"","stake","date","name","buy","sell","total"
"1","1309台達化","110/09/10","凱基-員林",470,0,470
"2","1309台達化","110/09/10","凱基-台北",18,371,-353
"3","1309台達化","110/09/10","宏遠-新化",80,0,80
"4","1309台達化","110/09/10","瑞士信貸",0,111,-111
"5","1309台達化","110/09/10","元大-南屯",81,4,77
"6","1309台達化","110/09/10","台灣摩根士丹利",36,121,-85
"7","1309台達化","110/09/10","福邦證券",75,0,75
"8","1309台達化","110/09/10","康和",0,80,-80
"9","1309台達化","110/09/10","美林",142,76,66
"10","1309台達化","110/09/10","群益金鼎-台南",0,61,-61
"11","1309台達化","110/09/10","元大證券",48,0,48
"12","1309台達化","110/09/10","凱基-松山",0,42,-42
"13","1309台達化","110/09/10","元富-三重",42,1,41
"14","1309台達化","110/09/10","元富-嘉義",0,39,-39
"15","1309台達化","110/09/10","元大-台北",44,3,41
"16","1309台達化","110/09/10","元大-竹南",0,33,-33
"17","1309台達化","110/09/10","永豐金-板橋",40,2,38
"18","1309台達化","110/09/10","台新-新莊",0,31,-31
"19","1309台達化","110/09/10","元大-蘆洲",37,2,35
"20","1309台達化","110/09/10","凱基-內湖",0,25,-25
"21","1309台達化","110/09/10","摩根大通",40,6,34
"22","1309台達化","110/09/10","元大-前金",2,26,-24
"23","1309台達化","110/09/10","新光-新竹",38,6,32
"24","1309台達化","110/09/10","華南永昌-鳳山",0,23,-23
"25","1309台達化","110/09/10","富邦-南屯",35,3,32
"26","1309台達化","110/09/10","凱基-站前",0,22,-22
"27","1309台達化","110/09/10","元大-景美",22,0,22
"28","1309台達化","110/09/10","統一-三重",7,26,-19
"29","1309台達化","110/09/10","元富-台南",21,0,21
"30","1309台達化","110/09/10","福勝",0,16,-16
"31","1312國喬","110/09/10","永豐金證券",450,1,449
"32","1312國喬","110/09/10","臺銀",14,1076,-1062
"33","1312國喬","110/09/10","摩根大通",563,230,333
"34","1312國喬","110/09/10","港商麥格理",0,461,-461
"35","1312國喬","110/09/10","國票-中港",308,3,305
"36","1312國喬","110/09/10","元富",0,264,-264
"37","1312國喬","110/09/10","香港上海匯豐",270,0,270
"38","1312國喬","110/09/10","元大-豐原",0,190,-190
"39","1312國喬","110/09/10","美林",229,11,218
"40","1312國喬","110/09/10","國票-南京",0,152,-152
"41","1312國喬","110/09/10","元大-羅東",203,0,203
"42","1312國喬","110/09/10","元富-大裕",2,141,-139
"43","1312國喬","110/09/10","新加坡商瑞銀",153,7,146
"44","1312國喬","110/09/10","群益金鼎",1,131,-130
"45","1312國喬","110/09/10","港商野村",199,71,128
"46","1312國喬","110/09/10","玉山-嘉義",0,110,-110
"47","1312國喬","110/09/10","凱基-台北",254,137,117
"48","1312國喬","110/09/10","元大-台中中港",74,182,-108
"49","1312國喬","110/09/10","土銀-南港",90,0,90
"50","1312國喬","110/09/10","臺灣企銀-埔墘",0,100,-100
"51","1312國喬","110/09/10","宏遠證券",65,0,65
"52","1312國喬","110/09/10","元大-中壢",26,88,-62
"53","1312國喬","110/09/10","新光",101,39,62
"54","1312國喬","110/09/10","統一-台南",0,47,-47
"55","1312國喬","110/09/10","國泰證券",65,4,61
"56","1312國喬","110/09/10","兆豐-三民",1,45,-44
"57","1312國喬","110/09/10","國泰-敦南",70,18,52
"58","1312國喬","110/09/10","永豐金-新店",0,35,-35
"59","1312國喬","110/09/10","聯邦商銀",50,0,50
"60","1312國喬","110/09/10","第一金-桃園",6,40,-34
"61","3702大聯大","110/09/10","台灣摩根士丹利",332,8,324
"62","3702大聯大","110/09/10","富邦證券",0,800,-800
"63","3702大聯大","110/09/10","美林",252,15,237
"64","3702大聯大","110/09/10","凱基-台南",0,300,-300
"65","3702大聯大","110/09/10","統一-內湖",210,0,210
"66","3702大聯大","110/09/10","元富",0,202,-202
"67","3702大聯大","110/09/10","華南永昌-東勢",160,19,141
"68","3702大聯大","110/09/10","瑞士信貸",186,302,-116
"69","3702大聯大","110/09/10","臺銀-鳳山",100,0,100
"70","3702大聯大","110/09/10","元富-城東",0,110,-110
"71","3702大聯大","110/09/10","摩根大通",171,74,97
"72","3702大聯大","110/09/10","土銀",5,100,-95
"73","3702大聯大","110/09/10","華南永昌-台中",103,9,94
"74","3702大聯大","110/09/10","永豐金-復興",0,62,-62
"75","3702大聯大","110/09/10","元大證券",76,1,75
"76","3702大聯大","110/09/10","元大-忠孝",4,52,-48
"77","3702大聯大","110/09/10","法銀巴黎",73,0,73
"78","3702大聯大","110/09/10","統一-敦南",2,35,-33
"79","3702大聯大","110/09/10","美商高盛",141,86,55
"80","3702大聯大","110/09/10","日盛-中壢",0,30,-30
"81","3702大聯大","110/09/10","港商法國興業",50,1,49
"82","3702大聯大","110/09/10","富邦-新店",0,27,-27
"83","3702大聯大","110/09/10","元大-新盛",46,1,45
"84","3702大聯大","110/09/10","兆豐-高雄",5,25,-20
"85","3702大聯大","110/09/10","凱基-市府",40,0,40
"86","3702大聯大","110/09/10","富邦-新營",0,20,-20
"87","3702大聯大","110/09/10","第一金-新興",35,0,35
"88","3702大聯大","110/09/10","統一-松江",1,20,-19
"89","3702大聯大","110/09/10","元大-府城",32,0,32
"90","3702大聯大","110/09/10","元大-文心興安",0,18,-18
"91","2417圓剛","110/09/10","凱基-台北",264,26,238
"92","2417圓剛","110/09/10","永豐金-嘉義",0,90,-90
"93","2417圓剛","110/09/10","新光-桃園",70,8,62
"94","2417圓剛","110/09/10","美商高盛",46,129,-83
"95","2417圓剛","110/09/10","花旗環球",50,0,50
"96","2417圓剛","110/09/10","新光",28,96,-68
"97","2417圓剛","110/09/10","新加坡商瑞銀",46,0,46
"98","2417圓剛","110/09/10","國泰-敦南",30,71,-41
"99","2417圓剛","110/09/10","兆豐-中壢",38,1,37
"100","2417圓剛","110/09/10","國票-南科",0,37,-37
"101","2417圓剛","110/09/10","摩根大通",126,91,35
"102","2417圓剛","110/09/10","永豐金-萬盛",3,40,-37
"103","2417圓剛","110/09/10","凱基",30,0,30
"104","2417圓剛","110/09/10","永豐金-豐原",0,25,-25
"105","2417圓剛","110/09/10","元大-豐原站前",28,5,23
"106","2417圓剛","110/09/10","台中銀",0,23,-23
"107","2417圓剛","110/09/10","群益金鼎-海山",22,0,22
"108","2417圓剛","110/09/10","台灣摩根士丹利",1,22,-21
"109","2417圓剛","110/09/10","統一-敦南",20,0,20
"110","2417圓剛","110/09/10","群益金鼎-土城",0,20,-20
"111","2417圓剛","110/09/10","國票-敦北法人",20,0,20
"112","2417圓剛","110/09/10","凱基-苗栗",0,20,-20
"113","2417圓剛","110/09/10","元大-路竹",27,7,20
"114","2417圓剛","110/09/10","台灣企銀-太平",1,20,-19
"115","2417圓剛","110/09/10","國泰-台南",20,1,19
"116","2417圓剛","110/09/10","富邦-宜蘭",2,21,-19
"117","2417圓剛","110/09/10","元大-左營",24,5,19
"118","2417圓剛","110/09/10","台新-台中",17,33,-16
"119","2417圓剛","110/09/10","國票-南崁",20,2,18
"120","2417圓剛","110/09/10","富邦-基隆",5,20,-15
"121","9919康那香","110/09/10","元富",113,3,110
"122","9919康那香","110/09/10","華南永昌-彰化",8,87,-79
"123","9919康那香","110/09/10","中國信託-松江",106,6,100
"124","9919康那香","110/09/10","國泰-敦南",105,171,-66
"125","9919康那香","110/09/10","凱基-台北",565,475,90
"126","9919康那香","110/09/10","富邦-嘉義",11,70,-59
"127","9919康那香","110/09/10","凱基-市政",104,21,83
"128","9919康那香","110/09/10","元大-大雅",5,64,-59
"129","9919康那香","110/09/10","中國信託-中壢",75,8,67
"130","9919康那香","110/09/10","中國信託",9,67,-58
"131","9919康那香","110/09/10","元大-開元",52,2,50
"132","9919康那香","110/09/10","統一-平鎮",1,51,-50
"133","9919康那香","110/09/10","華南永昌-鳳山",59,11,48
"134","9919康那香","110/09/10","新光-台中",23,65,-42
"135","9919康那香","110/09/10","台新-台中",74,27,47
"136","9919康那香","110/09/10","群益金鼎-基隆",1,43,-42
"137","9919康那香","110/09/10","永豐金-鳳山",45,3,42
"138","9919康那香","110/09/10","日盛-花蓮",0,39,-39
"139","9919康那香","110/09/10","日盛-中壢",40,0,40
"140","9919康那香","110/09/10","台新證券",135,174,-39
"141","9919康那香","110/09/10","群益金鼎-古亭",41,3,38
"142","9919康那香","110/09/10","永豐金-高雄",1,40,-39
"143","9919康那香","110/09/10","大昌-新店",33,4,29
"144","9919康那香","110/09/10","華南永昌-潮州",4,42,-38
"145","9919康那香","110/09/10","元大-台中",26,0,26
"146","9919康那香","110/09/10","永豐金-板新",0,34,-34
"147","9919康那香","110/09/10","大昌-桃園",25,0,25
"148","9919康那香","110/09/10","兆豐-台中港",0,32,-32
"149","9919康那香","110/09/10","大昌-樹林",29,5,24
"150","9919康那香","110/09/10","永豐金-桃盛",0,31,-31
"151","2834臺企銀","110/09/10","凱基-台北",2568,536,2032
"152","2834臺企銀","110/09/10","新加坡商瑞銀",0,1974,-1974
"153","2834臺企銀","110/09/10","台灣企銀",1138,9,1129
"154","2834臺企銀","110/09/10","摩根大通",1542,2647,-1105
"155","2834臺企銀","110/09/10","法銀巴黎",1026,0,1026
"156","2834臺企銀","110/09/10","富邦-建國",42,1142,-1100
"157","2834臺企銀","110/09/10","台灣摩根士丹利",1937,1234,703
"158","2834臺企銀","110/09/10","美林",816,1306,-490
"159","2834臺企銀","110/09/10","瑞士信貸",2270,1616,654
"160","2834臺企銀","110/09/10","華南永昌-高雄",1,300,-299
"161","2834臺企銀","110/09/10","元富-虎尾",270,0,270
"162","2834臺企銀","110/09/10","美商高盛",125,384,-259
"163","2834臺企銀","110/09/10","國票-嘉義",207,0,207
"164","2834臺企銀","110/09/10","元大-太平",0,252,-252
"165","2834臺企銀","110/09/10","國泰證券",200,0,200
"166","2834臺企銀","110/09/10","元大證券",1,250,-249
"167","2834臺企銀","110/09/10","第一金-桃園",185,0,185
"168","2834臺企銀","110/09/10","新光",85,331,-246
"169","2834臺企銀","110/09/10","華南永昌-麻豆",124,2,122
"170","2834臺企銀","110/09/10","高橋",2,233,-231
"171","2834臺企銀","110/09/10","日茂",110,0,110
"172","2834臺企銀","110/09/10","統一-高雄",0,197,-197
"173","2834臺企銀","110/09/10","國泰-台中",128,22,106
"174","2834臺企銀","110/09/10","台新-中壢",1,175,-174
"175","2834臺企銀","110/09/10","華南永昌",110,6,104
"176","2834臺企銀","110/09/10","華南永昌-彰化",1,150,-149
"177","2834臺企銀","110/09/10","宏遠-光隆",100,0,100
"178","2834臺企銀","110/09/10","元大-上新莊",0,126,-126
"179","2834臺企銀","110/09/10","統一-板橋",100,0,100
"180","2834臺企銀","110/09/10","元富-林園",0,125,-125
"181","5511德昌","110/09/10","華南永昌-忠孝",7,0,7
"182","5511德昌","110/09/10","凱基-永康",0,5,-5
"183","5511德昌","110/09/10","宏遠-桃園",1,0,1
"184","5511德昌","110/09/10","致和-崇德",0,2,-2
"185","5511德昌","110/09/10","群益金鼎-民權",1,0,1
"186","5511德昌","110/09/10","玉山證券",0,2,-2
"187","5511德昌","110/09/10","凱基-文心",1,0,1
"188","5511德昌","110/09/10","元大-大里德芳",0,2,-2
"189","5511德昌","110/09/10","元大-善化",1,0,1
"190","5511德昌","110/09/10","元大-士林",0,1,-1
"191","5511德昌","110/09/10","元大-林森",1,0,1
"192","5511德昌","110/09/10","康和-板橋",0,0,0
"193","5511德昌","110/09/10","康和-板橋",0,0,0
"194","5511德昌","110/09/10","凱基-興隆",0,0,0
"195","5511德昌","110/09/10","凱基-興隆",0,0,0
"196","5511德昌","110/09/10","元大-四維",0,0,0
"197","5511德昌","110/09/10","元大-四維",0,0,0
"198","5511德昌","110/09/10","",NA,NA,NA
"199","5511德昌","110/09/10","",NA,NA,NA
"200","5511德昌","110/09/10","",NA,NA,NA
"201","5511德昌","110/09/10","",NA,NA,NA
"202","5511德昌","110/09/10","",NA,NA,NA
"203","5511德昌","110/09/10","",NA,NA,NA
"204","5511德昌","110/09/10","",NA,NA,NA
"205","5511德昌","110/09/10","",NA,NA,NA
"206","5511德昌","110/09/10","",NA,NA,NA
"207","5511德昌","110/09/10","",NA,NA,NA
"208","5511德昌","110/09/10","",NA,NA,NA
"209","5511德昌","110/09/10","",NA,NA,NA
"210","5511德昌","110/09/10","",NA,NA,NA
"211","2489瑞軒","110/09/10","美商高盛",616,0,616
"212","2489瑞軒","110/09/10","第一金-新興",0,211,-211
"213","2489瑞軒","110/09/10","瑞士信貸",511,6,505
"214","2489瑞軒","110/09/10","元大-清水",0,121,-121
"215","2489瑞軒","110/09/10","摩根大通",434,49,385
"216","2489瑞軒","110/09/10","凱基-桃園",0,115,-115
"217","2489瑞軒","110/09/10","台灣摩根士丹利",338,1,337
"218","2489瑞軒","110/09/10","合庫-台中",0,110,-110
"219","2489瑞軒","110/09/10","凱基-台北",268,122,146
"220","2489瑞軒","110/09/10","華南永昌-虎尾",20,126,-106
"221","2489瑞軒","110/09/10","新加坡商瑞銀",160,16,144
"222","2489瑞軒","110/09/10","元大-淡水",2,102,-100
"223","2489瑞軒","110/09/10","美林",140,7,133
"224","2489瑞軒","110/09/10","統一-桃園",0,63,-63
"225","2489瑞軒","110/09/10","兆豐-內湖",90,0,90
"226","2489瑞軒","110/09/10","元大-內湖",0,51,-51
"227","2489瑞軒","110/09/10","港商野村",189,104,85
"228","2489瑞軒","110/09/10","凱基-中港",0,50,-50
"229","2489瑞軒","110/09/10","元富-四維",60,0,60
"230","2489瑞軒","110/09/10","凱基-東勢",0,50,-50
"231","2489瑞軒","110/09/10","台中銀",50,1,49
"232","2489瑞軒","110/09/10","玉山-台中",0,40,-40
"233","2489瑞軒","110/09/10","日盛-新竹",40,0,40
"234","2489瑞軒","110/09/10","富邦-板橋",3,43,-40
"235","2489瑞軒","110/09/10","土銀-玉里",40,2,38
"236","2489瑞軒","110/09/10","元大-雙和",0,37,-37
"237","2489瑞軒","110/09/10","元大-東港",30,0,30
"238","2489瑞軒","110/09/10","元大-鹿港",0,35,-35
"239","2489瑞軒","110/09/10","日盛證券",25,0,25
"240","2489瑞軒","110/09/10","元大-北港",0,34,-34
"241","2428興勤","110/09/10","凱基-城中",10,0,10
"242","2428興勤","110/09/10","富邦-台北",1,29,-28
"243","2428興勤","110/09/10","凱基-站前",8,0,8
"244","2428興勤","110/09/10","元大證券",3,13,-10
"245","2428興勤","110/09/10","台灣摩根士丹利",8,1,7
"246","2428興勤","110/09/10","凱基-三重",0,6,-6
"247","2428興勤","110/09/10","新加坡商瑞銀",6,0,6
"248","2428興勤","110/09/10","合庫-西台中",0,3,-3
"249","2428興勤","110/09/10","群益金鼎",5,0,5
"250","2428興勤","110/09/10","宏遠-新化",0,3,-3
"251","2428興勤","110/09/10","日盛-新竹",4,0,4
"252","2428興勤","110/09/10","第一金-頭份",0,3,-3
"253","2428興勤","110/09/10","美林",8,4,4
"254","2428興勤","110/09/10","元富-大昌",0,3,-3
"255","2428興勤","110/09/10","美商高盛",6,3,3
"256","2428興勤","110/09/10","元富-敦南",0,3,-3
"257","2428興勤","110/09/10","港商野村",3,0,3
"258","2428興勤","110/09/10","(牛牛牛)亞-鑫豐",0,3,-3
"259","2428興勤","110/09/10","大昌-桃園",3,0,3
"260","2428興勤","110/09/10","元大-大雅",0,3,-3
"261","2428興勤","110/09/10","凱基-大直",2,0,2
"262","2428興勤","110/09/10","康和-台中",0,2,-2
"263","2428興勤","110/09/10","元大-新竹",2,0,2
"264","2428興勤","110/09/10","元大-開元",0,2,-2
"265","2428興勤","110/09/10","元大-敦南",2,0,2
"266","2428興勤","110/09/10","元大-台北",0,2,-2
"267","2428興勤","110/09/10","日盛-鳳山",1,0,1
"268","2428興勤","110/09/10","日盛-忠孝",1,2,-1
"269","2428興勤","110/09/10","瑞士信貸",5,4,1
"270","2428興勤","110/09/10","亞東-台南",0,1,-1
"271","3176基亞","110/09/10","元大-淡水",25,0,25
"272","3176基亞","110/09/10","日盛-忠孝",0,16,-16
"273","3176基亞","110/09/10","凱基-高美館",20,0,20
"274","3176基亞","110/09/10","第一金-台中",0,10,-10
"275","3176基亞","110/09/10","元大-新竹經國",15,0,15
"276","3176基亞","110/09/10","第一金-桃園",0,10,-10
"277","3176基亞","110/09/10","國泰-敦南",13,0,13
"278","3176基亞","110/09/10","兆豐-台中",0,10,-10
"279","3176基亞","110/09/10","元大-和平",11,0,11
"280","3176基亞","110/09/10","新光-桃園",0,10,-10
"281","3176基亞","110/09/10","新光-台中",10,1,9
"282","3176基亞","110/09/10","富邦-仁愛",0,10,-10
"283","3176基亞","110/09/10","聯邦-富強",7,0,7
"284","3176基亞","110/09/10","康和-永和",0,6,-6
"285","3176基亞","110/09/10","元富-佳里",5,0,5
"286","3176基亞","110/09/10","華南永昌-南京",0,6,-6
"287","3176基亞","110/09/10","康和-仁愛",5,0,5
"288","3176基亞","110/09/10","第一金-大稻埕",0,5,-5
"289","3176基亞","110/09/10","兆豐-大同",4,0,4
"290","3176基亞","110/09/10","統一-基隆",0,5,-5
"291","3176基亞","110/09/10","台新-新營",5,1,4
"292","3176基亞","110/09/10","兆豐-麻豆",0,5,-5
"293","3176基亞","110/09/10","華南永昌-斗六",4,0,4
"294","3176基亞","110/09/10","群益金鼎-士林",0,5,-5
"295","3176基亞","110/09/10","元大-發財",3,0,3
"296","3176基亞","110/09/10","凱基-斗六",0,5,-5
"297","3176基亞","110/09/10","元大-萬華",3,0,3
"298","3176基亞","110/09/10","元大-四維",0,5,-5
"299","3176基亞","110/09/10","大慶-富順",2,0,2
"300","3176基亞","110/09/10","元大-忠孝",0,5,-5
"301","2409友達","110/09/10","凱基-員林",2611,41,2570
"302","2409友達","110/09/10","美商高盛",1034,9347,-8313
"303","2409友達","110/09/10","國泰證券",2328,10,2318
"304","2409友達","110/09/10","摩根大通",5757,13502,-7745
"305","2409友達","110/09/10","日盛-永康",1774,12,1762
"306","2409友達","110/09/10","美林",3641,6716,-3075
"307","2409友達","110/09/10","台灣摩根士丹利",1990,850,1140
"308","2409友達","110/09/10","新加坡商瑞銀",1550,3061,-1511
"309","2409友達","110/09/10","凱基-台北",2389,1354,1035
"310","2409友達","110/09/10","香港上海匯豐",0,1433,-1433
"311","2409友達","110/09/10","大慶-苗栗",1010,2,1008
"312","2409友達","110/09/10","瑞士信貸",1967,2826,-859
"313","2409友達","110/09/10","元富-大裕",987,30,957
"314","2409友達","110/09/10","台中銀-台北",5,860,-855
"315","2409友達","110/09/10","臺銀",980,118,862
"316","2409友達","110/09/10","港商野村",3711,4536,-825
"317","2409友達","110/09/10","元大-豐原站前",853,22,831
"318","2409友達","110/09/10","元大-東泰",134,669,-535
"319","2409友達","110/09/10","元大-中壢",884,176,708
"320","2409友達","110/09/10","中國信託-新竹",84,532,-448
"321","2409友達","110/09/10","永豐金-忠孝",649,16,633
"322","2409友達","110/09/10","宏遠-台中",122,543,-421
"323","2409友達","110/09/10","元富",841,219,622
"324","2409友達","110/09/10","群益金鼎-鳳山",31,419,-388
"325","2409友達","110/09/10","法銀巴黎",597,0,597
"326","2409友達","110/09/10","富邦-嘉義",117,465,-348
"327","2409友達","110/09/10","富邦-陽明",681,89,592
"328","2409友達","110/09/10","元大-北投",100,428,-328
"329","2409友達","110/09/10","國票-九鼎",1409,842,567
"330","2409友達","110/09/10","華南永昌-大安",134,461,-327
"331","1315達新","110/09/10","元大-文心興安",3,0,3
"332","1315達新","110/09/10","國票-台東",0,3,-3
"333","1315達新","110/09/10","美林",3,1,2
"334","1315達新","110/09/10","臺銀-鳳山",0,2,-2
"335","1315達新","110/09/10","永豐金證券",2,0,2
"336","1315達新","110/09/10","中國信託-文心",0,2,-2
"337","1315達新","110/09/10","日盛-永康",1,0,1
"338","1315達新","110/09/10","富邦-高雄",0,2,-2
"339","1315達新","110/09/10","台灣摩根士丹利",1,0,1
"340","1315達新","110/09/10","凱基-鳳山",0,1,-1
"341","1315達新","110/09/10","摩根大通",1,0,1
"342","1315達新","110/09/10","元大-台北",1,2,-1
"343","1315達新","110/09/10","新光-台中",1,0,1
"344","1315達新","110/09/10","永豐金-埔里",0,1,-1
"345","1315達新","110/09/10","凱基-中港",1,0,1
"346","1315達新","110/09/10","台灣企銀-台中",0,0,0
"347","1315達新","110/09/10","台灣企銀-台中",0,0,0
"348","1315達新","110/09/10","統一-屏東",0,0,0
"349","1315達新","110/09/10","統一-屏東",0,0,0
"350","1315達新","110/09/10","國泰-台中",0,0,0
"351","1315達新","110/09/10","國泰-台中",0,0,0
"352","1315達新","110/09/10","元大-松江",0,0,0
"353","1315達新","110/09/10","元大-松江",0,0,0
"354","1315達新","110/09/10","元大-龍潭",0,0,0
"355","1315達新","110/09/10","元大-龍潭",0,0,0
"356","1315達新","110/09/10","元大-鳳中",0,0,0
"357","1315達新","110/09/10","元大-鳳中",0,0,0
"358","1315達新","110/09/10","永豐金-萬盛",0,0,0
"359","1315達新","110/09/10","永豐金-萬盛",0,0,0
"360","1315達新","110/09/10","",NA,NA,NA
"361","2609陽明","110/09/10","永豐金-信義",3637,1055,2582
"362","2609陽明","110/09/10","群益金鼎-大安",466,2252,-1786
"363","2609陽明","110/09/10","康和",7550,5316,2234
"364","2609陽明","110/09/10","富邦證券",0,1001,-1001
"365","2609陽明","110/09/10","凱基-台北",3906,1796,2110
"366","2609陽明","110/09/10","元大-土城永寧",203,1096,-893
"367","2609陽明","110/09/10","兆豐-虎尾",2843,1276,1567
"368","2609陽明","110/09/10","統一-土城",49,658,-609
"369","2609陽明","110/09/10","美林",4156,2609,1547
"370","2609陽明","110/09/10","元大-大天母",24,380,-356
"371","2609陽明","110/09/10","摩根大通",3596,2341,1255
"372","2609陽明","110/09/10","統一-敦南",28,349,-321
"373","2609陽明","110/09/10","兆豐-嘉義",1091,17,1074
"374","2609陽明","110/09/10","華南永昌-虎尾",121,426,-305
"375","2609陽明","110/09/10","統一-仁愛",1233,579,654
"376","2609陽明","110/09/10","元大-板橋",64,368,-304
"377","2609陽明","110/09/10","台灣摩根士丹利",644,8,636
"378","2609陽明","110/09/10","玉山-新竹",32,334,-302
"379","2609陽明","110/09/10","瑞士信貸",973,441,532
"380","2609陽明","110/09/10","統一-三重",126,419,-293
"381","2609陽明","110/09/10","統一-士林",610,110,500
"382","2609陽明","110/09/10","第一金-桃園",104,384,-280
"383","2609陽明","110/09/10","國票-安和",1195,755,440
"384","2609陽明","110/09/10","統一-城中",256,534,-278
"385","2609陽明","110/09/10","富邦-仁愛",2075,1812,263
"386","2609陽明","110/09/10","國泰-敦南",1305,1570,-265
"387","2609陽明","110/09/10","元大-頭份",313,51,262
"388","2609陽明","110/09/10","玉山-高雄",94,352,-258
"389","2609陽明","110/09/10","凱基-桃園",492,267,225
"390","2609陽明","110/09/10","兆豐-寶成",42,272,-230
"391","2636台驊投控","110/09/10","元大-大雅",259,7,252
"392","2636台驊投控","110/09/10","統一",61,306,-245
"393","2636台驊投控","110/09/10","摩根大通",714,503,211
"394","2636台驊投控","110/09/10","兆豐證券",0,224,-224
"395","2636台驊投控","110/09/10","美林",437,235,202
"396","2636台驊投控","110/09/10","凱基-信義",6,171,-165
"397","2636台驊投控","110/09/10","瑞士信貸",381,260,121
"398","2636台驊投控","110/09/10","日盛-台中",44,139,-95
"399","2636台驊投控","110/09/10","台灣摩根士丹利",135,36,99
"400","2636台驊投控","110/09/10","群益金鼎-竹南",2,74,-72
"401","2636台驊投控","110/09/10","新加坡商瑞銀",106,22,84
"402","2636台驊投控","110/09/10","凱基-松山",1,62,-61
"403","2636台驊投控","110/09/10","美商高盛",162,92,70
"404","2636台驊投控","110/09/10","群益金鼎-敦南",37,72,-35
"405","2636台驊投控","110/09/10","華南永昌-三重",70,0,70
"406","2636台驊投控","110/09/10","群益金鼎-南京",10,42,-32
"407","2636台驊投控","110/09/10","凱基-台北",296,232,64
"408","2636台驊投控","110/09/10","宏遠證券",5,36,-31
"409","2636台驊投控","110/09/10","群益金鼎-鳳山",68,12,56
"410","2636台驊投控","110/09/10","第一金-桃園",4,31,-27
"411","2636台驊投控","110/09/10","新光-新竹",62,12,50
"412","2636台驊投控","110/09/10","華南永昌-內壢",0,24,-24
"413","2636台驊投控","110/09/10","第一金-忠孝",39,4,35
"414","2636台驊投控","110/09/10","富邦-南屯",1,25,-24
"415","2636台驊投控","110/09/10","元富-板橋",46,11,35
"416","2636台驊投控","110/09/10","華南永昌-台南",1,23,-22
"417","2636台驊投控","110/09/10","台新證券",75,43,32
"418","2636台驊投控","110/09/10","富邦-台北",15,37,-22
"419","2636台驊投控","110/09/10","港商野村",444,413,31
"420","2636台驊投控","110/09/10","兆豐-城中",7,28,-21
"421","2867三商壽","110/09/10","凱基-興隆",250,0,250
"422","2867三商壽","110/09/10","元富-佳里",0,259,-259
"423","2867三商壽","110/09/10","美林",192,14,178
"424","2867三商壽","110/09/10","港商麥格理",0,136,-136
"425","2867三商壽","110/09/10","元富-新竹",164,0,164
"426","2867三商壽","110/09/10","富邦-台北",0,116,-116
"427","2867三商壽","110/09/10","台灣摩根士丹利",171,9,162
"428","2867三商壽","110/09/10","元大-新店中正",0,100,-100
"429","2867三商壽","110/09/10","元大-沙鹿",155,0,155
"430","2867三商壽","110/09/10","永豐金-埔里",0,92,-92
"431","2867三商壽","110/09/10","瑞士信貸",139,0,139
"432","2867三商壽","110/09/10","玉山-城中",20,102,-82
"433","2867三商壽","110/09/10","台新-高雄",150,21,129
"434","2867三商壽","110/09/10","元大-崇德",0,71,-71
"435","2867三商壽","110/09/10","日盛-新莊",100,0,100
"436","2867三商壽","110/09/10","新光-台中",3,55,-52
"437","2867三商壽","110/09/10","新加坡商瑞銀",94,2,92
"438","2867三商壽","110/09/10","國票-台南",0,50,-50
"439","2867三商壽","110/09/10","元大-苑裡",75,1,74
"440","2867三商壽","110/09/10","康和-台中",0,50,-50
"441","2867三商壽","110/09/10","群益金鼎-東門",60,0,60
"442","2867三商壽","110/09/10","摩根大通",88,137,-49
"443","2867三商壽","110/09/10","美商高盛",81,30,51
"444","2867三商壽","110/09/10","凱基-台北",154,198,-44
"445","2867三商壽","110/09/10","富邦-高雄",100,50,50
"446","2867三商壽","110/09/10","宏遠-台中",0,41,-41
"447","2867三商壽","110/09/10","元大-桃園",50,0,50
"448","2867三商壽","110/09/10","新光-高雄",0,41,-41
"449","2867三商壽","110/09/10","元大-大甲",50,0,50
"450","2867三商壽","110/09/10","永豐金-台南",0,41,-41
"451","5521工信","110/09/10","華南永昌-苗栗",95,0,95
"452","5521工信","110/09/10","美商高盛",1,412,-411
"453","5521工信","110/09/10","玉山-左營",90,0,90
"454","5521工信","110/09/10","摩根大通",84,442,-358
"455","5521工信","110/09/10","日盛-花蓮",50,0,50
"456","5521工信","110/09/10","元大-成功",0,128,-128
"457","5521工信","110/09/10","富邦-敦南",40,0,40
"458","5521工信","110/09/10","富邦-台北",50,150,-100
"459","5521工信","110/09/10","國泰-敦南",35,2,33
"460","5521工信","110/09/10","元大-開元",0,95,-95
"461","5521工信","110/09/10","元大-桃園",30,0,30
"462","5521工信","110/09/10","凱基-台北",60,111,-51
"463","5521工信","110/09/10","群益金鼎-崇德",25,0,25
"464","5521工信","110/09/10","群益金鼎-敦南",0,45,-45
"465","5521工信","110/09/10","玉山-高雄",22,0,22
"466","5521工信","110/09/10","(牛牛牛)亞-網路",0,40,-40
"467","5521工信","110/09/10","元大-屏南",22,0,22
"468","5521工信","110/09/10","元富-古亭",0,15,-15
"469","5521工信","110/09/10","元大-竹南",22,0,22
"470","5521工信","110/09/10","美林",25,37,-12
"471","5521工信","110/09/10","元大-天母",21,0,21
"472","5521工信","110/09/10","元大-太平",0,10,-10
"473","5521工信","110/09/10","康和-板橋",20,0,20
"474","5521工信","110/09/10","玉山-台大",1,10,-9
"475","5521工信","110/09/10","玉山-嘉義",20,0,20
"476","5521工信","110/09/10","永豐金證券",7,16,-9
"477","5521工信","110/09/10","凱基-東勢",20,0,20
"478","5521工信","110/09/10","玉山-雙和",0,8,-8
"479","5521工信","110/09/10","富邦-高雄",20,0,20
"480","5521工信","110/09/10","京城",0,5,-5
"481","1471首利","110/09/10","元大-敦化",100,0,100
"482","1471首利","110/09/10","光和-溪湖",0,60,-60
"483","1471首利","110/09/10","元富-民權",37,0,37
"484","1471首利","110/09/10","永豐金-古亭",0,51,-51
"485","1471首利","110/09/10","華南永昌-中正",35,0,35
"486","1471首利","110/09/10","第一金-華江",1,26,-25
"487","1471首利","110/09/10","摩根大通",49,15,34
"488","1471首利","110/09/10","元大-南屯",0,19,-19
"489","1471首利","110/09/10","元大-龍潭",30,0,30
"490","1471首利","110/09/10","元大-福營",0,15,-15
"491","1471首利","110/09/10","統一-高雄",20,0,20
"492","1471首利","110/09/10","富邦-基隆",7,20,-13
"493","1471首利","110/09/10","群益金鼎-台南",20,0,20
"494","1471首利","110/09/10","日盛-士林",0,12,-12
"495","1471首利","110/09/10","凱基-台南",20,0,20
"496","1471首利","110/09/10","大昌-樹林",0,11,-11
"497","1471首利","110/09/10","致和-府前",16,0,16
"498","1471首利","110/09/10","華南永昌-虎尾",0,11,-11
"499","1471首利","110/09/10","台灣企銀-九如",15,0,15
"500","1471首利","110/09/10","臺灣企銀-桃園",0,10,-10
"501","1471首利","110/09/10","華南永昌-台中",12,0,12
"502","1471首利","110/09/10","元富-林園",0,10,-10
"503","1471首利","110/09/10","永豐金-羅東",12,0,12
"504","1471首利","110/09/10","玉山-左營",0,10,-10
"505","1471首利","110/09/10","合庫-嘉義",10,0,10
"506","1471首利","110/09/10","群益金鼎-丹鳳",0,10,-10
"507","1471首利","110/09/10","國泰-敦南",13,3,10
"508","1471首利","110/09/10","凱基-新莊",0,10,-10
"509","1471首利","110/09/10","元大-土城",10,0,10
"510","1471首利","110/09/10","富邦-花蓮",0,10,-10
"511","2883開發金","110/09/10","瑞士信貸",1950,126,1824
"512","2883開發金","110/09/10","富邦-內湖",0,1716,-1716
"513","2883開發金","110/09/10","國票-北高雄",1603,2,1601
"514","2883開發金","110/09/10","元富",2,1007,-1005
"515","2883開發金","110/09/10","凱基-台北",1675,225,1450
"516","2883開發金","110/09/10","永豐金-板橋",0,1000,-1000
"517","2883開發金","110/09/10","台灣摩根士丹利",841,248,593
"518","2883開發金","110/09/10","摩根大通",977,1911,-934
"519","2883開發金","110/09/10","新光-台中",501,55,446
"520","2883開發金","110/09/10","群益金鼎-西松",0,810,-810
"521","2883開發金","110/09/10","新加坡商瑞銀",404,0,404
"522","2883開發金","110/09/10","兆豐-北高雄",26,495,-469
"523","2883開發金","110/09/10","日盛-中和",360,1,359
"524","2883開發金","110/09/10","元大-豐原站前",0,430,-430
"525","2883開發金","110/09/10","元大證券",552,210,342
"526","2883開發金","110/09/10","亞東-新竹",0,388,-388
"527","2883開發金","110/09/10","凱基-高美館",353,64,289
"528","2883開發金","110/09/10","日盛-台南",1,276,-275
"529","2883開發金","110/09/10","元大-府城",251,2,249
"530","2883開發金","110/09/10","元大-左營",1,241,-240
"531","2883開發金","110/09/10","新光",777,532,245
"532","2883開發金","110/09/10","國泰-板橋",10,212,-202
"533","2883開發金","110/09/10","元大-文心興安",214,3,211
"534","2883開發金","110/09/10","元大-北投",4,200,-196
"535","2883開發金","110/09/10","統一-嘉義",200,0,200
"536","2883開發金","110/09/10","凱基-幸福",6,200,-194
"537","2883開發金","110/09/10","凱基-新豐",213,17,196
"538","2883開發金","110/09/10","福勝",1,142,-141
"539","2883開發金","110/09/10","(牛牛牛)亞-網路",234,50,184
"540","2883開發金","110/09/10","元大-大益",5,139,-134
"541","6205詮欣","110/09/10","玉山-板橋",10,0,10
"542","6205詮欣","110/09/10","合庫-自強",0,10,-10
"543","6205詮欣","110/09/10","凱基-汐止",7,0,7
"544","6205詮欣","110/09/10","群益金鼎-新莊",0,4,-4
"545","6205詮欣","110/09/10","凱基-東門",4,0,4
"546","6205詮欣","110/09/10","元大-雙和",0,4,-4
"547","6205詮欣","110/09/10","臺銀-民權",2,0,2
"548","6205詮欣","110/09/10","大慶-中壢",0,3,-3
"549","6205詮欣","110/09/10","元大-成功",2,0,2
"550","6205詮欣","110/09/10","盈溢",0,3,-3
"551","6205詮欣","110/09/10","富邦-內湖",2,0,2
"552","6205詮欣","110/09/10","康和-板橋",0,3,-3
"553","6205詮欣","110/09/10","臺銀-臺南",2,0,2
"554","6205詮欣","110/09/10","元大-屏東民生",0,3,-3
"555","6205詮欣","110/09/10","凱基-松山",1,0,1
"556","6205詮欣","110/09/10","元大-忠孝",0,2,-2
"557","6205詮欣","110/09/10","兆豐-台中",1,0,1
"558","6205詮欣","110/09/10","永豐金-潮州",0,2,-2
"559","6205詮欣","110/09/10","凱基-嘉義",1,0,1
"560","6205詮欣","110/09/10","統一-平鎮",0,1,-1
"561","6205詮欣","110/09/10","華南永昌-忠孝",1,0,1
"562","6205詮欣","110/09/10","台新證券",0,1,-1
"563","6205詮欣","110/09/10","華南永昌-頭份",1,0,1
"564","6205詮欣","110/09/10","國泰-板橋",0,1,-1
"565","6205詮欣","110/09/10","大展-台南",1,0,1
"566","6205詮欣","110/09/10","群益金鼎-內湖",0,1,-1
"567","6205詮欣","110/09/10","元大-沙鹿",1,0,1
"568","6205詮欣","110/09/10","富邦-板橋",1,1,0
"569","6205詮欣","110/09/10","元大-土城永寧",1,0,1
"570","6205詮欣","110/09/10","元大-北投",0,0,0
"571","1540喬福","110/09/10","元大-龍潭",3,0,3
"572","1540喬福","110/09/10","統一-中壢",0,8,-8
"573","1540喬福","110/09/10","元富",2,0,2
"574","1540喬福","110/09/10","兆豐-北高雄",0,2,-2
"575","1540喬福","110/09/10","台新-高雄",2,0,2
"576","1540喬福","110/09/10","元富-新竹",2,3,-1
"577","1540喬福","110/09/10","元大-土城永寧",2,0,2
"578","1540喬福","110/09/10","中國信託-新竹",0,1,-1
"579","1540喬福","110/09/10","中國信託",1,0,1
"580","1540喬福","110/09/10","國票-安和",0,1,-1
"581","1540喬福","110/09/10","兆豐-高雄",1,0,1
"582","1540喬福","110/09/10","國泰-台南",0,1,-1
"583","1540喬福","110/09/10","致和-南京",1,0,1
"584","1540喬福","110/09/10","第一金-自由",0,0,0
"585","1540喬福","110/09/10","國泰-敦南",1,0,1
"586","1540喬福","110/09/10","國泰-新莊",0,0,0
"587","1540喬福","110/09/10","凱基-台北",1,0,1
"588","1540喬福","110/09/10","凱基-竹北",0,0,0
"589","1540喬福","110/09/10","第一金-自由",0,0,0
"590","1540喬福","110/09/10","元大-成功",0,0,0
"591","1540喬福","110/09/10","國泰-新莊",0,0,0
"592","1540喬福","110/09/10","永豐金-萬盛",0,0,0
"593","1540喬福","110/09/10","凱基-竹北",0,0,0
"594","1540喬福","110/09/10","",NA,NA,NA
"595","1540喬福","110/09/10","元大-成功",0,0,0
"596","1540喬福","110/09/10","",NA,NA,NA
"597","1540喬福","110/09/10","永豐金-萬盛",0,0,0
"598","1540喬福","110/09/10","",NA,NA,NA
"599","1540喬福","110/09/10","",NA,NA,NA
"600","1540喬福","110/09/10","",NA,NA,NA
"601","2888新光金","110/09/10","台灣摩根士丹利",5115,42,5073
"602","2888新光金","110/09/10","凱基-台北",4002,12087,-8085
"603","2888新光金","110/09/10","國票-長城",5000,3,4997
"604","2888新光金","110/09/10","統一-板橋",750,2435,-1685
"605","2888新光金","110/09/10","摩根大通",4726,263,4463
"606","2888新光金","110/09/10","元大證券",80,1696,-1616
"607","2888新光金","110/09/10","美商高盛",4114,294,3820
"608","2888新光金","110/09/10","兆豐-西螺",2,1045,-1043
"609","2888新光金","110/09/10","台新-新莊",3280,30,3250
"610","2888新光金","110/09/10","瑞士信貸",5869,6905,-1036
"611","2888新光金","110/09/10","永豐金-桃園",3017,36,2981
"612","2888新光金","110/09/10","元富-城東",0,923,-923
"613","2888新光金","110/09/10","港商野村",2893,65,2828
"614","2888新光金","110/09/10","群益金鼎-彰化",60,915,-855
"615","2888新光金","110/09/10","新加坡商瑞銀",1742,206,1536
"616","2888新光金","110/09/10","元大-北港",37,873,-836
"617","2888新光金","110/09/10","群益金鼎-南京",1160,25,1135
"618","2888新光金","110/09/10","台新證券",602,1425,-823
"619","2888新光金","110/09/10","凱基-城中",1058,10,1048
"620","2888新光金","110/09/10","永豐金-市政",100,879,-779
"621","2888新光金","110/09/10","合庫-新竹",1056,22,1034
"622","2888新光金","110/09/10","元大-敦南",4,678,-674
"623","2888新光金","110/09/10","群益金鼎-崇德",1000,67,933
"624","2888新光金","110/09/10","凱基-市府",0,519,-519
"625","2888新光金","110/09/10","永豐金-台南",1094,225,869
"626","2888新光金","110/09/10","元大-新竹經國",20,515,-495
"627","2888新光金","110/09/10","法銀巴黎",772,0,772
"628","2888新光金","110/09/10","元富-板橋",57,545,-488
"629","2888新光金","110/09/10","凱基",606,0,606
"630","2888新光金","110/09/10","合庫證券",52,536,-484
"631","1340勝悅","110/09/10","瑞士信貸",5,0,5
"632","1340勝悅","110/09/10","台中銀",3,20,-17
"633","1340勝悅","110/09/10","玉山-板橋",5,0,5
"634","1340勝悅","110/09/10","國票-敦北法人",0,10,-10
"635","1340勝悅","110/09/10","國泰-館前",5,0,5
"636","1340勝悅","110/09/10","統一-城中",3,11,-8
"637","1340勝悅","110/09/10","國泰-敦南",5,1,4
"638","1340勝悅","110/09/10","(牛牛牛)亞-鑫豐",0,7,-7
"639","1340勝悅","110/09/10","美商高盛",3,0,3
"640","1340勝悅","110/09/10","日盛-永康",0,6,-6
"641","1340勝悅","110/09/10","元富-宜蘭",3,0,3
"642","1340勝悅","110/09/10","臺銀-鳳山",0,5,-5
"643","1340勝悅","110/09/10","國泰-台中",3,0,3
"644","1340勝悅","110/09/10","宏遠-桃園",0,5,-5
"645","1340勝悅","110/09/10","群益金鼎-北高雄",3,0,3
"646","1340勝悅","110/09/10","國泰-台南",3,8,-5
"647","1340勝悅","110/09/10","凱基-苗栗",3,0,3
"648","1340勝悅","110/09/10","第一金-華江",0,3,-3
"649","1340勝悅","110/09/10","華南永昌-高雄",4,1,3
"650","1340勝悅","110/09/10","中國信託-嘉義",0,3,-3
"651","1340勝悅","110/09/10","永豐金-桃園",3,0,3
"652","1340勝悅","110/09/10","新光",0,3,-3
"653","1340勝悅","110/09/10","臺灣企銀-埔墘",2,0,2
"654","1340勝悅","110/09/10","元大-成功",0,3,-3
"655","1340勝悅","110/09/10","國泰-新莊",2,0,2
"656","1340勝悅","110/09/10","美林",0,2,-2
"657","1340勝悅","110/09/10","群益金鼎-崇德",2,0,2
"658","1340勝悅","110/09/10","中農",0,2,-2
"659","1340勝悅","110/09/10","群益金鼎-古亭",2,0,2
"660","1340勝悅","110/09/10","凱基-宜蘭",0,2,-2
"661","6246臺龍","110/09/10","統一",67,0,67
"662","6246臺龍","110/09/10","合庫-台中",1,25,-24
"663","6246臺龍","110/09/10","群益金鼎-鳳山",24,4,20
"664","6246臺龍","110/09/10","群益金鼎-古亭",0,19,-19
"665","6246臺龍","110/09/10","元大-員林",20,0,20
"666","6246臺龍","110/09/10","華南永昌-南京",1,20,-19
"667","6246臺龍","110/09/10","摩根大通",16,0,16
"668","6246臺龍","110/09/10","元大-永康",0,18,-18
"669","6246臺龍","110/09/10","港商野村",13,1,12
"670","6246臺龍","110/09/10","元大-金門",0,17,-17
"671","6246臺龍","110/09/10","統一-土城",228,216,12
"672","6246臺龍","110/09/10","元大-竹山",0,11,-11
"673","6246臺龍","110/09/10","玉山-數位",11,0,11
"674","6246臺龍","110/09/10","元富-板橋",0,10,-10
"675","6246臺龍","110/09/10","(牛牛牛)亞-鑫豐",30,20,10
"676","6246臺龍","110/09/10","新光",10,20,-10
"677","6246臺龍","110/09/10","台中銀-豐原",10,0,10
"678","6246臺龍","110/09/10","凱基-幸福",0,10,-10
"679","6246臺龍","110/09/10","中農",10,0,10
"680","6246臺龍","110/09/10","富邦-羅東",0,10,-10
"681","6246臺龍","110/09/10","凱基-桃園",10,0,10
"682","6246臺龍","110/09/10","元大-土城永寧",0,10,-10
"683","6246臺龍","110/09/10","元大-竹東",10,0,10
"684","6246臺龍","110/09/10","高橋-龍潭",0,9,-9
"685","6246臺龍","110/09/10","元富-新店",10,1,9
"686","6246臺龍","110/09/10","國票-敦北法人",0,9,-9
"687","6246臺龍","110/09/10","玉山-板橋",8,0,8
"688","6246臺龍","110/09/10","富邦-新竹",0,9,-9
"689","6246臺龍","110/09/10","統一-內湖",7,0,7
"690","6246臺龍","110/09/10","元大-中壢",0,9,-9
"691","00715L期街口布蘭特正2","110/09/10","永豐金證券",989,50,939
"692","00715L期街口布蘭特正2","110/09/10","凱基-台北",488,5746,-5258
"693","00715L期街口布蘭特正2","110/09/10","群益金鼎-宜蘭",684,0,684
"694","00715L期街口布蘭特正2","110/09/10","聯邦-三重",0,3046,-3046
"695","00715L期街口布蘭特正2","110/09/10","日盛-和美",605,6,599
"696","00715L期街口布蘭特正2","110/09/10","新光",214,2460,-2246
"697","00715L期街口布蘭特正2","110/09/10","台新-台中",570,11,559
"698","00715L期街口布蘭特正2","110/09/10","元大-竹東",32,700,-668
"699","00715L期街口布蘭特正2","110/09/10","永豐金-內湖",500,0,500
"700","00715L期街口布蘭特正2","110/09/10","富邦證券",552,1147,-595
"701","00715L期街口布蘭特正2","110/09/10","元富",648,211,437
"702","00715L期街口布蘭特正2","110/09/10","群益金鼎-中壢",22,490,-468
"703","00715L期街口布蘭特正2","110/09/10","群益金鼎-士林",400,0,400
"704","00715L期街口布蘭特正2","110/09/10","元大證券",3101,3409,-308
"705","00715L期街口布蘭特正2","110/09/10","元大-萬華",403,3,400
"706","00715L期街口布蘭特正2","110/09/10","凱基-板橋",1,230,-229
"707","00715L期街口布蘭特正2","110/09/10","富邦-新竹",324,10,314
"708","00715L期街口布蘭特正2","110/09/10","凱基-和平",10,200,-190
"709","00715L期街口布蘭特正2","110/09/10","富邦-彰化",268,3,265
"710","00715L期街口布蘭特正2","110/09/10","港商野村",424,582,-158
"711","00715L期街口布蘭特正2","110/09/10","凱基-新豐",259,0,259
"712","00715L期街口布蘭特正2","110/09/10","凱基-竹科",0,155,-155
"713","00715L期街口布蘭特正2","110/09/10","(牛牛牛)亞-鑫豐",315,66,249
"714","00715L期街口布蘭特正2","110/09/10","元大-新店中正",5,158,-153
"715","00715L期街口布蘭特正2","110/09/10","合庫證券",238,2,236
"716","00715L期街口布蘭特正2","110/09/10","凱基-市政",22,165,-143
"717","00715L期街口布蘭特正2","110/09/10","康和",621,388,233
"718","00715L期街口布蘭特正2","110/09/10","中國信託-永康",11,118,-107
"719","00715L期街口布蘭特正2","110/09/10","元大-花蓮",205,1,204
"720","00715L期街口布蘭特正2","110/09/10","台新證券",56,157,-101
"721","8941關中","110/09/10","國泰-忠孝",1,0,1
"722","8941關中","110/09/10","元大-華山",0,1,-1
"723","8941關中","110/09/10","新光-台中",0,0,0
"724","8941關中","110/09/10","新光-台中",0,0,0
"725","8941關中","110/09/10","元大-鹿港",0,0,0
"726","8941關中","110/09/10","元大-鹿港",0,0,0
"727","8941關中","110/09/10","永豐金-南投",0,0,0
"728","8941關中","110/09/10","永豐金-南投",0,0,0
"729","8941關中","110/09/10","",NA,NA,NA
"730","8941關中","110/09/10","",NA,NA,NA
"731","8941關中","110/09/10","",NA,NA,NA
"732","8941關中","110/09/10","",NA,NA,NA
"733","8941關中","110/09/10","",NA,NA,NA
"734","8941關中","110/09/10","",NA,NA,NA
"735","8941關中","110/09/10","",NA,NA,NA
"736","8941關中","110/09/10","",NA,NA,NA
"737","8941關中","110/09/10","",NA,NA,NA
"738","8941關中","110/09/10","",NA,NA,NA
"739","8941關中","110/09/10","",NA,NA,NA
"740","8941關中","110/09/10","",NA,NA,NA
"741","8941關中","110/09/10","",NA,NA,NA
"742","8941關中","110/09/10","",NA,NA,NA
"743","8941關中","110/09/10","",NA,NA,NA
"744","8941關中","110/09/10","",NA,NA,NA
"745","8941關中","110/09/10","",NA,NA,NA
"746","8941關中","110/09/10","",NA,NA,NA
"747","8941關中","110/09/10","",NA,NA,NA
"748","8941關中","110/09/10","",NA,NA,NA
"749","8941關中","110/09/10","",NA,NA,NA
"750","8941關中","110/09/10","",NA,NA,NA
"751","8936國統","110/09/10","凱基-台北",169,54,115
"752","8936國統","110/09/10","美林",0,110,-110
"753","8936國統","110/09/10","美商高盛",87,4,83
"754","8936國統","110/09/10","永豐金-高雄",0,100,-100
"755","8936國統","110/09/10","台新-高雄",91,10,81
"756","8936國統","110/09/10","康和-嘉義",4,100,-96
"757","8936國統","110/09/10","新加坡商瑞銀",87,13,74
"758","8936國統","110/09/10","凱基-高美館",6,55,-49
"759","8936國統","110/09/10","摩根大通",81,24,57
"760","8936國統","110/09/10","台灣摩根士丹利",0,48,-48
"761","8936國統","110/09/10","港商法國興業",39,0,39
"762","8936國統","110/09/10","永豐金-忠孝",0,37,-37
"763","8936國統","110/09/10","兆豐-三民",33,0,33
"764","8936國統","110/09/10","台新-松江",26,60,-34
"765","8936國統","110/09/10","港商野村",49,18,31
"766","8936國統","110/09/10","統一-新台中",0,24,-24
"767","8936國統","110/09/10","日盛-北高雄",25,0,25
"768","8936國統","110/09/10","兆豐-三重",0,23,-23
"769","8936國統","110/09/10","光和",20,0,20
"770","8936國統","110/09/10","玉山-台南",0,12,-12
"771","8936國統","110/09/10","華南永昌",19,0,19
"772","8936國統","110/09/10","國泰-敦南",2,14,-12
"773","8936國統","110/09/10","永豐金-苓雅",19,0,19
"774","8936國統","110/09/10","台灣企銀-太平",0,11,-11
"775","8936國統","110/09/10","元富-古亭",19,1,18
"776","8936國統","110/09/10","日盛-龍潭",0,10,-10
"777","8936國統","110/09/10","富邦-羅東",12,0,12
"778","8936國統","110/09/10","國票-九鼎",5,15,-10
"779","8936國統","110/09/10","群益金鼎-古亭",16,5,11
"780","8936國統","110/09/10","華南永昌-高雄",2,12,-10
"781","6226光鼎","110/09/10","群益金鼎-東大",76,1,75
"782","6226光鼎","110/09/10","摩根大通",20,145,-125
"783","6226光鼎","110/09/10","港商法國興業",42,0,42
"784","6226光鼎","110/09/10","美林",98,150,-52
"785","6226光鼎","110/09/10","港商野村",87,52,35
"786","6226光鼎","110/09/10","群益金鼎-開元",20,62,-42
"787","6226光鼎","110/09/10","新百王",26,2,24
"788","6226光鼎","110/09/10","台灣摩根士丹利",6,42,-36
"789","6226光鼎","110/09/10","美商高盛",92,71,21
"790","6226光鼎","110/09/10","瑞士信貸",0,29,-29
"791","6226光鼎","110/09/10","日盛-中和",20,0,20
"792","6226光鼎","110/09/10","台新-台中",27,55,-28
"793","6226光鼎","110/09/10","國票-南崁",20,0,20
"794","6226光鼎","110/09/10","新加坡商瑞銀",15,42,-27
"795","6226光鼎","110/09/10","第一金-華江",22,3,19
"796","6226光鼎","110/09/10","群益金鼎-三民",1,26,-25
"797","6226光鼎","110/09/10","華南永昌-鶯歌",20,1,19
"798","6226光鼎","110/09/10","凱基-中港",34,57,-23
"799","6226光鼎","110/09/10","元大-花蓮",16,0,16
"800","6226光鼎","110/09/10","群益金鼎-南京",0,20,-20
"801","6226光鼎","110/09/10","新光",15,0,15
"802","6226光鼎","110/09/10","元大-鑫永和",0,20,-20
"803","6226光鼎","110/09/10","華南永昌-台中",17,3,14
"804","6226光鼎","110/09/10","新光-新竹",7,26,-19
"805","6226光鼎","110/09/10","富邦-新竹",15,1,14
"806","6226光鼎","110/09/10","群益金鼎-中壢",1,20,-19
"807","6226光鼎","110/09/10","(牛牛牛)亞-鑫豐",18,5,13
"808","6226光鼎","110/09/10","統一-三重",0,16,-16
"809","6226光鼎","110/09/10","永豐金-竹北",12,0,12
"810","6226光鼎","110/09/10","元大-天母",0,16,-16
"811","2363矽統","110/09/10","凱基-台北",1380,1074,306
"812","2363矽統","110/09/10","瑞士信貸",391,1735,-1344
"813","2363矽統","110/09/10","元大-前金",282,50,232
"814","2363矽統","110/09/10","合庫-台中",40,461,-421
"815","2363矽統","110/09/10","兆豐-南京",159,7,152
"816","2363矽統","110/09/10","新加坡商瑞銀",550,937,-387
"817","2363矽統","110/09/10","永豐金-竹科",185,34,151
"818","2363矽統","110/09/10","兆豐-三民",47,306,-259
"819","2363矽統","110/09/10","新光",490,348,142
"820","2363矽統","110/09/10","國票-博愛",100,328,-228
"821","2363矽統","110/09/10","元大-基隆孝二",183,63,120
"822","2363矽統","110/09/10","美商高盛",304,524,-220
"823","2363矽統","110/09/10","元大-敦化",124,10,114
"824","2363矽統","110/09/10","土銀-台中",5,192,-187
"825","2363矽統","110/09/10","富邦-台南",130,20,110
"826","2363矽統","110/09/10","台灣摩根士丹利",28,191,-163
"827","2363矽統","110/09/10","臺灣企銀-埔墘",105,0,105
"828","2363矽統","110/09/10","台灣企銀-台中",20,182,-162
"829","2363矽統","110/09/10","元大證券",502,399,103
"830","2363矽統","110/09/10","元富-永和",28,177,-149
"831","2363矽統","110/09/10","富邦-新店",151,54,97
"832","2363矽統","110/09/10","元大-古亭",30,174,-144
"833","2363矽統","110/09/10","臺銀",117,24,93
"834","2363矽統","110/09/10","永豐金證券",43,155,-112
"835","2363矽統","110/09/10","玉山-新莊",129,39,90
"836","2363矽統","110/09/10","統一",466,572,-106
"837","2363矽統","110/09/10","元大-桃興",160,72,88
"838","2363矽統","110/09/10","群益金鼎-西松",18,122,-104
"839","2363矽統","110/09/10","兆豐-桃園",115,29,86
"840","2363矽統","110/09/10","富邦-虎尾",22,122,-100
"841","8112至上","110/09/10","摩根大通",1259,48,1211
"842","8112至上","110/09/10","永豐金-內湖",2,287,-285
"843","8112至上","110/09/10","凱基-台北",1211,469,742
"844","8112至上","110/09/10","元大-信義",12,256,-244
"845","8112至上","110/09/10","美商高盛",662,18,644
"846","8112至上","110/09/10","群益金鼎-屏東",7,190,-183
"847","8112至上","110/09/10","美林",714,260,454
"848","8112至上","110/09/10","元大-北屯",4,151,-147
"849","8112至上","110/09/10","台灣摩根士丹利",449,1,448
"850","8112至上","110/09/10","台中銀",6,143,-137
"851","8112至上","110/09/10","日盛-新竹",341,14,327
"852","8112至上","110/09/10","大慶",4,134,-130
"853","8112至上","110/09/10","富邦-中壢",304,16,288
"854","8112至上","110/09/10","台新-台中",13,139,-126
"855","8112至上","110/09/10","瑞士信貸",225,0,225
"856","8112至上","110/09/10","富邦-仁愛",28,148,-120
"857","8112至上","110/09/10","群益金鼎",110,0,110
"858","8112至上","110/09/10","元大-西門",16,122,-106
"859","8112至上","110/09/10","華南永昌",110,6,104
"860","8112至上","110/09/10","陽信",0,100,-100
"861","8112至上","110/09/10","元大-南投",93,15,78
"862","8112至上","110/09/10","台新證券",46,136,-90
"863","8112至上","110/09/10","華南永昌-淡水",71,2,69
"864","8112至上","110/09/10","元富-信義",0,83,-83
"865","8112至上","110/09/10","凱基-新莊",68,0,68
"866","8112至上","110/09/10","元大-佳里",1,78,-77
"867","8112至上","110/09/10","元富-城東",80,17,63
"868","8112至上","110/09/10","統一-新竹",0,74,-74
"869","8112至上","110/09/10","合庫-台南",58,9,49
"870","8112至上","110/09/10","群益金鼎-丹鳳",0,73,-73
"871","2929淘帝","110/09/10","新加坡商瑞銀",48,1,47
"872","2929淘帝","110/09/10","富邦-南屯",0,30,-30
"873","2929淘帝","110/09/10","摩根大通",47,1,46
"874","2929淘帝","110/09/10","玉山-大里",0,23,-23
"875","2929淘帝","110/09/10","美商高盛",32,0,32
"876","2929淘帝","110/09/10","元大-新竹經國",0,13,-13
"877","2929淘帝","110/09/10","凱基-台北",17,2,15
"878","2929淘帝","110/09/10","元富-大裕",0,12,-12
"879","2929淘帝","110/09/10","元大-中壢",15,0,15
"880","2929淘帝","110/09/10","富邦-嘉義",0,11,-11
"881","2929淘帝","110/09/10","豐農",10,0,10
"882","2929淘帝","110/09/10","永興",0,10,-10
"883","2929淘帝","110/09/10","凱基-五股",10,0,10
"884","2929淘帝","110/09/10","永豐金-博愛",0,10,-10
"885","2929淘帝","110/09/10","港商野村",12,4,8
"886","2929淘帝","110/09/10","日盛-雙和",0,7,-7
"887","2929淘帝","110/09/10","元富-板橋",7,0,7
"888","2929淘帝","110/09/10","華南永昌-竹北",0,7,-7
"889","2929淘帝","110/09/10","臺銀-臺南",10,5,5
"890","2929淘帝","110/09/10","新光-台中",6,12,-6
"891","2929淘帝","110/09/10","元大-羅東",5,0,5
"892","2929淘帝","110/09/10","元大-竹科",0,6,-6
"893","2929淘帝","110/09/10","光和-花壇",4,0,4
"894","2929淘帝","110/09/10","台新證券",0,5,-5
"895","2929淘帝","110/09/10","國票-敦北法人",6,3,3
"896","2929淘帝","110/09/10","永豐金-敦南",0,5,-5
"897","2929淘帝","110/09/10","彰銀",3,1,2
"898","2929淘帝","110/09/10","陽信-石牌",0,4,-4
"899","2929淘帝","110/09/10","美林",10,8,2
"900","2929淘帝","110/09/10","群益金鼎-潭子",0,4,-4
"901","5410國眾","110/09/10","凱基-台北",15,0,15
"902","5410國眾","110/09/10","國泰-敦南",3,17,-14
"903","5410國眾","110/09/10","臺銀",10,0,10
"904","5410國眾","110/09/10","國票-桃園",0,8,-8
"905","5410國眾","110/09/10","元大-東蘆",10,0,10
"906","5410國眾","110/09/10","元大-崇德",0,8,-8
"907","5410國眾","110/09/10","臺銀-高雄",5,0,5
"908","5410國眾","110/09/10","元大-草屯",0,8,-8
"909","5410國眾","110/09/10","台新-新莊",5,0,5
"910","5410國眾","110/09/10","元富-嘉義",0,5,-5
"911","5410國眾","110/09/10","華南永昌-林口",5,0,5
"912","5410國眾","110/09/10","永豐金-板新",0,4,-4
"913","5410國眾","110/09/10","元大-中壢",3,0,3
"914","5410國眾","110/09/10","永豐金-羅東",0,3,-3
"915","5410國眾","110/09/10","臺銀-金山",2,0,2
"916","5410國眾","110/09/10","永豐金-中盛",0,3,-3
"917","5410國眾","110/09/10","元富-桃園",2,0,2
"918","5410國眾","110/09/10","臺銀-新竹",0,2,-2
"919","5410國眾","110/09/10","兆豐-麻豆",2,0,2
"920","5410國眾","110/09/10","台新-三民",0,2,-2
"921","5410國眾","110/09/10","合庫-台中",1,0,1
"922","5410國眾","110/09/10","凱基-桃園",0,2,-2
"923","5410國眾","110/09/10","兆豐-嘉義",1,0,1
"924","5410國眾","110/09/10","凱基-松山",0,2,-2
"925","5410國眾","110/09/10","國泰-台南",1,0,1
"926","5410國眾","110/09/10","永豐金證券",0,2,-2
"927","5410國眾","110/09/10","國泰-板橋",1,0,1
"928","5410國眾","110/09/10","永豐金-信義",0,2,-2
"929","5410國眾","110/09/10","凱基-站前",1,0,1
"930","5410國眾","110/09/10","元大-左營",0,1,-1
"931","2841台開","110/09/10","玉山-新竹",50,0,50
"932","2841台開","110/09/10","元富-四維",0,30,-30
"933","2841台開","110/09/10","永豐金-敦南",65,23,42
"934","2841台開","110/09/10","台灣企銀-岡山",0,25,-25
"935","2841台開","110/09/10","群益金鼎-彰化",21,0,21
"936","2841台開","110/09/10","元富-三重",0,20,-20
"937","2841台開","110/09/10","宏遠-館前",20,0,20
"938","2841台開","110/09/10","日茂-南投",0,20,-20
"939","2841台開","110/09/10","第一金-台中",14,0,14
"940","2841台開","110/09/10","元大-內湖",0,20,-20
"941","2841台開","110/09/10","台中銀",10,0,10
"942","2841台開","110/09/10","新加坡商瑞銀",0,15,-15
"943","2841台開","110/09/10","玉山證券",10,0,10
"944","2841台開","110/09/10","台灣企銀-太平",0,12,-12
"945","2841台開","110/09/10","富邦-仁愛",10,0,10
"946","2841台開","110/09/10","日盛證券",13,23,-10
"947","2841台開","110/09/10","元大-桃園",10,0,10
"948","2841台開","110/09/10","第一金-路竹",0,10,-10
"949","2841台開","110/09/10","統一-新竹",9,0,9
"950","2841台開","110/09/10","玉山-嘉義",0,10,-10
"951","2841台開","110/09/10","國泰-敦南",9,0,9
"952","2841台開","110/09/10","富邦-彰化",0,10,-10
"953","2841台開","110/09/10","康和-台北",8,0,8
"954","2841台開","110/09/10","元大-忠孝",0,10,-10
"955","2841台開","110/09/10","兆豐證券",6,0,6
"956","2841台開","110/09/10","國泰-館前",2,9,-7
"957","2841台開","110/09/10","元大-板橋",6,0,6
"958","2841台開","110/09/10","永豐金證券",0,7,-7
"959","2841台開","110/09/10","玉山-士林",5,0,5
"960","2841台開","110/09/10","合庫-台南",0,6,-6
"961","6207雷科","110/09/10","凱基-嘉義",12,0,12
"962","6207雷科","110/09/10","群益金鼎-丹鳳",0,30,-30
"963","6207雷科","110/09/10","統一-敦南",10,0,10
"964","6207雷科","110/09/10","富邦-中壢",0,12,-12
"965","6207雷科","110/09/10","凱基-中山",10,0,10
"966","6207雷科","110/09/10","凱基-大安",0,10,-10
"967","6207雷科","110/09/10","中國信託-高雄",8,0,8
"968","6207雷科","110/09/10","新加坡商瑞銀",7,15,-8
"969","6207雷科","110/09/10","永豐金-忠孝",8,0,8
"970","6207雷科","110/09/10","日盛-中壢",0,7,-7
"971","6207雷科","110/09/10","兆豐-嘉義",7,0,7
"972","6207雷科","110/09/10","港商野村",0,6,-6
"973","6207雷科","110/09/10","玉山-台大",7,0,7
"974","6207雷科","110/09/10","臺銀-臺中",0,5,-5
"975","6207雷科","110/09/10","群益金鼎-土城",7,0,7
"976","6207雷科","110/09/10","第一金-彰化",0,5,-5
"977","6207雷科","110/09/10","富邦-新竹",6,0,6
"978","6207雷科","110/09/10","統一",0,5,-5
"979","6207雷科","110/09/10","兆豐-新營",5,0,5
"980","6207雷科","110/09/10","凱基-高美館",0,5,-5
"981","6207雷科","110/09/10","新光",5,0,5
"982","6207雷科","110/09/10","華南永昌",0,5,-5
"983","6207雷科","110/09/10","國泰-敦南",5,0,5
"984","6207雷科","110/09/10","元大-彰化",0,5,-5
"985","6207雷科","110/09/10","日盛-員林",4,0,4
"986","6207雷科","110/09/10","元大-北成功",0,5,-5
"987","6207雷科","110/09/10","元富-新興",4,0,4
"988","6207雷科","110/09/10","元大-西門",0,4,-4
"989","6207雷科","110/09/10","台新-高雄",4,0,4
"990","6207雷科","110/09/10","美商高盛",2,5,-3
"991","3679新至陞","110/09/10","日盛-八德",5,0,5
"992","3679新至陞","110/09/10","中國信託-新竹",0,3,-3
"993","3679新至陞","110/09/10","凱基-台北",4,0,4
"994","3679新至陞","110/09/10","瑞士信貸",3,5,-2
"995","3679新至陞","110/09/10","元富-花蓮",3,0,3
"996","3679新至陞","110/09/10","大昌",0,2,-2
"997","3679新至陞","110/09/10","元大-大統",3,0,3
"998","3679新至陞","110/09/10","摩根大通",0,2,-2
"999","3679新至陞","110/09/10","日盛-樹林",2,0,2
"1000","3679新至陞","110/09/10","新光-高雄",0,2,-2
"1001","3679新至陞","110/09/10","日盛-文化",2,0,2
"1002","3679新至陞","110/09/10","群益金鼎-東湖",0,2,-2
"1003","3679新至陞","110/09/10","玉山-士林",2,0,2
"1004","3679新至陞","110/09/10","富邦-新店",0,2,-2
"1005","3679新至陞","110/09/10","美林",2,1,1
"1006","3679新至陞","110/09/10","富邦-員林",0,2,-2
"1007","3679新至陞","110/09/10","美商高盛",1,0,1
"1008","3679新至陞","110/09/10","元大-成功",0,2,-2
"1009","3679新至陞","110/09/10","港商野村",1,0,1
"1010","3679新至陞","110/09/10","永豐金-鳳山",0,2,-2
"1011","3679新至陞","110/09/10","統一-新竹",1,0,1
"1012","3679新至陞","110/09/10","日盛-士林",0,1,-1
"1013","3679新至陞","110/09/10","元富-草屯",1,0,1
"1014","3679新至陞","110/09/10","日盛-花蓮",0,1,-1
"1015","3679新至陞","110/09/10","台新證券",1,0,1
"1016","3679新至陞","110/09/10","台灣摩根士丹利",0,1,-1
"1017","3679新至陞","110/09/10","玉山-台中",1,0,1
"1018","3679新至陞","110/09/10","台中銀-員林",0,1,-1
"1019","3679新至陞","110/09/10","凱基-長庚",1,0,1
"1020","3679新至陞","110/09/10","元大證券",1,2,-1
"1021","2727王品","110/09/10","美林",44,3,41
"1022","2727王品","110/09/10","香港上海匯豐",0,50,-50
"1023","2727王品","110/09/10","台灣摩根士丹利",41,6,35
"1024","2727王品","110/09/10","摩根大通",19,40,-21
"1025","2727王品","110/09/10","台新證券",29,3,26
"1026","2727王品","110/09/10","新加坡商瑞銀",11,28,-17
"1027","2727王品","110/09/10","富邦-南屯",20,0,20
"1028","2727王品","110/09/10","國泰證券",1,17,-16
"1029","2727王品","110/09/10","永豐金-中和",17,0,17
"1030","2727王品","110/09/10","凱基-台北",43,59,-16
"1031","2727王品","110/09/10","港商野村",50,38,12
"1032","2727王品","110/09/10","元大-桃園",1,17,-16
"1033","2727王品","110/09/10","日盛-景美",11,1,10
"1034","2727王品","110/09/10","亞東",3,18,-15
"1035","2727王品","110/09/10","瑞士信貸",15,6,9
"1036","2727王品","110/09/10","國泰-台中",3,18,-15
"1037","2727王品","110/09/10","統一",12,5,7
"1038","2727王品","110/09/10","日盛-南京",6,20,-14
"1039","2727王品","110/09/10","元富-城東",11,4,7
"1040","2727王品","110/09/10","凱基-竹科",0,11,-11
"1041","2727王品","110/09/10","華南永昌-彰化",8,1,7
"1042","2727王品","110/09/10","新光",8,16,-8
"1043","2727王品","110/09/10","康和",6,0,6
"1044","2727王品","110/09/10","元大-中壢",2,10,-8
"1045","2727王品","110/09/10","凱基-中壢",7,1,6
"1046","2727王品","110/09/10","元富-桃園",0,6,-6
"1047","2727王品","110/09/10","玉山-台中",5,0,5
"1048","2727王品","110/09/10","國泰-高雄",6,12,-6
"1049","2727王品","110/09/10","富邦-新店",5,0,5
"1050","2727王品","110/09/10","凱基-高美館",2,8,-6
"1051","1570力肯","110/09/10","富邦-建國",56,0,56
"1052","1570力肯","110/09/10","群益金鼎-高雄",0,47,-47
"1053","1570力肯","110/09/10","永全-南崁",38,0,38
"1054","1570力肯","110/09/10","永豐金-苓雅",0,20,-20
"1055","1570力肯","110/09/10","陽信",21,0,21
"1056","1570力肯","110/09/10","凱基-天母",0,17,-17
"1057","1570力肯","110/09/10","國泰-台南",20,0,20
"1058","1570力肯","110/09/10","永豐金-北高雄",0,15,-15
"1059","1570力肯","110/09/10","台中銀-員林",16,0,16
"1060","1570力肯","110/09/10","美林",0,14,-14
"1061","1570力肯","110/09/10","新光",20,5,15
"1062","1570力肯","110/09/10","凱基-台北",10,23,-13
"1063","1570力肯","110/09/10","富邦-花蓮",14,0,14
"1064","1570力肯","110/09/10","永豐金-桃園",0,11,-11
"1065","1570力肯","110/09/10","摩根大通",13,0,13
"1066","1570力肯","110/09/10","元富-新興",0,10,-10
"1067","1570力肯","110/09/10","富邦-北港",12,0,12
"1068","1570力肯","110/09/10","兆豐-天母",0,10,-10
"1069","1570力肯","110/09/10","臺銀-鳳山",8,0,8
"1070","1570力肯","110/09/10","元大-民雄",0,9,-9
"1071","1570力肯","110/09/10","日茂-埔里",8,0,8
"1072","1570力肯","110/09/10","元富-緯城",0,8,-8
"1073","1570力肯","110/09/10","國票-和平",9,1,8
"1074","1570力肯","110/09/10","國票",2,10,-8
"1075","1570力肯","110/09/10","玉山-新竹",8,0,8
"1076","1570力肯","110/09/10","元大-龍潭",0,8,-8
"1077","1570力肯","110/09/10","台新證券",38,31,7
"1078","1570力肯","110/09/10","元大-高雄",0,8,-8
"1079","1570力肯","110/09/10","富邦-新竹",7,0,7
"1080","1570力肯","110/09/10","大慶-蘆洲",0,6,-6
"1081","6180橘子","110/09/10","國泰-板橋",24,0,24
"1082","6180橘子","110/09/10","美商高盛",0,44,-44
"1083","6180橘子","110/09/10","合庫-自強",15,0,15
"1084","6180橘子","110/09/10","群益金鼎-永和",0,26,-26
"1085","6180橘子","110/09/10","富邦-竹東",11,0,11
"1086","6180橘子","110/09/10","兆豐-埔墘",0,20,-20
"1087","6180橘子","110/09/10","凱基-桃園",10,0,10
"1088","6180橘子","110/09/10","元大證券",2,22,-20
"1089","6180橘子","110/09/10","凱基-興隆",10,0,10
"1090","6180橘子","110/09/10","新加坡商瑞銀",0,18,-18
"1091","6180橘子","110/09/10","元富-新興",6,0,6
"1092","6180橘子","110/09/10","凱基-士林",0,18,-18
"1093","6180橘子","110/09/10","群益金鼎-西松",6,0,6
"1094","6180橘子","110/09/10","摩根大通",22,35,-13
"1095","6180橘子","110/09/10","凱基-新豐",6,0,6
"1096","6180橘子","110/09/10","國票-北高雄",0,10,-10
"1097","6180橘子","110/09/10","臺銀-民權",5,0,5
"1098","6180橘子","110/09/10","凱基-台北",22,32,-10
"1099","6180橘子","110/09/10","統一-汐止",5,0,5
"1100","6180橘子","110/09/10","(牛牛牛)亞證券",1,10,-9
"1101","6180橘子","110/09/10","新光",14,9,5
"1102","6180橘子","110/09/10","元大-仁愛",0,9,-9
"1103","6180橘子","110/09/10","群益金鼎-中港",5,0,5
"1104","6180橘子","110/09/10","凱基-高雄",0,7,-7
"1105","6180橘子","110/09/10","凱基-長庚",5,0,5
"1106","6180橘子","110/09/10","土銀-彰化",0,5,-5
"1107","6180橘子","110/09/10","華南永昌-新莊",5,0,5
"1108","6180橘子","110/09/10","新光-桃園",1,6,-5
"1109","6180橘子","110/09/10","永豐金-南京",5,0,5
"1110","6180橘子","110/09/10","高橋",0,4,-4
"1111","2390云辰","110/09/10","美林",243,13,230
"1112","2390云辰","110/09/10","新加坡商瑞銀",0,77,-77
"1113","2390云辰","110/09/10","美商高盛",97,32,65
"1114","2390云辰","110/09/10","台新-台中",2,50,-48
"1115","2390云辰","110/09/10","國票-中和",60,0,60
"1116","2390云辰","110/09/10","元大證券",1,31,-30
"1117","2390云辰","110/09/10","凱基-台北",121,71,50
"1118","2390云辰","110/09/10","元大-內湖",3,33,-30
"1119","2390云辰","110/09/10","元大-松江",50,0,50
"1120","2390云辰","110/09/10","新光",7,30,-23
"1121","2390云辰","110/09/10","元大-館前",54,24,30
"1122","2390云辰","110/09/10","元大-土城學府",84,107,-23
"1123","2390云辰","110/09/10","日盛-二林",20,0,20
"1124","2390云辰","110/09/10","統一-士林",0,21,-21
"1125","2390云辰","110/09/10","元大-永和",20,1,19
"1126","2390云辰","110/09/10","富邦-宜蘭",0,20,-20
"1127","2390云辰","110/09/10","日盛-八德",17,0,17
"1128","2390云辰","110/09/10","康和-台中",0,14,-14
"1129","2390云辰","110/09/10","台灣摩根士丹利",16,0,16
"1130","2390云辰","110/09/10","國票-北高雄",0,11,-11
"1131","2390云辰","110/09/10","摩根大通",81,67,14
"1132","2390云辰","110/09/10","元大-沙鹿",2,13,-11
"1133","2390云辰","110/09/10","宏遠-高雄",12,0,12
"1134","2390云辰","110/09/10","日盛-頭份",0,10,-10
"1135","2390云辰","110/09/10","凱基-和平",10,0,10
"1136","2390云辰","110/09/10","宏遠-台南",0,10,-10
"1137","2390云辰","110/09/10","元大-頭份",10,0,10
"1138","2390云辰","110/09/10","高橋-內壢",0,10,-10
"1139","2390云辰","110/09/10","群益金鼎-基隆",10,2,8
"1140","2390云辰","110/09/10","元富-大昌",0,10,-10
"1141","1309台達化","110/09/09","美林",154,26,128
"1142","1309台達化","110/09/09","兆豐證券",0,169,-169
"1143","1309台達化","110/09/09","元大-東港",33,0,33
"1144","1309台達化","110/09/09","元大證券",4,110,-106
"1145","1309台達化","110/09/09","元大-竹山",30,2,28
"1146","1309台達化","110/09/09","台灣摩根士丹利",0,63,-63
"1147","1309台達化","110/09/09","元富-緯城",21,0,21
"1148","1309台達化","110/09/09","凱基-松山",0,42,-42
"1149","1309台達化","110/09/09","兆豐-台南",20,1,19
"1150","1309台達化","110/09/09","新光",4,29,-25
"1151","1309台達化","110/09/09","台新-左楠",17,0,17
"1152","1309台達化","110/09/09","台灣企銀",0,23,-23
"1153","1309台達化","110/09/09","瑞士信貸",22,7,15
"1154","1309台達化","110/09/09","康和-台北",0,20,-20
"1155","1309台達化","110/09/09","凱基-台北",87,73,14
"1156","1309台達化","110/09/09","凱基-南崁",0,20,-20
"1157","1309台達化","110/09/09","群益金鼎-天母",12,0,12
"1158","1309台達化","110/09/09","元富-大昌",0,15,-15
"1159","1309台達化","110/09/09","元大-沙鹿",12,0,12
"1160","1309台達化","110/09/09","國票-中港",1,15,-14
"1161","1309台達化","110/09/09","合庫證券",11,0,11
"1162","1309台達化","110/09/09","中國信託-高雄",0,13,-13
"1163","1309台達化","110/09/09","元富-台南",10,0,10
"1164","1309台達化","110/09/09","兆豐-岡山",0,12,-12
"1165","1309台達化","110/09/09","康和-石牌",10,0,10
"1166","1309台達化","110/09/09","富邦-仁愛",9,21,-12
"1167","1309台達化","110/09/09","群益金鼎-民權",10,0,10
"1168","1309台達化","110/09/09","元大-新盛",2,12,-10
"1169","1309台達化","110/09/09","元大-彰化民生",10,0,10
"1170","1309台達化","110/09/09","日盛證券",1,10,-9
"1171","1312國喬","110/09/09","土銀-南港",240,0,240
"1172","1312國喬","110/09/09","香港上海匯豐",0,554,-554
"1173","1312國喬","110/09/09","台新-中壢",200,0,200
"1174","1312國喬","110/09/09","永豐金證券",112,594,-482
"1175","1312國喬","110/09/09","凱基-台北",328,146,182
"1176","1312國喬","110/09/09","元大-豐原",0,360,-360
"1177","1312國喬","110/09/09","華南永昌-鳳山",170,0,170
"1178","1312國喬","110/09/09","元富-大裕",3,170,-167
"1179","1312國喬","110/09/09","元大-新莊",103,0,103
"1180","1312國喬","110/09/09","美林",13,138,-125
"1181","1312國喬","110/09/09","港商野村",138,62,76
"1182","1312國喬","110/09/09","台灣摩根士丹利",25,135,-110
"1183","1312國喬","110/09/09","台灣匯立證券",62,0,62
"1184","1312國喬","110/09/09","台新-松江",0,50,-50
"1185","1312國喬","110/09/09","摩根大通",149,96,53
"1186","1312國喬","110/09/09","永豐金-復興",0,50,-50
"1187","1312國喬","110/09/09","元富-緯城",50,0,50
"1188","1312國喬","110/09/09","瑞士信貸",0,44,-44
"1189","1312國喬","110/09/09","凱基-三重",52,4,48
"1190","1312國喬","110/09/09","富邦-桃園",2,40,-38
"1191","1312國喬","110/09/09","群益金鼎-民權",52,7,45
"1192","1312國喬","110/09/09","美商高盛",4,36,-32
"1193","1312國喬","110/09/09","日盛證券",40,0,40
"1194","1312國喬","110/09/09","元大-鳳中",0,24,-24
"1195","1312國喬","110/09/09","元大證券",92,53,39
"1196","1312國喬","110/09/09","元大-小港",6,30,-24
"1197","1312國喬","110/09/09","統一",38,0,38
"1198","1312國喬","110/09/09","台新證券",9,31,-22
"1199","1312國喬","110/09/09","凱基-宜蘭",38,0,38
"1200","1312國喬","110/09/09","元大-大安",0,22,-22
"1201","3702大聯大","110/09/09","美林",486,40,446
"1202","3702大聯大","110/09/09","富邦證券",0,500,-500
"1203","3702大聯大","110/09/09","台灣摩根士丹利",288,18,270
"1204","3702大聯大","110/09/09","美商高盛",96,385,-289
"1205","3702大聯大","110/09/09","摩根大通",386,147,239
"1206","3702大聯大","110/09/09","瑞士信貸",38,309,-271
"1207","3702大聯大","110/09/09","中國信託",129,0,129
"1208","3702大聯大","110/09/09","元大-向上",1,175,-174
"1209","3702大聯大","110/09/09","凱基-台南",100,0,100
"1210","3702大聯大","110/09/09","元富",27,200,-173
"1211","3702大聯大","110/09/09","凱基-台北",174,102,72
"1212","3702大聯大","110/09/09","新加坡商瑞銀",24,61,-37
"1213","3702大聯大","110/09/09","港商野村",39,7,32
"1214","3702大聯大","110/09/09","法銀巴黎",0,35,-35
"1215","3702大聯大","110/09/09","元大證券",43,12,31
"1216","3702大聯大","110/09/09","香港上海匯豐",16,47,-31
"1217","3702大聯大","110/09/09","兆豐-小港",25,0,25
"1218","3702大聯大","110/09/09","花旗環球",0,21,-21
"1219","3702大聯大","110/09/09","元大-西門",24,0,24
"1220","3702大聯大","110/09/09","元大-文心興安",0,17,-17
"1221","3702大聯大","110/09/09","元大-新莊",20,0,20
"1222","3702大聯大","110/09/09","日盛-和美",0,10,-10
"1223","3702大聯大","110/09/09","日盛-樹林",15,0,15
"1224","3702大聯大","110/09/09","凱基-和平",0,10,-10
"1225","3702大聯大","110/09/09","玉山-城中",13,0,13
"1226","3702大聯大","110/09/09","永豐金-板新",0,10,-10
"1227","3702大聯大","110/09/09","新光-高雄",14,3,11
"1228","3702大聯大","110/09/09","群益金鼎-土城",0,9,-9
"1229","3702大聯大","110/09/09","統一-內湖",10,0,10
"1230","3702大聯大","110/09/09","國泰-忠孝",0,8,-8
"1231","2417圓剛","110/09/09","新加坡商瑞銀",163,1,162
"1232","2417圓剛","110/09/09","凱基-台北",385,766,-381
"1233","2417圓剛","110/09/09","群益金鼎-新竹",153,24,129
"1234","2417圓剛","110/09/09","元大-中壢",212,561,-349
"1235","2417圓剛","110/09/09","花旗環球",122,2,120
"1236","2417圓剛","110/09/09","元富",3,344,-341
"1237","2417圓剛","110/09/09","華南永昌-林口",83,18,65
"1238","2417圓剛","110/09/09","元富-永和",2,244,-242
"1239","2417圓剛","110/09/09","元富-潮州",69,8,61
"1240","2417圓剛","110/09/09","台灣摩根士丹利",0,157,-157
"1241","2417圓剛","110/09/09","日盛-木柵",90,36,54
"1242","2417圓剛","110/09/09","美林",52,154,-102
"1243","2417圓剛","110/09/09","元大-花蓮",168,115,53
"1244","2417圓剛","110/09/09","美商高盛",46,141,-95
"1245","2417圓剛","110/09/09","台灣企銀",53,1,52
"1246","2417圓剛","110/09/09","永豐金證券",11,102,-91
"1247","2417圓剛","110/09/09","永豐金-豐原",54,2,52
"1248","2417圓剛","110/09/09","群益金鼎-台北",6,61,-55
"1249","2417圓剛","110/09/09","聯邦商銀",51,1,50
"1250","2417圓剛","110/09/09","統一-金門",1,50,-49
"1251","2417圓剛","110/09/09","元大-屏東民生",65,20,45
"1252","2417圓剛","110/09/09","凱基-內湖",3,50,-47
"1253","2417圓剛","110/09/09","群益金鼎-高雄",75,31,44
"1254","2417圓剛","110/09/09","日盛-士林",17,58,-41
"1255","2417圓剛","110/09/09","永豐金-嘉義",48,4,44
"1256","2417圓剛","110/09/09","台新-松江",45,83,-38
"1257","2417圓剛","110/09/09","華南永昌-台中",61,18,43
"1258","2417圓剛","110/09/09","統一-平鎮",2,39,-37
"1259","2417圓剛","110/09/09","合庫-彰化",46,4,42
"1260","2417圓剛","110/09/09","合庫-台中",2,38,-36
"1261","9919康那香","110/09/09","台新-台中",559,243,316
"1262","9919康那香","110/09/09","統一",201,890,-689
"1263","9919康那香","110/09/09","玉山證券",271,116,155
"1264","9919康那香","110/09/09","康和",265,811,-546
"1265","9919康那香","110/09/09","華南永昌-彰化",252,139,113
"1266","9919康那香","110/09/09","華南永昌-高雄",176,665,-489
"1267","9919康那香","110/09/09","元大-大甲",114,36,78
"1268","9919康那香","110/09/09","元大證券",188,542,-354
"1269","9919康那香","110/09/09","中國信託-松江",135,58,77
"1270","9919康那香","110/09/09","元富",18,356,-338
"1271","9919康那香","110/09/09","台新證券",721,647,74
"1272","9919康那香","110/09/09","日盛-三重",4,204,-200
"1273","9919康那香","110/09/09","凱基-中山",140,68,72
"1274","9919康那香","110/09/09","凱基-內湖",15,208,-193
"1275","9919康那香","110/09/09","富邦-竹北",137,66,71
"1276","9919康那香","110/09/09","永豐金證券",30,205,-175
"1277","9919康那香","110/09/09","國泰-板橋",243,177,66
"1278","9919康那香","110/09/09","國票-博愛",6,152,-146
"1279","9919康那香","110/09/09","永豐金-板盛",248,182,66
"1280","9919康那香","110/09/09","統一-三重",23,165,-142
"1281","9919康那香","110/09/09","臺銀-鳳山",110,45,65
"1282","9919康那香","110/09/09","華南永昌-南京",19,145,-126
"1283","9919康那香","110/09/09","凱基-台北",1979,1914,65
"1284","9919康那香","110/09/09","富邦-仁愛",173,299,-126
"1285","9919康那香","110/09/09","第一金-嘉義",68,4,64
"1286","9919康那香","110/09/09","富邦-高雄",146,261,-115
"1287","9919康那香","110/09/09","玉山-高雄",78,19,59
"1288","9919康那香","110/09/09","元大-新竹經國",27,120,-93
"1289","9919康那香","110/09/09","台新-高雄",239,181,58
"1290","9919康那香","110/09/09","凱基-信義",0,88,-88
"1291","2834臺企銀","110/09/09","聯邦-富強",1001,0,1001
"1292","2834臺企銀","110/09/09","國票-長城",8,5000,-4992
"1293","2834臺企銀","110/09/09","華南永昌",955,0,955
"1294","2834臺企銀","110/09/09","摩根大通",413,4338,-3925
"1295","2834臺企銀","110/09/09","凱基-台北",1237,441,796
"1296","2834臺企銀","110/09/09","新加坡商瑞銀",0,3657,-3657
"1297","2834臺企銀","110/09/09","玉山-台南",550,5,545
"1298","2834臺企銀","110/09/09","美商高盛",212,2967,-2755
"1299","2834臺企銀","110/09/09","玉山-新莊",538,4,534
"1300","2834臺企銀","110/09/09","瑞士信貸",310,2161,-1851
"1301","2834臺企銀","110/09/09","台新證券",467,14,453
"1302","2834臺企銀","110/09/09","台灣摩根士丹利",40,1367,-1327
"1303","2834臺企銀","110/09/09","元大-桃園",432,10,422
"1304","2834臺企銀","110/09/09","法銀巴黎",0,1028,-1028
"1305","2834臺企銀","110/09/09","元大-北投",421,0,421
"1306","2834臺企銀","110/09/09","美林",1145,1911,-766
"1307","2834臺企銀","110/09/09","元大-彰化",417,0,417
"1308","2834臺企銀","110/09/09","台灣企銀-豐原",32,702,-670
"1309","2834臺企銀","110/09/09","凱基-松山",415,0,415
"1310","2834臺企銀","110/09/09","花旗環球",80,546,-466
"1311","2834臺企銀","110/09/09","國泰-敦南",437,23,414
"1312","2834臺企銀","110/09/09","元富-板橋",36,300,-264
"1313","2834臺企銀","110/09/09","新光",406,33,373
"1314","2834臺企銀","110/09/09","永豐金-板盛",8,200,-192
"1315","2834臺企銀","110/09/09","光和",310,0,310
"1316","2834臺企銀","110/09/09","元大-花蓮",22,200,-178
"1317","2834臺企銀","110/09/09","永豐金-敦南",232,0,232
"1318","2834臺企銀","110/09/09","元大-左營",17,180,-163
"1319","2834臺企銀","110/09/09","中國信託-永康",227,0,227
"1320","2834臺企銀","110/09/09","群益金鼎-延平",19,172,-153
"1321","5511德昌","110/09/09","第一金-台中",5,0,5
"1322","5511德昌","110/09/09","凱基-員林",0,2,-2
"1323","5511德昌","110/09/09","永豐金-彰化",2,0,2
"1324","5511德昌","110/09/09","凱基-台北",0,2,-2
"1325","5511德昌","110/09/09","華南永昌-大安",0,0,0
"1326","5511德昌","110/09/09","元大-西螺",0,1,-1
"1327","5511德昌","110/09/09","元大-西門",0,0,0
"1328","5511德昌","110/09/09","元大-楊梅",0,1,-1
"1329","5511德昌","110/09/09","元大-斗信",0,0,0
"1330","5511德昌","110/09/09","永豐金-三重",0,1,-1
"1331","5511德昌","110/09/09","",NA,NA,NA
"1332","5511德昌","110/09/09","華南永昌-大安",0,0,0
"1333","5511德昌","110/09/09","",NA,NA,NA
"1334","5511德昌","110/09/09","元大-西門",0,0,0
"1335","5511德昌","110/09/09","",NA,NA,NA
"1336","5511德昌","110/09/09","元大-斗信",0,0,0
"1337","5511德昌","110/09/09","",NA,NA,NA
"1338","5511德昌","110/09/09","",NA,NA,NA
"1339","5511德昌","110/09/09","",NA,NA,NA
"1340","5511德昌","110/09/09","",NA,NA,NA
"1341","5511德昌","110/09/09","",NA,NA,NA
"1342","5511德昌","110/09/09","",NA,NA,NA
"1343","5511德昌","110/09/09","",NA,NA,NA
"1344","5511德昌","110/09/09","",NA,NA,NA
"1345","5511德昌","110/09/09","",NA,NA,NA
"1346","5511德昌","110/09/09","",NA,NA,NA
"1347","5511德昌","110/09/09","",NA,NA,NA
"1348","5511德昌","110/09/09","",NA,NA,NA
"1349","5511德昌","110/09/09","",NA,NA,NA
"1350","5511德昌","110/09/09","",NA,NA,NA
"1351","2489瑞軒","110/09/09","豐農",100,0,100
"1352","2489瑞軒","110/09/09","國泰-新莊",0,50,-50
"1353","2489瑞軒","110/09/09","港商野村",104,23,81
"1354","2489瑞軒","110/09/09","瑞士信貸",11,56,-45
"1355","2489瑞軒","110/09/09","美林",64,6,58
"1356","2489瑞軒","110/09/09","凱基-台北",99,130,-31
"1357","2489瑞軒","110/09/09","兆豐-西螺",50,0,50
"1358","2489瑞軒","110/09/09","合庫-台中",5,35,-30
"1359","2489瑞軒","110/09/09","元大-西螺",50,0,50
"1360","2489瑞軒","110/09/09","康和-台中",0,30,-30
"1361","2489瑞軒","110/09/09","摩根大通",52,19,33
"1362","2489瑞軒","110/09/09","光和-田中",0,27,-27
"1363","2489瑞軒","110/09/09","新加坡商瑞銀",57,27,30
"1364","2489瑞軒","110/09/09","合庫-台南",0,25,-25
"1365","2489瑞軒","110/09/09","康和-澎湖",22,0,22
"1366","2489瑞軒","110/09/09","富邦-竹東",1,26,-25
"1367","2489瑞軒","110/09/09","凱基-板橋",22,1,21
"1368","2489瑞軒","110/09/09","國泰-敦南",0,23,-23
"1369","2489瑞軒","110/09/09","元富-西松",20,0,20
"1370","2489瑞軒","110/09/09","玉山-台南",0,22,-22
"1371","2489瑞軒","110/09/09","兆豐-虎尾",20,0,20
"1372","2489瑞軒","110/09/09","元大-南京",0,21,-21
"1373","2489瑞軒","110/09/09","台灣摩根士丹利",26,7,19
"1374","2489瑞軒","110/09/09","土銀-南港",0,20,-20
"1375","2489瑞軒","110/09/09","統一-新竹",18,0,18
"1376","2489瑞軒","110/09/09","第一金-新興",0,20,-20
"1377","2489瑞軒","110/09/09","美商高盛",28,11,17
"1378","2489瑞軒","110/09/09","國票-北高雄",0,20,-20
"1379","2489瑞軒","110/09/09","國票-南港",20,5,15
"1380","2489瑞軒","110/09/09","元大-屏東",0,20,-20
"1381","2428興勤","110/09/09","摩根大通",51,7,44
"1382","2428興勤","110/09/09","國票-安和",1,38,-37
"1383","2428興勤","110/09/09","美商高盛",37,0,37
"1384","2428興勤","110/09/09","康和-石牌",0,10,-10
"1385","2428興勤","110/09/09","宏遠證券",21,1,20
"1386","2428興勤","110/09/09","永豐金證券",0,9,-9
"1387","2428興勤","110/09/09","台灣摩根士丹利",17,0,17
"1388","2428興勤","110/09/09","永豐金-信義",3,12,-9
"1389","2428興勤","110/09/09","美林",15,0,15
"1390","2428興勤","110/09/09","日盛-竹北",0,8,-8
"1391","2428興勤","110/09/09","元大-新竹",10,0,10
"1392","2428興勤","110/09/09","日盛-景美",0,7,-7
"1393","2428興勤","110/09/09","瑞士信貸",9,0,9
"1394","2428興勤","110/09/09","凱基-三重",0,7,-7
"1395","2428興勤","110/09/09","新加坡商瑞銀",20,13,7
"1396","2428興勤","110/09/09","新光",2,8,-6
"1397","2428興勤","110/09/09","港商野村",6,0,6
"1398","2428興勤","110/09/09","康和",0,5,-5
"1399","2428興勤","110/09/09","日盛-頭份",5,0,5
"1400","2428興勤","110/09/09","群益金鼎-古亭",0,5,-5
"1401","2428興勤","110/09/09","日盛-新竹",3,0,3
"1402","2428興勤","110/09/09","凱基-松山",0,5,-5
"1403","2428興勤","110/09/09","元大-鳳中",3,0,3
"1404","2428興勤","110/09/09","華南永昌",0,5,-5
"1405","2428興勤","110/09/09","合庫-鳳山",2,0,2
"1406","2428興勤","110/09/09","富邦-基隆",0,5,-5
"1407","2428興勤","110/09/09","日盛-忠孝",2,0,2
"1408","2428興勤","110/09/09","元大-旗山",0,5,-5
"1409","2428興勤","110/09/09","國泰-敦南",2,0,2
"1410","2428興勤","110/09/09","玉山-高雄",0,4,-4
"1411","3176基亞","110/09/09","元大-民雄",10,0,10
"1412","3176基亞","110/09/09","新光-台中",2,41,-39
"1413","3176基亞","110/09/09","宏遠-館前",7,0,7
"1414","3176基亞","110/09/09","群益金鼎-嘉義",0,18,-18
"1415","3176基亞","110/09/09","玉山-雙和",7,0,7
"1416","3176基亞","110/09/09","統一-土城",0,15,-15
"1417","3176基亞","110/09/09","日盛-永康",6,0,6
"1418","3176基亞","110/09/09","新加坡商瑞銀",0,14,-14
"1419","3176基亞","110/09/09","統一-三多",6,0,6
"1420","3176基亞","110/09/09","土銀-白河",0,10,-10
"1421","3176基亞","110/09/09","元富-高雄",5,0,5
"1422","3176基亞","110/09/09","宏遠-光隆",0,10,-10
"1423","3176基亞","110/09/09","光和-高雄",5,0,5
"1424","3176基亞","110/09/09","第一金-桃園",0,10,-10
"1425","3176基亞","110/09/09","台新-新營",5,0,5
"1426","3176基亞","110/09/09","富邦-仁愛",1,10,-9
"1427","3176基亞","110/09/09","華南永昌-敦南",5,0,5
"1428","3176基亞","110/09/09","元富-成功",0,8,-8
"1429","3176基亞","110/09/09","富邦-陽明",5,0,5
"1430","3176基亞","110/09/09","聯邦-富強",0,7,-7
"1431","3176基亞","110/09/09","富邦-虎尾",5,0,5
"1432","3176基亞","110/09/09","凱基-士林",0,7,-7
"1433","3176基亞","110/09/09","元大-大統",5,0,5
"1434","3176基亞","110/09/09","永豐金-竹科",0,6,-6
"1435","3176基亞","110/09/09","元大-永康",5,0,5
"1436","3176基亞","110/09/09","日盛-三峽",0,5,-5
"1437","3176基亞","110/09/09","永豐金-北高雄",5,0,5
"1438","3176基亞","110/09/09","元大-清水",0,5,-5
"1439","3176基亞","110/09/09","元富-三重",4,0,4
"1440","3176基亞","110/09/09","富邦-台東",0,4,-4
"1441","2409友達","110/09/09","(牛牛牛)亞證券",4435,0,4435
"1442","2409友達","110/09/09","美林",740,4129,-3389
"1443","2409友達","110/09/09","台灣匯立證券",3854,0,3854
"1444","2409友達","110/09/09","摩根大通",2819,4676,-1857
"1445","2409友達","110/09/09","新加坡商瑞銀",6902,4675,2227
"1446","2409友達","110/09/09","凱基-台北",1050,2714,-1664
"1447","2409友達","110/09/09","台灣摩根士丹利",3494,1687,1807
"1448","2409友達","110/09/09","瑞士信貸",106,1601,-1495
"1449","2409友達","110/09/09","福邦證券",1025,20,1005
"1450","2409友達","110/09/09","永豐金證券",29,1488,-1459
"1451","2409友達","110/09/09","日盛證券",1058,76,982
"1452","2409友達","110/09/09","花旗環球",11,959,-948
"1453","2409友達","110/09/09","玉山證券",606,145,461
"1454","2409友達","110/09/09","法銀巴黎",0,608,-608
"1455","2409友達","110/09/09","富邦-嘉義",453,89,364
"1456","2409友達","110/09/09","華南永昌-民權",5,509,-504
"1457","2409友達","110/09/09","中國信託-嘉義",358,5,353
"1458","2409友達","110/09/09","土銀-台南",13,503,-490
"1459","2409友達","110/09/09","群益金鼎-鳳山",371,29,342
"1460","2409友達","110/09/09","台新證券",258,656,-398
"1461","2409友達","110/09/09","國票-九鼎",587,265,322
"1462","2409友達","110/09/09","華南永昌-台中",5,396,-391
"1463","2409友達","110/09/09","國票-安和",513,219,294
"1464","2409友達","110/09/09","美商高盛",624,971,-347
"1465","2409友達","110/09/09","富邦-岡山",306,25,281
"1466","2409友達","110/09/09","國泰證券",8,351,-343
"1467","2409友達","110/09/09","凱基-基隆",403,144,259
"1468","2409友達","110/09/09","港商野村",2342,2633,-291
"1469","2409友達","110/09/09","新光-桃園",628,401,227
"1470","2409友達","110/09/09","元富-中原",81,316,-235
"1471","1315達新","110/09/09","永豐金-高雄",8,0,8
"1472","1315達新","110/09/09","美林",0,8,-8
"1473","1315達新","110/09/09","兆豐-台中",5,0,5
"1474","1315達新","110/09/09","永豐金證券",0,4,-4
"1475","1315達新","110/09/09","台灣摩根士丹利",4,0,4
"1476","1315達新","110/09/09","花旗環球",0,3,-3
"1477","1315達新","110/09/09","玉山-南京東路",2,0,2
"1478","1315達新","110/09/09","港商法國興業",0,2,-2
"1479","1315達新","110/09/09","華南永昌",2,0,2
"1480","1315達新","110/09/09","統一-城中",0,2,-2
"1481","1315達新","110/09/09","元大-斗信",1,0,1
"1482","1315達新","110/09/09","大慶-蘆洲",0,1,-1
"1483","1315達新","110/09/09","台新證券",1,0,1
"1484","1315達新","110/09/09","摩根大通",0,1,-1
"1485","1315達新","110/09/09","元大-板橋三民",1,0,1
"1486","1315達新","110/09/09","新光-台中",0,1,-1
"1487","1315達新","110/09/09","元大-文心興安",1,0,1
"1488","1315達新","110/09/09","玉山-大里",0,1,-1
"1489","1315達新","110/09/09","國泰-台中",0,0,0
"1490","1315達新","110/09/09","元大-林森",0,1,-1
"1491","1315達新","110/09/09","元大-古亭",0,0,0
"1492","1315達新","110/09/09","華南永昌-台中",0,1,-1
"1493","1315達新","110/09/09","元大-鳳中",0,0,0
"1494","1315達新","110/09/09","新光",0,0,0
"1495","1315達新","110/09/09","元大-花蓮",0,0,0
"1496","1315達新","110/09/09","元大-古亭",0,0,0
"1497","1315達新","110/09/09","元大-彰化",0,0,0
"1498","1315達新","110/09/09","元大-鳳中",0,0,0
"1499","1315達新","110/09/09","日盛-永康",0,0,0
"1500","1315達新","110/09/09","元大-花蓮",0,0,0
"1501","2609陽明","110/09/09","瑞士信貸",1936,258,1678
"1502","2609陽明","110/09/09","凱基-台北",1113,3762,-2649
"1503","2609陽明","110/09/09","台灣摩根士丹利",1657,101,1556
"1504","2609陽明","110/09/09","香港上海匯豐",0,2000,-2000
"1505","2609陽明","110/09/09","新加坡商瑞銀",1597,531,1066
"1506","2609陽明","110/09/09","兆豐-虎尾",6735,8557,-1822
"1507","2609陽明","110/09/09","美商高盛",1084,373,711
"1508","2609陽明","110/09/09","永豐金-信義",144,1229,-1085
"1509","2609陽明","110/09/09","富邦-仁愛",841,137,704
"1510","2609陽明","110/09/09","摩根大通",1536,2412,-876
"1511","2609陽明","110/09/09","元大-頭份",729,26,703
"1512","2609陽明","110/09/09","統一-仁愛",785,1403,-618
"1513","2609陽明","110/09/09","群益金鼎-大安",1281,673,608
"1514","2609陽明","110/09/09","元大證券",630,1194,-564
"1515","2609陽明","110/09/09","永豐金證券",504,59,445
"1516","2609陽明","110/09/09","兆豐-復興",23,404,-381
"1517","2609陽明","110/09/09","宏遠-館前",431,18,413
"1518","2609陽明","110/09/09","大慶",19,377,-358
"1519","2609陽明","110/09/09","元大-樹林",528,157,371
"1520","2609陽明","110/09/09","日盛-台中",36,388,-352
"1521","2609陽明","110/09/09","凱基-站前",384,61,323
"1522","2609陽明","110/09/09","富邦證券",2,309,-307
"1523","2609陽明","110/09/09","群益金鼎-內湖",288,67,221
"1524","2609陽明","110/09/09","大慶-富順",109,315,-206
"1525","2609陽明","110/09/09","國票-敦北法人",726,555,171
"1526","2609陽明","110/09/09","元大-士林",1070,1247,-177
"1527","2609陽明","110/09/09","新光-新竹",810,660,150
"1528","2609陽明","110/09/09","兆豐-寶成",44,215,-171
"1529","2609陽明","110/09/09","中國信託-三重",193,55,138
"1530","2609陽明","110/09/09","群益金鼎-古亭",85,243,-158
"1531","2636台驊投控","110/09/09","日盛-台中",372,2,370
"1532","2636台驊投控","110/09/09","瑞士信貸",140,466,-326
"1533","2636台驊投控","110/09/09","美商高盛",486,281,205
"1534","2636台驊投控","110/09/09","新光-新竹",32,254,-222
"1535","2636台驊投控","110/09/09","永豐金-萬盛",82,2,80
"1536","2636台驊投控","110/09/09","美林",271,398,-127
"1537","2636台驊投控","110/09/09","凱基-松山",61,1,60
"1538","2636台驊投控","110/09/09","摩根大通",241,310,-69
"1539","2636台驊投控","110/09/09","新加坡商瑞銀",77,18,59
"1540","2636台驊投控","110/09/09","玉山證券",13,46,-33
"1541","2636台驊投控","110/09/09","第一金-桃園",72,15,57
"1542","2636台驊投控","110/09/09","統一",71,102,-31
"1543","2636台驊投控","110/09/09","群益金鼎-民權",45,0,45
"1544","2636台驊投控","110/09/09","統一-仁愛",1,31,-30
"1545","2636台驊投控","110/09/09","元大-松山",47,3,44
"1546","2636台驊投控","110/09/09","兆豐-城中",5,29,-24
"1547","2636台驊投控","110/09/09","華南永昌-高雄",55,14,41
"1548","2636台驊投控","110/09/09","凱基-台南",8,31,-23
"1549","2636台驊投控","110/09/09","大慶-蘆洲",34,3,31
"1550","2636台驊投控","110/09/09","凱基-南崁",0,23,-23
"1551","2636台驊投控","110/09/09","康和",52,21,31
"1552","2636台驊投控","110/09/09","元大-樹林",1,23,-22
"1553","2636台驊投控","110/09/09","華南永昌-三重",33,2,31
"1554","2636台驊投控","110/09/09","兆豐-三民",4,25,-21
"1555","2636台驊投控","110/09/09","日盛-忠孝",31,1,30
"1556","2636台驊投控","110/09/09","富邦-板橋",5,26,-21
"1557","2636台驊投控","110/09/09","統一-南京",28,4,24
"1558","2636台驊投控","110/09/09","元大-向上",0,20,-20
"1559","2636台驊投控","110/09/09","港商野村",451,430,21
"1560","2636台驊投控","110/09/09","日盛-和美",13,32,-19
"1561","2867三商壽","110/09/09","新光",388,5,383
"1562","2867三商壽","110/09/09","元富-世貿",15,1594,-1579
"1563","2867三商壽","110/09/09","元大-沙鹿",363,0,363
"1564","2867三商壽","110/09/09","凱基-台北",179,510,-331
"1565","2867三商壽","110/09/09","元富-佳里",280,0,280
"1566","2867三商壽","110/09/09","摩根大通",4,241,-237
"1567","2867三商壽","110/09/09","瑞士信貸",127,0,127
"1568","2867三商壽","110/09/09","港商野村",3,166,-163
"1569","2867三商壽","110/09/09","統一-平鎮",100,0,100
"1570","2867三商壽","110/09/09","美商高盛",0,133,-133
"1571","2867三商壽","110/09/09","國票-台南",100,0,100
"1572","2867三商壽","110/09/09","美林",3,49,-46
"1573","2867三商壽","110/09/09","元大-新店中正",100,0,100
"1574","2867三商壽","110/09/09","元大-新竹",0,40,-40
"1575","2867三商壽","110/09/09","玉山-板橋",52,0,52
"1576","2867三商壽","110/09/09","花旗環球",0,37,-37
"1577","2867三商壽","110/09/09","永豐金-埔里",51,0,51
"1578","2867三商壽","110/09/09","宏遠-台中",1,32,-31
"1579","2867三商壽","110/09/09","日盛-頭份",50,0,50
"1580","2867三商壽","110/09/09","富邦-南屯",1,30,-29
"1581","2867三商壽","110/09/09","康和-台中",50,0,50
"1582","2867三商壽","110/09/09","港商法國興業",0,27,-27
"1583","2867三商壽","110/09/09","元大-北港",50,0,50
"1584","2867三商壽","110/09/09","台灣摩根士丹利",53,74,-21
"1585","2867三商壽","110/09/09","國票-南京",40,0,40
"1586","2867三商壽","110/09/09","群益金鼎-彰化",2,19,-17
"1587","2867三商壽","110/09/09","群益金鼎-開元",40,0,40
"1588","2867三商壽","110/09/09","日盛-樹林",2,16,-14
"1589","2867三商壽","110/09/09","富邦-新營",40,2,38
"1590","2867三商壽","110/09/09","元大證券",3,17,-14
"1591","5521工信","110/09/09","台新證券",216,2,214
"1592","5521工信","110/09/09","摩根大通",9,569,-560
"1593","5521工信","110/09/09","元大-三重",100,0,100
"1594","5521工信","110/09/09","華南永昌",15,210,-195
"1595","5521工信","110/09/09","華南永昌-東昇",55,0,55
"1596","5521工信","110/09/09","美商高盛",0,140,-140
"1597","5521工信","110/09/09","永豐金-中正",43,0,43
"1598","5521工信","110/09/09","元大證券",8,145,-137
"1599","5521工信","110/09/09","元大-新莊",41,0,41
"1600","5521工信","110/09/09","康和-澎湖",3,100,-97
"1601","5521工信","110/09/09","土銀-高雄",40,0,40
"1602","5521工信","110/09/09","瑞士信貸",0,83,-83
"1603","5521工信","110/09/09","華南永昌-古亭",40,0,40
"1604","5521工信","110/09/09","凱基-台北",25,99,-74
"1605","5521工信","110/09/09","華南永昌-苗栗",35,0,35
"1606","5521工信","110/09/09","元富",0,60,-60
"1607","5521工信","110/09/09","富邦-陽明",36,6,30
"1608","5521工信","110/09/09","富邦-板橋",0,60,-60
"1609","5521工信","110/09/09","玉山-雙和",29,0,29
"1610","5521工信","110/09/09","美林",80,117,-37
"1611","5521工信","110/09/09","凱基-斗六",28,0,28
"1612","5521工信","110/09/09","港商法國興業",0,36,-36
"1613","5521工信","110/09/09","日進",25,0,25
"1614","5521工信","110/09/09","元大-蘆洲",10,45,-35
"1615","5521工信","110/09/09","元富-同大",30,5,25
"1616","5521工信","110/09/09","台灣摩根士丹利",1,31,-30
"1617","5521工信","110/09/09","富邦-敦南",23,0,23
"1618","5521工信","110/09/09","群益金鼎-延平",0,17,-17
"1619","5521工信","110/09/09","玉山-台大",20,0,20
"1620","5521工信","110/09/09","永豐金證券",0,16,-16
"1621","1471首利","110/09/09","凱基-八德",32,0,32
"1622","1471首利","110/09/09","第一金-路竹",0,80,-80
"1623","1471首利","110/09/09","台新-松江",24,0,24
"1624","1471首利","110/09/09","凱基-市政",0,20,-20
"1625","1471首利","110/09/09","日盛-新莊",20,0,20
"1626","1471首利","110/09/09","元大-西螺",2,20,-18
"1627","1471首利","110/09/09","兆豐-忠孝",20,0,20
"1628","1471首利","110/09/09","港商法國興業",0,17,-17
"1629","1471首利","110/09/09","元大-南屯",20,0,20
"1630","1471首利","110/09/09","元大-西門",0,17,-17
"1631","1471首利","110/09/09","玉山-桃園",15,0,15
"1632","1471首利","110/09/09","合庫-高雄",0,15,-15
"1633","1471首利","110/09/09","摩根大通",26,12,14
"1634","1471首利","110/09/09","國泰-台中",0,15,-15
"1635","1471首利","110/09/09","宏遠-光隆",12,0,12
"1636","1471首利","110/09/09","元大-內湖",0,15,-15
"1637","1471首利","110/09/09","元大-八德",12,0,12
"1638","1471首利","110/09/09","元大-竹山",0,13,-13
"1639","1471首利","110/09/09","合庫-基隆",10,0,10
"1640","1471首利","110/09/09","元大-嘉義",0,12,-12
"1641","1471首利","110/09/09","台中銀",10,0,10
"1642","1471首利","110/09/09","日盛-三峽",0,10,-10
"1643","1471首利","110/09/09","玉山-左營",10,0,10
"1644","1471首利","110/09/09","群益金鼎-竹南",0,10,-10
"1645","1471首利","110/09/09","富邦-永和",10,0,10
"1646","1471首利","110/09/09","元大-鳳中",0,10,-10
"1647","1471首利","110/09/09","瑞士信貸",6,0,6
"1648","1471首利","110/09/09","元大-楊梅",0,10,-10
"1649","1471首利","110/09/09","台新-建北",5,0,5
"1650","1471首利","110/09/09","國泰-敦南",4,11,-7
"1651","2883開發金","110/09/09","合庫證券",2602,286,2316
"1652","2883開發金","110/09/09","國泰證券",48,5601,-5553
"1653","2883開發金","110/09/09","台新證券",1877,194,1683
"1654","2883開發金","110/09/09","摩根大通",506,3082,-2576
"1655","2883開發金","110/09/09","花旗環球",2216,749,1467
"1656","2883開發金","110/09/09","凱基-台北",709,2913,-2204
"1657","2883開發金","110/09/09","瑞士信貸",1582,434,1148
"1658","2883開發金","110/09/09","新加坡商瑞銀",10,1384,-1374
"1659","2883開發金","110/09/09","元大-文心興安",1018,2,1016
"1660","2883開發金","110/09/09","富邦-內湖",2,1000,-998
"1661","2883開發金","110/09/09","永豐金-板橋",1000,1,999
"1662","2883開發金","110/09/09","港商麥格理",0,640,-640
"1663","2883開發金","110/09/09","國票-長城",800,10,790
"1664","2883開發金","110/09/09","美林",468,931,-463
"1665","2883開發金","110/09/09","港商野村",2620,1834,786
"1666","2883開發金","110/09/09","法銀巴黎",1,455,-454
"1667","2883開發金","110/09/09","富邦-陽明",608,5,603
"1668","2883開發金","110/09/09","凱基",10,400,-390
"1669","2883開發金","110/09/09","元大-大同",499,4,495
"1670","2883開發金","110/09/09","台灣摩根士丹利",791,1098,-307
"1671","2883開發金","110/09/09","合庫-自強",493,11,482
"1672","2883開發金","110/09/09","元大-中壢",46,337,-291
"1673","2883開發金","110/09/09","新光-台中",346,12,334
"1674","2883開發金","110/09/09","凱基-復興",9,266,-257
"1675","2883開發金","110/09/09","元大-新莊",258,10,248
"1676","2883開發金","110/09/09","臺銀-臺中",13,260,-247
"1677","2883開發金","110/09/09","玉山證券",300,60,240
"1678","2883開發金","110/09/09","元大-大益",15,250,-235
"1679","2883開發金","110/09/09","永豐金-敦南",229,0,229
"1680","2883開發金","110/09/09","群益金鼎-延平",5,239,-234
"1681","6205詮欣","110/09/09","富邦-內湖",20,0,20
"1682","6205詮欣","110/09/09","土銀-白河",0,20,-20
"1683","6205詮欣","110/09/09","摩根大通",11,0,11
"1684","6205詮欣","110/09/09","元富",0,10,-10
"1685","6205詮欣","110/09/09","玉山-城中",10,0,10
"1686","6205詮欣","110/09/09","中國信託-忠孝",0,10,-10
"1687","6205詮欣","110/09/09","華南永昌-長虹",5,0,5
"1688","6205詮欣","110/09/09","凱基-台南",0,10,-10
"1689","6205詮欣","110/09/09","元大-汐止",5,0,5
"1690","6205詮欣","110/09/09","華南永昌-麻豆",0,7,-7
"1691","6205詮欣","110/09/09","臺銀-民權",4,0,4
"1692","6205詮欣","110/09/09","高橋",0,5,-5
"1693","6205詮欣","110/09/09","日盛-三重",4,0,4
"1694","6205詮欣","110/09/09","港商法國興業",0,4,-4
"1695","6205詮欣","110/09/09","美商高盛",3,0,3
"1696","6205詮欣","110/09/09","華南永昌-東昇",0,4,-4
"1697","6205詮欣","110/09/09","港商野村",2,0,2
"1698","6205詮欣","110/09/09","台新證券",0,3,-3
"1699","6205詮欣","110/09/09","新加坡商瑞銀",2,0,2
"1700","6205詮欣","110/09/09","第一金-新興",0,2,-2
"1701","6205詮欣","110/09/09","華南永昌",2,0,2
"1702","6205詮欣","110/09/09","兆豐-南京",0,2,-2
"1703","6205詮欣","110/09/09","元大-土城學府",2,0,2
"1704","6205詮欣","110/09/09","群益金鼎-潭子",0,2,-2
"1705","6205詮欣","110/09/09","美林",1,0,1
"1706","6205詮欣","110/09/09","華南永昌-忠孝",0,2,-2
"1707","6205詮欣","110/09/09","第一金-豐原",1,0,1
"1708","6205詮欣","110/09/09","富邦-永和",0,2,-2
"1709","6205詮欣","110/09/09","元富-草屯",1,0,1
"1710","6205詮欣","110/09/09","日盛-頭份",0,1,-1
"1711","1540喬福","110/09/09","玉山-台南",30,0,30
"1712","1540喬福","110/09/09","台新證券",0,14,-14
"1713","1540喬福","110/09/09","元大-佳里",10,0,10
"1714","1540喬福","110/09/09","日盛-文化",0,13,-13
"1715","1540喬福","110/09/09","凱基-台北",6,1,5
"1716","1540喬福","110/09/09","元大-龍潭",0,6,-6
"1717","1540喬福","110/09/09","華南永昌-林口",3,0,3
"1718","1540喬福","110/09/09","元大-北港",0,5,-5
"1719","1540喬福","110/09/09","元富-林園",2,0,2
"1720","1540喬福","110/09/09","摩根大通",1,6,-5
"1721","1540喬福","110/09/09","元富-新竹",2,0,2
"1722","1540喬福","110/09/09","港商法國興業",0,4,-4
"1723","1540喬福","110/09/09","群益金鼎-三民",2,0,2
"1724","1540喬福","110/09/09","元大-南屯",0,3,-3
"1725","1540喬福","110/09/09","元大-清水",2,0,2
"1726","1540喬福","110/09/09","富邦-羅東",0,3,-3
"1727","1540喬福","110/09/09","永豐金證券",2,0,2
"1728","1540喬福","110/09/09","元大-鳳中",0,2,-2
"1729","1540喬福","110/09/09","永豐金-員林",2,0,2
"1730","1540喬福","110/09/09","群益金鼎-松山",0,2,-2
"1731","1540喬福","110/09/09","統一-土城",1,0,1
"1732","1540喬福","110/09/09","玉山-新竹",0,1,-1
"1733","1540喬福","110/09/09","國票-安和",1,0,1
"1734","1540喬福","110/09/09","兆豐-南門",0,1,-1
"1735","1540喬福","110/09/09","元大-北成功",1,0,1
"1736","1540喬福","110/09/09","元富",0,1,-1
"1737","1540喬福","110/09/09","群益金鼎",0,0,0
"1738","1540喬福","110/09/09","花旗環球",0,1,-1
"1739","1540喬福","110/09/09","元大-豐原",0,0,0
"1740","1540喬福","110/09/09","台灣摩根士丹利",0,1,-1
"1741","2888新光金","110/09/09","華南永昌-南京",2495,46,2449
"1742","2888新光金","110/09/09","凱基-台北",715,6190,-5475
"1743","2888新光金","110/09/09","港商法國興業",2031,508,1523
"1744","2888新光金","110/09/09","摩根大通",600,3310,-2710
"1745","2888新光金","110/09/09","元富-世貿",2077,592,1485
"1746","2888新光金","110/09/09","瑞士信貸",46,1930,-1884
"1747","2888新光金","110/09/09","元大-苑裡",1016,2,1014
"1748","2888新光金","110/09/09","法銀巴黎",0,1236,-1236
"1749","2888新光金","110/09/09","永豐金-板橋",520,0,520
"1750","2888新光金","110/09/09","台灣摩根士丹利",99,805,-706
"1751","2888新光金","110/09/09","新加坡商瑞銀",671,207,464
"1752","2888新光金","110/09/09","花旗環球",0,663,-663
"1753","2888新光金","110/09/09","美林",2275,1832,443
"1754","2888新光金","110/09/09","新光-台南",122,662,-540
"1755","2888新光金","110/09/09","日盛-台南",409,0,409
"1756","2888新光金","110/09/09","國泰-桃園",7,500,-493
"1757","2888新光金","110/09/09","凱基-中山",400,0,400
"1758","2888新光金","110/09/09","永豐金證券",8,411,-403
"1759","2888新光金","110/09/09","(牛牛牛)亞-網路",345,0,345
"1760","2888新光金","110/09/09","日盛-台中",16,389,-373
"1761","2888新光金","110/09/09","新光",444,144,300
"1762","2888新光金","110/09/09","群益金鼎-竹南",54,320,-266
"1763","2888新光金","110/09/09","土銀-台中",282,0,282
"1764","2888新光金","110/09/09","玉山-大里",0,256,-256
"1765","2888新光金","110/09/09","日盛-頭份",314,60,254
"1766","2888新光金","110/09/09","元富-彰化",48,277,-229
"1767","2888新光金","110/09/09","兆豐-新竹",253,0,253
"1768","2888新光金","110/09/09","永豐金-高雄",8,225,-217
"1769","2888新光金","110/09/09","元大-新竹經國",256,14,242
"1770","2888新光金","110/09/09","富邦-基隆",0,206,-206
"1771","1340勝悅","110/09/09","凱基-台北",18,2,16
"1772","1340勝悅","110/09/09","高橋",0,75,-75
"1773","1340勝悅","110/09/09","玉山-高雄",12,0,12
"1774","1340勝悅","110/09/09","聯邦-三重",0,50,-50
"1775","1340勝悅","110/09/09","國泰-板橋",12,0,12
"1776","1340勝悅","110/09/09","臺銀-民權",0,43,-43
"1777","1340勝悅","110/09/09","群益金鼎-館前",14,2,12
"1778","1340勝悅","110/09/09","日盛-龍潭",0,8,-8
"1779","1340勝悅","110/09/09","國泰-敦南",15,4,11
"1780","1340勝悅","110/09/09","大昌",0,8,-8
"1781","1340勝悅","110/09/09","日盛-景美",10,0,10
"1782","1340勝悅","110/09/09","群益金鼎-古亭",0,8,-8
"1783","1340勝悅","110/09/09","群益金鼎-崇德",10,0,10
"1784","1340勝悅","110/09/09","港商法國興業",0,7,-7
"1785","1340勝悅","110/09/09","凱基-高雄",10,0,10
"1786","1340勝悅","110/09/09","美林",0,6,-6
"1787","1340勝悅","110/09/09","國泰-台南",9,0,9
"1788","1340勝悅","110/09/09","大昌-樹林",0,6,-6
"1789","1340勝悅","110/09/09","摩根大通",15,7,8
"1790","1340勝悅","110/09/09","元大-敦南",0,6,-6
"1791","1340勝悅","110/09/09","國泰-台中",7,0,7
"1792","1340勝悅","110/09/09","合庫-台中",0,5,-5
"1793","1340勝悅","110/09/09","元大-東蘆",6,0,6
"1794","1340勝悅","110/09/09","日盛-新莊",1,6,-5
"1795","1340勝悅","110/09/09","兆豐-斗南",5,0,5
"1796","1340勝悅","110/09/09","元富-彰化",0,5,-5
"1797","1340勝悅","110/09/09","國泰-高雄",9,4,5
"1798","1340勝悅","110/09/09","永全",0,4,-4
"1799","1340勝悅","110/09/09","華南永昌-高雄",9,5,4
"1800","1340勝悅","110/09/09","日盛-員林",0,3,-3
"1801","6246臺龍","110/09/09","群益金鼎-古亭",17,1,16
"1802","6246臺龍","110/09/09","統一-土城",16,52,-36
"1803","6246臺龍","110/09/09","永興",10,0,10
"1804","6246臺龍","110/09/09","新光-台南",0,15,-15
"1805","6246臺龍","110/09/09","元大-土城永寧",9,0,9
"1806","6246臺龍","110/09/09","國泰-館前",0,9,-9
"1807","6246臺龍","110/09/09","台新證券",6,0,6
"1808","6246臺龍","110/09/09","元富-敦南",0,8,-8
"1809","6246臺龍","110/09/09","玉山-板橋",5,0,5
"1810","6246臺龍","110/09/09","元大證券",5,11,-6
"1811","6246臺龍","110/09/09","凱基-台北",6,1,5
"1812","6246臺龍","110/09/09","元大-新竹經國",0,5,-5
"1813","6246臺龍","110/09/09","元大-大里",7,2,5
"1814","6246臺龍","110/09/09","第一金-中壢",0,4,-4
"1815","6246臺龍","110/09/09","凱基-三峽",4,0,4
"1816","6246臺龍","110/09/09","凱基-科園",0,3,-3
"1817","6246臺龍","110/09/09","富邦-竹北",7,3,4
"1818","6246臺龍","110/09/09","元大-苑裡",0,2,-2
"1819","6246臺龍","110/09/09","國票-新莊",3,0,3
"1820","6246臺龍","110/09/09","港商野村",0,1,-1
"1821","6246臺龍","110/09/09","國票-敦北法人",3,0,3
"1822","6246臺龍","110/09/09","高橋-中壢",0,1,-1
"1823","6246臺龍","110/09/09","元富-屏東",2,0,2
"1824","6246臺龍","110/09/09","元富-板橋",0,1,-1
"1825","6246臺龍","110/09/09","兆豐-忠孝",2,0,2
"1826","6246臺龍","110/09/09","台新-屏東",2,3,-1
"1827","6246臺龍","110/09/09","玉山-台南",2,0,2
"1828","6246臺龍","110/09/09","新光-高雄",0,1,-1
"1829","6246臺龍","110/09/09","國泰-敦南",2,0,2
"1830","6246臺龍","110/09/09","凱基-士林",0,1,-1
"1831","00715L期街口布蘭特正2","110/09/09","元大證券",5713,374,5339
"1832","00715L期街口布蘭特正2","110/09/09","(牛牛牛)亞-鑫豐",15,1303,-1288
"1833","00715L期街口布蘭特正2","110/09/09","永豐金證券",3226,87,3139
"1834","00715L期街口布蘭特正2","110/09/09","國泰-敦南",43,971,-928
"1835","00715L期街口布蘭特正2","110/09/09","元富",1881,0,1881
"1836","00715L期街口布蘭特正2","110/09/09","元大-前金",0,907,-907
"1837","00715L期街口布蘭特正2","110/09/09","凱基-市政",1736,35,1701
"1838","00715L期街口布蘭特正2","110/09/09","新光",152,968,-816
"1839","00715L期街口布蘭特正2","110/09/09","群益金鼎",1369,0,1369
"1840","00715L期街口布蘭特正2","110/09/09","第一金-豐原",1,462,-461
"1841","00715L期街口布蘭特正2","110/09/09","康和",1044,0,1044
"1842","00715L期街口布蘭特正2","110/09/09","新光-台南",0,447,-447
"1843","00715L期街口布蘭特正2","110/09/09","統一",997,0,997
"1844","00715L期街口布蘭特正2","110/09/09","群益金鼎-士林",0,430,-430
"1845","00715L期街口布蘭特正2","110/09/09","富邦證券",1045,50,995
"1846","00715L期街口布蘭特正2","110/09/09","永豐金-新莊",0,400,-400
"1847","00715L期街口布蘭特正2","110/09/09","元富-大裕",1000,10,990
"1848","00715L期街口布蘭特正2","110/09/09","兆豐-台中港",0,370,-370
"1849","00715L期街口布蘭特正2","110/09/09","元大-金門",650,10,640
"1850","00715L期街口布蘭特正2","110/09/09","凱基-五股",0,329,-329
"1851","00715L期街口布蘭特正2","110/09/09","國票-中港",500,0,500
"1852","00715L期街口布蘭特正2","110/09/09","元大-萬華",0,320,-320
"1853","00715L期街口布蘭特正2","110/09/09","台新-松江",500,0,500
"1854","00715L期街口布蘭特正2","110/09/09","凱基-台北",171,487,-316
"1855","00715L期街口布蘭特正2","110/09/09","合庫證券",812,354,458
"1856","00715L期街口布蘭特正2","110/09/09","日盛-和美",0,304,-304
"1857","00715L期街口布蘭特正2","110/09/09","台中銀-豐原",402,23,379
"1858","00715L期街口布蘭特正2","110/09/09","統一-高雄",0,261,-261
"1859","00715L期街口布蘭特正2","110/09/09","台新-台中",510,148,362
"1860","00715L期街口布蘭特正2","110/09/09","富邦-新竹",0,253,-253
"1861","8941關中","110/09/09","日盛-新竹",2,0,2
"1862","8941關中","110/09/09","彰銀-台中",0,2,-2
"1863","8941關中","110/09/09","國泰-新莊",1,0,1
"1864","8941關中","110/09/09","凱基-台北",0,2,-2
"1865","8941關中","110/09/09","元大-路竹",1,0,1
"1866","8941關中","110/09/09","新光-台中",0,1,-1
"1867","8941關中","110/09/09","元大-竹山",1,0,1
"1868","8941關中","110/09/09","富邦-南屯",0,1,-1
"1869","8941關中","110/09/09","元大-桃興",1,0,1
"1870","8941關中","110/09/09","元富-桃園",0,0,0
"1871","8941關中","110/09/09","元富-桃園",0,0,0
"1872","8941關中","110/09/09","康和-板橋",0,0,0
"1873","8941關中","110/09/09","康和-板橋",0,0,0
"1874","8941關中","110/09/09","國泰-高雄",0,0,0
"1875","8941關中","110/09/09","國泰-高雄",0,0,0
"1876","8941關中","110/09/09","元大證券",0,0,0
"1877","8941關中","110/09/09","元大證券",0,0,0
"1878","8941關中","110/09/09","永豐金-敦北",0,0,0
"1879","8941關中","110/09/09","永豐金-敦北",0,0,0
"1880","8941關中","110/09/09","永豐金-南投",1,1,0
"1881","8941關中","110/09/09","永豐金-南投",1,1,0
"1882","8941關中","110/09/09","",NA,NA,NA
"1883","8941關中","110/09/09","",NA,NA,NA
"1884","8941關中","110/09/09","",NA,NA,NA
"1885","8941關中","110/09/09","",NA,NA,NA
"1886","8941關中","110/09/09","",NA,NA,NA
"1887","8941關中","110/09/09","",NA,NA,NA
"1888","8941關中","110/09/09","",NA,NA,NA
"1889","8941關中","110/09/09","",NA,NA,NA
"1890","8941關中","110/09/09","",NA,NA,NA
"1891","8936國統","110/09/09","摩根大通",110,2,108
"1892","8936國統","110/09/09","凱基-高美館",0,56,-56
"1893","8936國統","110/09/09","元大-博愛",50,3,47
"1894","8936國統","110/09/09","國票-博愛",0,50,-50
"1895","8936國統","110/09/09","元大-東泰",51,11,40
"1896","8936國統","110/09/09","永豐金-中正",0,33,-33
"1897","8936國統","110/09/09","凱基-台北",58,20,38
"1898","8936國統","110/09/09","永豐金-忠孝",0,20,-20
"1899","8936國統","110/09/09","台新-松江",29,0,29
"1900","8936國統","110/09/09","華南永昌-岡山",3,21,-18
"1901","8936國統","110/09/09","港商野村",22,1,21
"1902","8936國統","110/09/09","元富-信義",0,15,-15
"1903","8936國統","110/09/09","兆豐-三民",21,1,20
"1904","8936國統","110/09/09","台新-高雄",86,101,-15
"1905","8936國統","110/09/09","兆豐-大同",10,0,10
"1906","8936國統","110/09/09","華南永昌",2,17,-15
"1907","8936國統","110/09/09","凱基-竹北",10,0,10
"1908","8936國統","110/09/09","台灣摩根士丹利",0,13,-13
"1909","8936國統","110/09/09","富邦-建國",10,0,10
"1910","8936國統","110/09/09","第一金-安和",0,11,-11
"1911","8936國統","110/09/09","元大-承德",10,0,10
"1912","8936國統","110/09/09","台灣企銀-岡山",0,10,-10
"1913","8936國統","110/09/09","元大-草屯",10,1,9
"1914","8936國統","110/09/09","日盛-頭份",0,10,-10
"1915","8936國統","110/09/09","群益金鼎-東門",8,0,8
"1916","8936國統","110/09/09","元大-敦南",4,14,-10
"1917","8936國統","110/09/09","元大-北投",8,0,8
"1918","8936國統","110/09/09","永豐金-南京",0,10,-10
"1919","8936國統","110/09/09","新加坡商瑞銀",41,34,7
"1920","8936國統","110/09/09","華南永昌-高雄",51,60,-9
"1921","6226光鼎","110/09/09","台灣摩根士丹利",255,0,255
"1922","6226光鼎","110/09/09","瑞士信貸",41,418,-377
"1923","6226光鼎","110/09/09","永豐金證券",100,5,95
"1924","6226光鼎","110/09/09","元富-松德",1,74,-73
"1925","6226光鼎","110/09/09","摩根大通",298,217,81
"1926","6226光鼎","110/09/09","元富-高雄",3,63,-60
"1927","6226光鼎","110/09/09","華南永昌",64,5,59
"1928","6226光鼎","110/09/09","臺銀-高雄",6,64,-58
"1929","6226光鼎","110/09/09","元大-仁愛",41,0,41
"1930","6226光鼎","110/09/09","凱基-中港",23,69,-46
"1931","6226光鼎","110/09/09","日盛-新竹",40,1,39
"1932","6226光鼎","110/09/09","第一金-桃園",26,71,-45
"1933","6226光鼎","110/09/09","國泰-桃園",65,27,38
"1934","6226光鼎","110/09/09","第一金-自由",3,42,-39
"1935","6226光鼎","110/09/09","凱基-宜蘭",32,0,32
"1936","6226光鼎","110/09/09","元大-員林",11,48,-37
"1937","6226光鼎","110/09/09","新光",99,69,30
"1938","6226光鼎","110/09/09","元大-開元",2,34,-32
"1939","6226光鼎","110/09/09","國泰-敦南",155,125,30
"1940","6226光鼎","110/09/09","永豐金-竹北",0,30,-30
"1941","6226光鼎","110/09/09","美商高盛",439,410,29
"1942","6226光鼎","110/09/09","元大-路竹",1,30,-29
"1943","6226光鼎","110/09/09","中國信託-文心",65,40,25
"1944","6226光鼎","110/09/09","元富-埔里",0,28,-28
"1945","6226光鼎","110/09/09","新加坡商瑞銀",152,128,24
"1946","6226光鼎","110/09/09","統一-台南",0,25,-25
"1947","6226光鼎","110/09/09","元大-太平",41,18,23
"1948","6226光鼎","110/09/09","新光-台中",37,61,-24
"1949","6226光鼎","110/09/09","統一-三重",48,28,20
"1950","6226光鼎","110/09/09","富邦-敦南",25,49,-24
"1951","2363矽統","110/09/09","摩根大通",1783,1411,372
"1952","2363矽統","110/09/09","瑞士信貸",0,3242,-3242
"1953","2363矽統","110/09/09","國票-博愛",299,75,224
"1954","2363矽統","110/09/09","第一金-桃園",190,1339,-1149
"1955","2363矽統","110/09/09","永豐金證券",211,20,191
"1956","2363矽統","110/09/09","台灣摩根士丹利",1,563,-562
"1957","2363矽統","110/09/09","國泰-敦南",1227,1089,138
"1958","2363矽統","110/09/09","新加坡商瑞銀",684,1117,-433
"1959","2363矽統","110/09/09","合庫-高雄",209,74,135
"1960","2363矽統","110/09/09","群益金鼎-台南",27,227,-200
"1961","2363矽統","110/09/09","元大-新竹經國",157,25,132
"1962","2363矽統","110/09/09","兆豐-南京",10,207,-197
"1963","2363矽統","110/09/09","元富-三重",216,93,123
"1964","2363矽統","110/09/09","凱基-竹北",43,191,-148
"1965","2363矽統","110/09/09","富邦-虎尾",437,330,107
"1966","2363矽統","110/09/09","群益金鼎-大安",60,181,-121
"1967","2363矽統","110/09/09","日盛-永康",127,26,101
"1968","2363矽統","110/09/09","美林",1131,1240,-109
"1969","2363矽統","110/09/09","兆豐-三民",270,172,98
"1970","2363矽統","110/09/09","元大-龍潭",163,261,-98
"1971","2363矽統","110/09/09","宏遠-台中",131,37,94
"1972","2363矽統","110/09/09","台中銀-員林",23,120,-97
"1973","2363矽統","110/09/09","富邦-台北",179,87,92
"1974","2363矽統","110/09/09","元大-汐止",97,193,-96
"1975","2363矽統","110/09/09","永豐金-南投",211,119,92
"1976","2363矽統","110/09/09","凱基-長庚",52,144,-92
"1977","2363矽統","110/09/09","元大-士林",109,19,90
"1978","2363矽統","110/09/09","元富-成功",242,332,-90
"1979","2363矽統","110/09/09","統一",269,180,89
"1980","2363矽統","110/09/09","元大-敦南",30,120,-90
"1981","8112至上","110/09/09","摩根大通",439,100,339
"1982","8112至上","110/09/09","合庫證券",0,156,-156
"1983","8112至上","110/09/09","瑞士信貸",305,0,305
"1984","8112至上","110/09/09","富邦-仁愛",3,66,-63
"1985","8112至上","110/09/09","美商高盛",209,0,209
"1986","8112至上","110/09/09","凱基-長庚",0,54,-54
"1987","8112至上","110/09/09","群益金鼎-屏東",173,2,171
"1988","8112至上","110/09/09","元大-員林中山",0,51,-51
"1989","8112至上","110/09/09","美林",176,33,143
"1990","8112至上","110/09/09","土銀-台中",0,45,-45
"1991","8112至上","110/09/09","凱基-竹科",140,1,139
"1992","8112至上","110/09/09","元大-楊梅",1,45,-44
"1993","8112至上","110/09/09","港商野村",71,3,68
"1994","8112至上","110/09/09","中國信託-忠孝",1,36,-35
"1995","8112至上","110/09/09","台新-新營",120,55,65
"1996","8112至上","110/09/09","日盛-八德",0,34,-34
"1997","8112至上","110/09/09","元大-萬華",40,5,35
"1998","8112至上","110/09/09","元大-佳里",0,32,-32
"1999","8112至上","110/09/09","新加坡商瑞銀",43,12,31
"2000","8112至上","110/09/09","元大-西門",0,32,-32
"2001","8112至上","110/09/09","中國信託-嘉義",40,9,31
"2002","8112至上","110/09/09","日盛-板橋中山",1,32,-31
"2003","8112至上","110/09/09","台灣摩根士丹利",46,16,30
"2004","8112至上","110/09/09","兆豐-岡山",0,30,-30
"2005","8112至上","110/09/09","中國信託",26,0,26
"2006","8112至上","110/09/09","華南永昌-嘉義",0,27,-27
"2007","8112至上","110/09/09","福勝",21,0,21
"2008","8112至上","110/09/09","新光",15,39,-24
"2009","8112至上","110/09/09","康和-仁愛",20,0,20
"2010","8112至上","110/09/09","凱基-豐中",0,24,-24
"2011","2929淘帝","110/09/09","摩根大通",41,0,41
"2012","2929淘帝","110/09/09","永豐金-敦南",0,22,-22
"2013","2929淘帝","110/09/09","兆豐-內湖",38,0,38
"2014","2929淘帝","110/09/09","大昌",0,11,-11
"2015","2929淘帝","110/09/09","美林",19,6,13
"2016","2929淘帝","110/09/09","永豐金證券",0,10,-10
"2017","2929淘帝","110/09/09","台灣摩根士丹利",12,0,12
"2018","2929淘帝","110/09/09","群益金鼎-高雄",0,8,-8
"2019","2929淘帝","110/09/09","新加坡商瑞銀",10,4,6
"2020","2929淘帝","110/09/09","港商野村",22,29,-7
"2021","2929淘帝","110/09/09","元富-大昌",5,0,5
"2022","2929淘帝","110/09/09","元富-新竹",2,9,-7
"2023","2929淘帝","110/09/09","台新-建北",5,0,5
"2024","2929淘帝","110/09/09","日盛-員林",0,5,-5
"2025","2929淘帝","110/09/09","凱基-中山",5,0,5
"2026","2929淘帝","110/09/09","日盛-龍潭",0,5,-5
"2027","2929淘帝","110/09/09","日盛-雙和",3,0,3
"2028","2929淘帝","110/09/09","富邦-新竹",0,5,-5
"2029","2929淘帝","110/09/09","元大-龍潭",3,0,3
"2030","2929淘帝","110/09/09","元大-土城",0,5,-5
"2031","2929淘帝","110/09/09","台新證券",2,0,2
"2032","2929淘帝","110/09/09","瑞士信貸",0,4,-4
"2033","2929淘帝","110/09/09","玉山-嘉義",2,0,2
"2034","2929淘帝","110/09/09","港商法國興業",0,4,-4
"2035","2929淘帝","110/09/09","凱基-三重",2,0,2
"2036","2929淘帝","110/09/09","元大-四維",0,4,-4
"2037","2929淘帝","110/09/09","凱基-永康",2,0,2
"2038","2929淘帝","110/09/09","元大-左營",0,3,-3
"2039","2929淘帝","110/09/09","元大-太平",2,0,2
"2040","2929淘帝","110/09/09","新光",1,3,-2
"2041","5410國眾","110/09/09","華南永昌-高雄",10,0,10
"2042","5410國眾","110/09/09","元大-崇德",1,28,-27
"2043","5410國眾","110/09/09","元大-忠孝",8,0,8
"2044","5410國眾","110/09/09","美林",0,6,-6
"2045","5410國眾","110/09/09","華南永昌-公誠",4,0,4
"2046","5410國眾","110/09/09","元大-屏東民生",0,6,-6
"2047","5410國眾","110/09/09","兆豐-竹北",3,0,3
"2048","5410國眾","110/09/09","元富-嘉義",0,5,-5
"2049","5410國眾","110/09/09","臺銀-臺中",2,0,2
"2050","5410國眾","110/09/09","國泰-敦南",2,4,-2
"2051","5410國眾","110/09/09","日盛-二林",2,0,2
"2052","5410國眾","110/09/09","永豐金-板橋",0,2,-2
"2053","5410國眾","110/09/09","中國信託-高雄",2,0,2
"2054","5410國眾","110/09/09","日盛-雙和",0,1,-1
"2055","5410國眾","110/09/09","新光",2,0,2
"2056","5410國眾","110/09/09","日盛-高雄",0,1,-1
"2057","5410國眾","110/09/09","玉山-新莊",2,0,2
"2058","5410國眾","110/09/09","台中銀-豐原",0,1,-1
"2059","5410國眾","110/09/09","華南永昌-台南",2,0,2
"2060","5410國眾","110/09/09","中國信託-忠孝",0,1,-1
"2061","5410國眾","110/09/09","元大-府城",2,0,2
"2062","5410國眾","110/09/09","台新-中壢",1,2,-1
"2063","5410國眾","110/09/09","元大-景美",2,0,2
"2064","5410國眾","110/09/09","凱基-中壢",0,1,-1
"2065","5410國眾","110/09/09","合庫-台中",1,0,1
"2066","5410國眾","110/09/09","元大-竹科",0,1,-1
"2067","5410國眾","110/09/09","亞東-新竹",1,0,1
"2068","5410國眾","110/09/09","元大-南屯",0,1,-1
"2069","5410國眾","110/09/09","高橋-龍潭",1,0,1
"2070","5410國眾","110/09/09","永豐金-板新",0,1,-1
"2071","2841台開","110/09/09","永豐金-敦南",123,6,117
"2072","2841台開","110/09/09","日盛證券",12,79,-67
"2073","2841台開","110/09/09","第一金-台中",40,0,40
"2074","2841台開","110/09/09","元富-三重",0,61,-61
"2075","2841台開","110/09/09","台新-三民",27,0,27
"2076","2841台開","110/09/09","永豐金-苓雅",0,33,-33
"2077","2841台開","110/09/09","宏遠-館前",20,0,20
"2078","2841台開","110/09/09","土銀-高雄",0,20,-20
"2079","2841台開","110/09/09","新光",17,0,17
"2080","2841台開","110/09/09","大昌-安康",0,20,-20
"2081","2841台開","110/09/09","華南永昌-台中",17,0,17
"2082","2841台開","110/09/09","群益金鼎-延平",0,20,-20
"2083","2841台開","110/09/09","元大-桃園",11,0,11
"2084","2841台開","110/09/09","華南永昌-世貿",0,20,-20
"2085","2841台開","110/09/09","台新證券",7,0,7
"2086","2841台開","110/09/09","新加坡商瑞銀",0,15,-15
"2087","2841台開","110/09/09","國泰-館前",7,0,7
"2088","2841台開","110/09/09","兆豐-新營",0,15,-15
"2089","2841台開","110/09/09","元大-忠孝鼎富",7,0,7
"2090","2841台開","110/09/09","玉山-桃園",0,10,-10
"2091","2841台開","110/09/09","合庫-台南",6,0,6
"2092","2841台開","110/09/09","凱基-三重",0,10,-10
"2093","2841台開","110/09/09","合庫-桃園",6,0,6
"2094","2841台開","110/09/09","元大-大同",0,10,-10
"2095","2841台開","110/09/09","統一-新台中",5,0,5
"2096","2841台開","110/09/09","永豐金-市政",0,10,-10
"2097","2841台開","110/09/09","台中銀",5,0,5
"2098","2841台開","110/09/09","富邦-台南",0,7,-7
"2099","2841台開","110/09/09","兆豐-嘉義",5,0,5
"2100","2841台開","110/09/09","元富-大裕",0,5,-5
"2101","6207雷科","110/09/09","摩根大通",23,1,22
"2102","6207雷科","110/09/09","群益金鼎-三民",0,71,-71
"2103","6207雷科","110/09/09","德信-和平",14,0,14
"2104","6207雷科","110/09/09","元大-高雄",0,45,-45
"2105","6207雷科","110/09/09","兆豐-來福",10,0,10
"2106","6207雷科","110/09/09","元大-南海",3,11,-8
"2107","6207雷科","110/09/09","元大-松江",10,0,10
"2108","6207雷科","110/09/09","日盛-信義",0,6,-6
"2109","6207雷科","110/09/09","永豐金-豐原",6,0,6
"2110","6207雷科","110/09/09","玉山-台南",0,6,-6
"2111","6207雷科","110/09/09","統一-敦南",5,0,5
"2112","6207雷科","110/09/09","元富-新興",0,4,-4
"2113","6207雷科","110/09/09","日茂-埔里",5,0,5
"2114","6207雷科","110/09/09","凱基-台北",7,10,-3
"2115","6207雷科","110/09/09","國票-九鼎",5,0,5
"2116","6207雷科","110/09/09","第一金-新興",0,2,-2
"2117","6207雷科","110/09/09","玉山-嘉義",5,0,5
"2118","6207雷科","110/09/09","元富-板橋",0,2,-2
"2119","6207雷科","110/09/09","凱基-台南",5,0,5
"2120","6207雷科","110/09/09","新百王",0,2,-2
"2121","6207雷科","110/09/09","凱基-中山",5,0,5
"2122","6207雷科","110/09/09","新光-台中",0,2,-2
"2123","6207雷科","110/09/09","群益金鼎-土城",4,0,4
"2124","6207雷科","110/09/09","新光-桃園",0,2,-2
"2125","6207雷科","110/09/09","永豐金-北高雄",4,0,4
"2126","6207雷科","110/09/09","華南永昌-鳳山",0,2,-2
"2127","6207雷科","110/09/09","日盛-嘉義",3,0,3
"2128","6207雷科","110/09/09","元大-大同",0,2,-2
"2129","6207雷科","110/09/09","兆豐-嘉義",3,0,3
"2130","6207雷科","110/09/09","大慶-富順",0,1,-1
"2131","3679新至陞","110/09/09","瑞士信貸",6,3,3
"2132","3679新至陞","110/09/09","永豐金證券",0,5,-5
"2133","3679新至陞","110/09/09","凱基-台北",5,2,3
"2134","3679新至陞","110/09/09","凱基-長庚",0,3,-3
"2135","3679新至陞","110/09/09","元大-花蓮",3,0,3
"2136","3679新至陞","110/09/09","兆豐-三重",0,2,-2
"2137","3679新至陞","110/09/09","元大-永和",3,0,3
"2138","3679新至陞","110/09/09","台新-屏東",0,2,-2
"2139","3679新至陞","110/09/09","元大-板橋",3,0,3
"2140","3679新至陞","110/09/09","國泰-忠孝",0,2,-2
"2141","3679新至陞","110/09/09","土銀-花蓮",1,0,1
"2142","3679新至陞","110/09/09","凱基-宜蘭",0,2,-2
"2143","3679新至陞","110/09/09","台灣摩根士丹利",1,0,1
"2144","3679新至陞","110/09/09","第一金-忠孝",0,1,-1
"2145","3679新至陞","110/09/09","富隆-長安",1,0,1
"2146","3679新至陞","110/09/09","統一-汐止",0,1,-1
"2147","3679新至陞","110/09/09","元富-新店",1,0,1
"2148","3679新至陞","110/09/09","中國信託-忠孝",0,1,-1
"2149","3679新至陞","110/09/09","兆豐-公益",1,0,1
"2150","3679新至陞","110/09/09","國票-北高雄",0,1,-1
"2151","3679新至陞","110/09/09","富邦-陽明",1,0,1
"2152","3679新至陞","110/09/09","摩根大通",1,2,-1
"2153","3679新至陞","110/09/09","富邦-新店",1,0,1
"2154","3679新至陞","110/09/09","玉山-數位",0,1,-1
"2155","3679新至陞","110/09/09","富邦-虎尾",1,0,1
"2156","3679新至陞","110/09/09","國泰-松江",0,1,-1
"2157","3679新至陞","110/09/09","元大-六合",1,0,1
"2158","3679新至陞","110/09/09","富邦-仁愛",0,1,-1
"2159","3679新至陞","110/09/09","元大-景美",1,0,1
"2160","3679新至陞","110/09/09","元大-嘉義",0,1,-1
"2161","2727王品","110/09/09","摩根大通",73,2,71
"2162","2727王品","110/09/09","永豐金證券",0,41,-41
"2163","2727王品","110/09/09","台灣摩根士丹利",73,7,66
"2164","2727王品","110/09/09","玉山-士林",0,22,-22
"2165","2727王品","110/09/09","港商野村",64,22,42
"2166","2727王品","110/09/09","日盛-屏東",0,15,-15
"2167","2727王品","110/09/09","元富-安南",30,0,30
"2168","2727王品","110/09/09","元大-成功",0,11,-11
"2169","2727王品","110/09/09","凱基-竹科",17,1,16
"2170","2727王品","110/09/09","彰銀-七賢",0,10,-10
"2171","2727王品","110/09/09","國泰證券",22,7,15
"2172","2727王品","110/09/09","新光-桃園",3,13,-10
"2173","2727王品","110/09/09","元大證券",32,17,15
"2174","2727王品","110/09/09","富邦-建國",1,11,-10
"2175","2727王品","110/09/09","永豐金-桃盛",15,0,15
"2176","2727王品","110/09/09","元大-桃園",0,10,-10
"2177","2727王品","110/09/09","美商高盛",21,8,13
"2178","2727王品","110/09/09","日盛-木柵",0,7,-7
"2179","2727王品","110/09/09","統一",15,2,13
"2180","2727王品","110/09/09","台新-高雄",0,7,-7
"2181","2727王品","110/09/09","凱基-台北",35,23,12
"2182","2727王品","110/09/09","元大-博愛",0,7,-7
"2183","2727王品","110/09/09","瑞士信貸",17,8,9
"2184","2727王品","110/09/09","元大-基隆",0,7,-7
"2185","2727王品","110/09/09","台新證券",16,7,9
"2186","2727王品","110/09/09","永豐金-市政",0,7,-7
"2187","2727王品","110/09/09","統一-桃園",10,4,6
"2188","2727王品","110/09/09","日盛-中和",0,6,-6
"2189","2727王品","110/09/09","元大-北成功",7,1,6
"2190","2727王品","110/09/09","兆豐-岡山",0,6,-6
"2191","1570力肯","110/09/09","國票-南科",31,0,31
"2192","1570力肯","110/09/09","台新證券",0,27,-27
"2193","1570力肯","110/09/09","新光",12,0,12
"2194","1570力肯","110/09/09","永豐金-北高雄",0,20,-20
"2195","1570力肯","110/09/09","富邦-新營",10,0,10
"2196","1570力肯","110/09/09","美林",0,13,-13
"2197","1570力肯","110/09/09","元大-北三重",7,0,7
"2198","1570力肯","110/09/09","大昌",0,10,-10
"2199","1570力肯","110/09/09","國票",4,0,4
"2200","1570力肯","110/09/09","元大-莒光",2,10,-8
"2201","1570力肯","110/09/09","富邦-三重",4,0,4
"2202","1570力肯","110/09/09","永豐金-屏東",0,8,-8
"2203","1570力肯","110/09/09","元大-四維",4,0,4
"2204","1570力肯","110/09/09","群益金鼎-鳳山",0,5,-5
"2205","1570力肯","110/09/09","瑞士信貸",3,0,3
"2206","1570力肯","110/09/09","富邦-陽明",0,3,-3
"2207","1570力肯","110/09/09","國泰-高雄",4,1,3
"2208","1570力肯","110/09/09","統一-南京",0,2,-2
"2209","1570力肯","110/09/09","永豐金-桃園",3,0,3
"2210","1570力肯","110/09/09","兆豐-民生",0,2,-2
"2211","1570力肯","110/09/09","日茂",2,0,2
"2212","1570力肯","110/09/09","兆豐-台南",0,1,-1
"2213","1570力肯","110/09/09","兆豐-松德",2,0,2
"2214","1570力肯","110/09/09","玉山-雙和",0,1,-1
"2215","1570力肯","110/09/09","永豐金-苓雅",2,0,2
"2216","1570力肯","110/09/09","凱基-羅東",0,1,-1
"2217","1570力肯","110/09/09","統一-三重",1,0,1
"2218","1570力肯","110/09/09","華南永昌-台南",0,1,-1
"2219","1570力肯","110/09/09","大昌-樹林",1,0,1
"2220","1570力肯","110/09/09","元大-新盛",0,1,-1
"2221","6180橘子","110/09/09","凱基-永康",21,0,21
"2222","6180橘子","110/09/09","香港上海匯豐",0,55,-55
"2223","6180橘子","110/09/09","港商野村",14,0,14
"2224","6180橘子","110/09/09","美林",0,39,-39
"2225","6180橘子","110/09/09","日盛-文化",10,0,10
"2226","6180橘子","110/09/09","彰銀-七賢",0,20,-20
"2227","6180橘子","110/09/09","國泰-敦南",11,1,10
"2228","6180橘子","110/09/09","兆豐-永和",0,20,-20
"2229","6180橘子","110/09/09","凱基-基隆",6,0,6
"2230","6180橘子","110/09/09","凱基-永和",0,12,-12
"2231","6180橘子","110/09/09","元大-中和",6,0,6
"2232","6180橘子","110/09/09","凱基-台北",15,25,-10
"2233","6180橘子","110/09/09","臺銀-民權",5,0,5
"2234","6180橘子","110/09/09","富邦-三重",0,10,-10
"2235","6180橘子","110/09/09","康和-新竹",5,0,5
"2236","6180橘子","110/09/09","永豐金-大園",0,10,-10
"2237","6180橘子","110/09/09","新光",5,0,5
"2238","6180橘子","110/09/09","新光-桃園",7,16,-9
"2239","6180橘子","110/09/09","新光-台中",7,2,5
"2240","6180橘子","110/09/09","統一-士林",0,7,-7
"2241","6180橘子","110/09/09","玉山-雙和",5,0,5
"2242","6180橘子","110/09/09","第一金-新竹",0,5,-5
"2243","6180橘子","110/09/09","群益金鼎-中港",5,0,5
"2244","6180橘子","110/09/09","群益金鼎",0,5,-5
"2245","6180橘子","110/09/09","華南永昌",5,0,5
"2246","6180橘子","110/09/09","元富-新店",0,4,-4
"2247","6180橘子","110/09/09","中國信託-忠孝",4,0,4
"2248","6180橘子","110/09/09","元富-台中",0,3,-3
"2249","6180橘子","110/09/09","台新-新莊",4,0,4
"2250","6180橘子","110/09/09","日茂",0,3,-3
"2251","2390云辰","110/09/09","統一-新台中",306,0,306
"2252","2390云辰","110/09/09","摩根大通",14,146,-132
"2253","2390云辰","110/09/09","華南永昌-中正",58,6,52
"2254","2390云辰","110/09/09","新加坡商瑞銀",3,120,-117
"2255","2390云辰","110/09/09","元富-高雄",43,1,42
"2256","2390云辰","110/09/09","美商高盛",25,121,-96
"2257","2390云辰","110/09/09","國票-桃園",31,0,31
"2258","2390云辰","110/09/09","凱基-台北",33,109,-76
"2259","2390云辰","110/09/09","群益金鼎-延平",29,0,29
"2260","2390云辰","110/09/09","華南永昌-楠梓",10,79,-69
"2261","2390云辰","110/09/09","元大-南屯",29,0,29
"2262","2390云辰","110/09/09","永豐金-南投",0,40,-40
"2263","2390云辰","110/09/09","元富-新店",26,1,25
"2264","2390云辰","110/09/09","台灣摩根士丹利",0,30,-30
"2265","2390云辰","110/09/09","華南永昌-林口",32,10,22
"2266","2390云辰","110/09/09","元大-內湖",1,30,-29
"2267","2390云辰","110/09/09","合庫-鳳山",20,0,20
"2268","2390云辰","110/09/09","永豐金-博愛",0,27,-27
"2269","2390云辰","110/09/09","第一金-豐原",20,1,19
"2270","2390云辰","110/09/09","元大-新營",3,29,-26
"2271","2390云辰","110/09/09","玉山-新莊",17,1,16
"2272","2390云辰","110/09/09","宏遠-中和",2,27,-25
"2273","2390云辰","110/09/09","華南永昌-虎尾",15,0,15
"2274","2390云辰","110/09/09","富隆-長安",0,24,-24
"2275","2390云辰","110/09/09","大慶-蘆洲",12,0,12
"2276","2390云辰","110/09/09","元大-雙和",6,30,-24
"2277","2390云辰","110/09/09","台新-高雄",12,0,12
"2278","2390云辰","110/09/09","台新-左楠",0,20,-20
"2279","2390云辰","110/09/09","元大-鹿港",14,2,12
"2280","2390云辰","110/09/09","華南永昌-大安",1,20,-19
"2281","2834臺企銀","110/09/08","凱基-台北",32669,19953,12716
"2282","2834臺企銀","110/09/08","國票-敦北法人",2,10010,-10008
"2283","2834臺企銀","110/09/08","國票-長城",3050,50,3000
"2284","2834臺企銀","110/09/08","美林",1498,4535,-3037
"2285","2834臺企銀","110/09/08","凱基-松山",1133,66,1067
"2286","2834臺企銀","110/09/08","港商麥格理",0,3008,-3008
"2287","2834臺企銀","110/09/08","聯邦-富強",901,0,901
"2288","2834臺企銀","110/09/08","瑞士信貸",869,3189,-2320
"2289","2834臺企銀","110/09/08","元大-蘆洲",836,5,831
"2290","2834臺企銀","110/09/08","國票-南港",13,1013,-1000
"2291","2834臺企銀","110/09/08","元大-民雄",624,12,612
"2292","2834臺企銀","110/09/08","台灣企銀-竹北",6,1000,-994
"2293","2834臺企銀","110/09/08","永豐金-台南",630,86,544
"2294","2834臺企銀","110/09/08","新光",437,1428,-991
"2295","2834臺企銀","110/09/08","(牛牛牛)亞-鑫豐",683,158,525
"2296","2834臺企銀","110/09/08","元大證券",14,843,-829
"2297","2834臺企銀","110/09/08","國泰-敦南",623,136,487
"2298","2834臺企銀","110/09/08","凱基-桃園",70,781,-711
"2299","2834臺企銀","110/09/08","台新證券",584,124,460
"2300","2834臺企銀","110/09/08","元大-竹南",34,658,-624
"2301","2834臺企銀","110/09/08","玉山-新莊",560,111,449
"2302","2834臺企銀","110/09/08","花旗環球",0,550,-550
"2303","2834臺企銀","110/09/08","華南永昌-嘉義",424,2,422
"2304","2834臺企銀","110/09/08","永豐金-埔里",51,568,-517
"2305","2834臺企銀","110/09/08","兆豐-忠孝",418,5,413
"2306","2834臺企銀","110/09/08","凱基-林口",213,651,-438
"2307","2834臺企銀","110/09/08","國泰-板橋",898,506,392
"2308","2834臺企銀","110/09/08","美商高盛",525,930,-405
"2309","2834臺企銀","110/09/08","元富-嘉義",354,2,352
"2310","2834臺企銀","110/09/08","群益金鼎-板橋",7,405,-398
"2311","5511德昌","110/09/08","玉山-台大",5,0,5
"2312","5511德昌","110/09/08","日盛-新竹",0,9,-9
"2313","5511德昌","110/09/08","第一金-台中",3,0,3
"2314","5511德昌","110/09/08","台中銀-豐原",0,4,-4
"2315","5511德昌","110/09/08","美商高盛",2,0,2
"2316","5511德昌","110/09/08","國泰-台中",0,4,-4
"2317","5511德昌","110/09/08","新光-高雄",2,0,2
"2318","5511德昌","110/09/08","華南永昌-內壢",0,2,-2
"2319","5511德昌","110/09/08","富邦-岡山",2,0,2
"2320","5511德昌","110/09/08","第一金-中山",0,1,-1
"2321","5511德昌","110/09/08","瑞士信貸",1,0,1
"2322","5511德昌","110/09/08","國票-九鼎",0,1,-1
"2323","5511德昌","110/09/08","元大-東蘆",1,0,1
"2324","5511德昌","110/09/08","台新-屏東",0,1,-1
"2325","5511德昌","110/09/08","元大-清水",1,0,1
"2326","5511德昌","110/09/08","元大-土城永寧",0,1,-1
"2327","5511德昌","110/09/08","富邦-台北",1,0,1
"2328","5511德昌","110/09/08","台新-台中",0,0,0
"2329","5511德昌","110/09/08","華南永昌-台中",1,0,1
"2330","5511德昌","110/09/08","玉山-數位",0,0,0
"2331","5511德昌","110/09/08","凱基-幸福",1,0,1
"2332","5511德昌","110/09/08","國泰-敦南",0,0,0
"2333","5511德昌","110/09/08","凱基-高雄",1,0,1
"2334","5511德昌","110/09/08","群益金鼎-崇德",0,0,0
"2335","5511德昌","110/09/08","玉山證券",1,0,1
"2336","5511德昌","110/09/08","凱基-台北",2,2,0
"2337","5511德昌","110/09/08","台新證券",1,0,1
"2338","5511德昌","110/09/08","元大-大益",0,0,0
"2339","5511德昌","110/09/08","群益金鼎-崇德",0,0,0
"2340","5511德昌","110/09/08","元大-忠孝",0,0,0
"2341","2489瑞軒","110/09/08","元大-斗六",245,5,240
"2342","2489瑞軒","110/09/08","凱基-台北",76,557,-481
"2343","2489瑞軒","110/09/08","凱基-桃園",91,0,91
"2344","2489瑞軒","110/09/08","瑞士信貸",8,300,-292
"2345","2489瑞軒","110/09/08","元大-內湖",72,0,72
"2346","2489瑞軒","110/09/08","元大-豐原",0,200,-200
"2347","2489瑞軒","110/09/08","華南永昌-高雄",60,0,60
"2348","2489瑞軒","110/09/08","港商野村",38,179,-141
"2349","2489瑞軒","110/09/08","華南永昌",59,0,59
"2350","2489瑞軒","110/09/08","台灣摩根士丹利",10,145,-135
"2351","2489瑞軒","110/09/08","合庫-台南",58,0,58
"2352","2489瑞軒","110/09/08","美商高盛",3,138,-135
"2353","2489瑞軒","110/09/08","合庫-台中",55,0,55
"2354","2489瑞軒","110/09/08","香港上海匯豐",0,100,-100
"2355","2489瑞軒","110/09/08","凱基-文心",50,8,42
"2356","2489瑞軒","110/09/08","永豐金-板盛",0,100,-100
"2357","2489瑞軒","110/09/08","群益金鼎-南京",37,0,37
"2358","2489瑞軒","110/09/08","摩根大通",151,246,-95
"2359","2489瑞軒","110/09/08","統一-桃園",35,0,35
"2360","2489瑞軒","110/09/08","元大證券",10,83,-73
"2361","2489瑞軒","110/09/08","華南永昌-虎尾",36,1,35
"2362","2489瑞軒","110/09/08","美林",109,173,-64
"2363","2489瑞軒","110/09/08","富邦-仁愛",35,0,35
"2364","2489瑞軒","110/09/08","元大-大同",11,75,-64
"2365","2489瑞軒","110/09/08","元大-台南",34,0,34
"2366","2489瑞軒","110/09/08","國票",7,69,-62
"2367","2489瑞軒","110/09/08","群益金鼎-崇德",33,0,33
"2368","2489瑞軒","110/09/08","中國信託-嘉義",0,60,-60
"2369","2489瑞軒","110/09/08","元大-清水",33,0,33
"2370","2489瑞軒","110/09/08","元大-民雄",0,50,-50
"2371","2428興勤","110/09/08","摩根大通",43,24,19
"2372","2428興勤","110/09/08","國票-安和",1,55,-54
"2373","2428興勤","110/09/08","凱基-台北",34,15,19
"2374","2428興勤","110/09/08","永豐金-信義",1,33,-32
"2375","2428興勤","110/09/08","新加坡商瑞銀",21,6,15
"2376","2428興勤","110/09/08","香港上海匯豐",0,28,-28
"2377","2428興勤","110/09/08","台灣摩根士丹利",19,6,13
"2378","2428興勤","110/09/08","中國信託",0,23,-23
"2379","2428興勤","110/09/08","元富-城東",13,0,13
"2380","2428興勤","110/09/08","凱基-市府",0,19,-19
"2381","2428興勤","110/09/08","凱基-鳳山",10,1,9
"2382","2428興勤","110/09/08","元大證券",2,14,-12
"2383","2428興勤","110/09/08","美商高盛",20,12,8
"2384","2428興勤","110/09/08","國票-博愛",0,11,-11
"2385","2428興勤","110/09/08","元富-緯城",9,1,8
"2386","2428興勤","110/09/08","新光-台南",1,12,-11
"2387","2428興勤","110/09/08","康和-內湖",8,0,8
"2388","2428興勤","110/09/08","合庫-自強",0,10,-10
"2389","2428興勤","110/09/08","臺銀-民權",7,0,7
"2390","2428興勤","110/09/08","富邦-敦南",0,7,-7
"2391","2428興勤","110/09/08","群益金鼎-屏東",10,3,7
"2392","2428興勤","110/09/08","元大-大雅",0,6,-6
"2393","2428興勤","110/09/08","富邦-高雄",7,0,7
"2394","2428興勤","110/09/08","凱基-中港",1,6,-5
"2395","2428興勤","110/09/08","港商野村",13,7,6
"2396","2428興勤","110/09/08","永興",0,4,-4
"2397","2428興勤","110/09/08","新光",8,2,6
"2398","2428興勤","110/09/08","群益金鼎-土城",0,4,-4
"2399","2428興勤","110/09/08","凱基-三重",6,0,6
"2400","2428興勤","110/09/08","凱基-中山",0,4,-4
"2401","3176基亞","110/09/08","統一-仁愛",58,0,58
"2402","3176基亞","110/09/08","新加坡商瑞銀",14,43,-29
"2403","3176基亞","110/09/08","富邦-台北",11,0,11
"2404","3176基亞","110/09/08","元大-南京",2,25,-23
"2405","3176基亞","110/09/08","元大-和平",10,0,10
"2406","3176基亞","110/09/08","第一金-新興",0,20,-20
"2407","3176基亞","110/09/08","國泰-敦南",9,1,8
"2408","3176基亞","110/09/08","摩根大通",1,19,-18
"2409","3176基亞","110/09/08","元大-路竹",10,2,8
"2410","3176基亞","110/09/08","新光",3,21,-18
"2411","3176基亞","110/09/08","元大-新竹經國",7,0,7
"2412","3176基亞","110/09/08","美商高盛",1,17,-16
"2413","3176基亞","110/09/08","日盛-文化",6,0,6
"2414","3176基亞","110/09/08","第一金-台中",0,16,-16
"2415","3176基亞","110/09/08","元大證券",6,0,6
"2416","3176基亞","110/09/08","凱基-屏東",0,15,-15
"2417","3176基亞","110/09/08","統一-基隆",5,0,5
"2418","3176基亞","110/09/08","第一金-路竹",0,12,-12
"2419","3176基亞","110/09/08","大昌-新店",5,0,5
"2420","3176基亞","110/09/08","富邦-新店",1,12,-11
"2421","3176基亞","110/09/08","凱基-中壢",5,0,5
"2422","3176基亞","110/09/08","宏遠-館前",0,10,-10
"2423","3176基亞","110/09/08","華南永昌-三重",5,0,5
"2424","3176基亞","110/09/08","台新-左楠",0,10,-10
"2425","3176基亞","110/09/08","元大-土城永寧",5,0,5
"2426","3176基亞","110/09/08","元大-松江",0,10,-10
"2427","3176基亞","110/09/08","合庫-鳳山",4,0,4
"2428","3176基亞","110/09/08","富邦-員林",3,12,-9
"2429","3176基亞","110/09/08","致和證券",4,0,4
"2430","3176基亞","110/09/08","永豐金-中壢",0,8,-8
"2431","2409友達","110/09/08","玉山證券",9286,169,9117
"2432","2409友達","110/09/08","瑞士信貸",247,5798,-5551
"2433","2409友達","110/09/08","永豐金證券",7987,183,7804
"2434","2409友達","110/09/08","美林",3248,6260,-3012
"2435","2409友達","110/09/08","摩根大通",10674,5233,5441
"2436","2409友達","110/09/08","港商野村",880,3790,-2910
"2437","2409友達","110/09/08","美商高盛",4361,2004,2357
"2438","2409友達","110/09/08","台灣匯立證券",0,2625,-2625
"2439","2409友達","110/09/08","港商麥格理",1547,438,1109
"2440","2409友達","110/09/08","台灣摩根士丹利",278,2251,-1973
"2441","2409友達","110/09/08","凱基-復興",641,34,607
"2442","2409友達","110/09/08","花旗環球",487,1744,-1257
"2443","2409友達","110/09/08","土銀-台南",501,3,498
"2444","2409友達","110/09/08","國泰證券",95,797,-702
"2445","2409友達","110/09/08","兆豐-天母",505,19,486
"2446","2409友達","110/09/08","元大-館前",17,661,-644
"2447","2409友達","110/09/08","華南永昌-民權",503,27,476
"2448","2409友達","110/09/08","新光",905,1468,-563
"2449","2409友達","110/09/08","凱基-羅東",482,8,474
"2450","2409友達","110/09/08","永豐金-中壢",34,565,-531
"2451","2409友達","110/09/08","元大證券",2786,2326,460
"2452","2409友達","110/09/08","國泰-敦南",454,967,-513
"2453","2409友達","110/09/08","國票-敦北法人",638,200,438
"2454","2409友達","110/09/08","玉山-台大",346,767,-421
"2455","2409友達","110/09/08","元大-中壢",545,150,395
"2456","2409友達","110/09/08","香港上海匯豐",0,410,-410
"2457","2409友達","110/09/08","國票",544,152,392
"2458","2409友達","110/09/08","群益金鼎-西松",14,417,-403
"2459","2409友達","110/09/08","康和",345,15,330
"2460","2409友達","110/09/08","台中銀-台北",2,400,-398
"2461","1315達新","110/09/08","凱基-中港",10,0,10
"2462","1315達新","110/09/08","新光",0,12,-12
"2463","1315達新","110/09/08","(牛牛牛)亞-鑫豐",5,0,5
"2464","1315達新","110/09/08","美林",0,10,-10
"2465","1315達新","110/09/08","元大-文心興安",5,0,5
"2466","1315達新","110/09/08","港商法國興業",0,9,-9
"2467","1315達新","110/09/08","永豐金-中正",3,0,3
"2468","1315達新","110/09/08","大昌-樹林",0,3,-3
"2469","1315達新","110/09/08","元大-花蓮",3,0,3
"2470","1315達新","110/09/08","大慶-楊梅",0,2,-2
"2471","1315達新","110/09/08","永豐金-高雄",2,0,2
"2472","1315達新","110/09/08","國泰-台中",0,2,-2
"2473","1315達新","110/09/08","永豐金證券",2,0,2
"2474","1315達新","110/09/08","元富-新竹",0,1,-1
"2475","1315達新","110/09/08","元大-台中中港",2,0,2
"2476","1315達新","110/09/08","國票-安和",0,1,-1
"2477","1315達新","110/09/08","元富-安南",2,0,2
"2478","1315達新","110/09/08","群益金鼎-古亭",0,1,-1
"2479","1315達新","110/09/08","台灣摩根士丹利",2,0,2
"2480","1315達新","110/09/08","群益金鼎-丹鳳",0,1,-1
"2481","1315達新","110/09/08","摩根大通",1,0,1
"2482","1315達新","110/09/08","凱基-台北",0,1,-1
"2483","1315達新","110/09/08","兆豐-台中",1,0,1
"2484","1315達新","110/09/08","華南永昌-高雄",0,1,-1
"2485","1315達新","110/09/08","第一金-忠孝",1,0,1
"2486","1315達新","110/09/08","玉山-大里",0,0,0
"2487","1315達新","110/09/08","台灣企銀",1,0,1
"2488","1315達新","110/09/08","華南永昌-內壢",0,0,0
"2489","1315達新","110/09/08","合庫-台中",1,0,1
"2490","1315達新","110/09/08","富邦-仁愛",0,0,0
"2491","2609陽明","110/09/08","瑞士信貸",2143,342,1801
"2492","2609陽明","110/09/08","摩根大通",2455,4905,-2450
"2493","2609陽明","110/09/08","台灣匯立證券",1516,13,1503
"2494","2609陽明","110/09/08","美商高盛",915,2392,-1477
"2495","2609陽明","110/09/08","北城證券",1574,110,1464
"2496","2609陽明","110/09/08","凱基-台北",2675,3280,-605
"2497","2609陽明","110/09/08","台灣摩根士丹利",1814,353,1461
"2498","2609陽明","110/09/08","元富",25,610,-585
"2499","2609陽明","110/09/08","元大-土城永寧",1552,562,990
"2500","2609陽明","110/09/08","日盛-雙和",74,611,-537
"2501","2609陽明","110/09/08","美林",3488,2625,863
"2502","2609陽明","110/09/08","第一金-桃園",67,571,-504
"2503","2609陽明","110/09/08","永豐金-中和",1355,583,772
"2504","2609陽明","110/09/08","兆豐-嘉義",25,507,-482
"2505","2609陽明","110/09/08","群益金鼎-大安",689,39,650
"2506","2609陽明","110/09/08","華南永昌-竹北",32,432,-400
"2507","2609陽明","110/09/08","日盛-台中",842,200,642
"2508","2609陽明","110/09/08","凱基-板橋",103,391,-288
"2509","2609陽明","110/09/08","統一-土城",667,74,593
"2510","2609陽明","110/09/08","凱基-民權",11,285,-274
"2511","2609陽明","110/09/08","兆豐-復興",513,29,484
"2512","2609陽明","110/09/08","元大-竹北",107,367,-260
"2513","2609陽明","110/09/08","日盛-板橋",571,105,466
"2514","2609陽明","110/09/08","凱基-大直",622,879,-257
"2515","2609陽明","110/09/08","新加坡商瑞銀",691,272,419
"2516","2609陽明","110/09/08","富邦-北港",56,263,-207
"2517","2609陽明","110/09/08","統一-城中",612,205,407
"2518","2609陽明","110/09/08","群益金鼎-內湖",33,238,-205
"2519","2609陽明","110/09/08","統一-仁愛",1572,1166,406
"2520","2609陽明","110/09/08","凱基-虎尾",57,261,-204
"2521","2636台驊投控","110/09/08","瑞士信貸",511,81,430
"2522","2636台驊投控","110/09/08","日盛-板橋",4,171,-167
"2523","2636台驊投控","110/09/08","富邦-建國",411,18,393
"2524","2636台驊投控","110/09/08","第一金-桃園",3,144,-141
"2525","2636台驊投控","110/09/08","美林",771,487,284
"2526","2636台驊投控","110/09/08","新光-新竹",13,131,-118
"2527","2636台驊投控","110/09/08","台灣摩根士丹利",149,6,143
"2528","2636台驊投控","110/09/08","元大證券",134,238,-104
"2529","2636台驊投控","110/09/08","兆豐-中壢",117,0,117
"2530","2636台驊投控","110/09/08","統一-基隆",4,89,-85
"2531","2636台驊投控","110/09/08","兆豐-虎尾",80,0,80
"2532","2636台驊投控","110/09/08","華南永昌-竹北",10,58,-48
"2533","2636台驊投控","110/09/08","美商高盛",142,72,70
"2534","2636台驊投控","110/09/08","新光-桃園",19,62,-43
"2535","2636台驊投控","110/09/08","摩根大通",519,458,61
"2536","2636台驊投控","110/09/08","致和-台北",0,40,-40
"2537","2636台驊投控","110/09/08","凱基-台北",419,368,51
"2538","2636台驊投控","110/09/08","富邦-虎尾",4,44,-40
"2539","2636台驊投控","110/09/08","統一-新台中",38,2,36
"2540","2636台驊投控","110/09/08","元大-羅東",8,48,-40
"2541","2636台驊投控","110/09/08","新加坡商瑞銀",47,13,34
"2542","2636台驊投控","110/09/08","統一-南京",39,74,-35
"2543","2636台驊投控","110/09/08","統一-仁愛",34,3,31
"2544","2636台驊投控","110/09/08","元大-花蓮",8,40,-32
"2545","2636台驊投控","110/09/08","群益金鼎-台南",41,11,30
"2546","2636台驊投控","110/09/08","凱基-中山",5,36,-31
"2547","2636台驊投控","110/09/08","富邦證券",25,0,25
"2548","2636台驊投控","110/09/08","宏遠-台中",0,30,-30
"2549","2636台驊投控","110/09/08","元富",25,4,21
"2550","2636台驊投控","110/09/08","國泰-台中",59,86,-27
"2551","2867三商壽","110/09/08","富邦-新營",390,12,378
"2552","2867三商壽","110/09/08","元大-桃園",0,517,-517
"2553","2867三商壽","110/09/08","新光",181,63,118
"2554","2867三商壽","110/09/08","元大證券",1,287,-286
"2555","2867三商壽","110/09/08","臺銀-鳳山",116,0,116
"2556","2867三商壽","110/09/08","摩根大通",43,248,-205
"2557","2867三商壽","110/09/08","瑞士信貸",112,0,112
"2558","2867三商壽","110/09/08","統一-士林",0,180,-180
"2559","2867三商壽","110/09/08","富邦-三重",90,0,90
"2560","2867三商壽","110/09/08","凱基-台北",53,204,-151
"2561","2867三商壽","110/09/08","華南永昌-虎尾",89,0,89
"2562","2867三商壽","110/09/08","元大-崇德",0,90,-90
"2563","2867三商壽","110/09/08","國票-南京",80,0,80
"2564","2867三商壽","110/09/08","法銀巴黎",0,80,-80
"2565","2867三商壽","110/09/08","新光-台中",70,1,69
"2566","2867三商壽","110/09/08","玉山-台中",0,71,-71
"2567","2867三商壽","110/09/08","元大-大甲",67,0,67
"2568","2867三商壽","110/09/08","美商高盛",4,69,-65
"2569","2867三商壽","110/09/08","元大-嘉義",65,0,65
"2570","2867三商壽","110/09/08","花旗環球",0,42,-42
"2571","2867三商壽","110/09/08","統一-平鎮",50,0,50
"2572","2867三商壽","110/09/08","永豐金-台南",0,37,-37
"2573","2867三商壽","110/09/08","華南永昌-淡水",50,0,50
"2574","2867三商壽","110/09/08","玉山-板橋",0,34,-34
"2575","2867三商壽","110/09/08","新光-高雄",46,0,46
"2576","2867三商壽","110/09/08","兆豐-岡山",0,30,-30
"2577","2867三商壽","110/09/08","永豐金-永康",41,0,41
"2578","2867三商壽","110/09/08","聯邦-三重",0,30,-30
"2579","2867三商壽","110/09/08","富邦-桃園",40,0,40
"2580","2867三商壽","110/09/08","華南永昌-古亭",0,30,-30
"2581","5521工信","110/09/08","華南永昌-苗栗",160,0,160
"2582","5521工信","110/09/08","富邦-台北",54,366,-312
"2583","5521工信","110/09/08","國泰-台中",165,6,159
"2584","5521工信","110/09/08","元富",60,370,-310
"2585","5521工信","110/09/08","群益金鼎-大甲",85,0,85
"2586","5521工信","110/09/08","摩根大通",57,355,-298
"2587","5521工信","110/09/08","元大-潮州",80,0,80
"2588","5521工信","110/09/08","美商高盛",0,259,-259
"2589","5521工信","110/09/08","元大-博愛",80,0,80
"2590","5521工信","110/09/08","凱基-台北",37,195,-158
"2591","5521工信","110/09/08","元大-大里德芳",55,0,55
"2592","5521工信","110/09/08","凱基-城中",0,126,-126
"2593","5521工信","110/09/08","華南永昌-鶯歌",50,0,50
"2594","5521工信","110/09/08","瑞士信貸",1,123,-122
"2595","5521工信","110/09/08","華南永昌-東昇",50,0,50
"2596","5521工信","110/09/08","元富-大昌",0,100,-100
"2597","5521工信","110/09/08","永豐金-彰化",50,0,50
"2598","5521工信","110/09/08","元大證券",4,90,-86
"2599","5521工信","110/09/08","台新證券",43,0,43
"2600","5521工信","110/09/08","台灣摩根士丹利",2,82,-80
"2601","5521工信","110/09/08","元大-南屯",42,0,42
"2602","5521工信","110/09/08","玉山-板橋",0,77,-77
"2603","5521工信","110/09/08","(牛牛牛)亞-網路",39,0,39
"2604","5521工信","110/09/08","元大-左營",4,50,-46
"2605","5521工信","110/09/08","國泰-敦南",50,13,37
"2606","5521工信","110/09/08","兆豐-北高雄",2,46,-44
"2607","5521工信","110/09/08","新光-高雄",36,0,36
"2608","5521工信","110/09/08","凱基-宜蘭",0,40,-40
"2609","5521工信","110/09/08","土銀-高雄",34,0,34
"2610","5521工信","110/09/08","凱基-三峽",8,40,-32
"2611","1471首利","110/09/08","日盛-新莊",50,0,50
"2612","1471首利","110/09/08","摩根大通",11,50,-39
"2613","1471首利","110/09/08","台新-松江",36,0,36
"2614","1471首利","110/09/08","永豐金-市政",0,35,-35
"2615","1471首利","110/09/08","凱基-竹北",20,0,20
"2616","1471首利","110/09/08","永豐金-忠孝",0,32,-32
"2617","1471首利","110/09/08","華南永昌-台中",17,0,17
"2618","1471首利","110/09/08","永豐金-古亭",0,31,-31
"2619","1471首利","110/09/08","元大-八德",12,0,12
"2620","1471首利","110/09/08","瑞士信貸",0,27,-27
"2621","1471首利","110/09/08","兆豐-桃園",10,0,10
"2622","1471首利","110/09/08","大慶",0,25,-25
"2623","1471首利","110/09/08","群益金鼎-東門",10,0,10
"2624","1471首利","110/09/08","富邦-員林",0,16,-16
"2625","1471首利","110/09/08","凱基-市府",10,0,10
"2626","1471首利","110/09/08","群益金鼎-鳳山",0,15,-15
"2627","1471首利","110/09/08","元大-土城永寧",10,0,10
"2628","1471首利","110/09/08","凱基-台北",0,12,-12
"2629","1471首利","110/09/08","兆豐-西螺",9,0,9
"2630","1471首利","110/09/08","國泰-敦南",3,14,-11
"2631","1471首利","110/09/08","富邦-永和",9,0,9
"2632","1471首利","110/09/08","元富-潮州",0,10,-10
"2633","1471首利","110/09/08","富邦-中壢",8,0,8
"2634","1471首利","110/09/08","元大-民雄",0,10,-10
"2635","1471首利","110/09/08","元大-竹山",8,0,8
"2636","1471首利","110/09/08","元大-大雅",0,10,-10
"2637","1471首利","110/09/08","大慶-楊梅",7,0,7
"2638","1471首利","110/09/08","美林",0,5,-5
"2639","1471首利","110/09/08","日盛-八德",6,0,6
"2640","1471首利","110/09/08","德信-中正",0,5,-5
"2641","2883開發金","110/09/08","臺銀",5051,40,5011
"2642","2883開發金","110/09/08","凱基-台北",724,3138,-2414
"2643","2883開發金","110/09/08","新加坡商瑞銀",3432,15,3417
"2644","2883開發金","110/09/08","元大證券",2022,3577,-1555
"2645","2883開發金","110/09/08","群益金鼎-古亭",588,20,568
"2646","2883開發金","110/09/08","凱基-復興",53,1328,-1275
"2647","2883開發金","110/09/08","富邦證券",602,43,559
"2648","2883開發金","110/09/08","台灣摩根士丹利",1953,3133,-1180
"2649","2883開發金","110/09/08","華南永昌",610,62,548
"2650","2883開發金","110/09/08","美林",896,1828,-932
"2651","2883開發金","110/09/08","永豐金-苓雅",433,11,422
"2652","2883開發金","110/09/08","港商野村",660,1509,-849
"2653","2883開發金","110/09/08","港商麥格理",971,552,419
"2654","2883開發金","110/09/08","台灣企銀-竹北",2,740,-738
"2655","2883開發金","110/09/08","亞東-新竹",766,383,383
"2656","2883開發金","110/09/08","美商高盛",2064,2757,-693
"2657","2883開發金","110/09/08","臺銀-高雄",346,13,333
"2658","2883開發金","110/09/08","凱基-台中",24,704,-680
"2659","2883開發金","110/09/08","摩根大通",1004,693,311
"2660","2883開發金","110/09/08","台新-建北",15,645,-630
"2661","2883開發金","110/09/08","永興",303,0,303
"2662","2883開發金","110/09/08","凱基-東港",103,638,-535
"2663","2883開發金","110/09/08","瑞士信貸",415,176,239
"2664","2883開發金","110/09/08","新光",1007,1474,-467
"2665","2883開發金","110/09/08","臺銀-臺中",253,25,228
"2666","2883開發金","110/09/08","元大-士林",44,462,-418
"2667","2883開發金","110/09/08","彰銀-台中",205,0,205
"2668","2883開發金","110/09/08","群益金鼎-鳳山",14,381,-367
"2669","2883開發金","110/09/08","群益金鼎-開元",207,4,203
"2670","2883開發金","110/09/08","花旗環球",0,341,-341
"2671","6205詮欣","110/09/08","日盛-三重",29,0,29
"2672","6205詮欣","110/09/08","華南永昌-麻豆",0,11,-11
"2673","6205詮欣","110/09/08","臺銀-民權",11,0,11
"2674","6205詮欣","110/09/08","凱基-台北",0,11,-11
"2675","6205詮欣","110/09/08","華南永昌-長虹",11,0,11
"2676","6205詮欣","110/09/08","德信-新營",0,9,-9
"2677","6205詮欣","110/09/08","元富-宜蘭",10,0,10
"2678","6205詮欣","110/09/08","瑞士信貸",0,6,-6
"2679","6205詮欣","110/09/08","玉山-城中",9,0,9
"2680","6205詮欣","110/09/08","凱基-東門",0,5,-5
"2681","6205詮欣","110/09/08","臺銀",5,0,5
"2682","6205詮欣","110/09/08","統一-汐止",0,5,-5
"2683","6205詮欣","110/09/08","新加坡商瑞銀",3,0,3
"2684","6205詮欣","110/09/08","港商法國興業",0,5,-5
"2685","6205詮欣","110/09/08","玉山-高雄",2,0,2
"2686","6205詮欣","110/09/08","群益金鼎-新莊",0,4,-4
"2687","6205詮欣","110/09/08","元大-汐止",2,0,2
"2688","6205詮欣","110/09/08","元大-虎尾",0,4,-4
"2689","6205詮欣","110/09/08","美林",1,0,1
"2690","6205詮欣","110/09/08","元大-屏東民生",0,4,-4
"2691","6205詮欣","110/09/08","亞東-板橋",1,0,1
"2692","6205詮欣","110/09/08","凱基-和平",0,3,-3
"2693","6205詮欣","110/09/08","兆豐-景美",1,0,1
"2694","6205詮欣","110/09/08","凱基-內湖",0,3,-3
"2695","6205詮欣","110/09/08","元大-莒光",1,0,1
"2696","6205詮欣","110/09/08","日盛-台中",0,2,-2
"2697","6205詮欣","110/09/08","康和-板橋",0,0,0
"2698","6205詮欣","110/09/08","凱基-林口",0,2,-2
"2699","6205詮欣","110/09/08","國泰-高雄",0,0,0
"2700","6205詮欣","110/09/08","元大-博愛",0,2,-2
"2701","1540喬福","110/09/08","華南永昌",11,0,11
"2702","1540喬福","110/09/08","元大-土城永寧",0,31,-31
"2703","1540喬福","110/09/08","日盛-士林",6,0,6
"2704","1540喬福","110/09/08","日盛-文化",0,25,-25
"2705","1540喬福","110/09/08","元富-新竹",6,0,6
"2706","1540喬福","110/09/08","元大-古亭",0,10,-10
"2707","1540喬福","110/09/08","元大-新店中正",5,0,5
"2708","1540喬福","110/09/08","摩根大通",0,5,-5
"2709","1540喬福","110/09/08","華南永昌-東勢",5,0,5
"2710","1540喬福","110/09/08","凱基-台北",0,5,-5
"2711","1540喬福","110/09/08","德信-新營",5,0,5
"2712","1540喬福","110/09/08","元大-忠孝",0,3,-3
"2713","1540喬福","110/09/08","群益金鼎-台北",5,0,5
"2714","1540喬福","110/09/08","兆豐-大安",0,2,-2
"2715","1540喬福","110/09/08","台新證券",3,0,3
"2716","1540喬福","110/09/08","華南永昌-中正",0,2,-2
"2717","1540喬福","110/09/08","元大-大雅",3,0,3
"2718","1540喬福","110/09/08","美林",0,1,-1
"2719","1540喬福","110/09/08","凱基-高雄",3,0,3
"2720","1540喬福","110/09/08","永興",0,1,-1
"2721","1540喬福","110/09/08","日盛-景美",3,0,3
"2722","1540喬福","110/09/08","國票-台中",0,1,-1
"2723","1540喬福","110/09/08","安泰",2,0,2
"2724","1540喬福","110/09/08","統一-新台中",0,0,0
"2725","1540喬福","110/09/08","臺銀-新竹",2,0,2
"2726","1540喬福","110/09/08","國票",0,0,0
"2727","1540喬福","110/09/08","兆豐-北高雄",2,0,2
"2728","1540喬福","110/09/08","康和-板橋",0,0,0
"2729","1540喬福","110/09/08","日盛-台中",2,0,2
"2730","1540喬福","110/09/08","國泰-板橋",7,7,0
"2731","2888新光金","110/09/08","美商高盛",2902,113,2789
"2732","2888新光金","110/09/08","凱基-台北",1269,8241,-6972
"2733","2888新光金","110/09/08","新加坡商瑞銀",1081,42,1039
"2734","2888新光金","110/09/08","瑞士信貸",521,2812,-2291
"2735","2888新光金","110/09/08","兆豐-西螺",1019,1,1018
"2736","2888新光金","110/09/08","國票-長城",5,1500,-1495
"2737","2888新光金","110/09/08","統一-板橋",1195,302,893
"2738","2888新光金","110/09/08","永豐金證券",76,1023,-947
"2739","2888新光金","110/09/08","摩根大通",1716,1084,632
"2740","2888新光金","110/09/08","元大證券",675,1584,-909
"2741","2888新光金","110/09/08","港商麥格理",768,309,459
"2742","2888新光金","110/09/08","元富-城東",111,683,-572
"2743","2888新光金","110/09/08","華南永昌-虎尾",388,20,368
"2744","2888新光金","110/09/08","兆豐-台中港",23,501,-478
"2745","2888新光金","110/09/08","台新-台中",425,72,353
"2746","2888新光金","110/09/08","元大-四維",23,450,-427
"2747","2888新光金","110/09/08","富邦-虎尾",333,0,333
"2748","2888新光金","110/09/08","兆豐證券",0,411,-411
"2749","2888新光金","110/09/08","群益金鼎-新莊",301,1,300
"2750","2888新光金","110/09/08","大昌-樹林",97,485,-388
"2751","2888新光金","110/09/08","新光",718,430,288
"2752","2888新光金","110/09/08","港商野村",1,377,-376
"2753","2888新光金","110/09/08","臺銀-鳳山",297,12,285
"2754","2888新光金","110/09/08","元大-內湖",30,339,-309
"2755","2888新光金","110/09/08","永豐金-鳳山",278,0,278
"2756","2888新光金","110/09/08","日盛-中和",12,319,-307
"2757","2888新光金","110/09/08","元大-古亭",263,2,261
"2758","2888新光金","110/09/08","群益金鼎-台中",191,492,-301
"2759","2888新光金","110/09/08","元大-大里",264,5,259
"2760","2888新光金","110/09/08","花旗環球",79,364,-285
"2761","1340勝悅","110/09/08","凱基-台南",30,0,30
"2762","1340勝悅","110/09/08","元富-彰化",0,30,-30
"2763","1340勝悅","110/09/08","臺銀-鳳山",7,0,7
"2764","1340勝悅","110/09/08","永全",0,18,-18
"2765","1340勝悅","110/09/08","日盛-板橋",5,0,5
"2766","1340勝悅","110/09/08","凱基-台北",0,13,-13
"2767","1340勝悅","110/09/08","宏遠-桃園",5,0,5
"2768","1340勝悅","110/09/08","美林",0,12,-12
"2769","1340勝悅","110/09/08","統一-城中",8,3,5
"2770","1340勝悅","110/09/08","摩根大通",0,6,-6
"2771","1340勝悅","110/09/08","華南永昌-鳳山",5,0,5
"2772","1340勝悅","110/09/08","臺銀-民權",0,5,-5
"2773","1340勝悅","110/09/08","元富-新店",4,0,4
"2774","1340勝悅","110/09/08","日盛-員林",0,5,-5
"2775","1340勝悅","110/09/08","新光",4,0,4
"2776","1340勝悅","110/09/08","群益金鼎-台中",0,5,-5
"2777","1340勝悅","110/09/08","國泰-敦南",5,1,4
"2778","1340勝悅","110/09/08","元大-忠孝鼎富",0,5,-5
"2779","1340勝悅","110/09/08","凱基-台中",4,0,4
"2780","1340勝悅","110/09/08","元大-新莊",0,5,-5
"2781","1340勝悅","110/09/08","美商高盛",3,0,3
"2782","1340勝悅","110/09/08","元大-蘆洲",0,5,-5
"2783","1340勝悅","110/09/08","中國信託-嘉義",3,0,3
"2784","1340勝悅","110/09/08","富邦-台中",0,4,-4
"2785","1340勝悅","110/09/08","新光-桃園",3,0,3
"2786","1340勝悅","110/09/08","花旗環球",0,3,-3
"2787","1340勝悅","110/09/08","國泰-高雄",3,0,3
"2788","1340勝悅","110/09/08","元富-文心",0,2,-2
"2789","1340勝悅","110/09/08","國泰-館前",3,0,3
"2790","1340勝悅","110/09/08","台中銀-豐原",0,2,-2
"2791","6246臺龍","110/09/08","統一-土城",36,0,36
"2792","6246臺龍","110/09/08","新光-台南",0,24,-24
"2793","6246臺龍","110/09/08","台新證券",5,0,5
"2794","6246臺龍","110/09/08","國泰-新莊",0,5,-5
"2795","6246臺龍","110/09/08","永豐金-板新",4,0,4
"2796","6246臺龍","110/09/08","元大-南崁",0,5,-5
"2797","6246臺龍","110/09/08","元富-中港",2,0,2
"2798","6246臺龍","110/09/08","元大-大雅",0,4,-4
"2799","6246臺龍","110/09/08","德信-中正",2,0,2
"2800","6246臺龍","110/09/08","台新-屏東",0,2,-2
"2801","6246臺龍","110/09/08","元大-大里",2,0,2
"2802","6246臺龍","110/09/08","玉山證券",0,2,-2
"2803","6246臺龍","110/09/08","永豐金-嘉義",2,0,2
"2804","6246臺龍","110/09/08","凱基-中港",0,2,-2
"2805","6246臺龍","110/09/08","日盛-八德",1,0,1
"2806","6246臺龍","110/09/08","華南永昌-台中",0,2,-2
"2807","6246臺龍","110/09/08","華南永昌",1,0,1
"2808","6246臺龍","110/09/08","永豐金-永康",0,2,-2
"2809","6246臺龍","110/09/08","華南永昌-長虹",1,0,1
"2810","6246臺龍","110/09/08","臺銀-金山",0,1,-1
"2811","6246臺龍","110/09/08","華南永昌-中正",1,0,1
"2812","6246臺龍","110/09/08","元富-台中",0,1,-1
"2813","6246臺龍","110/09/08","富邦-新竹",1,0,1
"2814","6246臺龍","110/09/08","康和-嘉義",0,1,-1
"2815","6246臺龍","110/09/08","元大-新盛",1,0,1
"2816","6246臺龍","110/09/08","新光-新竹",0,1,-1
"2817","6246臺龍","110/09/08","永豐金-屏東",1,0,1
"2818","6246臺龍","110/09/08","新光-桃園",0,1,-1
"2819","6246臺龍","110/09/08","元大證券",0,0,0
"2820","6246臺龍","110/09/08","玉山-桃園",0,1,-1
"2821","00715L期街口布蘭特正2","110/09/08","永豐金證券",2051,0,2051
"2822","00715L期街口布蘭特正2","110/09/08","元大-南崁",0,2310,-2310
"2823","00715L期街口布蘭特正2","110/09/08","元富",1148,0,1148
"2824","00715L期街口布蘭特正2","110/09/08","兆豐-鹿港",0,1000,-1000
"2825","00715L期街口布蘭特正2","110/09/08","統一",991,0,991
"2826","00715L期街口布蘭特正2","110/09/08","兆豐證券",0,960,-960
"2827","00715L期街口布蘭特正2","110/09/08","富邦證券",1894,927,967
"2828","00715L期街口布蘭特正2","110/09/08","元大-西屯",25,669,-644
"2829","00715L期街口布蘭特正2","110/09/08","合庫證券",815,0,815
"2830","00715L期街口布蘭特正2","110/09/08","港商野村",0,640,-640
"2831","00715L期街口布蘭特正2","110/09/08","康和",914,200,714
"2832","00715L期街口布蘭特正2","110/09/08","群益金鼎-潭子",2,551,-549
"2833","00715L期街口布蘭特正2","110/09/08","台新證券",504,5,499
"2834","00715L期街口布蘭特正2","110/09/08","第一金-桃園",0,500,-500
"2835","00715L期街口布蘭特正2","110/09/08","群益金鼎-士林",430,5,425
"2836","00715L期街口布蘭特正2","110/09/08","元大-金門",10,353,-343
"2837","00715L期街口布蘭特正2","110/09/08","日盛-和美",301,11,290
"2838","00715L期街口布蘭特正2","110/09/08","臺銀-民權",5,312,-307
"2839","00715L期街口布蘭特正2","110/09/08","國票-中港",287,0,287
"2840","00715L期街口布蘭特正2","110/09/08","富邦-嘉義",22,305,-283
"2841","00715L期街口布蘭特正2","110/09/08","富邦-彰化",302,25,277
"2842","00715L期街口布蘭特正2","110/09/08","群益金鼎-崇德",0,240,-240
"2843","00715L期街口布蘭特正2","110/09/08","元大證券",1728,1508,220
"2844","00715L期街口布蘭特正2","110/09/08","元大-復北",0,225,-225
"2845","00715L期街口布蘭特正2","110/09/08","元大-中和",190,0,190
"2846","00715L期街口布蘭特正2","110/09/08","元大-萬華",0,210,-210
"2847","00715L期街口布蘭特正2","110/09/08","玉山-高雄",162,45,117
"2848","00715L期街口布蘭特正2","110/09/08","新光",86,289,-203
"2849","00715L期街口布蘭特正2","110/09/08","元大-花蓮",200,95,105
"2850","00715L期街口布蘭特正2","110/09/08","臺銀-金山",9,210,-201
"2851","8941關中","110/09/08","國泰-新莊",1,0,1
"2852","8941關中","110/09/08","統一-台中",0,1,-1
"2853","8941關中","110/09/08","群益金鼎-三重",1,0,1
"2854","8941關中","110/09/08","富邦-台中",0,1,-1
"2855","8941關中","110/09/08","亞東-台中",0,0,0
"2856","8941關中","110/09/08","亞東-台中",0,0,0
"2857","8941關中","110/09/08","元大-竹山",0,0,0
"2858","8941關中","110/09/08","元大-竹山",0,0,0
"2859","8941關中","110/09/08","元大-羅東",0,0,0
"2860","8941關中","110/09/08","元大-羅東",0,0,0
"2861","8941關中","110/09/08","元大-金華",1,1,0
"2862","8941關中","110/09/08","元大-金華",1,1,0
"2863","8941關中","110/09/08","永豐金-敦北",0,0,0
"2864","8941關中","110/09/08","永豐金-敦北",0,0,0
"2865","8941關中","110/09/08","永豐金-南投",0,0,0
"2866","8941關中","110/09/08","永豐金-南投",0,0,0
"2867","8941關中","110/09/08","",NA,NA,NA
"2868","8941關中","110/09/08","",NA,NA,NA
"2869","8941關中","110/09/08","",NA,NA,NA
"2870","8941關中","110/09/08","",NA,NA,NA
"2871","8941關中","110/09/08","",NA,NA,NA
"2872","8941關中","110/09/08","",NA,NA,NA
"2873","8941關中","110/09/08","",NA,NA,NA
"2874","8941關中","110/09/08","",NA,NA,NA
"2875","8941關中","110/09/08","",NA,NA,NA
"2876","8941關中","110/09/08","",NA,NA,NA
"2877","8941關中","110/09/08","",NA,NA,NA
"2878","8941關中","110/09/08","",NA,NA,NA
"2879","8941關中","110/09/08","",NA,NA,NA
"2880","8941關中","110/09/08","",NA,NA,NA
"2881","8936國統","110/09/08","臺銀",60,6,54
"2882","8936國統","110/09/08","台灣摩根士丹利",0,68,-68
"2883","8936國統","110/09/08","元大-東泰",50,0,50
"2884","8936國統","110/09/08","摩根大通",6,61,-55
"2885","8936國統","110/09/08","華南永昌-高雄",158,121,37
"2886","8936國統","110/09/08","美商高盛",5,56,-51
"2887","8936國統","110/09/08","日盛-北高雄",20,0,20
"2888","8936國統","110/09/08","新加坡商瑞銀",35,73,-38
"2889","8936國統","110/09/08","台中銀-高雄",16,0,16
"2890","8936國統","110/09/08","元大-復北",0,23,-23
"2891","8936國統","110/09/08","台新-松江",19,4,15
"2892","8936國統","110/09/08","永豐金-中正",0,21,-21
"2893","8936國統","110/09/08","富邦-建國",13,0,13
"2894","8936國統","110/09/08","日盛-台中",0,20,-20
"2895","8936國統","110/09/08","元大-台中",13,0,13
"2896","8936國統","110/09/08","凱基-台北",48,66,-18
"2897","8936國統","110/09/08","元大-土城學府",13,0,13
"2898","8936國統","110/09/08","台新證券",3,19,-16
"2899","8936國統","110/09/08","台灣企銀-北高雄",11,0,11
"2900","8936國統","110/09/08","華南永昌-岡山",5,20,-15
"2901","8936國統","110/09/08","新光-新竹",11,0,11
"2902","8936國統","110/09/08","新光-台南",2,13,-11
"2903","8936國統","110/09/08","富邦-陽明",11,0,11
"2904","8936國統","110/09/08","日盛-八德",0,10,-10
"2905","8936國統","110/09/08","元富-同大",10,0,10
"2906","8936國統","110/09/08","台新-屏東",0,10,-10
"2907","8936國統","110/09/08","國票-九鼎",10,0,10
"2908","8936國統","110/09/08","凱基-三多",0,10,-10
"2909","8936國統","110/09/08","玉山-高雄",10,0,10
"2910","8936國統","110/09/08","元大-福營",0,10,-10
"2911","6226光鼎","110/09/08","瑞士信貸",141,26,115
"2912","6226光鼎","110/09/08","美商高盛",45,232,-187
"2913","6226光鼎","110/09/08","永豐金-大園",91,2,89
"2914","6226光鼎","110/09/08","美林",90,264,-174
"2915","6226光鼎","110/09/08","摩根大通",107,48,59
"2916","6226光鼎","110/09/08","元大-台中",91,237,-146
"2917","6226光鼎","110/09/08","台灣摩根士丹利",55,0,55
"2918","6226光鼎","110/09/08","統一-竹南",0,100,-100
"2919","6226光鼎","110/09/08","第一金-自由",50,0,50
"2920","6226光鼎","110/09/08","元大-仁愛",0,82,-82
"2921","6226光鼎","110/09/08","元大-開元",33,0,33
"2922","6226光鼎","110/09/08","華南永昌-楠梓",12,77,-65
"2923","6226光鼎","110/09/08","元富-埔里",34,6,28
"2924","6226光鼎","110/09/08","中國信託",9,63,-54
"2925","6226光鼎","110/09/08","元大-草屯",29,1,28
"2926","6226光鼎","110/09/08","富邦-宜蘭",0,51,-51
"2927","6226光鼎","110/09/08","華南永昌-小港",27,0,27
"2928","6226光鼎","110/09/08","元大-大灣",2,40,-38
"2929","6226光鼎","110/09/08","元大-大里德芳",26,0,26
"2930","6226光鼎","110/09/08","玉山-士林",9,39,-30
"2931","6226光鼎","110/09/08","日盛-桃園",23,0,23
"2932","6226光鼎","110/09/08","玉山-台中",8,38,-30
"2933","6226光鼎","110/09/08","富邦-敦南",48,26,22
"2934","6226光鼎","110/09/08","元大-東蘆",2,30,-28
"2935","6226光鼎","110/09/08","永豐金-鳳山",21,0,21
"2936","6226光鼎","110/09/08","元大-高雄",0,27,-27
"2937","6226光鼎","110/09/08","合庫證券",20,0,20
"2938","6226光鼎","110/09/08","富邦-中壢",13,39,-26
"2939","6226光鼎","110/09/08","宏遠證券",20,0,20
"2940","6226光鼎","110/09/08","台新-台中",10,34,-24
"2941","2363矽統","110/09/08","瑞士信貸",1191,413,778
"2942","2363矽統","110/09/08","新加坡商瑞銀",389,1526,-1137
"2943","2363矽統","110/09/08","第一金-桃園",460,71,389
"2944","2363矽統","110/09/08","永豐金-竹科",205,908,-703
"2945","2363矽統","110/09/08","兆豐-新竹",611,322,289
"2946","2363矽統","110/09/08","群益金鼎-敦南",24,416,-392
"2947","2363矽統","110/09/08","兆豐-南京",229,20,209
"2948","2363矽統","110/09/08","合庫-高雄",37,428,-391
"2949","2363矽統","110/09/08","康和-板橋",193,17,176
"2950","2363矽統","110/09/08","陽信-石牌",514,874,-360
"2951","2363矽統","110/09/08","元大-佳里",185,28,157
"2952","2363矽統","110/09/08","永豐金證券",74,424,-350
"2953","2363矽統","110/09/08","永豐金-板新",272,127,145
"2954","2363矽統","110/09/08","凱基-台北",2085,2402,-317
"2955","2363矽統","110/09/08","台新-建北",174,35,139
"2956","2363矽統","110/09/08","美商高盛",186,413,-227
"2957","2363矽統","110/09/08","凱基-南崁",136,7,129
"2958","2363矽統","110/09/08","富邦證券",6,223,-217
"2959","2363矽統","110/09/08","元大-土城",200,75,125
"2960","2363矽統","110/09/08","富隆-長安",2,203,-201
"2961","2363矽統","110/09/08","元大-龍潭",245,131,114
"2962","2363矽統","110/09/08","新光-高雄",127,325,-198
"2963","2363矽統","110/09/08","永豐金-南投",260,153,107
"2964","2363矽統","110/09/08","群益金鼎",171,359,-188
"2965","2363矽統","110/09/08","富邦-嘉義",286,180,106
"2966","2363矽統","110/09/08","永豐金-羅東",199,383,-184
"2967","2363矽統","110/09/08","國泰-高雄",229,125,104
"2968","2363矽統","110/09/08","摩根大通",771,935,-164
"2969","2363矽統","110/09/08","元富-永和",120,17,103
"2970","2363矽統","110/09/08","元大-前金",75,234,-159
"2971","8112至上","110/09/08","摩根大通",165,13,152
"2972","8112至上","110/09/08","國票-中港",0,125,-125
"2973","8112至上","110/09/08","元大-清水",83,1,82
"2974","8112至上","110/09/08","宏遠證券",0,100,-100
"2975","8112至上","110/09/08","華南永昌-中正",60,0,60
"2976","8112至上","110/09/08","台新-台中",0,84,-84
"2977","8112至上","110/09/08","美商高盛",73,17,56
"2978","8112至上","110/09/08","凱基-台北",109,172,-63
"2979","8112至上","110/09/08","凱基-三重",54,1,53
"2980","8112至上","110/09/08","兆豐-來福",0,60,-60
"2981","8112至上","110/09/08","凱基-嘉義",47,0,47
"2982","8112至上","110/09/08","凱基-高雄",0,50,-50
"2983","8112至上","110/09/08","美林",62,19,43
"2984","8112至上","110/09/08","新光-台南",7,49,-42
"2985","8112至上","110/09/08","元大-竹東",48,10,38
"2986","8112至上","110/09/08","永豐金-敦南",4,42,-38
"2987","8112至上","110/09/08","台新-新營",35,0,35
"2988","8112至上","110/09/08","大展-台南",0,36,-36
"2989","8112至上","110/09/08","中國信託",24,0,24
"2990","8112至上","110/09/08","元大證券",2,36,-34
"2991","8112至上","110/09/08","瑞士信貸",22,0,22
"2992","8112至上","110/09/08","兆豐-忠孝",0,32,-32
"2993","8112至上","110/09/08","富邦-仁愛",25,3,22
"2994","8112至上","110/09/08","台新-新莊",0,30,-30
"2995","8112至上","110/09/08","富邦-台北",21,0,21
"2996","8112至上","110/09/08","法銀巴黎",0,29,-29
"2997","8112至上","110/09/08","統一-南京",20,0,20
"2998","8112至上","110/09/08","臺銀",2,28,-26
"2999","8112至上","110/09/08","華南永昌",25,5,20
"3000","8112至上","110/09/08","國泰-敦南",9,33,-24
"3001","1570力肯","110/09/08","國票-和平",76,0,76
"3002","1570力肯","110/09/08","凱基-台北",0,64,-64
"3003","1570力肯","110/09/08","陽信",34,0,34
"3004","1570力肯","110/09/08","新光",2,36,-34
"3005","1570力肯","110/09/08","日盛-宜蘭",25,0,25
"3006","1570力肯","110/09/08","元大-內湖",0,30,-30
"3007","1570力肯","110/09/08","群益金鼎-中港",10,0,10
"3008","1570力肯","110/09/08","新光-新竹",0,18,-18
"3009","1570力肯","110/09/08","群益金鼎-中壢",10,0,10
"3010","1570力肯","110/09/08","摩根大通",0,14,-14
"3011","1570力肯","110/09/08","富邦-彰化",10,0,10
"3012","1570力肯","110/09/08","日盛-板橋",0,13,-13
"3013","1570力肯","110/09/08","永豐金-屏東",10,0,10
"3014","1570力肯","110/09/08","兆豐-新營",0,11,-11
"3015","1570力肯","110/09/08","國票-南科",8,0,8
"3016","1570力肯","110/09/08","群益金鼎-高雄",0,11,-11
"3017","1570力肯","110/09/08","永豐金-苓雅",8,0,8
"3018","1570力肯","110/09/08","富邦-新店",0,10,-10
"3019","1570力肯","110/09/08","元大-龍潭",7,0,7
"3020","1570力肯","110/09/08","永豐金-新竹",0,9,-9
"3021","1570力肯","110/09/08","彰銀-七賢",6,0,6
"3022","1570力肯","110/09/08","台灣摩根士丹利",0,7,-7
"3023","1570力肯","110/09/08","臺銀-新竹",5,0,5
"3024","1570力肯","110/09/08","凱基-文心",5,12,-7
"3025","1570力肯","110/09/08","群益金鼎-鳳山",5,0,5
"3026","1570力肯","110/09/08","統一-新竹",0,5,-5
"3027","1570力肯","110/09/08","元大-大里",5,0,5
"3028","1570力肯","110/09/08","元大-竹科",0,5,-5
"3029","1570力肯","110/09/08","元大-新竹經國",5,0,5
"3030","1570力肯","110/09/08","元大-敦化",0,5,-5
"3031","2929淘帝","110/09/08","富邦-新竹",19,0,19
"3032","2929淘帝","110/09/08","群益金鼎-三重",0,29,-29
"3033","2929淘帝","110/09/08","新光-台中",16,1,15
"3034","2929淘帝","110/09/08","永豐金-敦南",0,24,-24
"3035","2929淘帝","110/09/08","大昌",10,0,10
"3036","2929淘帝","110/09/08","國泰-松江",0,20,-20
"3037","2929淘帝","110/09/08","摩根大通",10,0,10
"3038","2929淘帝","110/09/08","日盛-龍潭",0,11,-11
"3039","2929淘帝","110/09/08","日盛-雙和",8,0,8
"3040","2929淘帝","110/09/08","統一-汐止",0,10,-10
"3041","2929淘帝","110/09/08","台新證券",8,0,8
"3042","2929淘帝","110/09/08","日盛-新莊",0,8,-8
"3043","2929淘帝","110/09/08","台新-台中",7,0,7
"3044","2929淘帝","110/09/08","美林",1,8,-7
"3045","2929淘帝","110/09/08","富邦-台南",5,0,5
"3046","2929淘帝","110/09/08","亞東",0,6,-6
"3047","2929淘帝","110/09/08","元大-土城",5,0,5
"3048","2929淘帝","110/09/08","凱基-中山",1,6,-5
"3049","2929淘帝","110/09/08","元大-左營",5,0,5
"3050","2929淘帝","110/09/08","群益金鼎",0,4,-4
"3051","2929淘帝","110/09/08","永豐金-博愛",5,0,5
"3052","2929淘帝","110/09/08","華南永昌-南京",0,4,-4
"3053","2929淘帝","110/09/08","第一金-華江",5,1,4
"3054","2929淘帝","110/09/08","中國信託-永康",0,3,-3
"3055","2929淘帝","110/09/08","元富-吉利",4,0,4
"3056","2929淘帝","110/09/08","兆豐-台中港",0,2,-2
"3057","2929淘帝","110/09/08","光和-花壇",4,0,4
"3058","2929淘帝","110/09/08","兆豐-大同",0,2,-2
"3059","2929淘帝","110/09/08","兆豐-忠孝",4,0,4
"3060","2929淘帝","110/09/08","國泰-板橋",1,3,-2
"3061","5410國眾","110/09/08","華南永昌-高雄",20,0,20
"3062","5410國眾","110/09/08","國泰-敦南",3,28,-25
"3063","5410國眾","110/09/08","玉山-嘉義",4,0,4
"3064","5410國眾","110/09/08","亞東-新竹",0,19,-19
"3065","5410國眾","110/09/08","元大-高雄",3,0,3
"3066","5410國眾","110/09/08","凱基-台北",0,6,-6
"3067","5410國眾","110/09/08","兆豐-岡山",3,0,3
"3068","5410國眾","110/09/08","亞東-板橋",0,5,-5
"3069","5410國眾","110/09/08","凱基-中壢",3,0,3
"3070","5410國眾","110/09/08","日盛-二林",0,4,-4
"3071","5410國眾","110/09/08","華南永昌-台中",2,0,2
"3072","5410國眾","110/09/08","摩根大通",0,4,-4
"3073","5410國眾","110/09/08","元大-蘆洲",2,0,2
"3074","5410國眾","110/09/08","美林",0,2,-2
"3075","5410國眾","110/09/08","元大-大統",2,0,2
"3076","5410國眾","110/09/08","日盛-雙和",0,1,-1
"3077","5410國眾","110/09/08","華南永昌-林口",2,0,2
"3078","5410國眾","110/09/08","新加坡商瑞銀",0,1,-1
"3079","5410國眾","110/09/08","統一-台中",2,0,2
"3080","5410國眾","110/09/08","群益金鼎-建成",0,1,-1
"3081","5410國眾","110/09/08","日盛-士林",2,0,2
"3082","5410國眾","110/09/08","元大-新營",0,1,-1
"3083","5410國眾","110/09/08","臺銀-金山",1,0,1
"3084","5410國眾","110/09/08","華南永昌-內壢",0,0,0
"3085","5410國眾","110/09/08","日盛-新竹",1,0,1
"3086","5410國眾","110/09/08","富邦-員林",0,0,0
"3087","5410國眾","110/09/08","日盛-景美",1,0,1
"3088","5410國眾","110/09/08","元大-台中中港",0,0,0
"3089","5410國眾","110/09/08","日盛-八德",1,0,1
"3090","5410國眾","110/09/08","元大-左營",0,0,0
"3091","2841台開","110/09/08","日盛證券",143,24,119
"3092","2841台開","110/09/08","元大-善化",0,130,-130
"3093","2841台開","110/09/08","元大-南投",84,0,84
"3094","2841台開","110/09/08","元大-台中中港",0,50,-50
"3095","2841台開","110/09/08","永豐金-敦南",117,43,74
"3096","2841台開","110/09/08","永豐金-員林",0,35,-35
"3097","2841台開","110/09/08","新光",67,7,60
"3098","2841台開","110/09/08","富邦-台北",1,34,-33
"3099","2841台開","110/09/08","國泰-館前",38,0,38
"3100","2841台開","110/09/08","富邦-台南",0,30,-30
"3101","2841台開","110/09/08","元大-大里",30,0,30
"3102","2841台開","110/09/08","光和-高雄",0,29,-29
"3103","2841台開","110/09/08","群益金鼎-彰化",29,0,29
"3104","2841台開","110/09/08","群益金鼎-竹南",0,29,-29
"3105","2841台開","110/09/08","華南永昌-東昇",26,0,26
"3106","2841台開","110/09/08","元大-西屯",0,20,-20
"3107","2841台開","110/09/08","宏遠-館前",20,0,20
"3108","2841台開","110/09/08","元大-復北",0,18,-18
"3109","2841台開","110/09/08","元大-松江",20,0,20
"3110","2841台開","110/09/08","台灣摩根士丹利",0,17,-17
"3111","2841台開","110/09/08","大昌-安康",18,6,12
"3112","2841台開","110/09/08","合庫-台南",0,11,-11
"3113","2841台開","110/09/08","大慶-蘆洲",10,0,10
"3114","2841台開","110/09/08","元大-崇德",0,11,-11
"3115","2841台開","110/09/08","華南永昌",10,0,10
"3116","2841台開","110/09/08","台灣企銀-太平",0,10,-10
"3117","2841台開","110/09/08","元大-天母",10,0,10
"3118","2841台開","110/09/08","統一-員林",0,10,-10
"3119","2841台開","110/09/08","元大-仁愛",10,0,10
"3120","2841台開","110/09/08","台中銀-豐原",0,10,-10
"3121","6207雷科","110/09/08","台新-高雄",19,0,19
"3122","6207雷科","110/09/08","凱基-三重",2,45,-43
"3123","6207雷科","110/09/08","永全-八德",13,0,13
"3124","6207雷科","110/09/08","新加坡商瑞銀",8,26,-18
"3125","6207雷科","110/09/08","兆豐-台南",10,0,10
"3126","6207雷科","110/09/08","摩根大通",24,36,-12
"3127","6207雷科","110/09/08","凱基-台南",10,0,10
"3128","6207雷科","110/09/08","台灣企銀-屏東",0,10,-10
"3129","6207雷科","110/09/08","兆豐-高雄",9,2,7
"3130","6207雷科","110/09/08","國票-台南",0,10,-10
"3131","6207雷科","110/09/08","永豐金-高雄",7,0,7
"3132","6207雷科","110/09/08","富邦-虎尾",0,10,-10
"3133","6207雷科","110/09/08","統一-敦南",5,0,5
"3134","6207雷科","110/09/08","中國信託-三重",0,8,-8
"3135","6207雷科","110/09/08","新光",5,0,5
"3136","6207雷科","110/09/08","凱基-台北",20,28,-8
"3137","6207雷科","110/09/08","元大-苑裡",5,0,5
"3138","6207雷科","110/09/08","元大-樹林",0,7,-7
"3139","6207雷科","110/09/08","玉山-大里",4,0,4
"3140","6207雷科","110/09/08","玉山-左營",1,7,-6
"3141","6207雷科","110/09/08","群益金鼎-瑞豐",4,0,4
"3142","6207雷科","110/09/08","台新-台南",0,5,-5
"3143","6207雷科","110/09/08","元大-南海",4,0,4
"3144","6207雷科","110/09/08","華南永昌-內壢",0,5,-5
"3145","6207雷科","110/09/08","臺銀-高雄",3,0,3
"3146","6207雷科","110/09/08","國泰-板橋",0,4,-4
"3147","6207雷科","110/09/08","高橋",3,0,3
"3148","6207雷科","110/09/08","日盛-士林",0,3,-3
"3149","6207雷科","110/09/08","新光-台中",3,0,3
"3150","6207雷科","110/09/08","華南永昌-淡水",0,3,-3
"3151","3679新至陞","110/09/08","元大-大天母",10,0,10
"3152","3679新至陞","110/09/08","華南永昌-台中",0,21,-21
"3153","3679新至陞","110/09/08","凱基-長庚",8,0,8
"3154","3679新至陞","110/09/08","瑞士信貸",0,14,-14
"3155","3679新至陞","110/09/08","華南永昌-小港",5,0,5
"3156","3679新至陞","110/09/08","摩根大通",0,9,-9
"3157","3679新至陞","110/09/08","元大-北三重",5,0,5
"3158","3679新至陞","110/09/08","凱基-台北",3,10,-7
"3159","3679新至陞","110/09/08","日盛-台中",4,0,4
"3160","3679新至陞","110/09/08","台灣摩根士丹利",0,6,-6
"3161","3679新至陞","110/09/08","日盛-嘉義",3,0,3
"3162","3679新至陞","110/09/08","元富-基隆",0,5,-5
"3163","3679新至陞","110/09/08","國票-台東",3,0,3
"3164","3679新至陞","110/09/08","富邦-陽明",0,5,-5
"3165","3679新至陞","110/09/08","元大-板橋",3,0,3
"3166","3679新至陞","110/09/08","玉山-台大",0,4,-4
"3167","3679新至陞","110/09/08","土銀-士林",2,0,2
"3168","3679新至陞","110/09/08","元大證券",2,6,-4
"3169","3679新至陞","110/09/08","宏遠-館前",2,0,2
"3170","3679新至陞","110/09/08","凱基-東勢",0,3,-3
"3171","3679新至陞","110/09/08","元富-緯城",2,0,2
"3172","3679新至陞","110/09/08","華南永昌-麻豆",0,3,-3
"3173","3679新至陞","110/09/08","日茂",2,0,2
"3174","3679新至陞","110/09/08","元大-竹北",0,3,-3
"3175","3679新至陞","110/09/08","兆豐-竹北",2,0,2
"3176","3679新至陞","110/09/08","凱基-彰化",0,2,-2
"3177","3679新至陞","110/09/08","國票-九鼎",2,0,2
"3178","3679新至陞","110/09/08","富邦-板橋",0,2,-2
"3179","3679新至陞","110/09/08","玉山-嘉義",2,0,2
"3180","3679新至陞","110/09/08","元大-土城",0,2,-2
"3181","2727王品","110/09/08","元大-台中中港",268,0,268
"3182","2727王品","110/09/08","宏遠證券",0,81,-81
"3183","2727王品","110/09/08","台灣摩根士丹利",93,4,89
"3184","2727王品","110/09/08","台灣匯立證券",0,58,-58
"3185","2727王品","110/09/08","凱基-台北",117,41,76
"3186","2727王品","110/09/08","元大-忠孝",1,59,-58
"3187","2727王品","110/09/08","港商野村",91,17,74
"3188","2727王品","110/09/08","美商高盛",91,148,-57
"3189","2727王品","110/09/08","新加坡商瑞銀",22,0,22
"3190","2727王品","110/09/08","新光-台中",2,47,-45
"3191","2727王品","110/09/08","摩根大通",71,50,21
"3192","2727王品","110/09/08","元富-安南",0,31,-31
"3193","2727王品","110/09/08","美林",49,32,17
"3194","2727王品","110/09/08","永豐金證券",3,33,-30
"3195","2727王品","110/09/08","兆豐-新莊",18,1,17
"3196","2727王品","110/09/08","永豐金-松山",0,27,-27
"3197","2727王品","110/09/08","(牛牛牛)亞-鑫豐",17,2,15
"3198","2727王品","110/09/08","國泰-敦南",22,46,-24
"3199","2727王品","110/09/08","日盛-屏東",15,1,14
"3200","2727王品","110/09/08","富邦-南屯",6,25,-19
"3201","2727王品","110/09/08","新光",25,13,12
"3202","2727王品","110/09/08","凱基-台東",1,19,-18
"3203","2727王品","110/09/08","德信",10,0,10
"3204","2727王品","110/09/08","瑞士信貸",2,19,-17
"3205","2727王品","110/09/08","台新證券",23,14,9
"3206","2727王品","110/09/08","永豐金-中和",0,17,-17
"3207","2727王品","110/09/08","凱基-板橋",10,2,8
"3208","2727王品","110/09/08","富邦-台中",2,16,-14
"3209","2727王品","110/09/08","永豐金-嘉義",7,0,7
"3210","2727王品","110/09/08","中國信託-忠孝",0,13,-13
"3211","1570力肯","110/09/08","國票-和平",76,0,76
"3212","1570力肯","110/09/08","凱基-台北",0,64,-64
"3213","1570力肯","110/09/08","陽信",34,0,34
"3214","1570力肯","110/09/08","新光",2,36,-34
"3215","1570力肯","110/09/08","日盛-宜蘭",25,0,25
"3216","1570力肯","110/09/08","元大-內湖",0,30,-30
"3217","1570力肯","110/09/08","群益金鼎-中港",10,0,10
"3218","1570力肯","110/09/08","新光-新竹",0,18,-18
"3219","1570力肯","110/09/08","群益金鼎-中壢",10,0,10
"3220","1570力肯","110/09/08","摩根大通",0,14,-14
"3221","1570力肯","110/09/08","富邦-彰化",10,0,10
"3222","1570力肯","110/09/08","日盛-板橋",0,13,-13
"3223","1570力肯","110/09/08","永豐金-屏東",10,0,10
"3224","1570力肯","110/09/08","兆豐-新營",0,11,-11
"3225","1570力肯","110/09/08","國票-南科",8,0,8
"3226","1570力肯","110/09/08","群益金鼎-高雄",0,11,-11
"3227","1570力肯","110/09/08","永豐金-苓雅",8,0,8
"3228","1570力肯","110/09/08","富邦-新店",0,10,-10
"3229","1570力肯","110/09/08","元大-龍潭",7,0,7
"3230","1570力肯","110/09/08","永豐金-新竹",0,9,-9
"3231","1570力肯","110/09/08","彰銀-七賢",6,0,6
"3232","1570力肯","110/09/08","台灣摩根士丹利",0,7,-7
"3233","1570力肯","110/09/08","臺銀-新竹",5,0,5
"3234","1570力肯","110/09/08","凱基-文心",5,12,-7
"3235","1570力肯","110/09/08","群益金鼎-鳳山",5,0,5
"3236","1570力肯","110/09/08","統一-新竹",0,5,-5
"3237","1570力肯","110/09/08","元大-大里",5,0,5
"3238","1570力肯","110/09/08","元大-竹科",0,5,-5
"3239","1570力肯","110/09/08","元大-新竹經國",5,0,5
"3240","1570力肯","110/09/08","元大-敦化",0,5,-5
"3241","6180橘子","110/09/08","富邦-仁愛",40,0,40
"3242","6180橘子","110/09/08","摩根大通",28,50,-22
"3243","6180橘子","110/09/08","新光-桃園",17,0,17
"3244","6180橘子","110/09/08","兆豐-埔墘",0,10,-10
"3245","6180橘子","110/09/08","群益金鼎-台中",10,0,10
"3246","6180橘子","110/09/08","元大-大安",0,10,-10
"3247","6180橘子","110/09/08","富邦-中壢",8,0,8
"3248","6180橘子","110/09/08","國泰-敦南",1,10,-9
"3249","6180橘子","110/09/08","中國信託",8,1,7
"3250","6180橘子","110/09/08","凱基-三重",0,9,-9
"3251","6180橘子","110/09/08","中國信託-文心",55,50,5
"3252","6180橘子","110/09/08","富邦-員林",0,9,-9
"3253","6180橘子","110/09/08","台新證券",5,0,5
"3254","6180橘子","110/09/08","元大-台南",1,10,-9
"3255","6180橘子","110/09/08","群益金鼎-東湖",5,0,5
"3256","6180橘子","110/09/08","美商高盛",0,8,-8
"3257","6180橘子","110/09/08","凱基-台北",20,15,5
"3258","6180橘子","110/09/08","國票-南港",0,6,-6
"3259","6180橘子","110/09/08","華南永昌-公誠",5,0,5
"3260","6180橘子","110/09/08","新光",2,8,-6
"3261","6180橘子","110/09/08","日盛-園區",4,0,4
"3262","6180橘子","110/09/08","富邦-嘉義",0,6,-6
"3263","6180橘子","110/09/08","臺銀-民權",3,0,3
"3264","6180橘子","110/09/08","新加坡商瑞銀",5,10,-5
"3265","6180橘子","110/09/08","統一-台中",3,0,3
"3266","6180橘子","110/09/08","元富-民權",0,5,-5
"3267","6180橘子","110/09/08","元富-台中",3,0,3
"3268","6180橘子","110/09/08","元富-新興",0,5,-5
"3269","6180橘子","110/09/08","玉山-高雄",3,0,3
"3270","6180橘子","110/09/08","台中銀-員林",0,5,-5
"3271","2390云辰","110/09/08","元大-土城學府",222,60,162
"3272","2390云辰","110/09/08","摩根大通",5,343,-338
"3273","2390云辰","110/09/08","國票-安和",150,0,150
"3274","2390云辰","110/09/08","台灣摩根士丹利",78,309,-231
"3275","2390云辰","110/09/08","美商高盛",200,58,142
"3276","2390云辰","110/09/08","美林",31,179,-148
"3277","2390云辰","110/09/08","元大證券",127,35,92
"3278","2390云辰","110/09/08","華南永昌-中正",6,113,-107
"3279","2390云辰","110/09/08","元富-安南",93,2,91
"3280","2390云辰","110/09/08","統一-新台中",0,85,-85
"3281","2390云辰","110/09/08","凱基-高雄",70,6,64
"3282","2390云辰","110/09/08","港商野村",251,318,-67
"3283","2390云辰","110/09/08","華南永昌-楠梓",95,35,60
"3284","2390云辰","110/09/08","玉山-台中",3,57,-54
"3285","2390云辰","110/09/08","新光-高雄",60,20,40
"3286","2390云辰","110/09/08","國票-博愛",60,110,-50
"3287","2390云辰","110/09/08","凱基-八德",40,0,40
"3288","2390云辰","110/09/08","玉山-新莊",10,50,-40
"3289","2390云辰","110/09/08","元大-南屯",51,21,30
"3290","2390云辰","110/09/08","大慶-富順",10,39,-29
"3291","2390云辰","110/09/08","凱基-台北",200,174,26
"3292","2390云辰","110/09/08","元大-松江",1,30,-29
"3293","2390云辰","110/09/08","康和",25,0,25
"3294","2390云辰","110/09/08","凱基-虎尾",1,28,-27
"3295","2390云辰","110/09/08","永豐金-中壢",25,0,25
"3296","2390云辰","110/09/08","富邦-竹北",13,40,-27
"3297","2390云辰","110/09/08","台新-高雄",26,2,24
"3298","2390云辰","110/09/08","新加坡商瑞銀",93,115,-22
"3299","2390云辰","110/09/08","台新-台中",59,36,23
"3300","2390云辰","110/09/08","凱基-長庚",1,21,-20
"3301","2834臺企銀","110/09/07","國票-敦北法人",10123,14,10109
"3302","2834臺企銀","110/09/07","凱基-台北",8942,16307,-7365
"3303","2834臺企銀","110/09/07","瑞士信貸",7521,1120,6401
"3304","2834臺企銀","110/09/07","台灣摩根士丹利",114,5259,-5145
"3305","2834臺企銀","110/09/07","日盛-三峽",2978,40,2938
"3306","2834臺企銀","110/09/07","美商高盛",265,2876,-2611
"3307","2834臺企銀","110/09/07","摩根大通",2105,171,1934
"3308","2834臺企銀","110/09/07","永豐金-中和",6,2006,-2000
"3309","2834臺企銀","110/09/07","國票-南港",1040,0,1040
"3310","2834臺企銀","110/09/07","華南永昌",74,2029,-1955
"3311","2834臺企銀","110/09/07","新光",1207,187,1020
"3312","2834臺企銀","110/09/07","聯邦-富強",0,1900,-1900
"3313","2834臺企銀","110/09/07","美林",2413,1412,1001
"3314","2834臺企銀","110/09/07","富邦-南屯",30,1322,-1292
"3315","2834臺企銀","110/09/07","華南永昌-彰化",717,5,712
"3316","2834臺企銀","110/09/07","凱基-基隆",14,1199,-1185
"3317","2834臺企銀","110/09/07","港商法國興業",709,7,702
"3318","2834臺企銀","110/09/07","統一-板橋",2,1065,-1063
"3319","2834臺企銀","110/09/07","日盛-二林",645,10,635
"3320","2834臺企銀","110/09/07","國票-長城",0,1000,-1000
"3321","2834臺企銀","110/09/07","元大-桃園",511,11,500
"3322","2834臺企銀","110/09/07","法銀巴黎",0,932,-932
"3323","2834臺企銀","110/09/07","台灣企銀-太平",477,12,465
"3324","2834臺企銀","110/09/07","凱基-八德",3,602,-599
"3325","2834臺企銀","110/09/07","凱基-湖口",414,31,383
"3326","2834臺企銀","110/09/07","永豐金-博愛",4,506,-502
"3327","2834臺企銀","110/09/07","玉山-台中",389,27,362
"3328","2834臺企銀","110/09/07","台新-三民",64,558,-494
"3329","2834臺企銀","110/09/07","永豐金-埔里",350,30,320
"3330","2834臺企銀","110/09/07","元大-彰化",1,482,-481
"3331","5511德昌","110/09/07","瑞士信貸",5,0,5
"3332","5511德昌","110/09/07","康和-內湖",0,4,-4
"3333","5511德昌","110/09/07","國泰-高雄",2,0,2
"3334","5511德昌","110/09/07","凱基-台南",0,3,-3
"3335","5511德昌","110/09/07","富邦-高雄",2,0,2
"3336","5511德昌","110/09/07","新光",0,2,-2
"3337","5511德昌","110/09/07","臺銀-臺南",1,0,1
"3338","5511德昌","110/09/07","日盛-新竹",0,1,-1
"3339","5511德昌","110/09/07","元富-安南",1,0,1
"3340","5511德昌","110/09/07","玉山-板橋",0,1,-1
"3341","5511德昌","110/09/07","新光-高雄",1,0,1
"3342","5511德昌","110/09/07","玉山-左營",0,1,-1
"3343","5511德昌","110/09/07","富邦-台北",1,0,1
"3344","5511德昌","110/09/07","凱基-市府",0,1,-1
"3345","5511德昌","110/09/07","國票-南崁",0,0,0
"3346","5511德昌","110/09/07","國票-南崁",0,0,0
"3347","5511德昌","110/09/07","元大-太平",0,0,0
"3348","5511德昌","110/09/07","元大-太平",0,0,0
"3349","5511德昌","110/09/07","",NA,NA,NA
"3350","5511德昌","110/09/07","",NA,NA,NA
"3351","5511德昌","110/09/07","",NA,NA,NA
"3352","5511德昌","110/09/07","",NA,NA,NA
"3353","5511德昌","110/09/07","",NA,NA,NA
"3354","5511德昌","110/09/07","",NA,NA,NA
"3355","5511德昌","110/09/07","",NA,NA,NA
"3356","5511德昌","110/09/07","",NA,NA,NA
"3357","5511德昌","110/09/07","",NA,NA,NA
"3358","5511德昌","110/09/07","",NA,NA,NA
"3359","5511德昌","110/09/07","",NA,NA,NA
"3360","5511德昌","110/09/07","",NA,NA,NA
"3361","2489瑞軒","110/09/07","凱基-台北",642,132,510
"3362","2489瑞軒","110/09/07","第一金-澎湖",5,330,-325
"3363","2489瑞軒","110/09/07","瑞士信貸",441,5,436
"3364","2489瑞軒","110/09/07","第一金-新興",0,196,-196
"3365","2489瑞軒","110/09/07","港商野村",433,78,355
"3366","2489瑞軒","110/09/07","凱基-竹北",1,110,-109
"3367","2489瑞軒","110/09/07","美林",434,175,259
"3368","2489瑞軒","110/09/07","康和-台中",5,106,-101
"3369","2489瑞軒","110/09/07","美商高盛",292,84,208
"3370","2489瑞軒","110/09/07","元富-文心",0,100,-100
"3371","2489瑞軒","110/09/07","元大-豐原",201,0,201
"3372","2489瑞軒","110/09/07","凱基-桃園",0,83,-83
"3373","2489瑞軒","110/09/07","摩根大通",291,155,136
"3374","2489瑞軒","110/09/07","群益金鼎-中壢",0,67,-67
"3375","2489瑞軒","110/09/07","台灣摩根士丹利",127,24,103
"3376","2489瑞軒","110/09/07","元大-清水",31,95,-64
"3377","2489瑞軒","110/09/07","永豐金-板盛",100,0,100
"3378","2489瑞軒","110/09/07","新光",10,71,-61
"3379","2489瑞軒","110/09/07","元大-大同",75,13,62
"3380","2489瑞軒","110/09/07","國票-台中",0,58,-58
"3381","2489瑞軒","110/09/07","土銀-新竹",54,1,53
"3382","2489瑞軒","110/09/07","統一-桃園",0,50,-50
"3383","2489瑞軒","110/09/07","兆豐-台南",50,0,50
"3384","2489瑞軒","110/09/07","合庫-桃園",4,53,-49
"3385","2489瑞軒","110/09/07","新加坡商瑞銀",157,108,49
"3386","2489瑞軒","110/09/07","華南永昌-虎尾",139,187,-48
"3387","2489瑞軒","110/09/07","元富-台中",50,2,48
"3388","2489瑞軒","110/09/07","凱基-中山",0,43,-43
"3389","2489瑞軒","110/09/07","日盛-三峽",50,5,45
"3390","2489瑞軒","110/09/07","合庫-台中",7,48,-41
"3391","2428興勤","110/09/07","台灣摩根士丹利",12,1,11
"3392","2428興勤","110/09/07","統一",0,10,-10
"3393","2428興勤","110/09/07","日盛-新竹",10,0,10
"3394","2428興勤","110/09/07","元富-新竹",0,10,-10
"3395","2428興勤","110/09/07","美商高盛",12,2,10
"3396","2428興勤","110/09/07","玉山證券",0,8,-8
"3397","2428興勤","110/09/07","美林",11,4,7
"3398","2428興勤","110/09/07","港商野村",0,6,-6
"3399","2428興勤","110/09/07","瑞士信貸",6,0,6
"3400","2428興勤","110/09/07","國票-敦北法人",1,6,-5
"3401","2428興勤","110/09/07","中國信託",5,0,5
"3402","2428興勤","110/09/07","新光",1,6,-5
"3403","2428興勤","110/09/07","國泰-高雄",5,0,5
"3404","2428興勤","110/09/07","中國信託-新竹",0,4,-4
"3405","2428興勤","110/09/07","國泰-板橋",5,0,5
"3406","2428興勤","110/09/07","國票",0,4,-4
"3407","2428興勤","110/09/07","新加坡商瑞銀",8,4,4
"3408","2428興勤","110/09/07","元大-新盛",1,5,-4
"3409","2428興勤","110/09/07","康和-台中",4,0,4
"3410","2428興勤","110/09/07","日盛-花蓮",0,3,-3
"3411","2428興勤","110/09/07","元富-城東",3,0,3
"3412","2428興勤","110/09/07","第一金-豐原",0,3,-3
"3413","2428興勤","110/09/07","群益金鼎-土城",3,0,3
"3414","2428興勤","110/09/07","摩根大通",30,33,-3
"3415","2428興勤","110/09/07","凱基-永康",3,0,3
"3416","2428興勤","110/09/07","凱基-三重",4,7,-3
"3417","2428興勤","110/09/07","合庫-高雄",2,0,2
"3418","2428興勤","110/09/07","凱基-高雄",0,3,-3
"3419","2428興勤","110/09/07","日盛-忠孝",2,0,2
"3420","2428興勤","110/09/07","凱基-松山",4,7,-3
"3421","3176基亞","110/09/07","新加坡商瑞銀",44,4,40
"3422","3176基亞","110/09/07","日盛-忠孝",1,24,-23
"3423","3176基亞","110/09/07","日盛-板橋中山",32,0,32
"3424","3176基亞","110/09/07","富邦-員林",2,14,-12
"3425","3176基亞","110/09/07","美商高盛",18,2,16
"3426","3176基亞","110/09/07","凱基-高美館",0,11,-11
"3427","3176基亞","110/09/07","凱基-屏東",15,0,15
"3428","3176基亞","110/09/07","致和證券",0,10,-10
"3429","3176基亞","110/09/07","摩根大通",19,5,14
"3430","3176基亞","110/09/07","國票-中正",0,10,-10
"3431","3176基亞","110/09/07","富邦-新店",12,0,12
"3432","3176基亞","110/09/07","國票-北投",0,9,-9
"3433","3176基亞","110/09/07","凱基-東門",10,0,10
"3434","3176基亞","110/09/07","新光",1,10,-9
"3435","3176基亞","110/09/07","元大-大雅",10,0,10
"3436","3176基亞","110/09/07","元大-中壢",0,9,-9
"3437","3176基亞","110/09/07","玉山-嘉義",9,0,9
"3438","3176基亞","110/09/07","富邦-高雄",0,8,-8
"3439","3176基亞","110/09/07","元大-新竹經國",9,0,9
"3440","3176基亞","110/09/07","合庫-基隆",0,7,-7
"3441","3176基亞","110/09/07","元大-和平",10,1,9
"3442","3176基亞","110/09/07","國泰-板橋",1,8,-7
"3443","3176基亞","110/09/07","國泰-敦南",8,1,7
"3444","3176基亞","110/09/07","凱基-站前",0,7,-7
"3445","3176基亞","110/09/07","華南永昌-嘉義",6,0,6
"3446","3176基亞","110/09/07","日盛-和美",2,8,-6
"3447","3176基亞","110/09/07","富邦-新竹",6,0,6
"3448","3176基亞","110/09/07","國泰-台中",0,6,-6
"3449","3176基亞","110/09/07","元大-草屯",6,0,6
"3450","3176基亞","110/09/07","合庫-鳳山",0,5,-5
"3451","2409友達","110/09/07","台灣摩根士丹利",31020,10876,20144
"3452","2409友達","110/09/07","瑞士信貸",3123,26453,-23330
"3453","2409友達","110/09/07","永豐金證券",11577,62,11515
"3454","2409友達","110/09/07","華南永昌-南京",72,8467,-8395
"3455","2409友達","110/09/07","元大證券",9263,2104,7159
"3456","2409友達","110/09/07","美商高盛",586,4838,-4252
"3457","2409友達","110/09/07","大昌-桃園",4059,47,4012
"3458","2409友達","110/09/07","美林",6133,8509,-2376
"3459","2409友達","110/09/07","花旗環球",2996,56,2940
"3460","2409友達","110/09/07","港商野村",3918,6196,-2278
"3461","2409友達","110/09/07","國泰證券",2706,449,2257
"3462","2409友達","110/09/07","玉山-高雄",118,1047,-929
"3463","2409友達","110/09/07","摩根大通",5858,4102,1756
"3464","2409友達","110/09/07","元大-館前",53,862,-809
"3465","2409友達","110/09/07","富邦證券",1311,47,1264
"3466","2409友達","110/09/07","港商法國興業",115,765,-650
"3467","2409友達","110/09/07","新加坡商瑞銀",6869,6047,822
"3468","2409友達","110/09/07","玉山證券",198,806,-608
"3469","2409友達","110/09/07","永豐金-台南",849,160,689
"3470","2409友達","110/09/07","元富",2,526,-524
"3471","2409友達","110/09/07","元富-安南",686,102,584
"3472","2409友達","110/09/07","(牛牛牛)亞-鑫豐",170,690,-520
"3473","2409友達","110/09/07","永豐金-中壢",637,53,584
"3474","2409友達","110/09/07","日盛證券",225,683,-458
"3475","2409友達","110/09/07","元大-南屯",725,154,571
"3476","2409友達","110/09/07","元富-城東",51,468,-417
"3477","2409友達","110/09/07","富邦-南屯",570,90,480
"3478","2409友達","110/09/07","台新證券",969,1353,-384
"3479","2409友達","110/09/07","台新-台南",661,200,461
"3480","2409友達","110/09/07","兆豐-忠孝",46,424,-378
"3481","1315達新","110/09/07","日盛-大墩",2,0,2
"3482","1315達新","110/09/07","港商法國興業",0,4,-4
"3483","1315達新","110/09/07","台灣摩根士丹利",3,1,2
"3484","1315達新","110/09/07","元大-文心興安",1,3,-2
"3485","1315達新","110/09/07","元大-花蓮",2,0,2
"3486","1315達新","110/09/07","群益金鼎-古亭",0,2,-2
"3487","1315達新","110/09/07","玉山-新莊",2,0,2
"3488","1315達新","110/09/07","永豐金-台南",0,1,-1
"3489","1315達新","110/09/07","永豐金-南投",1,0,1
"3490","1315達新","110/09/07","元大-新竹經國",0,1,-1
"3491","1315達新","110/09/07","臺銀",1,0,1
"3492","1315達新","110/09/07","元大-景美",0,1,-1
"3493","1315達新","110/09/07","元大-福營",1,0,1
"3494","1315達新","110/09/07","富邦-左營",0,1,-1
"3495","1315達新","110/09/07","富邦-台中",1,0,1
"3496","1315達新","110/09/07","華南永昌",0,1,-1
"3497","1315達新","110/09/07","聯邦-富強",1,0,1
"3498","1315達新","110/09/07","凱基-台北",0,1,-1
"3499","1315達新","110/09/07","新光",1,0,1
"3500","1315達新","110/09/07","元富-世貿",0,1,-1
"3501","1315達新","110/09/07","台新-台中",1,0,1
"3502","1315達新","110/09/07","美林",0,1,-1
"3503","1315達新","110/09/07","新加坡商瑞銀",1,0,1
"3504","1315達新","110/09/07","群益金鼎-台南",0,0,0
"3505","1315達新","110/09/07","國泰-敦南",0,0,0
"3506","1315達新","110/09/07","群益金鼎-士林",0,0,0
"3507","1315達新","110/09/07","群益金鼎-士林",0,0,0
"3508","1315達新","110/09/07","國泰-敦南",0,0,0
"3509","1315達新","110/09/07","群益金鼎-台南",0,0,0
"3510","1315達新","110/09/07","元富-城中",0,0,0
"3511","2609陽明","110/09/07","康和",7261,45,7216
"3512","2609陽明","110/09/07","瑞士信貸",2100,5289,-3189
"3513","2609陽明","110/09/07","凱基-台北",6900,1220,5680
"3514","2609陽明","110/09/07","富邦證券",4313,6250,-1937
"3515","2609陽明","110/09/07","新加坡商瑞銀",3022,307,2715
"3516","2609陽明","110/09/07","華南永昌-竹北",34,688,-654
"3517","2609陽明","110/09/07","永豐金-信義",2164,37,2127
"3518","2609陽明","110/09/07","元大-士林",5347,5967,-620
"3519","2609陽明","110/09/07","福邦-新竹",828,9,819
"3520","2609陽明","110/09/07","玉山證券",636,1209,-573
"3521","2609陽明","110/09/07","元大證券",2539,1912,627
"3522","2609陽明","110/09/07","元大-土城永寧",152,677,-525
"3523","2609陽明","110/09/07","統一-仁愛",1929,1334,595
"3524","2609陽明","110/09/07","兆豐-板橋",446,910,-464
"3525","2609陽明","110/09/07","凱基-竹北",757,192,565
"3526","2609陽明","110/09/07","富邦-仁愛",471,922,-451
"3527","2609陽明","110/09/07","日盛-文化",578,139,439
"3528","2609陽明","110/09/07","台新證券",1959,2389,-430
"3529","2609陽明","110/09/07","凱基-復興",677,255,422
"3530","2609陽明","110/09/07","統一-彰化",119,522,-403
"3531","2609陽明","110/09/07","國票-安和",913,503,410
"3532","2609陽明","110/09/07","元大-北屯",432,833,-401
"3533","2609陽明","110/09/07","永豐金-市政",536,129,407
"3534","2609陽明","110/09/07","永豐金證券",69,449,-380
"3535","2609陽明","110/09/07","兆豐-虎尾",9131,8725,406
"3536","2609陽明","110/09/07","國泰-館前",600,940,-340
"3537","2609陽明","110/09/07","凱基-板橋",431,107,324
"3538","2609陽明","110/09/07","宏遠-高雄",210,526,-316
"3539","2609陽明","110/09/07","摩根大通",6328,6053,275
"3540","2609陽明","110/09/07","新光",2364,2650,-286
"3541","2636台驊投控","110/09/07","統一",532,304,228
"3542","2636台驊投控","110/09/07","瑞士信貸",100,599,-499
"3543","2636台驊投控","110/09/07","凱基-信義",176,4,172
"3544","2636台驊投控","110/09/07","日盛-台中",160,410,-250
"3545","2636台驊投控","110/09/07","元富-嘉義",114,12,102
"3546","2636台驊投控","110/09/07","美林",438,672,-234
"3547","2636台驊投控","110/09/07","兆豐證券",100,0,100
"3548","2636台驊投控","110/09/07","華南永昌-竹北",54,274,-220
"3549","2636台驊投控","110/09/07","兆豐-中壢",98,14,84
"3550","2636台驊投控","110/09/07","摩根大通",875,1090,-215
"3551","2636台驊投控","110/09/07","統一-基隆",147,68,79
"3552","2636台驊投控","110/09/07","台灣摩根士丹利",182,360,-178
"3553","2636台驊投控","110/09/07","日盛-景美",122,60,62
"3554","2636台驊投控","110/09/07","玉山證券",62,190,-128
"3555","2636台驊投控","110/09/07","群益金鼎-竹南",65,4,61
"3556","2636台驊投控","110/09/07","新加坡商瑞銀",78,180,-102
"3557","2636台驊投控","110/09/07","富邦-仁愛",175,122,53
"3558","2636台驊投控","110/09/07","新光",382,451,-69
"3559","2636台驊投控","110/09/07","統一-南京",125,76,49
"3560","2636台驊投控","110/09/07","華南永昌-潮州",1,62,-61
"3561","2636台驊投控","110/09/07","兆豐-南京",61,19,42
"3562","2636台驊投控","110/09/07","日盛證券",96,153,-57
"3563","2636台驊投控","110/09/07","兆豐-三民",61,20,41
"3564","2636台驊投控","110/09/07","凱基-台北",900,956,-56
"3565","2636台驊投控","110/09/07","富邦-虎尾",45,4,41
"3566","2636台驊投控","110/09/07","兆豐-新莊",39,84,-45
"3567","2636台驊投控","110/09/07","元大-南屯",68,27,41
"3568","2636台驊投控","110/09/07","美商高盛",184,228,-44
"3569","2636台驊投控","110/09/07","富邦-台北",90,50,40
"3570","2636台驊投控","110/09/07","統一-新台中",3,38,-35
"3571","2867三商壽","110/09/07","瑞士信貸",329,0,329
"3572","2867三商壽","110/09/07","國泰-台中",5,177,-172
"3573","2867三商壽","110/09/07","美林",187,10,177
"3574","2867三商壽","110/09/07","凱基-中壢",0,140,-140
"3575","2867三商壽","110/09/07","玉山-城中",100,0,100
"3576","2867三商壽","110/09/07","凱基-市府",0,100,-100
"3577","2867三商壽","110/09/07","凱基-台北",70,18,52
"3578","2867三商壽","110/09/07","亞東",0,63,-63
"3579","2867三商壽","110/09/07","聯邦-嘉義",50,0,50
"3580","2867三商壽","110/09/07","摩根大通",17,77,-60
"3581","2867三商壽","110/09/07","華南永昌-台南",50,0,50
"3582","2867三商壽","110/09/07","宏遠-台中",0,55,-55
"3583","2867三商壽","110/09/07","華南永昌-淡水",50,0,50
"3584","2867三商壽","110/09/07","元大-崇德",0,53,-53
"3585","2867三商壽","110/09/07","台灣摩根士丹利",46,7,39
"3586","2867三商壽","110/09/07","統一-台南",0,50,-50
"3587","2867三商壽","110/09/07","臺銀-高雄",31,0,31
"3588","2867三商壽","110/09/07","統一-新竹",0,40,-40
"3589","2867三商壽","110/09/07","日盛-嘉義",30,0,30
"3590","2867三商壽","110/09/07","元富-基隆",0,40,-40
"3591","2867三商壽","110/09/07","富邦-新營",30,0,30
"3592","2867三商壽","110/09/07","統一-屏東",0,30,-30
"3593","2867三商壽","110/09/07","永豐金-北高雄",30,0,30
"3594","2867三商壽","110/09/07","宏遠-中和",0,28,-28
"3595","2867三商壽","110/09/07","國票-九鼎",35,6,29
"3596","2867三商壽","110/09/07","兆豐-桃園",0,26,-26
"3597","2867三商壽","110/09/07","新加坡商瑞銀",26,0,26
"3598","2867三商壽","110/09/07","元大-永春",0,25,-25
"3599","2867三商壽","110/09/07","凱基-興隆",25,0,25
"3600","2867三商壽","110/09/07","元富-古亭",0,22,-22
"3601","5521工信","110/09/07","凱基-台北",1776,1363,413
"3602","5521工信","110/09/07","富邦-台北",3,1100,-1097
"3603","5521工信","110/09/07","台新證券",251,4,247
"3604","5521工信","110/09/07","元富",5,887,-882
"3605","5521工信","110/09/07","國泰-敦南",202,7,195
"3606","5521工信","110/09/07","國票-敦北法人",4,818,-814
"3607","5521工信","110/09/07","玉山-左營",114,0,114
"3608","5521工信","110/09/07","摩根大通",67,535,-468
"3609","5521工信","110/09/07","富邦-敦南",82,0,82
"3610","5521工信","110/09/07","台灣摩根士丹利",5,141,-136
"3611","5521工信","110/09/07","元大-南屯",63,0,63
"3612","5521工信","110/09/07","美商高盛",0,92,-92
"3613","5521工信","110/09/07","元大-淡水",60,8,52
"3614","5521工信","110/09/07","兆豐-北高雄",14,102,-88
"3615","5521工信","110/09/07","台新-新莊",51,0,51
"3616","5521工信","110/09/07","元大-中壢",5,90,-85
"3617","5521工信","110/09/07","合庫-基隆",50,0,50
"3618","5521工信","110/09/07","港商野村",0,72,-72
"3619","5521工信","110/09/07","元富-花蓮",50,0,50
"3620","5521工信","110/09/07","(牛牛牛)亞-鑫豐",24,83,-59
"3621","5521工信","110/09/07","國票-安和",50,0,50
"3622","5521工信","110/09/07","元大-西門",3,62,-59
"3623","5521工信","110/09/07","福勝",49,0,49
"3624","5521工信","110/09/07","國票-中港",0,50,-50
"3625","5521工信","110/09/07","中國信託-三重",48,0,48
"3626","5521工信","110/09/07","元大-崇德",0,44,-44
"3627","5521工信","110/09/07","永豐金-松山",51,3,48
"3628","5521工信","110/09/07","台新-新營",0,30,-30
"3629","5521工信","110/09/07","國泰-台中",55,8,47
"3630","5521工信","110/09/07","凱基-大里",1,31,-30
"3631","1471首利","110/09/07","兆豐-桃園",30,0,30
"3632","1471首利","110/09/07","元大-民雄",0,50,-50
"3633","1471首利","110/09/07","光和-溪湖",21,0,21
"3634","1471首利","110/09/07","凱基-台北",0,30,-30
"3635","1471首利","110/09/07","群益金鼎-海山",29,8,21
"3636","1471首利","110/09/07","永豐金證券",0,30,-30
"3637","1471首利","110/09/07","群益金鼎-土城",20,0,20
"3638","1471首利","110/09/07","元大-西門",0,18,-18
"3639","1471首利","110/09/07","群益金鼎-東門",20,0,20
"3640","1471首利","110/09/07","凱基-科園",0,13,-13
"3641","1471首利","110/09/07","日盛-高雄",18,0,18
"3642","1471首利","110/09/07","元大-台南",0,13,-13
"3643","1471首利","110/09/07","瑞士信貸",18,2,16
"3644","1471首利","110/09/07","元大-基隆孝二",0,11,-11
"3645","1471首利","110/09/07","元大-福營",12,0,12
"3646","1471首利","110/09/07","永豐金-竹科",0,11,-11
"3647","1471首利","110/09/07","元大-竹山",12,0,12
"3648","1471首利","110/09/07","宏遠-館前",0,10,-10
"3649","1471首利","110/09/07","光和",11,0,11
"3650","1471首利","110/09/07","兆豐-西螺",0,10,-10
"3651","1471首利","110/09/07","玉山-左營",11,0,11
"3652","1471首利","110/09/07","富邦-彰化",0,10,-10
"3653","1471首利","110/09/07","摩根大通",40,30,10
"3654","1471首利","110/09/07","元富-同大",2,10,-8
"3655","1471首利","110/09/07","華南永昌-台南",10,0,10
"3656","1471首利","110/09/07","台新-新莊",0,8,-8
"3657","1471首利","110/09/07","富邦-桃園",10,0,10
"3658","1471首利","110/09/07","新光",1,9,-8
"3659","1471首利","110/09/07","元大-文心興安",7,0,7
"3660","1471首利","110/09/07","永豐金-天母",0,8,-8
"3661","2883開發金","110/09/07","瑞士信貸",4415,0,4415
"3662","2883開發金","110/09/07","花旗環球",0,10298,-10298
"3663","2883開發金","110/09/07","新加坡商瑞銀",3882,173,3709
"3664","2883開發金","110/09/07","亞東-新竹",125,1505,-1380
"3665","2883開發金","110/09/07","凱基-台北",2794,633,2161
"3666","2883開發金","110/09/07","國泰證券",2,1001,-999
"3667","2883開發金","110/09/07","台新證券",1137,95,1042
"3668","2883開發金","110/09/07","中國信託-文心",33,444,-411
"3669","2883開發金","110/09/07","國票-長城",1000,0,1000
"3670","2883開發金","110/09/07","新光-桃園",27,426,-399
"3671","2883開發金","110/09/07","臺銀-鳳山",724,106,618
"3672","2883開發金","110/09/07","元富-同大",15,364,-349
"3673","2883開發金","110/09/07","美林",1016,437,579
"3674","2883開發金","110/09/07","華南永昌-林口",20,300,-280
"3675","2883開發金","110/09/07","港商野村",1836,1354,482
"3676","2883開發金","110/09/07","國泰-板橋",144,419,-275
"3677","2883開發金","110/09/07","元大-竹北",323,11,312
"3678","2883開發金","110/09/07","富邦-嘉義",19,275,-256
"3679","2883開發金","110/09/07","群益金鼎-桃園",308,20,288
"3680","2883開發金","110/09/07","永豐金-三重",23,260,-237
"3681","2883開發金","110/09/07","元大-蘆洲",307,23,284
"3682","2883開發金","110/09/07","台灣摩根士丹利",257,476,-219
"3683","2883開發金","110/09/07","統一-彰化",274,20,254
"3684","2883開發金","110/09/07","國票",7,216,-209
"3685","2883開發金","110/09/07","元大-花蓮",278,33,245
"3686","2883開發金","110/09/07","光和",4,212,-208
"3687","2883開發金","110/09/07","富邦-中壢",269,26,243
"3688","2883開發金","110/09/07","(牛牛牛)亞-鑫豐",27,218,-191
"3689","2883開發金","110/09/07","永豐金-苓雅",242,28,214
"3690","2883開發金","110/09/07","元大-民生",5,195,-190
"3691","6205詮欣","110/09/07","玉山-城中",7,0,7
"3692","6205詮欣","110/09/07","德信-新營",0,10,-10
"3693","6205詮欣","110/09/07","臺銀",5,0,5
"3694","6205詮欣","110/09/07","瑞士信貸",0,4,-4
"3695","6205詮欣","110/09/07","臺銀-民權",5,0,5
"3696","6205詮欣","110/09/07","日盛-新莊",0,2,-2
"3697","6205詮欣","110/09/07","日盛-三重",3,0,3
"3698","6205詮欣","110/09/07","富邦-永和",0,2,-2
"3699","6205詮欣","110/09/07","元大-汐止",3,0,3
"3700","6205詮欣","110/09/07","元大-竹北",0,2,-2
"3701","6205詮欣","110/09/07","新加坡商瑞銀",2,0,2
"3702","6205詮欣","110/09/07","元大-忠孝",0,2,-2
"3703","6205詮欣","110/09/07","玉山-新莊",2,0,2
"3704","6205詮欣","110/09/07","日盛-中壢",0,1,-1
"3705","6205詮欣","110/09/07","元富-基隆",1,0,1
"3706","6205詮欣","110/09/07","美林",1,2,-1
"3707","6205詮欣","110/09/07","群益金鼎-士林",1,0,1
"3708","6205詮欣","110/09/07","大慶-蘆洲",0,1,-1
"3709","6205詮欣","110/09/07","凱基-東門",1,0,1
"3710","6205詮欣","110/09/07","元富-潮州",0,1,-1
"3711","6205詮欣","110/09/07","華南永昌-古亭",1,0,1
"3712","6205詮欣","110/09/07","大昌-樹林",0,1,-1
"3713","6205詮欣","110/09/07","元大-南崁",1,0,1
"3714","6205詮欣","110/09/07","致和-崇德",0,1,-1
"3715","6205詮欣","110/09/07","兆豐-景美",1,1,0
"3716","6205詮欣","110/09/07","群益金鼎-館前",0,1,-1
"3717","6205詮欣","110/09/07","",NA,NA,NA
"3718","6205詮欣","110/09/07","凱基-台北",0,1,-1
"3719","6205詮欣","110/09/07","",NA,NA,NA
"3720","6205詮欣","110/09/07","華南永昌-苑裡",0,1,-1
"3721","1540喬福","110/09/07","元富-佳里",9,0,9
"3722","1540喬福","110/09/07","日盛-文化",0,32,-32
"3723","1540喬福","110/09/07","元富-板橋",7,0,7
"3724","1540喬福","110/09/07","日盛-台南",0,7,-7
"3725","1540喬福","110/09/07","日盛-鳳山",6,0,6
"3726","1540喬福","110/09/07","日盛-花蓮",0,3,-3
"3727","1540喬福","110/09/07","日盛-士林",3,0,3
"3728","1540喬福","110/09/07","凱基-台北",0,3,-3
"3729","1540喬福","110/09/07","元大-清水",2,0,2
"3730","1540喬福","110/09/07","日盛-中壢",0,1,-1
"3731","1540喬福","110/09/07","台灣企銀-嘉義",2,0,2
"3732","1540喬福","110/09/07","台新-台中",0,1,-1
"3733","1540喬福","110/09/07","群益金鼎-三民",2,0,2
"3734","1540喬福","110/09/07","富邦-左營",0,1,-1
"3735","1540喬福","110/09/07","台中銀-豐原",2,0,2
"3736","1540喬福","110/09/07","元富",1,1,0
"3737","1540喬福","110/09/07","元富-緯城",2,0,2
"3738","1540喬福","110/09/07","玉山-嘉義",0,0,0
"3739","1540喬福","110/09/07","統一-土城",2,0,2
"3740","1540喬福","110/09/07","群益金鼎-古亭",0,0,0
"3741","1540喬福","110/09/07","兆豐-北高雄",1,0,1
"3742","1540喬福","110/09/07","凱基-竹北",0,0,0
"3743","1540喬福","110/09/07","兆豐-高雄",1,0,1
"3744","1540喬福","110/09/07","凱基-興隆",0,0,0
"3745","1540喬福","110/09/07","台新證券",1,0,1
"3746","1540喬福","110/09/07","華南永昌-高雄",0,0,0
"3747","1540喬福","110/09/07","新光",1,0,1
"3748","1540喬福","110/09/07","",NA,NA,NA
"3749","1540喬福","110/09/07","群益金鼎-館前",1,0,1
"3750","1540喬福","110/09/07","",NA,NA,NA
"3751","2888新光金","110/09/07","瑞士信貸",3114,598,2516
"3752","2888新光金","110/09/07","永豐金證券",27,1084,-1057
"3753","2888新光金","110/09/07","新加坡商瑞銀",850,2,848
"3754","2888新光金","110/09/07","群益金鼎-嘉義",20,897,-877
"3755","2888新光金","110/09/07","日盛-樹林",703,0,703
"3756","2888新光金","110/09/07","永豐金-松山",0,838,-838
"3757","2888新光金","110/09/07","國票-長城",1500,800,700
"3758","2888新光金","110/09/07","永豐金-羅東",0,650,-650
"3759","2888新光金","110/09/07","統一-板橋",866,303,563
"3760","2888新光金","110/09/07","台灣摩根士丹利",194,694,-500
"3761","2888新光金","110/09/07","摩根大通",1147,744,403
"3762","2888新光金","110/09/07","群益金鼎-館前",18,500,-482
"3763","2888新光金","110/09/07","富邦-陽明",475,138,337
"3764","2888新光金","110/09/07","國泰-忠孝",7,486,-479
"3765","2888新光金","110/09/07","美林",515,234,281
"3766","2888新光金","110/09/07","群益金鼎-彰化",50,440,-390
"3767","2888新光金","110/09/07","元大-大雅",275,3,272
"3768","2888新光金","110/09/07","凱基-湖口",0,285,-285
"3769","2888新光金","110/09/07","元大-發財",257,0,257
"3770","2888新光金","110/09/07","日盛-雙和",6,262,-256
"3771","2888新光金","110/09/07","元大-新竹經國",256,2,254
"3772","2888新光金","110/09/07","元富-台中",3,255,-252
"3773","2888新光金","110/09/07","台新-台南",213,1,212
"3774","2888新光金","110/09/07","華南永昌-台中",3,223,-220
"3775","2888新光金","110/09/07","康和-台中",200,0,200
"3776","2888新光金","110/09/07","元富-城東",22,221,-199
"3777","2888新光金","110/09/07","永豐金-彰化",205,10,195
"3778","2888新光金","110/09/07","凱基-高雄",46,244,-198
"3779","2888新光金","110/09/07","凱基-基隆",205,11,194
"3780","2888新光金","110/09/07","凱基-幸福",4,202,-198
"3781","1340勝悅","110/09/07","元大-前金",24,0,24
"3782","1340勝悅","110/09/07","群益金鼎-三重",0,15,-15
"3783","1340勝悅","110/09/07","元富-彰化",6,0,6
"3784","1340勝悅","110/09/07","摩根大通",0,14,-14
"3785","1340勝悅","110/09/07","凱基-台中",6,0,6
"3786","1340勝悅","110/09/07","凱基-台北",0,12,-12
"3787","1340勝悅","110/09/07","美商高盛",3,0,3
"3788","1340勝悅","110/09/07","新光-台中",0,7,-7
"3789","1340勝悅","110/09/07","華南永昌-忠孝",3,0,3
"3790","1340勝悅","110/09/07","日盛-員林",0,5,-5
"3791","1340勝悅","110/09/07","元大-屏南",3,0,3
"3792","1340勝悅","110/09/07","永豐金-苓雅",0,5,-5
"3793","1340勝悅","110/09/07","統一-城中",2,0,2
"3794","1340勝悅","110/09/07","美林",0,3,-3
"3795","1340勝悅","110/09/07","兆豐-新竹",2,0,2
"3796","1340勝悅","110/09/07","群益金鼎-館前",0,3,-3
"3797","1340勝悅","110/09/07","國泰-桃園",2,0,2
"3798","1340勝悅","110/09/07","臺銀-鳳山",0,2,-2
"3799","1340勝悅","110/09/07","富邦-北港",2,0,2
"3800","1340勝悅","110/09/07","富邦-羅東",0,2,-2
"3801","1340勝悅","110/09/07","元大-天母",2,0,2
"3802","1340勝悅","110/09/07","富邦-嘉義",0,2,-2
"3803","1340勝悅","110/09/07","元大-基隆孝二",2,0,2
"3804","1340勝悅","110/09/07","元大-土城永寧",0,2,-2
"3805","1340勝悅","110/09/07","元大-小港",2,0,2
"3806","1340勝悅","110/09/07","元大-豐原站前",0,2,-2
"3807","1340勝悅","110/09/07","永豐金-天母",2,0,2
"3808","1340勝悅","110/09/07","日盛-斗六",0,1,-1
"3809","1340勝悅","110/09/07","國泰-台中",1,0,1
"3810","1340勝悅","110/09/07","元大-金門",0,1,-1
"3811","6246臺龍","110/09/07","台新證券",10,0,10
"3812","6246臺龍","110/09/07","統一-台南",2,18,-16
"3813","6246臺龍","110/09/07","宏遠-館前",8,0,8
"3814","6246臺龍","110/09/07","日盛-木柵",0,10,-10
"3815","6246臺龍","110/09/07","元富-屏東",8,0,8
"3816","6246臺龍","110/09/07","港商野村",0,9,-9
"3817","6246臺龍","110/09/07","日盛-大墩",5,0,5
"3818","6246臺龍","110/09/07","凱基-永和",0,5,-5
"3819","6246臺龍","110/09/07","元富-中港",5,0,5
"3820","6246臺龍","110/09/07","群益金鼎-古亭",0,4,-4
"3821","6246臺龍","110/09/07","凱基-內湖",4,0,4
"3822","6246臺龍","110/09/07","元大-內湖",0,4,-4
"3823","6246臺龍","110/09/07","日盛-八德",3,0,3
"3824","6246臺龍","110/09/07","台新-台南",0,3,-3
"3825","6246臺龍","110/09/07","富邦-新竹",3,0,3
"3826","6246臺龍","110/09/07","日盛-台中",0,2,-2
"3827","6246臺龍","110/09/07","元富-吉利",2,0,2
"3828","6246臺龍","110/09/07","兆豐-桃園",0,2,-2
"3829","6246臺龍","110/09/07","國票-內壢",2,0,2
"3830","6246臺龍","110/09/07","臺銀",0,1,-1
"3831","6246臺龍","110/09/07","國泰-敦南",3,1,2
"3832","6246臺龍","110/09/07","日盛-宜蘭",0,1,-1
"3833","6246臺龍","110/09/07","凱基-高美館",2,0,2
"3834","6246臺龍","110/09/07","元富-新店",0,1,-1
"3835","6246臺龍","110/09/07","元大-發財",2,0,2
"3836","6246臺龍","110/09/07","兆豐-岡山",0,1,-1
"3837","6246臺龍","110/09/07","台中銀-員林",1,0,1
"3838","6246臺龍","110/09/07","新光-高雄",0,1,-1
"3839","6246臺龍","110/09/07","玉山-嘉義",1,0,1
"3840","6246臺龍","110/09/07","玉山-桃園",0,1,-1
"3841","00715L期街口布蘭特正2","110/09/07","永豐金證券",2384,0,2384
"3842","00715L期街口布蘭特正2","110/09/07","新光",0,709,-709
"3843","00715L期街口布蘭特正2","110/09/07","元大證券",2302,0,2302
"3844","00715L期街口布蘭特正2","110/09/07","元大-花蓮",0,601,-601
"3845","00715L期街口布蘭特正2","110/09/07","台新證券",1146,63,1083
"3846","00715L期街口布蘭特正2","110/09/07","永豐金-北高雄",0,550,-550
"3847","00715L期街口布蘭特正2","110/09/07","富邦證券",1095,142,953
"3848","00715L期街口布蘭特正2","110/09/07","元大-萬華",0,360,-360
"3849","00715L期街口布蘭特正2","110/09/07","康和",821,10,811
"3850","00715L期街口布蘭特正2","110/09/07","大昌-樹林",0,345,-345
"3851","00715L期街口布蘭特正2","110/09/07","港商野村",1183,373,810
"3852","00715L期街口布蘭特正2","110/09/07","日盛-和美",0,300,-300
"3853","00715L期街口布蘭特正2","110/09/07","合庫證券",838,118,720
"3854","00715L期街口布蘭特正2","110/09/07","新光-台南",0,238,-238
"3855","00715L期街口布蘭特正2","110/09/07","兆豐-台中",500,0,500
"3856","00715L期街口布蘭特正2","110/09/07","元大-台南",1,218,-217
"3857","00715L期街口布蘭特正2","110/09/07","永豐金-內湖",500,0,500
"3858","00715L期街口布蘭特正2","110/09/07","國泰-敦南",8,223,-215
"3859","00715L期街口布蘭特正2","110/09/07","元大-前金",580,106,474
"3860","00715L期街口布蘭特正2","110/09/07","台新-高雄",34,247,-213
"3861","00715L期街口布蘭特正2","110/09/07","群益金鼎",377,2,375
"3862","00715L期街口布蘭特正2","110/09/07","凱基-桃園",5,206,-201
"3863","00715L期街口布蘭特正2","110/09/07","台新-台中",502,235,267
"3864","00715L期街口布蘭特正2","110/09/07","群益金鼎-土城",0,200,-200
"3865","00715L期街口布蘭特正2","110/09/07","凱基-台北",341,97,244
"3866","00715L期街口布蘭特正2","110/09/07","第一金-台南",0,155,-155
"3867","00715L期街口布蘭特正2","110/09/07","統一",229,0,229
"3868","00715L期街口布蘭特正2","110/09/07","富邦-羅東",1,150,-149
"3869","00715L期街口布蘭特正2","110/09/07","日盛-永康",330,102,228
"3870","00715L期街口布蘭特正2","110/09/07","永豐金-台中",0,140,-140
"3871","8941關中","110/09/07","凱基-市府",2,0,2
"3872","8941關中","110/09/07","彰銀-台中",0,1,-1
"3873","8941關中","110/09/07","臺銀-臺中",1,0,1
"3874","8941關中","110/09/07","統一-台中",0,1,-1
"3875","8941關中","110/09/07","元大-華山",1,0,1
"3876","8941關中","110/09/07","德信-中正",0,1,-1
"3877","8941關中","110/09/07","元大-金華",1,0,1
"3878","8941關中","110/09/07","富邦-仁愛",0,1,-1
"3879","8941關中","110/09/07","",NA,NA,NA
"3880","8941關中","110/09/07","永豐金-中盛",0,1,-1
"3881","8941關中","110/09/07","",NA,NA,NA
"3882","8941關中","110/09/07","",NA,NA,NA
"3883","8941關中","110/09/07","",NA,NA,NA
"3884","8941關中","110/09/07","",NA,NA,NA
"3885","8941關中","110/09/07","",NA,NA,NA
"3886","8941關中","110/09/07","",NA,NA,NA
"3887","8941關中","110/09/07","",NA,NA,NA
"3888","8941關中","110/09/07","",NA,NA,NA
"3889","8941關中","110/09/07","",NA,NA,NA
"3890","8941關中","110/09/07","",NA,NA,NA
"3891","8941關中","110/09/07","",NA,NA,NA
"3892","8941關中","110/09/07","",NA,NA,NA
"3893","8941關中","110/09/07","",NA,NA,NA
"3894","8941關中","110/09/07","",NA,NA,NA
"3895","8941關中","110/09/07","",NA,NA,NA
"3896","8941關中","110/09/07","",NA,NA,NA
"3897","8941關中","110/09/07","",NA,NA,NA
"3898","8941關中","110/09/07","",NA,NA,NA
"3899","8941關中","110/09/07","",NA,NA,NA
"3900","8941關中","110/09/07","",NA,NA,NA
"3901","8936國統","110/09/07","永豐金-忠孝",40,0,40
"3902","8936國統","110/09/07","永豐金-高雄",0,100,-100
"3903","8936國統","110/09/07","富邦-岡山",38,0,38
"3904","8936國統","110/09/07","元富-林園",5,63,-58
"3905","8936國統","110/09/07","凱基-台北",91,55,36
"3906","8936國統","110/09/07","新加坡商瑞銀",3,48,-45
"3907","8936國統","110/09/07","中國信託-高雄",43,14,29
"3908","8936國統","110/09/07","華南永昌-高雄",48,90,-42
"3909","8936國統","110/09/07","日盛-三重",16,0,16
"3910","8936國統","110/09/07","瑞士信貸",0,41,-41
"3911","8936國統","110/09/07","元大-敦南",16,0,16
"3912","8936國統","110/09/07","台灣摩根士丹利",0,36,-36
"3913","8936國統","110/09/07","元大-員林",14,0,14
"3914","8936國統","110/09/07","美商高盛",3,33,-30
"3915","8936國統","110/09/07","富邦-台北",16,3,13
"3916","8936國統","110/09/07","玉山-桃園",0,30,-30
"3917","8936國統","110/09/07","永豐金-彰化",13,0,13
"3918","8936國統","110/09/07","摩根大通",43,72,-29
"3919","8936國統","110/09/07","日盛-和美",21,9,12
"3920","8936國統","110/09/07","港商野村",3,31,-28
"3921","8936國統","110/09/07","新光-台中",23,11,12
"3922","8936國統","110/09/07","元富-三重",0,28,-28
"3923","8936國統","110/09/07","第一金-安和",11,1,10
"3924","8936國統","110/09/07","統一",0,20,-20
"3925","8936國統","110/09/07","元富-敦南",10,0,10
"3926","8936國統","110/09/07","元富-中原",0,20,-20
"3927","8936國統","110/09/07","台新證券",12,2,10
"3928","8936國統","110/09/07","兆豐-新竹",0,20,-20
"3929","8936國統","110/09/07","元大-土城學府",10,0,10
"3930","8936國統","110/09/07","永豐金-竹科",0,20,-20
"3931","6226光鼎","110/09/07","美商高盛",463,26,437
"3932","6226光鼎","110/09/07","(牛牛牛)亞-鑫豐",4,109,-105
"3933","6226光鼎","110/09/07","瑞士信貸",252,0,252
"3934","6226光鼎","110/09/07","玉山-桃園",6,99,-93
"3935","6226光鼎","110/09/07","美林",376,166,210
"3936","6226光鼎","110/09/07","新光",16,77,-61
"3937","6226光鼎","110/09/07","凱基-台北",232,77,155
"3938","6226光鼎","110/09/07","臺銀-臺南",1,61,-60
"3939","6226光鼎","110/09/07","摩根大通",146,69,77
"3940","6226光鼎","110/09/07","元富-城中",1,60,-59
"3941","6226光鼎","110/09/07","群益金鼎-開元",51,1,50
"3942","6226光鼎","110/09/07","合庫-鳳山",1,57,-56
"3943","6226光鼎","110/09/07","新加坡商瑞銀",77,31,46
"3944","6226光鼎","110/09/07","凱基-內湖",1,56,-55
"3945","6226光鼎","110/09/07","元大-小港",48,3,45
"3946","6226光鼎","110/09/07","元大-新營",9,63,-54
"3947","6226光鼎","110/09/07","港商野村",215,179,36
"3948","6226光鼎","110/09/07","永豐金-苓雅",14,65,-51
"3949","6226光鼎","110/09/07","華南永昌-小港",33,0,33
"3950","6226光鼎","110/09/07","元大-松山",0,50,-50
"3951","6226光鼎","110/09/07","群益金鼎-竹南",41,9,32
"3952","6226光鼎","110/09/07","凱基-站前",0,47,-47
"3953","6226光鼎","110/09/07","華南永昌-大安",50,20,30
"3954","6226光鼎","110/09/07","中國信託-永康",1,45,-44
"3955","6226光鼎","110/09/07","永豐金-大園",40,11,29
"3956","6226光鼎","110/09/07","華南永昌-台中",5,48,-43
"3957","6226光鼎","110/09/07","國票-台南",27,0,27
"3958","6226光鼎","110/09/07","台灣企銀",0,40,-40
"3959","6226光鼎","110/09/07","富邦-桃園",25,0,25
"3960","6226光鼎","110/09/07","玉山-大里",1,41,-40
"3961","2363矽統","110/09/07","第一金-桃園",822,65,757
"3962","2363矽統","110/09/07","美林",1897,4225,-2328
"3963","2363矽統","110/09/07","統一-敦南",581,41,540
"3964","2363矽統","110/09/07","凱基-台北",2281,3707,-1426
"3965","2363矽統","110/09/07","新光",1339,821,518
"3966","2363矽統","110/09/07","美商高盛",576,1921,-1345
"3967","2363矽統","110/09/07","國泰-敦南",1624,1311,313
"3968","2363矽統","110/09/07","新加坡商瑞銀",512,1442,-930
"3969","2363矽統","110/09/07","富邦-仁愛",405,181,224
"3970","2363矽統","110/09/07","日盛-南京",37,904,-867
"3971","2363矽統","110/09/07","永豐金-中壢",230,13,217
"3972","2363矽統","110/09/07","台灣摩根士丹利",16,873,-857
"3973","2363矽統","110/09/07","富隆-長安",204,1,203
"3974","2363矽統","110/09/07","富邦-北港",58,849,-791
"3975","2363矽統","110/09/07","元大-汐止",303,106,197
"3976","2363矽統","110/09/07","統一",165,954,-789
"3977","2363矽統","110/09/07","元大-佳里",240,44,196
"3978","2363矽統","110/09/07","永豐金證券",132,879,-747
"3979","2363矽統","110/09/07","玉山-台中",257,63,194
"3980","2363矽統","110/09/07","港商野村",493,972,-479
"3981","2363矽統","110/09/07","兆豐-三民",230,41,189
"3982","2363矽統","110/09/07","元大證券",824,1298,-474
"3983","2363矽統","110/09/07","凱基-虎尾",192,15,177
"3984","2363矽統","110/09/07","統一-士林",244,699,-455
"3985","2363矽統","110/09/07","統一-南京",221,57,164
"3986","2363矽統","110/09/07","陽信-石牌",367,764,-397
"3987","2363矽統","110/09/07","台新-台中",549,390,159
"3988","2363矽統","110/09/07","群益金鼎-敦南",32,316,-284
"3989","2363矽統","110/09/07","永豐金-南投",208,49,159
"3990","2363矽統","110/09/07","凱基-信義",11,289,-278
"3991","8112至上","110/09/07","瑞士信貸",501,0,501
"3992","8112至上","110/09/07","台灣摩根士丹利",34,322,-288
"3993","8112至上","110/09/07","華南永昌-虎尾",100,0,100
"3994","8112至上","110/09/07","元大-信義",0,285,-285
"3995","8112至上","110/09/07","國票-南京",85,0,85
"3996","8112至上","110/09/07","凱基-長庚",0,112,-112
"3997","8112至上","110/09/07","凱基-市政",85,0,85
"3998","8112至上","110/09/07","新光-新竹",23,130,-107
"3999","8112至上","110/09/07","元大-北成功",71,1,70
"4000","8112至上","110/09/07","新光-台中",6,89,-83
"4001","8112至上","110/09/07","統一-中壢",60,2,58
"4002","8112至上","110/09/07","兆豐-來福",0,70,-70
"4003","8112至上","110/09/07","台新-新營",57,0,57
"4004","8112至上","110/09/07","(牛牛牛)亞-鑫豐",5,55,-50
"4005","8112至上","110/09/07","元大-士林",57,0,57
"4006","8112至上","110/09/07","群益金鼎-內湖",0,50,-50
"4007","8112至上","110/09/07","凱基-高雄",51,0,51
"4008","8112至上","110/09/07","華南永昌-淡水",0,41,-41
"4009","8112至上","110/09/07","元大-員林中山",51,0,51
"4010","8112至上","110/09/07","亞東",0,40,-40
"4011","8112至上","110/09/07","兆豐-桃園",49,0,49
"4012","8112至上","110/09/07","元大-淡水",1,41,-40
"4013","8112至上","110/09/07","富邦-仁愛",48,1,47
"4014","8112至上","110/09/07","新光-台南",13,52,-39
"4015","8112至上","110/09/07","永豐金-高雄",50,5,45
"4016","8112至上","110/09/07","凱基-台北",159,198,-39
"4017","8112至上","110/09/07","大展-台南",40,0,40
"4018","8112至上","110/09/07","港商野村",3,40,-37
"4019","8112至上","110/09/07","新光",51,20,31
"4020","8112至上","110/09/07","美林",52,88,-36
"4021","1570力肯","110/09/07","國票-和平",114,0,114
"4022","1570力肯","110/09/07","群益金鼎-中壢",10,52,-42
"4023","1570力肯","110/09/07","群益金鼎-東湖",17,0,17
"4024","1570力肯","110/09/07","凱基-市政",0,30,-30
"4025","1570力肯","110/09/07","元大-草屯",10,0,10
"4026","1570力肯","110/09/07","台新證券",0,22,-22
"4027","1570力肯","110/09/07","元大-北三重",10,0,10
"4028","1570力肯","110/09/07","凱基-高美館",0,20,-20
"4029","1570力肯","110/09/07","兆豐-天母",5,0,5
"4030","1570力肯","110/09/07","凱基-台北",0,9,-9
"4031","1570力肯","110/09/07","兆豐-員林",5,0,5
"4032","1570力肯","110/09/07","摩根大通",4,12,-8
"4033","1570力肯","110/09/07","群益金鼎-民權",5,0,5
"4034","1570力肯","110/09/07","元富-民權",0,6,-6
"4035","1570力肯","110/09/07","元大-福營",3,0,3
"4036","1570力肯","110/09/07","元大-館前",0,5,-5
"4037","1570力肯","110/09/07","日盛-八德",2,0,2
"4038","1570力肯","110/09/07","新光",1,5,-4
"4039","1570力肯","110/09/07","永豐金-苓雅",2,0,2
"4040","1570力肯","110/09/07","元大-龍潭",0,4,-4
"4041","1570力肯","110/09/07","合庫證券",1,0,1
"4042","1570力肯","110/09/07","元富-西松",0,3,-3
"4043","1570力肯","110/09/07","美林",1,0,1
"4044","1570力肯","110/09/07","國泰-館前",0,3,-3
"4045","1570力肯","110/09/07","元富-新店",1,0,1
"4046","1570力肯","110/09/07","元大-竹北",0,3,-3
"4047","1570力肯","110/09/07","中國信託",1,0,1
"4048","1570力肯","110/09/07","元大-新盛",0,3,-3
"4049","1570力肯","110/09/07","福邦證券",1,0,1
"4050","1570力肯","110/09/07","兆豐-台中港",0,2,-2
"4051","2929淘帝","110/09/07","元富-板橋",30,0,30
"4052","2929淘帝","110/09/07","統一-員林",0,20,-20
"4053","2929淘帝","110/09/07","摩根大通",13,3,10
"4054","2929淘帝","110/09/07","凱基-長庚",0,13,-13
"4055","2929淘帝","110/09/07","新光-台中",14,5,9
"4056","2929淘帝","110/09/07","陽信-石牌",0,11,-11
"4057","2929淘帝","110/09/07","臺銀-民權",5,0,5
"4058","2929淘帝","110/09/07","元大-前金",0,10,-10
"4059","2929淘帝","110/09/07","群益金鼎-基隆",5,0,5
"4060","2929淘帝","110/09/07","元大-林森",0,10,-10
"4061","2929淘帝","110/09/07","新光-新竹",4,0,4
"4062","2929淘帝","110/09/07","永豐金-敦南",0,8,-8
"4063","2929淘帝","110/09/07","玉山-嘉義",4,0,4
"4064","2929淘帝","110/09/07","美林",2,9,-7
"4065","2929淘帝","110/09/07","合庫-高雄",3,0,3
"4066","2929淘帝","110/09/07","兆豐-大同",3,10,-7
"4067","2929淘帝","110/09/07","元富-大裕",3,0,3
"4068","2929淘帝","110/09/07","華南永昌-古亭",0,7,-7
"4069","2929淘帝","110/09/07","元富-世貿",3,0,3
"4070","2929淘帝","110/09/07","元大-竹科",0,6,-6
"4071","2929淘帝","110/09/07","(牛牛牛)亞-鑫豐",3,0,3
"4072","2929淘帝","110/09/07","港商野村",1,6,-5
"4073","2929淘帝","110/09/07","凱基-豐中",3,0,3
"4074","2929淘帝","110/09/07","兆豐-桃鶯",2,5,-3
"4075","2929淘帝","110/09/07","富邦-建國",3,0,3
"4076","2929淘帝","110/09/07","群益金鼎-敦南",0,3,-3
"4077","2929淘帝","110/09/07","富邦-嘉義",3,0,3
"4078","2929淘帝","110/09/07","元大-復北",0,3,-3
"4079","2929淘帝","110/09/07","元大-太平",3,0,3
"4080","2929淘帝","110/09/07","元大-蘆洲",0,3,-3
"4081","5410國眾","110/09/07","華南永昌-高雄",30,0,30
"4082","5410國眾","110/09/07","元大-學甲",0,19,-19
"4083","5410國眾","110/09/07","元大-中壢",17,0,17
"4084","5410國眾","110/09/07","新光-台中",1,16,-15
"4085","5410國眾","110/09/07","元大-東泰",10,0,10
"4086","5410國眾","110/09/07","日盛-屏東",0,10,-10
"4087","5410國眾","110/09/07","國泰-松江",6,0,6
"4088","5410國眾","110/09/07","永豐金-中盛",0,10,-10
"4089","5410國眾","110/09/07","新光",5,0,5
"4090","5410國眾","110/09/07","永豐金-復興",0,6,-6
"4091","5410國眾","110/09/07","國泰-台中",3,0,3
"4092","5410國眾","110/09/07","國泰-館前",0,5,-5
"4093","5410國眾","110/09/07","元大-崇德",3,0,3
"4094","5410國眾","110/09/07","元富-嘉義",0,4,-4
"4095","5410國眾","110/09/07","元大-左營",3,0,3
"4096","5410國眾","110/09/07","光和-高雄",0,3,-3
"4097","5410國眾","110/09/07","大昌-安康",2,0,2
"4098","5410國眾","110/09/07","凱基-彰化",0,3,-3
"4099","5410國眾","110/09/07","凱基-南崁",2,0,2
"4100","5410國眾","110/09/07","華南永昌-淡水",0,3,-3
"4101","5410國眾","110/09/07","富邦-永和",2,0,2
"4102","5410國眾","110/09/07","臺銀-臺中",0,2,-2
"4103","5410國眾","110/09/07","永豐金-員林",2,0,2
"4104","5410國眾","110/09/07","元富-板橋",0,2,-2
"4105","5410國眾","110/09/07","永豐金-竹北",2,0,2
"4106","5410國眾","110/09/07","摩根大通",0,2,-2
"4107","5410國眾","110/09/07","日盛-和美",1,0,1
"4108","5410國眾","110/09/07","元大-汐止",0,2,-2
"4109","5410國眾","110/09/07","永豐金-敦南",1,0,1
"4110","5410國眾","110/09/07","永豐金-板橋",0,2,-2
"4111","2841台開","110/09/07","群益金鼎-彰化",50,0,50
"4112","2841台開","110/09/07","港商野村",0,61,-61
"4113","2841台開","110/09/07","富邦-中壢",40,0,40
"4114","2841台開","110/09/07","大慶-蘆洲",0,50,-50
"4115","2841台開","110/09/07","台中銀",32,8,24
"4116","2841台開","110/09/07","兆豐-寶成",0,30,-30
"4117","2841台開","110/09/07","宏遠-館前",20,0,20
"4118","2841台開","110/09/07","光和-高雄",0,21,-21
"4119","2841台開","110/09/07","日盛證券",17,0,17
"4120","2841台開","110/09/07","新加坡商瑞銀",0,14,-14
"4121","2841台開","110/09/07","元大-台中",17,0,17
"4122","2841台開","110/09/07","永豐金-敦南",8,22,-14
"4123","2841台開","110/09/07","元富-中原",16,0,16
"4124","2841台開","110/09/07","北城證券",0,10,-10
"4125","2841台開","110/09/07","元大-南投",16,0,16
"4126","2841台開","110/09/07","群益金鼎-永和",0,10,-10
"4127","2841台開","110/09/07","台灣摩根士丹利",15,0,15
"4128","2841台開","110/09/07","元大-永春",0,10,-10
"4129","2841台開","110/09/07","大昌-安康",15,0,15
"4130","2841台開","110/09/07","永豐金-松山",0,10,-10
"4131","2841台開","110/09/07","日盛-新竹",10,0,10
"4132","2841台開","110/09/07","永豐金-台南",0,10,-10
"4133","2841台開","110/09/07","富邦-南屯",10,0,10
"4134","2841台開","110/09/07","康和-台南",0,9,-9
"4135","2841台開","110/09/07","元大-天母",10,0,10
"4136","2841台開","110/09/07","統一-平鎮",0,7,-7
"4137","2841台開","110/09/07","康和-台北",9,0,9
"4138","2841台開","110/09/07","凱基-宜蘭",0,5,-5
"4139","2841台開","110/09/07","國泰-敦南",6,0,6
"4140","2841台開","110/09/07","元大-府城",0,5,-5
"4141","6207雷科","110/09/07","台新-高雄",101,0,101
"4142","6207雷科","110/09/07","新加坡商瑞銀",6,32,-26
"4143","6207雷科","110/09/07","永全-八德",18,0,18
"4144","6207雷科","110/09/07","合庫-嘉義",0,24,-24
"4145","6207雷科","110/09/07","中國信託-高雄",17,0,17
"4146","6207雷科","110/09/07","群益金鼎-中山",0,20,-20
"4147","6207雷科","110/09/07","群益金鼎-延平",13,0,13
"4148","6207雷科","110/09/07","凱基-台北",22,41,-19
"4149","6207雷科","110/09/07","統一-宜蘭",10,0,10
"4150","6207雷科","110/09/07","國泰-敦南",4,18,-14
"4151","6207雷科","110/09/07","元大-南海",10,0,10
"4152","6207雷科","110/09/07","美商高盛",4,17,-13
"4153","6207雷科","110/09/07","永豐金-敦南",10,0,10
"4154","6207雷科","110/09/07","國票-九鼎",2,14,-12
"4155","6207雷科","110/09/07","統一",9,0,9
"4156","6207雷科","110/09/07","摩根大通",2,13,-11
"4157","6207雷科","110/09/07","元大-高雄",8,0,8
"4158","6207雷科","110/09/07","元大-淡水",1,10,-9
"4159","6207雷科","110/09/07","凱基-中山",7,0,7
"4160","6207雷科","110/09/07","日盛-台中",0,8,-8
"4161","6207雷科","110/09/07","第一金-華江",5,0,5
"4162","6207雷科","110/09/07","港商野村",0,8,-8
"4163","6207雷科","110/09/07","國泰-台中",5,0,5
"4164","6207雷科","110/09/07","元富-潮州",0,8,-8
"4165","6207雷科","110/09/07","群益金鼎-高盛",5,0,5
"4166","6207雷科","110/09/07","富邦-台北",1,9,-8
"4167","6207雷科","110/09/07","日盛-士林",4,0,4
"4168","6207雷科","110/09/07","日盛-三重",0,6,-6
"4169","6207雷科","110/09/07","玉山-大里",4,0,4
"4170","6207雷科","110/09/07","永興",0,6,-6
"4171","3679新至陞","110/09/07","元大-成功",10,0,10
"4172","3679新至陞","110/09/07","摩根大通",0,15,-15
"4173","3679新至陞","110/09/07","凱基-台北",9,0,9
"4174","3679新至陞","110/09/07","美林",0,6,-6
"4175","3679新至陞","110/09/07","華南永昌-古亭",3,0,3
"4176","3679新至陞","110/09/07","元大-北三重",0,5,-5
"4177","3679新至陞","110/09/07","土銀-和平",4,2,2
"4178","3679新至陞","110/09/07","康和-高雄",0,4,-4
"4179","3679新至陞","110/09/07","第一金-忠孝",2,0,2
"4180","3679新至陞","110/09/07","美商高盛",0,3,-3
"4181","3679新至陞","110/09/07","元富-緯城",2,0,2
"4182","3679新至陞","110/09/07","港商野村",0,3,-3
"4183","3679新至陞","110/09/07","台中銀-員林",2,0,2
"4184","3679新至陞","110/09/07","台新證券",0,3,-3
"4185","3679新至陞","110/09/07","國票-台東",2,0,2
"4186","3679新至陞","110/09/07","玉山-台大",0,3,-3
"4187","3679新至陞","110/09/07","玉山-台中",2,0,2
"4188","3679新至陞","110/09/07","彰銀",0,2,-2
"4189","3679新至陞","110/09/07","玉山-新竹",2,0,2
"4190","3679新至陞","110/09/07","宏遠-中和",0,2,-2
"4191","3679新至陞","110/09/07","凱基-市政",2,0,2
"4192","3679新至陞","110/09/07","新加坡商瑞銀",0,2,-2
"4193","3679新至陞","110/09/07","元大-土城",2,0,2
"4194","3679新至陞","110/09/07","統一-士林",0,2,-2
"4195","3679新至陞","110/09/07","元大-淡水",2,0,2
"4196","3679新至陞","110/09/07","兆豐-鹿港",0,2,-2
"4197","3679新至陞","110/09/07","元大-板橋",2,0,2
"4198","3679新至陞","110/09/07","群益金鼎-三重",0,2,-2
"4199","3679新至陞","110/09/07","元大-景美",1,0,1
"4200","3679新至陞","110/09/07","華南永昌-麻豆",0,2,-2
"4201","2727王品","110/09/07","兆豐-新莊",60,0,60
"4202","2727王品","110/09/07","港商法國興業",0,45,-45
"4203","2727王品","110/09/07","摩根大通",84,27,57
"4204","2727王品","110/09/07","港商野村",15,51,-36
"4205","2727王品","110/09/07","台灣摩根士丹利",44,2,42
"4206","2727王品","110/09/07","華南永昌-鳳山",3,32,-29
"4207","2727王品","110/09/07","華南永昌-長虹",30,0,30
"4208","2727王品","110/09/07","美商高盛",24,49,-25
"4209","2727王品","110/09/07","瑞士信貸",29,0,29
"4210","2727王品","110/09/07","凱基-五股",0,24,-24
"4211","2727王品","110/09/07","日盛-南京",20,0,20
"4212","2727王品","110/09/07","群益金鼎-新店",0,21,-21
"4213","2727王品","110/09/07","元大-北屯",20,1,19
"4214","2727王品","110/09/07","新光-新竹",2,19,-17
"4215","2727王品","110/09/07","永豐金-中盛",16,0,16
"4216","2727王品","110/09/07","彰銀-台中",3,19,-16
"4217","2727王品","110/09/07","國泰-台中",18,3,15
"4218","2727王品","110/09/07","大慶-苗栗",0,13,-13
"4219","2727王品","110/09/07","元大-台中中港",15,1,14
"4220","2727王品","110/09/07","國泰-板橋",1,14,-13
"4221","2727王品","110/09/07","新加坡商瑞銀",11,0,11
"4222","2727王品","110/09/07","元大證券",45,58,-13
"4223","2727王品","110/09/07","德信",10,0,10
"4224","2727王品","110/09/07","富邦-板橋",1,13,-12
"4225","2727王品","110/09/07","台新證券",12,2,10
"4226","2727王品","110/09/07","日盛-大墩",0,11,-11
"4227","2727王品","110/09/07","凱基-中山",9,0,9
"4228","2727王品","110/09/07","統一",3,14,-11
"4229","2727王品","110/09/07","富邦-仁愛",8,2,6
"4230","2727王品","110/09/07","凱基-板橋",4,15,-11
"4231","1570力肯","110/09/07","國票-和平",114,0,114
"4232","1570力肯","110/09/07","群益金鼎-中壢",10,52,-42
"4233","1570力肯","110/09/07","群益金鼎-東湖",17,0,17
"4234","1570力肯","110/09/07","凱基-市政",0,30,-30
"4235","1570力肯","110/09/07","元大-草屯",10,0,10
"4236","1570力肯","110/09/07","台新證券",0,22,-22
"4237","1570力肯","110/09/07","元大-北三重",10,0,10
"4238","1570力肯","110/09/07","凱基-高美館",0,20,-20
"4239","1570力肯","110/09/07","兆豐-天母",5,0,5
"4240","1570力肯","110/09/07","凱基-台北",0,9,-9
"4241","1570力肯","110/09/07","兆豐-員林",5,0,5
"4242","1570力肯","110/09/07","摩根大通",4,12,-8
"4243","1570力肯","110/09/07","群益金鼎-民權",5,0,5
"4244","1570力肯","110/09/07","元富-民權",0,6,-6
"4245","1570力肯","110/09/07","元大-福營",3,0,3
"4246","1570力肯","110/09/07","元大-館前",0,5,-5
"4247","1570力肯","110/09/07","日盛-八德",2,0,2
"4248","1570力肯","110/09/07","新光",1,5,-4
"4249","1570力肯","110/09/07","永豐金-苓雅",2,0,2
"4250","1570力肯","110/09/07","元大-龍潭",0,4,-4
"4251","1570力肯","110/09/07","合庫證券",1,0,1
"4252","1570力肯","110/09/07","元富-西松",0,3,-3
"4253","1570力肯","110/09/07","美林",1,0,1
"4254","1570力肯","110/09/07","國泰-館前",0,3,-3
"4255","1570力肯","110/09/07","元富-新店",1,0,1
"4256","1570力肯","110/09/07","元大-竹北",0,3,-3
"4257","1570力肯","110/09/07","中國信託",1,0,1
"4258","1570力肯","110/09/07","元大-新盛",0,3,-3
"4259","1570力肯","110/09/07","福邦證券",1,0,1
"4260","1570力肯","110/09/07","兆豐-台中港",0,2,-2
"4261","6180橘子","110/09/07","永豐金-中盛",24,0,24
"4262","6180橘子","110/09/07","兆豐-北高雄",0,100,-100
"4263","6180橘子","110/09/07","美商高盛",20,1,19
"4264","6180橘子","110/09/07","元大-旗山",0,29,-29
"4265","6180橘子","110/09/07","摩根大通",16,5,11
"4266","6180橘子","110/09/07","統一-高雄",0,15,-15
"4267","6180橘子","110/09/07","第一金-中山",10,0,10
"4268","6180橘子","110/09/07","高橋",0,11,-11
"4269","6180橘子","110/09/07","元富-大裕",10,0,10
"4270","6180橘子","110/09/07","台中銀-員林",0,10,-10
"4271","6180橘子","110/09/07","亞東-新竹",9,0,9
"4272","6180橘子","110/09/07","群益金鼎-彰化",1,11,-10
"4273","6180橘子","110/09/07","美林",7,0,7
"4274","6180橘子","110/09/07","凱基-永康",0,10,-10
"4275","6180橘子","110/09/07","港商野村",9,2,7
"4276","6180橘子","110/09/07","元大-中和",0,10,-10
"4277","6180橘子","110/09/07","凱基-嘉義",7,0,7
"4278","6180橘子","110/09/07","台新-新營",0,7,-7
"4279","6180橘子","110/09/07","凱基-台北",20,13,7
"4280","6180橘子","110/09/07","國泰-板橋",0,7,-7
"4281","6180橘子","110/09/07","華南永昌-古亭",8,1,7
"4282","6180橘子","110/09/07","凱基-中港",0,6,-6
"4283","6180橘子","110/09/07","台新-左楠",6,0,6
"4284","6180橘子","110/09/07","日盛-樹林",0,5,-5
"4285","6180橘子","110/09/07","新光",10,4,6
"4286","6180橘子","110/09/07","大慶-楊梅",0,5,-5
"4287","6180橘子","110/09/07","富邦-陽明",6,0,6
"4288","6180橘子","110/09/07","新光-高雄",0,5,-5
"4289","6180橘子","110/09/07","國泰-敦南",7,2,5
"4290","6180橘子","110/09/07","元大-清水",1,6,-5
"4291","2390云辰","110/09/07","摩根大通",794,259,535
"4292","2390云辰","110/09/07","統一-新台中",6,205,-199
"4293","2390云辰","110/09/07","美林",275,113,162
"4294","2390云辰","110/09/07","新加坡商瑞銀",26,193,-167
"4295","2390云辰","110/09/07","元富-安南",113,10,103
"4296","2390云辰","110/09/07","元大證券",2,142,-140
"4297","2390云辰","110/09/07","國票-中和",86,6,80
"4298","2390云辰","110/09/07","元大-土城學府",83,208,-125
"4299","2390云辰","110/09/07","台灣摩根士丹利",157,86,71
"4300","2390云辰","110/09/07","新光-台中",30,152,-122
"4301","2390云辰","110/09/07","富邦-竹北",68,0,68
"4302","2390云辰","110/09/07","凱基-長庚",3,110,-107
"4303","2390云辰","110/09/07","國泰-板橋",87,21,66
"4304","2390云辰","110/09/07","元大-松山",8,108,-100
"4305","2390云辰","110/09/07","凱基-台北",179,125,54
"4306","2390云辰","110/09/07","日盛-新莊",6,104,-98
"4307","2390云辰","110/09/07","國泰-館前",46,10,36
"4308","2390云辰","110/09/07","新光",58,125,-67
"4309","2390云辰","110/09/07","富邦-仁愛",40,5,35
"4310","2390云辰","110/09/07","群益金鼎-民權",1,52,-51
"4311","2390云辰","110/09/07","永豐金-南投",63,28,35
"4312","2390云辰","110/09/07","富邦-宜蘭",8,56,-48
"4313","2390云辰","110/09/07","統一-彰化",34,2,32
"4314","2390云辰","110/09/07","元大-頭份",6,52,-46
"4315","2390云辰","110/09/07","國票-博愛",157,126,31
"4316","2390云辰","110/09/07","玉山-左營",3,46,-43
"4317","2390云辰","110/09/07","台新-台中",62,32,30
"4318","2390云辰","110/09/07","兆豐-寶成",2,43,-41
"4319","2390云辰","110/09/07","元大-松江",34,4,30
"4320","2390云辰","110/09/07","新光-桃園",16,57,-41
"4321","2834臺企銀","110/09/06","凱基-台北",22144,15172,6972
"4322","2834臺企銀","110/09/06","港商法國興業",0,4885,-4885
"4323","2834臺企銀","110/09/06","美商高盛",2346,481,1865
"4324","2834臺企銀","110/09/06","永豐金-中和",20,2832,-2812
"4325","2834臺企銀","110/09/06","摩根大通",2015,398,1617
"4326","2834臺企銀","110/09/06","新加坡商瑞銀",738,2933,-2195
"4327","2834臺企銀","110/09/06","富邦-南屯",1605,465,1140
"4328","2834臺企銀","110/09/06","國票-長城",50,2000,-1950
"4329","2834臺企銀","110/09/06","新光",1309,213,1096
"4330","2834臺企銀","110/09/06","台灣摩根士丹利",208,1932,-1724
"4331","2834臺企銀","110/09/06","富邦-建國",1122,126,996
"4332","2834臺企銀","110/09/06","瑞士信貸",439,1649,-1210
"4333","2834臺企銀","110/09/06","美林",1410,419,991
"4334","2834臺企銀","110/09/06","凱基-板橋",13,1016,-1003
"4335","2834臺企銀","110/09/06","日盛-二林",674,40,634
"4336","2834臺企銀","110/09/06","兆豐-天母",0,1000,-1000
"4337","2834臺企銀","110/09/06","元大-高雄",658,40,618
"4338","2834臺企銀","110/09/06","日盛證券",39,932,-893
"4339","2834臺企銀","110/09/06","元大-竹南",602,10,592
"4340","2834臺企銀","110/09/06","富邦-新竹",54,856,-802
"4341","2834臺企銀","110/09/06","富邦-陽明",532,5,527
"4342","2834臺企銀","110/09/06","玉山-嘉義",123,882,-759
"4343","2834臺企銀","110/09/06","(牛牛牛)亞-鑫豐",807,297,510
"4344","2834臺企銀","110/09/06","富邦-板橋",117,736,-619
"4345","2834臺企銀","110/09/06","統一-三重",503,21,482
"4346","2834臺企銀","110/09/06","永豐金-敦北",56,611,-555
"4347","2834臺企銀","110/09/06","永豐金-彰化",414,5,409
"4348","2834臺企銀","110/09/06","台新-中壢",33,569,-536
"4349","2834臺企銀","110/09/06","凱基-林口",412,4,408
"4350","2834臺企銀","110/09/06","元大-中壢",96,612,-516
"4351","5511德昌","110/09/06","統一-士林",26,0,26
"4352","5511德昌","110/09/06","寶盛",0,19,-19
"4353","5511德昌","110/09/06","國票-九鼎",20,0,20
"4354","5511德昌","110/09/06","日盛-南京",0,5,-5
"4355","5511德昌","110/09/06","台中銀-豐原",8,0,8
"4356","5511德昌","110/09/06","統一-新竹",0,5,-5
"4357","5511德昌","110/09/06","元富-安南",5,0,5
"4358","5511德昌","110/09/06","兆豐-公益",0,5,-5
"4359","5511德昌","110/09/06","元富-文心",1,0,1
"4360","5511德昌","110/09/06","康和-內湖",0,4,-4
"4361","5511德昌","110/09/06","凱基-台北",1,0,1
"4362","5511德昌","110/09/06","永豐金-天母",0,3,-3
"4363","5511德昌","110/09/06","富邦-台北",1,0,1
"4364","5511德昌","110/09/06","富邦-仁愛",0,3,-3
"4365","5511德昌","110/09/06","彰銀-台中",0,0,0
"4366","5511德昌","110/09/06","致和-崇德",0,3,-3
"4367","5511德昌","110/09/06","康和-板橋",0,0,0
"4368","5511德昌","110/09/06","永豐金-新店",0,2,-2
"4369","5511德昌","110/09/06","國泰-台中",1,1,0
"4370","5511德昌","110/09/06","(牛牛牛)亞-鑫豐",0,2,-2
"4371","5511德昌","110/09/06","群益金鼎-台中",0,0,0
"4372","5511德昌","110/09/06","日盛-復興",0,2,-2
"4373","5511德昌","110/09/06","群益金鼎-鳳山",0,0,0
"4374","5511德昌","110/09/06","日盛-斗六",0,2,-2
"4375","5511德昌","110/09/06","華南永昌-大安",0,0,0
"4376","5511德昌","110/09/06","元富-虎尾",0,1,-1
"4377","5511德昌","110/09/06","永豐金-萬盛",0,0,0
"4378","5511德昌","110/09/06","臺銀-臺中",0,1,-1
"4379","5511德昌","110/09/06","",NA,NA,NA
"4380","5511德昌","110/09/06","土銀-台中",0,1,-1
"4381","2489瑞軒","110/09/06","台灣企銀-屏東",110,0,110
"4382","2489瑞軒","110/09/06","摩根大通",82,437,-355
"4383","2489瑞軒","110/09/06","元富-文心",106,0,106
"4384","2489瑞軒","110/09/06","元大-士林",0,150,-150
"4385","2489瑞軒","110/09/06","康和-台中",102,3,99
"4386","2489瑞軒","110/09/06","瑞士信貸",81,227,-146
"4387","2489瑞軒","110/09/06","元大-清水",91,0,91
"4388","2489瑞軒","110/09/06","台灣摩根士丹利",18,158,-140
"4389","2489瑞軒","110/09/06","凱基-桃園",84,0,84
"4390","2489瑞軒","110/09/06","凱基-台北",79,213,-134
"4391","2489瑞軒","110/09/06","華南永昌-虎尾",123,40,83
"4392","2489瑞軒","110/09/06","元大-豐原",1,134,-133
"4393","2489瑞軒","110/09/06","元大-淡水",76,0,76
"4394","2489瑞軒","110/09/06","群益金鼎-大安",0,130,-130
"4395","2489瑞軒","110/09/06","合庫-桃園",50,2,48
"4396","2489瑞軒","110/09/06","美商高盛",53,154,-101
"4397","2489瑞軒","110/09/06","新光",51,8,43
"4398","2489瑞軒","110/09/06","富邦-新竹",3,102,-99
"4399","2489瑞軒","110/09/06","永豐金-大園",41,0,41
"4400","2489瑞軒","110/09/06","元大-歸仁",2,100,-98
"4401","2489瑞軒","110/09/06","中國信託-新竹",50,13,37
"4402","2489瑞軒","110/09/06","兆豐-公益",3,89,-86
"4403","2489瑞軒","110/09/06","大昌-桃園",40,3,37
"4404","2489瑞軒","110/09/06","華南永昌-忠孝",0,60,-60
"4405","2489瑞軒","110/09/06","凱基-長庚",37,0,37
"4406","2489瑞軒","110/09/06","元大-南屯",0,60,-60
"4407","2489瑞軒","110/09/06","合庫-台南",35,0,35
"4408","2489瑞軒","110/09/06","元大-彰化",1,60,-59
"4409","2489瑞軒","110/09/06","元大-大天母",35,0,35
"4410","2489瑞軒","110/09/06","港商野村",95,147,-52
"4411","2428興勤","110/09/06","統一-桃園",68,0,68
"4412","2428興勤","110/09/06","美商高盛",4,36,-32
"4413","2428興勤","110/09/06","日盛-新竹",13,2,11
"4414","2428興勤","110/09/06","美林",1,27,-26
"4415","2428興勤","110/09/06","新加坡商瑞銀",18,8,10
"4416","2428興勤","110/09/06","富邦-台北",0,24,-24
"4417","2428興勤","110/09/06","元富-新竹",6,0,6
"4418","2428興勤","110/09/06","統一",0,21,-21
"4419","2428興勤","110/09/06","凱基-三重",7,1,6
"4420","2428興勤","110/09/06","富邦-敦南",0,20,-20
"4421","2428興勤","110/09/06","臺銀",5,0,5
"4422","2428興勤","110/09/06","摩根大通",10,28,-18
"4423","2428興勤","110/09/06","兆豐-公益",6,1,5
"4424","2428興勤","110/09/06","凱基-台北",1,18,-17
"4425","2428興勤","110/09/06","元大-金華",5,0,5
"4426","2428興勤","110/09/06","瑞士信貸",2,15,-13
"4427","2428興勤","110/09/06","日盛-景美",4,0,4
"4428","2428興勤","110/09/06","永豐金-南投",0,6,-6
"4429","2428興勤","110/09/06","兆豐-大安",4,0,4
"4430","2428興勤","110/09/06","日盛證券",0,4,-4
"4431","2428興勤","110/09/06","日盛-樹林",3,0,3
"4432","2428興勤","110/09/06","國泰證券",0,4,-4
"4433","2428興勤","110/09/06","(牛牛牛)亞-鑫豐",4,1,3
"4434","2428興勤","110/09/06","凱基-民權",0,4,-4
"4435","2428興勤","110/09/06","凱基-復興",3,0,3
"4436","2428興勤","110/09/06","元大-左營",0,3,-3
"4437","2428興勤","110/09/06","華南永昌-古亭",3,0,3
"4438","2428興勤","110/09/06","永豐金-敦南",0,3,-3
"4439","2428興勤","110/09/06","元大-東泰",3,0,3
"4440","2428興勤","110/09/06","港商野村",11,13,-2
"4441","3176基亞","110/09/06","元大-土城永寧",34,0,34
"4442","3176基亞","110/09/06","臺銀",0,27,-27
"4443","3176基亞","110/09/06","元大-新竹經國",16,0,16
"4444","3176基亞","110/09/06","台中銀",0,20,-20
"4445","3176基亞","110/09/06","元大-小港",15,0,15
"4446","3176基亞","110/09/06","群益金鼎-板橋",0,17,-17
"4447","3176基亞","110/09/06","群益金鼎-中壢",15,1,14
"4448","3176基亞","110/09/06","元大-汐止",0,16,-16
"4449","3176基亞","110/09/06","日盛-文化",10,0,10
"4450","3176基亞","110/09/06","第一金-路竹",0,13,-13
"4451","3176基亞","110/09/06","大慶-富順",10,0,10
"4452","3176基亞","110/09/06","永豐金證券",3,15,-12
"4453","3176基亞","110/09/06","凱基-文心",10,0,10
"4454","3176基亞","110/09/06","華南永昌-民權",0,11,-11
"4455","3176基亞","110/09/06","永豐金-北高雄",10,0,10
"4456","3176基亞","110/09/06","宏遠-館前",0,10,-10
"4457","3176基亞","110/09/06","兆豐-忠孝",10,1,9
"4458","3176基亞","110/09/06","國票-台中",0,8,-8
"4459","3176基亞","110/09/06","玉山證券",7,0,7
"4460","3176基亞","110/09/06","元大-樹林",0,8,-8
"4461","3176基亞","110/09/06","國泰-板橋",7,0,7
"4462","3176基亞","110/09/06","日盛-樹林",0,6,-6
"4463","3176基亞","110/09/06","日盛-台南",6,1,5
"4464","3176基亞","110/09/06","玉山-士林",1,7,-6
"4465","3176基亞","110/09/06","元富-高雄",5,0,5
"4466","3176基亞","110/09/06","第一金-高雄",0,5,-5
"4467","3176基亞","110/09/06","元富-緯城",5,0,5
"4468","3176基亞","110/09/06","國泰-敦南",1,6,-5
"4469","3176基亞","110/09/06","華南永昌",5,0,5
"4470","3176基亞","110/09/06","元大-永春",0,5,-5
"4471","2409友達","110/09/06","瑞士信貸",22305,4023,18282
"4472","2409友達","110/09/06","台灣摩根士丹利",4953,28009,-23056
"4473","2409友達","110/09/06","永豐金證券",11529,746,10783
"4474","2409友達","110/09/06","凱基-苗栗",64,5070,-5006
"4475","2409友達","110/09/06","美商高盛",11094,2003,9091
"4476","2409友達","110/09/06","香港上海匯豐",93,4000,-3907
"4477","2409友達","110/09/06","摩根大通",11082,2196,8886
"4478","2409友達","110/09/06","花旗環球",1520,4800,-3280
"4479","2409友達","110/09/06","港商野村",11674,3314,8360
"4480","2409友達","110/09/06","元大-六合",222,3118,-2896
"4481","2409友達","110/09/06","美林",8993,3556,5437
"4482","2409友達","110/09/06","玉山-台中",154,1649,-1495
"4483","2409友達","110/09/06","新加坡商瑞銀",6748,2579,4169
"4484","2409友達","110/09/06","中國信託-嘉義",751,2006,-1255
"4485","2409友達","110/09/06","凱基-台北",7933,3867,4066
"4486","2409友達","110/09/06","宏遠證券",46,1269,-1223
"4487","2409友達","110/09/06","日盛證券",2936,262,2674
"4488","2409友達","110/09/06","國泰-敦南",891,2106,-1215
"4489","2409友達","110/09/06","合庫證券",1221,113,1108
"4490","2409友達","110/09/06","台灣企銀-台南",104,1212,-1108
"4491","2409友達","110/09/06","華南永昌-忠孝",503,3,500
"4492","2409友達","110/09/06","元大證券",2581,3599,-1018
"4493","2409友達","110/09/06","(牛牛牛)亞-鑫豐",687,198,489
"4494","2409友達","110/09/06","光和-溪湖",110,1080,-970
"4495","2409友達","110/09/06","永豐金-內湖",484,45,439
"4496","2409友達","110/09/06","元富",215,1130,-915
"4497","2409友達","110/09/06","元大-開元",497,101,396
"4498","2409友達","110/09/06","凱基-中山",654,1540,-886
"4499","2409友達","110/09/06","富邦-台北",522,188,334
"4500","2409友達","110/09/06","第一金-桃園",102,826,-724
"4501","1315達新","110/09/06","元大-文心興安",13,0,13
"4502","1315達新","110/09/06","美林",0,14,-14
"4503","1315達新","110/09/06","凱基-中港",10,0,10
"4504","1315達新","110/09/06","永豐金-高雄",0,14,-14
"4505","1315達新","110/09/06","日盛-大墩",4,0,4
"4506","1315達新","110/09/06","日盛-頭份",0,5,-5
"4507","1315達新","110/09/06","富邦-員林",3,0,3
"4508","1315達新","110/09/06","台新證券",1,5,-4
"4509","1315達新","110/09/06","台灣摩根士丹利",2,0,2
"4510","1315達新","110/09/06","元富-新竹",0,2,-2
"4511","1315達新","110/09/06","統一-彰化",2,0,2
"4512","1315達新","110/09/06","富邦-三重",0,2,-2
"4513","1315達新","110/09/06","摩根大通",2,0,2
"4514","1315達新","110/09/06","光和-溪湖",0,1,-1
"4515","1315達新","110/09/06","陽信-石牌",1,0,1
"4516","1315達新","110/09/06","群益金鼎-古亭",1,2,-1
"4517","1315達新","110/09/06","永豐金-古亭",1,0,1
"4518","1315達新","110/09/06","群益金鼎-建成",0,1,-1
"4519","1315達新","110/09/06","元大-太平",1,0,1
"4520","1315達新","110/09/06","元大-基隆孝二",0,1,-1
"4521","1315達新","110/09/06","元大-斗六",1,0,1
"4522","1315達新","110/09/06","永豐金-竹北",0,1,-1
"4523","1315達新","110/09/06","台新-高雄",1,0,1
"4524","1315達新","110/09/06","新光",0,0,0
"4525","1315達新","110/09/06","大展",1,0,1
"4526","1315達新","110/09/06","國泰-台中",0,0,0
"4527","1315達新","110/09/06","新加坡商瑞銀",1,0,1
"4528","1315達新","110/09/06","群益金鼎-士林",0,0,0
"4529","1315達新","110/09/06","彰銀-台中",1,0,1
"4530","1315達新","110/09/06","元大證券",0,0,0
"4531","2609陽明","110/09/06","瑞士信貸",7108,111,6997
"4532","2609陽明","110/09/06","凱基-台北",1502,4648,-3146
"4533","2609陽明","110/09/06","兆豐-虎尾",1704,6,1698
"4534","2609陽明","110/09/06","兆豐-北高雄",180,1631,-1451
"4535","2609陽明","110/09/06","台灣摩根士丹利",994,35,959
"4536","2609陽明","110/09/06","康和",534,1807,-1273
"4537","2609陽明","110/09/06","新加坡商瑞銀",1424,521,903
"4538","2609陽明","110/09/06","華南永昌",347,1439,-1092
"4539","2609陽明","110/09/06","美林",3107,2252,855
"4540","2609陽明","110/09/06","元大-西門",110,1062,-952
"4541","2609陽明","110/09/06","摩根大通",5471,4742,729
"4542","2609陽明","110/09/06","凱基-復興",1344,2244,-900
"4543","2609陽明","110/09/06","元大-士林",7870,7332,538
"4544","2609陽明","110/09/06","日盛證券",201,718,-517
"4545","2609陽明","110/09/06","元大-土城永寧",623,114,509
"4546","2609陽明","110/09/06","元大-開元",106,607,-501
"4547","2609陽明","110/09/06","凱基-虎尾",439,28,411
"4548","2609陽明","110/09/06","合庫-高雄",82,545,-463
"4549","2609陽明","110/09/06","美商高盛",700,304,396
"4550","2609陽明","110/09/06","永豐金-復興",66,527,-461
"4551","2609陽明","110/09/06","新光-新竹",814,428,386
"4552","2609陽明","110/09/06","華南永昌-斗六",45,465,-420
"4553","2609陽明","110/09/06","國泰-松江",641,259,382
"4554","2609陽明","110/09/06","玉山-嘉義",128,539,-411
"4555","2609陽明","110/09/06","永豐金證券",599,234,365
"4556","2609陽明","110/09/06","群益金鼎",229,637,-408
"4557","2609陽明","110/09/06","華南永昌-虎尾",370,58,312
"4558","2609陽明","110/09/06","統一-仁愛",1055,1440,-385
"4559","2609陽明","110/09/06","新光",2047,1803,244
"4560","2609陽明","110/09/06","元大-東蘆",182,551,-369
"4561","2636台驊投控","110/09/06","台灣摩根士丹利",776,2,774
"4562","2636台驊投控","110/09/06","元大證券",64,244,-180
"4563","2636台驊投控","110/09/06","凱基-復興",705,103,602
"4564","2636台驊投控","110/09/06","元大-龍潭",7,146,-139
"4565","2636台驊投控","110/09/06","瑞士信貸",607,29,578
"4566","2636台驊投控","110/09/06","華南永昌-潮州",4,109,-105
"4567","2636台驊投控","110/09/06","富邦證券",479,22,457
"4568","2636台驊投控","110/09/06","兆豐證券",0,102,-102
"4569","2636台驊投控","110/09/06","美林",503,180,323
"4570","2636台驊投控","110/09/06","新光",172,266,-94
"4571","2636台驊投控","110/09/06","美商高盛",395,117,278
"4572","2636台驊投控","110/09/06","元大-北成功",2,96,-94
"4573","2636台驊投控","110/09/06","摩根大通",731,475,256
"4574","2636台驊投控","110/09/06","臺銀-高雄",8,80,-72
"4575","2636台驊投控","110/09/06","日盛-台中",274,23,251
"4576","2636台驊投控","110/09/06","國泰-敦南",88,149,-61
"4577","2636台驊投控","110/09/06","統一",337,150,187
"4578","2636台驊投控","110/09/06","凱基-高雄",2,59,-57
"4579","2636台驊投控","110/09/06","新加坡商瑞銀",225,57,168
"4580","2636台驊投控","110/09/06","元富-文心",6,60,-54
"4581","2636台驊投控","110/09/06","元大-南屯",81,6,75
"4582","2636台驊投控","110/09/06","台新證券",52,104,-52
"4583","2636台驊投控","110/09/06","凱基-台北",465,391,74
"4584","2636台驊投控","110/09/06","康和-延平",1,49,-48
"4585","2636台驊投控","110/09/06","群益金鼎-台南",73,43,30
"4586","2636台驊投控","110/09/06","玉山-嘉義",11,57,-46
"4587","2636台驊投控","110/09/06","凱基-竹科",31,4,27
"4588","2636台驊投控","110/09/06","元大-豐原站前",6,49,-43
"4589","2636台驊投控","110/09/06","元富-安南",23,4,19
"4590","2636台驊投控","110/09/06","群益金鼎-竹南",0,42,-42
"4591","2867三商壽","110/09/06","美林",487,0,487
"4592","2867三商壽","110/09/06","新光",39,343,-304
"4593","2867三商壽","110/09/06","摩根大通",389,5,384
"4594","2867三商壽","110/09/06","元大-桃園",150,450,-300
"4595","2867三商壽","110/09/06","台新證券",319,7,312
"4596","2867三商壽","110/09/06","新光-新竹",0,222,-222
"4597","2867三商壽","110/09/06","永豐金-松山",210,0,210
"4598","2867三商壽","110/09/06","元大-永春",1,150,-149
"4599","2867三商壽","110/09/06","台灣摩根士丹利",237,43,194
"4600","2867三商壽","110/09/06","新光-高雄",0,105,-105
"4601","2867三商壽","110/09/06","凱基-台北",332,166,166
"4602","2867三商壽","110/09/06","元富-大昌",0,94,-94
"4603","2867三商壽","110/09/06","國票-台南",150,0,150
"4604","2867三商壽","110/09/06","港商野村",0,72,-72
"4605","2867三商壽","110/09/06","凱基-永和",100,0,100
"4606","2867三商壽","110/09/06","元大-中壢",0,53,-53
"4607","2867三商壽","110/09/06","華南永昌-虎尾",90,0,90
"4608","2867三商壽","110/09/06","臺銀-民權",0,50,-50
"4609","2867三商壽","110/09/06","大昌-新店",79,0,79
"4610","2867三商壽","110/09/06","兆豐-鹿港",0,50,-50
"4611","2867三商壽","110/09/06","新加坡商瑞銀",59,0,59
"4612","2867三商壽","110/09/06","元大-八德",0,50,-50
"4613","2867三商壽","110/09/06","統一-平鎮",50,0,50
"4614","2867三商壽","110/09/06","玉山-板橋",1,45,-44
"4615","2867三商壽","110/09/06","永豐金-市政",50,1,49
"4616","2867三商壽","110/09/06","新光-台中",25,68,-43
"4617","2867三商壽","110/09/06","永豐金-永康",48,0,48
"4618","2867三商壽","110/09/06","第一金-路竹",0,32,-32
"4619","2867三商壽","110/09/06","元大-豐原",41,0,41
"4620","2867三商壽","110/09/06","元大-博愛",0,32,-32
"4621","5521工信","110/09/06","元富",427,0,427
"4622","5521工信","110/09/06","日進",14,2000,-1986
"4623","5521工信","110/09/06","國票-敦北法人",412,0,412
"4624","5521工信","110/09/06","元大-成功",0,560,-560
"4625","5521工信","110/09/06","永豐金-松山",373,0,373
"4626","5521工信","110/09/06","華南永昌-民權",0,421,-421
"4627","5521工信","110/09/06","美林",203,2,201
"4628","5521工信","110/09/06","元大-南投",1,260,-259
"4629","5521工信","110/09/06","台新證券",237,45,192
"4630","5521工信","110/09/06","凱基-台北",277,474,-197
"4631","5521工信","110/09/06","群益金鼎-台中",188,0,188
"4632","5521工信","110/09/06","群益金鼎-大甲",0,185,-185
"4633","5521工信","110/09/06","元大-南屯",132,0,132
"4634","5521工信","110/09/06","富邦-敦南",3,146,-143
"4635","5521工信","110/09/06","台中銀",109,0,109
"4636","5521工信","110/09/06","中國信託-三重",23,129,-106
"4637","5521工信","110/09/06","凱基-中山",102,0,102
"4638","5521工信","110/09/06","凱基-松山",2,102,-100
"4639","5521工信","110/09/06","合庫-台中",98,0,98
"4640","5521工信","110/09/06","國泰-敦南",87,179,-92
"4641","5521工信","110/09/06","(牛牛牛)亞-鑫豐",118,20,98
"4642","5521工信","110/09/06","元大-內湖",3,65,-62
"4643","5521工信","110/09/06","元富-大昌",100,5,95
"4644","5521工信","110/09/06","永興-大墩",0,57,-57
"4645","5521工信","110/09/06","玉山-板橋",91,0,91
"4646","5521工信","110/09/06","合庫-彰化",0,41,-41
"4647","5521工信","110/09/06","美商高盛",105,15,90
"4648","5521工信","110/09/06","福勝",9,50,-41
"4649","5521工信","110/09/06","華南永昌",84,10,74
"4650","5521工信","110/09/06","元富-台南",0,40,-40
"4651","1471首利","110/09/06","摩根大通",119,52,67
"4652","1471首利","110/09/06","第一金-路竹",0,96,-96
"4653","1471首利","110/09/06","新光",40,0,40
"4654","1471首利","110/09/06","元大-內湖",0,55,-55
"4655","1471首利","110/09/06","台新-松江",37,0,37
"4656","1471首利","110/09/06","永興-水湳",0,50,-50
"4657","1471首利","110/09/06","元大-鳳山",31,0,31
"4658","1471首利","110/09/06","元富-埔里",0,40,-40
"4659","1471首利","110/09/06","日盛-新莊",30,0,30
"4660","1471首利","110/09/06","宏遠-光隆",0,24,-24
"4661","1471首利","110/09/06","日盛-大墩",28,0,28
"4662","1471首利","110/09/06","大昌",0,24,-24
"4663","1471首利","110/09/06","合庫-基隆",20,0,20
"4664","1471首利","110/09/06","台中銀",0,20,-20
"4665","1471首利","110/09/06","凱基-八德",20,0,20
"4666","1471首利","110/09/06","永豐金-中和",0,20,-20
"4667","1471首利","110/09/06","兆豐-桃園",24,5,19
"4668","1471首利","110/09/06","兆豐-寶成",0,18,-18
"4669","1471首利","110/09/06","永豐金-忠孝",16,0,16
"4670","1471首利","110/09/06","凱基-台北",0,18,-18
"4671","1471首利","110/09/06","國泰-敦南",20,7,13
"4672","1471首利","110/09/06","元大-新店中正",0,17,-17
"4673","1471首利","110/09/06","永豐金-鳳山",13,0,13
"4674","1471首利","110/09/06","國泰-台中",7,20,-13
"4675","1471首利","110/09/06","元富-民權",12,0,12
"4676","1471首利","110/09/06","凱基-和平",0,13,-13
"4677","1471首利","110/09/06","日盛-景美",10,0,10
"4678","1471首利","110/09/06","統一-新台中",1,13,-12
"4679","1471首利","110/09/06","日盛-南京",10,0,10
"4680","1471首利","110/09/06","元大-東蘆",0,12,-12
"4681","2883開發金","110/09/06","摩根大通",1695,359,1336
"4682","2883開發金","110/09/06","台灣摩根士丹利",431,9656,-9225
"4683","2883開發金","110/09/06","凱基-台北",1946,939,1007
"4684","2883開發金","110/09/06","國泰證券",136,1401,-1265
"4685","2883開發金","110/09/06","新光-台中",839,33,806
"4686","2883開發金","110/09/06","合庫-自強",42,800,-758
"4687","2883開發金","110/09/06","亞東-新竹",1356,600,756
"4688","2883開發金","110/09/06","華南永昌-東昇",25,705,-680
"4689","2883開發金","110/09/06","元大-林森",704,20,684
"4690","2883開發金","110/09/06","兆豐-台中港",31,663,-632
"4691","2883開發金","110/09/06","富邦-花蓮",478,103,375
"4692","2883開發金","110/09/06","富邦-建國",72,617,-545
"4693","2883開發金","110/09/06","臺銀-鳳山",355,9,346
"4694","2883開發金","110/09/06","港商麥格理",0,416,-416
"4695","2883開發金","110/09/06","統一-彰化",344,13,331
"4696","2883開發金","110/09/06","永豐金-中正",43,392,-349
"4697","2883開發金","110/09/06","富邦-中壢",331,12,319
"4698","2883開發金","110/09/06","元大-民雄",4,348,-344
"4699","2883開發金","110/09/06","玉山-大里",332,15,317
"4700","2883開發金","110/09/06","美林",0,316,-316
"4701","2883開發金","110/09/06","統一-新營",281,0,281
"4702","2883開發金","110/09/06","凱基-復興",9,317,-308
"4703","2883開發金","110/09/06","元大-大益",245,5,240
"4704","2883開發金","110/09/06","元大-四維",10,318,-308
"4705","2883開發金","110/09/06","元富-花蓮",253,20,233
"4706","2883開發金","110/09/06","元大-竹南",39,320,-281
"4707","2883開發金","110/09/06","元大-頭份",218,0,218
"4708","2883開發金","110/09/06","瑞士信貸",8,260,-252
"4709","2883開發金","110/09/06","永豐金證券",229,20,209
"4710","2883開發金","110/09/06","台新-三民",18,232,-214
"4711","6205詮欣","110/09/06","摩根大通",14,0,14
"4712","6205詮欣","110/09/06","元大-雙和",1,44,-43
"4713","6205詮欣","110/09/06","臺銀",10,0,10
"4714","6205詮欣","110/09/06","德信",0,10,-10
"4715","6205詮欣","110/09/06","元富-宜蘭",10,0,10
"4716","6205詮欣","110/09/06","兆豐-南京",0,6,-6
"4717","6205詮欣","110/09/06","元大-南投",10,0,10
"4718","6205詮欣","110/09/06","美林",1,6,-5
"4719","6205詮欣","110/09/06","玉山-城中",9,0,9
"4720","6205詮欣","110/09/06","瑞士信貸",0,3,-3
"4721","6205詮欣","110/09/06","永豐金-中正",9,0,9
"4722","6205詮欣","110/09/06","新光-桃園",0,3,-3
"4723","6205詮欣","110/09/06","凱基-汐止",5,0,5
"4724","6205詮欣","110/09/06","凱基-天母",0,3,-3
"4725","6205詮欣","110/09/06","臺銀-民權",3,0,3
"4726","6205詮欣","110/09/06","元大-竹科",0,3,-3
"4727","6205詮欣","110/09/06","元富-成功",3,0,3
"4728","6205詮欣","110/09/06","德信-新營",0,2,-2
"4729","6205詮欣","110/09/06","玉山-雙和",2,0,2
"4730","6205詮欣","110/09/06","群益金鼎-新莊",0,2,-2
"4731","6205詮欣","110/09/06","元大-西門",2,0,2
"4732","6205詮欣","110/09/06","富邦-陽明",1,3,-2
"4733","6205詮欣","110/09/06","元大-汐止",2,0,2
"4734","6205詮欣","110/09/06","元大-博愛",0,2,-2
"4735","6205詮欣","110/09/06","永豐金證券",2,0,2
"4736","6205詮欣","110/09/06","富邦-嘉義",0,1,-1
"4737","6205詮欣","110/09/06","第一金-大稻埕",1,0,1
"4738","6205詮欣","110/09/06","元大-西螺",0,1,-1
"4739","6205詮欣","110/09/06","華南永昌-古亭",1,0,1
"4740","6205詮欣","110/09/06","康和-板橋",0,0,0
"4741","1540喬福","110/09/06","凱基-興隆",10,0,10
"4742","1540喬福","110/09/06","台新證券",0,10,-10
"4743","1540喬福","110/09/06","致和證券",4,0,4
"4744","1540喬福","110/09/06","國票-彰化",0,3,-3
"4745","1540喬福","110/09/06","元大-四維",1,0,1
"4746","1540喬福","110/09/06","元大證券",0,2,-2
"4747","1540喬福","110/09/06","元大-太平",1,0,1
"4748","1540喬福","110/09/06","凱基-文心",0,2,-2
"4749","1540喬福","110/09/06","兆豐-高雄",1,0,1
"4750","1540喬福","110/09/06","永豐金-中盛",0,1,-1
"4751","1540喬福","110/09/06","玉山-台南",1,0,1
"4752","1540喬福","110/09/06","永豐金證券",0,1,-1
"4753","1540喬福","110/09/06","凱基-復興",1,0,1
"4754","1540喬福","110/09/06","美林",0,1,-1
"4755","1540喬福","110/09/06","合庫-台南",1,0,1
"4756","1540喬福","110/09/06","國泰-松江",0,0,0
"4757","1540喬福","110/09/06","國泰-松江",0,0,0
"4758","1540喬福","110/09/06","富邦-新店",0,0,0
"4759","1540喬福","110/09/06","富邦-新店",0,0,0
"4760","1540喬福","110/09/06","群益金鼎-館前",0,0,0
"4761","1540喬福","110/09/06","群益金鼎-館前",0,0,0
"4762","1540喬福","110/09/06","群益金鼎-北高雄",0,0,0
"4763","1540喬福","110/09/06","群益金鼎-北高雄",0,0,0
"4764","1540喬福","110/09/06","國泰-敦南",0,0,0
"4765","1540喬福","110/09/06","國泰-敦南",0,0,0
"4766","1540喬福","110/09/06","國泰-台中",0,0,0
"4767","1540喬福","110/09/06","國泰-台中",0,0,0
"4768","1540喬福","110/09/06","玉山-雙和",0,0,0
"4769","1540喬福","110/09/06","玉山-雙和",0,0,0
"4770","1540喬福","110/09/06","統一-士林",0,0,0
"4771","2888新光金","110/09/06","瑞士信貸",1045,87,958
"4772","2888新光金","110/09/06","永豐金-板橋",110,2037,-1927
"4773","2888新光金","110/09/06","凱基-台北",1359,568,791
"4774","2888新光金","110/09/06","彰銀",20,680,-660
"4775","2888新光金","110/09/06","富邦-花蓮",900,129,771
"4776","2888新光金","110/09/06","港商法國興業",62,704,-642
"4777","2888新光金","110/09/06","國票-長城",801,43,758
"4778","2888新光金","110/09/06","致和證券",10,600,-590
"4779","2888新光金","110/09/06","新加坡商瑞銀",739,39,700
"4780","2888新光金","110/09/06","(牛牛牛)亞-鑫豐",42,589,-547
"4781","2888新光金","110/09/06","元大-鹿港",513,5,508
"4782","2888新光金","110/09/06","兆豐-鹿港",61,604,-543
"4783","2888新光金","110/09/06","台新證券",514,51,463
"4784","2888新光金","110/09/06","元大-新莊",34,533,-499
"4785","2888新光金","110/09/06","台灣摩根士丹利",634,179,455
"4786","2888新光金","110/09/06","光和-溪湖",20,491,-471
"4787","2888新光金","110/09/06","元大-彰化民生",458,7,451
"4788","2888新光金","110/09/06","台新-三民",1,345,-344
"4789","2888新光金","110/09/06","華南永昌-小港",452,6,446
"4790","2888新光金","110/09/06","美商高盛",265,600,-335
"4791","2888新光金","110/09/06","國票-南京",400,0,400
"4792","2888新光金","110/09/06","中國信託-高雄",7,323,-316
"4793","2888新光金","110/09/06","統一-板橋",448,51,397
"4794","2888新光金","110/09/06","元大-善化",7,312,-305
"4795","2888新光金","110/09/06","兆豐-民生",281,0,281
"4796","2888新光金","110/09/06","群益金鼎-館前",9,311,-302
"4797","2888新光金","110/09/06","兆豐-嘉義",250,2,248
"4798","2888新光金","110/09/06","新百王",101,402,-301
"4799","2888新光金","110/09/06","元大證券",377,146,231
"4800","2888新光金","110/09/06","台新-新營",12,301,-289
"4801","1340勝悅","110/09/06","玉山-新竹",55,0,55
"4802","1340勝悅","110/09/06","元大-忠孝鼎富",0,41,-41
"4803","1340勝悅","110/09/06","華南永昌-公誠",10,0,10
"4804","1340勝悅","110/09/06","凱基-台北",0,13,-13
"4805","1340勝悅","110/09/06","美商高盛",4,1,3
"4806","1340勝悅","110/09/06","日盛證券",0,10,-10
"4807","1340勝悅","110/09/06","國泰-台中",3,0,3
"4808","1340勝悅","110/09/06","美林",0,8,-8
"4809","1340勝悅","110/09/06","群益金鼎-崇德",4,1,3
"4810","1340勝悅","110/09/06","群益金鼎-屏東",0,8,-8
"4811","1340勝悅","110/09/06","日盛-員林",2,0,2
"4812","1340勝悅","110/09/06","國票-台東",0,5,-5
"4813","1340勝悅","110/09/06","元富-宜蘭",2,0,2
"4814","1340勝悅","110/09/06","華南永昌-忠孝",0,5,-5
"4815","1340勝悅","110/09/06","國泰-高雄",4,2,2
"4816","1340勝悅","110/09/06","臺銀-高雄",0,3,-3
"4817","1340勝悅","110/09/06","國泰-板橋",2,0,2
"4818","1340勝悅","110/09/06","群益金鼎-敦南",0,3,-3
"4819","1340勝悅","110/09/06","華南永昌-中正",2,0,2
"4820","1340勝悅","110/09/06","高橋",0,2,-2
"4821","1340勝悅","110/09/06","富邦-嘉義",2,0,2
"4822","1340勝悅","110/09/06","摩根大通",0,2,-2
"4823","1340勝悅","110/09/06","國泰-桃園",1,0,1
"4824","1340勝悅","110/09/06","新光",1,3,-2
"4825","1340勝悅","110/09/06","國泰-敦南",2,1,1
"4826","1340勝悅","110/09/06","永豐金-屏東",0,2,-2
"4827","1340勝悅","110/09/06","群益金鼎-館前",2,1,1
"4828","1340勝悅","110/09/06","元富-新竹",0,1,-1
"4829","1340勝悅","110/09/06","華南永昌-高雄",1,0,1
"4830","1340勝悅","110/09/06","永豐金-台中",0,1,-1
"4831","6246臺龍","110/09/06","統一-台南",16,0,16
"4832","6246臺龍","110/09/06","群益金鼎-古亭",0,13,-13
"4833","6246臺龍","110/09/06","元富-屏東",11,0,11
"4834","6246臺龍","110/09/06","港商野村",0,12,-12
"4835","6246臺龍","110/09/06","台新證券",10,0,10
"4836","6246臺龍","110/09/06","日進",0,9,-9
"4837","6246臺龍","110/09/06","富邦-新竹",10,0,10
"4838","6246臺龍","110/09/06","統一-土城",0,8,-8
"4839","6246臺龍","110/09/06","元大-永康",7,0,7
"4840","6246臺龍","110/09/06","玉山證券",0,6,-6
"4841","6246臺龍","110/09/06","凱基-南崁",5,0,5
"4842","6246臺龍","110/09/06","凱基-台北",0,6,-6
"4843","6246臺龍","110/09/06","宏遠-館前",3,0,3
"4844","6246臺龍","110/09/06","元富-大裕",0,5,-5
"4845","6246臺龍","110/09/06","玉山-板橋",3,0,3
"4846","6246臺龍","110/09/06","光和",0,5,-5
"4847","6246臺龍","110/09/06","群益金鼎-新竹",3,0,3
"4848","6246臺龍","110/09/06","群益金鼎-開元",0,5,-5
"4849","6246臺龍","110/09/06","元大-台中中港",3,0,3
"4850","6246臺龍","110/09/06","元大-西螺",0,5,-5
"4851","6246臺龍","110/09/06","永豐金-中盛",3,0,3
"4852","6246臺龍","110/09/06","台灣企銀",0,4,-4
"4853","6246臺龍","110/09/06","土銀-新竹",2,0,2
"4854","6246臺龍","110/09/06","國泰-新莊",0,3,-3
"4855","6246臺龍","110/09/06","土銀-彰化",2,0,2
"4856","6246臺龍","110/09/06","國泰-敦南",1,4,-3
"4857","6246臺龍","110/09/06","兆豐-鹿港",2,0,2
"4858","6246臺龍","110/09/06","日盛-二林",0,2,-2
"4859","6246臺龍","110/09/06","國票-敦北法人",2,0,2
"4860","6246臺龍","110/09/06","光和-高雄",0,2,-2
"4861","00715L期街口布蘭特正2","110/09/06","永豐金證券",1263,0,1263
"4862","00715L期街口布蘭特正2","110/09/06","元大-敦化",0,1040,-1040
"4863","00715L期街口布蘭特正2","110/09/06","元富-大裕",505,0,505
"4864","00715L期街口布蘭特正2","110/09/06","富邦證券",0,1003,-1003
"4865","00715L期街口布蘭特正2","110/09/06","日盛-新莊",383,22,361
"4866","00715L期街口布蘭特正2","110/09/06","元大-高雄",102,987,-885
"4867","00715L期街口布蘭特正2","110/09/06","兆豐-台中港",351,5,346
"4868","00715L期街口布蘭特正2","110/09/06","永豐金-新店",0,707,-707
"4869","00715L期街口布蘭特正2","110/09/06","日盛-和美",307,8,299
"4870","00715L期街口布蘭特正2","110/09/06","元大-復北",2,520,-518
"4871","00715L期街口布蘭特正2","110/09/06","元大-花蓮",200,0,200
"4872","00715L期街口布蘭特正2","110/09/06","新光-台中",324,761,-437
"4873","00715L期街口布蘭特正2","110/09/06","元富-文心",149,0,149
"4874","00715L期街口布蘭特正2","110/09/06","元大證券",3767,4194,-427
"4875","00715L期街口布蘭特正2","110/09/06","新光-新竹",137,1,136
"4876","00715L期街口布蘭特正2","110/09/06","凱基-站前",0,300,-300
"4877","00715L期街口布蘭特正2","110/09/06","元大-草屯",141,9,132
"4878","00715L期街口布蘭特正2","110/09/06","元大-南崁",0,170,-170
"4879","00715L期街口布蘭特正2","110/09/06","元大-鳳中",119,0,119
"4880","00715L期街口布蘭特正2","110/09/06","港商野村",778,930,-152
"4881","00715L期街口布蘭特正2","110/09/06","康和",110,0,110
"4882","00715L期街口布蘭特正2","110/09/06","凱基-三重",0,150,-150
"4883","00715L期街口布蘭特正2","110/09/06","凱基-竹北",110,0,110
"4884","00715L期街口布蘭特正2","110/09/06","元大-永康",0,142,-142
"4885","00715L期街口布蘭特正2","110/09/06","元大-中和",110,0,110
"4886","00715L期街口布蘭特正2","110/09/06","玉山-嘉義",0,141,-141
"4887","00715L期街口布蘭特正2","110/09/06","大昌-樹林",112,3,109
"4888","00715L期街口布蘭特正2","110/09/06","華南永昌-台中",19,141,-122
"4889","00715L期街口布蘭特正2","110/09/06","日盛-永康",107,0,107
"4890","00715L期街口布蘭特正2","110/09/06","永豐金-桃園",6,118,-112
"4891","8941關中","110/09/06","國泰-新莊",1,0,1
"4892","8941關中","110/09/06","華南永昌-公誠",0,1,-1
"4893","8941關中","110/09/06","凱基-文心",1,0,1
"4894","8941關中","110/09/06","華南永昌-潮州",0,1,-1
"4895","8941關中","110/09/06","彰銀-台中",0,0,0
"4896","8941關中","110/09/06","彰銀-台中",0,0,0
"4897","8941關中","110/09/06","宏遠-館前",0,0,0
"4898","8941關中","110/09/06","宏遠-館前",0,0,0
"4899","8941關中","110/09/06","康和-板橋",0,0,0
"4900","8941關中","110/09/06","康和-板橋",0,0,0
"4901","8941關中","110/09/06","元大-鹿港",0,0,0
"4902","8941關中","110/09/06","元大-鹿港",0,0,0
"4903","8941關中","110/09/06","",NA,NA,NA
"4904","8941關中","110/09/06","",NA,NA,NA
"4905","8941關中","110/09/06","",NA,NA,NA
"4906","8941關中","110/09/06","",NA,NA,NA
"4907","8941關中","110/09/06","",NA,NA,NA
"4908","8941關中","110/09/06","",NA,NA,NA
"4909","8941關中","110/09/06","",NA,NA,NA
"4910","8941關中","110/09/06","",NA,NA,NA
"4911","8941關中","110/09/06","",NA,NA,NA
"4912","8941關中","110/09/06","",NA,NA,NA
"4913","8941關中","110/09/06","",NA,NA,NA
"4914","8941關中","110/09/06","",NA,NA,NA
"4915","8941關中","110/09/06","",NA,NA,NA
"4916","8941關中","110/09/06","",NA,NA,NA
"4917","8941關中","110/09/06","",NA,NA,NA
"4918","8941關中","110/09/06","",NA,NA,NA
"4919","8941關中","110/09/06","",NA,NA,NA
"4920","8941關中","110/09/06","",NA,NA,NA
"4921","8936國統","110/09/06","凱基-台北",178,30,148
"4922","8936國統","110/09/06","永豐金-博愛",0,100,-100
"4923","8936國統","110/09/06","美林",81,0,81
"4924","8936國統","110/09/06","元大-屏東民生",0,86,-86
"4925","8936國統","110/09/06","摩根大通",108,35,73
"4926","8936國統","110/09/06","兆豐-大同",0,46,-46
"4927","8936國統","110/09/06","新加坡商瑞銀",62,36,26
"4928","8936國統","110/09/06","瑞士信貸",0,44,-44
"4929","8936國統","110/09/06","台新-高雄",35,10,25
"4930","8936國統","110/09/06","台灣摩根士丹利",0,40,-40
"4931","8936國統","110/09/06","元大-東泰",30,5,25
"4932","8936國統","110/09/06","元富-緯城",0,40,-40
"4933","8936國統","110/09/06","元富-敦南",24,0,24
"4934","8936國統","110/09/06","美商高盛",10,45,-35
"4935","8936國統","110/09/06","永豐金-忠孝",28,5,23
"4936","8936國統","110/09/06","凱基-高美館",9,37,-28
"4937","8936國統","110/09/06","富邦-建國",21,0,21
"4938","8936國統","110/09/06","兆豐-嘉義",0,25,-25
"4939","8936國統","110/09/06","富邦-中壢",20,1,19
"4940","8936國統","110/09/06","統一-台中",0,22,-22
"4941","8936國統","110/09/06","第一金-新興",17,0,17
"4942","8936國統","110/09/06","元大-承德",0,20,-20
"4943","8936國統","110/09/06","元大-旗山",17,0,17
"4944","8936國統","110/09/06","元大-左營",1,20,-19
"4945","8936國統","110/09/06","兆豐-來福",15,0,15
"4946","8936國統","110/09/06","永豐金-苓雅",2,20,-18
"4947","8936國統","110/09/06","元大-博愛",13,0,13
"4948","8936國統","110/09/06","玉山證券",3,19,-16
"4949","8936國統","110/09/06","元大-桃興",13,0,13
"4950","8936國統","110/09/06","港商野村",10,24,-14
"4951","6226光鼎","110/09/06","富邦-台北",120,6,114
"4952","6226光鼎","110/09/06","凱基-台北",112,220,-108
"4953","6226光鼎","110/09/06","永豐金-大園",72,0,72
"4954","6226光鼎","110/09/06","元大-北成功",2,107,-105
"4955","6226光鼎","110/09/06","瑞士信貸",63,0,63
"4956","6226光鼎","110/09/06","大昌-新店",21,111,-90
"4957","6226光鼎","110/09/06","合庫-鳳山",60,0,60
"4958","6226光鼎","110/09/06","摩根大通",118,200,-82
"4959","6226光鼎","110/09/06","臺銀-臺南",67,9,58
"4960","6226光鼎","110/09/06","華南永昌",11,83,-72
"4961","6226光鼎","110/09/06","國泰-板橋",94,44,50
"4962","6226光鼎","110/09/06","台灣企銀-三民",0,51,-51
"4963","6226光鼎","110/09/06","玉山-士林",46,4,42
"4964","6226光鼎","110/09/06","第一金-光復",13,60,-47
"4965","6226光鼎","110/09/06","永豐金-新莊",38,0,38
"4966","6226光鼎","110/09/06","元大-竹北",2,43,-41
"4967","6226光鼎","110/09/06","土銀-嘉義",34,0,34
"4968","6226光鼎","110/09/06","華南永昌-岡山",0,38,-38
"4969","6226光鼎","110/09/06","群益金鼎-開元",35,2,33
"4970","6226光鼎","110/09/06","富邦-彰化",1,39,-38
"4971","6226光鼎","110/09/06","日盛-大墩",34,2,32
"4972","6226光鼎","110/09/06","日盛-和美",0,35,-35
"4973","6226光鼎","110/09/06","永豐金-台南",49,17,32
"4974","6226光鼎","110/09/06","新光",61,96,-35
"4975","6226光鼎","110/09/06","元大-楊梅",34,3,31
"4976","6226光鼎","110/09/06","凱基-台南",5,40,-35
"4977","6226光鼎","110/09/06","元大-員林",44,13,31
"4978","6226光鼎","110/09/06","港商野村",57,91,-34
"4979","6226光鼎","110/09/06","永豐金證券",32,2,30
"4980","6226光鼎","110/09/06","群益金鼎-新竹",7,41,-34
"4981","2363矽統","110/09/06","合庫-基隆",1471,72,1399
"4982","2363矽統","110/09/06","凱基-松山",1312,10959,-9647
"4983","2363矽統","110/09/06","美林",6969,5651,1318
"4984","2363矽統","110/09/06","統一",1488,4742,-3254
"4985","2363矽統","110/09/06","元大-大里",1591,439,1152
"4986","2363矽統","110/09/06","摩根大通",4294,7186,-2892
"4987","2363矽統","110/09/06","玉山-大里",1189,225,964
"4988","2363矽統","110/09/06","日盛-文化",172,1199,-1027
"4989","2363矽統","110/09/06","國泰-敦南",5341,4502,839
"4990","2363矽統","110/09/06","統一-敦南",499,1515,-1016
"4991","2363矽統","110/09/06","元富-大裕",820,99,721
"4992","2363矽統","110/09/06","凱基-台北",4788,5774,-986
"4993","2363矽統","110/09/06","群益金鼎-敦南",730,205,525
"4994","2363矽統","110/09/06","凱基-大直",61,1043,-982
"4995","2363矽統","110/09/06","元大-佳里",964,440,524
"4996","2363矽統","110/09/06","統一-土城",151,1105,-954
"4997","2363矽統","110/09/06","合庫-高雄",582,81,501
"4998","2363矽統","110/09/06","台灣摩根士丹利",683,1562,-879
"4999","2363矽統","110/09/06","港商野村",714,235,479
"5000","2363矽統","110/09/06","統一-仁愛",306,851,-545
"5001","2363矽統","110/09/06","瑞士信貸",522,59,463
"5002","2363矽統","110/09/06","統一-城中",175,650,-475
"5003","2363矽統","110/09/06","新光-高雄",1086,669,417
"5004","2363矽統","110/09/06","康和",347,811,-464
"5005","2363矽統","110/09/06","合庫-台中",803,394,409
"5006","2363矽統","110/09/06","國票-敦北法人",159,589,-430
"5007","2363矽統","110/09/06","兆豐-板橋",431,37,394
"5008","2363矽統","110/09/06","凱基-復興",82,477,-395
"5009","2363矽統","110/09/06","第一金-新竹",1613,1222,391
"5010","2363矽統","110/09/06","美商高盛",1531,1889,-358
"5011","8112至上","110/09/06","元大-汐止",101,0,101
"5012","8112至上","110/09/06","凱基-敦北",0,201,-201
"5013","8112至上","110/09/06","玉山-桃園",87,0,87
"5014","8112至上","110/09/06","凱基-台北",68,213,-145
"5015","8112至上","110/09/06","群益金鼎-敦南",66,2,64
"5016","8112至上","110/09/06","美林",18,154,-136
"5017","8112至上","110/09/06","合庫證券",62,0,62
"5018","8112至上","110/09/06","大昌-桃園",0,115,-115
"5019","8112至上","110/09/06","宏遠證券",50,0,50
"5020","8112至上","110/09/06","摩根大通",47,150,-103
"5021","8112至上","110/09/06","群益金鼎-內湖",50,0,50
"5022","8112至上","110/09/06","凱基-竹科",2,81,-79
"5023","8112至上","110/09/06","富邦-仁愛",50,6,44
"5024","8112至上","110/09/06","港商野村",16,87,-71
"5025","8112至上","110/09/06","元大-文心",44,0,44
"5026","8112至上","110/09/06","國票-南京",10,80,-70
"5027","8112至上","110/09/06","群益金鼎-高盛",43,0,43
"5028","8112至上","110/09/06","元大-信義",0,65,-65
"5029","8112至上","110/09/06","永豐金-中盛",31,0,31
"5030","8112至上","110/09/06","新加坡商瑞銀",18,82,-64
"5031","8112至上","110/09/06","日盛-大墩",35,6,29
"5032","8112至上","110/09/06","美商高盛",29,75,-46
"5033","8112至上","110/09/06","臺銀",28,1,27
"5034","8112至上","110/09/06","玉山-城中",4,43,-39
"5035","8112至上","110/09/06","元大-善化",26,1,25
"5036","8112至上","110/09/06","(牛牛牛)亞-鑫豐",6,41,-35
"5037","8112至上","110/09/06","兆豐-台中港",26,2,24
"5038","8112至上","110/09/06","台灣摩根士丹利",11,39,-28
"5039","8112至上","110/09/06","統一-南京",21,0,21
"5040","8112至上","110/09/06","中國信託",1,27,-26
"5041","1570力肯","110/09/06","國票-和平",50,0,50
"5042","1570力肯","110/09/06","元大-板橋",1,65,-64
"5043","1570力肯","110/09/06","元大-北三重",36,0,36
"5044","1570力肯","110/09/06","元大-內湖",0,40,-40
"5045","1570力肯","110/09/06","國票-北高雄",23,0,23
"5046","1570力肯","110/09/06","凱基-台北",2,38,-36
"5047","1570力肯","110/09/06","凱基-天母",20,0,20
"5048","1570力肯","110/09/06","宏遠證券",15,50,-35
"5049","1570力肯","110/09/06","元大-員林",20,0,20
"5050","1570力肯","110/09/06","合庫-桃園",0,20,-20
"5051","1570力肯","110/09/06","永豐金-苓雅",20,0,20
"5052","1570力肯","110/09/06","永豐金-中和",0,20,-20
"5053","1570力肯","110/09/06","新光-新竹",12,0,12
"5054","1570力肯","110/09/06","摩根大通",0,18,-18
"5055","1570力肯","110/09/06","元大-莒光",12,0,12
"5056","1570力肯","110/09/06","元大-基隆",0,17,-17
"5057","1570力肯","110/09/06","元大-草屯",12,0,12
"5058","1570力肯","110/09/06","統一-松江",0,16,-16
"5059","1570力肯","110/09/06","兆豐-員林",10,0,10
"5060","1570力肯","110/09/06","聯邦商銀",0,10,-10
"5061","1570力肯","110/09/06","富邦-新營",10,0,10
"5062","1570力肯","110/09/06","富邦-台南",0,10,-10
"5063","1570力肯","110/09/06","國票-內壢",9,0,9
"5064","1570力肯","110/09/06","群益金鼎-松山",0,9,-9
"5065","1570力肯","110/09/06","臺銀-臺南",6,0,6
"5066","1570力肯","110/09/06","兆豐-民生",0,8,-8
"5067","1570力肯","110/09/06","大昌-桃園",6,0,6
"5068","1570力肯","110/09/06","群益金鼎-丹鳳",0,7,-7
"5069","1570力肯","110/09/06","彰銀-七賢",5,0,5
"5070","1570力肯","110/09/06","元大-竹科",0,7,-7
"5071","2929淘帝","110/09/06","新光-台中",20,0,20
"5072","2929淘帝","110/09/06","玉山-新竹",0,60,-60
"5073","2929淘帝","110/09/06","富邦-內湖",15,0,15
"5074","2929淘帝","110/09/06","美林",2,22,-20
"5075","2929淘帝","110/09/06","日盛-八德",10,0,10
"5076","2929淘帝","110/09/06","凱基-長庚",0,19,-19
"5077","2929淘帝","110/09/06","元富-大裕",10,0,10
"5078","2929淘帝","110/09/06","新加坡商瑞銀",1,19,-18
"5079","2929淘帝","110/09/06","富邦-台南",10,0,10
"5080","2929淘帝","110/09/06","日盛-南京",0,15,-15
"5081","2929淘帝","110/09/06","元富-新竹",7,0,7
"5082","2929淘帝","110/09/06","國泰-台中",0,8,-8
"5083","2929淘帝","110/09/06","凱基-林口",7,0,7
"5084","2929淘帝","110/09/06","元大-左營",0,6,-6
"5085","2929淘帝","110/09/06","華南永昌-古亭",7,0,7
"5086","2929淘帝","110/09/06","港商野村",0,5,-5
"5087","2929淘帝","110/09/06","富邦-台北",7,0,7
"5088","2929淘帝","110/09/06","第一金-自由",0,5,-5
"5089","2929淘帝","110/09/06","元大-承德",6,0,6
"5090","2929淘帝","110/09/06","元富-基隆",0,5,-5
"5091","2929淘帝","110/09/06","合庫-高雄",5,0,5
"5092","2929淘帝","110/09/06","光和-高雄",0,5,-5
"5093","2929淘帝","110/09/06","元富-草屯",5,0,5
"5094","2929淘帝","110/09/06","永豐金-忠孝",0,5,-5
"5095","2929淘帝","110/09/06","台新證券",6,1,5
"5096","2929淘帝","110/09/06","台新-高雄",0,4,-4
"5097","2929淘帝","110/09/06","台新-建北",5,0,5
"5098","2929淘帝","110/09/06","富邦-南屯",0,4,-4
"5099","2929淘帝","110/09/06","玉山-台南",5,0,5
"5100","2929淘帝","110/09/06","臺銀-臺南",0,3,-3
"5101","5410國眾","110/09/06","華南永昌-高雄",30,0,30
"5102","5410國眾","110/09/06","凱基-台北",1,12,-11
"5103","5410國眾","110/09/06","元大-木柵",8,0,8
"5104","5410國眾","110/09/06","新光-台中",0,10,-10
"5105","5410國眾","110/09/06","兆豐-嘉義",4,0,4
"5106","5410國眾","110/09/06","群益金鼎-中壢",0,10,-10
"5107","5410國眾","110/09/06","新光",3,0,3
"5108","5410國眾","110/09/06","臺銀-金山",0,9,-9
"5109","5410國眾","110/09/06","華南永昌-淡水",3,0,3
"5110","5410國眾","110/09/06","大昌",0,5,-5
"5111","5410國眾","110/09/06","元大-大灣",3,0,3
"5112","5410國眾","110/09/06","臺銀-高雄",0,3,-3
"5113","5410國眾","110/09/06","元富-緯城",2,0,2
"5114","5410國眾","110/09/06","元富-板橋",0,3,-3
"5115","5410國眾","110/09/06","元富-嘉義",2,0,2
"5116","5410國眾","110/09/06","元富-林園",0,2,-2
"5117","5410國眾","110/09/06","國泰-台中",2,0,2
"5118","5410國眾","110/09/06","國票-博愛",0,2,-2
"5119","5410國眾","110/09/06","群益金鼎-士林",2,0,2
"5120","5410國眾","110/09/06","康和-延平",0,2,-2
"5121","5410國眾","110/09/06","凱基-台東",2,0,2
"5122","5410國眾","110/09/06","玉山-數位",0,2,-2
"5123","5410國眾","110/09/06","元大-鳳中",2,0,2
"5124","5410國眾","110/09/06","國泰-敦南",2,4,-2
"5125","5410國眾","110/09/06","元大-左營",2,0,2
"5126","5410國眾","110/09/06","凱基-岡山",0,2,-2
"5127","5410國眾","110/09/06","永豐金-竹北",2,0,2
"5128","5410國眾","110/09/06","華南永昌-公誠",0,2,-2
"5129","5410國眾","110/09/06","元大-崇德",1,0,1
"5130","5410國眾","110/09/06","元大-苑裡",0,2,-2
"5131","2841台開","110/09/06","永豐金-員林",60,0,60
"5132","2841台開","110/09/06","華南永昌-潮州",0,75,-75
"5133","2841台開","110/09/06","群益金鼎-彰化",50,0,50
"5134","2841台開","110/09/06","富隆-長安",0,40,-40
"5135","2841台開","110/09/06","台中銀",40,0,40
"5136","2841台開","110/09/06","永豐金-南投",0,25,-25
"5137","2841台開","110/09/06","富邦-新店",24,0,24
"5138","2841台開","110/09/06","台灣摩根士丹利",0,13,-13
"5139","2841台開","110/09/06","宏遠-館前",21,0,21
"5140","2841台開","110/09/06","群益金鼎-永和",0,13,-13
"5141","2841台開","110/09/06","群益金鼎-崇德",20,0,20
"5142","2841台開","110/09/06","國票-中和",0,12,-12
"5143","2841台開","110/09/06","凱基-大里",16,0,16
"5144","2841台開","110/09/06","國票-和平",0,10,-10
"5145","2841台開","110/09/06","日盛證券",17,5,12
"5146","2841台開","110/09/06","富邦-新竹",0,10,-10
"5147","2841台開","110/09/06","群益金鼎-大甲",10,0,10
"5148","2841台開","110/09/06","元大-復北",0,10,-10
"5149","2841台開","110/09/06","永豐金-敦南",23,15,8
"5150","2841台開","110/09/06","富邦-苗栗",0,9,-9
"5151","2841台開","110/09/06","國泰-敦南",6,0,6
"5152","2841台開","110/09/06","凱基-三重",0,8,-8
"5153","2841台開","110/09/06","元大-南勢角",6,0,6
"5154","2841台開","110/09/06","群益金鼎-新竹",0,7,-7
"5155","2841台開","110/09/06","國票-天祥",2,0,2
"5156","2841台開","110/09/06","元大-歸仁",0,7,-7
"5157","2841台開","110/09/06","國泰-桃園",2,0,2
"5158","2841台開","110/09/06","台新-台中",0,5,-5
"5159","2841台開","110/09/06","群益金鼎-館前",1,0,1
"5160","2841台開","110/09/06","元大-東蘆",0,5,-5
"5161","6207雷科","110/09/06","台新-高雄",57,0,57
"5162","6207雷科","110/09/06","新加坡商瑞銀",11,65,-54
"5163","6207雷科","110/09/06","元大-高雄",52,0,52
"5164","6207雷科","110/09/06","凱基-台北",17,56,-39
"5165","6207雷科","110/09/06","群益金鼎-瑞豐",40,0,40
"5166","6207雷科","110/09/06","(牛牛牛)亞-鑫豐",0,28,-28
"5167","6207雷科","110/09/06","中國信託-高雄",17,0,17
"5168","6207雷科","110/09/06","港商野村",0,27,-27
"5169","6207雷科","110/09/06","永全-八德",9,0,9
"5170","6207雷科","110/09/06","美商高盛",2,28,-26
"5171","6207雷科","110/09/06","永豐金-北高雄",9,0,9
"5172","6207雷科","110/09/06","華南永昌-朴子",0,20,-20
"5173","6207雷科","110/09/06","大昌-桃園",8,0,8
"5174","6207雷科","110/09/06","摩根大通",1,20,-19
"5175","6207雷科","110/09/06","凱基-中山",8,0,8
"5176","6207雷科","110/09/06","元大-博愛",0,15,-15
"5177","6207雷科","110/09/06","元大-大灣",8,0,8
"5178","6207雷科","110/09/06","國票-九鼎",2,16,-14
"5179","6207雷科","110/09/06","國泰-敦南",7,0,7
"5180","6207雷科","110/09/06","美林",0,13,-13
"5181","6207雷科","110/09/06","玉山-台南",6,0,6
"5182","6207雷科","110/09/06","大慶-富順",4,17,-13
"5183","6207雷科","110/09/06","富邦-內湖",6,0,6
"5184","6207雷科","110/09/06","統一-台中",1,14,-13
"5185","6207雷科","110/09/06","玉山-大里",5,0,5
"5186","6207雷科","110/09/06","兆豐-嘉義",1,14,-13
"5187","6207雷科","110/09/06","群益金鼎-高盛",5,0,5
"5188","6207雷科","110/09/06","國票-台南",0,8,-8
"5189","6207雷科","110/09/06","富邦-高雄",5,0,5
"5190","6207雷科","110/09/06","台新-台中",0,5,-5
"5191","3679新至陞","110/09/06","元大-大天母",30,0,30
"5192","3679新至陞","110/09/06","凱基-台北",0,17,-17
"5193","3679新至陞","110/09/06","元大-成功",14,0,14
"5194","3679新至陞","110/09/06","摩根大通",1,17,-16
"5195","3679新至陞","110/09/06","永豐金-南投",5,0,5
"5196","3679新至陞","110/09/06","華南永昌-三重",0,13,-13
"5197","3679新至陞","110/09/06","大昌-桃園",3,0,3
"5198","3679新至陞","110/09/06","瑞士信貸",0,9,-9
"5199","3679新至陞","110/09/06","玉山-台大",3,0,3
"5200","3679新至陞","110/09/06","北城證券",0,6,-6
"5201","3679新至陞","110/09/06","永豐金-松山",3,0,3
"5202","3679新至陞","110/09/06","台灣摩根士丹利",0,5,-5
"5203","3679新至陞","110/09/06","日盛-嘉義",2,0,2
"5204","3679新至陞","110/09/06","美商高盛",0,3,-3
"5205","3679新至陞","110/09/06","兆豐-松德",2,0,2
"5206","3679新至陞","110/09/06","港商野村",0,3,-3
"5207","3679新至陞","110/09/06","凱基-彰化",2,0,2
"5208","3679新至陞","110/09/06","凱基-埔墘",0,3,-3
"5209","3679新至陞","110/09/06","元大-草屯",2,0,2
"5210","3679新至陞","110/09/06","元大-松山",0,3,-3
"5211","3679新至陞","110/09/06","土銀-和平",2,1,1
"5212","3679新至陞","110/09/06","安泰",0,2,-2
"5213","3679新至陞","110/09/06","土銀-士林",1,0,1
"5214","3679新至陞","110/09/06","元大-萬華",0,2,-2
"5215","3679新至陞","110/09/06","臺銀-高雄",1,0,1
"5216","3679新至陞","110/09/06","美林",1,2,-1
"5217","3679新至陞","110/09/06","統一",1,0,1
"5218","3679新至陞","110/09/06","亞東",0,1,-1
"5219","3679新至陞","110/09/06","元富-緯城",1,0,1
"5220","3679新至陞","110/09/06","元大證券",0,1,-1
"5221","2727王品","110/09/06","統一-三重",24,0,24
"5222","2727王品","110/09/06","美林",0,81,-81
"5223","2727王品","110/09/06","聯邦-興中",20,0,20
"5224","2727王品","110/09/06","華南永昌-麻豆",0,60,-60
"5225","2727王品","110/09/06","國泰-敦南",30,13,17
"5226","2727王品","110/09/06","港商野村",19,60,-41
"5227","2727王品","110/09/06","(牛牛牛)亞-鑫豐",17,3,14
"5228","2727王品","110/09/06","凱基-台北",32,69,-37
"5229","2727王品","110/09/06","元富-永和",13,0,13
"5230","2727王品","110/09/06","中國信託",0,33,-33
"5231","2727王品","110/09/06","凱基-板橋",14,1,13
"5232","2727王品","110/09/06","統一",0,20,-20
"5233","2727王品","110/09/06","國票-九鼎",15,3,12
"5234","2727王品","110/09/06","永豐金-桃盛",0,20,-20
"5235","2727王品","110/09/06","日盛-木柵",11,0,11
"5236","2727王品","110/09/06","富邦-新竹",0,15,-15
"5237","2727王品","110/09/06","永豐金-忠孝",11,0,11
"5238","2727王品","110/09/06","群益金鼎-大興",0,13,-13
"5239","2727王品","110/09/06","德信",10,0,10
"5240","2727王品","110/09/06","摩根大通",18,30,-12
"5241","2727王品","110/09/06","新光",12,3,9
"5242","2727王品","110/09/06","凱基-興隆",1,12,-11
"5243","2727王品","110/09/06","元富",8,0,8
"5244","2727王品","110/09/06","元大-南京",2,13,-11
"5245","2727王品","110/09/06","玉山-桃園",11,3,8
"5246","2727王品","110/09/06","元大-高雄",2,13,-11
"5247","2727王品","110/09/06","永豐金-彰化",9,1,8
"5248","2727王品","110/09/06","群益金鼎-士林",0,8,-8
"5249","2727王品","110/09/06","玉山-板橋",8,1,7
"5250","2727王品","110/09/06","華南永昌",1,8,-7
"5251","1570力肯","110/09/06","國票-和平",50,0,50
"5252","1570力肯","110/09/06","元大-板橋",1,65,-64
"5253","1570力肯","110/09/06","元大-北三重",36,0,36
"5254","1570力肯","110/09/06","元大-內湖",0,40,-40
"5255","1570力肯","110/09/06","國票-北高雄",23,0,23
"5256","1570力肯","110/09/06","凱基-台北",2,38,-36
"5257","1570力肯","110/09/06","凱基-天母",20,0,20
"5258","1570力肯","110/09/06","宏遠證券",15,50,-35
"5259","1570力肯","110/09/06","元大-員林",20,0,20
"5260","1570力肯","110/09/06","合庫-桃園",0,20,-20
"5261","1570力肯","110/09/06","永豐金-苓雅",20,0,20
"5262","1570力肯","110/09/06","永豐金-中和",0,20,-20
"5263","1570力肯","110/09/06","新光-新竹",12,0,12
"5264","1570力肯","110/09/06","摩根大通",0,18,-18
"5265","1570力肯","110/09/06","元大-莒光",12,0,12
"5266","1570力肯","110/09/06","元大-基隆",0,17,-17
"5267","1570力肯","110/09/06","元大-草屯",12,0,12
"5268","1570力肯","110/09/06","統一-松江",0,16,-16
"5269","1570力肯","110/09/06","兆豐-員林",10,0,10
"5270","1570力肯","110/09/06","聯邦商銀",0,10,-10
"5271","1570力肯","110/09/06","富邦-新營",10,0,10
"5272","1570力肯","110/09/06","富邦-台南",0,10,-10
"5273","1570力肯","110/09/06","國票-內壢",9,0,9
"5274","1570力肯","110/09/06","群益金鼎-松山",0,9,-9
"5275","1570力肯","110/09/06","臺銀-臺南",6,0,6
"5276","1570力肯","110/09/06","兆豐-民生",0,8,-8
"5277","1570力肯","110/09/06","大昌-桃園",6,0,6
"5278","1570力肯","110/09/06","群益金鼎-丹鳳",0,7,-7
"5279","1570力肯","110/09/06","彰銀-七賢",5,0,5
"5280","1570力肯","110/09/06","元大-竹科",0,7,-7
"5281","6180橘子","110/09/06","凱基-永康",90,0,90
"5282","6180橘子","110/09/06","凱基-台北",22,132,-110
"5283","6180橘子","110/09/06","國泰-敦南",19,3,16
"5284","6180橘子","110/09/06","元大-大安",0,25,-25
"5285","6180橘子","110/09/06","玉山-大里",13,0,13
"5286","6180橘子","110/09/06","美林",0,24,-24
"5287","6180橘子","110/09/06","日盛-文化",12,0,12
"5288","6180橘子","110/09/06","國票-長城",0,22,-22
"5289","6180橘子","110/09/06","台灣摩根士丹利",12,0,12
"5290","6180橘子","110/09/06","國泰-台南",1,23,-22
"5291","6180橘子","110/09/06","合庫-自強",10,0,10
"5292","6180橘子","110/09/06","元大-草屯",0,22,-22
"5293","6180橘子","110/09/06","元富-大裕",10,0,10
"5294","6180橘子","110/09/06","凱基-中壢",0,21,-21
"5295","6180橘子","110/09/06","元大-金華",10,0,10
"5296","6180橘子","110/09/06","大慶-蘆洲",0,20,-20
"5297","6180橘子","110/09/06","港商野村",10,1,9
"5298","6180橘子","110/09/06","凱基-高美館",0,20,-20
"5299","6180橘子","110/09/06","土銀-和平",8,0,8
"5300","6180橘子","110/09/06","富邦-員林",0,18,-18
"5301","6180橘子","110/09/06","永豐金證券",8,0,8
"5302","6180橘子","110/09/06","摩根大通",26,41,-15
"5303","6180橘子","110/09/06","新光-高雄",8,1,7
"5304","6180橘子","110/09/06","國泰-新莊",0,10,-10
"5305","6180橘子","110/09/06","永豐金-萬盛",7,0,7
"5306","6180橘子","110/09/06","元大-大里德芳",0,10,-10
"5307","6180橘子","110/09/06","臺銀-高雄",6,0,6
"5308","6180橘子","110/09/06","國票-中和",0,8,-8
"5309","6180橘子","110/09/06","華南永昌-古亭",8,2,6
"5310","6180橘子","110/09/06","台新-左楠",0,8,-8
"5311","2390云辰","110/09/06","台灣摩根士丹利",242,16,226
"5312","2390云辰","110/09/06","摩根大通",36,602,-566
"5313","2390云辰","110/09/06","群益金鼎-海山",164,5,159
"5314","2390云辰","110/09/06","美商高盛",139,334,-195
"5315","2390云辰","110/09/06","元大-松山",107,4,103
"5316","2390云辰","110/09/06","美林",67,190,-123
"5317","2390云辰","110/09/06","新光-桃園",64,13,51
"5318","2390云辰","110/09/06","新光-台中",0,81,-81
"5319","2390云辰","110/09/06","兆豐-北高雄",50,0,50
"5320","2390云辰","110/09/06","臺銀-臺中",26,93,-67
"5321","2390云辰","110/09/06","元大-嘉義",50,0,50
"5322","2390云辰","110/09/06","元大-館前",5,66,-61
"5323","2390云辰","110/09/06","新加坡商瑞銀",113,71,42
"5324","2390云辰","110/09/06","群益金鼎-延平",1,49,-48
"5325","2390云辰","110/09/06","元大-內湖",41,0,41
"5326","2390云辰","110/09/06","凱基-台北",113,160,-47
"5327","2390云辰","110/09/06","兆豐-寶成",41,1,40
"5328","2390云辰","110/09/06","瑞士信貸",0,31,-31
"5329","2390云辰","110/09/06","元大-北三重",41,1,40
"5330","2390云辰","110/09/06","元富-高雄",0,31,-31
"5331","2390云辰","110/09/06","元大-福營",36,0,36
"5332","2390云辰","110/09/06","國票-中和",10,40,-30
"5333","2390云辰","110/09/06","第一金-新竹",30,1,29
"5334","2390云辰","110/09/06","大慶-中壢",3,30,-27
"5335","2390云辰","110/09/06","國票-敦北法人",29,1,28
"5336","2390云辰","110/09/06","日盛-新莊",32,57,-25
"5337","2390云辰","110/09/06","元大-土城學府",135,108,27
"5338","2390云辰","110/09/06","中國信託-嘉義",2,26,-24
"5339","2390云辰","110/09/06","富邦-板橋",30,4,26
"5340","2390云辰","110/09/06","凱基-內埔",0,20,-20
"5341","2834臺企銀","110/09/03","凱基-台北",6916,1284,5632
"5342","2834臺企銀","110/09/03","新加坡商瑞銀",141,10693,-10552
"5343","2834臺企銀","110/09/03","摩根大通",2831,187,2644
"5344","2834臺企銀","110/09/03","新光-台中",69,1833,-1764
"5345","2834臺企銀","110/09/03","花旗環球",1989,0,1989
"5346","2834臺企銀","110/09/03","永豐金-彰化",0,1201,-1201
"5347","2834臺企銀","110/09/03","港商法國興業",1852,0,1852
"5348","2834臺企銀","110/09/03","元富-城東",0,1155,-1155
"5349","2834臺企銀","110/09/03","港商野村",1704,220,1484
"5350","2834臺企銀","110/09/03","台灣摩根士丹利",664,1433,-769
"5351","2834臺企銀","110/09/03","日盛證券",1112,12,1100
"5352","2834臺企銀","110/09/03","元大-蘆洲",92,716,-624
"5353","2834臺企銀","110/09/03","美商高盛",724,77,647
"5354","2834臺企銀","110/09/03","臺銀-臺南",11,630,-619
"5355","2834臺企銀","110/09/03","元大-竹南",611,12,599
"5356","2834臺企銀","110/09/03","華南永昌-麻豆",26,497,-471
"5357","2834臺企銀","110/09/03","中國信託-文心",529,2,527
"5358","2834臺企銀","110/09/03","統一-板橋",150,600,-450
"5359","2834臺企銀","110/09/03","新光",758,240,518
"5360","2834臺企銀","110/09/03","凱基-高美館",3,342,-339
"5361","2834臺企銀","110/09/03","瑞士信貸",4566,4083,483
"5362","2834臺企銀","110/09/03","日盛-新莊",0,306,-306
"5363","2834臺企銀","110/09/03","元大-大里",564,106,458
"5364","2834臺企銀","110/09/03","元富-松德",7,303,-296
"5365","2834臺企銀","110/09/03","元富-虎尾",420,1,419
"5366","2834臺企銀","110/09/03","第一金-忠孝",2,284,-282
"5367","2834臺企銀","110/09/03","華南永昌-嘉義",402,0,402
"5368","2834臺企銀","110/09/03","永豐金-中和",0,282,-282
"5369","2834臺企銀","110/09/03","永豐金-埔里",406,21,385
"5370","2834臺企銀","110/09/03","臺銀-民權",43,292,-249
"5371","5511德昌","110/09/03","永豐金-內湖",35,0,35
"5372","5511德昌","110/09/03","寶盛",0,30,-30
"5373","5511德昌","110/09/03","華南永昌-忠孝",25,0,25
"5374","5511德昌","110/09/03","第一金-台中",0,15,-15
"5375","5511德昌","110/09/03","統一-士林",24,0,24
"5376","5511德昌","110/09/03","康和-內湖",0,10,-10
"5377","5511德昌","110/09/03","永豐金-市政",7,0,7
"5378","5511德昌","110/09/03","玉山-台南",0,5,-5
"5379","5511德昌","110/09/03","凱基-台北",5,0,5
"5380","5511德昌","110/09/03","致和-崇德",0,5,-5
"5381","5511德昌","110/09/03","兆豐-南京",3,0,3
"5382","5511德昌","110/09/03","大昌",0,4,-4
"5383","5511德昌","110/09/03","摩根大通",1,0,1
"5384","5511德昌","110/09/03","凱基-復興",0,3,-3
"5385","5511德昌","110/09/03","元大-清水",1,0,1
"5386","5511德昌","110/09/03","永豐金-台南",0,3,-3
"5387","5511德昌","110/09/03","元富-城中",0,0,0
"5388","5511德昌","110/09/03","群益金鼎-海山",0,2,-2
"5389","5511德昌","110/09/03","元富-中原",0,0,0
"5390","5511德昌","110/09/03","富邦-建國",0,2,-2
"5391","5511德昌","110/09/03","大昌-新竹",0,0,0
"5392","5511德昌","110/09/03","元大-新盛",0,2,-2
"5393","5511德昌","110/09/03","國票-南崁",0,0,0
"5394","5511德昌","110/09/03","元大-新莊",0,2,-2
"5395","5511德昌","110/09/03","台新-屏東",0,0,0
"5396","5511德昌","110/09/03","永豐金-中壢",0,2,-2
"5397","5511德昌","110/09/03","凱基-文心",0,0,0
"5398","5511德昌","110/09/03","永豐金-三重",0,2,-2
"5399","5511德昌","110/09/03","元大-沙鹿",0,0,0
"5400","5511德昌","110/09/03","兆豐-城中",0,1,-1
"5401","2489瑞軒","110/09/03","元大-豐原",137,0,137
"5402","2489瑞軒","110/09/03","台新-高雄",1,155,-154
"5403","2489瑞軒","110/09/03","瑞士信貸",136,0,136
"5404","2489瑞軒","110/09/03","美商高盛",0,101,-101
"5405","2489瑞軒","110/09/03","群益金鼎-大安",130,0,130
"5406","2489瑞軒","110/09/03","兆豐-岡山",0,100,-100
"5407","2489瑞軒","110/09/03","摩根大通",142,17,125
"5408","2489瑞軒","110/09/03","合庫-桃園",0,60,-60
"5409","2489瑞軒","110/09/03","美林",164,86,78
"5410","2489瑞軒","110/09/03","元大-東泰",0,60,-60
"5411","2489瑞軒","110/09/03","台灣摩根士丹利",74,13,61
"5412","2489瑞軒","110/09/03","康和-台中",0,51,-51
"5413","2489瑞軒","110/09/03","華南永昌-忠孝",60,0,60
"5414","2489瑞軒","110/09/03","第一金-路竹",0,50,-50
"5415","2489瑞軒","110/09/03","富邦-岡山",55,0,55
"5416","2489瑞軒","110/09/03","元大-汐止",1,44,-43
"5417","2489瑞軒","110/09/03","凱基-台北",152,104,48
"5418","2489瑞軒","110/09/03","合庫-台南",0,30,-30
"5419","2489瑞軒","110/09/03","花旗環球",46,0,46
"5420","2489瑞軒","110/09/03","國票-南科",0,30,-30
"5421","2489瑞軒","110/09/03","華南永昌-頭份",37,0,37
"5422","2489瑞軒","110/09/03","凱基-中山",0,25,-25
"5423","2489瑞軒","110/09/03","元大-歸仁",32,0,32
"5424","2489瑞軒","110/09/03","國票-長城",0,24,-24
"5425","2489瑞軒","110/09/03","富邦-陽明",30,1,29
"5426","2489瑞軒","110/09/03","群益金鼎-民權",0,22,-22
"5427","2489瑞軒","110/09/03","日盛-忠孝",25,0,25
"5428","2489瑞軒","110/09/03","群益金鼎-潭子",0,22,-22
"5429","2489瑞軒","110/09/03","永豐金-中正",28,5,23
"5430","2489瑞軒","110/09/03","大慶-富順",0,21,-21
"5431","2428興勤","110/09/03","美林",40,0,40
"5432","2428興勤","110/09/03","港商麥格理",0,46,-46
"5433","2428興勤","110/09/03","台灣摩根士丹利",32,2,30
"5434","2428興勤","110/09/03","宏遠-桃園",0,25,-25
"5435","2428興勤","110/09/03","摩根大通",31,4,27
"5436","2428興勤","110/09/03","永豐金證券",0,12,-12
"5437","2428興勤","110/09/03","美商高盛",26,0,26
"5438","2428興勤","110/09/03","永豐金-天母",0,12,-12
"5439","2428興勤","110/09/03","凱基-台北",27,3,24
"5440","2428興勤","110/09/03","國泰證券",0,10,-10
"5441","2428興勤","110/09/03","瑞士信貸",18,1,17
"5442","2428興勤","110/09/03","凱基-桃園",0,10,-10
"5443","2428興勤","110/09/03","新加坡商瑞銀",12,1,11
"5444","2428興勤","110/09/03","元大-旗山",0,10,-10
"5445","2428興勤","110/09/03","富邦-台南",10,0,10
"5446","2428興勤","110/09/03","永豐金-市政",0,10,-10
"5447","2428興勤","110/09/03","花旗環球",7,0,7
"5448","2428興勤","110/09/03","日盛-花蓮",3,10,-7
"5449","2428興勤","110/09/03","日盛-新竹",5,0,5
"5450","2428興勤","110/09/03","中國信託",0,7,-7
"5451","2428興勤","110/09/03","中國信託-高雄",5,0,5
"5452","2428興勤","110/09/03","聯邦-富強",0,6,-6
"5453","2428興勤","110/09/03","富邦-仁愛",5,0,5
"5454","2428興勤","110/09/03","國票-安和",2,7,-5
"5455","2428興勤","110/09/03","永興",4,0,4
"5456","2428興勤","110/09/03","元大-鹿港",0,5,-5
"5457","2428興勤","110/09/03","兆豐-公益",6,2,4
"5458","2428興勤","110/09/03","大昌-桃園",0,4,-4
"5459","2428興勤","110/09/03","凱基",3,0,3
"5460","2428興勤","110/09/03","台新-台中",1,5,-4
"5461","3176基亞","110/09/03","玉山-城中",44,0,44
"5462","3176基亞","110/09/03","永豐金-南投",0,67,-67
"5463","3176基亞","110/09/03","康和-板橋",25,0,25
"5464","3176基亞","110/09/03","台中銀",0,55,-55
"5465","3176基亞","110/09/03","第一金-路竹",20,0,20
"5466","3176基亞","110/09/03","元大-虎尾",0,25,-25
"5467","3176基亞","110/09/03","群益金鼎-板橋",20,0,20
"5468","3176基亞","110/09/03","群益金鼎-中壢",0,18,-18
"5469","3176基亞","110/09/03","元大-新竹經國",20,0,20
"5470","3176基亞","110/09/03","群益金鼎-敦南",0,13,-13
"5471","3176基亞","110/09/03","日盛-板橋",17,0,17
"5472","3176基亞","110/09/03","日盛-南京",0,10,-10
"5473","3176基亞","110/09/03","元富-高雄",12,0,12
"5474","3176基亞","110/09/03","元大-南京",0,10,-10
"5475","3176基亞","110/09/03","玉山-雙和",10,0,10
"5476","3176基亞","110/09/03","富邦-台中",0,9,-9
"5477","3176基亞","110/09/03","群益金鼎-大興",10,0,10
"5478","3176基亞","110/09/03","宏遠-台南",0,8,-8
"5479","3176基亞","110/09/03","日盛-高雄",8,0,8
"5480","3176基亞","110/09/03","新光",9,16,-7
"5481","3176基亞","110/09/03","富邦-台北",10,2,8
"5482","3176基亞","110/09/03","國泰-台中",0,7,-7
"5483","3176基亞","110/09/03","日盛-中壢",6,0,6
"5484","3176基亞","110/09/03","台灣摩根士丹利",0,6,-6
"5485","3176基亞","110/09/03","宏遠-光隆",6,0,6
"5486","3176基亞","110/09/03","第一金-新竹",0,6,-6
"5487","3176基亞","110/09/03","臺灣企銀-桃園",5,0,5
"5488","3176基亞","110/09/03","華南永昌-林口",0,6,-6
"5489","3176基亞","110/09/03","日盛-永康",5,0,5
"5490","3176基亞","110/09/03","第一金-桃園",0,5,-5
"5491","2409友達","110/09/03","永豐金證券",10515,756,9759
"5492","2409友達","110/09/03","台灣摩根士丹利",3924,11957,-8033
"5493","2409友達","110/09/03","摩根大通",6728,2458,4270
"5494","2409友達","110/09/03","元大-前金",33,1976,-1943
"5495","2409友達","110/09/03","合庫證券",2441,63,2378
"5496","2409友達","110/09/03","港商野村",1517,2516,-999
"5497","2409友達","110/09/03","凱基-台北",2289,1219,1070
"5498","2409友達","110/09/03","美商高盛",1046,1706,-660
"5499","2409友達","110/09/03","瑞士信貸",945,31,914
"5500","2409友達","110/09/03","日盛證券",148,796,-648
"5501","2409友達","110/09/03","花旗環球",830,0,830
"5502","2409友達","110/09/03","華南永昌-忠孝",0,606,-606
"5503","2409友達","110/09/03","元大-南屯",896,77,819
"5504","2409友達","110/09/03","兆豐-南京",68,580,-512
"5505","2409友達","110/09/03","康和-新竹",835,41,794
"5506","2409友達","110/09/03","元富-城東",66,563,-497
"5507","2409友達","110/09/03","凱基-中山",765,51,714
"5508","2409友達","110/09/03","玉山-桃園",20,382,-362
"5509","2409友達","110/09/03","元富-安南",705,23,682
"5510","2409友達","110/09/03","日盛-永康",198,528,-330
"5511","2409友達","110/09/03","宏遠-台中",618,1,617
"5512","2409友達","110/09/03","富邦-建國",99,418,-319
"5513","2409友達","110/09/03","華南永昌-南京",1042,532,510
"5514","2409友達","110/09/03","新光-桃園",92,379,-287
"5515","2409友達","110/09/03","玉山-雙和",579,129,450
"5516","2409友達","110/09/03","國泰-台中",119,399,-280
"5517","2409友達","110/09/03","元大-東泰",376,22,354
"5518","2409友達","110/09/03","統一-三重",20,297,-277
"5519","2409友達","110/09/03","玉山-高雄",773,437,336
"5520","2409友達","110/09/03","國票-台中",14,270,-256
"5521","1315達新","110/09/03","凱基-中港",16,0,16
"5522","1315達新","110/09/03","摩根大通",3,15,-12
"5523","1315達新","110/09/03","凱基",11,0,11
"5524","1315達新","110/09/03","富邦-台北",0,7,-7
"5525","1315達新","110/09/03","花旗環球",8,0,8
"5526","1315達新","110/09/03","國泰-桃園",0,5,-5
"5527","1315達新","110/09/03","豐農",8,0,8
"5528","1315達新","110/09/03","元大-花蓮",0,4,-4
"5529","1315達新","110/09/03","台灣摩根士丹利",5,0,5
"5530","1315達新","110/09/03","土銀",0,3,-3
"5531","1315達新","110/09/03","元大-文心興安",5,0,5
"5532","1315達新","110/09/03","台灣企銀-台中",0,3,-3
"5533","1315達新","110/09/03","美林",4,0,4
"5534","1315達新","110/09/03","群益金鼎-彰化",0,3,-3
"5535","1315達新","110/09/03","美商高盛",4,0,4
"5536","1315達新","110/09/03","元大-博愛",0,3,-3
"5537","1315達新","110/09/03","凱基-台北",4,1,3
"5538","1315達新","110/09/03","臺灣企銀-桃園",0,2,-2
"5539","1315達新","110/09/03","凱基-文心",3,0,3
"5540","1315達新","110/09/03","統一",0,2,-2
"5541","1315達新","110/09/03","亞東-板橋",2,0,2
"5542","1315達新","110/09/03","國票-桃園",0,2,-2
"5543","1315達新","110/09/03","元大-新店中正",2,0,2
"5544","1315達新","110/09/03","台新證券",0,2,-2
"5545","1315達新","110/09/03","新加坡商瑞銀",1,0,1
"5546","1315達新","110/09/03","富邦-內湖",0,2,-2
"5547","1315達新","110/09/03","元富-文心",1,0,1
"5548","1315達新","110/09/03","富邦-宜蘭",0,2,-2
"5549","1315達新","110/09/03","群益金鼎-板橋",1,0,1
"5550","1315達新","110/09/03","元大-南屯",0,2,-2
"5551","2609陽明","110/09/03","港商麥格理",610,0,610
"5552","2609陽明","110/09/03","富邦證券",308,2406,-2098
"5553","2609陽明","110/09/03","永豐金證券",610,65,545
"5554","2609陽明","110/09/03","康和",42,2053,-2011
"5555","2609陽明","110/09/03","元大-大天母",502,111,391
"5556","2609陽明","110/09/03","美林",26,1612,-1586
"5557","2609陽明","110/09/03","凱基-復興",2259,1887,372
"5558","2609陽明","110/09/03","富邦-新竹",258,1413,-1155
"5559","2609陽明","110/09/03","華南永昌-桃園",360,15,345
"5560","2609陽明","110/09/03","日盛-雙和",67,1210,-1143
"5561","2609陽明","110/09/03","兆豐-板橋",612,330,282
"5562","2609陽明","110/09/03","統一",717,1794,-1077
"5563","2609陽明","110/09/03","國泰-敦南",1931,1665,266
"5564","2609陽明","110/09/03","富邦-虎尾",5084,5917,-833
"5565","2609陽明","110/09/03","國票-桃園",277,35,242
"5566","2609陽明","110/09/03","新加坡商瑞銀",1267,2013,-746
"5567","2609陽明","110/09/03","華南永昌-竹北",1313,1073,240
"5568","2609陽明","110/09/03","元富-緯城",140,829,-689
"5569","2609陽明","110/09/03","玉山-新莊",419,182,237
"5570","2609陽明","110/09/03","美商高盛",340,1019,-679
"5571","2609陽明","110/09/03","台中銀",299,65,234
"5572","2609陽明","110/09/03","凱基-台北",2120,2780,-660
"5573","2609陽明","110/09/03","永豐金-竹科",381,155,226
"5574","2609陽明","110/09/03","國泰證券",61,682,-621
"5575","2609陽明","110/09/03","玉山-台大",267,47,220
"5576","2609陽明","110/09/03","中國信託-新竹",161,673,-512
"5577","2609陽明","110/09/03","國票-安和",420,201,219
"5578","2609陽明","110/09/03","日盛-大墩",223,708,-485
"5579","2609陽明","110/09/03","凱基-彰化",308,94,214
"5580","2609陽明","110/09/03","兆豐-三民",109,565,-456
"5581","2636台驊投控","110/09/03","摩根大通",610,329,281
"5582","2636台驊投控","110/09/03","凱基-復興",33,624,-591
"5583","2636台驊投控","110/09/03","統一-新台中",194,12,182
"5584","2636台驊投控","110/09/03","富邦證券",0,512,-512
"5585","2636台驊投控","110/09/03","第一金-桃園",148,24,124
"5586","2636台驊投控","110/09/03","統一",86,544,-458
"5587","2636台驊投控","110/09/03","新光",234,145,89
"5588","2636台驊投控","110/09/03","元富-嘉義",4,227,-223
"5589","2636台驊投控","110/09/03","宏遠-新化",79,1,78
"5590","2636台驊投控","110/09/03","兆豐-中壢",2,200,-198
"5591","2636台驊投控","110/09/03","國泰-敦南",258,184,74
"5592","2636台驊投控","110/09/03","凱基-信義",5,178,-173
"5593","2636台驊投控","110/09/03","大慶-中壢",91,18,73
"5594","2636台驊投控","110/09/03","華南永昌-朴子",10,148,-138
"5595","2636台驊投控","110/09/03","國泰-台中",113,52,61
"5596","2636台驊投控","110/09/03","元大-南屯",8,137,-129
"5597","2636台驊投控","110/09/03","永豐金-市政",109,52,57
"5598","2636台驊投控","110/09/03","國票-安和",8,136,-128
"5599","2636台驊投控","110/09/03","國泰-松江",64,8,56
"5600","2636台驊投控","110/09/03","國票-南港",7,121,-114
"5601","2636台驊投控","110/09/03","永豐金-豐原",67,11,56
"5602","2636台驊投控","110/09/03","美林",235,339,-104
"5603","2636台驊投控","110/09/03","玉山-南京東路",120,65,55
"5604","2636台驊投控","110/09/03","中國信託",21,115,-94
"5605","2636台驊投控","110/09/03","群益金鼎-竹南",46,1,45
"5606","2636台驊投控","110/09/03","永豐金-嘉義",1,92,-91
"5607","2636台驊投控","110/09/03","國泰-忠孝",106,62,44
"5608","2636台驊投控","110/09/03","瑞士信貸",0,89,-89
"5609","2636台驊投控","110/09/03","玉山-高雄",53,12,41
"5610","2636台驊投控","110/09/03","統一-基隆",6,90,-84
"5611","2867三商壽","110/09/03","美林",479,40,439
"5612","2867三商壽","110/09/03","元大-桃園",30,800,-770
"5613","2867三商壽","110/09/03","摩根大通",412,67,345
"5614","2867三商壽","110/09/03","日盛-中和",0,301,-301
"5615","2867三商壽","110/09/03","台新證券",261,7,254
"5616","2867三商壽","110/09/03","新光",22,322,-300
"5617","2867三商壽","110/09/03","元大-苑裡",220,0,220
"5618","2867三商壽","110/09/03","日盛-頭份",0,100,-100
"5619","2867三商壽","110/09/03","兆豐-東門",200,0,200
"5620","2867三商壽","110/09/03","新光-新竹",0,100,-100
"5621","2867三商壽","110/09/03","凱基",193,0,193
"5622","2867三商壽","110/09/03","新光-台中",6,89,-83
"5623","2867三商壽","110/09/03","凱基-台北",309,119,190
"5624","2867三商壽","110/09/03","元大-永春",0,75,-75
"5625","2867三商壽","110/09/03","統一-士林",180,0,180
"5626","2867三商壽","110/09/03","玉山-板橋",0,72,-72
"5627","2867三商壽","110/09/03","台灣摩根士丹利",183,5,178
"5628","2867三商壽","110/09/03","宏遠-高雄",0,64,-64
"5629","2867三商壽","110/09/03","花旗環球",142,0,142
"5630","2867三商壽","110/09/03","兆豐-新營",0,59,-59
"5631","2867三商壽","110/09/03","大展",134,1,133
"5632","2867三商壽","110/09/03","群益金鼎-中港",0,51,-51
"5633","2867三商壽","110/09/03","瑞士信貸",124,0,124
"5634","2867三商壽","110/09/03","群益金鼎-開元",0,50,-50
"5635","2867三商壽","110/09/03","台新-台中",102,2,100
"5636","2867三商壽","110/09/03","凱基-林口",0,50,-50
"5637","2867三商壽","110/09/03","新加坡商瑞銀",60,0,60
"5638","2867三商壽","110/09/03","國泰-台中",5,53,-48
"5639","2867三商壽","110/09/03","元大-前金",60,0,60
"5640","2867三商壽","110/09/03","宏遠-台中",0,44,-44
"5641","5521工信","110/09/03","摩根大通",434,12,422
"5642","5521工信","110/09/03","元大-成功",0,185,-185
"5643","5521工信","110/09/03","美林",175,1,174
"5644","5521工信","110/09/03","光和-溪湖",5,155,-150
"5645","5521工信","110/09/03","台新證券",175,29,146
"5646","5521工信","110/09/03","富邦-員林",2,108,-106
"5647","5521工信","110/09/03","康和-澎湖",110,0,110
"5648","5521工信","110/09/03","日盛-板橋中山",0,103,-103
"5649","5521工信","110/09/03","瑞士信貸",77,0,77
"5650","5521工信","110/09/03","大慶",0,100,-100
"5651","5521工信","110/09/03","美商高盛",72,0,72
"5652","5521工信","110/09/03","富邦-南屯",0,100,-100
"5653","5521工信","110/09/03","港商法國興業",72,0,72
"5654","5521工信","110/09/03","國泰-高雄",7,100,-93
"5655","5521工信","110/09/03","光和-花壇",60,0,60
"5656","5521工信","110/09/03","凱基-台北",620,701,-81
"5657","5521工信","110/09/03","第一金-豐原",50,0,50
"5658","5521工信","110/09/03","凱基-斗六",0,73,-73
"5659","5521工信","110/09/03","玉山-左營",50,2,48
"5660","5521工信","110/09/03","元大-林森",1,68,-67
"5661","5521工信","110/09/03","港商野村",45,0,45
"5662","5521工信","110/09/03","元富-板橋",0,64,-64
"5663","5521工信","110/09/03","富邦-台北",51,14,37
"5664","5521工信","110/09/03","華南永昌-民權",0,50,-50
"5665","5521工信","110/09/03","(牛牛牛)亞-鑫豐",45,13,32
"5666","5521工信","110/09/03","元大證券",0,50,-50
"5667","5521工信","110/09/03","群益金鼎-萬華",27,0,27
"5668","5521工信","110/09/03","元大-大里德芳",0,50,-50
"5669","5521工信","110/09/03","台灣摩根士丹利",39,16,23
"5670","5521工信","110/09/03","兆豐-三民",0,43,-43
"5671","1471首利","110/09/03","台新-松江",39,0,39
"5672","1471首利","110/09/03","元大-路竹",0,121,-121
"5673","1471首利","110/09/03","元大-西門",27,0,27
"5674","1471首利","110/09/03","日盛-文化",0,50,-50
"5675","1471首利","110/09/03","富邦-新竹",22,0,22
"5676","1471首利","110/09/03","大慶-蘆洲",0,20,-20
"5677","1471首利","110/09/03","日盛-景美",20,0,20
"5678","1471首利","110/09/03","摩根大通",14,29,-15
"5679","1471首利","110/09/03","日盛-大墩",18,0,18
"5680","1471首利","110/09/03","聯邦-高雄",0,14,-14
"5681","1471首利","110/09/03","元富-民權",15,0,15
"5682","1471首利","110/09/03","臺銀",1,14,-13
"5683","1471首利","110/09/03","群益金鼎-桃園",15,0,15
"5684","1471首利","110/09/03","臺銀-臺中",0,11,-11
"5685","1471首利","110/09/03","凱基-三多",15,0,15
"5686","1471首利","110/09/03","兆豐-麻豆",0,10,-10
"5687","1471首利","110/09/03","兆豐-桃園",14,0,14
"5688","1471首利","110/09/03","兆豐-高雄",0,10,-10
"5689","1471首利","110/09/03","統一-新台中",13,0,13
"5690","1471首利","110/09/03","國票-嘉義",0,10,-10
"5691","1471首利","110/09/03","花旗環球",11,0,11
"5692","1471首利","110/09/03","聯邦-大業",0,10,-10
"5693","1471首利","110/09/03","凱基-東勢",10,0,10
"5694","1471首利","110/09/03","華南永昌-鳳山",0,10,-10
"5695","1471首利","110/09/03","華南永昌-公誠",10,0,10
"5696","1471首利","110/09/03","富邦-嘉義",0,10,-10
"5697","1471首利","110/09/03","元大-鳳山",10,0,10
"5698","1471首利","110/09/03","元大-楊梅",0,10,-10
"5699","1471首利","110/09/03","國泰-敦南",12,3,9
"5700","1471首利","110/09/03","元富-宜蘭",1,10,-9
"5701","2883開發金","110/09/03","凱基-台北",2700,224,2476
"5702","2883開發金","110/09/03","國泰證券",41,2505,-2464
"5703","2883開發金","110/09/03","美商高盛",1463,120,1343
"5704","2883開發金","110/09/03","台灣摩根士丹利",981,3375,-2394
"5705","2883開發金","110/09/03","新加坡商瑞銀",1717,492,1225
"5706","2883開發金","110/09/03","亞東-新竹",1,1198,-1197
"5707","2883開發金","110/09/03","美林",1358,164,1194
"5708","2883開發金","110/09/03","富邦-內湖",60,1193,-1133
"5709","2883開發金","110/09/03","花旗環球",1093,0,1093
"5710","2883開發金","110/09/03","華南永昌-竹北",0,859,-859
"5711","2883開發金","110/09/03","元大-林森",805,1,804
"5712","2883開發金","110/09/03","富邦-台北",24,613,-589
"5713","2883開發金","110/09/03","摩根大通",941,308,633
"5714","2883開發金","110/09/03","元大-四維",4,530,-526
"5715","2883開發金","110/09/03","凱基-中壢",656,28,628
"5716","2883開發金","110/09/03","第一金-豐原",12,404,-392
"5717","2883開發金","110/09/03","玉山證券",706,97,609
"5718","2883開發金","110/09/03","元大-苗栗",0,386,-386
"5719","2883開發金","110/09/03","港商野村",757,239,518
"5720","2883開發金","110/09/03","亞東-台中",0,321,-321
"5721","2883開發金","110/09/03","永豐金-台南",447,10,437
"5722","2883開發金","110/09/03","新光-台南",58,377,-319
"5723","2883開發金","110/09/03","法銀巴黎",434,0,434
"5724","2883開發金","110/09/03","康和-延平",1,300,-299
"5725","2883開發金","110/09/03","元大-成功",475,46,429
"5726","2883開發金","110/09/03","國泰-新莊",4,278,-274
"5727","2883開發金","110/09/03","元大-民雄",310,3,307
"5728","2883開發金","110/09/03","國泰-敦南",125,383,-258
"5729","2883開發金","110/09/03","臺銀-鳳山",321,19,302
"5730","2883開發金","110/09/03","國泰-館前",52,293,-241
"5731","6205詮欣","110/09/03","元大-汐止",16,3,13
"5732","6205詮欣","110/09/03","元大-中和",0,26,-26
"5733","6205詮欣","110/09/03","美林",9,0,9
"5734","6205詮欣","110/09/03","日盛-木柵",0,6,-6
"5735","6205詮欣","110/09/03","摩根大通",8,0,8
"5736","6205詮欣","110/09/03","元富-花蓮",0,5,-5
"5737","6205詮欣","110/09/03","凱基-台北",6,0,6
"5738","6205詮欣","110/09/03","華南永昌-東昇",0,5,-5
"5739","6205詮欣","110/09/03","新光",5,0,5
"5740","6205詮欣","110/09/03","元大-基隆孝二",0,5,-5
"5741","6205詮欣","110/09/03","永豐金證券",5,0,5
"5742","6205詮欣","110/09/03","富邦-板橋",0,4,-4
"5743","6205詮欣","110/09/03","瑞士信貸",4,0,4
"5744","6205詮欣","110/09/03","永豐金-新竹",0,4,-4
"5745","6205詮欣","110/09/03","花旗環球",4,0,4
"5746","6205詮欣","110/09/03","亞東",0,2,-2
"5747","6205詮欣","110/09/03","玉山-城中",3,0,3
"5748","6205詮欣","110/09/03","光和",0,2,-2
"5749","6205詮欣","110/09/03","元大-崇德",3,0,3
"5750","6205詮欣","110/09/03","兆豐-台中",0,2,-2
"5751","6205詮欣","110/09/03","元大-新店中正",3,0,3
"5752","6205詮欣","110/09/03","兆豐-岡山",0,2,-2
"5753","6205詮欣","110/09/03","日盛-新莊",2,0,2
"5754","6205詮欣","110/09/03","富邦-仁愛",0,2,-2
"5755","6205詮欣","110/09/03","新光-桃園",3,1,2
"5756","6205詮欣","110/09/03","第一金-新興",0,1,-1
"5757","6205詮欣","110/09/03","凱基",2,0,2
"5758","6205詮欣","110/09/03","元富-同大",0,1,-1
"5759","6205詮欣","110/09/03","元大-大安",2,0,2
"5760","6205詮欣","110/09/03","元富-桃園",0,1,-1
"5761","1540喬福","110/09/03","國票-台南",6,0,6
"5762","1540喬福","110/09/03","亞東-高雄",0,6,-6
"5763","1540喬福","110/09/03","群益金鼎-館前",6,0,6
"5764","1540喬福","110/09/03","元大-龍潭",0,6,-6
"5765","1540喬福","110/09/03","凱基",6,0,6
"5766","1540喬福","110/09/03","兆豐-鹿港",0,3,-3
"5767","1540喬福","110/09/03","花旗環球",5,0,5
"5768","1540喬福","110/09/03","群益金鼎-永和",0,2,-2
"5769","1540喬福","110/09/03","元大-鳳中",1,0,1
"5770","1540喬福","110/09/03","永豐金-忠孝",0,1,-1
"5771","1540喬福","110/09/03","元大-土城永寧",1,0,1
"5772","1540喬福","110/09/03","美林",0,1,-1
"5773","1540喬福","110/09/03","日盛-土城",1,1,0
"5774","1540喬福","110/09/03","元富",0,1,-1
"5775","1540喬福","110/09/03","新光",0,0,0
"5776","1540喬福","110/09/03","元富-虎尾",0,1,-1
"5777","1540喬福","110/09/03","玉山-台中",0,0,0
"5778","1540喬福","110/09/03","中國信託-新竹",0,1,-1
"5779","1540喬福","110/09/03","國泰-敦南",0,0,0
"5780","1540喬福","110/09/03","新光-新竹",0,1,-1
"5781","1540喬福","110/09/03","群益金鼎-北高雄",0,0,0
"5782","1540喬福","110/09/03","土銀-和平",0,1,-1
"5783","1540喬福","110/09/03","華南永昌-高雄",0,0,0
"5784","1540喬福","110/09/03","元大-台北",0,1,-1
"5785","1540喬福","110/09/03","華南永昌-苗栗",0,0,0
"5786","1540喬福","110/09/03","群益金鼎-台中",0,1,-1
"5787","1540喬福","110/09/03","富邦-北港",0,0,0
"5788","1540喬福","110/09/03","國泰-敦南",0,0,0
"5789","1540喬福","110/09/03","元大-新竹經國",0,0,0
"5790","1540喬福","110/09/03","元大-新竹經國",0,0,0
"5791","2888新光金","110/09/03","元大-館前",4899,31,4868
"5792","2888新光金","110/09/03","永豐金證券",17,2041,-2024
"5793","2888新光金","110/09/03","摩根大通",2598,419,2179
"5794","2888新光金","110/09/03","元大證券",32,1634,-1602
"5795","2888新光金","110/09/03","美林",2132,22,2110
"5796","2888新光金","110/09/03","瑞士信貸",706,1308,-602
"5797","2888新光金","110/09/03","永豐金-板橋",2028,227,1801
"5798","2888新光金","110/09/03","群益金鼎-台中",8,554,-546
"5799","2888新光金","110/09/03","凱基-台北",2476,1063,1413
"5800","2888新光金","110/09/03","元大-大甲",18,557,-539
"5801","2888新光金","110/09/03","花旗環球",1073,0,1073
"5802","2888新光金","110/09/03","宏遠-桃園",0,520,-520
"5803","2888新光金","110/09/03","新加坡商瑞銀",936,0,936
"5804","2888新光金","110/09/03","日盛-雙和",2,515,-513
"5805","2888新光金","110/09/03","凱基",789,0,789
"5806","2888新光金","110/09/03","統一-台中",101,595,-494
"5807","2888新光金","110/09/03","元大-苑裡",512,1,511
"5808","2888新光金","110/09/03","國票-嘉義",5,407,-402
"5809","2888新光金","110/09/03","(牛牛牛)亞-鑫豐",570,231,339
"5810","2888新光金","110/09/03","元大-景美",8,372,-364
"5811","2888新光金","110/09/03","元大-彰化民生",413,104,309
"5812","2888新光金","110/09/03","永全-南崁",0,361,-361
"5813","2888新光金","110/09/03","台新-新營",318,13,305
"5814","2888新光金","110/09/03","新光",273,603,-330
"5815","2888新光金","110/09/03","法銀巴黎",300,0,300
"5816","2888新光金","110/09/03","凱基-頭份",0,303,-303
"5817","2888新光金","110/09/03","日進",300,8,292
"5818","2888新光金","110/09/03","合庫證券",60,335,-275
"5819","2888新光金","110/09/03","台灣摩根士丹利",494,257,237
"5820","2888新光金","110/09/03","統一-板橋",112,361,-249
"5821","1340勝悅","110/09/03","元大-前金",63,0,63
"5822","1340勝悅","110/09/03","台中銀",0,26,-26
"5823","1340勝悅","110/09/03","玉山-新竹",20,0,20
"5824","1340勝悅","110/09/03","元大-忠孝鼎富",0,15,-15
"5825","1340勝悅","110/09/03","摩根大通",13,3,10
"5826","1340勝悅","110/09/03","統一-宜蘭",0,11,-11
"5827","1340勝悅","110/09/03","花旗環球",7,0,7
"5828","1340勝悅","110/09/03","合庫-西台中",0,10,-10
"5829","1340勝悅","110/09/03","港商法國興業",6,0,6
"5830","1340勝悅","110/09/03","大昌-新店",0,10,-10
"5831","1340勝悅","110/09/03","瑞士信貸",4,0,4
"5832","1340勝悅","110/09/03","宏遠-桃園",0,8,-8
"5833","1340勝悅","110/09/03","凱基-台北",5,1,4
"5834","1340勝悅","110/09/03","(牛牛牛)亞-鑫豐",0,7,-7
"5835","1340勝悅","110/09/03","美商高盛",3,0,3
"5836","1340勝悅","110/09/03","玉山-桃園",0,7,-7
"5837","1340勝悅","110/09/03","大昌-樹林",3,0,3
"5838","1340勝悅","110/09/03","凱基-北門",0,7,-7
"5839","1340勝悅","110/09/03","凱基",3,0,3
"5840","1340勝悅","110/09/03","新光",1,7,-6
"5841","1340勝悅","110/09/03","元大-大雅",3,0,3
"5842","1340勝悅","110/09/03","統一-城中",0,5,-5
"5843","1340勝悅","110/09/03","元大-和平",3,0,3
"5844","1340勝悅","110/09/03","富邦-陽明",0,4,-4
"5845","1340勝悅","110/09/03","中國信託-文心",2,0,2
"5846","1340勝悅","110/09/03","元大-敦南",0,4,-4
"5847","1340勝悅","110/09/03","凱基-湖口",2,0,2
"5848","1340勝悅","110/09/03","日盛-員林",1,4,-3
"5849","1340勝悅","110/09/03","富邦-北港",2,0,2
"5850","1340勝悅","110/09/03","國泰-敦南",1,4,-3
"5851","6246臺龍","110/09/03","富邦-新竹",11,0,11
"5852","6246臺龍","110/09/03","元富-新店",0,11,-11
"5853","6246臺龍","110/09/03","統一-土城",9,1,8
"5854","6246臺龍","110/09/03","大慶-苗栗",0,8,-8
"5855","6246臺龍","110/09/03","群益金鼎-古亭",7,0,7
"5856","6246臺龍","110/09/03","港商野村",1,8,-7
"5857","6246臺龍","110/09/03","凱基-台北",5,0,5
"5858","6246臺龍","110/09/03","華南永昌-彰化",0,6,-6
"5859","6246臺龍","110/09/03","元富-屏東",4,0,4
"5860","6246臺龍","110/09/03","群益金鼎-永和",0,5,-5
"5861","6246臺龍","110/09/03","日盛-大墩",3,0,3
"5862","6246臺龍","110/09/03","富邦-彰化",0,5,-5
"5863","6246臺龍","110/09/03","元富-台中",3,0,3
"5864","6246臺龍","110/09/03","華南永昌-楠梓",0,4,-4
"5865","6246臺龍","110/09/03","元大-台中中港",3,0,3
"5866","6246臺龍","110/09/03","中國信託-永康",0,2,-2
"5867","6246臺龍","110/09/03","永豐金-苓雅",3,0,3
"5868","6246臺龍","110/09/03","臺銀-金山",0,1,-1
"5869","6246臺龍","110/09/03","日盛-中和",1,0,1
"5870","6246臺龍","110/09/03","第一金-台南",0,1,-1
"5871","6246臺龍","110/09/03","盈溢-楠梓",1,0,1
"5872","6246臺龍","110/09/03","兆豐-岡山",0,1,-1
"5873","6246臺龍","110/09/03","兆豐-新營",1,0,1
"5874","6246臺龍","110/09/03","台新-台中",0,1,-1
"5875","6246臺龍","110/09/03","台新-屏東",2,1,1
"5876","6246臺龍","110/09/03","國泰-桃園",0,1,-1
"5877","6246臺龍","110/09/03","玉山證券",1,0,1
"5878","6246臺龍","110/09/03","群益金鼎-東門",0,1,-1
"5879","6246臺龍","110/09/03","玉山-嘉義",1,0,1
"5880","6246臺龍","110/09/03","華南永昌",0,1,-1
"5881","00715L期街口布蘭特正2","110/09/03","元大證券",14101,122,13979
"5882","00715L期街口布蘭特正2","110/09/03","第一金-台中",2,4435,-4433
"5883","00715L期街口布蘭特正2","110/09/03","永豐金證券",6178,185,5993
"5884","00715L期街口布蘭特正2","110/09/03","豐農",0,1100,-1100
"5885","00715L期街口布蘭特正2","110/09/03","群益金鼎",4720,0,4720
"5886","00715L期街口布蘭特正2","110/09/03","國泰-板橋",0,1068,-1068
"5887","00715L期街口布蘭特正2","110/09/03","凱基-台北",3427,108,3319
"5888","00715L期街口布蘭特正2","110/09/03","群益金鼎-士林",0,900,-900
"5889","00715L期街口布蘭特正2","110/09/03","國票",2729,7,2722
"5890","00715L期街口布蘭特正2","110/09/03","元大-復北",0,890,-890
"5891","00715L期街口布蘭特正2","110/09/03","凱基-市政",2138,7,2131
"5892","00715L期街口布蘭特正2","110/09/03","永豐金-羅東",0,734,-734
"5893","00715L期街口布蘭特正2","110/09/03","富邦證券",1801,266,1535
"5894","00715L期街口布蘭特正2","110/09/03","群益金鼎-板橋",0,720,-720
"5895","00715L期街口布蘭特正2","110/09/03","永豐金-內湖",1500,0,1500
"5896","00715L期街口布蘭特正2","110/09/03","群益金鼎-宜蘭",0,707,-707
"5897","00715L期街口布蘭特正2","110/09/03","元富",1509,29,1480
"5898","00715L期街口布蘭特正2","110/09/03","日盛-新莊",0,666,-666
"5899","00715L期街口布蘭特正2","110/09/03","合庫證券",1190,9,1181
"5900","00715L期街口布蘭特正2","110/09/03","群益金鼎-大甲",14,652,-638
"5901","00715L期街口布蘭特正2","110/09/03","國票-中港",1000,40,960
"5902","00715L期街口布蘭特正2","110/09/03","日盛-和美",6,616,-610
"5903","00715L期街口布蘭特正2","110/09/03","康和",957,0,957
"5904","00715L期街口布蘭特正2","110/09/03","元大-大灣",0,599,-599
"5905","00715L期街口布蘭特正2","110/09/03","統一",720,9,711
"5906","00715L期街口布蘭特正2","110/09/03","中國信託-新竹",0,460,-460
"5907","00715L期街口布蘭特正2","110/09/03","永豐金-三重",625,1,624
"5908","00715L期街口布蘭特正2","110/09/03","玉山-高雄",25,478,-453
"5909","00715L期街口布蘭特正2","110/09/03","永豐金-博愛",500,20,480
"5910","00715L期街口布蘭特正2","110/09/03","宏遠-光隆",0,435,-435
"5911","8941關中","110/09/03","元大-士林",2,0,2
"5912","8941關中","110/09/03","彰銀-台中",0,1,-1
"5913","8941關中","110/09/03","國泰-新莊",1,0,1
"5914","8941關中","110/09/03","玉山-桃園",0,1,-1
"5915","8941關中","110/09/03","凱基-虎尾",1,0,1
"5916","8941關中","110/09/03","元大-豐原",0,1,-1
"5917","8941關中","110/09/03","國泰-高雄",0,0,0
"5918","8941關中","110/09/03","元大-金華",0,1,-1
"5919","8941關中","110/09/03","元大-斗信",0,0,0
"5920","8941關中","110/09/03","國泰-高雄",0,0,0
"5921","8941關中","110/09/03","元大-鹿港",0,0,0
"5922","8941關中","110/09/03","元大-斗信",0,0,0
"5923","8941關中","110/09/03","",NA,NA,NA
"5924","8941關中","110/09/03","元大-鹿港",0,0,0
"5925","8941關中","110/09/03","",NA,NA,NA
"5926","8941關中","110/09/03","",NA,NA,NA
"5927","8941關中","110/09/03","",NA,NA,NA
"5928","8941關中","110/09/03","",NA,NA,NA
"5929","8941關中","110/09/03","",NA,NA,NA
"5930","8941關中","110/09/03","",NA,NA,NA
"5931","8941關中","110/09/03","",NA,NA,NA
"5932","8941關中","110/09/03","",NA,NA,NA
"5933","8941關中","110/09/03","",NA,NA,NA
"5934","8941關中","110/09/03","",NA,NA,NA
"5935","8941關中","110/09/03","",NA,NA,NA
"5936","8941關中","110/09/03","",NA,NA,NA
"5937","8941關中","110/09/03","",NA,NA,NA
"5938","8941關中","110/09/03","",NA,NA,NA
"5939","8941關中","110/09/03","",NA,NA,NA
"5940","8941關中","110/09/03","",NA,NA,NA
"5941","8936國統","110/09/03","華南永昌-高雄",405,0,405
"5942","8936國統","110/09/03","美商高盛",24,188,-164
"5943","8936國統","110/09/03","凱基-台北",306,200,106
"5944","8936國統","110/09/03","台新證券",8,165,-157
"5945","8936國統","110/09/03","第一金-路竹",85,0,85
"5946","8936國統","110/09/03","摩根大通",65,214,-149
"5947","8936國統","110/09/03","凱基-信義",54,0,54
"5948","8936國統","110/09/03","瑞士信貸",0,105,-105
"5949","8936國統","110/09/03","康和-高雄",41,0,41
"5950","8936國統","110/09/03","新加坡商瑞銀",115,216,-101
"5951","8936國統","110/09/03","元大-東泰",61,24,37
"5952","8936國統","110/09/03","合庫-自強",0,100,-100
"5953","8936國統","110/09/03","日盛-北高雄",40,5,35
"5954","8936國統","110/09/03","國泰-高雄",2,100,-98
"5955","8936國統","110/09/03","台新-高雄",36,10,26
"5956","8936國統","110/09/03","合庫-高雄",1,95,-94
"5957","8936國統","110/09/03","統一-新台中",27,2,25
"5958","8936國統","110/09/03","國票-北高雄",2,90,-88
"5959","8936國統","110/09/03","永豐金-竹科",22,0,22
"5960","8936國統","110/09/03","中國信託-高雄",13,100,-87
"5961","8936國統","110/09/03","元大-博愛",22,1,21
"5962","8936國統","110/09/03","港商野村",91,173,-82
"5963","8936國統","110/09/03","元大-鳳山",22,1,21
"5964","8936國統","110/09/03","元富-敦南",17,92,-75
"5965","8936國統","110/09/03","統一-桃園",20,0,20
"5966","8936國統","110/09/03","元大-高雄",2,50,-48
"5967","8936國統","110/09/03","元富-林園",20,0,20
"5968","8936國統","110/09/03","元大-莒光",2,49,-47
"5969","8936國統","110/09/03","元富-緯城",25,5,20
"5970","8936國統","110/09/03","光和-溪湖",3,44,-41
"5971","6226光鼎","110/09/03","台新-台中",348,25,323
"5972","6226光鼎","110/09/03","合庫-台中",0,229,-229
"5973","6226光鼎","110/09/03","摩根大通",251,83,168
"5974","6226光鼎","110/09/03","大展-台南",0,130,-130
"5975","6226光鼎","110/09/03","美林",203,44,159
"5976","6226光鼎","110/09/03","台新-左楠",0,110,-110
"5977","6226光鼎","110/09/03","美商高盛",158,11,147
"5978","6226光鼎","110/09/03","玉山-士林",8,62,-54
"5979","6226光鼎","110/09/03","凱基-台北",141,41,100
"5980","6226光鼎","110/09/03","群益金鼎-開元",31,83,-52
"5981","6226光鼎","110/09/03","臺銀-新竹",72,1,71
"5982","6226光鼎","110/09/03","群益金鼎-西松",1,50,-49
"5983","6226光鼎","110/09/03","大慶-富順",60,0,60
"5984","6226光鼎","110/09/03","元大-板橋三民",14,61,-47
"5985","6226光鼎","110/09/03","凱基-岡山",60,1,59
"5986","6226光鼎","110/09/03","統一-竹南",1,47,-46
"5987","6226光鼎","110/09/03","第一金-桃園",52,0,52
"5988","6226光鼎","110/09/03","日盛-新竹",1,41,-40
"5989","6226光鼎","110/09/03","新加坡商瑞銀",59,9,50
"5990","6226光鼎","110/09/03","元大-員林中山",12,47,-35
"5991","6226光鼎","110/09/03","元大-中壢",70,24,46
"5992","6226光鼎","110/09/03","國泰-館前",35,67,-32
"5993","6226光鼎","110/09/03","元大-新營",46,4,42
"5994","6226光鼎","110/09/03","元大-新莊",4,35,-31
"5995","6226光鼎","110/09/03","華南永昌-世貿",42,1,41
"5996","6226光鼎","110/09/03","元富-敦南",0,30,-30
"5997","6226光鼎","110/09/03","群益金鼎-新竹",38,0,38
"5998","6226光鼎","110/09/03","群益金鼎-台北",6,36,-30
"5999","6226光鼎","110/09/03","元大-路竹",38,2,36
"6000","6226光鼎","110/09/03","元大-大雅",5,34,-29
"6001","2363矽統","110/09/03","凱基-松山",21948,12385,9563
"6002","2363矽統","110/09/03","元大-前金",139,785,-646
"6003","2363矽統","110/09/03","台灣摩根士丹利",5089,3,5086
"6004","2363矽統","110/09/03","國泰-敦南",1244,1857,-613
"6005","2363矽統","110/09/03","統一",4355,245,4110
"6006","2363矽統","110/09/03","新光",893,1469,-576
"6007","2363矽統","110/09/03","摩根大通",5484,2094,3390
"6008","2363矽統","110/09/03","統一-南京",33,497,-464
"6009","2363矽統","110/09/03","凱基-台北",5687,3262,2425
"6010","2363矽統","110/09/03","永豐金-竹科",24,456,-432
"6011","2363矽統","110/09/03","美商高盛",1980,496,1484
"6012","2363矽統","110/09/03","元大-佳里",77,479,-402
"6013","2363矽統","110/09/03","瑞士信貸",1319,12,1307
"6014","2363矽統","110/09/03","群益金鼎-士林",103,503,-400
"6015","2363矽統","110/09/03","統一-土城",1030,41,989
"6016","2363矽統","110/09/03","富邦-彰化",33,393,-360
"6017","2363矽統","110/09/03","日盛-文化",1068,94,974
"6018","2363矽統","110/09/03","華南永昌-公誠",101,459,-358
"6019","2363矽統","110/09/03","凱基-大直",1064,92,972
"6020","2363矽統","110/09/03","台新-左楠",85,441,-356
"6021","2363矽統","110/09/03","新加坡商瑞銀",1692,905,787
"6022","2363矽統","110/09/03","日盛-和美",64,387,-323
"6023","2363矽統","110/09/03","富邦-北港",921,155,766
"6024","2363矽統","110/09/03","光和-和美",7,324,-317
"6025","2363矽統","110/09/03","康和",1172,512,660
"6026","2363矽統","110/09/03","富邦-新竹",198,503,-305
"6027","2363矽統","110/09/03","美林",717,85,632
"6028","2363矽統","110/09/03","凱基-士林",68,364,-296
"6029","2363矽統","110/09/03","永豐金證券",1674,1126,548
"6030","2363矽統","110/09/03","永豐金-南投",60,355,-295
"6031","8112至上","110/09/03","凱基-台北",204,76,128
"6032","8112至上","110/09/03","元大-信義",0,185,-185
"6033","8112至上","110/09/03","美林",146,20,126
"6034","8112至上","110/09/03","富邦-北港",0,70,-70
"6035","8112至上","110/09/03","瑞士信貸",78,0,78
"6036","8112至上","110/09/03","華南永昌-鳳山",0,54,-54
"6037","8112至上","110/09/03","國票-南京",45,0,45
"6038","8112至上","110/09/03","富邦-新竹",2,49,-47
"6039","8112至上","110/09/03","永豐金-竹科",36,0,36
"6040","8112至上","110/09/03","臺灣企銀-桃園",1,45,-44
"6041","8112至上","110/09/03","群益金鼎-士林",25,0,25
"6042","8112至上","110/09/03","元大-北港",8,48,-40
"6043","8112至上","110/09/03","凱基-長庚",25,0,25
"6044","8112至上","110/09/03","國票-九鼎",0,34,-34
"6045","8112至上","110/09/03","美商高盛",23,1,22
"6046","8112至上","110/09/03","摩根大通",85,119,-34
"6047","8112至上","110/09/03","元富-古亭",20,0,20
"6048","8112至上","110/09/03","中國信託",0,20,-20
"6049","8112至上","110/09/03","凱基-文心",20,0,20
"6050","8112至上","110/09/03","永全",0,20,-20
"6051","8112至上","110/09/03","台新證券",19,0,19
"6052","8112至上","110/09/03","富邦-南屯",0,20,-20
"6053","8112至上","110/09/03","(牛牛牛)亞-鑫豐",18,2,16
"6054","8112至上","110/09/03","中國信託-中壢",0,16,-16
"6055","8112至上","110/09/03","凱基-市政",15,0,15
"6056","8112至上","110/09/03","新光-桃園",0,15,-15
"6057","8112至上","110/09/03","元大-善化",15,0,15
"6058","8112至上","110/09/03","元大-林園",0,15,-15
"6059","8112至上","110/09/03","元大-嘉義",15,0,15
"6060","8112至上","110/09/03","宏遠-館前",0,13,-13
"6061","1570力肯","110/09/03","大展",39,0,39
"6062","1570力肯","110/09/03","元大-北成功",0,35,-35
"6063","1570力肯","110/09/03","宏遠證券",35,0,35
"6064","1570力肯","110/09/03","元大-新店中正",0,30,-30
"6065","1570力肯","110/09/03","元大-北三重",16,0,16
"6066","1570力肯","110/09/03","新光",20,43,-23
"6067","1570力肯","110/09/03","元大-新竹經國",15,0,15
"6068","1570力肯","110/09/03","兆豐-寶成",0,18,-18
"6069","1570力肯","110/09/03","大昌",10,0,10
"6070","1570力肯","110/09/03","兆豐-公益",0,15,-15
"6071","1570力肯","110/09/03","兆豐-彰化",10,0,10
"6072","1570力肯","110/09/03","兆豐-嘉義",0,14,-14
"6073","1570力肯","110/09/03","凱基-永康",10,0,10
"6074","1570力肯","110/09/03","國票-博愛",0,9,-9
"6075","1570力肯","110/09/03","元大-內湖",10,0,10
"6076","1570力肯","110/09/03","元大-東泰",0,9,-9
"6077","1570力肯","110/09/03","瑞士信貸",8,0,8
"6078","1570力肯","110/09/03","元大-竹南",0,9,-9
"6079","1570力肯","110/09/03","國泰-台中",6,0,6
"6080","1570力肯","110/09/03","永豐金-虎尾",0,7,-7
"6081","1570力肯","110/09/03","康和-台中",5,0,5
"6082","1570力肯","110/09/03","大慶-泰山",0,6,-6
"6083","1570力肯","110/09/03","凱基-三峽",5,0,5
"6084","1570力肯","110/09/03","元富-敦南",0,6,-6
"6085","1570力肯","110/09/03","華南永昌-苑裡",5,0,5
"6086","1570力肯","110/09/03","凱基-文心",0,6,-6
"6087","1570力肯","110/09/03","元富-緯城",4,0,4
"6088","1570力肯","110/09/03","合庫-台中",0,5,-5
"6089","1570力肯","110/09/03","台新證券",5,1,4
"6090","1570力肯","110/09/03","富邦-內湖",0,5,-5
"6091","2929淘帝","110/09/03","摩根大通",27,0,27
"6092","2929淘帝","110/09/03","兆豐-新營",0,11,-11
"6093","2929淘帝","110/09/03","兆豐-大同",20,0,20
"6094","2929淘帝","110/09/03","日盛-台南",0,10,-10
"6095","2929淘帝","110/09/03","元大-前金",13,0,13
"6096","2929淘帝","110/09/03","元富-基隆",0,10,-10
"6097","2929淘帝","110/09/03","港商法國興業",6,0,6
"6098","2929淘帝","110/09/03","日盛-中壢",0,9,-9
"6099","2929淘帝","110/09/03","花旗環球",6,0,6
"6100","2929淘帝","110/09/03","新光",0,8,-8
"6101","2929淘帝","110/09/03","中國信託-高雄",5,0,5
"6102","2929淘帝","110/09/03","玉山-士林",0,7,-7
"6103","2929淘帝","110/09/03","美林",10,7,3
"6104","2929淘帝","110/09/03","元大-潮州",0,7,-7
"6105","2929淘帝","110/09/03","元富-世貿",3,0,3
"6106","2929淘帝","110/09/03","第一金-忠孝",0,5,-5
"6107","2929淘帝","110/09/03","新光-新竹",3,0,3
"6108","2929淘帝","110/09/03","台新-台中",0,5,-5
"6109","2929淘帝","110/09/03","陽信",3,0,3
"6110","2929淘帝","110/09/03","富邦-新竹",0,5,-5
"6111","2929淘帝","110/09/03","元富-文心",2,0,2
"6112","2929淘帝","110/09/03","國泰-敦南",0,4,-4
"6113","2929淘帝","110/09/03","台新-高雄",4,2,2
"6114","2929淘帝","110/09/03","元富-大裕",0,3,-3
"6115","2929淘帝","110/09/03","群益金鼎-三民",2,0,2
"6116","2929淘帝","110/09/03","富邦-仁愛",0,3,-3
"6117","2929淘帝","110/09/03","華南永昌-公誠",2,0,2
"6118","2929淘帝","110/09/03","富邦-台北",0,2,-2
"6119","2929淘帝","110/09/03","富邦-新店",1,0,1
"6120","2929淘帝","110/09/03","元大-斗六",0,2,-2
"6121","5410國眾","110/09/03","華南永昌-高雄",25,0,25
"6122","5410國眾","110/09/03","群益金鼎-中壢",0,50,-50
"6123","5410國眾","110/09/03","兆豐-嘉義",7,0,7
"6124","5410國眾","110/09/03","永豐金-萬盛",0,17,-17
"6125","5410國眾","110/09/03","凱基-中山",6,0,6
"6126","5410國眾","110/09/03","日盛-屏東",0,6,-6
"6127","5410國眾","110/09/03","國泰-台中",6,1,5
"6128","5410國眾","110/09/03","新光-台中",0,6,-6
"6129","5410國眾","110/09/03","群益金鼎-桃園",5,0,5
"6130","5410國眾","110/09/03","德信-和平",0,5,-5
"6131","5410國眾","110/09/03","富邦-台北",5,0,5
"6132","5410國眾","110/09/03","兆豐-桃園",0,5,-5
"6133","5410國眾","110/09/03","國票-北高雄",4,0,4
"6134","5410國眾","110/09/03","凱基-永康",0,3,-3
"6135","5410國眾","110/09/03","元大-和平",4,0,4
"6136","5410國眾","110/09/03","華南永昌-內壢",0,3,-3
"6137","5410國眾","110/09/03","宏遠-館前",3,0,3
"6138","5410國眾","110/09/03","元大-板橋",0,3,-3
"6139","5410國眾","110/09/03","國泰-敦南",3,0,3
"6140","5410國眾","110/09/03","玉山-新莊",0,2,-2
"6141","5410國眾","110/09/03","永豐金-桃園",3,0,3
"6142","5410國眾","110/09/03","群益金鼎-宜蘭",0,2,-2
"6143","5410國眾","110/09/03","臺銀-新竹",2,0,2
"6144","5410國眾","110/09/03","永豐金-台南",0,2,-2
"6145","5410國眾","110/09/03","台灣企銀-建成",2,0,2
"6146","5410國眾","110/09/03","日盛-高雄",0,1,-1
"6147","5410國眾","110/09/03","中國信託-新竹",2,0,2
"6148","5410國眾","110/09/03","台新-建北",0,1,-1
"6149","5410國眾","110/09/03","富邦-新店",2,0,2
"6150","5410國眾","110/09/03","安泰",0,1,-1
"6151","2841台開","110/09/03","群益金鼎-彰化",150,0,150
"6152","2841台開","110/09/03","華南永昌-台南",1,96,-95
"6153","2841台開","110/09/03","群益金鼎-海山",50,0,50
"6154","2841台開","110/09/03","兆豐-北高雄",0,60,-60
"6155","2841台開","110/09/03","元大-天母",40,0,40
"6156","2841台開","110/09/03","統一-嘉義",0,50,-50
"6157","2841台開","110/09/03","永豐金-板橋",35,0,35
"6158","2841台開","110/09/03","富邦-新竹",0,50,-50
"6159","2841台開","110/09/03","元大-福營",20,0,20
"6160","2841台開","110/09/03","華南永昌-潮州",0,25,-25
"6161","2841台開","110/09/03","宏遠-館前",16,0,16
"6162","2841台開","110/09/03","元大-員林",0,11,-11
"6163","2841台開","110/09/03","元大-歸仁",14,0,14
"6164","2841台開","110/09/03","台新證券",0,10,-10
"6165","2841台開","110/09/03","富邦-岡山",10,0,10
"6166","2841台開","110/09/03","永豐金-敦南",65,75,-10
"6167","2841台開","110/09/03","富邦-建國",6,0,6
"6168","2841台開","110/09/03","日盛證券",5,13,-8
"6169","2841台開","110/09/03","台中銀",5,0,5
"6170","2841台開","110/09/03","永豐金-高雄",0,6,-6
"6171","2841台開","110/09/03","台新-新營",3,0,3
"6172","2841台開","110/09/03","大昌-安康",23,28,-5
"6173","2841台開","110/09/03","群益金鼎-崇德",3,0,3
"6174","2841台開","110/09/03","國泰-館前",0,5,-5
"6175","2841台開","110/09/03","中國信託",2,0,2
"6176","2841台開","110/09/03","新光-桃園",0,4,-4
"6177","2841台開","110/09/03","中國信託-永康",2,0,2
"6178","2841台開","110/09/03","永豐金-桃園",0,4,-4
"6179","2841台開","110/09/03","國泰-台中",2,0,2
"6180","2841台開","110/09/03","兆豐-三民",0,3,-3
"6181","6207雷科","110/09/03","凱基-高美館",41,0,41
"6182","6207雷科","110/09/03","(牛牛牛)亞-鑫豐",0,30,-30
"6183","6207雷科","110/09/03","新加坡商瑞銀",33,4,29
"6184","6207雷科","110/09/03","元大-北成功",0,15,-15
"6185","6207雷科","110/09/03","摩根大通",26,6,20
"6186","6207雷科","110/09/03","元富-板橋",0,10,-10
"6187","6207雷科","110/09/03","美林",16,0,16
"6188","6207雷科","110/09/03","光和-和美",0,10,-10
"6189","6207雷科","110/09/03","凱基-中山",12,0,12
"6190","6207雷科","110/09/03","康和-延平",0,10,-10
"6191","6207雷科","110/09/03","元大-高雄",15,3,12
"6192","6207雷科","110/09/03","元富-成功",0,9,-9
"6193","6207雷科","110/09/03","元大-大里",15,4,11
"6194","6207雷科","110/09/03","致和-金華",0,7,-7
"6195","6207雷科","110/09/03","元大-大統",11,0,11
"6196","6207雷科","110/09/03","凱基-南崁",0,7,-7
"6197","6207雷科","110/09/03","凱基-台北",17,8,9
"6198","6207雷科","110/09/03","新光-台中",0,6,-6
"6199","6207雷科","110/09/03","美商高盛",8,1,7
"6200","6207雷科","110/09/03","玉山-台南",0,6,-6
"6201","6207雷科","110/09/03","宏遠-高雄",6,0,6
"6202","6207雷科","110/09/03","國泰-敦南",0,6,-6
"6203","6207雷科","110/09/03","富隆-長安",6,0,6
"6204","6207雷科","110/09/03","富邦-中壢",0,6,-6
"6205","6207雷科","110/09/03","統一-敦南",5,0,5
"6206","6207雷科","110/09/03","富邦-彰化",0,6,-6
"6207","6207雷科","110/09/03","元大-中壢",5,0,5
"6208","6207雷科","110/09/03","永豐金-板新",0,6,-6
"6209","6207雷科","110/09/03","群益金鼎-瑞豐",7,3,4
"6210","6207雷科","110/09/03","元大-四維",0,5,-5
"6211","3679新至陞","110/09/03","華南永昌-淡水",10,0,10
"6212","3679新至陞","110/09/03","元大-民生",0,8,-8
"6213","3679新至陞","110/09/03","花旗環球",4,0,4
"6214","3679新至陞","110/09/03","瑞士信貸",2,8,-6
"6215","3679新至陞","110/09/03","福邦-新竹",4,0,4
"6216","3679新至陞","110/09/03","美林",0,3,-3
"6217","3679新至陞","110/09/03","元大-大同",3,0,3
"6218","3679新至陞","110/09/03","第一金-澎湖",0,3,-3
"6219","3679新至陞","110/09/03","日盛-文化",2,0,2
"6220","3679新至陞","110/09/03","元大-板橋",0,3,-3
"6221","3679新至陞","110/09/03","國票-新莊",2,0,2
"6222","3679新至陞","110/09/03","宏遠-光隆",0,2,-2
"6223","3679新至陞","110/09/03","富邦-建國",2,0,2
"6224","3679新至陞","110/09/03","港商野村",0,2,-2
"6225","3679新至陞","110/09/03","元大-屏南",2,0,2
"6226","3679新至陞","110/09/03","高橋",0,2,-2
"6227","3679新至陞","110/09/03","日盛-三重",1,0,1
"6228","3679新至陞","110/09/03","元大證券",0,2,-2
"6229","3679新至陞","110/09/03","盈溢-楠梓",1,0,1
"6230","3679新至陞","110/09/03","元大-永春",2,4,-2
"6231","3679新至陞","110/09/03","元富-永和",1,0,1
"6232","3679新至陞","110/09/03","日盛-內湖",0,1,-1
"6233","3679新至陞","110/09/03","兆豐-西螺",1,0,1
"6234","3679新至陞","110/09/03","第一金-新竹",0,1,-1
"6235","3679新至陞","110/09/03","兆豐-彰化",1,0,1
"6236","3679新至陞","110/09/03","元富-松德",0,1,-1
"6237","3679新至陞","110/09/03","國泰-板橋",1,0,1
"6238","3679新至陞","110/09/03","台新-松江",0,1,-1
"6239","3679新至陞","110/09/03","群益金鼎-新莊",1,0,1
"6240","3679新至陞","110/09/03","安泰-大發",0,1,-1
"6241","2727王品","110/09/03","美商高盛",51,0,51
"6242","2727王品","110/09/03","第一金-台中",0,14,-14
"6243","2727王品","110/09/03","台灣摩根士丹利",37,6,31
"6244","2727王品","110/09/03","富邦-仁愛",0,11,-11
"6245","2727王品","110/09/03","港商野村",28,5,23
"6246","2727王品","110/09/03","日茂-埔里",0,10,-10
"6247","2727王品","110/09/03","凱基-台北",30,11,19
"6248","2727王品","110/09/03","摩根大通",12,21,-9
"6249","2727王品","110/09/03","美林",21,6,15
"6250","2727王品","110/09/03","新光",4,13,-9
"6251","2727王品","110/09/03","國泰-敦南",16,5,11
"6252","2727王品","110/09/03","元大-博愛",0,7,-7
"6253","2727王品","110/09/03","群益金鼎-士林",10,0,10
"6254","2727王品","110/09/03","兆豐-台南",0,6,-6
"6255","2727王品","110/09/03","玉山-板橋",10,2,8
"6256","2727王品","110/09/03","華南永昌-合泰",0,6,-6
"6257","2727王品","110/09/03","瑞士信貸",10,3,7
"6258","2727王品","110/09/03","日盛-木柵",0,5,-5
"6259","2727王品","110/09/03","永豐金-中盛",5,0,5
"6260","2727王品","110/09/03","玉山-嘉義",0,5,-5
"6261","2727王品","110/09/03","花旗環球",4,0,4
"6262","2727王品","110/09/03","富邦-陽明",0,5,-5
"6263","2727王品","110/09/03","元大-太平",4,0,4
"6264","2727王品","110/09/03","富邦-中壢",1,6,-5
"6265","2727王品","110/09/03","台新證券",4,1,3
"6266","2727王品","110/09/03","康和",0,4,-4
"6267","2727王品","110/09/03","國泰證券",3,0,3
"6268","2727王品","110/09/03","凱基-竹東",0,4,-4
"6269","2727王品","110/09/03","國泰-桃園",3,0,3
"6270","2727王品","110/09/03","元大-大雅",0,4,-4
"6271","1570力肯","110/09/03","大展",39,0,39
"6272","1570力肯","110/09/03","元大-北成功",0,35,-35
"6273","1570力肯","110/09/03","宏遠證券",35,0,35
"6274","1570力肯","110/09/03","元大-新店中正",0,30,-30
"6275","1570力肯","110/09/03","元大-北三重",16,0,16
"6276","1570力肯","110/09/03","新光",20,43,-23
"6277","1570力肯","110/09/03","元大-新竹經國",15,0,15
"6278","1570力肯","110/09/03","兆豐-寶成",0,18,-18
"6279","1570力肯","110/09/03","大昌",10,0,10
"6280","1570力肯","110/09/03","兆豐-公益",0,15,-15
"6281","1570力肯","110/09/03","兆豐-彰化",10,0,10
"6282","1570力肯","110/09/03","兆豐-嘉義",0,14,-14
"6283","1570力肯","110/09/03","凱基-永康",10,0,10
"6284","1570力肯","110/09/03","國票-博愛",0,9,-9
"6285","1570力肯","110/09/03","元大-內湖",10,0,10
"6286","1570力肯","110/09/03","元大-東泰",0,9,-9
"6287","1570力肯","110/09/03","瑞士信貸",8,0,8
"6288","1570力肯","110/09/03","元大-竹南",0,9,-9
"6289","1570力肯","110/09/03","國泰-台中",6,0,6
"6290","1570力肯","110/09/03","永豐金-虎尾",0,7,-7
"6291","1570力肯","110/09/03","康和-台中",5,0,5
"6292","1570力肯","110/09/03","大慶-泰山",0,6,-6
"6293","1570力肯","110/09/03","凱基-三峽",5,0,5
"6294","1570力肯","110/09/03","元富-敦南",0,6,-6
"6295","1570力肯","110/09/03","華南永昌-苑裡",5,0,5
"6296","1570力肯","110/09/03","凱基-文心",0,6,-6
"6297","1570力肯","110/09/03","元富-緯城",4,0,4
"6298","1570力肯","110/09/03","合庫-台中",0,5,-5
"6299","1570力肯","110/09/03","台新證券",5,1,4
"6300","1570力肯","110/09/03","富邦-內湖",0,5,-5
"6301","6180橘子","110/09/03","台灣摩根士丹利",93,9,84
"6302","6180橘子","110/09/03","康和-澎湖",0,20,-20
"6303","6180橘子","110/09/03","玉山-新莊",14,0,14
"6304","6180橘子","110/09/03","美林",0,14,-14
"6305","6180橘子","110/09/03","凱基-中壢",10,0,10
"6306","6180橘子","110/09/03","凱基-科園",0,10,-10
"6307","6180橘子","110/09/03","摩根大通",12,4,8
"6308","6180橘子","110/09/03","華南永昌-內壢",0,10,-10
"6309","6180橘子","110/09/03","大慶-苗栗",7,0,7
"6310","6180橘子","110/09/03","元大-大雅",4,14,-10
"6311","6180橘子","110/09/03","永豐金-大園",7,0,7
"6312","6180橘子","110/09/03","統一-士林",0,9,-9
"6313","6180橘子","110/09/03","日盛-桃園",5,0,5
"6314","6180橘子","110/09/03","元大-新店中正",0,9,-9
"6315","6180橘子","110/09/03","元富-彰化",5,0,5
"6316","6180橘子","110/09/03","群益金鼎-嘉義",0,8,-8
"6317","6180橘子","110/09/03","兆豐-高雄",5,0,5
"6318","6180橘子","110/09/03","致和證券",0,7,-7
"6319","6180橘子","110/09/03","國泰-敦南",7,2,5
"6320","6180橘子","110/09/03","元大-竹山",0,7,-7
"6321","6180橘子","110/09/03","群益金鼎-敦南",5,0,5
"6322","6180橘子","110/09/03","第一金-台中",0,6,-6
"6323","6180橘子","110/09/03","元大證券",5,0,5
"6324","6180橘子","110/09/03","第一金-中壢",0,5,-5
"6325","6180橘子","110/09/03","合庫-新竹",5,1,4
"6326","6180橘子","110/09/03","第一金-安和",0,5,-5
"6327","6180橘子","110/09/03","美商高盛",4,0,4
"6328","6180橘子","110/09/03","台新證券",2,7,-5
"6329","6180橘子","110/09/03","凱基-土城",4,0,4
"6330","6180橘子","110/09/03","合庫-台中",0,4,-4
"6331","2390云辰","110/09/03","摩根大通",667,46,621
"6332","2390云辰","110/09/03","統一-新台中",2,442,-440
"6333","2390云辰","110/09/03","新加坡商瑞銀",402,0,402
"6334","2390云辰","110/09/03","元富-草屯",5,364,-359
"6335","2390云辰","110/09/03","美商高盛",302,75,227
"6336","2390云辰","110/09/03","凱基-台中",12,184,-172
"6337","2390云辰","110/09/03","凱基-台北",256,86,170
"6338","2390云辰","110/09/03","元大-忠孝",1,150,-149
"6339","2390云辰","110/09/03","美林",116,9,107
"6340","2390云辰","110/09/03","日盛-新莊",29,174,-145
"6341","2390云辰","110/09/03","台灣摩根士丹利",156,73,83
"6342","2390云辰","110/09/03","國票-中和",10,120,-110
"6343","2390云辰","110/09/03","華南永昌-合泰",51,0,51
"6344","2390云辰","110/09/03","統一-新營",2,111,-109
"6345","2390云辰","110/09/03","元大-竹山",52,1,51
"6346","2390云辰","110/09/03","華南永昌-中正",91,173,-82
"6347","2390云辰","110/09/03","港商野村",98,51,47
"6348","2390云辰","110/09/03","元富-安南",2,72,-70
"6349","2390云辰","110/09/03","玉山-台中",46,2,44
"6350","2390云辰","110/09/03","群益金鼎-民權",2,71,-69
"6351","2390云辰","110/09/03","元大-小港",42,0,42
"6352","2390云辰","110/09/03","元大-內湖",3,53,-50
"6353","2390云辰","110/09/03","元富-林園",40,0,40
"6354","2390云辰","110/09/03","國泰-館前",7,56,-49
"6355","2390云辰","110/09/03","凱基-湖口",35,0,35
"6356","2390云辰","110/09/03","凱基-和平",0,46,-46
"6357","2390云辰","110/09/03","凱基-長庚",40,5,35
"6358","2390云辰","110/09/03","土銀-花蓮",0,39,-39
"6359","2390云辰","110/09/03","玉山-高雄",33,1,32
"6360","2390云辰","110/09/03","凱基-彰化",2,34,-32
"6361","2834臺企銀","110/09/02","凱基-台北",3603,1646,1957
"6362","2834臺企銀","110/09/02","新加坡商瑞銀",900,9806,-8906
"6363","2834臺企銀","110/09/02","瑞士信貸",1919,1,1918
"6364","2834臺企銀","110/09/02","台灣摩根士丹利",1313,5660,-4347
"6365","2834臺企銀","110/09/02","新光-台中",1886,26,1860
"6366","2834臺企銀","110/09/02","凱基-宜蘭",10,2003,-1993
"6367","2834臺企銀","110/09/02","港商法國興業",1787,0,1787
"6368","2834臺企銀","110/09/02","美商高盛",485,1313,-828
"6369","2834臺企銀","110/09/02","華南永昌-高雄",617,21,596
"6370","2834臺企銀","110/09/02","兆豐-寶成",4,800,-796
"6371","2834臺企銀","110/09/02","彰銀",505,10,495
"6372","2834臺企銀","110/09/02","港商野村",12,645,-633
"6373","2834臺企銀","110/09/02","元大-高雄",495,0,495
"6374","2834臺企銀","110/09/02","港商麥格理",0,585,-585
"6375","2834臺企銀","110/09/02","永豐金證券",430,0,430
"6376","2834臺企銀","110/09/02","元大-南海",0,550,-550
"6377","2834臺企銀","110/09/02","康和",405,0,405
"6378","2834臺企銀","110/09/02","富邦-台北",32,503,-471
"6379","2834臺企銀","110/09/02","元富-城中",404,16,388
"6380","2834臺企銀","110/09/02","美林",186,515,-329
"6381","2834臺企銀","110/09/02","元大-斗六",329,1,328
"6382","2834臺企銀","110/09/02","摩根大通",800,1106,-306
"6383","2834臺企銀","110/09/02","統一-板橋",565,250,315
"6384","2834臺企銀","110/09/02","元富-虎尾",17,280,-263
"6385","2834臺企銀","110/09/02","兆豐-中壢",222,0,222
"6386","2834臺企銀","110/09/02","元富-林園",3,264,-261
"6387","2834臺企銀","110/09/02","統一-松江",220,0,220
"6388","2834臺企銀","110/09/02","新光-桃園",63,324,-261
"6389","2834臺企銀","110/09/02","大昌",230,10,220
"6390","2834臺企銀","110/09/02","高橋",83,340,-257
"6391","5511德昌","110/09/02","永豐金-市政",122,1,121
"6392","5511德昌","110/09/02","兆豐-台中港",0,50,-50
"6393","5511德昌","110/09/02","玉山-台大",10,0,10
"6394","5511德昌","110/09/02","元大-台中",0,39,-39
"6395","5511德昌","110/09/02","兆豐-南京",9,0,9
"6396","5511德昌","110/09/02","寶盛",0,21,-21
"6397","5511德昌","110/09/02","元大-清水",4,0,4
"6398","5511德昌","110/09/02","永豐金-南京",0,10,-10
"6399","5511德昌","110/09/02","凱基-中壢",3,0,3
"6400","5511德昌","110/09/02","(牛牛牛)亞-鑫豐",0,4,-4
"6401","5511德昌","110/09/02","群益金鼎-潭子",2,0,2
"6402","5511德昌","110/09/02","永豐金-羅東",0,3,-3
"6403","5511德昌","110/09/02","新光",1,0,1
"6404","5511德昌","110/09/02","致和-崇德",0,2,-2
"6405","5511德昌","110/09/02","元富-城中",0,0,0
"6406","5511德昌","110/09/02","凱基-八德",0,2,-2
"6407","5511德昌","110/09/02","元富-新竹",0,0,0
"6408","5511德昌","110/09/02","群益金鼎-中壢",0,2,-2
"6409","5511德昌","110/09/02","國票-台中",0,0,0
"6410","5511德昌","110/09/02","國票-北高雄",0,2,-2
"6411","5511德昌","110/09/02","玉山-數位",0,0,0
"6412","5511德昌","110/09/02","臺銀-高雄",0,2,-2
"6413","5511德昌","110/09/02","華南永昌-彰化",1,1,0
"6414","5511德昌","110/09/02","合庫-彰化",0,2,-2
"6415","5511德昌","110/09/02","元大-西門",0,0,0
"6416","5511德昌","110/09/02","大昌-新店",0,1,-1
"6417","5511德昌","110/09/02","",NA,NA,NA
"6418","5511德昌","110/09/02","合庫-台南",0,1,-1
"6419","5511德昌","110/09/02","",NA,NA,NA
"6420","5511德昌","110/09/02","日盛-宜蘭",0,1,-1
"6421","2489瑞軒","110/09/02","瑞士信貸",150,0,150
"6422","2489瑞軒","110/09/02","美林",51,321,-270
"6423","2489瑞軒","110/09/02","合庫-台中",134,0,134
"6424","2489瑞軒","110/09/02","摩根大通",58,259,-201
"6425","2489瑞軒","110/09/02","兆豐-東門",100,0,100
"6426","2489瑞軒","110/09/02","港商野村",27,173,-146
"6427","2489瑞軒","110/09/02","凱基-竹北",100,1,99
"6428","2489瑞軒","110/09/02","第一金-新興",2,137,-135
"6429","2489瑞軒","110/09/02","華南永昌-虎尾",113,21,92
"6430","2489瑞軒","110/09/02","美商高盛",0,127,-127
"6431","2489瑞軒","110/09/02","日盛-大墩",60,0,60
"6432","2489瑞軒","110/09/02","元大-內湖",1,122,-121
"6433","2489瑞軒","110/09/02","元大-清水",60,0,60
"6434","2489瑞軒","110/09/02","永豐金-新竹",0,100,-100
"6435","2489瑞軒","110/09/02","康和-台中",60,2,58
"6436","2489瑞軒","110/09/02","凱基-台北",37,105,-68
"6437","2489瑞軒","110/09/02","富邦-陽明",50,3,47
"6438","2489瑞軒","110/09/02","台灣摩根士丹利",16,72,-56
"6439","2489瑞軒","110/09/02","元大-土城永寧",41,0,41
"6440","2489瑞軒","110/09/02","元富-四維",0,42,-42
"6441","2489瑞軒","110/09/02","玉山-左營",34,2,32
"6442","2489瑞軒","110/09/02","凱基-和平",22,63,-41
"6443","2489瑞軒","110/09/02","合庫-台南",31,0,31
"6444","2489瑞軒","110/09/02","新加坡商瑞銀",31,65,-34
"6445","2489瑞軒","110/09/02","兆豐-鹿港",30,0,30
"6446","2489瑞軒","110/09/02","元大-楊梅",45,71,-26
"6447","2489瑞軒","110/09/02","華南永昌-苗栗",30,0,30
"6448","2489瑞軒","110/09/02","日茂-埔里",0,23,-23
"6449","2489瑞軒","110/09/02","元大-員林中山",30,1,29
"6450","2489瑞軒","110/09/02","群益金鼎-高盛",2,23,-21
"6451","2428興勤","110/09/02","元大-南京",20,0,20
"6452","2428興勤","110/09/02","港商麥格理",0,69,-69
"6453","2428興勤","110/09/02","台灣摩根士丹利",25,14,11
"6454","2428興勤","110/09/02","富邦-敦南",0,50,-50
"6455","2428興勤","110/09/02","美商高盛",12,2,10
"6456","2428興勤","110/09/02","元大-虎尾",0,40,-40
"6457","2428興勤","110/09/02","中國信託",11,1,10
"6458","2428興勤","110/09/02","新光",6,35,-29
"6459","2428興勤","110/09/02","永豐金-中正",11,1,10
"6460","2428興勤","110/09/02","凱基-台北",11,34,-23
"6461","2428興勤","110/09/02","亞東-高雄",9,0,9
"6462","2428興勤","110/09/02","國票-安和",0,19,-19
"6463","2428興勤","110/09/02","元富-緯城",9,0,9
"6464","2428興勤","110/09/02","台新證券",5,24,-19
"6465","2428興勤","110/09/02","新加坡商瑞銀",35,27,8
"6466","2428興勤","110/09/02","摩根大通",44,59,-15
"6467","2428興勤","110/09/02","國泰-高雄",8,0,8
"6468","2428興勤","110/09/02","瑞士信貸",9,23,-14
"6469","2428興勤","110/09/02","台新-台中",7,0,7
"6470","2428興勤","110/09/02","日盛-南京",0,13,-13
"6471","2428興勤","110/09/02","玉山-左營",7,0,7
"6472","2428興勤","110/09/02","統一",1,13,-12
"6473","2428興勤","110/09/02","凱基-中山",7,0,7
"6474","2428興勤","110/09/02","凱基-信義",0,10,-10
"6475","2428興勤","110/09/02","臺銀-民權",6,0,6
"6476","2428興勤","110/09/02","元富-台中",0,7,-7
"6477","2428興勤","110/09/02","宏遠-桃園",6,0,6
"6478","2428興勤","110/09/02","富邦-新竹",0,6,-6
"6479","2428興勤","110/09/02","凱基-三重",6,0,6
"6480","2428興勤","110/09/02","安泰",0,5,-5
"6481","3176基亞","110/09/02","國票-北投",110,0,110
"6482","3176基亞","110/09/02","宏遠-民生",0,43,-43
"6483","3176基亞","110/09/02","統一-土城",61,0,61
"6484","3176基亞","110/09/02","玉山-南京東路",0,35,-35
"6485","3176基亞","110/09/02","康和-板橋",25,0,25
"6486","3176基亞","110/09/02","富邦-永和",0,35,-35
"6487","3176基亞","110/09/02","凱基-高美館",18,1,17
"6488","3176基亞","110/09/02","富邦-高雄",1,31,-30
"6489","3176基亞","110/09/02","元富-高雄",16,0,16
"6490","3176基亞","110/09/02","萬泰",1,22,-21
"6491","3176基亞","110/09/02","摩根大通",17,1,16
"6492","3176基亞","110/09/02","凱基-三重",0,21,-21
"6493","3176基亞","110/09/02","富邦-仁愛",11,0,11
"6494","3176基亞","110/09/02","新光",4,23,-19
"6495","3176基亞","110/09/02","第一金-嘉義",10,0,10
"6496","3176基亞","110/09/02","國泰-敦南",0,15,-15
"6497","3176基亞","110/09/02","凱基-高雄",8,0,8
"6498","3176基亞","110/09/02","國泰-板橋",4,19,-15
"6499","3176基亞","110/09/02","台新證券",7,0,7
"6500","3176基亞","110/09/02","富邦-竹東",0,12,-12
"6501","3176基亞","110/09/02","富邦-員林",9,2,7
"6502","3176基亞","110/09/02","中國信託-忠孝",0,11,-11
"6503","3176基亞","110/09/02","富邦-虎尾",6,0,6
"6504","3176基亞","110/09/02","統一-員林",0,10,-10
"6505","3176基亞","110/09/02","元大證券",6,0,6
"6506","3176基亞","110/09/02","富邦-北港",1,11,-10
"6507","3176基亞","110/09/02","日盛-永康",5,0,5
"6508","3176基亞","110/09/02","元大-和平",0,10,-10
"6509","3176基亞","110/09/02","宏遠-光隆",5,0,5
"6510","3176基亞","110/09/02","富邦-板橋",1,10,-9
"6511","2409友達","110/09/02","摩根大通",13939,2902,11037
"6512","2409友達","110/09/02","台灣摩根士丹利",3905,23925,-20020
"6513","2409友達","110/09/02","瑞士信貸",7765,239,7526
"6514","2409友達","110/09/02","美林",2916,8870,-5954
"6515","2409友達","110/09/02","凱基-台北",9079,3811,5268
"6516","2409友達","110/09/02","群益金鼎",18,4663,-4645
"6517","2409友達","110/09/02","合庫證券",4069,211,3858
"6518","2409友達","110/09/02","富邦-虎尾",5052,7783,-2731
"6519","2409友達","110/09/02","寶盛",1560,60,1500
"6520","2409友達","110/09/02","第一金-華江",90,2245,-2155
"6521","2409友達","110/09/02","宏遠證券",1286,52,1234
"6522","2409友達","110/09/02","凱基-苗栗",53,1409,-1356
"6523","2409友達","110/09/02","土銀-和平",1014,20,994
"6524","2409友達","110/09/02","康和",734,2081,-1347
"6525","2409友達","110/09/02","玉山-高雄",1134,377,757
"6526","2409友達","110/09/02","港商野村",2398,3664,-1266
"6527","2409友達","110/09/02","陽信",596,17,579
"6528","2409友達","110/09/02","日茂-埔里",13,1105,-1092
"6529","2409友達","110/09/02","富邦-竹北",561,27,534
"6530","2409友達","110/09/02","日盛-和美",174,1250,-1076
"6531","2409友達","110/09/02","新光",1902,1400,502
"6532","2409友達","110/09/02","美商高盛",940,2011,-1071
"6533","2409友達","110/09/02","北城證券",525,46,479
"6534","2409友達","110/09/02","元大-開元",76,1015,-939
"6535","2409友達","110/09/02","中國信託-新竹",566,95,471
"6536","2409友達","110/09/02","花旗環球",1254,2093,-839
"6537","2409友達","110/09/02","國泰-敦南",1371,913,458
"6538","2409友達","110/09/02","元大-南屯",314,1123,-809
"6539","2409友達","110/09/02","宏遠-高雄",445,4,441
"6540","2409友達","110/09/02","康和-新竹",29,812,-783
"6541","1315達新","110/09/02","凱基-中港",12,0,12
"6542","1315達新","110/09/02","永豐金證券",0,6,-6
"6543","1315達新","110/09/02","元大-文心興安",5,0,5
"6544","1315達新","110/09/02","統一-桃園",0,5,-5
"6545","1315達新","110/09/02","永豐金-高雄",5,0,5
"6546","1315達新","110/09/02","致和-東門",0,5,-5
"6547","1315達新","110/09/02","台灣摩根士丹利",4,0,4
"6548","1315達新","110/09/02","富邦-宜蘭",0,3,-3
"6549","1315達新","110/09/02","群益金鼎-彰化",3,0,3
"6550","1315達新","110/09/02","凱基-台北",0,2,-2
"6551","1315達新","110/09/02","美商高盛",2,0,2
"6552","1315達新","110/09/02","富邦-高雄",0,2,-2
"6553","1315達新","110/09/02","亞東-板橋",1,0,1
"6554","1315達新","110/09/02","元富-成功",0,2,-2
"6555","1315達新","110/09/02","台新證券",3,2,1
"6556","1315達新","110/09/02","日盛-大墩",0,2,-2
"6557","1315達新","110/09/02","摩根大通",1,0,1
"6558","1315達新","110/09/02","國票-桃園",0,1,-1
"6559","1315達新","110/09/02","元大證券",1,0,1
"6560","1315達新","110/09/02","國泰-板橋",0,1,-1
"6561","1315達新","110/09/02","元大-花蓮",1,0,1
"6562","1315達新","110/09/02","富邦-台北",0,1,-1
"6563","1315達新","110/09/02","日盛-雙和",0,0,0
"6564","1315達新","110/09/02","元富-大昌",0,1,-1
"6565","1315達新","110/09/02","玉山-數位",0,0,0
"6566","1315達新","110/09/02","元大-天母",0,1,-1
"6567","1315達新","110/09/02","元大-屏東民生",0,0,0
"6568","1315達新","110/09/02","元大-大安",0,1,-1
"6569","1315達新","110/09/02","元大-豐原站前",0,0,0
"6570","1315達新","110/09/02","元大-龍潭",0,1,-1
"6571","2609陽明","110/09/02","康和",4708,555,4153
"6572","2609陽明","110/09/02","富邦證券",986,2072,-1086
"6573","2609陽明","110/09/02","摩根大通",5457,2911,2546
"6574","2609陽明","110/09/02","凱基-台北",977,1940,-963
"6575","2609陽明","110/09/02","新加坡商瑞銀",2881,338,2543
"6576","2609陽明","110/09/02","元大-仁愛",48,601,-553
"6577","2609陽明","110/09/02","美林",3860,2164,1696
"6578","2609陽明","110/09/02","統一-新台中",73,607,-534
"6579","2609陽明","110/09/02","台灣摩根士丹利",1541,85,1456
"6580","2609陽明","110/09/02","群益金鼎-高雄",70,506,-436
"6581","2609陽明","110/09/02","港商麥格理",1258,0,1258
"6582","2609陽明","110/09/02","永豐金證券",153,459,-306
"6583","2609陽明","110/09/02","富邦-虎尾",5424,4714,710
"6584","2609陽明","110/09/02","統一-三重",140,439,-299
"6585","2609陽明","110/09/02","永豐金-信義",749,51,698
"6586","2609陽明","110/09/02","統一-桃園",158,447,-289
"6587","2609陽明","110/09/02","統一-仁愛",3359,2671,688
"6588","2609陽明","110/09/02","國泰-敦南",1735,2011,-276
"6589","2609陽明","110/09/02","元大-開元",661,64,597
"6590","2609陽明","110/09/02","元大-南崁",43,316,-273
"6591","2609陽明","110/09/02","凱基-桃園",713,174,539
"6592","2609陽明","110/09/02","永豐金-古亭",44,310,-266
"6593","2609陽明","110/09/02","元大-南屯",523,129,394
"6594","2609陽明","110/09/02","兆豐-板橋",224,478,-254
"6595","2609陽明","110/09/02","第一金-桃園",498,121,377
"6596","2609陽明","110/09/02","新光",1385,1635,-250
"6597","2609陽明","110/09/02","元富",290,30,260
"6598","2609陽明","110/09/02","凱基-竹北",102,352,-250
"6599","2609陽明","110/09/02","兆豐-虎尾",628,369,259
"6600","2609陽明","110/09/02","富邦-南屯",136,384,-248
"6601","2636台驊投控","110/09/02","美商高盛",219,22,197
"6602","2636台驊投控","110/09/02","統一-新台中",3,162,-159
"6603","2636台驊投控","110/09/02","摩根大通",262,70,192
"6604","2636台驊投控","110/09/02","日盛-景美",8,120,-112
"6605","2636台驊投控","110/09/02","台灣摩根士丹利",185,3,182
"6606","2636台驊投控","110/09/02","台新證券",16,60,-44
"6607","2636台驊投控","110/09/02","美林",226,45,181
"6608","2636台驊投控","110/09/02","群益金鼎-古亭",32,73,-41
"6609","2636台驊投控","110/09/02","國票-安和",150,1,149
"6610","2636台驊投控","110/09/02","群益金鼎-中壢",0,36,-36
"6611","2636台驊投控","110/09/02","國票-南港",120,0,120
"6612","2636台驊投控","110/09/02","第一金-員林",1,35,-34
"6613","2636台驊投控","110/09/02","新加坡商瑞銀",141,23,118
"6614","2636台驊投控","110/09/02","華南永昌-虎尾",12,44,-32
"6615","2636台驊投控","110/09/02","凱基-台北",179,89,90
"6616","2636台驊投控","110/09/02","元大-左營",0,29,-29
"6617","2636台驊投控","110/09/02","港商野村",604,521,83
"6618","2636台驊投控","110/09/02","日盛-台中",3,30,-27
"6619","2636台驊投控","110/09/02","瑞士信貸",83,11,72
"6620","2636台驊投控","110/09/02","永豐金-員林",1,27,-26
"6621","2636台驊投控","110/09/02","群益金鼎-南京",42,0,42
"6622","2636台驊投控","110/09/02","花旗環球",0,25,-25
"6623","2636台驊投控","110/09/02","元大-林森",72,42,30
"6624","2636台驊投控","110/09/02","凱基-鳳山",2,27,-25
"6625","2636台驊投控","110/09/02","元大-敦南",44,16,28
"6626","2636台驊投控","110/09/02","永豐金-中正",2,26,-24
"6627","2636台驊投控","110/09/02","永豐金-屏東",30,4,26
"6628","2636台驊投控","110/09/02","康和-延平",50,73,-23
"6629","2636台驊投控","110/09/02","元大-天母",28,4,24
"6630","2636台驊投控","110/09/02","元富-成功",3,25,-22
"6631","2867三商壽","110/09/02","統一-平鎮",850,0,850
"6632","2867三商壽","110/09/02","新光-新竹",0,709,-709
"6633","2867三商壽","110/09/02","元大-桃園",150,0,150
"6634","2867三商壽","110/09/02","元富-新興",5,300,-295
"6635","2867三商壽","110/09/02","凱基-中壢",140,0,140
"6636","2867三商壽","110/09/02","新光",115,367,-252
"6637","2867三商壽","110/09/02","美商高盛",177,38,139
"6638","2867三商壽","110/09/02","美林",36,281,-245
"6639","2867三商壽","110/09/02","凱基-台北",131,22,109
"6640","2867三商壽","110/09/02","摩根大通",0,211,-211
"6641","2867三商壽","110/09/02","日盛-頭份",100,0,100
"6642","2867三商壽","110/09/02","台新證券",7,114,-107
"6643","2867三商壽","110/09/02","新光-台中",109,21,88
"6644","2867三商壽","110/09/02","臺銀-臺南",1,100,-99
"6645","2867三商壽","110/09/02","元大-豐原站前",79,0,79
"6646","2867三商壽","110/09/02","新加坡商瑞銀",8,99,-91
"6647","2867三商壽","110/09/02","永豐金-永康",61,0,61
"6648","2867三商壽","110/09/02","國票-南京",0,80,-80
"6649","2867三商壽","110/09/02","日盛-中和",60,3,57
"6650","2867三商壽","110/09/02","凱基-士林",0,50,-50
"6651","2867三商壽","110/09/02","國票-台南",50,0,50
"6652","2867三商壽","110/09/02","元大-四維",5,50,-45
"6653","2867三商壽","110/09/02","華南永昌-虎尾",64,14,50
"6654","2867三商壽","110/09/02","兆豐-新營",0,41,-41
"6655","2867三商壽","110/09/02","元大-彰化民生",50,0,50
"6656","2867三商壽","110/09/02","永豐金-高雄",0,40,-40
"6657","2867三商壽","110/09/02","凱基-高雄",50,1,49
"6658","2867三商壽","110/09/02","日茂-南投",0,34,-34
"6659","2867三商壽","110/09/02","瑞士信貸",46,0,46
"6660","2867三商壽","110/09/02","(牛牛牛)亞-網路",0,26,-26
"6661","5521工信","110/09/02","群益金鼎-台南",150,0,150
"6662","5521工信","110/09/02","永豐金證券",2,223,-221
"6663","5521工信","110/09/02","富邦-台北",130,0,130
"6664","5521工信","110/09/02","台灣摩根士丹利",27,188,-161
"6665","5521工信","110/09/02","玉山-台大",95,0,95
"6666","5521工信","110/09/02","元大-成功",0,100,-100
"6667","5521工信","110/09/02","華南永昌",68,5,63
"6668","5521工信","110/09/02","元富-大昌",2,100,-98
"6669","5521工信","110/09/02","富邦-板橋",62,0,62
"6670","5521工信","110/09/02","凱基-台北",468,542,-74
"6671","5521工信","110/09/02","凱基-宜蘭",55,0,55
"6672","5521工信","110/09/02","新百王",0,50,-50
"6673","5521工信","110/09/02","日盛-高雄",50,0,50
"6674","5521工信","110/09/02","群益金鼎-崇德",0,50,-50
"6675","5521工信","110/09/02","康和-澎湖",50,0,50
"6676","5521工信","110/09/02","華南永昌-民權",0,50,-50
"6677","5521工信","110/09/02","玉山-左營",50,0,50
"6678","5521工信","110/09/02","福勝",3,49,-46
"6679","5521工信","110/09/02","元大-小港",44,0,44
"6680","5521工信","110/09/02","摩根大通",162,206,-44
"6681","5521工信","110/09/02","凱基-站前",45,2,43
"6682","5521工信","110/09/02","臺銀",1,35,-34
"6683","5521工信","110/09/02","富邦-員林",43,0,43
"6684","5521工信","110/09/02","高橋-內壢",0,30,-30
"6685","5521工信","110/09/02","國票-中港",40,0,40
"6686","5521工信","110/09/02","第一金-華江",0,30,-30
"6687","5521工信","110/09/02","元大-旗山",40,0,40
"6688","5521工信","110/09/02","華南永昌-彰化",0,28,-28
"6689","5521工信","110/09/02","瑞士信貸",39,0,39
"6690","5521工信","110/09/02","台新-新莊",3,30,-27
"6691","1471首利","110/09/02","元富-民權",60,0,60
"6692","1471首利","110/09/02","摩根大通",12,98,-86
"6693","1471首利","110/09/02","元富-花蓮",20,0,20
"6694","1471首利","110/09/02","中國信託-文心",0,40,-40
"6695","1471首利","110/09/02","大昌-桃園",20,0,20
"6696","1471首利","110/09/02","宏遠-桃園",0,35,-35
"6697","1471首利","110/09/02","台新-松江",20,0,20
"6698","1471首利","110/09/02","台灣摩根士丹利",0,34,-34
"6699","1471首利","110/09/02","凱基-內埔",15,0,15
"6700","1471首利","110/09/02","元大-西門",0,29,-29
"6701","1471首利","110/09/02","凱基-市府",12,0,12
"6702","1471首利","110/09/02","美林",0,24,-24
"6703","1471首利","110/09/02","元大-頭份",12,0,12
"6704","1471首利","110/09/02","瑞士信貸",1,23,-22
"6705","1471首利","110/09/02","日盛-鳳山",10,0,10
"6706","1471首利","110/09/02","宏遠-光隆",0,20,-20
"6707","1471首利","110/09/02","中國信託",10,0,10
"6708","1471首利","110/09/02","台中銀-員林",0,20,-20
"6709","1471首利","110/09/02","國泰-台南",10,0,10
"6710","1471首利","110/09/02","元大-莒光",1,20,-19
"6711","1471首利","110/09/02","富邦-永和",10,0,10
"6712","1471首利","110/09/02","聯邦-高雄",0,13,-13
"6713","1471首利","110/09/02","富邦-南屯",10,0,10
"6714","1471首利","110/09/02","日盛-八德",0,11,-11
"6715","1471首利","110/09/02","富邦-新營",10,0,10
"6716","1471首利","110/09/02","凱基-台北",3,14,-11
"6717","1471首利","110/09/02","元大-南崁",10,0,10
"6718","1471首利","110/09/02","國泰-館前",0,10,-10
"6719","1471首利","110/09/02","元大-松山",10,0,10
"6720","1471首利","110/09/02","元大-中壢",0,10,-10
"6721","2883開發金","110/09/02","玉山證券",4630,30,4600
"6722","2883開發金","110/09/02","臺銀-新竹",2429,10392,-7963
"6723","2883開發金","110/09/02","凱基-新店",1053,0,1053
"6724","2883開發金","110/09/02","元大證券",934,7552,-6618
"6725","2883開發金","110/09/02","玉山-大里",1094,61,1033
"6726","2883開發金","110/09/02","元富",1212,6466,-5254
"6727","2883開發金","110/09/02","台新證券",1142,197,945
"6728","2883開發金","110/09/02","台灣摩根士丹利",873,4900,-4027
"6729","2883開發金","110/09/02","新光",2576,1805,771
"6730","2883開發金","110/09/02","瑞士信貸",101,3288,-3187
"6731","2883開發金","110/09/02","國泰-敦南",1107,404,703
"6732","2883開發金","110/09/02","凱基-台北",2289,4969,-2680
"6733","2883開發金","110/09/02","臺銀",649,25,624
"6734","2883開發金","110/09/02","國票-南京",0,2000,-2000
"6735","2883開發金","110/09/02","新光-台中",629,24,605
"6736","2883開發金","110/09/02","美林",1044,2979,-1935
"6737","2883開發金","110/09/02","國票-安和",569,0,569
"6738","2883開發金","110/09/02","兆豐-北高雄",115,1602,-1487
"6739","2883開發金","110/09/02","國泰-板橋",617,57,560
"6740","2883開發金","110/09/02","港商野村",1290,2552,-1262
"6741","2883開發金","110/09/02","兆豐-台中港",583,30,553
"6742","2883開發金","110/09/02","兆豐-竹北",234,1375,-1141
"6743","2883開發金","110/09/02","國票-長城",510,2,508
"6744","2883開發金","110/09/02","群益金鼎-南京",9,1125,-1116
"6745","2883開發金","110/09/02","中國信託",550,47,503
"6746","2883開發金","110/09/02","永豐金-台南",139,1126,-987
"6747","2883開發金","110/09/02","兆豐-高雄",413,12,401
"6748","2883開發金","110/09/02","亞東-新竹",1173,2062,-889
"6749","2883開發金","110/09/02","統一-新竹",369,0,369
"6750","2883開發金","110/09/02","日盛-台中",3,635,-632
"6751","6205詮欣","110/09/02","合庫-三重",33,0,33
"6752","6205詮欣","110/09/02","日盛-三重",0,53,-53
"6753","6205詮欣","110/09/02","元大-向上",19,0,19
"6754","6205詮欣","110/09/02","元大-中和",0,17,-17
"6755","6205詮欣","110/09/02","摩根大通",9,2,7
"6756","6205詮欣","110/09/02","玉山證券",0,5,-5
"6757","6205詮欣","110/09/02","永豐金證券",4,0,4
"6758","6205詮欣","110/09/02","群益金鼎-基隆",0,3,-3
"6759","6205詮欣","110/09/02","元大-南投",4,0,4
"6760","6205詮欣","110/09/02","日盛-台中",0,2,-2
"6761","6205詮欣","110/09/02","元大-汐止",3,0,3
"6762","6205詮欣","110/09/02","美林",0,2,-2
"6763","6205詮欣","110/09/02","國票",3,0,3
"6764","6205詮欣","110/09/02","兆豐-桃園",0,2,-2
"6765","6205詮欣","110/09/02","玉山-高雄",3,0,3
"6766","6205詮欣","110/09/02","兆豐-新營",0,1,-1
"6767","6205詮欣","110/09/02","玉山-新莊",2,0,2
"6768","6205詮欣","110/09/02","凱基-桃園",0,1,-1
"6769","6205詮欣","110/09/02","臺銀-臺中",1,0,1
"6770","6205詮欣","110/09/02","華南永昌-東昇",0,1,-1
"6771","6205詮欣","110/09/02","台新-台中",1,0,1
"6772","6205詮欣","110/09/02","富邦-板橋",0,1,-1
"6773","6205詮欣","110/09/02","台新-高雄",1,0,1
"6774","6205詮欣","110/09/02","永豐金-中和",0,1,-1
"6775","6205詮欣","110/09/02","兆豐-竹北",1,0,1
"6776","6205詮欣","110/09/02","康和-板橋",0,0,0
"6777","6205詮欣","110/09/02","瑞士信貸",2,1,1
"6778","6205詮欣","110/09/02","華南永昌-高雄",0,0,0
"6779","6205詮欣","110/09/02","日盛-中和",1,0,1
"6780","6205詮欣","110/09/02","元大-民生",2,2,0
"6781","1540喬福","110/09/02","元富-板橋",17,0,17
"6782","1540喬福","110/09/02","富邦-中壢",0,13,-13
"6783","1540喬福","110/09/02","元大-四維",5,0,5
"6784","1540喬福","110/09/02","摩根大通",0,5,-5
"6785","1540喬福","110/09/02","元富-中原",3,0,3
"6786","1540喬福","110/09/02","富邦-台南",0,5,-5
"6787","1540喬福","110/09/02","元大-大雅",2,0,2
"6788","1540喬福","110/09/02","富邦-虎尾",0,5,-5
"6789","1540喬福","110/09/02","元大-竹東",2,0,2
"6790","1540喬福","110/09/02","永豐金-鳳山",0,5,-5
"6791","1540喬福","110/09/02","兆豐-員林",2,0,2
"6792","1540喬福","110/09/02","元大-斗信",0,4,-4
"6793","1540喬福","110/09/02","元大-頭份",2,0,2
"6794","1540喬福","110/09/02","元大-龍潭",0,2,-2
"6795","1540喬福","110/09/02","群益金鼎-館前",5,3,2
"6796","1540喬福","110/09/02","永豐金-高雄",0,2,-2
"6797","1540喬福","110/09/02","富邦-建國",2,0,2
"6798","1540喬福","110/09/02","台新證券",0,1,-1
"6799","1540喬福","110/09/02","富邦-仁愛",2,0,2
"6800","1540喬福","110/09/02","元大-東蘆",0,1,-1
"6801","1540喬福","110/09/02","統一-汐止",1,0,1
"6802","1540喬福","110/09/02","美林",1,1,0
"6803","1540喬福","110/09/02","元大-彰化",1,0,1
"6804","1540喬福","110/09/02","康和-板橋",0,0,0
"6805","1540喬福","110/09/02","凱基-台北",1,0,1
"6806","1540喬福","110/09/02","新光",0,0,0
"6807","1540喬福","110/09/02","元富",1,0,1
"6808","1540喬福","110/09/02","元大-竹北",0,0,0
"6809","1540喬福","110/09/02","元大-竹北",0,0,0
"6810","1540喬福","110/09/02","元大-鹿港",0,0,0
"6811","2888新光金","110/09/02","瑞士信貸",4150,60,4090
"6812","2888新光金","110/09/02","臺銀-高雄",126,7509,-7383
"6813","2888新光金","110/09/02","元大證券",2179,241,1938
"6814","2888新光金","110/09/02","國票-長城",23,3040,-3017
"6815","2888新光金","110/09/02","凱基-台北",2132,1288,844
"6816","2888新光金","110/09/02","日盛-台中",68,2972,-2904
"6817","2888新光金","110/09/02","凱基-站前",856,16,840
"6818","2888新光金","110/09/02","美林",275,3018,-2743
"6819","2888新光金","110/09/02","(牛牛牛)亞-網路",850,48,802
"6820","2888新光金","110/09/02","台灣摩根士丹利",279,2624,-2345
"6821","2888新光金","110/09/02","台新-台中",681,49,632
"6822","2888新光金","110/09/02","台新-三民",74,2010,-1936
"6823","2888新光金","110/09/02","宏遠-桃園",637,20,617
"6824","2888新光金","110/09/02","永豐金證券",270,2043,-1773
"6825","2888新光金","110/09/02","元大-南海",595,0,595
"6826","2888新光金","110/09/02","港商野村",8,1614,-1606
"6827","2888新光金","110/09/02","富邦-建國",659,70,589
"6828","2888新光金","110/09/02","永豐金-桃園",50,1504,-1454
"6829","2888新光金","110/09/02","兆豐-台中港",539,3,536
"6830","2888新光金","110/09/02","永全-南崁",611,1862,-1251
"6831","2888新光金","110/09/02","兆豐-三民",530,0,530
"6832","2888新光金","110/09/02","凱基-新店",3,1150,-1147
"6833","2888新光金","110/09/02","日盛-雙和",606,80,526
"6834","2888新光金","110/09/02","元大-豐原",47,1060,-1013
"6835","2888新光金","110/09/02","群益金鼎-台中",621,112,509
"6836","2888新光金","110/09/02","美商高盛",12,861,-849
"6837","2888新光金","110/09/02","中農",499,20,479
"6838","2888新光金","110/09/02","臺銀-金山",125,833,-708
"6839","2888新光金","110/09/02","華南永昌-中正",438,6,432
"6840","2888新光金","110/09/02","元大-四維",76,779,-703
"6841","1340勝悅","110/09/02","玉山-新竹",33,0,33
"6842","1340勝悅","110/09/02","台中銀",0,27,-27
"6843","1340勝悅","110/09/02","宏遠-館前",10,0,10
"6844","1340勝悅","110/09/02","日盛證券",0,10,-10
"6845","1340勝悅","110/09/02","華南永昌-虎尾",6,0,6
"6846","1340勝悅","110/09/02","群益金鼎-敦南",0,10,-10
"6847","1340勝悅","110/09/02","臺銀",5,0,5
"6848","1340勝悅","110/09/02","美林",0,9,-9
"6849","1340勝悅","110/09/02","臺銀-鳳山",5,0,5
"6850","1340勝悅","110/09/02","統一-新營",0,8,-8
"6851","1340勝悅","110/09/02","凱基-北門",5,0,5
"6852","1340勝悅","110/09/02","玉山-桃園",0,8,-8
"6853","1340勝悅","110/09/02","元富-新店",4,0,4
"6854","1340勝悅","110/09/02","摩根大通",0,7,-7
"6855","1340勝悅","110/09/02","新光",4,0,4
"6856","1340勝悅","110/09/02","日盛-員林",0,6,-6
"6857","1340勝悅","110/09/02","國泰-敦南",4,0,4
"6858","1340勝悅","110/09/02","元大-龍潭",0,5,-5
"6859","1340勝悅","110/09/02","美商高盛",3,0,3
"6860","1340勝悅","110/09/02","大慶-苗栗",0,4,-4
"6861","1340勝悅","110/09/02","元大-基隆",3,0,3
"6862","1340勝悅","110/09/02","凱基-台中",0,4,-4
"6863","1340勝悅","110/09/02","臺灣企銀-埔墘",2,0,2
"6864","1340勝悅","110/09/02","元富-板橋",0,3,-3
"6865","1340勝悅","110/09/02","光和",2,0,2
"6866","1340勝悅","110/09/02","永豐金-苓雅",0,3,-3
"6867","1340勝悅","110/09/02","兆豐-大安",2,0,2
"6868","1340勝悅","110/09/02","日盛-景美",0,2,-2
"6869","1340勝悅","110/09/02","國票-長城",2,0,2
"6870","1340勝悅","110/09/02","統一-城中",6,8,-2
"6871","6246臺龍","110/09/02","宏遠-館前",32,13,19
"6872","6246臺龍","110/09/02","元大-南投",0,19,-19
"6873","6246臺龍","110/09/02","元富-新店",11,0,11
"6874","6246臺龍","110/09/02","永豐金-松山",0,15,-15
"6875","6246臺龍","110/09/02","德信-新營",10,0,10
"6876","6246臺龍","110/09/02","群益金鼎-古亭",0,10,-10
"6877","6246臺龍","110/09/02","元大-屏南",10,0,10
"6878","6246臺龍","110/09/02","大昌-桃園",0,5,-5
"6879","6246臺龍","110/09/02","華南永昌-彰化",6,0,6
"6880","6246臺龍","110/09/02","凱基-台北",1,6,-5
"6881","6246臺龍","110/09/02","群益金鼎-永和",5,0,5
"6882","6246臺龍","110/09/02","元大-金門",0,5,-5
"6883","6246臺龍","110/09/02","(牛牛牛)亞-鑫豐",4,0,4
"6884","6246臺龍","110/09/02","元富-吉利",0,4,-4
"6885","6246臺龍","110/09/02","華南永昌-公誠",4,0,4
"6886","6246臺龍","110/09/02","國泰-板橋",0,4,-4
"6887","6246臺龍","110/09/02","富邦-板橋",5,1,4
"6888","6246臺龍","110/09/02","第一金-頭份",0,3,-3
"6889","6246臺龍","110/09/02","元富-埔里",3,0,3
"6890","6246臺龍","110/09/02","新光-新竹",0,3,-3
"6891","6246臺龍","110/09/02","元富-新興",3,0,3
"6892","6246臺龍","110/09/02","港商野村",3,5,-2
"6893","6246臺龍","110/09/02","兆豐-新營",3,0,3
"6894","6246臺龍","110/09/02","國票-北高雄",0,2,-2
"6895","6246臺龍","110/09/02","國票-桃園",3,0,3
"6896","6246臺龍","110/09/02","國票-敦北法人",0,2,-2
"6897","6246臺龍","110/09/02","華南永昌-台中",3,0,3
"6898","6246臺龍","110/09/02","台新-台南",0,2,-2
"6899","6246臺龍","110/09/02","元大-大雅",3,0,3
"6900","6246臺龍","110/09/02","台新-屏東",0,2,-2
"6901","00715L期街口布蘭特正2","110/09/02","元大證券",5620,931,4689
"6902","00715L期街口布蘭特正2","110/09/02","元大-復北",0,1372,-1372
"6903","00715L期街口布蘭特正2","110/09/02","(牛牛牛)亞-鑫豐",1283,115,1168
"6904","00715L期街口布蘭特正2","110/09/02","凱基-新豐",0,1053,-1053
"6905","00715L期街口布蘭特正2","110/09/02","永豐金證券",1199,60,1139
"6906","00715L期街口布蘭特正2","110/09/02","永豐金-市政",0,829,-829
"6907","00715L期街口布蘭特正2","110/09/02","元大-萬華",920,0,920
"6908","00715L期街口布蘭特正2","110/09/02","新光-台中",221,719,-498
"6909","00715L期街口布蘭特正2","110/09/02","群益金鼎",829,0,829
"6910","00715L期街口布蘭特正2","110/09/02","玉山-雙和",0,420,-420
"6911","00715L期街口布蘭特正2","110/09/02","統一",787,0,787
"6912","00715L期街口布蘭特正2","110/09/02","中國信託-新竹",0,400,-400
"6913","00715L期街口布蘭特正2","110/09/02","康和",1080,412,668
"6914","00715L期街口布蘭特正2","110/09/02","兆豐-台中港",12,362,-350
"6915","00715L期街口布蘭特正2","110/09/02","元富",609,0,609
"6916","00715L期街口布蘭特正2","110/09/02","康和-嘉義",0,300,-300
"6917","00715L期街口布蘭特正2","110/09/02","台新-台中",543,43,500
"6918","00715L期街口布蘭特正2","110/09/02","台中銀-豐原",12,310,-298
"6919","00715L期街口布蘭特正2","110/09/02","元富-大裕",478,0,478
"6920","00715L期街口布蘭特正2","110/09/02","元大-草屯",7,254,-247
"6921","00715L期街口布蘭特正2","110/09/02","群益金鼎-台中",354,1,353
"6922","00715L期街口布蘭特正2","110/09/02","凱基-站前",0,245,-245
"6923","00715L期街口布蘭特正2","110/09/02","元大-花蓮",146,11,135
"6924","00715L期街口布蘭特正2","110/09/02","凱基-城中",0,237,-237
"6925","00715L期街口布蘭特正2","110/09/02","元大-前金",102,0,102
"6926","00715L期街口布蘭特正2","110/09/02","富邦-台北",5,223,-218
"6927","00715L期街口布蘭特正2","110/09/02","中國信託-高雄",102,19,83
"6928","00715L期街口布蘭特正2","110/09/02","新光",125,342,-217
"6929","00715L期街口布蘭特正2","110/09/02","元大-大雅",95,22,73
"6930","00715L期街口布蘭特正2","110/09/02","兆豐-嘉義",0,206,-206
"6931","8941關中","110/09/02","高橋-內壢",2,0,2
"6932","8941關中","110/09/02","元大-金華",0,2,-2
"6933","8941關中","110/09/02","日盛-板橋",1,0,1
"6934","8941關中","110/09/02","統一-彰化",0,1,-1
"6935","8941關中","110/09/02","凱基-市府",1,0,1
"6936","8941關中","110/09/02","國泰-忠孝",0,1,-1
"6937","8941關中","110/09/02","宏遠-館前",0,0,0
"6938","8941關中","110/09/02","宏遠-館前",0,0,0
"6939","8941關中","110/09/02","元大-淡水",0,0,0
"6940","8941關中","110/09/02","元大-淡水",0,0,0
"6941","8941關中","110/09/02","元大-鹿港",0,0,0
"6942","8941關中","110/09/02","元大-鹿港",0,0,0
"6943","8941關中","110/09/02","永豐金-敦北",0,0,0
"6944","8941關中","110/09/02","永豐金-敦北",0,0,0
"6945","8941關中","110/09/02","永豐金-萬盛",0,0,0
"6946","8941關中","110/09/02","永豐金-萬盛",0,0,0
"6947","8941關中","110/09/02","永豐金-南投",0,0,0
"6948","8941關中","110/09/02","永豐金-南投",0,0,0
"6949","8941關中","110/09/02","",NA,NA,NA
"6950","8941關中","110/09/02","",NA,NA,NA
"6951","8941關中","110/09/02","",NA,NA,NA
"6952","8941關中","110/09/02","",NA,NA,NA
"6953","8941關中","110/09/02","",NA,NA,NA
"6954","8941關中","110/09/02","",NA,NA,NA
"6955","8941關中","110/09/02","",NA,NA,NA
"6956","8941關中","110/09/02","",NA,NA,NA
"6957","8941關中","110/09/02","",NA,NA,NA
"6958","8941關中","110/09/02","",NA,NA,NA
"6959","8941關中","110/09/02","",NA,NA,NA
"6960","8941關中","110/09/02","",NA,NA,NA
"6961","8936國統","110/09/02","台新證券",163,5,158
"6962","8936國統","110/09/02","永豐金-竹科",10,150,-140
"6963","8936國統","110/09/02","新加坡商瑞銀",163,51,112
"6964","8936國統","110/09/02","摩根大通",59,163,-104
"6965","8936國統","110/09/02","美林",120,13,107
"6966","8936國統","110/09/02","永豐金-高雄",1,100,-99
"6967","8936國統","110/09/02","華南永昌-高雄",91,0,91
"6968","8936國統","110/09/02","瑞士信貸",1,72,-71
"6969","8936國統","110/09/02","凱基-台北",174,108,66
"6970","8936國統","110/09/02","永豐金-彰化",5,56,-51
"6971","8936國統","110/09/02","元大-東泰",59,9,50
"6972","8936國統","110/09/02","元大-旗山",0,24,-24
"6973","8936國統","110/09/02","日盛-樹林",40,0,40
"6974","8936國統","110/09/02","大昌-新店",0,19,-19
"6975","8936國統","110/09/02","台新-高雄",40,9,31
"6976","8936國統","110/09/02","元大-南京",2,20,-18
"6977","8936國統","110/09/02","新光-台中",37,9,28
"6978","8936國統","110/09/02","國票-中正",0,16,-16
"6979","8936國統","110/09/02","美商高盛",57,31,26
"6980","8936國統","110/09/02","富邦-高雄",0,15,-15
"6981","8936國統","110/09/02","日盛-北高雄",41,16,25
"6982","8936國統","110/09/02","宏遠-新化",0,14,-14
"6983","8936國統","110/09/02","元富-敦南",25,0,25
"6984","8936國統","110/09/02","中國信託-高雄",0,13,-13
"6985","8936國統","110/09/02","國泰-敦南",29,9,20
"6986","8936國統","110/09/02","群益金鼎-忠孝",8,21,-13
"6987","8936國統","110/09/02","凱基-信義",20,1,19
"6988","8936國統","110/09/02","臺銀-金山",0,11,-11
"6989","8936國統","110/09/02","玉山-大里",16,0,16
"6990","8936國統","110/09/02","台灣摩根士丹利",0,11,-11
"6991","6226光鼎","110/09/02","元大-大灣",118,3,115
"6992","6226光鼎","110/09/02","港商野村",148,254,-106
"6993","6226光鼎","110/09/02","大昌-新店",95,5,90
"6994","6226光鼎","110/09/02","台新證券",65,150,-85
"6995","6226光鼎","110/09/02","統一-桃園",76,0,76
"6996","6226光鼎","110/09/02","日盛-鳳山",0,80,-80
"6997","6226光鼎","110/09/02","元大-小港",78,7,71
"6998","6226光鼎","110/09/02","台灣摩根士丹利",0,77,-77
"6999","6226光鼎","110/09/02","元大-嘉義",60,0,60
"7000","6226光鼎","110/09/02","元大-龍潭",1,71,-70
"7001","6226光鼎","110/09/02","元富-松德",52,0,52
"7002","6226光鼎","110/09/02","凱基-岡山",1,61,-60
"7003","6226光鼎","110/09/02","元富-高雄",62,11,51
"7004","6226光鼎","110/09/02","台新-新營",4,63,-59
"7005","6226光鼎","110/09/02","群益金鼎-中壢",45,1,44
"7006","6226光鼎","110/09/02","元大-北投",5,61,-56
"7007","6226光鼎","110/09/02","大展-台南",43,0,43
"7008","6226光鼎","110/09/02","大慶-富順",0,45,-45
"7009","6226光鼎","110/09/02","華南永昌-楠梓",62,19,43
"7010","6226光鼎","110/09/02","元大-虎尾",5,50,-45
"7011","6226光鼎","110/09/02","元大-楊梅",43,1,42
"7012","6226光鼎","110/09/02","元大-台中中港",10,55,-45
"7013","6226光鼎","110/09/02","元大-員林中山",40,0,40
"7014","6226光鼎","110/09/02","台新-台南",3,40,-37
"7015","6226光鼎","110/09/02","元大-汐止",40,0,40
"7016","6226光鼎","110/09/02","中國信託-忠孝",11,46,-35
"7017","6226光鼎","110/09/02","日盛-景美",34,0,34
"7018","6226光鼎","110/09/02","華南永昌-東勢",20,54,-34
"7019","6226光鼎","110/09/02","群益金鼎-開元",61,31,30
"7020","6226光鼎","110/09/02","元大-新竹經國",9,43,-34
"7021","2363矽統","110/09/02","日盛-南京",869,3,866
"7022","2363矽統","110/09/02","美林",216,1191,-975
"7023","2363矽統","110/09/02","台灣摩根士丹利",437,2,435
"7024","2363矽統","110/09/02","永豐金-南投",29,917,-888
"7025","2363矽統","110/09/02","元大-佳里",547,264,283
"7026","2363矽統","110/09/02","摩根大通",540,1319,-779
"7027","2363矽統","110/09/02","元大-前金",268,49,219
"7028","2363矽統","110/09/02","德信-中正",56,575,-519
"7029","2363矽統","110/09/02","國泰-敦南",958,758,200
"7030","2363矽統","110/09/02","凱基-台北",2310,2708,-398
"7031","2363矽統","110/09/02","永豐金-竹科",184,41,143
"7032","2363矽統","110/09/02","台新-三民",75,444,-369
"7033","2363矽統","110/09/02","新加坡商瑞銀",419,282,137
"7034","2363矽統","110/09/02","瑞士信貸",62,392,-330
"7035","2363矽統","110/09/02","中國信託-忠孝",153,18,135
"7036","2363矽統","110/09/02","永豐金證券",124,377,-253
"7037","2363矽統","110/09/02","國泰-館前",271,144,127
"7038","2363矽統","110/09/02","凱基-南崁",51,235,-184
"7039","2363矽統","110/09/02","元大-南京",139,16,123
"7040","2363矽統","110/09/02","富邦-北港",101,284,-183
"7041","2363矽統","110/09/02","臺銀-金山",170,50,120
"7042","2363矽統","110/09/02","群益金鼎",105,252,-147
"7043","2363矽統","110/09/02","北城證券",135,18,117
"7044","2363矽統","110/09/02","凱基-科園",82,224,-142
"7045","2363矽統","110/09/02","兆豐-公益",142,27,115
"7046","2363矽統","110/09/02","富邦-台北",145,286,-141
"7047","2363矽統","110/09/02","台新證券",636,521,115
"7048","2363矽統","110/09/02","富邦證券",98,235,-137
"7049","2363矽統","110/09/02","元大證券",217,105,112
"7050","2363矽統","110/09/02","康和",30,162,-132
"7051","8112至上","110/09/02","合庫證券",92,0,92
"7052","8112至上","110/09/02","摩根大通",4,169,-165
"7053","8112至上","110/09/02","元大-竹東",70,0,70
"7054","8112至上","110/09/02","元大-東門",0,90,-90
"7055","8112至上","110/09/02","新光",51,5,46
"7056","8112至上","110/09/02","港商野村",36,114,-78
"7057","8112至上","110/09/02","凱基-長庚",46,0,46
"7058","8112至上","110/09/02","美林",52,115,-63
"7059","8112至上","110/09/02","群益金鼎-士林",36,0,36
"7060","8112至上","110/09/02","國票-南京",0,62,-62
"7061","8112至上","110/09/02","台新-新營",32,0,32
"7062","8112至上","110/09/02","凱基-台北",58,117,-59
"7063","8112至上","110/09/02","臺銀",27,0,27
"7064","8112至上","110/09/02","美商高盛",0,52,-52
"7065","8112至上","110/09/02","新光-高雄",29,2,27
"7066","8112至上","110/09/02","元大-南屯",0,52,-52
"7067","8112至上","110/09/02","富邦-台中",25,0,25
"7068","8112至上","110/09/02","瑞士信貸",0,48,-48
"7069","8112至上","110/09/02","元富-大裕",24,1,23
"7070","8112至上","110/09/02","元大-大里",9,55,-46
"7071","8112至上","110/09/02","大慶-楊梅",22,0,22
"7072","8112至上","110/09/02","元大-士林",0,45,-45
"7073","8112至上","110/09/02","國票-內壢",21,0,21
"7074","8112至上","110/09/02","香港上海匯豐",0,42,-42
"7075","8112至上","110/09/02","華南永昌-鳳山",21,0,21
"7076","8112至上","110/09/02","凱基-松山",0,37,-37
"7077","8112至上","110/09/02","元大-淡水",21,0,21
"7078","8112至上","110/09/02","日盛-三峽",0,30,-30
"7079","8112至上","110/09/02","群益金鼎-北高雄",20,0,20
"7080","8112至上","110/09/02","台灣匯立證券",0,29,-29
"7081","1570力肯","110/09/02","國票-和平",85,0,85
"7082","1570力肯","110/09/02","新光",25,211,-186
"7083","1570力肯","110/09/02","元大-北三重",68,0,68
"7084","1570力肯","110/09/02","群益金鼎-高雄",5,60,-55
"7085","1570力肯","110/09/02","國票",30,0,30
"7086","1570力肯","110/09/02","摩根大通",0,54,-54
"7087","1570力肯","110/09/02","元大-內湖",30,1,29
"7088","1570力肯","110/09/02","元大-東泰",0,41,-41
"7089","1570力肯","110/09/02","第一金-嘉義",25,0,25
"7090","1570力肯","110/09/02","凱基-台北",1,32,-31
"7091","1570力肯","110/09/02","光和-田中",19,0,19
"7092","1570力肯","110/09/02","合庫-嘉義",1,30,-29
"7093","1570力肯","110/09/02","元大-板橋",16,0,16
"7094","1570力肯","110/09/02","元大-南屯",0,22,-22
"7095","1570力肯","110/09/02","兆豐-嘉義",16,1,15
"7096","1570力肯","110/09/02","元大-永和",0,22,-22
"7097","1570力肯","110/09/02","凱基-高美館",15,0,15
"7098","1570力肯","110/09/02","富邦-嘉義",0,20,-20
"7099","1570力肯","110/09/02","富邦-建國",15,0,15
"7100","1570力肯","110/09/02","華南永昌-彰化",0,15,-15
"7101","1570力肯","110/09/02","彰銀-七賢",14,0,14
"7102","1570力肯","110/09/02","(牛牛牛)亞-網路",1,15,-14
"7103","1570力肯","110/09/02","大慶-蘆洲",11,0,11
"7104","1570力肯","110/09/02","元大-員林中山",0,13,-13
"7105","1570力肯","110/09/02","富邦-新營",10,0,10
"7106","1570力肯","110/09/02","聯邦-三重",0,10,-10
"7107","1570力肯","110/09/02","永豐金-中和",10,0,10
"7108","1570力肯","110/09/02","群益金鼎-三民",0,8,-8
"7109","1570力肯","110/09/02","群益金鼎-瑞豐",9,0,9
"7110","1570力肯","110/09/02","日盛-園區",0,6,-6
"7111","2929淘帝","110/09/02","摩根大通",11,0,11
"7112","2929淘帝","110/09/02","日盛-板橋中山",0,30,-30
"7113","2929淘帝","110/09/02","凱基-東門",11,0,11
"7114","2929淘帝","110/09/02","美林",0,16,-16
"7115","2929淘帝","110/09/02","臺銀-臺南",10,0,10
"7116","2929淘帝","110/09/02","日盛-台南",0,12,-12
"7117","2929淘帝","110/09/02","元大-太平",6,0,6
"7118","2929淘帝","110/09/02","元富-大裕",0,12,-12
"7119","2929淘帝","110/09/02","日盛-台中",5,0,5
"7120","2929淘帝","110/09/02","港商野村",0,6,-6
"7121","2929淘帝","110/09/02","台新-建北",5,0,5
"7122","2929淘帝","110/09/02","新加坡商瑞銀",0,6,-6
"7123","2929淘帝","110/09/02","富邦-新竹",5,0,5
"7124","2929淘帝","110/09/02","元大-竹科",0,4,-4
"7125","2929淘帝","110/09/02","富邦-南屯",5,0,5
"7126","2929淘帝","110/09/02","元富-板橋",0,3,-3
"7127","2929淘帝","110/09/02","群益金鼎",4,0,4
"7128","2929淘帝","110/09/02","群益金鼎-敦南",0,3,-3
"7129","2929淘帝","110/09/02","元大-府城",4,0,4
"7130","2929淘帝","110/09/02","凱基-敦北",0,3,-3
"7131","2929淘帝","110/09/02","元大-大雅",4,0,4
"7132","2929淘帝","110/09/02","元大-虎尾",0,3,-3
"7133","2929淘帝","110/09/02","(牛牛牛)亞-鑫豐",4,1,3
"7134","2929淘帝","110/09/02","新光-高雄",0,2,-2
"7135","2929淘帝","110/09/02","新光-新竹",3,0,3
"7136","2929淘帝","110/09/02","國泰-館前",0,2,-2
"7137","2929淘帝","110/09/02","玉山-大里",3,0,3
"7138","2929淘帝","110/09/02","富邦-花蓮",0,2,-2
"7139","2929淘帝","110/09/02","臺銀-臺中",2,0,2
"7140","2929淘帝","110/09/02","富邦-建國",0,2,-2
"7141","5410國眾","110/09/02","富邦-板橋",10,0,10
"7142","5410國眾","110/09/02","群益金鼎-民權",0,10,-10
"7143","5410國眾","110/09/02","臺銀",5,0,5
"7144","5410國眾","110/09/02","玉山-南京東路",0,5,-5
"7145","5410國眾","110/09/02","台新-左楠",5,0,5
"7146","5410國眾","110/09/02","元大-新莊",0,5,-5
"7147","5410國眾","110/09/02","玉山-板橋",5,0,5
"7148","5410國眾","110/09/02","摩根大通",0,3,-3
"7149","5410國眾","110/09/02","凱基-科園",5,0,5
"7150","5410國眾","110/09/02","國泰-敦南",1,4,-3
"7151","5410國眾","110/09/02","元大-彰化民生",3,0,3
"7152","5410國眾","110/09/02","華南永昌-鶯歌",0,3,-3
"7153","5410國眾","110/09/02","台新-中壢",2,0,2
"7154","5410國眾","110/09/02","台新證券",0,2,-2
"7155","5410國眾","110/09/02","新光",2,0,2
"7156","5410國眾","110/09/02","台新-新營",0,2,-2
"7157","5410國眾","110/09/02","元大-虎尾",2,0,2
"7158","5410國眾","110/09/02","凱基-雙和",0,2,-2
"7159","5410國眾","110/09/02","永豐金-中正",2,0,2
"7160","5410國眾","110/09/02","永豐金-中盛",0,2,-2
"7161","5410國眾","110/09/02","元富-新店",1,0,1
"7162","5410國眾","110/09/02","元富-大昌",0,1,-1
"7163","5410國眾","110/09/02","元富-敦南",1,0,1
"7164","5410國眾","110/09/02","元富-埔里",0,1,-1
"7165","5410國眾","110/09/02","中國信託-中壢",1,0,1
"7166","5410國眾","110/09/02","兆豐-北高雄",0,1,-1
"7167","5410國眾","110/09/02","群益金鼎-基隆",1,0,1
"7168","5410國眾","110/09/02","台新-建北",0,1,-1
"7169","5410國眾","110/09/02","富邦-彰化",1,0,1
"7170","5410國眾","110/09/02","富邦-員林",0,1,-1
"7171","2841台開","110/09/02","群益金鼎-海山",100,0,100
"7172","2841台開","110/09/02","元大-八德",0,100,-100
"7173","2841台開","110/09/02","宏遠-館前",65,0,65
"7174","2841台開","110/09/02","兆豐-彰化",0,60,-60
"7175","2841台開","110/09/02","台中銀",40,3,37
"7176","2841台開","110/09/02","港商野村",0,43,-43
"7177","2841台開","110/09/02","群益金鼎-崇德",26,0,26
"7178","2841台開","110/09/02","兆豐-新營",0,20,-20
"7179","2841台開","110/09/02","台新-三民",20,0,20
"7180","2841台開","110/09/02","玉山-台中",0,20,-20
"7181","2841台開","110/09/02","大慶-蘆洲",10,0,10
"7182","2841台開","110/09/02","永豐金-中正",0,20,-20
"7183","2841台開","110/09/02","元大-新竹經國",10,0,10
"7184","2841台開","110/09/02","日盛證券",6,25,-19
"7185","2841台開","110/09/02","富邦-左營",8,0,8
"7186","2841台開","110/09/02","台灣摩根士丹利",0,19,-19
"7187","2841台開","110/09/02","富邦-台北",7,0,7
"7188","2841台開","110/09/02","元大-復北",0,11,-11
"7189","2841台開","110/09/02","日盛-忠孝",6,0,6
"7190","2841台開","110/09/02","日盛-台中",10,20,-10
"7191","2841台開","110/09/02","大昌-安康",27,21,6
"7192","2841台開","110/09/02","富邦-新店",0,10,-10
"7193","2841台開","110/09/02","台新-台中",6,0,6
"7194","2841台開","110/09/02","國票-中和",0,8,-8
"7195","2841台開","110/09/02","新光-桃園",6,0,6
"7196","2841台開","110/09/02","元大-萬華",0,8,-8
"7197","2841台開","110/09/02","國泰-館前",6,0,6
"7198","2841台開","110/09/02","兆豐-高雄",0,6,-6
"7199","2841台開","110/09/02","元大-屏南",6,0,6
"7200","2841台開","110/09/02","群益金鼎-民權",0,6,-6
"7201","6207雷科","110/09/02","元大-高雄",52,3,49
"7202","6207雷科","110/09/02","新加坡商瑞銀",4,48,-44
"7203","6207雷科","110/09/02","凱基-高美館",21,0,21
"7204","6207雷科","110/09/02","摩根大通",9,30,-21
"7205","6207雷科","110/09/02","群益金鼎-大甲",12,0,12
"7206","6207雷科","110/09/02","元大-大灣",0,21,-21
"7207","6207雷科","110/09/02","永豐金-高雄",12,0,12
"7208","6207雷科","110/09/02","康和-石牌",0,20,-20
"7209","6207雷科","110/09/02","國泰-台南",20,10,10
"7210","6207雷科","110/09/02","群益金鼎-館前",0,20,-20
"7211","6207雷科","110/09/02","群益金鼎-瑞豐",10,0,10
"7212","6207雷科","110/09/02","華南永昌-虎尾",0,19,-19
"7213","6207雷科","110/09/02","元大-博愛",10,0,10
"7214","6207雷科","110/09/02","(牛牛牛)亞-鑫豐",0,13,-13
"7215","6207雷科","110/09/02","元富-板橋",5,0,5
"7216","6207雷科","110/09/02","大慶-泰山",0,10,-10
"7217","6207雷科","110/09/02","兆豐-桃園",5,0,5
"7218","6207雷科","110/09/02","元富-民權",0,10,-10
"7219","6207雷科","110/09/02","國泰-台中",5,0,5
"7220","6207雷科","110/09/02","港商野村",1,8,-7
"7221","6207雷科","110/09/02","凱基-市政",5,0,5
"7222","6207雷科","110/09/02","統一-員林",1,7,-6
"7223","6207雷科","110/09/02","富邦-左營",5,0,5
"7224","6207雷科","110/09/02","元大-木柵",0,6,-6
"7225","6207雷科","110/09/02","富邦-宜蘭",5,0,5
"7226","6207雷科","110/09/02","日盛-中壢",0,5,-5
"7227","6207雷科","110/09/02","元大-士林",6,1,5
"7228","6207雷科","110/09/02","兆豐-台中",0,5,-5
"7229","6207雷科","110/09/02","元大-六合",5,0,5
"7230","6207雷科","110/09/02","康和-延平",0,5,-5
"7231","3679新至陞","110/09/02","元大-成功",12,0,12
"7232","3679新至陞","110/09/02","凱基-台北",4,18,-14
"7233","3679新至陞","110/09/02","元大-大天母",10,0,10
"7234","3679新至陞","110/09/02","美林",0,10,-10
"7235","3679新至陞","110/09/02","富邦-嘉義",5,0,5
"7236","3679新至陞","110/09/02","兆豐-高雄",0,10,-10
"7237","3679新至陞","110/09/02","致和-東門",3,0,3
"7238","3679新至陞","110/09/02","摩根大通",0,9,-9
"7239","3679新至陞","110/09/02","元大-福營",3,0,3
"7240","3679新至陞","110/09/02","瑞士信貸",1,8,-7
"7241","3679新至陞","110/09/02","元大-小港",3,0,3
"7242","3679新至陞","110/09/02","美商高盛",0,3,-3
"7243","3679新至陞","110/09/02","元富-緯城",2,0,2
"7244","3679新至陞","110/09/02","新加坡商瑞銀",0,3,-3
"7245","3679新至陞","110/09/02","台中銀-員林",2,0,2
"7246","3679新至陞","110/09/02","日盛-樹林",0,2,-2
"7247","3679新至陞","110/09/02","新百王",2,0,2
"7248","3679新至陞","110/09/02","港商野村",0,2,-2
"7249","3679新至陞","110/09/02","國票-台東",2,0,2
"7250","3679新至陞","110/09/02","兆豐-公益",0,2,-2
"7251","3679新至陞","110/09/02","玉山證券",2,0,2
"7252","3679新至陞","110/09/02","玉山-台中",0,2,-2
"7253","3679新至陞","110/09/02","群益金鼎-台中",2,0,2
"7254","3679新至陞","110/09/02","凱基-高雄",0,2,-2
"7255","3679新至陞","110/09/02","群益金鼎-三民",2,0,2
"7256","3679新至陞","110/09/02","凱基-新店",0,2,-2
"7257","3679新至陞","110/09/02","富邦-岡山",2,0,2
"7258","3679新至陞","110/09/02","亞東-板橋",0,1,-1
"7259","3679新至陞","110/09/02","元大-文心興安",2,0,2
"7260","3679新至陞","110/09/02","富隆-長安",0,1,-1
"7261","2727王品","110/09/02","台灣摩根士丹利",50,32,18
"7262","2727王品","110/09/02","永豐金證券",1,32,-31
"7263","2727王品","110/09/02","摩根大通",15,0,15
"7264","2727王品","110/09/02","凱基-台北",12,34,-22
"7265","2727王品","110/09/02","美商高盛",15,3,12
"7266","2727王品","110/09/02","美林",8,27,-19
"7267","2727王品","110/09/02","富邦-桃園",10,0,10
"7268","2727王品","110/09/02","國泰-板橋",6,19,-13
"7269","2727王品","110/09/02","日盛-木柵",6,0,6
"7270","2727王品","110/09/02","凱基-板橋",0,11,-11
"7271","2727王品","110/09/02","新光",11,6,5
"7272","2727王品","110/09/02","國泰-台南",0,10,-10
"7273","2727王品","110/09/02","群益金鼎-高雄",5,0,5
"7274","2727王品","110/09/02","富邦-建國",10,20,-10
"7275","2727王品","110/09/02","凱基-基隆",5,0,5
"7276","2727王品","110/09/02","元大-內湖",0,10,-10
"7277","2727王品","110/09/02","元大-桃興",5,0,5
"7278","2727王品","110/09/02","永豐金-竹科",1,10,-9
"7279","2727王品","110/09/02","永豐金-新店",5,0,5
"7280","2727王品","110/09/02","元大-高雄",1,9,-8
"7281","2727王品","110/09/02","元富-延平",4,0,4
"7282","2727王品","110/09/02","玉山-台南",1,8,-7
"7283","2727王品","110/09/02","玉山-大里",4,0,4
"7284","2727王品","110/09/02","統一",1,7,-6
"7285","2727王品","110/09/02","國泰-台中",5,1,4
"7286","2727王品","110/09/02","中國信託-文心",0,6,-6
"7287","2727王品","110/09/02","元大-民生",4,0,4
"7288","2727王品","110/09/02","群益金鼎-東大",0,6,-6
"7289","2727王品","110/09/02","群益金鼎-宜蘭",3,0,3
"7290","2727王品","110/09/02","永豐金-忠孝",0,6,-6
"7291","1570力肯","110/09/02","國票-和平",85,0,85
"7292","1570力肯","110/09/02","新光",25,211,-186
"7293","1570力肯","110/09/02","元大-北三重",68,0,68
"7294","1570力肯","110/09/02","群益金鼎-高雄",5,60,-55
"7295","1570力肯","110/09/02","國票",30,0,30
"7296","1570力肯","110/09/02","摩根大通",0,54,-54
"7297","1570力肯","110/09/02","元大-內湖",30,1,29
"7298","1570力肯","110/09/02","元大-東泰",0,41,-41
"7299","1570力肯","110/09/02","第一金-嘉義",25,0,25
"7300","1570力肯","110/09/02","凱基-台北",1,32,-31
"7301","1570力肯","110/09/02","光和-田中",19,0,19
"7302","1570力肯","110/09/02","合庫-嘉義",1,30,-29
"7303","1570力肯","110/09/02","元大-板橋",16,0,16
"7304","1570力肯","110/09/02","元大-南屯",0,22,-22
"7305","1570力肯","110/09/02","兆豐-嘉義",16,1,15
"7306","1570力肯","110/09/02","元大-永和",0,22,-22
"7307","1570力肯","110/09/02","凱基-高美館",15,0,15
"7308","1570力肯","110/09/02","富邦-嘉義",0,20,-20
"7309","1570力肯","110/09/02","富邦-建國",15,0,15
"7310","1570力肯","110/09/02","華南永昌-彰化",0,15,-15
"7311","1570力肯","110/09/02","彰銀-七賢",14,0,14
"7312","1570力肯","110/09/02","(牛牛牛)亞-網路",1,15,-14
"7313","1570力肯","110/09/02","大慶-蘆洲",11,0,11
"7314","1570力肯","110/09/02","元大-員林中山",0,13,-13
"7315","1570力肯","110/09/02","富邦-新營",10,0,10
"7316","1570力肯","110/09/02","聯邦-三重",0,10,-10
"7317","1570力肯","110/09/02","永豐金-中和",10,0,10
"7318","1570力肯","110/09/02","群益金鼎-三民",0,8,-8
"7319","1570力肯","110/09/02","群益金鼎-瑞豐",9,0,9
"7320","1570力肯","110/09/02","日盛-園區",0,6,-6
"7321","6180橘子","110/09/02","華南永昌",84,1,83
"7322","6180橘子","110/09/02","亞東-高雄",0,22,-22
"7323","6180橘子","110/09/02","摩根大通",29,4,25
"7324","6180橘子","110/09/02","凱基-台北",3,23,-20
"7325","6180橘子","110/09/02","台灣摩根士丹利",23,0,23
"7326","6180橘子","110/09/02","元富-高雄",0,12,-12
"7327","6180橘子","110/09/02","美商高盛",25,6,19
"7328","6180橘子","110/09/02","新光",3,14,-11
"7329","6180橘子","110/09/02","台新證券",13,0,13
"7330","6180橘子","110/09/02","新光-台南",0,10,-10
"7331","6180橘子","110/09/02","美林",6,0,6
"7332","6180橘子","110/09/02","富邦-竹北",0,10,-10
"7333","6180橘子","110/09/02","元富-永和",6,0,6
"7334","6180橘子","110/09/02","元大-大益",0,10,-10
"7335","6180橘子","110/09/02","玉山-新莊",6,0,6
"7336","6180橘子","110/09/02","統一-彰化",0,8,-8
"7337","6180橘子","110/09/02","凱基-復興",5,0,5
"7338","6180橘子","110/09/02","元大-館前",0,8,-8
"7339","6180橘子","110/09/02","台新-台中",4,0,4
"7340","6180橘子","110/09/02","群益金鼎-西松",0,6,-6
"7341","6180橘子","110/09/02","國泰-敦南",10,6,4
"7342","6180橘子","110/09/02","合庫-三重",0,5,-5
"7343","6180橘子","110/09/02","日盛-永康",3,0,3
"7344","6180橘子","110/09/02","日盛-和美",0,5,-5
"7345","6180橘子","110/09/02","彰銀",3,0,3
"7346","6180橘子","110/09/02","統一-嘉義",0,5,-5
"7347","6180橘子","110/09/02","第一金-新竹",3,0,3
"7348","6180橘子","110/09/02","國泰-館前",0,5,-5
"7349","6180橘子","110/09/02","玉山證券",3,0,3
"7350","6180橘子","110/09/02","元大證券",1,6,-5
"7351","2390云辰","110/09/02","日盛-新莊",271,5,266
"7352","2390云辰","110/09/02","凱基-台北",35,186,-151
"7353","2390云辰","110/09/02","元大證券",118,6,112
"7354","2390云辰","110/09/02","元富-安南",4,147,-143
"7355","2390云辰","110/09/02","華南永昌-中正",106,4,102
"7356","2390云辰","110/09/02","元大-雙和",34,135,-101
"7357","2390云辰","110/09/02","台灣摩根士丹利",94,0,94
"7358","2390云辰","110/09/02","元大-南屯",2,82,-80
"7359","2390云辰","110/09/02","大慶-富順",76,2,74
"7360","2390云辰","110/09/02","元大-林園",0,79,-79
"7361","2390云辰","110/09/02","凱基-長庚",56,0,56
"7362","2390云辰","110/09/02","國泰-板橋",14,82,-68
"7363","2390云辰","110/09/02","元大-松山",55,0,55
"7364","2390云辰","110/09/02","元大-板橋",4,71,-67
"7365","2390云辰","110/09/02","玉山-台中",54,2,52
"7366","2390云辰","110/09/02","國泰-館前",3,59,-56
"7367","2390云辰","110/09/02","元富-高雄",52,2,50
"7368","2390云辰","110/09/02","凱基-和平",0,52,-52
"7369","2390云辰","110/09/02","元大-嘉義",50,5,45
"7370","2390云辰","110/09/02","康和",0,50,-50
"7371","2390云辰","110/09/02","華南永昌-合泰",40,0,40
"7372","2390云辰","110/09/02","第一金-中山",2,50,-48
"7373","2390云辰","110/09/02","統一-新台中",45,6,39
"7374","2390云辰","110/09/02","統一",7,55,-48
"7375","2390云辰","110/09/02","統一-員林",46,10,36
"7376","2390云辰","110/09/02","元富-信義",3,51,-48
"7377","2390云辰","110/09/02","美商高盛",49,14,35
"7378","2390云辰","110/09/02","土銀-花蓮",0,47,-47
"7379","2390云辰","110/09/02","元大-前金",35,0,35
"7380","2390云辰","110/09/02","元大-新盛",1,48,-47
"7381","2834臺企銀","110/08/31","新加坡商瑞銀",58095,14804,43291
"7382","2834臺企銀","110/08/31","台灣摩根士丹利",138752,224200,-85448
"7383","2834臺企銀","110/08/31","瑞士信貸",40098,11880,28218
"7384","2834臺企銀","110/08/31","美林",16181,38669,-22488
"7385","2834臺企銀","110/08/31","凱基-台北",24998,6606,18392
"7386","2834臺企銀","110/08/31","港商法國興業",11216,33391,-22175
"7387","2834臺企銀","110/08/31","摩根大通",37495,20369,17126
"7388","2834臺企銀","110/08/31","永豐金證券",227,4552,-4325
"7389","2834臺企銀","110/08/31","美商高盛",58399,41472,16927
"7390","2834臺企銀","110/08/31","法銀巴黎",2076,6320,-4244
"7391","2834臺企銀","110/08/31","港商野村",10074,4570,5504
"7392","2834臺企銀","110/08/31","元大證券",1048,5233,-4185
"7393","2834臺企銀","110/08/31","國票-長城",5000,0,5000
"7394","2834臺企銀","110/08/31","花旗環球",3376,5995,-2619
"7395","2834臺企銀","110/08/31","兆豐-寶成",1000,0,1000
"7396","2834臺企銀","110/08/31","華南永昌-高雄",24,1662,-1638
"7397","2834臺企銀","110/08/31","國泰-台南",609,2,607
"7398","2834臺企銀","110/08/31","豐農",1,760,-759
"7399","2834臺企銀","110/08/31","彰銀-台中",621,83,538
"7400","2834臺企銀","110/08/31","香港上海匯豐",549,1100,-551
"7401","2834臺企銀","110/08/31","元大-蘆洲",529,5,524
"7402","2834臺企銀","110/08/31","群益金鼎-彰化",59,499,-440
"7403","2834臺企銀","110/08/31","富邦-新竹",481,26,455
"7404","2834臺企銀","110/08/31","元大-苗栗",7,400,-393
"7405","2834臺企銀","110/08/31","群益金鼎-土城",418,0,418
"7406","2834臺企銀","110/08/31","凱基-興隆",0,320,-320
"7407","2834臺企銀","110/08/31","群益金鼎-萬華",400,0,400
"7408","2834臺企銀","110/08/31","日盛證券",442,747,-305
"7409","2834臺企銀","110/08/31","元大-復北",404,8,396
"7410","2834臺企銀","110/08/31","群益金鼎-板橋",30,325,-295
"7411","5511德昌","110/08/31","永豐金-市政",107,0,107
"7412","5511德昌","110/08/31","兆豐-台中港",0,80,-80
"7413","5511德昌","110/08/31","日盛-新竹",10,0,10
"7414","5511德昌","110/08/31","統一",0,10,-10
"7415","5511德昌","110/08/31","元大-彰化",10,0,10
"7416","5511德昌","110/08/31","致和-崇德",0,10,-10
"7417","5511德昌","110/08/31","第一金-台中",8,0,8
"7418","5511德昌","110/08/31","凱基-台北",1,10,-9
"7419","5511德昌","110/08/31","瑞士信貸",2,0,2
"7420","5511德昌","110/08/31","兆豐-台中",0,8,-8
"7421","5511德昌","110/08/31","元大-中壢",2,0,2
"7422","5511德昌","110/08/31","第一金",0,5,-5
"7423","5511德昌","110/08/31","元大-北屯",2,0,2
"7424","5511德昌","110/08/31","第一金-大稻埕",0,2,-2
"7425","5511德昌","110/08/31","兆豐-南京",1,0,1
"7426","5511德昌","110/08/31","元大-員林",0,2,-2
"7427","5511德昌","110/08/31","元大-東蘆",1,0,1
"7428","5511德昌","110/08/31","華南永昌-麻豆",0,2,-2
"7429","5511德昌","110/08/31","永豐金-苓雅",1,0,1
"7430","5511德昌","110/08/31","國泰-敦南",0,2,-2
"7431","5511德昌","110/08/31","永豐金-新店",1,0,1
"7432","5511德昌","110/08/31","康和-仁愛",0,2,-2
"7433","5511德昌","110/08/31","台中銀-員林",0,0,0
"7434","5511德昌","110/08/31","國票-中和",0,2,-2
"7435","5511德昌","110/08/31","中國信託",0,0,0
"7436","5511德昌","110/08/31","台新證券",0,1,-1
"7437","5511德昌","110/08/31","國泰-台中",0,0,0
"7438","5511德昌","110/08/31","國票-天祥",0,1,-1
"7439","5511德昌","110/08/31","群益金鼎-鳳山",0,0,0
"7440","5511德昌","110/08/31","中國信託-忠孝",0,1,-1
"7441","2489瑞軒","110/08/31","瑞士信貸",348,4,344
"7442","2489瑞軒","110/08/31","台灣摩根士丹利",17,427,-410
"7443","2489瑞軒","110/08/31","美林",278,81,197
"7444","2489瑞軒","110/08/31","摩根大通",116,283,-167
"7445","2489瑞軒","110/08/31","凱基-台北",133,0,133
"7446","2489瑞軒","110/08/31","日盛-嘉義",10,128,-118
"7447","2489瑞軒","110/08/31","國泰-敦南",134,46,88
"7448","2489瑞軒","110/08/31","第一金-新興",0,84,-84
"7449","2489瑞軒","110/08/31","新加坡商瑞銀",89,2,87
"7450","2489瑞軒","110/08/31","美商高盛",0,79,-79
"7451","2489瑞軒","110/08/31","合庫-桃園",61,3,58
"7452","2489瑞軒","110/08/31","元大-樹林",2,80,-78
"7453","2489瑞軒","110/08/31","台新-台中",50,0,50
"7454","2489瑞軒","110/08/31","元富-四維",3,67,-64
"7455","2489瑞軒","110/08/31","元富-潮州",41,0,41
"7456","2489瑞軒","110/08/31","永豐金-竹科",0,36,-36
"7457","2489瑞軒","110/08/31","新光",42,2,40
"7458","2489瑞軒","110/08/31","凱基-城中",0,35,-35
"7459","2489瑞軒","110/08/31","合庫-嘉義",30,0,30
"7460","2489瑞軒","110/08/31","元富-文心",0,30,-30
"7461","2489瑞軒","110/08/31","華南永昌-虎尾",91,61,30
"7462","2489瑞軒","110/08/31","富邦-永和",0,30,-30
"7463","2489瑞軒","110/08/31","元大-南屯",30,0,30
"7464","2489瑞軒","110/08/31","富邦-桃園",0,30,-30
"7465","2489瑞軒","110/08/31","元大-龍潭",30,2,28
"7466","2489瑞軒","110/08/31","永豐金-大園",1,30,-29
"7467","2489瑞軒","110/08/31","元大-楊梅",25,0,25
"7468","2489瑞軒","110/08/31","元大-彰化",0,26,-26
"7469","2489瑞軒","110/08/31","富邦-羅東",21,0,21
"7470","2489瑞軒","110/08/31","(牛牛牛)亞-鑫豐",36,59,-23
"7471","2428興勤","110/08/31","元大-南京",18,0,18
"7472","2428興勤","110/08/31","瑞士信貸",0,68,-68
"7473","2428興勤","110/08/31","凱基-信義",15,0,15
"7474","2428興勤","110/08/31","港商麥格理",0,29,-29
"7475","2428興勤","110/08/31","兆豐-景美",10,0,10
"7476","2428興勤","110/08/31","美林",2,28,-26
"7477","2428興勤","110/08/31","凱基-鳳山",10,0,10
"7478","2428興勤","110/08/31","摩根大通",9,33,-24
"7479","2428興勤","110/08/31","臺銀-金山",8,0,8
"7480","2428興勤","110/08/31","元大-西門",0,21,-21
"7481","2428興勤","110/08/31","元富-緯城",10,2,8
"7482","2428興勤","110/08/31","美商高盛",2,17,-15
"7483","2428興勤","110/08/31","港商野村",6,0,6
"7484","2428興勤","110/08/31","康和",0,14,-14
"7485","2428興勤","110/08/31","凱基-三重",8,2,6
"7486","2428興勤","110/08/31","康和-板橋",0,13,-13
"7487","2428興勤","110/08/31","凱基-台北",19,13,6
"7488","2428興勤","110/08/31","國票-安和",0,12,-12
"7489","2428興勤","110/08/31","元大-萬華",6,0,6
"7490","2428興勤","110/08/31","富邦證券",0,10,-10
"7491","2428興勤","110/08/31","元大-敦南",6,0,6
"7492","2428興勤","110/08/31","日盛-景美",1,10,-9
"7493","2428興勤","110/08/31","永豐金-板橋",6,0,6
"7494","2428興勤","110/08/31","台灣摩根士丹利",7,16,-9
"7495","2428興勤","110/08/31","永豐金-中正",6,0,6
"7496","2428興勤","110/08/31","永豐金-信義",0,8,-8
"7497","2428興勤","110/08/31","第一金-大稻埕",5,0,5
"7498","2428興勤","110/08/31","富邦-敦南",1,7,-6
"7499","2428興勤","110/08/31","凱基-天母",5,0,5
"7500","2428興勤","110/08/31","元大-屏東",0,6,-6
"7501","3176基亞","110/08/31","日盛-桃園",27,0,27
"7502","3176基亞","110/08/31","富邦-台北",0,126,-126
"7503","3176基亞","110/08/31","統一-土城",20,0,20
"7504","3176基亞","110/08/31","元大-大益",0,32,-32
"7505","3176基亞","110/08/31","富邦-羅東",21,1,20
"7506","3176基亞","110/08/31","台灣摩根士丹利",0,9,-9
"7507","3176基亞","110/08/31","摩根大通",16,0,16
"7508","3176基亞","110/08/31","統一-汐止",0,9,-9
"7509","3176基亞","110/08/31","永豐金-北高雄",15,0,15
"7510","3176基亞","110/08/31","凱基-湖口",0,9,-9
"7511","3176基亞","110/08/31","大慶-苗栗",10,0,10
"7512","3176基亞","110/08/31","華南永昌-公誠",1,10,-9
"7513","3176基亞","110/08/31","大慶-富順",10,0,10
"7514","3176基亞","110/08/31","元富-同大",1,8,-7
"7515","3176基亞","110/08/31","台新-左楠",10,0,10
"7516","3176基亞","110/08/31","凱基-台北",0,7,-7
"7517","3176基亞","110/08/31","華南永昌",11,1,10
"7518","3176基亞","110/08/31","元大-士林",1,8,-7
"7519","3176基亞","110/08/31","群益金鼎-高雄",8,1,7
"7520","3176基亞","110/08/31","元大-新營",0,7,-7
"7521","3176基亞","110/08/31","富邦-仁愛",6,0,6
"7522","3176基亞","110/08/31","新加坡商瑞銀",2,8,-6
"7523","3176基亞","110/08/31","宏遠-中和",5,0,5
"7524","3176基亞","110/08/31","中國信託-永康",0,6,-6
"7525","3176基亞","110/08/31","元富-草屯",5,0,5
"7526","3176基亞","110/08/31","元大-彰化民生",0,6,-6
"7527","3176基亞","110/08/31","台新-台中",5,0,5
"7528","3176基亞","110/08/31","永豐金-羅東",0,6,-6
"7529","3176基亞","110/08/31","群益金鼎-嘉義",5,0,5
"7530","3176基亞","110/08/31","國泰-館前",0,5,-5
"7531","2409友達","110/08/31","摩根大通",12388,3383,9005
"7532","2409友達","110/08/31","香港上海匯豐",651,24651,-24000
"7533","2409友達","110/08/31","美林",8491,2090,6401
"7534","2409友達","110/08/31","台灣摩根士丹利",4000,24791,-20791
"7535","2409友達","110/08/31","合庫證券",5242,27,5215
"7536","2409友達","110/08/31","永豐金證券",1612,6074,-4462
"7537","2409友達","110/08/31","台灣匯立證券",3859,0,3859
"7538","2409友達","110/08/31","花旗環球",81,3901,-3820
"7539","2409友達","110/08/31","瑞士信貸",4073,283,3790
"7540","2409友達","110/08/31","港商野村",3031,6453,-3422
"7541","2409友達","110/08/31","(牛牛牛)亞證券",3233,0,3233
"7542","2409友達","110/08/31","元大證券",1580,4157,-2577
"7543","2409友達","110/08/31","富邦證券",3021,57,2964
"7544","2409友達","110/08/31","凱基-員林",33,2035,-2002
"7545","2409友達","110/08/31","新加坡商瑞銀",3845,1353,2492
"7546","2409友達","110/08/31","法銀巴黎",348,1702,-1354
"7547","2409友達","110/08/31","寶盛",2013,0,2013
"7548","2409友達","110/08/31","凱基-東港",507,1794,-1287
"7549","2409友達","110/08/31","宏遠-館前",2233,286,1947
"7550","2409友達","110/08/31","元大-博愛",54,1174,-1120
"7551","2409友達","110/08/31","凱基-台北",4372,2949,1423
"7552","2409友達","110/08/31","日盛-中壢",92,1079,-987
"7553","2409友達","110/08/31","港商麥格理",1513,297,1216
"7554","2409友達","110/08/31","第一金-中壢",129,1071,-942
"7555","2409友達","110/08/31","日盛證券",1200,109,1091
"7556","2409友達","110/08/31","元大-豐原",85,933,-848
"7557","2409友達","110/08/31","美商高盛",2007,1058,949
"7558","2409友達","110/08/31","元大-北屯",107,871,-764
"7559","2409友達","110/08/31","元富-台南",857,3,854
"7560","2409友達","110/08/31","群益金鼎",53,722,-669
"7561","1315達新","110/08/31","元大-文心興安",6,0,6
"7562","1315達新","110/08/31","花旗環球",0,10,-10
"7563","1315達新","110/08/31","美林",8,3,5
"7564","1315達新","110/08/31","高橋-龍潭",0,7,-7
"7565","1315達新","110/08/31","致和-東門",5,0,5
"7566","1315達新","110/08/31","凱基-岡山",0,6,-6
"7567","1315達新","110/08/31","豐農",4,0,4
"7568","1315達新","110/08/31","華南永昌-彰化",0,5,-5
"7569","1315達新","110/08/31","美商高盛",3,0,3
"7570","1315達新","110/08/31","台新證券",2,5,-3
"7571","1315達新","110/08/31","富邦-永和",3,0,3
"7572","1315達新","110/08/31","元大-八德",0,3,-3
"7573","1315達新","110/08/31","元大-虎尾",3,0,3
"7574","1315達新","110/08/31","新百王",0,2,-2
"7575","1315達新","110/08/31","元大-花蓮",3,0,3
"7576","1315達新","110/08/31","兆豐-公益",0,2,-2
"7577","1315達新","110/08/31","第一金-豐原",2,0,2
"7578","1315達新","110/08/31","國泰-敦南",2,4,-2
"7579","1315達新","110/08/31","玉山證券",2,0,2
"7580","1315達新","110/08/31","元大-萬華",0,2,-2
"7581","1315達新","110/08/31","群益金鼎-新莊",2,0,2
"7582","1315達新","110/08/31","永豐金-中正",0,2,-2
"7583","1315達新","110/08/31","永豐金-敦南",2,0,2
"7584","1315達新","110/08/31","元富-虎尾",0,1,-1
"7585","1315達新","110/08/31","港商法國興業",1,0,1
"7586","1315達新","110/08/31","元富-文心",0,1,-1
"7587","1315達新","110/08/31","亞東-板橋",1,0,1
"7588","1315達新","110/08/31","凱基-桃園",0,1,-1
"7589","1315達新","110/08/31","兆豐-台南",1,0,1
"7590","1315達新","110/08/31","華南永昌-長虹",0,1,-1
"7591","2609陽明","110/08/31","港商麥格理",2365,7,2358
"7592","2609陽明","110/08/31","康和",70,7383,-7313
"7593","2609陽明","110/08/31","台灣摩根士丹利",4559,2270,2289
"7594","2609陽明","110/08/31","永豐金-信義",20,3830,-3810
"7595","2609陽明","110/08/31","美林",2036,829,1207
"7596","2609陽明","110/08/31","兆豐-大安",19,3214,-3195
"7597","2609陽明","110/08/31","花旗環球",810,24,786
"7598","2609陽明","110/08/31","瑞士信貸",1526,3530,-2004
"7599","2609陽明","110/08/31","新光-新竹",962,211,751
"7600","2609陽明","110/08/31","新加坡商瑞銀",576,2446,-1870
"7601","2609陽明","110/08/31","統一-新台中",578,32,546
"7602","2609陽明","110/08/31","凱基-台北",2645,4077,-1432
"7603","2609陽明","110/08/31","港商法國興業",519,8,511
"7604","2609陽明","110/08/31","富邦證券",1404,2833,-1429
"7605","2609陽明","110/08/31","元富",539,140,399
"7606","2609陽明","110/08/31","兆豐-三民",57,1026,-969
"7607","2609陽明","110/08/31","國泰-敦南",1724,1347,377
"7608","2609陽明","110/08/31","統一-仁愛",926,1805,-879
"7609","2609陽明","110/08/31","新光",1890,1520,370
"7610","2609陽明","110/08/31","華南永昌-南京",240,691,-451
"7611","2609陽明","110/08/31","第一金-桃園",429,100,329
"7612","2609陽明","110/08/31","日盛-文化",21,458,-437
"7613","2609陽明","110/08/31","陽信-石牌",350,48,302
"7614","2609陽明","110/08/31","群益金鼎-大安",58,418,-360
"7615","2609陽明","110/08/31","凱基-民權",278,21,257
"7616","2609陽明","110/08/31","台新-三民",90,446,-356
"7617","2609陽明","110/08/31","華南永昌-台中",339,92,247
"7618","2609陽明","110/08/31","日盛證券",155,503,-348
"7619","2609陽明","110/08/31","摩根大通",2595,2358,237
"7620","2609陽明","110/08/31","元大證券",1007,1299,-292
"7621","2636台驊投控","110/08/31","群益金鼎-敦南",149,2,147
"7622","2636台驊投控","110/08/31","日盛-台中",3,200,-197
"7623","2636台驊投控","110/08/31","亞東",137,3,134
"7624","2636台驊投控","110/08/31","統一-新台中",0,165,-165
"7625","2636台驊投控","110/08/31","臺銀-高雄",94,4,90
"7626","2636台驊投控","110/08/31","美商高盛",8,140,-132
"7627","2636台驊投控","110/08/31","宏遠-館前",52,0,52
"7628","2636台驊投控","110/08/31","瑞士信貸",89,213,-124
"7629","2636台驊投控","110/08/31","群益金鼎-古亭",44,4,40
"7630","2636台驊投控","110/08/31","富邦-虎尾",5,105,-100
"7631","2636台驊投控","110/08/31","永豐金-敦南",41,3,38
"7632","2636台驊投控","110/08/31","新加坡商瑞銀",11,71,-60
"7633","2636台驊投控","110/08/31","永豐金-大園",35,0,35
"7634","2636台驊投控","110/08/31","台灣摩根士丹利",43,101,-58
"7635","2636台驊投控","110/08/31","港商野村",372,343,29
"7636","2636台驊投控","110/08/31","凱基-台北",166,200,-34
"7637","2636台驊投控","110/08/31","凱基-桃園",28,3,25
"7638","2636台驊投控","110/08/31","凱基-中山",0,30,-30
"7639","2636台驊投控","110/08/31","凱基-南崁",25,1,24
"7640","2636台驊投控","110/08/31","台新-台南",5,33,-28
"7641","2636台驊投控","110/08/31","新光",67,46,21
"7642","2636台驊投控","110/08/31","日盛-復興",3,26,-23
"7643","2636台驊投控","110/08/31","台灣企銀-岡山",20,0,20
"7644","2636台驊投控","110/08/31","凱基-高美館",9,31,-22
"7645","2636台驊投控","110/08/31","合庫-自強",24,5,19
"7646","2636台驊投控","110/08/31","第一金-桃園",8,28,-20
"7647","2636台驊投控","110/08/31","元大-東門",20,1,19
"7648","2636台驊投控","110/08/31","摩根大通",67,87,-20
"7649","2636台驊投控","110/08/31","康和-石牌",16,0,16
"7650","2636台驊投控","110/08/31","永豐金-台南",3,23,-20
"7651","2867三商壽","110/08/31","美商高盛",202,34,168
"7652","2867三商壽","110/08/31","摩根大通",159,436,-277
"7653","2867三商壽","110/08/31","統一-平鎮",160,1,159
"7654","2867三商壽","110/08/31","凱基-台北",66,209,-143
"7655","2867三商壽","110/08/31","兆豐-岡山",110,0,110
"7656","2867三商壽","110/08/31","新光-新竹",0,101,-101
"7657","2867三商壽","110/08/31","元富-佳里",106,0,106
"7658","2867三商壽","110/08/31","富邦-三重",0,91,-91
"7659","2867三商壽","110/08/31","玉山-城中",100,0,100
"7660","2867三商壽","110/08/31","元大-太平",0,85,-85
"7661","2867三商壽","110/08/31","凱基-南崁",100,0,100
"7662","2867三商壽","110/08/31","元大-永春",0,75,-75
"7663","2867三商壽","110/08/31","瑞士信貸",98,1,97
"7664","2867三商壽","110/08/31","美林",65,116,-51
"7665","2867三商壽","110/08/31","華南永昌-朴子",80,0,80
"7666","2867三商壽","110/08/31","玉山-台大",0,50,-50
"7667","2867三商壽","110/08/31","凱基",73,0,73
"7668","2867三商壽","110/08/31","永豐金-新莊",0,50,-50
"7669","2867三商壽","110/08/31","元大-沙鹿",70,0,70
"7670","2867三商壽","110/08/31","永豐金-市政",0,50,-50
"7671","2867三商壽","110/08/31","元富-大昌",57,0,57
"7672","2867三商壽","110/08/31","港商野村",27,72,-45
"7673","2867三商壽","110/08/31","國泰-台中",64,10,54
"7674","2867三商壽","110/08/31","宏遠-台中",0,39,-39
"7675","2867三商壽","110/08/31","凱基-高雄",50,0,50
"7676","2867三商壽","110/08/31","宏遠證券",0,38,-38
"7677","2867三商壽","110/08/31","元大-桃園",50,0,50
"7678","2867三商壽","110/08/31","新光",22,55,-33
"7679","2867三商壽","110/08/31","華南永昌",46,2,44
"7680","2867三商壽","110/08/31","元大-開元",0,33,-33
"7681","5521工信","110/08/31","國票-敦北法人",411,0,411
"7682","5521工信","110/08/31","凱基-台北",144,477,-333
"7683","5521工信","110/08/31","光和-溪湖",150,0,150
"7684","5521工信","110/08/31","永豐金證券",0,200,-200
"7685","5521工信","110/08/31","元富",124,0,124
"7686","5521工信","110/08/31","港商野村",0,166,-166
"7687","5521工信","110/08/31","摩根大通",151,57,94
"7688","5521工信","110/08/31","統一-員林",0,70,-70
"7689","5521工信","110/08/31","富邦-員林",68,0,68
"7690","5521工信","110/08/31","台新-台中",0,62,-62
"7691","5521工信","110/08/31","元富-板橋",66,0,66
"7692","5521工信","110/08/31","永豐金-中正",0,50,-50
"7693","5521工信","110/08/31","第一金-新竹",40,4,36
"7694","5521工信","110/08/31","群益金鼎-基隆",0,34,-34
"7695","5521工信","110/08/31","新百王",32,0,32
"7696","5521工信","110/08/31","美商高盛",0,33,-33
"7697","5521工信","110/08/31","(牛牛牛)亞-鑫豐",32,6,26
"7698","5521工信","110/08/31","元大-台中",0,30,-30
"7699","5521工信","110/08/31","群益金鼎-大甲",21,0,21
"7700","5521工信","110/08/31","元大-南屯",10,35,-25
"7701","5521工信","110/08/31","華南永昌",36,15,21
"7702","5521工信","110/08/31","國泰-新莊",0,21,-21
"7703","5521工信","110/08/31","康和-澎湖",20,0,20
"7704","5521工信","110/08/31","元大-六合",0,20,-20
"7705","5521工信","110/08/31","元大-佳里",20,0,20
"7706","5521工信","110/08/31","國泰-台中",1,20,-19
"7707","5521工信","110/08/31","元大-沙鹿",19,0,19
"7708","5521工信","110/08/31","富邦-高雄",0,19,-19
"7709","5521工信","110/08/31","元富-基隆",15,0,15
"7710","5521工信","110/08/31","元大-斗六",1,20,-19
"7711","1471首利","110/08/31","永豐金-員林",25,0,25
"7712","1471首利","110/08/31","群益金鼎-東大",0,51,-51
"7713","1471首利","110/08/31","大昌-桃園",20,0,20
"7714","1471首利","110/08/31","元大-清水",5,40,-35
"7715","1471首利","110/08/31","華南永昌-中正",20,0,20
"7716","1471首利","110/08/31","臺銀",0,32,-32
"7717","1471首利","110/08/31","臺銀-臺中",15,0,15
"7718","1471首利","110/08/31","凱基-科園",0,32,-32
"7719","1471首利","110/08/31","大慶-富順",15,0,15
"7720","1471首利","110/08/31","元大-台南",0,30,-30
"7721","1471首利","110/08/31","台新-松江",15,0,15
"7722","1471首利","110/08/31","富邦-陽明",0,16,-16
"7723","1471首利","110/08/31","港商法國興業",13,0,13
"7724","1471首利","110/08/31","凱基-台北",0,13,-13
"7725","1471首利","110/08/31","瑞士信貸",11,0,11
"7726","1471首利","110/08/31","元大-竹科",0,11,-11
"7727","1471首利","110/08/31","日盛-鳳山",10,0,10
"7728","1471首利","110/08/31","美林",3,10,-7
"7729","1471首利","110/08/31","富邦-中壢",10,0,10
"7730","1471首利","110/08/31","玉山-大里",0,7,-7
"7731","1471首利","110/08/31","元大-中壢",10,0,10
"7732","1471首利","110/08/31","元富-安南",0,6,-6
"7733","1471首利","110/08/31","元大-板橋",10,0,10
"7734","1471首利","110/08/31","大昌-新店",0,6,-6
"7735","1471首利","110/08/31","台新-左楠",9,0,9
"7736","1471首利","110/08/31","元大-斗信",0,6,-6
"7737","1471首利","110/08/31","永豐金-三重",9,0,9
"7738","1471首利","110/08/31","元大-花蓮",0,5,-5
"7739","1471首利","110/08/31","國泰-台南",10,2,8
"7740","1471首利","110/08/31","永豐金-高雄",5,10,-5
"7741","2883開發金","110/08/31","新加坡商瑞銀",5199,2017,3182
"7742","2883開發金","110/08/31","香港上海匯豐",0,10048,-10048
"7743","2883開發金","110/08/31","亞東-新竹",2900,216,2684
"7744","2883開發金","110/08/31","元大證券",555,10482,-9927
"7745","2883開發金","110/08/31","瑞士信貸",2653,204,2449
"7746","2883開發金","110/08/31","第一金-忠孝",133,1540,-1407
"7747","2883開發金","110/08/31","台灣摩根士丹利",4184,2771,1413
"7748","2883開發金","110/08/31","摩根大通",1383,2786,-1403
"7749","2883開發金","110/08/31","富邦-永和",1249,146,1103
"7750","2883開發金","110/08/31","永豐金-板橋",5,1306,-1301
"7751","2883開發金","110/08/31","花旗環球",1908,911,997
"7752","2883開發金","110/08/31","國票-南京",5,1035,-1030
"7753","2883開發金","110/08/31","華南永昌-竹北",859,18,841
"7754","2883開發金","110/08/31","兆豐-三民",41,997,-956
"7755","2883開發金","110/08/31","元大-大灣",824,39,785
"7756","2883開發金","110/08/31","福勝",4,402,-398
"7757","2883開發金","110/08/31","日盛-台中",640,8,632
"7758","2883開發金","110/08/31","第一金-豐原",12,403,-391
"7759","2883開發金","110/08/31","港商法國興業",564,0,564
"7760","2883開發金","110/08/31","國泰-館前",102,484,-382
"7761","2883開發金","110/08/31","元富",795,258,537
"7762","2883開發金","110/08/31","兆豐-內湖",5,375,-370
"7763","2883開發金","110/08/31","國票-長城",507,4,503
"7764","2883開發金","110/08/31","法銀巴黎",154,513,-359
"7765","2883開發金","110/08/31","台灣企銀-竹北",500,0,500
"7766","2883開發金","110/08/31","統一",112,468,-356
"7767","2883開發金","110/08/31","華南永昌-中正",628,130,498
"7768","2883開發金","110/08/31","兆豐-桃園",87,435,-348
"7769","2883開發金","110/08/31","富邦-台中",456,40,416
"7770","2883開發金","110/08/31","富邦-仁愛",106,418,-312
"7771","6205詮欣","110/08/31","港商法國興業",13,0,13
"7772","6205詮欣","110/08/31","元大-中和",0,35,-35
"7773","6205詮欣","110/08/31","華南永昌-長虹",10,0,10
"7774","6205詮欣","110/08/31","台新證券",0,6,-6
"7775","6205詮欣","110/08/31","瑞士信貸",4,0,4
"7776","6205詮欣","110/08/31","玉山-左營",0,3,-3
"7777","6205詮欣","110/08/31","統一-屏東",3,0,3
"7778","6205詮欣","110/08/31","群益金鼎-三重",0,2,-2
"7779","6205詮欣","110/08/31","台中銀",3,0,3
"7780","6205詮欣","110/08/31","元大-汐止",0,2,-2
"7781","6205詮欣","110/08/31","元大-民雄",3,0,3
"7782","6205詮欣","110/08/31","日盛-台中",0,1,-1
"7783","6205詮欣","110/08/31","臺銀-民權",2,0,2
"7784","6205詮欣","110/08/31","美商高盛",0,1,-1
"7785","6205詮欣","110/08/31","國票-中和",2,0,2
"7786","6205詮欣","110/08/31","花旗環球",0,1,-1
"7787","6205詮欣","110/08/31","摩根大通",4,2,2
"7788","6205詮欣","110/08/31","國票-博愛",0,1,-1
"7789","6205詮欣","110/08/31","康和-板橋",2,0,2
"7790","6205詮欣","110/08/31","凱基-和平",0,1,-1
"7791","6205詮欣","110/08/31","富邦-苗栗",2,0,2
"7792","6205詮欣","110/08/31","富邦-陽明",0,1,-1
"7793","6205詮欣","110/08/31","美林",1,0,1
"7794","6205詮欣","110/08/31","臺銀-高雄",0,0,0
"7795","6205詮欣","110/08/31","第一金-大稻埕",1,0,1
"7796","6205詮欣","110/08/31","元大-大里",1,1,0
"7797","6205詮欣","110/08/31","第一金-路竹",1,0,1
"7798","6205詮欣","110/08/31","",NA,NA,NA
"7799","6205詮欣","110/08/31","元富-桃園",1,0,1
"7800","6205詮欣","110/08/31","",NA,NA,NA
"7801","1540喬福","110/08/31","日盛-樹林",5,0,5
"7802","1540喬福","110/08/31","富邦-中壢",0,19,-19
"7803","1540喬福","110/08/31","安泰",5,0,5
"7804","1540喬福","110/08/31","日盛-南京",0,6,-6
"7805","1540喬福","110/08/31","凱基-中壢",4,0,4
"7806","1540喬福","110/08/31","富邦-虎尾",0,4,-4
"7807","1540喬福","110/08/31","新光-台南",4,0,4
"7808","1540喬福","110/08/31","元富-中原",0,2,-2
"7809","1540喬福","110/08/31","土銀-新竹",2,0,2
"7810","1540喬福","110/08/31","美林",0,1,-1
"7811","1540喬福","110/08/31","元大-東蘆",2,0,2
"7812","1540喬福","110/08/31","美商高盛",0,1,-1
"7813","1540喬福","110/08/31","富邦-高雄",2,0,2
"7814","1540喬福","110/08/31","花旗環球",0,1,-1
"7815","1540喬福","110/08/31","凱基-斗六",2,0,2
"7816","1540喬福","110/08/31","元富",0,1,-1
"7817","1540喬福","110/08/31","合庫證券",2,0,2
"7818","1540喬福","110/08/31","康和-板橋",0,1,-1
"7819","1540喬福","110/08/31","群益金鼎-永和",2,0,2
"7820","1540喬福","110/08/31","元富-中港",0,0,0
"7821","1540喬福","110/08/31","國泰-忠孝",1,0,1
"7822","1540喬福","110/08/31","致和-南京",2,2,0
"7823","1540喬福","110/08/31","凱基",1,0,1
"7824","1540喬福","110/08/31","凱基-竹北",0,0,0
"7825","1540喬福","110/08/31","台新證券",1,0,1
"7826","1540喬福","110/08/31","凱基-竹科",0,0,0
"7827","1540喬福","110/08/31","國票-台南",1,0,1
"7828","1540喬福","110/08/31","元大-內湖",0,0,0
"7829","1540喬福","110/08/31","大昌",1,0,1
"7830","1540喬福","110/08/31","永豐金-中盛",0,0,0
"7831","2888新光金","110/08/31","元大證券",14689,281,14408
"7832","2888新光金","110/08/31","美商高盛",230,8929,-8699
"7833","2888新光金","110/08/31","元大-館前",3112,34,3078
"7834","2888新光金","110/08/31","美林",3678,9122,-5444
"7835","2888新光金","110/08/31","日盛-台中",2979,11,2968
"7836","2888新光金","110/08/31","亞東-新竹",30,4195,-4165
"7837","2888新光金","110/08/31","國泰-台南",1886,83,1803
"7838","2888新光金","110/08/31","凱基-台北",1467,5223,-3756
"7839","2888新光金","110/08/31","台灣摩根士丹利",5981,4550,1431
"7840","2888新光金","110/08/31","群益金鼎-崇德",14,2881,-2867
"7841","2888新光金","110/08/31","元大-大益",1444,45,1399
"7842","2888新光金","110/08/31","國票-南京",2,2505,-2503
"7843","2888新光金","110/08/31","兆豐-寶成",1436,61,1375
"7844","2888新光金","110/08/31","元富-城東",28,2075,-2047
"7845","2888新光金","110/08/31","瑞士信貸",2357,1139,1218
"7846","2888新光金","110/08/31","永豐金證券",197,2020,-1823
"7847","2888新光金","110/08/31","群益金鼎-彰化",1186,35,1151
"7848","2888新光金","110/08/31","摩根大通",2340,4119,-1779
"7849","2888新光金","110/08/31","兆豐-台中港",1205,99,1106
"7850","2888新光金","110/08/31","合庫證券",149,1703,-1554
"7851","2888新光金","110/08/31","(牛牛牛)亞-網路",1107,27,1080
"7852","2888新光金","110/08/31","元富-文心",22,1493,-1471
"7853","2888新光金","110/08/31","元大-豐原",1491,544,947
"7854","2888新光金","110/08/31","港商野村",288,1540,-1252
"7855","2888新光金","110/08/31","臺銀-金山",865,125,740
"7856","2888新光金","110/08/31","新加坡商瑞銀",1936,3101,-1165
"7857","2888新光金","110/08/31","元大-中壢",913,195,718
"7858","2888新光金","110/08/31","統一-新台中",54,1199,-1145
"7859","2888新光金","110/08/31","合庫-嘉義",740,74,666
"7860","2888新光金","110/08/31","華南永昌-台中",66,1192,-1126
"7861","1340勝悅","110/08/31","美林",11,1,10
"7862","1340勝悅","110/08/31","台中銀",0,15,-15
"7863","1340勝悅","110/08/31","日盛-忠孝",7,0,7
"7864","1340勝悅","110/08/31","安泰",0,8,-8
"7865","1340勝悅","110/08/31","臺灣企銀-埔墘",5,0,5
"7866","1340勝悅","110/08/31","摩根大通",0,6,-6
"7867","1340勝悅","110/08/31","瑞士信貸",5,0,5
"7868","1340勝悅","110/08/31","第一金-豐原",0,5,-5
"7869","1340勝悅","110/08/31","永豐金-三重",5,0,5
"7870","1340勝悅","110/08/31","元富-世貿",0,5,-5
"7871","1340勝悅","110/08/31","美商高盛",3,0,3
"7872","1340勝悅","110/08/31","國票-台東",0,5,-5
"7873","1340勝悅","110/08/31","玉山-左營",3,0,3
"7874","1340勝悅","110/08/31","永豐金-南投",0,5,-5
"7875","1340勝悅","110/08/31","國泰-敦南",3,0,3
"7876","1340勝悅","110/08/31","富邦-台中",0,4,-4
"7877","1340勝悅","110/08/31","元大-松江",3,0,3
"7878","1340勝悅","110/08/31","玉山-板橋",0,3,-3
"7879","1340勝悅","110/08/31","新光",2,0,2
"7880","1340勝悅","110/08/31","元大-彰化民生",0,3,-3
"7881","1340勝悅","110/08/31","群益金鼎-崇德",2,0,2
"7882","1340勝悅","110/08/31","(牛牛牛)亞-鑫豐",8,10,-2
"7883","1340勝悅","110/08/31","元大-東泰",2,0,2
"7884","1340勝悅","110/08/31","元大-竹山",0,2,-2
"7885","1340勝悅","110/08/31","國泰-新莊",1,0,1
"7886","1340勝悅","110/08/31","第一金-新竹",0,1,-1
"7887","1340勝悅","110/08/31","群益金鼎-高盛",1,0,1
"7888","1340勝悅","110/08/31","凱基-竹北",0,1,-1
"7889","1340勝悅","110/08/31","群益金鼎-館前",1,0,1
"7890","1340勝悅","110/08/31","統一-城中",0,0,0
"7891","6246臺龍","110/08/31","元富-宜蘭",13,0,13
"7892","6246臺龍","110/08/31","華南永昌-頭份",0,20,-20
"7893","6246臺龍","110/08/31","國票-桃園",6,0,6
"7894","6246臺龍","110/08/31","致和-台北",0,14,-14
"7895","6246臺龍","110/08/31","凱基-台北",5,0,5
"7896","6246臺龍","110/08/31","元大-博愛",0,7,-7
"7897","6246臺龍","110/08/31","國票-敦北法人",4,0,4
"7898","6246臺龍","110/08/31","群益金鼎-古亭",0,5,-5
"7899","6246臺龍","110/08/31","台新-屏東",3,0,3
"7900","6246臺龍","110/08/31","合庫-西台中",0,3,-3
"7901","6246臺龍","110/08/31","日盛-內湖",2,0,2
"7902","6246臺龍","110/08/31","群益金鼎-土城",0,3,-3
"7903","6246臺龍","110/08/31","日盛-大墩",2,0,2
"7904","6246臺龍","110/08/31","第一金-自由",0,2,-2
"7905","6246臺龍","110/08/31","元富-屏東",2,0,2
"7906","6246臺龍","110/08/31","台新證券",1,3,-2
"7907","6246臺龍","110/08/31","凱基-桃園",2,0,2
"7908","6246臺龍","110/08/31","台新-三民",0,2,-2
"7909","6246臺龍","110/08/31","華南永昌",2,0,2
"7910","6246臺龍","110/08/31","凱基-東門",0,2,-2
"7911","6246臺龍","110/08/31","元大-豐原站前",2,0,2
"7912","6246臺龍","110/08/31","元大-府城",0,2,-2
"7913","6246臺龍","110/08/31","元大-小港",2,0,2
"7914","6246臺龍","110/08/31","永豐金-新竹",0,2,-2
"7915","6246臺龍","110/08/31","元大-北屯",2,0,2
"7916","6246臺龍","110/08/31","日盛證券",0,1,-1
"7917","6246臺龍","110/08/31","日盛-新莊",1,0,1
"7918","6246臺龍","110/08/31","港商野村",0,1,-1
"7919","6246臺龍","110/08/31","元富-安南",1,0,1
"7920","6246臺龍","110/08/31","元大-沙鹿",0,1,-1
"7921","00715L期街口布蘭特正2","110/08/31","永豐金證券",4504,25,4479
"7922","00715L期街口布蘭特正2","110/08/31","元大-斗六",0,1401,-1401
"7923","00715L期街口布蘭特正2","110/08/31","元大證券",4224,444,3780
"7924","00715L期街口布蘭特正2","110/08/31","永豐金-台中",20,970,-950
"7925","00715L期街口布蘭特正2","110/08/31","國票",2499,0,2499
"7926","00715L期街口布蘭特正2","110/08/31","凱基-高美館",0,746,-746
"7927","00715L期街口布蘭特正2","110/08/31","群益金鼎",1981,0,1981
"7928","00715L期街口布蘭特正2","110/08/31","兆豐-中壢",0,737,-737
"7929","00715L期街口布蘭特正2","110/08/31","元富",1195,0,1195
"7930","00715L期街口布蘭特正2","110/08/31","群益金鼎-中壢",0,573,-573
"7931","00715L期街口布蘭特正2","110/08/31","國票-中港",1000,0,1000
"7932","00715L期街口布蘭特正2","110/08/31","富邦-彰化",100,606,-506
"7933","00715L期街口布蘭特正2","110/08/31","凱基-城中",1001,35,966
"7934","00715L期街口布蘭特正2","110/08/31","元大-金門",0,475,-475
"7935","00715L期街口布蘭特正2","110/08/31","康和",959,0,959
"7936","00715L期街口布蘭特正2","110/08/31","凱基-高雄",0,431,-431
"7937","00715L期街口布蘭特正2","110/08/31","統一",886,0,886
"7938","00715L期街口布蘭特正2","110/08/31","新光",43,382,-339
"7939","00715L期街口布蘭特正2","110/08/31","凱基-台北",684,0,684
"7940","00715L期街口布蘭特正2","110/08/31","元富-文心",21,341,-320
"7941","00715L期街口布蘭特正2","110/08/31","群益金鼎-宜蘭",653,7,646
"7942","00715L期街口布蘭特正2","110/08/31","富邦-嘉義",5,316,-311
"7943","00715L期街口布蘭特正2","110/08/31","永豐金-三重",625,0,625
"7944","00715L期街口布蘭特正2","110/08/31","新光-桃園",42,339,-297
"7945","00715L期街口布蘭特正2","110/08/31","合庫證券",605,10,595
"7946","00715L期街口布蘭特正2","110/08/31","台新-台南",0,290,-290
"7947","00715L期街口布蘭特正2","110/08/31","兆豐-台中",502,0,502
"7948","00715L期街口布蘭特正2","110/08/31","富邦-中壢",0,284,-284
"7949","00715L期街口布蘭特正2","110/08/31","台新-松江",500,0,500
"7950","00715L期街口布蘭特正2","110/08/31","台中銀-豐原",5,265,-260
"7951","8941關中","110/08/31","元大-金華",3,0,3
"7952","8941關中","110/08/31","臺銀-新竹",0,3,-3
"7953","8941關中","110/08/31","永豐金-三重",3,0,3
"7954","8941關中","110/08/31","富邦-仁愛",0,2,-2
"7955","8941關中","110/08/31","國泰-新莊",2,0,2
"7956","8941關中","110/08/31","統一-彰化",0,1,-1
"7957","8941關中","110/08/31","富邦-左營",0,0,0
"7958","8941關中","110/08/31","凱基-台北",0,1,-1
"7959","8941關中","110/08/31","元大-桃興",1,1,0
"7960","8941關中","110/08/31","元大-路竹",0,1,-1
"7961","8941關中","110/08/31","永豐金-南投",0,0,0
"7962","8941關中","110/08/31","富邦-左營",0,0,0
"7963","8941關中","110/08/31","",NA,NA,NA
"7964","8941關中","110/08/31","元大-桃興",1,1,0
"7965","8941關中","110/08/31","",NA,NA,NA
"7966","8941關中","110/08/31","永豐金-南投",0,0,0
"7967","8941關中","110/08/31","",NA,NA,NA
"7968","8941關中","110/08/31","",NA,NA,NA
"7969","8941關中","110/08/31","",NA,NA,NA
"7970","8941關中","110/08/31","",NA,NA,NA
"7971","8941關中","110/08/31","",NA,NA,NA
"7972","8941關中","110/08/31","",NA,NA,NA
"7973","8941關中","110/08/31","",NA,NA,NA
"7974","8941關中","110/08/31","",NA,NA,NA
"7975","8941關中","110/08/31","",NA,NA,NA
"7976","8941關中","110/08/31","",NA,NA,NA
"7977","8941關中","110/08/31","",NA,NA,NA
"7978","8941關中","110/08/31","",NA,NA,NA
"7979","8941關中","110/08/31","",NA,NA,NA
"7980","8941關中","110/08/31","",NA,NA,NA
"7981","8936國統","110/08/31","摩根大通",222,7,215
"7982","8936國統","110/08/31","永豐金-高雄",0,100,-100
"7983","8936國統","110/08/31","台灣摩根士丹利",152,0,152
"7984","8936國統","110/08/31","台新-高雄",75,147,-72
"7985","8936國統","110/08/31","美商高盛",153,3,150
"7986","8936國統","110/08/31","統一-金門",0,45,-45
"7987","8936國統","110/08/31","華南永昌-高雄",142,12,130
"7988","8936國統","110/08/31","凱基-信義",1,30,-29
"7989","8936國統","110/08/31","新加坡商瑞銀",83,9,74
"7990","8936國統","110/08/31","新光-高雄",6,33,-27
"7991","8936國統","110/08/31","港商野村",62,4,58
"7992","8936國統","110/08/31","元大-天母",2,26,-24
"7993","8936國統","110/08/31","永豐金-彰化",50,20,30
"7994","8936國統","110/08/31","元大-博愛",1,23,-22
"7995","8936國統","110/08/31","元富-敦南",19,0,19
"7996","8936國統","110/08/31","元大-員林",0,20,-20
"7997","8936國統","110/08/31","凱基-台北",90,71,19
"7998","8936國統","110/08/31","元大-佳里",0,19,-19
"7999","8936國統","110/08/31","富邦-員林",20,4,16
"8000","8936國統","110/08/31","國泰-高雄",0,18,-18
"8001","8936國統","110/08/31","日盛-豐原",15,0,15
"8002","8936國統","110/08/31","國泰-敦南",6,23,-17
"8003","8936國統","110/08/31","瑞士信貸",15,0,15
"8004","8936國統","110/08/31","富邦-羅東",0,16,-16
"8005","8936國統","110/08/31","第一金-華江",15,0,15
"8006","8936國統","110/08/31","凱基-員林",0,15,-15
"8007","8936國統","110/08/31","美林",15,1,14
"8008","8936國統","110/08/31","新光-桃園",0,12,-12
"8009","8936國統","110/08/31","玉山-高雄",16,3,13
"8010","8936國統","110/08/31","台新-左楠",0,11,-11
"8011","6226光鼎","110/08/31","美商高盛",617,39,578
"8012","6226光鼎","110/08/31","國泰-敦南",37,130,-93
"8013","6226光鼎","110/08/31","港商野村",256,59,197
"8014","6226光鼎","110/08/31","元大-員林中山",5,81,-76
"8015","6226光鼎","110/08/31","美林",201,59,142
"8016","6226光鼎","110/08/31","宏遠-光隆",0,65,-65
"8017","6226光鼎","110/08/31","摩根大通",166,78,88
"8018","6226光鼎","110/08/31","新光",21,75,-54
"8019","6226光鼎","110/08/31","群益金鼎-鳳山",91,3,88
"8020","6226光鼎","110/08/31","永全-南崁",0,40,-40
"8021","6226光鼎","110/08/31","亞東-高雄",60,0,60
"8022","6226光鼎","110/08/31","群益金鼎-忠孝",3,40,-37
"8023","6226光鼎","110/08/31","新加坡商瑞銀",44,4,40
"8024","6226光鼎","110/08/31","台新證券",11,47,-36
"8025","6226光鼎","110/08/31","凱基-台北",45,15,30
"8026","6226光鼎","110/08/31","凱基-中山",0,36,-36
"8027","6226光鼎","110/08/31","元大-新竹經國",31,1,30
"8028","6226光鼎","110/08/31","元大-大灣",0,34,-34
"8029","6226光鼎","110/08/31","兆豐-松德",27,0,27
"8030","6226光鼎","110/08/31","元大-東泰",0,33,-33
"8031","6226光鼎","110/08/31","日盛-員林",29,3,26
"8032","6226光鼎","110/08/31","日盛-八德",11,42,-31
"8033","6226光鼎","110/08/31","元大-小港",29,3,26
"8034","6226光鼎","110/08/31","元富-城中",0,30,-30
"8035","6226光鼎","110/08/31","新光-台中",25,4,21
"8036","6226光鼎","110/08/31","永豐金-台中",3,33,-30
"8037","6226光鼎","110/08/31","群益金鼎-土城",20,0,20
"8038","6226光鼎","110/08/31","群益金鼎-中壢",1,27,-26
"8039","6226光鼎","110/08/31","華南永昌-台中",30,10,20
"8040","6226光鼎","110/08/31","元大-北港",0,26,-26
"8041","2363矽統","110/08/31","康和-台中",674,11,663
"8042","2363矽統","110/08/31","瑞士信貸",0,1792,-1792
"8043","2363矽統","110/08/31","台灣摩根士丹利",210,10,200
"8044","2363矽統","110/08/31","凱基-台北",886,1639,-753
"8045","2363矽統","110/08/31","國泰-敦南",360,168,192
"8046","2363矽統","110/08/31","第一金-桃園",22,620,-598
"8047","2363矽統","110/08/31","元大-前金",267,89,178
"8048","2363矽統","110/08/31","港商野村",242,834,-592
"8049","2363矽統","110/08/31","元大-大統",166,14,152
"8050","2363矽統","110/08/31","凱基-站前",85,565,-480
"8051","2363矽統","110/08/31","日盛-中和",139,8,131
"8052","2363矽統","110/08/31","國票-南港",2,409,-407
"8053","2363矽統","110/08/31","陽信-石牌",141,18,123
"8054","2363矽統","110/08/31","元大-承德",5,402,-397
"8055","2363矽統","110/08/31","第一金-新竹",399,286,113
"8056","2363矽統","110/08/31","台新-新莊",15,308,-293
"8057","2363矽統","110/08/31","國票-博愛",111,3,108
"8058","2363矽統","110/08/31","兆豐-公益",9,223,-214
"8059","2363矽統","110/08/31","元大-士林",119,12,107
"8060","2363矽統","110/08/31","第一金-豐原",40,211,-171
"8061","2363矽統","110/08/31","永豐金-敦南",125,22,103
"8062","2363矽統","110/08/31","永豐金-台中",8,171,-163
"8063","2363矽統","110/08/31","永豐金-中壢",103,0,103
"8064","2363矽統","110/08/31","元大-南勢角",8,135,-127
"8065","2363矽統","110/08/31","彰銀-台中",101,1,100
"8066","2363矽統","110/08/31","群益金鼎",8,126,-118
"8067","2363矽統","110/08/31","台新-台中",113,28,85
"8068","2363矽統","110/08/31","富邦-嘉義",91,209,-118
"8069","2363矽統","110/08/31","臺銀-臺南",94,11,83
"8070","2363矽統","110/08/31","美商高盛",90,206,-116
"8071","8112至上","110/08/31","香港上海匯豐",442,37,405
"8072","8112至上","110/08/31","第一金-頭份",2,99,-97
"8073","8112至上","110/08/31","美林",91,8,83
"8074","8112至上","110/08/31","富邦-仁愛",1,73,-72
"8075","8112至上","110/08/31","凱基-內埔",45,0,45
"8076","8112至上","110/08/31","臺灣企銀-桃園",0,70,-70
"8077","8112至上","110/08/31","國票-南京",40,0,40
"8078","8112至上","110/08/31","法銀巴黎",0,49,-49
"8079","8112至上","110/08/31","元大-士林",42,2,40
"8080","8112至上","110/08/31","元大-仁愛",1,50,-49
"8081","8112至上","110/08/31","瑞士信貸",38,0,38
"8082","8112至上","110/08/31","大昌-桃園",0,40,-40
"8083","8112至上","110/08/31","元大-楊梅",30,0,30
"8084","8112至上","110/08/31","花旗環球",0,30,-30
"8085","8112至上","110/08/31","(牛牛牛)亞-鑫豐",23,0,23
"8086","8112至上","110/08/31","群益金鼎-瑞豐",0,30,-30
"8087","8112至上","110/08/31","富邦-虎尾",24,1,23
"8088","8112至上","110/08/31","日盛-雙和",9,37,-28
"8089","8112至上","110/08/31","群益金鼎-東門",21,0,21
"8090","8112至上","110/08/31","國泰-板橋",0,28,-28
"8091","8112至上","110/08/31","元大-永和",21,0,21
"8092","8112至上","110/08/31","台灣摩根士丹利",24,47,-23
"8093","8112至上","110/08/31","元大-新盛",20,0,20
"8094","8112至上","110/08/31","富邦-南屯",0,20,-20
"8095","8112至上","110/08/31","凱基-士林",19,0,19
"8096","8112至上","110/08/31","元大-小港",0,20,-20
"8097","8112至上","110/08/31","永豐金-竹科",18,0,18
"8098","8112至上","110/08/31","玉山-士林",1,20,-19
"8099","8112至上","110/08/31","凱基-松山",20,4,16
"8100","8112至上","110/08/31","群益金鼎-基隆",2,21,-19
"8101","1570力肯","110/08/31","香港上海匯豐",53,0,53
"8102","1570力肯","110/08/31","元大-板橋",11,60,-49
"8103","1570力肯","110/08/31","凱基-市政",30,1,29
"8104","1570力肯","110/08/31","群益金鼎-北高雄",0,27,-27
"8105","1570力肯","110/08/31","第一金-嘉義",20,0,20
"8106","1570力肯","110/08/31","元富-世貿",0,20,-20
"8107","1570力肯","110/08/31","台新-台南",20,0,20
"8108","1570力肯","110/08/31","永豐金-中壢",0,19,-19
"8109","1570力肯","110/08/31","宏遠-光隆",20,1,19
"8110","1570力肯","110/08/31","兆豐-員林",0,17,-17
"8111","1570力肯","110/08/31","康和-高雄",18,0,18
"8112","1570力肯","110/08/31","摩根大通",0,16,-16
"8113","1570力肯","110/08/31","日茂-南投",17,0,17
"8114","1570力肯","110/08/31","凱基-台北",20,35,-15
"8115","1570力肯","110/08/31","台新-台中",17,1,16
"8116","1570力肯","110/08/31","元大-竹南",1,16,-15
"8117","1570力肯","110/08/31","兆豐-天母",15,0,15
"8118","1570力肯","110/08/31","新光",8,22,-14
"8119","1570力肯","110/08/31","元大-鳳中",18,4,14
"8120","1570力肯","110/08/31","(牛牛牛)亞-鑫豐",11,23,-12
"8121","1570力肯","110/08/31","合庫-嘉義",10,0,10
"8122","1570力肯","110/08/31","臺銀-臺南",0,11,-11
"8123","1570力肯","110/08/31","日盛-員林",10,0,10
"8124","1570力肯","110/08/31","日盛-八德",0,11,-11
"8125","1570力肯","110/08/31","元富-草屯",10,0,10
"8126","1570力肯","110/08/31","富邦-北港",0,11,-11
"8127","1570力肯","110/08/31","國票-九鼎",10,0,10
"8128","1570力肯","110/08/31","日茂",0,10,-10
"8129","1570力肯","110/08/31","國泰-台中",10,0,10
"8130","1570力肯","110/08/31","凱基-東勢",0,10,-10
"8131","2929淘帝","110/08/31","美林",47,2,45
"8132","2929淘帝","110/08/31","元富-敦南",0,121,-121
"8133","2929淘帝","110/08/31","兆豐-大同",37,0,37
"8134","2929淘帝","110/08/31","元富-彰化",0,20,-20
"8135","2929淘帝","110/08/31","摩根大通",27,0,27
"8136","2929淘帝","110/08/31","新加坡商瑞銀",0,15,-15
"8137","2929淘帝","110/08/31","港商野村",52,31,21
"8138","2929淘帝","110/08/31","元大-豐原站前",0,10,-10
"8139","2929淘帝","110/08/31","大昌",10,0,10
"8140","2929淘帝","110/08/31","台新證券",0,5,-5
"8141","2929淘帝","110/08/31","港商法國興業",8,0,8
"8142","2929淘帝","110/08/31","華南永昌-台中",0,5,-5
"8143","2929淘帝","110/08/31","瑞士信貸",6,0,6
"8144","2929淘帝","110/08/31","元大-士林",0,4,-4
"8145","2929淘帝","110/08/31","元大-大雅",6,0,6
"8146","2929淘帝","110/08/31","光和-嘉義",0,3,-3
"8147","2929淘帝","110/08/31","第一金-忠孝",5,0,5
"8148","2929淘帝","110/08/31","臺銀-金山",0,2,-2
"8149","2929淘帝","110/08/31","凱基-東門",5,0,5
"8150","2929淘帝","110/08/31","日盛-雙和",0,2,-2
"8151","2929淘帝","110/08/31","凱基-台北",7,2,5
"8152","2929淘帝","110/08/31","元富-三重",0,2,-2
"8153","2929淘帝","110/08/31","永豐金-板橋",5,0,5
"8154","2929淘帝","110/08/31","元富-中原",0,2,-2
"8155","2929淘帝","110/08/31","元富-新竹",4,0,4
"8156","2929淘帝","110/08/31","(牛牛牛)亞-鑫豐",0,2,-2
"8157","2929淘帝","110/08/31","玉山-士林",4,0,4
"8158","2929淘帝","110/08/31","中國信託",0,2,-2
"8159","2929淘帝","110/08/31","兆豐-桃鶯",3,0,3
"8160","2929淘帝","110/08/31","大昌-新竹",0,2,-2
"8161","5410國眾","110/08/31","永豐金-內湖",20,0,20
"8162","5410國眾","110/08/31","群益金鼎-民權",0,28,-28
"8163","5410國眾","110/08/31","臺銀-臺南",4,0,4
"8164","5410國眾","110/08/31","元大-板橋",0,4,-4
"8165","5410國眾","110/08/31","國泰-台中",4,0,4
"8166","5410國眾","110/08/31","寶盛",0,3,-3
"8167","5410國眾","110/08/31","中國信託-高雄",3,0,3
"8168","5410國眾","110/08/31","兆豐-北高雄",0,3,-3
"8169","5410國眾","110/08/31","台新證券",3,0,3
"8170","5410國眾","110/08/31","國票-和平",0,3,-3
"8171","5410國眾","110/08/31","元大-中壢",3,0,3
"8172","5410國眾","110/08/31","新光",0,3,-3
"8173","5410國眾","110/08/31","新光-台中",2,0,2
"8174","5410國眾","110/08/31","凱基-桃園",0,3,-3
"8175","5410國眾","110/08/31","凱基-科園",2,0,2
"8176","5410國眾","110/08/31","凱基-台南",0,3,-3
"8177","5410國眾","110/08/31","凱基-永康",2,0,2
"8178","5410國眾","110/08/31","富邦-嘉義",0,2,-2
"8179","5410國眾","110/08/31","凱基-興隆",2,0,2
"8180","5410國眾","110/08/31","元大-斗六",0,2,-2
"8181","5410國眾","110/08/31","元大-長庚",2,0,2
"8182","5410國眾","110/08/31","元大-土城學府",0,2,-2
"8183","5410國眾","110/08/31","臺銀-臺中",1,0,1
"8184","5410國眾","110/08/31","永豐金-埔里",0,2,-2
"8185","5410國眾","110/08/31","元富-埔里",1,0,1
"8186","5410國眾","110/08/31","國泰-敦南",0,1,-1
"8187","5410國眾","110/08/31","元富-西松",1,0,1
"8188","5410國眾","110/08/31","群益金鼎-中壢",0,1,-1
"8189","5410國眾","110/08/31","中國信託-永康",1,0,1
"8190","5410國眾","110/08/31","富邦-新店",0,1,-1
"8191","2841台開","110/08/31","宏遠-館前",150,0,150
"8192","2841台開","110/08/31","港商野村",0,171,-171
"8193","2841台開","110/08/31","永豐金-敦南",62,28,34
"8194","2841台開","110/08/31","元大-台中中港",0,39,-39
"8195","2841台開","110/08/31","日盛證券",21,8,13
"8196","2841台開","110/08/31","統一-士林",5,25,-20
"8197","2841台開","110/08/31","大慶-蘆洲",10,0,10
"8198","2841台開","110/08/31","永豐金-復興",0,11,-11
"8199","2841台開","110/08/31","元大-善化",10,0,10
"8200","2841台開","110/08/31","元富-嘉義",0,10,-10
"8201","2841台開","110/08/31","元大-新莊",10,0,10
"8202","2841台開","110/08/31","全泰證券",0,10,-10
"8203","2841台開","110/08/31","大昌-安康",15,6,9
"8204","2841台開","110/08/31","群益金鼎-彰化",0,10,-10
"8205","2841台開","110/08/31","元大-南屯",8,0,8
"8206","2841台開","110/08/31","元大-豐原",0,10,-10
"8207","2841台開","110/08/31","元大-台南",8,0,8
"8208","2841台開","110/08/31","台新證券",0,8,-8
"8209","2841台開","110/08/31","第一金-台南",6,0,6
"8210","2841台開","110/08/31","群益金鼎-丹鳳",0,6,-6
"8211","2841台開","110/08/31","第一金-自由",6,0,6
"8212","2841台開","110/08/31","凱基-鳳山",0,6,-6
"8213","2841台開","110/08/31","台新-台中",6,0,6
"8214","2841台開","110/08/31","元大-大里德芳",0,6,-6
"8215","2841台開","110/08/31","凱基-興隆",6,0,6
"8216","2841台開","110/08/31","日盛-屏東",0,5,-5
"8217","2841台開","110/08/31","元大-屏南",6,0,6
"8218","2841台開","110/08/31","台中銀",0,5,-5
"8219","2841台開","110/08/31","凱基-東港",5,0,5
"8220","2841台開","110/08/31","元大-景美",0,5,-5
"8221","6207雷科","110/08/31","元大-高雄",51,0,51
"8222","6207雷科","110/08/31","(牛牛牛)亞-鑫豐",0,67,-67
"8223","6207雷科","110/08/31","元大-大統",18,0,18
"8224","6207雷科","110/08/31","華南永昌-林口",0,13,-13
"8225","6207雷科","110/08/31","日盛-桃園",15,0,15
"8226","6207雷科","110/08/31","國票-台中",0,12,-12
"8227","6207雷科","110/08/31","群益金鼎-瑞豐",15,1,14
"8228","6207雷科","110/08/31","中國信託-新竹",0,10,-10
"8229","6207雷科","110/08/31","摩根大通",18,5,13
"8230","6207雷科","110/08/31","元大-府城",0,10,-10
"8231","6207雷科","110/08/31","永豐金-高雄",11,0,11
"8232","6207雷科","110/08/31","元大-敦南",0,10,-10
"8233","6207雷科","110/08/31","群益金鼎-新竹",8,0,8
"8234","6207雷科","110/08/31","日盛-台南",0,7,-7
"8235","6207雷科","110/08/31","凱基-中山",6,1,5
"8236","6207雷科","110/08/31","統一-屏東",0,7,-7
"8237","6207雷科","110/08/31","華南永昌-古亭",5,0,5
"8238","6207雷科","110/08/31","元富-中港",0,7,-7
"8239","6207雷科","110/08/31","元大-鳳山",7,2,5
"8240","6207雷科","110/08/31","兆豐-嘉義",0,6,-6
"8241","6207雷科","110/08/31","永豐金-北高雄",5,0,5
"8242","6207雷科","110/08/31","元富-三重",0,5,-5
"8243","6207雷科","110/08/31","富邦-桃園",4,0,4
"8244","6207雷科","110/08/31","元富-新興",0,5,-5
"8245","6207雷科","110/08/31","日盛證券",3,0,3
"8246","6207雷科","110/08/31","日盛-高雄",0,4,-4
"8247","6207雷科","110/08/31","日盛-龍潭",3,0,3
"8248","6207雷科","110/08/31","兆豐-三民",1,5,-4
"8249","6207雷科","110/08/31","富邦-中壢",3,0,3
"8250","6207雷科","110/08/31","合庫-自強",0,3,-3
"8251","3679新至陞","110/08/31","凱基-中山",6,0,6
"8252","3679新至陞","110/08/31","土銀-建國",0,17,-17
"8253","3679新至陞","110/08/31","(牛牛牛)亞-網路",5,0,5
"8254","3679新至陞","110/08/31","凱基-竹科",0,11,-11
"8255","3679新至陞","110/08/31","台中銀-員林",4,0,4
"8256","3679新至陞","110/08/31","摩根大通",1,6,-5
"8257","3679新至陞","110/08/31","國泰-松江",3,0,3
"8258","3679新至陞","110/08/31","玉山-台大",0,4,-4
"8259","3679新至陞","110/08/31","永豐金-南投",3,0,3
"8260","3679新至陞","110/08/31","瑞士信貸",0,2,-2
"8261","3679新至陞","110/08/31","康和-台中",2,0,2
"8262","3679新至陞","110/08/31","國泰-敦南",0,2,-2
"8263","3679新至陞","110/08/31","玉山-高雄",2,0,2
"8264","3679新至陞","110/08/31","永豐金-內湖",0,2,-2
"8265","3679新至陞","110/08/31","元大-新莊",2,0,2
"8266","3679新至陞","110/08/31","台灣摩根士丹利",0,1,-1
"8267","3679新至陞","110/08/31","土銀-台中",1,0,1
"8268","3679新至陞","110/08/31","中國信託",0,1,-1
"8269","3679新至陞","110/08/31","臺銀",1,0,1
"8270","3679新至陞","110/08/31","凱基-新店",0,1,-1
"8271","3679新至陞","110/08/31","臺銀-高雄",1,0,1
"8272","3679新至陞","110/08/31","元大-南海",0,1,-1
"8273","3679新至陞","110/08/31","亞東",1,0,1
"8274","3679新至陞","110/08/31","元大-木柵",0,1,-1
"8275","3679新至陞","110/08/31","統一-敦南",1,0,1
"8276","3679新至陞","110/08/31","元大-東港",0,1,-1
"8277","3679新至陞","110/08/31","大昌-桃園",1,0,1
"8278","3679新至陞","110/08/31","永豐金-敦南",0,1,-1
"8279","3679新至陞","110/08/31","元大-大里",1,0,1
"8280","3679新至陞","110/08/31","元大證券",1,1,0
"8281","2727王品","110/08/31","台灣摩根士丹利",84,8,76
"8282","2727王品","110/08/31","花旗環球",0,30,-30
"8283","2727王品","110/08/31","瑞士信貸",50,6,44
"8284","2727王品","110/08/31","凱基-信義",0,18,-18
"8285","2727王品","110/08/31","華南永昌-鳳山",15,0,15
"8286","2727王品","110/08/31","港商野村",6,22,-16
"8287","2727王品","110/08/31","合庫-新竹",10,1,9
"8288","2727王品","110/08/31","永豐金-苓雅",0,15,-15
"8289","2727王品","110/08/31","合庫-台中",7,0,7
"8290","2727王品","110/08/31","富邦-羅東",0,11,-11
"8291","2727王品","110/08/31","台新證券",14,7,7
"8292","2727王品","110/08/31","中國信託",1,10,-9
"8293","2727王品","110/08/31","安泰",5,0,5
"8294","2727王品","110/08/31","國泰證券",0,9,-9
"8295","2727王品","110/08/31","新光",5,0,5
"8296","2727王品","110/08/31","日盛-中壢",0,7,-7
"8297","2727王品","110/08/31","日盛-屏東",4,0,4
"8298","2727王品","110/08/31","(牛牛牛)亞-鑫豐",1,8,-7
"8299","2727王品","110/08/31","摩根大通",16,12,4
"8300","2727王品","110/08/31","新光-台南",0,7,-7
"8301","2727王品","110/08/31","兆豐-岡山",3,0,3
"8302","2727王品","110/08/31","凱基-市政",5,12,-7
"8303","2727王品","110/08/31","國泰-板橋",5,2,3
"8304","2727王品","110/08/31","統一",1,7,-6
"8305","2727王品","110/08/31","元大-彰化民生",3,0,3
"8306","2727王品","110/08/31","彰銀-七賢",1,6,-5
"8307","2727王品","110/08/31","元大-內湖",5,2,3
"8308","2727王品","110/08/31","彰銀-台中",0,5,-5
"8309","2727王品","110/08/31","永豐金-台中",4,1,3
"8310","2727王品","110/08/31","元大-中壢",0,5,-5
"8311","1570力肯","110/08/31","香港上海匯豐",53,0,53
"8312","1570力肯","110/08/31","元大-板橋",11,60,-49
"8313","1570力肯","110/08/31","凱基-市政",30,1,29
"8314","1570力肯","110/08/31","群益金鼎-北高雄",0,27,-27
"8315","1570力肯","110/08/31","第一金-嘉義",20,0,20
"8316","1570力肯","110/08/31","元富-世貿",0,20,-20
"8317","1570力肯","110/08/31","台新-台南",20,0,20
"8318","1570力肯","110/08/31","永豐金-中壢",0,19,-19
"8319","1570力肯","110/08/31","宏遠-光隆",20,1,19
"8320","1570力肯","110/08/31","兆豐-員林",0,17,-17
"8321","1570力肯","110/08/31","康和-高雄",18,0,18
"8322","1570力肯","110/08/31","摩根大通",0,16,-16
"8323","1570力肯","110/08/31","日茂-南投",17,0,17
"8324","1570力肯","110/08/31","凱基-台北",20,35,-15
"8325","1570力肯","110/08/31","台新-台中",17,1,16
"8326","1570力肯","110/08/31","元大-竹南",1,16,-15
"8327","1570力肯","110/08/31","兆豐-天母",15,0,15
"8328","1570力肯","110/08/31","新光",8,22,-14
"8329","1570力肯","110/08/31","元大-鳳中",18,4,14
"8330","1570力肯","110/08/31","(牛牛牛)亞-鑫豐",11,23,-12
"8331","1570力肯","110/08/31","合庫-嘉義",10,0,10
"8332","1570力肯","110/08/31","臺銀-臺南",0,11,-11
"8333","1570力肯","110/08/31","日盛-員林",10,0,10
"8334","1570力肯","110/08/31","日盛-八德",0,11,-11
"8335","1570力肯","110/08/31","元富-草屯",10,0,10
"8336","1570力肯","110/08/31","富邦-北港",0,11,-11
"8337","1570力肯","110/08/31","國票-九鼎",10,0,10
"8338","1570力肯","110/08/31","日茂",0,10,-10
"8339","1570力肯","110/08/31","國泰-台中",10,0,10
"8340","1570力肯","110/08/31","凱基-東勢",0,10,-10
"8341","6180橘子","110/08/31","美林",80,0,80
"8342","6180橘子","110/08/31","凱基-嘉義",0,75,-75
"8343","6180橘子","110/08/31","凱基-台北",71,6,65
"8344","6180橘子","110/08/31","兆豐證券",0,42,-42
"8345","6180橘子","110/08/31","高橋",17,1,16
"8346","6180橘子","110/08/31","玉山-新莊",0,40,-40
"8347","6180橘子","110/08/31","台灣摩根士丹利",28,13,15
"8348","6180橘子","110/08/31","兆豐-三民",0,20,-20
"8349","6180橘子","110/08/31","美商高盛",24,10,14
"8350","6180橘子","110/08/31","富邦-南屯",2,13,-11
"8351","6180橘子","110/08/31","合庫-自強",10,0,10
"8352","6180橘子","110/08/31","元富-埔里",0,10,-10
"8353","6180橘子","110/08/31","新光-桃園",8,0,8
"8354","6180橘子","110/08/31","玉山-高雄",0,10,-10
"8355","6180橘子","110/08/31","摩根大通",24,17,7
"8356","6180橘子","110/08/31","富邦-竹東",0,10,-10
"8357","6180橘子","110/08/31","華南永昌-朴子",6,0,6
"8358","6180橘子","110/08/31","富邦-陽明",0,9,-9
"8359","6180橘子","110/08/31","國泰-台中",5,0,5
"8360","6180橘子","110/08/31","華南永昌-古亭",3,11,-8
"8361","6180橘子","110/08/31","凱基-東門",5,0,5
"8362","6180橘子","110/08/31","元大-發財",0,8,-8
"8363","6180橘子","110/08/31","凱基-永華",5,0,5
"8364","6180橘子","110/08/31","新光-台中",0,7,-7
"8365","6180橘子","110/08/31","元大證券",5,0,5
"8366","6180橘子","110/08/31","群益金鼎-新店",0,7,-7
"8367","6180橘子","110/08/31","聯邦-嘉義",4,0,4
"8368","6180橘子","110/08/31","永豐金-桃園",0,6,-6
"8369","6180橘子","110/08/31","元大-南屯",4,0,4
"8370","6180橘子","110/08/31","凱基-和平",0,5,-5
"8371","2390云辰","110/08/31","新光-台中",98,11,87
"8372","2390云辰","110/08/31","群益金鼎-敦南",2,56,-54
"8373","2390云辰","110/08/31","兆豐-公益",70,0,70
"8374","2390云辰","110/08/31","日盛-新莊",0,50,-50
"8375","2390云辰","110/08/31","凱基-竹北",67,0,67
"8376","2390云辰","110/08/31","永豐金-竹科",0,50,-50
"8377","2390云辰","110/08/31","華南永昌-麻豆",50,6,44
"8378","2390云辰","110/08/31","港商野村",50,99,-49
"8379","2390云辰","110/08/31","凱基-台北",61,23,38
"8380","2390云辰","110/08/31","兆豐-三民",0,35,-35
"8381","2390云辰","110/08/31","統一",41,5,36
"8382","2390云辰","110/08/31","高橋",1,33,-32
"8383","2390云辰","110/08/31","統一-新營",39,7,32
"8384","2390云辰","110/08/31","統一-屏東",0,30,-30
"8385","2390云辰","110/08/31","富邦-苗栗",22,0,22
"8386","2390云辰","110/08/31","台新-台南",0,25,-25
"8387","2390云辰","110/08/31","第一金-安和",20,0,20
"8388","2390云辰","110/08/31","元大-彰化",0,21,-21
"8389","2390云辰","110/08/31","富邦-羅東",26,6,20
"8390","2390云辰","110/08/31","臺銀-高雄",0,20,-20
"8391","2390云辰","110/08/31","統一-彰化",20,2,18
"8392","2390云辰","110/08/31","凱基-台中",0,20,-20
"8393","2390云辰","110/08/31","華南永昌-內壢",16,0,16
"8394","2390云辰","110/08/31","元大-南屯",6,25,-19
"8395","2390云辰","110/08/31","兆豐-台中",15,0,15
"8396","2390云辰","110/08/31","國泰-敦南",19,37,-18
"8397","2390云辰","110/08/31","元大-中壢",18,3,15
"8398","2390云辰","110/08/31","元大-土城學府",61,78,-17
"8399","2390云辰","110/08/31","台新-中壢",20,7,13
"8400","2390云辰","110/08/31","元大-雙和",4,20,-16
"8401","2834臺企銀","110/08/30","凱基-台北",5495,473,5022
"8402","2834臺企銀","110/08/30","新加坡商瑞銀",2178,10258,-8080
"8403","2834臺企銀","110/08/30","台灣摩根士丹利",4649,0,4649
"8404","2834臺企銀","110/08/30","美商高盛",1692,8522,-6830
"8405","2834臺企銀","110/08/30","美林",4408,656,3752
"8406","2834臺企銀","110/08/30","花旗環球",821,3248,-2427
"8407","2834臺企銀","110/08/30","瑞士信貸",5025,2357,2668
"8408","2834臺企銀","110/08/30","(牛牛牛)亞-鑫豐",66,1298,-1232
"8409","2834臺企銀","110/08/30","元富-虎尾",1361,1,1360
"8410","2834臺企銀","110/08/30","元富-城中",100,1008,-908
"8411","2834臺企銀","110/08/30","元大-草屯",681,126,555
"8412","2834臺企銀","110/08/30","台新-台中",50,668,-618
"8413","2834臺企銀","110/08/30","群益金鼎-彰化",527,0,527
"8414","2834臺企銀","110/08/30","第一金-嘉義",1,590,-589
"8415","2834臺企銀","110/08/30","華南永昌-東昇",500,5,495
"8416","2834臺企銀","110/08/30","中國信託-忠孝",6,550,-544
"8417","2834臺企銀","110/08/30","日盛-竹北",450,0,450
"8418","2834臺企銀","110/08/30","華南永昌-朴子",59,600,-541
"8419","2834臺企銀","110/08/30","華南永昌-虎尾",447,2,445
"8420","2834臺企銀","110/08/30","統一-板橋",154,644,-490
"8421","2834臺企銀","110/08/30","富邦-虎尾",409,5,404
"8422","2834臺企銀","110/08/30","台新-中壢",10,454,-444
"8423","2834臺企銀","110/08/30","元富-嘉義",410,7,403
"8424","2834臺企銀","110/08/30","永豐金證券",14,447,-433
"8425","2834臺企銀","110/08/30","富邦-板橋",427,31,396
"8426","2834臺企銀","110/08/30","元大-大里",14,445,-431
"8427","2834臺企銀","110/08/30","法銀巴黎",434,51,383
"8428","2834臺企銀","110/08/30","永豐金-萬盛",22,449,-427
"8429","2834臺企銀","110/08/30","元大-南海",345,11,334
"8430","2834臺企銀","110/08/30","元大-北投",12,435,-423
"8431","5511德昌","110/08/30","永豐金-市政",94,0,94
"8432","5511德昌","110/08/30","兆豐-台中港",0,50,-50
"8433","5511德昌","110/08/30","華南永昌-忠孝",14,0,14
"8434","5511德昌","110/08/30","致和-崇德",0,10,-10
"8435","5511德昌","110/08/30","元大-北屯",8,0,8
"8436","5511德昌","110/08/30","凱基-新豐",0,8,-8
"8437","5511德昌","110/08/30","永豐金-敦北",8,0,8
"8438","5511德昌","110/08/30","大昌-桃園",0,7,-7
"8439","5511德昌","110/08/30","第一金-台中",4,0,4
"8440","5511德昌","110/08/30","元大-大雅",0,7,-7
"8441","5511德昌","110/08/30","元大-斗信",3,0,3
"8442","5511德昌","110/08/30","富邦-虎尾",0,6,-6
"8443","5511德昌","110/08/30","凱基-台北",3,1,2
"8444","5511德昌","110/08/30","兆豐-北高雄",0,5,-5
"8445","5511德昌","110/08/30","富邦-台北",1,0,1
"8446","5511德昌","110/08/30","元大-鹿港",0,5,-5
"8447","5511德昌","110/08/30","康和-板橋",0,0,0
"8448","5511德昌","110/08/30","華南永昌-世貿",0,5,-5
"8449","5511德昌","110/08/30","康和-南崁",0,0,0
"8450","5511德昌","110/08/30","兆豐-大安",0,4,-4
"8451","5511德昌","110/08/30","新光-台南",0,0,0
"8452","5511德昌","110/08/30","兆豐-來福",0,3,-3
"8453","5511德昌","110/08/30","群益金鼎-鳳山",0,0,0
"8454","5511德昌","110/08/30","國泰-敦南",0,3,-3
"8455","5511德昌","110/08/30","華南永昌-公誠",0,0,0
"8456","5511德昌","110/08/30","玉山-雙和",0,2,-2
"8457","5511德昌","110/08/30","",NA,NA,NA
"8458","5511德昌","110/08/30","玉山-大里",0,2,-2
"8459","5511德昌","110/08/30","",NA,NA,NA
"8460","5511德昌","110/08/30","(牛牛牛)亞-鑫豐",0,2,-2
"8461","2489瑞軒","110/08/30","康和-台中",185,0,185
"8462","2489瑞軒","110/08/30","富邦-仁愛",0,117,-117
"8463","2489瑞軒","110/08/30","瑞士信貸",133,0,133
"8464","2489瑞軒","110/08/30","凱基-五股",0,100,-100
"8465","2489瑞軒","110/08/30","新加坡商瑞銀",77,5,72
"8466","2489瑞軒","110/08/30","康和-石牌",5,100,-95
"8467","2489瑞軒","110/08/30","凱基-台北",78,17,61
"8468","2489瑞軒","110/08/30","日盛-木柵",0,35,-35
"8469","2489瑞軒","110/08/30","美林",66,18,48
"8470","2489瑞軒","110/08/30","第一金-新興",0,30,-30
"8471","2489瑞軒","110/08/30","元富-三重",40,0,40
"8472","2489瑞軒","110/08/30","富邦-新竹",6,32,-26
"8473","2489瑞軒","110/08/30","新光",35,7,28
"8474","2489瑞軒","110/08/30","群益金鼎",0,25,-25
"8475","2489瑞軒","110/08/30","元大-彰化",25,0,25
"8476","2489瑞軒","110/08/30","國泰-敦南",4,27,-23
"8477","2489瑞軒","110/08/30","元大-員林中山",25,0,25
"8478","2489瑞軒","110/08/30","富隆證券",0,20,-20
"8479","2489瑞軒","110/08/30","元大-松江",23,0,23
"8480","2489瑞軒","110/08/30","康和-嘉義",20,40,-20
"8481","2489瑞軒","110/08/30","永豐金-大園",21,0,21
"8482","2489瑞軒","110/08/30","凱基-中港",0,20,-20
"8483","2489瑞軒","110/08/30","大慶-富順",20,0,20
"8484","2489瑞軒","110/08/30","凱基-彰化",0,20,-20
"8485","2489瑞軒","110/08/30","統一-嘉義",20,0,20
"8486","2489瑞軒","110/08/30","元大-東蘆",0,20,-20
"8487","2489瑞軒","110/08/30","元大-汐止",20,0,20
"8488","2489瑞軒","110/08/30","第一金-華江",0,17,-17
"8489","2489瑞軒","110/08/30","元大-樹林",20,0,20
"8490","2489瑞軒","110/08/30","元大-板橋",0,16,-16
"8491","2428興勤","110/08/30","富邦-高雄",31,0,31
"8492","2428興勤","110/08/30","美林",0,26,-26
"8493","2428興勤","110/08/30","元大-南京",16,0,16
"8494","2428興勤","110/08/30","港商野村",2,28,-26
"8495","2428興勤","110/08/30","永興",15,0,15
"8496","2428興勤","110/08/30","台灣摩根士丹利",2,18,-16
"8497","2428興勤","110/08/30","凱基-鳳山",10,0,10
"8498","2428興勤","110/08/30","摩根大通",0,13,-13
"8499","2428興勤","110/08/30","凱基-中山",10,1,9
"8500","2428興勤","110/08/30","元大-八德",0,10,-10
"8501","2428興勤","110/08/30","群益金鼎-屏東",9,1,8
"8502","2428興勤","110/08/30","元大-西門",0,10,-10
"8503","2428興勤","110/08/30","元富-台中",7,1,6
"8504","2428興勤","110/08/30","永豐金證券",1,10,-9
"8505","2428興勤","110/08/30","中國信託",5,0,5
"8506","2428興勤","110/08/30","日盛-竹北",2,10,-8
"8507","2428興勤","110/08/30","兆豐-忠孝",5,0,5
"8508","2428興勤","110/08/30","美商高盛",1,9,-8
"8509","2428興勤","110/08/30","群益金鼎-鳳山",4,0,4
"8510","2428興勤","110/08/30","元大證券",2,9,-7
"8511","2428興勤","110/08/30","元大-敦南",4,0,4
"8512","2428興勤","110/08/30","日盛-中壢",0,6,-6
"8513","2428興勤","110/08/30","永豐金-信義",4,0,4
"8514","2428興勤","110/08/30","統一",0,5,-5
"8515","2428興勤","110/08/30","元富-大昌",3,0,3
"8516","2428興勤","110/08/30","華南永昌",0,4,-4
"8517","2428興勤","110/08/30","(牛牛牛)亞-鑫豐",3,0,3
"8518","2428興勤","110/08/30","元大-大甲",0,3,-3
"8519","2428興勤","110/08/30","富邦-新竹",3,0,3
"8520","2428興勤","110/08/30","日盛-新莊",0,2,-2
"8521","3176基亞","110/08/30","群益金鼎-潭子",31,0,31
"8522","3176基亞","110/08/30","富邦-台北",0,76,-76
"8523","3176基亞","110/08/30","群益金鼎-板橋",20,0,20
"8524","3176基亞","110/08/30","兆豐-三民",0,20,-20
"8525","3176基亞","110/08/30","國泰-敦南",16,1,15
"8526","3176基亞","110/08/30","新加坡商瑞銀",0,13,-13
"8527","3176基亞","110/08/30","永豐金證券",15,0,15
"8528","3176基亞","110/08/30","元富-佳里",0,13,-13
"8529","3176基亞","110/08/30","日盛-桃園",13,0,13
"8530","3176基亞","110/08/30","國泰-板橋",1,14,-13
"8531","3176基亞","110/08/30","國票-北高雄",10,0,10
"8532","3176基亞","110/08/30","元富-桃園",1,12,-11
"8533","3176基亞","110/08/30","華南永昌",10,0,10
"8534","3176基亞","110/08/30","富邦-中壢",0,10,-10
"8535","3176基亞","110/08/30","華南永昌-林口",10,0,10
"8536","3176基亞","110/08/30","富邦-建國",0,10,-10
"8537","3176基亞","110/08/30","富邦-新竹",8,0,8
"8538","3176基亞","110/08/30","元大-楊梅",0,9,-9
"8539","3176基亞","110/08/30","日盛-台南",6,0,6
"8540","3176基亞","110/08/30","臺銀-新竹",0,8,-8
"8541","3176基亞","110/08/30","元富-新店",5,0,5
"8542","3176基亞","110/08/30","玉山-台中",1,8,-7
"8543","3176基亞","110/08/30","兆豐-內湖",5,0,5
"8544","3176基亞","110/08/30","華南永昌-嘉義",0,7,-7
"8545","3176基亞","110/08/30","富邦-花蓮",5,0,5
"8546","3176基亞","110/08/30","元大-南屯",0,7,-7
"8547","3176基亞","110/08/30","元大-豐原",5,0,5
"8548","3176基亞","110/08/30","新光-台南",0,6,-6
"8549","3176基亞","110/08/30","元大-基隆",5,0,5
"8550","3176基亞","110/08/30","元富-大裕",0,5,-5
"8551","2409友達","110/08/30","合庫證券",2480,104,2376
"8552","2409友達","110/08/30","台灣摩根士丹利",1303,13111,-11808
"8553","2409友達","110/08/30","康和",2143,416,1727
"8554","2409友達","110/08/30","美商高盛",946,5209,-4263
"8555","2409友達","110/08/30","瑞士信貸",1713,21,1692
"8556","2409友達","110/08/30","凱基",53,2000,-1947
"8557","2409友達","110/08/30","凱基-員林",1609,4,1605
"8558","2409友達","110/08/30","元富",19,1780,-1761
"8559","2409友達","110/08/30","凱基-東港",1921,570,1351
"8560","2409友達","110/08/30","港商野村",1462,2550,-1088
"8561","2409友達","110/08/30","兆豐證券",1176,17,1159
"8562","2409友達","110/08/30","摩根大通",4521,5376,-855
"8563","2409友達","110/08/30","元大-豐原",1819,949,870
"8564","2409友達","110/08/30","華南永昌-鶯歌",129,957,-828
"8565","2409友達","110/08/30","永豐金證券",1409,547,862
"8566","2409友達","110/08/30","新加坡商瑞銀",185,989,-804
"8567","2409友達","110/08/30","法銀巴黎",837,225,612
"8568","2409友達","110/08/30","中國信託",142,867,-725
"8569","2409友達","110/08/30","大昌-樹林",608,2,606
"8570","2409友達","110/08/30","日盛-永康",209,836,-627
"8571","2409友達","110/08/30","華南永昌-南京",1958,1399,559
"8572","2409友達","110/08/30","玉山-高雄",90,597,-507
"8573","2409友達","110/08/30","群益金鼎",425,9,416
"8574","2409友達","110/08/30","永豐金-板橋",7,482,-475
"8575","2409友達","110/08/30","台灣企銀-北高雄",403,0,403
"8576","2409友達","110/08/30","花旗環球",121,591,-470
"8577","2409友達","110/08/30","台灣匯立證券",546,153,393
"8578","2409友達","110/08/30","元大證券",1282,1608,-326
"8579","2409友達","110/08/30","元富-安南",661,320,341
"8580","2409友達","110/08/30","富邦-中壢",111,354,-243
"8581","1315達新","110/08/30","凱基-中港",17,0,17
"8582","1315達新","110/08/30","香港上海匯豐",0,46,-46
"8583","1315達新","110/08/30","凱基-板橋",15,0,15
"8584","1315達新","110/08/30","元富-板橋",0,21,-21
"8585","1315達新","110/08/30","統一-城中",10,0,10
"8586","1315達新","110/08/30","元大-文心興安",0,19,-19
"8587","1315達新","110/08/30","豐農",9,0,9
"8588","1315達新","110/08/30","台灣企銀-民雄",0,10,-10
"8589","1315達新","110/08/30","美林",17,10,7
"8590","1315達新","110/08/30","群益金鼎-桃園",2,10,-8
"8591","1315達新","110/08/30","美商高盛",9,2,7
"8592","1315達新","110/08/30","元大-四維",0,5,-5
"8593","1315達新","110/08/30","凱基-台北",7,0,7
"8594","1315達新","110/08/30","華南永昌-彰化",0,4,-4
"8595","1315達新","110/08/30","凱基-岡山",6,0,6
"8596","1315達新","110/08/30","台灣企銀-台中",0,3,-3
"8597","1315達新","110/08/30","華南永昌-台中",5,0,5
"8598","1315達新","110/08/30","新光",0,3,-3
"8599","1315達新","110/08/30","富邦-台北",5,0,5
"8600","1315達新","110/08/30","日盛-樹林",0,2,-2
"8601","1315達新","110/08/30","日盛-二林",3,0,3
"8602","1315達新","110/08/30","元大-雙和",0,2,-2
"8603","1315達新","110/08/30","日盛-和美",3,0,3
"8604","1315達新","110/08/30","元大-桃園",0,2,-2
"8605","1315達新","110/08/30","台新證券",3,0,3
"8606","1315達新","110/08/30","永豐金-中盛",0,2,-2
"8607","1315達新","110/08/30","國泰-敦南",4,1,3
"8608","1315達新","110/08/30","合庫-彰化",0,1,-1
"8609","1315達新","110/08/30","台灣摩根士丹利",2,0,2
"8610","1315達新","110/08/30","合庫-鳳山",0,1,-1
"8611","2609陽明","110/08/30","摩根大通",2955,864,2091
"8612","2609陽明","110/08/30","富邦證券",946,2220,-1274
"8613","2609陽明","110/08/30","凱基-台北",2436,1058,1378
"8614","2609陽明","110/08/30","凱基-斗六",1,1007,-1006
"8615","2609陽明","110/08/30","新加坡商瑞銀",771,0,771
"8616","2609陽明","110/08/30","統一-士林",128,996,-868
"8617","2609陽明","110/08/30","兆豐-虎尾",822,67,755
"8618","2609陽明","110/08/30","永豐金-虎尾",774,1318,-544
"8619","2609陽明","110/08/30","華南永昌-竹北",805,178,627
"8620","2609陽明","110/08/30","宏遠證券",344,864,-520
"8621","2609陽明","110/08/30","美林",1702,1259,443
"8622","2609陽明","110/08/30","台灣摩根士丹利",198,638,-440
"8623","2609陽明","110/08/30","元大證券",755,478,277
"8624","2609陽明","110/08/30","元大-內湖",48,467,-419
"8625","2609陽明","110/08/30","兆豐-板橋",382,108,274
"8626","2609陽明","110/08/30","凱基-城中",48,415,-367
"8627","2609陽明","110/08/30","凱基-桃園",394,129,265
"8628","2609陽明","110/08/30","致和-台北",0,360,-360
"8629","2609陽明","110/08/30","美商高盛",399,146,253
"8630","2609陽明","110/08/30","群益金鼎-大安",40,351,-311
"8631","2609陽明","110/08/30","華南永昌-三重",454,213,241
"8632","2609陽明","110/08/30","兆豐-復興",21,324,-303
"8633","2609陽明","110/08/30","兆豐-寶成",281,69,212
"8634","2609陽明","110/08/30","日盛-復興",41,271,-230
"8635","2609陽明","110/08/30","日盛證券",427,228,199
"8636","2609陽明","110/08/30","元大-彰化民生",29,224,-195
"8637","2609陽明","110/08/30","玉山-嘉義",235,39,196
"8638","2609陽明","110/08/30","群益金鼎",284,467,-183
"8639","2609陽明","110/08/30","國票-台中",578,391,187
"8640","2609陽明","110/08/30","統一-三多",24,198,-174
"8641","2636台驊投控","110/08/30","華南永昌-竹北",399,1,398
"8642","2636台驊投控","110/08/30","港商野村",279,397,-118
"8643","2636台驊投控","110/08/30","日盛-台中",232,5,227
"8644","2636台驊投控","110/08/30","摩根大通",72,183,-111
"8645","2636台驊投控","110/08/30","新光-新竹",231,12,219
"8646","2636台驊投控","110/08/30","元富-大昌",14,70,-56
"8647","2636台驊投控","110/08/30","瑞士信貸",227,30,197
"8648","2636台驊投控","110/08/30","元大-北屯",0,51,-51
"8649","2636台驊投控","110/08/30","兆豐-中壢",141,0,141
"8650","2636台驊投控","110/08/30","永豐金-嘉義",1,52,-51
"8651","2636台驊投控","110/08/30","富邦-虎尾",186,86,100
"8652","2636台驊投控","110/08/30","統一-中壢",0,41,-41
"8653","2636台驊投控","110/08/30","台灣摩根士丹利",166,78,88
"8654","2636台驊投控","110/08/30","國泰-敦南",66,97,-31
"8655","2636台驊投控","110/08/30","兆豐-斗南",87,0,87
"8656","2636台驊投控","110/08/30","美商高盛",62,91,-29
"8657","2636台驊投控","110/08/30","元大-南京",50,6,44
"8658","2636台驊投控","110/08/30","新光",30,59,-29
"8659","2636台驊投控","110/08/30","新加坡商瑞銀",69,30,39
"8660","2636台驊投控","110/08/30","新光-台中",6,31,-25
"8661","2636台驊投控","110/08/30","宏遠-館前",39,1,38
"8662","2636台驊投控","110/08/30","台新-三民",0,23,-23
"8663","2636台驊投控","110/08/30","凱基-中山",34,2,32
"8664","2636台驊投控","110/08/30","凱基-台南",10,32,-22
"8665","2636台驊投控","110/08/30","台新-台南",33,4,29
"8666","2636台驊投控","110/08/30","元大-大雅",1,23,-22
"8667","2636台驊投控","110/08/30","凱基-台北",229,200,29
"8668","2636台驊投控","110/08/30","高橋-內壢",1,22,-21
"8669","2636台驊投控","110/08/30","台中銀-台北",27,0,27
"8670","2636台驊投控","110/08/30","康和-高雄",2,23,-21
"8671","2867三商壽","110/08/30","美林",736,19,717
"8672","2867三商壽","110/08/30","元富-佳里",0,541,-541
"8673","2867三商壽","110/08/30","元富-民權",450,0,450
"8674","2867三商壽","110/08/30","永豐金-埔里",2,331,-329
"8675","2867三商壽","110/08/30","華南永昌-大安",352,0,352
"8676","2867三商壽","110/08/30","華南永昌-高雄",1,202,-201
"8677","2867三商壽","110/08/30","元富-新興",304,4,300
"8678","2867三商壽","110/08/30","富邦-桃園",0,135,-135
"8679","2867三商壽","110/08/30","兆豐-北高雄",280,5,275
"8680","2867三商壽","110/08/30","華南永昌-虎尾",0,132,-132
"8681","2867三商壽","110/08/30","摩根大通",257,18,239
"8682","2867三商壽","110/08/30","玉山-台中",2,132,-130
"8683","2867三商壽","110/08/30","新加坡商瑞銀",231,0,231
"8684","2867三商壽","110/08/30","國泰證券",0,120,-120
"8685","2867三商壽","110/08/30","群益金鼎-土城",218,5,213
"8686","2867三商壽","110/08/30","永豐金-中盛",5,123,-118
"8687","2867三商壽","110/08/30","永豐金-豐原",200,0,200
"8688","2867三商壽","110/08/30","元富-潮州",0,115,-115
"8689","2867三商壽","110/08/30","臺銀",190,2,188
"8690","2867三商壽","110/08/30","群益金鼎-東門",0,114,-114
"8691","2867三商壽","110/08/30","國泰-台中",308,148,160
"8692","2867三商壽","110/08/30","台新-台中",0,112,-112
"8693","2867三商壽","110/08/30","富邦-新店",150,0,150
"8694","2867三商壽","110/08/30","國泰-板橋",1,106,-105
"8695","2867三商壽","110/08/30","群益金鼎-北高雄",130,18,112
"8696","2867三商壽","110/08/30","元大-沙鹿",21,111,-90
"8697","2867三商壽","110/08/30","美商高盛",173,68,105
"8698","2867三商壽","110/08/30","新光-台中",90,174,-84
"8699","2867三商壽","110/08/30","聯邦-富強",100,0,100
"8700","2867三商壽","110/08/30","台新-高雄",7,86,-79
"8701","5521工信","110/08/30","摩根大通",397,0,397
"8702","5521工信","110/08/30","康和-高雄",0,200,-200
"8703","5521工信","110/08/30","元富",358,0,358
"8704","5521工信","110/08/30","香港上海匯豐",0,113,-113
"8705","5521工信","110/08/30","凱基-台北",208,23,185
"8706","5521工信","110/08/30","華南永昌-民權",0,100,-100
"8707","5521工信","110/08/30","美商高盛",181,9,172
"8708","5521工信","110/08/30","元富-新店",2,80,-78
"8709","5521工信","110/08/30","台灣摩根士丹利",160,19,141
"8710","5521工信","110/08/30","國泰-敦南",14,87,-73
"8711","5521工信","110/08/30","華南永昌",94,1,93
"8712","5521工信","110/08/30","兆豐-忠孝",0,67,-67
"8713","5521工信","110/08/30","美林",92,3,89
"8714","5521工信","110/08/30","國票-和平",0,66,-66
"8715","5521工信","110/08/30","華南永昌-中正",55,0,55
"8716","5521工信","110/08/30","元大-新莊",0,66,-66
"8717","5521工信","110/08/30","富邦-台北",50,3,47
"8718","5521工信","110/08/30","日盛-忠孝",0,50,-50
"8719","5521工信","110/08/30","兆豐-西螺",20,0,20
"8720","5521工信","110/08/30","新光-高雄",1,31,-30
"8721","5521工信","110/08/30","國票",20,0,20
"8722","5521工信","110/08/30","玉山-雙和",0,30,-30
"8723","5521工信","110/08/30","富邦-羅東",20,0,20
"8724","5521工信","110/08/30","(牛牛牛)亞-鑫豐",5,33,-28
"8725","5521工信","110/08/30","元大-北成功",20,0,20
"8726","5521工信","110/08/30","元富-文心",12,39,-27
"8727","5521工信","110/08/30","國泰-板橋",31,12,19
"8728","5521工信","110/08/30","群益金鼎-丹鳳",0,26,-26
"8729","5521工信","110/08/30","新百王",18,0,18
"8730","5521工信","110/08/30","日盛-高雄",0,24,-24
"8731","1471首利","110/08/30","元大-虎尾",27,0,27
"8732","1471首利","110/08/30","群益金鼎-東大",0,49,-49
"8733","1471首利","110/08/30","凱基-科園",23,0,23
"8734","1471首利","110/08/30","元大-斗信",0,24,-24
"8735","1471首利","110/08/30","新光",15,0,15
"8736","1471首利","110/08/30","臺銀-臺中",0,20,-20
"8737","1471首利","110/08/30","永豐金-三重",11,0,11
"8738","1471首利","110/08/30","美林",0,18,-18
"8739","1471首利","110/08/30","日盛-屏東",10,0,10
"8740","1471首利","110/08/30","凱基-松山",0,12,-12
"8741","1471首利","110/08/30","台新-松江",10,0,10
"8742","1471首利","110/08/30","元富-埔里",0,10,-10
"8743","1471首利","110/08/30","合庫-台中",7,0,7
"8744","1471首利","110/08/30","永豐金-敦北",0,10,-10
"8745","1471首利","110/08/30","日盛-八德",7,0,7
"8746","1471首利","110/08/30","臺銀-鳳山",0,5,-5
"8747","1471首利","110/08/30","日盛-高雄",15,9,6
"8748","1471首利","110/08/30","統一-屏東",0,5,-5
"8749","1471首利","110/08/30","(牛牛牛)亞-鑫豐",6,0,6
"8750","1471首利","110/08/30","元富-烏日",0,5,-5
"8751","1471首利","110/08/30","富邦-仁愛",6,0,6
"8752","1471首利","110/08/30","玉山-桃園",0,5,-5
"8753","1471首利","110/08/30","統一-台南",5,0,5
"8754","1471首利","110/08/30","凱基-三重",0,5,-5
"8755","1471首利","110/08/30","國泰-敦南",6,1,5
"8756","1471首利","110/08/30","凱基-板橋",0,5,-5
"8757","1471首利","110/08/30","凱基-高雄",5,0,5
"8758","1471首利","110/08/30","富邦-高雄",0,5,-5
"8759","1471首利","110/08/30","凱基-城中",5,0,5
"8760","1471首利","110/08/30","元大-左營",0,5,-5
"8761","2883開發金","110/08/30","國票-南京",3819,33,3786
"8762","2883開發金","110/08/30","兆豐證券",21,5003,-4982
"8763","2883開發金","110/08/30","凱基-台北",6596,2919,3677
"8764","2883開發金","110/08/30","第一金-忠孝",48,3082,-3034
"8765","2883開發金","110/08/30","美林",3606,23,3583
"8766","2883開發金","110/08/30","新光",496,1843,-1347
"8767","2883開發金","110/08/30","永豐金證券",3376,93,3283
"8768","2883開發金","110/08/30","玉山-大里",84,1010,-926
"8769","2883開發金","110/08/30","美商高盛",2717,599,2118
"8770","2883開發金","110/08/30","台中銀-員林",10,795,-785
"8771","2883開發金","110/08/30","國票-長城",2056,18,2038
"8772","2883開發金","110/08/30","玉山-高雄",150,860,-710
"8773","2883開發金","110/08/30","臺銀-新竹",2933,1133,1800
"8774","2883開發金","110/08/30","港商麥格理",0,676,-676
"8775","2883開發金","110/08/30","統一",1871,181,1690
"8776","2883開發金","110/08/30","元大-民雄",42,709,-667
"8777","2883開發金","110/08/30","富邦-建國",1672,182,1490
"8778","2883開發金","110/08/30","兆豐-來福",40,678,-638
"8779","2883開發金","110/08/30","永豐金-板橋",1302,2,1300
"8780","2883開發金","110/08/30","華南永昌-中正",145,649,-504
"8781","2883開發金","110/08/30","宏遠證券",1170,44,1126
"8782","2883開發金","110/08/30","凱基-三重",40,540,-500
"8783","2883開發金","110/08/30","法銀巴黎",1059,10,1049
"8784","2883開發金","110/08/30","國泰-台中",154,606,-452
"8785","2883開發金","110/08/30","華南永昌",1089,115,974
"8786","2883開發金","110/08/30","玉山-新竹",18,427,-409
"8787","2883開發金","110/08/30","瑞士信貸",1162,231,931
"8788","2883開發金","110/08/30","國票-安和",14,399,-385
"8789","2883開發金","110/08/30","兆豐-三民",901,14,887
"8790","2883開發金","110/08/30","凱基-站前",80,462,-382
"8791","6205詮欣","110/08/30","台中銀",7,0,7
"8792","6205詮欣","110/08/30","永豐金-敦南",0,5,-5
"8793","6205詮欣","110/08/30","臺銀-臺中",5,0,5
"8794","6205詮欣","110/08/30","第一金-路竹",0,5,-5
"8795","6205詮欣","110/08/30","台新證券",3,0,3
"8796","6205詮欣","110/08/30","元大-屏東",0,3,-3
"8797","6205詮欣","110/08/30","臺銀-民權",2,0,2
"8798","6205詮欣","110/08/30","華南永昌-朴子",0,3,-3
"8799","6205詮欣","110/08/30","光和",2,0,2
"8800","6205詮欣","110/08/30","永豐金證券",0,2,-2
"8801","6205詮欣","110/08/30","元大-豐原站前",1,0,1
"8802","6205詮欣","110/08/30","凱基-中壢",0,1,-1
"8803","6205詮欣","110/08/30","元大-館前",1,0,1
"8804","6205詮欣","110/08/30","元大-開元",0,1,-1
"8805","6205詮欣","110/08/30","元大-松山",1,0,1
"8806","6205詮欣","110/08/30","日盛-台南",0,1,-1
"8807","6205詮欣","110/08/30","大昌-樹林",1,0,1
"8808","6205詮欣","110/08/30","凱基-永康",0,1,-1
"8809","6205詮欣","110/08/30","元富-潮州",1,0,1
"8810","6205詮欣","110/08/30","國票-博愛",0,1,-1
"8811","6205詮欣","110/08/30","美林",1,0,1
"8812","6205詮欣","110/08/30","元富-文心",0,1,-1
"8813","6205詮欣","110/08/30","日盛-新莊",1,0,1
"8814","6205詮欣","110/08/30","統一-松江",0,1,-1
"8815","6205詮欣","110/08/30","兆豐-永和",0,0,0
"8816","6205詮欣","110/08/30","大慶-台南",0,1,-1
"8817","6205詮欣","110/08/30","群益金鼎-台中",0,0,0
"8818","6205詮欣","110/08/30","群益金鼎-台中",0,0,0
"8819","6205詮欣","110/08/30","富邦-台北",0,0,0
"8820","6205詮欣","110/08/30","富邦-台北",0,0,0
"8821","1540喬福","110/08/30","玉山-大里",14,0,14
"8822","1540喬福","110/08/30","凱基-興隆",0,12,-12
"8823","1540喬福","110/08/30","華南永昌-公誠",10,0,10
"8824","1540喬福","110/08/30","國票-中正",0,5,-5
"8825","1540喬福","110/08/30","元大-龍潭",6,0,6
"8826","1540喬福","110/08/30","玉山-板橋",0,5,-5
"8827","1540喬福","110/08/30","國票-台南",5,0,5
"8828","1540喬福","110/08/30","玉山-左營",0,5,-5
"8829","1540喬福","110/08/30","凱基-中壢",3,0,3
"8830","1540喬福","110/08/30","玉山-數位",0,4,-4
"8831","1540喬福","110/08/30","兆豐-內湖",2,0,2
"8832","1540喬福","110/08/30","元大-大安",0,4,-4
"8833","1540喬福","110/08/30","元大-土城永寧",2,0,2
"8834","1540喬福","110/08/30","台新-台中",0,3,-3
"8835","1540喬福","110/08/30","合庫證券",1,0,1
"8836","1540喬福","110/08/30","國泰-敦南",0,3,-3
"8837","1540喬福","110/08/30","日盛-士林",1,0,1
"8838","1540喬福","110/08/30","元富-緯城",0,2,-2
"8839","1540喬福","110/08/30","台灣摩根士丹利",1,0,1
"8840","1540喬福","110/08/30","富邦-仁愛",0,2,-2
"8841","1540喬福","110/08/30","元富",2,1,1
"8842","1540喬福","110/08/30","第一金-員林",0,1,-1
"8843","1540喬福","110/08/30","兆豐-鹿港",1,0,1
"8844","1540喬福","110/08/30","統一-三多",0,1,-1
"8845","1540喬福","110/08/30","凱基-內埔",1,0,1
"8846","1540喬福","110/08/30","元富-虎尾",0,1,-1
"8847","1540喬福","110/08/30","元大-頭份",1,0,1
"8848","1540喬福","110/08/30","致和-南京",0,1,-1
"8849","1540喬福","110/08/30","元大-楊梅",1,0,1
"8850","1540喬福","110/08/30","元大-竹東",0,1,-1
"8851","2888新光金","110/08/30","元大證券",28738,3652,25086
"8852","2888新光金","110/08/30","元富-城東",123,7579,-7456
"8853","2888新光金","110/08/30","美林",6052,562,5490
"8854","2888新光金","110/08/30","永豐金證券",69,4239,-4170
"8855","2888新光金","110/08/30","臺銀-高雄",4494,65,4429
"8856","2888新光金","110/08/30","國票-長城",61,2957,-2896
"8857","2888新光金","110/08/30","美商高盛",4381,1190,3191
"8858","2888新光金","110/08/30","凱基-大里",92,2505,-2413
"8859","2888新光金","110/08/30","台灣摩根士丹利",5027,2870,2157
"8860","2888新光金","110/08/30","華南永昌-台中",43,2049,-2006
"8861","2888新光金","110/08/30","元大-館前",2282,149,2133
"8862","2888新光金","110/08/30","合庫證券",155,2038,-1883
"8863","2888新光金","110/08/30","亞東-新竹",2698,591,2107
"8864","2888新光金","110/08/30","凱基-台北",5304,7027,-1723
"8865","2888新光金","110/08/30","群益金鼎",2082,41,2041
"8866","2888新光金","110/08/30","新光",1799,3317,-1518
"8867","2888新光金","110/08/30","永豐金-中正",2140,106,2034
"8868","2888新光金","110/08/30","兆豐-西螺",167,1632,-1465
"8869","2888新光金","110/08/30","永全-南崁",1904,5,1899
"8870","2888新光金","110/08/30","華南永昌-大安",20,1454,-1434
"8871","2888新光金","110/08/30","元富-草屯",2009,229,1780
"8872","2888新光金","110/08/30","元富-文心",113,1427,-1314
"8873","2888新光金","110/08/30","台新-三民",2093,316,1777
"8874","2888新光金","110/08/30","富邦-中壢",272,1481,-1209
"8875","2888新光金","110/08/30","國泰-台南",2057,285,1772
"8876","2888新光金","110/08/30","元富-世貿",225,1314,-1089
"8877","2888新光金","110/08/30","新加坡商瑞銀",3676,2205,1471
"8878","2888新光金","110/08/30","宏遠-桃園",17,1089,-1072
"8879","2888新光金","110/08/30","法銀巴黎",1141,9,1132
"8880","2888新光金","110/08/30","元富-板橋",154,1212,-1058
"8881","1340勝悅","110/08/30","群益金鼎-三重",10,0,10
"8882","1340勝悅","110/08/30","元大-新盛",0,22,-22
"8883","1340勝悅","110/08/30","美林",8,0,8
"8884","1340勝悅","110/08/30","台灣企銀-民雄",0,8,-8
"8885","1340勝悅","110/08/30","臺灣企銀-埔墘",5,0,5
"8886","1340勝悅","110/08/30","台中銀",0,7,-7
"8887","1340勝悅","110/08/30","國泰-敦南",6,3,3
"8888","1340勝悅","110/08/30","日盛-鳳山",0,5,-5
"8889","1340勝悅","110/08/30","華南永昌-南京",3,0,3
"8890","1340勝悅","110/08/30","摩根大通",0,5,-5
"8891","1340勝悅","110/08/30","元大-屏南",3,0,3
"8892","1340勝悅","110/08/30","凱基-台北",2,7,-5
"8893","1340勝悅","110/08/30","日盛-中和",2,0,2
"8894","1340勝悅","110/08/30","日盛-員林",0,3,-3
"8895","1340勝悅","110/08/30","大慶-泰山",2,0,2
"8896","1340勝悅","110/08/30","元大-林園",0,3,-3
"8897","1340勝悅","110/08/30","第一金-華江",3,1,2
"8898","1340勝悅","110/08/30","合庫-自強",0,2,-2
"8899","1340勝悅","110/08/30","兆豐-三重",2,0,2
"8900","1340勝悅","110/08/30","美商高盛",0,2,-2
"8901","1340勝悅","110/08/30","國票-台南",2,0,2
"8902","1340勝悅","110/08/30","台新-高雄",1,3,-2
"8903","1340勝悅","110/08/30","國票-台中",2,0,2
"8904","1340勝悅","110/08/30","永豐金-信義",0,2,-2
"8905","1340勝悅","110/08/30","玉山-左營",2,0,2
"8906","1340勝悅","110/08/30","日盛-樹林",0,1,-1
"8907","1340勝悅","110/08/30","元大-歸仁",2,0,2
"8908","1340勝悅","110/08/30","台新-台南",0,1,-1
"8909","1340勝悅","110/08/30","群益金鼎-館前",1,0,1
"8910","1340勝悅","110/08/30","永豐金-中正",0,1,-1
"8911","6246臺龍","110/08/30","群益金鼎-古亭",11,1,10
"8912","6246臺龍","110/08/30","群益金鼎-東大",0,30,-30
"8913","6246臺龍","110/08/30","台新證券",10,1,9
"8914","6246臺龍","110/08/30","聯邦-大業",0,10,-10
"8915","6246臺龍","110/08/30","富邦-新竹",4,0,4
"8916","6246臺龍","110/08/30","台新-高雄",0,6,-6
"8917","6246臺龍","110/08/30","元大-館前",4,0,4
"8918","6246臺龍","110/08/30","玉山-新莊",0,3,-3
"8919","6246臺龍","110/08/30","港商野村",3,0,3
"8920","6246臺龍","110/08/30","元大-北港",2,5,-3
"8921","6246臺龍","110/08/30","永豐金-桃園",3,0,3
"8922","6246臺龍","110/08/30","第一金-彰化",0,2,-2
"8923","6246臺龍","110/08/30","福勝",2,0,2
"8924","6246臺龍","110/08/30","國泰-板橋",0,2,-2
"8925","6246臺龍","110/08/30","玉山證券",2,0,2
"8926","6246臺龍","110/08/30","元大-竹山",0,2,-2
"8927","6246臺龍","110/08/30","凱基-板橋",2,0,2
"8928","6246臺龍","110/08/30","日盛-宜蘭",0,1,-1
"8929","6246臺龍","110/08/30","凱基-高美館",2,0,2
"8930","6246臺龍","110/08/30","台新-台南",0,1,-1
"8931","6246臺龍","110/08/30","元大-新盛",2,0,2
"8932","6246臺龍","110/08/30","國泰-台中",0,1,-1
"8933","6246臺龍","110/08/30","元大-大天母",2,0,2
"8934","6246臺龍","110/08/30","元大-鑫永和",0,1,-1
"8935","6246臺龍","110/08/30","元大-內湖",2,0,2
"8936","6246臺龍","110/08/30","元大-大同",0,1,-1
"8937","6246臺龍","110/08/30","永豐金-鳳山",2,0,2
"8938","6246臺龍","110/08/30","元大-古亭",0,1,-1
"8939","6246臺龍","110/08/30","合庫-三重",1,0,1
"8940","6246臺龍","110/08/30","統一-南京",0,0,0
"8941","00715L期街口布蘭特正2","110/08/30","元大證券",14770,43,14727
"8942","00715L期街口布蘭特正2","110/08/30","元大-萬華",0,911,-911
"8943","00715L期街口布蘭特正2","110/08/30","國票",3922,0,3922
"8944","00715L期街口布蘭特正2","110/08/30","兆豐-嘉義",20,754,-734
"8945","00715L期街口布蘭特正2","110/08/30","群益金鼎",1953,405,1548
"8946","00715L期街口布蘭特正2","110/08/30","富邦-台東",0,613,-613
"8947","00715L期街口布蘭特正2","110/08/30","永豐金-內湖",1500,17,1483
"8948","00715L期街口布蘭特正2","110/08/30","元大-嘉義",21,608,-587
"8949","00715L期街口布蘭特正2","110/08/30","永豐金證券",1565,335,1230
"8950","00715L期街口布蘭特正2","110/08/30","港商野村",511,1090,-579
"8951","00715L期街口布蘭特正2","110/08/30","國票-博愛",1155,0,1155
"8952","00715L期街口布蘭特正2","110/08/30","日盛-新莊",210,775,-565
"8953","00715L期街口布蘭特正2","110/08/30","康和",1007,0,1007
"8954","00715L期街口布蘭特正2","110/08/30","日盛-員林",0,540,-540
"8955","00715L期街口布蘭特正2","110/08/30","統一",952,1,951
"8956","00715L期街口布蘭特正2","110/08/30","凱基-屏東",5,543,-538
"8957","00715L期街口布蘭特正2","110/08/30","合庫證券",943,5,938
"8958","00715L期街口布蘭特正2","110/08/30","富邦-陽明",0,509,-509
"8959","00715L期街口布蘭特正2","110/08/30","富邦證券",2782,2251,531
"8960","00715L期街口布蘭特正2","110/08/30","玉山-嘉義",4,512,-508
"8961","00715L期街口布蘭特正2","110/08/30","兆豐-台中",500,0,500
"8962","00715L期街口布蘭特正2","110/08/30","元大-前金",2,506,-504
"8963","00715L期街口布蘭特正2","110/08/30","國票-中港",500,0,500
"8964","00715L期街口布蘭特正2","110/08/30","兆豐-台中港",0,463,-463
"8965","00715L期街口布蘭特正2","110/08/30","凱基-台南",500,1,499
"8966","00715L期街口布蘭特正2","110/08/30","國票-九鼎",1,440,-439
"8967","00715L期街口布蘭特正2","110/08/30","凱基-市政",500,7,493
"8968","00715L期街口布蘭特正2","110/08/30","永豐金-板盛",0,421,-421
"8969","00715L期街口布蘭特正2","110/08/30","元富-大裕",500,22,478
"8970","00715L期街口布蘭特正2","110/08/30","富邦-基隆",0,420,-420
"8971","8941關中","110/08/30","國泰-忠孝",1,0,1
"8972","8941關中","110/08/30","凱基-市府",0,1,-1
"8973","8941關中","110/08/30","第一金-台南",0,0,0
"8974","8941關中","110/08/30","第一金-台南",0,0,0
"8975","8941關中","110/08/30","康和-板橋",0,0,0
"8976","8941關中","110/08/30","康和-板橋",0,0,0
"8977","8941關中","110/08/30","新光-高雄",0,0,0
"8978","8941關中","110/08/30","新光-高雄",0,0,0
"8979","8941關中","110/08/30","華南永昌-淡水",0,0,0
"8980","8941關中","110/08/30","華南永昌-淡水",0,0,0
"8981","8941關中","110/08/30","富邦-台北",0,0,0
"8982","8941關中","110/08/30","富邦-台北",0,0,0
"8983","8941關中","110/08/30","元大-新竹經國",0,0,0
"8984","8941關中","110/08/30","元大-新竹經國",0,0,0
"8985","8941關中","110/08/30","永豐金-萬盛",0,0,0
"8986","8941關中","110/08/30","永豐金-萬盛",0,0,0
"8987","8941關中","110/08/30","",NA,NA,NA
"8988","8941關中","110/08/30","",NA,NA,NA
"8989","8941關中","110/08/30","",NA,NA,NA
"8990","8941關中","110/08/30","",NA,NA,NA
"8991","8941關中","110/08/30","",NA,NA,NA
"8992","8941關中","110/08/30","",NA,NA,NA
"8993","8941關中","110/08/30","",NA,NA,NA
"8994","8941關中","110/08/30","",NA,NA,NA
"8995","8941關中","110/08/30","",NA,NA,NA
"8996","8941關中","110/08/30","",NA,NA,NA
"8997","8941關中","110/08/30","",NA,NA,NA
"8998","8941關中","110/08/30","",NA,NA,NA
"8999","8941關中","110/08/30","",NA,NA,NA
"9000","8941關中","110/08/30","",NA,NA,NA
"9001","8936國統","110/08/30","統一-金門",100,30,70
"9002","8936國統","110/08/30","摩根大通",38,197,-159
"9003","8936國統","110/08/30","中國信託-高雄",56,0,56
"9004","8936國統","110/08/30","新加坡商瑞銀",5,152,-147
"9005","8936國統","110/08/30","國票-天祥",50,0,50
"9006","8936國統","110/08/30","凱基-台北",48,181,-133
"9007","8936國統","110/08/30","國票-敦北法人",50,0,50
"9008","8936國統","110/08/30","美商高盛",10,130,-120
"9009","8936國統","110/08/30","宏遠-光隆",47,0,47
"9010","8936國統","110/08/30","港商野村",4,97,-93
"9011","8936國統","110/08/30","元富-林園",40,0,40
"9012","8936國統","110/08/30","玉山-高雄",2,45,-43
"9013","8936國統","110/08/30","國泰-敦南",50,22,28
"9014","8936國統","110/08/30","華南永昌-楠梓",7,50,-43
"9015","8936國統","110/08/30","元大-松江",22,1,21
"9016","8936國統","110/08/30","新光",18,59,-41
"9017","8936國統","110/08/30","群益金鼎",20,0,20
"9018","8936國統","110/08/30","康和-嘉義",51,71,-20
"9019","8936國統","110/08/30","凱基-站前",20,0,20
"9020","8936國統","110/08/30","凱基-市政",0,20,-20
"9021","8936國統","110/08/30","永豐金-彰化",23,3,20
"9022","8936國統","110/08/30","永豐金-台中",0,20,-20
"9023","8936國統","110/08/30","日盛-台中",20,1,19
"9024","8936國統","110/08/30","台新-左楠",0,14,-14
"9025","8936國統","110/08/30","台灣摩根士丹利",19,0,19
"9026","8936國統","110/08/30","永豐金-苓雅",11,25,-14
"9027","8936國統","110/08/30","中國信託-文心",20,1,19
"9028","8936國統","110/08/30","永全-八德",0,10,-10
"9029","8936國統","110/08/30","元大-東港",16,0,16
"9030","8936國統","110/08/30","兆豐-三民",1,11,-10
"9031","6226光鼎","110/08/30","凱基-站前",105,0,105
"9032","6226光鼎","110/08/30","元富-世貿",0,111,-111
"9033","6226光鼎","110/08/30","台灣摩根士丹利",105,8,97
"9034","6226光鼎","110/08/30","凱基-竹科",10,86,-76
"9035","6226光鼎","110/08/30","國泰-敦南",210,125,85
"9036","6226光鼎","110/08/30","美林",102,165,-63
"9037","6226光鼎","110/08/30","摩根大通",104,29,75
"9038","6226光鼎","110/08/30","華南永昌-南京",6,69,-63
"9039","6226光鼎","110/08/30","永全-南崁",40,0,40
"9040","6226光鼎","110/08/30","玉山-高雄",6,63,-57
"9041","6226光鼎","110/08/30","群益金鼎-忠孝",40,0,40
"9042","6226光鼎","110/08/30","元大-大雅",5,58,-53
"9043","6226光鼎","110/08/30","元大-東泰",38,0,38
"9044","6226光鼎","110/08/30","兆豐-松德",3,53,-50
"9045","6226光鼎","110/08/30","日盛-八德",32,0,32
"9046","6226光鼎","110/08/30","凱基-內埔",15,50,-35
"9047","6226光鼎","110/08/30","台新-台中",41,11,30
"9048","6226光鼎","110/08/30","統一-基隆",0,30,-30
"9049","6226光鼎","110/08/30","凱基-三多",23,0,23
"9050","6226光鼎","110/08/30","中國信託",3,31,-28
"9051","6226光鼎","110/08/30","第一金-中壢",20,0,20
"9052","6226光鼎","110/08/30","凱基-台北",89,117,-28
"9053","6226光鼎","110/08/30","國票-長城",20,0,20
"9054","6226光鼎","110/08/30","合庫-西台中",2,26,-24
"9055","6226光鼎","110/08/30","玉山-大里",23,3,20
"9056","6226光鼎","110/08/30","福勝",10,32,-22
"9057","6226光鼎","110/08/30","富邦-竹北",21,2,19
"9058","6226光鼎","110/08/30","玉山-新莊",5,27,-22
"9059","6226光鼎","110/08/30","永豐金-鳳山",20,1,19
"9060","6226光鼎","110/08/30","元大-南崁",0,21,-21
"9061","2363矽統","110/08/30","元大-萬華",825,16,809
"9062","2363矽統","110/08/30","合庫-基隆",5,1735,-1730
"9063","2363矽統","110/08/30","港商野村",1455,869,586
"9064","2363矽統","110/08/30","康和-台中",23,619,-596
"9065","2363矽統","110/08/30","元大-承德",405,1,404
"9066","2363矽統","110/08/30","台新-台南",39,428,-389
"9067","2363矽統","110/08/30","國票-南港",405,6,399
"9068","2363矽統","110/08/30","元大-士林",9,363,-354
"9069","2363矽統","110/08/30","凱基-站前",367,74,293
"9070","2363矽統","110/08/30","摩根大通",121,453,-332
"9071","2363矽統","110/08/30","凱基-台北",1335,1052,283
"9072","2363矽統","110/08/30","台中銀-豐原",5,255,-250
"9073","2363矽統","110/08/30","永全",305,41,264
"9074","2363矽統","110/08/30","大展",32,271,-239
"9075","2363矽統","110/08/30","第一金-豐原",231,4,227
"9076","2363矽統","110/08/30","台新-台中",102,325,-223
"9077","2363矽統","110/08/30","華南永昌-林口",225,15,210
"9078","2363矽統","110/08/30","國票-和平",0,158,-158
"9079","2363矽統","110/08/30","日盛-樹林",208,49,159
"9080","2363矽統","110/08/30","永豐金-南京",34,165,-131
"9081","2363矽統","110/08/30","台新-新莊",157,7,150
"9082","2363矽統","110/08/30","大昌-樹林",14,136,-122
"9083","2363矽統","110/08/30","新光",236,92,144
"9084","2363矽統","110/08/30","元大-桃興",13,132,-119
"9085","2363矽統","110/08/30","光和",127,7,120
"9086","2363矽統","110/08/30","富邦-新竹",43,157,-114
"9087","2363矽統","110/08/30","臺銀",132,15,117
"9088","2363矽統","110/08/30","元大-大統",27,140,-113
"9089","2363矽統","110/08/30","兆豐-彰化",112,0,112
"9090","2363矽統","110/08/30","日盛-南京",9,113,-104
"9091","8112至上","110/08/30","凱基-竹東",100,0,100
"9092","8112至上","110/08/30","第一金-桃園",5,366,-361
"9093","8112至上","110/08/30","華南永昌-南京",60,1,59
"9094","8112至上","110/08/30","摩根大通",5,228,-223
"9095","8112至上","110/08/30","凱基-長庚",53,0,53
"9096","8112至上","110/08/30","統一-中壢",9,80,-71
"9097","8112至上","110/08/30","永豐金-板盛",50,0,50
"9098","8112至上","110/08/30","美林",16,78,-62
"9099","8112至上","110/08/30","富邦-仁愛",46,0,46
"9100","8112至上","110/08/30","兆豐-西螺",0,60,-60
"9101","8112至上","110/08/30","凱基-竹科",43,1,42
"9102","8112至上","110/08/30","美商高盛",5,60,-55
"9103","8112至上","110/08/30","兆豐-高雄",40,0,40
"9104","8112至上","110/08/30","元大-大灣",1,50,-49
"9105","8112至上","110/08/30","元大-竹東",37,0,37
"9106","8112至上","110/08/30","國票-南京",0,40,-40
"9107","8112至上","110/08/30","富邦-竹東",28,0,28
"9108","8112至上","110/08/30","元大-永和",0,40,-40
"9109","8112至上","110/08/30","統一-高雄",30,4,26
"9110","8112至上","110/08/30","群益金鼎-大甲",0,31,-31
"9111","8112至上","110/08/30","兆豐-天母",25,0,25
"9112","8112至上","110/08/30","台灣摩根士丹利",22,51,-29
"9113","8112至上","110/08/30","元大-高雄",20,0,20
"9114","8112至上","110/08/30","日盛-忠孝",2,28,-26
"9115","8112至上","110/08/30","元富-同大",22,3,19
"9116","8112至上","110/08/30","康和",1,26,-25
"9117","8112至上","110/08/30","凱基-士林",19,0,19
"9118","8112至上","110/08/30","群益金鼎-基隆",0,25,-25
"9119","8112至上","110/08/30","國泰-館前",19,2,17
"9120","8112至上","110/08/30","台中銀-員林",0,23,-23
"9121","1570力肯","110/08/30","摩根大通",69,18,51
"9122","1570力肯","110/08/30","群益金鼎-高雄",0,57,-57
"9123","1570力肯","110/08/30","元大-板橋",31,1,30
"9124","1570力肯","110/08/30","永豐金-永康",0,33,-33
"9125","1570力肯","110/08/30","元大-新營",27,0,27
"9126","1570力肯","110/08/30","國票-南科",0,26,-26
"9127","1570力肯","110/08/30","元大-永和",22,0,22
"9128","1570力肯","110/08/30","國票-北高雄",1,21,-20
"9129","1570力肯","110/08/30","元富-世貿",21,0,21
"9130","1570力肯","110/08/30","富邦-仁愛",1,20,-19
"9131","1570力肯","110/08/30","第一金-嘉義",20,0,20
"9132","1570力肯","110/08/30","元大-花蓮",0,19,-19
"9133","1570力肯","110/08/30","福勝",20,1,19
"9134","1570力肯","110/08/30","元富-延平",0,15,-15
"9135","1570力肯","110/08/30","(牛牛牛)亞-鑫豐",20,2,18
"9136","1570力肯","110/08/30","富邦-高雄",0,15,-15
"9137","1570力肯","110/08/30","台新證券",22,6,16
"9138","1570力肯","110/08/30","元富-新興",0,11,-11
"9139","1570力肯","110/08/30","群益金鼎-台中",16,0,16
"9140","1570力肯","110/08/30","亞東-板橋",0,10,-10
"9141","1570力肯","110/08/30","日盛-雙和",15,0,15
"9142","1570力肯","110/08/30","永豐金-中壢",0,10,-10
"9143","1570力肯","110/08/30","合庫-台中",11,0,11
"9144","1570力肯","110/08/30","元富-緯城",10,19,-9
"9145","1570力肯","110/08/30","聯邦商銀",10,0,10
"9146","1570力肯","110/08/30","元富-民權",5,13,-8
"9147","1570力肯","110/08/30","華南永昌-彰化",10,0,10
"9148","1570力肯","110/08/30","凱基-嘉義",2,10,-8
"9149","1570力肯","110/08/30","元大-鳳中",12,2,10
"9150","1570力肯","110/08/30","元大-南投",0,8,-8
"9151","2929淘帝","110/08/30","摩根大通",22,0,22
"9152","2929淘帝","110/08/30","凱基-高雄",0,150,-150
"9153","2929淘帝","110/08/30","元富-大裕",12,0,12
"9154","2929淘帝","110/08/30","凱基-長庚",0,15,-15
"9155","2929淘帝","110/08/30","華南永昌-台中",11,0,11
"9156","2929淘帝","110/08/30","富邦-南屯",0,13,-13
"9157","2929淘帝","110/08/30","兆豐-忠孝",10,0,10
"9158","2929淘帝","110/08/30","元大-蘆洲",0,12,-12
"9159","2929淘帝","110/08/30","永豐金-博愛",9,0,9
"9160","2929淘帝","110/08/30","元富-三重",0,8,-8
"9161","2929淘帝","110/08/30","國泰-敦南",8,0,8
"9162","2929淘帝","110/08/30","新加坡商瑞銀",3,10,-7
"9163","2929淘帝","110/08/30","凱基-東門",8,0,8
"9164","2929淘帝","110/08/30","元大-博愛",0,6,-6
"9165","2929淘帝","110/08/30","日盛-雙和",7,0,7
"9166","2929淘帝","110/08/30","國票-南京",0,5,-5
"9167","2929淘帝","110/08/30","新光-台中",7,0,7
"9168","2929淘帝","110/08/30","國泰-台南",0,5,-5
"9169","2929淘帝","110/08/30","元大-太平",7,0,7
"9170","2929淘帝","110/08/30","台新-中壢",0,4,-4
"9171","2929淘帝","110/08/30","元大-土城永寧",7,0,7
"9172","2929淘帝","110/08/30","群益金鼎-大安",0,4,-4
"9173","2929淘帝","110/08/30","元大-新竹經國",6,0,6
"9174","2929淘帝","110/08/30","日盛-信義",1,3,-2
"9175","2929淘帝","110/08/30","元富-新竹",5,0,5
"9176","2929淘帝","110/08/30","新光-新竹",0,2,-2
"9177","2929淘帝","110/08/30","台中銀-豐原",5,0,5
"9178","2929淘帝","110/08/30","元大-南屯",0,2,-2
"9179","2929淘帝","110/08/30","台新-建北",5,0,5
"9180","2929淘帝","110/08/30","元大-東蘆",0,2,-2
"9181","5410國眾","110/08/30","華南永昌-高雄",10,0,10
"9182","5410國眾","110/08/30","群益金鼎-新竹",0,8,-8
"9183","5410國眾","110/08/30","群益金鼎-東湖",5,0,5
"9184","5410國眾","110/08/30","日盛-新莊",0,6,-6
"9185","5410國眾","110/08/30","凱基-科園",5,0,5
"9186","5410國眾","110/08/30","凱基-長庚",0,5,-5
"9187","5410國眾","110/08/30","元大-中壢",5,0,5
"9188","5410國眾","110/08/30","元富-嘉義",0,4,-4
"9189","5410國眾","110/08/30","兆豐-嘉義",4,0,4
"9190","5410國眾","110/08/30","台灣企銀",0,3,-3
"9191","5410國眾","110/08/30","元大-彰化",3,0,3
"9192","5410國眾","110/08/30","寶盛",0,3,-3
"9193","5410國眾","110/08/30","玉山-新竹",2,0,2
"9194","5410國眾","110/08/30","元富-台中",1,4,-3
"9195","5410國眾","110/08/30","國泰-台中",2,0,2
"9196","5410國眾","110/08/30","兆豐-竹北",0,3,-3
"9197","5410國眾","110/08/30","國泰-敦南",2,0,2
"9198","5410國眾","110/08/30","元大-屏東民生",0,3,-3
"9199","5410國眾","110/08/30","香港上海匯豐",2,0,2
"9200","5410國眾","110/08/30","永豐金-中正",0,3,-3
"9201","5410國眾","110/08/30","永豐金-萬盛",2,0,2
"9202","5410國眾","110/08/30","統一-基隆",0,2,-2
"9203","5410國眾","110/08/30","日盛-員林",1,0,1
"9204","5410國眾","110/08/30","群益金鼎-新店",0,2,-2
"9205","5410國眾","110/08/30","第一金-高雄",1,0,1
"9206","5410國眾","110/08/30","凱基-台南",0,2,-2
"9207","5410國眾","110/08/30","元富",1,0,1
"9208","5410國眾","110/08/30","元大-龍潭",0,2,-2
"9209","5410國眾","110/08/30","國票-北高雄",1,0,1
"9210","5410國眾","110/08/30","第一金-台南",0,1,-1
"9211","2841台開","110/08/30","宏遠-館前",215,0,215
"9212","2841台開","110/08/30","萬泰",0,50,-50
"9213","2841台開","110/08/30","日盛證券",26,0,26
"9214","2841台開","110/08/30","台中銀",0,40,-40
"9215","2841台開","110/08/30","元大-台中",16,0,16
"9216","2841台開","110/08/30","永豐金-敦南",33,71,-38
"9217","2841台開","110/08/30","第一金-華江",12,0,12
"9218","2841台開","110/08/30","富邦-花蓮",0,21,-21
"9219","2841台開","110/08/30","日盛-台中",20,10,10
"9220","2841台開","110/08/30","元大-嘉義",0,20,-20
"9221","2841台開","110/08/30","新光-桃園",10,0,10
"9222","2841台開","110/08/30","台灣摩根士丹利",0,19,-19
"9223","2841台開","110/08/30","凱基-內湖",10,0,10
"9224","2841台開","110/08/30","新加坡商瑞銀",0,19,-19
"9225","2841台開","110/08/30","元大-沙鹿",5,0,5
"9226","2841台開","110/08/30","台新證券",1,20,-19
"9227","2841台開","110/08/30","元大-南屯",5,0,5
"9228","2841台開","110/08/30","元大-花蓮",0,17,-17
"9229","2841台開","110/08/30","台新-台中",4,0,4
"9230","2841台開","110/08/30","國票-中和",0,12,-12
"9231","2841台開","110/08/30","元大-三重",4,0,4
"9232","2841台開","110/08/30","凱基-竹北",0,10,-10
"9233","2841台開","110/08/30","兆豐-高雄",3,0,3
"9234","2841台開","110/08/30","永豐金-新莊",0,10,-10
"9235","2841台開","110/08/30","日盛-大墩",1,0,1
"9236","2841台開","110/08/30","兆豐-台中",0,5,-5
"9237","2841台開","110/08/30","元富-成功",1,0,1
"9238","2841台開","110/08/30","新光",0,5,-5
"9239","2841台開","110/08/30","國泰-館前",1,0,1
"9240","2841台開","110/08/30","永豐金-忠孝",0,5,-5
"9241","6207雷科","110/08/30","群益金鼎-高雄",45,0,45
"9242","6207雷科","110/08/30","元大-新莊",0,43,-43
"9243","6207雷科","110/08/30","凱基-台北",28,3,25
"9244","6207雷科","110/08/30","新加坡商瑞銀",1,38,-37
"9245","6207雷科","110/08/30","兆豐-嘉義",21,0,21
"9246","6207雷科","110/08/30","臺銀",0,18,-18
"9247","6207雷科","110/08/30","港商野村",30,13,17
"9248","6207雷科","110/08/30","群益金鼎-土城",0,13,-13
"9249","6207雷科","110/08/30","國票-台中",27,15,12
"9250","6207雷科","110/08/30","群益金鼎-延平",0,13,-13
"9251","6207雷科","110/08/30","凱基-彰化",10,0,10
"9252","6207雷科","110/08/30","永豐金-中壢",0,13,-13
"9253","6207雷科","110/08/30","華南永昌-長虹",10,0,10
"9254","6207雷科","110/08/30","元富-延平",0,10,-10
"9255","6207雷科","110/08/30","元大-大灣",10,0,10
"9256","6207雷科","110/08/30","國泰-桃園",0,10,-10
"9257","6207雷科","110/08/30","摩根大通",30,21,9
"9258","6207雷科","110/08/30","中國信託-高雄",0,8,-8
"9259","6207雷科","110/08/30","日盛-台中",8,0,8
"9260","6207雷科","110/08/30","陽信-石牌",0,8,-8
"9261","6207雷科","110/08/30","群益金鼎-鳳山",7,0,7
"9262","6207雷科","110/08/30","群益金鼎-中壢",2,10,-8
"9263","6207雷科","110/08/30","元大-文心興安",7,0,7
"9264","6207雷科","110/08/30","元富-安南",0,6,-6
"9265","6207雷科","110/08/30","台新-屏東",6,0,6
"9266","6207雷科","110/08/30","群益金鼎-士林",0,6,-6
"9267","6207雷科","110/08/30","聯邦-大業",6,0,6
"9268","6207雷科","110/08/30","華南永昌",0,6,-6
"9269","6207雷科","110/08/30","國泰-高雄",6,0,6
"9270","6207雷科","110/08/30","第一金-高雄",0,5,-5
"9271","3679新至陞","110/08/30","永豐金-南投",12,0,12
"9272","3679新至陞","110/08/30","美林",0,9,-9
"9273","3679新至陞","110/08/30","凱基-中山",3,0,3
"9274","3679新至陞","110/08/30","中國信託-三重",0,4,-4
"9275","3679新至陞","110/08/30","元富-埔里",2,0,2
"9276","3679新至陞","110/08/30","摩根大通",0,3,-3
"9277","3679新至陞","110/08/30","凱基",1,0,1
"9278","3679新至陞","110/08/30","台灣摩根士丹利",0,2,-2
"9279","3679新至陞","110/08/30","元大-四維",1,0,1
"9280","3679新至陞","110/08/30","凱基-台北",0,2,-2
"9281","3679新至陞","110/08/30","富邦-竹北",1,0,1
"9282","3679新至陞","110/08/30","華南永昌",0,2,-2
"9283","3679新至陞","110/08/30","華南永昌-大安",1,0,1
"9284","3679新至陞","110/08/30","元大證券",0,2,-2
"9285","3679新至陞","110/08/30","華南永昌-台中",1,0,1
"9286","3679新至陞","110/08/30","永豐金-高雄",0,2,-2
"9287","3679新至陞","110/08/30","日盛-新莊",1,0,1
"9288","3679新至陞","110/08/30","大慶-富順",0,1,-1
"9289","3679新至陞","110/08/30","玉山-新竹",1,0,1
"9290","3679新至陞","110/08/30","國票-九鼎",0,1,-1
"9291","3679新至陞","110/08/30","台新證券",1,0,1
"9292","3679新至陞","110/08/30","富邦-虎尾",0,1,-1
"9293","3679新至陞","110/08/30","大昌-新店",1,0,1
"9294","3679新至陞","110/08/30","元大-屏東民生",0,1,-1
"9295","3679新至陞","110/08/30","光和-溪湖",1,0,1
"9296","3679新至陞","110/08/30","國泰-敦南",0,0,0
"9297","3679新至陞","110/08/30","元富-板橋",1,0,1
"9298","3679新至陞","110/08/30","元大-太平",0,0,0
"9299","3679新至陞","110/08/30","元富-潮州",1,0,1
"9300","3679新至陞","110/08/30","元大-忠孝",0,0,0
"9301","2727王品","110/08/30","台灣摩根士丹利",74,15,59
"9302","2727王品","110/08/30","港商法國興業",0,27,-27
"9303","2727王品","110/08/30","元大-彰化民生",35,0,35
"9304","2727王品","110/08/30","港商野村",6,24,-18
"9305","2727王品","110/08/30","群益金鼎-大興",13,0,13
"9306","2727王品","110/08/30","元大-中壢",0,16,-16
"9307","2727王品","110/08/30","凱基-台北",36,23,13
"9308","2727王品","110/08/30","元大-苗栗",0,11,-11
"9309","2727王品","110/08/30","國泰證券",10,1,9
"9310","2727王品","110/08/30","元大-小港",1,12,-11
"9311","2727王品","110/08/30","元大-仁愛",9,0,9
"9312","2727王品","110/08/30","新光-新竹",0,9,-9
"9313","2727王品","110/08/30","第一金-台南",6,0,6
"9314","2727王品","110/08/30","美林",23,31,-8
"9315","2727王品","110/08/30","凱基-五股",6,0,6
"9316","2727王品","110/08/30","(牛牛牛)亞-鑫豐",4,11,-7
"9317","2727王品","110/08/30","元大-金華",6,0,6
"9318","2727王品","110/08/30","新光",6,13,-7
"9319","2727王品","110/08/30","元大-桃興",7,1,6
"9320","2727王品","110/08/30","元大-南投",1,8,-7
"9321","2727王品","110/08/30","統一",5,0,5
"9322","2727王品","110/08/30","日盛-木柵",0,6,-6
"9323","2727王品","110/08/30","中國信託-嘉義",5,0,5
"9324","2727王品","110/08/30","元富-草屯",0,6,-6
"9325","2727王品","110/08/30","國票-和平",5,0,5
"9326","2727王品","110/08/30","日盛-士林",0,5,-5
"9327","2727王品","110/08/30","富邦-南屯",7,2,5
"9328","2727王品","110/08/30","統一-屏東",0,5,-5
"9329","2727王品","110/08/30","永豐金-松山",5,0,5
"9330","2727王品","110/08/30","永興-台中",0,4,-4
"9331","1570力肯","110/08/30","摩根大通",69,18,51
"9332","1570力肯","110/08/30","群益金鼎-高雄",0,57,-57
"9333","1570力肯","110/08/30","元大-板橋",31,1,30
"9334","1570力肯","110/08/30","永豐金-永康",0,33,-33
"9335","1570力肯","110/08/30","元大-新營",27,0,27
"9336","1570力肯","110/08/30","國票-南科",0,26,-26
"9337","1570力肯","110/08/30","元大-永和",22,0,22
"9338","1570力肯","110/08/30","國票-北高雄",1,21,-20
"9339","1570力肯","110/08/30","元富-世貿",21,0,21
"9340","1570力肯","110/08/30","富邦-仁愛",1,20,-19
"9341","1570力肯","110/08/30","第一金-嘉義",20,0,20
"9342","1570力肯","110/08/30","元大-花蓮",0,19,-19
"9343","1570力肯","110/08/30","福勝",20,1,19
"9344","1570力肯","110/08/30","元富-延平",0,15,-15
"9345","1570力肯","110/08/30","(牛牛牛)亞-鑫豐",20,2,18
"9346","1570力肯","110/08/30","富邦-高雄",0,15,-15
"9347","1570力肯","110/08/30","台新證券",22,6,16
"9348","1570力肯","110/08/30","元富-新興",0,11,-11
"9349","1570力肯","110/08/30","群益金鼎-台中",16,0,16
"9350","1570力肯","110/08/30","亞東-板橋",0,10,-10
"9351","1570力肯","110/08/30","日盛-雙和",15,0,15
"9352","1570力肯","110/08/30","永豐金-中壢",0,10,-10
"9353","1570力肯","110/08/30","合庫-台中",11,0,11
"9354","1570力肯","110/08/30","元富-緯城",10,19,-9
"9355","1570力肯","110/08/30","聯邦商銀",10,0,10
"9356","1570力肯","110/08/30","元富-民權",5,13,-8
"9357","1570力肯","110/08/30","華南永昌-彰化",10,0,10
"9358","1570力肯","110/08/30","凱基-嘉義",2,10,-8
"9359","1570力肯","110/08/30","元大-鳳中",12,2,10
"9360","1570力肯","110/08/30","元大-南投",0,8,-8
"9361","6180橘子","110/08/30","台灣摩根士丹利",43,0,43
"9362","6180橘子","110/08/30","兆豐證券",0,82,-82
"9363","6180橘子","110/08/30","日盛-八德",15,0,15
"9364","6180橘子","110/08/30","元大-新竹",0,30,-30
"9365","6180橘子","110/08/30","華南永昌-台中",13,0,13
"9366","6180橘子","110/08/30","美商高盛",0,25,-25
"9367","6180橘子","110/08/30","元大-北成功",59,46,13
"9368","6180橘子","110/08/30","新光-高雄",0,19,-19
"9369","6180橘子","110/08/30","美林",11,0,11
"9370","6180橘子","110/08/30","新加坡商瑞銀",0,18,-18
"9371","6180橘子","110/08/30","合庫-彰化",10,0,10
"9372","6180橘子","110/08/30","港商野村",0,13,-13
"9373","6180橘子","110/08/30","宏遠-桃園",9,0,9
"9374","6180橘子","110/08/30","元大-上新莊",0,13,-13
"9375","6180橘子","110/08/30","康和-嘉義",8,0,8
"9376","6180橘子","110/08/30","國泰-新莊",0,12,-12
"9377","6180橘子","110/08/30","群益金鼎-古亭",7,0,7
"9378","6180橘子","110/08/30","玉山-板橋",0,11,-11
"9379","6180橘子","110/08/30","國票-新莊",6,0,6
"9380","6180橘子","110/08/30","凱基-高雄",2,11,-9
"9381","6180橘子","110/08/30","玉山-新莊",6,0,6
"9382","6180橘子","110/08/30","元大-草屯",0,6,-6
"9383","6180橘子","110/08/30","凱基-台北",42,36,6
"9384","6180橘子","110/08/30","元大-彰化民生",0,6,-6
"9385","6180橘子","110/08/30","華南永昌-東昇",6,0,6
"9386","6180橘子","110/08/30","新光",3,8,-5
"9387","6180橘子","110/08/30","群益金鼎-敦南",5,0,5
"9388","6180橘子","110/08/30","富邦-苗栗",0,5,-5
"9389","6180橘子","110/08/30","元大證券",5,0,5
"9390","6180橘子","110/08/30","元大-中壢",0,4,-4
"9391","2390云辰","110/08/30","港商野村",174,128,46
"9392","2390云辰","110/08/30","第一金-華江",0,210,-210
"9393","2390云辰","110/08/30","第一金-中山",33,0,33
"9394","2390云辰","110/08/30","玉山-嘉義",42,113,-71
"9395","2390云辰","110/08/30","凱基-台北",90,64,26
"9396","2390云辰","110/08/30","美林",4,65,-61
"9397","2390云辰","110/08/30","元富-中壢",25,1,24
"9398","2390云辰","110/08/30","新光-桃園",2,42,-40
"9399","2390云辰","110/08/30","中國信託-文心",25,3,22
"9400","2390云辰","110/08/30","元大-龍潭",0,40,-40
"9401","2390云辰","110/08/30","臺銀-高雄",20,0,20
"9402","2390云辰","110/08/30","元大-永春",0,35,-35
"9403","2390云辰","110/08/30","日盛-頭份",20,0,20
"9404","2390云辰","110/08/30","兆豐-高雄",0,33,-33
"9405","2390云辰","110/08/30","元富-虎尾",24,4,20
"9406","2390云辰","110/08/30","元大-台南",0,25,-25
"9407","2390云辰","110/08/30","元大-開元",20,0,20
"9408","2390云辰","110/08/30","台灣摩根士丹利",0,21,-21
"9409","2390云辰","110/08/30","元富-板橋",20,1,19
"9410","2390云辰","110/08/30","元大-林園",0,20,-20
"9411","2390云辰","110/08/30","元富-大裕",23,4,19
"9412","2390云辰","110/08/30","元大-斗信",0,18,-18
"9413","2390云辰","110/08/30","國票-博愛",21,2,19
"9414","2390云辰","110/08/30","玉山-新竹",3,20,-17
"9415","2390云辰","110/08/30","兆豐-台中港",17,0,17
"9416","2390云辰","110/08/30","統一-敦南",0,15,-15
"9417","2390云辰","110/08/30","新光",28,11,17
"9418","2390云辰","110/08/30","兆豐-三民",0,15,-15
"9419","2390云辰","110/08/30","元大-台中",17,0,17
"9420","2390云辰","110/08/30","兆豐-景美",1,14,-13
"9421","1315達新","110/08/26","豐農",32,0,32
"9422","1315達新","110/08/26","永豐金證券",1,17,-16
"9423","1315達新","110/08/26","統一-台中",5,0,5
"9424","1315達新","110/08/26","凱基-台北",0,9,-9
"9425","1315達新","110/08/26","凱基-中港",5,0,5
"9426","1315達新","110/08/26","永豐金-市政",0,8,-8
"9427","1315達新","110/08/26","台灣摩根士丹利",5,1,4
"9428","1315達新","110/08/26","富邦-台中",0,5,-5
"9429","1315達新","110/08/26","美商高盛",4,0,4
"9430","1315達新","110/08/26","元大-花蓮",0,5,-5
"9431","1315達新","110/08/26","聯邦-三重",2,0,2
"9432","1315達新","110/08/26","日盛-新竹",0,2,-2
"9433","1315達新","110/08/26","富邦-內湖",2,0,2
"9434","1315達新","110/08/26","美林",0,2,-2
"9435","1315達新","110/08/26","永興",1,0,1
"9436","1315達新","110/08/26","兆豐-南京",0,2,-2
"9437","1315達新","110/08/26","致和-佳里",1,0,1
"9438","1315達新","110/08/26","國泰-台中",1,3,-2
"9439","1315達新","110/08/26","凱基-三重",1,0,1
"9440","1315達新","110/08/26","華南永昌-楠梓",0,2,-2
"9441","1315達新","110/08/26","凱基-高美館",1,0,1
"9442","1315達新","110/08/26","瑞士信貸",0,1,-1
"9443","1315達新","110/08/26","凱基-內埔",1,0,1
"9444","1315達新","110/08/26","花旗環球",0,1,-1
"9445","1315達新","110/08/26","元大證券",1,0,1
"9446","1315達新","110/08/26","亞東-台南",0,1,-1
"9447","1315達新","110/08/26","元大-沙鹿",1,0,1
"9448","1315達新","110/08/26","第一金",0,1,-1
"9449","1315達新","110/08/26","元大-台北",1,0,1
"9450","1315達新","110/08/26","元富-花蓮",0,1,-1
"9451","2609陽明","110/08/26","永豐金-信義",3562,119,3443
"9452","2609陽明","110/08/26","凱基-台北",2973,9333,-6360
"9453","2609陽明","110/08/26","康和",4424,1135,3289
"9454","2609陽明","110/08/26","台灣摩根士丹利",92,1881,-1789
"9455","2609陽明","110/08/26","摩根大通",6387,3687,2700
"9456","2609陽明","110/08/26","美林",515,1703,-1188
"9457","2609陽明","110/08/26","兆豐-三民",2069,35,2034
"9458","2609陽明","110/08/26","兆豐-中壢",10,856,-846
"9459","2609陽明","110/08/26","花旗環球",1142,0,1142
"9460","2609陽明","110/08/26","富邦-台東",35,624,-589
"9461","2609陽明","110/08/26","統一-敦南",2070,936,1134
"9462","2609陽明","110/08/26","瑞士信貸",390,948,-558
"9463","2609陽明","110/08/26","兆豐-南京",1088,76,1012
"9464","2609陽明","110/08/26","日盛-板橋",169,679,-510
"9465","2609陽明","110/08/26","富邦-建國",1011,325,686
"9466","2609陽明","110/08/26","宏遠證券",1001,1420,-419
"9467","2609陽明","110/08/26","兆豐-虎尾",4061,3405,656
"9468","2609陽明","110/08/26","元大證券",1362,1772,-410
"9469","2609陽明","110/08/26","凱基-市政",1854,1349,505
"9470","2609陽明","110/08/26","富邦-南屯",218,600,-382
"9471","2609陽明","110/08/26","國票-彰化",1013,618,395
"9472","2609陽明","110/08/26","新加坡商瑞銀",1501,1879,-378
"9473","2609陽明","110/08/26","元大-樹林",436,112,324
"9474","2609陽明","110/08/26","兆豐-彰化",382,743,-361
"9475","2609陽明","110/08/26","群益金鼎",517,212,305
"9476","2609陽明","110/08/26","富邦-虎尾",3490,3837,-347
"9477","2609陽明","110/08/26","元富-文心",572,288,284
"9478","2609陽明","110/08/26","寶盛",15,315,-300
"9479","2609陽明","110/08/26","兆豐-埔墘",354,143,211
"9480","2609陽明","110/08/26","華南永昌-竹北",709,1009,-300
"9481","2636台驊投控","110/08/26","富邦-台北",72,6,66
"9482","2636台驊投控","110/08/26","凱基-台北",566,1251,-685
"9483","2636台驊投控","110/08/26","元大-松江",77,15,62
"9484","2636台驊投控","110/08/26","瑞士信貸",31,462,-431
"9485","2636台驊投控","110/08/26","永豐金-嘉義",114,54,60
"9486","2636台驊投控","110/08/26","美商高盛",35,394,-359
"9487","2636台驊投控","110/08/26","華南永昌-南京",78,22,56
"9488","2636台驊投控","110/08/26","台灣摩根士丹利",7,344,-337
"9489","2636台驊投控","110/08/26","國泰-敦南",176,125,51
"9490","2636台驊投控","110/08/26","國票-彰化",466,763,-297
"9491","2636台驊投控","110/08/26","宏遠-館前",50,0,50
"9492","2636台驊投控","110/08/26","美林",290,532,-242
"9493","2636台驊投控","110/08/26","群益金鼎-海山",62,18,44
"9494","2636台驊投控","110/08/26","兆豐-中壢",30,234,-204
"9495","2636台驊投控","110/08/26","第一金-中壢",50,7,43
"9496","2636台驊投控","110/08/26","港商野村",679,881,-202
"9497","2636台驊投控","110/08/26","兆豐-南京",54,11,43
"9498","2636台驊投控","110/08/26","元富-西松",54,219,-165
"9499","2636台驊投控","110/08/26","富邦-嘉義",53,11,42
"9500","2636台驊投控","110/08/26","元大-淡水",8,54,-46
"9501","2636台驊投控","110/08/26","新光",183,143,40
"9502","2636台驊投控","110/08/26","元大-士林",41,82,-41
"9503","2636台驊投控","110/08/26","元大-林森",42,3,39
"9504","2636台驊投控","110/08/26","新加坡商瑞銀",127,164,-37
"9505","2636台驊投控","110/08/26","日盛-忠孝",45,9,36
"9506","2636台驊投控","110/08/26","摩根大通",363,399,-36
"9507","2636台驊投控","110/08/26","華南永昌-合泰",56,20,36
"9508","2636台驊投控","110/08/26","日盛-永康",14,43,-29
"9509","2636台驊投控","110/08/26","日盛-木柵",46,11,35
"9510","2636台驊投控","110/08/26","台中銀-台北",5,33,-28
"9511","2867三商壽","110/08/26","美林",559,133,426
"9512","2867三商壽","110/08/26","台灣摩根士丹利",25,307,-282
"9513","2867三商壽","110/08/26","瑞士信貸",223,8,215
"9514","2867三商壽","110/08/26","凱基-中港",2,279,-277
"9515","2867三商壽","110/08/26","日盛-頭份",108,0,108
"9516","2867三商壽","110/08/26","花旗環球",0,180,-180
"9517","2867三商壽","110/08/26","臺銀-臺中",103,0,103
"9518","2867三商壽","110/08/26","元大-桃園",20,199,-179
"9519","2867三商壽","110/08/26","日盛-樹林",100,0,100
"9520","2867三商壽","110/08/26","國泰證券",0,150,-150
"9521","2867三商壽","110/08/26","新光",90,1,89
"9522","2867三商壽","110/08/26","凱基-台北",18,156,-138
"9523","2867三商壽","110/08/26","光和",80,0,80
"9524","2867三商壽","110/08/26","凱基-長庚",0,120,-120
"9525","2867三商壽","110/08/26","兆豐-城中",70,0,70
"9526","2867三商壽","110/08/26","摩根大通",59,172,-113
"9527","2867三商壽","110/08/26","凱基-高雄",60,0,60
"9528","2867三商壽","110/08/26","群益金鼎-大甲",0,90,-90
"9529","2867三商壽","110/08/26","凱基-林口",50,0,50
"9530","2867三商壽","110/08/26","中國信託-忠孝",0,70,-70
"9531","2867三商壽","110/08/26","富邦-高雄",60,11,49
"9532","2867三商壽","110/08/26","兆豐-新營",0,50,-50
"9533","2867三商壽","110/08/26","港商野村",66,29,37
"9534","2867三商壽","110/08/26","台灣企銀",0,40,-40
"9535","2867三商壽","110/08/26","大昌-新店",37,0,37
"9536","2867三商壽","110/08/26","華南永昌-高雄",24,60,-36
"9537","2867三商壽","110/08/26","國票-南崁",30,0,30
"9538","2867三商壽","110/08/26","兆豐-西螺",0,30,-30
"9539","2867三商壽","110/08/26","中農",25,0,25
"9540","2867三商壽","110/08/26","兆豐-斗南",0,30,-30
"9541","5521工信","110/08/26","摩根大通",563,0,563
"9542","5521工信","110/08/26","華南永昌-民權",0,100,-100
"9543","5521工信","110/08/26","凱基-台北",346,17,329
"9544","5521工信","110/08/26","台灣摩根士丹利",14,103,-89
"9545","5521工信","110/08/26","群益金鼎-大甲",145,0,145
"9546","5521工信","110/08/26","富邦-台北",0,47,-47
"9547","5521工信","110/08/26","美林",61,9,52
"9548","5521工信","110/08/26","國泰-板橋",0,46,-46
"9549","5521工信","110/08/26","兆豐-嘉義",50,0,50
"9550","5521工信","110/08/26","元富-新店",0,40,-40
"9551","5521工信","110/08/26","美商高盛",49,0,49
"9552","5521工信","110/08/26","中國信託-三重",0,40,-40
"9553","5521工信","110/08/26","日進",45,0,45
"9554","5521工信","110/08/26","永豐金-中盛",0,33,-33
"9555","5521工信","110/08/26","元大證券",47,2,45
"9556","5521工信","110/08/26","日盛-中壢",0,32,-32
"9557","5521工信","110/08/26","康和-台中",30,0,30
"9558","5521工信","110/08/26","新光",0,32,-32
"9559","5521工信","110/08/26","福勝",30,12,18
"9560","5521工信","110/08/26","富邦-嘉義",0,31,-31
"9561","5521工信","110/08/26","港商野村",16,0,16
"9562","5521工信","110/08/26","日盛-雙和",0,30,-30
"9563","5521工信","110/08/26","統一-屏東",15,0,15
"9564","5521工信","110/08/26","國票-安和",0,24,-24
"9565","5521工信","110/08/26","日盛-新莊",30,20,10
"9566","5521工信","110/08/26","第一金-桃園",0,23,-23
"9567","5521工信","110/08/26","日盛-中和",10,0,10
"9568","5521工信","110/08/26","日盛-大墩",0,20,-20
"9569","5521工信","110/08/26","凱基-高雄",10,0,10
"9570","5521工信","110/08/26","第一金-華江",0,20,-20
"9571","1471首利","110/08/26","瑞士信貸",60,4,56
"9572","1471首利","110/08/26","群益金鼎-東大",0,120,-120
"9573","1471首利","110/08/26","永豐金-台南",34,0,34
"9574","1471首利","110/08/26","元大-敦化",0,86,-86
"9575","1471首利","110/08/26","大慶",25,0,25
"9576","1471首利","110/08/26","美林",0,40,-40
"9577","1471首利","110/08/26","台中銀-員林",20,0,20
"9578","1471首利","110/08/26","台灣摩根士丹利",0,36,-36
"9579","1471首利","110/08/26","群益金鼎-土城",20,0,20
"9580","1471首利","110/08/26","摩根大通",25,61,-36
"9581","1471首利","110/08/26","新光",16,0,16
"9582","1471首利","110/08/26","元大-內湖",0,30,-30
"9583","1471首利","110/08/26","永豐金-大園",11,0,11
"9584","1471首利","110/08/26","凱基-五股",0,25,-25
"9585","1471首利","110/08/26","永豐金-竹北",11,0,11
"9586","1471首利","110/08/26","元大-大甲",0,20,-20
"9587","1471首利","110/08/26","第一金-台南",10,0,10
"9588","1471首利","110/08/26","台新證券",3,20,-17
"9589","1471首利","110/08/26","中國信託",10,0,10
"9590","1471首利","110/08/26","兆豐-西螺",0,14,-14
"9591","1471首利","110/08/26","中國信託-永康",10,0,10
"9592","1471首利","110/08/26","凱基-台北",4,18,-14
"9593","1471首利","110/08/26","群益金鼎-海山",10,0,10
"9594","1471首利","110/08/26","大慶-富順",0,10,-10
"9595","1471首利","110/08/26","富邦-板橋",10,0,10
"9596","1471首利","110/08/26","國票-九鼎",0,5,-5
"9597","1471首利","110/08/26","元大-永康",10,0,10
"9598","1471首利","110/08/26","元大-斗信",0,5,-5
"9599","1471首利","110/08/26","元富-草屯",9,0,9
"9600","1471首利","110/08/26","永豐金-敦北",0,5,-5
"9601","2883開發金","110/08/26","美林",3929,1002,2927
"9602","2883開發金","110/08/26","台灣摩根士丹利",24,5752,-5728
"9603","2883開發金","110/08/26","元大證券",2303,84,2219
"9604","2883開發金","110/08/26","統一",3,2525,-2522
"9605","2883開發金","110/08/26","港商法國興業",1967,153,1814
"9606","2883開發金","110/08/26","瑞士信貸",71,2033,-1962
"9607","2883開發金","110/08/26","玉山證券",1626,46,1580
"9608","2883開發金","110/08/26","永豐金-新莊",1,1001,-1000
"9609","2883開發金","110/08/26","摩根大通",2510,1213,1297
"9610","2883開發金","110/08/26","新加坡商瑞銀",508,1498,-990
"9611","2883開發金","110/08/26","元大-草屯",1002,18,984
"9612","2883開發金","110/08/26","港商野村",4,846,-842
"9613","2883開發金","110/08/26","華南永昌",1021,206,815
"9614","2883開發金","110/08/26","香港上海匯豐",0,698,-698
"9615","2883開發金","110/08/26","陽信",400,0,400
"9616","2883開發金","110/08/26","凱基-台北",725,1403,-678
"9617","2883開發金","110/08/26","第一金-台南",314,12,302
"9618","2883開發金","110/08/26","永豐金證券",100,493,-393
"9619","2883開發金","110/08/26","國泰-館前",373,86,287
"9620","2883開發金","110/08/26","美商高盛",32,393,-361
"9621","2883開發金","110/08/26","亞東-台中",282,0,282
"9622","2883開發金","110/08/26","元富-城東",4,287,-283
"9623","2883開發金","110/08/26","台新證券",390,136,254
"9624","2883開發金","110/08/26","兆豐-北高雄",172,451,-279
"9625","2883開發金","110/08/26","凱基-宜蘭",270,25,245
"9626","2883開發金","110/08/26","富邦證券",10,235,-225
"9627","2883開發金","110/08/26","凱基-台東",342,113,229
"9628","2883開發金","110/08/26","兆豐-三民",2,210,-208
"9629","2883開發金","110/08/26","永豐金-竹科",233,10,223
"9630","2883開發金","110/08/26","新光",885,1069,-184
"9631","6205詮欣","110/08/26","凱基-信義",20,0,20
"9632","6205詮欣","110/08/26","永豐金-敦南",0,30,-30
"9633","6205詮欣","110/08/26","凱基-長庚",11,0,11
"9634","6205詮欣","110/08/26","凱基-台北",0,9,-9
"9635","6205詮欣","110/08/26","日盛-北高雄",5,0,5
"9636","6205詮欣","110/08/26","凱基-台南",0,7,-7
"9637","6205詮欣","110/08/26","台中銀",5,0,5
"9638","6205詮欣","110/08/26","摩根大通",4,10,-6
"9639","6205詮欣","110/08/26","臺銀-民權",4,0,4
"9640","6205詮欣","110/08/26","兆豐-公益",0,4,-4
"9641","6205詮欣","110/08/26","臺銀-臺中",3,0,3
"9642","6205詮欣","110/08/26","永豐金證券",0,4,-4
"9643","6205詮欣","110/08/26","台新-屏東",3,0,3
"9644","6205詮欣","110/08/26","港商法國興業",0,3,-3
"9645","6205詮欣","110/08/26","日盛-土城",2,0,2
"9646","6205詮欣","110/08/26","瑞士信貸",0,2,-2
"9647","6205詮欣","110/08/26","中農",2,0,2
"9648","6205詮欣","110/08/26","亞東",0,2,-2
"9649","6205詮欣","110/08/26","玉山-台大",2,0,2
"9650","6205詮欣","110/08/26","新光-高雄",0,2,-2
"9651","6205詮欣","110/08/26","玉山-大里",2,0,2
"9652","6205詮欣","110/08/26","元大-屏東民生",0,2,-2
"9653","6205詮欣","110/08/26","國泰-板橋",2,0,2
"9654","6205詮欣","110/08/26","元大-仁愛",0,2,-2
"9655","6205詮欣","110/08/26","凱基-高美館",2,0,2
"9656","6205詮欣","110/08/26","永豐金-台南",0,2,-2
"9657","6205詮欣","110/08/26","華南永昌-台中",2,0,2
"9658","6205詮欣","110/08/26","大慶-台南",0,1,-1
"9659","6205詮欣","110/08/26","永豐金-中和",2,0,2
"9660","6205詮欣","110/08/26","新光",0,1,-1
"9661","1540喬福","110/08/26","元大-士林",12,0,12
"9662","1540喬福","110/08/26","富邦-中壢",0,14,-14
"9663","1540喬福","110/08/26","凱基-中壢",5,0,5
"9664","1540喬福","110/08/26","富邦-虎尾",0,13,-13
"9665","1540喬福","110/08/26","富邦-仁愛",5,0,5
"9666","1540喬福","110/08/26","台新-高雄",0,5,-5
"9667","1540喬福","110/08/26","凱基-台北",4,0,4
"9668","1540喬福","110/08/26","日盛-花蓮",0,2,-2
"9669","1540喬福","110/08/26","富邦-建國",3,0,3
"9670","1540喬福","110/08/26","北城證券",0,2,-2
"9671","1540喬福","110/08/26","中國信託",2,0,2
"9672","1540喬福","110/08/26","元大-南屯",0,1,-1
"9673","1540喬福","110/08/26","國泰-忠孝",2,0,2
"9674","1540喬福","110/08/26","凱基-北門",0,1,-1
"9675","1540喬福","110/08/26","群益金鼎-崇德",2,0,2
"9676","1540喬福","110/08/26","統一-員林",0,1,-1
"9677","1540喬福","110/08/26","永豐金-埔里",1,0,1
"9678","1540喬福","110/08/26","美商高盛",0,1,-1
"9679","1540喬福","110/08/26","致和-南京",1,0,1
"9680","1540喬福","110/08/26","美林",0,1,-1
"9681","1540喬福","110/08/26","華南永昌-中正",1,0,1
"9682","1540喬福","110/08/26","康和-板橋",0,0,0
"9683","1540喬福","110/08/26","富邦-台北",1,0,1
"9684","1540喬福","110/08/26","凱基-竹北",0,0,0
"9685","1540喬福","110/08/26","富邦-左營",1,0,1
"9686","1540喬福","110/08/26","高橋",0,0,0
"9687","1540喬福","110/08/26","華南永昌-敦南",0,0,0
"9688","1540喬福","110/08/26","華南永昌-敦南",0,0,0
"9689","1540喬福","110/08/26","元大-金門",0,0,0
"9690","1540喬福","110/08/26","元大-莒光",0,0,0
"9691","2888新光金","110/08/26","瑞士信貸",3038,457,2581
"9692","2888新光金","110/08/26","元富-大昌",7,9389,-9382
"9693","2888新光金","110/08/26","群益金鼎-崇德",1739,0,1739
"9694","2888新光金","110/08/26","元富-城東",37,2318,-2281
"9695","2888新光金","110/08/26","富邦-岡山",1647,23,1624
"9696","2888新光金","110/08/26","永豐金證券",28,1552,-1524
"9697","2888新光金","110/08/26","凱基-台北",3564,2278,1286
"9698","2888新光金","110/08/26","國票-長城",500,2005,-1505
"9699","2888新光金","110/08/26","致和證券",1108,5,1103
"9700","2888新光金","110/08/26","花旗環球",138,1202,-1064
"9701","2888新光金","110/08/26","美林",1537,539,998
"9702","2888新光金","110/08/26","台灣摩根士丹利",55,1026,-971
"9703","2888新光金","110/08/26","群益金鼎-嘉義",903,17,886
"9704","2888新光金","110/08/26","元富",1,799,-798
"9705","2888新光金","110/08/26","大慶-高雄",832,0,832
"9706","2888新光金","110/08/26","元富-世貿",8,776,-768
"9707","2888新光金","110/08/26","永豐金-板橋",820,1,819
"9708","2888新光金","110/08/26","(牛牛牛)亞-鑫豐",34,645,-611
"9709","2888新光金","110/08/26","凱基-桃園",774,15,759
"9710","2888新光金","110/08/26","香港上海匯豐",0,600,-600
"9711","2888新光金","110/08/26","日盛-忠孝",744,10,734
"9712","2888新光金","110/08/26","元大-板橋",37,499,-462
"9713","2888新光金","110/08/26","新光",766,153,613
"9714","2888新光金","110/08/26","港商法國興業",135,568,-433
"9715","2888新光金","110/08/26","合庫-高雄",607,0,607
"9716","2888新光金","110/08/26","元大證券",239,634,-395
"9717","2888新光金","110/08/26","宏遠-桃園",504,0,504
"9718","2888新光金","110/08/26","元富-文心",132,483,-351
"9719","2888新光金","110/08/26","凱基-台南",520,23,497
"9720","2888新光金","110/08/26","元富-成功",19,358,-339
"9721","1340勝悅","110/08/26","元大-基隆孝二",10,0,10
"9722","1340勝悅","110/08/26","元大-新盛",0,16,-16
"9723","1340勝悅","110/08/26","凱基-台北",9,1,8
"9724","1340勝悅","110/08/26","元大-四維",0,11,-11
"9725","1340勝悅","110/08/26","國泰-台中",7,0,7
"9726","1340勝悅","110/08/26","凱基-松山",0,10,-10
"9727","1340勝悅","110/08/26","美林",6,0,6
"9728","1340勝悅","110/08/26","元大-東門",0,10,-10
"9729","1340勝悅","110/08/26","臺灣企銀-埔墘",5,0,5
"9730","1340勝悅","110/08/26","統一-南京",0,8,-8
"9731","1340勝悅","110/08/26","統一-城中",5,1,4
"9732","1340勝悅","110/08/26","國票-台東",0,5,-5
"9733","1340勝悅","110/08/26","群益金鼎-北高雄",4,0,4
"9734","1340勝悅","110/08/26","摩根大通",2,7,-5
"9735","1340勝悅","110/08/26","日盛-鳳山",3,0,3
"9736","1340勝悅","110/08/26","元大-忠孝鼎富",0,5,-5
"9737","1340勝悅","110/08/26","元大-林園",5,2,3
"9738","1340勝悅","110/08/26","港商法國興業",0,2,-2
"9739","1340勝悅","110/08/26","宏遠-桃園",2,0,2
"9740","1340勝悅","110/08/26","兆豐-三民",0,2,-2
"9741","1340勝悅","110/08/26","第一金-華江",2,0,2
"9742","1340勝悅","110/08/26","臺銀",0,1,-1
"9743","1340勝悅","110/08/26","中農",2,0,2
"9744","1340勝悅","110/08/26","中國信託-文心",0,1,-1
"9745","1340勝悅","110/08/26","國泰-敦南",5,3,2
"9746","1340勝悅","110/08/26","凱基",0,1,-1
"9747","1340勝悅","110/08/26","國泰-館前",2,0,2
"9748","1340勝悅","110/08/26","富邦-嘉義",0,1,-1
"9749","1340勝悅","110/08/26","富邦-北港",2,0,2
"9750","1340勝悅","110/08/26","元大-東泰",0,1,-1
"9751","6246臺龍","110/08/26","兆豐-內湖",40,0,40
"9752","6246臺龍","110/08/26","兆豐-忠孝",0,20,-20
"9753","6246臺龍","110/08/26","新光-台中",11,0,11
"9754","6246臺龍","110/08/26","統一-台南",0,15,-15
"9755","6246臺龍","110/08/26","凱基-永康",10,0,10
"9756","6246臺龍","110/08/26","聯邦-大業",0,10,-10
"9757","6246臺龍","110/08/26","元大-屏南",10,0,10
"9758","6246臺龍","110/08/26","港商野村",0,9,-9
"9759","6246臺龍","110/08/26","元富-板橋",5,0,5
"9760","6246臺龍","110/08/26","元大-員林",0,6,-6
"9761","6246臺龍","110/08/26","元大-北港",5,0,5
"9762","6246臺龍","110/08/26","元富-宜蘭",0,5,-5
"9763","6246臺龍","110/08/26","元大-小港",5,0,5
"9764","6246臺龍","110/08/26","永豐金-板橋",0,5,-5
"9765","6246臺龍","110/08/26","兆豐-竹北",4,0,4
"9766","6246臺龍","110/08/26","兆豐-公益",0,4,-4
"9767","6246臺龍","110/08/26","華南永昌-台中",4,0,4
"9768","6246臺龍","110/08/26","兆豐-新營",0,4,-4
"9769","6246臺龍","110/08/26","華南永昌-彰化",3,0,3
"9770","6246臺龍","110/08/26","國票-新莊",0,4,-4
"9771","6246臺龍","110/08/26","元大-大雅",3,0,3
"9772","6246臺龍","110/08/26","玉山證券",0,4,-4
"9773","6246臺龍","110/08/26","土銀-新竹",2,0,2
"9774","6246臺龍","110/08/26","凱基-長庚",0,4,-4
"9775","6246臺龍","110/08/26","日盛-八德",2,0,2
"9776","6246臺龍","110/08/26","永豐金-復興",1,5,-4
"9777","6246臺龍","110/08/26","高橋",2,0,2
"9778","6246臺龍","110/08/26","元大-永康",0,3,-3
"9779","6246臺龍","110/08/26","玉山-台南",2,0,2
"9780","6246臺龍","110/08/26","台新證券",0,2,-2
"9781","00715L期街口布蘭特正2","110/08/26","元大證券",27288,25,27263
"9782","00715L期街口布蘭特正2","110/08/26","宏遠-高雄",0,11055,-11055
"9783","00715L期街口布蘭特正2","110/08/26","永豐金證券",6471,22,6449
"9784","00715L期街口布蘭特正2","110/08/26","元大-萬華",0,2051,-2051
"9785","00715L期街口布蘭特正2","110/08/26","元富",3942,0,3942
"9786","00715L期街口布蘭特正2","110/08/26","(牛牛牛)亞-鑫豐",17,1456,-1439
"9787","00715L期街口布蘭特正2","110/08/26","合庫證券",3500,20,3480
"9788","00715L期街口布蘭特正2","110/08/26","元大-新竹",110,1320,-1210
"9789","00715L期街口布蘭特正2","110/08/26","國票",2138,8,2130
"9790","00715L期街口布蘭特正2","110/08/26","元大-永康",0,1053,-1053
"9791","00715L期街口布蘭特正2","110/08/26","群益金鼎",1740,0,1740
"9792","00715L期街口布蘭特正2","110/08/26","華南永昌-台中",102,827,-725
"9793","00715L期街口布蘭特正2","110/08/26","統一",1396,3,1393
"9794","00715L期街口布蘭特正2","110/08/26","玉山-大里",2,630,-628
"9795","00715L期街口布蘭特正2","110/08/26","台新證券",1085,223,862
"9796","00715L期街口布蘭特正2","110/08/26","華南永昌",0,606,-606
"9797","00715L期街口布蘭特正2","110/08/26","聯邦-三重",550,19,531
"9798","00715L期街口布蘭特正2","110/08/26","新光",179,718,-539
"9799","00715L期街口布蘭特正2","110/08/26","國票-博愛",550,30,520
"9800","00715L期街口布蘭特正2","110/08/26","國泰-敦南",607,1119,-512
"9801","00715L期街口布蘭特正2","110/08/26","富邦證券",562,99,463
"9802","00715L期街口布蘭特正2","110/08/26","元大-大雅",22,524,-502
"9803","00715L期街口布蘭特正2","110/08/26","兆豐證券",600,156,444
"9804","00715L期街口布蘭特正2","110/08/26","玉山-新竹",0,489,-489
"9805","00715L期街口布蘭特正2","110/08/26","凱基-台北",401,129,272
"9806","00715L期街口布蘭特正2","110/08/26","第一金-路竹",5,459,-454
"9807","00715L期街口布蘭特正2","110/08/26","凱基-新豐",208,20,188
"9808","00715L期街口布蘭特正2","110/08/26","富邦-嘉義",0,406,-406
"9809","00715L期街口布蘭特正2","110/08/26","新光-桃園",92,29,63
"9810","00715L期街口布蘭特正2","110/08/26","元大-淡水",1,326,-325
"9811","8941關中","110/08/26","元大-四維",6,0,6
"9812","8941關中","110/08/26","凱基-中山",0,4,-4
"9813","8941關中","110/08/26","玉山證券",4,0,4
"9814","8941關中","110/08/26","富邦-員林",2,6,-4
"9815","8941關中","110/08/26","元富-台中",1,0,1
"9816","8941關中","110/08/26","彰銀-台中",0,1,-1
"9817","8941關中","110/08/26","元大-斗六",1,0,1
"9818","8941關中","110/08/26","第一金-台中",0,1,-1
"9819","8941關中","110/08/26","凱基-高美館",3,3,0
"9820","8941關中","110/08/26","康和-板橋",0,1,-1
"9821","8941關中","110/08/26","元大-金華",3,3,0
"9822","8941關中","110/08/26","元大-桃興",1,2,-1
"9823","8941關中","110/08/26","永豐金-敦北",0,0,0
"9824","8941關中","110/08/26","凱基-高美館",3,3,0
"9825","8941關中","110/08/26","永豐金-萬盛",0,0,0
"9826","8941關中","110/08/26","元大-金華",3,3,0
"9827","8941關中","110/08/26","永豐金-南投",0,0,0
"9828","8941關中","110/08/26","永豐金-敦北",0,0,0
"9829","8941關中","110/08/26","",NA,NA,NA
"9830","8941關中","110/08/26","永豐金-萬盛",0,0,0
"9831","8941關中","110/08/26","",NA,NA,NA
"9832","8941關中","110/08/26","永豐金-南投",0,0,0
"9833","8941關中","110/08/26","",NA,NA,NA
"9834","8941關中","110/08/26","",NA,NA,NA
"9835","8941關中","110/08/26","",NA,NA,NA
"9836","8941關中","110/08/26","",NA,NA,NA
"9837","8941關中","110/08/26","",NA,NA,NA
"9838","8941關中","110/08/26","",NA,NA,NA
"9839","8941關中","110/08/26","",NA,NA,NA
"9840","8941關中","110/08/26","",NA,NA,NA
"9841","8936國統","110/08/26","永豐金-苓雅",106,0,106
"9842","8936國統","110/08/26","元大-蘆洲",0,107,-107
"9843","8936國統","110/08/26","台新-高雄",48,2,46
"9844","8936國統","110/08/26","元富-新興",0,96,-96
"9845","8936國統","110/08/26","元大-天母",43,0,43
"9846","8936國統","110/08/26","康和-嘉義",2,79,-77
"9847","8936國統","110/08/26","光和-溪湖",40,0,40
"9848","8936國統","110/08/26","凱基-台北",1,72,-71
"9849","8936國統","110/08/26","元富-敦南",32,0,32
"9850","8936國統","110/08/26","新光-台中",30,89,-59
"9851","8936國統","110/08/26","中國信託-高雄",31,0,31
"9852","8936國統","110/08/26","國票-台東",0,50,-50
"9853","8936國統","110/08/26","國票-敦北法人",20,0,20
"9854","8936國統","110/08/26","摩根大通",4,39,-35
"9855","8936國統","110/08/26","台灣摩根士丹利",14,0,14
"9856","8936國統","110/08/26","富邦-陽明",0,30,-30
"9857","8936國統","110/08/26","美林",12,0,12
"9858","8936國統","110/08/26","新加坡商瑞銀",23,51,-28
"9859","8936國統","110/08/26","國泰-館前",12,0,12
"9860","8936國統","110/08/26","新光-新竹",5,25,-20
"9861","8936國統","110/08/26","第一金-桃園",11,0,11
"9862","8936國統","110/08/26","永豐金-北高雄",0,15,-15
"9863","8936國統","110/08/26","日盛證券",10,0,10
"9864","8936國統","110/08/26","群益金鼎-彰化",0,12,-12
"9865","8936國統","110/08/26","日盛-北高雄",10,0,10
"9866","8936國統","110/08/26","日盛-忠孝",0,10,-10
"9867","8936國統","110/08/26","統一-台中",10,0,10
"9868","8936國統","110/08/26","中國信託-松江",0,10,-10
"9869","8936國統","110/08/26","兆豐-竹北",10,0,10
"9870","8936國統","110/08/26","富邦-三重",0,10,-10
"9871","6226光鼎","110/08/26","大展-台南",235,14,221
"9872","6226光鼎","110/08/26","摩根大通",0,1105,-1105
"9873","6226光鼎","110/08/26","宏遠-光隆",186,32,154
"9874","6226光鼎","110/08/26","台灣摩根士丹利",12,742,-730
"9875","6226光鼎","110/08/26","兆豐-松德",145,0,145
"9876","6226光鼎","110/08/26","元大-大同",6,557,-551
"9877","6226光鼎","110/08/26","凱基-台北",204,67,137
"9878","6226光鼎","110/08/26","統一",13,410,-397
"9879","6226光鼎","110/08/26","合庫-台中",127,13,114
"9880","6226光鼎","110/08/26","凱基-永和",10,305,-295
"9881","6226光鼎","110/08/26","元大-敦化",97,0,97
"9882","6226光鼎","110/08/26","港商野村",193,480,-287
"9883","6226光鼎","110/08/26","中國信託-忠孝",97,13,84
"9884","6226光鼎","110/08/26","美商高盛",48,329,-281
"9885","6226光鼎","110/08/26","國泰-敦南",354,272,82
"9886","6226光鼎","110/08/26","美林",73,274,-201
"9887","6226光鼎","110/08/26","臺銀-鳳山",84,12,72
"9888","6226光鼎","110/08/26","統一-南京",5,205,-200
"9889","6226光鼎","110/08/26","元大-木柵",80,12,68
"9890","6226光鼎","110/08/26","富邦證券",0,95,-95
"9891","6226光鼎","110/08/26","富邦-台北",73,6,67
"9892","6226光鼎","110/08/26","凱基-大直",110,187,-77
"9893","6226光鼎","110/08/26","永豐金-苓雅",67,0,67
"9894","6226光鼎","110/08/26","元大-四維",61,135,-74
"9895","6226光鼎","110/08/26","元大-大雅",184,127,57
"9896","6226光鼎","110/08/26","群益金鼎-鳳山",2,61,-59
"9897","6226光鼎","110/08/26","玉山-板橋",55,0,55
"9898","6226光鼎","110/08/26","富邦-建國",18,74,-56
"9899","6226光鼎","110/08/26","元大-仁愛",55,0,55
"9900","6226光鼎","110/08/26","永豐金-虎尾",1,50,-49
"9901","2363矽統","110/08/26","美林",676,159,517
"9902","2363矽統","110/08/26","凱基-台北",1056,1726,-670
"9903","2363矽統","110/08/26","合庫-基隆",1381,1003,378
"9904","2363矽統","110/08/26","宏遠-光隆",18,368,-350
"9905","2363矽統","110/08/26","富邦-彰化",380,25,355
"9906","2363矽統","110/08/26","台新-台南",56,248,-192
"9907","2363矽統","110/08/26","第一金-桃園",311,12,299
"9908","2363矽統","110/08/26","日盛-南京",34,170,-136
"9909","2363矽統","110/08/26","華南永昌-台中",349,81,268
"9910","2363矽統","110/08/26","北城證券",206,329,-123
"9911","2363矽統","110/08/26","新光",480,249,231
"9912","2363矽統","110/08/26","光和-嘉義",20,137,-117
"9913","2363矽統","110/08/26","瑞士信貸",198,3,195
"9914","2363矽統","110/08/26","統一-城中",75,189,-114
"9915","2363矽統","110/08/26","元大-前金",160,31,129
"9916","2363矽統","110/08/26","華南永昌-朴子",28,131,-103
"9917","2363矽統","110/08/26","元大-博愛",157,31,126
"9918","2363矽統","110/08/26","康和-嘉義",3,101,-98
"9919","2363矽統","110/08/26","凱基-嘉義",90,6,84
"9920","2363矽統","110/08/26","凱基-中山",8,105,-97
"9921","2363矽統","110/08/26","玉山-桃園",104,24,80
"9922","2363矽統","110/08/26","台新-台中",29,118,-89
"9923","2363矽統","110/08/26","元大-和平",80,13,67
"9924","2363矽統","110/08/26","凱基-大直",30,108,-78
"9925","2363矽統","110/08/26","第一金-嘉義",71,11,60
"9926","2363矽統","110/08/26","亞東-板橋",17,89,-72
"9927","2363矽統","110/08/26","新光-桃園",163,105,58
"9928","2363矽統","110/08/26","國泰-板橋",93,164,-71
"9929","2363矽統","110/08/26","元大-左營",68,13,55
"9930","2363矽統","110/08/26","統一-永和",2,62,-60
"9931","8112至上","110/08/26","凱基-台北",372,56,316
"9932","8112至上","110/08/26","群益金鼎",0,150,-150
"9933","8112至上","110/08/26","摩根大通",376,62,314
"9934","8112至上","110/08/26","台新-台中",10,113,-103
"9935","8112至上","110/08/26","凱基-竹科",151,1,150
"9936","8112至上","110/08/26","群益金鼎-基隆",0,90,-90
"9937","8112至上","110/08/26","新加坡商瑞銀",191,45,146
"9938","8112至上","110/08/26","永豐金-台中",1,80,-79
"9939","8112至上","110/08/26","台灣摩根士丹利",129,41,88
"9940","8112至上","110/08/26","凱基-東勢",0,50,-50
"9941","8112至上","110/08/26","美商高盛",172,92,80
"9942","8112至上","110/08/26","凱基-北門",0,50,-50
"9943","8112至上","110/08/26","日進",69,3,66
"9944","8112至上","110/08/26","元大-西門",0,50,-50
"9945","8112至上","110/08/26","兆豐-西螺",60,0,60
"9946","8112至上","110/08/26","群益金鼎-高雄",0,40,-40
"9947","8112至上","110/08/26","港商野村",63,24,39
"9948","8112至上","110/08/26","元富-新莊",0,31,-31
"9949","8112至上","110/08/26","元大-竹東",30,0,30
"9950","8112至上","110/08/26","日盛-復興",1,31,-30
"9951","8112至上","110/08/26","元大-淡水",30,2,28
"9952","8112至上","110/08/26","統一-南京",0,30,-30
"9953","8112至上","110/08/26","康和",30,5,25
"9954","8112至上","110/08/26","凱基-士林",1,31,-30
"9955","8112至上","110/08/26","凱基-三重",22,0,22
"9956","8112至上","110/08/26","元大-佳里",0,30,-30
"9957","8112至上","110/08/26","元大-楊梅",20,1,19
"9958","8112至上","110/08/26","台灣企銀-民雄",0,27,-27
"9959","8112至上","110/08/26","元大-豐原",20,2,18
"9960","8112至上","110/08/26","日盛-台南",0,27,-27
"9961","1570力肯","110/08/26","群益金鼎-高雄",34,0,34
"9962","1570力肯","110/08/26","永豐金-虎尾",0,50,-50
"9963","1570力肯","110/08/26","香港上海匯豐",21,0,21
"9964","1570力肯","110/08/26","富邦-高雄",0,38,-38
"9965","1570力肯","110/08/26","凱基-台北",9,1,8
"9966","1570力肯","110/08/26","華南永昌-麻豆",0,14,-14
"9967","1570力肯","110/08/26","國票-台中",7,0,7
"9968","1570力肯","110/08/26","摩根大通",0,11,-11
"9969","1570力肯","110/08/26","美林",6,0,6
"9970","1570力肯","110/08/26","凱基-復興",0,7,-7
"9971","1570力肯","110/08/26","群益金鼎-瑞豐",6,0,6
"9972","1570力肯","110/08/26","元大-基隆孝二",0,7,-7
"9973","1570力肯","110/08/26","日茂-南投",5,0,5
"9974","1570力肯","110/08/26","國票-博愛",2,8,-6
"9975","1570力肯","110/08/26","兆豐-鹿港",5,0,5
"9976","1570力肯","110/08/26","元富-城東",0,5,-5
"9977","1570力肯","110/08/26","兆豐-松德",5,0,5
"9978","1570力肯","110/08/26","兆豐-中壢",0,4,-4
"9979","1570力肯","110/08/26","國票-和平",5,0,5
"9980","1570力肯","110/08/26","華南永昌-大安",0,4,-4
"9981","1570力肯","110/08/26","凱基-站前",5,0,5
"9982","1570力肯","110/08/26","統一-三重",0,3,-3
"9983","1570力肯","110/08/26","元大-新竹經國",5,0,5
"9984","1570力肯","110/08/26","統一-員林",0,2,-2
"9985","1570力肯","110/08/26","元大-草屯",4,0,4
"9986","1570力肯","110/08/26","凱基-天母",0,2,-2
"9987","1570力肯","110/08/26","(牛牛牛)亞-鑫豐",3,0,3
"9988","1570力肯","110/08/26","元大-大里",0,2,-2
"9989","1570力肯","110/08/26","國票-北高雄",4,1,3
"9990","1570力肯","110/08/26","大慶-富順",0,1,-1
"9991","2929淘帝","110/08/26","新光-新竹",47,0,47
"9992","2929淘帝","110/08/26","元大-豐原站前",0,20,-20
"9993","2929淘帝","110/08/26","摩根大通",20,0,20
"9994","2929淘帝","110/08/26","康和-仁愛",0,17,-17
"9995","2929淘帝","110/08/26","兆豐-民生",10,0,10
"9996","2929淘帝","110/08/26","新光-台中",16,32,-16
"9997","2929淘帝","110/08/26","元大-承德",10,0,10
"9998","2929淘帝","110/08/26","港商野村",3,15,-12
"9999","2929淘帝","110/08/26","元大-萬華",10,0,10
"10000","2929淘帝","110/08/26","合庫-自強",0,10,-10
"10001","2929淘帝","110/08/26","日盛-和美",5,0,5
"10002","2929淘帝","110/08/26","美林",3,12,-9
"10003","2929淘帝","110/08/26","台中銀-豐原",5,0,5
"10004","2929淘帝","110/08/26","富邦-南屯",1,10,-9
"10005","2929淘帝","110/08/26","國泰-敦南",5,0,5
"10006","2929淘帝","110/08/26","元富-花蓮",0,8,-8
"10007","2929淘帝","110/08/26","元大-大雅",5,0,5
"10008","2929淘帝","110/08/26","富邦-高雄",0,8,-8
"10009","2929淘帝","110/08/26","元大-蘆洲",5,0,5
"10010","2929淘帝","110/08/26","華南永昌-古亭",0,5,-5
"10011","2929淘帝","110/08/26","富邦-內湖",4,0,4
"10012","2929淘帝","110/08/26","港商法國興業",0,4,-4
"10013","2929淘帝","110/08/26","元大-太平",4,0,4
"10014","2929淘帝","110/08/26","新加坡商瑞銀",0,4,-4
"10015","2929淘帝","110/08/26","新光-台南",3,0,3
"10016","2929淘帝","110/08/26","第一金-台南",0,4,-4
"10017","2929淘帝","110/08/26","陽信",3,0,3
"10018","2929淘帝","110/08/26","凱基-長庚",0,4,-4
"10019","2929淘帝","110/08/26","國泰-板橋",3,0,3
"10020","2929淘帝","110/08/26","元大-新竹經國",0,4,-4
"10021","5410國眾","110/08/26","香港上海匯豐",34,0,34
"10022","5410國眾","110/08/26","高橋",0,20,-20
"10023","5410國眾","110/08/26","凱基-台北",34,1,33
"10024","5410國眾","110/08/26","寶盛",0,10,-10
"10025","5410國眾","110/08/26","玉山-高雄",15,0,15
"10026","5410國眾","110/08/26","安泰",0,10,-10
"10027","5410國眾","110/08/26","富邦-內湖",10,0,10
"10028","5410國眾","110/08/26","國泰-敦南",0,10,-10
"10029","5410國眾","110/08/26","元大-中壢",7,0,7
"10030","5410國眾","110/08/26","國泰-台南",0,9,-9
"10031","5410國眾","110/08/26","元大-內湖",7,0,7
"10032","5410國眾","110/08/26","玉山-雙和",0,7,-7
"10033","5410國眾","110/08/26","康和-新竹",6,0,6
"10034","5410國眾","110/08/26","元大-金華",0,7,-7
"10035","5410國眾","110/08/26","摩根大通",5,0,5
"10036","5410國眾","110/08/26","台新-建北",0,6,-6
"10037","5410國眾","110/08/26","凱基-長庚",5,0,5
"10038","5410國眾","110/08/26","元大-羅東",0,6,-6
"10039","5410國眾","110/08/26","元大-向上",5,0,5
"10040","5410國眾","110/08/26","合庫-嘉義",0,5,-5
"10041","5410國眾","110/08/26","元大-南屯",5,0,5
"10042","5410國眾","110/08/26","新光",1,6,-5
"10043","5410國眾","110/08/26","華南永昌-林口",4,0,4
"10044","5410國眾","110/08/26","富邦-台北",0,5,-5
"10045","5410國眾","110/08/26","台新-中壢",3,0,3
"10046","5410國眾","110/08/26","元大-土城",0,5,-5
"10047","5410國眾","110/08/26","華南永昌-內壢",3,0,3
"10048","5410國眾","110/08/26","臺銀-臺中",0,3,-3
"10049","5410國眾","110/08/26","元大-北投",2,0,2
"10050","5410國眾","110/08/26","第一金-澎湖",0,3,-3
"10051","2841台開","110/08/26","宏遠-館前",180,0,180
"10052","2841台開","110/08/26","台中銀",0,50,-50
"10053","2841台開","110/08/26","元富-新興",25,0,25
"10054","2841台開","110/08/26","港商野村",0,35,-35
"10055","2841台開","110/08/26","永豐金-敦南",23,12,11
"10056","2841台開","110/08/26","台新-屏東",0,21,-21
"10057","2841台開","110/08/26","康和-內湖",8,0,8
"10058","2841台開","110/08/26","新加坡商瑞銀",0,20,-20
"10059","2841台開","110/08/26","永豐金-古亭",6,0,6
"10060","2841台開","110/08/26","新光-新竹",0,20,-20
"10061","2841台開","110/08/26","台新-新營",5,0,5
"10062","2841台開","110/08/26","元大-彰化民生",0,18,-18
"10063","2841台開","110/08/26","玉山證券",5,0,5
"10064","2841台開","110/08/26","台灣摩根士丹利",0,12,-12
"10065","2841台開","110/08/26","元大-板橋",4,0,4
"10066","2841台開","110/08/26","日盛-頭份",0,11,-11
"10067","2841台開","110/08/26","國泰-敦南",3,0,3
"10068","2841台開","110/08/26","華南永昌-虎尾",0,10,-10
"10069","2841台開","110/08/26","日盛-和美",2,0,2
"10070","2841台開","110/08/26","元大-承德",0,10,-10
"10071","2841台開","110/08/26","台新-台南",2,0,2
"10072","2841台開","110/08/26","元大-北三重",0,10,-10
"10073","2841台開","110/08/26","凱基-台北",5,3,2
"10074","2841台開","110/08/26","富邦-宜蘭",0,7,-7
"10075","2841台開","110/08/26","合庫-自強",1,0,1
"10076","2841台開","110/08/26","華南永昌-岡山",0,5,-5
"10077","2841台開","110/08/26","元富-板橋",1,0,1
"10078","2841台開","110/08/26","富邦-中壢",0,5,-5
"10079","2841台開","110/08/26","群益金鼎-崇德",1,0,1
"10080","2841台開","110/08/26","日盛-二林",0,4,-4
"10081","6207雷科","110/08/26","凱基-台北",21,0,21
"10082","6207雷科","110/08/26","新加坡商瑞銀",1,63,-62
"10083","6207雷科","110/08/26","統一-竹南",18,0,18
"10084","6207雷科","110/08/26","凱基-高美館",5,32,-27
"10085","6207雷科","110/08/26","凱基-台東",15,0,15
"10086","6207雷科","110/08/26","第一金-華江",0,11,-11
"10087","6207雷科","110/08/26","元大-六合",12,0,12
"10088","6207雷科","110/08/26","國泰-板橋",0,11,-11
"10089","6207雷科","110/08/26","元大-大灣",10,0,10
"10090","6207雷科","110/08/26","港商野村",10,20,-10
"10091","6207雷科","110/08/26","瑞士信貸",7,0,7
"10092","6207雷科","110/08/26","國票-中正",0,10,-10
"10093","6207雷科","110/08/26","亞東-台南",7,0,7
"10094","6207雷科","110/08/26","永豐金-內湖",0,10,-10
"10095","6207雷科","110/08/26","寶盛",6,0,6
"10096","6207雷科","110/08/26","中國信託-高雄",0,9,-9
"10097","6207雷科","110/08/26","永豐金-板新",6,0,6
"10098","6207雷科","110/08/26","元大-大同",0,8,-8
"10099","6207雷科","110/08/26","日盛-員林",22,17,5
"10100","6207雷科","110/08/26","合庫-台中",0,5,-5
"10101","6207雷科","110/08/26","第一金-高雄",5,0,5
"10102","6207雷科","110/08/26","第一金-中山",0,5,-5
"10103","6207雷科","110/08/26","第一金-路竹",5,0,5
"10104","6207雷科","110/08/26","德信-和平",0,5,-5
"10105","6207雷科","110/08/26","兆豐-三民",5,0,5
"10106","6207雷科","110/08/26","群益金鼎-忠孝",0,5,-5
"10107","6207雷科","110/08/26","國票-新莊",5,0,5
"10108","6207雷科","110/08/26","凱基-長庚",0,5,-5
"10109","6207雷科","110/08/26","群益金鼎-高盛",5,0,5
"10110","6207雷科","110/08/26","華南永昌-林口",0,5,-5
"10111","3679新至陞","110/08/26","永豐金-南投",13,0,13
"10112","3679新至陞","110/08/26","凱基-台北",0,11,-11
"10113","3679新至陞","110/08/26","元大-大天母",10,0,10
"10114","3679新至陞","110/08/26","摩根大通",0,10,-10
"10115","3679新至陞","110/08/26","玉山-台大",6,0,6
"10116","3679新至陞","110/08/26","美林",0,9,-9
"10117","3679新至陞","110/08/26","台灣摩根士丹利",3,2,1
"10118","3679新至陞","110/08/26","瑞士信貸",0,5,-5
"10119","3679新至陞","110/08/26","亞東-板橋",1,0,1
"10120","3679新至陞","110/08/26","華南永昌-嘉義",0,4,-4
"10121","3679新至陞","110/08/26","統一-桃園",1,0,1
"10122","3679新至陞","110/08/26","元大-福營",0,3,-3
"10123","3679新至陞","110/08/26","元富-埔里",1,0,1
"10124","3679新至陞","110/08/26","花旗環球",0,1,-1
"10125","3679新至陞","110/08/26","台中銀-員林",1,0,1
"10126","3679新至陞","110/08/26","新加坡商瑞銀",0,1,-1
"10127","3679新至陞","110/08/26","兆豐-來福",1,0,1
"10128","3679新至陞","110/08/26","中國信託-永康",0,1,-1
"10129","3679新至陞","110/08/26","兆豐-松德",1,0,1
"10130","3679新至陞","110/08/26","國票-中和",0,1,-1
"10131","3679新至陞","110/08/26","玉山-高雄",2,1,1
"10132","3679新至陞","110/08/26","香港上海匯豐",0,1,-1
"10133","3679新至陞","110/08/26","凱基-桃園",1,0,1
"10134","3679新至陞","110/08/26","富邦-建國",0,1,-1
"10135","3679新至陞","110/08/26","凱基-幸福",1,0,1
"10136","3679新至陞","110/08/26","富邦-新店",1,2,-1
"10137","3679新至陞","110/08/26","凱基-城中",1,0,1
"10138","3679新至陞","110/08/26","元大-永春",0,1,-1
"10139","3679新至陞","110/08/26","華南永昌-大安",1,0,1
"10140","3679新至陞","110/08/26","永豐金證券",0,1,-1
"10141","2727王品","110/08/26","瑞士信貸",54,0,54
"10142","2727王品","110/08/26","凱基-台北",11,70,-59
"10143","2727王品","110/08/26","元大-桃園",26,0,26
"10144","2727王品","110/08/26","永豐金證券",0,48,-48
"10145","2727王品","110/08/26","兆豐-北高雄",32,7,25
"10146","2727王品","110/08/26","華南永昌-鳳山",0,36,-36
"10147","2727王品","110/08/26","台新證券",29,8,21
"10148","2727王品","110/08/26","元大-彰化民生",1,35,-34
"10149","2727王品","110/08/26","康和-澎湖",20,0,20
"10150","2727王品","110/08/26","摩根大通",13,46,-33
"10151","2727王品","110/08/26","台灣摩根士丹利",54,35,19
"10152","2727王品","110/08/26","元大證券",25,57,-32
"10153","2727王品","110/08/26","(牛牛牛)亞-鑫豐",18,2,16
"10154","2727王品","110/08/26","彰銀-台中",1,30,-29
"10155","2727王品","110/08/26","元大-中壢",16,1,15
"10156","2727王品","110/08/26","國泰證券",0,19,-19
"10157","2727王品","110/08/26","華南永昌",13,1,12
"10158","2727王品","110/08/26","富邦-建國",2,21,-19
"10159","2727王品","110/08/26","永豐金-萬盛",12,0,12
"10160","2727王品","110/08/26","美林",5,19,-14
"10161","2727王品","110/08/26","新光-台中",14,3,11
"10162","2727王品","110/08/26","統一",0,14,-14
"10163","2727王品","110/08/26","新光",19,9,10
"10164","2727王品","110/08/26","國票-內壢",1,14,-13
"10165","2727王品","110/08/26","國泰-台南",12,3,9
"10166","2727王品","110/08/26","台灣企銀",0,12,-12
"10167","2727王品","110/08/26","元大-景美",9,1,8
"10168","2727王品","110/08/26","康和-高雄",0,10,-10
"10169","2727王品","110/08/26","國泰-敦南",20,13,7
"10170","2727王品","110/08/26","統一-松江",0,8,-8
"10171","1570力肯","110/08/26","群益金鼎-高雄",34,0,34
"10172","1570力肯","110/08/26","永豐金-虎尾",0,50,-50
"10173","1570力肯","110/08/26","香港上海匯豐",21,0,21
"10174","1570力肯","110/08/26","富邦-高雄",0,38,-38
"10175","1570力肯","110/08/26","凱基-台北",9,1,8
"10176","1570力肯","110/08/26","華南永昌-麻豆",0,14,-14
"10177","1570力肯","110/08/26","國票-台中",7,0,7
"10178","1570力肯","110/08/26","摩根大通",0,11,-11
"10179","1570力肯","110/08/26","美林",6,0,6
"10180","1570力肯","110/08/26","凱基-復興",0,7,-7
"10181","1570力肯","110/08/26","群益金鼎-瑞豐",6,0,6
"10182","1570力肯","110/08/26","元大-基隆孝二",0,7,-7
"10183","1570力肯","110/08/26","日茂-南投",5,0,5
"10184","1570力肯","110/08/26","國票-博愛",2,8,-6
"10185","1570力肯","110/08/26","兆豐-鹿港",5,0,5
"10186","1570力肯","110/08/26","元富-城東",0,5,-5
"10187","1570力肯","110/08/26","兆豐-松德",5,0,5
"10188","1570力肯","110/08/26","兆豐-中壢",0,4,-4
"10189","1570力肯","110/08/26","國票-和平",5,0,5
"10190","1570力肯","110/08/26","華南永昌-大安",0,4,-4
"10191","1570力肯","110/08/26","凱基-站前",5,0,5
"10192","1570力肯","110/08/26","統一-三重",0,3,-3
"10193","1570力肯","110/08/26","元大-新竹經國",5,0,5
"10194","1570力肯","110/08/26","統一-員林",0,2,-2
"10195","1570力肯","110/08/26","元大-草屯",4,0,4
"10196","1570力肯","110/08/26","凱基-天母",0,2,-2
"10197","1570力肯","110/08/26","(牛牛牛)亞-鑫豐",3,0,3
"10198","1570力肯","110/08/26","元大-大里",0,2,-2
"10199","1570力肯","110/08/26","國票-北高雄",4,1,3
"10200","1570力肯","110/08/26","大慶-富順",0,1,-1
"10201","6180橘子","110/08/26","港商野村",126,2,124
"10202","6180橘子","110/08/26","國票-南港",0,71,-71
"10203","6180橘子","110/08/26","美林",29,0,29
"10204","6180橘子","110/08/26","新加坡商瑞銀",0,31,-31
"10205","6180橘子","110/08/26","國泰-敦南",19,1,18
"10206","6180橘子","110/08/26","大慶-富順",0,22,-22
"10207","6180橘子","110/08/26","日盛-文化",15,0,15
"10208","6180橘子","110/08/26","摩根大通",28,47,-19
"10209","6180橘子","110/08/26","美商高盛",26,11,15
"10210","6180橘子","110/08/26","華南永昌-公誠",1,20,-19
"10211","6180橘子","110/08/26","高橋",15,0,15
"10212","6180橘子","110/08/26","元大-台中中港",1,17,-16
"10213","6180橘子","110/08/26","新光-台中",14,0,14
"10214","6180橘子","110/08/26","新光",5,20,-15
"10215","6180橘子","110/08/26","日盛-中壢",13,0,13
"10216","6180橘子","110/08/26","國泰-高雄",1,16,-15
"10217","6180橘子","110/08/26","富邦-新營",13,0,13
"10218","6180橘子","110/08/26","凱基-台北",263,277,-14
"10219","6180橘子","110/08/26","永豐金-松山",14,1,13
"10220","6180橘子","110/08/26","元大-天母",0,14,-14
"10221","6180橘子","110/08/26","日盛-花蓮",10,0,10
"10222","6180橘子","110/08/26","元大-草屯",0,13,-13
"10223","6180橘子","110/08/26","第一金-光復",14,4,10
"10224","6180橘子","110/08/26","富隆-長安",0,12,-12
"10225","6180橘子","110/08/26","台新-高雄",10,0,10
"10226","6180橘子","110/08/26","凱基-站前",0,12,-12
"10227","6180橘子","110/08/26","玉山-高雄",12,2,10
"10228","6180橘子","110/08/26","元大-北成功",0,12,-12
"10229","6180橘子","110/08/26","凱基-高雄",10,0,10
"10230","6180橘子","110/08/26","合庫-新竹",2,12,-10
"10231","2390云辰","110/08/26","統一-新台中",134,19,115
"10232","2390云辰","110/08/26","元大證券",22,150,-128
"10233","2390云辰","110/08/26","元大-松山",82,0,82
"10234","2390云辰","110/08/26","摩根大通",18,141,-123
"10235","2390云辰","110/08/26","國泰-桃園",78,7,71
"10236","2390云辰","110/08/26","凱基-湖口",6,101,-95
"10237","2390云辰","110/08/26","元大-土城學府",121,63,58
"10238","2390云辰","110/08/26","元大-前金",3,82,-79
"10239","2390云辰","110/08/26","台新-左楠",47,0,47
"10240","2390云辰","110/08/26","康和-石牌",3,53,-50
"10241","2390云辰","110/08/26","玉山-板橋",45,1,44
"10242","2390云辰","110/08/26","港商野村",348,393,-45
"10243","2390云辰","110/08/26","國票-嘉義",40,0,40
"10244","2390云辰","110/08/26","凱基-大直",0,45,-45
"10245","2390云辰","110/08/26","凱基-台北",142,106,36
"10246","2390云辰","110/08/26","新加坡商瑞銀",4,48,-44
"10247","2390云辰","110/08/26","群益金鼎-民權",33,0,33
"10248","2390云辰","110/08/26","永豐金-敦北",1,40,-39
"10249","2390云辰","110/08/26","富邦-三重",33,1,32
"10250","2390云辰","110/08/26","大慶-富順",7,40,-33
"10251","2390云辰","110/08/26","富邦-中壢",35,8,27
"10252","2390云辰","110/08/26","元大-豐原",3,36,-33
"10253","2390云辰","110/08/26","玉山-嘉義",29,3,26
"10254","2390云辰","110/08/26","日盛-和美",0,30,-30
"10255","2390云辰","110/08/26","高橋-中壢",25,0,25
"10256","2390云辰","110/08/26","宏遠證券",0,30,-30
"10257","2390云辰","110/08/26","國泰-板橋",44,19,25
"10258","2390云辰","110/08/26","元大-士林",4,34,-30
"10259","2390云辰","110/08/26","富邦-陽明",43,18,25
"10260","2390云辰","110/08/26","台灣摩根士丹利",5,34,-29
"10261","1315達新","110/08/25","凱基-中港",7,0,7
"10262","1315達新","110/08/25","群益金鼎-東湖",0,9,-9
"10263","1315達新","110/08/25","富邦-台中",7,0,7
"10264","1315達新","110/08/25","永豐金證券",0,8,-8
"10265","1315達新","110/08/25","台灣摩根士丹利",4,0,4
"10266","1315達新","110/08/25","群益金鼎-瑞豐",0,3,-3
"10267","1315達新","110/08/25","元大-歸仁",2,0,2
"10268","1315達新","110/08/25","元富-世貿",0,2,-2
"10269","1315達新","110/08/25","元大-南屯",2,0,2
"10270","1315達新","110/08/25","元富-花蓮",0,2,-2
"10271","1315達新","110/08/25","永豐金-中正",2,0,2
"10272","1315達新","110/08/25","元大-文心興安",0,2,-2
"10273","1315達新","110/08/25","統一-城中",1,0,1
"10274","1315達新","110/08/25","宏遠-館前",0,1,-1
"10275","1315達新","110/08/25","統一-三重",1,0,1
"10276","1315達新","110/08/25","統一-敦南",0,1,-1
"10277","1315達新","110/08/25","德信-中正",1,0,1
"10278","1315達新","110/08/25","元富-文心",0,1,-1
"10279","1315達新","110/08/25","玉山-新莊",1,0,1
"10280","1315達新","110/08/25","兆豐-嘉義",0,1,-1
"10281","1315達新","110/08/25","國泰-台南",1,0,1
"10282","1315達新","110/08/25","凱基-市政",0,1,-1
"10283","1315達新","110/08/25","群益金鼎-建成",1,0,1
"10284","1315達新","110/08/25","元大-開元",0,1,-1
"10285","1315達新","110/08/25","群益金鼎-鳳山",1,0,1
"10286","1315達新","110/08/25","元大-東蘆",0,1,-1
"10287","1315達新","110/08/25","凱基",1,0,1
"10288","1315達新","110/08/25","元大-桃園",0,1,-1
"10289","1315達新","110/08/25","凱基-台北",1,0,1
"10290","1315達新","110/08/25","元大-北投",0,1,-1
"10291","2609陽明","110/08/25","康和",4817,1130,3687
"10292","2609陽明","110/08/25","富邦證券",20,1499,-1479
"10293","2609陽明","110/08/25","富邦-虎尾",5954,3739,2215
"10294","2609陽明","110/08/25","華南永昌-虎尾",60,1507,-1447
"10295","2609陽明","110/08/25","台灣摩根士丹利",2126,25,2101
"10296","2609陽明","110/08/25","華南永昌-竹北",35,1362,-1327
"10297","2609陽明","110/08/25","凱基-台北",2778,942,1836
"10298","2609陽明","110/08/25","富邦-建國",327,1397,-1070
"10299","2609陽明","110/08/25","兆豐-虎尾",5704,4355,1349
"10300","2609陽明","110/08/25","群益金鼎-大安",177,815,-638
"10301","2609陽明","110/08/25","元大-開元",1090,150,940
"10302","2609陽明","110/08/25","永豐金-松山",135,646,-511
"10303","2609陽明","110/08/25","新加坡商瑞銀",1582,730,852
"10304","2609陽明","110/08/25","華南永昌-長虹",344,810,-466
"10305","2609陽明","110/08/25","統一-仁愛",961,139,822
"10306","2609陽明","110/08/25","新光",1804,2222,-418
"10307","2609陽明","110/08/25","瑞士信貸",1307,553,754
"10308","2609陽明","110/08/25","合庫-桃園",48,447,-399
"10309","2609陽明","110/08/25","美林",4574,3894,680
"10310","2609陽明","110/08/25","元大-雙和",203,536,-333
"10311","2609陽明","110/08/25","國票-彰化",685,112,573
"10312","2609陽明","110/08/25","永豐金證券",145,468,-323
"10313","2609陽明","110/08/25","摩根大通",4654,4103,551
"10314","2609陽明","110/08/25","兆豐-板橋",88,398,-310
"10315","2609陽明","110/08/25","日盛-板橋",648,186,462
"10316","2609陽明","110/08/25","群益金鼎-敦南",98,346,-248
"10317","2609陽明","110/08/25","兆豐-彰化",904,448,456
"10318","2609陽明","110/08/25","國泰-敦南",1686,1916,-230
"10319","2609陽明","110/08/25","兆豐-中壢",425,15,410
"10320","2609陽明","110/08/25","元大-佳里",54,271,-217
"10321","2636台驊投控","110/08/25","凱基-台北",791,245,546
"10322","2636台驊投控","110/08/25","日進",10,242,-232
"10323","2636台驊投控","110/08/25","美商高盛",508,168,340
"10324","2636台驊投控","110/08/25","兆豐-中壢",0,209,-209
"10325","2636台驊投控","110/08/25","國票-彰化",292,29,263
"10326","2636台驊投控","110/08/25","元大-松江",3,68,-65
"10327","2636台驊投控","110/08/25","美林",331,117,214
"10328","2636台驊投控","110/08/25","國泰-敦南",61,106,-45
"10329","2636台驊投控","110/08/25","摩根大通",424,213,211
"10330","2636台驊投控","110/08/25","富邦-嘉義",10,55,-45
"10331","2636台驊投控","110/08/25","港商野村",852,674,178
"10332","2636台驊投控","110/08/25","群益金鼎-大安",2,43,-41
"10333","2636台驊投控","110/08/25","台灣摩根士丹利",205,89,116
"10334","2636台驊投控","110/08/25","元大-林森",45,84,-39
"10335","2636台驊投控","110/08/25","瑞士信貸",148,86,62
"10336","2636台驊投控","110/08/25","華南永昌-合泰",0,36,-36
"10337","2636台驊投控","110/08/25","元大-士林",43,0,43
"10338","2636台驊投控","110/08/25","富邦-建國",17,52,-35
"10339","2636台驊投控","110/08/25","宏遠-台南",37,3,34
"10340","2636台驊投控","110/08/25","兆豐-城中",1,31,-30
"10341","2636台驊投控","110/08/25","永豐金-萬盛",38,4,34
"10342","2636台驊投控","110/08/25","新光-台中",33,62,-29
"10343","2636台驊投控","110/08/25","凱基-鳳山",32,2,30
"10344","2636台驊投控","110/08/25","台新-台中",13,40,-27
"10345","2636台驊投控","110/08/25","元大-桃園",29,1,28
"10346","2636台驊投控","110/08/25","玉山證券",20,47,-27
"10347","2636台驊投控","110/08/25","新加坡商瑞銀",58,33,25
"10348","2636台驊投控","110/08/25","永豐金-天母",3,30,-27
"10349","2636台驊投控","110/08/25","兆豐-三民",21,0,21
"10350","2636台驊投控","110/08/25","元大-成功",2,24,-22
"10351","2867三商壽","110/08/25","華南永昌-大安",201,0,201
"10352","2867三商壽","110/08/25","元大-北投",0,384,-384
"10353","2867三商壽","110/08/25","元大-竹科",140,0,140
"10354","2867三商壽","110/08/25","摩根大通",78,315,-237
"10355","2867三商壽","110/08/25","美林",174,50,124
"10356","2867三商壽","110/08/25","國泰證券",0,150,-150
"10357","2867三商壽","110/08/25","凱基-台北",125,26,99
"10358","2867三商壽","110/08/25","土銀-台中",0,120,-120
"10359","2867三商壽","110/08/25","瑞士信貸",98,0,98
"10360","2867三商壽","110/08/25","台灣摩根士丹利",0,120,-120
"10361","2867三商壽","110/08/25","兆豐-新營",70,0,70
"10362","2867三商壽","110/08/25","日盛-員林",0,99,-99
"10363","2867三商壽","110/08/25","兆豐-永和",64,0,64
"10364","2867三商壽","110/08/25","兆豐-斗南",0,40,-40
"10365","2867三商壽","110/08/25","群益金鼎-大甲",47,4,43
"10366","2867三商壽","110/08/25","中國信託-永康",0,35,-35
"10367","2867三商壽","110/08/25","群益金鼎-東門",40,0,40
"10368","2867三商壽","110/08/25","群益金鼎-屏東",0,32,-32
"10369","2867三商壽","110/08/25","元大-沙鹿",40,0,40
"10370","2867三商壽","110/08/25","群益金鼎-彰化",2,32,-30
"10371","2867三商壽","110/08/25","國泰-板橋",40,1,39
"10372","2867三商壽","110/08/25","元大-基隆孝二",0,30,-30
"10373","2867三商壽","110/08/25","元大-桃園",36,0,36
"10374","2867三商壽","110/08/25","元大-四維",0,25,-25
"10375","2867三商壽","110/08/25","合庫-基隆",30,0,30
"10376","2867三商壽","110/08/25","國票-北高雄",0,20,-20
"10377","2867三商壽","110/08/25","凱基",26,0,26
"10378","2867三商壽","110/08/25","華南永昌-南京",0,20,-20
"10379","2867三商壽","110/08/25","兆豐-台南",25,0,25
"10380","2867三商壽","110/08/25","宏遠-台中",0,16,-16
"10381","5521工信","110/08/25","凱基-台北",112,46,66
"10382","5521工信","110/08/25","兆豐-桃園",0,207,-207
"10383","5521工信","110/08/25","元大證券",66,0,66
"10384","5521工信","110/08/25","台灣摩根士丹利",1,206,-205
"10385","5521工信","110/08/25","元大-大統",42,0,42
"10386","5521工信","110/08/25","華南永昌-朴子",10,53,-43
"10387","5521工信","110/08/25","元大-南屯",40,0,40
"10388","5521工信","110/08/25","美林",0,35,-35
"10389","5521工信","110/08/25","華南永昌",38,0,38
"10390","5521工信","110/08/25","國泰-板橋",0,34,-34
"10391","5521工信","110/08/25","合庫-台南",30,0,30
"10392","5521工信","110/08/25","豐農",0,30,-30
"10393","5521工信","110/08/25","高橋-內壢",30,0,30
"10394","5521工信","110/08/25","富邦-新竹",0,21,-21
"10395","5521工信","110/08/25","摩根大通",121,91,30
"10396","5521工信","110/08/25","群益金鼎-萬華",0,20,-20
"10397","5521工信","110/08/25","台新-左楠",28,0,28
"10398","5521工信","110/08/25","元大-基隆孝二",0,20,-20
"10399","5521工信","110/08/25","日盛-斗六",26,0,26
"10400","5521工信","110/08/25","凱基-斗六",2,20,-18
"10401","5521工信","110/08/25","元大-東蘆",21,0,21
"10402","5521工信","110/08/25","富邦-陽明",0,16,-16
"10403","5521工信","110/08/25","第一金-新竹",21,3,18
"10404","5521工信","110/08/25","港商野村",0,13,-13
"10405","5521工信","110/08/25","玉山-新莊",16,0,16
"10406","5521工信","110/08/25","群益金鼎-館前",0,11,-11
"10407","5521工信","110/08/25","元大-北投",15,0,15
"10408","5521工信","110/08/25","土銀-高雄",0,10,-10
"10409","5521工信","110/08/25","凱基-台東",15,1,14
"10410","5521工信","110/08/25","統一",0,10,-10
"10411","1471首利","110/08/25","元大-敦化",86,0,86
"10412","1471首利","110/08/25","元大-清水",0,111,-111
"10413","1471首利","110/08/25","凱基-台北",46,0,46
"10414","1471首利","110/08/25","群益金鼎-東大",0,78,-78
"10415","1471首利","110/08/25","美林",34,0,34
"10416","1471首利","110/08/25","新光",0,39,-39
"10417","1471首利","110/08/25","摩根大通",53,26,27
"10418","1471首利","110/08/25","國票-北高雄",0,25,-25
"10419","1471首利","110/08/25","凱基-五股",25,0,25
"10420","1471首利","110/08/25","富邦-高雄",0,15,-15
"10421","1471首利","110/08/25","日盛-樹林",20,0,20
"10422","1471首利","110/08/25","兆豐-員林",0,14,-14
"10423","1471首利","110/08/25","瑞士信貸",20,0,20
"10424","1471首利","110/08/25","元大-土城永寧",0,13,-13
"10425","1471首利","110/08/25","元大-莒光",21,5,16
"10426","1471首利","110/08/25","盈溢-楠梓",0,11,-11
"10427","1471首利","110/08/25","統一-新台中",15,0,15
"10428","1471首利","110/08/25","元大-大里",0,11,-11
"10429","1471首利","110/08/25","永豐金-敦南",15,0,15
"10430","1471首利","110/08/25","日盛-高雄",5,15,-10
"10431","1471首利","110/08/25","光和-溪湖",13,0,13
"10432","1471首利","110/08/25","凱基-竹科",0,10,-10
"10433","1471首利","110/08/25","日盛-屏東",10,0,10
"10434","1471首利","110/08/25","元大-斗信",0,10,-10
"10435","1471首利","110/08/25","兆豐-高雄",10,0,10
"10436","1471首利","110/08/25","第一金-台南",1,10,-9
"10437","1471首利","110/08/25","中農",10,0,10
"10438","1471首利","110/08/25","台灣企銀-太平",0,8,-8
"10439","1471首利","110/08/25","華南永昌-合泰",10,0,10
"10440","1471首利","110/08/25","新光-台中",5,12,-7
"10441","2883開發金","110/08/25","凱基",4004,0,4004
"10442","2883開發金","110/08/25","摩根大通",106,4873,-4767
"10443","2883開發金","110/08/25","群益金鼎",2728,3,2725
"10444","2883開發金","110/08/25","瑞士信貸",1180,3777,-2597
"10445","2883開發金","110/08/25","美林",2122,57,2065
"10446","2883開發金","110/08/25","元大-開元",29,2542,-2513
"10447","2883開發金","110/08/25","凱基-台北",2581,555,2026
"10448","2883開發金","110/08/25","聯邦商銀",1,1900,-1899
"10449","2883開發金","110/08/25","富邦-建國",2069,82,1987
"10450","2883開發金","110/08/25","台灣摩根士丹利",3322,4605,-1283
"10451","2883開發金","110/08/25","中國信託",3132,1528,1604
"10452","2883開發金","110/08/25","元大-忠孝",10,1219,-1209
"10453","2883開發金","110/08/25","兆豐-北高雄",1657,83,1574
"10454","2883開發金","110/08/25","香港上海匯豐",0,1001,-1001
"10455","2883開發金","110/08/25","統一",1311,107,1204
"10456","2883開發金","110/08/25","新光",1050,1828,-778
"10457","2883開發金","110/08/25","永豐金-南京",1030,3,1027
"10458","2883開發金","110/08/25","港商野村",1304,2000,-696
"10459","2883開發金","110/08/25","美商高盛",1733,815,918
"10460","2883開發金","110/08/25","元富",314,1002,-688
"10461","2883開發金","110/08/25","台灣匯立證券",638,0,638
"10462","2883開發金","110/08/25","國泰-敦南",289,975,-686
"10463","2883開發金","110/08/25","合庫-台中",608,38,570
"10464","2883開發金","110/08/25","新光-台南",23,521,-498
"10465","2883開發金","110/08/25","臺銀",1016,450,566
"10466","2883開發金","110/08/25","合庫證券",19,461,-442
"10467","2883開發金","110/08/25","元大-豐原",556,25,531
"10468","2883開發金","110/08/25","(牛牛牛)亞-鑫豐",134,538,-404
"10469","2883開發金","110/08/25","台中銀-員林",501,13,488
"10470","2883開發金","110/08/25","元大-士林",8,385,-377
"10471","6205詮欣","110/08/25","日盛-新莊",12,2,10
"10472","6205詮欣","110/08/25","日盛-樹林",0,12,-12
"10473","6205詮欣","110/08/25","康和-台北",10,0,10
"10474","6205詮欣","110/08/25","臺銀-民權",0,10,-10
"10475","6205詮欣","110/08/25","臺銀-臺中",9,0,9
"10476","6205詮欣","110/08/25","元大-博愛",20,30,-10
"10477","6205詮欣","110/08/25","瑞士信貸",10,2,8
"10478","6205詮欣","110/08/25","元大-羅東",0,8,-8
"10479","6205詮欣","110/08/25","摩根大通",17,10,7
"10480","6205詮欣","110/08/25","元富-三重",0,6,-6
"10481","6205詮欣","110/08/25","凱基-台南",6,0,6
"10482","6205詮欣","110/08/25","群益金鼎-永和",0,5,-5
"10483","6205詮欣","110/08/25","玉山證券",5,0,5
"10484","6205詮欣","110/08/25","元大-館前",0,5,-5
"10485","6205詮欣","110/08/25","元大-東泰",5,0,5
"10486","6205詮欣","110/08/25","凱基-汐止",0,4,-4
"10487","6205詮欣","110/08/25","元富-潮州",4,0,4
"10488","6205詮欣","110/08/25","元大-大益",0,4,-4
"10489","6205詮欣","110/08/25","大慶-泰山",3,0,3
"10490","6205詮欣","110/08/25","永豐金證券",0,4,-4
"10491","6205詮欣","110/08/25","亞東-台南",2,0,2
"10492","6205詮欣","110/08/25","永豐金-台南",0,4,-4
"10493","6205詮欣","110/08/25","兆豐-台南",2,0,2
"10494","6205詮欣","110/08/25","台灣企銀-九如",0,3,-3
"10495","6205詮欣","110/08/25","兆豐-公益",2,0,2
"10496","6205詮欣","110/08/25","兆豐-景美",0,3,-3
"10497","6205詮欣","110/08/25","凱基-松山",2,0,2
"10498","6205詮欣","110/08/25","北城證券",0,3,-3
"10499","6205詮欣","110/08/25","凱基-台北",2,0,2
"10500","6205詮欣","110/08/25","元大-忠孝",0,3,-3
"10501","1540喬福","110/08/25","元大-士林",8,0,8
"10502","1540喬福","110/08/25","摩根大通",0,13,-13
"10503","1540喬福","110/08/25","元富-文心",5,0,5
"10504","1540喬福","110/08/25","永豐金-永康",0,6,-6
"10505","1540喬福","110/08/25","凱基-台北",4,0,4
"10506","1540喬福","110/08/25","群益金鼎-丹鳳",0,5,-5
"10507","1540喬福","110/08/25","元大-土城永寧",2,0,2
"10508","1540喬福","110/08/25","合庫-鳳山",0,1,-1
"10509","1540喬福","110/08/25","元大-頭份",2,0,2
"10510","1540喬福","110/08/25","美商高盛",0,1,-1
"10511","1540喬福","110/08/25","兆豐-北高雄",2,0,2
"10512","1540喬福","110/08/25","中國信託-忠孝",0,1,-1
"10513","1540喬福","110/08/25","凱基-中壢",2,0,2
"10514","1540喬福","110/08/25","致和-南京",0,1,-1
"10515","1540喬福","110/08/25","美林",1,0,1
"10516","1540喬福","110/08/25","富邦-仁愛",0,1,-1
"10517","1540喬福","110/08/25","永豐金-中正",1,0,1
"10518","1540喬福","110/08/25","元大-大里德芳",0,1,-1
"10519","1540喬福","110/08/25","元大-文心興安",1,0,1
"10520","1540喬福","110/08/25","元大-左營",0,1,-1
"10521","1540喬福","110/08/25","華南永昌-公誠",1,0,1
"10522","1540喬福","110/08/25","元大-汐止",0,1,-1
"10523","1540喬福","110/08/25","大昌-新店",1,0,1
"10524","1540喬福","110/08/25","日盛-內湖",0,0,0
"10525","1540喬福","110/08/25","元富-大昌",1,0,1
"10526","1540喬福","110/08/25","(牛牛牛)亞-網路",0,0,0
"10527","1540喬福","110/08/25","元富",1,0,1
"10528","1540喬福","110/08/25","康和-板橋",0,0,0
"10529","1540喬福","110/08/25","凱基-竹北",0,0,0
"10530","1540喬福","110/08/25","凱基-竹北",0,0,0
"10531","2888新光金","110/08/25","統一",11078,277,10801
"10532","2888新光金","110/08/25","元富-城東",162,17808,-17646
"10533","2888新光金","110/08/25","元大-忠孝鼎富",10200,0,10200
"10534","2888新光金","110/08/25","康和-台中",45,10015,-9970
"10535","2888新光金","110/08/25","華南永昌-岡山",9944,105,9839
"10536","2888新光金","110/08/25","第一金-華江",266,9839,-9573
"10537","2888新光金","110/08/25","日盛證券",8935,66,8869
"10538","2888新光金","110/08/25","元富-新店",37,2975,-2938
"10539","2888新光金","110/08/25","瑞士信貸",8347,1175,7172
"10540","2888新光金","110/08/25","元富-世貿",332,3270,-2938
"10541","2888新光金","110/08/25","富邦-岡山",5039,52,4987
"10542","2888新光金","110/08/25","元富-新興",31,2160,-2129
"10543","2888新光金","110/08/25","國票-九鼎",4662,102,4560
"10544","2888新光金","110/08/25","元富-敦南",19,2135,-2116
"10545","2888新光金","110/08/25","國票-長城",4288,5,4283
"10546","2888新光金","110/08/25","元富",7,2039,-2032
"10547","2888新光金","110/08/25","國票-北高雄",2515,38,2477
"10548","2888新光金","110/08/25","元富-成功",184,2095,-1911
"10549","2888新光金","110/08/25","新光",2800,661,2139
"10550","2888新光金","110/08/25","元富-板橋",65,1967,-1902
"10551","2888新光金","110/08/25","統一-板橋",1762,10,1752
"10552","2888新光金","110/08/25","彰銀",0,1865,-1865
"10553","2888新光金","110/08/25","玉山-板橋",1714,21,1693
"10554","2888新光金","110/08/25","元富-文心",159,1916,-1757
"10555","2888新光金","110/08/25","美商高盛",2345,739,1606
"10556","2888新光金","110/08/25","元富-吉利",45,1701,-1656
"10557","2888新光金","110/08/25","國票-博愛",1264,4,1260
"10558","2888新光金","110/08/25","元富-花蓮",13,1602,-1589
"10559","2888新光金","110/08/25","富邦-中壢",1278,95,1183
"10560","2888新光金","110/08/25","凱基-台北",1875,3353,-1478
"10561","1340勝悅","110/08/25","凱基-台北",13,0,13
"10562","1340勝悅","110/08/25","日盛-永康",0,10,-10
"10563","1340勝悅","110/08/25","華南永昌-公誠",10,0,10
"10564","1340勝悅","110/08/25","元大-忠孝鼎富",0,10,-10
"10565","1340勝悅","110/08/25","臺灣企銀-埔墘",5,0,5
"10566","1340勝悅","110/08/25","華南永昌-東昇",0,9,-9
"10567","1340勝悅","110/08/25","美商高盛",3,0,3
"10568","1340勝悅","110/08/25","摩根大通",1,9,-8
"10569","1340勝悅","110/08/25","元大-仁愛",3,0,3
"10570","1340勝悅","110/08/25","華南永昌-林口",0,6,-6
"10571","1340勝悅","110/08/25","永豐金-永康",3,0,3
"10572","1340勝悅","110/08/25","兆豐-新營",0,5,-5
"10573","1340勝悅","110/08/25","國泰-敦南",3,1,2
"10574","1340勝悅","110/08/25","富邦-羅東",0,3,-3
"10575","1340勝悅","110/08/25","富邦-北港",2,0,2
"10576","1340勝悅","110/08/25","元大-竹山",0,3,-3
"10577","1340勝悅","110/08/25","元大-南勢角",2,0,2
"10578","1340勝悅","110/08/25","元大-復北",0,3,-3
"10579","1340勝悅","110/08/25","合庫-台中",1,0,1
"10580","1340勝悅","110/08/25","元大-嘉義",0,3,-3
"10581","1340勝悅","110/08/25","日盛-新莊",1,0,1
"10582","1340勝悅","110/08/25","元大-草屯",0,2,-2
"10583","1340勝悅","110/08/25","日盛-頭份",1,0,1
"10584","1340勝悅","110/08/25","國票-和平",0,1,-1
"10585","1340勝悅","110/08/25","國泰-台中",6,5,1
"10586","1340勝悅","110/08/25","新光",0,1,-1
"10587","1340勝悅","110/08/25","國泰-台南",1,0,1
"10588","1340勝悅","110/08/25","群益金鼎-高盛",0,1,-1
"10589","1340勝悅","110/08/25","元大-竹東",1,0,1
"10590","1340勝悅","110/08/25","元大-新竹經國",0,1,-1
"10591","6246臺龍","110/08/25","統一-台南",15,0,15
"10592","6246臺龍","110/08/25","日盛-斗六",0,9,-9
"10593","6246臺龍","110/08/25","新光-台中",7,0,7
"10594","6246臺龍","110/08/25","新光-高雄",0,5,-5
"10595","6246臺龍","110/08/25","永豐金-嘉義",4,0,4
"10596","6246臺龍","110/08/25","光和-高雄",0,3,-3
"10597","6246臺龍","110/08/25","台新證券",4,1,3
"10598","6246臺龍","110/08/25","永全",0,3,-3
"10599","6246臺龍","110/08/25","凱基-竹科",3,0,3
"10600","6246臺龍","110/08/25","國泰-敦南",0,3,-3
"10601","6246臺龍","110/08/25","統一-中壢",2,0,2
"10602","6246臺龍","110/08/25","元大-員林",4,7,-3
"10603","6246臺龍","110/08/25","兆豐-竹北",2,0,2
"10604","6246臺龍","110/08/25","元大-小港",0,3,-3
"10605","6246臺龍","110/08/25","兆豐-景美",2,0,2
"10606","6246臺龍","110/08/25","土銀-花蓮",0,2,-2
"10607","6246臺龍","110/08/25","元大-內湖",4,2,2
"10608","6246臺龍","110/08/25","日盛-文化",0,2,-2
"10609","6246臺龍","110/08/25","元大-北屯",2,0,2
"10610","6246臺龍","110/08/25","統一-新竹",0,2,-2
"10611","6246臺龍","110/08/25","日盛-中壢",1,0,1
"10612","6246臺龍","110/08/25","台新-台南",0,2,-2
"10613","6246臺龍","110/08/25","日盛-八德",1,0,1
"10614","6246臺龍","110/08/25","國泰-板橋",0,2,-2
"10615","6246臺龍","110/08/25","日盛-新竹",1,0,1
"10616","6246臺龍","110/08/25","富邦-竹東",0,2,-2
"10617","6246臺龍","110/08/25","日盛-宜蘭",1,0,1
"10618","6246臺龍","110/08/25","合庫-西台中",0,1,-1
"10619","6246臺龍","110/08/25","日盛-頭份",1,0,1
"10620","6246臺龍","110/08/25","日盛-新莊",0,1,-1
"10621","00715L期街口布蘭特正2","110/08/25","元大證券",19583,546,19037
"10622","00715L期街口布蘭特正2","110/08/25","第一金-豐原",0,1000,-1000
"10623","00715L期街口布蘭特正2","110/08/25","合庫證券",4367,15,4352
"10624","00715L期街口布蘭特正2","110/08/25","新光",311,1182,-871
"10625","00715L期街口布蘭特正2","110/08/25","永豐金證券",3240,15,3225
"10626","00715L期街口布蘭特正2","110/08/25","兆豐-台中",0,798,-798
"10627","00715L期街口布蘭特正2","110/08/25","元富",3115,0,3115
"10628","00715L期街口布蘭特正2","110/08/25","玉山-新莊",2,634,-632
"10629","00715L期街口布蘭特正2","110/08/25","統一",2701,40,2661
"10630","00715L期街口布蘭特正2","110/08/25","元富-中壢",22,630,-608
"10631","00715L期街口布蘭特正2","110/08/25","第一金-台中",800,2,798
"10632","00715L期街口布蘭特正2","110/08/25","玉山-板橋",1,563,-562
"10633","00715L期街口布蘭特正2","110/08/25","聯邦-三重",750,10,740
"10634","00715L期街口布蘭特正2","110/08/25","華南永昌-台中",105,642,-537
"10635","00715L期街口布蘭特正2","110/08/25","富邦證券",945,420,525
"10636","00715L期街口布蘭特正2","110/08/25","(牛牛牛)亞-鑫豐",31,557,-526
"10637","00715L期街口布蘭特正2","110/08/25","元大-三重",500,3,497
"10638","00715L期街口布蘭特正2","110/08/25","玉山-新竹",0,508,-508
"10639","00715L期街口布蘭特正2","110/08/25","台新證券",955,537,418
"10640","00715L期街口布蘭特正2","110/08/25","新光-台中",52,556,-504
"10641","00715L期街口布蘭特正2","110/08/25","國票-博愛",260,0,260
"10642","00715L期街口布蘭特正2","110/08/25","富邦-陽明",2,475,-473
"10643","00715L期街口布蘭特正2","110/08/25","元大-蘆洲",262,15,247
"10644","00715L期街口布蘭特正2","110/08/25","中國信託-新竹",0,455,-455
"10645","00715L期街口布蘭特正2","110/08/25","台新-台中",390,161,229
"10646","00715L期街口布蘭特正2","110/08/25","群益金鼎-宜蘭",1,448,-447
"10647","00715L期街口布蘭特正2","110/08/25","康和-嘉義",250,36,214
"10648","00715L期街口布蘭特正2","110/08/25","臺銀-新竹",34,435,-401
"10649","00715L期街口布蘭特正2","110/08/25","凱基-站前",245,36,209
"10650","00715L期街口布蘭特正2","110/08/25","第一金-台南",1,400,-399
"10651","8941關中","110/08/25","國泰-新莊",2,0,2
"10652","8941關中","110/08/25","富邦-左營",0,1,-1
"10653","8941關中","110/08/25","(牛牛牛)亞-鑫豐",0,0,0
"10654","8941關中","110/08/25","富邦-員林",0,1,-1
"10655","8941關中","110/08/25","康和-板橋",0,0,0
"10656","8941關中","110/08/25","(牛牛牛)亞-鑫豐",0,0,0
"10657","8941關中","110/08/25","凱基-板橋",0,0,0
"10658","8941關中","110/08/25","康和-板橋",0,0,0
"10659","8941關中","110/08/25","富邦-竹北",0,0,0
"10660","8941關中","110/08/25","凱基-板橋",0,0,0
"10661","8941關中","110/08/25","元大-花蓮",0,0,0
"10662","8941關中","110/08/25","富邦-竹北",0,0,0
"10663","8941關中","110/08/25","元大-土城",0,0,0
"10664","8941關中","110/08/25","元大-花蓮",0,0,0
"10665","8941關中","110/08/25","永豐金-萬盛",0,0,0
"10666","8941關中","110/08/25","元大-土城",0,0,0
"10667","8941關中","110/08/25","永豐金-南投",0,0,0
"10668","8941關中","110/08/25","永豐金-萬盛",0,0,0
"10669","8941關中","110/08/25","",NA,NA,NA
"10670","8941關中","110/08/25","永豐金-南投",0,0,0
"10671","8941關中","110/08/25","",NA,NA,NA
"10672","8941關中","110/08/25","",NA,NA,NA
"10673","8941關中","110/08/25","",NA,NA,NA
"10674","8941關中","110/08/25","",NA,NA,NA
"10675","8941關中","110/08/25","",NA,NA,NA
"10676","8941關中","110/08/25","",NA,NA,NA
"10677","8941關中","110/08/25","",NA,NA,NA
"10678","8941關中","110/08/25","",NA,NA,NA
"10679","8941關中","110/08/25","",NA,NA,NA
"10680","8941關中","110/08/25","",NA,NA,NA
"10681","8936國統","110/08/25","台灣摩根士丹利",132,11,121
"10682","8936國統","110/08/25","第一金-高雄",1,100,-99
"10683","8936國統","110/08/25","元富-新興",96,0,96
"10684","8936國統","110/08/25","美商高盛",1,63,-62
"10685","8936國統","110/08/25","瑞士信貸",74,0,74
"10686","8936國統","110/08/25","元大-蘆洲",0,50,-50
"10687","8936國統","110/08/25","摩根大通",113,52,61
"10688","8936國統","110/08/25","凱基-市政",0,35,-35
"10689","8936國統","110/08/25","永豐金-松山",50,0,50
"10690","8936國統","110/08/25","元大-北港",0,31,-31
"10691","8936國統","110/08/25","凱基-台北",84,52,32
"10692","8936國統","110/08/25","港商野村",4,26,-22
"10693","8936國統","110/08/25","新光",66,36,30
"10694","8936國統","110/08/25","日盛-豐原",0,20,-20
"10695","8936國統","110/08/25","新光-台中",50,24,26
"10696","8936國統","110/08/25","元大-鳳山",0,19,-19
"10697","8936國統","110/08/25","凱基-信義",20,0,20
"10698","8936國統","110/08/25","新加坡商瑞銀",27,45,-18
"10699","8936國統","110/08/25","永豐金-苓雅",20,0,20
"10700","8936國統","110/08/25","群益金鼎-嘉義",0,16,-16
"10701","8936國統","110/08/25","元大-天母",49,30,19
"10702","8936國統","110/08/25","凱基-林口",0,15,-15
"10703","8936國統","110/08/25","華南永昌",21,3,18
"10704","8936國統","110/08/25","台新-高雄",2,16,-14
"10705","8936國統","110/08/25","日盛-板橋",23,7,16
"10706","8936國統","110/08/25","國票-內壢",0,13,-13
"10707","8936國統","110/08/25","元富-敦南",15,0,15
"10708","8936國統","110/08/25","元富-三重",0,12,-12
"10709","8936國統","110/08/25","群益金鼎-古亭",15,0,15
"10710","8936國統","110/08/25","元富-緯城",5,17,-12
"10711","6226光鼎","110/08/25","摩根大通",1583,220,1363
"10712","6226光鼎","110/08/25","瑞士信貸",30,229,-199
"10713","6226光鼎","110/08/25","統一",1723,948,775
"10714","6226光鼎","110/08/25","國泰-敦南",442,580,-138
"10715","6226光鼎","110/08/25","元大-大同",1456,903,553
"10716","6226光鼎","110/08/25","台新-中壢",5,141,-136
"10717","6226光鼎","110/08/25","港商野村",688,373,315
"10718","6226光鼎","110/08/25","宏遠-光隆",22,137,-115
"10719","6226光鼎","110/08/25","凱基-永和",505,200,305
"10720","6226光鼎","110/08/25","元大-虎尾",5,96,-91
"10721","6226光鼎","110/08/25","統一-南京",303,106,197
"10722","6226光鼎","110/08/25","新加坡商瑞銀",49,134,-85
"10723","6226光鼎","110/08/25","美商高盛",243,76,167
"10724","6226光鼎","110/08/25","元大-板橋",2,83,-81
"10725","6226光鼎","110/08/25","台灣摩根士丹利",142,0,142
"10726","6226光鼎","110/08/25","玉山-桃園",46,126,-80
"10727","6226光鼎","110/08/25","兆豐-松德",145,46,99
"10728","6226光鼎","110/08/25","富邦-台北",27,101,-74
"10729","6226光鼎","110/08/25","玉山-城中",115,19,96
"10730","6226光鼎","110/08/25","兆豐-埔墘",0,67,-67
"10731","6226光鼎","110/08/25","富邦證券",148,53,95
"10732","6226光鼎","110/08/25","凱基-台北",51,113,-62
"10733","6226光鼎","110/08/25","富邦-建國",206,126,80
"10734","6226光鼎","110/08/25","台新-高雄",45,101,-56
"10735","6226光鼎","110/08/25","凱基-大直",81,2,79
"10736","6226光鼎","110/08/25","華南永昌-麻豆",5,61,-56
"10737","6226光鼎","110/08/25","元大-四維",149,71,78
"10738","6226光鼎","110/08/25","凱基-內埔",0,52,-52
"10739","6226光鼎","110/08/25","大展-台南",75,0,75
"10740","6226光鼎","110/08/25","日盛-復興",58,109,-51
"10741","2363矽統","110/08/25","合庫-基隆",894,406,488
"10742","2363矽統","110/08/25","元大-萬華",51,751,-700
"10743","2363矽統","110/08/25","瑞士信貸",448,0,448
"10744","2363矽統","110/08/25","美商高盛",260,879,-619
"10745","2363矽統","110/08/25","華南永昌-林口",256,17,239
"10746","2363矽統","110/08/25","凱基-台北",1409,1709,-300
"10747","2363矽統","110/08/25","元大-東泰",360,132,228
"10748","2363矽統","110/08/25","美林",337,633,-296
"10749","2363矽統","110/08/25","元大-員林中山",246,46,200
"10750","2363矽統","110/08/25","摩根大通",712,999,-287
"10751","2363矽統","110/08/25","富邦-新店",246,104,142
"10752","2363矽統","110/08/25","新加坡商瑞銀",671,900,-229
"10753","2363矽統","110/08/25","統一-城中",173,37,136
"10754","2363矽統","110/08/25","大昌-桃園",138,342,-204
"10755","2363矽統","110/08/25","富邦-板橋",196,72,124
"10756","2363矽統","110/08/25","中國信託-忠孝",134,313,-179
"10757","2363矽統","110/08/25","土銀-士林",100,0,100
"10758","2363矽統","110/08/25","元大-淡水",23,201,-178
"10759","2363矽統","110/08/25","新光",427,328,99
"10760","2363矽統","110/08/25","富邦-苗栗",215,356,-141
"10761","2363矽統","110/08/25","元大-員林",121,22,99
"10762","2363矽統","110/08/25","北城證券",23,144,-121
"10763","2363矽統","110/08/25","凱基-台中",107,11,96
"10764","2363矽統","110/08/25","新光-台中",92,210,-118
"10765","2363矽統","110/08/25","富邦-北港",212,117,95
"10766","2363矽統","110/08/25","永豐金-天母",17,132,-115
"10767","2363矽統","110/08/25","統一-高雄",110,18,92
"10768","2363矽統","110/08/25","日盛-台南",256,356,-100
"10769","2363矽統","110/08/25","凱基-苗栗",91,1,90
"10770","2363矽統","110/08/25","元大-大同",22,118,-96
"10771","8112至上","110/08/25","台灣匯立證券",237,0,237
"10772","8112至上","110/08/25","群益金鼎-基隆",1,95,-94
"10773","8112至上","110/08/25","摩根大通",283,173,110
"10774","8112至上","110/08/25","元大-路竹",2,74,-72
"10775","8112至上","110/08/25","第一金-桃園",96,0,96
"10776","8112至上","110/08/25","台灣摩根士丹利",1,61,-60
"10777","8112至上","110/08/25","凱基-台北",126,33,93
"10778","8112至上","110/08/25","永豐金-台中",2,55,-53
"10779","8112至上","110/08/25","國票-南京",80,0,80
"10780","8112至上","110/08/25","(牛牛牛)亞-鑫豐",5,49,-44
"10781","8112至上","110/08/25","瑞士信貸",78,1,77
"10782","8112至上","110/08/25","群益金鼎-高盛",0,43,-43
"10783","8112至上","110/08/25","富邦-仁愛",110,35,75
"10784","8112至上","110/08/25","永豐金-永康",3,46,-43
"10785","8112至上","110/08/25","群益金鼎-敦南",72,0,72
"10786","8112至上","110/08/25","日盛-花蓮",0,40,-40
"10787","8112至上","110/08/25","新加坡商瑞銀",63,9,54
"10788","8112至上","110/08/25","凱基-東勢",0,35,-35
"10789","8112至上","110/08/25","華南永昌-南京",50,0,50
"10790","8112至上","110/08/25","元大-仁愛",0,34,-34
"10791","8112至上","110/08/25","港商野村",45,2,43
"10792","8112至上","110/08/25","台新-台中",0,31,-31
"10793","8112至上","110/08/25","元大-新竹經國",34,3,31
"10794","8112至上","110/08/25","元大-佳里",0,31,-31
"10795","8112至上","110/08/25","康和-仁愛",30,0,30
"10796","8112至上","110/08/25","兆豐-西螺",10,40,-30
"10797","8112至上","110/08/25","凱基-士林",30,0,30
"10798","8112至上","110/08/25","元大-楊梅",0,30,-30
"10799","8112至上","110/08/25","元大-永和",25,0,25
"10800","8112至上","110/08/25","永豐金證券",0,28,-28
"10801","1570力肯","110/08/25","永豐金-虎尾",52,0,52
"10802","1570力肯","110/08/25","元大-竹山",0,14,-14
"10803","1570力肯","110/08/25","國票-南科",26,0,26
"10804","1570力肯","110/08/25","日盛-忠孝",0,12,-12
"10805","1570力肯","110/08/25","凱基-台北",22,3,19
"10806","1570力肯","110/08/25","凱基-高美館",0,10,-10
"10807","1570力肯","110/08/25","日茂-南投",17,0,17
"10808","1570力肯","110/08/25","元富-緯城",3,12,-9
"10809","1570力肯","110/08/25","兆豐-台中港",12,0,12
"10810","1570力肯","110/08/25","(牛牛牛)亞-鑫豐",2,11,-9
"10811","1570力肯","110/08/25","合庫-嘉義",10,0,10
"10812","1570力肯","110/08/25","元大-鳳山",0,8,-8
"10813","1570力肯","110/08/25","凱基-復興",10,0,10
"10814","1570力肯","110/08/25","台灣摩根士丹利",0,7,-7
"10815","1570力肯","110/08/25","國票-博愛",16,7,9
"10816","1570力肯","110/08/25","兆豐-中壢",0,6,-6
"10817","1570力肯","110/08/25","香港上海匯豐",9,0,9
"10818","1570力肯","110/08/25","國票",0,6,-6
"10819","1570力肯","110/08/25","瑞士信貸",8,0,8
"10820","1570力肯","110/08/25","國票-天祥",0,6,-6
"10821","1570力肯","110/08/25","富邦-高雄",8,0,8
"10822","1570力肯","110/08/25","群益金鼎-桃園",0,6,-6
"10823","1570力肯","110/08/25","摩根大通",12,9,3
"10824","1570力肯","110/08/25","華南永昌-大安",0,6,-6
"10825","1570力肯","110/08/25","新光-新竹",3,0,3
"10826","1570力肯","110/08/25","永豐金-桃園",0,6,-6
"10827","1570力肯","110/08/25","群益金鼎-民權",3,0,3
"10828","1570力肯","110/08/25","兆豐-松德",0,5,-5
"10829","1570力肯","110/08/25","富邦-建國",5,2,3
"10830","1570力肯","110/08/25","群益金鼎-鳳山",0,5,-5
"10831","2929淘帝","110/08/25","摩根大通",64,0,64
"10832","2929淘帝","110/08/25","康和-仁愛",0,44,-44
"10833","2929淘帝","110/08/25","港商野村",37,8,29
"10834","2929淘帝","110/08/25","新光-台中",20,43,-23
"10835","2929淘帝","110/08/25","新加坡商瑞銀",36,12,24
"10836","2929淘帝","110/08/25","台新-台中",0,11,-11
"10837","2929淘帝","110/08/25","美林",29,6,23
"10838","2929淘帝","110/08/25","日盛-中壢",0,10,-10
"10839","2929淘帝","110/08/25","群益金鼎-三重",21,0,21
"10840","2929淘帝","110/08/25","日盛-中和",0,10,-10
"10841","2929淘帝","110/08/25","元大-豐原站前",20,0,20
"10842","2929淘帝","110/08/25","兆豐-忠孝",0,10,-10
"10843","2929淘帝","110/08/25","富邦-高雄",20,2,18
"10844","2929淘帝","110/08/25","華南永昌-台中",0,10,-10
"10845","2929淘帝","110/08/25","日盛-台中",16,0,16
"10846","2929淘帝","110/08/25","華南永昌-麻豆",0,10,-10
"10847","2929淘帝","110/08/25","新光-新竹",17,4,13
"10848","2929淘帝","110/08/25","富邦-陽明",0,10,-10
"10849","2929淘帝","110/08/25","凱基-豐中",13,0,13
"10850","2929淘帝","110/08/25","新光",1,9,-8
"10851","2929淘帝","110/08/25","元富-花蓮",10,0,10
"10852","2929淘帝","110/08/25","元大-大里",0,8,-8
"10853","2929淘帝","110/08/25","元富-板橋",8,0,8
"10854","2929淘帝","110/08/25","永豐金-市政",0,8,-8
"10855","2929淘帝","110/08/25","元大-太平",7,0,7
"10856","2929淘帝","110/08/25","合庫-台中",0,7,-7
"10857","2929淘帝","110/08/25","元大-永和",6,0,6
"10858","2929淘帝","110/08/25","元大-文心",0,7,-7
"10859","2929淘帝","110/08/25","日盛-八德",6,1,5
"10860","2929淘帝","110/08/25","日盛-員林",4,10,-6
"10861","5410國眾","110/08/25","華南永昌-高雄",23,0,23
"10862","5410國眾","110/08/25","元大-崇德",0,30,-30
"10863","5410國眾","110/08/25","香港上海匯豐",12,0,12
"10864","5410國眾","110/08/25","日盛-木柵",0,20,-20
"10865","5410國眾","110/08/25","永豐金-內湖",6,0,6
"10866","5410國眾","110/08/25","大展",0,5,-5
"10867","5410國眾","110/08/25","土銀",5,0,5
"10868","5410國眾","110/08/25","國泰-敦南",0,5,-5
"10869","5410國眾","110/08/25","日盛-屏東",5,0,5
"10870","5410國眾","110/08/25","凱基-基隆",0,5,-5
"10871","5410國眾","110/08/25","國泰-板橋",5,0,5
"10872","5410國眾","110/08/25","華南永昌-淡水",0,5,-5
"10873","5410國眾","110/08/25","元大-南京",5,0,5
"10874","5410國眾","110/08/25","元大-新莊",0,5,-5
"10875","5410國眾","110/08/25","新光-台中",4,0,4
"10876","5410國眾","110/08/25","群益金鼎-新店",0,4,-4
"10877","5410國眾","110/08/25","臺銀-金山",3,0,3
"10878","5410國眾","110/08/25","華南永昌-公誠",0,4,-4
"10879","5410國眾","110/08/25","摩根大通",3,0,3
"10880","5410國眾","110/08/25","元大-龍潭",0,4,-4
"10881","5410國眾","110/08/25","元大-鳳山",3,0,3
"10882","5410國眾","110/08/25","元富-大裕",0,3,-3
"10883","5410國眾","110/08/25","台新-中壢",2,0,2
"10884","5410國眾","110/08/25","富邦-建國",0,3,-3
"10885","5410國眾","110/08/25","新光",2,0,2
"10886","5410國眾","110/08/25","美林",0,2,-2
"10887","5410國眾","110/08/25","群益金鼎-新竹",2,0,2
"10888","5410國眾","110/08/25","新光-桃園",0,2,-2
"10889","5410國眾","110/08/25","群益金鼎-三民",2,0,2
"10890","5410國眾","110/08/25","元大-花蓮",0,2,-2
"10891","2841台開","110/08/25","宏遠-館前",155,0,155
"10892","2841台開","110/08/25","台中銀",0,45,-45
"10893","2841台開","110/08/25","元大-仁愛",50,0,50
"10894","2841台開","110/08/25","元大-承德",0,40,-40
"10895","2841台開","110/08/25","永豐金-豐原",50,0,50
"10896","2841台開","110/08/25","永豐金-桃盛",0,40,-40
"10897","2841台開","110/08/25","元大-草屯",40,0,40
"10898","2841台開","110/08/25","港商野村",0,34,-34
"10899","2841台開","110/08/25","永豐金-敦南",45,12,33
"10900","2841台開","110/08/25","永豐金-台中",0,18,-18
"10901","2841台開","110/08/25","元大-沙鹿",10,0,10
"10902","2841台開","110/08/25","國票-中和",0,17,-17
"10903","2841台開","110/08/25","第一金",8,0,8
"10904","2841台開","110/08/25","凱基-高美館",0,16,-16
"10905","2841台開","110/08/25","康和-內湖",7,0,7
"10906","2841台開","110/08/25","永豐金-桃園",0,15,-15
"10907","2841台開","110/08/25","富邦-台北",5,0,5
"10908","2841台開","110/08/25","台灣摩根士丹利",0,11,-11
"10909","2841台開","110/08/25","玉山證券",4,0,4
"10910","2841台開","110/08/25","元富-三重",0,10,-10
"10911","2841台開","110/08/25","富邦-新竹",4,0,4
"10912","2841台開","110/08/25","華南永昌-虎尾",0,10,-10
"10913","2841台開","110/08/25","元大-大里",3,0,3
"10914","2841台開","110/08/25","富邦-基隆",0,10,-10
"10915","2841台開","110/08/25","兆豐-忠孝",2,0,2
"10916","2841台開","110/08/25","元大-成功",0,10,-10
"10917","2841台開","110/08/25","新光",4,2,2
"10918","2841台開","110/08/25","元大-北三重",0,10,-10
"10919","2841台開","110/08/25","元大-南崁",2,0,2
"10920","2841台開","110/08/25","新光-高雄",0,9,-9
"10921","6207雷科","110/08/25","摩根大通",76,0,76
"10922","6207雷科","110/08/25","凱基-復興",0,160,-160
"10923","6207雷科","110/08/25","永豐金證券",63,9,54
"10924","6207雷科","110/08/25","元大-高雄",0,100,-100
"10925","6207雷科","110/08/25","凱基-台北",50,5,45
"10926","6207雷科","110/08/25","元大-林園",0,65,-65
"10927","6207雷科","110/08/25","美商高盛",25,0,25
"10928","6207雷科","110/08/25","臺灣企銀-埔墘",0,20,-20
"10929","6207雷科","110/08/25","港商野村",24,3,21
"10930","6207雷科","110/08/25","第一金-高雄",0,20,-20
"10931","6207雷科","110/08/25","台新-高雄",20,1,19
"10932","6207雷科","110/08/25","元大-大里德芳",0,18,-18
"10933","6207雷科","110/08/25","兆豐-高雄",17,0,17
"10934","6207雷科","110/08/25","元大-敦南",2,18,-16
"10935","6207雷科","110/08/25","新加坡商瑞銀",32,21,11
"10936","6207雷科","110/08/25","玉山-高雄",0,15,-15
"10937","6207雷科","110/08/25","台灣企銀-屏東",10,0,10
"10938","6207雷科","110/08/25","臺銀-鳳山",1,13,-12
"10939","6207雷科","110/08/25","富邦-虎尾",10,0,10
"10940","6207雷科","110/08/25","第一金-中山",10,20,-10
"10941","6207雷科","110/08/25","永豐金-博愛",10,0,10
"10942","6207雷科","110/08/25","元大-鳳山",0,10,-10
"10943","6207雷科","110/08/25","永豐金-中壢",10,0,10
"10944","6207雷科","110/08/25","華南永昌-古亭",5,14,-9
"10945","6207雷科","110/08/25","兆豐-城中",9,0,9
"10946","6207雷科","110/08/25","華南永昌-高雄",3,10,-7
"10947","6207雷科","110/08/25","兆豐-嘉義",7,0,7
"10948","6207雷科","110/08/25","永豐金-市政",0,6,-6
"10949","6207雷科","110/08/25","兆豐-三民",6,0,6
"10950","6207雷科","110/08/25","群益金鼎-嘉義",1,6,-5
"10951","3679新至陞","110/08/25","永豐金-南投",11,0,11
"10952","3679新至陞","110/08/25","台灣摩根士丹利",6,14,-8
"10953","3679新至陞","110/08/25","港商法國興業",10,0,10
"10954","3679新至陞","110/08/25","瑞士信貸",0,6,-6
"10955","3679新至陞","110/08/25","兆豐-公益",3,0,3
"10956","3679新至陞","110/08/25","永豐金-敦北",0,5,-5
"10957","3679新至陞","110/08/25","(牛牛牛)亞-網路",2,0,2
"10958","3679新至陞","110/08/25","群益金鼎-高盛",0,4,-4
"10959","3679新至陞","110/08/25","玉山-嘉義",2,0,2
"10960","3679新至陞","110/08/25","元大-文心興安",0,4,-4
"10961","3679新至陞","110/08/25","元大-華山",2,0,2
"10962","3679新至陞","110/08/25","臺銀-臺中",0,3,-3
"10963","3679新至陞","110/08/25","臺銀",1,0,1
"10964","3679新至陞","110/08/25","美商高盛",0,3,-3
"10965","3679新至陞","110/08/25","美林",3,2,1
"10966","3679新至陞","110/08/25","臺銀-新竹",0,2,-2
"10967","3679新至陞","110/08/25","港商野村",1,0,1
"10968","3679新至陞","110/08/25","宏遠-中和",0,2,-2
"10969","3679新至陞","110/08/25","富隆-長安",1,0,1
"10970","3679新至陞","110/08/25","摩根大通",5,7,-2
"10971","3679新至陞","110/08/25","大慶-富順",1,0,1
"10972","3679新至陞","110/08/25","合庫-彰化",0,1,-1
"10973","3679新至陞","110/08/25","元富-林園",1,0,1
"10974","3679新至陞","110/08/25","臺銀-高雄",0,1,-1
"10975","3679新至陞","110/08/25","元富-嘉義",1,0,1
"10976","3679新至陞","110/08/25","日盛-木柵",0,1,-1
"10977","3679新至陞","110/08/25","元富-埔里",1,0,1
"10978","3679新至陞","110/08/25","日盛-文化",0,1,-1
"10979","3679新至陞","110/08/25","台中銀-員林",1,0,1
"10980","3679新至陞","110/08/25","玉山證券",0,1,-1
"10981","2727王品","110/08/25","美商高盛",121,6,115
"10982","2727王品","110/08/25","美林",9,114,-105
"10983","2727王品","110/08/25","台灣摩根士丹利",139,57,82
"10984","2727王品","110/08/25","永豐金證券",3,71,-68
"10985","2727王品","110/08/25","凱基-台北",105,26,79
"10986","2727王品","110/08/25","元大證券",52,108,-56
"10987","2727王品","110/08/25","新光-台中",34,5,29
"10988","2727王品","110/08/25","摩根大通",35,73,-38
"10989","2727王品","110/08/25","瑞士信貸",20,0,20
"10990","2727王品","110/08/25","華南永昌-麻豆",1,21,-20
"10991","2727王品","110/08/25","凱基-信義",19,1,18
"10992","2727王品","110/08/25","國泰-台中",5,19,-14
"10993","2727王品","110/08/25","國票-內壢",13,0,13
"10994","2727王品","110/08/25","富邦-羅東",2,16,-14
"10995","2727王品","110/08/25","中國信託",12,0,12
"10996","2727王品","110/08/25","富邦-高雄",2,16,-14
"10997","2727王品","110/08/25","元大-中壢",15,3,12
"10998","2727王品","110/08/25","富邦-台中",2,16,-14
"10999","2727王品","110/08/25","日盛-景美",11,0,11
"11000","2727王品","110/08/25","華南永昌",61,73,-12
"11001","2727王品","110/08/25","富邦-板橋",11,0,11
"11002","2727王品","110/08/25","群益金鼎",1,12,-11
"11003","2727王品","110/08/25","元大-台中",11,0,11
"11004","2727王品","110/08/25","群益金鼎-松山",0,10,-10
"11005","2727王品","110/08/25","台新-高雄",14,4,10
"11006","2727王品","110/08/25","凱基-市府",0,10,-10
"11007","2727王品","110/08/25","康和",12,2,10
"11008","2727王品","110/08/25","凱基-市政",1,10,-9
"11009","2727王品","110/08/25","新加坡商瑞銀",9,0,9
"11010","2727王品","110/08/25","富邦-台北",2,10,-8
"11011","1570力肯","110/08/25","永豐金-虎尾",52,0,52
"11012","1570力肯","110/08/25","元大-竹山",0,14,-14
"11013","1570力肯","110/08/25","國票-南科",26,0,26
"11014","1570力肯","110/08/25","日盛-忠孝",0,12,-12
"11015","1570力肯","110/08/25","凱基-台北",22,3,19
"11016","1570力肯","110/08/25","凱基-高美館",0,10,-10
"11017","1570力肯","110/08/25","日茂-南投",17,0,17
"11018","1570力肯","110/08/25","元富-緯城",3,12,-9
"11019","1570力肯","110/08/25","兆豐-台中港",12,0,12
"11020","1570力肯","110/08/25","(牛牛牛)亞-鑫豐",2,11,-9
"11021","1570力肯","110/08/25","合庫-嘉義",10,0,10
"11022","1570力肯","110/08/25","元大-鳳山",0,8,-8
"11023","1570力肯","110/08/25","凱基-復興",10,0,10
"11024","1570力肯","110/08/25","台灣摩根士丹利",0,7,-7
"11025","1570力肯","110/08/25","國票-博愛",16,7,9
"11026","1570力肯","110/08/25","兆豐-中壢",0,6,-6
"11027","1570力肯","110/08/25","香港上海匯豐",9,0,9
"11028","1570力肯","110/08/25","國票",0,6,-6
"11029","1570力肯","110/08/25","瑞士信貸",8,0,8
"11030","1570力肯","110/08/25","國票-天祥",0,6,-6
"11031","1570力肯","110/08/25","富邦-高雄",8,0,8
"11032","1570力肯","110/08/25","群益金鼎-桃園",0,6,-6
"11033","1570力肯","110/08/25","摩根大通",12,9,3
"11034","1570力肯","110/08/25","華南永昌-大安",0,6,-6
"11035","1570力肯","110/08/25","新光-新竹",3,0,3
"11036","1570力肯","110/08/25","永豐金-桃園",0,6,-6
"11037","1570力肯","110/08/25","群益金鼎-民權",3,0,3
"11038","1570力肯","110/08/25","兆豐-松德",0,5,-5
"11039","1570力肯","110/08/25","富邦-建國",5,2,3
"11040","1570力肯","110/08/25","群益金鼎-鳳山",0,5,-5
"11041","6180橘子","110/08/25","摩根大通",127,3,124
"11042","6180橘子","110/08/25","台灣摩根士丹利",5,98,-93
"11043","6180橘子","110/08/25","凱基-台北",387,266,121
"11044","6180橘子","110/08/25","元大-頭份",2,44,-42
"11045","6180橘子","110/08/25","港商野村",106,5,101
"11046","6180橘子","110/08/25","元富-古亭",0,27,-27
"11047","6180橘子","110/08/25","國票-南港",70,1,69
"11048","6180橘子","110/08/25","富邦-陽明",1,28,-27
"11049","6180橘子","110/08/25","美林",47,0,47
"11050","6180橘子","110/08/25","富邦-高雄",0,27,-27
"11051","6180橘子","110/08/25","新加坡商瑞銀",51,6,45
"11052","6180橘子","110/08/25","元大-新店中正",2,25,-23
"11053","6180橘子","110/08/25","美商高盛",43,5,38
"11054","6180橘子","110/08/25","第一金-中山",1,22,-21
"11055","6180橘子","110/08/25","富邦-員林",28,0,28
"11056","6180橘子","110/08/25","合庫-自強",0,20,-20
"11057","6180橘子","110/08/25","大慶-富順",22,0,22
"11058","6180橘子","110/08/25","兆豐證券",0,20,-20
"11059","6180橘子","110/08/25","第一金",20,0,20
"11060","6180橘子","110/08/25","元大-台中中港",1,20,-19
"11061","6180橘子","110/08/25","元富-高雄",20,1,19
"11062","6180橘子","110/08/25","康和-新竹",0,15,-15
"11063","6180橘子","110/08/25","北城證券",18,1,17
"11064","6180橘子","110/08/25","國泰-敦南",3,18,-15
"11065","6180橘子","110/08/25","大昌",15,1,14
"11066","6180橘子","110/08/25","元大-和平",0,15,-15
"11067","6180橘子","110/08/25","元大-六合",13,0,13
"11068","6180橘子","110/08/25","日盛-中壢",0,13,-13
"11069","6180橘子","110/08/25","統一-彰化",13,1,12
"11070","6180橘子","110/08/25","福勝",0,13,-13
"11071","2390云辰","110/08/25","元大-永和",583,40,543
"11072","2390云辰","110/08/25","港商野村",593,815,-222
"11073","2390云辰","110/08/25","元富-安南",400,0,400
"11074","2390云辰","110/08/25","合庫-高雄",19,149,-130
"11075","2390云辰","110/08/25","凱基-台北",361,93,268
"11076","2390云辰","110/08/25","新光-台中",28,149,-121
"11077","2390云辰","110/08/25","凱基-湖口",101,0,101
"11078","2390云辰","110/08/25","致和-崇德",0,116,-116
"11079","2390云辰","110/08/25","元大-土城學府",153,76,77
"11080","2390云辰","110/08/25","美商高盛",11,122,-111
"11081","2390云辰","110/08/25","富邦-陽明",97,28,69
"11082","2390云辰","110/08/25","第一金-豐原",9,109,-100
"11083","2390云辰","110/08/25","群益金鼎-基隆",62,2,60
"11084","2390云辰","110/08/25","元大-雙和",16,113,-97
"11085","2390云辰","110/08/25","元大-南屯",54,4,50
"11086","2390云辰","110/08/25","統一-新台中",81,161,-80
"11087","2390云辰","110/08/25","摩根大通",166,118,48
"11088","2390云辰","110/08/25","富邦-新店",0,80,-80
"11089","2390云辰","110/08/25","元大證券",64,18,46
"11090","2390云辰","110/08/25","國泰-桃園",13,86,-73
"11091","2390云辰","110/08/25","華南永昌-合泰",40,0,40
"11092","2390云辰","110/08/25","台新證券",57,129,-72
"11093","2390云辰","110/08/25","土銀-花蓮",39,0,39
"11094","2390云辰","110/08/25","新光",207,273,-66
"11095","2390云辰","110/08/25","大昌",50,11,39
"11096","2390云辰","110/08/25","華南永昌-楠梓",21,70,-49
"11097","2390云辰","110/08/25","元富-桃園",38,1,37
"11098","2390云辰","110/08/25","群益金鼎-敦南",87,133,-46
"11099","2390云辰","110/08/25","光和-溪湖",32,1,31
"11100","2390云辰","110/08/25","永豐金-敦北",0,40,-40
"11101","1315達新","110/08/23","元大-文心興安",22,0,22
"11102","1315達新","110/08/23","香港上海匯豐",0,25,-25
"11103","1315達新","110/08/23","元大-北屯",9,0,9
"11104","1315達新","110/08/23","港商麥格理",0,22,-22
"11105","1315達新","110/08/23","元大-中壢",6,0,6
"11106","1315達新","110/08/23","群益金鼎-東湖",0,17,-17
"11107","1315達新","110/08/23","新光",5,0,5
"11108","1315達新","110/08/23","日盛-台中",0,9,-9
"11109","1315達新","110/08/23","國泰-桃園",5,0,5
"11110","1315達新","110/08/23","台新-台南",0,8,-8
"11111","1315達新","110/08/23","凱基-中港",5,0,5
"11112","1315達新","110/08/23","元大-四維",0,5,-5
"11113","1315達新","110/08/23","元大-豐原",5,0,5
"11114","1315達新","110/08/23","美林",0,4,-4
"11115","1315達新","110/08/23","致和-東門",3,0,3
"11116","1315達新","110/08/23","群益金鼎-瑞豐",0,3,-3
"11117","1315達新","110/08/23","華南永昌-鳳山",3,0,3
"11118","1315達新","110/08/23","元大-松山",0,2,-2
"11119","1315達新","110/08/23","元大-屏南",3,0,3
"11120","1315達新","110/08/23","元大-板橋",0,2,-2
"11121","1315達新","110/08/23","元大-仁愛",3,0,3
"11122","1315達新","110/08/23","永豐金證券",0,2,-2
"11123","1315達新","110/08/23","日盛-頭份",2,0,2
"11124","1315達新","110/08/23","元富-信義",0,1,-1
"11125","1315達新","110/08/23","港商法國興業",2,0,2
"11126","1315達新","110/08/23","華南永昌-中正",0,1,-1
"11127","1315達新","110/08/23","新加坡商瑞銀",2,0,2
"11128","1315達新","110/08/23","富邦-板橋",0,1,-1
"11129","1315達新","110/08/23","第一金",2,0,2
"11130","1315達新","110/08/23","富邦-仁愛",0,1,-1
"11131","2609陽明","110/08/23","摩根大通",18636,4559,14077
"11132","2609陽明","110/08/23","富邦證券",10185,12443,-2258
"11133","2609陽明","110/08/23","康和",2421,208,2213
"11134","2609陽明","110/08/23","富邦-虎尾",7091,8076,-985
"11135","2609陽明","110/08/23","台灣摩根士丹利",2570,528,2042
"11136","2609陽明","110/08/23","華南永昌-竹北",340,1185,-845
"11137","2609陽明","110/08/23","凱基-台北",2772,1398,1374
"11138","2609陽明","110/08/23","新光-新竹",958,1746,-788
"11139","2609陽明","110/08/23","美林",7570,6327,1243
"11140","2609陽明","110/08/23","凱基-長庚",161,815,-654
"11141","2609陽明","110/08/23","瑞士信貸",1505,326,1179
"11142","2609陽明","110/08/23","凱基-市府",164,817,-653
"11143","2609陽明","110/08/23","日盛-板橋",1087,183,904
"11144","2609陽明","110/08/23","國泰-敦南",5133,5754,-621
"11145","2609陽明","110/08/23","凱基-復興",1293,497,796
"11146","2609陽明","110/08/23","國泰-館前",1329,1670,-341
"11147","2609陽明","110/08/23","元大證券",3275,2760,515
"11148","2609陽明","110/08/23","富邦-建國",489,824,-335
"11149","2609陽明","110/08/23","元大-頭份",776,338,438
"11150","2609陽明","110/08/23","元大-大同",246,569,-323
"11151","2609陽明","110/08/23","富邦-仁愛",1292,875,417
"11152","2609陽明","110/08/23","元大-和平",98,405,-307
"11153","2609陽明","110/08/23","凱基-市政",2414,2002,412
"11154","2609陽明","110/08/23","元大-台中中港",128,429,-301
"11155","2609陽明","110/08/23","元大-士林",2427,2036,391
"11156","2609陽明","110/08/23","玉山證券",756,1049,-293
"11157","2609陽明","110/08/23","宏遠證券",1542,1153,389
"11158","2609陽明","110/08/23","群益金鼎-內湖",32,319,-287
"11159","2609陽明","110/08/23","新加坡商瑞銀",746,375,371
"11160","2609陽明","110/08/23","群益金鼎-大安",1012,1296,-284
"11161","2636台驊投控","110/08/23","摩根大通",1383,622,761
"11162","2636台驊投控","110/08/23","第一金-桃園",32,181,-149
"11163","2636台驊投控","110/08/23","瑞士信貸",679,89,590
"11164","2636台驊投控","110/08/23","永豐金-新竹",6,139,-133
"11165","2636台驊投控","110/08/23","台灣摩根士丹利",413,93,320
"11166","2636台驊投控","110/08/23","日盛-景美",5,108,-103
"11167","2636台驊投控","110/08/23","美商高盛",400,167,233
"11168","2636台驊投控","110/08/23","台新證券",155,215,-60
"11169","2636台驊投控","110/08/23","新加坡商瑞銀",215,57,158
"11170","2636台驊投控","110/08/23","日盛-台中",0,55,-55
"11171","2636台驊投控","110/08/23","元大-松江",81,17,64
"11172","2636台驊投控","110/08/23","富邦-苗栗",2,57,-55
"11173","2636台驊投控","110/08/23","新光",303,240,63
"11174","2636台驊投控","110/08/23","日盛-信義",12,66,-54
"11175","2636台驊投控","110/08/23","凱基-台北",601,539,62
"11176","2636台驊投控","110/08/23","富邦-北港",7,56,-49
"11177","2636台驊投控","110/08/23","富邦-彰化",116,55,61
"11178","2636台驊投控","110/08/23","中國信託-文心",19,67,-48
"11179","2636台驊投控","110/08/23","永豐金-萬盛",84,36,48
"11180","2636台驊投控","110/08/23","統一-城中",34,81,-47
"11181","2636台驊投控","110/08/23","兆豐-中壢",67,22,45
"11182","2636台驊投控","110/08/23","土銀-南港",0,45,-45
"11183","2636台驊投控","110/08/23","兆豐-鹿港",44,4,40
"11184","2636台驊投控","110/08/23","永豐金-桃園",19,64,-45
"11185","2636台驊投控","110/08/23","元大-林森",77,40,37
"11186","2636台驊投控","110/08/23","台新-台中",63,107,-44
"11187","2636台驊投控","110/08/23","富邦-虎尾",255,221,34
"11188","2636台驊投控","110/08/23","日盛證券",24,67,-43
"11189","2636台驊投控","110/08/23","元富-成功",37,6,31
"11190","2636台驊投控","110/08/23","凱基-竹科",80,118,-38
"11191","2867三商壽","110/08/23","凱基-台北",292,9,283
"11192","2867三商壽","110/08/23","宏遠證券",0,1024,-1024
"11193","2867三商壽","110/08/23","康和-台中",273,3,270
"11194","2867三商壽","110/08/23","富邦-陽明",0,280,-280
"11195","2867三商壽","110/08/23","土銀-台中",150,0,150
"11196","2867三商壽","110/08/23","元大-北投",0,100,-100
"11197","2867三商壽","110/08/23","新光",135,10,125
"11198","2867三商壽","110/08/23","元富",0,75,-75
"11199","2867三商壽","110/08/23","新加坡商瑞銀",109,5,104
"11200","2867三商壽","110/08/23","摩根大通",309,368,-59
"11201","2867三商壽","110/08/23","元大-桃園",100,0,100
"11202","2867三商壽","110/08/23","台灣摩根士丹利",6,57,-51
"11203","2867三商壽","110/08/23","元大-沙鹿",76,0,76
"11204","2867三商壽","110/08/23","元富-城東",0,51,-51
"11205","2867三商壽","110/08/23","凱基",75,0,75
"11206","2867三商壽","110/08/23","美林",9,59,-50
"11207","2867三商壽","110/08/23","元大-彰化民生",72,0,72
"11208","2867三商壽","110/08/23","宏遠-中和",3,50,-47
"11209","2867三商壽","110/08/23","國泰-台南",78,10,68
"11210","2867三商壽","110/08/23","元大-永和",0,42,-42
"11211","2867三商壽","110/08/23","元大-屏東",60,0,60
"11212","2867三商壽","110/08/23","土銀-白河",0,36,-36
"11213","2867三商壽","110/08/23","華南永昌-公誠",60,1,59
"11214","2867三商壽","110/08/23","元大-博愛",0,31,-31
"11215","2867三商壽","110/08/23","國票-安和",50,0,50
"11216","2867三商壽","110/08/23","凱基-八德",0,30,-30
"11217","2867三商壽","110/08/23","國泰-板橋",50,0,50
"11218","2867三商壽","110/08/23","元大-永康",0,30,-30
"11219","2867三商壽","110/08/23","永豐金-新莊",50,0,50
"11220","2867三商壽","110/08/23","日盛-二林",20,40,-20
"11221","5521工信","110/08/23","摩根大通",142,16,126
"11222","5521工信","110/08/23","港商野村",0,134,-134
"11223","5521工信","110/08/23","群益金鼎-台中",123,0,123
"11224","5521工信","110/08/23","元大-南屯",10,135,-125
"11225","5521工信","110/08/23","元大證券",106,0,106
"11226","5521工信","110/08/23","國泰-敦南",1,34,-33
"11227","5521工信","110/08/23","凱基-台北",117,24,93
"11228","5521工信","110/08/23","台新-台中",2,30,-28
"11229","5521工信","110/08/23","中國信託-三重",44,0,44
"11230","5521工信","110/08/23","群益金鼎-三民",0,25,-25
"11231","5521工信","110/08/23","日盛-宜蘭",20,0,20
"11232","5521工信","110/08/23","福勝",0,20,-20
"11233","5521工信","110/08/23","元大-桃園",20,0,20
"11234","5521工信","110/08/23","元大-內湖",0,20,-20
"11235","5521工信","110/08/23","日茂",14,0,14
"11236","5521工信","110/08/23","第一金-新竹",0,15,-15
"11237","5521工信","110/08/23","富邦-苗栗",12,0,12
"11238","5521工信","110/08/23","統一-員林",0,15,-15
"11239","5521工信","110/08/23","港商法國興業",11,0,11
"11240","5521工信","110/08/23","新光",0,15,-15
"11241","5521工信","110/08/23","統一-新台中",66,55,11
"11242","5521工信","110/08/23","華南永昌-高雄",0,15,-15
"11243","5521工信","110/08/23","宏遠-桃園",10,0,10
"11244","5521工信","110/08/23","第一金-桃園",0,12,-12
"11245","5521工信","110/08/23","日進",10,0,10
"11246","5521工信","110/08/23","群益金鼎-萬華",0,12,-12
"11247","5521工信","110/08/23","群益金鼎-中壢",10,0,10
"11248","5521工信","110/08/23","兆豐-新竹",0,11,-11
"11249","5521工信","110/08/23","富邦-虎尾",10,0,10
"11250","5521工信","110/08/23","群益金鼎-忠孝",0,10,-10
"11251","1471首利","110/08/23","摩根大通",143,11,132
"11252","1471首利","110/08/23","元大-草屯",0,153,-153
"11253","1471首利","110/08/23","瑞士信貸",79,0,79
"11254","1471首利","110/08/23","富邦-台北",0,30,-30
"11255","1471首利","110/08/23","美林",27,1,26
"11256","1471首利","110/08/23","第一金-路竹",0,28,-28
"11257","1471首利","110/08/23","凱基-台北",23,0,23
"11258","1471首利","110/08/23","光和-嘉義",0,20,-20
"11259","1471首利","110/08/23","港商法國興業",16,0,16
"11260","1471首利","110/08/23","兆豐-台中港",0,20,-20
"11261","1471首利","110/08/23","兆豐-員林",13,1,12
"11262","1471首利","110/08/23","新光-台南",0,20,-20
"11263","1471首利","110/08/23","台新-台南",10,0,10
"11264","1471首利","110/08/23","永豐金-松山",0,20,-20
"11265","1471首利","110/08/23","玉山-新莊",10,0,10
"11266","1471首利","110/08/23","永興-大墩",0,12,-12
"11267","1471首利","110/08/23","元大-南崁",10,0,10
"11268","1471首利","110/08/23","元富-民權",0,12,-12
"11269","1471首利","110/08/23","國泰-敦南",9,0,9
"11270","1471首利","110/08/23","光和",0,11,-11
"11271","1471首利","110/08/23","中農",7,0,7
"11272","1471首利","110/08/23","凱基-嘉義",0,11,-11
"11273","1471首利","110/08/23","元大-南投",7,0,7
"11274","1471首利","110/08/23","宏遠-光隆",0,10,-10
"11275","1471首利","110/08/23","臺銀-鳳山",5,0,5
"11276","1471首利","110/08/23","元富-台南",0,10,-10
"11277","1471首利","110/08/23","臺銀-新竹",5,0,5
"11278","1471首利","110/08/23","國票-天祥",1,7,-6
"11279","1471首利","110/08/23","台新-松江",5,0,5
"11280","1471首利","110/08/23","凱基-新店",1,7,-6
"11281","2883開發金","110/08/23","港商野村",10106,1311,8795
"11282","2883開發金","110/08/23","凱基",0,12731,-12731
"11283","2883開發金","110/08/23","國泰-館前",3231,61,3170
"11284","2883開發金","110/08/23","華南永昌",206,3525,-3319
"11285","2883開發金","110/08/23","美林",3113,860,2253
"11286","2883開發金","110/08/23","台灣摩根士丹利",274,2928,-2654
"11287","2883開發金","110/08/23","元大-開元",2066,52,2014
"11288","2883開發金","110/08/23","凱基-台北",1073,3532,-2459
"11289","2883開發金","110/08/23","統一",1542,16,1526
"11290","2883開發金","110/08/23","新加坡商瑞銀",404,2862,-2458
"11291","2883開發金","110/08/23","永豐金-新莊",1111,2,1109
"11292","2883開發金","110/08/23","群益金鼎",2,1833,-1831
"11293","2883開發金","110/08/23","永豐金-台南",1055,155,900
"11294","2883開發金","110/08/23","摩根大通",987,2808,-1821
"11295","2883開發金","110/08/23","統一-基隆",542,0,542
"11296","2883開發金","110/08/23","聯邦商銀",4,1800,-1796
"11297","2883開發金","110/08/23","花旗環球",650,117,533
"11298","2883開發金","110/08/23","康和",5,1485,-1480
"11299","2883開發金","110/08/23","群益金鼎-開元",531,23,508
"11300","2883開發金","110/08/23","新光",1648,2512,-864
"11301","2883開發金","110/08/23","港商法國興業",484,0,484
"11302","2883開發金","110/08/23","美商高盛",11,687,-676
"11303","2883開發金","110/08/23","統一-台中",496,32,464
"11304","2883開發金","110/08/23","大慶-基隆",3,503,-500
"11305","2883開發金","110/08/23","(牛牛牛)亞-鑫豐",475,48,427
"11306","2883開發金","110/08/23","瑞士信貸",206,641,-435
"11307","2883開發金","110/08/23","元大證券",560,198,362
"11308","2883開發金","110/08/23","第一金-台南",79,494,-415
"11309","2883開發金","110/08/23","台新證券",488,128,360
"11310","2883開發金","110/08/23","華南永昌-苑裡",2,315,-313
"11311","6205詮欣","110/08/23","合庫-三重",49,0,49
"11312","6205詮欣","110/08/23","永豐金-敦南",0,52,-52
"11313","6205詮欣","110/08/23","摩根大通",8,0,8
"11314","6205詮欣","110/08/23","統一-中壢",0,10,-10
"11315","6205詮欣","110/08/23","日盛-高雄",5,0,5
"11316","6205詮欣","110/08/23","瑞士信貸",3,11,-8
"11317","6205詮欣","110/08/23","新光-台南",5,0,5
"11318","6205詮欣","110/08/23","群益金鼎-永和",0,5,-5
"11319","6205詮欣","110/08/23","元大-復北",4,0,4
"11320","6205詮欣","110/08/23","華南永昌-公誠",0,5,-5
"11321","6205詮欣","110/08/23","永豐金證券",4,0,4
"11322","6205詮欣","110/08/23","元大-屏東",0,5,-5
"11323","6205詮欣","110/08/23","臺銀-高雄",3,0,3
"11324","6205詮欣","110/08/23","元大-汐止",1,5,-4
"11325","6205詮欣","110/08/23","港商法國興業",3,0,3
"11326","6205詮欣","110/08/23","統一-汐止",0,3,-3
"11327","6205詮欣","110/08/23","凱基-汐止",3,0,3
"11328","6205詮欣","110/08/23","元富-嘉義",0,2,-2
"11329","6205詮欣","110/08/23","凱基-台北",4,1,3
"11330","6205詮欣","110/08/23","北城證券",0,2,-2
"11331","6205詮欣","110/08/23","日盛-三重",2,0,2
"11332","6205詮欣","110/08/23","凱基-新莊",0,2,-2
"11333","6205詮欣","110/08/23","華南永昌-潮州",2,0,2
"11334","6205詮欣","110/08/23","富邦-仁愛",0,2,-2
"11335","6205詮欣","110/08/23","元大-成功",2,0,2
"11336","6205詮欣","110/08/23","永豐金-新莊",0,2,-2
"11337","6205詮欣","110/08/23","美林",1,0,1
"11338","6205詮欣","110/08/23","永豐金-台中",0,2,-2
"11339","6205詮欣","110/08/23","第一金-大稻埕",1,0,1
"11340","6205詮欣","110/08/23","第一金-路竹",0,1,-1
"11341","1540喬福","110/08/23","玉山證券",6,1,5
"11342","1540喬福","110/08/23","元富-新竹",0,5,-5
"11343","1540喬福","110/08/23","港商法國興業",3,0,3
"11344","1540喬福","110/08/23","玉山-城中",0,5,-5
"11345","1540喬福","110/08/23","元富-敦南",3,0,3
"11346","1540喬福","110/08/23","兆豐-台中港",0,4,-4
"11347","1540喬福","110/08/23","凱基-台北",2,0,2
"11348","1540喬福","110/08/23","元大-太平",0,4,-4
"11349","1540喬福","110/08/23","國泰-敦南",1,0,1
"11350","1540喬福","110/08/23","美林",0,1,-1
"11351","1540喬福","110/08/23","永豐金-豐原",1,0,1
"11352","1540喬福","110/08/23","元富",0,1,-1
"11353","1540喬福","110/08/23","永豐金-敦南",1,0,1
"11354","1540喬福","110/08/23","群益金鼎-海山",0,1,-1
"11355","1540喬福","110/08/23","元大-文心興安",1,0,1
"11356","1540喬福","110/08/23","富邦-嘉義",0,1,-1
"11357","1540喬福","110/08/23","群益金鼎-丹鳳",1,0,1
"11358","1540喬福","110/08/23","日盛-八德",0,0,0
"11359","1540喬福","110/08/23","群益金鼎-高雄",1,0,1
"11360","1540喬福","110/08/23","統一-三重",0,0,0
"11361","1540喬福","110/08/23","合庫-高雄",1,0,1
"11362","1540喬福","110/08/23","(牛牛牛)亞-網路",0,0,0
"11363","1540喬福","110/08/23","致和-南京",2,1,1
"11364","1540喬福","110/08/23","國泰-高雄",0,0,0
"11365","1540喬福","110/08/23","新加坡商瑞銀",1,0,1
"11366","1540喬福","110/08/23","凱基-竹北",0,0,0
"11367","1540喬福","110/08/23","國泰-高雄",0,0,0
"11368","1540喬福","110/08/23","華南永昌-嘉義",0,0,0
"11369","1540喬福","110/08/23","凱基-竹北",0,0,0
"11370","1540喬福","110/08/23","元大-西門",0,0,0
"11371","2888新光金","110/08/23","港商野村",2200,82,2118
"11372","2888新光金","110/08/23","元富-城東",72,2108,-2036
"11373","2888新光金","110/08/23","凱基-台北",1553,74,1479
"11374","2888新光金","110/08/23","元大-北投",15,1631,-1616
"11375","2888新光金","110/08/23","合庫-新竹",800,0,800
"11376","2888新光金","110/08/23","美商高盛",264,1857,-1593
"11377","2888新光金","110/08/23","法銀巴黎",688,38,650
"11378","2888新光金","110/08/23","摩根大通",2146,3664,-1518
"11379","2888新光金","110/08/23","元富",590,17,573
"11380","2888新光金","110/08/23","元大證券",87,1208,-1121
"11381","2888新光金","110/08/23","第一金-新竹",572,0,572
"11382","2888新光金","110/08/23","凱基-頭份",0,1100,-1100
"11383","2888新光金","110/08/23","台灣摩根士丹利",597,168,429
"11384","2888新光金","110/08/23","玉山-板橋",93,712,-619
"11385","2888新光金","110/08/23","福邦-新竹",412,0,412
"11386","2888新光金","110/08/23","瑞士信貸",535,1122,-587
"11387","2888新光金","110/08/23","新光",504,139,365
"11388","2888新光金","110/08/23","元富-嘉義",27,583,-556
"11389","2888新光金","110/08/23","元大-屏南",343,4,339
"11390","2888新光金","110/08/23","凱基-敦北",2,500,-498
"11391","2888新光金","110/08/23","(牛牛牛)亞-鑫豐",398,63,335
"11392","2888新光金","110/08/23","華南永昌-林口",130,620,-490
"11393","2888新光金","110/08/23","永豐金-嘉義",300,0,300
"11394","2888新光金","110/08/23","元大-草屯",27,442,-415
"11395","2888新光金","110/08/23","富邦-台北",309,14,295
"11396","2888新光金","110/08/23","元大-大天母",5,255,-250
"11397","2888新光金","110/08/23","元富-彰化",254,2,252
"11398","2888新光金","110/08/23","土銀-嘉義",10,250,-240
"11399","2888新光金","110/08/23","群益金鼎-竹南",282,32,250
"11400","2888新光金","110/08/23","富邦-高雄",42,266,-224
"11401","1340勝悅","110/08/23","港商法國興業",20,0,20
"11402","1340勝悅","110/08/23","凱基-永華",0,26,-26
"11403","1340勝悅","110/08/23","凱基-台北",15,1,14
"11404","1340勝悅","110/08/23","元大-四維",0,20,-20
"11405","1340勝悅","110/08/23","美林",12,0,12
"11406","1340勝悅","110/08/23","元大-向上",0,19,-19
"11407","1340勝悅","110/08/23","元富-宜蘭",7,0,7
"11408","1340勝悅","110/08/23","元大-竹北",0,18,-18
"11409","1340勝悅","110/08/23","美商高盛",6,0,6
"11410","1340勝悅","110/08/23","永豐金-內湖",0,15,-15
"11411","1340勝悅","110/08/23","國泰-台中",6,0,6
"11412","1340勝悅","110/08/23","摩根大通",0,9,-9
"11413","1340勝悅","110/08/23","臺灣企銀-埔墘",5,0,5
"11414","1340勝悅","110/08/23","元大-忠孝鼎富",0,9,-9
"11415","1340勝悅","110/08/23","元富-彰化",5,0,5
"11416","1340勝悅","110/08/23","凱基-高美館",0,4,-4
"11417","1340勝悅","110/08/23","台中銀",5,0,5
"11418","1340勝悅","110/08/23","臺銀-鳳山",0,3,-3
"11419","1340勝悅","110/08/23","新光",5,0,5
"11420","1340勝悅","110/08/23","統一-城中",3,6,-3
"11421","1340勝悅","110/08/23","瑞士信貸",4,0,4
"11422","1340勝悅","110/08/23","陽信-石牌",0,2,-2
"11423","1340勝悅","110/08/23","華南永昌-新莊",4,0,4
"11424","1340勝悅","110/08/23","群益金鼎-屏東",0,2,-2
"11425","1340勝悅","110/08/23","富邦-新店",5,1,4
"11426","1340勝悅","110/08/23","富邦-羅東",0,2,-2
"11427","1340勝悅","110/08/23","群益金鼎-館前",3,0,3
"11428","1340勝悅","110/08/23","元大-新竹經國",0,2,-2
"11429","1340勝悅","110/08/23","國泰-桃園",2,0,2
"11430","1340勝悅","110/08/23","新光-台南",0,1,-1
"11431","6246臺龍","110/08/23","台新-高雄",46,22,24
"11432","6246臺龍","110/08/23","元富-高雄",0,26,-26
"11433","6246臺龍","110/08/23","凱基-台北",10,1,9
"11434","6246臺龍","110/08/23","元大-台北",0,8,-8
"11435","6246臺龍","110/08/23","臺銀-臺中",6,0,6
"11436","6246臺龍","110/08/23","日進",0,6,-6
"11437","6246臺龍","110/08/23","國票-北高雄",6,0,6
"11438","6246臺龍","110/08/23","第一金-高雄",0,5,-5
"11439","6246臺龍","110/08/23","第一金-安和",5,0,5
"11440","6246臺龍","110/08/23","玉山-桃園",0,5,-5
"11441","6246臺龍","110/08/23","元富-宜蘭",5,0,5
"11442","6246臺龍","110/08/23","群益金鼎-東門",0,5,-5
"11443","6246臺龍","110/08/23","康和-內湖",5,0,5
"11444","6246臺龍","110/08/23","永豐金-三重",0,5,-5
"11445","6246臺龍","110/08/23","兆豐-公益",4,0,4
"11446","6246臺龍","110/08/23","元富-潮州",0,4,-4
"11447","6246臺龍","110/08/23","台新-屏東",20,16,4
"11448","6246臺龍","110/08/23","元大-新莊",0,4,-4
"11449","6246臺龍","110/08/23","元大-高雄",4,0,4
"11450","6246臺龍","110/08/23","宏遠-新化",0,3,-3
"11451","6246臺龍","110/08/23","兆豐-景美",3,0,3
"11452","6246臺龍","110/08/23","富邦-嘉義",0,3,-3
"11453","6246臺龍","110/08/23","國票-敦北法人",5,2,3
"11454","6246臺龍","110/08/23","日盛-新莊",0,2,-2
"11455","6246臺龍","110/08/23","新光-台中",3,0,3
"11456","6246臺龍","110/08/23","元富-花蓮",0,2,-2
"11457","6246臺龍","110/08/23","元大-竹山",3,0,3
"11458","6246臺龍","110/08/23","兆豐-高雄",0,2,-2
"11459","6246臺龍","110/08/23","元大-土城",3,0,3
"11460","6246臺龍","110/08/23","國泰-敦南",1,3,-2
"11461","00715L期街口布蘭特正2","110/08/23","中國信託-永康",1679,1,1678
"11462","00715L期街口布蘭特正2","110/08/23","元大證券",181,15885,-15704
"11463","00715L期街口布蘭特正2","110/08/23","元大-新竹",1242,37,1205
"11464","00715L期街口布蘭特正2","110/08/23","凱基",0,4277,-4277
"11465","00715L期街口布蘭特正2","110/08/23","兆豐-鹿港",790,10,780
"11466","00715L期街口布蘭特正2","110/08/23","合庫證券",25,3475,-3450
"11467","00715L期街口布蘭特正2","110/08/23","凱基-台北",1274,502,772
"11468","00715L期街口布蘭特正2","110/08/23","永豐金證券",100,3461,-3361
"11469","00715L期街口布蘭特正2","110/08/23","新光",913,226,687
"11470","00715L期街口布蘭特正2","110/08/23","元富",11,2829,-2818
"11471","00715L期街口布蘭特正2","110/08/23","台中銀",639,24,615
"11472","00715L期街口布蘭特正2","110/08/23","康和",0,2551,-2551
"11473","00715L期街口布蘭特正2","110/08/23","元大-嘉義",584,0,584
"11474","00715L期街口布蘭特正2","110/08/23","富邦證券",1628,2629,-1001
"11475","00715L期街口布蘭特正2","110/08/23","兆豐-台中港",613,30,583
"11476","00715L期街口布蘭特正2","110/08/23","元大-林森",45,602,-557
"11477","00715L期街口布蘭特正2","110/08/23","永豐金-板盛",506,0,506
"11478","00715L期街口布蘭特正2","110/08/23","元大-三重",21,550,-529
"11479","00715L期街口布蘭特正2","110/08/23","群益金鼎-屏東",501,0,501
"11480","00715L期街口布蘭特正2","110/08/23","元大-民雄",92,575,-483
"11481","00715L期街口布蘭特正2","110/08/23","元大-北港",496,10,486
"11482","00715L期街口布蘭特正2","110/08/23","元大-蘆洲",15,316,-301
"11483","00715L期街口布蘭特正2","110/08/23","新光-台中",463,36,427
"11484","00715L期街口布蘭特正2","110/08/23","群益金鼎-台中",10,300,-290
"11485","00715L期街口布蘭特正2","110/08/23","永豐金-市政",420,15,405
"11486","00715L期街口布蘭特正2","110/08/23","群益金鼎-丹鳳",37,320,-283
"11487","00715L期街口布蘭特正2","110/08/23","元大-復北",415,11,404
"11488","00715L期街口布蘭特正2","110/08/23","富邦-嘉義",346,628,-282
"11489","00715L期街口布蘭特正2","110/08/23","中國信託-高雄",428,28,400
"11490","00715L期街口布蘭特正2","110/08/23","大昌-樹林",48,295,-247
"11491","8941關中","110/08/23","凱基-市府",1,0,1
"11492","8941關中","110/08/23","元大-金華",0,1,-1
"11493","8941關中","110/08/23","元富-台中",0,0,0
"11494","8941關中","110/08/23","元富-台中",0,0,0
"11495","8941關中","110/08/23","康和-板橋",0,0,0
"11496","8941關中","110/08/23","康和-板橋",0,0,0
"11497","8941關中","110/08/23","凱基-市政",0,0,0
"11498","8941關中","110/08/23","凱基-市政",0,0,0
"11499","8941關中","110/08/23","永豐金-敦北",0,0,0
"11500","8941關中","110/08/23","永豐金-敦北",0,0,0
"11501","8941關中","110/08/23","永豐金-南投",0,0,0
"11502","8941關中","110/08/23","永豐金-南投",0,0,0
"11503","8941關中","110/08/23","",NA,NA,NA
"11504","8941關中","110/08/23","",NA,NA,NA
"11505","8941關中","110/08/23","",NA,NA,NA
"11506","8941關中","110/08/23","",NA,NA,NA
"11507","8941關中","110/08/23","",NA,NA,NA
"11508","8941關中","110/08/23","",NA,NA,NA
"11509","8941關中","110/08/23","",NA,NA,NA
"11510","8941關中","110/08/23","",NA,NA,NA
"11511","8941關中","110/08/23","",NA,NA,NA
"11512","8941關中","110/08/23","",NA,NA,NA
"11513","8941關中","110/08/23","",NA,NA,NA
"11514","8941關中","110/08/23","",NA,NA,NA
"11515","8941關中","110/08/23","",NA,NA,NA
"11516","8941關中","110/08/23","",NA,NA,NA
"11517","8941關中","110/08/23","",NA,NA,NA
"11518","8941關中","110/08/23","",NA,NA,NA
"11519","8941關中","110/08/23","",NA,NA,NA
"11520","8941關中","110/08/23","",NA,NA,NA
"11521","8936國統","110/08/23","新加坡商瑞銀",220,12,208
"11522","8936國統","110/08/23","宏遠-台南",0,264,-264
"11523","8936國統","110/08/23","第一金-高雄",100,0,100
"11524","8936國統","110/08/23","康和-高雄",0,156,-156
"11525","8936國統","110/08/23","美商高盛",89,5,84
"11526","8936國統","110/08/23","凱基-高美館",0,56,-56
"11527","8936國統","110/08/23","瑞士信貸",77,0,77
"11528","8936國統","110/08/23","凱基-台北",7,50,-43
"11529","8936國統","110/08/23","中國信託-高雄",55,0,55
"11530","8936國統","110/08/23","大慶-楊梅",0,19,-19
"11531","8936國統","110/08/23","摩根大通",44,0,44
"11532","8936國統","110/08/23","富邦-台北",1,17,-16
"11533","8936國統","110/08/23","港商野村",68,31,37
"11534","8936國統","110/08/23","國票-中正",0,15,-15
"11535","8936國統","110/08/23","富邦-陽明",30,0,30
"11536","8936國統","110/08/23","兆豐-北高雄",0,14,-14
"11537","8936國統","110/08/23","美林",15,0,15
"11538","8936國統","110/08/23","日盛-和美",1,12,-11
"11539","8936國統","110/08/23","華南永昌",15,0,15
"11540","8936國統","110/08/23","統一-新竹",2,13,-11
"11541","8936國統","110/08/23","新光-台中",13,1,12
"11542","8936國統","110/08/23","永興-水湳",0,10,-10
"11543","8936國統","110/08/23","臺銀-鳳山",11,0,11
"11544","8936國統","110/08/23","國票-北高雄",0,10,-10
"11545","8936國統","110/08/23","元富-城東",10,0,10
"11546","8936國統","110/08/23","凱基-科園",0,10,-10
"11547","8936國統","110/08/23","宏遠-高雄",11,2,9
"11548","8936國統","110/08/23","元大-高雄",0,10,-10
"11549","8936國統","110/08/23","元富-古亭",9,0,9
"11550","8936國統","110/08/23","元大-西螺",0,8,-8
"11551","6226光鼎","110/08/23","摩根大通",432,89,343
"11552","6226光鼎","110/08/23","元大-文心興安",17,248,-231
"11553","6226光鼎","110/08/23","凱基-台北",234,13,221
"11554","6226光鼎","110/08/23","台新-台南",5,92,-87
"11555","6226光鼎","110/08/23","瑞士信貸",176,1,175
"11556","6226光鼎","110/08/23","致和-佳里",0,50,-50
"11557","6226光鼎","110/08/23","美林",77,4,73
"11558","6226光鼎","110/08/23","永豐金-大園",1,50,-49
"11559","6226光鼎","110/08/23","元大-板橋",51,4,47
"11560","6226光鼎","110/08/23","永豐金-竹北",0,40,-40
"11561","6226光鼎","110/08/23","港商法國興業",41,0,41
"11562","6226光鼎","110/08/23","凱基-台中",10,46,-36
"11563","6226光鼎","110/08/23","富邦-陽明",60,20,40
"11564","6226光鼎","110/08/23","統一",0,35,-35
"11565","6226光鼎","110/08/23","華南永昌-中正",38,0,38
"11566","6226光鼎","110/08/23","國泰-板橋",13,47,-34
"11567","6226光鼎","110/08/23","美商高盛",120,86,34
"11568","6226光鼎","110/08/23","富邦-岡山",0,34,-34
"11569","6226光鼎","110/08/23","永豐金-虎尾",54,21,33
"11570","6226光鼎","110/08/23","元富-城中",4,37,-33
"11571","6226光鼎","110/08/23","元大-中壢",43,11,32
"11572","6226光鼎","110/08/23","永豐金-中盛",2,35,-33
"11573","6226光鼎","110/08/23","元大-松山",30,0,30
"11574","6226光鼎","110/08/23","新光",29,60,-31
"11575","6226光鼎","110/08/23","華南永昌-麻豆",29,0,29
"11576","6226光鼎","110/08/23","第一金-台南",3,28,-25
"11577","6226光鼎","110/08/23","國泰-敦南",108,80,28
"11578","6226光鼎","110/08/23","元富-同大",0,23,-23
"11579","6226光鼎","110/08/23","凱基-內埔",31,10,21
"11580","6226光鼎","110/08/23","元大-高雄",0,23,-23
"11581","2363矽統","110/08/23","摩根大通",2511,676,1835
"11582","2363矽統","110/08/23","凱基-南崁",11,1553,-1542
"11583","2363矽統","110/08/23","凱基-台北",1871,888,983
"11584","2363矽統","110/08/23","玉山-台中",25,549,-524
"11585","2363矽統","110/08/23","合庫-基隆",965,24,941
"11586","2363矽統","110/08/23","台灣摩根士丹利",0,504,-504
"11587","2363矽統","110/08/23","瑞士信貸",553,0,553
"11588","2363矽統","110/08/23","永豐金-板盛",4,302,-298
"11589","2363矽統","110/08/23","美商高盛",1636,1099,537
"11590","2363矽統","110/08/23","大展",13,289,-276
"11591","2363矽統","110/08/23","港商野村",2021,1501,520
"11592","2363矽統","110/08/23","元大-汐止",123,391,-268
"11593","2363矽統","110/08/23","美林",395,80,315
"11594","2363矽統","110/08/23","台新證券",332,525,-193
"11595","2363矽統","110/08/23","富邦-苗栗",360,53,307
"11596","2363矽統","110/08/23","富邦-新竹",45,201,-156
"11597","2363矽統","110/08/23","統一-土城",254,6,248
"11598","2363矽統","110/08/23","群益金鼎-桃園",4,107,-103
"11599","2363矽統","110/08/23","統一-仁愛",281,48,233
"11600","2363矽統","110/08/23","台新-屏東",58,156,-98
"11601","2363矽統","110/08/23","統一-敦南",261,40,221
"11602","2363矽統","110/08/23","元富-永和",9,103,-94
"11603","2363矽統","110/08/23","統一-城中",276,57,219
"11604","2363矽統","110/08/23","富邦-新店",19,107,-88
"11605","2363矽統","110/08/23","群益金鼎-敦南",209,13,196
"11606","2363矽統","110/08/23","群益金鼎-南京",24,111,-87
"11607","2363矽統","110/08/23","華南永昌-林口",174,12,162
"11608","2363矽統","110/08/23","台新-左楠",4,88,-84
"11609","2363矽統","110/08/23","元大-淡水",210,57,153
"11610","2363矽統","110/08/23","元大-沙鹿",58,137,-79
"11611","8112至上","110/08/23","美林",116,9,107
"11612","8112至上","110/08/23","群益金鼎-基隆",0,172,-172
"11613","8112至上","110/08/23","摩根大通",133,59,74
"11614","8112至上","110/08/23","香港上海匯豐",0,120,-120
"11615","8112至上","110/08/23","第一金-桃園",99,30,69
"11616","8112至上","110/08/23","台灣摩根士丹利",0,110,-110
"11617","8112至上","110/08/23","凱基-台北",129,78,51
"11618","8112至上","110/08/23","群益金鼎",0,100,-100
"11619","8112至上","110/08/23","元大-成功",50,1,49
"11620","8112至上","110/08/23","元大-佳里",5,92,-87
"11621","8112至上","110/08/23","日盛-花蓮",40,0,40
"11622","8112至上","110/08/23","港商野村",77,140,-63
"11623","8112至上","110/08/23","國票-天祥",40,0,40
"11624","8112至上","110/08/23","元大-永和",0,45,-45
"11625","8112至上","110/08/23","群益金鼎-板橋",40,0,40
"11626","8112至上","110/08/23","富邦-仁愛",31,66,-35
"11627","8112至上","110/08/23","元大-萬華",49,10,39
"11628","8112至上","110/08/23","日盛-文化",0,26,-26
"11629","8112至上","110/08/23","合庫-西台中",40,5,35
"11630","8112至上","110/08/23","元富-佳里",4,30,-26
"11631","8112至上","110/08/23","瑞士信貸",33,0,33
"11632","8112至上","110/08/23","第一金-大稻埕",0,25,-25
"11633","8112至上","110/08/23","中國信託-永康",31,0,31
"11634","8112至上","110/08/23","大慶-蘆洲",0,22,-22
"11635","8112至上","110/08/23","亞東",30,0,30
"11636","8112至上","110/08/23","永豐金-敦南",2,23,-21
"11637","8112至上","110/08/23","亞東-台中",26,0,26
"11638","8112至上","110/08/23","台中銀",0,20,-20
"11639","8112至上","110/08/23","富邦-北港",35,11,24
"11640","8112至上","110/08/23","兆豐-西螺",0,20,-20
"11641","1570力肯","110/08/23","國票-和平",39,0,39
"11642","1570力肯","110/08/23","統一",0,28,-28
"11643","1570力肯","110/08/23","摩根大通",22,1,21
"11644","1570力肯","110/08/23","群益金鼎-東門",0,20,-20
"11645","1570力肯","110/08/23","臺銀",18,0,18
"11646","1570力肯","110/08/23","中國信託-嘉義",0,15,-15
"11647","1570力肯","110/08/23","台新-台中",18,0,18
"11648","1570力肯","110/08/23","台新證券",0,15,-15
"11649","1570力肯","110/08/23","凱基-台北",25,8,17
"11650","1570力肯","110/08/23","元富-世貿",0,10,-10
"11651","1570力肯","110/08/23","中農",10,0,10
"11652","1570力肯","110/08/23","國票-博愛",0,10,-10
"11653","1570力肯","110/08/23","瑞士信貸",5,0,5
"11654","1570力肯","110/08/23","元富-新興",0,9,-9
"11655","1570力肯","110/08/23","兆豐-松德",5,0,5
"11656","1570力肯","110/08/23","新光",0,9,-9
"11657","1570力肯","110/08/23","凱基-高美館",5,0,5
"11658","1570力肯","110/08/23","元大-四維",1,7,-6
"11659","1570力肯","110/08/23","凱基-幸福",5,0,5
"11660","1570力肯","110/08/23","元大-淡水",0,4,-4
"11661","1570力肯","110/08/23","元大-和平",20,15,5
"11662","1570力肯","110/08/23","元大-民生",0,4,-4
"11663","1570力肯","110/08/23","元大-草屯",5,0,5
"11664","1570力肯","110/08/23","元大-東港",0,4,-4
"11665","1570力肯","110/08/23","日盛-中壢",4,0,4
"11666","1570力肯","110/08/23","永豐金-松山",0,4,-4
"11667","1570力肯","110/08/23","國票-天祥",3,0,3
"11668","1570力肯","110/08/23","日盛-景美",0,3,-3
"11669","1570力肯","110/08/23","台灣企銀-屏東",2,0,2
"11670","1570力肯","110/08/23","中國信託-新竹",0,3,-3
"11671","2929淘帝","110/08/23","凱基-台北",27,2,25
"11672","2929淘帝","110/08/23","花旗環球",0,22,-22
"11673","2929淘帝","110/08/23","元大-太平",23,0,23
"11674","2929淘帝","110/08/23","宏遠-館前",0,20,-20
"11675","2929淘帝","110/08/23","元大-萬華",20,0,20
"11676","2929淘帝","110/08/23","富邦-高雄",0,20,-20
"11677","2929淘帝","110/08/23","港商野村",14,0,14
"11678","2929淘帝","110/08/23","兆豐-北高雄",0,17,-17
"11679","2929淘帝","110/08/23","摩根大通",14,0,14
"11680","2929淘帝","110/08/23","致和-高雄",0,10,-10
"11681","2929淘帝","110/08/23","富邦-陽明",11,0,11
"11682","2929淘帝","110/08/23","康和-內湖",0,10,-10
"11683","2929淘帝","110/08/23","元大-文心興安",10,0,10
"11684","2929淘帝","110/08/23","元大-沙鹿",0,9,-9
"11685","2929淘帝","110/08/23","永豐金-大園",10,0,10
"11686","2929淘帝","110/08/23","元大-豐原站前",0,8,-8
"11687","2929淘帝","110/08/23","凱基-林口",7,0,7
"11688","2929淘帝","110/08/23","高橋-龍潭",0,7,-7
"11689","2929淘帝","110/08/23","新加坡商瑞銀",9,3,6
"11690","2929淘帝","110/08/23","臺銀-高雄",0,6,-6
"11691","2929淘帝","110/08/23","日盛-員林",5,0,5
"11692","2929淘帝","110/08/23","元富-新竹",0,6,-6
"11693","2929淘帝","110/08/23","元大-虎尾",5,0,5
"11694","2929淘帝","110/08/23","富邦-竹北",0,6,-6
"11695","2929淘帝","110/08/23","美林",6,2,4
"11696","2929淘帝","110/08/23","元大-莒光",0,5,-5
"11697","2929淘帝","110/08/23","港商法國興業",4,0,4
"11698","2929淘帝","110/08/23","元大-左營",0,5,-5
"11699","2929淘帝","110/08/23","凱基-東門",4,0,4
"11700","2929淘帝","110/08/23","元大-鹿港",0,5,-5
"11701","5410國眾","110/08/23","港商野村",14,0,14
"11702","5410國眾","110/08/23","元大-崇德",0,22,-22
"11703","5410國眾","110/08/23","凱基-台北",14,3,11
"11704","5410國眾","110/08/23","元大-清水",0,15,-15
"11705","5410國眾","110/08/23","凱基-科園",10,0,10
"11706","5410國眾","110/08/23","元大-金華",0,10,-10
"11707","5410國眾","110/08/23","華南永昌-高雄",7,0,7
"11708","5410國眾","110/08/23","元大-中壢",0,9,-9
"11709","5410國眾","110/08/23","新加坡商瑞銀",6,0,6
"11710","5410國眾","110/08/23","日盛-台中",0,8,-8
"11711","5410國眾","110/08/23","國泰-台中",5,0,5
"11712","5410國眾","110/08/23","元大-前金",0,6,-6
"11713","5410國眾","110/08/23","國泰-桃園",5,0,5
"11714","5410國眾","110/08/23","華南永昌-公誠",0,5,-5
"11715","5410國眾","110/08/23","華南永昌-淡水",5,0,5
"11716","5410國眾","110/08/23","臺銀-高雄",0,4,-4
"11717","5410國眾","110/08/23","新光",2,0,2
"11718","5410國眾","110/08/23","華南永昌-鶯歌",1,5,-4
"11719","5410國眾","110/08/23","國泰-台南",2,0,2
"11720","5410國眾","110/08/23","元富-烏日",0,3,-3
"11721","5410國眾","110/08/23","凱基-桃園",2,0,2
"11722","5410國眾","110/08/23","富邦-桃園",0,3,-3
"11723","5410國眾","110/08/23","富邦-建國",2,0,2
"11724","5410國眾","110/08/23","元大-發財",0,2,-2
"11725","5410國眾","110/08/23","永豐金-敦北",2,0,2
"11726","5410國眾","110/08/23","元大-雙和",0,2,-2
"11727","5410國眾","110/08/23","日盛-園區",1,0,1
"11728","5410國眾","110/08/23","日盛-中和",0,1,-1
"11729","5410國眾","110/08/23","第一金-中壢",1,0,1
"11730","5410國眾","110/08/23","彰銀",0,1,-1
"11731","2841台開","110/08/23","宏遠-館前",300,0,300
"11732","2841台開","110/08/23","台中銀",0,74,-74
"11733","2841台開","110/08/23","第一金",54,0,54
"11734","2841台開","110/08/23","港商野村",0,62,-62
"11735","2841台開","110/08/23","元大-仁愛",38,0,38
"11736","2841台開","110/08/23","永豐金-敦南",10,58,-48
"11737","2841台開","110/08/23","合庫-三重",15,0,15
"11738","2841台開","110/08/23","台新-三民",0,39,-39
"11739","2841台開","110/08/23","玉山-新竹",15,0,15
"11740","2841台開","110/08/23","日盛證券",0,27,-27
"11741","2841台開","110/08/23","元大-大里德芳",10,0,10
"11742","2841台開","110/08/23","新光",13,37,-24
"11743","2841台開","110/08/23","元大-新莊",10,0,10
"11744","2841台開","110/08/23","凱基-虎尾",0,20,-20
"11745","2841台開","110/08/23","元富-緯城",5,0,5
"11746","2841台開","110/08/23","永豐金-忠孝",0,20,-20
"11747","2841台開","110/08/23","第一金-台南",4,0,4
"11748","2841台開","110/08/23","富邦-板橋",0,19,-19
"11749","2841台開","110/08/23","富邦-岡山",4,0,4
"11750","2841台開","110/08/23","凱基-東港",0,15,-15
"11751","2841台開","110/08/23","元大-虎尾",4,0,4
"11752","2841台開","110/08/23","國泰-敦南",0,11,-11
"11753","2841台開","110/08/23","元大-學甲",2,0,2
"11754","2841台開","110/08/23","元大-竹北",0,10,-10
"11755","2841台開","110/08/23","元大-草屯",2,0,2
"11756","2841台開","110/08/23","元大-彰化",1,11,-10
"11757","2841台開","110/08/23","台中銀-員林",1,0,1
"11758","2841台開","110/08/23","元大-北三重",0,10,-10
"11759","2841台開","110/08/23","台新-新營",1,0,1
"11760","2841台開","110/08/23","國泰-桃園",1,9,-8
"11761","6207雷科","110/08/23","摩根大通",29,6,23
"11762","6207雷科","110/08/23","元大-高雄",0,75,-75
"11763","6207雷科","110/08/23","凱基-台北",18,3,15
"11764","6207雷科","110/08/23","華南永昌-世貿",0,38,-38
"11765","6207雷科","110/08/23","安泰-楠梓",11,0,11
"11766","6207雷科","110/08/23","凱基-高雄",0,13,-13
"11767","6207雷科","110/08/23","凱基-頭份",12,1,11
"11768","6207雷科","110/08/23","港商野村",7,19,-12
"11769","6207雷科","110/08/23","群益金鼎-中壢",10,0,10
"11770","6207雷科","110/08/23","新加坡商瑞銀",1,13,-12
"11771","6207雷科","110/08/23","統一-中壢",9,0,9
"11772","6207雷科","110/08/23","元大-新莊",0,7,-7
"11773","6207雷科","110/08/23","元大-敦南",9,0,9
"11774","6207雷科","110/08/23","兆豐-公益",0,6,-6
"11775","6207雷科","110/08/23","瑞士信貸",8,0,8
"11776","6207雷科","110/08/23","合庫-高雄",0,5,-5
"11777","6207雷科","110/08/23","兆豐-嘉義",8,0,8
"11778","6207雷科","110/08/23","宏遠-高雄",0,5,-5
"11779","6207雷科","110/08/23","華南永昌-古亭",7,0,7
"11780","6207雷科","110/08/23","凱基-板橋",0,5,-5
"11781","6207雷科","110/08/23","富邦-陽明",7,0,7
"11782","6207雷科","110/08/23","群益金鼎-三民",0,4,-4
"11783","6207雷科","110/08/23","日盛-員林",6,0,6
"11784","6207雷科","110/08/23","群益金鼎-東門",0,4,-4
"11785","6207雷科","110/08/23","德信-新營",5,0,5
"11786","6207雷科","110/08/23","富邦-羅東",0,4,-4
"11787","6207雷科","110/08/23","凱基-高美館",5,0,5
"11788","6207雷科","110/08/23","元富-虎尾",0,3,-3
"11789","6207雷科","110/08/23","玉山-高雄",4,0,4
"11790","6207雷科","110/08/23","國泰-桃園",0,3,-3
"11791","3679新至陞","110/08/23","永豐金-南投",17,0,17
"11792","3679新至陞","110/08/23","港商法國興業",0,8,-8
"11793","3679新至陞","110/08/23","元富-埔里",9,0,9
"11794","3679新至陞","110/08/23","凱基-長庚",0,8,-8
"11795","3679新至陞","110/08/23","(牛牛牛)亞-網路",7,0,7
"11796","3679新至陞","110/08/23","宏遠-光隆",0,6,-6
"11797","3679新至陞","110/08/23","美林",7,1,6
"11798","3679新至陞","110/08/23","玉山-高雄",0,5,-5
"11799","3679新至陞","110/08/23","台灣摩根士丹利",5,0,5
"11800","3679新至陞","110/08/23","群益金鼎-高盛",0,3,-3
"11801","3679新至陞","110/08/23","瑞士信貸",6,1,5
"11802","3679新至陞","110/08/23","華南永昌-林口",0,3,-3
"11803","3679新至陞","110/08/23","元大-樹林",5,0,5
"11804","3679新至陞","110/08/23","元大證券",0,3,-3
"11805","3679新至陞","110/08/23","元大-文心興安",6,2,4
"11806","3679新至陞","110/08/23","元大-小港",0,3,-3
"11807","3679新至陞","110/08/23","凱基-台北",3,0,3
"11808","3679新至陞","110/08/23","統一-敦南",0,2,-2
"11809","3679新至陞","110/08/23","臺銀",2,0,2
"11810","3679新至陞","110/08/23","元富-大昌",0,2,-2
"11811","3679新至陞","110/08/23","臺銀-臺中",3,1,2
"11812","3679新至陞","110/08/23","玉山-新莊",0,2,-2
"11813","3679新至陞","110/08/23","新光-高雄",2,0,2
"11814","3679新至陞","110/08/23","群益金鼎-三民",0,2,-2
"11815","3679新至陞","110/08/23","華南永昌",2,0,2
"11816","3679新至陞","110/08/23","富邦-新竹",0,2,-2
"11817","3679新至陞","110/08/23","日盛-二林",1,0,1
"11818","3679新至陞","110/08/23","元大-敦化",0,2,-2
"11819","3679新至陞","110/08/23","新加坡商瑞銀",1,0,1
"11820","3679新至陞","110/08/23","永豐金-內湖",0,2,-2
"11821","2727王品","110/08/23","凱基-台北",163,48,115
"11822","2727王品","110/08/23","港商麥格理",0,51,-51
"11823","2727王品","110/08/23","台灣摩根士丹利",62,0,62
"11824","2727王品","110/08/23","國票-南港",0,50,-50
"11825","2727王品","110/08/23","元大-台中中港",58,0,58
"11826","2727王品","110/08/23","台新證券",9,35,-26
"11827","2727王品","110/08/23","美林",48,0,48
"11828","2727王品","110/08/23","元大-景美",2,21,-19
"11829","2727王品","110/08/23","摩根大通",73,41,32
"11830","2727王品","110/08/23","大慶-台南",0,15,-15
"11831","2727王品","110/08/23","港商野村",61,35,26
"11832","2727王品","110/08/23","中國信託-高雄",1,15,-14
"11833","2727王品","110/08/23","統一",21,4,17
"11834","2727王品","110/08/23","永豐金-市政",2,13,-11
"11835","2727王品","110/08/23","群益金鼎-大興",15,0,15
"11836","2727王品","110/08/23","第一金-桃園",0,10,-10
"11837","2727王品","110/08/23","台灣企銀",12,0,12
"11838","2727王品","110/08/23","玉山證券",1,11,-10
"11839","2727王品","110/08/23","新加坡商瑞銀",11,0,11
"11840","2727王品","110/08/23","凱基-三重",0,10,-10
"11841","2727王品","110/08/23","統一-三重",10,0,10
"11842","2727王品","110/08/23","富邦-建國",0,10,-10
"11843","2727王品","110/08/23","永豐金-竹科",13,3,10
"11844","2727王品","110/08/23","美商高盛",7,16,-9
"11845","2727王品","110/08/23","合庫-台中",10,1,9
"11846","2727王品","110/08/23","群益金鼎-三重",0,9,-9
"11847","2727王品","110/08/23","香港上海匯豐",9,0,9
"11848","2727王品","110/08/23","群益金鼎-宜蘭",0,9,-9
"11849","2727王品","110/08/23","凱基-台南",10,2,8
"11850","2727王品","110/08/23","凱基-高美館",0,9,-9
"11851","1570力肯","110/08/23","國票-和平",39,0,39
"11852","1570力肯","110/08/23","統一",0,28,-28
"11853","1570力肯","110/08/23","摩根大通",22,1,21
"11854","1570力肯","110/08/23","群益金鼎-東門",0,20,-20
"11855","1570力肯","110/08/23","臺銀",18,0,18
"11856","1570力肯","110/08/23","中國信託-嘉義",0,15,-15
"11857","1570力肯","110/08/23","台新-台中",18,0,18
"11858","1570力肯","110/08/23","台新證券",0,15,-15
"11859","1570力肯","110/08/23","凱基-台北",25,8,17
"11860","1570力肯","110/08/23","元富-世貿",0,10,-10
"11861","1570力肯","110/08/23","中農",10,0,10
"11862","1570力肯","110/08/23","國票-博愛",0,10,-10
"11863","1570力肯","110/08/23","瑞士信貸",5,0,5
"11864","1570力肯","110/08/23","元富-新興",0,9,-9
"11865","1570力肯","110/08/23","兆豐-松德",5,0,5
"11866","1570力肯","110/08/23","新光",0,9,-9
"11867","1570力肯","110/08/23","凱基-高美館",5,0,5
"11868","1570力肯","110/08/23","元大-四維",1,7,-6
"11869","1570力肯","110/08/23","凱基-幸福",5,0,5
"11870","1570力肯","110/08/23","元大-淡水",0,4,-4
"11871","1570力肯","110/08/23","元大-和平",20,15,5
"11872","1570力肯","110/08/23","元大-民生",0,4,-4
"11873","1570力肯","110/08/23","元大-草屯",5,0,5
"11874","1570力肯","110/08/23","元大-東港",0,4,-4
"11875","1570力肯","110/08/23","日盛-中壢",4,0,4
"11876","1570力肯","110/08/23","永豐金-松山",0,4,-4
"11877","1570力肯","110/08/23","國票-天祥",3,0,3
"11878","1570力肯","110/08/23","日盛-景美",0,3,-3
"11879","1570力肯","110/08/23","台灣企銀-屏東",2,0,2
"11880","1570力肯","110/08/23","中國信託-新竹",0,3,-3
"11881","6180橘子","110/08/23","凱基-台北",107,15,92
"11882","6180橘子","110/08/23","國泰-館前",2,28,-26
"11883","6180橘子","110/08/23","美林",50,0,50
"11884","6180橘子","110/08/23","元大-中壢",0,22,-22
"11885","6180橘子","110/08/23","摩根大通",66,24,42
"11886","6180橘子","110/08/23","華南永昌-鶯歌",0,21,-21
"11887","6180橘子","110/08/23","港商野村",38,2,36
"11888","6180橘子","110/08/23","台灣企銀-屏東",0,18,-18
"11889","6180橘子","110/08/23","元富-高雄",22,0,22
"11890","6180橘子","110/08/23","永豐金-中壢",0,18,-18
"11891","6180橘子","110/08/23","元大-上新莊",21,0,21
"11892","6180橘子","110/08/23","兆豐-台中",0,17,-17
"11893","6180橘子","110/08/23","福勝",19,1,18
"11894","6180橘子","110/08/23","新光-高雄",1,18,-17
"11895","6180橘子","110/08/23","富邦-內湖",13,2,11
"11896","6180橘子","110/08/23","台灣摩根士丹利",9,21,-12
"11897","6180橘子","110/08/23","永豐金證券",11,0,11
"11898","6180橘子","110/08/23","富邦-永和",0,12,-12
"11899","6180橘子","110/08/23","彰銀-七賢",10,0,10
"11900","6180橘子","110/08/23","合庫-自強",0,11,-11
"11901","6180橘子","110/08/23","中國信託-高雄",10,0,10
"11902","6180橘子","110/08/23","元大-發財",0,11,-11
"11903","6180橘子","110/08/23","兆豐-埔墘",10,0,10
"11904","6180橘子","110/08/23","第一金-新興",0,10,-10
"11905","6180橘子","110/08/23","群益金鼎-敦南",10,0,10
"11906","6180橘子","110/08/23","統一-中壢",0,10,-10
"11907","6180橘子","110/08/23","元大-台南",10,0,10
"11908","6180橘子","110/08/23","台新-屏東",0,10,-10
"11909","6180橘子","110/08/23","元大-左營",11,1,10
"11910","6180橘子","110/08/23","元大-旗山",0,10,-10
"11911","2390云辰","110/08/23","元大-土城學府",197,0,197
"11912","2390云辰","110/08/23","凱基-台北",87,301,-214
"11913","2390云辰","110/08/23","新光-台中",154,34,120
"11914","2390云辰","110/08/23","兆豐-公益",4,173,-169
"11915","2390云辰","110/08/23","宏遠證券",100,0,100
"11916","2390云辰","110/08/23","國票-博愛",65,200,-135
"11917","2390云辰","110/08/23","凱基-林口",92,0,92
"11918","2390云辰","110/08/23","群益金鼎-三重",8,112,-104
"11919","2390云辰","110/08/23","統一-新台中",83,1,82
"11920","2390云辰","110/08/23","日盛-園區",4,104,-100
"11921","2390云辰","110/08/23","凱基-竹北",62,8,54
"11922","2390云辰","110/08/23","凱基-屏東",1,101,-100
"11923","2390云辰","110/08/23","華南永昌-公誠",66,15,51
"11924","2390云辰","110/08/23","富邦-花蓮",2,100,-98
"11925","2390云辰","110/08/23","國泰-敦南",172,129,43
"11926","2390云辰","110/08/23","摩根大通",83,162,-79
"11927","2390云辰","110/08/23","統一-新竹",44,7,37
"11928","2390云辰","110/08/23","元富-花蓮",2,74,-72
"11929","2390云辰","110/08/23","元大-沙鹿",73,39,34
"11930","2390云辰","110/08/23","第一金-安和",32,101,-69
"11931","2390云辰","110/08/23","元大-新盛",47,16,31
"11932","2390云辰","110/08/23","美商高盛",26,92,-66
"11933","2390云辰","110/08/23","華南永昌-鳳山",29,3,26
"11934","2390云辰","110/08/23","統一-三重",6,71,-65
"11935","2390云辰","110/08/23","大昌-樹林",34,9,25
"11936","2390云辰","110/08/23","富邦-嘉義",195,260,-65
"11937","2390云辰","110/08/23","富邦-陽明",59,34,25
"11938","2390云辰","110/08/23","元大-忠孝鼎富",0,50,-50
"11939","2390云辰","110/08/23","富邦-宜蘭",28,3,25
"11940","2390云辰","110/08/23","統一-城中",7,53,-46
"11941","1315達新","110/08/20","日盛-和美",16,0,16
"11942","1315達新","110/08/20","香港上海匯豐",0,41,-41
"11943","1315達新","110/08/20","元富-成功",10,0,10
"11944","1315達新","110/08/20","元大-文心興安",2,36,-34
"11945","1315達新","110/08/20","兆豐-台中",10,0,10
"11946","1315達新","110/08/20","港商麥格理",0,26,-26
"11947","1315達新","110/08/20","凱基-中港",10,0,10
"11948","1315達新","110/08/20","元富",0,14,-14
"11949","1315達新","110/08/20","元大-桃園",8,0,8
"11950","1315達新","110/08/20","元富-敦南",0,8,-8
"11951","1315達新","110/08/20","凱基-高美館",7,0,7
"11952","1315達新","110/08/20","凱基-台北",7,15,-8
"11953","1315達新","110/08/20","統一",5,0,5
"11954","1315達新","110/08/20","元大-花蓮",2,10,-8
"11955","1315達新","110/08/20","中國信託-高雄",5,0,5
"11956","1315達新","110/08/20","摩根大通",0,7,-7
"11957","1315達新","110/08/20","致和-東門",5,0,5
"11958","1315達新","110/08/20","(牛牛牛)亞證券",0,6,-6
"11959","1315達新","110/08/20","國票-北高雄",5,0,5
"11960","1315達新","110/08/20","群益金鼎-鳳山",0,6,-6
"11961","1315達新","110/08/20","國票-桃園",5,0,5
"11962","1315達新","110/08/20","美林",3,8,-5
"11963","1315達新","110/08/20","凱基-高雄",5,0,5
"11964","1315達新","110/08/20","玉山-大里",0,4,-4
"11965","1315達新","110/08/20","凱基-大安",5,0,5
"11966","1315達新","110/08/20","國票-安和",1,4,-3
"11967","1315達新","110/08/20","新光",5,1,4
"11968","1315達新","110/08/20","永興-台中",0,1,-1
"11969","1315達新","110/08/20","國泰-敦南",4,0,4
"11970","1315達新","110/08/20","光和-花壇",0,1,-1
"11971","2609陽明","110/08/20","摩根大通",7094,4108,2986
"11972","2609陽明","110/08/20","富邦證券",916,4167,-3251
"11973","2609陽明","110/08/20","凱基-台北",3009,829,2180
"11974","2609陽明","110/08/20","瑞士信貸",1961,3747,-1786
"11975","2609陽明","110/08/20","永豐金-信義",2022,49,1973
"11976","2609陽明","110/08/20","美林",3367,4938,-1571
"11977","2609陽明","110/08/20","富邦-虎尾",14038,12509,1529
"11978","2609陽明","110/08/20","元大證券",1688,3204,-1516
"11979","2609陽明","110/08/20","華南永昌-竹北",2009,531,1478
"11980","2609陽明","110/08/20","凱基-高美館",303,786,-483
"11981","2609陽明","110/08/20","群益金鼎-大安",1208,64,1144
"11982","2609陽明","110/08/20","日盛-板橋",125,587,-462
"11983","2609陽明","110/08/20","康和",5625,4754,871
"11984","2609陽明","110/08/20","富邦-北港",163,571,-408
"11985","2609陽明","110/08/20","兆豐-虎尾",919,77,842
"11986","2609陽明","110/08/20","凱基-台南",165,557,-392
"11987","2609陽明","110/08/20","新加坡商瑞銀",1133,390,743
"11988","2609陽明","110/08/20","元大-樹林",215,599,-384
"11989","2609陽明","110/08/20","統一-仁愛",1379,702,677
"11990","2609陽明","110/08/20","富邦-台中",246,596,-350
"11991","2609陽明","110/08/20","美商高盛",1051,452,599
"11992","2609陽明","110/08/20","凱基-復興",141,467,-326
"11993","2609陽明","110/08/20","凱基-市府",658,82,576
"11994","2609陽明","110/08/20","台新-高雄",483,807,-324
"11995","2609陽明","110/08/20","元大-新莊",665,169,496
"11996","2609陽明","110/08/20","日盛證券",323,619,-296
"11997","2609陽明","110/08/20","台灣摩根士丹利",773,365,408
"11998","2609陽明","110/08/20","法銀巴黎",0,292,-292
"11999","2609陽明","110/08/20","日盛-雙和",550,197,353
"12000","2609陽明","110/08/20","元大-北投",454,729,-275
"12001","2636台驊投控","110/08/20","摩根大通",709,415,294
"12002","2636台驊投控","110/08/20","台灣摩根士丹利",146,252,-106
"12003","2636台驊投控","110/08/20","台新-台中",176,64,112
"12004","2636台驊投控","110/08/20","港商野村",1266,1357,-91
"12005","2636台驊投控","110/08/20","統一",191,91,100
"12006","2636台驊投控","110/08/20","美林",246,335,-89
"12007","2636台驊投控","110/08/20","永豐金-萬盛",136,39,97
"12008","2636台驊投控","110/08/20","宏遠-新化",1,75,-74
"12009","2636台驊投控","110/08/20","永豐金-南京",105,33,72
"12010","2636台驊投控","110/08/20","群益金鼎-竹南",5,69,-64
"12011","2636台驊投控","110/08/20","日盛-景美",102,32,70
"12012","2636台驊投控","110/08/20","日盛-大墩",4,56,-52
"12013","2636台驊投控","110/08/20","日盛證券",154,103,51
"12014","2636台驊投控","110/08/20","第一金-台中",5,56,-51
"12015","2636台驊投控","110/08/20","第一金-桃園",54,7,47
"12016","2636台驊投控","110/08/20","日盛-宜蘭",2,52,-50
"12017","2636台驊投控","110/08/20","統一-基隆",47,5,42
"12018","2636台驊投控","110/08/20","兆豐-南京",0,49,-49
"12019","2636台驊投控","110/08/20","元富-城東",63,22,41
"12020","2636台驊投控","110/08/20","合庫-新竹",4,47,-43
"12021","2636台驊投控","110/08/20","富邦-建國",67,35,32
"12022","2636台驊投控","110/08/20","統一-城中",6,33,-27
"12023","2636台驊投控","110/08/20","元大-桃興",40,10,30
"12024","2636台驊投控","110/08/20","凱基-科園",7,34,-27
"12025","2636台驊投控","110/08/20","土銀-南港",34,6,28
"12026","2636台驊投控","110/08/20","新光",167,193,-26
"12027","2636台驊投控","110/08/20","永豐金-台南",54,27,27
"12028","2636台驊投控","110/08/20","群益金鼎-古亭",51,75,-24
"12029","2636台驊投控","110/08/20","富邦-台北",45,19,26
"12030","2636台驊投控","110/08/20","富邦-仁愛",51,74,-23
"12031","2867三商壽","110/08/20","凱基-台北",225,43,182
"12032","2867三商壽","110/08/20","宏遠證券",0,1023,-1023
"12033","2867三商壽","110/08/20","元大-土城永寧",150,2,148
"12034","2867三商壽","110/08/20","摩根大通",123,551,-428
"12035","2867三商壽","110/08/20","新光",213,72,141
"12036","2867三商壽","110/08/20","美商高盛",62,194,-132
"12037","2867三商壽","110/08/20","臺銀-鳳山",131,26,105
"12038","2867三商壽","110/08/20","國票-中正",0,130,-130
"12039","2867三商壽","110/08/20","元大-屏東民生",100,0,100
"12040","2867三商壽","110/08/20","美林",1,114,-113
"12041","2867三商壽","110/08/20","元大-桃園",100,1,99
"12042","2867三商壽","110/08/20","台灣摩根士丹利",31,107,-76
"12043","2867三商壽","110/08/20","永豐金-埔里",94,20,74
"12044","2867三商壽","110/08/20","富邦-中壢",1,75,-74
"12045","2867三商壽","110/08/20","土銀-台中",60,0,60
"12046","2867三商壽","110/08/20","華南永昌-南京",10,70,-60
"12047","2867三商壽","110/08/20","臺銀-高雄",56,1,55
"12048","2867三商壽","110/08/20","富邦-彰化",10,67,-57
"12049","2867三商壽","110/08/20","統一-台南",55,0,55
"12050","2867三商壽","110/08/20","凱基-高美館",0,50,-50
"12051","2867三商壽","110/08/20","富邦-仁愛",53,0,53
"12052","2867三商壽","110/08/20","港商野村",35,68,-33
"12053","2867三商壽","110/08/20","富邦-台北",44,1,43
"12054","2867三商壽","110/08/20","台新-高雄",1,31,-30
"12055","2867三商壽","110/08/20","合庫-高雄",40,0,40
"12056","2867三商壽","110/08/20","元大-北屯",9,36,-27
"12057","2867三商壽","110/08/20","華南永昌-虎尾",50,10,40
"12058","2867三商壽","110/08/20","法銀巴黎",1,27,-26
"12059","2867三商壽","110/08/20","富邦-宜蘭",40,0,40
"12060","2867三商壽","110/08/20","日盛-中壢",0,20,-20
"12061","5521工信","110/08/20","元大-內湖",55,0,55
"12062","5521工信","110/08/20","美商高盛",0,182,-182
"12063","5521工信","110/08/20","日進",36,0,36
"12064","5521工信","110/08/20","摩根大通",39,180,-141
"12065","5521工信","110/08/20","兆豐-來福",30,0,30
"12066","5521工信","110/08/20","凱基-台北",0,101,-101
"12067","5521工信","110/08/20","元大-屏南",30,0,30
"12068","5521工信","110/08/20","富邦-岡山",0,50,-50
"12069","5521工信","110/08/20","台新證券",26,4,22
"12070","5521工信","110/08/20","港商野村",0,41,-41
"12071","5521工信","110/08/20","玉山-台大",25,5,20
"12072","5521工信","110/08/20","台灣摩根士丹利",1,30,-29
"12073","5521工信","110/08/20","群益金鼎-忠孝",20,0,20
"12074","5521工信","110/08/20","群益金鼎-高雄",0,20,-20
"12075","5521工信","110/08/20","富邦-台北",20,0,20
"12076","5521工信","110/08/20","華南永昌-中正",0,20,-20
"12077","5521工信","110/08/20","永豐金-中正",19,0,19
"12078","5521工信","110/08/20","台新-新營",0,19,-19
"12079","5521工信","110/08/20","統一-員林",15,0,15
"12080","5521工信","110/08/20","華南永昌-彰化",2,20,-18
"12081","5521工信","110/08/20","合庫-桃園",12,0,12
"12082","5521工信","110/08/20","群益金鼎-潭子",0,15,-15
"12083","5521工信","110/08/20","陽信-石牌",11,0,11
"12084","5521工信","110/08/20","元大-板橋",0,15,-15
"12085","5521工信","110/08/20","元大-基隆孝二",11,0,11
"12086","5521工信","110/08/20","元大-南屯",1,15,-14
"12087","5521工信","110/08/20","土銀-白河",10,0,10
"12088","5521工信","110/08/20","永豐金-桃盛",0,10,-10
"12089","5521工信","110/08/20","華南永昌-大安",10,0,10
"12090","5521工信","110/08/20","聯邦-雙和",0,8,-8
"12091","1471首利","110/08/20","富邦-員林",41,0,41
"12092","1471首利","110/08/20","元大-草屯",1,100,-99
"12093","1471首利","110/08/20","摩根大通",88,63,25
"12094","1471首利","110/08/20","元富-民權",0,41,-41
"12095","1471首利","110/08/20","永豐金-板盛",23,0,23
"12096","1471首利","110/08/20","致和-府前",0,20,-20
"12097","1471首利","110/08/20","台新證券",30,11,19
"12098","1471首利","110/08/20","大慶-蘆洲",0,14,-14
"12099","1471首利","110/08/20","日盛-高雄",15,0,15
"12100","1471首利","110/08/20","凱基-台北",3,16,-13
"12101","1471首利","110/08/20","瑞士信貸",36,21,15
"12102","1471首利","110/08/20","玉山-新莊",1,12,-11
"12103","1471首利","110/08/20","元大-成功",15,0,15
"12104","1471首利","110/08/20","日盛-樹林",0,10,-10
"12105","1471首利","110/08/20","元大-鳳山",13,0,13
"12106","1471首利","110/08/20","台中銀-豐原",0,10,-10
"12107","1471首利","110/08/20","美林",11,0,11
"12108","1471首利","110/08/20","國票-新莊",0,10,-10
"12109","1471首利","110/08/20","兆豐-西螺",10,0,10
"12110","1471首利","110/08/20","元大-開元",0,10,-10
"12111","1471首利","110/08/20","台新-台南",10,0,10
"12112","1471首利","110/08/20","新光",9,18,-9
"12113","1471首利","110/08/20","新光-台中",7,0,7
"12114","1471首利","110/08/20","元大-台中",0,8,-8
"12115","1471首利","110/08/20","凱基-長庚",7,0,7
"12116","1471首利","110/08/20","富邦-竹東",0,7,-7
"12117","1471首利","110/08/20","日盛-大墩",6,0,6
"12118","1471首利","110/08/20","元大-善化",0,7,-7
"12119","1471首利","110/08/20","國泰-敦南",6,0,6
"12120","1471首利","110/08/20","永豐金-忠孝",0,7,-7
"12121","2883開發金","110/08/20","美商高盛",5045,274,4771
"12122","2883開發金","110/08/20","元大-草屯",110,5813,-5703
"12123","2883開發金","110/08/20","摩根大通",6375,3996,2379
"12124","2883開發金","110/08/20","元大-雙和",35,5050,-5015
"12125","2883開發金","110/08/20","瑞士信貸",2180,184,1996
"12126","2883開發金","110/08/20","元富",228,2528,-2300
"12127","2883開發金","110/08/20","港商野村",4455,2645,1810
"12128","2883開發金","110/08/20","新光",2896,4495,-1599
"12129","2883開發金","110/08/20","美林",1695,187,1508
"12130","2883開發金","110/08/20","法銀巴黎",12,1549,-1537
"12131","2883開發金","110/08/20","凱基-台北",3659,2336,1323
"12132","2883開發金","110/08/20","統一",61,1390,-1329
"12133","2883開發金","110/08/20","富邦證券",1343,39,1304
"12134","2883開發金","110/08/20","台灣匯立證券",0,995,-995
"12135","2883開發金","110/08/20","臺銀",1447,177,1270
"12136","2883開發金","110/08/20","台灣摩根士丹利",1050,1929,-879
"12137","2883開發金","110/08/20","國泰證券",1228,72,1156
"12138","2883開發金","110/08/20","元大-前金",15,785,-770
"12139","2883開發金","110/08/20","華南永昌",1230,198,1032
"12140","2883開發金","110/08/20","元大-桃興",64,796,-732
"12141","2883開發金","110/08/20","元大證券",1137,317,820
"12142","2883開發金","110/08/20","宏遠-台南",80,759,-679
"12143","2883開發金","110/08/20","致和證券",819,0,819
"12144","2883開發金","110/08/20","合庫證券",245,861,-616
"12145","2883開發金","110/08/20","元大-善化",756,83,673
"12146","2883開發金","110/08/20","元大-大灣",46,660,-614
"12147","2883開發金","110/08/20","元大-新莊",731,108,623
"12148","2883開發金","110/08/20","國票-南港",32,641,-609
"12149","2883開發金","110/08/20","凱基",520,10,510
"12150","2883開發金","110/08/20","群益金鼎-開元",30,551,-521
"12151","6205詮欣","110/08/20","聯邦商銀",27,0,27
"12152","6205詮欣","110/08/20","凱基-新店",0,24,-24
"12153","6205詮欣","110/08/20","凱基-汐止",25,0,25
"12154","6205詮欣","110/08/20","元大-忠孝",0,18,-18
"12155","6205詮欣","110/08/20","元大-汐止",10,0,10
"12156","6205詮欣","110/08/20","瑞士信貸",0,17,-17
"12157","6205詮欣","110/08/20","臺銀-臺中",7,0,7
"12158","6205詮欣","110/08/20","摩根大通",2,11,-9
"12159","6205詮欣","110/08/20","統一-基隆",7,0,7
"12160","6205詮欣","110/08/20","日盛-永康",0,5,-5
"12161","6205詮欣","110/08/20","臺銀-高雄",6,0,6
"12162","6205詮欣","110/08/20","聯邦-興中",0,5,-5
"12163","6205詮欣","110/08/20","臺銀-民權",5,0,5
"12164","6205詮欣","110/08/20","華南永昌-公誠",0,5,-5
"12165","6205詮欣","110/08/20","亞東",4,0,4
"12166","6205詮欣","110/08/20","元大-西螺",0,5,-5
"12167","6205詮欣","110/08/20","玉山證券",4,0,4
"12168","6205詮欣","110/08/20","群益金鼎-永和",0,4,-4
"12169","6205詮欣","110/08/20","華南永昌-古亭",4,0,4
"12170","6205詮欣","110/08/20","元大-新竹經國",0,4,-4
"12171","6205詮欣","110/08/20","元大-博愛",4,0,4
"12172","6205詮欣","110/08/20","永興-大墩",0,3,-3
"12173","6205詮欣","110/08/20","元富-草屯",3,0,3
"12174","6205詮欣","110/08/20","國票-和平",0,3,-3
"12175","6205詮欣","110/08/20","合庫-鳳山",2,0,2
"12176","6205詮欣","110/08/20","國泰-敦南",0,3,-3
"12177","6205詮欣","110/08/20","日進",2,0,2
"12178","6205詮欣","110/08/20","華南永昌",0,3,-3
"12179","6205詮欣","110/08/20","凱基-苗栗",2,0,2
"12180","6205詮欣","110/08/20","永豐金-新竹",0,3,-3
"12181","1540喬福","110/08/20","富邦-員林",11,0,11
"12182","1540喬福","110/08/20","元大-北三重",0,12,-12
"12183","1540喬福","110/08/20","永豐金-鳳山",5,0,5
"12184","1540喬福","110/08/20","元大-土城永寧",0,10,-10
"12185","1540喬福","110/08/20","亞東",4,0,4
"12186","1540喬福","110/08/20","新光-新竹",1,6,-5
"12187","1540喬福","110/08/20","新光",3,0,3
"12188","1540喬福","110/08/20","富邦-台南",0,5,-5
"12189","1540喬福","110/08/20","日盛-頭份",2,0,2
"12190","1540喬福","110/08/20","元大-龍潭",0,5,-5
"12191","1540喬福","110/08/20","第一金-嘉義",2,0,2
"12192","1540喬福","110/08/20","日盛-台中",0,2,-2
"12193","1540喬福","110/08/20","兆豐-鹿港",2,0,2
"12194","1540喬福","110/08/20","元大-東港",0,1,-1
"12195","1540喬福","110/08/20","摩根大通",2,0,2
"12196","1540喬福","110/08/20","日盛-板橋",0,0,0
"12197","1540喬福","110/08/20","玉山-桃園",1,0,1
"12198","1540喬福","110/08/20","元富",1,1,0
"12199","1540喬福","110/08/20","凱基-台北",1,0,1
"12200","1540喬福","110/08/20","康和-板橋",0,0,0
"12201","1540喬福","110/08/20","凱基-嘉義",1,0,1
"12202","1540喬福","110/08/20","國泰-敦南",0,0,0
"12203","1540喬福","110/08/20","凱基-市府",1,0,1
"12204","1540喬福","110/08/20","群益金鼎-板橋",0,0,0
"12205","1540喬福","110/08/20","群益金鼎-潭子",1,0,1
"12206","1540喬福","110/08/20","富邦-桃園",0,0,0
"12207","1540喬福","110/08/20","台灣企銀-建成",1,0,1
"12208","1540喬福","110/08/20","元大-西門",0,0,0
"12209","1540喬福","110/08/20","國票-天祥",1,0,1
"12210","1540喬福","110/08/20","元大-草屯",0,0,0
"12211","2888新光金","110/08/20","元富",2479,10,2469
"12212","2888新光金","110/08/20","摩根大通",2428,8920,-6492
"12213","2888新光金","110/08/20","華南永昌",1300,1,1299
"12214","2888新光金","110/08/20","台灣摩根士丹利",272,5505,-5233
"12215","2888新光金","110/08/20","凱基-頭份",1104,10,1094
"12216","2888新光金","110/08/20","美商高盛",23,4545,-4522
"12217","2888新光金","110/08/20","新光",1484,401,1083
"12218","2888新光金","110/08/20","瑞士信貸",62,1483,-1421
"12219","2888新光金","110/08/20","元大證券",1044,239,805
"12220","2888新光金","110/08/20","港商法國興業",66,1075,-1009
"12221","2888新光金","110/08/20","國票-北高雄",711,0,711
"12222","2888新光金","110/08/20","元大-大雅",47,998,-951
"12223","2888新光金","110/08/20","兆豐-台中港",629,0,629
"12224","2888新光金","110/08/20","法銀巴黎",449,1363,-914
"12225","2888新光金","110/08/20","臺銀",509,9,500
"12226","2888新光金","110/08/20","國票-九鼎",27,911,-884
"12227","2888新光金","110/08/20","國泰-忠孝",491,53,438
"12228","2888新光金","110/08/20","港商野村",79,637,-558
"12229","2888新光金","110/08/20","國泰-敦南",466,37,429
"12230","2888新光金","110/08/20","群益金鼎-瑞豐",11,560,-549
"12231","2888新光金","110/08/20","台中銀",442,30,412
"12232","2888新光金","110/08/20","德信-和平",8,500,-492
"12233","2888新光金","110/08/20","富邦-南屯",429,30,399
"12234","2888新光金","110/08/20","元大-大天母",54,452,-398
"12235","2888新光金","110/08/20","元大-三重",338,11,327
"12236","2888新光金","110/08/20","合庫證券",34,393,-359
"12237","2888新光金","110/08/20","永豐金-大園",326,10,316
"12238","2888新光金","110/08/20","群益金鼎",16,358,-342
"12239","2888新光金","110/08/20","北城證券",306,6,300
"12240","2888新光金","110/08/20","群益金鼎-板橋",6,304,-298
"12241","1340勝悅","110/08/20","元富-成功",23,0,23
"12242","1340勝悅","110/08/20","摩根大通",0,13,-13
"12243","1340勝悅","110/08/20","華南永昌-高雄",11,0,11
"12244","1340勝悅","110/08/20","港商法國興業",0,10,-10
"12245","1340勝悅","110/08/20","統一-城中",8,2,6
"12246","1340勝悅","110/08/20","凱基-東勢",0,10,-10
"12247","1340勝悅","110/08/20","元大-北成功",6,0,6
"12248","1340勝悅","110/08/20","元大-楊梅",0,10,-10
"12249","1340勝悅","110/08/20","臺銀-臺中",5,0,5
"12250","1340勝悅","110/08/20","華南永昌-東昇",0,9,-9
"12251","1340勝悅","110/08/20","臺灣企銀-埔墘",5,0,5
"12252","1340勝悅","110/08/20","合庫-自強",0,5,-5
"12253","1340勝悅","110/08/20","日盛-板橋",5,0,5
"12254","1340勝悅","110/08/20","兆豐-新竹",0,5,-5
"12255","1340勝悅","110/08/20","美商高盛",4,0,4
"12256","1340勝悅","110/08/20","玉山-桃園",0,5,-5
"12257","1340勝悅","110/08/20","大昌",3,0,3
"12258","1340勝悅","110/08/20","元大-復北",0,5,-5
"12259","1340勝悅","110/08/20","台中銀",2,0,2
"12260","1340勝悅","110/08/20","兆豐-來福",0,4,-4
"12261","1340勝悅","110/08/20","新光-台中",2,0,2
"12262","1340勝悅","110/08/20","新光",0,4,-4
"12263","1340勝悅","110/08/20","群益金鼎-崇德",2,0,2
"12264","1340勝悅","110/08/20","瑞士信貸",0,3,-3
"12265","1340勝悅","110/08/20","群益金鼎-館前",2,0,2
"12266","1340勝悅","110/08/20","台新證券",0,3,-3
"12267","1340勝悅","110/08/20","華南永昌-忠孝",2,0,2
"12268","1340勝悅","110/08/20","臺銀-鳳山",0,2,-2
"12269","1340勝悅","110/08/20","富邦-北港",2,0,2
"12270","1340勝悅","110/08/20","美林",0,2,-2
"12271","6246臺龍","110/08/20","新光-台中",18,0,18
"12272","6246臺龍","110/08/20","元大-林園",0,20,-20
"12273","6246臺龍","110/08/20","凱基-台北",15,0,15
"12274","6246臺龍","110/08/20","凱基-永和",1,15,-14
"12275","6246臺龍","110/08/20","元大-台北",8,0,8
"12276","6246臺龍","110/08/20","凱基-竹北",0,12,-12
"12277","6246臺龍","110/08/20","元大-北屯",6,0,6
"12278","6246臺龍","110/08/20","富邦-桃園",0,6,-6
"12279","6246臺龍","110/08/20","臺銀-臺中",4,0,4
"12280","6246臺龍","110/08/20","國泰-敦南",0,5,-5
"12281","6246臺龍","110/08/20","元富-吉利",4,0,4
"12282","6246臺龍","110/08/20","日盛證券",0,3,-3
"12283","6246臺龍","110/08/20","凱基-內湖",4,0,4
"12284","6246臺龍","110/08/20","第一金-台南",0,3,-3
"12285","6246臺龍","110/08/20","富邦-建國",4,0,4
"12286","6246臺龍","110/08/20","第一金-桃園",0,3,-3
"12287","6246臺龍","110/08/20","宏遠-新化",3,0,3
"12288","6246臺龍","110/08/20","群益金鼎-北高雄",0,3,-3
"12289","6246臺龍","110/08/20","第一金-大稻埕",2,0,2
"12290","6246臺龍","110/08/20","凱基-虎尾",0,3,-3
"12291","6246臺龍","110/08/20","國票-敦北法人",2,0,2
"12292","6246臺龍","110/08/20","元大-博愛",0,3,-3
"12293","6246臺龍","110/08/20","群益金鼎-開元",2,0,2
"12294","6246臺龍","110/08/20","統一-新竹",0,2,-2
"12295","6246臺龍","110/08/20","元大-竹山",2,0,2
"12296","6246臺龍","110/08/20","元富-新店",0,2,-2
"12297","6246臺龍","110/08/20","元大-上新莊",2,0,2
"12298","6246臺龍","110/08/20","元富-烏日",0,2,-2
"12299","6246臺龍","110/08/20","元大-土城",2,0,2
"12300","6246臺龍","110/08/20","台新-中壢",0,2,-2
"12301","00715L期街口布蘭特正2","110/08/20","新光",1501,206,1295
"12302","00715L期街口布蘭特正2","110/08/20","元大證券",460,5183,-4723
"12303","00715L期街口布蘭特正2","110/08/20","富邦-南屯",671,15,656
"12304","00715L期街口布蘭特正2","110/08/20","合庫證券",9,3350,-3341
"12305","00715L期街口布蘭特正2","110/08/20","元大-復北",756,120,636
"12306","00715L期街口布蘭特正2","110/08/20","康和",603,2255,-1652
"12307","00715L期街口布蘭特正2","110/08/20","華南永昌",555,0,555
"12308","00715L期街口布蘭特正2","110/08/20","群益金鼎",0,1488,-1488
"12309","00715L期街口布蘭特正2","110/08/20","玉山證券",525,32,493
"12310","00715L期街口布蘭特正2","110/08/20","凱基-台北",57,1280,-1223
"12311","00715L期街口布蘭特正2","110/08/20","第一金-華江",472,1,471
"12312","00715L期街口布蘭特正2","110/08/20","統一-台中",34,1238,-1204
"12313","00715L期街口布蘭特正2","110/08/20","元大-西屯",412,0,412
"12314","00715L期街口布蘭特正2","110/08/20","國票",306,1276,-970
"12315","00715L期街口布蘭特正2","110/08/20","第一金-豐原",390,0,390
"12316","00715L期街口布蘭特正2","110/08/20","富邦證券",2234,2995,-761
"12317","00715L期街口布蘭特正2","110/08/20","元大-北港",374,0,374
"12318","00715L期街口布蘭特正2","110/08/20","日盛-新莊",221,825,-604
"12319","00715L期街口布蘭特正2","110/08/20","華南永昌-台中",379,10,369
"12320","00715L期街口布蘭特正2","110/08/20","台新-台中",169,711,-542
"12321","00715L期街口布蘭特正2","110/08/20","玉山-新竹",345,10,335
"12322","00715L期街口布蘭特正2","110/08/20","元富",0,507,-507
"12323","00715L期街口布蘭特正2","110/08/20","元大-草屯",413,88,325
"12324","00715L期街口布蘭特正2","110/08/20","台中銀",90,452,-362
"12325","00715L期街口布蘭特正2","110/08/20","日盛-二林",307,1,306
"12326","00715L期街口布蘭特正2","110/08/20","凱基-中壢",98,442,-344
"12327","00715L期街口布蘭特正2","110/08/20","凱基-站前",306,0,306
"12328","00715L期街口布蘭特正2","110/08/20","台新證券",312,644,-332
"12329","00715L期街口布蘭特正2","110/08/20","新光-台中",308,23,285
"12330","00715L期街口布蘭特正2","110/08/20","元大-林森",1,252,-251
"12331","8941關中","110/08/20","合庫-彰化",1,0,1
"12332","8941關中","110/08/20","大慶-富順",0,1,-1
"12333","8941關中","110/08/20","凱基-市府",1,0,1
"12334","8941關中","110/08/20","國泰-忠孝",0,1,-1
"12335","8941關中","110/08/20","玉山-台大",0,0,0
"12336","8941關中","110/08/20","玉山-台大",0,0,0
"12337","8941關中","110/08/20","國泰-高雄",0,0,0
"12338","8941關中","110/08/20","國泰-高雄",0,0,0
"12339","8941關中","110/08/20","元大-南投",0,0,0
"12340","8941關中","110/08/20","元大-南投",0,0,0
"12341","8941關中","110/08/20","永豐金-萬盛",0,0,0
"12342","8941關中","110/08/20","永豐金-萬盛",0,0,0
"12343","8941關中","110/08/20","永豐金-南投",0,0,0
"12344","8941關中","110/08/20","永豐金-南投",0,0,0
"12345","8941關中","110/08/20","",NA,NA,NA
"12346","8941關中","110/08/20","",NA,NA,NA
"12347","8941關中","110/08/20","",NA,NA,NA
"12348","8941關中","110/08/20","",NA,NA,NA
"12349","8941關中","110/08/20","",NA,NA,NA
"12350","8941關中","110/08/20","",NA,NA,NA
"12351","8941關中","110/08/20","",NA,NA,NA
"12352","8941關中","110/08/20","",NA,NA,NA
"12353","8941關中","110/08/20","",NA,NA,NA
"12354","8941關中","110/08/20","",NA,NA,NA
"12355","8941關中","110/08/20","",NA,NA,NA
"12356","8941關中","110/08/20","",NA,NA,NA
"12357","8941關中","110/08/20","",NA,NA,NA
"12358","8941關中","110/08/20","",NA,NA,NA
"12359","8941關中","110/08/20","",NA,NA,NA
"12360","8941關中","110/08/20","",NA,NA,NA
"12361","8936國統","110/08/20","美林",81,0,81
"12362","8936國統","110/08/20","國票-和平",0,75,-75
"12363","8936國統","110/08/20","宏遠-台南",82,29,53
"12364","8936國統","110/08/20","台灣摩根士丹利",9,55,-46
"12365","8936國統","110/08/20","台中銀-高雄",51,0,51
"12366","8936國統","110/08/20","美商高盛",6,33,-27
"12367","8936國統","110/08/20","富邦-岡山",35,0,35
"12368","8936國統","110/08/20","凱基-高美館",6,33,-27
"12369","8936國統","110/08/20","港商野村",73,43,30
"12370","8936國統","110/08/20","新光-台中",18,43,-25
"12371","8936國統","110/08/20","康和-高雄",30,0,30
"12372","8936國統","110/08/20","凱基-中山",0,17,-17
"12373","8936國統","110/08/20","瑞士信貸",15,0,15
"12374","8936國統","110/08/20","玉山-城中",3,17,-14
"12375","8936國統","110/08/20","兆豐-北高雄",14,0,14
"12376","8936國統","110/08/20","日盛-頭份",0,12,-12
"12377","8936國統","110/08/20","元大-汐止",11,0,11
"12378","8936國統","110/08/20","日盛-大墩",0,10,-10
"12379","8936國統","110/08/20","玉山-左營",10,0,10
"12380","8936國統","110/08/20","凱基-台北",34,44,-10
"12381","8936國統","110/08/20","元大-路竹",10,0,10
"12382","8936國統","110/08/20","元大-高雄",0,10,-10
"12383","8936國統","110/08/20","永豐金-南投",10,0,10
"12384","8936國統","110/08/20","元富-同大",0,8,-8
"12385","8936國統","110/08/20","臺銀",8,2,6
"12386","8936國統","110/08/20","元大-鑫永和",0,8,-8
"12387","8936國統","110/08/20","大昌-新店",5,0,5
"12388","8936國統","110/08/20","日盛-豐原",0,7,-7
"12389","8936國統","110/08/20","國票-內壢",5,0,5
"12390","8936國統","110/08/20","第一金-路竹",0,7,-7
"12391","6226光鼎","110/08/20","美商高盛",388,14,374
"12392","6226光鼎","110/08/20","國泰-台中",62,142,-80
"12393","6226光鼎","110/08/20","台灣摩根士丹利",347,26,321
"12394","6226光鼎","110/08/20","元大-北屯",27,101,-74
"12395","6226光鼎","110/08/20","元大-文心興安",238,8,230
"12396","6226光鼎","110/08/20","永豐金-竹科",0,69,-69
"12397","6226光鼎","110/08/20","美林",265,60,205
"12398","6226光鼎","110/08/20","臺銀-高雄",0,61,-61
"12399","6226光鼎","110/08/20","凱基-台北",211,59,152
"12400","6226光鼎","110/08/20","日盛-信義",0,60,-60
"12401","6226光鼎","110/08/20","摩根大通",172,72,100
"12402","6226光鼎","110/08/20","元大證券",18,76,-58
"12403","6226光鼎","110/08/20","新加坡商瑞銀",162,78,84
"12404","6226光鼎","110/08/20","中國信託",31,81,-50
"12405","6226光鼎","110/08/20","港商野村",168,89,79
"12406","6226光鼎","110/08/20","華南永昌-長虹",1,51,-50
"12407","6226光鼎","110/08/20","中國信託-永康",70,28,42
"12408","6226光鼎","110/08/20","富邦-板橋",6,55,-49
"12409","6226光鼎","110/08/20","致和-佳里",39,5,34
"12410","6226光鼎","110/08/20","土銀-彰化",8,53,-45
"12411","6226光鼎","110/08/20","兆豐-桃鶯",30,0,30
"12412","6226光鼎","110/08/20","新光",49,94,-45
"12413","6226光鼎","110/08/20","永豐金-中盛",38,10,28
"12414","6226光鼎","110/08/20","台新證券",86,129,-43
"12415","6226光鼎","110/08/20","凱基-站前",27,0,27
"12416","6226光鼎","110/08/20","元大-竹科",14,57,-43
"12417","6226光鼎","110/08/20","群益金鼎-永和",25,0,25
"12418","6226光鼎","110/08/20","兆豐-寶成",1,43,-42
"12419","6226光鼎","110/08/20","國票-台南",23,0,23
"12420","6226光鼎","110/08/20","國泰-館前",13,55,-42
"12421","2363矽統","110/08/20","凱基-台北",909,319,590
"12422","2363矽統","110/08/20","群益金鼎",10,183,-173
"12423","2363矽統","110/08/20","港商野村",1346,1106,240
"12424","2363矽統","110/08/20","國票-台東",2,153,-151
"12425","2363矽統","110/08/20","美林",332,137,195
"12426","2363矽統","110/08/20","元大-前金",44,169,-125
"12427","2363矽統","110/08/20","摩根大通",268,88,180
"12428","2363矽統","110/08/20","元大-汐止",32,121,-89
"12429","2363矽統","110/08/20","美商高盛",270,113,157
"12430","2363矽統","110/08/20","統一-屏東",14,90,-76
"12431","2363矽統","110/08/20","統一-三重",108,0,108
"12432","2363矽統","110/08/20","國泰-敦南",202,271,-69
"12433","2363矽統","110/08/20","日盛-中和",110,13,97
"12434","2363矽統","110/08/20","凱基-長庚",12,76,-64
"12435","2363矽統","110/08/20","台新-新營",84,14,70
"12436","2363矽統","110/08/20","凱基-鳳山",4,61,-57
"12437","2363矽統","110/08/20","富邦-台北",183,117,66
"12438","2363矽統","110/08/20","群益金鼎-中壢",25,81,-56
"12439","2363矽統","110/08/20","新光",238,178,60
"12440","2363矽統","110/08/20","合庫-高雄",23,78,-55
"12441","2363矽統","110/08/20","元大-士林",56,1,55
"12442","2363矽統","110/08/20","永豐金-市政",23,75,-52
"12443","2363矽統","110/08/20","凱基-台南",54,6,48
"12444","2363矽統","110/08/20","國泰-館前",98,148,-50
"12445","2363矽統","110/08/20","光和",45,4,41
"12446","2363矽統","110/08/20","國票-九鼎",14,62,-48
"12447","2363矽統","110/08/20","凱基-敦北",40,0,40
"12448","2363矽統","110/08/20","台新-左楠",2,47,-45
"12449","2363矽統","110/08/20","永豐金-台中",45,7,38
"12450","2363矽統","110/08/20","永豐金-潮州",3,46,-43
"12451","8112至上","110/08/20","港商法國興業",188,0,188
"12452","8112至上","110/08/20","台灣摩根士丹利",0,152,-152
"12453","8112至上","110/08/20","港商野村",229,78,151
"12454","8112至上","110/08/20","合庫-西台中",0,130,-130
"12455","8112至上","110/08/20","凱基-台北",95,12,83
"12456","8112至上","110/08/20","富邦-仁愛",7,102,-95
"12457","8112至上","110/08/20","美商高盛",100,23,77
"12458","8112至上","110/08/20","元大-永春",0,88,-88
"12459","8112至上","110/08/20","瑞士信貸",54,1,53
"12460","8112至上","110/08/20","元大-佳里",5,60,-55
"12461","8112至上","110/08/20","元大-路竹",38,7,31
"12462","8112至上","110/08/20","群益金鼎-基隆",1,49,-48
"12463","8112至上","110/08/20","富邦-新竹",37,7,30
"12464","8112至上","110/08/20","新加坡商瑞銀",34,73,-39
"12465","8112至上","110/08/20","元大-竹東",23,0,23
"12466","8112至上","110/08/20","摩根大通",183,214,-31
"12467","8112至上","110/08/20","凱基-桃園",22,1,21
"12468","8112至上","110/08/20","亞東-新竹",0,30,-30
"12469","8112至上","110/08/20","群益金鼎-大興",20,0,20
"12470","8112至上","110/08/20","亞東-台中",0,30,-30
"12471","8112至上","110/08/20","富邦-北港",20,0,20
"12472","8112至上","110/08/20","美林",32,61,-29
"12473","8112至上","110/08/20","元大-東港",20,0,20
"12474","8112至上","110/08/20","合庫-基隆",0,21,-21
"12475","8112至上","110/08/20","第一金-頭份",23,5,18
"12476","8112至上","110/08/20","(牛牛牛)亞-鑫豐",14,35,-21
"12477","8112至上","110/08/20","元大-仁愛",17,0,17
"12478","8112至上","110/08/20","國票-南港",5,26,-21
"12479","8112至上","110/08/20","國票-天祥",16,0,16
"12480","8112至上","110/08/20","國泰-台中",5,26,-21
"12481","1570力肯","110/08/20","國票-北高雄",27,0,27
"12482","1570力肯","110/08/20","元大-大雅",8,58,-50
"12483","1570力肯","110/08/20","元大-鹿港",29,4,25
"12484","1570力肯","110/08/20","凱基-三峽",0,30,-30
"12485","1570力肯","110/08/20","摩根大通",27,5,22
"12486","1570力肯","110/08/20","元大-樹林",0,30,-30
"12487","1570力肯","110/08/20","富邦-花蓮",20,0,20
"12488","1570力肯","110/08/20","統一",0,28,-28
"12489","1570力肯","110/08/20","群益金鼎-高雄",18,0,18
"12490","1570力肯","110/08/20","國票-南科",0,13,-13
"12491","1570力肯","110/08/20","元大-草屯",13,0,13
"12492","1570力肯","110/08/20","元大-鑫永和",0,12,-12
"12493","1570力肯","110/08/20","元富-緯城",12,0,12
"12494","1570力肯","110/08/20","台新證券",0,11,-11
"12495","1570力肯","110/08/20","元富-世貿",10,0,10
"12496","1570力肯","110/08/20","群益金鼎-民權",0,10,-10
"12497","1570力肯","110/08/20","大慶-蘆洲",7,0,7
"12498","1570力肯","110/08/20","國票-台中",3,11,-8
"12499","1570力肯","110/08/20","(牛牛牛)亞-鑫豐",25,18,7
"12500","1570力肯","110/08/20","土銀-新竹",1,7,-6
"12501","1570力肯","110/08/20","國票-天祥",6,0,6
"12502","1570力肯","110/08/20","台灣摩根士丹利",0,6,-6
"12503","1570力肯","110/08/20","凱基-台北",7,1,6
"12504","1570力肯","110/08/20","國泰-敦南",1,7,-6
"12505","1570力肯","110/08/20","元富-城東",5,0,5
"12506","1570力肯","110/08/20","高橋-龍潭",0,5,-5
"12507","1570力肯","110/08/20","國票",5,0,5
"12508","1570力肯","110/08/20","玉山-高雄",0,5,-5
"12509","1570力肯","110/08/20","萬泰",5,0,5
"12510","1570力肯","110/08/20","永豐金-苓雅",0,5,-5
"12511","2929淘帝","110/08/20","元大-太平",35,0,35
"12512","2929淘帝","110/08/20","元大-莒光",0,25,-25
"12513","2929淘帝","110/08/20","港商野村",17,5,12
"12514","2929淘帝","110/08/20","富邦-新營",0,20,-20
"12515","2929淘帝","110/08/20","摩根大通",16,6,10
"12516","2929淘帝","110/08/20","華南永昌-古亭",0,16,-16
"12517","2929淘帝","110/08/20","永豐金-板新",10,0,10
"12518","2929淘帝","110/08/20","兆豐-桃鶯",0,12,-12
"12519","2929淘帝","110/08/20","美林",10,1,9
"12520","2929淘帝","110/08/20","中國信託",0,10,-10
"12521","2929淘帝","110/08/20","兆豐-忠孝",8,0,8
"12522","2929淘帝","110/08/20","元大-竹科",0,10,-10
"12523","2929淘帝","110/08/20","凱基-東門",8,0,8
"12524","2929淘帝","110/08/20","永豐金-新莊",0,10,-10
"12525","2929淘帝","110/08/20","高橋-龍潭",5,0,5
"12526","2929淘帝","110/08/20","兆豐-東門",0,8,-8
"12527","2929淘帝","110/08/20","玉山-台南",5,0,5
"12528","2929淘帝","110/08/20","凱基-三峽",0,7,-7
"12529","2929淘帝","110/08/20","凱基-中山",5,0,5
"12530","2929淘帝","110/08/20","宏遠-館前",0,5,-5
"12531","2929淘帝","110/08/20","華南永昌-小港",5,0,5
"12532","2929淘帝","110/08/20","瑞士信貸",0,5,-5
"12533","2929淘帝","110/08/20","元大-員林",5,0,5
"12534","2929淘帝","110/08/20","富邦-陽明",0,5,-5
"12535","2929淘帝","110/08/20","元大-永和",5,0,5
"12536","2929淘帝","110/08/20","中國信託-松江",0,4,-4
"12537","2929淘帝","110/08/20","永豐金-永康",5,0,5
"12538","2929淘帝","110/08/20","玉山-新竹",11,15,-4
"12539","2929淘帝","110/08/20","群益金鼎-潭子",4,0,4
"12540","2929淘帝","110/08/20","元富-成功",0,3,-3
"12541","5410國眾","110/08/20","大昌",5,0,5
"12542","5410國眾","110/08/20","元大-發財",0,9,-9
"12543","5410國眾","110/08/20","華南永昌-高雄",5,0,5
"12544","5410國眾","110/08/20","元大-士林",2,8,-6
"12545","5410國眾","110/08/20","元大-東泰",5,0,5
"12546","5410國眾","110/08/20","日盛-屏東",0,5,-5
"12547","5410國眾","110/08/20","元大-中壢",5,0,5
"12548","5410國眾","110/08/20","新加坡商瑞銀",3,8,-5
"12549","5410國眾","110/08/20","中國信託-新竹",4,0,4
"12550","5410國眾","110/08/20","凱基-台北",0,4,-4
"12551","5410國眾","110/08/20","新光",3,0,3
"12552","5410國眾","110/08/20","元大-南勢角",0,4,-4
"12553","5410國眾","110/08/20","凱基-竹北",3,0,3
"12554","5410國眾","110/08/20","寶盛",0,3,-3
"12555","5410國眾","110/08/20","國泰-松江",2,0,2
"12556","5410國眾","110/08/20","元富-台南",0,2,-2
"12557","5410國眾","110/08/20","群益金鼎-海山",2,0,2
"12558","5410國眾","110/08/20","華南永昌-小港",0,2,-2
"12559","5410國眾","110/08/20","凱基-彰化",2,0,2
"12560","5410國眾","110/08/20","富邦-竹北",1,3,-2
"12561","5410國眾","110/08/20","日盛-二林",1,0,1
"12562","5410國眾","110/08/20","富邦-永和",0,2,-2
"12563","5410國眾","110/08/20","美林",1,0,1
"12564","5410國眾","110/08/20","元大-華山",0,2,-2
"12565","5410國眾","110/08/20","大慶-蘆洲",1,0,1
"12566","5410國眾","110/08/20","中國信託-文心",0,1,-1
"12567","5410國眾","110/08/20","中國信託-嘉義",1,0,1
"12568","5410國眾","110/08/20","國泰-敦南",4,5,-1
"12569","5410國眾","110/08/20","國泰-台南",1,0,1
"12570","5410國眾","110/08/20","華南永昌-楠梓",0,1,-1
"12571","2841台開","110/08/20","宏遠-館前",465,0,465
"12572","2841台開","110/08/20","台中銀",0,113,-113
"12573","2841台開","110/08/20","第一金",102,0,102
"12574","2841台開","110/08/20","國票-敦北法人",0,51,-51
"12575","2841台開","110/08/20","富邦-岡山",18,0,18
"12576","2841台開","110/08/20","高橋",0,50,-50
"12577","2841台開","110/08/20","台新證券",15,2,13
"12578","2841台開","110/08/20","日盛證券",0,43,-43
"12579","2841台開","110/08/20","元大-新竹經國",10,0,10
"12580","2841台開","110/08/20","永豐金-三重",0,39,-39
"12581","2841台開","110/08/20","日盛-新竹",6,0,6
"12582","2841台開","110/08/20","玉山-高雄",0,30,-30
"12583","2841台開","110/08/20","元富-文心",5,0,5
"12584","2841台開","110/08/20","元大-竹山",0,30,-30
"12585","2841台開","110/08/20","第一金-路竹",3,0,3
"12586","2841台開","110/08/20","光和-高雄",0,28,-28
"12587","2841台開","110/08/20","永豐金-中盛",3,0,3
"12588","2841台開","110/08/20","永豐金-敦南",15,37,-22
"12589","2841台開","110/08/20","新光-台中",2,0,2
"12590","2841台開","110/08/20","新光-台南",0,21,-21
"12591","2841台開","110/08/20","群益金鼎-館前",2,0,2
"12592","2841台開","110/08/20","玉山-嘉義",0,20,-20
"12593","2841台開","110/08/20","群益金鼎-東湖",2,0,2
"12594","2841台開","110/08/20","富邦-員林",0,20,-20
"12595","2841台開","110/08/20","元大-屏東民生",2,0,2
"12596","2841台開","110/08/20","元大-竹科",0,20,-20
"12597","2841台開","110/08/20","國泰-板橋",1,0,1
"12598","2841台開","110/08/20","元大-善化",0,15,-15
"12599","2841台開","110/08/20","群益金鼎-崇德",1,0,1
"12600","2841台開","110/08/20","永豐金-忠孝",0,15,-15
"12601","6207雷科","110/08/20","日盛-員林",20,0,20
"12602","6207雷科","110/08/20","凱基-敦北",0,26,-26
"12603","6207雷科","110/08/20","美林",16,0,16
"12604","6207雷科","110/08/20","新加坡商瑞銀",12,27,-15
"12605","6207雷科","110/08/20","凱基-台北",20,8,12
"12606","6207雷科","110/08/20","國票-南科",1,13,-12
"12607","6207雷科","110/08/20","瑞士信貸",11,0,11
"12608","6207雷科","110/08/20","台新證券",0,10,-10
"12609","6207雷科","110/08/20","港商野村",23,12,11
"12610","6207雷科","110/08/20","國票-九鼎",2,10,-8
"12611","6207雷科","110/08/20","摩根大通",33,22,11
"12612","6207雷科","110/08/20","台新-台中",0,5,-5
"12613","6207雷科","110/08/20","凱基-羅東",6,0,6
"12614","6207雷科","110/08/20","玉山-嘉義",0,5,-5
"12615","6207雷科","110/08/20","富邦-中壢",6,0,6
"12616","6207雷科","110/08/20","群益金鼎-三民",0,5,-5
"12617","6207雷科","110/08/20","元大-大灣",6,0,6
"12618","6207雷科","110/08/20","元大-博愛",0,5,-5
"12619","6207雷科","110/08/20","日盛-台南",5,0,5
"12620","6207雷科","110/08/20","中國信託-中壢",0,4,-4
"12621","6207雷科","110/08/20","富邦-台北",5,0,5
"12622","6207雷科","110/08/20","兆豐-彰化",0,4,-4
"12623","6207雷科","110/08/20","富邦-新店",5,0,5
"12624","6207雷科","110/08/20","群益金鼎-東門",0,4,-4
"12625","6207雷科","110/08/20","元大-府城",5,0,5
"12626","6207雷科","110/08/20","致和-高雄",0,3,-3
"12627","6207雷科","110/08/20","中農",3,0,3
"12628","6207雷科","110/08/20","新光-高雄",0,3,-3
"12629","6207雷科","110/08/20","華南永昌-古亭",3,0,3
"12630","6207雷科","110/08/20","凱基-高雄",0,3,-3
"12631","3679新至陞","110/08/20","元大-大天母",10,0,10
"12632","3679新至陞","110/08/20","台灣企銀-建成",0,6,-6
"12633","3679新至陞","110/08/20","港商野村",3,0,3
"12634","3679新至陞","110/08/20","美林",0,6,-6
"12635","3679新至陞","110/08/20","(牛牛牛)亞-網路",3,0,3
"12636","3679新至陞","110/08/20","花旗環球",0,5,-5
"12637","3679新至陞","110/08/20","富邦-花蓮",3,0,3
"12638","3679新至陞","110/08/20","新加坡商瑞銀",0,5,-5
"12639","3679新至陞","110/08/20","凱基-中山",2,0,2
"12640","3679新至陞","110/08/20","日盛-忠孝",0,4,-4
"12641","3679新至陞","110/08/20","日盛-木柵",1,0,1
"12642","3679新至陞","110/08/20","元大證券",1,4,-3
"12643","3679新至陞","110/08/20","日盛-員林",1,0,1
"12644","3679新至陞","110/08/20","摩根大通",4,6,-2
"12645","3679新至陞","110/08/20","日盛-文化",1,0,1
"12646","3679新至陞","110/08/20","凱基-埔墘",0,2,-2
"12647","3679新至陞","110/08/20","台灣摩根士丹利",1,0,1
"12648","3679新至陞","110/08/20","日盛-板橋",0,1,-1
"12649","3679新至陞","110/08/20","瑞士信貸",1,0,1
"12650","3679新至陞","110/08/20","美商高盛",0,1,-1
"12651","3679新至陞","110/08/20","第一金-澎湖",1,0,1
"12652","3679新至陞","110/08/20","第一金-台南",0,1,-1
"12653","3679新至陞","110/08/20","統一-松江",1,0,1
"12654","3679新至陞","110/08/20","台中銀-員林",0,1,-1
"12655","3679新至陞","110/08/20","元富-草屯",1,0,1
"12656","3679新至陞","110/08/20","北城證券",0,1,-1
"12657","3679新至陞","110/08/20","光和-溪湖",1,0,1
"12658","3679新至陞","110/08/20","國票-九鼎",0,1,-1
"12659","3679新至陞","110/08/20","兆豐-三重",1,0,1
"12660","3679新至陞","110/08/20","富邦-陽明",0,1,-1
"12661","2727王品","110/08/20","元大-台中中港",339,0,339
"12662","2727王品","110/08/20","兆豐-南京",0,980,-980
"12663","2727王品","110/08/20","台灣摩根士丹利",93,12,81
"12664","2727王品","110/08/20","港商麥格理",0,65,-65
"12665","2727王品","110/08/20","摩根大通",63,4,59
"12666","2727王品","110/08/20","玉山證券",2,25,-23
"12667","2727王品","110/08/20","瑞士信貸",62,7,55
"12668","2727王品","110/08/20","元大證券",2,22,-20
"12669","2727王品","110/08/20","國票-南港",50,0,50
"12670","2727王品","110/08/20","永豐金-桃盛",0,20,-20
"12671","2727王品","110/08/20","玉山-板橋",40,10,30
"12672","2727王品","110/08/20","元富-西松",0,18,-18
"12673","2727王品","110/08/20","美林",38,9,29
"12674","2727王品","110/08/20","美商高盛",5,17,-12
"12675","2727王品","110/08/20","國泰-敦南",23,2,21
"12676","2727王品","110/08/20","台新-中壢",0,11,-11
"12677","2727王品","110/08/20","富邦-台北",16,2,14
"12678","2727王品","110/08/20","富邦-桃園",0,11,-11
"12679","2727王品","110/08/20","凱基-科園",15,2,13
"12680","2727王品","110/08/20","永豐金-新竹",0,11,-11
"12681","2727王品","110/08/20","凱基-台北",68,56,12
"12682","2727王品","110/08/20","彰銀-台中",0,10,-10
"12683","2727王品","110/08/20","宏遠-高雄",11,0,11
"12684","2727王品","110/08/20","兆豐-新莊",0,10,-10
"12685","2727王品","110/08/20","日茂-埔里",11,0,11
"12686","2727王品","110/08/20","元大-學甲",0,10,-10
"12687","2727王品","110/08/20","港商野村",58,48,10
"12688","2727王品","110/08/20","群益金鼎-延平",0,9,-9
"12689","2727王品","110/08/20","群益金鼎-潭子",10,0,10
"12690","2727王品","110/08/20","永豐金-松山",2,10,-8
"12691","1570力肯","110/08/20","國票-北高雄",27,0,27
"12692","1570力肯","110/08/20","元大-大雅",8,58,-50
"12693","1570力肯","110/08/20","元大-鹿港",29,4,25
"12694","1570力肯","110/08/20","凱基-三峽",0,30,-30
"12695","1570力肯","110/08/20","摩根大通",27,5,22
"12696","1570力肯","110/08/20","元大-樹林",0,30,-30
"12697","1570力肯","110/08/20","富邦-花蓮",20,0,20
"12698","1570力肯","110/08/20","統一",0,28,-28
"12699","1570力肯","110/08/20","群益金鼎-高雄",18,0,18
"12700","1570力肯","110/08/20","國票-南科",0,13,-13
"12701","1570力肯","110/08/20","元大-草屯",13,0,13
"12702","1570力肯","110/08/20","元大-鑫永和",0,12,-12
"12703","1570力肯","110/08/20","元富-緯城",12,0,12
"12704","1570力肯","110/08/20","台新證券",0,11,-11
"12705","1570力肯","110/08/20","元富-世貿",10,0,10
"12706","1570力肯","110/08/20","群益金鼎-民權",0,10,-10
"12707","1570力肯","110/08/20","大慶-蘆洲",7,0,7
"12708","1570力肯","110/08/20","國票-台中",3,11,-8
"12709","1570力肯","110/08/20","(牛牛牛)亞-鑫豐",25,18,7
"12710","1570力肯","110/08/20","土銀-新竹",1,7,-6
"12711","1570力肯","110/08/20","國票-天祥",6,0,6
"12712","1570力肯","110/08/20","台灣摩根士丹利",0,6,-6
"12713","1570力肯","110/08/20","凱基-台北",7,1,6
"12714","1570力肯","110/08/20","國泰-敦南",1,7,-6
"12715","1570力肯","110/08/20","元富-城東",5,0,5
"12716","1570力肯","110/08/20","高橋-龍潭",0,5,-5
"12717","1570力肯","110/08/20","國票",5,0,5
"12718","1570力肯","110/08/20","玉山-高雄",0,5,-5
"12719","1570力肯","110/08/20","萬泰",5,0,5
"12720","1570力肯","110/08/20","永豐金-苓雅",0,5,-5
"12721","6180橘子","110/08/20","港商野村",272,0,272
"12722","6180橘子","110/08/20","元大-博愛",0,42,-42
"12723","6180橘子","110/08/20","美林",47,0,47
"12724","6180橘子","110/08/20","群益金鼎-永和",1,40,-39
"12725","6180橘子","110/08/20","兆豐-埔墘",10,0,10
"12726","6180橘子","110/08/20","台灣摩根士丹利",4,39,-35
"12727","6180橘子","110/08/20","元大-天母",9,0,9
"12728","6180橘子","110/08/20","摩根大通",11,46,-35
"12729","6180橘子","110/08/20","永豐金-桃園",10,1,9
"12730","6180橘子","110/08/20","新光-桃園",0,35,-35
"12731","6180橘子","110/08/20","凱基-大里",8,0,8
"12732","6180橘子","110/08/20","臺銀",2,34,-32
"12733","6180橘子","110/08/20","元大-草屯",7,0,7
"12734","6180橘子","110/08/20","國泰-館前",1,33,-32
"12735","6180橘子","110/08/20","日盛-雙和",5,0,5
"12736","6180橘子","110/08/20","新光",7,38,-31
"12737","6180橘子","110/08/20","第一金-高雄",5,0,5
"12738","6180橘子","110/08/20","宏遠-館前",0,21,-21
"12739","6180橘子","110/08/20","第一金-新竹",5,0,5
"12740","6180橘子","110/08/20","富邦-竹東",0,21,-21
"12741","6180橘子","110/08/20","群益金鼎-大興",5,0,5
"12742","6180橘子","110/08/20","日盛-景美",0,20,-20
"12743","6180橘子","110/08/20","群益金鼎-開元",5,0,5
"12744","6180橘子","110/08/20","第一金-新興",0,20,-20
"12745","6180橘子","110/08/20","元大-東泰",5,0,5
"12746","6180橘子","110/08/20","凱基-彰化",0,16,-16
"12747","6180橘子","110/08/20","元大-士林",5,0,5
"12748","6180橘子","110/08/20","新加坡商瑞銀",5,15,-10
"12749","6180橘子","110/08/20","元大-土城",5,0,5
"12750","6180橘子","110/08/20","國票-長城",0,10,-10
"12751","2390云辰","110/08/20","國票-安和",130,0,130
"12752","2390云辰","110/08/20","統一-新台中",0,200,-200
"12753","2390云辰","110/08/20","凱基-屏東",100,0,100
"12754","2390云辰","110/08/20","聯邦-敦化",0,68,-68
"12755","2390云辰","110/08/20","摩根大通",233,161,72
"12756","2390云辰","110/08/20","美林",62,127,-65
"12757","2390云辰","110/08/20","美商高盛",101,30,71
"12758","2390云辰","110/08/20","新加坡商瑞銀",0,61,-61
"12759","2390云辰","110/08/20","兆豐-高雄",78,11,67
"12760","2390云辰","110/08/20","統一-新營",26,71,-45
"12761","2390云辰","110/08/20","凱基-台北",257,199,58
"12762","2390云辰","110/08/20","國泰-敦南",114,153,-39
"12763","2390云辰","110/08/20","第一金-安和",62,8,54
"12764","2390云辰","110/08/20","華南永昌-朴子",2,41,-39
"12765","2390云辰","110/08/20","統一-城中",60,10,50
"12766","2390云辰","110/08/20","元大-土城學府",156,192,-36
"12767","2390云辰","110/08/20","富邦-宜蘭",52,4,48
"12768","2390云辰","110/08/20","元大-六合",17,53,-36
"12769","2390云辰","110/08/20","元大-鳳山",60,12,48
"12770","2390云辰","110/08/20","土銀-嘉義",0,35,-35
"12771","2390云辰","110/08/20","元大-板橋三民",50,2,48
"12772","2390云辰","110/08/20","大昌",5,36,-31
"12773","2390云辰","110/08/20","國票-博愛",178,141,37
"12774","2390云辰","110/08/20","宏遠-台南",0,27,-27
"12775","2390云辰","110/08/20","華南永昌-岡山",33,1,32
"12776","2390云辰","110/08/20","群益金鼎-民權",6,31,-25
"12777","2390云辰","110/08/20","元大-北三重",32,1,31
"12778","2390云辰","110/08/20","國泰-館前",28,52,-24
"12779","2390云辰","110/08/20","第一金-豐原",30,0,30
"12780","2390云辰","110/08/20","富邦-建國",13,36,-23
"12781","2609陽明","110/08/19","美商高盛",2352,641,1711
"12782","2609陽明","110/08/19","凱基-台北",2247,12187,-9940
"12783","2609陽明","110/08/19","華南永昌-竹北",1335,536,799
"12784","2609陽明","110/08/19","康和",1685,8746,-7061
"12785","2609陽明","110/08/19","國泰-敦南",5999,5202,797
"12786","2609陽明","110/08/19","富邦證券",159,6808,-6649
"12787","2609陽明","110/08/19","日盛-雙和",967,217,750
"12788","2609陽明","110/08/19","台灣摩根士丹利",66,2608,-2542
"12789","2609陽明","110/08/19","國泰-館前",1665,1071,594
"12790","2609陽明","110/08/19","兆豐-南京",144,2129,-1985
"12791","2609陽明","110/08/19","台新證券",3672,3095,577
"12792","2609陽明","110/08/19","兆豐-虎尾",7267,9058,-1791
"12793","2609陽明","110/08/19","統一-三重",826,296,530
"12794","2609陽明","110/08/19","美林",2631,4379,-1748
"12795","2609陽明","110/08/19","玉山證券",1424,939,485
"12796","2609陽明","110/08/19","永豐金-信義",140,1816,-1676
"12797","2609陽明","110/08/19","富邦-建國",1115,663,452
"12798","2609陽明","110/08/19","富邦-仁愛",873,2277,-1404
"12799","2609陽明","110/08/19","統一-士林",809,391,418
"12800","2609陽明","110/08/19","摩根大通",4652,6019,-1367
"12801","2609陽明","110/08/19","凱基-城中",614,199,415
"12802","2609陽明","110/08/19","凱基-斗六",3347,4638,-1291
"12803","2609陽明","110/08/19","華南永昌-台中",863,449,414
"12804","2609陽明","110/08/19","富邦-虎尾",11651,12857,-1206
"12805","2609陽明","110/08/19","新光-新竹",1263,857,406
"12806","2609陽明","110/08/19","元大證券",2875,3808,-933
"12807","2609陽明","110/08/19","國泰-台中",1878,1503,375
"12808","2609陽明","110/08/19","統一-仁愛",1484,2392,-908
"12809","2609陽明","110/08/19","玉山-左營",623,251,372
"12810","2609陽明","110/08/19","元大-頭份",315,1194,-879
"12811","2636台驊投控","110/08/19","華南永昌-竹北",257,10,247
"12812","2636台驊投控","110/08/19","富邦證券",8,1056,-1048
"12813","2636台驊投控","110/08/19","國泰-敦南",483,306,177
"12814","2636台驊投控","110/08/19","摩根大通",329,1288,-959
"12815","2636台驊投控","110/08/19","新光-新竹",174,42,132
"12816","2636台驊投控","110/08/19","台灣摩根士丹利",168,753,-585
"12817","2636台驊投控","110/08/19","港商野村",2255,2136,119
"12818","2636台驊投控","110/08/19","凱基-台北",574,996,-422
"12819","2636台驊投控","110/08/19","台新證券",257,150,107
"12820","2636台驊投控","110/08/19","瑞士信貸",75,421,-346
"12821","2636台驊投控","110/08/19","新光",389,312,77
"12822","2636台驊投控","110/08/19","統一",98,420,-322
"12823","2636台驊投控","110/08/19","華南永昌-楠梓",98,27,71
"12824","2636台驊投控","110/08/19","凱基",21,323,-302
"12825","2636台驊投控","110/08/19","華南永昌-南京",104,40,64
"12826","2636台驊投控","110/08/19","富邦-員林",377,670,-293
"12827","2636台驊投控","110/08/19","富邦-苗栗",99,35,64
"12828","2636台驊投控","110/08/19","日盛-台中",26,244,-218
"12829","2636台驊投控","110/08/19","元大-竹北",79,16,63
"12830","2636台驊投控","110/08/19","美商高盛",87,244,-157
"12831","2636台驊投控","110/08/19","凱基-市政",265,203,62
"12832","2636台驊投控","110/08/19","日盛-板橋",40,163,-123
"12833","2636台驊投控","110/08/19","中國信託-文心",80,21,59
"12834","2636台驊投控","110/08/19","大慶",2,120,-118
"12835","2636台驊投控","110/08/19","大昌-安康",60,4,56
"12836","2636台驊投控","110/08/19","日盛-大墩",73,184,-111
"12837","2636台驊投控","110/08/19","日盛-宜蘭",53,0,53
"12838","2636台驊投控","110/08/19","宏遠證券",60,152,-92
"12839","2636台驊投控","110/08/19","元富-大昌",81,28,53
"12840","2636台驊投控","110/08/19","新加坡商瑞銀",88,173,-85
"12841","2867三商壽","110/08/19","美林",389,60,329
"12842","2867三商壽","110/08/19","宏遠證券",0,969,-969
"12843","2867三商壽","110/08/19","元大-土城永寧",252,2,250
"12844","2867三商壽","110/08/19","摩根大通",111,691,-580
"12845","2867三商壽","110/08/19","玉山-板橋",127,0,127
"12846","2867三商壽","110/08/19","土銀-建國",0,240,-240
"12847","2867三商壽","110/08/19","元大-大里德芳",110,0,110
"12848","2867三商壽","110/08/19","日盛-中壢",0,122,-122
"12849","2867三商壽","110/08/19","國泰-台中",103,1,102
"12850","2867三商壽","110/08/19","台新-高雄",4,121,-117
"12851","2867三商壽","110/08/19","新加坡商瑞銀",114,19,95
"12852","2867三商壽","110/08/19","德信-中正",0,100,-100
"12853","2867三商壽","110/08/19","玉山-城中",86,0,86
"12854","2867三商壽","110/08/19","華南永昌-南京",0,100,-100
"12855","2867三商壽","110/08/19","合庫-西台中",80,0,80
"12856","2867三商壽","110/08/19","台新證券",15,101,-86
"12857","2867三商壽","110/08/19","永豐金-竹科",80,1,79
"12858","2867三商壽","110/08/19","凱基-台北",42,118,-76
"12859","2867三商壽","110/08/19","玉山-台中",61,0,61
"12860","2867三商壽","110/08/19","富邦-建國",1,71,-70
"12861","2867三商壽","110/08/19","土銀-台中",60,0,60
"12862","2867三商壽","110/08/19","元大-八德",0,70,-70
"12863","2867三商壽","110/08/19","富邦-台南",60,0,60
"12864","2867三商壽","110/08/19","凱基",0,68,-68
"12865","2867三商壽","110/08/19","元大-中壢",56,0,56
"12866","2867三商壽","110/08/19","富邦-三重",0,55,-55
"12867","2867三商壽","110/08/19","群益金鼎-彰化",62,8,54
"12868","2867三商壽","110/08/19","元大-彰化民生",0,50,-50
"12869","2867三商壽","110/08/19","永豐金-埔里",67,13,54
"12870","2867三商壽","110/08/19","亞東",0,45,-45
"12871","5521工信","110/08/19","元大證券",232,28,204
"12872","5521工信","110/08/19","凱基-台北",0,178,-178
"12873","5521工信","110/08/19","中國信託-三重",70,0,70
"12874","5521工信","110/08/19","福勝",0,80,-80
"12875","5521工信","110/08/19","台新證券",37,0,37
"12876","5521工信","110/08/19","新光-新竹",1,80,-79
"12877","5521工信","110/08/19","日盛-高雄",27,0,27
"12878","5521工信","110/08/19","港商法國興業",0,67,-67
"12879","5521工信","110/08/19","元富-埔里",20,0,20
"12880","5521工信","110/08/19","摩根大通",194,256,-62
"12881","5521工信","110/08/19","玉山-雙和",20,0,20
"12882","5521工信","110/08/19","群益金鼎-敦南",0,50,-50
"12883","5521工信","110/08/19","富邦-台北",20,0,20
"12884","5521工信","110/08/19","第一金-桃園",0,36,-36
"12885","5521工信","110/08/19","永豐金-竹科",19,0,19
"12886","5521工信","110/08/19","德信-中正",0,29,-29
"12887","5521工信","110/08/19","臺銀-鳳山",18,0,18
"12888","5521工信","110/08/19","元大-基隆孝二",0,28,-28
"12889","5521工信","110/08/19","華南永昌-高雄",20,2,18
"12890","5521工信","110/08/19","美林",1,27,-26
"12891","5521工信","110/08/19","華南永昌-彰化",23,8,15
"12892","5521工信","110/08/19","兆豐-員林",0,25,-25
"12893","5521工信","110/08/19","元大-大天母",15,0,15
"12894","5521工信","110/08/19","群益金鼎-土城",0,20,-20
"12895","5521工信","110/08/19","富邦-宜蘭",14,0,14
"12896","5521工信","110/08/19","元富-宜蘭",0,18,-18
"12897","5521工信","110/08/19","台新-台中",12,0,12
"12898","5521工信","110/08/19","富邦-高雄",1,15,-14
"12899","5521工信","110/08/19","臺銀-高雄",11,0,11
"12900","5521工信","110/08/19","元大-歸仁",2,16,-14
"12901","1471首利","110/08/19","新光",35,0,35
"12902","1471首利","110/08/19","摩根大通",42,206,-164
"12903","1471首利","110/08/19","新光-台南",24,0,24
"12904","1471首利","110/08/19","瑞士信貸",1,39,-38
"12905","1471首利","110/08/19","元大-太平",20,2,18
"12906","1471首利","110/08/19","凱基-五股",0,23,-23
"12907","1471首利","110/08/19","土銀-花蓮",15,0,15
"12908","1471首利","110/08/19","凱基-台北",6,29,-23
"12909","1471首利","110/08/19","玉山-桃園",15,0,15
"12910","1471首利","110/08/19","元大-虎尾",7,27,-20
"12911","1471首利","110/08/19","元富-三重",13,0,13
"12912","1471首利","110/08/19","光和",9,24,-15
"12913","1471首利","110/08/19","台新證券",12,0,12
"12914","1471首利","110/08/19","致和-府前",0,15,-15
"12915","1471首利","110/08/19","元大-員林中山",11,0,11
"12916","1471首利","110/08/19","兆豐-員林",0,12,-12
"12917","1471首利","110/08/19","台灣企銀-屏東",10,0,10
"12918","1471首利","110/08/19","凱基-新店",0,12,-12
"12919","1471首利","110/08/19","兆豐-台中港",10,0,10
"12920","1471首利","110/08/19","美林",0,11,-11
"12921","1471首利","110/08/19","致和-崇德",10,0,10
"12922","1471首利","110/08/19","凱基-頭份",0,10,-10
"12923","1471首利","110/08/19","凱基-高美館",10,0,10
"12924","1471首利","110/08/19","華南永昌-台中",0,10,-10
"12925","1471首利","110/08/19","華南永昌-公誠",10,0,10
"12926","1471首利","110/08/19","元大-大甲",0,9,-9
"12927","1471首利","110/08/19","華南永昌-楠梓",10,0,10
"12928","1471首利","110/08/19","凱基-三重",3,10,-7
"12929","1471首利","110/08/19","富邦-南屯",10,0,10
"12930","1471首利","110/08/19","永豐金-新店",0,7,-7
"12931","2883開發金","110/08/19","香港上海匯豐",6827,846,5981
"12932","2883開發金","110/08/19","凱基-台北",1722,11079,-9357
"12933","2883開發金","110/08/19","中國信託-文心",4667,49,4618
"12934","2883開發金","110/08/19","花旗環球",1244,7162,-5918
"12935","2883開發金","110/08/19","新光",3917,1918,1999
"12936","2883開發金","110/08/19","國泰證券",51,3659,-3608
"12937","2883開發金","110/08/19","凱基",1952,0,1952
"12938","2883開發金","110/08/19","台新證券",1038,4320,-3282
"12939","2883開發金","110/08/19","玉山證券",2183,465,1718
"12940","2883開發金","110/08/19","兆豐證券",7,1979,-1972
"12941","2883開發金","110/08/19","元大-忠孝",1666,40,1626
"12942","2883開發金","110/08/19","統一",51,1553,-1502
"12943","2883開發金","110/08/19","國泰-敦南",2025,483,1542
"12944","2883開發金","110/08/19","日盛證券",70,1356,-1286
"12945","2883開發金","110/08/19","新加坡商瑞銀",5707,4366,1341
"12946","2883開發金","110/08/19","合庫-彰化",31,1273,-1242
"12947","2883開發金","110/08/19","瑞士信貸",1645,478,1167
"12948","2883開發金","110/08/19","元大證券",2109,3261,-1152
"12949","2883開發金","110/08/19","康和-仁愛",1143,1,1142
"12950","2883開發金","110/08/19","宏遠證券",11,1083,-1072
"12951","2883開發金","110/08/19","凱基-竹科",753,16,737
"12952","2883開發金","110/08/19","富邦-北港",134,1188,-1054
"12953","2883開發金","110/08/19","國泰-板橋",919,284,635
"12954","2883開發金","110/08/19","元大-福營",55,1070,-1015
"12955","2883開發金","110/08/19","新光-台南",757,132,625
"12956","2883開發金","110/08/19","台灣企銀-民雄",23,1022,-999
"12957","2883開發金","110/08/19","元大-萬華",559,62,497
"12958","2883開發金","110/08/19","永豐金-南京",131,1128,-997
"12959","2883開發金","110/08/19","元大-中壢",533,53,480
"12960","2883開發金","110/08/19","群益金鼎-大安",38,965,-927
"12961","6205詮欣","110/08/19","日盛-三重",23,0,23
"12962","6205詮欣","110/08/19","高橋-內壢",0,20,-20
"12963","6205詮欣","110/08/19","凱基-汐止",21,0,21
"12964","6205詮欣","110/08/19","摩根大通",1,12,-11
"12965","6205詮欣","110/08/19","日茂-埔里",10,0,10
"12966","6205詮欣","110/08/19","福邦證券",0,10,-10
"12967","6205詮欣","110/08/19","凱基-台北",3,0,3
"12968","6205詮欣","110/08/19","元富-安南",0,6,-6
"12969","6205詮欣","110/08/19","永豐金證券",3,0,3
"12970","6205詮欣","110/08/19","永興-大墩",0,4,-4
"12971","6205詮欣","110/08/19","元富-草屯",2,0,2
"12972","6205詮欣","110/08/19","元大-豐原",0,2,-2
"12973","6205詮欣","110/08/19","臺銀-臺中",1,0,1
"12974","6205詮欣","110/08/19","統一-中壢",0,2,-2
"12975","6205詮欣","110/08/19","兆豐-景美",1,0,1
"12976","6205詮欣","110/08/19","中國信託-文心",0,2,-2
"12977","6205詮欣","110/08/19","凱基-桃園",1,0,1
"12978","6205詮欣","110/08/19","大慶-台南",0,1,-1
"12979","6205詮欣","110/08/19","凱基-復興",1,0,1
"12980","6205詮欣","110/08/19","元大-南投",0,1,-1
"12981","6205詮欣","110/08/19","華南永昌-台南",1,0,1
"12982","6205詮欣","110/08/19","華南永昌-虎尾",0,1,-1
"12983","6205詮欣","110/08/19","華南永昌-新莊",0,0,0
"12984","6205詮欣","110/08/19","凱基-和平",0,1,-1
"12985","6205詮欣","110/08/19","元大-大里",0,0,0
"12986","6205詮欣","110/08/19","豐農",0,1,-1
"12987","6205詮欣","110/08/19","永豐金-中和",1,1,0
"12988","6205詮欣","110/08/19","元富-文心",0,1,-1
"12989","6205詮欣","110/08/19","",NA,NA,NA
"12990","6205詮欣","110/08/19","美商高盛",0,1,-1
"12991","1540喬福","110/08/19","日盛-台南",20,0,20
"12992","1540喬福","110/08/19","兆豐-小港",0,30,-30
"12993","1540喬福","110/08/19","元大-板橋三民",11,0,11
"12994","1540喬福","110/08/19","富邦-台南",0,10,-10
"12995","1540喬福","110/08/19","富邦-陽明",10,0,10
"12996","1540喬福","110/08/19","元富-桃園",0,9,-9
"12997","1540喬福","110/08/19","富邦-南屯",10,0,10
"12998","1540喬福","110/08/19","元大-龍潭",0,9,-9
"12999","1540喬福","110/08/19","元大-桃興",10,0,10
"13000","1540喬福","110/08/19","元大-雙和",0,6,-6
"13001","1540喬福","110/08/19","元大-成功",10,0,10
"13002","1540喬福","110/08/19","元大-台南",0,5,-5
"13003","1540喬福","110/08/19","(牛牛牛)亞-網路",7,0,7
"13004","1540喬福","110/08/19","台中銀",0,4,-4
"13005","1540喬福","110/08/19","凱基-中壢",3,0,3
"13006","1540喬福","110/08/19","港商法國興業",0,3,-3
"13007","1540喬福","110/08/19","臺銀-新竹",2,0,2
"13008","1540喬福","110/08/19","富邦-員林",0,3,-3
"13009","1540喬福","110/08/19","國票-南崁",2,0,2
"13010","1540喬福","110/08/19","元富",0,2,-2
"13011","1540喬福","110/08/19","摩根大通",5,3,2
"13012","1540喬福","110/08/19","康和-板橋",0,2,-2
"13013","1540喬福","110/08/19","華南永昌-高雄",2,0,2
"13014","1540喬福","110/08/19","玉山-城中",0,2,-2
"13015","1540喬福","110/08/19","台中銀-豐原",1,0,1
"13016","1540喬福","110/08/19","元大-南崁",0,2,-2
"13017","1540喬福","110/08/19","國票-桃園",1,0,1
"13018","1540喬福","110/08/19","元大-敦南",0,2,-2
"13019","1540喬福","110/08/19","玉山-新竹",1,0,1
"13020","1540喬福","110/08/19","國票-台中",0,1,-1
"13021","2888新光金","110/08/19","兆豐-公益",5003,799,4204
"13022","2888新光金","110/08/19","摩根大通",1356,4583,-3227
"13023","2888新光金","110/08/19","凱基-台北",4068,1621,2447
"13024","2888新光金","110/08/19","凱基",0,3218,-3218
"13025","2888新光金","110/08/19","福邦-新竹",982,0,982
"13026","2888新光金","110/08/19","瑞士信貸",1,3126,-3125
"13027","2888新光金","110/08/19","美商高盛",1215,342,873
"13028","2888新光金","110/08/19","大昌-新竹",2,1424,-1422
"13029","2888新光金","110/08/19","統一-板橋",650,15,635
"13030","2888新光金","110/08/19","元富-虎尾",4,1276,-1272
"13031","2888新光金","110/08/19","凱基-中山",634,3,631
"13032","2888新光金","110/08/19","玉山-台南",134,1204,-1070
"13033","2888新光金","110/08/19","永豐金-鳳山",569,12,557
"13034","2888新光金","110/08/19","宏遠-光隆",25,1050,-1025
"13035","2888新光金","110/08/19","新光",855,323,532
"13036","2888新光金","110/08/19","玉山-板橋",106,841,-735
"13037","2888新光金","110/08/19","統一-台中",558,30,528
"13038","2888新光金","110/08/19","香港上海匯豐",0,728,-728
"13039","2888新光金","110/08/19","凱基-鳳山",525,0,525
"13040","2888新光金","110/08/19","台灣摩根士丹利",940,1609,-669
"13041","2888新光金","110/08/19","統一",577,100,477
"13042","2888新光金","110/08/19","中國信託",15,637,-622
"13043","2888新光金","110/08/19","元大證券",1048,635,413
"13044","2888新光金","110/08/19","元大-永和",20,600,-580
"13045","2888新光金","110/08/19","美林",1075,740,335
"13046","2888新光金","110/08/19","福勝",67,600,-533
"13047","2888新光金","110/08/19","元大-嘉義",315,10,305
"13048","2888新光金","110/08/19","凱基-中港",71,580,-509
"13049","2888新光金","110/08/19","元大-大統",304,13,291
"13050","2888新光金","110/08/19","群益金鼎",50,520,-470
"13051","1340勝悅","110/08/19","國泰-台南",99,3,96
"13052","1340勝悅","110/08/19","元大-成功",0,204,-204
"13053","1340勝悅","110/08/19","台中銀",38,0,38
"13054","1340勝悅","110/08/19","摩根大通",0,20,-20
"13055","1340勝悅","110/08/19","國泰-板橋",13,0,13
"13056","1340勝悅","110/08/19","瑞士信貸",0,12,-12
"13057","1340勝悅","110/08/19","臺銀-金山",10,0,10
"13058","1340勝悅","110/08/19","國票-敦北法人",0,12,-12
"13059","1340勝悅","110/08/19","元富-中港",10,0,10
"13060","1340勝悅","110/08/19","華南永昌-東昇",0,12,-12
"13061","1340勝悅","110/08/19","國泰-敦南",13,3,10
"13062","1340勝悅","110/08/19","永豐金-台南",0,12,-12
"13063","1340勝悅","110/08/19","元富-新店",10,2,8
"13064","1340勝悅","110/08/19","合庫-自強",0,11,-11
"13065","1340勝悅","110/08/19","合庫-新竹",7,0,7
"13066","1340勝悅","110/08/19","富邦-台中",0,5,-5
"13067","1340勝悅","110/08/19","群益金鼎-館前",10,3,7
"13068","1340勝悅","110/08/19","港商法國興業",0,4,-4
"13069","1340勝悅","110/08/19","致和-東門",6,0,6
"13070","1340勝悅","110/08/19","致和-金華",0,4,-4
"13071","1340勝悅","110/08/19","元大-屏南",6,0,6
"13072","1340勝悅","110/08/19","新光-台南",0,4,-4
"13073","1340勝悅","110/08/19","臺灣企銀-埔墘",5,0,5
"13074","1340勝悅","110/08/19","凱基-台北",1,5,-4
"13075","1340勝悅","110/08/19","日盛-和美",5,0,5
"13076","1340勝悅","110/08/19","土銀-南港",0,2,-2
"13077","1340勝悅","110/08/19","第一金-新竹",5,0,5
"13078","1340勝悅","110/08/19","元富-世貿",0,2,-2
"13079","1340勝悅","110/08/19","新光-桃園",5,0,5
"13080","1340勝悅","110/08/19","元大-信義",0,2,-2
"13081","6246臺龍","110/08/19","新光-台中",18,1,17
"13082","6246臺龍","110/08/19","日盛-和美",0,10,-10
"13083","6246臺龍","110/08/19","台灣企銀-台南",10,0,10
"13084","6246臺龍","110/08/19","元大-基隆孝二",0,9,-9
"13085","6246臺龍","110/08/19","凱基-台北",8,2,6
"13086","6246臺龍","110/08/19","港商野村",0,6,-6
"13087","6246臺龍","110/08/19","華南永昌-彰化",5,0,5
"13088","6246臺龍","110/08/19","臺銀-高雄",0,5,-5
"13089","6246臺龍","110/08/19","元大-南投",5,0,5
"13090","6246臺龍","110/08/19","兆豐-公益",0,5,-5
"13091","6246臺龍","110/08/19","元大-林園",5,0,5
"13092","6246臺龍","110/08/19","永豐金-三重",0,5,-5
"13093","6246臺龍","110/08/19","日盛-斗六",4,0,4
"13094","6246臺龍","110/08/19","中國信託",0,4,-4
"13095","6246臺龍","110/08/19","兆豐-新營",4,0,4
"13096","6246臺龍","110/08/19","元大-北成功",0,4,-4
"13097","6246臺龍","110/08/19","(牛牛牛)亞-鑫豐",3,0,3
"13098","6246臺龍","110/08/19","元大-台南",0,4,-4
"13099","6246臺龍","110/08/19","台新-台中",3,0,3
"13100","6246臺龍","110/08/19","元富-烏日",0,3,-3
"13101","6246臺龍","110/08/19","元大-大統",3,0,3
"13102","6246臺龍","110/08/19","玉山-城中",0,3,-3
"13103","6246臺龍","110/08/19","臺銀-民權",2,0,2
"13104","6246臺龍","110/08/19","元大-長庚",0,3,-3
"13105","6246臺龍","110/08/19","第一金-大稻埕",2,0,2
"13106","6246臺龍","110/08/19","元大-苑裡",0,3,-3
"13107","6246臺龍","110/08/19","元富-大昌",2,0,2
"13108","6246臺龍","110/08/19","永豐金-屏東",0,3,-3
"13109","6246臺龍","110/08/19","國票-敦北法人",2,0,2
"13110","6246臺龍","110/08/19","統一-永和",0,2,-2
"13111","00715L期街口布蘭特正2","110/08/19","台新證券",1458,205,1253
"13112","00715L期街口布蘭特正2","110/08/19","元大證券",4224,11178,-6954
"13113","00715L期街口布蘭特正2","110/08/19","富邦-南屯",1119,14,1105
"13114","00715L期街口布蘭特正2","110/08/19","合庫證券",266,2599,-2333
"13115","00715L期街口布蘭特正2","110/08/19","元大-永康",1118,19,1099
"13116","00715L期街口布蘭特正2","110/08/19","永豐金證券",8,2207,-2199
"13117","00715L期街口布蘭特正2","110/08/19","豐農",1023,30,993
"13118","00715L期街口布蘭特正2","110/08/19","元大-屏東民生",14,2200,-2186
"13119","00715L期街口布蘭特正2","110/08/19","元大-復北",954,74,880
"13120","00715L期街口布蘭特正2","110/08/19","凱基-台北",245,1890,-1645
"13121","00715L期街口布蘭特正2","110/08/19","中國信託-新竹",840,0,840
"13122","00715L期街口布蘭特正2","110/08/19","國票-博愛",10,1405,-1395
"13123","00715L期街口布蘭特正2","110/08/19","富邦證券",2317,1629,688
"13124","00715L期街口布蘭特正2","110/08/19","元富",10,1165,-1155
"13125","00715L期街口布蘭特正2","110/08/19","第一金-台南",540,0,540
"13126","00715L期街口布蘭特正2","110/08/19","新光",791,1810,-1019
"13127","00715L期街口布蘭特正2","110/08/19","兆豐-台中港",523,30,493
"13128","00715L期街口布蘭特正2","110/08/19","統一",3,978,-975
"13129","00715L期街口布蘭特正2","110/08/19","兆豐-嘉義",465,110,355
"13130","00715L期街口布蘭特正2","110/08/19","華南永昌-長虹",82,830,-748
"13131","00715L期街口布蘭特正2","110/08/19","元大-大里德芳",323,0,323
"13132","00715L期街口布蘭特正2","110/08/19","群益金鼎-宜蘭",20,737,-717
"13133","00715L期街口布蘭特正2","110/08/19","富邦-基隆",336,20,316
"13134","00715L期街口布蘭特正2","110/08/19","亞東",21,512,-491
"13135","00715L期街口布蘭特正2","110/08/19","元大-草屯",434,124,310
"13136","00715L期街口布蘭特正2","110/08/19","永豐金-板盛",6,420,-414
"13137","00715L期街口布蘭特正2","110/08/19","國泰-敦南",552,280,272
"13138","00715L期街口布蘭特正2","110/08/19","第一金-自由",28,419,-391
"13139","00715L期街口布蘭特正2","110/08/19","永豐金-羅東",270,2,268
"13140","00715L期街口布蘭特正2","110/08/19","元大-高雄",128,502,-374
"13141","8941關中","110/08/19","宏遠-館前",2,0,2
"13142","8941關中","110/08/19","富邦-台中",0,6,-6
"13143","8941關中","110/08/19","元大-西門",2,0,2
"13144","8941關中","110/08/19","兆豐-台中",0,2,-2
"13145","8941關中","110/08/19","新光-台中",1,0,1
"13146","8941關中","110/08/19","元大-金華",1,2,-1
"13147","8941關中","110/08/19","玉山-桃園",1,0,1
"13148","8941關中","110/08/19","兆豐-南京",0,0,0
"13149","8941關中","110/08/19","國泰-忠孝",1,0,1
"13150","8941關中","110/08/19","富邦-仁愛",0,0,0
"13151","8941關中","110/08/19","元大-華山",1,0,1
"13152","8941關中","110/08/19","元大-大雅",0,0,0
"13153","8941關中","110/08/19","元大-桃興",1,0,1
"13154","8941關中","110/08/19","永豐金-敦北",0,0,0
"13155","8941關中","110/08/19","兆豐-南京",0,0,0
"13156","8941關中","110/08/19","永豐金-南投",0,0,0
"13157","8941關中","110/08/19","富邦-仁愛",0,0,0
"13158","8941關中","110/08/19","",NA,NA,NA
"13159","8941關中","110/08/19","元大-大雅",0,0,0
"13160","8941關中","110/08/19","",NA,NA,NA
"13161","8941關中","110/08/19","永豐金-敦北",0,0,0
"13162","8941關中","110/08/19","",NA,NA,NA
"13163","8941關中","110/08/19","永豐金-南投",0,0,0
"13164","8941關中","110/08/19","",NA,NA,NA
"13165","8941關中","110/08/19","",NA,NA,NA
"13166","8941關中","110/08/19","",NA,NA,NA
"13167","8941關中","110/08/19","",NA,NA,NA
"13168","8941關中","110/08/19","",NA,NA,NA
"13169","8941關中","110/08/19","",NA,NA,NA
"13170","8941關中","110/08/19","",NA,NA,NA
"13171","8936國統","110/08/19","宏遠-台南",211,0,211
"13172","8936國統","110/08/19","元大-高雄",0,40,-40
"13173","8936國統","110/08/19","康和-高雄",126,1,125
"13174","8936國統","110/08/19","永豐金-苓雅",0,38,-38
"13175","8936國統","110/08/19","凱基-台北",122,66,56
"13176","8936國統","110/08/19","美商高盛",6,38,-32
"13177","8936國統","110/08/19","美林",54,0,54
"13178","8936國統","110/08/19","港商野村",17,38,-21
"13179","8936國統","110/08/19","新加坡商瑞銀",46,20,26
"13180","8936國統","110/08/19","日盛-頭份",0,20,-20
"13181","8936國統","110/08/19","元富-緯城",25,0,25
"13182","8936國統","110/08/19","兆豐-三重",0,20,-20
"13183","8936國統","110/08/19","富邦-高雄",14,0,14
"13184","8936國統","110/08/19","玉山-桃園",0,20,-20
"13185","8936國統","110/08/19","日盛-復興",10,0,10
"13186","8936國統","110/08/19","國泰-高雄",4,22,-18
"13187","8936國統","110/08/19","宏遠-高雄",18,8,10
"13188","8936國統","110/08/19","台灣摩根士丹利",0,17,-17
"13189","8936國統","110/08/19","中國信託-高雄",20,12,8
"13190","8936國統","110/08/19","凱基-竹科",0,16,-16
"13191","8936國統","110/08/19","日盛-豐原",7,0,7
"13192","8936國統","110/08/19","元大-大里德芳",0,16,-16
"13193","8936國統","110/08/19","元富-三重",7,0,7
"13194","8936國統","110/08/19","大昌-樹林",0,15,-15
"13195","8936國統","110/08/19","台新-高雄",10,3,7
"13196","8936國統","110/08/19","台新-屏東",0,12,-12
"13197","8936國統","110/08/19","臺銀-高雄",6,0,6
"13198","8936國統","110/08/19","中農",0,11,-11
"13199","8936國統","110/08/19","第一金-路竹",6,0,6
"13200","8936國統","110/08/19","臺銀-新竹",0,10,-10
"13201","6226光鼎","110/08/19","富邦-左營",110,2,108
"13202","6226光鼎","110/08/19","凱基-台北",177,732,-555
"13203","6226光鼎","110/08/19","元大-北屯",151,50,101
"13204","6226光鼎","110/08/19","摩根大通",28,396,-368
"13205","6226光鼎","110/08/19","國泰-敦南",201,125,76
"13206","6226光鼎","110/08/19","台灣摩根士丹利",0,254,-254
"13207","6226光鼎","110/08/19","元大-敦化",56,4,52
"13208","6226光鼎","110/08/19","元大-文心興安",1,230,-229
"13209","6226光鼎","110/08/19","兆豐-中壢",50,1,49
"13210","6226光鼎","110/08/19","美商高盛",33,233,-200
"13211","6226光鼎","110/08/19","凱基-台中",44,2,42
"13212","6226光鼎","110/08/19","富邦-台北",22,202,-180
"13213","6226光鼎","110/08/19","新光",121,81,40
"13214","6226光鼎","110/08/19","美林",72,160,-88
"13215","6226光鼎","110/08/19","合庫-西台中",47,10,37
"13216","6226光鼎","110/08/19","新加坡商瑞銀",138,225,-87
"13217","6226光鼎","110/08/19","元大-龍潭",42,5,37
"13218","6226光鼎","110/08/19","元大-南勢角",0,70,-70
"13219","6226光鼎","110/08/19","兆豐-東門",36,0,36
"13220","6226光鼎","110/08/19","臺銀-高雄",0,67,-67
"13221","6226光鼎","110/08/19","新光-台中",83,48,35
"13222","6226光鼎","110/08/19","港商野村",178,231,-53
"13223","6226光鼎","110/08/19","玉山-桃園",39,4,35
"13224","6226光鼎","110/08/19","永豐金-內湖",6,56,-50
"13225","6226光鼎","110/08/19","元大-竹科",59,24,35
"13226","6226光鼎","110/08/19","高橋-內壢",5,54,-49
"13227","6226光鼎","110/08/19","第一金-台南",33,0,33
"13228","6226光鼎","110/08/19","凱基-員林",7,53,-46
"13229","6226光鼎","110/08/19","台新證券",66,33,33
"13230","6226光鼎","110/08/19","台新-台中",28,65,-37
"13231","2363矽統","110/08/19","日盛-樹林",300,12,288
"13232","2363矽統","110/08/19","凱基-台北",560,1671,-1111
"13233","2363矽統","110/08/19","永豐金-板盛",200,2,198
"13234","2363矽統","110/08/19","摩根大通",3,713,-710
"13235","2363矽統","110/08/19","凱基-三峽",134,18,116
"13236","2363矽統","110/08/19","台新-三民",50,291,-241
"13237","2363矽統","110/08/19","富邦-新竹",94,7,87
"13238","2363矽統","110/08/19","台灣摩根士丹利",0,206,-206
"13239","2363矽統","110/08/19","元大-汐止",75,8,67
"13240","2363矽統","110/08/19","凱基-和平",1,132,-131
"13241","2363矽統","110/08/19","元大-斗六",67,2,65
"13242","2363矽統","110/08/19","永豐金證券",12,125,-113
"13243","2363矽統","110/08/19","大慶-蘆洲",69,13,56
"13244","2363矽統","110/08/19","石橋證券",50,155,-105
"13245","2363矽統","110/08/19","永豐金-豐原",55,2,53
"13246","2363矽統","110/08/19","港商野村",838,925,-87
"13247","2363矽統","110/08/19","日盛-豐原",59,10,49
"13248","2363矽統","110/08/19","新光-桃園",4,87,-83
"13249","2363矽統","110/08/19","群益金鼎-中壢",54,7,47
"13250","2363矽統","110/08/19","新光",212,282,-70
"13251","2363矽統","110/08/19","元大-南投",58,12,46
"13252","2363矽統","110/08/19","陽信-石牌",18,83,-65
"13253","2363矽統","110/08/19","富邦-板橋",51,7,44
"13254","2363矽統","110/08/19","美林",31,91,-60
"13255","2363矽統","110/08/19","台新證券",117,74,43
"13256","2363矽統","110/08/19","永豐金-新店",1,59,-58
"13257","2363矽統","110/08/19","元大-東港",45,2,43
"13258","2363矽統","110/08/19","台新-左楠",19,76,-57
"13259","2363矽統","110/08/19","元大-旗山",47,5,42
"13260","2363矽統","110/08/19","永全-南崁",7,53,-46
"13261","8112至上","110/08/19","元大-敦化",60,0,60
"13262","8112至上","110/08/19","港商野村",22,279,-257
"13263","8112至上","110/08/19","玉山-城中",60,2,58
"13264","8112至上","110/08/19","瑞士信貸",0,239,-239
"13265","8112至上","110/08/19","永豐金-敦南",52,4,48
"13266","8112至上","110/08/19","凱基-台北",101,275,-174
"13267","8112至上","110/08/19","統一",41,0,41
"13268","8112至上","110/08/19","摩根大通",161,332,-171
"13269","8112至上","110/08/19","元大-竹東",36,0,36
"13270","8112至上","110/08/19","凱基-市政",0,80,-80
"13271","8112至上","110/08/19","凱基-嘉義",35,0,35
"13272","8112至上","110/08/19","台灣摩根士丹利",6,75,-69
"13273","8112至上","110/08/19","新光-台南",32,0,32
"13274","8112至上","110/08/19","美商高盛",18,76,-58
"13275","8112至上","110/08/19","永興-水湳",30,0,30
"13276","8112至上","110/08/19","新加坡商瑞銀",22,76,-54
"13277","8112至上","110/08/19","元大-永和",29,0,29
"13278","8112至上","110/08/19","美林",9,61,-52
"13279","8112至上","110/08/19","凱基-東勢",26,1,25
"13280","8112至上","110/08/19","富邦-花蓮",1,51,-50
"13281","8112至上","110/08/19","臺銀-臺南",28,4,24
"13282","8112至上","110/08/19","元大-路竹",8,52,-44
"13283","8112至上","110/08/19","富邦-中壢",29,5,24
"13284","8112至上","110/08/19","(牛牛牛)亞-鑫豐",34,77,-43
"13285","8112至上","110/08/19","第一金-桃園",24,1,23
"13286","8112至上","110/08/19","台新-中壢",2,42,-40
"13287","8112至上","110/08/19","國泰-敦南",27,4,23
"13288","8112至上","110/08/19","國泰證券",0,40,-40
"13289","8112至上","110/08/19","凱基-文心",23,0,23
"13290","8112至上","110/08/19","永豐金-苓雅",0,40,-40
"13291","1570力肯","110/08/19","國票-北高雄",37,0,37
"13292","1570力肯","110/08/19","新光-台南",3,44,-41
"13293","1570力肯","110/08/19","康和-台南",30,0,30
"13294","1570力肯","110/08/19","元大-大統",0,20,-20
"13295","1570力肯","110/08/19","國票-內壢",25,0,25
"13296","1570力肯","110/08/19","元富-新店",0,18,-18
"13297","1570力肯","110/08/19","元富-虎尾",20,0,20
"13298","1570力肯","110/08/19","元大-民生",2,19,-17
"13299","1570力肯","110/08/19","國票-博愛",17,0,17
"13300","1570力肯","110/08/19","國泰-敦南",1,16,-15
"13301","1570力肯","110/08/19","日盛-高雄",15,0,15
"13302","1570力肯","110/08/19","富邦-敦南",0,15,-15
"13303","1570力肯","110/08/19","元大-南投",15,0,15
"13304","1570力肯","110/08/19","元大-大雅",10,25,-15
"13305","1570力肯","110/08/19","富邦-嘉義",15,1,14
"13306","1570力肯","110/08/19","日盛-板橋",2,16,-14
"13307","1570力肯","110/08/19","元大-北投",13,0,13
"13308","1570力肯","110/08/19","華南永昌-嘉義",0,12,-12
"13309","1570力肯","110/08/19","元富-緯城",12,0,12
"13310","1570力肯","110/08/19","凱基-台北",3,14,-11
"13311","1570力肯","110/08/19","土銀-新竹",11,0,11
"13312","1570力肯","110/08/19","元富-草屯",0,10,-10
"13313","1570力肯","110/08/19","日盛-嘉義",11,0,11
"13314","1570力肯","110/08/19","新光",7,17,-10
"13315","1570力肯","110/08/19","富邦-羅東",11,0,11
"13316","1570力肯","110/08/19","富邦-內湖",3,13,-10
"13317","1570力肯","110/08/19","富邦-仁愛",10,0,10
"13318","1570力肯","110/08/19","元大-福營",0,10,-10
"13319","1570力肯","110/08/19","元大-羅東",10,0,10
"13320","1570力肯","110/08/19","元大-松山",0,10,-10
"13321","2929淘帝","110/08/19","元大-太平",54,0,54
"13322","2929淘帝","110/08/19","摩根大通",0,58,-58
"13323","2929淘帝","110/08/19","凱基-東門",32,0,32
"13324","2929淘帝","110/08/19","宏遠-館前",0,35,-35
"13325","2929淘帝","110/08/19","日盛-桃園",20,0,20
"13326","2929淘帝","110/08/19","元富-台南",0,32,-32
"13327","2929淘帝","110/08/19","富邦-高雄",16,0,16
"13328","2929淘帝","110/08/19","日茂",0,20,-20
"13329","2929淘帝","110/08/19","元大-員林",11,0,11
"13330","2929淘帝","110/08/19","美商高盛",0,11,-11
"13331","2929淘帝","110/08/19","凱基-中山",10,0,10
"13332","2929淘帝","110/08/19","凱基-站前",0,10,-10
"13333","2929淘帝","110/08/19","富邦-南屯",7,0,7
"13334","2929淘帝","110/08/19","統一-三重",0,8,-8
"13335","2929淘帝","110/08/19","日盛-雙和",6,0,6
"13336","2929淘帝","110/08/19","群益金鼎",0,7,-7
"13337","2929淘帝","110/08/19","亞東-新竹",6,0,6
"13338","2929淘帝","110/08/19","凱基-八德",0,7,-7
"13339","2929淘帝","110/08/19","兆豐-桃鶯",6,0,6
"13340","2929淘帝","110/08/19","港商野村",3,9,-6
"13341","2929淘帝","110/08/19","新光",6,0,6
"13342","2929淘帝","110/08/19","安泰",0,5,-5
"13343","2929淘帝","110/08/19","群益金鼎-三重",5,0,5
"13344","2929淘帝","110/08/19","元大-金門",0,5,-5
"13345","2929淘帝","110/08/19","元大-左營",5,0,5
"13346","2929淘帝","110/08/19","永豐金-竹科",0,5,-5
"13347","2929淘帝","110/08/19","台新-新莊",9,5,4
"13348","2929淘帝","110/08/19","致和證券",0,4,-4
"13349","2929淘帝","110/08/19","群益金鼎-新店",4,0,4
"13350","2929淘帝","110/08/19","元大-苑裡",0,4,-4
"13351","5410國眾","110/08/19","土銀-嘉義",14,0,14
"13352","5410國眾","110/08/19","致和-台北",0,60,-60
"13353","5410國眾","110/08/19","國票-北高雄",10,0,10
"13354","5410國眾","110/08/19","凱基-台北",1,20,-19
"13355","5410國眾","110/08/19","玉山-城中",10,0,10
"13356","5410國眾","110/08/19","新加坡商瑞銀",0,14,-14
"13357","5410國眾","110/08/19","元大-中壢",9,0,9
"13358","5410國眾","110/08/19","亞東-新竹",0,14,-14
"13359","5410國眾","110/08/19","台新證券",8,0,8
"13360","5410國眾","110/08/19","富邦-永和",0,7,-7
"13361","5410國眾","110/08/19","新光",7,1,6
"13362","5410國眾","110/08/19","摩根大通",0,5,-5
"13363","5410國眾","110/08/19","日盛-八德",5,0,5
"13364","5410國眾","110/08/19","元大-南勢角",0,3,-3
"13365","5410國眾","110/08/19","元大-旗山",5,0,5
"13366","5410國眾","110/08/19","元大-板橋三民",0,3,-3
"13367","5410國眾","110/08/19","元大-博愛",5,0,5
"13368","5410國眾","110/08/19","元富-大昌",0,2,-2
"13369","5410國眾","110/08/19","元大-左營",5,0,5
"13370","5410國眾","110/08/19","台中銀-員林",0,2,-2
"13371","5410國眾","110/08/19","臺銀-金山",6,2,4
"13372","5410國眾","110/08/19","台新-左楠",0,2,-2
"13373","5410國眾","110/08/19","統一-台中",4,0,4
"13374","5410國眾","110/08/19","群益金鼎-東門",0,2,-2
"13375","5410國眾","110/08/19","元大-開元",4,0,4
"13376","5410國眾","110/08/19","凱基-汐止",0,2,-2
"13377","5410國眾","110/08/19","日盛-園區",3,0,3
"13378","5410國眾","110/08/19","華南永昌-小港",0,2,-2
"13379","5410國眾","110/08/19","國泰-敦南",3,0,3
"13380","5410國眾","110/08/19","富邦-新店",0,2,-2
"13381","2841台開","110/08/19","宏遠-館前",360,0,360
"13382","2841台開","110/08/19","元大證券",0,108,-108
"13383","2841台開","110/08/19","第一金",104,0,104
"13384","2841台開","110/08/19","國票-敦北法人",0,98,-98
"13385","2841台開","110/08/19","日盛-台中",35,1,34
"13386","2841台開","110/08/19","台中銀",0,93,-93
"13387","2841台開","110/08/19","合庫證券",20,0,20
"13388","2841台開","110/08/19","元大-府城",0,51,-51
"13389","2841台開","110/08/19","第一金-台中",20,0,20
"13390","2841台開","110/08/19","日盛-信義",0,50,-50
"13391","2841台開","110/08/19","富邦-基隆",20,0,20
"13392","2841台開","110/08/19","新光-台南",0,46,-46
"13393","2841台開","110/08/19","富邦-三重",20,0,20
"13394","2841台開","110/08/19","永豐金-桃園",0,41,-41
"13395","2841台開","110/08/19","元大-六合",17,0,17
"13396","2841台開","110/08/19","凱基-高美館",0,30,-30
"13397","2841台開","110/08/19","國泰-館前",11,0,11
"13398","2841台開","110/08/19","凱基-新豐",0,30,-30
"13399","2841台開","110/08/19","統一-新台中",10,0,10
"13400","2841台開","110/08/19","第一金-忠孝",0,20,-20
"13401","2841台開","110/08/19","玉山證券",10,0,10
"13402","2841台開","110/08/19","富邦-員林",0,20,-20
"13403","2841台開","110/08/19","國泰-台中",10,0,10
"13404","2841台開","110/08/19","日盛證券",22,38,-16
"13405","2841台開","110/08/19","國泰-忠孝",10,0,10
"13406","2841台開","110/08/19","國泰-敦南",3,19,-16
"13407","2841台開","110/08/19","元大-東泰",10,0,10
"13408","2841台開","110/08/19","中國信託-嘉義",0,15,-15
"13409","2841台開","110/08/19","元大-高雄",10,0,10
"13410","2841台開","110/08/19","永豐金-敦南",17,29,-12
"13411","6207雷科","110/08/19","元大-高雄",76,0,76
"13412","6207雷科","110/08/19","凱基-大安",0,50,-50
"13413","6207雷科","110/08/19","光和-和美",53,0,53
"13414","6207雷科","110/08/19","凱基-復興",2,30,-28
"13415","6207雷科","110/08/19","日盛-桃園",10,0,10
"13416","6207雷科","110/08/19","日盛-三重",0,23,-23
"13417","6207雷科","110/08/19","元大-六合",10,0,10
"13418","6207雷科","110/08/19","港商野村",8,30,-22
"13419","6207雷科","110/08/19","凱基-台北",21,13,8
"13420","6207雷科","110/08/19","新加坡商瑞銀",12,29,-17
"13421","6207雷科","110/08/19","永豐金-高雄",8,0,8
"13422","6207雷科","110/08/19","日茂-埔里",0,17,-17
"13423","6207雷科","110/08/19","凱基-高雄",7,0,7
"13424","6207雷科","110/08/19","摩根大通",7,21,-14
"13425","6207雷科","110/08/19","元大-沙鹿",6,0,6
"13426","6207雷科","110/08/19","群益金鼎-東門",0,12,-12
"13427","6207雷科","110/08/19","元大-東門",6,0,6
"13428","6207雷科","110/08/19","富邦-虎尾",0,10,-10
"13429","6207雷科","110/08/19","元富-吉利",5,0,5
"13430","6207雷科","110/08/19","凱基-高美館",5,14,-9
"13431","6207雷科","110/08/19","大昌-桃園",5,0,5
"13432","6207雷科","110/08/19","富邦-板橋",0,8,-8
"13433","6207雷科","110/08/19","玉山-大里",5,0,5
"13434","6207雷科","110/08/19","元富-潮州",0,7,-7
"13435","6207雷科","110/08/19","元大-大益",5,0,5
"13436","6207雷科","110/08/19","凱基-員林",0,7,-7
"13437","6207雷科","110/08/19","元大-福營",4,0,4
"13438","6207雷科","110/08/19","華南永昌-林口",0,7,-7
"13439","6207雷科","110/08/19","臺銀-臺中",3,0,3
"13440","6207雷科","110/08/19","日盛-八德",0,6,-6
"13441","3679新至陞","110/08/19","台灣摩根士丹利",7,0,7
"13442","3679新至陞","110/08/19","摩根大通",3,11,-8
"13443","3679新至陞","110/08/19","元大-板橋",6,0,6
"13444","3679新至陞","110/08/19","瑞士信貸",1,6,-5
"13445","3679新至陞","110/08/19","美林",10,5,5
"13446","3679新至陞","110/08/19","美商高盛",0,3,-3
"13447","3679新至陞","110/08/19","日盛-土城",2,0,2
"13448","3679新至陞","110/08/19","宏遠-館前",0,2,-2
"13449","3679新至陞","110/08/19","富邦-新店",2,0,2
"13450","3679新至陞","110/08/19","港商野村",0,2,-2
"13451","3679新至陞","110/08/19","土銀-新竹",1,0,1
"13452","3679新至陞","110/08/19","花旗環球",0,2,-2
"13453","3679新至陞","110/08/19","臺銀-高雄",1,0,1
"13454","3679新至陞","110/08/19","國泰-高雄",0,2,-2
"13455","3679新至陞","110/08/19","(牛牛牛)亞-網路",1,0,1
"13456","3679新至陞","110/08/19","元大證券",1,3,-2
"13457","3679新至陞","110/08/19","中國信託-永康",1,0,1
"13458","3679新至陞","110/08/19","元大-新店中正",0,2,-2
"13459","3679新至陞","110/08/19","光和-溪湖",1,0,1
"13460","3679新至陞","110/08/19","元大-成功",0,2,-2
"13461","3679新至陞","110/08/19","兆豐證券",1,0,1
"13462","3679新至陞","110/08/19","永豐金-板新",0,2,-2
"13463","3679新至陞","110/08/19","國票-台東",1,0,1
"13464","3679新至陞","110/08/19","土銀-和平",0,1,-1
"13465","3679新至陞","110/08/19","玉山-新莊",1,0,1
"13466","3679新至陞","110/08/19","新加坡商瑞銀",0,1,-1
"13467","3679新至陞","110/08/19","玉山-嘉義",1,0,1
"13468","3679新至陞","110/08/19","第一金-忠孝",0,1,-1
"13469","3679新至陞","110/08/19","群益金鼎-高盛",1,0,1
"13470","3679新至陞","110/08/19","凱基",0,1,-1
"13471","2727王品","110/08/19","日盛-忠孝",36,0,36
"13472","2727王品","110/08/19","宏遠證券",0,75,-75
"13473","2727王品","110/08/19","中國信託-高雄",12,0,12
"13474","2727王品","110/08/19","美林",0,49,-49
"13475","2727王品","110/08/19","國泰-敦南",17,6,11
"13476","2727王品","110/08/19","摩根大通",1,47,-46
"13477","2727王品","110/08/19","群益金鼎-新店",10,0,10
"13478","2727王品","110/08/19","永豐金證券",2,45,-43
"13479","2727王品","110/08/19","富邦-羅東",10,0,10
"13480","2727王品","110/08/19","美商高盛",2,39,-37
"13481","2727王品","110/08/19","富邦-仁愛",9,0,9
"13482","2727王品","110/08/19","凱基-台北",27,56,-29
"13483","2727王品","110/08/19","國泰-台中",14,6,8
"13484","2727王品","110/08/19","新光-台中",5,28,-23
"13485","2727王品","110/08/19","元大-北屯",10,2,8
"13486","2727王品","110/08/19","台灣摩根士丹利",1,21,-20
"13487","2727王品","110/08/19","元富-大昌",7,0,7
"13488","2727王品","110/08/19","凱基-東門",0,18,-18
"13489","2727王品","110/08/19","台新-台中",9,2,7
"13490","2727王品","110/08/19","統一",0,17,-17
"13491","2727王品","110/08/19","新光-新竹",7,0,7
"13492","2727王品","110/08/19","瑞士信貸",2,13,-11
"13493","2727王品","110/08/19","凱基-基隆",7,0,7
"13494","2727王品","110/08/19","新加坡商瑞銀",0,11,-11
"13495","2727王品","110/08/19","宏遠-高雄",6,0,6
"13496","2727王品","110/08/19","港商野村",18,28,-10
"13497","2727王品","110/08/19","台新證券",6,0,6
"13498","2727王品","110/08/19","富邦-新店",1,11,-10
"13499","2727王品","110/08/19","玉山證券",6,0,6
"13500","2727王品","110/08/19","元大-善化",0,10,-10
"13501","1570力肯","110/08/19","國票-北高雄",37,0,37
"13502","1570力肯","110/08/19","新光-台南",3,44,-41
"13503","1570力肯","110/08/19","康和-台南",30,0,30
"13504","1570力肯","110/08/19","元大-大統",0,20,-20
"13505","1570力肯","110/08/19","國票-內壢",25,0,25
"13506","1570力肯","110/08/19","元富-新店",0,18,-18
"13507","1570力肯","110/08/19","元富-虎尾",20,0,20
"13508","1570力肯","110/08/19","元大-民生",2,19,-17
"13509","1570力肯","110/08/19","國票-博愛",17,0,17
"13510","1570力肯","110/08/19","國泰-敦南",1,16,-15
"13511","1570力肯","110/08/19","日盛-高雄",15,0,15
"13512","1570力肯","110/08/19","富邦-敦南",0,15,-15
"13513","1570力肯","110/08/19","元大-南投",15,0,15
"13514","1570力肯","110/08/19","元大-大雅",10,25,-15
"13515","1570力肯","110/08/19","富邦-嘉義",15,1,14
"13516","1570力肯","110/08/19","日盛-板橋",2,16,-14
"13517","1570力肯","110/08/19","元大-北投",13,0,13
"13518","1570力肯","110/08/19","華南永昌-嘉義",0,12,-12
"13519","1570力肯","110/08/19","元富-緯城",12,0,12
"13520","1570力肯","110/08/19","凱基-台北",3,14,-11
"13521","1570力肯","110/08/19","土銀-新竹",11,0,11
"13522","1570力肯","110/08/19","元富-草屯",0,10,-10
"13523","1570力肯","110/08/19","日盛-嘉義",11,0,11
"13524","1570力肯","110/08/19","新光",7,17,-10
"13525","1570力肯","110/08/19","富邦-羅東",11,0,11
"13526","1570力肯","110/08/19","富邦-內湖",3,13,-10
"13527","1570力肯","110/08/19","富邦-仁愛",10,0,10
"13528","1570力肯","110/08/19","元大-福營",0,10,-10
"13529","1570力肯","110/08/19","元大-羅東",10,0,10
"13530","1570力肯","110/08/19","元大-松山",0,10,-10
"13531","6180橘子","110/08/19","美林",29,0,29
"13532","6180橘子","110/08/19","新光-台中",4,23,-19
"13533","6180橘子","110/08/19","美商高盛",24,0,24
"13534","6180橘子","110/08/19","元大-大甲",0,16,-16
"13535","6180橘子","110/08/19","富邦-竹東",21,0,21
"13536","6180橘子","110/08/19","元富-城東",1,13,-12
"13537","6180橘子","110/08/19","第一金-新竹",20,0,20
"13538","6180橘子","110/08/19","凱基-台北",2,13,-11
"13539","6180橘子","110/08/19","富邦-永和",11,0,11
"13540","6180橘子","110/08/19","凱基-竹科",1,12,-11
"13541","6180橘子","110/08/19","合庫-自強",10,0,10
"13542","6180橘子","110/08/19","元富-草屯",0,10,-10
"13543","6180橘子","110/08/19","富邦-新竹",12,2,10
"13544","6180橘子","110/08/19","新光",8,18,-10
"13545","6180橘子","110/08/19","元大-中壢",10,1,9
"13546","6180橘子","110/08/19","凱基-站前",0,10,-10
"13547","6180橘子","110/08/19","國泰-板橋",7,1,6
"13548","6180橘子","110/08/19","元大-文心興安",0,10,-10
"13549","6180橘子","110/08/19","富隆-長安",5,0,5
"13550","6180橘子","110/08/19","永豐金-新店",0,10,-10
"13551","6180橘子","110/08/19","大慶-苗栗",5,0,5
"13552","6180橘子","110/08/19","兆豐-新營",1,10,-9
"13553","6180橘子","110/08/19","台新-屏東",5,0,5
"13554","6180橘子","110/08/19","元大-北屯",1,10,-9
"13555","6180橘子","110/08/19","元大-向上",5,0,5
"13556","6180橘子","110/08/19","摩根大通",28,36,-8
"13557","6180橘子","110/08/19","永豐金-竹科",5,0,5
"13558","6180橘子","110/08/19","凱基-市政",0,7,-7
"13559","6180橘子","110/08/19","土銀-新竹",4,0,4
"13560","6180橘子","110/08/19","台灣摩根士丹利",11,17,-6
"13561","2390云辰","110/08/19","富邦-花蓮",100,0,100
"13562","2390云辰","110/08/19","摩根大通",96,805,-709
"13563","2390云辰","110/08/19","統一-新台中",86,0,86
"13564","2390云辰","110/08/19","美林",195,271,-76
"13565","2390云辰","110/08/19","凱基-台北",335,254,81
"13566","2390云辰","110/08/19","兆豐-桃園",15,90,-75
"13567","2390云辰","110/08/19","國票-博愛",132,54,78
"13568","2390云辰","110/08/19","大昌-新店",27,92,-65
"13569","2390云辰","110/08/19","凱基-台中",77,1,76
"13570","2390云辰","110/08/19","宏遠-桃園",1,63,-62
"13571","2390云辰","110/08/19","凱基-和平",60,2,58
"13572","2390云辰","110/08/19","華南永昌-公誠",53,110,-57
"13573","2390云辰","110/08/19","國票-安和",53,10,43
"13574","2390云辰","110/08/19","大慶-富順",11,67,-56
"13575","2390云辰","110/08/19","元大-四維",46,10,36
"13576","2390云辰","110/08/19","元大-歸仁",2,55,-53
"13577","2390云辰","110/08/19","中農",55,20,35
"13578","2390云辰","110/08/19","日茂",7,58,-51
"13579","2390云辰","110/08/19","第一金-安和",55,22,33
"13580","2390云辰","110/08/19","元大-大灣",10,60,-50
"13581","2390云辰","110/08/19","元大-雙和",42,12,30
"13582","2390云辰","110/08/19","凱基-三重",1,48,-47
"13583","2390云辰","110/08/19","國泰-館前",77,48,29
"13584","2390云辰","110/08/19","國票-台東",2,41,-39
"13585","2390云辰","110/08/19","元大-文心興安",42,13,29
"13586","2390云辰","110/08/19","豐農",7,41,-34
"13587","2390云辰","110/08/19","(牛牛牛)亞-鑫豐",59,31,28
"13588","2390云辰","110/08/19","凱基-中港",5,36,-31
"13589","2390云辰","110/08/19","國泰-高雄",44,18,26
"13590","2390云辰","110/08/19","永豐金-嘉義",3,32,-29
"13591","2609陽明","110/08/18","凱基-台北",15132,4630,10502
"13592","2609陽明","110/08/18","兆豐-復興",1580,3572,-1992
"13593","2609陽明","110/08/18","康和",4145,283,3862
"13594","2609陽明","110/08/18","日盛-板橋",943,2532,-1589
"13595","2609陽明","110/08/18","美林",6982,3580,3402
"13596","2609陽明","110/08/18","國泰-敦南",4957,6082,-1125
"13597","2609陽明","110/08/18","富邦證券",5335,3049,2286
"13598","2609陽明","110/08/18","新光",3470,4443,-973
"13599","2609陽明","110/08/18","兆豐-南京",2352,209,2143
"13600","2609陽明","110/08/18","玉山證券",1002,1913,-911
"13601","2609陽明","110/08/18","兆豐-虎尾",4490,2388,2102
"13602","2609陽明","110/08/18","台新證券",2873,3601,-728
"13603","2609陽明","110/08/18","永豐金-信義",1719,99,1620
"13604","2609陽明","110/08/18","國泰-館前",1002,1633,-631
"13605","2609陽明","110/08/18","摩根大通",9173,7611,1562
"13606","2609陽明","110/08/18","日盛-中壢",255,825,-570
"13607","2609陽明","110/08/18","台灣摩根士丹利",2544,1230,1314
"13608","2609陽明","110/08/18","兆豐-板橋",646,1122,-476
"13609","2609陽明","110/08/18","凱基-斗六",4335,3037,1298
"13610","2609陽明","110/08/18","第一金-嘉義",153,589,-436
"13611","2609陽明","110/08/18","統一",1895,653,1242
"13612","2609陽明","110/08/18","第一金-桃園",168,595,-427
"13613","2609陽明","110/08/18","元大證券",3293,2063,1230
"13614","2609陽明","110/08/18","(牛牛牛)亞-鑫豐",283,690,-407
"13615","2609陽明","110/08/18","富邦-仁愛",2205,1064,1141
"13616","2609陽明","110/08/18","國泰-板橋",1508,1913,-405
"13617","2609陽明","110/08/18","富邦-虎尾",10781,9680,1101
"13618","2609陽明","110/08/18","凱基-市政",9806,10201,-395
"13619","2609陽明","110/08/18","元大-頭份",1219,381,838
"13620","2609陽明","110/08/18","凱基-高美館",607,1000,-393
"13621","2636台驊投控","110/08/18","富邦證券",1190,0,1190
"13622","2636台驊投控","110/08/18","凱基",21,470,-449
"13623","2636台驊投控","110/08/18","摩根大通",1639,646,993
"13624","2636台驊投控","110/08/18","玉山-南京東路",3,355,-352
"13625","2636台驊投控","110/08/18","台灣摩根士丹利",825,36,789
"13626","2636台驊投控","110/08/18","統一-新台中",15,291,-276
"13627","2636台驊投控","110/08/18","凱基-台北",881,309,572
"13628","2636台驊投控","110/08/18","永豐金-新竹",38,292,-254
"13629","2636台驊投控","110/08/18","統一",503,143,360
"13630","2636台驊投控","110/08/18","國票-彰化",518,760,-242
"13631","2636台驊投控","110/08/18","富邦-員林",373,78,295
"13632","2636台驊投控","110/08/18","國泰-敦南",456,601,-145
"13633","2636台驊投控","110/08/18","新加坡商瑞銀",307,50,257
"13634","2636台驊投控","110/08/18","日盛-宜蘭",12,143,-131
"13635","2636台驊投控","110/08/18","美林",863,611,252
"13636","2636台驊投控","110/08/18","日盛-景美",26,156,-130
"13637","2636台驊投控","110/08/18","日盛-台中",273,57,216
"13638","2636台驊投控","110/08/18","日盛證券",180,298,-118
"13639","2636台驊投控","110/08/18","日盛-板橋",166,13,153
"13640","2636台驊投控","110/08/18","第一金-桃園",36,154,-118
"13641","2636台驊投控","110/08/18","兆豐-虎尾",169,20,149
"13642","2636台驊投控","110/08/18","新光",402,503,-101
"13643","2636台驊投控","110/08/18","華南永昌-竹北",221,84,137
"13644","2636台驊投控","110/08/18","凱基-市政",93,185,-92
"13645","2636台驊投控","110/08/18","大慶",123,6,117
"13646","2636台驊投控","110/08/18","台新證券",371,450,-79
"13647","2636台驊投控","110/08/18","美商高盛",432,323,109
"13648","2636台驊投控","110/08/18","凱基-天母",2,81,-79
"13649","2636台驊投控","110/08/18","統一-南京",102,33,69
"13650","2636台驊投控","110/08/18","華南永昌-南京",30,101,-71
"13651","2867三商壽","110/08/18","摩根大通",776,115,661
"13652","2867三商壽","110/08/18","華南永昌",2,804,-802
"13653","2867三商壽","110/08/18","美林",510,38,472
"13654","2867三商壽","110/08/18","富邦-陽明",0,253,-253
"13655","2867三商壽","110/08/18","元富-世貿",164,15,149
"13656","2867三商壽","110/08/18","宏遠證券",0,220,-220
"13657","2867三商壽","110/08/18","元大-桃園",110,1,109
"13658","2867三商壽","110/08/18","元大-崇德",0,178,-178
"13659","2867三商壽","110/08/18","新加坡商瑞銀",168,73,95
"13660","2867三商壽","110/08/18","元大證券",7,143,-136
"13661","2867三商壽","110/08/18","台新證券",97,2,95
"13662","2867三商壽","110/08/18","土銀-新竹",0,86,-86
"13663","2867三商壽","110/08/18","康和-台中",90,1,89
"13664","2867三商壽","110/08/18","統一-台中",0,82,-82
"13665","2867三商壽","110/08/18","富邦-三重",90,6,84
"13666","2867三商壽","110/08/18","富邦-嘉義",0,70,-70
"13667","2867三商壽","110/08/18","元富",70,0,70
"13668","2867三商壽","110/08/18","宏遠-台中",7,71,-64
"13669","2867三商壽","110/08/18","兆豐-寶成",70,1,69
"13670","2867三商壽","110/08/18","富邦-南屯",0,63,-63
"13671","2867三商壽","110/08/18","台新-台中",68,13,55
"13672","2867三商壽","110/08/18","元大-大甲",1,61,-60
"13673","2867三商壽","110/08/18","凱基",51,0,51
"13674","2867三商壽","110/08/18","美商高盛",32,87,-55
"13675","2867三商壽","110/08/18","元大-開元",51,0,51
"13676","2867三商壽","110/08/18","元富-大裕",0,50,-50
"13677","2867三商壽","110/08/18","日盛-頭份",50,0,50
"13678","2867三商壽","110/08/18","富邦-高雄",1,48,-47
"13679","2867三商壽","110/08/18","兆豐-台中",50,0,50
"13680","2867三商壽","110/08/18","元大-台北",0,40,-40
"13681","5521工信","110/08/18","台新證券",144,10,134
"13682","5521工信","110/08/18","台新-台中",0,200,-200
"13683","5521工信","110/08/18","群益金鼎-台中",43,0,43
"13684","5521工信","110/08/18","香港上海匯豐",0,143,-143
"13685","5521工信","110/08/18","富邦-嘉義",31,0,31
"13686","5521工信","110/08/18","日盛-雙和",0,100,-100
"13687","5521工信","110/08/18","華南永昌-林口",30,1,29
"13688","5521工信","110/08/18","元大-沙鹿",0,61,-61
"13689","5521工信","110/08/18","日進",25,0,25
"13690","5521工信","110/08/18","凱基-台北",57,116,-59
"13691","5521工信","110/08/18","國泰-敦南",26,3,23
"13692","5521工信","110/08/18","美林",3,61,-58
"13693","5521工信","110/08/18","群益金鼎-高雄",20,0,20
"13694","5521工信","110/08/18","永豐金-桃盛",0,50,-50
"13695","5521工信","110/08/18","元大-屏南",20,0,20
"13696","5521工信","110/08/18","摩根大通",106,150,-44
"13697","5521工信","110/08/18","元大-基隆孝二",20,0,20
"13698","5521工信","110/08/18","大慶-富順",0,42,-42
"13699","5521工信","110/08/18","永豐金-新店",20,0,20
"13700","5521工信","110/08/18","元大-鳳山",0,30,-30
"13701","5521工信","110/08/18","元大-龍潭",17,0,17
"13702","5521工信","110/08/18","凱基-三重",25,50,-25
"13703","5521工信","110/08/18","兆豐-北高雄",16,0,16
"13704","5521工信","110/08/18","光和-田中",2,24,-22
"13705","5521工信","110/08/18","元富-文心",15,0,15
"13706","5521工信","110/08/18","元大-和平",0,20,-20
"13707","5521工信","110/08/18","元大-前金",15,0,15
"13708","5521工信","110/08/18","華南永昌",0,15,-15
"13709","5521工信","110/08/18","元大-北投",15,0,15
"13710","5521工信","110/08/18","凱基-南崁",0,12,-12
"13711","1471首利","110/08/18","摩根大通",195,17,178
"13712","1471首利","110/08/18","元大-西門",16,81,-65
"13713","1471首利","110/08/18","永豐金-板盛",42,0,42
"13714","1471首利","110/08/18","高橋-龍潭",0,35,-35
"13715","1471首利","110/08/18","台新證券",35,13,22
"13716","1471首利","110/08/18","新光",14,41,-27
"13717","1471首利","110/08/18","台灣企銀-九如",20,0,20
"13718","1471首利","110/08/18","台新-高雄",2,25,-23
"13719","1471首利","110/08/18","凱基-五股",20,0,20
"13720","1471首利","110/08/18","元富-世貿",0,20,-20
"13721","1471首利","110/08/18","瑞士信貸",25,13,12
"13722","1471首利","110/08/18","台新-中壢",0,20,-20
"13723","1471首利","110/08/18","群益金鼎-三重",10,0,10
"13724","1471首利","110/08/18","玉山-高雄",1,21,-20
"13725","1471首利","110/08/18","凱基-台南",10,0,10
"13726","1471首利","110/08/18","富邦-基隆",13,30,-17
"13727","1471首利","110/08/18","華南永昌-鳳山",10,0,10
"13728","1471首利","110/08/18","凱基-彰化",0,14,-14
"13729","1471首利","110/08/18","富邦-嘉義",10,0,10
"13730","1471首利","110/08/18","元富-民權",0,12,-12
"13731","1471首利","110/08/18","元大-開元",10,0,10
"13732","1471首利","110/08/18","凱基-羅東",0,11,-11
"13733","1471首利","110/08/18","元大-內湖",10,0,10
"13734","1471首利","110/08/18","合庫證券",0,10,-10
"13735","1471首利","110/08/18","元大-東港",10,0,10
"13736","1471首利","110/08/18","日盛-斗六",0,10,-10
"13737","1471首利","110/08/18","永豐金-台南",10,0,10
"13738","1471首利","110/08/18","群益金鼎-潭子",0,10,-10
"13739","1471首利","110/08/18","凱基-台北",25,16,9
"13740","1471首利","110/08/18","元大-汐止",0,10,-10
"13741","2883開發金","110/08/18","合庫-台中",6579,11,6568
"13742","2883開發金","110/08/18","新加坡商瑞銀",902,7117,-6215
"13743","2883開發金","110/08/18","香港上海匯豐",4579,0,4579
"13744","2883開發金","110/08/18","台灣摩根士丹利",375,5303,-4928
"13745","2883開發金","110/08/18","富邦-台中",3720,12,3708
"13746","2883開發金","110/08/18","凱基",0,4582,-4582
"13747","2883開發金","110/08/18","中國信託-文心",3128,2,3126
"13748","2883開發金","110/08/18","台新證券",425,4594,-4169
"13749","2883開發金","110/08/18","元大-福營",1063,19,1044
"13750","2883開發金","110/08/18","國泰證券",11,3677,-3666
"13751","2883開發金","110/08/18","華南永昌-南京",1046,43,1003
"13752","2883開發金","110/08/18","富邦證券",47,3305,-3258
"13753","2883開發金","110/08/18","合庫證券",999,7,992
"13754","2883開發金","110/08/18","元大證券",1065,3675,-2610
"13755","2883開發金","110/08/18","瑞士信貸",1041,53,988
"13756","2883開發金","110/08/18","凱基-台北",1972,4074,-2102
"13757","2883開發金","110/08/18","摩根大通",2088,1332,756
"13758","2883開發金","110/08/18","國票-長城",711,2005,-1294
"13759","2883開發金","110/08/18","新光",2279,1577,702
"13760","2883開發金","110/08/18","日盛證券",88,1002,-914
"13761","2883開發金","110/08/18","元大-金華",559,0,559
"13762","2883開發金","110/08/18","群益金鼎-西松",38,786,-748
"13763","2883開發金","110/08/18","花旗環球",652,184,468
"13764","2883開發金","110/08/18","兆豐-高雄",12,668,-656
"13765","2883開發金","110/08/18","港商野村",1145,723,422
"13766","2883開發金","110/08/18","元富-四維",2,606,-604
"13767","2883開發金","110/08/18","國泰-敦南",609,244,365
"13768","2883開發金","110/08/18","宏遠-光隆",14,615,-601
"13769","2883開發金","110/08/18","元富",353,0,353
"13770","2883開發金","110/08/18","永豐金-苓雅",30,595,-565
"13771","6205詮欣","110/08/18","摩根大通",14,1,13
"13772","6205詮欣","110/08/18","合庫證券",0,15,-15
"13773","6205詮欣","110/08/18","凱基-汐止",10,0,10
"13774","6205詮欣","110/08/18","國票-南港",0,14,-14
"13775","6205詮欣","110/08/18","臺銀-臺中",9,0,9
"13776","6205詮欣","110/08/18","元大-大天母",0,8,-8
"13777","6205詮欣","110/08/18","德信-新營",7,0,7
"13778","6205詮欣","110/08/18","富邦-仁愛",0,6,-6
"13779","6205詮欣","110/08/18","元富-安南",6,0,6
"13780","6205詮欣","110/08/18","兆豐-竹北",0,5,-5
"13781","6205詮欣","110/08/18","凱基-台北",5,0,5
"13782","6205詮欣","110/08/18","兆豐-台中",0,4,-4
"13783","6205詮欣","110/08/18","美林",4,0,4
"13784","6205詮欣","110/08/18","元大-土城學府",0,3,-3
"13785","6205詮欣","110/08/18","華南永昌-古亭",6,2,4
"13786","6205詮欣","110/08/18","永豐金-台南",0,3,-3
"13787","6205詮欣","110/08/18","永豐金證券",4,0,4
"13788","6205詮欣","110/08/18","日盛-板橋中山",0,2,-2
"13789","6205詮欣","110/08/18","玉山證券",3,0,3
"13790","6205詮欣","110/08/18","亞東-高雄",0,2,-2
"13791","6205詮欣","110/08/18","永豐金-中正",3,0,3
"13792","6205詮欣","110/08/18","大昌-安康",0,2,-2
"13793","6205詮欣","110/08/18","大慶-台南",2,0,2
"13794","6205詮欣","110/08/18","大昌-新店",0,2,-2
"13795","6205詮欣","110/08/18","元富-草屯",2,0,2
"13796","6205詮欣","110/08/18","玉山-高雄",0,2,-2
"13797","6205詮欣","110/08/18","元大-豐原",2,0,2
"13798","6205詮欣","110/08/18","日盛-板橋",0,1,-1
"13799","6205詮欣","110/08/18","日盛-三重",1,0,1
"13800","6205詮欣","110/08/18","宏遠-民生",0,1,-1
"13801","1540喬福","110/08/18","凱基-台北",26,5,21
"13802","1540喬福","110/08/18","兆豐-小港",0,45,-45
"13803","1540喬福","110/08/18","元大-土城永寧",15,0,15
"13804","1540喬福","110/08/18","群益金鼎-館前",1,40,-39
"13805","1540喬福","110/08/18","凱基-中壢",12,0,12
"13806","1540喬福","110/08/18","新光-台南",0,10,-10
"13807","1540喬福","110/08/18","日盛-二林",10,0,10
"13808","1540喬福","110/08/18","元大-北屯",0,6,-6
"13809","1540喬福","110/08/18","日盛-鳳山",6,0,6
"13810","1540喬福","110/08/18","新光-桃園",0,5,-5
"13811","1540喬福","110/08/18","兆豐-北高雄",6,0,6
"13812","1540喬福","110/08/18","元富",0,4,-4
"13813","1540喬福","110/08/18","元大-龍潭",6,0,6
"13814","1540喬福","110/08/18","元大-館前",0,4,-4
"13815","1540喬福","110/08/18","日盛-樹林",5,0,5
"13816","1540喬福","110/08/18","國票-台東",0,3,-3
"13817","1540喬福","110/08/18","瑞士信貸",3,0,3
"13818","1540喬福","110/08/18","富邦-台南",0,3,-3
"13819","1540喬福","110/08/18","兆豐-三民",3,0,3
"13820","1540喬福","110/08/18","第一金-大稻埕",0,2,-2
"13821","1540喬福","110/08/18","國票-彰化",3,0,3
"13822","1540喬福","110/08/18","致和-南京",0,2,-2
"13823","1540喬福","110/08/18","富邦-員林",3,0,3
"13824","1540喬福","110/08/18","玉山-城中",0,2,-2
"13825","1540喬福","110/08/18","永豐金-敦南",3,0,3
"13826","1540喬福","110/08/18","元大-南崁",0,2,-2
"13827","1540喬福","110/08/18","日盛-板橋",2,0,2
"13828","1540喬福","110/08/18","元大-府城",1,3,-2
"13829","1540喬福","110/08/18","兆豐-台中港",2,0,2
"13830","1540喬福","110/08/18","元大-松山",0,2,-2
"13831","2888新光金","110/08/18","兆豐-公益",6495,300,6195
"13832","2888新光金","110/08/18","美商高盛",222,4409,-4187
"13833","2888新光金","110/08/18","元大-忠孝鼎富",4187,0,4187
"13834","2888新光金","110/08/18","元富-城東",12,2101,-2089
"13835","2888新光金","110/08/18","瑞士信貸",2917,33,2884
"13836","2888新光金","110/08/18","華南永昌",26,1674,-1648
"13837","2888新光金","110/08/18","華南永昌-大安",1071,5,1066
"13838","2888新光金","110/08/18","華南永昌-忠孝",0,1211,-1211
"13839","2888新光金","110/08/18","宏遠-光隆",1044,6,1038
"13840","2888新光金","110/08/18","群益金鼎-彰化",14,1211,-1197
"13841","2888新光金","110/08/18","元富",805,90,715
"13842","2888新光金","110/08/18","元大-大同",5,711,-706
"13843","2888新光金","110/08/18","凱基-台北",2712,2138,574
"13844","2888新光金","110/08/18","凱基-桃園",93,755,-662
"13845","2888新光金","110/08/18","台灣摩根士丹利",742,305,437
"13846","2888新光金","110/08/18","新光-台南",2,610,-608
"13847","2888新光金","110/08/18","富邦證券",385,20,365
"13848","2888新光金","110/08/18","第一金-新竹",100,706,-606
"13849","2888新光金","110/08/18","摩根大通",2204,1868,336
"13850","2888新光金","110/08/18","福勝",2,600,-598
"13851","2888新光金","110/08/18","永興-台中",303,29,274
"13852","2888新光金","110/08/18","華南永昌-岡山",12,457,-445
"13853","2888新光金","110/08/18","元大-六合",302,28,274
"13854","2888新光金","110/08/18","花旗環球",38,466,-428
"13855","2888新光金","110/08/18","華南永昌-敦南",262,10,252
"13856","2888新光金","110/08/18","元富-民權",0,300,-300
"13857","2888新光金","110/08/18","新加坡商瑞銀",287,70,217
"13858","2888新光金","110/08/18","華南永昌-合泰",4,303,-299
"13859","2888新光金","110/08/18","統一-板橋",170,5,165
"13860","2888新光金","110/08/18","元富-中港",3,300,-297
"13861","1340勝悅","110/08/18","摩根大通",139,18,121
"13862","1340勝悅","110/08/18","聯邦-三重",0,100,-100
"13863","1340勝悅","110/08/18","華南永昌-敦南",8,0,8
"13864","1340勝悅","110/08/18","華南永昌",1,20,-19
"13865","1340勝悅","110/08/18","永豐金-板盛",7,0,7
"13866","1340勝悅","110/08/18","合庫證券",0,10,-10
"13867","1340勝悅","110/08/18","美商高盛",6,0,6
"13868","1340勝悅","110/08/18","新光-新竹",0,10,-10
"13869","1340勝悅","110/08/18","臺灣企銀-埔墘",5,0,5
"13870","1340勝悅","110/08/18","富邦-嘉義",0,8,-8
"13871","1340勝悅","110/08/18","國泰-台中",5,0,5
"13872","1340勝悅","110/08/18","元大-新竹經國",0,7,-7
"13873","1340勝悅","110/08/18","凱基-松山",5,0,5
"13874","1340勝悅","110/08/18","臺銀-鳳山",5,10,-5
"13875","1340勝悅","110/08/18","新光",4,0,4
"13876","1340勝悅","110/08/18","瑞士信貸",0,5,-5
"13877","1340勝悅","110/08/18","中國信託-文心",3,0,3
"13878","1340勝悅","110/08/18","統一-城中",9,13,-4
"13879","1340勝悅","110/08/18","康和-延平",3,0,3
"13880","1340勝悅","110/08/18","元大-歸仁",0,4,-4
"13881","1340勝悅","110/08/18","新光-桃園",3,0,3
"13882","1340勝悅","110/08/18","元大-桃興",1,5,-4
"13883","1340勝悅","110/08/18","凱基-基隆",3,0,3
"13884","1340勝悅","110/08/18","(牛牛牛)亞-鑫豐",1,4,-3
"13885","1340勝悅","110/08/18","合庫-鳳山",2,0,2
"13886","1340勝悅","110/08/18","台新證券",0,3,-3
"13887","1340勝悅","110/08/18","元富-板橋",2,0,2
"13888","1340勝悅","110/08/18","合庫-高雄",0,2,-2
"13889","1340勝悅","110/08/18","大昌-安康",2,0,2
"13890","1340勝悅","110/08/18","日盛-文化",0,2,-2
"13891","6246臺龍","110/08/18","港商野村",62,7,55
"13892","6246臺龍","110/08/18","元富-高雄",0,20,-20
"13893","6246臺龍","110/08/18","台新-三民",20,0,20
"13894","6246臺龍","110/08/18","新光",1,16,-15
"13895","6246臺龍","110/08/18","台新證券",19,0,19
"13896","6246臺龍","110/08/18","日盛-板橋",0,10,-10
"13897","6246臺龍","110/08/18","元富-林園",10,0,10
"13898","6246臺龍","110/08/18","致和-台北",0,10,-10
"13899","6246臺龍","110/08/18","光和-和美",10,0,10
"13900","6246臺龍","110/08/18","凱基-永和",0,10,-10
"13901","6246臺龍","110/08/18","凱基-屏東",10,0,10
"13902","6246臺龍","110/08/18","華南永昌-公誠",0,10,-10
"13903","6246臺龍","110/08/18","元大-永康",10,0,10
"13904","6246臺龍","110/08/18","凱基-台北",1,10,-9
"13905","6246臺龍","110/08/18","元大-竹科",5,0,5
"13906","6246臺龍","110/08/18","元大-北港",0,9,-9
"13907","6246臺龍","110/08/18","元大-北成功",4,0,4
"13908","6246臺龍","110/08/18","日盛-和美",0,6,-6
"13909","6246臺龍","110/08/18","大慶-苗栗",3,0,3
"13910","6246臺龍","110/08/18","群益金鼎-北高雄",0,6,-6
"13911","6246臺龍","110/08/18","統一-彰化",3,0,3
"13912","6246臺龍","110/08/18","日進",0,5,-5
"13913","6246臺龍","110/08/18","日茂-南投",3,0,3
"13914","6246臺龍","110/08/18","凱基-松山",0,5,-5
"13915","6246臺龍","110/08/18","兆豐-新營",3,0,3
"13916","6246臺龍","110/08/18","凱基-三多",2,7,-5
"13917","6246臺龍","110/08/18","元大-南投",3,0,3
"13918","6246臺龍","110/08/18","元富-烏日",0,4,-4
"13919","6246臺龍","110/08/18","元富-大裕",2,0,2
"13920","6246臺龍","110/08/18","兆豐-景美",0,4,-4
"13921","00715L期街口布蘭特正2","110/08/18","兆豐-鹿港",751,0,751
"13922","00715L期街口布蘭特正2","110/08/18","元大證券",368,4666,-4298
"13923","00715L期街口布蘭特正2","110/08/18","合庫-新竹",597,1,596
"13924","00715L期街口布蘭特正2","110/08/18","凱基-台北",310,4173,-3863
"13925","00715L期街口布蘭特正2","110/08/18","(牛牛牛)亞-鑫豐",606,24,582
"13926","00715L期街口布蘭特正2","110/08/18","統一",5,1703,-1698
"13927","00715L期街口布蘭特正2","110/08/18","元富-古亭",499,0,499
"13928","00715L期街口布蘭特正2","110/08/18","元大-台中",8,1176,-1168
"13929","00715L期街口布蘭特正2","110/08/18","統一-新竹",411,0,411
"13930","00715L期街口布蘭特正2","110/08/18","兆豐-來福",0,590,-590
"13931","00715L期街口布蘭特正2","110/08/18","永豐金-北高雄",331,0,331
"13932","00715L期街口布蘭特正2","110/08/18","元富",5,588,-583
"13933","00715L期街口布蘭特正2","110/08/18","中國信託-新竹",327,0,327
"13934","00715L期街口布蘭特正2","110/08/18","康和",686,1184,-498
"13935","00715L期街口布蘭特正2","110/08/18","新光",396,124,272
"13936","00715L期街口布蘭特正2","110/08/18","新光-台中",143,525,-382
"13937","00715L期街口布蘭特正2","110/08/18","元大-沙鹿",216,0,216
"13938","00715L期街口布蘭特正2","110/08/18","元大-雙和",25,380,-355
"13939","00715L期街口布蘭特正2","110/08/18","國泰-敦南",244,30,214
"13940","00715L期街口布蘭特正2","110/08/18","玉山-新竹",8,324,-316
"13941","00715L期街口布蘭特正2","110/08/18","元大-花蓮",229,20,209
"13942","00715L期街口布蘭特正2","110/08/18","玉山-台南",19,285,-266
"13943","00715L期街口布蘭特正2","110/08/18","兆豐-台中",226,36,190
"13944","00715L期街口布蘭特正2","110/08/18","永豐金證券",4,240,-236
"13945","00715L期街口布蘭特正2","110/08/18","元大-復北",200,10,190
"13946","00715L期街口布蘭特正2","110/08/18","永豐金-台南",13,230,-217
"13947","00715L期街口布蘭特正2","110/08/18","台新-新營",221,32,189
"13948","00715L期街口布蘭特正2","110/08/18","中國信託-永康",15,210,-195
"13949","00715L期街口布蘭特正2","110/08/18","新光-新竹",204,17,187
"13950","00715L期街口布蘭特正2","110/08/18","凱基-大里",2,189,-187
"13951","8941關中","110/08/18","元大-華山",1,0,1
"13952","8941關中","110/08/18","群益金鼎-開元",0,2,-2
"13953","8941關中","110/08/18","元大-南京",1,0,1
"13954","8941關中","110/08/18","元大-桃興",0,1,-1
"13955","8941關中","110/08/18","元大-西門",1,0,1
"13956","8941關中","110/08/18","華南永昌-淡水",0,0,0
"13957","8941關中","110/08/18","華南永昌-淡水",0,0,0
"13958","8941關中","110/08/18","富邦-台北",0,0,0
"13959","8941關中","110/08/18","富邦-台北",0,0,0
"13960","8941關中","110/08/18","元大-金華",1,1,0
"13961","8941關中","110/08/18","元大-金華",1,1,0
"13962","8941關中","110/08/18","永豐金-敦北",0,0,0
"13963","8941關中","110/08/18","永豐金-敦北",0,0,0
"13964","8941關中","110/08/18","",NA,NA,NA
"13965","8941關中","110/08/18","",NA,NA,NA
"13966","8941關中","110/08/18","",NA,NA,NA
"13967","8941關中","110/08/18","",NA,NA,NA
"13968","8941關中","110/08/18","",NA,NA,NA
"13969","8941關中","110/08/18","",NA,NA,NA
"13970","8941關中","110/08/18","",NA,NA,NA
"13971","8941關中","110/08/18","",NA,NA,NA
"13972","8941關中","110/08/18","",NA,NA,NA
"13973","8941關中","110/08/18","",NA,NA,NA
"13974","8941關中","110/08/18","",NA,NA,NA
"13975","8941關中","110/08/18","",NA,NA,NA
"13976","8941關中","110/08/18","",NA,NA,NA
"13977","8941關中","110/08/18","",NA,NA,NA
"13978","8941關中","110/08/18","",NA,NA,NA
"13979","8941關中","110/08/18","",NA,NA,NA
"13980","8941關中","110/08/18","",NA,NA,NA
"13981","8936國統","110/08/18","凱基-台北",120,29,91
"13982","8936國統","110/08/18","新光-高雄",0,70,-70
"13983","8936國統","110/08/18","美林",66,1,65
"13984","8936國統","110/08/18","華南永昌-林口",1,70,-69
"13985","8936國統","110/08/18","元大-萬華",50,0,50
"13986","8936國統","110/08/18","台新-高雄",36,97,-61
"13987","8936國統","110/08/18","摩根大通",95,54,41
"13988","8936國統","110/08/18","永豐金-忠孝",12,44,-32
"13989","8936國統","110/08/18","港商野村",92,58,34
"13990","8936國統","110/08/18","台灣摩根士丹利",26,53,-27
"13991","8936國統","110/08/18","中國信託-高雄",12,0,12
"13992","8936國統","110/08/18","台新-中壢",0,25,-25
"13993","8936國統","110/08/18","玉山-台南",12,0,12
"13994","8936國統","110/08/18","元大-高雄",5,30,-25
"13995","8936國統","110/08/18","國泰-敦南",18,6,12
"13996","8936國統","110/08/18","玉山-嘉義",5,25,-20
"13997","8936國統","110/08/18","元大-成功",11,0,11
"13998","8936國統","110/08/18","新加坡商瑞銀",120,137,-17
"13999","8936國統","110/08/18","臺銀-新竹",10,0,10
"14000","8936國統","110/08/18","美商高盛",7,23,-16
"14001","8936國統","110/08/18","大慶-楊梅",10,0,10
"14002","8936國統","110/08/18","國泰-板橋",0,13,-13
"14003","8936國統","110/08/18","兆豐-三重",10,0,10
"14004","8936國統","110/08/18","群益金鼎-潭子",0,12,-12
"14005","8936國統","110/08/18","兆豐-北高雄",10,0,10
"14006","8936國統","110/08/18","群益金鼎-鳳山",0,12,-12
"14007","8936國統","110/08/18","元大-大里德芳",10,0,10
"14008","8936國統","110/08/18","合庫-高雄",0,10,-10
"14009","8936國統","110/08/18","永豐金-新莊",10,0,10
"14010","8936國統","110/08/18","第一金-新興",0,10,-10
"14011","6226光鼎","110/08/18","凱基-台北",625,134,491
"14012","6226光鼎","110/08/18","國泰-台中",21,655,-634
"14013","6226光鼎","110/08/18","元大-文心興安",224,4,220
"14014","6226光鼎","110/08/18","群益金鼎-士林",0,100,-100
"14015","6226光鼎","110/08/18","美商高盛",231,46,185
"14016","6226光鼎","110/08/18","元大-竹科",24,122,-98
"14017","6226光鼎","110/08/18","美林",213,118,95
"14018","6226光鼎","110/08/18","新光-桃園",22,96,-74
"14019","6226光鼎","110/08/18","新加坡商瑞銀",165,83,82
"14020","6226光鼎","110/08/18","永豐金-南投",15,83,-68
"14021","6226光鼎","110/08/18","凱基-竹科",67,4,63
"14022","6226光鼎","110/08/18","富邦-建國",21,80,-59
"14023","6226光鼎","110/08/18","元大證券",92,29,63
"14024","6226光鼎","110/08/18","元富-信義",2,58,-56
"14025","6226光鼎","110/08/18","元大-敦化",63,11,52
"14026","6226光鼎","110/08/18","凱基-新豐",15,69,-54
"14027","6226光鼎","110/08/18","兆豐-鹿港",54,4,50
"14028","6226光鼎","110/08/18","群益金鼎-台中",2,54,-52
"14029","6226光鼎","110/08/18","群益金鼎-萬華",54,9,45
"14030","6226光鼎","110/08/18","宏遠-光隆",0,50,-50
"14031","6226光鼎","110/08/18","大昌",48,12,36
"14032","6226光鼎","110/08/18","元大-福營",5,53,-48
"14033","6226光鼎","110/08/18","凱基-站前",35,1,34
"14034","6226光鼎","110/08/18","永豐金-竹北",2,43,-41
"14035","6226光鼎","110/08/18","日盛-和美",47,16,31
"14036","6226光鼎","110/08/18","兆豐-民生",0,40,-40
"14037","6226光鼎","110/08/18","群益金鼎-永和",30,0,30
"14038","6226光鼎","110/08/18","玉山證券",10,50,-40
"14039","6226光鼎","110/08/18","凱基-中港",30,0,30
"14040","6226光鼎","110/08/18","凱基-民權",11,51,-40
"14041","2363矽統","110/08/18","凱基-南崁",1528,19,1509
"14042","2363矽統","110/08/18","台灣摩根士丹利",64,1051,-987
"14043","2363矽統","110/08/18","凱基-台北",1850,671,1179
"14044","2363矽統","110/08/18","美商高盛",386,711,-325
"14045","2363矽統","110/08/18","摩根大通",1073,563,510
"14046","2363矽統","110/08/18","台新-三民",47,361,-314
"14047","2363矽統","110/08/18","富邦-板橋",403,71,332
"14048","2363矽統","110/08/18","新加坡商瑞銀",699,987,-288
"14049","2363矽統","110/08/18","玉山-高雄",391,228,163
"14050","2363矽統","110/08/18","富邦-台北",82,251,-169
"14051","2363矽統","110/08/18","群益金鼎",154,21,133
"14052","2363矽統","110/08/18","富邦-新店",28,140,-112
"14053","2363矽統","110/08/18","永豐金證券",155,31,124
"14054","2363矽統","110/08/18","中國信託-忠孝",89,200,-111
"14055","2363矽統","110/08/18","日盛-樹林",159,39,120
"14056","2363矽統","110/08/18","玉山-台中",14,122,-108
"14057","2363矽統","110/08/18","石橋證券",112,1,111
"14058","2363矽統","110/08/18","元大-汐止",112,215,-103
"14059","2363矽統","110/08/18","合庫-高雄",123,15,108
"14060","2363矽統","110/08/18","永豐金-板盛",2,105,-103
"14061","2363矽統","110/08/18","凱基-汐止",103,1,102
"14062","2363矽統","110/08/18","群益金鼎-南京",59,160,-101
"14063","2363矽統","110/08/18","永興",94,4,90
"14064","2363矽統","110/08/18","永豐金-天母",14,112,-98
"14065","2363矽統","110/08/18","元大-前金",207,139,68
"14066","2363矽統","110/08/18","凱基-竹科",22,110,-88
"14067","2363矽統","110/08/18","新光-桃園",84,17,67
"14068","2363矽統","110/08/18","華南永昌-台中",35,122,-87
"14069","2363矽統","110/08/18","富邦-台南",95,30,65
"14070","2363矽統","110/08/18","國泰-敦南",437,521,-84
"14071","8112至上","110/08/18","港商野村",371,52,319
"14072","8112至上","110/08/18","新加坡商瑞銀",70,220,-150
"14073","8112至上","110/08/18","凱基-台北",202,29,173
"14074","8112至上","110/08/18","元大證券",3,102,-99
"14075","8112至上","110/08/18","美林",135,39,96
"14076","8112至上","110/08/18","凱基-新店",0,91,-91
"14077","8112至上","110/08/18","凱基-市政",81,0,81
"14078","8112至上","110/08/18","台灣摩根士丹利",0,87,-87
"14079","8112至上","110/08/18","摩根大通",287,209,78
"14080","8112至上","110/08/18","元大-佳里",3,82,-79
"14081","8112至上","110/08/18","美商高盛",97,25,72
"14082","8112至上","110/08/18","合庫-台中",5,67,-62
"14083","8112至上","110/08/18","台新證券",71,13,58
"14084","8112至上","110/08/18","宏遠證券",0,59,-59
"14085","8112至上","110/08/18","大慶",60,10,50
"14086","8112至上","110/08/18","凱基-文心",0,53,-53
"14087","8112至上","110/08/18","凱基-站前",52,13,39
"14088","8112至上","110/08/18","元大-樹林",8,60,-52
"14089","8112至上","110/08/18","元大-大灣",38,0,38
"14090","8112至上","110/08/18","元大-永春",2,43,-41
"14091","8112至上","110/08/18","永豐金-中盛",31,3,28
"14092","8112至上","110/08/18","富邦-新營",2,40,-38
"14093","8112至上","110/08/18","國票-北高雄",25,0,25
"14094","8112至上","110/08/18","永豐金-員林",1,38,-37
"14095","8112至上","110/08/18","富邦-竹東",21,0,21
"14096","8112至上","110/08/18","玉山-高雄",23,55,-32
"14097","8112至上","110/08/18","彰銀-七賢",20,0,20
"14098","8112至上","110/08/18","大昌-桃園",1,30,-29
"14099","8112至上","110/08/18","元富-新莊",20,0,20
"14100","8112至上","110/08/18","新光-台南",1,30,-29
"14101","1570力肯","110/08/18","凱基-台北",129,5,124
"14102","1570力肯","110/08/18","華南永昌-桃園",0,102,-102
"14103","1570力肯","110/08/18","香港上海匯豐",36,0,36
"14104","1570力肯","110/08/18","中國信託-高雄",0,49,-49
"14105","1570力肯","110/08/18","統一",30,0,30
"14106","1570力肯","110/08/18","元富-世貿",0,20,-20
"14107","1570力肯","110/08/18","群益金鼎-北高雄",27,0,27
"14108","1570力肯","110/08/18","國泰證券",0,20,-20
"14109","1570力肯","110/08/18","國票-北高雄",21,3,18
"14110","1570力肯","110/08/18","元大-屏南",0,15,-15
"14111","1570力肯","110/08/18","元大-南投",20,4,16
"14112","1570力肯","110/08/18","元大-和平",5,20,-15
"14113","1570力肯","110/08/18","新光-台南",15,0,15
"14114","1570力肯","110/08/18","元大-基隆",0,12,-12
"14115","1570力肯","110/08/18","富邦-高雄",15,0,15
"14116","1570力肯","110/08/18","玉山-台中",0,10,-10
"14117","1570力肯","110/08/18","華南永昌-嘉義",12,0,12
"14118","1570力肯","110/08/18","元大-苗栗",0,10,-10
"14119","1570力肯","110/08/18","富邦-花蓮",10,0,10
"14120","1570力肯","110/08/18","元大-草屯",0,10,-10
"14121","1570力肯","110/08/18","元富-新店",10,2,8
"14122","1570力肯","110/08/18","富邦-彰化",0,8,-8
"14123","1570力肯","110/08/18","富邦-台東",12,4,8
"14124","1570力肯","110/08/18","日盛-嘉義",0,7,-7
"14125","1570力肯","110/08/18","日盛-高雄",7,0,7
"14126","1570力肯","110/08/18","永豐金-桃園",3,10,-7
"14127","1570力肯","110/08/18","元大-羅東",7,0,7
"14128","1570力肯","110/08/18","大昌-安康",0,6,-6
"14129","1570力肯","110/08/18","大慶-蘆洲",9,3,6
"14130","1570力肯","110/08/18","國票-和平",0,6,-6
"14131","2929淘帝","110/08/18","摩根大通",42,2,40
"14132","2929淘帝","110/08/18","日盛-嘉義",0,30,-30
"14133","2929淘帝","110/08/18","元富-板橋",23,0,23
"14134","2929淘帝","110/08/18","兆豐-復興",0,16,-16
"14135","2929淘帝","110/08/18","元大-太平",19,0,19
"14136","2929淘帝","110/08/18","兆豐-桃鶯",0,13,-13
"14137","2929淘帝","110/08/18","永豐金-中盛",10,0,10
"14138","2929淘帝","110/08/18","中國信託",4,14,-10
"14139","2929淘帝","110/08/18","新光",18,9,9
"14140","2929淘帝","110/08/18","宏遠-高雄",0,6,-6
"14141","2929淘帝","110/08/18","永豐金證券",8,0,8
"14142","2929淘帝","110/08/18","元大-東泰",0,5,-5
"14143","2929淘帝","110/08/18","元富-新竹",5,0,5
"14144","2929淘帝","110/08/18","港商野村",5,9,-4
"14145","2929淘帝","110/08/18","富邦-新店",5,0,5
"14146","2929淘帝","110/08/18","(牛牛牛)亞-鑫豐",0,4,-4
"14147","2929淘帝","110/08/18","凱基-豐中",4,0,4
"14148","2929淘帝","110/08/18","群益金鼎-潭子",0,4,-4
"14149","2929淘帝","110/08/18","永豐金-竹北",4,0,4
"14150","2929淘帝","110/08/18","亞東",0,3,-3
"14151","2929淘帝","110/08/18","亞東-板橋",4,1,3
"14152","2929淘帝","110/08/18","台新-高雄",0,3,-3
"14153","2929淘帝","110/08/18","中國信託-中壢",3,0,3
"14154","2929淘帝","110/08/18","國泰-板橋",0,3,-3
"14155","2929淘帝","110/08/18","凱基-中山",7,4,3
"14156","2929淘帝","110/08/18","元大-土城學府",0,3,-3
"14157","2929淘帝","110/08/18","富邦-陽明",5,2,3
"14158","2929淘帝","110/08/18","元大-楊梅",0,3,-3
"14159","2929淘帝","110/08/18","臺銀-鳳山",2,0,2
"14160","2929淘帝","110/08/18","日盛-高雄",0,2,-2
"14161","5410國眾","110/08/18","元大-中壢",31,0,31
"14162","5410國眾","110/08/18","凱基-台北",3,57,-54
"14163","5410國眾","110/08/18","康和-台北",10,0,10
"14164","5410國眾","110/08/18","台灣企銀-北高雄",0,20,-20
"14165","5410國眾","110/08/18","土銀-嘉義",9,0,9
"14166","5410國眾","110/08/18","摩根大通",5,22,-17
"14167","5410國眾","110/08/18","凱基-中山",8,0,8
"14168","5410國眾","110/08/18","臺銀-臺南",1,16,-15
"14169","5410國眾","110/08/18","凱基-彰化",7,0,7
"14170","5410國眾","110/08/18","大昌-樹林",5,20,-15
"14171","5410國眾","110/08/18","永豐金-員林",8,1,7
"14172","5410國眾","110/08/18","宏遠-民生",0,10,-10
"14173","5410國眾","110/08/18","玉山-城中",6,0,6
"14174","5410國眾","110/08/18","兆豐-高雄",0,10,-10
"14175","5410國眾","110/08/18","富邦-員林",6,0,6
"14176","5410國眾","110/08/18","富邦-仁愛",1,10,-9
"14177","5410國眾","110/08/18","元大-崇德",6,0,6
"14178","5410國眾","110/08/18","元大-土城學府",2,11,-9
"14179","5410國眾","110/08/18","永豐金-敦南",6,0,6
"14180","5410國眾","110/08/18","元大-豐原",0,7,-7
"14181","5410國眾","110/08/18","國泰-敦南",5,0,5
"14182","5410國眾","110/08/18","台新-高雄",0,6,-6
"14183","5410國眾","110/08/18","凱基-科園",5,0,5
"14184","5410國眾","110/08/18","元大-大里",0,6,-6
"14185","5410國眾","110/08/18","元大-博愛",5,0,5
"14186","5410國眾","110/08/18","永豐金-復興",0,6,-6
"14187","5410國眾","110/08/18","元大-新盛",5,0,5
"14188","5410國眾","110/08/18","元大-大天母",0,5,-5
"14189","5410國眾","110/08/18","國泰-松江",4,0,4
"14190","5410國眾","110/08/18","永豐金-板新",0,5,-5
"14191","2841台開","110/08/18","宏遠-館前",479,0,479
"14192","2841台開","110/08/18","兆豐-鹿港",0,200,-200
"14193","2841台開","110/08/18","第一金",46,0,46
"14194","2841台開","110/08/18","兆豐-台南",0,120,-120
"14195","2841台開","110/08/18","凱基-竹科",25,0,25
"14196","2841台開","110/08/18","摩根大通",0,100,-100
"14197","2841台開","110/08/18","合庫證券",24,0,24
"14198","2841台開","110/08/18","日盛-信義",0,69,-69
"14199","2841台開","110/08/18","第一金-台中",20,0,20
"14200","2841台開","110/08/18","玉山-高雄",0,51,-51
"14201","2841台開","110/08/18","富邦-板橋",24,5,19
"14202","2841台開","110/08/18","台新證券",5,40,-35
"14203","2841台開","110/08/18","永豐金-中盛",16,0,16
"14204","2841台開","110/08/18","華南永昌-鳳山",0,30,-30
"14205","2841台開","110/08/18","統一-新台中",15,0,15
"14206","2841台開","110/08/18","中國信託-嘉義",0,24,-24
"14207","2841台開","110/08/18","統一-士林",20,5,15
"14208","2841台開","110/08/18","元大-竹山",0,21,-21
"14209","2841台開","110/08/18","華南永昌-台中",14,0,14
"14210","2841台開","110/08/18","凱基-高美館",0,20,-20
"14211","2841台開","110/08/18","元大-彰化",20,7,13
"14212","2841台開","110/08/18","華南永昌-高雄",5,25,-20
"14213","2841台開","110/08/18","元大-六合",13,0,13
"14214","2841台開","110/08/18","元大-嘉義",0,20,-20
"14215","2841台開","110/08/18","兆豐-台中",10,0,10
"14216","2841台開","110/08/18","兆豐-天母",0,10,-10
"14217","2841台開","110/08/18","玉山-桃園",10,0,10
"14218","2841台開","110/08/18","群益金鼎-敦南",0,10,-10
"14219","2841台開","110/08/18","元大-台南",10,0,10
"14220","2841台開","110/08/18","元大-北三重",0,10,-10
"14221","6207雷科","110/08/18","凱基-台北",77,2,75
"14222","6207雷科","110/08/18","元大-高雄",0,106,-106
"14223","6207雷科","110/08/18","摩根大通",94,60,34
"14224","6207雷科","110/08/18","凱基-高雄",4,34,-30
"14225","6207雷科","110/08/18","港商野村",48,17,31
"14226","6207雷科","110/08/18","凱基-復興",0,30,-30
"14227","6207雷科","110/08/18","兆豐-南京",30,0,30
"14228","6207雷科","110/08/18","日盛證券",0,29,-29
"14229","6207雷科","110/08/18","元大-六合",30,0,30
"14230","6207雷科","110/08/18","凱基-敦北",1,28,-27
"14231","6207雷科","110/08/18","新加坡商瑞銀",66,40,26
"14232","6207雷科","110/08/18","群益金鼎-東門",0,16,-16
"14233","6207雷科","110/08/18","台新-高雄",21,0,21
"14234","6207雷科","110/08/18","元大-天母",0,11,-11
"14235","6207雷科","110/08/18","光和-和美",17,0,17
"14236","6207雷科","110/08/18","美商高盛",4,13,-9
"14237","6207雷科","110/08/18","凱基-三重",13,0,13
"14238","6207雷科","110/08/18","新光",0,8,-8
"14239","6207雷科","110/08/18","元富-安南",10,0,10
"14240","6207雷科","110/08/18","永豐金-忠孝",0,8,-8
"14241","6207雷科","110/08/18","元大-東門",9,0,9
"14242","6207雷科","110/08/18","合庫證券",0,7,-7
"14243","6207雷科","110/08/18","第一金-華江",8,2,6
"14244","6207雷科","110/08/18","康和-台中",0,6,-6
"14245","6207雷科","110/08/18","永豐金-高雄",6,0,6
"14246","6207雷科","110/08/18","元大-大天母",0,6,-6
"14247","6207雷科","110/08/18","玉山-台大",5,0,5
"14248","6207雷科","110/08/18","統一-三多",0,5,-5
"14249","6207雷科","110/08/18","凱基-岡山",5,0,5
"14250","6207雷科","110/08/18","中國信託-忠孝",0,5,-5
"14251","3679新至陞","110/08/18","摩根大通",52,6,46
"14252","3679新至陞","110/08/18","統一-三重",0,21,-21
"14253","3679新至陞","110/08/18","凱基-台北",46,13,33
"14254","3679新至陞","110/08/18","元大-北成功",0,19,-19
"14255","3679新至陞","110/08/18","台灣摩根士丹利",31,0,31
"14256","3679新至陞","110/08/18","華南永昌-大安",0,18,-18
"14257","3679新至陞","110/08/18","瑞士信貸",26,1,25
"14258","3679新至陞","110/08/18","台新證券",0,14,-14
"14259","3679新至陞","110/08/18","美林",23,5,18
"14260","3679新至陞","110/08/18","萬泰",0,12,-12
"14261","3679新至陞","110/08/18","元大-文心興安",15,0,15
"14262","3679新至陞","110/08/18","大慶-苗栗",0,10,-10
"14263","3679新至陞","110/08/18","(牛牛牛)亞-網路",8,0,8
"14264","3679新至陞","110/08/18","元大-成功",0,10,-10
"14265","3679新至陞","110/08/18","永豐金-板橋",5,0,5
"14266","3679新至陞","110/08/18","富邦-嘉義",0,8,-8
"14267","3679新至陞","110/08/18","美商高盛",3,0,3
"14268","3679新至陞","110/08/18","凱基-長庚",0,7,-7
"14269","3679新至陞","110/08/18","兆豐-公益",3,0,3
"14270","3679新至陞","110/08/18","凱基-文心",0,6,-6
"14271","3679新至陞","110/08/18","聯邦-三重",3,0,3
"14272","3679新至陞","110/08/18","統一",0,5,-5
"14273","3679新至陞","110/08/18","土銀-台中",2,0,2
"14274","3679新至陞","110/08/18","元大-敦化",0,4,-4
"14275","3679新至陞","110/08/18","土銀-新竹",2,0,2
"14276","3679新至陞","110/08/18","日盛-文化",1,4,-3
"14277","3679新至陞","110/08/18","國泰-高雄",2,0,2
"14278","3679新至陞","110/08/18","彰銀",0,3,-3
"14279","3679新至陞","110/08/18","土銀-士林",1,0,1
"14280","3679新至陞","110/08/18","元富-大昌",0,3,-3
"14281","2727王品","110/08/18","凱基-台北",94,29,65
"14282","2727王品","110/08/18","港商麥格理",0,65,-65
"14283","2727王品","110/08/18","摩根大通",42,13,29
"14284","2727王品","110/08/18","華南永昌",1,39,-38
"14285","2727王品","110/08/18","彰銀-台中",27,0,27
"14286","2727王品","110/08/18","元富-板橋",1,16,-15
"14287","2727王品","110/08/18","瑞士信貸",18,3,15
"14288","2727王品","110/08/18","港商野村",66,79,-13
"14289","2727王品","110/08/18","凱基-埔墘",10,0,10
"14290","2727王品","110/08/18","第一金-桃園",0,11,-11
"14291","2727王品","110/08/18","富邦-建國",13,3,10
"14292","2727王品","110/08/18","元大-汐止",0,11,-11
"14293","2727王品","110/08/18","元大-學甲",10,0,10
"14294","2727王品","110/08/18","凱基-三峽",0,10,-10
"14295","2727王品","110/08/18","國泰-台中",28,19,9
"14296","2727王品","110/08/18","凱基-板橋",3,12,-9
"14297","2727王品","110/08/18","凱基-高美館",7,0,7
"14298","2727王品","110/08/18","凱基-林口",5,14,-9
"14299","2727王品","110/08/18","凱基-竹北",9,2,7
"14300","2727王品","110/08/18","富邦-中壢",2,11,-9
"14301","2727王品","110/08/18","元大-四維",7,0,7
"14302","2727王品","110/08/18","福勝",0,8,-8
"14303","2727王品","110/08/18","元大-敦南",8,1,7
"14304","2727王品","110/08/18","國泰-敦南",4,12,-8
"14305","2727王品","110/08/18","統一",19,13,6
"14306","2727王品","110/08/18","台新-三民",1,8,-7
"14307","2727王品","110/08/18","日盛-屏東",5,0,5
"14308","2727王品","110/08/18","華南永昌-林口",0,7,-7
"14309","2727王品","110/08/18","國泰-館前",6,1,5
"14310","2727王品","110/08/18","永豐金-內湖",0,7,-7
"14311","1570力肯","110/08/18","凱基-台北",129,5,124
"14312","1570力肯","110/08/18","華南永昌-桃園",0,102,-102
"14313","1570力肯","110/08/18","香港上海匯豐",36,0,36
"14314","1570力肯","110/08/18","中國信託-高雄",0,49,-49
"14315","1570力肯","110/08/18","統一",30,0,30
"14316","1570力肯","110/08/18","元富-世貿",0,20,-20
"14317","1570力肯","110/08/18","群益金鼎-北高雄",27,0,27
"14318","1570力肯","110/08/18","國泰證券",0,20,-20
"14319","1570力肯","110/08/18","國票-北高雄",21,3,18
"14320","1570力肯","110/08/18","元大-屏南",0,15,-15
"14321","1570力肯","110/08/18","元大-南投",20,4,16
"14322","1570力肯","110/08/18","元大-和平",5,20,-15
"14323","1570力肯","110/08/18","新光-台南",15,0,15
"14324","1570力肯","110/08/18","元大-基隆",0,12,-12
"14325","1570力肯","110/08/18","富邦-高雄",15,0,15
"14326","1570力肯","110/08/18","玉山-台中",0,10,-10
"14327","1570力肯","110/08/18","華南永昌-嘉義",12,0,12
"14328","1570力肯","110/08/18","元大-苗栗",0,10,-10
"14329","1570力肯","110/08/18","富邦-花蓮",10,0,10
"14330","1570力肯","110/08/18","元大-草屯",0,10,-10
"14331","1570力肯","110/08/18","元富-新店",10,2,8
"14332","1570力肯","110/08/18","富邦-彰化",0,8,-8
"14333","1570力肯","110/08/18","富邦-台東",12,4,8
"14334","1570力肯","110/08/18","日盛-嘉義",0,7,-7
"14335","1570力肯","110/08/18","日盛-高雄",7,0,7
"14336","1570力肯","110/08/18","永豐金-桃園",3,10,-7
"14337","1570力肯","110/08/18","元大-羅東",7,0,7
"14338","1570力肯","110/08/18","大昌-安康",0,6,-6
"14339","1570力肯","110/08/18","大慶-蘆洲",9,3,6
"14340","1570力肯","110/08/18","國票-和平",0,6,-6
"14341","6180橘子","110/08/18","美林",40,0,40
"14342","6180橘子","110/08/18","香港上海匯豐",0,102,-102
"14343","6180橘子","110/08/18","新加坡商瑞銀",23,1,22
"14344","6180橘子","110/08/18","台灣摩根士丹利",2,73,-71
"14345","6180橘子","110/08/18","凱基-基隆",18,2,16
"14346","6180橘子","110/08/18","美商高盛",1,31,-30
"14347","6180橘子","110/08/18","華南永昌-虎尾",15,0,15
"14348","6180橘子","110/08/18","凱基-市政",1,25,-24
"14349","6180橘子","110/08/18","元富-城東",14,1,13
"14350","6180橘子","110/08/18","日盛-板橋",1,20,-19
"14351","6180橘子","110/08/18","富邦-台北",16,3,13
"14352","6180橘子","110/08/18","新光-高雄",1,14,-13
"14353","6180橘子","110/08/18","富邦-中壢",11,2,9
"14354","6180橘子","110/08/18","凱基-東門",2,15,-13
"14355","6180橘子","110/08/18","富邦-宜蘭",9,0,9
"14356","6180橘子","110/08/18","元大-基隆孝二",0,12,-12
"14357","6180橘子","110/08/18","元大-前金",10,1,9
"14358","6180橘子","110/08/18","兆豐-三重",0,11,-11
"14359","6180橘子","110/08/18","中國信託",8,0,8
"14360","6180橘子","110/08/18","日盛證券",0,10,-10
"14361","6180橘子","110/08/18","元大-中壢",12,4,8
"14362","6180橘子","110/08/18","摩根大通",80,89,-9
"14363","6180橘子","110/08/18","凱基-大直",7,0,7
"14364","6180橘子","110/08/18","新光",9,18,-9
"14365","6180橘子","110/08/18","元大證券",9,2,7
"14366","6180橘子","110/08/18","富邦-南屯",0,9,-9
"14367","6180橘子","110/08/18","大慶-楊梅",6,0,6
"14368","6180橘子","110/08/18","元大-板橋三民",0,9,-9
"14369","6180橘子","110/08/18","華南永昌",7,1,6
"14370","6180橘子","110/08/18","元大-桃園",2,11,-9
"14371","2390云辰","110/08/18","兆豐-公益",192,31,161
"14372","2390云辰","110/08/18","摩根大通",1314,1582,-268
"14373","2390云辰","110/08/18","元大-土城學府",406,260,146
"14374","2390云辰","110/08/18","凱基-台北",727,962,-235
"14375","2390云辰","110/08/18","群益金鼎-敦南",106,4,102
"14376","2390云辰","110/08/18","國泰-桃園",53,264,-211
"14377","2390云辰","110/08/18","元大-竹科",136,36,100
"14378","2390云辰","110/08/18","富邦-內湖",0,201,-201
"14379","2390云辰","110/08/18","元大-館前",151,52,99
"14380","2390云辰","110/08/18","元大-復北",5,193,-188
"14381","2390云辰","110/08/18","日盛-園區",128,46,82
"14382","2390云辰","110/08/18","凱基-民權",2,160,-158
"14383","2390云辰","110/08/18","元大-東泰",84,9,75
"14384","2390云辰","110/08/18","國票-安和",98,231,-133
"14385","2390云辰","110/08/18","福勝",68,8,60
"14386","2390云辰","110/08/18","新加坡商瑞銀",102,225,-123
"14387","2390云辰","110/08/18","宏遠-光隆",73,14,59
"14388","2390云辰","110/08/18","港商野村",1128,1238,-110
"14389","2390云辰","110/08/18","元富",66,10,56
"14390","2390云辰","110/08/18","台灣摩根士丹利",3,100,-97
"14391","2390云辰","110/08/18","華南永昌-合泰",54,1,53
"14392","2390云辰","110/08/18","永豐金-嘉義",4,97,-93
"14393","2390云辰","110/08/18","凱基-中港",60,9,51
"14394","2390云辰","110/08/18","統一-城中",57,147,-90
"14395","2390云辰","110/08/18","第一金-忠孝",54,5,49
"14396","2390云辰","110/08/18","富邦-彰化",47,128,-81
"14397","2390云辰","110/08/18","統一-新台中",140,91,49
"14398","2390云辰","110/08/18","美林",341,412,-71
"14399","2390云辰","110/08/18","群益金鼎-台中",53,6,47
"14400","2390云辰","110/08/18","新光",312,382,-70
"14401","2609陽明","110/08/17","兆豐-中壢",5227,708,4519
"14402","2609陽明","110/08/17","康和",48,4865,-4817
"14403","2609陽明","110/08/17","凱基-台北",5969,1780,4189
"14404","2609陽明","110/08/17","永豐金-信義",84,2643,-2559
"14405","2609陽明","110/08/17","兆豐-三民",2114,136,1978
"14406","2609陽明","110/08/17","凱基-虎尾",487,2286,-1799
"14407","2609陽明","110/08/17","兆豐-復興",3638,1682,1956
"14408","2609陽明","110/08/17","港商野村",1127,2155,-1028
"14409","2609陽明","110/08/17","台灣摩根士丹利",2505,858,1647
"14410","2609陽明","110/08/17","兆豐-虎尾",1846,2756,-910
"14411","2609陽明","110/08/17","日盛-板橋",1734,262,1472
"14412","2609陽明","110/08/17","富邦-嘉義",7219,8100,-881
"14413","2609陽明","110/08/17","美林",3468,2882,586
"14414","2609陽明","110/08/17","元大-頭份",78,810,-732
"14415","2609陽明","110/08/17","香港上海匯豐",593,100,493
"14416","2609陽明","110/08/17","摩根大通",1422,2133,-711
"14417","2609陽明","110/08/17","統一-土城",366,14,352
"14418","2609陽明","110/08/17","元大-永春",281,971,-690
"14419","2609陽明","110/08/17","統一-敦南",899,577,322
"14420","2609陽明","110/08/17","宏遠證券",948,1614,-666
"14421","2609陽明","110/08/17","富邦-桃園",413,123,290
"14422","2609陽明","110/08/17","凱基-竹東",20,668,-648
"14423","2609陽明","110/08/17","日盛-中壢",537,256,281
"14424","2609陽明","110/08/17","元大證券",1377,2001,-624
"14425","2609陽明","110/08/17","兆豐-板橋",545,318,227
"14426","2609陽明","110/08/17","元富-新店",74,549,-475
"14427","2609陽明","110/08/17","凱基-桃園",367,142,225
"14428","2609陽明","110/08/17","華南永昌-楠梓",73,486,-413
"14429","2609陽明","110/08/17","統一-城中",390,169,221
"14430","2609陽明","110/08/17","臺銀",286,681,-395
"14431","2636台驊投控","110/08/17","元富-文心",272,9,263
"14432","2636台驊投控","110/08/17","凱基-彰化",0,689,-689
"14433","2636台驊投控","110/08/17","日盛-大墩",185,19,166
"14434","2636台驊投控","110/08/17","摩根大通",347,761,-414
"14435","2636台驊投控","110/08/17","第一金-桃園",147,26,121
"14436","2636台驊投控","110/08/17","富邦-花蓮",106,366,-260
"14437","2636台驊投控","110/08/17","元富-大昌",84,15,69
"14438","2636台驊投控","110/08/17","凱基-台北",395,566,-171
"14439","2636台驊投控","110/08/17","新光",258,192,66
"14440","2636台驊投控","110/08/17","大慶",15,175,-160
"14441","2636台驊投控","110/08/17","統一-新台中",64,4,60
"14442","2636台驊投控","110/08/17","統一",111,247,-136
"14443","2636台驊投控","110/08/17","華南永昌-竹北",308,252,56
"14444","2636台驊投控","110/08/17","富邦證券",0,134,-134
"14445","2636台驊投控","110/08/17","日盛-木柵",60,8,52
"14446","2636台驊投控","110/08/17","富邦-虎尾",294,414,-120
"14447","2636台驊投控","110/08/17","國泰-敦南",335,283,52
"14448","2636台驊投控","110/08/17","元大-士林",4,114,-110
"14449","2636台驊投控","110/08/17","美商高盛",96,54,42
"14450","2636台驊投控","110/08/17","美林",320,401,-81
"14451","2636台驊投控","110/08/17","凱基-市政",60,22,38
"14452","2636台驊投控","110/08/17","瑞士信貸",62,134,-72
"14453","2636台驊投控","110/08/17","元大-龍潭",50,13,37
"14454","2636台驊投控","110/08/17","兆豐-東門",70,140,-70
"14455","2636台驊投控","110/08/17","國票-九鼎",50,16,34
"14456","2636台驊投控","110/08/17","凱基-高美館",89,158,-69
"14457","2636台驊投控","110/08/17","元大-東門",37,3,34
"14458","2636台驊投控","110/08/17","日盛證券",103,170,-67
"14459","2636台驊投控","110/08/17","富邦-三重",33,1,32
"14460","2636台驊投控","110/08/17","宏遠-桃園",4,44,-40
"14461","2867三商壽","110/08/17","摩根大通",670,119,551
"14462","2867三商壽","110/08/17","玉山-左營",10,1173,-1163
"14463","2867三商壽","110/08/17","元富-世貿",288,0,288
"14464","2867三商壽","110/08/17","華南永昌",50,736,-686
"14465","2867三商壽","110/08/17","日盛-中和",276,10,266
"14466","2867三商壽","110/08/17","台灣摩根士丹利",37,195,-158
"14467","2867三商壽","110/08/17","新光-台中",243,7,236
"14468","2867三商壽","110/08/17","兆豐-北高雄",0,135,-135
"14469","2867三商壽","110/08/17","台新-台中",198,1,197
"14470","2867三商壽","110/08/17","宏遠證券",9,141,-132
"14471","2867三商壽","110/08/17","華南永昌-長虹",136,0,136
"14472","2867三商壽","110/08/17","永豐金-市政",0,115,-115
"14473","2867三商壽","110/08/17","美林",137,2,135
"14474","2867三商壽","110/08/17","兆豐-新竹",0,113,-113
"14475","2867三商壽","110/08/17","元大-土城永寧",100,1,99
"14476","2867三商壽","110/08/17","永豐金證券",0,82,-82
"14477","2867三商壽","110/08/17","國泰-台中",99,2,97
"14478","2867三商壽","110/08/17","元大-彰化民生",0,80,-80
"14479","2867三商壽","110/08/17","元富-古亭",100,4,96
"14480","2867三商壽","110/08/17","永豐金-中盛",4,77,-73
"14481","2867三商壽","110/08/17","合庫-西台中",80,0,80
"14482","2867三商壽","110/08/17","元富",0,70,-70
"14483","2867三商壽","110/08/17","新加坡商瑞銀",83,4,79
"14484","2867三商壽","110/08/17","宏遠-中和",10,57,-47
"14485","2867三商壽","110/08/17","永豐金-埔里",64,5,59
"14486","2867三商壽","110/08/17","富邦-嘉義",4,50,-46
"14487","2867三商壽","110/08/17","元富-緯城",50,0,50
"14488","2867三商壽","110/08/17","第一金-華江",0,30,-30
"14489","2867三商壽","110/08/17","台新-建北",49,0,49
"14490","2867三商壽","110/08/17","台新證券",2,32,-30
"14491","5521工信","110/08/17","元大-沙鹿",60,0,60
"14492","5521工信","110/08/17","摩根大通",75,227,-152
"14493","5521工信","110/08/17","群益金鼎-萬華",46,0,46
"14494","5521工信","110/08/17","凱基-台北",5,68,-63
"14495","5521工信","110/08/17","台新證券",37,1,36
"14496","5521工信","110/08/17","群益金鼎-敦南",0,60,-60
"14497","5521工信","110/08/17","華南永昌-竹北",31,0,31
"14498","5521工信","110/08/17","台灣摩根士丹利",5,64,-59
"14499","5521工信","110/08/17","元大-北投",30,0,30
"14500","5521工信","110/08/17","元富-古亭",0,40,-40
"14501","5521工信","110/08/17","元富-屏東",24,0,24
"14502","5521工信","110/08/17","台灣企銀-嘉義",0,35,-35
"14503","5521工信","110/08/17","富邦-台北",23,0,23
"14504","5521工信","110/08/17","美林",5,37,-32
"14505","5521工信","110/08/17","元大-屏南",23,0,23
"14506","5521工信","110/08/17","華南永昌",0,27,-27
"14507","5521工信","110/08/17","國泰-敦南",40,18,22
"14508","5521工信","110/08/17","華南永昌-潮州",0,25,-25
"14509","5521工信","110/08/17","兆豐-中壢",20,0,20
"14510","5521工信","110/08/17","台新-高雄",0,24,-24
"14511","5521工信","110/08/17","新光-台南",20,0,20
"14512","5521工信","110/08/17","大慶-楊梅",0,22,-22
"14513","5521工信","110/08/17","臺銀-鳳山",19,0,19
"14514","5521工信","110/08/17","凱基-桃園",0,20,-20
"14515","5521工信","110/08/17","日進",18,0,18
"14516","5521工信","110/08/17","元大-東蘆",0,20,-20
"14517","5521工信","110/08/17","永豐金-鳳山",17,0,17
"14518","5521工信","110/08/17","第一金-桃園",0,18,-18
"14519","5521工信","110/08/17","玉山證券",14,0,14
"14520","5521工信","110/08/17","新光-新竹",3,20,-17
"14521","1471首利","110/08/17","摩根大通",110,14,96
"14522","1471首利","110/08/17","元大-台南",0,54,-54
"14523","1471首利","110/08/17","臺銀-臺中",40,0,40
"14524","1471首利","110/08/17","高橋-龍潭",0,50,-50
"14525","1471首利","110/08/17","瑞士信貸",33,0,33
"14526","1471首利","110/08/17","元大-竹南",0,35,-35
"14527","1471首利","110/08/17","凱基-台北",30,6,24
"14528","1471首利","110/08/17","台新證券",1,31,-30
"14529","1471首利","110/08/17","元大-竹山",23,0,23
"14530","1471首利","110/08/17","國泰-敦南",7,33,-26
"14531","1471首利","110/08/17","大慶-蘆洲",14,0,14
"14532","1471首利","110/08/17","元大-西門",0,23,-23
"14533","1471首利","110/08/17","兆豐-員林",13,1,12
"14534","1471首利","110/08/17","元富-埔里",0,20,-20
"14535","1471首利","110/08/17","致和-府前",11,0,11
"14536","1471首利","110/08/17","富邦-台中",0,20,-20
"14537","1471首利","110/08/17","國票-彰化",11,0,11
"14538","1471首利","110/08/17","日茂",0,11,-11
"14539","1471首利","110/08/17","元富-新莊",10,0,10
"14540","1471首利","110/08/17","高橋",0,10,-10
"14541","1471首利","110/08/17","國票",10,0,10
"14542","1471首利","110/08/17","大昌-新店",0,10,-10
"14543","1471首利","110/08/17","富邦-永和",10,0,10
"14544","1471首利","110/08/17","元富-文心",1,10,-9
"14545","1471首利","110/08/17","元大-新莊",10,0,10
"14546","1471首利","110/08/17","凱基-雙和",0,8,-8
"14547","1471首利","110/08/17","元大-鹿港",10,0,10
"14548","1471首利","110/08/17","凱基-屏東",0,8,-8
"14549","1471首利","110/08/17","元大-清水",11,2,9
"14550","1471首利","110/08/17","日盛-永康",0,7,-7
"14551","2883開發金","110/08/17","中國信託-文心",3524,26,3498
"14552","2883開發金","110/08/17","新加坡商瑞銀",513,7792,-7279
"14553","2883開發金","110/08/17","元大證券",1912,297,1615
"14554","2883開發金","110/08/17","亞東-新竹",206,2692,-2486
"14555","2883開發金","110/08/17","摩根大通",4110,2504,1606
"14556","2883開發金","110/08/17","凱基-台北",2263,4277,-2014
"14557","2883開發金","110/08/17","美林",2099,733,1366
"14558","2883開發金","110/08/17","永豐金證券",103,1899,-1796
"14559","2883開發金","110/08/17","日盛證券",2406,1218,1188
"14560","2883開發金","110/08/17","華南永昌-苑裡",13,1229,-1216
"14561","2883開發金","110/08/17","國泰-館前",942,128,814
"14562","2883開發金","110/08/17","統一-新營",39,1202,-1163
"14563","2883開發金","110/08/17","元富-城中",808,6,802
"14564","2883開發金","110/08/17","兆豐-高雄",68,1153,-1085
"14565","2883開發金","110/08/17","港商法國興業",764,0,764
"14566","2883開發金","110/08/17","凱基-斗六",3,812,-809
"14567","2883開發金","110/08/17","元大-南屯",759,75,684
"14568","2883開發金","110/08/17","元大-四維",736,1467,-731
"14569","2883開發金","110/08/17","康和-仁愛",514,10,504
"14570","2883開發金","110/08/17","台新證券",682,1391,-709
"14571","2883開發金","110/08/17","新光",1403,910,493
"14572","2883開發金","110/08/17","凱基-豐中",7,617,-610
"14573","2883開發金","110/08/17","統一-汐止",489,5,484
"14574","2883開發金","110/08/17","土銀-嘉義",10,580,-570
"14575","2883開發金","110/08/17","永豐金-忠孝",650,206,444
"14576","2883開發金","110/08/17","港商麥格理",1131,1682,-551
"14577","2883開發金","110/08/17","港商野村",2803,2361,442
"14578","2883開發金","110/08/17","富邦-陽明",158,680,-522
"14579","2883開發金","110/08/17","元富-大裕",454,22,432
"14580","2883開發金","110/08/17","台灣摩根士丹利",2238,2750,-512
"14581","6205詮欣","110/08/17","日盛-三重",15,0,15
"14582","6205詮欣","110/08/17","元富-松德",0,10,-10
"14583","6205詮欣","110/08/17","臺銀-民權",5,0,5
"14584","6205詮欣","110/08/17","元富-安南",0,8,-8
"14585","6205詮欣","110/08/17","華南永昌-長虹",5,0,5
"14586","6205詮欣","110/08/17","元大-大雅",0,3,-3
"14587","6205詮欣","110/08/17","德信-新營",4,0,4
"14588","6205詮欣","110/08/17","兆豐-南門",0,3,-3
"14589","6205詮欣","110/08/17","凱基-汐止",4,0,4
"14590","6205詮欣","110/08/17","兆豐-南京",0,3,-3
"14591","6205詮欣","110/08/17","富邦-陽明",4,0,4
"14592","6205詮欣","110/08/17","元大-豐原",0,2,-2
"14593","6205詮欣","110/08/17","元大-汐止",4,0,4
"14594","6205詮欣","110/08/17","大昌",0,1,-1
"14595","6205詮欣","110/08/17","華南永昌-古亭",3,0,3
"14596","6205詮欣","110/08/17","永豐金-中正",0,1,-1
"14597","6205詮欣","110/08/17","凱基-台北",1,0,1
"14598","6205詮欣","110/08/17","大昌-安康",0,1,-1
"14599","6205詮欣","110/08/17","元大-鑫永和",1,0,1
"14600","6205詮欣","110/08/17","日盛-台中",0,1,-1
"14601","6205詮欣","110/08/17","統一-士林",0,0,0
"14602","6205詮欣","110/08/17","新百王",0,1,-1
"14603","6205詮欣","110/08/17","統一-南京",0,0,0
"14604","6205詮欣","110/08/17","元富-文心",0,1,-1
"14605","6205詮欣","110/08/17","國泰證券",0,0,0
"14606","6205詮欣","110/08/17","統一",0,1,-1
"14607","6205詮欣","110/08/17","華南永昌-高雄",0,0,0
"14608","6205詮欣","110/08/17","第一金-中壢",0,1,-1
"14609","6205詮欣","110/08/17","永豐金-中和",1,1,0
"14610","6205詮欣","110/08/17","大慶-基隆",0,1,-1
"14611","1540喬福","110/08/17","元大-松山",20,0,20
"14612","1540喬福","110/08/17","群益金鼎-館前",0,31,-31
"14613","1540喬福","110/08/17","凱基-中壢",17,0,17
"14614","1540喬福","110/08/17","日盛-文化",0,30,-30
"14615","1540喬福","110/08/17","元大-左營",11,0,11
"14616","1540喬福","110/08/17","兆豐-民生",0,17,-17
"14617","1540喬福","110/08/17","元富-文心",10,0,10
"14618","1540喬福","110/08/17","凱基-台北",0,5,-5
"14619","1540喬福","110/08/17","元大-土城永寧",10,0,10
"14620","1540喬福","110/08/17","國票-台中",0,3,-3
"14621","1540喬福","110/08/17","元大-成功",10,0,10
"14622","1540喬福","110/08/17","元大-大益",0,3,-3
"14623","1540喬福","110/08/17","富邦-板橋",6,0,6
"14624","1540喬福","110/08/17","致和-南京",0,2,-2
"14625","1540喬福","110/08/17","新光",4,0,4
"14626","1540喬福","110/08/17","國泰-館前",0,2,-2
"14627","1540喬福","110/08/17","亞東",2,0,2
"14628","1540喬福","110/08/17","富邦-陽明",0,2,-2
"14629","1540喬福","110/08/17","群益金鼎-新店",2,0,2
"14630","1540喬福","110/08/17","元大-龍潭",0,2,-2
"14631","1540喬福","110/08/17","日盛-員林",1,0,1
"14632","1540喬福","110/08/17","日盛-台中",0,1,-1
"14633","1540喬福","110/08/17","日盛-鳳山",1,0,1
"14634","1540喬福","110/08/17","美林",0,1,-1
"14635","1540喬福","110/08/17","統一-屏東",1,0,1
"14636","1540喬福","110/08/17","第一金-高雄",0,1,-1
"14637","1540喬福","110/08/17","元富-大昌",1,0,1
"14638","1540喬福","110/08/17","元富",1,2,-1
"14639","1540喬福","110/08/17","台新-高雄",1,0,1
"14640","1540喬福","110/08/17","新光-新竹",0,1,-1
"14641","2888新光金","110/08/17","華南永昌-岡山",6623,36,6587
"14642","2888新光金","110/08/17","元富-城東",11,13997,-13986
"14643","2888新光金","110/08/17","元大-忠孝鼎富",4976,0,4976
"14644","2888新光金","110/08/17","永豐金證券",19,2260,-2241
"14645","2888新光金","110/08/17","永豐金-萬盛",3955,15,3940
"14646","2888新光金","110/08/17","國票-博愛",0,2051,-2051
"14647","2888新光金","110/08/17","摩根大通",3699,247,3452
"14648","2888新光金","110/08/17","群益金鼎",0,1836,-1836
"14649","2888新光金","110/08/17","瑞士信貸",3064,605,2459
"14650","2888新光金","110/08/17","華南永昌",10,1624,-1614
"14651","2888新光金","110/08/17","凱基-大安",2179,2,2177
"14652","2888新光金","110/08/17","元大-大同",0,714,-714
"14653","2888新光金","110/08/17","國票-台東",1935,23,1912
"14654","2888新光金","110/08/17","安泰",0,598,-598
"14655","2888新光金","110/08/17","永豐金-信義",1497,5,1492
"14656","2888新光金","110/08/17","大昌",3,555,-552
"14657","2888新光金","110/08/17","國票-北投",1304,0,1304
"14658","2888新光金","110/08/17","福勝",3,510,-507
"14659","2888新光金","110/08/17","兆豐-松德",1251,0,1251
"14660","2888新光金","110/08/17","元大-太平",20,525,-505
"14661","2888新光金","110/08/17","花旗環球",1101,147,954
"14662","2888新光金","110/08/17","中國信託-三重",0,503,-503
"14663","2888新光金","110/08/17","港商法國興業",1031,180,851
"14664","2888新光金","110/08/17","台灣摩根士丹利",1136,1627,-491
"14665","2888新光金","110/08/17","凱基-站前",788,13,775
"14666","2888新光金","110/08/17","美林",141,604,-463
"14667","2888新光金","110/08/17","台灣匯立證券",763,0,763
"14668","2888新光金","110/08/17","群益金鼎-土城",0,415,-415
"14669","2888新光金","110/08/17","群益金鼎-崇德",735,3,732
"14670","2888新光金","110/08/17","凱基-台北",632,1033,-401
"14671","1340勝悅","110/08/17","國泰-台中",12,0,12
"14672","1340勝悅","110/08/17","永豐金-潮州",0,20,-20
"14673","1340勝悅","110/08/17","新光-新竹",10,0,10
"14674","1340勝悅","110/08/17","臺灣企銀-桃園",0,10,-10
"14675","1340勝悅","110/08/17","元富-成功",8,0,8
"14676","1340勝悅","110/08/17","瑞士信貸",0,6,-6
"14677","1340勝悅","110/08/17","臺灣企銀-埔墘",5,0,5
"14678","1340勝悅","110/08/17","玉山-桃園",0,5,-5
"14679","1340勝悅","110/08/17","華南永昌-敦南",5,0,5
"14680","1340勝悅","110/08/17","華南永昌-虎尾",0,5,-5
"14681","1340勝悅","110/08/17","富邦-新店",11,6,5
"14682","1340勝悅","110/08/17","永豐金-博愛",0,5,-5
"14683","1340勝悅","110/08/17","美商高盛",4,0,4
"14684","1340勝悅","110/08/17","日盛-永康",0,4,-4
"14685","1340勝悅","110/08/17","新光-桃園",3,0,3
"14686","1340勝悅","110/08/17","元富-世貿",0,4,-4
"14687","1340勝悅","110/08/17","日盛-八德",2,0,2
"14688","1340勝悅","110/08/17","摩根大通",2,6,-4
"14689","1340勝悅","110/08/17","凱基-基隆",2,0,2
"14690","1340勝悅","110/08/17","玉山-新莊",0,3,-3
"14691","1340勝悅","110/08/17","元大-松江",2,0,2
"14692","1340勝悅","110/08/17","國泰-敦南",5,8,-3
"14693","1340勝悅","110/08/17","元大-崇德",2,0,2
"14694","1340勝悅","110/08/17","富邦-桃園",0,3,-3
"14695","1340勝悅","110/08/17","國泰-館前",1,0,1
"14696","1340勝悅","110/08/17","元大-和平",0,3,-3
"14697","1340勝悅","110/08/17","群益金鼎-民權",1,0,1
"14698","1340勝悅","110/08/17","永豐金-南投",0,3,-3
"14699","1340勝悅","110/08/17","華南永昌-大安",1,0,1
"14700","1340勝悅","110/08/17","富邦-羅東",2,4,-2
"14701","6246臺龍","110/08/17","台新-三民",90,0,90
"14702","6246臺龍","110/08/17","日盛證券",0,52,-52
"14703","6246臺龍","110/08/17","港商野村",63,28,35
"14704","6246臺龍","110/08/17","凱基-幸福",0,10,-10
"14705","6246臺龍","110/08/17","台新證券",20,0,20
"14706","6246臺龍","110/08/17","元富-新店",0,9,-9
"14707","6246臺龍","110/08/17","凱基-信義",7,0,7
"14708","6246臺龍","110/08/17","凱基-科園",0,8,-8
"14709","6246臺龍","110/08/17","凱基-站前",5,0,5
"14710","6246臺龍","110/08/17","元富-世貿",0,7,-7
"14711","6246臺龍","110/08/17","合庫-嘉義",5,1,4
"14712","6246臺龍","110/08/17","兆豐-公益",0,7,-7
"14713","6246臺龍","110/08/17","元大-林園",10,6,4
"14714","6246臺龍","110/08/17","元大-東蘆",0,7,-7
"14715","6246臺龍","110/08/17","元大-永康",4,0,4
"14716","6246臺龍","110/08/17","群益金鼎-嘉義",0,6,-6
"14717","6246臺龍","110/08/17","元大-基隆孝二",4,0,4
"14718","6246臺龍","110/08/17","華南永昌-頭份",0,6,-6
"14719","6246臺龍","110/08/17","日盛-斗六",3,0,3
"14720","6246臺龍","110/08/17","元大-北港",0,5,-5
"14721","6246臺龍","110/08/17","永全",3,0,3
"14722","6246臺龍","110/08/17","日盛-和美",0,4,-4
"14723","6246臺龍","110/08/17","兆豐-景美",3,0,3
"14724","6246臺龍","110/08/17","國泰-敦南",1,5,-4
"14725","6246臺龍","110/08/17","台新-台中",3,0,3
"14726","6246臺龍","110/08/17","群益金鼎-新竹",0,4,-4
"14727","6246臺龍","110/08/17","元大-雙和",3,0,3
"14728","6246臺龍","110/08/17","凱基-台北",0,4,-4
"14729","6246臺龍","110/08/17","土銀",2,0,2
"14730","6246臺龍","110/08/17","元大-府城",0,4,-4
"14731","00715L期街口布蘭特正2","110/08/17","華南永昌-長虹",860,0,860
"14732","00715L期街口布蘭特正2","110/08/17","元大證券",78,4339,-4261
"14733","00715L期街口布蘭特正2","110/08/17","永豐金-台中",823,20,803
"14734","00715L期街口布蘭特正2","110/08/17","元富",2,3940,-3938
"14735","00715L期街口布蘭特正2","110/08/17","日盛-和美",595,0,595
"14736","00715L期街口布蘭特正2","110/08/17","永豐金證券",41,1048,-1007
"14737","00715L期街口布蘭特正2","110/08/17","第一金-豐原",420,0,420
"14738","00715L期街口布蘭特正2","110/08/17","統一-桃園",5,850,-845
"14739","00715L期街口布蘭特正2","110/08/17","元大-前金",419,0,419
"14740","00715L期街口布蘭特正2","110/08/17","富邦證券",258,1081,-823
"14741","00715L期街口布蘭特正2","110/08/17","華南永昌-台中",419,5,414
"14742","00715L期街口布蘭特正2","110/08/17","元大-台中",9,534,-525
"14743","00715L期街口布蘭特正2","110/08/17","元大-北三重",403,0,403
"14744","00715L期街口布蘭特正2","110/08/17","合庫-高雄",10,310,-300
"14745","00715L期街口布蘭特正2","110/08/17","日盛-新莊",375,0,375
"14746","00715L期街口布蘭特正2","110/08/17","港商野村",1,240,-239
"14747","00715L期街口布蘭特正2","110/08/17","富邦-基隆",310,0,310
"14748","00715L期街口布蘭特正2","110/08/17","群益金鼎-民權",2,208,-206
"14749","00715L期街口布蘭特正2","110/08/17","臺銀-新竹",311,10,301
"14750","00715L期街口布蘭特正2","110/08/17","元大-大里德芳",1,200,-199
"14751","00715L期街口布蘭特正2","110/08/17","元富-中港",300,0,300
"14752","00715L期街口布蘭特正2","110/08/17","元大-中和",1,187,-186
"14753","00715L期街口布蘭特正2","110/08/17","新光",368,82,286
"14754","00715L期街口布蘭特正2","110/08/17","康和",0,133,-133
"14755","00715L期街口布蘭特正2","110/08/17","中國信託-新竹",263,0,263
"14756","00715L期街口布蘭特正2","110/08/17","永豐金-板新",25,150,-125
"14757","00715L期街口布蘭特正2","110/08/17","台中銀",253,0,253
"14758","00715L期街口布蘭特正2","110/08/17","兆豐-桃鶯",6,110,-104
"14759","00715L期街口布蘭特正2","110/08/17","統一-台中",230,0,230
"14760","00715L期街口布蘭特正2","110/08/17","凱基-大直",2,100,-98
"14761","8941關中","110/08/17","宏遠-館前",4,0,4
"14762","8941關中","110/08/17","凱基-高美館",0,1,-1
"14763","8941關中","110/08/17","",NA,NA,NA
"14764","8941關中","110/08/17","凱基-台北",0,1,-1
"14765","8941關中","110/08/17","",NA,NA,NA
"14766","8941關中","110/08/17","元大-南投",0,1,-1
"14767","8941關中","110/08/17","",NA,NA,NA
"14768","8941關中","110/08/17","元大-華山",0,1,-1
"14769","8941關中","110/08/17","",NA,NA,NA
"14770","8941關中","110/08/17","",NA,NA,NA
"14771","8941關中","110/08/17","",NA,NA,NA
"14772","8941關中","110/08/17","",NA,NA,NA
"14773","8941關中","110/08/17","",NA,NA,NA
"14774","8941關中","110/08/17","",NA,NA,NA
"14775","8941關中","110/08/17","",NA,NA,NA
"14776","8941關中","110/08/17","",NA,NA,NA
"14777","8941關中","110/08/17","",NA,NA,NA
"14778","8941關中","110/08/17","",NA,NA,NA
"14779","8941關中","110/08/17","",NA,NA,NA
"14780","8941關中","110/08/17","",NA,NA,NA
"14781","8941關中","110/08/17","",NA,NA,NA
"14782","8941關中","110/08/17","",NA,NA,NA
"14783","8941關中","110/08/17","",NA,NA,NA
"14784","8941關中","110/08/17","",NA,NA,NA
"14785","8941關中","110/08/17","",NA,NA,NA
"14786","8941關中","110/08/17","",NA,NA,NA
"14787","8941關中","110/08/17","",NA,NA,NA
"14788","8941關中","110/08/17","",NA,NA,NA
"14789","8941關中","110/08/17","",NA,NA,NA
"14790","8941關中","110/08/17","",NA,NA,NA
"14791","8936國統","110/08/17","台新-高雄",511,7,504
"14792","8936國統","110/08/17","凱基-高美館",20,157,-137
"14793","8936國統","110/08/17","美林",60,0,60
"14794","8936國統","110/08/17","台灣摩根士丹利",7,56,-49
"14795","8936國統","110/08/17","台中銀-高雄",33,0,33
"14796","8936國統","110/08/17","永豐金-大園",5,52,-47
"14797","8936國統","110/08/17","摩根大通",71,39,32
"14798","8936國統","110/08/17","新光-台中",16,60,-44
"14799","8936國統","110/08/17","元大-豐原站前",30,0,30
"14800","8936國統","110/08/17","國泰-敦南",14,44,-30
"14801","8936國統","110/08/17","第一金-新興",25,0,25
"14802","8936國統","110/08/17","港商野村",41,64,-23
"14803","8936國統","110/08/17","凱基-台北",45,24,21
"14804","8936國統","110/08/17","凱基-站前",0,20,-20
"14805","8936國統","110/08/17","日盛-忠孝",20,0,20
"14806","8936國統","110/08/17","國泰-高雄",3,20,-17
"14807","8936國統","110/08/17","日盛-高雄",15,0,15
"14808","8936國統","110/08/17","富邦-嘉義",0,17,-17
"14809","8936國統","110/08/17","新加坡商瑞銀",66,53,13
"14810","8936國統","110/08/17","元大-敦化",0,17,-17
"14811","8936國統","110/08/17","玉山-台南",14,3,11
"14812","8936國統","110/08/17","統一-台中",0,15,-15
"14813","8936國統","110/08/17","日盛-斗六",10,0,10
"14814","8936國統","110/08/17","兆豐-高雄",0,15,-15
"14815","8936國統","110/08/17","統一-新營",10,0,10
"14816","8936國統","110/08/17","陽信-石牌",0,15,-15
"14817","8936國統","110/08/17","元富-三重",15,5,10
"14818","8936國統","110/08/17","元大-文心",0,15,-15
"14819","8936國統","110/08/17","群益金鼎-台中",10,0,10
"14820","8936國統","110/08/17","美商高盛",8,22,-14
"14821","6226光鼎","110/08/17","國泰-台中",693,66,627
"14822","6226光鼎","110/08/17","美商高盛",21,669,-648
"14823","6226光鼎","110/08/17","摩根大通",453,306,147
"14824","6226光鼎","110/08/17","凱基-台北",116,705,-589
"14825","6226光鼎","110/08/17","日盛-員林",105,1,104
"14826","6226光鼎","110/08/17","第一金-大稻埕",101,627,-526
"14827","6226光鼎","110/08/17","永豐金-南投",80,0,80
"14828","6226光鼎","110/08/17","瑞士信貸",0,356,-356
"14829","6226光鼎","110/08/17","宏遠-光隆",60,0,60
"14830","6226光鼎","110/08/17","美林",48,202,-154
"14831","6226光鼎","110/08/17","元大-員林中山",52,0,52
"14832","6226光鼎","110/08/17","新光",74,175,-101
"14833","6226光鼎","110/08/17","合庫-鳳山",54,4,50
"14834","6226光鼎","110/08/17","元大-北屯",1,101,-100
"14835","6226光鼎","110/08/17","元大-福營",51,5,46
"14836","6226光鼎","110/08/17","台新-屏東",0,70,-70
"14837","6226光鼎","110/08/17","凱基-市府",46,4,42
"14838","6226光鼎","110/08/17","永豐金-南京",6,74,-68
"14839","6226光鼎","110/08/17","兆豐-永和",41,1,40
"14840","6226光鼎","110/08/17","元大-西螺",2,55,-53
"14841","6226光鼎","110/08/17","凱基-永和",40,1,39
"14842","6226光鼎","110/08/17","統一-基隆",0,50,-50
"14843","6226光鼎","110/08/17","元大-敦化",38,0,38
"14844","6226光鼎","110/08/17","永豐金-板橋",2,46,-44
"14845","6226光鼎","110/08/17","凱基-中山",42,5,37
"14846","6226光鼎","110/08/17","元大-草屯",2,33,-31
"14847","6226光鼎","110/08/17","國泰-桃園",131,97,34
"14848","6226光鼎","110/08/17","元大-西門",0,28,-28
"14849","6226光鼎","110/08/17","富邦-台北",55,21,34
"14850","6226光鼎","110/08/17","凱基-屏東",1,27,-26
"14851","2363矽統","110/08/17","第一金-高雄",356,4,352
"14852","2363矽統","110/08/17","瑞士信貸",86,1495,-1409
"14853","2363矽統","110/08/17","元富-永和",241,5,236
"14854","2363矽統","110/08/17","凱基-台北",737,1867,-1130
"14855","2363矽統","110/08/17","凱基-高美館",254,23,231
"14856","2363矽統","110/08/17","台灣摩根士丹利",0,438,-438
"14857","2363矽統","110/08/17","台新證券",511,295,216
"14858","2363矽統","110/08/17","元富-城東",13,409,-396
"14859","2363矽統","110/08/17","土銀-士林",189,0,189
"14860","2363矽統","110/08/17","(牛牛牛)亞-鑫豐",24,247,-223
"14861","2363矽統","110/08/17","永豐金-天母",155,0,155
"14862","2363矽統","110/08/17","美林",97,274,-177
"14863","2363矽統","110/08/17","玉山-台中",301,164,137
"14864","2363矽統","110/08/17","凱基-長庚",11,134,-123
"14865","2363矽統","110/08/17","凱基-竹北",122,5,117
"14866","2363矽統","110/08/17","元富-新店",4,115,-111
"14867","2363矽統","110/08/17","群益金鼎-三民",115,8,107
"14868","2363矽統","110/08/17","元大-北成功",142,237,-95
"14869","2363矽統","110/08/17","港商野村",1447,1350,97
"14870","2363矽統","110/08/17","日盛-木柵",70,160,-90
"14871","2363矽統","110/08/17","永豐金-新竹",105,20,85
"14872","2363矽統","110/08/17","摩根大通",240,322,-82
"14873","2363矽統","110/08/17","永豐金-松山",77,0,77
"14874","2363矽統","110/08/17","第一金-新竹",266,342,-76
"14875","2363矽統","110/08/17","富邦-宜蘭",84,11,73
"14876","2363矽統","110/08/17","華南永昌-岡山",42,110,-68
"14877","2363矽統","110/08/17","永豐金-南投",72,1,71
"14878","2363矽統","110/08/17","康和",48,112,-64
"14879","2363矽統","110/08/17","富邦-仁愛",90,22,68
"14880","2363矽統","110/08/17","華南永昌-楠梓",30,90,-60
"14881","8112至上","110/08/17","港商麥格理",158,0,158
"14882","8112至上","110/08/17","瑞士信貸",0,249,-249
"14883","8112至上","110/08/17","凱基-台北",177,49,128
"14884","8112至上","110/08/17","摩根大通",56,233,-177
"14885","8112至上","110/08/17","德信",120,0,120
"14886","8112至上","110/08/17","新加坡商瑞銀",19,179,-160
"14887","8112至上","110/08/17","台新證券",116,19,97
"14888","8112至上","110/08/17","富邦-仁愛",13,141,-128
"14889","8112至上","110/08/17","合庫-台中",75,2,73
"14890","8112至上","110/08/17","凱基-復興",1,108,-107
"14891","8112至上","110/08/17","美林",79,10,69
"14892","8112至上","110/08/17","台灣摩根士丹利",0,101,-101
"14893","8112至上","110/08/17","統一",46,0,46
"14894","8112至上","110/08/17","香港上海匯豐",0,96,-96
"14895","8112至上","110/08/17","群益金鼎-瑞豐",40,0,40
"14896","8112至上","110/08/17","群益金鼎-基隆",1,70,-69
"14897","8112至上","110/08/17","臺銀-金山",37,0,37
"14898","8112至上","110/08/17","日盛-花蓮",0,52,-52
"14899","8112至上","110/08/17","新光-高雄",37,4,33
"14900","8112至上","110/08/17","國票-北高雄",0,50,-50
"14901","8112至上","110/08/17","臺銀",41,15,26
"14902","8112至上","110/08/17","永豐金-新竹",0,48,-48
"14903","8112至上","110/08/17","元大證券",27,2,25
"14904","8112至上","110/08/17","日進",0,45,-45
"14905","8112至上","110/08/17","元大-內湖",24,0,24
"14906","8112至上","110/08/17","大展",0,30,-30
"14907","8112至上","110/08/17","國票-天祥",23,0,23
"14908","8112至上","110/08/17","港商野村",30,52,-22
"14909","8112至上","110/08/17","元大-土城永寧",23,0,23
"14910","8112至上","110/08/17","凱基-市府",1,21,-20
"14911","1570力肯","110/08/17","元大-南投",88,1,87
"14912","1570力肯","110/08/17","富邦-仁愛",0,42,-42
"14913","1570力肯","110/08/17","群益金鼎-高雄",51,10,41
"14914","1570力肯","110/08/17","元富-新竹",0,30,-30
"14915","1570力肯","110/08/17","凱基-台北",47,7,40
"14916","1570力肯","110/08/17","元大-新盛",2,28,-26
"14917","1570力肯","110/08/17","統一",29,4,25
"14918","1570力肯","110/08/17","凱基-台南",0,20,-20
"14919","1570力肯","110/08/17","元大-大雅",25,0,25
"14920","1570力肯","110/08/17","日盛-復興",0,15,-15
"14921","1570力肯","110/08/17","台新證券",24,10,14
"14922","1570力肯","110/08/17","元大-前金",1,15,-14
"14923","1570力肯","110/08/17","元大證券",14,0,14
"14924","1570力肯","110/08/17","元大-北成功",0,14,-14
"14925","1570力肯","110/08/17","日盛-板橋",12,0,12
"14926","1570力肯","110/08/17","臺銀-臺南",0,11,-11
"14927","1570力肯","110/08/17","元大-鑫永和",11,0,11
"14928","1570力肯","110/08/17","凱基-彰化",0,11,-11
"14929","1570力肯","110/08/17","富邦-內湖",10,0,10
"14930","1570力肯","110/08/17","合庫-桃園",0,10,-10
"14931","1570力肯","110/08/17","元富-緯城",10,1,9
"14932","1570力肯","110/08/17","凱基-南崁",0,10,-10
"14933","1570力肯","110/08/17","元大-開元",10,2,8
"14934","1570力肯","110/08/17","凱基-台中",0,9,-9
"14935","1570力肯","110/08/17","元大-桃興",8,1,7
"14936","1570力肯","110/08/17","華南永昌-嘉義",0,8,-8
"14937","1570力肯","110/08/17","日盛-員林",6,0,6
"14938","1570力肯","110/08/17","元大-鹿港",1,9,-8
"14939","1570力肯","110/08/17","陽信",5,0,5
"14940","1570力肯","110/08/17","國票-中正",0,7,-7
"14941","2929淘帝","110/08/17","元大-太平",48,0,48
"14942","2929淘帝","110/08/17","華南永昌-苗栗",0,30,-30
"14943","2929淘帝","110/08/17","永豐金-敦南",22,0,22
"14944","2929淘帝","110/08/17","兆豐-復興",0,15,-15
"14945","2929淘帝","110/08/17","永興",12,0,12
"14946","2929淘帝","110/08/17","凱基-長庚",0,13,-13
"14947","2929淘帝","110/08/17","日盛-復興",10,0,10
"14948","2929淘帝","110/08/17","美林",1,13,-12
"14949","2929淘帝","110/08/17","第一金-大稻埕",10,0,10
"14950","2929淘帝","110/08/17","永豐金-豐原",0,10,-10
"14951","2929淘帝","110/08/17","華南永昌-長虹",10,0,10
"14952","2929淘帝","110/08/17","華南永昌-高雄",1,10,-9
"14953","2929淘帝","110/08/17","元大-高雄",8,0,8
"14954","2929淘帝","110/08/17","日盛-南京",0,8,-8
"14955","2929淘帝","110/08/17","港商野村",12,5,7
"14956","2929淘帝","110/08/17","兆豐-大同",0,7,-7
"14957","2929淘帝","110/08/17","亞東-板橋",7,0,7
"14958","2929淘帝","110/08/17","摩根大通",0,6,-6
"14959","2929淘帝","110/08/17","國票-北高雄",6,0,6
"14960","2929淘帝","110/08/17","凱基-台中",0,5,-5
"14961","2929淘帝","110/08/17","國票-九鼎",6,0,6
"14962","2929淘帝","110/08/17","元大-鶯歌",0,5,-5
"14963","2929淘帝","110/08/17","亞東-新竹",5,0,5
"14964","2929淘帝","110/08/17","元大-上新莊",0,5,-5
"14965","2929淘帝","110/08/17","新加坡商瑞銀",4,0,4
"14966","2929淘帝","110/08/17","元大-北三重",0,5,-5
"14967","2929淘帝","110/08/17","凱基-中山",6,2,4
"14968","2929淘帝","110/08/17","第一金-澎湖",4,8,-4
"14969","2929淘帝","110/08/17","富邦-南屯",4,0,4
"14970","2929淘帝","110/08/17","日進",1,5,-4
"14971","5410國眾","110/08/17","元大-博愛",50,3,47
"14972","5410國眾","110/08/17","瑞士信貸",0,61,-61
"14973","5410國眾","110/08/17","土銀-嘉義",38,0,38
"14974","5410國眾","110/08/17","新光",3,41,-38
"14975","5410國眾","110/08/17","國票-北高雄",20,0,20
"14976","5410國眾","110/08/17","凱基-台南",2,30,-28
"14977","5410國眾","110/08/17","凱基-台北",37,22,15
"14978","5410國眾","110/08/17","元富-基隆",0,21,-21
"14979","5410國眾","110/08/17","兆豐-永和",14,0,14
"14980","5410國眾","110/08/17","富邦-新竹",1,16,-15
"14981","5410國眾","110/08/17","富邦-台北",22,10,12
"14982","5410國眾","110/08/17","亞東-新竹",0,14,-14
"14983","5410國眾","110/08/17","元大-中壢",12,0,12
"14984","5410國眾","110/08/17","群益金鼎-新竹",1,15,-14
"14985","5410國眾","110/08/17","摩根大通",25,14,11
"14986","5410國眾","110/08/17","富邦-永和",1,14,-13
"14987","5410國眾","110/08/17","日盛-花蓮",10,0,10
"14988","5410國眾","110/08/17","元大-新竹經國",0,12,-12
"14989","5410國眾","110/08/17","元富-同大",11,1,10
"14990","5410國眾","110/08/17","群益金鼎-三民",0,11,-11
"14991","5410國眾","110/08/17","凱基-科園",10,0,10
"14992","5410國眾","110/08/17","寶盛",0,10,-10
"14993","5410國眾","110/08/17","元大-潮州",10,0,10
"14994","5410國眾","110/08/17","永豐金-板橋",0,10,-10
"14995","5410國眾","110/08/17","台新-左楠",10,1,9
"14996","5410國眾","110/08/17","永豐金-竹科",1,11,-10
"14997","5410國眾","110/08/17","群益金鼎-古亭",14,5,9
"14998","5410國眾","110/08/17","臺銀",1,9,-8
"14999","5410國眾","110/08/17","永豐金-萬盛",9,0,9
"15000","5410國眾","110/08/17","群益金鼎-南京",0,8,-8
"15001","2841台開","110/08/17","宏遠-館前",169,2,167
"15002","2841台開","110/08/17","光和-溪湖",0,120,-120
"15003","2841台開","110/08/17","第一金",54,0,54
"15004","2841台開","110/08/17","兆豐-台南",0,109,-109
"15005","2841台開","110/08/17","台新-三民",50,0,50
"15006","2841台開","110/08/17","永豐金-台南",0,50,-50
"15007","2841台開","110/08/17","日盛證券",52,24,28
"15008","2841台開","110/08/17","兆豐-高雄",0,38,-38
"15009","2841台開","110/08/17","華南永昌-台中",20,0,20
"15010","2841台開","110/08/17","元大-林園",0,30,-30
"15011","2841台開","110/08/17","永豐金-中盛",17,0,17
"15012","2841台開","110/08/17","兆豐-台中",0,20,-20
"15013","2841台開","110/08/17","日盛-台中",15,0,15
"15014","2841台開","110/08/17","元大-敦化",0,20,-20
"15015","2841台開","110/08/17","日盛-園區",15,0,15
"15016","2841台開","110/08/17","元大-彰化民生",2,21,-19
"15017","2841台開","110/08/17","國泰-館前",15,0,15
"15018","2841台開","110/08/17","凱基-彰化",1,14,-13
"15019","2841台開","110/08/17","日盛-大墩",10,0,10
"15020","2841台開","110/08/17","元大-大灣",0,13,-13
"15021","2841台開","110/08/17","大慶-蘆洲",10,0,10
"15022","2841台開","110/08/17","元大-鹿港",0,11,-11
"15023","2841台開","110/08/17","凱基-員林",10,0,10
"15024","2841台開","110/08/17","兆豐-公益",0,10,-10
"15025","2841台開","110/08/17","富邦-基隆",10,0,10
"15026","2841台開","110/08/17","元大-北三重",0,10,-10
"15027","2841台開","110/08/17","元大-新竹經國",10,0,10
"15028","2841台開","110/08/17","華南永昌-鳳山",0,7,-7
"15029","2841台開","110/08/17","元富-成功",8,0,8
"15030","2841台開","110/08/17","元大-南海",0,7,-7
"15031","6207雷科","110/08/17","台新-高雄",82,2,80
"15032","6207雷科","110/08/17","第一金-員林",0,60,-60
"15033","6207雷科","110/08/17","凱基-台北",42,16,26
"15034","6207雷科","110/08/17","元大-高雄",0,47,-47
"15035","6207雷科","110/08/17","摩根大通",26,5,21
"15036","6207雷科","110/08/17","凱基-復興",0,20,-20
"15037","6207雷科","110/08/17","安泰",20,0,20
"15038","6207雷科","110/08/17","元大-新盛",1,20,-19
"15039","6207雷科","110/08/17","富邦-中壢",20,0,20
"15040","6207雷科","110/08/17","元富-大昌",0,12,-12
"15041","6207雷科","110/08/17","新加坡商瑞銀",23,6,17
"15042","6207雷科","110/08/17","華南永昌-岡山",1,12,-11
"15043","6207雷科","110/08/17","日盛-桃園",10,0,10
"15044","6207雷科","110/08/17","日盛-板橋",0,10,-10
"15045","6207雷科","110/08/17","兆豐-西螺",10,0,10
"15046","6207雷科","110/08/17","凱基-中壢",0,10,-10
"15047","6207雷科","110/08/17","中國信託-高雄",8,0,8
"15048","6207雷科","110/08/17","港商野村",7,16,-9
"15049","6207雷科","110/08/17","大昌-桃園",8,0,8
"15050","6207雷科","110/08/17","凱基-三重",1,10,-9
"15051","6207雷科","110/08/17","群益金鼎-士林",6,0,6
"15052","6207雷科","110/08/17","台新-台中",0,8,-8
"15053","6207雷科","110/08/17","美林",5,0,5
"15054","6207雷科","110/08/17","富邦-板橋",0,8,-8
"15055","6207雷科","110/08/17","中國信託-三重",5,0,5
"15056","6207雷科","110/08/17","兆豐-公益",0,6,-6
"15057","6207雷科","110/08/17","康和-內湖",5,0,5
"15058","6207雷科","110/08/17","新光-桃園",0,6,-6
"15059","6207雷科","110/08/17","新光",9,4,5
"15060","6207雷科","110/08/17","凱基-大里",0,6,-6
"15061","3679新至陞","110/08/17","台灣摩根士丹利",20,0,20
"15062","3679新至陞","110/08/17","台新證券",1,31,-30
"15063","3679新至陞","110/08/17","凱基-長庚",12,0,12
"15064","3679新至陞","110/08/17","統一",0,27,-27
"15065","3679新至陞","110/08/17","元大-大天母",12,0,12
"15066","3679新至陞","110/08/17","國票-南科",0,20,-20
"15067","3679新至陞","110/08/17","瑞士信貸",24,15,9
"15068","3679新至陞","110/08/17","國泰-忠孝",0,7,-7
"15069","3679新至陞","110/08/17","康和-板橋",6,0,6
"15070","3679新至陞","110/08/17","美林",10,15,-5
"15071","3679新至陞","110/08/17","元大-四維",6,0,6
"15072","3679新至陞","110/08/17","國泰-桃園",0,5,-5
"15073","3679新至陞","110/08/17","日盛-台中",5,0,5
"15074","3679新至陞","110/08/17","凱基-頭份",0,4,-4
"15075","3679新至陞","110/08/17","第一金-彰化",5,0,5
"15076","3679新至陞","110/08/17","港商野村",1,4,-3
"15077","3679新至陞","110/08/17","凱基-文心",5,1,4
"15078","3679新至陞","110/08/17","凱基-台北",8,11,-3
"15079","3679新至陞","110/08/17","元大-雙和",4,0,4
"15080","3679新至陞","110/08/17","元大證券",1,4,-3
"15081","3679新至陞","110/08/17","元大-草屯",4,0,4
"15082","3679新至陞","110/08/17","元大-新莊",0,3,-3
"15083","3679新至陞","110/08/17","合庫-彰化",2,0,2
"15084","3679新至陞","110/08/17","港商法國興業",0,2,-2
"15085","3679新至陞","110/08/17","臺銀-臺中",2,0,2
"15086","3679新至陞","110/08/17","元富-板橋",0,2,-2
"15087","3679新至陞","110/08/17","日盛-文化",3,1,2
"15088","3679新至陞","110/08/17","康和-高雄",0,2,-2
"15089","3679新至陞","110/08/17","永豐金-敦南",2,0,2
"15090","3679新至陞","110/08/17","群益金鼎-三重",0,2,-2
"15091","2727王品","110/08/17","凱基-台北",63,1,62
"15092","2727王品","110/08/17","第一金-高雄",1,111,-110
"15093","2727王品","110/08/17","台灣摩根士丹利",86,37,49
"15094","2727王品","110/08/17","摩根大通",29,118,-89
"15095","2727王品","110/08/17","瑞士信貸",32,0,32
"15096","2727王品","110/08/17","永豐金證券",0,83,-83
"15097","2727王品","110/08/17","元大-北屯",32,1,31
"15098","2727王品","110/08/17","華南永昌",1,38,-37
"15099","2727王品","110/08/17","美林",37,8,29
"15100","2727王品","110/08/17","合庫-新竹",1,31,-30
"15101","2727王品","110/08/17","凱基-市政",23,0,23
"15102","2727王品","110/08/17","中國信託-新竹",1,23,-22
"15103","2727王品","110/08/17","港商野村",74,54,20
"15104","2727王品","110/08/17","玉山證券",16,33,-17
"15105","2727王品","110/08/17","元大-板橋",20,0,20
"15106","2727王品","110/08/17","富邦-台北",5,19,-14
"15107","2727王品","110/08/17","元大-汐止",12,0,12
"15108","2727王品","110/08/17","群益金鼎-中壢",1,14,-13
"15109","2727王品","110/08/17","元大-龍潭",19,8,11
"15110","2727王品","110/08/17","富邦證券",0,13,-13
"15111","2727王品","110/08/17","元富",10,0,10
"15112","2727王品","110/08/17","元大證券",9,22,-13
"15113","2727王品","110/08/17","彰銀-台中",9,0,9
"15114","2727王品","110/08/17","聯邦商銀",0,12,-12
"15115","2727王品","110/08/17","中國信託",11,2,9
"15116","2727王品","110/08/17","日盛-屏東",7,17,-10
"15117","2727王品","110/08/17","群益金鼎-西松",10,1,9
"15118","2727王品","110/08/17","康和-高雄",0,10,-10
"15119","2727王品","110/08/17","第一金-自由",8,0,8
"15120","2727王品","110/08/17","新光-高雄",1,11,-10
"15121","1570力肯","110/08/17","元大-南投",88,1,87
"15122","1570力肯","110/08/17","富邦-仁愛",0,42,-42
"15123","1570力肯","110/08/17","群益金鼎-高雄",51,10,41
"15124","1570力肯","110/08/17","元富-新竹",0,30,-30
"15125","1570力肯","110/08/17","凱基-台北",47,7,40
"15126","1570力肯","110/08/17","元大-新盛",2,28,-26
"15127","1570力肯","110/08/17","統一",29,4,25
"15128","1570力肯","110/08/17","凱基-台南",0,20,-20
"15129","1570力肯","110/08/17","元大-大雅",25,0,25
"15130","1570力肯","110/08/17","日盛-復興",0,15,-15
"15131","1570力肯","110/08/17","台新證券",24,10,14
"15132","1570力肯","110/08/17","元大-前金",1,15,-14
"15133","1570力肯","110/08/17","元大證券",14,0,14
"15134","1570力肯","110/08/17","元大-北成功",0,14,-14
"15135","1570力肯","110/08/17","日盛-板橋",12,0,12
"15136","1570力肯","110/08/17","臺銀-臺南",0,11,-11
"15137","1570力肯","110/08/17","元大-鑫永和",11,0,11
"15138","1570力肯","110/08/17","凱基-彰化",0,11,-11
"15139","1570力肯","110/08/17","富邦-內湖",10,0,10
"15140","1570力肯","110/08/17","合庫-桃園",0,10,-10
"15141","1570力肯","110/08/17","元富-緯城",10,1,9
"15142","1570力肯","110/08/17","凱基-南崁",0,10,-10
"15143","1570力肯","110/08/17","元大-開元",10,2,8
"15144","1570力肯","110/08/17","凱基-台中",0,9,-9
"15145","1570力肯","110/08/17","元大-桃興",8,1,7
"15146","1570力肯","110/08/17","華南永昌-嘉義",0,8,-8
"15147","1570力肯","110/08/17","日盛-員林",6,0,6
"15148","1570力肯","110/08/17","元大-鹿港",1,9,-8
"15149","1570力肯","110/08/17","陽信",5,0,5
"15150","1570力肯","110/08/17","國票-中正",0,7,-7
"15151","6180橘子","110/08/17","摩根大通",107,25,82
"15152","6180橘子","110/08/17","元大-高雄",0,50,-50
"15153","6180橘子","110/08/17","美林",59,0,59
"15154","6180橘子","110/08/17","第一金-新竹",1,30,-29
"15155","6180橘子","110/08/17","美商高盛",31,0,31
"15156","6180橘子","110/08/17","台新-建北",1,25,-24
"15157","6180橘子","110/08/17","凱基-台北",32,6,26
"15158","6180橘子","110/08/17","群益金鼎-大安",0,20,-20
"15159","6180橘子","110/08/17","合庫-自強",10,0,10
"15160","6180橘子","110/08/17","台灣摩根士丹利",37,54,-17
"15161","6180橘子","110/08/17","元富-世貿",10,0,10
"15162","6180橘子","110/08/17","玉山-台南",1,13,-12
"15163","6180橘子","110/08/17","元大-台中中港",10,0,10
"15164","6180橘子","110/08/17","富邦-基隆",0,11,-11
"15165","6180橘子","110/08/17","臺銀-金山",11,2,9
"15166","6180橘子","110/08/17","日盛-雙和",0,10,-10
"15167","6180橘子","110/08/17","華南永昌-虎尾",8,0,8
"15168","6180橘子","110/08/17","統一-台南",0,10,-10
"15169","6180橘子","110/08/17","元大-彰化民生",7,0,7
"15170","6180橘子","110/08/17","新光-桃園",0,10,-10
"15171","6180橘子","110/08/17","群益金鼎-嘉義",6,0,6
"15172","6180橘子","110/08/17","凱基-竹北",0,10,-10
"15173","6180橘子","110/08/17","元大-太平",6,0,6
"15174","6180橘子","110/08/17","元大-基隆孝二",0,10,-10
"15175","6180橘子","110/08/17","永豐金-敦北",6,0,6
"15176","6180橘子","110/08/17","永豐金-大園",0,10,-10
"15177","6180橘子","110/08/17","華南永昌-台中",5,0,5
"15178","6180橘子","110/08/17","第一金-中山",0,8,-8
"15179","6180橘子","110/08/17","元大-永春",5,0,5
"15180","6180橘子","110/08/17","台新證券",4,12,-8
"15181","2390云辰","110/08/17","美林",601,355,246
"15182","2390云辰","110/08/17","富邦-虎尾",786,1240,-454
"15183","2390云辰","110/08/17","凱基-台北",999,859,140
"15184","2390云辰","110/08/17","富隆-長安",2,262,-260
"15185","2390云辰","110/08/17","新光",1508,1370,138
"15186","2390云辰","110/08/17","摩根大通",2924,3174,-250
"15187","2390云辰","110/08/17","國泰-敦南",1264,1133,131
"15188","2390云辰","110/08/17","元大-木柵",204,419,-215
"15189","2390云辰","110/08/17","富邦-內湖",143,18,125
"15190","2390云辰","110/08/17","兆豐-埔墘",10,165,-155
"15191","2390云辰","110/08/17","統一-新營",142,28,114
"15192","2390云辰","110/08/17","美商高盛",332,483,-151
"15193","2390云辰","110/08/17","兆豐-虎尾",107,5,102
"15194","2390云辰","110/08/17","元大-大同",829,966,-137
"15195","2390云辰","110/08/17","新加坡商瑞銀",274,177,97
"15196","2390云辰","110/08/17","元大-土城學府",236,367,-131
"15197","2390云辰","110/08/17","元大-上新莊",82,9,73
"15198","2390云辰","110/08/17","富邦-花蓮",5,107,-102
"15199","2390云辰","110/08/17","凱基-民權",145,78,67
"15200","2390云辰","110/08/17","元大-台中",20,118,-98
"15201","2390云辰","110/08/17","富邦-彰化",200,133,67
"15202","2390云辰","110/08/17","群益金鼎-開元",70,150,-80
"15203","2390云辰","110/08/17","宏遠-桃園",67,5,62
"15204","2390云辰","110/08/17","永豐金-古亭",27,106,-79
"15205","2390云辰","110/08/17","港商野村",2090,2030,60
"15206","2390云辰","110/08/17","土銀-士林",0,78,-78
"15207","2390云辰","110/08/17","永豐金-萬盛",76,17,59
"15208","2390云辰","110/08/17","元富-高雄",94,166,-72
"15209","2390云辰","110/08/17","元大-歸仁",85,34,51
"15210","2390云辰","110/08/17","富邦-敦南",40,108,-68
"15211","2609陽明","110/08/16","康和",4181,128,4053
"15212","2609陽明","110/08/16","凱基-台北",1053,19933,-18880
"15213","2609陽明","110/08/16","宏遠證券",2579,659,1920
"15214","2609陽明","110/08/16","群益金鼎-三重",162,5149,-4987
"15215","2609陽明","110/08/16","華南永昌-竹北",2072,225,1847
"15216","2609陽明","110/08/16","兆豐-南京",3041,5871,-2830
"15217","2609陽明","110/08/16","凱基-虎尾",4140,2400,1740
"15218","2609陽明","110/08/16","中國信託-松江",116,2823,-2707
"15219","2609陽明","110/08/16","元大證券",8157,7010,1147
"15220","2609陽明","110/08/16","兆豐-復興",107,2607,-2500
"15221","2609陽明","110/08/16","摩根大通",5939,5074,865
"15222","2609陽明","110/08/16","美林",2802,5073,-2271
"15223","2609陽明","110/08/16","永豐金-信義",865,85,780
"15224","2609陽明","110/08/16","兆豐-三民",182,2181,-1999
"15225","2609陽明","110/08/16","元大-頭份",1005,248,757
"15226","2609陽明","110/08/16","新加坡商瑞銀",561,2511,-1950
"15227","2609陽明","110/08/16","港商野村",2920,2184,736
"15228","2609陽明","110/08/16","凱基-城中",585,1560,-975
"15229","2609陽明","110/08/16","元大-信義",944,209,735
"15230","2609陽明","110/08/16","元大-竹科",394,1326,-932
"15231","2609陽明","110/08/16","凱基-市政",14533,13859,674
"15232","2609陽明","110/08/16","群益金鼎-大安",89,951,-862
"15233","2609陽明","110/08/16","富邦-嘉義",7027,6481,546
"15234","2609陽明","110/08/16","瑞士信貸",910,1607,-697
"15235","2609陽明","110/08/16","新光-新竹",1792,1331,461
"15236","2609陽明","110/08/16","兆豐-新竹",305,932,-627
"15237","2609陽明","110/08/16","凱基-台南",808,378,430
"15238","2609陽明","110/08/16","元大-永春",376,856,-480
"15239","2609陽明","110/08/16","凱基-信義",434,31,403
"15240","2609陽明","110/08/16","元富",483,956,-473
"15241","2636台驊投控","110/08/16","凱基",893,138,755
"15242","2636台驊投控","110/08/16","日盛-台中",36,221,-185
"15243","2636台驊投控","110/08/16","瑞士信貸",524,17,507
"15244","2636台驊投控","110/08/16","統一-新竹",4,188,-184
"15245","2636台驊投控","110/08/16","台灣摩根士丹利",534,35,499
"15246","2636台驊投控","110/08/16","國泰-敦南",291,403,-112
"15247","2636台驊投控","110/08/16","富邦-花蓮",283,25,258
"15248","2636台驊投控","110/08/16","新光",259,366,-107
"15249","2636台驊投控","110/08/16","新光-新竹",349,144,205
"15250","2636台驊投控","110/08/16","群益金鼎",89,185,-96
"15251","2636台驊投控","110/08/16","國票-彰化",442,282,160
"15252","2636台驊投控","110/08/16","新光-桃園",22,98,-76
"15253","2636台驊投控","110/08/16","大慶",160,1,159
"15254","2636台驊投控","110/08/16","群益金鼎-南京",57,126,-69
"15255","2636台驊投控","110/08/16","富邦-虎尾",144,13,131
"15256","2636台驊投控","110/08/16","玉山-台南",61,127,-66
"15257","2636台驊投控","110/08/16","元大-士林",118,2,116
"15258","2636台驊投控","110/08/16","元富-大昌",5,66,-61
"15259","2636台驊投控","110/08/16","摩根大通",799,698,101
"15260","2636台驊投控","110/08/16","日盛證券",78,137,-59
"15261","2636台驊投控","110/08/16","日盛-宜蘭",100,3,97
"15262","2636台驊投控","110/08/16","凱基-市政",13,68,-55
"15263","2636台驊投控","110/08/16","凱基-台北",786,690,96
"15264","2636台驊投控","110/08/16","兆豐-城中",7,58,-51
"15265","2636台驊投控","110/08/16","兆豐-東門",101,31,70
"15266","2636台驊投控","110/08/16","永豐金-新竹",33,83,-50
"15267","2636台驊投控","110/08/16","凱基-長庚",66,6,60
"15268","2636台驊投控","110/08/16","國泰-台中",69,115,-46
"15269","2636台驊投控","110/08/16","元富-中壢",76,18,58
"15270","2636台驊投控","110/08/16","國票-九鼎",18,61,-43
"15271","2867三商壽","110/08/16","兆豐-大同",800,0,800
"15272","2867三商壽","110/08/16","台新證券",7,983,-976
"15273","2867三商壽","110/08/16","元富-世貿",646,5,641
"15274","2867三商壽","110/08/16","美林",0,406,-406
"15275","2867三商壽","110/08/16","元大-土城永寧",320,0,320
"15276","2867三商壽","110/08/16","(牛牛牛)亞-鑫豐",15,120,-105
"15277","2867三商壽","110/08/16","新加坡商瑞銀",241,18,223
"15278","2867三商壽","110/08/16","土銀",0,100,-100
"15279","2867三商壽","110/08/16","玉山-城中",156,0,156
"15280","2867三商壽","110/08/16","兆豐-來福",0,100,-100
"15281","2867三商壽","110/08/16","元大-桃園",100,0,100
"15282","2867三商壽","110/08/16","凱基-虎尾",0,90,-90
"15283","2867三商壽","110/08/16","高橋-龍潭",87,1,86
"15284","2867三商壽","110/08/16","瑞士信貸",53,140,-87
"15285","2867三商壽","110/08/16","富邦-員林",79,0,79
"15286","2867三商壽","110/08/16","花旗環球",7,83,-76
"15287","2867三商壽","110/08/16","華南永昌-高雄",50,0,50
"15288","2867三商壽","110/08/16","元大-大同",0,67,-67
"15289","2867三商壽","110/08/16","元大-崇德",50,0,50
"15290","2867三商壽","110/08/16","日盛-板橋",0,60,-60
"15291","2867三商壽","110/08/16","華南永昌-虎尾",40,0,40
"15292","2867三商壽","110/08/16","元大-博愛",2,62,-60
"15293","2867三商壽","110/08/16","元大-大統",40,0,40
"15294","2867三商壽","110/08/16","(牛牛牛)亞-網路",0,55,-55
"15295","2867三商壽","110/08/16","新光",87,48,39
"15296","2867三商壽","110/08/16","美商高盛",105,158,-53
"15297","2867三商壽","110/08/16","元大-大安",36,0,36
"15298","2867三商壽","110/08/16","永豐金-屏東",1,52,-51
"15299","2867三商壽","110/08/16","群益金鼎-西松",35,0,35
"15300","2867三商壽","110/08/16","兆豐-台中港",0,50,-50
"15301","5521工信","110/08/16","第一金-新竹",84,0,84
"15302","5521工信","110/08/16","摩根大通",83,306,-223
"15303","5521工信","110/08/16","日進",60,0,60
"15304","5521工信","110/08/16","日盛證券",0,70,-70
"15305","5521工信","110/08/16","凱基-中壢",40,0,40
"15306","5521工信","110/08/16","群益金鼎-海山",0,40,-40
"15307","5521工信","110/08/16","台新證券",37,0,37
"15308","5521工信","110/08/16","華南永昌",0,39,-39
"15309","5521工信","110/08/16","群益金鼎-台中",35,0,35
"15310","5521工信","110/08/16","美林",5,43,-38
"15311","5521工信","110/08/16","富邦-台北",30,0,30
"15312","5521工信","110/08/16","康和-澎湖",0,30,-30
"15313","5521工信","110/08/16","元大-永和",30,0,30
"15314","5521工信","110/08/16","華南永昌-彰化",5,34,-29
"15315","5521工信","110/08/16","華南永昌-潮州",28,0,28
"15316","5521工信","110/08/16","元大-龍潭",0,25,-25
"15317","5521工信","110/08/16","玉山-嘉義",23,0,23
"15318","5521工信","110/08/16","兆豐-桃園",0,24,-24
"15319","5521工信","110/08/16","元大-新莊",40,17,23
"15320","5521工信","110/08/16","華南永昌-林口",1,25,-24
"15321","5521工信","110/08/16","第一金-桃園",22,0,22
"15322","5521工信","110/08/16","台灣企銀-台中",0,20,-20
"15323","5521工信","110/08/16","凱基-鳳山",20,0,20
"15324","5521工信","110/08/16","第一金-台南",0,20,-20
"15325","5521工信","110/08/16","元大-路竹",20,0,20
"15326","5521工信","110/08/16","元富-古亭",0,20,-20
"15327","5521工信","110/08/16","合庫-桃園",20,1,19
"15328","5521工信","110/08/16","兆豐-中壢",0,20,-20
"15329","5521工信","110/08/16","臺銀-鳳山",21,2,19
"15330","5521工信","110/08/16","元大-仁愛",0,20,-20
"15331","1471首利","110/08/16","摩根大通",196,88,108
"15332","1471首利","110/08/16","元大-草屯",1,200,-199
"15333","1471首利","110/08/16","瑞士信貸",95,17,78
"15334","1471首利","110/08/16","元富-埔里",0,51,-51
"15335","1471首利","110/08/16","新加坡商瑞銀",38,0,38
"15336","1471首利","110/08/16","凱基-雙和",0,40,-40
"15337","1471首利","110/08/16","國泰-敦南",37,2,35
"15338","1471首利","110/08/16","華南永昌-公誠",0,40,-40
"15339","1471首利","110/08/16","凱基-彰化",31,0,31
"15340","1471首利","110/08/16","元大-大灣",0,36,-36
"15341","1471首利","110/08/16","光和-溪湖",20,0,20
"15342","1471首利","110/08/16","新光-台中",17,42,-25
"15343","1471首利","110/08/16","國票-中港",20,0,20
"15344","1471首利","110/08/16","富邦-仁愛",0,25,-25
"15345","1471首利","110/08/16","美林",15,0,15
"15346","1471首利","110/08/16","群益金鼎-台北",0,24,-24
"15347","1471首利","110/08/16","元大-板橋",15,0,15
"15348","1471首利","110/08/16","永豐金-竹北",0,22,-22
"15349","1471首利","110/08/16","凱基-長庚",16,2,14
"15350","1471首利","110/08/16","合庫-台中",0,20,-20
"15351","1471首利","110/08/16","元大-斗信",14,0,14
"15352","1471首利","110/08/16","高橋-龍潭",2,22,-20
"15353","1471首利","110/08/16","第一金-高雄",12,0,12
"15354","1471首利","110/08/16","國票-台中",0,20,-20
"15355","1471首利","110/08/16","玉山-大里",12,0,12
"15356","1471首利","110/08/16","群益金鼎-潭子",0,20,-20
"15357","1471首利","110/08/16","永豐金-大園",12,0,12
"15358","1471首利","110/08/16","台新證券",2,19,-17
"15359","1471首利","110/08/16","永豐金-中正",12,0,12
"15360","1471首利","110/08/16","聯邦-高雄",0,15,-15
"15361","2883開發金","110/08/16","中國信託-文心",4881,27,4854
"15362","2883開發金","110/08/16","摩根大通",1712,30864,-29152
"15363","2883開發金","110/08/16","國泰-敦南",3101,627,2474
"15364","2883開發金","110/08/16","台灣摩根士丹利",453,18916,-18463
"15365","2883開發金","110/08/16","亞東-新竹",3614,1222,2392
"15366","2883開發金","110/08/16","凱基-台北",8208,20874,-12666
"15367","2883開發金","110/08/16","花旗環球",3115,841,2274
"15368","2883開發金","110/08/16","新加坡商瑞銀",363,11873,-11510
"15369","2883開發金","110/08/16","元大證券",3308,1099,2209
"15370","2883開發金","110/08/16","美林",130,9722,-9592
"15371","2883開發金","110/08/16","康和-仁愛",2103,0,2103
"15372","2883開發金","110/08/16","統一",766,7210,-6444
"15373","2883開發金","110/08/16","玉山-大里",1874,31,1843
"15374","2883開發金","110/08/16","元富",48,5683,-5635
"15375","2883開發金","110/08/16","第一金-忠孝",1836,3,1833
"15376","2883開發金","110/08/16","富邦證券",147,4117,-3970
"15377","2883開發金","110/08/16","宏遠證券",1825,5,1820
"15378","2883開發金","110/08/16","國票-長城",22,2713,-2691
"15379","2883開發金","110/08/16","統一-新竹",1630,2,1628
"15380","2883開發金","110/08/16","台新證券",1753,4439,-2686
"15381","2883開發金","110/08/16","國泰-板橋",1493,346,1147
"15382","2883開發金","110/08/16","元大-士林",417,2698,-2281
"15383","2883開發金","110/08/16","國泰-館前",1856,775,1081
"15384","2883開發金","110/08/16","港商野村",3026,5159,-2133
"15385","2883開發金","110/08/16","群益金鼎-高盛",1005,12,993
"15386","2883開發金","110/08/16","瑞士信貸",1295,3237,-1942
"15387","2883開發金","110/08/16","元大-新莊",860,16,844
"15388","2883開發金","110/08/16","美商高盛",162,1917,-1755
"15389","2883開發金","110/08/16","臺銀",807,32,775
"15390","2883開發金","110/08/16","國泰證券",290,1593,-1303
"15391","6205詮欣","110/08/16","凱基-汐止",22,0,22
"15392","6205詮欣","110/08/16","凱基-台北",0,10,-10
"15393","6205詮欣","110/08/16","臺銀-民權",10,0,10
"15394","6205詮欣","110/08/16","永興-水湳",0,6,-6
"15395","6205詮欣","110/08/16","德信-新營",6,0,6
"15396","6205詮欣","110/08/16","國票-博愛",0,6,-6
"15397","6205詮欣","110/08/16","玉山證券",5,0,5
"15398","6205詮欣","110/08/16","日盛-三重",5,10,-5
"15399","6205詮欣","110/08/16","亞東-板橋",4,0,4
"15400","6205詮欣","110/08/16","日盛-永康",0,5,-5
"15401","6205詮欣","110/08/16","元大-羅東",4,0,4
"15402","6205詮欣","110/08/16","摩根大通",0,5,-5
"15403","6205詮欣","110/08/16","元大-汐止",4,0,4
"15404","6205詮欣","110/08/16","玉山-台南",0,5,-5
"15405","6205詮欣","110/08/16","臺銀-高雄",3,0,3
"15406","6205詮欣","110/08/16","元大-大天母",0,4,-4
"15407","6205詮欣","110/08/16","美林",2,0,2
"15408","6205詮欣","110/08/16","永豐金-中盛",0,3,-3
"15409","6205詮欣","110/08/16","群益金鼎-基隆",2,0,2
"15410","6205詮欣","110/08/16","華南永昌-彰化",0,2,-2
"15411","6205詮欣","110/08/16","合庫-三重",1,0,1
"15412","6205詮欣","110/08/16","富邦-中壢",0,2,-2
"15413","6205詮欣","110/08/16","(牛牛牛)亞-網路",1,0,1
"15414","6205詮欣","110/08/16","元大-成功",0,2,-2
"15415","6205詮欣","110/08/16","豐農",1,0,1
"15416","6205詮欣","110/08/16","統一-士林",0,1,-1
"15417","6205詮欣","110/08/16","凱基-站前",1,0,1
"15418","6205詮欣","110/08/16","統一-金門",0,1,-1
"15419","6205詮欣","110/08/16","富邦-建國",1,0,1
"15420","6205詮欣","110/08/16","元富-文心",0,1,-1
"15421","1540喬福","110/08/16","元大-成功",25,0,25
"15422","1540喬福","110/08/16","凱基-台北",0,51,-51
"15423","1540喬福","110/08/16","新光",16,0,16
"15424","1540喬福","110/08/16","新光-新竹",10,29,-19
"15425","1540喬福","110/08/16","日盛-鳳山",10,0,10
"15426","1540喬福","110/08/16","元大-北屯",0,18,-18
"15427","1540喬福","110/08/16","台新-左楠",10,0,10
"15428","1540喬福","110/08/16","北城證券",0,16,-16
"15429","1540喬福","110/08/16","玉山-左營",10,0,10
"15430","1540喬福","110/08/16","國泰-敦南",2,18,-16
"15431","1540喬福","110/08/16","富邦-南屯",10,0,10
"15432","1540喬福","110/08/16","新光-桃園",0,15,-15
"15433","1540喬福","110/08/16","富邦-板橋",8,0,8
"15434","1540喬福","110/08/16","新光-台南",0,12,-12
"15435","1540喬福","110/08/16","凱基-中壢",7,0,7
"15436","1540喬福","110/08/16","凱基-台中",0,12,-12
"15437","1540喬福","110/08/16","元富-新竹",5,0,5
"15438","1540喬福","110/08/16","元大-汐止",0,10,-10
"15439","1540喬福","110/08/16","兆豐-北高雄",5,0,5
"15440","1540喬福","110/08/16","凱基-竹北",0,7,-7
"15441","1540喬福","110/08/16","台新-台中",5,0,5
"15442","1540喬福","110/08/16","日盛-文化",0,4,-4
"15443","1540喬福","110/08/16","凱基-台南",5,0,5
"15444","1540喬福","110/08/16","富邦-桃園",0,3,-3
"15445","1540喬福","110/08/16","元大-龍潭",5,0,5
"15446","1540喬福","110/08/16","摩根大通",1,3,-2
"15447","1540喬福","110/08/16","元富-緯城",4,0,4
"15448","1540喬福","110/08/16","玉山-城中",0,2,-2
"15449","1540喬福","110/08/16","元大-大安",4,0,4
"15450","1540喬福","110/08/16","永豐金-桃園",0,2,-2
"15451","2888新光金","110/08/16","兆豐-公益",12939,12,12927
"15452","2888新光金","110/08/16","摩根大通",2056,10998,-8942
"15453","2888新光金","110/08/16","元大-忠孝鼎富",11100,189,10911
"15454","2888新光金","110/08/16","元富-城東",25,8381,-8356
"15455","2888新光金","110/08/16","港商麥格理",9753,0,9753
"15456","2888新光金","110/08/16","元富",6,7491,-7485
"15457","2888新光金","110/08/16","群益金鼎-大安",3294,0,3294
"15458","2888新光金","110/08/16","美林",136,3975,-3839
"15459","2888新光金","110/08/16","凱基-復興",3020,0,3020
"15460","2888新光金","110/08/16","臺銀-高雄",19,3007,-2988
"15461","2888新光金","110/08/16","美商高盛",5603,3216,2387
"15462","2888新光金","110/08/16","台灣摩根士丹利",419,2562,-2143
"15463","2888新光金","110/08/16","國票-台東",2067,0,2067
"15464","2888新光金","110/08/16","瑞士信貸",58,1618,-1560
"15465","2888新光金","110/08/16","群益金鼎-台北",1872,0,1872
"15466","2888新光金","110/08/16","玉山-新竹",0,1497,-1497
"15467","2888新光金","110/08/16","新加坡商瑞銀",2005,179,1826
"15468","2888新光金","110/08/16","國票-博愛",3,1208,-1205
"15469","2888新光金","110/08/16","華南永昌-忠孝",1827,90,1737
"15470","2888新光金","110/08/16","元大-士林",85,1185,-1100
"15471","2888新光金","110/08/16","富邦-新營",1400,0,1400
"15472","2888新光金","110/08/16","臺銀-民權",19,1095,-1076
"15473","2888新光金","110/08/16","華南永昌-鳳山",1174,11,1163
"15474","2888新光金","110/08/16","法銀巴黎",0,868,-868
"15475","2888新光金","110/08/16","元大-員林",1051,12,1039
"15476","2888新光金","110/08/16","群益金鼎",10,847,-837
"15477","2888新光金","110/08/16","富邦-高雄",1015,11,1004
"15478","2888新光金","110/08/16","元富-世貿",7,794,-787
"15479","2888新光金","110/08/16","日盛-南京",1000,5,995
"15480","2888新光金","110/08/16","國票-安和",0,724,-724
"15481","1340勝悅","110/08/16","元富-成功",30,0,30
"15482","1340勝悅","110/08/16","元富-城東",0,107,-107
"15483","1340勝悅","110/08/16","華南永昌-公誠",30,0,30
"15484","1340勝悅","110/08/16","永豐金-竹科",0,38,-38
"15485","1340勝悅","110/08/16","華南永昌-敦南",25,0,25
"15486","1340勝悅","110/08/16","德信-新營",0,30,-30
"15487","1340勝悅","110/08/16","合庫-自強",15,0,15
"15488","1340勝悅","110/08/16","國泰-松江",0,15,-15
"15489","1340勝悅","110/08/16","臺銀-鳳山",15,0,15
"15490","1340勝悅","110/08/16","摩根大通",5,17,-12
"15491","1340勝悅","110/08/16","元富-中港",10,0,10
"15492","1340勝悅","110/08/16","港商法國興業",0,11,-11
"15493","1340勝悅","110/08/16","永豐金-南京",10,0,10
"15494","1340勝悅","110/08/16","玉山-高雄",0,10,-10
"15495","1340勝悅","110/08/16","新光",9,0,9
"15496","1340勝悅","110/08/16","凱基-台北",0,10,-10
"15497","1340勝悅","110/08/16","國泰-台中",14,7,7
"15498","1340勝悅","110/08/16","華南永昌-嘉義",0,10,-10
"15499","1340勝悅","110/08/16","元大-苗栗",6,0,6
"15500","1340勝悅","110/08/16","合庫-台南",0,6,-6
"15501","1340勝悅","110/08/16","元大-屏南",6,0,6
"15502","1340勝悅","110/08/16","玉山-桃園",0,5,-5
"15503","1340勝悅","110/08/16","臺灣企銀-埔墘",5,0,5
"15504","1340勝悅","110/08/16","永豐金-博愛",0,5,-5
"15505","1340勝悅","110/08/16","日盛-板橋",5,0,5
"15506","1340勝悅","110/08/16","美林",0,2,-2
"15507","1340勝悅","110/08/16","致和-東門",5,0,5
"15508","1340勝悅","110/08/16","兆豐-城中",0,2,-2
"15509","1340勝悅","110/08/16","群益金鼎-館前",7,2,5
"15510","1340勝悅","110/08/16","元大-大雅",0,2,-2
"15511","6246臺龍","110/08/16","元大-南投",25,5,20
"15512","6246臺龍","110/08/16","元大-中壢",9,26,-17
"15513","6246臺龍","110/08/16","港商野村",65,46,19
"15514","6246臺龍","110/08/16","台新-台中",1,15,-14
"15515","6246臺龍","110/08/16","華南永昌",23,5,18
"15516","6246臺龍","110/08/16","群益金鼎-開元",0,12,-12
"15517","6246臺龍","110/08/16","華南永昌-彰化",15,4,11
"15518","6246臺龍","110/08/16","凱基-苗栗",0,7,-7
"15519","6246臺龍","110/08/16","統一-台中",10,0,10
"15520","6246臺龍","110/08/16","日盛-鳳山",0,6,-6
"15521","6246臺龍","110/08/16","兆豐-新營",11,1,10
"15522","6246臺龍","110/08/16","台新證券",4,10,-6
"15523","6246臺龍","110/08/16","玉山-桃園",10,0,10
"15524","6246臺龍","110/08/16","新光",4,10,-6
"15525","6246臺龍","110/08/16","凱基-台北",12,2,10
"15526","6246臺龍","110/08/16","華南永昌-嘉義",0,6,-6
"15527","6246臺龍","110/08/16","群益金鼎-東大",9,0,9
"15528","6246臺龍","110/08/16","元大-竹北",0,6,-6
"15529","6246臺龍","110/08/16","元富-中港",6,0,6
"15530","6246臺龍","110/08/16","元大-永康",0,6,-6
"15531","6246臺龍","110/08/16","德信-新營",6,0,6
"15532","6246臺龍","110/08/16","元富-新店",0,5,-5
"15533","6246臺龍","110/08/16","兆豐-西螺",5,0,5
"15534","6246臺龍","110/08/16","台中銀",0,5,-5
"15535","6246臺龍","110/08/16","群益金鼎-土城",5,0,5
"15536","6246臺龍","110/08/16","群益金鼎-永和",0,5,-5
"15537","6246臺龍","110/08/16","富邦-仁愛",5,0,5
"15538","6246臺龍","110/08/16","元大-台南",0,5,-5
"15539","6246臺龍","110/08/16","元大-基隆孝二",7,2,5
"15540","6246臺龍","110/08/16","元大-土城",0,5,-5
"15541","00715L期街口布蘭特正2","110/08/16","元富",1720,5,1715
"15542","00715L期街口布蘭特正2","110/08/16","元大證券",365,4674,-4309
"15543","00715L期街口布蘭特正2","110/08/16","港商野村",1350,660,690
"15544","00715L期街口布蘭特正2","110/08/16","華南永昌-長虹",50,820,-770
"15545","00715L期街口布蘭特正2","110/08/16","(牛牛牛)亞-鑫豐",587,51,536
"15546","00715L期街口布蘭特正2","110/08/16","凱基-台北",42,470,-428
"15547","00715L期街口布蘭特正2","110/08/16","富邦-嘉義",405,0,405
"15548","00715L期街口布蘭特正2","110/08/16","永豐金證券",5,360,-355
"15549","00715L期街口布蘭特正2","110/08/16","兆豐-嘉義",303,0,303
"15550","00715L期街口布蘭特正2","110/08/16","元大-復北",1,333,-332
"15551","00715L期街口布蘭特正2","110/08/16","元大-學甲",272,0,272
"15552","00715L期街口布蘭特正2","110/08/16","兆豐-新莊",0,306,-306
"15553","00715L期街口布蘭特正2","110/08/16","元大-中和",308,52,256
"15554","00715L期街口布蘭特正2","110/08/16","凱基-松山",0,302,-302
"15555","00715L期街口布蘭特正2","110/08/16","新光",318,84,234
"15556","00715L期街口布蘭特正2","110/08/16","統一-桃園",7,280,-273
"15557","00715L期街口布蘭特正2","110/08/16","元大-北港",165,0,165
"15558","00715L期街口布蘭特正2","110/08/16","日盛-板橋",31,300,-269
"15559","00715L期街口布蘭特正2","110/08/16","台中銀",202,45,157
"15560","00715L期街口布蘭特正2","110/08/16","凱基",0,250,-250
"15561","00715L期街口布蘭特正2","110/08/16","元大-台中中港",157,0,157
"15562","00715L期街口布蘭特正2","110/08/16","富邦-仁愛",11,250,-239
"15563","00715L期街口布蘭特正2","110/08/16","元大-花蓮",150,4,146
"15564","00715L期街口布蘭特正2","110/08/16","台新-台中",34,262,-228
"15565","00715L期街口布蘭特正2","110/08/16","統一-台中",165,32,133
"15566","00715L期街口布蘭特正2","110/08/16","元富-吉利",5,210,-205
"15567","00715L期街口布蘭特正2","110/08/16","永全-南崁",130,0,130
"15568","00715L期街口布蘭特正2","110/08/16","康和",0,150,-150
"15569","00715L期街口布蘭特正2","110/08/16","元富-中壢",223,100,123
"15570","00715L期街口布蘭特正2","110/08/16","兆豐-台中港",53,190,-137
"15571","8941關中","110/08/16","凱基-市府",4,0,4
"15572","8941關中","110/08/16","統一-台中",0,3,-3
"15573","8941關中","110/08/16","(牛牛牛)亞-鑫豐",2,1,1
"15574","8941關中","110/08/16","宏遠-中和",0,1,-1
"15575","8941關中","110/08/16","富邦-左營",1,0,1
"15576","8941關中","110/08/16","富邦-竹北",0,1,-1
"15577","8941關中","110/08/16","元大-路竹",1,0,1
"15578","8941關中","110/08/16","元大-華山",0,1,-1
"15579","8941關中","110/08/16","統一-新台中",0,0,0
"15580","8941關中","110/08/16","永豐金-中正",0,1,-1
"15581","8941關中","110/08/16","元富-中港",0,0,0
"15582","8941關中","110/08/16","統一-新台中",0,0,0
"15583","8941關中","110/08/16","元大證券",0,0,0
"15584","8941關中","110/08/16","元富-中港",0,0,0
"15585","8941關中","110/08/16","元大-龍潭",0,0,0
"15586","8941關中","110/08/16","元大證券",0,0,0
"15587","8941關中","110/08/16","永豐金-南投",0,0,0
"15588","8941關中","110/08/16","元大-龍潭",0,0,0
"15589","8941關中","110/08/16","",NA,NA,NA
"15590","8941關中","110/08/16","永豐金-南投",0,0,0
"15591","8941關中","110/08/16","",NA,NA,NA
"15592","8941關中","110/08/16","",NA,NA,NA
"15593","8941關中","110/08/16","",NA,NA,NA
"15594","8941關中","110/08/16","",NA,NA,NA
"15595","8941關中","110/08/16","",NA,NA,NA
"15596","8941關中","110/08/16","",NA,NA,NA
"15597","8941關中","110/08/16","",NA,NA,NA
"15598","8941關中","110/08/16","",NA,NA,NA
"15599","8941關中","110/08/16","",NA,NA,NA
"15600","8941關中","110/08/16","",NA,NA,NA
"15601","8936國統","110/08/16","台中銀-高雄",200,0,200
"15602","8936國統","110/08/16","摩根大通",39,181,-142
"15603","8936國統","110/08/16","美林",139,31,108
"15604","8936國統","110/08/16","新加坡商瑞銀",48,178,-130
"15605","8936國統","110/08/16","元大-天母",50,0,50
"15606","8936國統","110/08/16","凱基-台北",66,161,-95
"15607","8936國統","110/08/16","中國信託",50,2,48
"15608","8936國統","110/08/16","新光-桃園",2,90,-88
"15609","8936國統","110/08/16","元大-豐原站前",40,0,40
"15610","8936國統","110/08/16","台灣摩根士丹利",1,79,-78
"15611","8936國統","110/08/16","元大-北港",32,0,32
"15612","8936國統","110/08/16","永豐金-苓雅",10,80,-70
"15613","8936國統","110/08/16","永豐金-竹科",28,0,28
"15614","8936國統","110/08/16","富邦-南屯",15,64,-49
"15615","8936國統","110/08/16","凱基-岡山",27,0,27
"15616","8936國統","110/08/16","台新-高雄",10,56,-46
"15617","8936國統","110/08/16","第一金-自由",20,0,20
"15618","8936國統","110/08/16","國票-北高雄",5,30,-25
"15619","8936國統","110/08/16","港商野村",68,50,18
"15620","8936國統","110/08/16","台新-屏東",0,25,-25
"15621","8936國統","110/08/16","華南永昌-岡山",16,0,16
"15622","8936國統","110/08/16","元大-高雄",0,23,-23
"15623","8936國統","110/08/16","新光-台中",59,44,15
"15624","8936國統","110/08/16","台灣企銀-豐原",0,22,-22
"15625","8936國統","110/08/16","日盛證券",14,0,14
"15626","8936國統","110/08/16","玉山證券",0,19,-19
"15627","8936國統","110/08/16","元富-林園",12,0,12
"15628","8936國統","110/08/16","日盛-中壢",0,16,-16
"15629","8936國統","110/08/16","兆豐-景美",12,0,12
"15630","8936國統","110/08/16","美商高盛",6,21,-15
"15631","6226光鼎","110/08/16","凱基-台北",1070,545,525
"15632","6226光鼎","110/08/16","台新證券",86,218,-132
"15633","6226光鼎","110/08/16","美林",291,133,158
"15634","6226光鼎","110/08/16","元富-新竹",10,139,-129
"15635","6226光鼎","110/08/16","瑞士信貸",144,6,138
"15636","6226光鼎","110/08/16","元大-台南",0,101,-101
"15637","6226光鼎","110/08/16","摩根大通",340,206,134
"15638","6226光鼎","110/08/16","永豐金-南投",1,100,-99
"15639","6226光鼎","110/08/16","美商高盛",222,102,120
"15640","6226光鼎","110/08/16","華南永昌-高雄",1,63,-62
"15641","6226光鼎","110/08/16","新光",195,77,118
"15642","6226光鼎","110/08/16","元大-仁愛",1,61,-60
"15643","6226光鼎","110/08/16","第一金-大稻埕",103,1,102
"15644","6226光鼎","110/08/16","群益金鼎-士林",39,98,-59
"15645","6226光鼎","110/08/16","元大-北投",101,4,97
"15646","6226光鼎","110/08/16","元大-府城",20,72,-52
"15647","6226光鼎","110/08/16","元大-竹科",101,10,91
"15648","6226光鼎","110/08/16","合庫-鳳山",4,53,-49
"15649","6226光鼎","110/08/16","元大-北屯",104,15,89
"15650","6226光鼎","110/08/16","國票-九鼎",2,44,-42
"15651","6226光鼎","110/08/16","國泰-桃園",98,29,69
"15652","6226光鼎","110/08/16","元大-金華",13,55,-42
"15653","6226光鼎","110/08/16","群益金鼎-東門",67,0,67
"15654","6226光鼎","110/08/16","富邦-竹東",5,43,-38
"15655","6226光鼎","110/08/16","港商野村",277,215,62
"15656","6226光鼎","110/08/16","元大-雙和",6,43,-37
"15657","6226光鼎","110/08/16","群益金鼎-西松",51,1,50
"15658","6226光鼎","110/08/16","中國信託-忠孝",2,36,-34
"15659","6226光鼎","110/08/16","元富-古亭",50,3,47
"15660","6226光鼎","110/08/16","華南永昌-三重",3,37,-34
"15661","2363矽統","110/08/16","凱基-台北",2187,1127,1060
"15662","2363矽統","110/08/16","元大-東泰",32,339,-307
"15663","2363矽統","110/08/16","美商高盛",1277,381,896
"15664","2363矽統","110/08/16","國泰-敦南",408,608,-200
"15665","2363矽統","110/08/16","美林",777,172,605
"15666","2363矽統","110/08/16","台灣摩根士丹利",6,185,-179
"15667","2363矽統","110/08/16","新加坡商瑞銀",764,476,288
"15668","2363矽統","110/08/16","群益金鼎",14,154,-140
"15669","2363矽統","110/08/16","永豐金-嘉義",250,2,248
"15670","2363矽統","110/08/16","富邦-新竹",103,229,-126
"15671","2363矽統","110/08/16","瑞士信貸",247,11,236
"15672","2363矽統","110/08/16","凱基",0,120,-120
"15673","2363矽統","110/08/16","群益金鼎-士林",173,17,156
"15674","2363矽統","110/08/16","元大-大統",25,138,-113
"15675","2363矽統","110/08/16","統一-新竹",151,2,149
"15676","2363矽統","110/08/16","富邦-中壢",17,125,-108
"15677","2363矽統","110/08/16","港商野村",1539,1409,130
"15678","2363矽統","110/08/16","兆豐-天母",1,102,-101
"15679","2363矽統","110/08/16","凱基-長庚",136,12,124
"15680","2363矽統","110/08/16","陽信-石牌",13,105,-92
"15681","2363矽統","110/08/16","台新-三民",156,49,107
"15682","2363矽統","110/08/16","永豐金-新店",8,100,-92
"15683","2363矽統","110/08/16","凱基-南崁",98,26,72
"15684","2363矽統","110/08/16","日盛-北高雄",25,105,-80
"15685","2363矽統","110/08/16","元富-城東",78,9,69
"15686","2363矽統","110/08/16","元大-萬華",36,116,-80
"15687","2363矽統","110/08/16","元大-汐止",144,79,65
"15688","2363矽統","110/08/16","玉山證券",37,116,-79
"15689","2363矽統","110/08/16","永豐金-中壢",91,28,63
"15690","2363矽統","110/08/16","元大-敦南",3,81,-78
"15691","8112至上","110/08/16","合庫證券",140,7,133
"15692","8112至上","110/08/16","摩根大通",19,588,-569
"15693","8112至上","110/08/16","新光-桃園",102,4,98
"15694","8112至上","110/08/16","新加坡商瑞銀",17,338,-321
"15695","8112至上","110/08/16","元大-敦化",80,2,78
"15696","8112至上","110/08/16","瑞士信貸",3,181,-178
"15697","8112至上","110/08/16","元大-台北",71,0,71
"15698","8112至上","110/08/16","美林",84,183,-99
"15699","8112至上","110/08/16","凱基-嘉義",97,37,60
"15700","8112至上","110/08/16","台灣摩根士丹利",9,101,-92
"15701","8112至上","110/08/16","元大-開元",44,1,43
"15702","8112至上","110/08/16","凱基-台北",133,201,-68
"15703","8112至上","110/08/16","永豐金-台中",43,0,43
"15704","8112至上","110/08/16","新光-高雄",3,57,-54
"15705","8112至上","110/08/16","元大-仁愛",40,0,40
"15706","8112至上","110/08/16","新百王",1,51,-50
"15707","8112至上","110/08/16","富邦-仁愛",65,27,38
"15708","8112至上","110/08/16","華南永昌-新莊",2,47,-45
"15709","8112至上","110/08/16","元大-前金",40,3,37
"15710","8112至上","110/08/16","華南永昌-潮州",0,30,-30
"15711","8112至上","110/08/16","富邦-中壢",33,1,32
"15712","8112至上","110/08/16","國票-長城",18,45,-27
"15713","8112至上","110/08/16","統一-中壢",31,0,31
"15714","8112至上","110/08/16","群益金鼎-海山",3,30,-27
"15715","8112至上","110/08/16","台新-台中",32,1,31
"15716","8112至上","110/08/16","元大-發財",1,28,-27
"15717","8112至上","110/08/16","新光",38,11,27
"15718","8112至上","110/08/16","兆豐-斗南",4,30,-26
"15719","8112至上","110/08/16","合庫-嘉義",25,0,25
"15720","8112至上","110/08/16","國泰-板橋",9,32,-23
"15721","1570力肯","110/08/16","兆豐-民生",80,0,80
"15722","1570力肯","110/08/16","台新證券",17,184,-167
"15723","1570力肯","110/08/16","國票-北高雄",145,85,60
"15724","1570力肯","110/08/16","凱基-台北",61,183,-122
"15725","1570力肯","110/08/16","新光",83,31,52
"15726","1570力肯","110/08/16","摩根大通",18,89,-71
"15727","1570力肯","110/08/16","凱基-三峽",40,0,40
"15728","1570力肯","110/08/16","新光-台南",1,50,-49
"15729","1570力肯","110/08/16","元大-大雅",40,0,40
"15730","1570力肯","110/08/16","國泰-松江",0,30,-30
"15731","1570力肯","110/08/16","元富-新竹",30,0,30
"15732","1570力肯","110/08/16","永豐金-桃園",0,30,-30
"15733","1570力肯","110/08/16","富邦-花蓮",29,0,29
"15734","1570力肯","110/08/16","元富-文心",1,23,-22
"15735","1570力肯","110/08/16","統一-高雄",26,1,25
"15736","1570力肯","110/08/16","永豐金-屏東",3,25,-22
"15737","1570力肯","110/08/16","元大-雙和",24,0,24
"15738","1570力肯","110/08/16","台灣摩根士丹利",0,18,-18
"15739","1570力肯","110/08/16","日盛-高雄",21,0,21
"15740","1570力肯","110/08/16","元富-新店",2,20,-18
"15741","1570力肯","110/08/16","國票-和平",27,6,21
"15742","1570力肯","110/08/16","康和-屏東",0,16,-16
"15743","1570力肯","110/08/16","國泰證券",20,0,20
"15744","1570力肯","110/08/16","聯邦-三重",0,15,-15
"15745","1570力肯","110/08/16","群益金鼎-東門",20,0,20
"15746","1570力肯","110/08/16","富邦-內湖",8,21,-13
"15747","1570力肯","110/08/16","元大-民生",19,0,19
"15748","1570力肯","110/08/16","新光-台中",8,20,-12
"15749","1570力肯","110/08/16","元富-民權",15,0,15
"15750","1570力肯","110/08/16","國泰-館前",0,12,-12
"15751","2929淘帝","110/08/16","日盛-中壢",55,1,54
"15752","2929淘帝","110/08/16","摩根大通",10,80,-70
"15753","2929淘帝","110/08/16","元大-太平",31,0,31
"15754","2929淘帝","110/08/16","港商野村",13,57,-44
"15755","2929淘帝","110/08/16","宏遠-館前",30,0,30
"15756","2929淘帝","110/08/16","元大-西門",0,37,-37
"15757","2929淘帝","110/08/16","凱基-東門",24,0,24
"15758","2929淘帝","110/08/16","新加坡商瑞銀",4,26,-22
"15759","2929淘帝","110/08/16","台新-台中",21,0,21
"15760","2929淘帝","110/08/16","元大-大里",0,22,-22
"15761","2929淘帝","110/08/16","日盛-八德",16,0,16
"15762","2929淘帝","110/08/16","兆豐-三重",0,20,-20
"15763","2929淘帝","110/08/16","元富-文心",10,0,10
"15764","2929淘帝","110/08/16","永豐金-鳳山",0,14,-14
"15765","2929淘帝","110/08/16","兆豐-桃園",10,0,10
"15766","2929淘帝","110/08/16","美林",6,17,-11
"15767","2929淘帝","110/08/16","群益金鼎-基隆",10,0,10
"15768","2929淘帝","110/08/16","臺銀-金山",0,10,-10
"15769","2929淘帝","110/08/16","永豐金證券",10,0,10
"15770","2929淘帝","110/08/16","國票-博愛",0,10,-10
"15771","2929淘帝","110/08/16","新光",10,2,8
"15772","2929淘帝","110/08/16","元大-上新莊",2,12,-10
"15773","2929淘帝","110/08/16","元大-承德",8,0,8
"15774","2929淘帝","110/08/16","兆豐-大同",0,9,-9
"15775","2929淘帝","110/08/16","亞東-新竹",7,0,7
"15776","2929淘帝","110/08/16","台新-建北",0,9,-9
"15777","2929淘帝","110/08/16","凱基-林口",7,0,7
"15778","2929淘帝","110/08/16","國泰-館前",0,7,-7
"15779","2929淘帝","110/08/16","凱基-新豐",6,0,6
"15780","2929淘帝","110/08/16","兆豐-台南",0,6,-6
"15781","5410國眾","110/08/16","兆豐-城中",85,0,85
"15782","5410國眾","110/08/16","國泰-敦南",15,99,-84
"15783","5410國眾","110/08/16","元大-六合",42,0,42
"15784","5410國眾","110/08/16","凱基-高雄",0,50,-50
"15785","5410國眾","110/08/16","兆豐-小港",36,0,36
"15786","5410國眾","110/08/16","瑞士信貸",0,44,-44
"15787","5410國眾","110/08/16","凱基-台南",30,0,30
"15788","5410國眾","110/08/16","摩根大通",46,87,-41
"15789","5410國眾","110/08/16","富邦-建國",31,1,30
"15790","5410國眾","110/08/16","元大-士林",0,38,-38
"15791","5410國眾","110/08/16","國票-安和",31,4,27
"15792","5410國眾","110/08/16","兆豐-台中港",0,30,-30
"15793","5410國眾","110/08/16","凱基-竹北",24,0,24
"15794","5410國眾","110/08/16","凱基-台北",27,55,-28
"15795","5410國眾","110/08/16","玉山-新莊",15,0,15
"15796","5410國眾","110/08/16","元大-古亭",0,26,-26
"15797","5410國眾","110/08/16","元大-木柵",12,0,12
"15798","5410國眾","110/08/16","臺銀",1,24,-23
"15799","5410國眾","110/08/16","元大-新盛",12,0,12
"15800","5410國眾","110/08/16","元大-中壢",3,26,-23
"15801","5410國眾","110/08/16","永豐金-台南",12,1,11
"15802","5410國眾","110/08/16","元大-北港",0,21,-21
"15803","5410國眾","110/08/16","合庫-桃園",10,0,10
"15804","5410國眾","110/08/16","元大-北投",0,20,-20
"15805","5410國眾","110/08/16","日盛-屏東",10,0,10
"15806","5410國眾","110/08/16","元富-潮州",0,15,-15
"15807","5410國眾","110/08/16","元富-城東",10,0,10
"15808","5410國眾","110/08/16","臺銀-鳳山",1,15,-14
"15809","5410國眾","110/08/16","富邦-陽明",10,0,10
"15810","5410國眾","110/08/16","元大-屏東",0,14,-14
"15811","2841台開","110/08/16","宏遠-館前",190,0,190
"15812","2841台開","110/08/16","港商野村",0,44,-44
"15813","2841台開","110/08/16","合庫證券",30,0,30
"15814","2841台開","110/08/16","新光-台南",0,33,-33
"15815","2841台開","110/08/16","凱基-竹科",20,0,20
"15816","2841台開","110/08/16","台新證券",10,42,-32
"15817","2841台開","110/08/16","永豐金-中盛",13,0,13
"15818","2841台開","110/08/16","元大-大里德芳",0,30,-30
"15819","2841台開","110/08/16","大慶-蘆洲",10,0,10
"15820","2841台開","110/08/16","合庫-台中",0,28,-28
"15821","2841台開","110/08/16","新光",13,3,10
"15822","2841台開","110/08/16","元大-善化",0,20,-20
"15823","2841台開","110/08/16","元大-新店中正",10,0,10
"15824","2841台開","110/08/16","永豐金-敦南",30,50,-20
"15825","2841台開","110/08/16","群益金鼎-崇德",8,0,8
"15826","2841台開","110/08/16","新加坡商瑞銀",0,16,-16
"15827","2841台開","110/08/16","元富-成功",7,0,7
"15828","2841台開","110/08/16","玉山-新莊",0,16,-16
"15829","2841台開","110/08/16","元大-彰化",7,0,7
"15830","2841台開","110/08/16","日盛-內湖",0,15,-15
"15831","2841台開","110/08/16","台中銀",5,0,5
"15832","2841台開","110/08/16","兆豐-民生",0,15,-15
"15833","2841台開","110/08/16","中國信託-文心",5,0,5
"15834","2841台開","110/08/16","華南永昌-高雄",0,15,-15
"15835","2841台開","110/08/16","兆豐-台中",5,0,5
"15836","2841台開","110/08/16","元大-永康",0,10,-10
"15837","2841台開","110/08/16","台新-新營",5,0,5
"15838","2841台開","110/08/16","元大-北三重",0,10,-10
"15839","2841台開","110/08/16","凱基-東港",10,5,5
"15840","2841台開","110/08/16","永豐金證券",0,10,-10
"15841","6207雷科","110/08/16","台新-高雄",131,3,128
"15842","6207雷科","110/08/16","元大-高雄",0,52,-52
"15843","6207雷科","110/08/16","凱基-台北",70,20,50
"15844","6207雷科","110/08/16","摩根大通",62,112,-50
"15845","6207雷科","110/08/16","元大-東門",42,0,42
"15846","6207雷科","110/08/16","華南永昌-三重",0,50,-50
"15847","6207雷科","110/08/16","永豐金證券",30,0,30
"15848","6207雷科","110/08/16","凱基-復興",0,40,-40
"15849","6207雷科","110/08/16","元大-六合",21,0,21
"15850","6207雷科","110/08/16","元大-潮州",0,40,-40
"15851","6207雷科","110/08/16","群益金鼎-東門",20,0,20
"15852","6207雷科","110/08/16","日盛證券",2,37,-35
"15853","6207雷科","110/08/16","元大-松江",20,0,20
"15854","6207雷科","110/08/16","新加坡商瑞銀",45,80,-35
"15855","6207雷科","110/08/16","大昌-桃園",28,10,18
"15856","6207雷科","110/08/16","玉山-士林",0,27,-27
"15857","6207雷科","110/08/16","統一-新竹",16,0,16
"15858","6207雷科","110/08/16","元大-大統",0,22,-22
"15859","6207雷科","110/08/16","台中銀",15,0,15
"15860","6207雷科","110/08/16","元大-民生",2,24,-22
"15861","6207雷科","110/08/16","中國信託-三重",13,0,13
"15862","6207雷科","110/08/16","凱基-高雄",6,27,-21
"15863","6207雷科","110/08/16","凱基-岡山",11,0,11
"15864","6207雷科","110/08/16","國票-北高雄",0,15,-15
"15865","6207雷科","110/08/16","富邦-中壢",11,0,11
"15866","6207雷科","110/08/16","新光",0,12,-12
"15867","6207雷科","110/08/16","港商野村",27,17,10
"15868","6207雷科","110/08/16","台新-左楠",1,12,-11
"15869","6207雷科","110/08/16","第一金-安和",10,0,10
"15870","6207雷科","110/08/16","新光-台南",0,10,-10
"15871","3679新至陞","110/08/16","凱基-台北",15,2,13
"15872","3679新至陞","110/08/16","摩根大通",7,19,-12
"15873","3679新至陞","110/08/16","台灣摩根士丹利",8,3,5
"15874","3679新至陞","110/08/16","瑞士信貸",0,11,-11
"15875","3679新至陞","110/08/16","國泰-桃園",5,0,5
"15876","3679新至陞","110/08/16","永豐金-苓雅",1,5,-4
"15877","3679新至陞","110/08/16","美商高盛",3,0,3
"15878","3679新至陞","110/08/16","國泰-松江",0,3,-3
"15879","3679新至陞","110/08/16","華南永昌",3,0,3
"15880","3679新至陞","110/08/16","凱基-台南",0,3,-3
"15881","3679新至陞","110/08/16","日盛-竹北",2,0,2
"15882","3679新至陞","110/08/16","彰銀",0,2,-2
"15883","3679新至陞","110/08/16","日盛-文化",3,1,2
"15884","3679新至陞","110/08/16","新加坡商瑞銀",0,2,-2
"15885","3679新至陞","110/08/16","大慶-蘆洲",3,1,2
"15886","3679新至陞","110/08/16","第一金-頭份",0,2,-2
"15887","3679新至陞","110/08/16","國票-九鼎",2,0,2
"15888","3679新至陞","110/08/16","康和-嘉義",0,2,-2
"15889","3679新至陞","110/08/16","華南永昌-高雄",2,0,2
"15890","3679新至陞","110/08/16","凱基-站前",0,2,-2
"15891","3679新至陞","110/08/16","元大-新店中正",2,0,2
"15892","3679新至陞","110/08/16","元大證券",0,2,-2
"15893","3679新至陞","110/08/16","土銀-士林",1,0,1
"15894","3679新至陞","110/08/16","元大-頭份",0,2,-2
"15895","3679新至陞","110/08/16","日盛證券",1,0,1
"15896","3679新至陞","110/08/16","元大-斗信",0,2,-2
"15897","3679新至陞","110/08/16","美林",10,9,1
"15898","3679新至陞","110/08/16","元大-嘉義",0,2,-2
"15899","3679新至陞","110/08/16","第一金-忠孝",1,0,1
"15900","3679新至陞","110/08/16","日盛-龍潭",0,1,-1
"15901","2727王品","110/08/16","瑞士信貸",49,0,49
"15902","2727王品","110/08/16","台新證券",4,162,-158
"15903","2727王品","110/08/16","台灣摩根士丹利",33,3,30
"15904","2727王品","110/08/16","臺銀-鳳山",5,81,-76
"15905","2727王品","110/08/16","新光",37,12,25
"15906","2727王品","110/08/16","玉山-台南",2,33,-31
"15907","2727王品","110/08/16","日盛-忠孝",20,0,20
"15908","2727王品","110/08/16","美商高盛",0,23,-23
"15909","2727王品","110/08/16","元大-東蘆",16,1,15
"15910","2727王品","110/08/16","兆豐-南京",0,20,-20
"15911","2727王品","110/08/16","第一金-台中",15,1,14
"15912","2727王品","110/08/16","凱基-虎尾",0,20,-20
"15913","2727王品","110/08/16","國泰-敦南",29,15,14
"15914","2727王品","110/08/16","中國信託",2,20,-18
"15915","2727王品","110/08/16","第一金-桃園",13,0,13
"15916","2727王品","110/08/16","新光-桃園",2,20,-18
"15917","2727王品","110/08/16","第一金-忠孝",13,1,12
"15918","2727王品","110/08/16","永豐金證券",2,20,-18
"15919","2727王品","110/08/16","摩根大通",24,12,12
"15920","2727王品","110/08/16","統一",6,22,-16
"15921","2727王品","110/08/16","富邦-陽明",15,3,12
"15922","2727王品","110/08/16","合庫證券",2,14,-12
"15923","2727王品","110/08/16","元富-西松",13,2,11
"15924","2727王品","110/08/16","富邦-仁愛",7,19,-12
"15925","2727王品","110/08/16","聯邦-興中",11,0,11
"15926","2727王品","110/08/16","元大-竹科",4,16,-12
"15927","2727王品","110/08/16","中國信託-松江",10,0,10
"15928","2727王品","110/08/16","元大-和平",0,12,-12
"15929","2727王品","110/08/16","凱基-市府",10,0,10
"15930","2727王品","110/08/16","凱基-興隆",1,12,-11
"15931","1570力肯","110/08/16","兆豐-民生",80,0,80
"15932","1570力肯","110/08/16","台新證券",17,184,-167
"15933","1570力肯","110/08/16","國票-北高雄",145,85,60
"15934","1570力肯","110/08/16","凱基-台北",61,183,-122
"15935","1570力肯","110/08/16","新光",83,31,52
"15936","1570力肯","110/08/16","摩根大通",18,89,-71
"15937","1570力肯","110/08/16","凱基-三峽",40,0,40
"15938","1570力肯","110/08/16","新光-台南",1,50,-49
"15939","1570力肯","110/08/16","元大-大雅",40,0,40
"15940","1570力肯","110/08/16","國泰-松江",0,30,-30
"15941","1570力肯","110/08/16","元富-新竹",30,0,30
"15942","1570力肯","110/08/16","永豐金-桃園",0,30,-30
"15943","1570力肯","110/08/16","富邦-花蓮",29,0,29
"15944","1570力肯","110/08/16","元富-文心",1,23,-22
"15945","1570力肯","110/08/16","統一-高雄",26,1,25
"15946","1570力肯","110/08/16","永豐金-屏東",3,25,-22
"15947","1570力肯","110/08/16","元大-雙和",24,0,24
"15948","1570力肯","110/08/16","台灣摩根士丹利",0,18,-18
"15949","1570力肯","110/08/16","日盛-高雄",21,0,21
"15950","1570力肯","110/08/16","元富-新店",2,20,-18
"15951","1570力肯","110/08/16","國票-和平",27,6,21
"15952","1570力肯","110/08/16","康和-屏東",0,16,-16
"15953","1570力肯","110/08/16","國泰證券",20,0,20
"15954","1570力肯","110/08/16","聯邦-三重",0,15,-15
"15955","1570力肯","110/08/16","群益金鼎-東門",20,0,20
"15956","1570力肯","110/08/16","富邦-內湖",8,21,-13
"15957","1570力肯","110/08/16","元大-民生",19,0,19
"15958","1570力肯","110/08/16","新光-台中",8,20,-12
"15959","1570力肯","110/08/16","元富-民權",15,0,15
"15960","1570力肯","110/08/16","國泰-館前",0,12,-12
"15961","6180橘子","110/08/16","美林",85,0,85
"15962","6180橘子","110/08/16","合庫-高雄",2,121,-119
"15963","6180橘子","110/08/16","新加坡商瑞銀",42,8,34
"15964","6180橘子","110/08/16","群益金鼎-三民",0,100,-100
"15965","6180橘子","110/08/16","合庫-自強",30,0,30
"15966","6180橘子","110/08/16","台灣摩根士丹利",0,50,-50
"15967","6180橘子","110/08/16","元大-中壢",23,0,23
"15968","6180橘子","110/08/16","統一",0,30,-30
"15969","6180橘子","110/08/16","新光-桃園",24,2,22
"15970","6180橘子","110/08/16","凱基-台北",0,27,-27
"15971","6180橘子","110/08/16","日盛-板橋",20,0,20
"15972","6180橘子","110/08/16","群益金鼎-大安",0,20,-20
"15973","6180橘子","110/08/16","康和-嘉義",19,0,19
"15974","6180橘子","110/08/16","元大-博愛",1,20,-19
"15975","6180橘子","110/08/16","永豐金-敦北",19,1,18
"15976","6180橘子","110/08/16","元大-文心興安",2,20,-18
"15977","6180橘子","110/08/16","元大-四維",16,0,16
"15978","6180橘子","110/08/16","統一-中壢",0,15,-15
"15979","6180橘子","110/08/16","元大-和平",16,0,16
"15980","6180橘子","110/08/16","元富-宜蘭",2,15,-13
"15981","6180橘子","110/08/16","港商野村",27,12,15
"15982","6180橘子","110/08/16","元大-沙鹿",0,12,-12
"15983","6180橘子","110/08/16","富隆-長安",15,0,15
"15984","6180橘子","110/08/16","元大-清水",0,12,-12
"15985","6180橘子","110/08/16","摩根大通",51,36,15
"15986","6180橘子","110/08/16","臺銀-鳳山",3,14,-11
"15987","6180橘子","110/08/16","美商高盛",15,1,14
"15988","6180橘子","110/08/16","盈溢",0,10,-10
"15989","6180橘子","110/08/16","元大-永和",13,0,13
"15990","6180橘子","110/08/16","元富-世貿",0,10,-10
"15991","2390云辰","110/08/16","富邦-虎尾",514,48,466
"15992","2390云辰","110/08/16","凱基-台北",495,1222,-727
"15993","2390云辰","110/08/16","摩根大通",2747,2369,378
"15994","2390云辰","110/08/16","元富-西松",194,423,-229
"15995","2390云辰","110/08/16","國泰-桃園",291,66,225
"15996","2390云辰","110/08/16","國票-安和",121,349,-228
"15997","2390云辰","110/08/16","元大-木柵",237,23,214
"15998","2390云辰","110/08/16","元大-信義",10,155,-145
"15999","2390云辰","110/08/16","新光",859,695,164
"16000","2390云辰","110/08/16","統一-新台中",6,137,-131
"16001","2390云辰","110/08/16","元大證券",229,67,162
"16002","2390云辰","110/08/16","美林",355,470,-115
"16003","2390云辰","110/08/16","兆豐-埔墘",719,573,146
"16004","2390云辰","110/08/16","台新-高雄",113,208,-95
"16005","2390云辰","110/08/16","永豐金-嘉義",144,20,124
"16006","2390云辰","110/08/16","豐農",37,114,-77
"16007","2390云辰","110/08/16","元大-台中",126,26,100
"16008","2390云辰","110/08/16","國泰-忠孝",15,85,-70
"16009","2390云辰","110/08/16","瑞士信貸",124,28,96
"16010","2390云辰","110/08/16","富邦-北港",154,223,-69
"16011","2390云辰","110/08/16","永豐金-古亭",120,24,96
"16012","2390云辰","110/08/16","凱基-科園",11,79,-68
"16013","2390云辰","110/08/16","富邦-嘉義",2108,2013,95
"16014","2390云辰","110/08/16","華南永昌-台中",82,149,-67
"16015","2390云辰","110/08/16","富邦-內湖",120,26,94
"16016","2390云辰","110/08/16","台新-左楠",61,126,-65
"16017","2390云辰","110/08/16","群益金鼎-三重",142,56,86
"16018","2390云辰","110/08/16","元大-林園",3,67,-64
"16019","2390云辰","110/08/16","元大-前金",200,123,77
"16020","2390云辰","110/08/16","永豐金-萬盛",23,84,-61
"16021","2867三商壽","110/08/13","美商高盛",295,16,279
"16022","2867三商壽","110/08/13","摩根大通",109,286,-177
"16023","2867三商壽","110/08/13","大慶-中壢",183,1,182
"16024","2867三商壽","110/08/13","元大-佳里",0,113,-113
"16025","2867三商壽","110/08/13","新加坡商瑞銀",121,0,121
"16026","2867三商壽","110/08/13","元大-崇德",0,103,-103
"16027","2867三商壽","110/08/13","凱基-五股",100,0,100
"16028","2867三商壽","110/08/13","台灣摩根士丹利",9,83,-74
"16029","2867三商壽","110/08/13","元大-桃園",100,1,99
"16030","2867三商壽","110/08/13","國泰-台南",1,73,-72
"16031","2867三商壽","110/08/13","凱基-虎尾",90,0,90
"16032","2867三商壽","110/08/13","元大證券",1,62,-61
"16033","2867三商壽","110/08/13","華南永昌-高雄",100,10,90
"16034","2867三商壽","110/08/13","元大-台中",0,60,-60
"16035","2867三商壽","110/08/13","兆豐-北高雄",81,2,79
"16036","2867三商壽","110/08/13","元大-大同",0,53,-53
"16037","2867三商壽","110/08/13","新光",105,39,66
"16038","2867三商壽","110/08/13","兆豐-鹿港",0,50,-50
"16039","2867三商壽","110/08/13","富邦-彰化",60,0,60
"16040","2867三商壽","110/08/13","合庫-西台中",2,50,-48
"16041","2867三商壽","110/08/13","富邦-台南",60,0,60
"16042","2867三商壽","110/08/13","新光-台中",7,53,-46
"16043","2867三商壽","110/08/13","玉山-板橋",60,1,59
"16044","2867三商壽","110/08/13","元大-大益",0,44,-44
"16045","2867三商壽","110/08/13","群益金鼎-新竹",56,0,56
"16046","2867三商壽","110/08/13","亞東-板橋",0,36,-36
"16047","2867三商壽","110/08/13","元大-大統",53,0,53
"16048","2867三商壽","110/08/13","福邦證券",0,34,-34
"16049","2867三商壽","110/08/13","瑞士信貸",55,3,52
"16050","2867三商壽","110/08/13","元大-博愛",16,50,-34
"16051","5521工信","110/08/13","日進",100,0,100
"16052","5521工信","110/08/13","美林",1,87,-86
"16053","5521工信","110/08/13","摩根大通",180,102,78
"16054","5521工信","110/08/13","日盛-復興",1,70,-69
"16055","5521工信","110/08/13","元大-鳳山",30,0,30
"16056","5521工信","110/08/13","永豐金-鳳山",1,60,-59
"16057","5521工信","110/08/13","(牛牛牛)亞-鑫豐",28,2,26
"16058","5521工信","110/08/13","中國信託-三重",0,52,-52
"16059","5521工信","110/08/13","新光",24,0,24
"16060","5521工信","110/08/13","華南永昌-民權",0,50,-50
"16061","5521工信","110/08/13","華南永昌-彰化",21,0,21
"16062","5521工信","110/08/13","第一金-新竹",0,34,-34
"16063","5521工信","110/08/13","台灣企銀-建成",20,0,20
"16064","5521工信","110/08/13","凱基-台北",18,49,-31
"16065","5521工信","110/08/13","大昌",20,0,20
"16066","5521工信","110/08/13","元大-新莊",10,38,-28
"16067","5521工信","110/08/13","兆豐-中壢",20,0,20
"16068","5521工信","110/08/13","台灣摩根士丹利",2,28,-26
"16069","5521工信","110/08/13","國票-和平",20,0,20
"16070","5521工信","110/08/13","華南永昌",0,23,-23
"16071","5521工信","110/08/13","元大-基隆孝二",20,0,20
"16072","5521工信","110/08/13","統一-板橋",0,20,-20
"16073","5521工信","110/08/13","日盛-中和",19,0,19
"16074","5521工信","110/08/13","港商法國興業",0,17,-17
"16075","5521工信","110/08/13","兆豐-小港",19,0,19
"16076","5521工信","110/08/13","元大-府城",0,16,-16
"16077","5521工信","110/08/13","富邦-高雄",17,0,17
"16078","5521工信","110/08/13","元大-敦化",0,16,-16
"16079","5521工信","110/08/13","統一-員林",15,0,15
"16080","5521工信","110/08/13","新光-新竹",5,20,-15
"16081","1471首利","110/08/13","聯邦-高雄",42,0,42
"16082","1471首利","110/08/13","摩根大通",41,220,-179
"16083","1471首利","110/08/13","元大-西門",40,0,40
"16084","1471首利","110/08/13","元大-敦化",0,100,-100
"16085","1471首利","110/08/13","元大-大灣",37,0,37
"16086","1471首利","110/08/13","美林",0,69,-69
"16087","1471首利","110/08/13","第一金-台南",30,0,30
"16088","1471首利","110/08/13","瑞士信貸",5,65,-60
"16089","1471首利","110/08/13","元富-大昌",25,0,25
"16090","1471首利","110/08/13","美商高盛",0,51,-51
"16091","1471首利","110/08/13","大慶-中壢",20,0,20
"16092","1471首利","110/08/13","華南永昌-苗栗",5,30,-25
"16093","1471首利","110/08/13","凱基-台南",20,0,20
"16094","1471首利","110/08/13","玉山-台南",0,22,-22
"16095","1471首利","110/08/13","新光",19,0,19
"16096","1471首利","110/08/13","元富-民權",0,20,-20
"16097","1471首利","110/08/13","凱基-羅東",17,0,17
"16098","1471首利","110/08/13","中國信託",0,20,-20
"16099","1471首利","110/08/13","永豐金-台南",20,4,16
"16100","1471首利","110/08/13","凱基-五股",0,20,-20
"16101","1471首利","110/08/13","元大-屏東",14,0,14
"16102","1471首利","110/08/13","台灣摩根士丹利",0,17,-17
"16103","1471首利","110/08/13","新光-台中",16,4,12
"16104","1471首利","110/08/13","兆豐-員林",2,15,-13
"16105","1471首利","110/08/13","元大-頭份",12,0,12
"16106","1471首利","110/08/13","日盛-宜蘭",0,10,-10
"16107","1471首利","110/08/13","凱基-三重",11,0,11
"16108","1471首利","110/08/13","元富-緯城",1,10,-9
"16109","1471首利","110/08/13","日盛-鳳山",10,0,10
"16110","1471首利","110/08/13","國泰-台中",2,8,-6
"16111","2883開發金","110/08/13","凱基-台北",23196,4416,18780
"16112","2883開發金","110/08/13","永豐金-彰化",79,4793,-4714
"16113","2883開發金","110/08/13","摩根大通",24818,6057,18761
"16114","2883開發金","110/08/13","第一金-忠孝",55,4613,-4558
"16115","2883開發金","110/08/13","新加坡商瑞銀",6645,205,6440
"16116","2883開發金","110/08/13","台新證券",1316,5539,-4223
"16117","2883開發金","110/08/13","中國信託-文心",4723,123,4600
"16118","2883開發金","110/08/13","日盛證券",587,3754,-3167
"16119","2883開發金","110/08/13","美林",6276,1780,4496
"16120","2883開發金","110/08/13","群益金鼎-大甲",48,2429,-2381
"16121","2883開發金","110/08/13","國泰證券",3682,17,3665
"16122","2883開發金","110/08/13","永豐金證券",169,1849,-1680
"16123","2883開發金","110/08/13","台灣摩根士丹利",3927,582,3345
"16124","2883開發金","110/08/13","華南永昌-南京",169,1407,-1238
"16125","2883開發金","110/08/13","群益金鼎",2401,367,2034
"16126","2883開發金","110/08/13","凱基-台東",270,1494,-1224
"16127","2883開發金","110/08/13","香港上海匯豐",2006,0,2006
"16128","2883開發金","110/08/13","日盛-板橋",207,1398,-1191
"16129","2883開發金","110/08/13","兆豐證券",1776,128,1648
"16130","2883開發金","110/08/13","元大-萬華",78,1243,-1165
"16131","2883開發金","110/08/13","瑞士信貸",3551,2174,1377
"16132","2883開發金","110/08/13","富邦-台北",295,1428,-1133
"16133","2883開發金","110/08/13","港商野村",7299,6088,1211
"16134","2883開發金","110/08/13","元大-成功",216,1287,-1071
"16135","2883開發金","110/08/13","美商高盛",1016,0,1016
"16136","2883開發金","110/08/13","新光-台中",485,1519,-1034
"16137","2883開發金","110/08/13","元大-大灣",1183,214,969
"16138","2883開發金","110/08/13","國票",232,1261,-1029
"16139","2883開發金","110/08/13","花旗環球",1104,284,820
"16140","2883開發金","110/08/13","永豐金-桃園",141,1157,-1016
"16141","6205詮欣","110/08/13","合庫-三重",15,0,15
"16142","6205詮欣","110/08/13","摩根大通",3,17,-14
"16143","6205詮欣","110/08/13","港商法國興業",11,0,11
"16144","6205詮欣","110/08/13","元大-善化",0,10,-10
"16145","6205詮欣","110/08/13","臺銀-民權",7,0,7
"16146","6205詮欣","110/08/13","元大-台中中港",0,3,-3
"16147","6205詮欣","110/08/13","日盛-三重",5,0,5
"16148","6205詮欣","110/08/13","合庫-鳳山",0,2,-2
"16149","6205詮欣","110/08/13","群益金鼎-屏東",5,0,5
"16150","6205詮欣","110/08/13","元富-潮州",0,2,-2
"16151","6205詮欣","110/08/13","德信-新營",3,0,3
"16152","6205詮欣","110/08/13","兆豐-桃鶯",0,2,-2
"16153","6205詮欣","110/08/13","美林",2,0,2
"16154","6205詮欣","110/08/13","致和-台北",0,2,-2
"16155","6205詮欣","110/08/13","兆豐-西螺",1,0,1
"16156","6205詮欣","110/08/13","華南永昌-三重",0,2,-2
"16157","6205詮欣","110/08/13","新光-台中",1,0,1
"16158","6205詮欣","110/08/13","土銀-台中",0,1,-1
"16159","6205詮欣","110/08/13","聯邦-嘉義",1,0,1
"16160","6205詮欣","110/08/13","日盛-中壢",0,1,-1
"16161","6205詮欣","110/08/13","玉山-南京東路",1,0,1
"16162","6205詮欣","110/08/13","美商高盛",0,1,-1
"16163","6205詮欣","110/08/13","群益金鼎-中港",1,0,1
"16164","6205詮欣","110/08/13","大展-台南",0,1,-1
"16165","6205詮欣","110/08/13","凱基-大安",1,0,1
"16166","6205詮欣","110/08/13","第一金-彰化",0,1,-1
"16167","6205詮欣","110/08/13","元大-仁愛",1,0,1
"16168","6205詮欣","110/08/13","統一-三重",1,2,-1
"16169","6205詮欣","110/08/13","元大-台南",1,0,1
"16170","6205詮欣","110/08/13","元富-桃園",0,1,-1
"16171","1540喬福","110/08/13","元富-中原",100,0,100
"16172","1540喬福","110/08/13","日盛-文化",0,48,-48
"16173","1540喬福","110/08/13","台新-台中",31,0,31
"16174","1540喬福","110/08/13","凱基-台北",0,33,-33
"16175","1540喬福","110/08/13","兆豐-北高雄",18,0,18
"16176","1540喬福","110/08/13","元大-大安",0,32,-32
"16177","1540喬福","110/08/13","元大-土城永寧",11,0,11
"16178","1540喬福","110/08/13","合庫-台中",2,23,-21
"16179","1540喬福","110/08/13","(牛牛牛)亞-鑫豐",10,0,10
"16180","1540喬福","110/08/13","華南永昌-楠梓",0,20,-20
"16181","1540喬福","110/08/13","凱基-中壢",7,0,7
"16182","1540喬福","110/08/13","群益金鼎-館前",1,20,-19
"16183","1540喬福","110/08/13","安泰",5,0,5
"16184","1540喬福","110/08/13","富邦-花蓮",0,15,-15
"16185","1540喬福","110/08/13","群益金鼎-古亭",5,0,5
"16186","1540喬福","110/08/13","日盛-景美",0,10,-10
"16187","1540喬福","110/08/13","元富-緯城",4,0,4
"16188","1540喬福","110/08/13","台新-高雄",0,9,-9
"16189","1540喬福","110/08/13","兆豐-南京",4,0,4
"16190","1540喬福","110/08/13","玉山-大里",0,8,-8
"16191","1540喬福","110/08/13","凱基-台中",4,0,4
"16192","1540喬福","110/08/13","元大-斗信",0,8,-8
"16193","1540喬福","110/08/13","凱基-台南",5,1,4
"16194","1540喬福","110/08/13","新光-台南",0,6,-6
"16195","1540喬福","110/08/13","元大-龍潭",4,0,4
"16196","1540喬福","110/08/13","兆豐-板橋",0,5,-5
"16197","1540喬福","110/08/13","兆豐-高雄",3,0,3
"16198","1540喬福","110/08/13","富邦-彰化",0,5,-5
"16199","1540喬福","110/08/13","兆豐-鹿港",3,0,3
"16200","1540喬福","110/08/13","美林",0,4,-4
"16201","2888新光金","110/08/13","永豐金-天母",2112,0,2112
"16202","2888新光金","110/08/13","摩根大通",308,3587,-3279
"16203","2888新光金","110/08/13","合庫-西台中",2116,5,2111
"16204","2888新光金","110/08/13","玉山-嘉義",7,1514,-1507
"16205","2888新光金","110/08/13","統一-新竹",1706,0,1706
"16206","2888新光金","110/08/13","國票-台東",0,1500,-1500
"16207","2888新光金","110/08/13","凱基-台北",3076,1640,1436
"16208","2888新光金","110/08/13","台灣摩根士丹利",127,1148,-1021
"16209","2888新光金","110/08/13","元大證券",1418,10,1408
"16210","2888新光金","110/08/13","華南永昌-岡山",62,930,-868
"16211","2888新光金","110/08/13","康和",761,2,759
"16212","2888新光金","110/08/13","港商野村",47,827,-780
"16213","2888新光金","110/08/13","富邦-仁愛",739,52,687
"16214","2888新光金","110/08/13","美商高盛",697,1236,-539
"16215","2888新光金","110/08/13","新加坡商瑞銀",716,121,595
"16216","2888新光金","110/08/13","日盛-八德",88,572,-484
"16217","2888新光金","110/08/13","富邦-彰化",588,12,576
"16218","2888新光金","110/08/13","群益金鼎-三重",1,437,-436
"16219","2888新光金","110/08/13","玉山證券",558,12,546
"16220","2888新光金","110/08/13","永豐金-嘉義",52,472,-420
"16221","2888新光金","110/08/13","群益金鼎-瑞豐",550,10,540
"16222","2888新光金","110/08/13","元富-城東",7,390,-383
"16223","2888新光金","110/08/13","元大-三重",523,0,523
"16224","2888新光金","110/08/13","群益金鼎-高雄",6,387,-381
"16225","2888新光金","110/08/13","永豐金-博愛",420,27,393
"16226","2888新光金","110/08/13","凱基-宜蘭",9,379,-370
"16227","2888新光金","110/08/13","第一金-豐原",364,20,344
"16228","2888新光金","110/08/13","美林",938,1287,-349
"16229","2888新光金","110/08/13","國票-九鼎",317,3,314
"16230","2888新光金","110/08/13","華南永昌-台中",0,329,-329
"16231","1340勝悅","110/08/13","元富-成功",72,0,72
"16232","1340勝悅","110/08/13","元大-忠孝",0,36,-36
"16233","1340勝悅","110/08/13","元大-博愛",10,0,10
"16234","1340勝悅","110/08/13","新光",4,21,-17
"16235","1340勝悅","110/08/13","臺灣企銀-埔墘",5,0,5
"16236","1340勝悅","110/08/13","摩根大通",3,19,-16
"16237","1340勝悅","110/08/13","元大-新莊",5,0,5
"16238","1340勝悅","110/08/13","群益金鼎-三重",0,15,-15
"16239","1340勝悅","110/08/13","美商高盛",4,0,4
"16240","1340勝悅","110/08/13","日盛-永康",0,10,-10
"16241","1340勝悅","110/08/13","國泰-敦南",6,2,4
"16242","1340勝悅","110/08/13","華南永昌-合泰",0,10,-10
"16243","1340勝悅","110/08/13","統一-城中",6,3,3
"16244","1340勝悅","110/08/13","日盛-木柵",0,8,-8
"16245","1340勝悅","110/08/13","元富-新店",3,0,3
"16246","1340勝悅","110/08/13","港商法國興業",0,6,-6
"16247","1340勝悅","110/08/13","玉山-士林",3,0,3
"16248","1340勝悅","110/08/13","群益金鼎-中港",0,5,-5
"16249","1340勝悅","110/08/13","群益金鼎-館前",4,1,3
"16250","1340勝悅","110/08/13","第一金-自由",0,4,-4
"16251","1340勝悅","110/08/13","元富-安南",2,0,2
"16252","1340勝悅","110/08/13","兆豐-新營",0,4,-4
"16253","1340勝悅","110/08/13","大昌-樹林",2,0,2
"16254","1340勝悅","110/08/13","國泰-台中",1,5,-4
"16255","1340勝悅","110/08/13","群益金鼎",2,0,2
"16256","1340勝悅","110/08/13","元大-林園",0,4,-4
"16257","1340勝悅","110/08/13","群益金鼎-北高雄",2,0,2
"16258","1340勝悅","110/08/13","元大-四維",0,4,-4
"16259","1340勝悅","110/08/13","華南永昌",2,0,2
"16260","1340勝悅","110/08/13","美林",0,2,-2
"16261","6246臺龍","110/08/13","華南永昌-彰化",31,0,31
"16262","6246臺龍","110/08/13","永豐金-內湖",0,95,-95
"16263","6246臺龍","110/08/13","合庫-台中",23,0,23
"16264","6246臺龍","110/08/13","玉山-大里",0,21,-21
"16265","6246臺龍","110/08/13","兆豐-忠孝",24,3,21
"16266","6246臺龍","110/08/13","新光-新竹",0,20,-20
"16267","6246臺龍","110/08/13","元大-台北",16,0,16
"16268","6246臺龍","110/08/13","台新-台中",1,19,-18
"16269","6246臺龍","110/08/13","元大-新莊",11,1,10
"16270","6246臺龍","110/08/13","光和",2,17,-15
"16271","6246臺龍","110/08/13","德信-新營",9,0,9
"16272","6246臺龍","110/08/13","日盛-高雄",0,10,-10
"16273","6246臺龍","110/08/13","凱基-永和",9,0,9
"16274","6246臺龍","110/08/13","元富-世貿",0,10,-10
"16275","6246臺龍","110/08/13","港商野村",20,12,8
"16276","6246臺龍","110/08/13","(牛牛牛)亞-鑫豐",1,11,-10
"16277","6246臺龍","110/08/13","富邦-建國",8,0,8
"16278","6246臺龍","110/08/13","國泰-敦南",6,16,-10
"16279","6246臺龍","110/08/13","群益金鼎-開元",12,5,7
"16280","6246臺龍","110/08/13","永豐金-市政",1,10,-9
"16281","6246臺龍","110/08/13","群益金鼎-古亭",7,0,7
"16282","6246臺龍","110/08/13","華南永昌-嘉義",0,8,-8
"16283","6246臺龍","110/08/13","凱基-高美館",7,0,7
"16284","6246臺龍","110/08/13","富邦-敦南",4,11,-7
"16285","6246臺龍","110/08/13","元大-東蘆",10,3,7
"16286","6246臺龍","110/08/13","第一金-彰化",6,12,-6
"16287","6246臺龍","110/08/13","元大-金華",8,1,7
"16288","6246臺龍","110/08/13","新光-桃園",2,8,-6
"16289","6246臺龍","110/08/13","永豐金-松山",7,0,7
"16290","6246臺龍","110/08/13","凱基-竹科",0,6,-6
"16291","00715L期街口布蘭特正2","110/08/13","元大證券",6162,789,5373
"16292","00715L期街口布蘭特正2","110/08/13","元大-四維",2,1000,-998
"16293","00715L期街口布蘭特正2","110/08/13","元富",1528,0,1528
"16294","00715L期街口布蘭特正2","110/08/13","玉山-嘉義",20,1016,-996
"16295","00715L期街口布蘭特正2","110/08/13","合庫證券",1153,0,1153
"16296","00715L期街口布蘭特正2","110/08/13","群益金鼎-古亭",0,666,-666
"16297","00715L期街口布蘭特正2","110/08/13","富邦證券",1029,290,739
"16298","00715L期街口布蘭特正2","110/08/13","富邦-員林",9,489,-480
"16299","00715L期街口布蘭特正2","110/08/13","台新-台中",284,9,275
"16300","00715L期街口布蘭特正2","110/08/13","元大-嘉義",1,400,-399
"16301","00715L期街口布蘭特正2","110/08/13","兆豐-台中",238,0,238
"16302","00715L期街口布蘭特正2","110/08/13","臺銀-新竹",2,360,-358
"16303","00715L期街口布蘭特正2","110/08/13","統一-桃園",283,80,203
"16304","00715L期街口布蘭特正2","110/08/13","日盛-二林",0,300,-300
"16305","00715L期街口布蘭特正2","110/08/13","群益金鼎-屏東",200,0,200
"16306","00715L期街口布蘭特正2","110/08/13","群益金鼎-延平",100,400,-300
"16307","00715L期街口布蘭特正2","110/08/13","元富-虎尾",172,0,172
"16308","00715L期街口布蘭特正2","110/08/13","元大-中和",175,450,-275
"16309","00715L期街口布蘭特正2","110/08/13","凱基-五股",163,0,163
"16310","00715L期街口布蘭特正2","110/08/13","第一金-彰化",5,230,-225
"16311","00715L期街口布蘭特正2","110/08/13","國泰-台南",155,19,136
"16312","00715L期街口布蘭特正2","110/08/13","元大-大里",16,225,-209
"16313","00715L期街口布蘭特正2","110/08/13","永豐金證券",482,350,132
"16314","00715L期街口布蘭特正2","110/08/13","港商野村",7,212,-205
"16315","00715L期街口布蘭特正2","110/08/13","元大-內湖",110,0,110
"16316","00715L期街口布蘭特正2","110/08/13","合庫-新竹",1,199,-198
"16317","00715L期街口布蘭特正2","110/08/13","兆豐-嘉義",103,0,103
"16318","00715L期街口布蘭特正2","110/08/13","高橋",9,205,-196
"16319","00715L期街口布蘭特正2","110/08/13","群益金鼎-土城",100,0,100
"16320","00715L期街口布蘭特正2","110/08/13","國泰-敦南",78,271,-193
"16321","8941關中","110/08/13","宏遠-館前",3,0,3
"16322","8941關中","110/08/13","日盛-信義",0,2,-2
"16323","8941關中","110/08/13","國泰-忠孝",1,0,1
"16324","8941關中","110/08/13","宏遠-中和",0,1,-1
"16325","8941關中","110/08/13","康和-板橋",0,0,0
"16326","8941關中","110/08/13","康和-嘉義",0,1,-1
"16327","8941關中","110/08/13","富邦-左營",0,0,0
"16328","8941關中","110/08/13","康和-板橋",0,0,0
"16329","8941關中","110/08/13","元大-松江",0,0,0
"16330","8941關中","110/08/13","富邦-左營",0,0,0
"16331","8941關中","110/08/13","元大-淡水",0,0,0
"16332","8941關中","110/08/13","元大-松江",0,0,0
"16333","8941關中","110/08/13","",NA,NA,NA
"16334","8941關中","110/08/13","元大-淡水",0,0,0
"16335","8941關中","110/08/13","",NA,NA,NA
"16336","8941關中","110/08/13","",NA,NA,NA
"16337","8941關中","110/08/13","",NA,NA,NA
"16338","8941關中","110/08/13","",NA,NA,NA
"16339","8941關中","110/08/13","",NA,NA,NA
"16340","8941關中","110/08/13","",NA,NA,NA
"16341","8941關中","110/08/13","",NA,NA,NA
"16342","8941關中","110/08/13","",NA,NA,NA
"16343","8941關中","110/08/13","",NA,NA,NA
"16344","8941關中","110/08/13","",NA,NA,NA
"16345","8941關中","110/08/13","",NA,NA,NA
"16346","8941關中","110/08/13","",NA,NA,NA
"16347","8941關中","110/08/13","",NA,NA,NA
"16348","8941關中","110/08/13","",NA,NA,NA
"16349","8941關中","110/08/13","",NA,NA,NA
"16350","8941關中","110/08/13","",NA,NA,NA
"16351","8936國統","110/08/13","台新-高雄",127,0,127
"16352","8936國統","110/08/13","第一金-豐原",0,60,-60
"16353","8936國統","110/08/13","美林",84,18,66
"16354","8936國統","110/08/13","凱基-台北",1,50,-49
"16355","8936國統","110/08/13","摩根大通",40,14,26
"16356","8936國統","110/08/13","凱基-高美館",8,51,-43
"16357","8936國統","110/08/13","凱基-台南",23,0,23
"16358","8936國統","110/08/13","港商野村",8,39,-31
"16359","8936國統","110/08/13","第一金-路竹",20,0,20
"16360","8936國統","110/08/13","日盛-忠孝",0,25,-25
"16361","8936國統","110/08/13","元大-敦化",17,0,17
"16362","8936國統","110/08/13","群益金鼎-台中",0,20,-20
"16363","8936國統","110/08/13","新光-台中",22,6,16
"16364","8936國統","110/08/13","台新-台南",0,15,-15
"16365","8936國統","110/08/13","元大-文心",15,0,15
"16366","8936國統","110/08/13","元大-博愛",0,14,-14
"16367","8936國統","110/08/13","元大-敦南",14,0,14
"16368","8936國統","110/08/13","合庫-台南",0,10,-10
"16369","8936國統","110/08/13","日盛-北高雄",12,0,12
"16370","8936國統","110/08/13","新光-桃園",0,10,-10
"16371","8936國統","110/08/13","元大-西螺",10,0,10
"16372","8936國統","110/08/13","永豐金-南投",0,10,-10
"16373","8936國統","110/08/13","彰銀",8,0,8
"16374","8936國統","110/08/13","永豐金-竹科",0,10,-10
"16375","8936國統","110/08/13","元富-大昌",8,0,8
"16376","8936國統","110/08/13","富邦-竹北",0,8,-8
"16377","8936國統","110/08/13","富邦-南屯",10,2,8
"16378","8936國統","110/08/13","元大-大里德芳",5,13,-8
"16379","8936國統","110/08/13","元大-天母",7,0,7
"16380","8936國統","110/08/13","台新證券",0,7,-7
"16381","6226光鼎","110/08/13","國泰-敦南",676,469,207
"16382","6226光鼎","110/08/13","摩根大通",267,1531,-1264
"16383","6226光鼎","110/08/13","元富-新竹",163,19,144
"16384","6226光鼎","110/08/13","美商高盛",149,1352,-1203
"16385","6226光鼎","110/08/13","合庫-台中",461,334,127
"16386","6226光鼎","110/08/13","瑞士信貸",52,752,-700
"16387","6226光鼎","110/08/13","國泰-台中",734,609,125
"16388","6226光鼎","110/08/13","凱基-台北",84,488,-404
"16389","6226光鼎","110/08/13","元大-小港",198,88,110
"16390","6226光鼎","110/08/13","台新-中壢",2,226,-224
"16391","6226光鼎","110/08/13","凱基-永和",91,0,91
"16392","6226光鼎","110/08/13","元大-文心興安",44,216,-172
"16393","6226光鼎","110/08/13","元大-西螺",82,5,77
"16394","6226光鼎","110/08/13","美林",234,376,-142
"16395","6226光鼎","110/08/13","永豐金-南京",78,1,77
"16396","6226光鼎","110/08/13","凱基-嘉義",12,126,-114
"16397","6226光鼎","110/08/13","群益金鼎-萬華",78,9,69
"16398","6226光鼎","110/08/13","富邦-陽明",23,117,-94
"16399","6226光鼎","110/08/13","日盛-八德",63,1,62
"16400","6226光鼎","110/08/13","兆豐-大安",4,85,-81
"16401","6226光鼎","110/08/13","凱基-桃園",88,27,61
"16402","6226光鼎","110/08/13","永豐金-中盛",27,107,-80
"16403","6226光鼎","110/08/13","凱基-岡山",62,1,61
"16404","6226光鼎","110/08/13","元大證券",232,304,-72
"16405","6226光鼎","110/08/13","臺銀-鳳山",110,52,58
"16406","6226光鼎","110/08/13","凱基-台中",19,84,-65
"16407","6226光鼎","110/08/13","元大-板橋三民",114,56,58
"16408","6226光鼎","110/08/13","元大-士林",107,171,-64
"16409","6226光鼎","110/08/13","凱基-板橋",195,140,55
"16410","6226光鼎","110/08/13","富邦-高雄",15,69,-54
"16411","2363矽統","110/08/13","美商高盛",416,10,406
"16412","2363矽統","110/08/13","元大-佳里",319,1216,-897
"16413","2363矽統","110/08/13","土銀",374,14,360
"16414","2363矽統","110/08/13","瑞士信貸",0,836,-836
"16415","2363矽統","110/08/13","玉山-台中",289,18,271
"16416","2363矽統","110/08/13","永豐金-中正",22,676,-654
"16417","2363矽統","110/08/13","大展",244,10,234
"16418","2363矽統","110/08/13","台灣摩根士丹利",116,566,-450
"16419","2363矽統","110/08/13","永豐金-板盛",172,22,150
"16420","2363矽統","110/08/13","宏遠-桃園",11,359,-348
"16421","2363矽統","110/08/13","富邦-仁愛",198,49,149
"16422","2363矽統","110/08/13","國泰-敦南",671,911,-240
"16423","2363矽統","110/08/13","日盛-北高雄",206,85,121
"16424","2363矽統","110/08/13","元大證券",126,352,-226
"16425","2363矽統","110/08/13","台新-三民",163,55,108
"16426","2363矽統","110/08/13","花旗環球",0,223,-223
"16427","2363矽統","110/08/13","元富-新店",130,23,107
"16428","2363矽統","110/08/13","臺銀",48,259,-211
"16429","2363矽統","110/08/13","永豐金-桃盛",108,5,103
"16430","2363矽統","110/08/13","摩根大通",268,460,-192
"16431","2363矽統","110/08/13","元大-復北",129,28,101
"16432","2363矽統","110/08/13","國票",63,248,-185
"16433","2363矽統","110/08/13","台新-屏東",116,18,98
"16434","2363矽統","110/08/13","台新-高雄",91,263,-172
"16435","2363矽統","110/08/13","華南永昌-虎尾",180,87,93
"16436","2363矽統","110/08/13","合庫證券",18,177,-159
"16437","2363矽統","110/08/13","元大-板橋",101,10,91
"16438","2363矽統","110/08/13","第一金-華江",65,206,-141
"16439","2363矽統","110/08/13","新光",343,260,83
"16440","2363矽統","110/08/13","中國信託-忠孝",65,201,-136
"16441","8112至上","110/08/13","合庫證券",160,5,155
"16442","8112至上","110/08/13","摩根大通",123,818,-695
"16443","8112至上","110/08/13","凱基-竹科",140,12,128
"16444","8112至上","110/08/13","美林",22,299,-277
"16445","8112至上","110/08/13","臺灣企銀-桃園",126,0,126
"16446","8112至上","110/08/13","第一金-華江",4,158,-154
"16447","8112至上","110/08/13","統一-中壢",79,1,78
"16448","8112至上","110/08/13","群益金鼎-基隆",1,117,-116
"16449","8112至上","110/08/13","港商麥格理",86,9,77
"16450","8112至上","110/08/13","新光-桃園",2,100,-98
"16451","8112至上","110/08/13","富邦-新竹",78,2,76
"16452","8112至上","110/08/13","永興-水湳",0,95,-95
"16453","8112至上","110/08/13","凱基-復興",67,0,67
"16454","8112至上","110/08/13","凱基-新店",50,141,-91
"16455","8112至上","110/08/13","合庫-西台中",62,2,60
"16456","8112至上","110/08/13","元富-新興",3,91,-88
"16457","8112至上","110/08/13","大慶",60,0,60
"16458","8112至上","110/08/13","凱基-台北",60,148,-88
"16459","8112至上","110/08/13","日盛-新竹",59,2,57
"16460","8112至上","110/08/13","國票-中和",4,90,-86
"16461","8112至上","110/08/13","元大-開元",53,0,53
"16462","8112至上","110/08/13","新加坡商瑞銀",5,88,-83
"16463","8112至上","110/08/13","富邦-中壢",51,4,47
"16464","8112至上","110/08/13","宏遠-民生",2,52,-50
"16465","8112至上","110/08/13","富邦-桃園",46,0,46
"16466","8112至上","110/08/13","群益金鼎-竹南",0,50,-50
"16467","8112至上","110/08/13","合庫-嘉義",44,0,44
"16468","8112至上","110/08/13","新百王",2,50,-48
"16469","8112至上","110/08/13","元大-府城",55,11,44
"16470","8112至上","110/08/13","港商野村",13,60,-47
"16471","1570力肯","110/08/13","新光",147,12,135
"16472","1570力肯","110/08/13","(牛牛牛)亞-鑫豐",15,136,-121
"16473","1570力肯","110/08/13","國票-北高雄",128,0,128
"16474","1570力肯","110/08/13","富邦-台中",0,51,-51
"16475","1570力肯","110/08/13","凱基-台北",80,24,56
"16476","1570力肯","110/08/13","日盛-頭份",0,50,-50
"16477","1570力肯","110/08/13","統一",54,0,54
"16478","1570力肯","110/08/13","元富-高雄",0,40,-40
"16479","1570力肯","110/08/13","國票-內壢",49,1,48
"16480","1570力肯","110/08/13","凱基-高美館",2,41,-39
"16481","1570力肯","110/08/13","美林",37,0,37
"16482","1570力肯","110/08/13","日盛-忠孝",0,38,-38
"16483","1570力肯","110/08/13","國票-天祥",45,8,37
"16484","1570力肯","110/08/13","元大-羅東",0,20,-20
"16485","1570力肯","110/08/13","摩根大通",67,45,22
"16486","1570力肯","110/08/13","元大-大天母",0,20,-20
"16487","1570力肯","110/08/13","永豐金-屏東",22,0,22
"16488","1570力肯","110/08/13","永豐金-嘉義",0,20,-20
"16489","1570力肯","110/08/13","元富-新店",20,0,20
"16490","1570力肯","110/08/13","國泰-敦南",2,20,-18
"16491","1570力肯","110/08/13","(牛牛牛)亞證券",20,0,20
"16492","1570力肯","110/08/13","元大-沙鹿",1,18,-17
"16493","1570力肯","110/08/13","凱基-台南",20,0,20
"16494","1570力肯","110/08/13","元大-林森",0,16,-16
"16495","1570力肯","110/08/13","元大-開元",20,0,20
"16496","1570力肯","110/08/13","永豐金-市政",1,16,-15
"16497","1570力肯","110/08/13","元大-花蓮",20,0,20
"16498","1570力肯","110/08/13","統一-三重",5,19,-14
"16499","1570力肯","110/08/13","元大-基隆",19,0,19
"16500","1570力肯","110/08/13","國泰-新莊",1,15,-14
"16501","2929淘帝","110/08/13","新光-新竹",488,287,201
"16502","2929淘帝","110/08/13","美林",17,84,-67
"16503","2929淘帝","110/08/13","元大-西門",38,1,37
"16504","2929淘帝","110/08/13","摩根大通",0,63,-63
"16505","2929淘帝","110/08/13","元富-文心",30,0,30
"16506","2929淘帝","110/08/13","港商野村",14,69,-55
"16507","2929淘帝","110/08/13","華南永昌-苗栗",30,0,30
"16508","2929淘帝","110/08/13","玉山-新竹",0,50,-50
"16509","2929淘帝","110/08/13","元大-豐原站前",31,1,30
"16510","2929淘帝","110/08/13","臺銀-新竹",0,30,-30
"16511","2929淘帝","110/08/13","元富-台南",22,0,22
"16512","2929淘帝","110/08/13","元富-三重",23,52,-29
"16513","2929淘帝","110/08/13","凱基-東門",20,0,20
"16514","2929淘帝","110/08/13","新加坡商瑞銀",18,41,-23
"16515","2929淘帝","110/08/13","永豐金-敦南",17,0,17
"16516","2929淘帝","110/08/13","兆豐-大同",0,21,-21
"16517","2929淘帝","110/08/13","新光",44,29,15
"16518","2929淘帝","110/08/13","美商高盛",0,20,-20
"16519","2929淘帝","110/08/13","元大-蘆洲",14,0,14
"16520","2929淘帝","110/08/13","台新-左楠",6,25,-19
"16521","2929淘帝","110/08/13","國票-博愛",12,0,12
"16522","2929淘帝","110/08/13","港商法國興業",0,14,-14
"16523","2929淘帝","110/08/13","合庫-自強",10,0,10
"16524","2929淘帝","110/08/13","台新證券",7,21,-14
"16525","2929淘帝","110/08/13","兆豐-桃園",10,0,10
"16526","2929淘帝","110/08/13","元大-館前",0,14,-14
"16527","2929淘帝","110/08/13","凱基-頭份",10,0,10
"16528","2929淘帝","110/08/13","亞東-新竹",0,13,-13
"16529","2929淘帝","110/08/13","華南永昌-大安",10,0,10
"16530","2929淘帝","110/08/13","元大-永和",7,20,-13
"16531","5410國眾","110/08/13","土銀-嘉義",21,0,21
"16532","5410國眾","110/08/13","國泰-敦南",20,102,-82
"16533","5410國眾","110/08/13","日盛-大墩",15,0,15
"16534","5410國眾","110/08/13","元大-大雅",0,64,-64
"16535","5410國眾","110/08/13","群益金鼎-民權",14,0,14
"16536","5410國眾","110/08/13","大昌-新店",0,37,-37
"16537","5410國眾","110/08/13","玉山-嘉義",12,0,12
"16538","5410國眾","110/08/13","陽信-石牌",0,33,-33
"16539","5410國眾","110/08/13","元大-新竹經國",12,0,12
"16540","5410國眾","110/08/13","摩根大通",0,26,-26
"16541","5410國眾","110/08/13","日盛-屏東",10,0,10
"16542","5410國眾","110/08/13","瑞士信貸",0,18,-18
"16543","5410國眾","110/08/13","富邦-竹北",10,0,10
"16544","5410國眾","110/08/13","元大-北投",8,22,-14
"16545","5410國眾","110/08/13","元富",10,1,9
"16546","5410國眾","110/08/13","合庫-台中",0,10,-10
"16547","5410國眾","110/08/13","凱基-八德",9,0,9
"16548","5410國眾","110/08/13","合庫-新竹",0,10,-10
"16549","5410國眾","110/08/13","富邦-台北",9,0,9
"16550","5410國眾","110/08/13","元大-善化",0,10,-10
"16551","5410國眾","110/08/13","富邦-新店",10,1,9
"16552","5410國眾","110/08/13","大昌",0,9,-9
"16553","5410國眾","110/08/13","元富-虎尾",8,0,8
"16554","5410國眾","110/08/13","兆豐-三重",0,9,-9
"16555","5410國眾","110/08/13","統一",7,0,7
"16556","5410國眾","110/08/13","新光",17,25,-8
"16557","5410國眾","110/08/13","日茂-南投",7,0,7
"16558","5410國眾","110/08/13","亞東-新竹",0,5,-5
"16559","5410國眾","110/08/13","元大-彰化",7,0,7
"16560","5410國眾","110/08/13","兆豐-桃鶯",0,5,-5
"16561","2841台開","110/08/13","宏遠-館前",181,0,181
"16562","2841台開","110/08/13","永豐金-內湖",0,77,-77
"16563","2841台開","110/08/13","日盛證券",70,1,69
"16564","2841台開","110/08/13","富邦-岡山",0,72,-72
"16565","2841台開","110/08/13","台新-三民",50,0,50
"16566","2841台開","110/08/13","永豐金-屏東",0,50,-50
"16567","2841台開","110/08/13","凱基-市政",18,0,18
"16568","2841台開","110/08/13","港商野村",0,38,-38
"16569","2841台開","110/08/13","新光",32,16,16
"16570","2841台開","110/08/13","元大-林園",0,30,-30
"16571","2841台開","110/08/13","兆豐-新營",15,0,15
"16572","2841台開","110/08/13","永豐金-敦南",13,42,-29
"16573","2841台開","110/08/13","日盛-內湖",12,0,12
"16574","2841台開","110/08/13","臺銀-民權",0,20,-20
"16575","2841台開","110/08/13","群益金鼎-基隆",11,0,11
"16576","2841台開","110/08/13","元大-崇德",0,19,-19
"16577","2841台開","110/08/13","富邦-台北",10,0,10
"16578","2841台開","110/08/13","日盛-中壢",0,18,-18
"16579","2841台開","110/08/13","元大-歸仁",10,0,10
"16580","2841台開","110/08/13","兆豐-板橋",0,10,-10
"16581","2841台開","110/08/13","凱基-台北",9,2,7
"16582","2841台開","110/08/13","豐農",0,10,-10
"16583","2841台開","110/08/13","元大-福營",10,3,7
"16584","2841台開","110/08/13","元大-北三重",0,10,-10
"16585","2841台開","110/08/13","元富-文心",5,0,5
"16586","2841台開","110/08/13","台新證券",6,13,-7
"16587","2841台開","110/08/13","凱基-東港",5,0,5
"16588","2841台開","110/08/13","光和-嘉義",0,6,-6
"16589","2841台開","110/08/13","元富-成功",3,0,3
"16590","2841台開","110/08/13","中國信託-高雄",0,5,-5
"16591","6207雷科","110/08/13","安泰",51,0,51
"16592","6207雷科","110/08/13","摩根大通",12,80,-68
"16593","6207雷科","110/08/13","永豐金證券",34,0,34
"16594","6207雷科","110/08/13","美林",1,34,-33
"16595","6207雷科","110/08/13","元大-潮州",32,0,32
"16596","6207雷科","110/08/13","新加坡商瑞銀",18,45,-27
"16597","6207雷科","110/08/13","元大-六合",30,0,30
"16598","6207雷科","110/08/13","凱基-復興",0,20,-20
"16599","6207雷科","110/08/13","富邦-中壢",20,0,20
"16600","6207雷科","110/08/13","凱基-台北",15,31,-16
"16601","6207雷科","110/08/13","統一-台中",10,0,10
"16602","6207雷科","110/08/13","港商野村",1,13,-12
"16603","6207雷科","110/08/13","凱基-岡山",10,0,10
"16604","6207雷科","110/08/13","群益金鼎-東門",0,12,-12
"16605","6207雷科","110/08/13","元大-東門",10,0,10
"16606","6207雷科","110/08/13","凱基-三峽",4,15,-11
"16607","6207雷科","110/08/13","元大-大天母",13,3,10
"16608","6207雷科","110/08/13","兆豐-公益",0,9,-9
"16609","6207雷科","110/08/13","元大-路竹",8,0,8
"16610","6207雷科","110/08/13","元大-鳳山",0,8,-8
"16611","6207雷科","110/08/13","富邦-敦南",7,0,7
"16612","6207雷科","110/08/13","合庫-鳳山",0,6,-6
"16613","6207雷科","110/08/13","兆豐-彰化",6,0,6
"16614","6207雷科","110/08/13","凱基-三重",0,6,-6
"16615","6207雷科","110/08/13","群益金鼎-土城",6,0,6
"16616","6207雷科","110/08/13","凱基-幸福",0,6,-6
"16617","6207雷科","110/08/13","玉山-台南",5,0,5
"16618","6207雷科","110/08/13","富邦-基隆",0,6,-6
"16619","6207雷科","110/08/13","凱基-湖口",5,0,5
"16620","6207雷科","110/08/13","元大-清水",0,6,-6
"16621","3679新至陞","110/08/13","元大-大天母",20,0,20
"16622","3679新至陞","110/08/13","摩根大通",2,27,-25
"16623","3679新至陞","110/08/13","台灣摩根士丹利",12,0,12
"16624","3679新至陞","110/08/13","瑞士信貸",1,16,-15
"16625","3679新至陞","110/08/13","元大-成功",10,0,10
"16626","3679新至陞","110/08/13","美林",0,10,-10
"16627","3679新至陞","110/08/13","兆豐-高雄",9,0,9
"16628","3679新至陞","110/08/13","凱基-台北",11,16,-5
"16629","3679新至陞","110/08/13","國泰-松江",4,0,4
"16630","3679新至陞","110/08/13","元大-東蘆",0,5,-5
"16631","3679新至陞","110/08/13","元大-大同",3,0,3
"16632","3679新至陞","110/08/13","元大-北成功",0,4,-4
"16633","3679新至陞","110/08/13","合庫-台中",2,0,2
"16634","3679新至陞","110/08/13","富邦-中壢",0,3,-3
"16635","3679新至陞","110/08/13","台中銀-員林",2,0,2
"16636","3679新至陞","110/08/13","彰銀",0,2,-2
"16637","3679新至陞","110/08/13","康和-板橋",2,0,2
"16638","3679新至陞","110/08/13","凱基-大安",0,2,-2
"16639","3679新至陞","110/08/13","新光-高雄",2,0,2
"16640","3679新至陞","110/08/13","華南永昌-鶯歌",0,2,-2
"16641","3679新至陞","110/08/13","凱基-文心",5,3,2
"16642","3679新至陞","110/08/13","富邦-仁愛",0,2,-2
"16643","3679新至陞","110/08/13","元大-景美",2,0,2
"16644","3679新至陞","110/08/13","元大證券",1,3,-2
"16645","3679新至陞","110/08/13","元大-土城永寧",2,0,2
"16646","3679新至陞","110/08/13","元大-土城",0,2,-2
"16647","3679新至陞","110/08/13","美商高盛",1,0,1
"16648","3679新至陞","110/08/13","台灣企銀-民雄",0,1,-1
"16649","3679新至陞","110/08/13","台新證券",1,0,1
"16650","3679新至陞","110/08/13","日盛證券",0,1,-1
"16651","2727王品","110/08/13","新光",27,6,21
"16652","2727王品","110/08/13","摩根大通",1,53,-52
"16653","2727王品","110/08/13","大慶-富順",20,0,20
"16654","2727王品","110/08/13","土銀-南港",0,40,-40
"16655","2727王品","110/08/13","兆豐-東門",17,0,17
"16656","2727王品","110/08/13","港商麥格理",0,24,-24
"16657","2727王品","110/08/13","新光-台中",19,2,17
"16658","2727王品","110/08/13","新加坡商瑞銀",0,21,-21
"16659","2727王品","110/08/13","元大-竹科",11,0,11
"16660","2727王品","110/08/13","康和-台南",1,22,-21
"16661","2727王品","110/08/13","日盛-屏東",10,0,10
"16662","2727王品","110/08/13","富邦-員林",0,17,-17
"16663","2727王品","110/08/13","彰銀-七賢",10,0,10
"16664","2727王品","110/08/13","港商野村",3,18,-15
"16665","2727王品","110/08/13","玉山-大里",10,0,10
"16666","2727王品","110/08/13","富邦-新營",0,15,-15
"16667","2727王品","110/08/13","富邦-台中",12,2,10
"16668","2727王品","110/08/13","台灣企銀-竹北",3,17,-14
"16669","2727王品","110/08/13","國泰-敦南",15,6,9
"16670","2727王品","110/08/13","國泰-板橋",3,17,-14
"16671","2727王品","110/08/13","臺銀",9,1,8
"16672","2727王品","110/08/13","凱基-板橋",0,13,-13
"16673","2727王品","110/08/13","元大-台中",8,0,8
"16674","2727王品","110/08/13","日盛-中和",1,13,-12
"16675","2727王品","110/08/13","國泰-台中",11,4,7
"16676","2727王品","110/08/13","第一金-新竹",1,12,-11
"16677","2727王品","110/08/13","永豐金-彰化",7,0,7
"16678","2727王品","110/08/13","統一",1,12,-11
"16679","2727王品","110/08/13","新光-桃園",6,0,6
"16680","2727王品","110/08/13","統一-竹南",0,10,-10
"16681","1570力肯","110/08/13","新光",147,12,135
"16682","1570力肯","110/08/13","(牛牛牛)亞-鑫豐",15,136,-121
"16683","1570力肯","110/08/13","國票-北高雄",128,0,128
"16684","1570力肯","110/08/13","富邦-台中",0,51,-51
"16685","1570力肯","110/08/13","凱基-台北",80,24,56
"16686","1570力肯","110/08/13","日盛-頭份",0,50,-50
"16687","1570力肯","110/08/13","統一",54,0,54
"16688","1570力肯","110/08/13","元富-高雄",0,40,-40
"16689","1570力肯","110/08/13","國票-內壢",49,1,48
"16690","1570力肯","110/08/13","凱基-高美館",2,41,-39
"16691","1570力肯","110/08/13","美林",37,0,37
"16692","1570力肯","110/08/13","日盛-忠孝",0,38,-38
"16693","1570力肯","110/08/13","國票-天祥",45,8,37
"16694","1570力肯","110/08/13","元大-羅東",0,20,-20
"16695","1570力肯","110/08/13","摩根大通",67,45,22
"16696","1570力肯","110/08/13","元大-大天母",0,20,-20
"16697","1570力肯","110/08/13","永豐金-屏東",22,0,22
"16698","1570力肯","110/08/13","永豐金-嘉義",0,20,-20
"16699","1570力肯","110/08/13","元富-新店",20,0,20
"16700","1570力肯","110/08/13","國泰-敦南",2,20,-18
"16701","1570力肯","110/08/13","(牛牛牛)亞證券",20,0,20
"16702","1570力肯","110/08/13","元大-沙鹿",1,18,-17
"16703","1570力肯","110/08/13","凱基-台南",20,0,20
"16704","1570力肯","110/08/13","元大-林森",0,16,-16
"16705","1570力肯","110/08/13","元大-開元",20,0,20
"16706","1570力肯","110/08/13","永豐金-市政",1,16,-15
"16707","1570力肯","110/08/13","元大-花蓮",20,0,20
"16708","1570力肯","110/08/13","統一-三重",5,19,-14
"16709","1570力肯","110/08/13","元大-基隆",19,0,19
"16710","1570力肯","110/08/13","國泰-新莊",1,15,-14
"16711","6180橘子","110/08/13","美商高盛",48,0,48
"16712","6180橘子","110/08/13","玉山-桃園",1,30,-29
"16713","6180橘子","110/08/13","美林",37,0,37
"16714","6180橘子","110/08/13","元大-成功",0,22,-22
"16715","6180橘子","110/08/13","凱基-台北",17,1,16
"16716","6180橘子","110/08/13","群益金鼎",0,11,-11
"16717","6180橘子","110/08/13","台新證券",15,1,14
"16718","6180橘子","110/08/13","亞東-高雄",0,10,-10
"16719","6180橘子","110/08/13","台灣摩根士丹利",13,0,13
"16720","6180橘子","110/08/13","元大-北港",0,10,-10
"16721","6180橘子","110/08/13","元大-北投",11,0,11
"16722","6180橘子","110/08/13","統一-彰化",3,10,-7
"16723","6180橘子","110/08/13","合庫-自強",10,0,10
"16724","6180橘子","110/08/13","摩根大通",6,13,-7
"16725","6180橘子","110/08/13","統一-台南",10,0,10
"16726","6180橘子","110/08/13","群益金鼎-中山",1,8,-7
"16727","6180橘子","110/08/13","兆豐-台中",10,0,10
"16728","6180橘子","110/08/13","元大-敦南",0,7,-7
"16729","6180橘子","110/08/13","群益金鼎-台中",10,0,10
"16730","6180橘子","110/08/13","國泰-板橋",0,6,-6
"16731","6180橘子","110/08/13","康和-台中",6,0,6
"16732","6180橘子","110/08/13","富邦-宜蘭",0,6,-6
"16733","6180橘子","110/08/13","凱基-汐止",5,0,5
"16734","6180橘子","110/08/13","元大-台北",0,6,-6
"16735","6180橘子","110/08/13","日盛-景美",6,2,4
"16736","6180橘子","110/08/13","永豐金-板橋",0,6,-6
"16737","6180橘子","110/08/13","新光-台中",4,0,4
"16738","6180橘子","110/08/13","亞東",0,5,-5
"16739","6180橘子","110/08/13","國泰-敦南",4,0,4
"16740","6180橘子","110/08/13","兆豐-竹北",0,5,-5
"16741","2390云辰","110/08/13","摩根大通",643,393,250
"16742","2390云辰","110/08/13","元大-信義",0,202,-202
"16743","2390云辰","110/08/13","美商高盛",269,138,131
"16744","2390云辰","110/08/13","美林",169,289,-120
"16745","2390云辰","110/08/13","凱基-台北",418,293,125
"16746","2390云辰","110/08/13","元大-東港",9,102,-93
"16747","2390云辰","110/08/13","元富-板橋",94,13,81
"16748","2390云辰","110/08/13","元富-高雄",17,94,-77
"16749","2390云辰","110/08/13","土銀-士林",78,0,78
"16750","2390云辰","110/08/13","凱基-竹科",5,76,-71
"16751","2390云辰","110/08/13","元大-前金",92,16,76
"16752","2390云辰","110/08/13","國票-博愛",40,107,-67
"16753","2390云辰","110/08/13","台新-台中",89,24,65
"16754","2390云辰","110/08/13","群益金鼎-開元",26,90,-64
"16755","2390云辰","110/08/13","光和-嘉義",73,10,63
"16756","2390云辰","110/08/13","新加坡商瑞銀",4,61,-57
"16757","2390云辰","110/08/13","富邦-敦南",59,0,59
"16758","2390云辰","110/08/13","港商野村",277,333,-56
"16759","2390云辰","110/08/13","富邦-彰化",69,11,58
"16760","2390云辰","110/08/13","新光",144,197,-53
"16761","2390云辰","110/08/13","元大-草屯",75,17,58
"16762","2390云辰","110/08/13","統一",23,75,-52
"16763","2390云辰","110/08/13","光和-溪湖",54,1,53
"16764","2390云辰","110/08/13","元大-林園",0,51,-51
"16765","2390云辰","110/08/13","元大-土城學府",263,210,53
"16766","2390云辰","110/08/13","富邦-新營",1,48,-47
"16767","2390云辰","110/08/13","元大-文心興安",64,11,53
"16768","2390云辰","110/08/13","元大-新莊",33,80,-47
"16769","2390云辰","110/08/13","國泰-忠孝",50,0,50
"16770","2390云辰","110/08/13","日盛-園區",10,55,-45
"16771","2867三商壽","110/08/12","新光",292,1,291
"16772","2867三商壽","110/08/12","摩根大通",53,266,-213
"16773","2867三商壽","110/08/12","元大-土城永寧",200,0,200
"16774","2867三商壽","110/08/12","元大-崇德",3,201,-198
"16775","2867三商壽","110/08/12","合庫證券",100,0,100
"16776","2867三商壽","110/08/12","美商高盛",31,159,-128
"16777","2867三商壽","110/08/12","土銀",100,0,100
"16778","2867三商壽","110/08/12","富邦證券",0,120,-120
"16779","2867三商壽","110/08/12","臺銀-臺南",100,0,100
"16780","2867三商壽","110/08/12","凱基-信義",0,117,-117
"16781","2867三商壽","110/08/12","元富-古亭",100,0,100
"16782","2867三商壽","110/08/12","凱基-台北",2,113,-111
"16783","2867三商壽","110/08/12","元大-新莊",100,0,100
"16784","2867三商壽","110/08/12","凱基-虎尾",0,100,-100
"16785","2867三商壽","110/08/12","凱基",97,0,97
"16786","2867三商壽","110/08/12","元大-南投",0,92,-92
"16787","2867三商壽","110/08/12","元大-桃園",60,0,60
"16788","2867三商壽","110/08/12","台灣摩根士丹利",0,70,-70
"16789","2867三商壽","110/08/12","合庫-西台中",51,0,51
"16790","2867三商壽","110/08/12","美林",8,72,-64
"16791","2867三商壽","110/08/12","華南永昌-鳳山",51,1,50
"16792","2867三商壽","110/08/12","新加坡商瑞銀",0,61,-61
"16793","2867三商壽","110/08/12","元大-沙鹿",39,0,39
"16794","2867三商壽","110/08/12","群益金鼎-台北",0,60,-60
"16795","2867三商壽","110/08/12","光和",30,0,30
"16796","2867三商壽","110/08/12","富邦-宜蘭",0,50,-50
"16797","2867三商壽","110/08/12","元大-龍潭",30,0,30
"16798","2867三商壽","110/08/12","元大-旗山",0,50,-50
"16799","2867三商壽","110/08/12","永豐金-員林",30,0,30
"16800","2867三商壽","110/08/12","元富-吉利",0,27,-27
"16801","5521工信","110/08/12","日進",900,0,900
"16802","5521工信","110/08/12","永豐金證券",14,200,-186
"16803","5521工信","110/08/12","摩根大通",678,57,621
"16804","5521工信","110/08/12","富邦-中壢",2,112,-110
"16805","5521工信","110/08/12","國票-安和",254,20,234
"16806","5521工信","110/08/12","中國信託-嘉義",0,100,-100
"16807","5521工信","110/08/12","凱基-台北",194,46,148
"16808","5521工信","110/08/12","元大-南屯",0,58,-58
"16809","5521工信","110/08/12","日盛-中和",103,10,93
"16810","5521工信","110/08/12","凱基-中壢",0,55,-55
"16811","5521工信","110/08/12","新光-新竹",80,5,75
"16812","5521工信","110/08/12","(牛牛牛)亞-鑫豐",1,52,-51
"16813","5521工信","110/08/12","美林",69,10,59
"16814","5521工信","110/08/12","台新證券",1,51,-50
"16815","5521工信","110/08/12","富邦-台北",69,20,49
"16816","5521工信","110/08/12","群益金鼎-崇德",0,48,-48
"16817","5521工信","110/08/12","新光-台南",37,0,37
"16818","5521工信","110/08/12","康和-內湖",0,46,-46
"16819","5521工信","110/08/12","永豐金-鳳山",32,0,32
"16820","5521工信","110/08/12","日盛-新莊",0,45,-45
"16821","5521工信","110/08/12","第一金-台南",67,42,25
"16822","5521工信","110/08/12","元大-旗山",1,46,-45
"16823","5521工信","110/08/12","台灣企銀-台中",20,0,20
"16824","5521工信","110/08/12","元大-內湖",0,45,-45
"16825","5521工信","110/08/12","康和-澎湖",20,0,20
"16826","5521工信","110/08/12","日盛-高雄",0,42,-42
"16827","5521工信","110/08/12","凱基-三多",20,0,20
"16828","5521工信","110/08/12","元大-大同",0,42,-42
"16829","5521工信","110/08/12","元大-仁愛",20,0,20
"16830","5521工信","110/08/12","第一金-新竹",0,40,-40
"16831","1471首利","110/08/12","摩根大通",190,21,169
"16832","1471首利","110/08/12","光和-溪湖",0,75,-75
"16833","1471首利","110/08/12","元大-敦化",100,0,100
"16834","1471首利","110/08/12","富邦-基隆",2,41,-39
"16835","1471首利","110/08/12","瑞士信貸",86,0,86
"16836","1471首利","110/08/12","凱基-台南",0,30,-30
"16837","1471首利","110/08/12","美商高盛",51,0,51
"16838","1471首利","110/08/12","元富-民權",0,29,-29
"16839","1471首利","110/08/12","美林",49,0,49
"16840","1471首利","110/08/12","凱基-東門",0,24,-24
"16841","1471首利","110/08/12","國票-北高雄",20,0,20
"16842","1471首利","110/08/12","永興-大墩",0,20,-20
"16843","1471首利","110/08/12","凱基-五股",20,0,20
"16844","1471首利","110/08/12","元大-土城",1,21,-20
"16845","1471首利","110/08/12","永豐金-中壢",20,0,20
"16846","1471首利","110/08/12","凱基-內埔",1,20,-19
"16847","1471首利","110/08/12","凱基-台北",16,0,16
"16848","1471首利","110/08/12","中國信託",0,17,-17
"16849","1471首利","110/08/12","台新證券",16,3,13
"16850","1471首利","110/08/12","華南永昌-中正",2,19,-17
"16851","1471首利","110/08/12","兆豐-員林",15,3,12
"16852","1471首利","110/08/12","中國信託-文心",0,16,-16
"16853","1471首利","110/08/12","中國信託-永康",10,0,10
"16854","1471首利","110/08/12","兆豐-台南",1,17,-16
"16855","1471首利","110/08/12","華南永昌-麻豆",11,1,10
"16856","1471首利","110/08/12","凱基-新豐",0,15,-15
"16857","1471首利","110/08/12","元大-新營",10,0,10
"16858","1471首利","110/08/12","永豐金-新莊",0,15,-15
"16859","1471首利","110/08/12","新加坡商瑞銀",6,0,6
"16860","1471首利","110/08/12","凱基-彰化",6,20,-14
"16861","2883開發金","110/08/12","美林",2636,759,1877
"16862","2883開發金","110/08/12","摩根大通",28,5087,-5059
"16863","2883開發金","110/08/12","華南永昌",889,3,886
"16864","2883開發金","110/08/12","新加坡商瑞銀",111,2619,-2508
"16865","2883開發金","110/08/12","美商高盛",1037,275,762
"16866","2883開發金","110/08/12","富邦-彰化",7,809,-802
"16867","2883開發金","110/08/12","凱基-員林",600,0,600
"16868","2883開發金","110/08/12","瑞士信貸",773,1528,-755
"16869","2883開發金","110/08/12","日盛-中壢",532,9,523
"16870","2883開發金","110/08/12","港商野村",2,600,-598
"16871","2883開發金","110/08/12","元大證券",631,169,462
"16872","2883開發金","110/08/12","宏遠-民生",0,500,-500
"16873","2883開發金","110/08/12","玉山-高雄",457,5,452
"16874","2883開發金","110/08/12","元大-桃園",19,504,-485
"16875","2883開發金","110/08/12","元大-員林",435,0,435
"16876","2883開發金","110/08/12","台灣摩根士丹利",1506,1983,-477
"16877","2883開發金","110/08/12","永豐金-高雄",343,20,323
"16878","2883開發金","110/08/12","永豐金-台南",29,495,-466
"16879","2883開發金","110/08/12","日盛-大墩",321,0,321
"16880","2883開發金","110/08/12","元大-斗六",4,457,-453
"16881","2883開發金","110/08/12","台新-三民",338,19,319
"16882","2883開發金","110/08/12","群益金鼎-桃園",36,314,-278
"16883","2883開發金","110/08/12","國泰-敦南",468,170,298
"16884","2883開發金","110/08/12","群益金鼎-開元",15,221,-206
"16885","2883開發金","110/08/12","兆豐-北高雄",258,6,252
"16886","2883開發金","110/08/12","土銀-台中",1,202,-201
"16887","2883開發金","110/08/12","安泰",272,53,219
"16888","2883開發金","110/08/12","凱基-台中",12,204,-192
"16889","2883開發金","110/08/12","群益金鼎-彰化",218,4,214
"16890","2883開發金","110/08/12","永豐金-中盛",55,246,-191
"16891","6205詮欣","110/08/12","元大-新竹經國",12,0,12
"16892","6205詮欣","110/08/12","元大-善化",0,20,-20
"16893","6205詮欣","110/08/12","臺銀-民權",8,0,8
"16894","6205詮欣","110/08/12","瑞士信貸",0,4,-4
"16895","6205詮欣","110/08/12","聯邦-嘉義",5,0,5
"16896","6205詮欣","110/08/12","群益金鼎-板橋",0,4,-4
"16897","6205詮欣","110/08/12","中國信託-三重",3,0,3
"16898","6205詮欣","110/08/12","元大-屏東民生",0,4,-4
"16899","6205詮欣","110/08/12","德信-新營",3,0,3
"16900","6205詮欣","110/08/12","臺銀-高雄",0,3,-3
"16901","6205詮欣","110/08/12","合庫-彰化",2,0,2
"16902","6205詮欣","110/08/12","凱基-南崁",0,3,-3
"16903","6205詮欣","110/08/12","新光-台南",2,0,2
"16904","6205詮欣","110/08/12","元大-華山",0,3,-3
"16905","6205詮欣","110/08/12","玉山-雙和",2,0,2
"16906","6205詮欣","110/08/12","摩根大通",0,2,-2
"16907","6205詮欣","110/08/12","元大-南投",2,0,2
"16908","6205詮欣","110/08/12","兆豐-新營",0,1,-1
"16909","6205詮欣","110/08/12","統一-三重",1,0,1
"16910","6205詮欣","110/08/12","兆豐-中壢",0,1,-1
"16911","6205詮欣","110/08/12","元富-安南",1,0,1
"16912","6205詮欣","110/08/12","凱基-台北",0,1,-1
"16913","6205詮欣","110/08/12","豐農",1,0,1
"16914","6205詮欣","110/08/12","凱基-竹科",0,1,-1
"16915","6205詮欣","110/08/12","北城證券",1,0,1
"16916","6205詮欣","110/08/12","富邦-高雄",0,1,-1
"16917","6205詮欣","110/08/12","玉山-嘉義",1,0,1
"16918","6205詮欣","110/08/12","元大-路竹",0,1,-1
"16919","6205詮欣","110/08/12","凱基-五股",1,0,1
"16920","6205詮欣","110/08/12","元大-屏南",0,1,-1
"16921","1540喬福","110/08/12","元富-中原",20,0,20
"16922","1540喬福","110/08/12","永豐金-豐原",0,64,-64
"16923","1540喬福","110/08/12","台中銀",17,0,17
"16924","1540喬福","110/08/12","統一-新台中",0,19,-19
"16925","1540喬福","110/08/12","凱基-中壢",11,0,11
"16926","1540喬福","110/08/12","凱基-興隆",0,7,-7
"16927","1540喬福","110/08/12","凱基-台中",8,0,8
"16928","1540喬福","110/08/12","玉山-城中",0,6,-6
"16929","1540喬福","110/08/12","亞東",5,0,5
"16930","1540喬福","110/08/12","富邦-台北",1,5,-4
"16931","1540喬福","110/08/12","群益金鼎-古亭",5,0,5
"16932","1540喬福","110/08/12","元大-左營",0,2,-2
"16933","1540喬福","110/08/12","美林",4,0,4
"16934","1540喬福","110/08/12","國泰-敦南",0,1,-1
"16935","1540喬福","110/08/12","兆豐-鹿港",4,0,4
"16936","1540喬福","110/08/12","凱基-基隆",0,1,-1
"16937","1540喬福","110/08/12","港商法國興業",3,0,3
"16938","1540喬福","110/08/12","凱基-大里",0,1,-1
"16939","1540喬福","110/08/12","凱基-苗栗",3,0,3
"16940","1540喬福","110/08/12","元富-中壢",0,0,0
"16941","1540喬福","110/08/12","國票-台中",2,0,2
"16942","1540喬福","110/08/12","凱基-竹北",0,0,0
"16943","1540喬福","110/08/12","兆豐-高雄",2,0,2
"16944","1540喬福","110/08/12","凱基-台北",1,1,0
"16945","1540喬福","110/08/12","元富-緯城",2,0,2
"16946","1540喬福","110/08/12","華南永昌-南京",0,0,0
"16947","1540喬福","110/08/12","華南永昌-台中",2,0,2
"16948","1540喬福","110/08/12","富邦-高雄",0,0,0
"16949","1540喬福","110/08/12","富邦-中壢",2,0,2
"16950","1540喬福","110/08/12","富邦-三重",0,0,0
"16951","2888新光金","110/08/12","群益金鼎-崇德",2118,3,2115
"16952","2888新光金","110/08/12","國票-台東",12,1903,-1891
"16953","2888新光金","110/08/12","國票-九鼎",2175,141,2034
"16954","2888新光金","110/08/12","永豐金-竹科",0,1186,-1186
"16955","2888新光金","110/08/12","元大-忠孝鼎富",986,4,982
"16956","2888新光金","110/08/12","群益金鼎-民權",1,1049,-1048
"16957","2888新光金","110/08/12","台灣摩根士丹利",992,319,673
"16958","2888新光金","110/08/12","凱基-台北",1172,2195,-1023
"16959","2888新光金","110/08/12","港商法國興業",670,0,670
"16960","2888新光金","110/08/12","摩根大通",829,1704,-875
"16961","2888新光金","110/08/12","富邦-內湖",605,0,605
"16962","2888新光金","110/08/12","美林",248,668,-420
"16963","2888新光金","110/08/12","華南永昌-台中",600,3,597
"16964","2888新光金","110/08/12","群益金鼎-鳳山",2,404,-402
"16965","2888新光金","110/08/12","元大-豐原站前",556,38,518
"16966","2888新光金","110/08/12","新加坡商瑞銀",470,857,-387
"16967","2888新光金","110/08/12","瑞士信貸",643,139,504
"16968","2888新光金","110/08/12","香港上海匯豐",22,270,-248
"16969","2888新光金","110/08/12","元大-永和",505,8,497
"16970","2888新光金","110/08/12","合庫證券",2,232,-230
"16971","2888新光金","110/08/12","法銀巴黎",498,9,489
"16972","2888新光金","110/08/12","元大-大同",0,214,-214
"16973","2888新光金","110/08/12","福邦-新竹",430,0,430
"16974","2888新光金","110/08/12","元富-文心",2,210,-208
"16975","2888新光金","110/08/12","凱基-鳳山",379,3,376
"16976","2888新光金","110/08/12","新光",154,346,-192
"16977","2888新光金","110/08/12","康和-內湖",306,7,299
"16978","2888新光金","110/08/12","元富-城東",28,215,-187
"16979","2888新光金","110/08/12","元大-樹林",300,10,290
"16980","2888新光金","110/08/12","富邦-彰化",23,201,-178
"16981","1340勝悅","110/08/12","國泰-台中",11,0,11
"16982","1340勝悅","110/08/12","中國信託",0,76,-76
"16983","1340勝悅","110/08/12","元大-博愛",10,0,10
"16984","1340勝悅","110/08/12","日盛-八德",0,14,-14
"16985","1340勝悅","110/08/12","凱基-台北",8,1,7
"16986","1340勝悅","110/08/12","摩根大通",3,13,-10
"16987","1340勝悅","110/08/12","臺灣企銀-埔墘",5,0,5
"16988","1340勝悅","110/08/12","日盛-木柵",0,7,-7
"16989","1340勝悅","110/08/12","第一金-新竹",5,0,5
"16990","1340勝悅","110/08/12","元大-路竹",0,7,-7
"16991","1340勝悅","110/08/12","元富-新興",5,0,5
"16992","1340勝悅","110/08/12","群益金鼎-內湖",0,4,-4
"16993","1340勝悅","110/08/12","兆豐-台南",5,0,5
"16994","1340勝悅","110/08/12","凱基-彰化",0,4,-4
"16995","1340勝悅","110/08/12","玉山-士林",5,0,5
"16996","1340勝悅","110/08/12","元大-大天母",0,3,-3
"16997","1340勝悅","110/08/12","華南永昌-新莊",5,0,5
"16998","1340勝悅","110/08/12","統一-城中",4,6,-2
"16999","1340勝悅","110/08/12","美商高盛",4,0,4
"17000","1340勝悅","110/08/12","兆豐-新竹",0,2,-2
"17001","1340勝悅","110/08/12","港商法國興業",3,0,3
"17002","1340勝悅","110/08/12","台新證券",0,2,-2
"17003","1340勝悅","110/08/12","台新-台中",3,0,3
"17004","1340勝悅","110/08/12","富邦-台南",0,2,-2
"17005","1340勝悅","110/08/12","玉山-台大",3,0,3
"17006","1340勝悅","110/08/12","元大-新營",0,2,-2
"17007","1340勝悅","110/08/12","國泰-高雄",3,0,3
"17008","1340勝悅","110/08/12","瑞士信貸",2,3,-1
"17009","1340勝悅","110/08/12","元大-竹南",3,0,3
"17010","1340勝悅","110/08/12","永豐金-中正",0,1,-1
"17011","6246臺龍","110/08/12","元大-南投",75,0,75
"17012","6246臺龍","110/08/12","統一-台中",0,58,-58
"17013","6246臺龍","110/08/12","元大-台北",32,0,32
"17014","6246臺龍","110/08/12","合庫-台中",1,41,-40
"17015","6246臺龍","110/08/12","元富-世貿",30,2,28
"17016","6246臺龍","110/08/12","凱基-市府",0,40,-40
"17017","6246臺龍","110/08/12","凱基-永和",25,0,25
"17018","6246臺龍","110/08/12","日盛-木柵",4,33,-29
"17019","6246臺龍","110/08/12","元富-新店",18,3,15
"17020","6246臺龍","110/08/12","凱基-台北",1,29,-28
"17021","6246臺龍","110/08/12","華南永昌-忠孝",12,0,12
"17022","6246臺龍","110/08/12","永豐金-內湖",2,30,-28
"17023","6246臺龍","110/08/12","永豐金-復興",12,0,12
"17024","6246臺龍","110/08/12","元大-中壢",23,44,-21
"17025","6246臺龍","110/08/12","富邦-敦南",11,0,11
"17026","6246臺龍","110/08/12","永全-南崁",0,20,-20
"17027","6246臺龍","110/08/12","元大證券",13,2,11
"17028","6246臺龍","110/08/12","國泰-敦南",7,27,-20
"17029","6246臺龍","110/08/12","大慶-蘆洲",10,0,10
"17030","6246臺龍","110/08/12","大昌",0,18,-18
"17031","6246臺龍","110/08/12","元大-新莊",10,0,10
"17032","6246臺龍","110/08/12","新光-台中",3,17,-14
"17033","6246臺龍","110/08/12","元大-林園",10,1,9
"17034","6246臺龍","110/08/12","元大-金門",3,16,-13
"17035","6246臺龍","110/08/12","元大-西屯",10,2,8
"17036","6246臺龍","110/08/12","永全",0,10,-10
"17037","6246臺龍","110/08/12","兆豐-公益",7,0,7
"17038","6246臺龍","110/08/12","元大-新店中正",0,10,-10
"17039","6246臺龍","110/08/12","群益金鼎-開元",7,0,7
"17040","6246臺龍","110/08/12","日盛-八德",0,8,-8
"17041","00715L期街口布蘭特正2","110/08/12","元大證券",13644,167,13477
"17042","00715L期街口布蘭特正2","110/08/12","元大-林森",0,780,-780
"17043","00715L期街口布蘭特正2","110/08/12","永豐金證券",2789,2,2787
"17044","00715L期街口布蘭特正2","110/08/12","台新-新營",12,600,-588
"17045","00715L期街口布蘭特正2","110/08/12","統一",2972,199,2773
"17046","00715L期街口布蘭特正2","110/08/12","台中銀",10,592,-582
"17047","00715L期街口布蘭特正2","110/08/12","元富",1524,5,1519
"17048","00715L期街口布蘭特正2","110/08/12","群益金鼎-屏東",0,575,-575
"17049","00715L期街口布蘭特正2","110/08/12","統一-嘉義",466,26,440
"17050","00715L期街口布蘭特正2","110/08/12","元大-北港",10,505,-495
"17051","00715L期街口布蘭特正2","110/08/12","群益金鼎-延平",300,4,296
"17052","00715L期街口布蘭特正2","110/08/12","兆豐-台中",0,476,-476
"17053","00715L期街口布蘭特正2","110/08/12","台新-三民",300,24,276
"17054","00715L期街口布蘭特正2","110/08/12","宏遠-桃園",0,438,-438
"17055","00715L期街口布蘭特正2","110/08/12","群益金鼎-瑞豐",210,14,196
"17056","00715L期街口布蘭特正2","110/08/12","台新-台中",65,474,-409
"17057","00715L期街口布蘭特正2","110/08/12","港商野村",320,140,180
"17058","00715L期街口布蘭特正2","110/08/12","元大-西螺",3,382,-379
"17059","00715L期街口布蘭特正2","110/08/12","台新-松江",200,35,165
"17060","00715L期街口布蘭特正2","110/08/12","凱基-城中",0,370,-370
"17061","00715L期街口布蘭特正2","110/08/12","合庫證券",121,0,121
"17062","00715L期街口布蘭特正2","110/08/12","元大-歸仁",20,384,-364
"17063","00715L期街口布蘭特正2","110/08/12","元大-旗山",120,1,119
"17064","00715L期街口布蘭特正2","110/08/12","群益金鼎-古亭",13,367,-354
"17065","00715L期街口布蘭特正2","110/08/12","富邦-員林",362,251,111
"17066","00715L期街口布蘭特正2","110/08/12","元大-竹科",6,327,-321
"17067","00715L期街口布蘭特正2","110/08/12","日盛-木柵",130,22,108
"17068","00715L期街口布蘭特正2","110/08/12","臺銀-新竹",0,320,-320
"17069","00715L期街口布蘭特正2","110/08/12","大慶-苗栗",107,2,105
"17070","00715L期街口布蘭特正2","110/08/12","統一-台中",7,325,-318
"17071","8941關中","110/08/12","元大-金華",1,0,1
"17072","8941關中","110/08/12","凱基-士林",0,2,-2
"17073","8941關中","110/08/12","元大-桃興",1,0,1
"17074","8941關中","110/08/12","(牛牛牛)亞-鑫豐",0,0,0
"17075","8941關中","110/08/12","(牛牛牛)亞-鑫豐",0,0,0
"17076","8941關中","110/08/12","台新-三民",0,0,0
"17077","8941關中","110/08/12","台新-三民",0,0,0
"17078","8941關中","110/08/12","國泰-忠孝",1,1,0
"17079","8941關中","110/08/12","國泰-忠孝",1,1,0
"17080","8941關中","110/08/12","凱基-市府",1,1,0
"17081","8941關中","110/08/12","凱基-市府",1,1,0
"17082","8941關中","110/08/12","",NA,NA,NA
"17083","8941關中","110/08/12","",NA,NA,NA
"17084","8941關中","110/08/12","",NA,NA,NA
"17085","8941關中","110/08/12","",NA,NA,NA
"17086","8941關中","110/08/12","",NA,NA,NA
"17087","8941關中","110/08/12","",NA,NA,NA
"17088","8941關中","110/08/12","",NA,NA,NA
"17089","8941關中","110/08/12","",NA,NA,NA
"17090","8941關中","110/08/12","",NA,NA,NA
"17091","8941關中","110/08/12","",NA,NA,NA
"17092","8941關中","110/08/12","",NA,NA,NA
"17093","8941關中","110/08/12","",NA,NA,NA
"17094","8941關中","110/08/12","",NA,NA,NA
"17095","8941關中","110/08/12","",NA,NA,NA
"17096","8941關中","110/08/12","",NA,NA,NA
"17097","8941關中","110/08/12","",NA,NA,NA
"17098","8941關中","110/08/12","",NA,NA,NA
"17099","8941關中","110/08/12","",NA,NA,NA
"17100","8941關中","110/08/12","",NA,NA,NA
"17101","8936國統","110/08/12","台新-高雄",410,32,378
"17102","8936國統","110/08/12","日盛-景美",0,70,-70
"17103","8936國統","110/08/12","元富-林園",65,0,65
"17104","8936國統","110/08/12","臺銀-金山",0,55,-55
"17105","8936國統","110/08/12","摩根大通",64,12,52
"17106","8936國統","110/08/12","元大-敦南",0,32,-32
"17107","8936國統","110/08/12","新加坡商瑞銀",53,31,22
"17108","8936國統","110/08/12","華南永昌-南京",0,30,-30
"17109","8936國統","110/08/12","元大-莒光",19,0,19
"17110","8936國統","110/08/12","玉山-台南",0,23,-23
"17111","8936國統","110/08/12","第一金-高雄",10,0,10
"17112","8936國統","110/08/12","兆豐-岡山",1,21,-20
"17113","8936國統","110/08/12","統一-高雄",10,0,10
"17114","8936國統","110/08/12","統一-新竹",0,14,-14
"17115","8936國統","110/08/12","元富-桃園",10,0,10
"17116","8936國統","110/08/12","國泰-敦南",1,14,-13
"17117","8936國統","110/08/12","台新-台南",10,0,10
"17118","8936國統","110/08/12","台灣摩根士丹利",2,14,-12
"17119","8936國統","110/08/12","元大-竹山",9,0,9
"17120","8936國統","110/08/12","凱基-台南",3,14,-11
"17121","8936國統","110/08/12","港商野村",15,8,7
"17122","8936國統","110/08/12","凱基-高美館",0,11,-11
"17123","8936國統","110/08/12","華南永昌-高雄",6,0,6
"17124","8936國統","110/08/12","元大-博愛",0,10,-10
"17125","8936國統","110/08/12","土銀-高雄",5,0,5
"17126","8936國統","110/08/12","第一金-新興",0,9,-9
"17127","8936國統","110/08/12","大昌-安康",5,0,5
"17128","8936國統","110/08/12","元大-沙鹿",0,9,-9
"17129","8936國統","110/08/12","兆豐-斗南",5,0,5
"17130","8936國統","110/08/12","元大-左營",3,12,-9
"17131","6226光鼎","110/08/12","摩根大通",1930,830,1100
"17132","6226光鼎","110/08/12","凱基-台北",224,675,-451
"17133","6226光鼎","110/08/12","第一金-大稻埕",418,0,418
"17134","6226光鼎","110/08/12","統一-高雄",1,353,-352
"17135","6226光鼎","110/08/12","台新-中壢",239,3,236
"17136","6226光鼎","110/08/12","美林",153,291,-138
"17137","6226光鼎","110/08/12","元大-文心興安",223,27,196
"17138","6226光鼎","110/08/12","大昌",88,225,-137
"17139","6226光鼎","110/08/12","富邦-陽明",112,9,103
"17140","6226光鼎","110/08/12","元大-土城永寧",3,126,-123
"17141","6226光鼎","110/08/12","華南永昌-高雄",96,13,83
"17142","6226光鼎","110/08/12","元大-北屯",16,107,-91
"17143","6226光鼎","110/08/12","永豐金-南投",95,13,82
"17144","6226光鼎","110/08/12","統一-板橋",0,88,-88
"17145","6226光鼎","110/08/12","永豐金-中盛",102,26,76
"17146","6226光鼎","110/08/12","群益金鼎-東大",5,91,-86
"17147","6226光鼎","110/08/12","元大證券",90,15,75
"17148","6226光鼎","110/08/12","富邦-南屯",40,111,-71
"17149","6226光鼎","110/08/12","元大-屏東民生",85,15,70
"17150","6226光鼎","110/08/12","新光",240,309,-69
"17151","6226光鼎","110/08/12","台灣摩根士丹利",93,32,61
"17152","6226光鼎","110/08/12","台新-高雄",75,143,-68
"17153","6226光鼎","110/08/12","富邦-高雄",121,66,55
"17154","6226光鼎","110/08/12","日盛證券",10,76,-66
"17155","6226光鼎","110/08/12","臺銀",106,54,52
"17156","6226光鼎","110/08/12","國泰-敦南",391,457,-66
"17157","6226光鼎","110/08/12","台灣企銀-三民",58,8,50
"17158","6226光鼎","110/08/12","富邦-台北",31,97,-66
"17159","6226光鼎","110/08/12","元大-新竹",250,200,50
"17160","6226光鼎","110/08/12","凱基-永和",30,91,-61
"17161","2363矽統","110/08/12","元大-佳里",810,33,777
"17162","2363矽統","110/08/12","凱基-台北",1783,3582,-1799
"17163","2363矽統","110/08/12","元大-大同",455,30,425
"17164","2363矽統","110/08/12","台灣摩根士丹利",0,959,-959
"17165","2363矽統","110/08/12","富邦-建國",503,100,403
"17166","2363矽統","110/08/12","華南永昌-斗六",90,1037,-947
"17167","2363矽統","110/08/12","北城證券",434,34,400
"17168","2363矽統","110/08/12","群益金鼎-敦南",27,331,-304
"17169","2363矽統","110/08/12","元大-開元",321,33,288
"17170","2363矽統","110/08/12","美商高盛",57,327,-270
"17171","2363矽統","110/08/12","台新-三民",287,84,203
"17172","2363矽統","110/08/12","大慶-蘆洲",26,233,-207
"17173","2363矽統","110/08/12","台中銀",157,23,134
"17174","2363矽統","110/08/12","新光-台南",130,324,-194
"17175","2363矽統","110/08/12","元大-新竹經國",152,21,131
"17176","2363矽統","110/08/12","美林",927,1076,-149
"17177","2363矽統","110/08/12","台新-高雄",449,322,127
"17178","2363矽統","110/08/12","華南永昌-頭份",187,328,-141
"17179","2363矽統","110/08/12","華南永昌",254,163,91
"17180","2363矽統","110/08/12","陽信-石牌",157,276,-119
"17181","2363矽統","110/08/12","凱基-城中",98,13,85
"17182","2363矽統","110/08/12","兆豐證券",0,104,-104
"17183","2363矽統","110/08/12","台中銀-台北",85,4,81
"17184","2363矽統","110/08/12","元大-忠孝鼎富",32,132,-100
"17185","2363矽統","110/08/12","元大-新莊",140,60,80
"17186","2363矽統","110/08/12","元大-鳳中",85,185,-100
"17187","2363矽統","110/08/12","玉山-台中",116,41,75
"17188","2363矽統","110/08/12","永豐金-桃盛",24,119,-95
"17189","2363矽統","110/08/12","元富-彰化",88,23,65
"17190","2363矽統","110/08/12","元大證券",51,145,-94
"17191","8112至上","110/08/12","摩根大通",1492,130,1362
"17192","8112至上","110/08/12","永豐金-台中",0,274,-274
"17193","8112至上","110/08/12","美林",712,13,699
"17194","8112至上","110/08/12","永豐金證券",8,272,-264
"17195","8112至上","110/08/12","台灣摩根士丹利",696,41,655
"17196","8112至上","110/08/12","群益金鼎-基隆",0,249,-249
"17197","8112至上","110/08/12","凱基-台北",582,82,500
"17198","8112至上","110/08/12","國票-長城",2,228,-226
"17199","8112至上","110/08/12","新加坡商瑞銀",359,18,341
"17200","8112至上","110/08/12","新光-新竹",19,208,-189
"17201","8112至上","110/08/12","花旗環球",266,0,266
"17202","8112至上","110/08/12","玉山-嘉義",20,168,-148
"17203","8112至上","110/08/12","富邦-仁愛",231,25,206
"17204","8112至上","110/08/12","元大-高雄",0,131,-131
"17205","8112至上","110/08/12","美商高盛",190,3,187
"17206","8112至上","110/08/12","臺灣企銀-桃園",128,251,-123
"17207","8112至上","110/08/12","凱基-三重",121,6,115
"17208","8112至上","110/08/12","元大-府城",0,115,-115
"17209","8112至上","110/08/12","港商野村",198,88,110
"17210","8112至上","110/08/12","台新證券",100,203,-103
"17211","8112至上","110/08/12","國票-中港",101,0,101
"17212","8112至上","110/08/12","康和-板橋",5,106,-101
"17213","8112至上","110/08/12","日盛-新竹",80,3,77
"17214","8112至上","110/08/12","元大-北成功",0,101,-101
"17215","8112至上","110/08/12","兆豐-斗南",71,8,63
"17216","8112至上","110/08/12","元大-永和",5,88,-83
"17217","8112至上","110/08/12","大慶",63,1,62
"17218","8112至上","110/08/12","群益金鼎-內湖",0,80,-80
"17219","8112至上","110/08/12","群益金鼎-竹南",57,1,56
"17220","8112至上","110/08/12","元大-南勢角",0,80,-80
"17221","1570力肯","110/08/12","台新證券",91,15,76
"17222","1570力肯","110/08/12","國票-北高雄",2,361,-359
"17223","1570力肯","110/08/12","元大-南投",81,5,76
"17224","1570力肯","110/08/12","新光",95,222,-127
"17225","1570力肯","110/08/12","永全-南崁",94,20,74
"17226","1570力肯","110/08/12","(牛牛牛)亞-鑫豐",28,120,-92
"17227","1570力肯","110/08/12","日盛-忠孝",57,0,57
"17228","1570力肯","110/08/12","華南永昌-高雄",0,52,-52
"17229","1570力肯","110/08/12","永豐金-北高雄",55,0,55
"17230","1570力肯","110/08/12","群益金鼎-三重",0,42,-42
"17231","1570力肯","110/08/12","中國信託-高雄",72,22,50
"17232","1570力肯","110/08/12","日盛-八德",2,39,-37
"17233","1570力肯","110/08/12","凱基-天母",49,0,49
"17234","1570力肯","110/08/12","新光-台中",130,167,-37
"17235","1570力肯","110/08/12","新光-台南",56,18,38
"17236","1570力肯","110/08/12","日盛-樹林",1,31,-30
"17237","1570力肯","110/08/12","兆豐-嘉義",35,0,35
"17238","1570力肯","110/08/12","元大-竹北",0,30,-30
"17239","1570力肯","110/08/12","國票-天祥",32,1,31
"17240","1570力肯","110/08/12","元大-楊梅",6,35,-29
"17241","1570力肯","110/08/12","國泰-松江",81,51,30
"17242","1570力肯","110/08/12","元大-桃興",4,32,-28
"17243","1570力肯","110/08/12","元大-新店中正",33,3,30
"17244","1570力肯","110/08/12","亞東-台中",0,26,-26
"17245","1570力肯","110/08/12","統一",48,21,27
"17246","1570力肯","110/08/12","永豐金-屏東",5,30,-25
"17247","1570力肯","110/08/12","國票-內壢",26,0,26
"17248","1570力肯","110/08/12","國泰-館前",0,24,-24
"17249","1570力肯","110/08/12","元大-大益",27,1,26
"17250","1570力肯","110/08/12","摩根大通",173,193,-20
"17251","2929淘帝","110/08/12","摩根大通",47,0,47
"17252","2929淘帝","110/08/12","華南永昌-彰化",0,30,-30
"17253","2929淘帝","110/08/12","宏遠-館前",40,0,40
"17254","2929淘帝","110/08/12","第一金-大稻埕",0,10,-10
"17255","2929淘帝","110/08/12","富邦-高雄",16,0,16
"17256","2929淘帝","110/08/12","統一-敦南",0,10,-10
"17257","2929淘帝","110/08/12","兆豐-內湖",15,0,15
"17258","2929淘帝","110/08/12","玉山-台南",0,10,-10
"17259","2929淘帝","110/08/12","港商野村",29,15,14
"17260","2929淘帝","110/08/12","元大-花蓮",0,10,-10
"17261","2929淘帝","110/08/12","元富-台南",10,0,10
"17262","2929淘帝","110/08/12","凱基-台中",0,9,-9
"17263","2929淘帝","110/08/12","豐農",10,0,10
"17264","2929淘帝","110/08/12","群益金鼎-潭子",0,8,-8
"17265","2929淘帝","110/08/12","群益金鼎-三重",10,0,10
"17266","2929淘帝","110/08/12","新加坡商瑞銀",10,17,-7
"17267","2929淘帝","110/08/12","永豐金證券",10,0,10
"17268","2929淘帝","110/08/12","新光-高雄",0,7,-7
"17269","2929淘帝","110/08/12","永豐金-敦南",10,0,10
"17270","2929淘帝","110/08/12","亞東-板橋",0,6,-6
"17271","2929淘帝","110/08/12","凱基-八德",6,0,6
"17272","2929淘帝","110/08/12","元富-中港",0,6,-6
"17273","2929淘帝","110/08/12","台新-新莊",5,0,5
"17274","2929淘帝","110/08/12","國泰-敦南",1,7,-6
"17275","2929淘帝","110/08/12","群益金鼎-中山",5,0,5
"17276","2929淘帝","110/08/12","永豐金-市政",0,6,-6
"17277","2929淘帝","110/08/12","凱基-幸福",5,0,5
"17278","2929淘帝","110/08/12","永豐金-中盛",10,16,-6
"17279","2929淘帝","110/08/12","元富-新竹",4,0,4
"17280","2929淘帝","110/08/12","台新-三民",0,5,-5
"17281","5410國眾","110/08/12","凱基-八德",23,0,23
"17282","5410國眾","110/08/12","國泰-敦南",1,101,-100
"17283","5410國眾","110/08/12","元大-大灣",11,0,11
"17284","5410國眾","110/08/12","第一金-華江",0,27,-27
"17285","5410國眾","110/08/12","合庫-新竹",10,0,10
"17286","5410國眾","110/08/12","元大-竹科",0,17,-17
"17287","5410國眾","110/08/12","凱基-虎尾",10,0,10
"17288","5410國眾","110/08/12","元大-歸仁",1,15,-14
"17289","5410國眾","110/08/12","富邦-竹北",10,0,10
"17290","5410國眾","110/08/12","日盛-八德",0,10,-10
"17291","5410國眾","110/08/12","玉山-新莊",9,0,9
"17292","5410國眾","110/08/12","華南永昌-潮州",0,10,-10
"17293","5410國眾","110/08/12","玉山-台大",8,0,8
"17294","5410國眾","110/08/12","富邦-板橋",0,7,-7
"17295","5410國眾","110/08/12","凱基-桃園",8,0,8
"17296","5410國眾","110/08/12","凱基-高雄",0,6,-6
"17297","5410國眾","110/08/12","日盛-永康",7,0,7
"17298","5410國眾","110/08/12","元大-忠孝",0,6,-6
"17299","5410國眾","110/08/12","玉山-雙和",7,0,7
"17300","5410國眾","110/08/12","凱基-汐止",0,5,-5
"17301","5410國眾","110/08/12","元大-彰化",7,0,7
"17302","5410國眾","110/08/12","凱基-台北",0,5,-5
"17303","5410國眾","110/08/12","元大-崇德",7,0,7
"17304","5410國眾","110/08/12","元富-花蓮",0,4,-4
"17305","5410國眾","110/08/12","國泰-館前",6,0,6
"17306","5410國眾","110/08/12","凱基-岡山",0,4,-4
"17307","5410國眾","110/08/12","國泰-板橋",8,2,6
"17308","5410國眾","110/08/12","瑞士信貸",0,3,-3
"17309","5410國眾","110/08/12","元富-桃園",5,0,5
"17310","5410國眾","110/08/12","富邦-台中",0,3,-3
"17311","2841台開","110/08/12","宏遠-館前",370,0,370
"17312","2841台開","110/08/12","永豐金-敦南",4,134,-130
"17313","2841台開","110/08/12","永豐金-豐原",94,0,94
"17314","2841台開","110/08/12","港商野村",0,85,-85
"17315","2841台開","110/08/12","富邦-北港",53,0,53
"17316","2841台開","110/08/12","國泰-忠孝",1,40,-39
"17317","2841台開","110/08/12","新光-台中",20,0,20
"17318","2841台開","110/08/12","富邦-仁愛",0,38,-38
"17319","2841台開","110/08/12","凱基-高美館",20,0,20
"17320","2841台開","110/08/12","新加坡商瑞銀",0,27,-27
"17321","2841台開","110/08/12","元大-左營",20,0,20
"17322","2841台開","110/08/12","統一-嘉義",0,21,-21
"17323","2841台開","110/08/12","元大-基隆孝二",11,0,11
"17324","2841台開","110/08/12","日盛-忠孝",0,20,-20
"17325","2841台開","110/08/12","元大-路竹",10,0,10
"17326","2841台開","110/08/12","日盛-中壢",0,20,-20
"17327","2841台開","110/08/12","華南永昌-虎尾",9,0,9
"17328","2841台開","110/08/12","宏遠-桃園",0,20,-20
"17329","2841台開","110/08/12","康和-台北",6,0,6
"17330","2841台開","110/08/12","群益金鼎-南京",0,20,-20
"17331","2841台開","110/08/12","致和-東門",5,0,5
"17332","2841台開","110/08/12","合庫-基隆",0,18,-18
"17333","2841台開","110/08/12","元大-虎尾",5,0,5
"17334","2841台開","110/08/12","日盛證券",0,17,-17
"17335","2841台開","110/08/12","元大-莒光",5,0,5
"17336","2841台開","110/08/12","元大-歸仁",0,15,-15
"17337","2841台開","110/08/12","永豐金-桃園",5,0,5
"17338","2841台開","110/08/12","新光",10,21,-11
"17339","2841台開","110/08/12","新光-台南",4,0,4
"17340","2841台開","110/08/12","群益金鼎-天母",0,11,-11
"17341","6207雷科","110/08/12","摩根大通",125,11,114
"17342","6207雷科","110/08/12","凱基-復興",0,120,-120
"17343","6207雷科","110/08/12","凱基-台北",96,1,95
"17344","6207雷科","110/08/12","元大-鳳山",0,62,-62
"17345","6207雷科","110/08/12","美林",38,3,35
"17346","6207雷科","110/08/12","日盛證券",0,56,-56
"17347","6207雷科","110/08/12","兆豐-南京",30,0,30
"17348","6207雷科","110/08/12","日盛-忠孝",0,48,-48
"17349","6207雷科","110/08/12","港商野村",27,1,26
"17350","6207雷科","110/08/12","日盛-桃園",0,11,-11
"17351","6207雷科","110/08/12","元大-南京",20,0,20
"17352","6207雷科","110/08/12","中國信託-高雄",0,10,-10
"17353","6207雷科","110/08/12","臺銀-臺南",12,0,12
"17354","6207雷科","110/08/12","元大-土城永寧",0,10,-10
"17355","6207雷科","110/08/12","瑞士信貸",11,0,11
"17356","6207雷科","110/08/12","凱基-湖口",0,8,-8
"17357","6207雷科","110/08/12","新加坡商瑞銀",20,11,9
"17358","6207雷科","110/08/12","富邦-敦南",0,7,-7
"17359","6207雷科","110/08/12","第一金-新興",6,0,6
"17360","6207雷科","110/08/12","凱基-三峽",0,6,-6
"17361","6207雷科","110/08/12","群益金鼎-士林",6,0,6
"17362","6207雷科","110/08/12","永豐金-高雄",0,6,-6
"17363","6207雷科","110/08/12","群益金鼎-瑞豐",6,0,6
"17364","6207雷科","110/08/12","宏遠證券",0,5,-5
"17365","6207雷科","110/08/12","兆豐-來福",5,0,5
"17366","6207雷科","110/08/12","元富-彰化",0,5,-5
"17367","6207雷科","110/08/12","華南永昌-彰化",5,0,5
"17368","6207雷科","110/08/12","凱基-岡山",0,5,-5
"17369","6207雷科","110/08/12","富邦-中壢",5,0,5
"17370","6207雷科","110/08/12","富邦-建國",0,5,-5
"17371","3679新至陞","110/08/12","台灣摩根士丹利",10,0,10
"17372","3679新至陞","110/08/12","元大-成功",0,10,-10
"17373","3679新至陞","110/08/12","國泰-松江",8,0,8
"17374","3679新至陞","110/08/12","新加坡商瑞銀",0,7,-7
"17375","3679新至陞","110/08/12","元大-大同",3,0,3
"17376","3679新至陞","110/08/12","摩根大通",2,6,-4
"17377","3679新至陞","110/08/12","聯邦-三重",2,0,2
"17378","3679新至陞","110/08/12","瑞士信貸",0,3,-3
"17379","3679新至陞","110/08/12","凱基-站前",2,0,2
"17380","3679新至陞","110/08/12","港商野村",0,3,-3
"17381","3679新至陞","110/08/12","日盛-板橋",1,0,1
"17382","3679新至陞","110/08/12","凱基-新豐",0,3,-3
"17383","3679新至陞","110/08/12","日盛-龍潭",1,0,1
"17384","3679新至陞","110/08/12","元大證券",0,3,-3
"17385","3679新至陞","110/08/12","美商高盛",1,0,1
"17386","3679新至陞","110/08/12","康和-板橋",0,2,-2
"17387","3679新至陞","110/08/12","大慶-蘆洲",1,0,1
"17388","3679新至陞","110/08/12","富邦-台北",0,2,-2
"17389","3679新至陞","110/08/12","元富-民權",1,0,1
"17390","3679新至陞","110/08/12","元大-土城永寧",0,2,-2
"17391","3679新至陞","110/08/12","元富-花蓮",1,0,1
"17392","3679新至陞","110/08/12","彰銀",0,1,-1
"17393","3679新至陞","110/08/12","(牛牛牛)亞-網路",1,0,1
"17394","3679新至陞","110/08/12","大慶-富順",0,1,-1
"17395","3679新至陞","110/08/12","光和-溪湖",1,0,1
"17396","3679新至陞","110/08/12","台中銀-豐原",0,1,-1
"17397","3679新至陞","110/08/12","兆豐-城中",1,0,1
"17398","3679新至陞","110/08/12","兆豐-東門",0,1,-1
"17399","3679新至陞","110/08/12","兆豐-岡山",1,0,1
"17400","3679新至陞","110/08/12","凱基-新店",0,1,-1
"17401","2727王品","110/08/12","新光",25,8,17
"17402","2727王品","110/08/12","美林",0,76,-76
"17403","2727王品","110/08/12","彰銀-台中",14,2,12
"17404","2727王品","110/08/12","新加坡商瑞銀",0,52,-52
"17405","2727王品","110/08/12","康和-澎湖",10,0,10
"17406","2727王品","110/08/12","凱基-台北",2,38,-36
"17407","2727王品","110/08/12","富邦-建國",10,1,9
"17408","2727王品","110/08/12","國泰證券",0,22,-22
"17409","2727王品","110/08/12","永豐金-中正",9,0,9
"17410","2727王品","110/08/12","統一",1,19,-18
"17411","2727王品","110/08/12","中國信託",12,4,8
"17412","2727王品","110/08/12","元大證券",5,21,-16
"17413","2727王品","110/08/12","國泰-敦南",9,1,8
"17414","2727王品","110/08/12","永豐金證券",0,16,-16
"17415","2727王品","110/08/12","日盛-景美",8,1,7
"17416","2727王品","110/08/12","港商野村",4,15,-11
"17417","2727王品","110/08/12","元富-永和",7,0,7
"17418","2727王品","110/08/12","元富-大昌",0,8,-8
"17419","2727王品","110/08/12","富邦-新店",7,0,7
"17420","2727王品","110/08/12","元大-沙鹿",0,8,-8
"17421","2727王品","110/08/12","日盛-木柵",6,0,6
"17422","2727王品","110/08/12","元大-板橋",5,10,-5
"17423","2727王品","110/08/12","日盛-屏東",7,1,6
"17424","2727王品","110/08/12","永豐金-彰化",0,5,-5
"17425","2727王品","110/08/12","台新-三民",7,1,6
"17426","2727王品","110/08/12","大慶-泰山",0,4,-4
"17427","2727王品","110/08/12","凱基-三重",6,0,6
"17428","2727王品","110/08/12","台中銀",0,4,-4
"17429","2727王品","110/08/12","第一金-台南",5,0,5
"17430","2727王品","110/08/12","康和",0,4,-4
"17431","1570力肯","110/08/12","台新證券",91,15,76
"17432","1570力肯","110/08/12","國票-北高雄",2,361,-359
"17433","1570力肯","110/08/12","元大-南投",81,5,76
"17434","1570力肯","110/08/12","新光",95,222,-127
"17435","1570力肯","110/08/12","永全-南崁",94,20,74
"17436","1570力肯","110/08/12","(牛牛牛)亞-鑫豐",28,120,-92
"17437","1570力肯","110/08/12","日盛-忠孝",57,0,57
"17438","1570力肯","110/08/12","華南永昌-高雄",0,52,-52
"17439","1570力肯","110/08/12","永豐金-北高雄",55,0,55
"17440","1570力肯","110/08/12","群益金鼎-三重",0,42,-42
"17441","1570力肯","110/08/12","中國信託-高雄",72,22,50
"17442","1570力肯","110/08/12","日盛-八德",2,39,-37
"17443","1570力肯","110/08/12","凱基-天母",49,0,49
"17444","1570力肯","110/08/12","新光-台中",130,167,-37
"17445","1570力肯","110/08/12","新光-台南",56,18,38
"17446","1570力肯","110/08/12","日盛-樹林",1,31,-30
"17447","1570力肯","110/08/12","兆豐-嘉義",35,0,35
"17448","1570力肯","110/08/12","元大-竹北",0,30,-30
"17449","1570力肯","110/08/12","國票-天祥",32,1,31
"17450","1570力肯","110/08/12","元大-楊梅",6,35,-29
"17451","1570力肯","110/08/12","國泰-松江",81,51,30
"17452","1570力肯","110/08/12","元大-桃興",4,32,-28
"17453","1570力肯","110/08/12","元大-新店中正",33,3,30
"17454","1570力肯","110/08/12","亞東-台中",0,26,-26
"17455","1570力肯","110/08/12","統一",48,21,27
"17456","1570力肯","110/08/12","永豐金-屏東",5,30,-25
"17457","1570力肯","110/08/12","國票-內壢",26,0,26
"17458","1570力肯","110/08/12","國泰-館前",0,24,-24
"17459","1570力肯","110/08/12","元大-大益",27,1,26
"17460","1570力肯","110/08/12","摩根大通",173,193,-20
"17461","6180橘子","110/08/12","第一金-忠孝",54,0,54
"17462","6180橘子","110/08/12","台灣企銀-屏東",0,30,-30
"17463","6180橘子","110/08/12","美林",35,0,35
"17464","6180橘子","110/08/12","元大-斗信",0,20,-20
"17465","6180橘子","110/08/12","凱基-台北",27,0,27
"17466","6180橘子","110/08/12","永豐金-信義",0,15,-15
"17467","6180橘子","110/08/12","美商高盛",23,2,21
"17468","6180橘子","110/08/12","玉山-桃園",0,14,-14
"17469","6180橘子","110/08/12","元大-前金",20,0,20
"17470","6180橘子","110/08/12","兆豐-埔墘",0,10,-10
"17471","6180橘子","110/08/12","摩根大通",21,5,16
"17472","6180橘子","110/08/12","富邦-高雄",0,10,-10
"17473","6180橘子","110/08/12","元大-敦南",11,0,11
"17474","6180橘子","110/08/12","台新-新營",1,10,-9
"17475","6180橘子","110/08/12","統一-基隆",10,0,10
"17476","6180橘子","110/08/12","富邦-員林",0,9,-9
"17477","6180橘子","110/08/12","元大證券",6,0,6
"17478","6180橘子","110/08/12","台灣摩根士丹利",4,11,-7
"17479","6180橘子","110/08/12","日盛-樹林",5,0,5
"17480","6180橘子","110/08/12","大慶-蘆洲",0,7,-7
"17481","6180橘子","110/08/12","新光-新竹",6,1,5
"17482","6180橘子","110/08/12","元大-北三重",0,7,-7
"17483","6180橘子","110/08/12","元大-上新莊",5,0,5
"17484","6180橘子","110/08/12","新光",1,6,-5
"17485","6180橘子","110/08/12","新加坡商瑞銀",3,0,3
"17486","6180橘子","110/08/12","華南永昌-虎尾",0,5,-5
"17487","6180橘子","110/08/12","統一-中壢",3,0,3
"17488","6180橘子","110/08/12","元大-屏南",0,5,-5
"17489","6180橘子","110/08/12","元富-新店",3,0,3
"17490","6180橘子","110/08/12","群益金鼎-東湖",1,5,-4
"17491","2390云辰","110/08/12","美林",245,9,236
"17492","2390云辰","110/08/12","臺銀-臺中",2,218,-216
"17493","2390云辰","110/08/12","新加坡商瑞銀",90,20,70
"17494","2390云辰","110/08/12","兆豐-寶成",0,185,-185
"17495","2390云辰","110/08/12","台灣摩根士丹利",59,2,57
"17496","2390云辰","110/08/12","元大-板橋三民",1,70,-69
"17497","2390云辰","110/08/12","凱基-台北",127,72,55
"17498","2390云辰","110/08/12","永豐金-松山",5,70,-65
"17499","2390云辰","110/08/12","元大-豐原站前",51,1,50
"17500","2390云辰","110/08/12","富邦-建國",11,62,-51
"17501","2390云辰","110/08/12","港商野村",198,154,44
"17502","2390云辰","110/08/12","元大-土城學府",36,70,-34
"17503","2390云辰","110/08/12","凱基-站前",54,10,44
"17504","2390云辰","110/08/12","元大-土城永寧",10,39,-29
"17505","2390云辰","110/08/12","元大-北三重",34,2,32
"17506","2390云辰","110/08/12","群益金鼎-中壢",3,30,-27
"17507","2390云辰","110/08/12","凱基-民權",30,0,30
"17508","2390云辰","110/08/12","元大-新竹",3,30,-27
"17509","2390云辰","110/08/12","華南永昌-岡山",28,0,28
"17510","2390云辰","110/08/12","元富-城東",2,28,-26
"17511","2390云辰","110/08/12","元富-同大",34,7,27
"17512","2390云辰","110/08/12","群益金鼎-三民",2,26,-24
"17513","2390云辰","110/08/12","元大-路竹",45,20,25
"17514","2390云辰","110/08/12","台新-左楠",28,50,-22
"17515","2390云辰","110/08/12","國票-博愛",34,11,23
"17516","2390云辰","110/08/12","中農",1,23,-22
"17517","2390云辰","110/08/12","元大-台南",25,2,23
"17518","2390云辰","110/08/12","聯邦商銀",0,22,-22
"17519","2390云辰","110/08/12","群益金鼎-開元",30,8,22
"17520","2390云辰","110/08/12","元富-新店",2,23,-21
"17521","2867三商壽","110/08/11","摩根大通",509,31,478
"17522","2867三商壽","110/08/11","港商野村",13,188,-175
"17523","2867三商壽","110/08/11","美商高盛",157,17,140
"17524","2867三商壽","110/08/11","宏遠-高雄",0,150,-150
"17525","2867三商壽","110/08/11","凱基-台北",123,14,109
"17526","2867三商壽","110/08/11","日盛-鳳山",0,73,-73
"17527","2867三商壽","110/08/11","凱基-八德",101,0,101
"17528","2867三商壽","110/08/11","德信-中正",0,71,-71
"17529","2867三商壽","110/08/11","統一-平鎮",100,0,100
"17530","2867三商壽","110/08/11","凱基-新豐",1,67,-66
"17531","2867三商壽","110/08/11","元大-土城永寧",94,5,89
"17532","2867三商壽","110/08/11","土銀-新竹",0,60,-60
"17533","2867三商壽","110/08/11","元大-沙鹿",63,0,63
"17534","2867三商壽","110/08/11","凱基-中港",0,55,-55
"17535","2867三商壽","110/08/11","新加坡商瑞銀",55,1,54
"17536","2867三商壽","110/08/11","中國信託-文心",11,61,-50
"17537","2867三商壽","110/08/11","台灣摩根士丹利",60,10,50
"17538","2867三商壽","110/08/11","國泰-新莊",2,50,-48
"17539","2867三商壽","110/08/11","元富-潮州",41,0,41
"17540","2867三商壽","110/08/11","群益金鼎",0,40,-40
"17541","2867三商壽","110/08/11","統一-汐止",40,0,40
"17542","2867三商壽","110/08/11","元大-大益",0,40,-40
"17543","2867三商壽","110/08/11","新光-高雄",40,4,36
"17544","2867三商壽","110/08/11","富邦-板橋",5,38,-33
"17545","2867三商壽","110/08/11","玉山-板橋",31,1,30
"17546","2867三商壽","110/08/11","元富-古亭",0,30,-30
"17547","2867三商壽","110/08/11","美林",194,168,26
"17548","2867三商壽","110/08/11","元大-金華",0,30,-30
"17549","2867三商壽","110/08/11","凱基",24,0,24
"17550","2867三商壽","110/08/11","元大-汐止",13,42,-29
"17551","5521工信","110/08/11","摩根大通",417,16,401
"17552","5521工信","110/08/11","元大-沙鹿",0,103,-103
"17553","5521工信","110/08/11","凱基-台北",86,5,81
"17554","5521工信","110/08/11","華南永昌",0,43,-43
"17555","5521工信","110/08/11","日進",73,0,73
"17556","5521工信","110/08/11","聯邦-雙和",0,42,-42
"17557","5521工信","110/08/11","日盛證券",70,0,70
"17558","5521工信","110/08/11","元富-基隆",0,38,-38
"17559","5521工信","110/08/11","富邦-台北",65,0,65
"17560","5521工信","110/08/11","第一金-路竹",0,37,-37
"17561","5521工信","110/08/11","富邦-苗栗",50,0,50
"17562","5521工信","110/08/11","土銀-台中",0,35,-35
"17563","5521工信","110/08/11","永豐金-鳳山",40,1,39
"17564","5521工信","110/08/11","玉山-高雄",0,30,-30
"17565","5521工信","110/08/11","台灣企銀-北高雄",30,0,30
"17566","5521工信","110/08/11","凱基-台南",0,30,-30
"17567","5521工信","110/08/11","美林",71,42,29
"17568","5521工信","110/08/11","凱基-復興",0,30,-30
"17569","5521工信","110/08/11","台新-台中",31,6,25
"17570","5521工信","110/08/11","元大-屏南",0,30,-30
"17571","5521工信","110/08/11","凱基-鳳山",20,0,20
"17572","5521工信","110/08/11","永豐金-天母",0,30,-30
"17573","5521工信","110/08/11","元大-東蘆",20,0,20
"17574","5521工信","110/08/11","華南永昌-潮州",4,32,-28
"17575","5521工信","110/08/11","群益金鼎-士林",21,3,18
"17576","5521工信","110/08/11","華南永昌-彰化",13,39,-26
"17577","5521工信","110/08/11","永豐金證券",14,0,14
"17578","5521工信","110/08/11","日盛-新莊",0,25,-25
"17579","5521工信","110/08/11","瑞士信貸",13,0,13
"17580","5521工信","110/08/11","群益金鼎-敦南",0,25,-25
"17581","1471首利","110/08/11","瑞士信貸",162,0,162
"17582","1471首利","110/08/11","日盛-和美",1,55,-54
"17583","1471首利","110/08/11","永全-八德",100,0,100
"17584","1471首利","110/08/11","臺銀-臺中",3,55,-52
"17585","1471首利","110/08/11","摩根大通",128,46,82
"17586","1471首利","110/08/11","永豐金-板盛",0,42,-42
"17587","1471首利","110/08/11","台新證券",48,7,41
"17588","1471首利","110/08/11","兆豐-桃園",0,40,-40
"17589","1471首利","110/08/11","凱基-台南",30,0,30
"17590","1471首利","110/08/11","凱基-東門",0,40,-40
"17591","1471首利","110/08/11","凱基-內埔",20,0,20
"17592","1471首利","110/08/11","元大-新竹經國",0,40,-40
"17593","1471首利","110/08/11","元大-蘆洲",20,0,20
"17594","1471首利","110/08/11","群益金鼎-中港",0,35,-35
"17595","1471首利","110/08/11","台新-高雄",16,0,16
"17596","1471首利","110/08/11","元大-竹山",0,30,-30
"17597","1471首利","110/08/11","大慶-富順",13,0,13
"17598","1471首利","110/08/11","富邦-新竹",1,30,-29
"17599","1471首利","110/08/11","群益金鼎-海山",13,0,13
"17600","1471首利","110/08/11","日盛-八德",0,27,-27
"17601","1471首利","110/08/11","日盛-大墩",12,0,12
"17602","1471首利","110/08/11","大慶-蘆洲",5,30,-25
"17603","1471首利","110/08/11","凱基-三重",12,0,12
"17604","1471首利","110/08/11","元富-林園",0,25,-25
"17605","1471首利","110/08/11","華南永昌-林口",12,0,12
"17606","1471首利","110/08/11","元富-大昌",0,25,-25
"17607","1471首利","110/08/11","富邦-中壢",13,2,11
"17608","1471首利","110/08/11","新光",9,34,-25
"17609","1471首利","110/08/11","合庫-台中",10,0,10
"17610","1471首利","110/08/11","兆豐-寶成",0,24,-24
"17611","2883開發金","110/08/11","瑞士信貸",5796,0,5796
"17612","2883開發金","110/08/11","元富",772,4335,-3563
"17613","2883開發金","110/08/11","元大-板橋三民",4182,53,4129
"17614","2883開發金","110/08/11","美林",2516,5260,-2744
"17615","2883開發金","110/08/11","合庫證券",3532,28,3504
"17616","2883開發金","110/08/11","永豐金-彰化",42,2447,-2405
"17617","2883開發金","110/08/11","兆豐證券",2123,44,2079
"17618","2883開發金","110/08/11","元大證券",1279,3467,-2188
"17619","2883開發金","110/08/11","台灣摩根士丹利",2946,1744,1202
"17620","2883開發金","110/08/11","國票-長城",0,2014,-2014
"17621","2883開發金","110/08/11","富邦-建國",1195,92,1103
"17622","2883開發金","110/08/11","港商野村",3121,4600,-1479
"17623","2883開發金","110/08/11","新光-新竹",1140,38,1102
"17624","2883開發金","110/08/11","元大-金華",31,1341,-1310
"17625","2883開發金","110/08/11","美商高盛",1600,535,1065
"17626","2883開發金","110/08/11","元大-彰化",67,1218,-1151
"17627","2883開發金","110/08/11","群益金鼎-南京",1083,202,881
"17628","2883開發金","110/08/11","玉山-高雄",99,986,-887
"17629","2883開發金","110/08/11","凱基-台北",5046,4258,788
"17630","2883開發金","110/08/11","元富-彰化",27,813,-786
"17631","2883開發金","110/08/11","港商法國興業",728,0,728
"17632","2883開發金","110/08/11","摩根大通",3362,4085,-723
"17633","2883開發金","110/08/11","玉山證券",716,98,618
"17634","2883開發金","110/08/11","國泰證券",21,658,-637
"17635","2883開發金","110/08/11","凱基-豐中",634,76,558
"17636","2883開發金","110/08/11","富邦-新店",61,662,-601
"17637","2883開發金","110/08/11","永豐金-忠孝",1406,858,548
"17638","2883開發金","110/08/11","元大-小港",71,667,-596
"17639","2883開發金","110/08/11","元大-民生",532,2,530
"17640","2883開發金","110/08/11","富邦-台北",213,798,-585
"17641","6205詮欣","110/08/11","臺銀-民權",25,0,25
"17642","6205詮欣","110/08/11","摩根大通",2,46,-44
"17643","6205詮欣","110/08/11","合庫-三重",20,0,20
"17644","6205詮欣","110/08/11","永豐金-敦南",0,14,-14
"17645","6205詮欣","110/08/11","元富-宜蘭",20,0,20
"17646","6205詮欣","110/08/11","瑞士信貸",0,11,-11
"17647","6205詮欣","110/08/11","德信-新營",10,0,10
"17648","6205詮欣","110/08/11","永豐金-忠孝",0,10,-10
"17649","6205詮欣","110/08/11","元大-西屯",10,0,10
"17650","6205詮欣","110/08/11","統一-汐止",0,6,-6
"17651","6205詮欣","110/08/11","永豐金-中正",9,0,9
"17652","6205詮欣","110/08/11","港商野村",0,5,-5
"17653","6205詮欣","110/08/11","日盛-三重",5,0,5
"17654","6205詮欣","110/08/11","新光",0,5,-5
"17655","6205詮欣","110/08/11","日盛-花蓮",5,0,5
"17656","6205詮欣","110/08/11","群益金鼎-開元",0,5,-5
"17657","6205詮欣","110/08/11","宏遠證券",5,0,5
"17658","6205詮欣","110/08/11","富邦-陽明",0,5,-5
"17659","6205詮欣","110/08/11","高橋",5,0,5
"17660","6205詮欣","110/08/11","元大-館前",0,5,-5
"17661","6205詮欣","110/08/11","亞東-板橋",4,0,4
"17662","6205詮欣","110/08/11","大慶-中壢",0,4,-4
"17663","6205詮欣","110/08/11","元富-基隆",3,0,3
"17664","6205詮欣","110/08/11","凱基-和平",0,4,-4
"17665","6205詮欣","110/08/11","元大-台中中港",3,0,3
"17666","6205詮欣","110/08/11","富邦-台北",0,4,-4
"17667","6205詮欣","110/08/11","合庫-彰化",2,0,2
"17668","6205詮欣","110/08/11","元大-南投",0,4,-4
"17669","6205詮欣","110/08/11","元大-西門",2,0,2
"17670","6205詮欣","110/08/11","元大-東蘆",0,4,-4
"17671","1540喬福","110/08/11","元富-中原",30,0,30
"17672","1540喬福","110/08/11","統一-新台中",0,18,-18
"17673","1540喬福","110/08/11","台中銀",17,0,17
"17674","1540喬福","110/08/11","凱基-台北",0,16,-16
"17675","1540喬福","110/08/11","富邦-竹北",11,0,11
"17676","1540喬福","110/08/11","永豐金-板新",0,15,-15
"17677","1540喬福","110/08/11","國泰-敦南",8,0,8
"17678","1540喬福","110/08/11","永豐金-中盛",0,11,-11
"17679","1540喬福","110/08/11","凱基-中壢",6,0,6
"17680","1540喬福","110/08/11","元大-中壢",0,10,-10
"17681","1540喬福","110/08/11","凱基-台南",5,0,5
"17682","1540喬福","110/08/11","玉山-台南",0,4,-4
"17683","1540喬福","110/08/11","元大-土城永寧",3,0,3
"17684","1540喬福","110/08/11","國票-南科",0,3,-3
"17685","1540喬福","110/08/11","臺銀-鳳山",2,0,2
"17686","1540喬福","110/08/11","元大-龍潭",0,3,-3
"17687","1540喬福","110/08/11","日盛-台中",2,0,2
"17688","1540喬福","110/08/11","臺銀-臺中",0,2,-2
"17689","1540喬福","110/08/11","兆豐-北高雄",2,0,2
"17690","1540喬福","110/08/11","(牛牛牛)亞-網路",0,2,-2
"17691","1540喬福","110/08/11","兆豐-三民",2,0,2
"17692","1540喬福","110/08/11","新光-台南",0,2,-2
"17693","1540喬福","110/08/11","合庫-桃園",1,0,1
"17694","1540喬福","110/08/11","凱基-永和",0,2,-2
"17695","1540喬福","110/08/11","臺銀-民權",1,0,1
"17696","1540喬福","110/08/11","元大-南崁",0,2,-2
"17697","1540喬福","110/08/11","臺銀-高雄",1,0,1
"17698","1540喬福","110/08/11","美林",0,1,-1
"17699","1540喬福","110/08/11","日盛-永康",1,0,1
"17700","1540喬福","110/08/11","美商高盛",0,1,-1
"17701","2888新光金","110/08/11","摩根大通",6950,1470,5480
"17702","2888新光金","110/08/11","第一金-高雄",5,5018,-5013
"17703","2888新光金","110/08/11","元大-忠孝鼎富",4314,11,4303
"17704","2888新光金","110/08/11","永豐金-天母",0,2241,-2241
"17705","2888新光金","110/08/11","美商高盛",4420,228,4192
"17706","2888新光金","110/08/11","統一-中壢",11,1720,-1709
"17707","2888新光金","110/08/11","瑞士信貸",2928,166,2762
"17708","2888新光金","110/08/11","美林",1510,3170,-1660
"17709","2888新光金","110/08/11","群益金鼎",1859,0,1859
"17710","2888新光金","110/08/11","國票-台東",21,1606,-1585
"17711","2888新光金","110/08/11","凱基-台北",5335,3700,1635
"17712","2888新光金","110/08/11","元富-城東",25,1082,-1057
"17713","2888新光金","110/08/11","新加坡商瑞銀",1506,65,1441
"17714","2888新光金","110/08/11","台灣摩根士丹利",916,1951,-1035
"17715","2888新光金","110/08/11","港商法國興業",1338,0,1338
"17716","2888新光金","110/08/11","中國信託",25,740,-715
"17717","2888新光金","110/08/11","元富-中港",1250,9,1241
"17718","2888新光金","110/08/11","新光",391,1047,-656
"17719","2888新光金","110/08/11","福邦-新竹",1176,0,1176
"17720","2888新光金","110/08/11","合庫-高雄",1,567,-566
"17721","2888新光金","110/08/11","凱基-林口",1005,35,970
"17722","2888新光金","110/08/11","康和-台中",1,463,-462
"17723","2888新光金","110/08/11","港商野村",1301,434,867
"17724","2888新光金","110/08/11","玉山證券",260,691,-431
"17725","2888新光金","110/08/11","國票-安和",1179,519,660
"17726","2888新光金","110/08/11","元大-和平",4,382,-378
"17727","2888新光金","110/08/11","富邦-敦南",569,19,550
"17728","2888新光金","110/08/11","日盛-新莊",0,350,-350
"17729","2888新光金","110/08/11","香港上海匯豐",441,0,441
"17730","2888新光金","110/08/11","群益金鼎-大興",1,341,-340
"17731","1340勝悅","110/08/11","華南永昌-高雄",24,4,20
"17732","1340勝悅","110/08/11","元大-大統",0,42,-42
"17733","1340勝悅","110/08/11","亞東-板橋",18,0,18
"17734","1340勝悅","110/08/11","(牛牛牛)亞-鑫豐",0,25,-25
"17735","1340勝悅","110/08/11","永豐金-台南",12,0,12
"17736","1340勝悅","110/08/11","美林",0,20,-20
"17737","1340勝悅","110/08/11","永豐金-板盛",10,0,10
"17738","1340勝悅","110/08/11","摩根大通",0,18,-18
"17739","1340勝悅","110/08/11","永豐金-天母",9,0,9
"17740","1340勝悅","110/08/11","元富-基隆",0,12,-12
"17741","1340勝悅","110/08/11","國泰-敦南",15,7,8
"17742","1340勝悅","110/08/11","玉山-高雄",0,12,-12
"17743","1340勝悅","110/08/11","群益金鼎-館前",8,0,8
"17744","1340勝悅","110/08/11","元大-桃興",0,10,-10
"17745","1340勝悅","110/08/11","凱基-台中",7,0,7
"17746","1340勝悅","110/08/11","永豐金-博愛",0,10,-10
"17747","1340勝悅","110/08/11","統一-城中",6,0,6
"17748","1340勝悅","110/08/11","瑞士信貸",0,8,-8
"17749","1340勝悅","110/08/11","群益金鼎-崇德",6,0,6
"17750","1340勝悅","110/08/11","日盛-台中",0,6,-6
"17751","1340勝悅","110/08/11","永豐金-松山",6,0,6
"17752","1340勝悅","110/08/11","元大-景美",0,6,-6
"17753","1340勝悅","110/08/11","臺銀-鳳山",5,0,5
"17754","1340勝悅","110/08/11","日盛-信義",0,5,-5
"17755","1340勝悅","110/08/11","永全-南崁",5,0,5
"17756","1340勝悅","110/08/11","台新證券",0,5,-5
"17757","1340勝悅","110/08/11","玉山-士林",5,0,5
"17758","1340勝悅","110/08/11","元大-忠孝鼎富",0,5,-5
"17759","1340勝悅","110/08/11","國泰-台中",15,10,5
"17760","1340勝悅","110/08/11","元大-中壢",0,5,-5
"17761","6246臺龍","110/08/11","永興",40,3,37
"17762","6246臺龍","110/08/11","港商野村",6,139,-133
"17763","6246臺龍","110/08/11","永豐金-內湖",42,9,33
"17764","6246臺龍","110/08/11","統一",0,97,-97
"17765","6246臺龍","110/08/11","元大-豐原站前",68,41,27
"17766","6246臺龍","110/08/11","兆豐-松德",0,82,-82
"17767","6246臺龍","110/08/11","日盛-員林",21,1,20
"17768","6246臺龍","110/08/11","元大-新盛",24,80,-56
"17769","6246臺龍","110/08/11","康和-澎湖",20,0,20
"17770","6246臺龍","110/08/11","元大-北港",0,35,-35
"17771","6246臺龍","110/08/11","元大-歸仁",18,0,18
"17772","6246臺龍","110/08/11","元大-西門",0,28,-28
"17773","6246臺龍","110/08/11","元大-中壢",35,17,18
"17774","6246臺龍","110/08/11","永興-台中",0,27,-27
"17775","6246臺龍","110/08/11","玉山-大里",17,0,17
"17776","6246臺龍","110/08/11","永興-水湳",0,25,-25
"17777","6246臺龍","110/08/11","大慶-泰山",15,0,15
"17778","6246臺龍","110/08/11","元大-西螺",6,30,-24
"17779","6246臺龍","110/08/11","永豐金-松山",15,1,14
"17780","6246臺龍","110/08/11","元大-西屯",2,25,-23
"17781","6246臺龍","110/08/11","凱基-永和",13,0,13
"17782","6246臺龍","110/08/11","新光",45,67,-22
"17783","6246臺龍","110/08/11","華南永昌-嘉義",13,0,13
"17784","6246臺龍","110/08/11","第一金-台中",0,20,-20
"17785","6246臺龍","110/08/11","富邦-三重",13,0,13
"17786","6246臺龍","110/08/11","兆豐-南京",0,20,-20
"17787","6246臺龍","110/08/11","日盛-高雄",12,0,12
"17788","6246臺龍","110/08/11","日盛-頭份",2,20,-18
"17789","6246臺龍","110/08/11","群益金鼎-北高雄",12,0,12
"17790","6246臺龍","110/08/11","宏遠-桃園",0,17,-17
"17791","00715L期街口布蘭特正2","110/08/11","元大證券",11593,2378,9215
"17792","00715L期街口布蘭特正2","110/08/11","凱基-台北",313,3001,-2688
"17793","00715L期街口布蘭特正2","110/08/11","永豐金-新店",1600,4,1596
"17794","00715L期街口布蘭特正2","110/08/11","富邦-南屯",403,1908,-1505
"17795","00715L期街口布蘭特正2","110/08/11","第一金-台中",1282,31,1251
"17796","00715L期街口布蘭特正2","110/08/11","新光",152,1165,-1013
"17797","00715L期街口布蘭特正2","110/08/11","元大-敦化",1200,20,1180
"17798","00715L期街口布蘭特正2","110/08/11","第一金-台南",0,519,-519
"17799","00715L期街口布蘭特正2","110/08/11","永豐金證券",1128,53,1075
"17800","00715L期街口布蘭特正2","110/08/11","統一-新竹",13,506,-493
"17801","00715L期街口布蘭特正2","110/08/11","元大-復北",556,21,535
"17802","00715L期街口布蘭特正2","110/08/11","台新-三民",0,438,-438
"17803","00715L期街口布蘭特正2","110/08/11","日盛-永康",340,0,340
"17804","00715L期街口布蘭特正2","110/08/11","富邦-彰化",30,391,-361
"17805","00715L期街口布蘭特正2","110/08/11","群益金鼎-板橋",350,17,333
"17806","00715L期街口布蘭特正2","110/08/11","元富-中壢",5,316,-311
"17807","00715L期街口布蘭特正2","110/08/11","元富",325,2,323
"17808","00715L期街口布蘭特正2","110/08/11","凱基-豐中",0,302,-302
"17809","00715L期街口布蘭特正2","110/08/11","凱基-科園",300,0,300
"17810","00715L期街口布蘭特正2","110/08/11","康和",359,645,-286
"17811","00715L期街口布蘭特正2","110/08/11","元大-蘆洲",311,59,252
"17812","00715L期街口布蘭特正2","110/08/11","元富-成功",5,290,-285
"17813","00715L期街口布蘭特正2","110/08/11","群益金鼎-崇德",251,20,231
"17814","00715L期街口布蘭特正2","110/08/11","台新-松江",0,268,-268
"17815","00715L期街口布蘭特正2","110/08/11","富邦-建國",265,42,223
"17816","00715L期街口布蘭特正2","110/08/11","元大-前金",21,279,-258
"17817","00715L期街口布蘭特正2","110/08/11","富邦-嘉義",300,99,201
"17818","00715L期街口布蘭特正2","110/08/11","國泰-高雄",13,236,-223
"17819","00715L期街口布蘭特正2","110/08/11","元大-竹科",314,115,199
"17820","00715L期街口布蘭特正2","110/08/11","中國信託-嘉義",4,223,-219
"17821","8941關中","110/08/11","凱基-市府",1,0,1
"17822","8941關中","110/08/11","元大-古亭",0,1,-1
"17823","8941關中","110/08/11","康和-板橋",0,0,0
"17824","8941關中","110/08/11","康和-板橋",0,0,0
"17825","8941關中","110/08/11","國泰-忠孝",0,0,0
"17826","8941關中","110/08/11","國泰-忠孝",0,0,0
"17827","8941關中","110/08/11","富邦-北港",0,0,0
"17828","8941關中","110/08/11","富邦-北港",0,0,0
"17829","8941關中","110/08/11","元大證券",0,0,0
"17830","8941關中","110/08/11","元大證券",0,0,0
"17831","8941關中","110/08/11","",NA,NA,NA
"17832","8941關中","110/08/11","",NA,NA,NA
"17833","8941關中","110/08/11","",NA,NA,NA
"17834","8941關中","110/08/11","",NA,NA,NA
"17835","8941關中","110/08/11","",NA,NA,NA
"17836","8941關中","110/08/11","",NA,NA,NA
"17837","8941關中","110/08/11","",NA,NA,NA
"17838","8941關中","110/08/11","",NA,NA,NA
"17839","8941關中","110/08/11","",NA,NA,NA
"17840","8941關中","110/08/11","",NA,NA,NA
"17841","8941關中","110/08/11","",NA,NA,NA
"17842","8941關中","110/08/11","",NA,NA,NA
"17843","8941關中","110/08/11","",NA,NA,NA
"17844","8941關中","110/08/11","",NA,NA,NA
"17845","8941關中","110/08/11","",NA,NA,NA
"17846","8941關中","110/08/11","",NA,NA,NA
"17847","8941關中","110/08/11","",NA,NA,NA
"17848","8941關中","110/08/11","",NA,NA,NA
"17849","8941關中","110/08/11","",NA,NA,NA
"17850","8941關中","110/08/11","",NA,NA,NA
"17851","8936國統","110/08/11","台新-高雄",218,1,217
"17852","8936國統","110/08/11","凱基-內埔",0,70,-70
"17853","8936國統","110/08/11","新光-桃園",105,3,102
"17854","8936國統","110/08/11","元大-太平",0,60,-60
"17855","8936國統","110/08/11","新加坡商瑞銀",124,59,65
"17856","8936國統","110/08/11","永豐金-板盛",0,48,-48
"17857","8936國統","110/08/11","美林",61,0,61
"17858","8936國統","110/08/11","兆豐-高雄",0,29,-29
"17859","8936國統","110/08/11","摩根大通",71,16,55
"17860","8936國統","110/08/11","群益金鼎-屏東",0,27,-27
"17861","8936國統","110/08/11","元富-同大",41,5,36
"17862","8936國統","110/08/11","新光",0,24,-24
"17863","8936國統","110/08/11","凱基-台北",38,6,32
"17864","8936國統","110/08/11","凱基-台南",0,22,-22
"17865","8936國統","110/08/11","華南永昌-高雄",22,0,22
"17866","8936國統","110/08/11","合庫-高雄",0,20,-20
"17867","8936國統","110/08/11","日盛-三峽",21,0,21
"17868","8936國統","110/08/11","永豐金-大園",0,20,-20
"17869","8936國統","110/08/11","兆豐-大同",30,9,21
"17870","8936國統","110/08/11","永豐金-台中",0,20,-20
"17871","8936國統","110/08/11","宏遠-台南",20,0,20
"17872","8936國統","110/08/11","永豐金-竹科",0,20,-20
"17873","8936國統","110/08/11","美商高盛",17,1,16
"17874","8936國統","110/08/11","港商野村",49,67,-18
"17875","8936國統","110/08/11","日盛-斗六",15,0,15
"17876","8936國統","110/08/11","第一金-新興",0,16,-16
"17877","8936國統","110/08/11","元富-大裕",15,0,15
"17878","8936國統","110/08/11","新光-台中",14,29,-15
"17879","8936國統","110/08/11","台新-台中",15,2,13
"17880","8936國統","110/08/11","凱基-永和",0,15,-15
"17881","6226光鼎","110/08/11","美商高盛",595,148,447
"17882","6226光鼎","110/08/11","瑞士信貸",297,751,-454
"17883","6226光鼎","110/08/11","凱基-台北",506,69,437
"17884","6226光鼎","110/08/11","摩根大通",911,1317,-406
"17885","6226光鼎","110/08/11","統一-高雄",503,150,353
"17886","6226光鼎","110/08/11","凱基-站前",29,313,-284
"17887","6226光鼎","110/08/11","美林",507,312,195
"17888","6226光鼎","110/08/11","台中銀-台北",0,280,-280
"17889","6226光鼎","110/08/11","合庫-台中",143,4,139
"17890","6226光鼎","110/08/11","國泰-台中",75,176,-101
"17891","6226光鼎","110/08/11","大昌",139,0,139
"17892","6226光鼎","110/08/11","元富-潮州",10,107,-97
"17893","6226光鼎","110/08/11","台灣摩根士丹利",229,101,128
"17894","6226光鼎","110/08/11","中國信託-永康",63,159,-96
"17895","6226光鼎","110/08/11","元大-北投",123,4,119
"17896","6226光鼎","110/08/11","國泰-高雄",15,96,-81
"17897","6226光鼎","110/08/11","富邦-南屯",170,63,107
"17898","6226光鼎","110/08/11","凱基-三多",23,100,-77
"17899","6226光鼎","110/08/11","群益金鼎-西松",176,93,83
"17900","6226光鼎","110/08/11","玉山-高雄",17,90,-73
"17901","6226光鼎","110/08/11","台新證券",167,99,68
"17902","6226光鼎","110/08/11","元大-新盛",8,81,-73
"17903","6226光鼎","110/08/11","永豐金-內湖",79,22,57
"17904","6226光鼎","110/08/11","元大-府城",7,72,-65
"17905","6226光鼎","110/08/11","日盛證券",51,6,45
"17906","6226光鼎","110/08/11","統一-仁愛",13,75,-62
"17907","6226光鼎","110/08/11","臺銀-高雄",70,26,44
"17908","6226光鼎","110/08/11","高橋",4,61,-57
"17909","6226光鼎","110/08/11","富邦-陽明",84,40,44
"17910","6226光鼎","110/08/11","台新-屏東",16,71,-55
"17911","2363矽統","110/08/11","瑞士信貸",547,0,547
"17912","2363矽統","110/08/11","凱基-台北",2934,4385,-1451
"17913","2363矽統","110/08/11","台灣摩根士丹利",677,160,517
"17914","2363矽統","110/08/11","陽信-石牌",34,626,-592
"17915","2363矽統","110/08/11","玉山-台中",331,139,192
"17916","2363矽統","110/08/11","永豐金證券",103,405,-302
"17917","2363矽統","110/08/11","台新-左楠",191,33,158
"17918","2363矽統","110/08/11","元大-成功",60,289,-229
"17919","2363矽統","110/08/11","華南永昌-頭份",197,45,152
"17920","2363矽統","110/08/11","美林",747,959,-212
"17921","2363矽統","110/08/11","元大-忠孝鼎富",196,51,145
"17922","2363矽統","110/08/11","元大-員林中山",83,286,-203
"17923","2363矽統","110/08/11","元大-汐止",279,150,129
"17924","2363矽統","110/08/11","凱基-市府",42,242,-200
"17925","2363矽統","110/08/11","大慶-蘆洲",135,26,109
"17926","2363矽統","110/08/11","永豐金-埔里",4,181,-177
"17927","2363矽統","110/08/11","合庫-高雄",135,30,105
"17928","2363矽統","110/08/11","群益金鼎-內湖",41,195,-154
"17929","2363矽統","110/08/11","兆豐證券",105,1,104
"17930","2363矽統","110/08/11","元大-旗山",157,307,-150
"17931","2363矽統","110/08/11","永豐金-竹科",112,15,97
"17932","2363矽統","110/08/11","兆豐-台中港",38,178,-140
"17933","2363矽統","110/08/11","國票-彰化",95,0,95
"17934","2363矽統","110/08/11","元大-新竹",55,194,-139
"17935","2363矽統","110/08/11","元大-斗信",152,65,87
"17936","2363矽統","110/08/11","凱基-永和",32,161,-129
"17937","2363矽統","110/08/11","亞東",95,10,85
"17938","2363矽統","110/08/11","第一金-桃園",59,183,-124
"17939","2363矽統","110/08/11","美商高盛",906,822,84
"17940","2363矽統","110/08/11","台新證券",525,640,-115
"17941","8112至上","110/08/11","港商野村",188,11,177
"17942","8112至上","110/08/11","新加坡商瑞銀",35,847,-812
"17943","8112至上","110/08/11","大昌-桃園",173,0,173
"17944","8112至上","110/08/11","宏遠證券",2,536,-534
"17945","8112至上","110/08/11","合庫證券",142,3,139
"17946","8112至上","110/08/11","富邦-仁愛",67,324,-257
"17947","8112至上","110/08/11","美商高盛",145,14,131
"17948","8112至上","110/08/11","凱基-市政",0,202,-202
"17949","8112至上","110/08/11","群益金鼎-內湖",132,10,122
"17950","8112至上","110/08/11","凱基-復興",16,190,-174
"17951","8112至上","110/08/11","國票-長城",130,30,100
"17952","8112至上","110/08/11","瑞士信貸",136,306,-170
"17953","8112至上","110/08/11","玉山-板橋",84,0,84
"17954","8112至上","110/08/11","兆豐-公益",1,120,-119
"17955","8112至上","110/08/11","臺灣企銀-桃園",60,0,60
"17956","8112至上","110/08/11","元大-萬華",12,131,-119
"17957","8112至上","110/08/11","新光",103,44,59
"17958","8112至上","110/08/11","凱基-台北",211,321,-110
"17959","8112至上","110/08/11","華南永昌-中正",52,0,52
"17960","8112至上","110/08/11","美林",21,116,-95
"17961","8112至上","110/08/11","元大-仁愛",50,0,50
"17962","8112至上","110/08/11","永豐金-豐原",7,102,-95
"17963","8112至上","110/08/11","元大-北成功",101,53,48
"17964","8112至上","110/08/11","兆豐-民生",0,70,-70
"17965","8112至上","110/08/11","合庫-嘉義",45,0,45
"17966","8112至上","110/08/11","元富",2,71,-69
"17967","8112至上","110/08/11","大慶-富順",46,1,45
"17968","8112至上","110/08/11","玉山-士林",6,67,-61
"17969","8112至上","110/08/11","臺銀-金山",45,1,44
"17970","8112至上","110/08/11","凱基-埔墘",0,60,-60
"17971","1570力肯","110/08/11","國票-內壢",386,0,386
"17972","1570力肯","110/08/11","群益金鼎-大興",0,100,-100
"17973","1570力肯","110/08/11","華南永昌-桃園",104,3,101
"17974","1570力肯","110/08/11","新光",177,255,-78
"17975","1570力肯","110/08/11","摩根大通",154,84,70
"17976","1570力肯","110/08/11","富邦-台中",0,61,-61
"17977","1570力肯","110/08/11","日盛-頭份",51,0,51
"17978","1570力肯","110/08/11","群益金鼎-忠孝",1,60,-59
"17979","1570力肯","110/08/11","永豐金-中壢",51,1,50
"17980","1570力肯","110/08/11","元大-新店中正",2,61,-59
"17981","1570力肯","110/08/11","永豐金-北高雄",50,0,50
"17982","1570力肯","110/08/11","富邦-陽明",1,51,-50
"17983","1570力肯","110/08/11","凱基-天母",51,2,49
"17984","1570力肯","110/08/11","元大-太平",5,54,-49
"17985","1570力肯","110/08/11","日盛-員林",52,5,47
"17986","1570力肯","110/08/11","統一-松江",0,43,-43
"17987","1570力肯","110/08/11","元富-高雄",40,0,40
"17988","1570力肯","110/08/11","台新證券",6,44,-38
"17989","1570力肯","110/08/11","中國信託-嘉義",34,0,34
"17990","1570力肯","110/08/11","永豐金證券",1,36,-35
"17991","1570力肯","110/08/11","元大-北成功",30,1,29
"17992","1570力肯","110/08/11","瑞士信貸",0,27,-27
"17993","1570力肯","110/08/11","亞東-台中",26,0,26
"17994","1570力肯","110/08/11","元大-中壢",9,35,-26
"17995","1570力肯","110/08/11","第一金-嘉義",26,0,26
"17996","1570力肯","110/08/11","美商高盛",0,25,-25
"17997","1570力肯","110/08/11","凱基-中壢",27,3,24
"17998","1570力肯","110/08/11","國票-北高雄",128,153,-25
"17999","1570力肯","110/08/11","元大-福營",25,1,24
"18000","1570力肯","110/08/11","元富-新店",10,34,-24
"18001","2929淘帝","110/08/11","美林",25,5,20
"18002","2929淘帝","110/08/11","華南永昌",0,25,-25
"18003","2929淘帝","110/08/11","永興",20,0,20
"18004","2929淘帝","110/08/11","台新-台中",0,22,-22
"18005","2929淘帝","110/08/11","新光",17,1,16
"18006","2929淘帝","110/08/11","富邦-永和",1,21,-20
"18007","2929淘帝","110/08/11","臺銀-臺南",12,0,12
"18008","2929淘帝","110/08/11","元富-古亭",0,18,-18
"18009","2929淘帝","110/08/11","第一金-大稻埕",10,0,10
"18010","2929淘帝","110/08/11","永豐金-大園",5,23,-18
"18011","2929淘帝","110/08/11","兆豐-桃園",10,0,10
"18012","2929淘帝","110/08/11","富邦-新店",3,19,-16
"18013","2929淘帝","110/08/11","國票-九鼎",10,0,10
"18014","2929淘帝","110/08/11","新光-台中",16,31,-15
"18015","2929淘帝","110/08/11","華南永昌-長虹",10,0,10
"18016","2929淘帝","110/08/11","國泰-新莊",0,10,-10
"18017","2929淘帝","110/08/11","凱基-長庚",7,0,7
"18018","2929淘帝","110/08/11","元大-東泰",0,10,-10
"18019","2929淘帝","110/08/11","凱基-林口",7,0,7
"18020","2929淘帝","110/08/11","凱基-斗六",0,8,-8
"18021","2929淘帝","110/08/11","日盛-中壢",5,0,5
"18022","2929淘帝","110/08/11","永豐金證券",0,7,-7
"18023","2929淘帝","110/08/11","港商法國興業",5,0,5
"18024","2929淘帝","110/08/11","第一金-員林",0,5,-5
"18025","2929淘帝","110/08/11","元富-中壢",5,0,5
"18026","2929淘帝","110/08/11","元富-新竹",0,5,-5
"18027","2929淘帝","110/08/11","元富-文心",5,0,5
"18028","2929淘帝","110/08/11","凱基-東門",0,5,-5
"18029","2929淘帝","110/08/11","凱基-台中",5,0,5
"18030","2929淘帝","110/08/11","元大-桃園",0,5,-5
"18031","5410國眾","110/08/11","群益金鼎",128,0,128
"18032","5410國眾","110/08/11","國泰-敦南",12,206,-194
"18033","5410國眾","110/08/11","富邦-建國",100,0,100
"18034","5410國眾","110/08/11","凱基-竹北",2,112,-110
"18035","5410國眾","110/08/11","玉山-新莊",35,0,35
"18036","5410國眾","110/08/11","大昌-樹林",0,100,-100
"18037","5410國眾","110/08/11","合庫-桃園",30,0,30
"18038","5410國眾","110/08/11","凱基-市政",0,100,-100
"18039","5410國眾","110/08/11","高橋",30,0,30
"18040","5410國眾","110/08/11","摩根大通",20,68,-48
"18041","5410國眾","110/08/11","元大-崇德",28,0,28
"18042","5410國眾","110/08/11","凱基-台北",7,39,-32
"18043","5410國眾","110/08/11","元大-新盛",28,0,28
"18044","5410國眾","110/08/11","元大-復北",0,30,-30
"18045","5410國眾","110/08/11","凱基-三峽",21,0,21
"18046","5410國眾","110/08/11","大昌",0,26,-26
"18047","5410國眾","110/08/11","臺銀-臺中",17,0,17
"18048","5410國眾","110/08/11","第一金-豐原",0,23,-23
"18049","5410國眾","110/08/11","新光",15,0,15
"18050","5410國眾","110/08/11","元富-三重",0,22,-22
"18051","5410國眾","110/08/11","國泰-台中",20,8,12
"18052","5410國眾","110/08/11","元大-樹林",2,21,-19
"18053","5410國眾","110/08/11","新光-桃園",11,0,11
"18054","5410國眾","110/08/11","元大-成功",0,17,-17
"18055","5410國眾","110/08/11","元大-旗山",11,0,11
"18056","5410國眾","110/08/11","新光-台中",0,16,-16
"18057","5410國眾","110/08/11","大昌-新店",10,0,10
"18058","5410國眾","110/08/11","臺銀-臺南",1,14,-13
"18059","5410國眾","110/08/11","豐農",10,0,10
"18060","5410國眾","110/08/11","瑞士信貸",0,12,-12
"18061","2841台開","110/08/11","宏遠-館前",402,0,402
"18062","2841台開","110/08/11","永豐金-敦南",11,270,-259
"18063","2841台開","110/08/11","日盛-信義",129,0,129
"18064","2841台開","110/08/11","國票-天祥",0,100,-100
"18065","2841台開","110/08/11","元大-南投",80,0,80
"18066","2841台開","110/08/11","日盛證券",27,117,-90
"18067","2841台開","110/08/11","日盛-園區",72,0,72
"18068","2841台開","110/08/11","永興-水湳",0,30,-30
"18069","2841台開","110/08/11","華南永昌-鶯歌",45,0,45
"18070","2841台開","110/08/11","兆豐-寶成",0,30,-30
"18071","2841台開","110/08/11","元大-福營",20,0,20
"18072","2841台開","110/08/11","元富-四維",0,26,-26
"18073","2841台開","110/08/11","元大-左營",20,0,20
"18074","2841台開","110/08/11","統一-士林",0,25,-25
"18075","2841台開","110/08/11","永豐金-員林",15,0,15
"18076","2841台開","110/08/11","日盛-忠孝",0,20,-20
"18077","2841台開","110/08/11","日盛-內湖",11,0,11
"18078","2841台開","110/08/11","大慶-蘆洲",0,20,-20
"18079","2841台開","110/08/11","國泰-館前",10,0,10
"18080","2841台開","110/08/11","國票-中和",0,20,-20
"18081","2841台開","110/08/11","華南永昌-潮州",10,0,10
"18082","2841台開","110/08/11","元大-大灣",0,20,-20
"18083","2841台開","110/08/11","元大-大里德芳",10,0,10
"18084","2841台開","110/08/11","元大-雙和",0,20,-20
"18085","2841台開","110/08/11","元大-小港",10,0,10
"18086","2841台開","110/08/11","新光",28,47,-19
"18087","2841台開","110/08/11","新光-台南",7,0,7
"18088","2841台開","110/08/11","玉山-台中",0,13,-13
"18089","2841台開","110/08/11","國泰-台中",6,0,6
"18090","2841台開","110/08/11","富邦-建國",0,12,-12
"18091","6207雷科","110/08/11","台新-高雄",136,8,128
"18092","6207雷科","110/08/11","群益金鼎-東門",1,90,-89
"18093","6207雷科","110/08/11","凱基-台北",108,21,87
"18094","6207雷科","110/08/11","摩根大通",89,156,-67
"18095","6207雷科","110/08/11","富邦-陽明",70,0,70
"18096","6207雷科","110/08/11","元大-鳳山",22,60,-38
"18097","6207雷科","110/08/11","永豐金證券",30,0,30
"18098","6207雷科","110/08/11","凱基-三重",5,40,-35
"18099","6207雷科","110/08/11","永豐金-高雄",29,5,24
"18100","6207雷科","110/08/11","美林",5,35,-30
"18101","6207雷科","110/08/11","元大-高雄",18,0,18
"18102","6207雷科","110/08/11","港商野村",28,58,-30
"18103","6207雷科","110/08/11","元大-竹山",17,0,17
"18104","6207雷科","110/08/11","元大-路竹",3,30,-27
"18105","6207雷科","110/08/11","國泰-台南",15,2,13
"18106","6207雷科","110/08/11","元大-小港",3,30,-27
"18107","6207雷科","110/08/11","元大-東門",12,0,12
"18108","6207雷科","110/08/11","(牛牛牛)亞-網路",0,23,-23
"18109","6207雷科","110/08/11","台灣企銀-太平",10,0,10
"18110","6207雷科","110/08/11","台新證券",4,26,-22
"18111","6207雷科","110/08/11","富邦-中壢",10,0,10
"18112","6207雷科","110/08/11","新光",2,23,-21
"18113","6207雷科","110/08/11","元大-博愛",10,0,10
"18114","6207雷科","110/08/11","元大-雙和",0,19,-19
"18115","6207雷科","110/08/11","富邦-內湖",9,0,9
"18116","6207雷科","110/08/11","新加坡商瑞銀",25,41,-16
"18117","6207雷科","110/08/11","中國信託-高雄",8,0,8
"18118","6207雷科","110/08/11","玉山證券",3,19,-16
"18119","6207雷科","110/08/11","國票-九鼎",8,0,8
"18120","6207雷科","110/08/11","玉山-雙和",0,16,-16
"18121","3679新至陞","110/08/11","摩根大通",62,3,59
"18122","3679新至陞","110/08/11","港商野村",7,25,-18
"18123","3679新至陞","110/08/11","台灣摩根士丹利",38,0,38
"18124","3679新至陞","110/08/11","凱基-文心",0,9,-9
"18125","3679新至陞","110/08/11","華南永昌-台中",16,0,16
"18126","3679新至陞","110/08/11","北城證券",0,8,-8
"18127","3679新至陞","110/08/11","凱基-台北",37,23,14
"18128","3679新至陞","110/08/11","華南永昌-大安",2,10,-8
"18129","3679新至陞","110/08/11","元大-成功",13,1,12
"18130","3679新至陞","110/08/11","元大-板橋",0,8,-8
"18131","3679新至陞","110/08/11","美林",22,16,6
"18132","3679新至陞","110/08/11","致和-東門",0,7,-7
"18133","3679新至陞","110/08/11","新加坡商瑞銀",12,6,6
"18134","3679新至陞","110/08/11","凱基-長庚",0,7,-7
"18135","3679新至陞","110/08/11","國泰-館前",5,0,5
"18136","3679新至陞","110/08/11","花旗環球",0,6,-6
"18137","3679新至陞","110/08/11","瑞士信貸",9,5,4
"18138","3679新至陞","110/08/11","群益金鼎-古亭",0,6,-6
"18139","3679新至陞","110/08/11","國泰-板橋",5,1,4
"18140","3679新至陞","110/08/11","元大-大同",0,6,-6
"18141","3679新至陞","110/08/11","日進",3,0,3
"18142","3679新至陞","110/08/11","華南永昌-鶯歌",0,5,-5
"18143","3679新至陞","110/08/11","(牛牛牛)亞-網路",4,1,3
"18144","3679新至陞","110/08/11","永豐金-新竹",0,5,-5
"18145","3679新至陞","110/08/11","康和-板橋",3,0,3
"18146","3679新至陞","110/08/11","凱基-新豐",0,4,-4
"18147","3679新至陞","110/08/11","高橋-內壢",2,0,2
"18148","3679新至陞","110/08/11","臺銀-高雄",1,4,-3
"18149","3679新至陞","110/08/11","富邦-台北",7,5,2
"18150","3679新至陞","110/08/11","日盛-文化",0,3,-3
"18151","2727王品","110/08/11","美林",113,23,90
"18152","2727王品","110/08/11","台灣摩根士丹利",8,65,-57
"18153","2727王品","110/08/11","富邦-左營",72,1,71
"18154","2727王品","110/08/11","合庫-新竹",1,23,-22
"18155","2727王品","110/08/11","凱基-台北",80,42,38
"18156","2727王品","110/08/11","永豐金-忠孝",0,20,-20
"18157","2727王品","110/08/11","港商野村",96,70,26
"18158","2727王品","110/08/11","彰銀-台中",1,15,-14
"18159","2727王品","110/08/11","國泰證券",23,1,22
"18160","2727王品","110/08/11","國泰-敦南",10,24,-14
"18161","2727王品","110/08/11","統一",28,8,20
"18162","2727王品","110/08/11","凱基-南崁",0,11,-11
"18163","2727王品","110/08/11","玉山-台南",20,1,19
"18164","2727王品","110/08/11","永豐金-三重",0,10,-10
"18165","2727王品","110/08/11","新光-台中",22,9,13
"18166","2727王品","110/08/11","富邦-中壢",3,12,-9
"18167","2727王品","110/08/11","凱基-興隆",11,0,11
"18168","2727王品","110/08/11","新光",16,24,-8
"18169","2727王品","110/08/11","元大證券",44,33,11
"18170","2727王品","110/08/11","國泰-板橋",12,20,-8
"18171","2727王品","110/08/11","日盛-樹林",12,2,10
"18172","2727王品","110/08/11","元大-彰化",0,8,-8
"18173","2727王品","110/08/11","第一金-新竹",10,0,10
"18174","2727王品","110/08/11","日盛-木柵",0,7,-7
"18175","2727王品","110/08/11","永全",10,0,10
"18176","2727王品","110/08/11","第一金-頭份",0,7,-7
"18177","2727王品","110/08/11","凱基-埔墘",10,0,10
"18178","2727王品","110/08/11","中國信託-高雄",2,9,-7
"18179","2727王品","110/08/11","摩根大通",42,33,9
"18180","2727王品","110/08/11","兆豐-公益",0,7,-7
"18181","1570力肯","110/08/11","國票-內壢",386,0,386
"18182","1570力肯","110/08/11","群益金鼎-大興",0,100,-100
"18183","1570力肯","110/08/11","華南永昌-桃園",104,3,101
"18184","1570力肯","110/08/11","新光",177,255,-78
"18185","1570力肯","110/08/11","摩根大通",154,84,70
"18186","1570力肯","110/08/11","富邦-台中",0,61,-61
"18187","1570力肯","110/08/11","日盛-頭份",51,0,51
"18188","1570力肯","110/08/11","群益金鼎-忠孝",1,60,-59
"18189","1570力肯","110/08/11","永豐金-中壢",51,1,50
"18190","1570力肯","110/08/11","元大-新店中正",2,61,-59
"18191","1570力肯","110/08/11","永豐金-北高雄",50,0,50
"18192","1570力肯","110/08/11","富邦-陽明",1,51,-50
"18193","1570力肯","110/08/11","凱基-天母",51,2,49
"18194","1570力肯","110/08/11","元大-太平",5,54,-49
"18195","1570力肯","110/08/11","日盛-員林",52,5,47
"18196","1570力肯","110/08/11","統一-松江",0,43,-43
"18197","1570力肯","110/08/11","元富-高雄",40,0,40
"18198","1570力肯","110/08/11","台新證券",6,44,-38
"18199","1570力肯","110/08/11","中國信託-嘉義",34,0,34
"18200","1570力肯","110/08/11","永豐金證券",1,36,-35
"18201","1570力肯","110/08/11","元大-北成功",30,1,29
"18202","1570力肯","110/08/11","瑞士信貸",0,27,-27
"18203","1570力肯","110/08/11","亞東-台中",26,0,26
"18204","1570力肯","110/08/11","元大-中壢",9,35,-26
"18205","1570力肯","110/08/11","第一金-嘉義",26,0,26
"18206","1570力肯","110/08/11","美商高盛",0,25,-25
"18207","1570力肯","110/08/11","凱基-中壢",27,3,24
"18208","1570力肯","110/08/11","國票-北高雄",128,153,-25
"18209","1570力肯","110/08/11","元大-福營",25,1,24
"18210","1570力肯","110/08/11","元富-新店",10,34,-24
"18211","6180橘子","110/08/11","台灣摩根士丹利",42,7,35
"18212","6180橘子","110/08/11","港商野村",5,128,-123
"18213","6180橘子","110/08/11","美商高盛",25,0,25
"18214","6180橘子","110/08/11","合庫-高雄",0,31,-31
"18215","6180橘子","110/08/11","元大-草屯",17,0,17
"18216","6180橘子","110/08/11","摩根大通",13,36,-23
"18217","6180橘子","110/08/11","日盛-文化",16,0,16
"18218","6180橘子","110/08/11","凱基-台北",37,60,-23
"18219","6180橘子","110/08/11","康和-嘉義",11,0,11
"18220","6180橘子","110/08/11","北城證券",0,19,-19
"18221","6180橘子","110/08/11","元大-左營",11,0,11
"18222","6180橘子","110/08/11","元富-潮州",24,41,-17
"18223","6180橘子","110/08/11","土銀-花蓮",10,0,10
"18224","6180橘子","110/08/11","群益金鼎-新店",0,15,-15
"18225","6180橘子","110/08/11","日盛證券",10,0,10
"18226","6180橘子","110/08/11","兆豐-竹北",0,14,-14
"18227","6180橘子","110/08/11","日盛-高雄",10,0,10
"18228","6180橘子","110/08/11","元富-成功",0,13,-13
"18229","6180橘子","110/08/11","國泰-新莊",10,0,10
"18230","6180橘子","110/08/11","新加坡商瑞銀",0,10,-10
"18231","6180橘子","110/08/11","群益金鼎-東門",10,0,10
"18232","6180橘子","110/08/11","康和-高雄",0,10,-10
"18233","6180橘子","110/08/11","凱基-中壢",10,0,10
"18234","6180橘子","110/08/11","國泰-館前",0,10,-10
"18235","6180橘子","110/08/11","元大-中壢",10,0,10
"18236","6180橘子","110/08/11","群益金鼎-嘉義",1,11,-10
"18237","6180橘子","110/08/11","元大-復北",10,0,10
"18238","6180橘子","110/08/11","華南永昌-虎尾",0,10,-10
"18239","6180橘子","110/08/11","美林",12,3,9
"18240","6180橘子","110/08/11","元富-民權",0,8,-8
"18241","2390云辰","110/08/11","臺銀-臺中",224,5,219
"18242","2390云辰","110/08/11","摩根大通",194,707,-513
"18243","2390云辰","110/08/11","兆豐-寶成",187,2,185
"18244","2390云辰","110/08/11","美商高盛",18,229,-211
"18245","2390云辰","110/08/11","元大-土城學府",143,69,74
"18246","2390云辰","110/08/11","兆豐-岡山",5,103,-98
"18247","2390云辰","110/08/11","凱基-民權",70,0,70
"18248","2390云辰","110/08/11","台新證券",13,108,-95
"18249","2390云辰","110/08/11","元大-草屯",67,2,65
"18250","2390云辰","110/08/11","美林",23,98,-75
"18251","2390云辰","110/08/11","兆豐-公益",60,0,60
"18252","2390云辰","110/08/11","永豐金-竹科",0,71,-71
"18253","2390云辰","110/08/11","國票-安和",56,0,56
"18254","2390云辰","110/08/11","元富-花蓮",0,70,-70
"18255","2390云辰","110/08/11","元富-中港",50,0,50
"18256","2390云辰","110/08/11","統一-城中",5,66,-61
"18257","2390云辰","110/08/11","元富-高雄",48,1,47
"18258","2390云辰","110/08/11","國泰-台中",50,109,-59
"18259","2390云辰","110/08/11","統一-新營",45,5,40
"18260","2390云辰","110/08/11","元大-豐原站前",10,69,-59
"18261","2390云辰","110/08/11","元大-板橋三民",39,1,38
"18262","2390云辰","110/08/11","新加坡商瑞銀",18,75,-57
"18263","2390云辰","110/08/11","元富-新店",52,17,35
"18264","2390云辰","110/08/11","台新-左楠",15,67,-52
"18265","2390云辰","110/08/11","永全-南崁",35,4,31
"18266","2390云辰","110/08/11","凱基-中壢",7,59,-52
"18267","2390云辰","110/08/11","群益金鼎-萬華",33,3,30
"18268","2390云辰","110/08/11","國票-北高雄",23,69,-46
"18269","2390云辰","110/08/11","日盛-宜蘭",25,0,25
"18270","2390云辰","110/08/11","新光-高雄",11,53,-42
"18271","2542興富發","110/08/06","瑞士信貸",747,10,737
"18272","2542興富發","110/08/06","凱基-士林",5,972,-967
"18273","2542興富發","110/08/06","摩根大通",837,107,730
"18274","2542興富發","110/08/06","統一-台中",1,376,-375
"18275","2542興富發","110/08/06","群益金鼎-敦南",681,1,680
"18276","2542興富發","110/08/06","永豐金-豐原",16,133,-117
"18277","2542興富發","110/08/06","凱基-台北",790,360,430
"18278","2542興富發","110/08/06","元富-敦南",0,111,-111
"18279","2542興富發","110/08/06","台灣摩根士丹利",259,20,239
"18280","2542興富發","110/08/06","兆豐-南京",0,108,-108
"18281","2542興富發","110/08/06","美商高盛",235,0,235
"18282","2542興富發","110/08/06","元大-金華",0,100,-100
"18283","2542興富發","110/08/06","新加坡商瑞銀",178,0,178
"18284","2542興富發","110/08/06","陽信",0,80,-80
"18285","2542興富發","110/08/06","凱基-中山",167,2,165
"18286","2542興富發","110/08/06","統一-金門",0,78,-78
"18287","2542興富發","110/08/06","凱基",121,14,107
"18288","2542興富發","110/08/06","新光-台中",7,68,-61
"18289","2542興富發","110/08/06","大慶-楊梅",101,4,97
"18290","2542興富發","110/08/06","富邦-新店",2,58,-56
"18291","2542興富發","110/08/06","美林",193,109,84
"18292","2542興富發","110/08/06","元大-新竹",0,52,-52
"18293","2542興富發","110/08/06","統一",64,5,59
"18294","2542興富發","110/08/06","凱基-永和",0,51,-51
"18295","2542興富發","110/08/06","富邦-南屯",60,1,59
"18296","2542興富發","110/08/06","統一-中壢",0,50,-50
"18297","2542興富發","110/08/06","群益金鼎",43,0,43
"18298","2542興富發","110/08/06","元富",0,50,-50
"18299","2542興富發","110/08/06","元大證券",128,85,43
"18300","2542興富發","110/08/06","法銀巴黎",0,48,-48
"18301","2867三商壽","110/08/06","摩根大通",410,157,253
"18302","2867三商壽","110/08/06","日盛-新莊",0,719,-719
"18303","2867三商壽","110/08/06","元大-北港",201,0,201
"18304","2867三商壽","110/08/06","群益金鼎-桃園",0,400,-400
"18305","2867三商壽","110/08/06","元大-斗信",200,0,200
"18306","2867三商壽","110/08/06","中國信託-文心",1,301,-300
"18307","2867三商壽","110/08/06","元大-沙鹿",199,0,199
"18308","2867三商壽","110/08/06","美林",10,169,-159
"18309","2867三商壽","110/08/06","永豐金-嘉義",130,0,130
"18310","2867三商壽","110/08/06","法銀巴黎",0,122,-122
"18311","2867三商壽","110/08/06","第一金-自由",100,0,100
"18312","2867三商壽","110/08/06","國票-中和",0,100,-100
"18313","2867三商壽","110/08/06","元大-大里德芳",100,0,100
"18314","2867三商壽","110/08/06","台灣摩根士丹利",65,164,-99
"18315","2867三商壽","110/08/06","元大-土城永寧",100,0,100
"18316","2867三商壽","110/08/06","凱基-高美館",2,64,-62
"18317","2867三商壽","110/08/06","瑞士信貸",94,0,94
"18318","2867三商壽","110/08/06","元大證券",1,62,-61
"18319","2867三商壽","110/08/06","元大-汐止",60,0,60
"18320","2867三商壽","110/08/06","華南永昌-南京",0,50,-50
"18321","2867三商壽","110/08/06","元富-大裕",52,0,52
"18322","2867三商壽","110/08/06","凱基-頭份",0,45,-45
"18323","2867三商壽","110/08/06","新光",53,1,52
"18324","2867三商壽","110/08/06","凱基",0,44,-44
"18325","2867三商壽","110/08/06","凱基-市府",51,0,51
"18326","2867三商壽","110/08/06","康和-屏東",0,43,-43
"18327","2867三商壽","110/08/06","安泰",49,0,49
"18328","2867三商壽","110/08/06","凱基-八德",0,40,-40
"18329","2867三商壽","110/08/06","富邦-桃園",50,2,48
"18330","2867三商壽","110/08/06","凱基-虎尾",0,40,-40
"18331","5521工信","110/08/06","日進",412,0,412
"18332","5521工信","110/08/06","中國信託-嘉義",0,100,-100
"18333","5521工信","110/08/06","瑞士信貸",48,0,48
"18334","5521工信","110/08/06","美林",0,69,-69
"18335","5521工信","110/08/06","日盛-雙和",34,0,34
"18336","5521工信","110/08/06","統一-新竹",0,60,-60
"18337","5521工信","110/08/06","聯邦-雙和",25,0,25
"18338","5521工信","110/08/06","第一金-桃園",0,55,-55
"18339","5521工信","110/08/06","台新證券",32,12,20
"18340","5521工信","110/08/06","凱基-台北",0,54,-54
"18341","5521工信","110/08/06","土銀-台中",17,0,17
"18342","5521工信","110/08/06","華南永昌-桃園",0,49,-49
"18343","5521工信","110/08/06","(牛牛牛)亞-鑫豐",15,0,15
"18344","5521工信","110/08/06","第一金-安和",0,40,-40
"18345","5521工信","110/08/06","元大-沙鹿",19,4,15
"18346","5521工信","110/08/06","合庫-台南",0,36,-36
"18347","5521工信","110/08/06","元富-安南",14,0,14
"18348","5521工信","110/08/06","台灣摩根士丹利",7,34,-27
"18349","5521工信","110/08/06","新加坡商瑞銀",10,0,10
"18350","5521工信","110/08/06","摩根大通",22,48,-26
"18351","5521工信","110/08/06","德信-中正",10,0,10
"18352","5521工信","110/08/06","台新-台中",0,20,-20
"18353","5521工信","110/08/06","國泰-敦南",22,12,10
"18354","5521工信","110/08/06","元大-豐原",0,20,-20
"18355","5521工信","110/08/06","群益金鼎-屏東",10,0,10
"18356","5521工信","110/08/06","元大-北成功",0,20,-20
"18357","5521工信","110/08/06","群益金鼎-東門",10,0,10
"18358","5521工信","110/08/06","永豐金-埔里",0,20,-20
"18359","5521工信","110/08/06","元大-西螺",10,0,10
"18360","5521工信","110/08/06","港商野村",0,16,-16
"18361","1471首利","110/08/06","國票-彰化",30,0,30
"18362","1471首利","110/08/06","兆豐-麻豆",0,50,-50
"18363","1471首利","110/08/06","凱基-宜蘭",27,0,27
"18364","1471首利","110/08/06","台新證券",3,30,-27
"18365","1471首利","110/08/06","玉山-桃園",22,0,22
"18366","1471首利","110/08/06","美林",15,41,-26
"18367","1471首利","110/08/06","新光-台中",17,0,17
"18368","1471首利","110/08/06","永豐金-台南",0,25,-25
"18369","1471首利","110/08/06","兆豐-埔墘",14,0,14
"18370","1471首利","110/08/06","元富-草屯",0,19,-19
"18371","1471首利","110/08/06","新光-高雄",11,0,11
"18372","1471首利","110/08/06","新光-桃園",0,17,-17
"18373","1471首利","110/08/06","合庫-鳳山",10,0,10
"18374","1471首利","110/08/06","摩根大通",13,28,-15
"18375","1471首利","110/08/06","統一-竹南",10,0,10
"18376","1471首利","110/08/06","華南永昌-淡水",1,15,-14
"18377","1471首利","110/08/06","(牛牛牛)亞-鑫豐",10,0,10
"18378","1471首利","110/08/06","台中銀",1,14,-13
"18379","1471首利","110/08/06","兆豐-岡山",10,0,10
"18380","1471首利","110/08/06","玉山-板橋",0,12,-12
"18381","1471首利","110/08/06","凱基-彰化",10,0,10
"18382","1471首利","110/08/06","富邦-基隆",10,22,-12
"18383","1471首利","110/08/06","富邦-永和",10,0,10
"18384","1471首利","110/08/06","台灣企銀",0,10,-10
"18385","1471首利","110/08/06","元大-竹山",10,0,10
"18386","1471首利","110/08/06","元富-民權",0,10,-10
"18387","1471首利","110/08/06","元大-民雄",10,0,10
"18388","1471首利","110/08/06","元大-左營",0,10,-10
"18389","1471首利","110/08/06","元大-南崁",10,1,9
"18390","1471首利","110/08/06","大昌-新店",2,11,-9
"18391","2883開發金","110/08/06","國泰證券",7766,49,7717
"18392","2883開發金","110/08/06","永豐金-板橋",2,2245,-2243
"18393","2883開發金","110/08/06","元富-城東",7094,124,6970
"18394","2883開發金","110/08/06","玉山-台南",63,2130,-2067
"18395","2883開發金","110/08/06","摩根大通",4922,1097,3825
"18396","2883開發金","110/08/06","國泰-板橋",236,1871,-1635
"18397","2883開發金","110/08/06","瑞士信貸",3230,108,3122
"18398","2883開發金","110/08/06","港商野村",1243,2562,-1319
"18399","2883開發金","110/08/06","凱基-台北",4810,2311,2499
"18400","2883開發金","110/08/06","美林",1480,2782,-1302
"18401","2883開發金","110/08/06","合庫證券",3551,2064,1487
"18402","2883開發金","110/08/06","群益金鼎-中山",7,1151,-1144
"18403","2883開發金","110/08/06","新加坡商瑞銀",3900,2689,1211
"18404","2883開發金","110/08/06","日盛-員林",17,1100,-1083
"18405","2883開發金","110/08/06","玉山證券",1332,183,1149
"18406","2883開發金","110/08/06","台灣摩根士丹利",509,1544,-1035
"18407","2883開發金","110/08/06","國票-長城",1003,0,1003
"18408","2883開發金","110/08/06","台灣企銀-民雄",0,1004,-1004
"18409","2883開發金","110/08/06","康和",720,0,720
"18410","2883開發金","110/08/06","港商法國興業",7,981,-974
"18411","2883開發金","110/08/06","福邦證券",590,15,575
"18412","2883開發金","110/08/06","新光",240,1199,-959
"18413","2883開發金","110/08/06","台灣企銀-九如",492,10,482
"18414","2883開發金","110/08/06","元大-新莊",58,1017,-959
"18415","2883開發金","110/08/06","宏遠-民生",502,54,448
"18416","2883開發金","110/08/06","富邦-彰化",5,766,-761
"18417","2883開發金","110/08/06","元大證券",803,358,445
"18418","2883開發金","110/08/06","中國信託",270,931,-661
"18419","2883開發金","110/08/06","玉山-高雄",476,80,396
"18420","2883開發金","110/08/06","永豐金-彰化",33,655,-622
"18421","6205詮欣","110/08/06","臺銀-民權",20,0,20
"18422","6205詮欣","110/08/06","元大-板橋",0,50,-50
"18423","6205詮欣","110/08/06","合庫-三重",15,0,15
"18424","6205詮欣","110/08/06","摩根大通",0,29,-29
"18425","6205詮欣","110/08/06","日盛-三重",15,4,11
"18426","6205詮欣","110/08/06","臺銀-新竹",0,3,-3
"18427","6205詮欣","110/08/06","凱基-長庚",10,0,10
"18428","6205詮欣","110/08/06","日盛-頭份",0,3,-3
"18429","6205詮欣","110/08/06","臺銀-臺中",5,0,5
"18430","6205詮欣","110/08/06","群益金鼎-潭子",0,3,-3
"18431","6205詮欣","110/08/06","兆豐-台中",4,0,4
"18432","6205詮欣","110/08/06","永豐金-敦南",0,3,-3
"18433","6205詮欣","110/08/06","凱基-台北",4,0,4
"18434","6205詮欣","110/08/06","美林",0,2,-2
"18435","6205詮欣","110/08/06","元大-龍潭",4,0,4
"18436","6205詮欣","110/08/06","新加坡商瑞銀",6,8,-2
"18437","6205詮欣","110/08/06","瑞士信貸",3,0,3
"18438","6205詮欣","110/08/06","華南永昌-淡水",0,2,-2
"18439","6205詮欣","110/08/06","國泰-板橋",3,0,3
"18440","6205詮欣","110/08/06","元大-發財",0,2,-2
"18441","6205詮欣","110/08/06","台中銀",2,0,2
"18442","6205詮欣","110/08/06","元大-屏東民生",0,2,-2
"18443","6205詮欣","110/08/06","德信-新營",2,0,2
"18444","6205詮欣","110/08/06","統一-南京",0,1,-1
"18445","6205詮欣","110/08/06","兆豐-竹北",2,0,2
"18446","6205詮欣","110/08/06","新光-台中",0,1,-1
"18447","6205詮欣","110/08/06","兆豐-景美",2,0,2
"18448","6205詮欣","110/08/06","玉山證券",0,1,-1
"18449","6205詮欣","110/08/06","台新-台中",2,0,2
"18450","6205詮欣","110/08/06","富邦-左營",0,1,-1
"18451","1540喬福","110/08/06","元富-中原",27,0,27
"18452","1540喬福","110/08/06","統一-新台中",0,25,-25
"18453","1540喬福","110/08/06","合庫-台中",24,0,24
"18454","1540喬福","110/08/06","大慶-中壢",0,24,-24
"18455","1540喬福","110/08/06","台新-台中",10,0,10
"18456","1540喬福","110/08/06","福勝",0,7,-7
"18457","1540喬福","110/08/06","富邦-竹北",7,0,7
"18458","1540喬福","110/08/06","群益金鼎-高雄",0,5,-5
"18459","1540喬福","110/08/06","華南永昌-中正",5,0,5
"18460","1540喬福","110/08/06","富邦-高雄",0,5,-5
"18461","1540喬福","110/08/06","玉山證券",4,0,4
"18462","1540喬福","110/08/06","美林",0,3,-3
"18463","1540喬福","110/08/06","兆豐-台中港",2,0,2
"18464","1540喬福","110/08/06","元大-景美",0,3,-3
"18465","1540喬福","110/08/06","國票-中正",2,0,2
"18466","1540喬福","110/08/06","元大-和平",0,3,-3
"18467","1540喬福","110/08/06","凱基-虎尾",2,0,2
"18468","1540喬福","110/08/06","日盛-台中",0,2,-2
"18469","1540喬福","110/08/06","凱基-台北",2,0,2
"18470","1540喬福","110/08/06","日盛-中和",0,2,-2
"18471","1540喬福","110/08/06","元大-府城",2,0,2
"18472","1540喬福","110/08/06","台新-台南",0,2,-2
"18473","1540喬福","110/08/06","土銀-玉里",1,0,1
"18474","1540喬福","110/08/06","玉山-高雄",0,2,-2
"18475","1540喬福","110/08/06","第一金-中壢",1,0,1
"18476","1540喬福","110/08/06","凱基-中壢",0,2,-2
"18477","1540喬福","110/08/06","國票-彰化",1,0,1
"18478","1540喬福","110/08/06","致和-南京",0,1,-1
"18479","1540喬福","110/08/06","國泰-敦南",1,0,1
"18480","1540喬福","110/08/06","摩根大通",0,1,-1
"18481","2888新光金","110/08/06","玉山-城中",3762,22,3740
"18482","2888新光金","110/08/06","美林",583,3191,-2608
"18483","2888新光金","110/08/06","瑞士信貸",1783,778,1005
"18484","2888新光金","110/08/06","元富-城東",39,1594,-1555
"18485","2888新光金","110/08/06","元大-土城永寧",1004,16,988
"18486","2888新光金","110/08/06","日盛-板橋",19,1000,-981
"18487","2888新光金","110/08/06","新加坡商瑞銀",1129,357,772
"18488","2888新光金","110/08/06","摩根大通",2207,3153,-946
"18489","2888新光金","110/08/06","中國信託",566,4,562
"18490","2888新光金","110/08/06","新光",505,1390,-885
"18491","2888新光金","110/08/06","富邦-員林",484,3,481
"18492","2888新光金","110/08/06","台灣摩根士丹利",181,1022,-841
"18493","2888新光金","110/08/06","臺銀-金山",432,3,429
"18494","2888新光金","110/08/06","元大-四維",35,750,-715
"18495","2888新光金","110/08/06","臺銀",418,2,416
"18496","2888新光金","110/08/06","美商高盛",114,811,-697
"18497","2888新光金","110/08/06","凱基-東勢",404,6,398
"18498","2888新光金","110/08/06","法銀巴黎",274,867,-593
"18499","2888新光金","110/08/06","玉山證券",416,73,343
"18500","2888新光金","110/08/06","元大-員林",18,503,-485
"18501","2888新光金","110/08/06","華南永昌-民權",305,0,305
"18502","2888新光金","110/08/06","富邦-建國",57,471,-414
"18503","2888新光金","110/08/06","永興",300,10,290
"18504","2888新光金","110/08/06","富邦-台中",15,418,-403
"18505","2888新光金","110/08/06","富邦-台北",319,48,271
"18506","2888新光金","110/08/06","華南永昌-嘉義",2,324,-322
"18507","2888新光金","110/08/06","兆豐-員林",274,28,246
"18508","2888新光金","110/08/06","凱基-台北",839,1120,-281
"18509","2888新光金","110/08/06","合庫-台中",240,10,230
"18510","2888新光金","110/08/06","國泰-館前",20,289,-269
"18511","1340勝悅","110/08/06","國泰-台中",30,0,30
"18512","1340勝悅","110/08/06","凱基-三峽",0,20,-20
"18513","1340勝悅","110/08/06","元富-彰化",10,0,10
"18514","1340勝悅","110/08/06","富邦-台東",1,14,-13
"18515","1340勝悅","110/08/06","華南永昌-忠孝",8,0,8
"18516","1340勝悅","110/08/06","華南永昌-三重",0,12,-12
"18517","1340勝悅","110/08/06","華南永昌-大安",7,0,7
"18518","1340勝悅","110/08/06","華南永昌-台中",0,10,-10
"18519","1340勝悅","110/08/06","永豐金-信義",6,0,6
"18520","1340勝悅","110/08/06","美林",0,8,-8
"18521","1340勝悅","110/08/06","臺灣企銀-埔墘",5,0,5
"18522","1340勝悅","110/08/06","第一金-豐原",0,8,-8
"18523","1340勝悅","110/08/06","元大-沙鹿",5,0,5
"18524","1340勝悅","110/08/06","凱基-城中",0,8,-8
"18525","1340勝悅","110/08/06","新光-高雄",4,0,4
"18526","1340勝悅","110/08/06","華南永昌-嘉義",0,6,-6
"18527","1340勝悅","110/08/06","群益金鼎-彰化",4,0,4
"18528","1340勝悅","110/08/06","元富",0,5,-5
"18529","1340勝悅","110/08/06","元大-仁愛",4,0,4
"18530","1340勝悅","110/08/06","光和-田中",0,5,-5
"18531","1340勝悅","110/08/06","美商高盛",3,0,3
"18532","1340勝悅","110/08/06","摩根大通",0,5,-5
"18533","1340勝悅","110/08/06","群益金鼎-館前",3,0,3
"18534","1340勝悅","110/08/06","元大-草屯",0,4,-4
"18535","1340勝悅","110/08/06","臺銀-臺中",2,0,2
"18536","1340勝悅","110/08/06","凱基-台北",1,4,-3
"18537","1340勝悅","110/08/06","永全-南崁",2,0,2
"18538","1340勝悅","110/08/06","元大-苑裡",0,3,-3
"18539","1340勝悅","110/08/06","群益金鼎-崇德",2,0,2
"18540","1340勝悅","110/08/06","日盛-員林",0,2,-2
"18541","6246臺龍","110/08/06","元大-西螺",120,1,119
"18542","6246臺龍","110/08/06","統一",0,247,-247
"18543","6246臺龍","110/08/06","富邦-敦南",111,0,111
"18544","6246臺龍","110/08/06","元大-林森",3,203,-200
"18545","6246臺龍","110/08/06","統一-台中",74,10,64
"18546","6246臺龍","110/08/06","凱基-大直",4,103,-99
"18547","6246臺龍","110/08/06","日盛證券",53,0,53
"18548","6246臺龍","110/08/06","大慶-富順",45,110,-65
"18549","6246臺龍","110/08/06","兆豐-高雄",81,38,43
"18550","6246臺龍","110/08/06","統一-南京",20,70,-50
"18551","6246臺龍","110/08/06","群益金鼎-東大",43,2,41
"18552","6246臺龍","110/08/06","港商野村",166,213,-47
"18553","6246臺龍","110/08/06","統一-永和",40,0,40
"18554","6246臺龍","110/08/06","台灣企銀",0,45,-45
"18555","6246臺龍","110/08/06","凱基-市府",48,8,40
"18556","6246臺龍","110/08/06","華南永昌-忠孝",1,45,-44
"18557","6246臺龍","110/08/06","凱基-員林",40,0,40
"18558","6246臺龍","110/08/06","永豐金-桃盛",0,35,-35
"18559","6246臺龍","110/08/06","新光-高雄",57,21,36
"18560","6246臺龍","110/08/06","康和-澎湖",0,30,-30
"18561","6246臺龍","110/08/06","國泰-敦南",104,69,35
"18562","6246臺龍","110/08/06","康和-石牌",0,30,-30
"18563","6246臺龍","110/08/06","元大-金門",39,5,34
"18564","6246臺龍","110/08/06","中國信託-永康",6,35,-29
"18565","6246臺龍","110/08/06","元大-西屯",29,2,27
"18566","6246臺龍","110/08/06","康和-內湖",2,30,-28
"18567","6246臺龍","110/08/06","永興-水湳",26,1,25
"18568","6246臺龍","110/08/06","大昌",16,43,-27
"18569","6246臺龍","110/08/06","元大-豐原站前",25,0,25
"18570","6246臺龍","110/08/06","台新證券",29,55,-26
"18571","00715L期街口布蘭特正2","110/08/06","華南永昌-長虹",810,50,760
"18572","00715L期街口布蘭特正2","110/08/06","永豐金證券",105,2122,-2017
"18573","00715L期街口布蘭特正2","110/08/06","富邦證券",557,0,557
"18574","00715L期街口布蘭特正2","110/08/06","(牛牛牛)亞-鑫豐",23,892,-869
"18575","00715L期街口布蘭特正2","110/08/06","新光",643,129,514
"18576","00715L期街口布蘭特正2","110/08/06","凱基-台北",1,789,-788
"18577","00715L期街口布蘭特正2","110/08/06","台新-新營",434,0,434
"18578","00715L期街口布蘭特正2","110/08/06","元大-永康",0,781,-781
"18579","00715L期街口布蘭特正2","110/08/06","群益金鼎-屏東",401,0,401
"18580","00715L期街口布蘭特正2","110/08/06","富邦-彰化",0,513,-513
"18581","00715L期街口布蘭特正2","110/08/06","永豐金-板盛",402,21,381
"18582","00715L期街口布蘭特正2","110/08/06","玉山-大里",0,488,-488
"18583","00715L期街口布蘭特正2","110/08/06","兆豐-員林",302,6,296
"18584","00715L期街口布蘭特正2","110/08/06","元大-中和",0,400,-400
"18585","00715L期街口布蘭特正2","110/08/06","兆豐-新莊",260,0,260
"18586","00715L期街口布蘭特正2","110/08/06","元富-安南",2,310,-308
"18587","00715L期街口布蘭特正2","110/08/06","宏遠-光隆",252,0,252
"18588","00715L期街口布蘭特正2","110/08/06","元大-羅東",5,304,-299
"18589","00715L期街口布蘭特正2","110/08/06","台中銀",207,0,207
"18590","00715L期街口布蘭特正2","110/08/06","第一金-路竹",13,273,-260
"18591","00715L期街口布蘭特正2","110/08/06","國票-北高雄",204,0,204
"18592","00715L期街口布蘭特正2","110/08/06","元大-新盛",5,247,-242
"18593","00715L期街口布蘭特正2","110/08/06","永豐金-新店",200,4,196
"18594","00715L期街口布蘭特正2","110/08/06","元大-忠孝",0,202,-202
"18595","00715L期街口布蘭特正2","110/08/06","元大-新莊",211,17,194
"18596","00715L期街口布蘭特正2","110/08/06","兆豐-嘉義",8,200,-192
"18597","00715L期街口布蘭特正2","110/08/06","聯邦-興中",185,0,185
"18598","00715L期街口布蘭特正2","110/08/06","元大-西屯",5,190,-185
"18599","00715L期街口布蘭特正2","110/08/06","元富-成功",244,62,182
"18600","00715L期街口布蘭特正2","110/08/06","元大-前金",1,181,-180
"18601","8941關中","110/08/06","第一金-台南",6,0,6
"18602","8941關中","110/08/06","富邦-員林",0,20,-20
"18603","8941關中","110/08/06","凱基-市府",6,0,6
"18604","8941關中","110/08/06","元大-金華",0,1,-1
"18605","8941關中","110/08/06","合庫-台中",5,0,5
"18606","8941關中","110/08/06","元大-淡水",0,1,-1
"18607","8941關中","110/08/06","永豐金-三重",2,0,2
"18608","8941關中","110/08/06","合庫證券",0,0,0
"18609","8941關中","110/08/06","(牛牛牛)亞-鑫豐",1,0,1
"18610","8941關中","110/08/06","元大證券",0,0,0
"18611","8941關中","110/08/06","群益金鼎-基隆",1,0,1
"18612","8941關中","110/08/06","元大-桃興",2,2,0
"18613","8941關中","110/08/06","元大-古亭",1,0,1
"18614","8941關中","110/08/06","元大-板橋",0,0,0
"18615","8941關中","110/08/06","合庫證券",0,0,0
"18616","8941關中","110/08/06","永豐金-萬盛",0,0,0
"18617","8941關中","110/08/06","元大證券",0,0,0
"18618","8941關中","110/08/06","",NA,NA,NA
"18619","8941關中","110/08/06","元大-桃興",2,2,0
"18620","8941關中","110/08/06","",NA,NA,NA
"18621","8941關中","110/08/06","元大-板橋",0,0,0
"18622","8941關中","110/08/06","",NA,NA,NA
"18623","8941關中","110/08/06","永豐金-萬盛",0,0,0
"18624","8941關中","110/08/06","",NA,NA,NA
"18625","8941關中","110/08/06","",NA,NA,NA
"18626","8941關中","110/08/06","",NA,NA,NA
"18627","8941關中","110/08/06","",NA,NA,NA
"18628","8941關中","110/08/06","",NA,NA,NA
"18629","8941關中","110/08/06","",NA,NA,NA
"18630","8941關中","110/08/06","",NA,NA,NA
"18631","8936國統","110/08/06","摩根大通",55,0,55
"18632","8936國統","110/08/06","大慶-蘆洲",1,63,-62
"18633","8936國統","110/08/06","凱基-台北",66,19,47
"18634","8936國統","110/08/06","宏遠-館前",0,50,-50
"18635","8936國統","110/08/06","國票-敦北法人",25,1,24
"18636","8936國統","110/08/06","凱基-長庚",0,46,-46
"18637","8936國統","110/08/06","元大-大里德芳",22,0,22
"18638","8936國統","110/08/06","台灣摩根士丹利",0,42,-42
"18639","8936國統","110/08/06","兆豐-新營",20,0,20
"18640","8936國統","110/08/06","永豐金-苓雅",15,48,-33
"18641","8936國統","110/08/06","新光-新竹",17,0,17
"18642","8936國統","110/08/06","元大-竹東",0,30,-30
"18643","8936國統","110/08/06","新光-台中",17,4,13
"18644","8936國統","110/08/06","新加坡商瑞銀",23,49,-26
"18645","8936國統","110/08/06","元富-新店",10,0,10
"18646","8936國統","110/08/06","國票-北高雄",0,25,-25
"18647","8936國統","110/08/06","中國信託-永康",10,0,10
"18648","8936國統","110/08/06","國泰-台南",0,20,-20
"18649","8936國統","110/08/06","台新-高雄",11,1,10
"18650","8936國統","110/08/06","國泰-敦南",7,24,-17
"18651","8936國統","110/08/06","國泰-板橋",10,0,10
"18652","8936國統","110/08/06","臺灣企銀-桃園",0,13,-13
"18653","8936國統","110/08/06","群益金鼎-東湖",10,0,10
"18654","8936國統","110/08/06","美商高盛",1,13,-12
"18655","8936國統","110/08/06","元大-北成功",10,0,10
"18656","8936國統","110/08/06","合庫-高雄",0,10,-10
"18657","8936國統","110/08/06","臺銀-高雄",9,0,9
"18658","8936國統","110/08/06","臺銀",0,10,-10
"18659","8936國統","110/08/06","日盛-和美",9,0,9
"18660","8936國統","110/08/06","元大-土城學府",0,10,-10
"18661","6226光鼎","110/08/06","國泰-敦南",183,87,96
"18662","6226光鼎","110/08/06","富邦-嘉義",286,537,-251
"18663","6226光鼎","110/08/06","台新-高雄",129,53,76
"18664","6226光鼎","110/08/06","統一-新竹",30,181,-151
"18665","6226光鼎","110/08/06","新光",81,25,56
"18666","6226光鼎","110/08/06","宏遠-台中",0,118,-118
"18667","6226光鼎","110/08/06","台新證券",112,57,55
"18668","6226光鼎","110/08/06","華南永昌-大安",2,82,-80
"18669","6226光鼎","110/08/06","台新-新營",56,4,52
"18670","6226光鼎","110/08/06","元富-西松",1,76,-75
"18671","6226光鼎","110/08/06","中國信託",48,7,41
"18672","6226光鼎","110/08/06","凱基-豐中",1,74,-73
"18673","6226光鼎","110/08/06","富邦-板橋",38,5,33
"18674","6226光鼎","110/08/06","凱基-長庚",3,64,-61
"18675","6226光鼎","110/08/06","台新-中壢",32,0,32
"18676","6226光鼎","110/08/06","元富-高雄",2,58,-56
"18677","6226光鼎","110/08/06","日盛-北高雄",32,1,31
"18678","6226光鼎","110/08/06","永豐金-萬盛",2,49,-47
"18679","6226光鼎","110/08/06","群益金鼎-桃園",31,0,31
"18680","6226光鼎","110/08/06","統一-仁愛",11,57,-46
"18681","6226光鼎","110/08/06","元大-屏東民生",31,0,31
"18682","6226光鼎","110/08/06","國票-台中",0,46,-46
"18683","6226光鼎","110/08/06","中國信託-永康",35,5,30
"18684","6226光鼎","110/08/06","群益金鼎-嘉義",11,55,-44
"18685","6226光鼎","110/08/06","國泰-台中",57,27,30
"18686","6226光鼎","110/08/06","元大-沙鹿",6,50,-44
"18687","6226光鼎","110/08/06","群益金鼎-板橋",30,0,30
"18688","6226光鼎","110/08/06","新光-高雄",17,58,-41
"18689","6226光鼎","110/08/06","寶盛",29,0,29
"18690","6226光鼎","110/08/06","元大-嘉義",3,36,-33
"18691","2363矽統","110/08/06","新加坡商瑞銀",1338,777,561
"18692","2363矽統","110/08/06","凱基-台北",4343,7347,-3004
"18693","2363矽統","110/08/06","日盛-三峽",475,86,389
"18694","2363矽統","110/08/06","摩根大通",1716,2908,-1192
"18695","2363矽統","110/08/06","中國信託-忠孝",433,44,389
"18696","2363矽統","110/08/06","美商高盛",315,1169,-854
"18697","2363矽統","110/08/06","陽信-石牌",448,73,375
"18698","2363矽統","110/08/06","永豐金證券",168,889,-721
"18699","2363矽統","110/08/06","國泰-台中",743,471,272
"18700","2363矽統","110/08/06","國票-敦北法人",29,513,-484
"18701","2363矽統","110/08/06","國泰-敦南",2177,1919,258
"18702","2363矽統","110/08/06","元富-嘉義",43,424,-381
"18703","2363矽統","110/08/06","台新-台中",565,347,218
"18704","2363矽統","110/08/06","元大-東泰",174,540,-366
"18705","2363矽統","110/08/06","元大-敦化",246,31,215
"18706","2363矽統","110/08/06","元大證券",187,522,-335
"18707","2363矽統","110/08/06","大昌-桃園",241,51,190
"18708","2363矽統","110/08/06","合庫證券",173,495,-322
"18709","2363矽統","110/08/06","華南永昌-淡水",230,48,182
"18710","2363矽統","110/08/06","元大-萬華",128,391,-263
"18711","2363矽統","110/08/06","港商野村",2381,2203,178
"18712","2363矽統","110/08/06","國票-博愛",93,350,-257
"18713","2363矽統","110/08/06","台新-高雄",529,361,168
"18714","2363矽統","110/08/06","台新-屏東",200,455,-255
"18715","2363矽統","110/08/06","元大-新竹",320,156,164
"18716","2363矽統","110/08/06","日盛-南京",74,327,-253
"18717","2363矽統","110/08/06","元大-中壢",454,292,162
"18718","2363矽統","110/08/06","兆豐-民生",16,227,-211
"18719","2363矽統","110/08/06","新光-台南",310,150,160
"18720","2363矽統","110/08/06","元大-旗山",168,364,-196
"18721","8112至上","110/08/06","新光-新竹",533,65,468
"18722","8112至上","110/08/06","摩根大通",12,2930,-2918
"18723","8112至上","110/08/06","國泰-新莊",192,0,192
"18724","8112至上","110/08/06","凱基-台北",388,1548,-1160
"18725","8112至上","110/08/06","合庫證券",195,11,184
"18726","8112至上","110/08/06","新加坡商瑞銀",17,1069,-1052
"18727","8112至上","110/08/06","元大-西門",178,2,176
"18728","8112至上","110/08/06","台灣摩根士丹利",48,955,-907
"18729","8112至上","110/08/06","(牛牛牛)亞-鑫豐",153,13,140
"18730","8112至上","110/08/06","元大-竹科",61,824,-763
"18731","8112至上","110/08/06","永豐金-中正",120,1,119
"18732","8112至上","110/08/06","美林",19,583,-564
"18733","8112至上","110/08/06","陽信",111,0,111
"18734","8112至上","110/08/06","瑞士信貸",0,547,-547
"18735","8112至上","110/08/06","康和-板橋",106,0,106
"18736","8112至上","110/08/06","康和",2,484,-482
"18737","8112至上","110/08/06","群益金鼎-延平",101,0,101
"18738","8112至上","110/08/06","永豐金-台中",17,430,-413
"18739","8112至上","110/08/06","元大-北成功",110,14,96
"18740","8112至上","110/08/06","元大-屏南",4,393,-389
"18741","8112至上","110/08/06","元富-古亭",141,46,95
"18742","8112至上","110/08/06","美商高盛",12,217,-205
"18743","8112至上","110/08/06","臺灣企銀-埔墘",92,1,91
"18744","8112至上","110/08/06","新光-桃園",42,204,-162
"18745","8112至上","110/08/06","第一金-桃園",89,0,89
"18746","8112至上","110/08/06","玉山證券",18,162,-144
"18747","8112至上","110/08/06","台新證券",105,16,89
"18748","8112至上","110/08/06","群益金鼎-基隆",7,151,-144
"18749","8112至上","110/08/06","玉山-板橋",96,10,86
"18750","8112至上","110/08/06","台新-新營",60,183,-123
"18751","1570力肯","110/08/06","國票-北高雄",246,40,206
"18752","1570力肯","110/08/06","富邦-高雄",0,47,-47
"18753","1570力肯","110/08/06","統一-松江",43,0,43
"18754","1570力肯","110/08/06","凱基-台北",55,101,-46
"18755","1570力肯","110/08/06","日茂-南投",42,2,40
"18756","1570力肯","110/08/06","台新證券",25,60,-35
"18757","1570力肯","110/08/06","群益金鼎-三重",34,2,32
"18758","1570力肯","110/08/06","元富-三重",0,32,-32
"18759","1570力肯","110/08/06","華南永昌-麻豆",32,4,28
"18760","1570力肯","110/08/06","台中銀-員林",0,32,-32
"18761","1570力肯","110/08/06","永豐金-中和",29,2,27
"18762","1570力肯","110/08/06","國泰-板橋",1,33,-32
"18763","1570力肯","110/08/06","永豐金-大園",21,0,21
"18764","1570力肯","110/08/06","摩根大通",83,112,-29
"18765","1570力肯","110/08/06","統一-三重",25,5,20
"18766","1570力肯","110/08/06","玉山-新莊",0,27,-27
"18767","1570力肯","110/08/06","元富-新店",20,0,20
"18768","1570力肯","110/08/06","永豐金-虎尾",0,27,-27
"18769","1570力肯","110/08/06","大昌-桃園",21,1,20
"18770","1570力肯","110/08/06","玉山-左營",0,25,-25
"18771","1570力肯","110/08/06","康和-高雄",18,1,17
"18772","1570力肯","110/08/06","富邦-仁愛",10,32,-22
"18773","1570力肯","110/08/06","元富-潮州",16,0,16
"18774","1570力肯","110/08/06","中國信託-忠孝",0,21,-21
"18775","1570力肯","110/08/06","元富-松德",15,0,15
"18776","1570力肯","110/08/06","臺銀-鳳山",4,24,-20
"18777","1570力肯","110/08/06","凱基-嘉義",15,0,15
"18778","1570力肯","110/08/06","台新-屏東",1,21,-20
"18779","1570力肯","110/08/06","凱基-埔墘",15,0,15
"18780","1570力肯","110/08/06","群益金鼎-西松",0,20,-20
"18781","2929淘帝","110/08/06","統一",155,0,155
"18782","2929淘帝","110/08/06","元富-敦南",0,100,-100
"18783","2929淘帝","110/08/06","港商野村",188,52,136
"18784","2929淘帝","110/08/06","兆豐-忠孝",0,60,-60
"18785","2929淘帝","110/08/06","摩根大通",72,3,69
"18786","2929淘帝","110/08/06","台新證券",9,68,-59
"18787","2929淘帝","110/08/06","新光-新竹",45,0,45
"18788","2929淘帝","110/08/06","凱基-台北",30,80,-50
"18789","2929淘帝","110/08/06","華南永昌",40,1,39
"18790","2929淘帝","110/08/06","台新-台中",0,45,-45
"18791","2929淘帝","110/08/06","美林",52,18,34
"18792","2929淘帝","110/08/06","國泰-台中",2,43,-41
"18793","2929淘帝","110/08/06","新加坡商瑞銀",48,14,34
"18794","2929淘帝","110/08/06","華南永昌-林口",0,37,-37
"18795","2929淘帝","110/08/06","日盛-頭份",32,0,32
"18796","2929淘帝","110/08/06","元大-屏南",0,30,-30
"18797","2929淘帝","110/08/06","日盛-板橋中山",30,0,30
"18798","2929淘帝","110/08/06","群益金鼎-潭子",0,26,-26
"18799","2929淘帝","110/08/06","元大-中壢",25,3,22
"18800","2929淘帝","110/08/06","元大-新莊",3,26,-23
"18801","2929淘帝","110/08/06","元大-莒光",21,0,21
"18802","2929淘帝","110/08/06","臺銀-臺南",0,22,-22
"18803","2929淘帝","110/08/06","福勝",20,0,20
"18804","2929淘帝","110/08/06","新光",2,24,-22
"18805","2929淘帝","110/08/06","元富-三重",17,0,17
"18806","2929淘帝","110/08/06","華南永昌-長虹",0,22,-22
"18807","2929淘帝","110/08/06","國票-南京",17,0,17
"18808","2929淘帝","110/08/06","富邦-高雄",0,20,-20
"18809","2929淘帝","110/08/06","合庫證券",16,0,16
"18810","2929淘帝","110/08/06","元大-竹科",0,20,-20
"18811","5410國眾","110/08/06","元大-中壢",15,1,14
"18812","5410國眾","110/08/06","凱基-台北",0,16,-16
"18813","5410國眾","110/08/06","玉山-嘉義",10,0,10
"18814","5410國眾","110/08/06","元大-松山",0,15,-15
"18815","5410國眾","110/08/06","元大-敦南",10,0,10
"18816","5410國眾","110/08/06","元大-斗信",0,10,-10
"18817","5410國眾","110/08/06","永豐金-板橋",10,0,10
"18818","5410國眾","110/08/06","臺銀-臺南",0,9,-9
"18819","5410國眾","110/08/06","華南永昌-新莊",9,0,9
"18820","5410國眾","110/08/06","新光-台中",0,9,-9
"18821","5410國眾","110/08/06","華南永昌-世貿",6,0,6
"18822","5410國眾","110/08/06","群益金鼎-中壢",0,7,-7
"18823","5410國眾","110/08/06","亞東",5,0,5
"18824","5410國眾","110/08/06","永豐金-中和",0,7,-7
"18825","5410國眾","110/08/06","大昌-新店",5,0,5
"18826","5410國眾","110/08/06","元大-北投",0,6,-6
"18827","5410國眾","110/08/06","凱基-民權",5,0,5
"18828","5410國眾","110/08/06","元大-豐原站前",0,6,-6
"18829","5410國眾","110/08/06","元大-士林",5,0,5
"18830","5410國眾","110/08/06","臺銀",0,5,-5
"18831","5410國眾","110/08/06","元大-北三重",5,0,5
"18832","5410國眾","110/08/06","台灣企銀-太平",0,5,-5
"18833","5410國眾","110/08/06","永豐金-桃園",5,0,5
"18834","5410國眾","110/08/06","元大-大益",0,5,-5
"18835","5410國眾","110/08/06","兆豐-員林",4,0,4
"18836","5410國眾","110/08/06","元大-和平",0,5,-5
"18837","5410國眾","110/08/06","台新-三民",4,0,4
"18838","5410國眾","110/08/06","元大-台南",0,5,-5
"18839","5410國眾","110/08/06","國泰-敦南",6,2,4
"18840","5410國眾","110/08/06","元大-古亭",0,5,-5
"18841","2841台開","110/08/06","宏遠-館前",520,0,520
"18842","2841台開","110/08/06","元富-台南",0,200,-200
"18843","2841台開","110/08/06","合庫證券",193,0,193
"18844","2841台開","110/08/06","元大-鹿港",0,182,-182
"18845","2841台開","110/08/06","永興-台中",100,0,100
"18846","2841台開","110/08/06","群益金鼎-桃園",0,132,-132
"18847","2841台開","110/08/06","永豐金-竹北",78,0,78
"18848","2841台開","110/08/06","中國信託-忠孝",0,130,-130
"18849","2841台開","110/08/06","元大證券",50,0,50
"18850","2841台開","110/08/06","元大-四維",3,116,-113
"18851","2841台開","110/08/06","元大-大天母",50,0,50
"18852","2841台開","110/08/06","元富-嘉義",0,50,-50
"18853","2841台開","110/08/06","永豐金-敦南",50,0,50
"18854","2841台開","110/08/06","元富-板橋",0,50,-50
"18855","2841台開","110/08/06","日盛-園區",49,0,49
"18856","2841台開","110/08/06","(牛牛牛)亞-鑫豐",0,50,-50
"18857","2841台開","110/08/06","元大-前金",38,0,38
"18858","2841台開","110/08/06","群益金鼎-新店",0,50,-50
"18859","2841台開","110/08/06","新光-台中",32,1,31
"18860","2841台開","110/08/06","統一-彰化",0,45,-45
"18861","2841台開","110/08/06","華南永昌-台中",30,0,30
"18862","2841台開","110/08/06","台中銀",12,50,-38
"18863","2841台開","110/08/06","第一金-忠孝",20,0,20
"18864","2841台開","110/08/06","國票-中和",0,30,-30
"18865","2841台開","110/08/06","富邦-台北",20,0,20
"18866","2841台開","110/08/06","富邦-竹北",0,29,-29
"18867","2841台開","110/08/06","元大-林園",20,0,20
"18868","2841台開","110/08/06","日盛-樹林",0,26,-26
"18869","2841台開","110/08/06","日盛-信義",18,0,18
"18870","2841台開","110/08/06","富邦-板橋",0,25,-25
"18871","6207雷科","110/08/06","凱基-台北",167,49,118
"18872","6207雷科","110/08/06","群益金鼎-古亭",0,80,-80
"18873","6207雷科","110/08/06","摩根大通",185,102,83
"18874","6207雷科","110/08/06","康和-台中",0,56,-56
"18875","6207雷科","110/08/06","新光-台中",65,1,64
"18876","6207雷科","110/08/06","統一-板橋",8,59,-51
"18877","6207雷科","110/08/06","元大-鳳山",77,40,37
"18878","6207雷科","110/08/06","臺銀",0,50,-50
"18879","6207雷科","110/08/06","德信",30,0,30
"18880","6207雷科","110/08/06","日盛-忠孝",0,50,-50
"18881","6207雷科","110/08/06","新加坡商瑞銀",47,19,28
"18882","6207雷科","110/08/06","永豐金-虎尾",0,29,-29
"18883","6207雷科","110/08/06","凱基-三重",30,2,28
"18884","6207雷科","110/08/06","凱基-敦北",0,23,-23
"18885","6207雷科","110/08/06","凱基-三峽",33,10,23
"18886","6207雷科","110/08/06","華南永昌-世貿",0,22,-22
"18887","6207雷科","110/08/06","玉山-台大",25,3,22
"18888","6207雷科","110/08/06","兆豐-來福",5,25,-20
"18889","6207雷科","110/08/06","元大-板橋",15,0,15
"18890","6207雷科","110/08/06","群益金鼎-中壢",1,21,-20
"18891","6207雷科","110/08/06","元大-南京",13,0,13
"18892","6207雷科","110/08/06","宏遠-台南",0,16,-16
"18893","6207雷科","110/08/06","元富-大昌",12,0,12
"18894","6207雷科","110/08/06","合庫-桃園",0,15,-15
"18895","6207雷科","110/08/06","德信-和平",11,0,11
"18896","6207雷科","110/08/06","玉山-新莊",1,16,-15
"18897","6207雷科","110/08/06","元大-承德",12,1,11
"18898","6207雷科","110/08/06","群益金鼎-敦南",0,15,-15
"18899","6207雷科","110/08/06","台新-高雄",18,8,10
"18900","6207雷科","110/08/06","台新-左楠",2,15,-13
"18901","3679新至陞","110/08/06","國票-安和",10,0,10
"18902","3679新至陞","110/08/06","摩根大通",1,32,-31
"18903","3679新至陞","110/08/06","元大-上新莊",10,0,10
"18904","3679新至陞","110/08/06","凱基-台北",2,17,-15
"18905","3679新至陞","110/08/06","富邦-台北",9,0,9
"18906","3679新至陞","110/08/06","台灣摩根士丹利",0,11,-11
"18907","3679新至陞","110/08/06","元大-板橋",9,3,6
"18908","3679新至陞","110/08/06","瑞士信貸",0,11,-11
"18909","3679新至陞","110/08/06","康和-板橋",5,0,5
"18910","3679新至陞","110/08/06","兆豐-員林",0,10,-10
"18911","3679新至陞","110/08/06","國泰-松江",5,0,5
"18912","3679新至陞","110/08/06","元大-蘆洲",0,10,-10
"18913","3679新至陞","110/08/06","凱基-三峽",5,0,5
"18914","3679新至陞","110/08/06","美林",1,8,-7
"18915","3679新至陞","110/08/06","華南永昌-大安",5,0,5
"18916","3679新至陞","110/08/06","群益金鼎-桃園",0,7,-7
"18917","3679新至陞","110/08/06","台新-屏東",4,0,4
"18918","3679新至陞","110/08/06","玉山-台大",0,5,-5
"18919","3679新至陞","110/08/06","群益金鼎-敦南",4,0,4
"18920","3679新至陞","110/08/06","日盛-新竹",0,4,-4
"18921","3679新至陞","110/08/06","元大-天母",4,0,4
"18922","3679新至陞","110/08/06","土銀-和平",2,5,-3
"18923","3679新至陞","110/08/06","臺銀-高雄",3,0,3
"18924","3679新至陞","110/08/06","元富-松德",0,3,-3
"18925","3679新至陞","110/08/06","台中銀-員林",3,0,3
"18926","3679新至陞","110/08/06","光和-田中",0,3,-3
"18927","3679新至陞","110/08/06","北城證券",3,0,3
"18928","3679新至陞","110/08/06","群益金鼎-台南",0,3,-3
"18929","3679新至陞","110/08/06","元大-景美",3,0,3
"18930","3679新至陞","110/08/06","元大證券",1,4,-3
"18931","2727王品","110/08/06","摩根大通",65,18,47
"18932","2727王品","110/08/06","美商高盛",12,258,-246
"18933","2727王品","110/08/06","華南永昌",18,0,18
"18934","2727王品","110/08/06","安泰",2,60,-58
"18935","2727王品","110/08/06","凱基-台北",41,25,16
"18936","2727王品","110/08/06","台灣摩根士丹利",10,59,-49
"18937","2727王品","110/08/06","元大-中壢",20,4,16
"18938","2727王品","110/08/06","台新證券",17,60,-43
"18939","2727王品","110/08/06","台新-高雄",27,13,14
"18940","2727王品","110/08/06","元大-桃園",0,32,-32
"18941","2727王品","110/08/06","永豐金-苓雅",14,1,13
"18942","2727王品","110/08/06","凱基-基隆",0,30,-30
"18943","2727王品","110/08/06","永豐金-中盛",14,1,13
"18944","2727王品","110/08/06","群益金鼎-台中",0,22,-22
"18945","2727王品","110/08/06","第一金-安和",12,0,12
"18946","2727王品","110/08/06","凱基-三重",1,20,-19
"18947","2727王品","110/08/06","台新-台南",12,0,12
"18948","2727王品","110/08/06","元大證券",23,42,-19
"18949","2727王品","110/08/06","元大-八德",12,0,12
"18950","2727王品","110/08/06","瑞士信貸",0,18,-18
"18951","2727王品","110/08/06","新加坡商瑞銀",14,3,11
"18952","2727王品","110/08/06","港商野村",32,50,-18
"18953","2727王品","110/08/06","美林",11,1,10
"18954","2727王品","110/08/06","元大-羅東",2,17,-15
"18955","2727王品","110/08/06","台新-中壢",10,0,10
"18956","2727王品","110/08/06","元大-彰化",3,15,-12
"18957","2727王品","110/08/06","大昌-新竹",9,0,9
"18958","2727王品","110/08/06","土銀-高雄",1,12,-11
"18959","2727王品","110/08/06","元大-文心興安",11,2,9
"18960","2727王品","110/08/06","台新-新莊",0,11,-11
"18961","1570力肯","110/08/06","國票-北高雄",246,40,206
"18962","1570力肯","110/08/06","富邦-高雄",0,47,-47
"18963","1570力肯","110/08/06","統一-松江",43,0,43
"18964","1570力肯","110/08/06","凱基-台北",55,101,-46
"18965","1570力肯","110/08/06","日茂-南投",42,2,40
"18966","1570力肯","110/08/06","台新證券",25,60,-35
"18967","1570力肯","110/08/06","群益金鼎-三重",34,2,32
"18968","1570力肯","110/08/06","元富-三重",0,32,-32
"18969","1570力肯","110/08/06","華南永昌-麻豆",32,4,28
"18970","1570力肯","110/08/06","台中銀-員林",0,32,-32
"18971","1570力肯","110/08/06","永豐金-中和",29,2,27
"18972","1570力肯","110/08/06","國泰-板橋",1,33,-32
"18973","1570力肯","110/08/06","永豐金-大園",21,0,21
"18974","1570力肯","110/08/06","摩根大通",83,112,-29
"18975","1570力肯","110/08/06","統一-三重",25,5,20
"18976","1570力肯","110/08/06","玉山-新莊",0,27,-27
"18977","1570力肯","110/08/06","元富-新店",20,0,20
"18978","1570力肯","110/08/06","永豐金-虎尾",0,27,-27
"18979","1570力肯","110/08/06","大昌-桃園",21,1,20
"18980","1570力肯","110/08/06","玉山-左營",0,25,-25
"18981","1570力肯","110/08/06","康和-高雄",18,1,17
"18982","1570力肯","110/08/06","富邦-仁愛",10,32,-22
"18983","1570力肯","110/08/06","元富-潮州",16,0,16
"18984","1570力肯","110/08/06","中國信託-忠孝",0,21,-21
"18985","1570力肯","110/08/06","元富-松德",15,0,15
"18986","1570力肯","110/08/06","臺銀-鳳山",4,24,-20
"18987","1570力肯","110/08/06","凱基-嘉義",15,0,15
"18988","1570力肯","110/08/06","台新-屏東",1,21,-20
"18989","1570力肯","110/08/06","凱基-埔墘",15,0,15
"18990","1570力肯","110/08/06","群益金鼎-西松",0,20,-20
"18991","6180橘子","110/08/06","凱基-中山",138,3,135
"18992","6180橘子","110/08/06","新光",6,37,-31
"18993","6180橘子","110/08/06","富邦-高雄",18,0,18
"18994","6180橘子","110/08/06","永豐金-板新",0,24,-24
"18995","6180橘子","110/08/06","美商高盛",14,0,14
"18996","6180橘子","110/08/06","國票-九鼎",0,20,-20
"18997","6180橘子","110/08/06","富邦-板橋",14,0,14
"18998","6180橘子","110/08/06","群益金鼎-古亭",0,20,-20
"18999","6180橘子","110/08/06","台灣摩根士丹利",18,6,12
"19000","6180橘子","110/08/06","凱基-台北",2,22,-20
"19001","6180橘子","110/08/06","聯邦-雙和",11,0,11
"19002","6180橘子","110/08/06","富邦-員林",1,20,-19
"19003","6180橘子","110/08/06","宏遠-光隆",10,0,10
"19004","6180橘子","110/08/06","富邦-基隆",0,14,-14
"19005","6180橘子","110/08/06","元富-四維",10,0,10
"19006","6180橘子","110/08/06","元富-永和",1,12,-11
"19007","6180橘子","110/08/06","摩根大通",11,1,10
"19008","6180橘子","110/08/06","玉山-台南",0,11,-11
"19009","6180橘子","110/08/06","日盛-中壢",9,0,9
"19010","6180橘子","110/08/06","元大-彰化民生",0,11,-11
"19011","6180橘子","110/08/06","中國信託",9,0,9
"19012","6180橘子","110/08/06","群益金鼎-忠孝",0,10,-10
"19013","6180橘子","110/08/06","凱基-板橋",10,1,9
"19014","6180橘子","110/08/06","元大-龍潭",0,10,-10
"19015","6180橘子","110/08/06","日盛-景美",9,2,7
"19016","6180橘子","110/08/06","元大-金華",1,11,-10
"19017","6180橘子","110/08/06","瑞士信貸",7,0,7
"19018","6180橘子","110/08/06","第一金-新興",0,8,-8
"19019","6180橘子","110/08/06","元大-高雄",5,0,5
"19020","6180橘子","110/08/06","美林",0,7,-7
"19021","2390云辰","110/08/06","元大證券",203,14,189
"19022","2390云辰","110/08/06","永豐金-豐原",0,174,-174
"19023","2390云辰","110/08/06","美商高盛",114,7,107
"19024","2390云辰","110/08/06","第一金-華江",0,83,-83
"19025","2390云辰","110/08/06","華南永昌-麻豆",103,0,103
"19026","2390云辰","110/08/06","凱基-台北",126,197,-71
"19027","2390云辰","110/08/06","國票-安和",76,11,65
"19028","2390云辰","110/08/06","摩根大通",129,187,-58
"19029","2390云辰","110/08/06","港商野村",188,138,50
"19030","2390云辰","110/08/06","臺銀-金山",0,50,-50
"19031","2390云辰","110/08/06","元大-土城學府",102,56,46
"19032","2390云辰","110/08/06","聯邦商銀",13,50,-37
"19033","2390云辰","110/08/06","元富-板橋",41,0,41
"19034","2390云辰","110/08/06","元大-上新莊",10,43,-33
"19035","2390云辰","110/08/06","新加坡商瑞銀",47,7,40
"19036","2390云辰","110/08/06","兆豐-三民",0,30,-30
"19037","2390云辰","110/08/06","元大-台南",35,0,35
"19038","2390云辰","110/08/06","富邦-桃園",0,30,-30
"19039","2390云辰","110/08/06","凱基-林口",31,0,31
"19040","2390云辰","110/08/06","國泰-敦南",33,60,-27
"19041","2390云辰","110/08/06","凱基-台中",23,0,23
"19042","2390云辰","110/08/06","元大-天母",1,28,-27
"19043","2390云辰","110/08/06","台新-左楠",22,0,22
"19044","2390云辰","110/08/06","統一-高雄",0,25,-25
"19045","2390云辰","110/08/06","元大-文心",24,2,22
"19046","2390云辰","110/08/06","元大-太平",0,22,-22
"19047","2390云辰","110/08/06","統一-三重",22,1,21
"19048","2390云辰","110/08/06","彰銀-台中",36,56,-20
"19049","2390云辰","110/08/06","台灣企銀-嘉義",20,0,20
"19050","2390云辰","110/08/06","統一-屏東",1,21,-20
"19051","2867三商壽","110/08/05","摩根大通",376,0,376
"19052","2867三商壽","110/08/05","日盛-新莊",0,253,-253
"19053","2867三商壽","110/08/05","玉山-大里",307,1,306
"19054","2867三商壽","110/08/05","宏遠-高雄",0,156,-156
"19055","2867三商壽","110/08/05","元大-土城永寧",250,0,250
"19056","2867三商壽","110/08/05","康和-台中",0,135,-135
"19057","2867三商壽","110/08/05","新加坡商瑞銀",137,0,137
"19058","2867三商壽","110/08/05","台灣摩根士丹利",17,133,-116
"19059","2867三商壽","110/08/05","大展",120,0,120
"19060","2867三商壽","110/08/05","台灣企銀-竹北",0,100,-100
"19061","2867三商壽","110/08/05","凱基-長庚",120,0,120
"19062","2867三商壽","110/08/05","群益金鼎-桃園",1,100,-99
"19063","2867三商壽","110/08/05","元大-大同",104,2,102
"19064","2867三商壽","110/08/05","永豐金-高雄",10,101,-91
"19065","2867三商壽","110/08/05","凱基-台北",98,30,68
"19066","2867三商壽","110/08/05","元富",0,70,-70
"19067","2867三商壽","110/08/05","華南永昌-朴子",60,0,60
"19068","2867三商壽","110/08/05","富邦-花蓮",0,53,-53
"19069","2867三商壽","110/08/05","永豐金-市政",50,0,50
"19070","2867三商壽","110/08/05","日盛-台南",0,43,-43
"19071","2867三商壽","110/08/05","富邦-台南",49,1,48
"19072","2867三商壽","110/08/05","宏遠-台中",6,45,-39
"19073","2867三商壽","110/08/05","永豐金-永康",30,0,30
"19074","2867三商壽","110/08/05","瑞士信貸",0,32,-32
"19075","2867三商壽","110/08/05","富邦-竹東",30,1,29
"19076","2867三商壽","110/08/05","致和-高雄",0,31,-31
"19077","2867三商壽","110/08/05","兆豐-高雄",30,10,20
"19078","2867三商壽","110/08/05","國泰-台南",1,32,-31
"19079","2867三商壽","110/08/05","群益金鼎-西松",20,0,20
"19080","2867三商壽","110/08/05","元大-松山",1,31,-30
"19081","5521工信","110/08/05","兆豐-桃園",72,0,72
"19082","5521工信","110/08/05","美林",5,100,-95
"19083","5521工信","110/08/05","(牛牛牛)亞-鑫豐",24,0,24
"19084","5521工信","110/08/05","華南永昌-桃園",0,76,-76
"19085","5521工信","110/08/05","富邦-建國",22,0,22
"19086","5521工信","110/08/05","第一金-桃園",0,43,-43
"19087","5521工信","110/08/05","日盛-雙和",16,0,16
"19088","5521工信","110/08/05","凱基-台北",0,26,-26
"19089","5521工信","110/08/05","元大-鳳山",16,0,16
"19090","5521工信","110/08/05","台灣摩根士丹利",0,22,-22
"19091","5521工信","110/08/05","元富-城東",12,0,12
"19092","5521工信","110/08/05","富邦-竹北",0,20,-20
"19093","5521工信","110/08/05","元大-東蘆",12,0,12
"19094","5521工信","110/08/05","富邦-員林",0,20,-20
"19095","5521工信","110/08/05","元大-路竹",11,0,11
"19096","5521工信","110/08/05","元大-豐原",0,20,-20
"19097","5521工信","110/08/05","元大-基隆孝二",11,0,11
"19098","5521工信","110/08/05","港商野村",0,17,-17
"19099","5521工信","110/08/05","日盛-園區",10,0,10
"19100","5521工信","110/08/05","元大-大同",0,14,-14
"19101","5521工信","110/08/05","玉山-台大",10,0,10
"19102","5521工信","110/08/05","永豐金證券",0,14,-14
"19103","5521工信","110/08/05","華南永昌-公誠",10,0,10
"19104","5521工信","110/08/05","兆豐-高雄",0,10,-10
"19105","5521工信","110/08/05","元大-斗六",10,0,10
"19106","5521工信","110/08/05","群益金鼎-永和",0,10,-10
"19107","5521工信","110/08/05","元大-屏東",10,0,10
"19108","5521工信","110/08/05","永豐金-中和",0,10,-10
"19109","5521工信","110/08/05","國泰-台中",9,0,9
"19110","5521工信","110/08/05","第一金-高雄",0,7,-7
"19111","1471首利","110/08/05","國票-北高雄",50,0,50
"19112","1471首利","110/08/05","永豐金-板盛",0,129,-129
"19113","1471首利","110/08/05","台灣摩根士丹利",49,0,49
"19114","1471首利","110/08/05","元大-三重",0,50,-50
"19115","1471首利","110/08/05","元大-太平",30,0,30
"19116","1471首利","110/08/05","瑞士信貸",0,42,-42
"19117","1471首利","110/08/05","國泰-敦南",24,0,24
"19118","1471首利","110/08/05","美林",0,37,-37
"19119","1471首利","110/08/05","玉山-桃園",21,0,21
"19120","1471首利","110/08/05","元富-草屯",0,30,-30
"19121","1471首利","110/08/05","宏遠-光隆",20,0,20
"19122","1471首利","110/08/05","元富-民權",0,25,-25
"19123","1471首利","110/08/05","富邦-嘉義",20,1,19
"19124","1471首利","110/08/05","台中銀",0,23,-23
"19125","1471首利","110/08/05","元大-博愛",30,13,17
"19126","1471首利","110/08/05","元富-新興",0,20,-20
"19127","1471首利","110/08/05","台新-高雄",16,0,16
"19128","1471首利","110/08/05","摩根大通",17,33,-16
"19129","1471首利","110/08/05","日盛-文化",15,0,15
"19130","1471首利","110/08/05","日盛-鳳山",0,15,-15
"19131","1471首利","110/08/05","群益金鼎-新莊",15,0,15
"19132","1471首利","110/08/05","高橋",0,14,-14
"19133","1471首利","110/08/05","凱基-科園",13,0,13
"19134","1471首利","110/08/05","富邦-羅東",0,13,-13
"19135","1471首利","110/08/05","元大-高雄",12,0,12
"19136","1471首利","110/08/05","德信-中正",0,12,-12
"19137","1471首利","110/08/05","第一金-桃園",11,0,11
"19138","1471首利","110/08/05","群益金鼎-中港",5,17,-12
"19139","1471首利","110/08/05","台灣企銀-太平",10,0,10
"19140","1471首利","110/08/05","第一金-台南",0,10,-10
"19141","2883開發金","110/08/05","元富",5268,0,5268
"19142","2883開發金","110/08/05","新光-高雄",309,4909,-4600
"19143","2883開發金","110/08/05","瑞士信貸",4963,0,4963
"19144","2883開發金","110/08/05","富邦-竹東",594,3509,-2915
"19145","2883開發金","110/08/05","富邦證券",3800,0,3800
"19146","2883開發金","110/08/05","永豐金-南京",2,1915,-1913
"19147","2883開發金","110/08/05","台灣摩根士丹利",3886,1250,2636
"19148","2883開發金","110/08/05","第一金-自由",2,1894,-1892
"19149","2883開發金","110/08/05","元富-城東",2119,68,2051
"19150","2883開發金","110/08/05","康和-仁愛",0,1820,-1820
"19151","2883開發金","110/08/05","港商野村",2397,395,2002
"19152","2883開發金","110/08/05","兆豐-台中港",22,1522,-1500
"19153","2883開發金","110/08/05","第一金-忠孝",2020,88,1932
"19154","2883開發金","110/08/05","元大-大同",43,1010,-967
"19155","2883開發金","110/08/05","國泰證券",1682,3,1679
"19156","2883開發金","110/08/05","國票",53,645,-592
"19157","2883開發金","110/08/05","大和國泰",1666,0,1666
"19158","2883開發金","110/08/05","富邦-新竹",86,674,-588
"19159","2883開發金","110/08/05","永豐金-板橋",1507,15,1492
"19160","2883開發金","110/08/05","富邦-建國",39,560,-521
"19161","2883開發金","110/08/05","台灣企銀-民雄",1002,0,1002
"19162","2883開發金","110/08/05","日盛-台南",7,525,-518
"19163","2883開發金","110/08/05","美林",1263,577,686
"19164","2883開發金","110/08/05","凱基-基隆",1,510,-509
"19165","2883開發金","110/08/05","康和",640,0,640
"19166","2883開發金","110/08/05","元富-民權",0,500,-500
"19167","2883開發金","110/08/05","凱基-台北",1262,679,583
"19168","2883開發金","110/08/05","永豐金-松山",9,509,-500
"19169","2883開發金","110/08/05","福邦證券",560,50,510
"19170","2883開發金","110/08/05","華南永昌-中正",25,511,-486
"19171","6205詮欣","110/08/05","富邦-高雄",27,0,27
"19172","6205詮欣","110/08/05","臺銀-鳳山",0,31,-31
"19173","6205詮欣","110/08/05","摩根大通",27,1,26
"19174","6205詮欣","110/08/05","合庫-三重",0,15,-15
"19175","6205詮欣","110/08/05","永豐金-敦南",14,0,14
"19176","6205詮欣","110/08/05","臺銀-民權",11,21,-10
"19177","6205詮欣","110/08/05","凱基-台北",14,1,13
"19178","6205詮欣","110/08/05","日盛-中壢",0,10,-10
"19179","6205詮欣","110/08/05","瑞士信貸",14,5,9
"19180","6205詮欣","110/08/05","統一-松江",0,10,-10
"19181","6205詮欣","110/08/05","凱基-湖口",9,0,9
"19182","6205詮欣","110/08/05","台新-三民",0,9,-9
"19183","6205詮欣","110/08/05","德信-新營",4,0,4
"19184","6205詮欣","110/08/05","臺銀-新竹",1,9,-8
"19185","6205詮欣","110/08/05","元大-東蘆",5,1,4
"19186","6205詮欣","110/08/05","康和",0,5,-5
"19187","6205詮欣","110/08/05","臺銀-高雄",3,0,3
"19188","6205詮欣","110/08/05","元大-館前",0,4,-4
"19189","6205詮欣","110/08/05","富邦-左營",3,0,3
"19190","6205詮欣","110/08/05","宏遠-新化",0,3,-3
"19191","6205詮欣","110/08/05","日盛-花蓮",2,0,2
"19192","6205詮欣","110/08/05","新加坡商瑞銀",4,7,-3
"19193","6205詮欣","110/08/05","元富-三重",2,0,2
"19194","6205詮欣","110/08/05","致和-高雄",0,3,-3
"19195","6205詮欣","110/08/05","北城證券",2,0,2
"19196","6205詮欣","110/08/05","國票",0,3,-3
"19197","6205詮欣","110/08/05","國票-南港",2,0,2
"19198","6205詮欣","110/08/05","富邦-嘉義",0,3,-3
"19199","6205詮欣","110/08/05","台新證券",2,0,2
"19200","6205詮欣","110/08/05","統一-士林",0,2,-2
"19201","1540喬福","110/08/05","元富-中原",24,0,24
"19202","1540喬福","110/08/05","統一-新台中",0,21,-21
"19203","1540喬福","110/08/05","台新-台南",10,0,10
"19204","1540喬福","110/08/05","國泰-敦南",0,15,-15
"19205","1540喬福","110/08/05","台新-台中",10,0,10
"19206","1540喬福","110/08/05","華南永昌-南京",0,10,-10
"19207","1540喬福","110/08/05","瑞士信貸",6,0,6
"19208","1540喬福","110/08/05","元大-台中中港",0,10,-10
"19209","1540喬福","110/08/05","台中銀-豐原",6,0,6
"19210","1540喬福","110/08/05","德信-新營",0,8,-8
"19211","1540喬福","110/08/05","凱基-台北",6,0,6
"19212","1540喬福","110/08/05","新光-台南",0,4,-4
"19213","1540喬福","110/08/05","凱基-台南",5,0,5
"19214","1540喬福","110/08/05","元大-大天母",6,10,-4
"19215","1540喬福","110/08/05","元大-士林",5,0,5
"19216","1540喬福","110/08/05","康和-新竹",0,3,-3
"19217","1540喬福","110/08/05","美林",2,0,2
"19218","1540喬福","110/08/05","元大-龍潭",0,3,-3
"19219","1540喬福","110/08/05","群益金鼎-崇德",2,0,2
"19220","1540喬福","110/08/05","第一金-員林",0,1,-1
"19221","1540喬福","110/08/05","凱基-苗栗",2,0,2
"19222","1540喬福","110/08/05","第一金-豐原",0,1,-1
"19223","1540喬福","110/08/05","凱基-中壢",2,0,2
"19224","1540喬福","110/08/05","台新-高雄",0,1,-1
"19225","1540喬福","110/08/05","土銀-士林",1,0,1
"19226","1540喬福","110/08/05","元大-崇德",0,1,-1
"19227","1540喬福","110/08/05","群益金鼎-丹鳳",1,0,1
"19228","1540喬福","110/08/05","元大-中壢",0,1,-1
"19229","1540喬福","110/08/05","元大-文心",1,0,1
"19230","1540喬福","110/08/05","元大-斗信",0,1,-1
"19231","2888新光金","110/08/05","華南永昌-南京",3753,8,3745
"19232","2888新光金","110/08/05","第一金-高雄",0,5007,-5007
"19233","2888新光金","110/08/05","玉山-城中",2004,28,1976
"19234","2888新光金","110/08/05","美商高盛",12,1719,-1707
"19235","2888新光金","110/08/05","元大-西門",906,18,888
"19236","2888新光金","110/08/05","香港上海匯豐",0,1437,-1437
"19237","2888新光金","110/08/05","日盛-和美",557,3,554
"19238","2888新光金","110/08/05","凱基-台南",46,802,-756
"19239","2888新光金","110/08/05","康和-台中",460,49,411
"19240","2888新光金","110/08/05","美林",538,1140,-602
"19241","2888新光金","110/08/05","元富-緯城",302,1,301
"19242","2888新光金","110/08/05","凱基-台北",686,1280,-594
"19243","2888新光金","110/08/05","彰銀",301,3,298
"19244","2888新光金","110/08/05","法銀巴黎",0,562,-562
"19245","2888新光金","110/08/05","花旗環球",356,84,272
"19246","2888新光金","110/08/05","瑞士信貸",1350,1798,-448
"19247","2888新光金","110/08/05","永全-南崁",240,0,240
"19248","2888新光金","110/08/05","群益金鼎-丹鳳",4,303,-299
"19249","2888新光金","110/08/05","永豐金-彰化",232,20,212
"19250","2888新光金","110/08/05","安泰-大發",10,300,-290
"19251","2888新光金","110/08/05","統一-新台中",214,7,207
"19252","2888新光金","110/08/05","摩根大通",1159,1428,-269
"19253","2888新光金","110/08/05","中國信託-永康",203,0,203
"19254","2888新光金","110/08/05","兆豐-員林",4,260,-256
"19255","2888新光金","110/08/05","日盛-景美",200,0,200
"19256","2888新光金","110/08/05","日盛-大墩",0,250,-250
"19257","2888新光金","110/08/05","元大-東泰",207,22,185
"19258","2888新光金","110/08/05","元大-大里",31,243,-212
"19259","2888新光金","110/08/05","合庫證券",181,2,179
"19260","2888新光金","110/08/05","北城證券",25,230,-205
"19261","1340勝悅","110/08/05","富邦-仁愛",20,0,20
"19262","1340勝悅","110/08/05","中國信託",0,36,-36
"19263","1340勝悅","110/08/05","華南永昌-忠孝",12,0,12
"19264","1340勝悅","110/08/05","新光-新竹",0,18,-18
"19265","1340勝悅","110/08/05","華南永昌-楠梓",10,0,10
"19266","1340勝悅","110/08/05","永豐金-嘉義",0,15,-15
"19267","1340勝悅","110/08/05","統一-城中",17,11,6
"19268","1340勝悅","110/08/05","日茂",0,10,-10
"19269","1340勝悅","110/08/05","臺灣企銀-埔墘",5,0,5
"19270","1340勝悅","110/08/05","富邦-宜蘭",0,10,-10
"19271","1340勝悅","110/08/05","國票-台東",5,0,5
"19272","1340勝悅","110/08/05","元富-花蓮",0,9,-9
"19273","1340勝悅","110/08/05","新光-高雄",5,0,5
"19274","1340勝悅","110/08/05","永豐金-南京",0,7,-7
"19275","1340勝悅","110/08/05","國泰-台中",6,1,5
"19276","1340勝悅","110/08/05","統一",0,6,-6
"19277","1340勝悅","110/08/05","富邦-陽明",5,0,5
"19278","1340勝悅","110/08/05","合庫-西台中",0,3,-3
"19279","1340勝悅","110/08/05","日盛-板橋",4,0,4
"19280","1340勝悅","110/08/05","港商野村",0,3,-3
"19281","1340勝悅","110/08/05","港商法國興業",4,0,4
"19282","1340勝悅","110/08/05","兆豐-新竹",0,3,-3
"19283","1340勝悅","110/08/05","臺銀-高雄",3,0,3
"19284","1340勝悅","110/08/05","亞東-台中",0,2,-2
"19285","1340勝悅","110/08/05","元富-新店",3,0,3
"19286","1340勝悅","110/08/05","元大-歸仁",0,2,-2
"19287","1340勝悅","110/08/05","康和-屏東",3,0,3
"19288","1340勝悅","110/08/05","日盛-斗六",0,1,-1
"19289","1340勝悅","110/08/05","群益金鼎-民權",3,0,3
"19290","1340勝悅","110/08/05","日盛-中和",0,1,-1
"19291","6246臺龍","110/08/05","元大-林森",200,0,200
"19292","6246臺龍","110/08/05","統一",0,180,-180
"19293","6246臺龍","110/08/05","元大證券",92,1,91
"19294","6246臺龍","110/08/05","大慶-富順",0,114,-114
"19295","6246臺龍","110/08/05","凱基-大直",99,19,80
"19296","6246臺龍","110/08/05","台新-三民",0,77,-77
"19297","6246臺龍","110/08/05","元大-北港",51,0,51
"19298","6246臺龍","110/08/05","永興",0,48,-48
"19299","6246臺龍","110/08/05","統一-南京",50,0,50
"19300","6246臺龍","110/08/05","華南永昌-嘉義",1,26,-25
"19301","6246臺龍","110/08/05","台灣企銀",40,0,40
"19302","6246臺龍","110/08/05","宏遠-民生",0,20,-20
"19303","6246臺龍","110/08/05","永豐金-虎尾",23,0,23
"19304","6246臺龍","110/08/05","兆豐-大同",0,20,-20
"19305","6246臺龍","110/08/05","凱基-台北",27,5,22
"19306","6246臺龍","110/08/05","華南永昌-林口",0,20,-20
"19307","6246臺龍","110/08/05","元富-新竹",20,0,20
"19308","6246臺龍","110/08/05","元大-永春",0,20,-20
"19309","6246臺龍","110/08/05","康和-石牌",20,0,20
"19310","6246臺龍","110/08/05","元大-東泰",0,19,-19
"19311","6246臺龍","110/08/05","聯邦-大業",20,0,20
"19312","6246臺龍","110/08/05","德信-新營",0,18,-18
"19313","6246臺龍","110/08/05","凱基-彰化",18,0,18
"19314","6246臺龍","110/08/05","永豐金-松山",10,28,-18
"19315","6246臺龍","110/08/05","永豐金-復興",17,1,16
"19316","6246臺龍","110/08/05","台新-台中",4,20,-16
"19317","6246臺龍","110/08/05","新光-台中",17,2,15
"19318","6246臺龍","110/08/05","兆豐-竹北",5,20,-15
"19319","6246臺龍","110/08/05","元大-路竹",15,1,14
"19320","6246臺龍","110/08/05","兆豐-南京",1,14,-13
"19321","00715L期街口布蘭特正2","110/08/05","(牛牛牛)亞-鑫豐",1195,20,1175
"19322","00715L期街口布蘭特正2","110/08/05","元大證券",1735,21716,-19981
"19323","00715L期街口布蘭特正2","110/08/05","元大-萬華",930,0,930
"19324","00715L期街口布蘭特正2","110/08/05","凱基-台北",182,11686,-11504
"19325","00715L期街口布蘭特正2","110/08/05","元大-永康",810,9,801
"19326","00715L期街口布蘭特正2","110/08/05","元富",8,6852,-6844
"19327","00715L期街口布蘭特正2","110/08/05","富邦-彰化",760,0,760
"19328","00715L期街口布蘭特正2","110/08/05","台新證券",598,4522,-3924
"19329","00715L期街口布蘭特正2","110/08/05","國泰-敦南",830,155,675
"19330","00715L期街口布蘭特正2","110/08/05","凱基",0,3168,-3168
"19331","00715L期街口布蘭特正2","110/08/05","新光-台中",698,33,665
"19332","00715L期街口布蘭特正2","110/08/05","群益金鼎",0,1742,-1742
"19333","00715L期街口布蘭特正2","110/08/05","富邦-南屯",621,5,616
"19334","00715L期街口布蘭特正2","110/08/05","國票",22,1607,-1585
"19335","00715L期街口布蘭特正2","110/08/05","群益金鼎-士林",620,40,580
"19336","00715L期街口布蘭特正2","110/08/05","永豐金證券",91,1254,-1163
"19337","00715L期街口布蘭特正2","110/08/05","兆豐-嘉義",510,0,510
"19338","00715L期街口布蘭特正2","110/08/05","富邦證券",140,1095,-955
"19339","00715L期街口布蘭特正2","110/08/05","統一-新竹",508,9,499
"19340","00715L期街口布蘭特正2","110/08/05","元大-雙和",22,850,-828
"19341","00715L期街口布蘭特正2","110/08/05","國泰-板橋",521,24,497
"19342","00715L期街口布蘭特正2","110/08/05","國票-台中",25,805,-780
"19343","00715L期街口布蘭特正2","110/08/05","元大-中和",481,3,478
"19344","00715L期街口布蘭特正2","110/08/05","華南永昌-長虹",145,820,-675
"19345","00715L期街口布蘭特正2","110/08/05","元大-羅東",470,0,470
"19346","00715L期街口布蘭特正2","110/08/05","日盛-大墩",121,455,-334
"19347","00715L期街口布蘭特正2","110/08/05","群益金鼎-嘉義",483,20,463
"19348","00715L期街口布蘭特正2","110/08/05","華南永昌-斗六",52,380,-328
"19349","00715L期街口布蘭特正2","110/08/05","群益金鼎-中壢",476,30,446
"19350","00715L期街口布蘭特正2","110/08/05","康和",0,250,-250
"19351","8941關中","110/08/05","第一金-台南",1,0,1
"19352","8941關中","110/08/05","元富-宜蘭",0,2,-2
"19353","8941關中","110/08/05","康和-嘉義",1,0,1
"19354","8941關中","110/08/05","統一-南京",0,1,-1
"19355","8941關中","110/08/05","群益金鼎-延平",1,0,1
"19356","8941關中","110/08/05","合庫證券",0,0,0
"19357","8941關中","110/08/05","合庫證券",0,0,0
"19358","8941關中","110/08/05","(牛牛牛)亞-鑫豐",0,0,0
"19359","8941關中","110/08/05","(牛牛牛)亞-鑫豐",0,0,0
"19360","8941關中","110/08/05","富邦-北港",0,0,0
"19361","8941關中","110/08/05","富邦-北港",0,0,0
"19362","8941關中","110/08/05","",NA,NA,NA
"19363","8941關中","110/08/05","",NA,NA,NA
"19364","8941關中","110/08/05","",NA,NA,NA
"19365","8941關中","110/08/05","",NA,NA,NA
"19366","8941關中","110/08/05","",NA,NA,NA
"19367","8941關中","110/08/05","",NA,NA,NA
"19368","8941關中","110/08/05","",NA,NA,NA
"19369","8941關中","110/08/05","",NA,NA,NA
"19370","8941關中","110/08/05","",NA,NA,NA
"19371","8941關中","110/08/05","",NA,NA,NA
"19372","8941關中","110/08/05","",NA,NA,NA
"19373","8941關中","110/08/05","",NA,NA,NA
"19374","8941關中","110/08/05","",NA,NA,NA
"19375","8941關中","110/08/05","",NA,NA,NA
"19376","8941關中","110/08/05","",NA,NA,NA
"19377","8941關中","110/08/05","",NA,NA,NA
"19378","8941關中","110/08/05","",NA,NA,NA
"19379","8941關中","110/08/05","",NA,NA,NA
"19380","8941關中","110/08/05","",NA,NA,NA
"19381","8936國統","110/08/05","國票-敦北法人",100,0,100
"19382","8936國統","110/08/05","摩根大通",16,240,-224
"19383","8936國統","110/08/05","第一金-光復",50,0,50
"19384","8936國統","110/08/05","台新-松江",0,205,-205
"19385","8936國統","110/08/05","元大-蘆洲",45,0,45
"19386","8936國統","110/08/05","凱基-台北",1,177,-176
"19387","8936國統","110/08/05","富邦-建國",34,0,34
"19388","8936國統","110/08/05","新加坡商瑞銀",14,119,-105
"19389","8936國統","110/08/05","富邦-高雄",33,1,32
"19390","8936國統","110/08/05","凱基-市政",0,35,-35
"19391","8936國統","110/08/05","元大-敦南",30,0,30
"19392","8936國統","110/08/05","瑞士信貸",0,31,-31
"19393","8936國統","110/08/05","元大-博愛",23,0,23
"19394","8936國統","110/08/05","合庫-高雄",22,49,-27
"19395","8936國統","110/08/05","國票-長城",20,0,20
"19396","8936國統","110/08/05","港商野村",15,41,-26
"19397","8936國統","110/08/05","凱基-岡山",20,0,20
"19398","8936國統","110/08/05","富邦-陽明",1,24,-23
"19399","8936國統","110/08/05","凱基-台南",20,0,20
"19400","8936國統","110/08/05","合庫-新竹",0,22,-22
"19401","8936國統","110/08/05","富邦-中壢",21,2,19
"19402","8936國統","110/08/05","美商高盛",0,20,-20
"19403","8936國統","110/08/05","永豐金-忠孝",17,0,17
"19404","8936國統","110/08/05","元大-雙和",0,20,-20
"19405","8936國統","110/08/05","玉山-台中",16,0,16
"19406","8936國統","110/08/05","彰銀-七賢",0,18,-18
"19407","8936國統","110/08/05","兆豐-景美",15,0,15
"19408","8936國統","110/08/05","台灣企銀-台中",0,15,-15
"19409","8936國統","110/08/05","富邦-南屯",15,0,15
"19410","8936國統","110/08/05","兆豐-大同",0,15,-15
"19411","6226光鼎","110/08/05","國泰-敦南",190,90,100
"19412","6226光鼎","110/08/05","富邦-嘉義",590,964,-374
"19413","6226光鼎","110/08/05","凱基-台中",98,2,96
"19414","6226光鼎","110/08/05","日盛-員林",9,200,-191
"19415","6226光鼎","110/08/05","華南永昌-大安",95,13,82
"19416","6226光鼎","110/08/05","華南永昌",5,157,-152
"19417","6226光鼎","110/08/05","凱基-豐中",68,2,66
"19418","6226光鼎","110/08/05","國票-敦北法人",0,106,-106
"19419","6226光鼎","110/08/05","元富-西松",76,15,61
"19420","6226光鼎","110/08/05","元大-雙和",27,118,-91
"19421","6226光鼎","110/08/05","群益金鼎-土城",61,0,61
"19422","6226光鼎","110/08/05","華南永昌-南京",48,137,-89
"19423","6226光鼎","110/08/05","新光-高雄",64,4,60
"19424","6226光鼎","110/08/05","統一-新竹",37,124,-87
"19425","6226光鼎","110/08/05","宏遠-台中",67,9,58
"19426","6226光鼎","110/08/05","大昌",3,78,-75
"19427","6226光鼎","110/08/05","元大-東港",53,0,53
"19428","6226光鼎","110/08/05","凱基-台北",1,74,-73
"19429","6226光鼎","110/08/05","群益金鼎-敦南",60,10,50
"19430","6226光鼎","110/08/05","中國信託-文心",10,65,-55
"19431","6226光鼎","110/08/05","日盛-高雄",53,7,46
"19432","6226光鼎","110/08/05","台新-新莊",1,54,-53
"19433","6226光鼎","110/08/05","台新-新營",49,4,45
"19434","6226光鼎","110/08/05","台新-台中",84,135,-51
"19435","6226光鼎","110/08/05","玉山-雙和",42,2,40
"19436","6226光鼎","110/08/05","元大-嘉義",77,128,-51
"19437","6226光鼎","110/08/05","永豐金-高雄",44,8,36
"19438","6226光鼎","110/08/05","日盛-大墩",1,43,-42
"19439","6226光鼎","110/08/05","元富-花蓮",42,7,35
"19440","6226光鼎","110/08/05","日茂-埔里",0,41,-41
"19441","2363矽統","110/08/05","瑞士信貸",3345,0,3345
"19442","2363矽統","110/08/05","新加坡商瑞銀",1909,2622,-713
"19443","2363矽統","110/08/05","台灣摩根士丹利",2917,53,2864
"19444","2363矽統","110/08/05","統一-板橋",37,650,-613
"19445","2363矽統","110/08/05","摩根大通",5124,3944,1180
"19446","2363矽統","110/08/05","美商高盛",702,1245,-543
"19447","2363矽統","110/08/05","康和-台中",911,292,619
"19448","2363矽統","110/08/05","元富-西松",367,902,-535
"19449","2363矽統","110/08/05","永豐金證券",951,339,612
"19450","2363矽統","110/08/05","華南永昌-斗六",55,584,-529
"19451","2363矽統","110/08/05","群益金鼎-三民",571,106,465
"19452","2363矽統","110/08/05","美林",2987,3501,-514
"19453","2363矽統","110/08/05","國票-敦北法人",484,51,433
"19454","2363矽統","110/08/05","群益金鼎-館前",331,802,-471
"19455","2363矽統","110/08/05","陽信-石牌",624,204,420
"19456","2363矽統","110/08/05","永豐金-三重",138,571,-433
"19457","2363矽統","110/08/05","合庫證券",520,118,402
"19458","2363矽統","110/08/05","富邦-中壢",348,774,-426
"19459","2363矽統","110/08/05","元大-承德",385,70,315
"19460","2363矽統","110/08/05","北城證券",53,459,-406
"19461","2363矽統","110/08/05","新光",2366,2079,287
"19462","2363矽統","110/08/05","凱基-興隆",370,717,-347
"19463","2363矽統","110/08/05","元大證券",601,329,272
"19464","2363矽統","110/08/05","元大-屏南",132,464,-332
"19465","2363矽統","110/08/05","國泰-敦南",4481,4216,265
"19466","2363矽統","110/08/05","日盛-中和",208,531,-323
"19467","2363矽統","110/08/05","元大-台中",562,349,213
"19468","2363矽統","110/08/05","土銀",28,340,-312
"19469","2363矽統","110/08/05","富邦-台北",584,380,204
"19470","2363矽統","110/08/05","永豐金-嘉義",97,401,-304
"19471","8112至上","110/08/05","元大-竹科",858,64,794
"19472","8112至上","110/08/05","摩根大通",461,775,-314
"19473","8112至上","110/08/05","港商野村",937,361,576
"19474","8112至上","110/08/05","台灣摩根士丹利",16,272,-256
"19475","8112至上","110/08/05","康和",484,0,484
"19476","8112至上","110/08/05","高橋",3,183,-180
"19477","8112至上","110/08/05","新加坡商瑞銀",514,58,456
"19478","8112至上","110/08/05","合庫證券",19,162,-143
"19479","8112至上","110/08/05","元大-屏南",391,4,387
"19480","8112至上","110/08/05","元大-北屯",3,145,-142
"19481","8112至上","110/08/05","國票-長城",427,142,285
"19482","8112至上","110/08/05","元大-府城",14,154,-140
"19483","8112至上","110/08/05","元大-萬華",246,12,234
"19484","8112至上","110/08/05","群益金鼎-三重",0,138,-138
"19485","8112至上","110/08/05","台灣匯立證券",210,0,210
"19486","8112至上","110/08/05","富邦-台北",25,129,-104
"19487","8112至上","110/08/05","凱基-敦北",200,4,196
"19488","8112至上","110/08/05","元富-佳里",7,100,-93
"19489","8112至上","110/08/05","元大-北成功",205,17,188
"19490","8112至上","110/08/05","元富-台南",0,86,-86
"19491","8112至上","110/08/05","元大-高雄",146,14,132
"19492","8112至上","110/08/05","臺灣企銀-桃園",0,82,-82
"19493","8112至上","110/08/05","美商高盛",161,47,114
"19494","8112至上","110/08/05","玉山-嘉義",10,88,-78
"19495","8112至上","110/08/05","花旗環球",102,0,102
"19496","8112至上","110/08/05","凱基-復興",1,67,-66
"19497","8112至上","110/08/05","統一-士林",108,8,100
"19498","8112至上","110/08/05","富邦-中壢",23,89,-66
"19499","8112至上","110/08/05","新光",244,159,85
"19500","8112至上","110/08/05","元大-上新莊",1,67,-66
"19501","1570力肯","110/08/05","國票",352,0,352
"19502","1570力肯","110/08/05","國票-和平",7,402,-395
"19503","1570力肯","110/08/05","台新證券",211,87,124
"19504","1570力肯","110/08/05","摩根大通",46,335,-289
"19505","1570力肯","110/08/05","國泰-敦南",206,125,81
"19506","1570力肯","110/08/05","國票-北高雄",79,306,-227
"19507","1570力肯","110/08/05","聯邦商銀",75,0,75
"19508","1570力肯","110/08/05","統一",3,226,-223
"19509","1570力肯","110/08/05","元大-東泰",61,4,57
"19510","1570力肯","110/08/05","凱基-台北",184,366,-182
"19511","1570力肯","110/08/05","元大-桃興",113,66,47
"19512","1570力肯","110/08/05","統一-土城",89,161,-72
"19513","1570力肯","110/08/05","國泰-板橋",96,50,46
"19514","1570力肯","110/08/05","統一-屏東",0,64,-64
"19515","1570力肯","110/08/05","合庫-桃園",92,48,44
"19516","1570力肯","110/08/05","大昌-新店",9,61,-52
"19517","1570力肯","110/08/05","華南永昌-高雄",53,12,41
"19518","1570力肯","110/08/05","群益金鼎-忠孝",11,60,-49
"19519","1570力肯","110/08/05","國泰-高雄",50,14,36
"19520","1570力肯","110/08/05","臺銀-臺南",12,52,-40
"19521","1570力肯","110/08/05","國泰-台中",60,25,35
"19522","1570力肯","110/08/05","凱基-岡山",28,68,-40
"19523","1570力肯","110/08/05","富邦-仁愛",52,17,35
"19524","1570力肯","110/08/05","元大-蘆洲",8,44,-36
"19525","1570力肯","110/08/05","中國信託-忠孝",37,3,34
"19526","1570力肯","110/08/05","統一-仁愛",25,60,-35
"19527","1570力肯","110/08/05","元大-中壢",44,10,34
"19528","1570力肯","110/08/05","富邦-高雄",8,43,-35
"19529","1570力肯","110/08/05","日盛-新竹",30,0,30
"19530","1570力肯","110/08/05","大慶-蘆洲",110,142,-32
"19531","2929淘帝","110/08/05","國泰-松江",60,0,60
"19532","2929淘帝","110/08/05","摩根大通",4,87,-83
"19533","2929淘帝","110/08/05","美林",79,30,49
"19534","2929淘帝","110/08/05","日盛-南京",0,80,-80
"19535","2929淘帝","110/08/05","港商野村",87,45,42
"19536","2929淘帝","110/08/05","華南永昌-頭份",0,80,-80
"19537","2929淘帝","110/08/05","兆豐-忠孝",40,0,40
"19538","2929淘帝","110/08/05","日盛-雙和",2,57,-55
"19539","2929淘帝","110/08/05","新光-新竹",41,2,39
"19540","2929淘帝","110/08/05","台新-台中",2,33,-31
"19541","2929淘帝","110/08/05","元大-民生",31,0,31
"19542","2929淘帝","110/08/05","群益金鼎-新竹",0,30,-30
"19543","2929淘帝","110/08/05","元富-中港",28,0,28
"19544","2929淘帝","110/08/05","元大-北成功",0,30,-30
"19545","2929淘帝","110/08/05","凱基-台北",66,41,25
"19546","2929淘帝","110/08/05","元大-天母",5,30,-25
"19547","2929淘帝","110/08/05","富邦-新店",20,0,20
"19548","2929淘帝","110/08/05","元大-北港",0,25,-25
"19549","2929淘帝","110/08/05","康和-台中",15,0,15
"19550","2929淘帝","110/08/05","兆豐-彰化",0,24,-24
"19551","2929淘帝","110/08/05","華南永昌-古亭",15,0,15
"19552","2929淘帝","110/08/05","國泰-台中",1,25,-24
"19553","2929淘帝","110/08/05","日盛-景美",11,0,11
"19554","2929淘帝","110/08/05","華南永昌-大安",0,22,-22
"19555","2929淘帝","110/08/05","台新證券",11,0,11
"19556","2929淘帝","110/08/05","國泰-館前",10,31,-21
"19557","2929淘帝","110/08/05","凱基-三重",11,0,11
"19558","2929淘帝","110/08/05","元富-安南",0,20,-20
"19559","2929淘帝","110/08/05","華南永昌-竹北",11,0,11
"19560","2929淘帝","110/08/05","元大-屏南",10,30,-20
"19561","5410國眾","110/08/05","凱基-市政",40,0,40
"19562","5410國眾","110/08/05","元富-台南",0,27,-27
"19563","5410國眾","110/08/05","安泰",16,0,16
"19564","5410國眾","110/08/05","群益金鼎-內湖",0,16,-16
"19565","5410國眾","110/08/05","元大-善化",12,0,12
"19566","5410國眾","110/08/05","中農",0,15,-15
"19567","5410國眾","110/08/05","元富-同大",10,0,10
"19568","5410國眾","110/08/05","新光-台南",0,15,-15
"19569","5410國眾","110/08/05","中國信託-新竹",10,0,10
"19570","5410國眾","110/08/05","統一-平鎮",0,13,-13
"19571","5410國眾","110/08/05","元大-敦南",10,0,10
"19572","5410國眾","110/08/05","臺銀",0,11,-11
"19573","5410國眾","110/08/05","台灣企銀-太平",8,0,8
"19574","5410國眾","110/08/05","凱基-城中",0,10,-10
"19575","5410國眾","110/08/05","瑞士信貸",7,0,7
"19576","5410國眾","110/08/05","元大-崇德",0,10,-10
"19577","5410國眾","110/08/05","元富-烏日",6,0,6
"19578","5410國眾","110/08/05","元大-和平",0,10,-10
"19579","5410國眾","110/08/05","摩根大通",7,1,6
"19580","5410國眾","110/08/05","新光-台中",1,9,-8
"19581","5410國眾","110/08/05","元富-三重",11,6,5
"19582","5410國眾","110/08/05","富邦-板橋",0,6,-6
"19583","5410國眾","110/08/05","中國信託-忠孝",5,0,5
"19584","5410國眾","110/08/05","新百王",0,5,-5
"19585","5410國眾","110/08/05","凱基-復興",5,0,5
"19586","5410國眾","110/08/05","元大-大益",0,5,-5
"19587","5410國眾","110/08/05","永豐金-台中",4,0,4
"19588","5410國眾","110/08/05","永豐金-板橋",0,5,-5
"19589","5410國眾","110/08/05","元富-板橋",3,0,3
"19590","5410國眾","110/08/05","台新-中壢",0,4,-4
"19591","2841台開","110/08/05","日盛證券",201,0,201
"19592","2841台開","110/08/05","第一金-自由",0,272,-272
"19593","2841台開","110/08/05","永豐金-敦南",202,1,201
"19594","2841台開","110/08/05","瑞士信貸",0,149,-149
"19595","2841台開","110/08/05","元大-大天母",200,0,200
"19596","2841台開","110/08/05","玉山-新竹",0,131,-131
"19597","2841台開","110/08/05","永豐金-鳳山",100,0,100
"19598","2841台開","110/08/05","元富-板橋",0,125,-125
"19599","2841台開","110/08/05","台新-三民",100,1,99
"19600","2841台開","110/08/05","元大-台中中港",0,109,-109
"19601","2841台開","110/08/05","凱基-竹科",67,0,67
"19602","2841台開","110/08/05","兆豐-東門",0,100,-100
"19603","2841台開","110/08/05","國泰-敦南",44,5,39
"19604","2841台開","110/08/05","(牛牛牛)亞-鑫豐",0,97,-97
"19605","2841台開","110/08/05","元大-中壢",35,0,35
"19606","2841台開","110/08/05","元富-嘉義",0,50,-50
"19607","2841台開","110/08/05","國泰-忠孝",33,0,33
"19608","2841台開","110/08/05","新光",20,67,-47
"19609","2841台開","110/08/05","元大-新竹經國",30,0,30
"19610","2841台開","110/08/05","永豐金-豐原",3,50,-47
"19611","2841台開","110/08/05","日盛-內湖",24,0,24
"19612","2841台開","110/08/05","統一-士林",0,31,-31
"19613","2841台開","110/08/05","新光-高雄",21,0,21
"19614","2841台開","110/08/05","元大-龍潭",0,30,-30
"19615","2841台開","110/08/05","元大-林園",20,0,20
"19616","2841台開","110/08/05","新光-台南",0,27,-27
"19617","2841台開","110/08/05","元大-仁愛",20,0,20
"19618","2841台開","110/08/05","台新-台中",0,22,-22
"19619","2841台開","110/08/05","群益金鼎-崇德",18,0,18
"19620","2841台開","110/08/05","大昌-安康",0,20,-20
"19621","6207雷科","110/08/05","摩根大通",313,64,249
"19622","6207雷科","110/08/05","日盛-忠孝",2,93,-91
"19623","6207雷科","110/08/05","新加坡商瑞銀",141,6,135
"19624","6207雷科","110/08/05","凱基-復興",0,90,-90
"19625","6207雷科","110/08/05","凱基-台北",142,20,122
"19626","6207雷科","110/08/05","群益金鼎-敦南",0,67,-67
"19627","6207雷科","110/08/05","台新-高雄",111,0,111
"19628","6207雷科","110/08/05","元大-鳳山",11,73,-62
"19629","6207雷科","110/08/05","瑞士信貸",58,0,58
"19630","6207雷科","110/08/05","群益金鼎-東門",0,56,-56
"19631","6207雷科","110/08/05","美林",45,0,45
"19632","6207雷科","110/08/05","元富-同大",1,41,-40
"19633","6207雷科","110/08/05","凱基-板橋",46,1,45
"19634","6207雷科","110/08/05","群益金鼎-屏東",1,41,-40
"19635","6207雷科","110/08/05","美商高盛",37,0,37
"19636","6207雷科","110/08/05","群益金鼎-延平",0,40,-40
"19637","6207雷科","110/08/05","凱基-三多",30,0,30
"19638","6207雷科","110/08/05","群益金鼎-瑞豐",1,33,-32
"19639","6207雷科","110/08/05","永豐金-虎尾",29,0,29
"19640","6207雷科","110/08/05","日盛證券",0,30,-30
"19641","6207雷科","110/08/05","第一金-中山",21,1,20
"19642","6207雷科","110/08/05","臺銀",1,30,-29
"19643","6207雷科","110/08/05","華南永昌-林口",20,0,20
"19644","6207雷科","110/08/05","群益金鼎-古亭",0,26,-26
"19645","6207雷科","110/08/05","兆豐-公益",18,0,18
"19646","6207雷科","110/08/05","凱基-高雄",4,30,-26
"19647","6207雷科","110/08/05","港商野村",62,46,16
"19648","6207雷科","110/08/05","富邦-竹東",0,25,-25
"19649","6207雷科","110/08/05","華南永昌-南京",16,0,16
"19650","6207雷科","110/08/05","元大-台中中港",2,25,-23
"19651","3679新至陞","110/08/05","新光",13,0,13
"19652","3679新至陞","110/08/05","凱基-台北",1,13,-12
"19653","3679新至陞","110/08/05","華南永昌-麻豆",3,0,3
"19654","3679新至陞","110/08/05","台灣摩根士丹利",0,5,-5
"19655","3679新至陞","110/08/05","臺灣企銀-埔墘",2,0,2
"19656","3679新至陞","110/08/05","元大-成功",0,5,-5
"19657","3679新至陞","110/08/05","彰銀",2,0,2
"19658","3679新至陞","110/08/05","元大證券",0,3,-3
"19659","3679新至陞","110/08/05","永全-南崁",2,0,2
"19660","3679新至陞","110/08/05","新加坡商瑞銀",0,2,-2
"19661","3679新至陞","110/08/05","群益金鼎",2,0,2
"19662","3679新至陞","110/08/05","摩根大通",0,2,-2
"19663","3679新至陞","110/08/05","富邦-三重",2,0,2
"19664","3679新至陞","110/08/05","國泰-館前",0,2,-2
"19665","3679新至陞","110/08/05","永豐金-敦北",2,0,2
"19666","3679新至陞","110/08/05","凱基-東港",0,2,-2
"19667","3679新至陞","110/08/05","臺銀-新竹",1,0,1
"19668","3679新至陞","110/08/05","元大-竹北",0,2,-2
"19669","3679新至陞","110/08/05","第一金-新興",1,0,1
"19670","3679新至陞","110/08/05","日盛-嘉義",0,1,-1
"19671","3679新至陞","110/08/05","統一-宜蘭",1,0,1
"19672","3679新至陞","110/08/05","美商高盛",1,2,-1
"19673","3679新至陞","110/08/05","元富-同大",1,0,1
"19674","3679新至陞","110/08/05","港商野村",0,1,-1
"19675","3679新至陞","110/08/05","中國信託-新竹",1,0,1
"19676","3679新至陞","110/08/05","第一金-員林",0,1,-1
"19677","3679新至陞","110/08/05","兆豐-民生",1,0,1
"19678","3679新至陞","110/08/05","統一-中壢",0,1,-1
"19679","3679新至陞","110/08/05","國泰-新莊",1,0,1
"19680","3679新至陞","110/08/05","統一-新竹",0,1,-1
"19681","2727王品","110/08/05","港商野村",68,43,25
"19682","2727王品","110/08/05","元富-宜蘭",6,96,-90
"19683","2727王品","110/08/05","花旗環球",24,0,24
"19684","2727王品","110/08/05","凱基-市政",1,89,-88
"19685","2727王品","110/08/05","新光",42,19,23
"19686","2727王品","110/08/05","群益金鼎-宜蘭",4,89,-85
"19687","2727王品","110/08/05","永豐金-忠孝",21,0,21
"19688","2727王品","110/08/05","永豐金-大園",4,66,-62
"19689","2727王品","110/08/05","凱基-埔墘",15,0,15
"19690","2727王品","110/08/05","康和-澎湖",1,60,-59
"19691","2727王品","110/08/05","新光-桃園",17,3,14
"19692","2727王品","110/08/05","日盛-八德",1,33,-32
"19693","2727王品","110/08/05","日盛-忠孝",16,3,13
"19694","2727王品","110/08/05","元大-桃園",0,29,-29
"19695","2727王品","110/08/05","統一",28,15,13
"19696","2727王品","110/08/05","凱基-竹科",4,31,-27
"19697","2727王品","110/08/05","富邦-員林",15,2,13
"19698","2727王品","110/08/05","富邦-新店",2,29,-27
"19699","2727王品","110/08/05","永豐金-桃盛",16,3,13
"19700","2727王品","110/08/05","兆豐-小港",2,26,-24
"19701","2727王品","110/08/05","元富-屏東",12,0,12
"19702","2727王品","110/08/05","華南永昌",6,25,-19
"19703","2727王品","110/08/05","凱基-台北",52,40,12
"19704","2727王品","110/08/05","台灣摩根士丹利",15,32,-17
"19705","2727王品","110/08/05","永豐金-彰化",12,0,12
"19706","2727王品","110/08/05","凱基-天母",0,15,-15
"19707","2727王品","110/08/05","美林",11,0,11
"19708","2727王品","110/08/05","富邦證券",0,15,-15
"19709","2727王品","110/08/05","群益金鼎-崇德",10,0,10
"19710","2727王品","110/08/05","永豐金證券",1,13,-12
"19711","1570力肯","110/08/05","國票",352,0,352
"19712","1570力肯","110/08/05","國票-和平",7,402,-395
"19713","1570力肯","110/08/05","台新證券",211,87,124
"19714","1570力肯","110/08/05","摩根大通",46,335,-289
"19715","1570力肯","110/08/05","國泰-敦南",206,125,81
"19716","1570力肯","110/08/05","國票-北高雄",79,306,-227
"19717","1570力肯","110/08/05","聯邦商銀",75,0,75
"19718","1570力肯","110/08/05","統一",3,226,-223
"19719","1570力肯","110/08/05","元大-東泰",61,4,57
"19720","1570力肯","110/08/05","凱基-台北",184,366,-182
"19721","1570力肯","110/08/05","元大-桃興",113,66,47
"19722","1570力肯","110/08/05","統一-土城",89,161,-72
"19723","1570力肯","110/08/05","國泰-板橋",96,50,46
"19724","1570力肯","110/08/05","統一-屏東",0,64,-64
"19725","1570力肯","110/08/05","合庫-桃園",92,48,44
"19726","1570力肯","110/08/05","大昌-新店",9,61,-52
"19727","1570力肯","110/08/05","華南永昌-高雄",53,12,41
"19728","1570力肯","110/08/05","群益金鼎-忠孝",11,60,-49
"19729","1570力肯","110/08/05","國泰-高雄",50,14,36
"19730","1570力肯","110/08/05","臺銀-臺南",12,52,-40
"19731","1570力肯","110/08/05","國泰-台中",60,25,35
"19732","1570力肯","110/08/05","凱基-岡山",28,68,-40
"19733","1570力肯","110/08/05","富邦-仁愛",52,17,35
"19734","1570力肯","110/08/05","元大-蘆洲",8,44,-36
"19735","1570力肯","110/08/05","中國信託-忠孝",37,3,34
"19736","1570力肯","110/08/05","統一-仁愛",25,60,-35
"19737","1570力肯","110/08/05","元大-中壢",44,10,34
"19738","1570力肯","110/08/05","富邦-高雄",8,43,-35
"19739","1570力肯","110/08/05","日盛-新竹",30,0,30
"19740","1570力肯","110/08/05","大慶-蘆洲",110,142,-32
"19741","6180橘子","110/08/05","永豐金-松山",51,0,51
"19742","6180橘子","110/08/05","凱基-板橋",0,80,-80
"19743","6180橘子","110/08/05","新光",40,2,38
"19744","6180橘子","110/08/05","康和-高雄",0,40,-40
"19745","6180橘子","110/08/05","兆豐證券",33,0,33
"19746","6180橘子","110/08/05","合庫-鳳山",0,32,-32
"19747","6180橘子","110/08/05","中國信託-文心",15,0,15
"19748","6180橘子","110/08/05","日盛-頭份",1,24,-23
"19749","6180橘子","110/08/05","富邦-陽明",15,0,15
"19750","6180橘子","110/08/05","兆豐-新營",0,22,-22
"19751","6180橘子","110/08/05","元大-龍潭",11,0,11
"19752","6180橘子","110/08/05","元大-福營",0,20,-20
"19753","6180橘子","110/08/05","日盛-新竹",10,0,10
"19754","6180橘子","110/08/05","新加坡商瑞銀",0,19,-19
"19755","6180橘子","110/08/05","凱基-汐止",10,0,10
"19756","6180橘子","110/08/05","永豐金-新竹",0,17,-17
"19757","6180橘子","110/08/05","元大-中壢",10,1,9
"19758","6180橘子","110/08/05","第一金-新興",1,16,-15
"19759","6180橘子","110/08/05","元富-潮州",8,0,8
"19760","6180橘子","110/08/05","凱基-中壢",0,12,-12
"19761","6180橘子","110/08/05","大慶",7,0,7
"19762","6180橘子","110/08/05","光和",0,10,-10
"19763","6180橘子","110/08/05","台新證券",7,0,7
"19764","6180橘子","110/08/05","統一-中壢",0,9,-9
"19765","6180橘子","110/08/05","聯邦-雙和",7,0,7
"19766","6180橘子","110/08/05","富邦-基隆",0,9,-9
"19767","6180橘子","110/08/05","元大證券",7,0,7
"19768","6180橘子","110/08/05","台灣摩根士丹利",0,8,-8
"19769","6180橘子","110/08/05","國泰-新莊",6,0,6
"19770","6180橘子","110/08/05","康和-仁愛",0,8,-8
"19771","2390云辰","110/08/05","日盛證券",100,0,100
"19772","2390云辰","110/08/05","摩根大通",45,525,-480
"19773","2390云辰","110/08/05","兆豐-岡山",63,0,63
"19774","2390云辰","110/08/05","統一-新台中",62,177,-115
"19775","2390云辰","110/08/05","凱基-基隆",65,10,55
"19776","2390云辰","110/08/05","富邦-中壢",0,81,-81
"19777","2390云辰","110/08/05","凱基-中壢",52,3,49
"19778","2390云辰","110/08/05","元大-大甲",3,73,-70
"19779","2390云辰","110/08/05","台新-左楠",30,0,30
"19780","2390云辰","110/08/05","元大-樹林",16,53,-37
"19781","2390云辰","110/08/05","富邦-台北",33,6,27
"19782","2390云辰","110/08/05","元富-大裕",17,46,-29
"19783","2390云辰","110/08/05","統一-中壢",27,1,26
"19784","2390云辰","110/08/05","凱基-台中",1,30,-29
"19785","2390云辰","110/08/05","元大-和平",47,22,25
"19786","2390云辰","110/08/05","大慶-蘆洲",2,30,-28
"19787","2390云辰","110/08/05","統一-士林",26,2,24
"19788","2390云辰","110/08/05","元大-大統",3,31,-28
"19789","2390云辰","110/08/05","富邦-新營",23,0,23
"19790","2390云辰","110/08/05","臺銀-金山",1,27,-26
"19791","2390云辰","110/08/05","元大-景美",22,1,21
"19792","2390云辰","110/08/05","國泰-台中",0,23,-23
"19793","2390云辰","110/08/05","合庫-嘉義",20,0,20
"19794","2390云辰","110/08/05","富邦-岡山",0,23,-23
"19795","2390云辰","110/08/05","台灣企銀-嘉義",20,0,20
"19796","2390云辰","110/08/05","元大-土城學府",24,47,-23
"19797","2390云辰","110/08/05","日盛-板橋",21,1,20
"19798","2390云辰","110/08/05","台新-台中",28,50,-22
"19799","2390云辰","110/08/05","凱基-竹科",28,8,20
"19800","2390云辰","110/08/05","群益金鼎-鳳山",0,21,-21
"19801","1471首利","110/08/04","玉山-桃園",51,0,51
"19802","1471首利","110/08/04","國票-九鼎",0,60,-60
"19803","1471首利","110/08/04","華南永昌-潮州",50,1,49
"19804","1471首利","110/08/04","日盛-士林",0,20,-20
"19805","1471首利","110/08/04","瑞士信貸",33,3,30
"19806","1471首利","110/08/04","元大-博愛",4,24,-20
"19807","1471首利","110/08/04","兆豐-板橋",20,0,20
"19808","1471首利","110/08/04","群益金鼎-台中",1,20,-19
"19809","1471首利","110/08/04","兆豐-台中港",30,13,17
"19810","1471首利","110/08/04","國泰-高雄",0,16,-16
"19811","1471首利","110/08/04","富邦-基隆",16,0,16
"19812","1471首利","110/08/04","元大-台南",1,17,-16
"19813","1471首利","110/08/04","美林",15,0,15
"19814","1471首利","110/08/04","國泰-敦南",18,32,-14
"19815","1471首利","110/08/04","永豐金-員林",12,0,12
"19816","1471首利","110/08/04","新光",21,33,-12
"19817","1471首利","110/08/04","第一金-台南",11,0,11
"19818","1471首利","110/08/04","凱基-土城",0,12,-12
"19819","1471首利","110/08/04","德信-中正",12,1,11
"19820","1471首利","110/08/04","合庫-高雄",0,10,-10
"19821","1471首利","110/08/04","合庫-台中",10,0,10
"19822","1471首利","110/08/04","元富-宜蘭",0,10,-10
"19823","1471首利","110/08/04","國泰-新莊",10,0,10
"19824","1471首利","110/08/04","國泰-板橋",0,10,-10
"19825","1471首利","110/08/04","富邦-桃園",10,0,10
"19826","1471首利","110/08/04","群益金鼎-鳳山",0,10,-10
"19827","1471首利","110/08/04","元大-苗栗",10,0,10
"19828","1471首利","110/08/04","元大-東泰",0,10,-10
"19829","1471首利","110/08/04","玉山-左營",10,1,9
"19830","1471首利","110/08/04","元大-林園",0,10,-10
"19831","2883開發金","110/08/04","國泰證券",3650,0,3650
"19832","2883開發金","110/08/04","康和-仁愛",3,1737,-1734
"19833","2883開發金","110/08/04","統一",2763,29,2734
"19834","2883開發金","110/08/04","新加坡商瑞銀",356,1472,-1116
"19835","2883開發金","110/08/04","凱基-台北",2041,429,1612
"19836","2883開發金","110/08/04","豐農",5,1025,-1020
"19837","2883開發金","110/08/04","元富-城東",1602,26,1576
"19838","2883開發金","110/08/04","富邦-建國",271,1004,-733
"19839","2883開發金","110/08/04","元富",1190,0,1190
"19840","2883開發金","110/08/04","元大-北成功",6,608,-602
"19841","2883開發金","110/08/04","美商高盛",1033,355,678
"19842","2883開發金","110/08/04","台灣摩根士丹利",573,1019,-446
"19843","2883開發金","110/08/04","康和",661,6,655
"19844","2883開發金","110/08/04","台新-中壢",2,431,-429
"19845","2883開發金","110/08/04","國票-長城",504,8,496
"19846","2883開發金","110/08/04","凱基-和平",1,400,-399
"19847","2883開發金","110/08/04","元大-大灣",734,304,430
"19848","2883開發金","110/08/04","元大-蘆洲",7,370,-363
"19849","2883開發金","110/08/04","永豐金-板橋",500,100,400
"19850","2883開發金","110/08/04","元大-民生",10,370,-360
"19851","2883開發金","110/08/04","永豐金-台南",389,11,378
"19852","2883開發金","110/08/04","中國信託-中壢",1,321,-320
"19853","2883開發金","110/08/04","日盛證券",608,255,353
"19854","2883開發金","110/08/04","港商法國興業",0,291,-291
"19855","2883開發金","110/08/04","花旗環球",343,0,343
"19856","2883開發金","110/08/04","日盛-北高雄",20,309,-289
"19857","2883開發金","110/08/04","瑞士信貸",462,121,341
"19858","2883開發金","110/08/04","日盛-花蓮",11,250,-239
"19859","2883開發金","110/08/04","凱基",320,0,320
"19860","2883開發金","110/08/04","群益金鼎-東湖",10,243,-233
"19861","6205詮欣","110/08/04","摩根大通",18,0,18
"19862","6205詮欣","110/08/04","永豐金-敦南",16,36,-20
"19863","6205詮欣","110/08/04","臺銀-民權",5,0,5
"19864","6205詮欣","110/08/04","瑞士信貸",6,10,-4
"19865","6205詮欣","110/08/04","凱基-台北",4,0,4
"19866","6205詮欣","110/08/04","致和-高雄",0,4,-4
"19867","6205詮欣","110/08/04","元富-潮州",3,0,3
"19868","6205詮欣","110/08/04","群益金鼎-台南",0,3,-3
"19869","6205詮欣","110/08/04","台中銀",3,0,3
"19870","6205詮欣","110/08/04","元大-路竹",0,3,-3
"19871","6205詮欣","110/08/04","華南永昌",3,0,3
"19872","6205詮欣","110/08/04","元大-北成功",0,3,-3
"19873","6205詮欣","110/08/04","美林",2,0,2
"19874","6205詮欣","110/08/04","凱基-東門",0,2,-2
"19875","6205詮欣","110/08/04","元富-新店",2,0,2
"19876","6205詮欣","110/08/04","凱基-基隆",0,2,-2
"19877","6205詮欣","110/08/04","元大-羅東",2,0,2
"19878","6205詮欣","110/08/04","凱基-大安",0,2,-2
"19879","6205詮欣","110/08/04","元大-館前",2,0,2
"19880","6205詮欣","110/08/04","元大-土城學府",0,2,-2
"19881","6205詮欣","110/08/04","元大-楊梅",2,0,2
"19882","6205詮欣","110/08/04","元大-民生",0,2,-2
"19883","6205詮欣","110/08/04","元大-信義",2,0,2
"19884","6205詮欣","110/08/04","日盛-八德",0,1,-1
"19885","6205詮欣","110/08/04","永豐金-埔里",2,0,2
"19886","6205詮欣","110/08/04","宏遠-高雄",0,1,-1
"19887","6205詮欣","110/08/04","日盛-板橋",1,0,1
"19888","6205詮欣","110/08/04","新加坡商瑞銀",0,1,-1
"19889","6205詮欣","110/08/04","日盛-木柵",1,0,1
"19890","6205詮欣","110/08/04","第一金-華江",0,1,-1
"19891","1540喬福","110/08/04","元富-中原",58,0,58
"19892","1540喬福","110/08/04","元大-大天母",0,60,-60
"19893","1540喬福","110/08/04","(牛牛牛)亞-鑫豐",26,0,26
"19894","1540喬福","110/08/04","統一-新台中",0,18,-18
"19895","1540喬福","110/08/04","國泰-敦南",10,0,10
"19896","1540喬福","110/08/04","群益金鼎-士林",0,7,-7
"19897","1540喬福","110/08/04","富邦-南屯",10,0,10
"19898","1540喬福","110/08/04","兆豐-北高雄",0,6,-6
"19899","1540喬福","110/08/04","兆豐-鹿港",3,0,3
"19900","1540喬福","110/08/04","凱基-市政",0,5,-5
"19901","1540喬福","110/08/04","元大-土城永寧",2,0,2
"19902","1540喬福","110/08/04","亞東-高雄",0,4,-4
"19903","1540喬福","110/08/04","第一金-桃園",1,0,1
"19904","1540喬福","110/08/04","永豐金-大園",0,4,-4
"19905","1540喬福","110/08/04","兆豐-高雄",1,0,1
"19906","1540喬福","110/08/04","永豐金-豐原",0,2,-2
"19907","1540喬福","110/08/04","元大-苑裡",1,0,1
"19908","1540喬福","110/08/04","兆豐-三重",0,1,-1
"19909","1540喬福","110/08/04","臺銀-鳳山",0,0,0
"19910","1540喬福","110/08/04","致和-南京",0,1,-1
"19911","1540喬福","110/08/04","大慶",0,0,0
"19912","1540喬福","110/08/04","國票-嘉義",0,1,-1
"19913","1540喬福","110/08/04","元富-信義",0,0,0
"19914","1540喬福","110/08/04","兆豐-嘉義",0,1,-1
"19915","1540喬福","110/08/04","德信-新營",1,1,0
"19916","1540喬福","110/08/04","華南永昌-林口",0,1,-1
"19917","1540喬福","110/08/04","國票-台中",1,1,0
"19918","1540喬福","110/08/04","華南永昌-潮州",0,1,-1
"19919","1540喬福","110/08/04","康和-板橋",0,0,0
"19920","1540喬福","110/08/04","國票-台中",1,1,0
"19921","2888新光金","110/08/04","港商麥格理",2490,0,2490
"19922","2888新光金","110/08/04","永豐金-苓雅",2,1543,-1541
"19923","2888新光金","110/08/04","凱基-八德",1000,1,999
"19924","2888新光金","110/08/04","美商高盛",196,1441,-1245
"19925","2888新光金","110/08/04","新光",1122,247,875
"19926","2888新光金","110/08/04","台灣摩根士丹利",724,1776,-1052
"19927","2888新光金","110/08/04","國票-桃園",1200,402,798
"19928","2888新光金","110/08/04","摩根大通",616,1665,-1049
"19929","2888新光金","110/08/04","華南永昌-南京",759,36,723
"19930","2888新光金","110/08/04","康和-台中",0,680,-680
"19931","2888新光金","110/08/04","港商法國興業",568,0,568
"19932","2888新光金","110/08/04","群益金鼎-高雄",0,533,-533
"19933","2888新光金","110/08/04","花旗環球",559,0,559
"19934","2888新光金","110/08/04","亞東",34,531,-497
"19935","2888新光金","110/08/04","法銀巴黎",801,242,559
"19936","2888新光金","110/08/04","群益金鼎-土城",25,464,-439
"19937","2888新光金","110/08/04","凱基-台北",889,355,534
"19938","2888新光金","110/08/04","國票-北高雄",2,425,-423
"19939","2888新光金","110/08/04","統一-松江",500,0,500
"19940","2888新光金","110/08/04","凱基-台南",0,400,-400
"19941","2888新光金","110/08/04","華南永昌-長虹",345,0,345
"19942","2888新光金","110/08/04","新加坡商瑞銀",128,486,-358
"19943","2888新光金","110/08/04","美林",884,551,333
"19944","2888新光金","110/08/04","統一-屏東",0,344,-344
"19945","2888新光金","110/08/04","群益金鼎-中壢",301,3,298
"19946","2888新光金","110/08/04","統一-宜蘭",8,326,-318
"19947","2888新光金","110/08/04","群益金鼎",278,0,278
"19948","2888新光金","110/08/04","群益金鼎-萬華",0,284,-284
"19949","2888新光金","110/08/04","元大-北投",249,5,244
"19950","2888新光金","110/08/04","富邦-仁愛",10,276,-266
"19951","1340勝悅","110/08/04","第一金-新竹",10,0,10
"19952","1340勝悅","110/08/04","中國信託",0,23,-23
"19953","1340勝悅","110/08/04","凱基-虎尾",8,0,8
"19954","1340勝悅","110/08/04","永豐金-潮州",0,19,-19
"19955","1340勝悅","110/08/04","凱基-台中",6,0,6
"19956","1340勝悅","110/08/04","元富-花蓮",0,10,-10
"19957","1340勝悅","110/08/04","臺灣企銀-埔墘",5,0,5
"19958","1340勝悅","110/08/04","中國信託-永康",0,10,-10
"19959","1340勝悅","110/08/04","第一金",5,0,5
"19960","1340勝悅","110/08/04","第一金-中壢",0,7,-7
"19961","1340勝悅","110/08/04","凱基-八德",5,0,5
"19962","1340勝悅","110/08/04","高橋-中壢",0,5,-5
"19963","1340勝悅","110/08/04","永豐金-博愛",5,0,5
"19964","1340勝悅","110/08/04","富邦-新店",0,5,-5
"19965","1340勝悅","110/08/04","摩根大通",6,2,4
"19966","1340勝悅","110/08/04","台新-高雄",0,4,-4
"19967","1340勝悅","110/08/04","凱基-三重",4,0,4
"19968","1340勝悅","110/08/04","新光",0,4,-4
"19969","1340勝悅","110/08/04","統一-城中",7,4,3
"19970","1340勝悅","110/08/04","兆豐-松德",0,2,-2
"19971","1340勝悅","110/08/04","群益金鼎-館前",3,0,3
"19972","1340勝悅","110/08/04","凱基-嘉義",0,2,-2
"19973","1340勝悅","110/08/04","元大-南京",3,0,3
"19974","1340勝悅","110/08/04","富邦-宜蘭",0,2,-2
"19975","1340勝悅","110/08/04","瑞士信貸",2,0,2
"19976","1340勝悅","110/08/04","永豐金-永康",0,2,-2
"19977","1340勝悅","110/08/04","大慶-富順",2,0,2
"19978","1340勝悅","110/08/04","永豐金-嘉義",0,2,-2
"19979","1340勝悅","110/08/04","國泰-高雄",2,0,2
"19980","1340勝悅","110/08/04","玉山證券",0,1,-1
"19981","6246臺龍","110/08/04","統一",347,0,347
"19982","6246臺龍","110/08/04","大慶-富順",0,168,-168
"19983","6246臺龍","110/08/04","元大-西螺",30,0,30
"19984","6246臺龍","110/08/04","元大-善化",1,91,-90
"19985","6246臺龍","110/08/04","華南永昌-嘉義",26,0,26
"19986","6246臺龍","110/08/04","新光-高雄",2,75,-73
"19987","6246臺龍","110/08/04","中國信託-永康",31,9,22
"19988","6246臺龍","110/08/04","元大-永春",1,40,-39
"19989","6246臺龍","110/08/04","元大-西屯",25,4,21
"19990","6246臺龍","110/08/04","元大-基隆孝二",1,35,-34
"19991","6246臺龍","110/08/04","凱基-竹科",23,3,20
"19992","6246臺龍","110/08/04","凱基-復興",10,43,-33
"19993","6246臺龍","110/08/04","凱基-大直",19,0,19
"19994","6246臺龍","110/08/04","國泰-台中",3,34,-31
"19995","6246臺龍","110/08/04","第一金-台南",18,0,18
"19996","6246臺龍","110/08/04","統一-屏東",0,26,-26
"19997","6246臺龍","110/08/04","萬泰",15,0,15
"19998","6246臺龍","110/08/04","台灣企銀-台南",1,25,-24
"19999","6246臺龍","110/08/04","華南永昌-台中",15,0,15
"20000","6246臺龍","110/08/04","宏遠-民生",0,22,-22
"20001","6246臺龍","110/08/04","凱基-板橋",13,0,13
"20002","6246臺龍","110/08/04","兆豐-來福",0,20,-20
"20003","6246臺龍","110/08/04","宏遠-高雄",12,0,12
"20004","6246臺龍","110/08/04","永豐金-市政",0,17,-17
"20005","6246臺龍","110/08/04","新光-台中",11,0,11
"20006","6246臺龍","110/08/04","台新-台中",5,21,-16
"20007","6246臺龍","110/08/04","玉山證券",13,2,11
"20008","6246臺龍","110/08/04","華南永昌-彰化",1,16,-15
"20009","6246臺龍","110/08/04","永豐金-高雄",12,1,11
"20010","6246臺龍","110/08/04","元大-博愛",13,28,-15
"20011","00715L期街口布蘭特正2","110/08/04","宏遠-高雄",1056,0,1056
"20012","00715L期街口布蘭特正2","110/08/04","元大證券",1348,7345,-5997
"20013","00715L期街口布蘭特正2","110/08/04","凱基-豐中",576,0,576
"20014","00715L期街口布蘭特正2","110/08/04","凱基-台北",37,5749,-5712
"20015","00715L期街口布蘭特正2","110/08/04","富邦-基隆",467,0,467
"20016","00715L期街口布蘭特正2","110/08/04","富邦證券",253,2075,-1822
"20017","00715L期街口布蘭特正2","110/08/04","國泰-板橋",470,30,440
"20018","00715L期街口布蘭特正2","110/08/04","第一金-頭份",11,400,-389
"20019","00715L期街口布蘭特正2","110/08/04","統一-高雄",358,3,355
"20020","00715L期街口布蘭特正2","110/08/04","富邦-永和",4,376,-372
"20021","00715L期街口布蘭特正2","110/08/04","中國信託-永康",219,1,218
"20022","00715L期街口布蘭特正2","110/08/04","永豐金-新店",0,370,-370
"20023","00715L期街口布蘭特正2","110/08/04","元大-中和",217,0,217
"20024","00715L期街口布蘭特正2","110/08/04","元富",53,412,-359
"20025","00715L期街口布蘭特正2","110/08/04","日盛-花蓮",201,1,200
"20026","00715L期街口布蘭特正2","110/08/04","臺銀-民權",15,366,-351
"20027","00715L期街口布蘭特正2","110/08/04","元大-中壢",201,12,189
"20028","00715L期街口布蘭特正2","110/08/04","兆豐-新莊",0,300,-300
"20029","00715L期街口布蘭特正2","110/08/04","宏遠-桃園",190,2,188
"20030","00715L期街口布蘭特正2","110/08/04","大昌-新店",17,300,-283
"20031","00715L期街口布蘭特正2","110/08/04","玉山-大里",182,0,182
"20032","00715L期街口布蘭特正2","110/08/04","元大-西螺",87,303,-216
"20033","00715L期街口布蘭特正2","110/08/04","新光",258,80,178
"20034","00715L期街口布蘭特正2","110/08/04","華南永昌-高雄",7,206,-199
"20035","00715L期街口布蘭特正2","110/08/04","元大-花蓮",178,0,178
"20036","00715L期街口布蘭特正2","110/08/04","國票-台中",8,200,-192
"20037","00715L期街口布蘭特正2","110/08/04","新光-台中",242,68,174
"20038","00715L期街口布蘭特正2","110/08/04","群益金鼎-鳳山",12,174,-162
"20039","00715L期街口布蘭特正2","110/08/04","(牛牛牛)亞-網路",166,0,166
"20040","00715L期街口布蘭特正2","110/08/04","國泰-台南",8,150,-142
"20041","8941關中","110/08/04","宏遠-館前",3,0,3
"20042","8941關中","110/08/04","元大-基隆",0,3,-3
"20043","8941關中","110/08/04","日盛-和美",1,0,1
"20044","8941關中","110/08/04","富邦-員林",0,2,-2
"20045","8941關中","110/08/04","元大-華山",1,0,1
"20046","8941關中","110/08/04","新光-高雄",0,0,0
"20047","8941關中","110/08/04","新光-高雄",0,0,0
"20048","8941關中","110/08/04","國泰-高雄",0,0,0
"20049","8941關中","110/08/04","國泰-高雄",0,0,0
"20050","8941關中","110/08/04","富邦-建國",0,0,0
"20051","8941關中","110/08/04","富邦-建國",0,0,0
"20052","8941關中","110/08/04","元大-西屯",0,0,0
"20053","8941關中","110/08/04","元大-西屯",0,0,0
"20054","8941關中","110/08/04","元大-花蓮",0,0,0
"20055","8941關中","110/08/04","元大-花蓮",0,0,0
"20056","8941關中","110/08/04","永豐金-萬盛",0,0,0
"20057","8941關中","110/08/04","永豐金-萬盛",0,0,0
"20058","8941關中","110/08/04","",NA,NA,NA
"20059","8941關中","110/08/04","",NA,NA,NA
"20060","8941關中","110/08/04","",NA,NA,NA
"20061","8941關中","110/08/04","",NA,NA,NA
"20062","8941關中","110/08/04","",NA,NA,NA
"20063","8941關中","110/08/04","",NA,NA,NA
"20064","8941關中","110/08/04","",NA,NA,NA
"20065","8941關中","110/08/04","",NA,NA,NA
"20066","8941關中","110/08/04","",NA,NA,NA
"20067","8941關中","110/08/04","",NA,NA,NA
"20068","8941關中","110/08/04","",NA,NA,NA
"20069","8941關中","110/08/04","",NA,NA,NA
"20070","8941關中","110/08/04","",NA,NA,NA
"20071","8936國統","110/08/04","第一金-光復",120,0,120
"20072","8936國統","110/08/04","兆豐-彰化",0,61,-61
"20073","8936國統","110/08/04","美林",99,3,96
"20074","8936國統","110/08/04","凱基-台北",4,56,-52
"20075","8936國統","110/08/04","華南永昌-楠梓",70,5,65
"20076","8936國統","110/08/04","凱基-內埔",0,50,-50
"20077","8936國統","110/08/04","永豐金-高雄",62,0,62
"20078","8936國統","110/08/04","台灣摩根士丹利",0,42,-42
"20079","8936國統","110/08/04","國票-台南",60,0,60
"20080","8936國統","110/08/04","永豐金-苓雅",1,40,-39
"20081","8936國統","110/08/04","永豐金-台中",30,0,30
"20082","8936國統","110/08/04","群益金鼎-內湖",0,30,-30
"20083","8936國統","110/08/04","第一金-豐原",20,0,20
"20084","8936國統","110/08/04","國票-北高雄",0,20,-20
"20085","8936國統","110/08/04","玉山-高雄",13,0,13
"20086","8936國統","110/08/04","宏遠-館前",0,19,-19
"20087","8936國統","110/08/04","元大-莒光",11,0,11
"20088","8936國統","110/08/04","美商高盛",3,22,-19
"20089","8936國統","110/08/04","亞東-高雄",10,0,10
"20090","8936國統","110/08/04","元大-大里德芳",4,21,-17
"20091","8936國統","110/08/04","第一金-路竹",10,0,10
"20092","8936國統","110/08/04","第一金-高雄",0,14,-14
"20093","8936國統","110/08/04","新光-台中",8,1,7
"20094","8936國統","110/08/04","日盛-竹北",0,12,-12
"20095","8936國統","110/08/04","統一-三多",5,0,5
"20096","8936國統","110/08/04","亞東",0,12,-12
"20097","8936國統","110/08/04","國票-內壢",5,0,5
"20098","8936國統","110/08/04","摩根大通",32,44,-12
"20099","8936國統","110/08/04","新光",10,5,5
"20100","8936國統","110/08/04","第一金-嘉義",0,10,-10
"20101","6226光鼎","110/08/04","富邦-嘉義",1247,573,674
"20102","6226光鼎","110/08/04","國泰-敦南",89,234,-145
"20103","6226光鼎","110/08/04","永豐金-桃盛",205,0,205
"20104","6226光鼎","110/08/04","日盛-嘉義",0,131,-131
"20105","6226光鼎","110/08/04","台新-左楠",120,1,119
"20106","6226光鼎","110/08/04","群益金鼎-東大",35,150,-115
"20107","6226光鼎","110/08/04","群益金鼎-敦南",127,8,119
"20108","6226光鼎","110/08/04","台中銀-員林",0,101,-101
"20109","6226光鼎","110/08/04","台灣摩根士丹利",135,55,80
"20110","6226光鼎","110/08/04","玉山-雙和",2,97,-95
"20111","6226光鼎","110/08/04","華南永昌-南京",89,14,75
"20112","6226光鼎","110/08/04","台新證券",76,167,-91
"20113","6226光鼎","110/08/04","台新-台中",101,32,69
"20114","6226光鼎","110/08/04","華南永昌-頭份",7,86,-79
"20115","6226光鼎","110/08/04","宏遠-台中",60,3,57
"20116","6226光鼎","110/08/04","高橋",0,70,-70
"20117","6226光鼎","110/08/04","大昌",79,26,53
"20118","6226光鼎","110/08/04","國泰-館前",18,62,-44
"20119","6226光鼎","110/08/04","台新-新莊",54,2,52
"20120","6226光鼎","110/08/04","凱基-永和",0,43,-43
"20121","6226光鼎","110/08/04","群益金鼎-三民",51,3,48
"20122","6226光鼎","110/08/04","日盛-景美",0,38,-38
"20123","6226光鼎","110/08/04","中國信託-永康",62,18,44
"20124","6226光鼎","110/08/04","華南永昌-高雄",9,47,-38
"20125","6226光鼎","110/08/04","國票-台中",45,2,43
"20126","6226光鼎","110/08/04","元大-太平",6,44,-38
"20127","6226光鼎","110/08/04","統一-士林",44,4,40
"20128","6226光鼎","110/08/04","元大-北投",0,37,-37
"20129","6226光鼎","110/08/04","統一-仁愛",51,14,37
"20130","6226光鼎","110/08/04","元大-板橋",0,37,-37
"20131","2363矽統","110/08/04","富邦-中壢",628,138,490
"20132","2363矽統","110/08/04","新加坡商瑞銀",986,2541,-1555
"20133","2363矽統","110/08/04","凱基-台北",7207,6730,477
"20134","2363矽統","110/08/04","台灣摩根士丹利",158,1373,-1215
"20135","2363矽統","110/08/04","元大-承德",449,81,368
"20136","2363矽統","110/08/04","摩根大通",2506,3701,-1195
"20137","2363矽統","110/08/04","群益金鼎-高雄",438,99,339
"20138","2363矽統","110/08/04","日盛-文化",121,1226,-1105
"20139","2363矽統","110/08/04","元富-嘉義",383,57,326
"20140","2363矽統","110/08/04","美林",2013,2637,-624
"20141","2363矽統","110/08/04","元大-旗山",446,147,299
"20142","2363矽統","110/08/04","凱基-新莊",44,445,-401
"20143","2363矽統","110/08/04","大慶-台中",304,14,290
"20144","2363矽統","110/08/04","台新-松江",60,449,-389
"20145","2363矽統","110/08/04","國票-博愛",425,150,275
"20146","2363矽統","110/08/04","統一-士林",649,1031,-382
"20147","2363矽統","110/08/04","台新-台南",494,230,264
"20148","2363矽統","110/08/04","新光",1494,1876,-382
"20149","2363矽統","110/08/04","群益金鼎-內湖",393,135,258
"20150","2363矽統","110/08/04","華南永昌",691,1068,-377
"20151","2363矽統","110/08/04","群益金鼎-桃園",295,68,227
"20152","2363矽統","110/08/04","富邦-彰化",122,486,-364
"20153","2363矽統","110/08/04","永豐金-羅東",397,182,215
"20154","2363矽統","110/08/04","凱基-永和",198,478,-280
"20155","2363矽統","110/08/04","元大-永春",347,142,205
"20156","2363矽統","110/08/04","富邦-嘉義",1358,1619,-261
"20157","2363矽統","110/08/04","台新-屏東",466,275,191
"20158","2363矽統","110/08/04","元大-前金",175,419,-244
"20159","2363矽統","110/08/04","元大-萬華",286,96,190
"20160","2363矽統","110/08/04","凱基-大直",681,912,-231
"20161","8112至上","110/08/04","台灣匯立證券",138,0,138
"20162","8112至上","110/08/04","日盛-高雄",1,355,-354
"20163","8112至上","110/08/04","元富-新興",94,8,86
"20164","8112至上","110/08/04","玉山-士林",0,150,-150
"20165","8112至上","110/08/04","合庫-西台中",55,7,48
"20166","8112至上","110/08/04","台灣摩根士丹利",20,143,-123
"20167","8112至上","110/08/04","摩根大通",145,97,48
"20168","8112至上","110/08/04","元富-大昌",0,120,-120
"20169","8112至上","110/08/04","台新證券",48,1,47
"20170","8112至上","110/08/04","華南永昌-林口",1,90,-89
"20171","8112至上","110/08/04","第一金-高雄",40,0,40
"20172","8112至上","110/08/04","元大-北屯",1,70,-69
"20173","8112至上","110/08/04","群益金鼎-大安",40,0,40
"20174","8112至上","110/08/04","凱基-台北",140,206,-66
"20175","8112至上","110/08/04","日盛-新竹",60,26,34
"20176","8112至上","110/08/04","新加坡商瑞銀",16,68,-52
"20177","8112至上","110/08/04","美林",69,38,31
"20178","8112至上","110/08/04","第一金-自由",0,50,-50
"20179","8112至上","110/08/04","凱基-虎尾",30,0,30
"20180","8112至上","110/08/04","康和-內湖",0,34,-34
"20181","8112至上","110/08/04","永豐金-台南",32,2,30
"20182","8112至上","110/08/04","聯邦商銀",0,34,-34
"20183","8112至上","110/08/04","港商野村",30,1,29
"20184","8112至上","110/08/04","臺銀-鳳山",0,28,-28
"20185","8112至上","110/08/04","國泰-館前",29,5,24
"20186","8112至上","110/08/04","兆豐-公益",0,28,-28
"20187","8112至上","110/08/04","元富-佳里",21,0,21
"20188","8112至上","110/08/04","元大-崇德",0,21,-21
"20189","8112至上","110/08/04","日進",20,0,20
"20190","8112至上","110/08/04","元大-土城永寧",0,20,-20
"20191","1570力肯","110/08/04","摩根大通",330,27,303
"20192","1570力肯","110/08/04","元大-板橋",0,86,-86
"20193","1570力肯","110/08/04","統一",224,0,224
"20194","1570力肯","110/08/04","群益金鼎-忠孝",0,80,-80
"20195","1570力肯","110/08/04","富邦-台中",84,1,83
"20196","1570力肯","110/08/04","元富-緯城",0,51,-51
"20197","1570力肯","110/08/04","統一-土城",287,222,65
"20198","1570力肯","110/08/04","國票-和平",0,51,-51
"20199","1570力肯","110/08/04","群益金鼎-中壢",60,0,60
"20200","1570力肯","110/08/04","日盛-二林",0,43,-43
"20201","1570力肯","110/08/04","富邦-高雄",69,10,59
"20202","1570力肯","110/08/04","國泰-板橋",0,43,-43
"20203","1570力肯","110/08/04","統一-屏東",61,4,57
"20204","1570力肯","110/08/04","元大-新莊",1,44,-43
"20205","1570力肯","110/08/04","凱基-岡山",53,1,52
"20206","1570力肯","110/08/04","凱基-嘉義",0,42,-42
"20207","1570力肯","110/08/04","新光-台中",43,12,31
"20208","1570力肯","110/08/04","華南永昌-鳳山",2,42,-40
"20209","1570力肯","110/08/04","台中銀-員林",30,1,29
"20210","1570力肯","110/08/04","凱基-三峽",0,37,-37
"20211","1570力肯","110/08/04","元富-三重",37,12,25
"20212","1570力肯","110/08/04","國票-中正",0,36,-36
"20213","1570力肯","110/08/04","統一-新台中",30,6,24
"20214","1570力肯","110/08/04","高橋",0,30,-30
"20215","1570力肯","110/08/04","致和-府前",25,1,24
"20216","1570力肯","110/08/04","日盛-高雄",0,29,-29
"20217","1570力肯","110/08/04","凱基-中港",22,0,22
"20218","1570力肯","110/08/04","(牛牛牛)亞-鑫豐",6,29,-23
"20219","1570力肯","110/08/04","宏遠證券",20,0,20
"20220","1570力肯","110/08/04","元富-松德",1,22,-21
"20221","2929淘帝","110/08/04","兆豐-忠孝",23,0,23
"20222","2929淘帝","110/08/04","美林",12,107,-95
"20223","2929淘帝","110/08/04","華南永昌-長虹",21,0,21
"20224","2929淘帝","110/08/04","兆豐-新莊",0,94,-94
"20225","2929淘帝","110/08/04","兆豐-桃園",20,0,20
"20226","2929淘帝","110/08/04","富邦-北港",0,30,-30
"20227","2929淘帝","110/08/04","新加坡商瑞銀",34,18,16
"20228","2929淘帝","110/08/04","永興-水湳",0,20,-20
"20229","2929淘帝","110/08/04","凱基-林口",15,0,15
"20230","2929淘帝","110/08/04","兆豐-復興",0,20,-20
"20231","2929淘帝","110/08/04","富邦-竹東",17,5,12
"20232","2929淘帝","110/08/04","國泰-高雄",1,15,-14
"20233","2929淘帝","110/08/04","台新-建北",11,0,11
"20234","2929淘帝","110/08/04","元大-上新莊",0,14,-14
"20235","2929淘帝","110/08/04","凱基-豐中",11,0,11
"20236","2929淘帝","110/08/04","凱基-敦北",0,11,-11
"20237","2929淘帝","110/08/04","統一-汐止",10,0,10
"20238","2929淘帝","110/08/04","臺銀-金山",0,10,-10
"20239","2929淘帝","110/08/04","新百王",10,0,10
"20240","2929淘帝","110/08/04","日盛-斗六",0,10,-10
"20241","2929淘帝","110/08/04","凱基-台北",16,6,10
"20242","2929淘帝","110/08/04","港商野村",16,26,-10
"20243","2929淘帝","110/08/04","華南永昌-苗栗",10,0,10
"20244","2929淘帝","110/08/04","第一金-自由",0,10,-10
"20245","2929淘帝","110/08/04","富邦-板橋",10,0,10
"20246","2929淘帝","110/08/04","玉山-台南",0,10,-10
"20247","2929淘帝","110/08/04","元大-路竹",10,0,10
"20248","2929淘帝","110/08/04","凱基-五股",0,10,-10
"20249","2929淘帝","110/08/04","元大-東蘆",10,0,10
"20250","2929淘帝","110/08/04","華南永昌-楠梓",0,10,-10
"20251","5410國眾","110/08/04","永豐金-內湖",100,1,99
"20252","5410國眾","110/08/04","群益金鼎-內湖",0,46,-46
"20253","5410國眾","110/08/04","永豐金-板新",36,0,36
"20254","5410國眾","110/08/04","新光",2,36,-34
"20255","5410國眾","110/08/04","兆豐-城中",27,0,27
"20256","5410國眾","110/08/04","元富-嘉義",0,20,-20
"20257","5410國眾","110/08/04","凱基-竹北",10,0,10
"20258","5410國眾","110/08/04","元大-博愛",0,20,-20
"20259","5410國眾","110/08/04","新光-高雄",9,0,9
"20260","5410國眾","110/08/04","永豐金-彰化",0,20,-20
"20261","5410國眾","110/08/04","兆豐-北高雄",8,0,8
"20262","5410國眾","110/08/04","元大-斗信",0,11,-11
"20263","5410國眾","110/08/04","元富-三重",9,3,6
"20264","5410國眾","110/08/04","統一-平鎮",0,10,-10
"20265","5410國眾","110/08/04","台新證券",7,1,6
"20266","5410國眾","110/08/04","元大-台北",0,10,-10
"20267","5410國眾","110/08/04","元大-中壢",10,4,6
"20268","5410國眾","110/08/04","元大-大灣",0,10,-10
"20269","5410國眾","110/08/04","北城證券",5,0,5
"20270","5410國眾","110/08/04","元大-前金",0,9,-9
"20271","5410國眾","110/08/04","國票-和平",5,0,5
"20272","5410國眾","110/08/04","致和證券",0,8,-8
"20273","5410國眾","110/08/04","元大-新盛",5,0,5
"20274","5410國眾","110/08/04","元大-崇德",0,7,-7
"20275","5410國眾","110/08/04","永豐金-中盛",5,0,5
"20276","5410國眾","110/08/04","臺銀-鳳山",0,6,-6
"20277","5410國眾","110/08/04","永豐金-桃園",5,0,5
"20278","5410國眾","110/08/04","玉山-左營",0,6,-6
"20279","5410國眾","110/08/04","凱基-台北",7,3,4
"20280","5410國眾","110/08/04","富邦-台中",0,6,-6
"20281","2841台開","110/08/04","永豐金-敦南",1166,0,1166
"20282","2841台開","110/08/04","統一-三重",0,943,-943
"20283","2841台開","110/08/04","永豐金-鳳山",206,50,156
"20284","2841台開","110/08/04","群益金鼎-東大",0,250,-250
"20285","2841台開","110/08/04","凱基-文心",136,0,136
"20286","2841台開","110/08/04","元富-城東",5,250,-245
"20287","2841台開","110/08/04","國泰-敦南",135,7,128
"20288","2841台開","110/08/04","元大-大灣",16,200,-184
"20289","2841台開","110/08/04","新光",109,4,105
"20290","2841台開","110/08/04","元大-新店中正",0,128,-128
"20291","2841台開","110/08/04","日盛-信義",102,0,102
"20292","2841台開","110/08/04","兆豐-麻豆",0,120,-120
"20293","2841台開","110/08/04","兆豐-東門",100,0,100
"20294","2841台開","110/08/04","土銀",0,100,-100
"20295","2841台開","110/08/04","台新-三民",100,0,100
"20296","2841台開","110/08/04","臺銀",0,100,-100
"20297","2841台開","110/08/04","群益金鼎-海山",100,0,100
"20298","2841台開","110/08/04","富邦-新店",4,90,-86
"20299","2841台開","110/08/04","國泰-板橋",106,13,93
"20300","2841台開","110/08/04","合庫-台中",23,104,-81
"20301","2841台開","110/08/04","永豐金-彰化",100,10,90
"20302","2841台開","110/08/04","統一-高雄",0,77,-77
"20303","2841台開","110/08/04","永豐金-萬盛",101,16,85
"20304","2841台開","110/08/04","群益金鼎-屏東",0,75,-75
"20305","2841台開","110/08/04","國票-天祥",80,0,80
"20306","2841台開","110/08/04","中國信託-高雄",2,70,-68
"20307","2841台開","110/08/04","群益金鼎-崇德",84,5,79
"20308","2841台開","110/08/04","凱基-三峽",0,61,-61
"20309","2841台開","110/08/04","群益金鼎-館前",82,3,79
"20310","2841台開","110/08/04","統一-彰化",0,60,-60
"20311","6207雷科","110/08/04","凱基-羅東",80,1,79
"20312","6207雷科","110/08/04","凱基-板橋",1,213,-212
"20313","6207雷科","110/08/04","元大-鳳山",76,2,74
"20314","6207雷科","110/08/04","摩根大通",105,209,-104
"20315","6207雷科","110/08/04","凱基-台南",37,1,36
"20316","6207雷科","110/08/04","凱基-台北",22,122,-100
"20317","6207雷科","110/08/04","富邦-竹東",35,0,35
"20318","6207雷科","110/08/04","華南永昌",12,100,-88
"20319","6207雷科","110/08/04","群益金鼎-東門",31,4,27
"20320","6207雷科","110/08/04","統一-高雄",3,74,-71
"20321","6207雷科","110/08/04","新光-高雄",30,4,26
"20322","6207雷科","110/08/04","群益金鼎-大興",0,70,-70
"20323","6207雷科","110/08/04","大慶-蘆洲",21,0,21
"20324","6207雷科","110/08/04","日盛-忠孝",0,62,-62
"20325","6207雷科","110/08/04","瑞士信貸",20,0,20
"20326","6207雷科","110/08/04","富邦-台中",0,50,-50
"20327","6207雷科","110/08/04","元大-羅東",20,0,20
"20328","6207雷科","110/08/04","永豐金-內湖",0,50,-50
"20329","6207雷科","110/08/04","群益金鼎-南京",20,2,18
"20330","6207雷科","110/08/04","美林",3,47,-44
"20331","6207雷科","110/08/04","元大-汐止",16,0,16
"20332","6207雷科","110/08/04","元富-大昌",0,40,-40
"20333","6207雷科","110/08/04","兆豐-來福",15,0,15
"20334","6207雷科","110/08/04","兆豐-景美",2,40,-38
"20335","6207雷科","110/08/04","國泰-敦南",21,6,15
"20336","6207雷科","110/08/04","新加坡商瑞銀",12,49,-37
"20337","6207雷科","110/08/04","永豐金-台中",15,0,15
"20338","6207雷科","110/08/04","群益金鼎-古亭",2,24,-22
"20339","6207雷科","110/08/04","元大-沙鹿",14,0,14
"20340","6207雷科","110/08/04","華南永昌-虎尾",0,21,-21
"20341","3679新至陞","110/08/04","凱基-台北",27,0,27
"20342","3679新至陞","110/08/04","香港上海匯豐",0,12,-12
"20343","3679新至陞","110/08/04","港商法國興業",20,0,20
"20344","3679新至陞","110/08/04","台灣摩根士丹利",0,10,-10
"20345","3679新至陞","110/08/04","新加坡商瑞銀",13,0,13
"20346","3679新至陞","110/08/04","港商野村",0,8,-8
"20347","3679新至陞","110/08/04","(牛牛牛)亞-網路",11,0,11
"20348","3679新至陞","110/08/04","玉山證券",2,9,-7
"20349","3679新至陞","110/08/04","摩根大通",9,4,5
"20350","3679新至陞","110/08/04","富邦-陽明",0,6,-6
"20351","3679新至陞","110/08/04","國泰-敦南",6,2,4
"20352","3679新至陞","110/08/04","統一",0,5,-5
"20353","3679新至陞","110/08/04","土銀-和平",3,0,3
"20354","3679新至陞","110/08/04","華南永昌-淡水",0,5,-5
"20355","3679新至陞","110/08/04","台中銀-員林",3,0,3
"20356","3679新至陞","110/08/04","元大-成功",0,5,-5
"20357","3679新至陞","110/08/04","元大-永春",3,0,3
"20358","3679新至陞","110/08/04","群益金鼎-內湖",0,4,-4
"20359","3679新至陞","110/08/04","國票-台東",2,0,2
"20360","3679新至陞","110/08/04","國泰-館前",0,3,-3
"20361","3679新至陞","110/08/04","富邦-新店",2,0,2
"20362","3679新至陞","110/08/04","凱基-板橋",0,3,-3
"20363","3679新至陞","110/08/04","富邦-三重",2,0,2
"20364","3679新至陞","110/08/04","凱基-三峽",0,3,-3
"20365","3679新至陞","110/08/04","元大-板橋三民",2,0,2
"20366","3679新至陞","110/08/04","凱基-中山",0,3,-3
"20367","3679新至陞","110/08/04","永豐金-敦南",2,0,2
"20368","3679新至陞","110/08/04","元大-承德",1,4,-3
"20369","3679新至陞","110/08/04","大昌-新店",1,0,1
"20370","3679新至陞","110/08/04","元大-大同",0,3,-3
"20371","2727王品","110/08/04","元富",46,0,46
"20372","2727王品","110/08/04","台灣摩根士丹利",20,277,-257
"20373","2727王品","110/08/04","台新證券",36,7,29
"20374","2727王品","110/08/04","群益金鼎-三民",2,104,-102
"20375","2727王品","110/08/04","國泰-敦南",42,13,29
"20376","2727王品","110/08/04","第一金",1,102,-101
"20377","2727王品","110/08/04","國泰-台中",19,2,17
"20378","2727王品","110/08/04","元大-東蘆",1,45,-44
"20379","2727王品","110/08/04","華南永昌-虎尾",13,0,13
"20380","2727王品","110/08/04","新光-台中",10,43,-33
"20381","2727王品","110/08/04","凱基-五股",11,0,11
"20382","2727王品","110/08/04","新光-桃園",9,42,-33
"20383","2727王品","110/08/04","國泰-館前",16,6,10
"20384","2727王品","110/08/04","凱基-興隆",1,21,-20
"20385","2727王品","110/08/04","凱基-基隆",10,0,10
"20386","2727王品","110/08/04","元大-龍潭",6,23,-17
"20387","2727王品","110/08/04","凱基-南崁",10,0,10
"20388","2727王品","110/08/04","日盛-士林",0,15,-15
"20389","2727王品","110/08/04","富邦-台北",12,2,10
"20390","2727王品","110/08/04","凱基-天母",0,15,-15
"20391","2727王品","110/08/04","新光",34,25,9
"20392","2727王品","110/08/04","日盛-台中",4,15,-11
"20393","2727王品","110/08/04","玉山證券",12,3,9
"20394","2727王品","110/08/04","永豐金-信義",1,12,-11
"20395","2727王品","110/08/04","國泰-高雄",10,2,8
"20396","2727王品","110/08/04","新加坡商瑞銀",2,12,-10
"20397","2727王品","110/08/04","群益金鼎-宜蘭",8,0,8
"20398","2727王品","110/08/04","元大-豐原",0,10,-10
"20399","2727王品","110/08/04","國泰-台南",7,0,7
"20400","2727王品","110/08/04","元大-樹林",1,11,-10
"20401","1570力肯","110/08/04","摩根大通",330,27,303
"20402","1570力肯","110/08/04","元大-板橋",0,86,-86
"20403","1570力肯","110/08/04","統一",224,0,224
"20404","1570力肯","110/08/04","群益金鼎-忠孝",0,80,-80
"20405","1570力肯","110/08/04","富邦-台中",84,1,83
"20406","1570力肯","110/08/04","元富-緯城",0,51,-51
"20407","1570力肯","110/08/04","統一-土城",287,222,65
"20408","1570力肯","110/08/04","國票-和平",0,51,-51
"20409","1570力肯","110/08/04","群益金鼎-中壢",60,0,60
"20410","1570力肯","110/08/04","日盛-二林",0,43,-43
"20411","1570力肯","110/08/04","富邦-高雄",69,10,59
"20412","1570力肯","110/08/04","國泰-板橋",0,43,-43
"20413","1570力肯","110/08/04","統一-屏東",61,4,57
"20414","1570力肯","110/08/04","元大-新莊",1,44,-43
"20415","1570力肯","110/08/04","凱基-岡山",53,1,52
"20416","1570力肯","110/08/04","凱基-嘉義",0,42,-42
"20417","1570力肯","110/08/04","新光-台中",43,12,31
"20418","1570力肯","110/08/04","華南永昌-鳳山",2,42,-40
"20419","1570力肯","110/08/04","台中銀-員林",30,1,29
"20420","1570力肯","110/08/04","凱基-三峽",0,37,-37
"20421","1570力肯","110/08/04","元富-三重",37,12,25
"20422","1570力肯","110/08/04","國票-中正",0,36,-36
"20423","1570力肯","110/08/04","統一-新台中",30,6,24
"20424","1570力肯","110/08/04","高橋",0,30,-30
"20425","1570力肯","110/08/04","致和-府前",25,1,24
"20426","1570力肯","110/08/04","日盛-高雄",0,29,-29
"20427","1570力肯","110/08/04","凱基-中港",22,0,22
"20428","1570力肯","110/08/04","(牛牛牛)亞-鑫豐",6,29,-23
"20429","1570力肯","110/08/04","宏遠證券",20,0,20
"20430","1570力肯","110/08/04","元富-松德",1,22,-21
"20431","6180橘子","110/08/04","新光",67,10,57
"20432","6180橘子","110/08/04","群益金鼎-桃園",0,30,-30
"20433","6180橘子","110/08/04","美林",15,0,15
"20434","6180橘子","110/08/04","華南永昌-苑裡",0,30,-30
"20435","6180橘子","110/08/04","第一金-中山",15,1,14
"20436","6180橘子","110/08/04","台灣摩根士丹利",0,19,-19
"20437","6180橘子","110/08/04","日盛-台中",10,0,10
"20438","6180橘子","110/08/04","台新-三民",0,16,-16
"20439","6180橘子","110/08/04","新光-桃園",10,0,10
"20440","6180橘子","110/08/04","群益金鼎-士林",0,13,-13
"20441","6180橘子","110/08/04","康和",9,0,9
"20442","6180橘子","110/08/04","群益金鼎-中港",0,11,-11
"20443","6180橘子","110/08/04","富邦-羅東",8,0,8
"20444","6180橘子","110/08/04","新加坡商瑞銀",0,10,-10
"20445","6180橘子","110/08/04","國票-九鼎",7,0,7
"20446","6180橘子","110/08/04","統一-彰化",0,10,-10
"20447","6180橘子","110/08/04","玉山-桃園",7,0,7
"20448","6180橘子","110/08/04","兆豐-埔墘",0,10,-10
"20449","6180橘子","110/08/04","元大-員林中山",7,0,7
"20450","6180橘子","110/08/04","摩根大通",3,13,-10
"20451","6180橘子","110/08/04","瑞士信貸",6,0,6
"20452","6180橘子","110/08/04","康和-延平",0,10,-10
"20453","6180橘子","110/08/04","富邦-新竹",7,1,6
"20454","6180橘子","110/08/04","大昌-安康",0,9,-9
"20455","6180橘子","110/08/04","富邦-宜蘭",6,0,6
"20456","6180橘子","110/08/04","富邦-仁愛",1,10,-9
"20457","6180橘子","110/08/04","統一-嘉義",5,0,5
"20458","6180橘子","110/08/04","花旗環球",0,8,-8
"20459","6180橘子","110/08/04","富邦-陽明",5,0,5
"20460","6180橘子","110/08/04","福勝",0,8,-8
"20461","2390云辰","110/08/04","元富-吉利",71,6,65
"20462","2390云辰","110/08/04","港商野村",180,422,-242
"20463","2390云辰","110/08/04","兆豐-新營",53,4,49
"20464","2390云辰","110/08/04","凱基-台北",75,264,-189
"20465","2390云辰","110/08/04","台新證券",83,37,46
"20466","2390云辰","110/08/04","美林",32,132,-100
"20467","2390云辰","110/08/04","日盛-新莊",53,12,41
"20468","2390云辰","110/08/04","華南永昌-鳳山",82,181,-99
"20469","2390云辰","110/08/04","兆豐-岡山",40,0,40
"20470","2390云辰","110/08/04","日盛-園區",1,91,-90
"20471","2390云辰","110/08/04","元大-新莊",42,6,36
"20472","2390云辰","110/08/04","統一-城中",3,82,-79
"20473","2390云辰","110/08/04","永豐金-鳳山",37,3,34
"20474","2390云辰","110/08/04","第一金-中壢",0,73,-73
"20475","2390云辰","110/08/04","德信-新營",37,4,33
"20476","2390云辰","110/08/04","元大-忠孝",8,74,-66
"20477","2390云辰","110/08/04","群益金鼎-三民",35,2,33
"20478","2390云辰","110/08/04","凱基-竹科",6,67,-61
"20479","2390云辰","110/08/04","玉山-雙和",39,7,32
"20480","2390云辰","110/08/04","統一-屏東",0,51,-51
"20481","2390云辰","110/08/04","凱基-三重",33,3,30
"20482","2390云辰","110/08/04","富邦-新店",2,50,-48
"20483","2390云辰","110/08/04","華南永昌-朴子",35,6,29
"20484","2390云辰","110/08/04","元富-大裕",21,56,-35
"20485","2390云辰","110/08/04","國票-和平",29,1,28
"20486","2390云辰","110/08/04","永豐金-三重",6,41,-35
"20487","2390云辰","110/08/04","元大-東蘆",31,3,28
"20488","2390云辰","110/08/04","臺銀",15,47,-32
"20489","2390云辰","110/08/04","日茂",59,33,26
"20490","2390云辰","110/08/04","凱基-台中",1,33,-32
"20491","1471首利","110/08/02","日盛-和美",31,0,31
"20492","1471首利","110/08/02","日盛-八德",0,63,-63
"20493","1471首利","110/08/02","宏遠-光隆",30,0,30
"20494","1471首利","110/08/02","凱基-幸福",0,49,-49
"20495","1471首利","110/08/02","元富-花蓮",25,0,25
"20496","1471首利","110/08/02","富邦-台北",0,30,-30
"20497","1471首利","110/08/02","凱基-台北",25,0,25
"20498","1471首利","110/08/02","元大-東蘆",0,30,-30
"20499","1471首利","110/08/02","日盛-木柵",20,0,20
"20500","1471首利","110/08/02","合庫-桃園",0,20,-20
"20501","1471首利","110/08/02","凱基-高美館",20,0,20
"20502","1471首利","110/08/02","康和-澎湖",0,15,-15
"20503","1471首利","110/08/02","新光-台中",24,5,19
"20504","1471首利","110/08/02","元大-斗信",0,15,-15
"20505","1471首利","110/08/02","富邦-羅東",15,0,15
"20506","1471首利","110/08/02","元富-民權",0,12,-12
"20507","1471首利","110/08/02","兆豐-鹿港",14,0,14
"20508","1471首利","110/08/02","玉山-新莊",0,12,-12
"20509","1471首利","110/08/02","美林",16,4,12
"20510","1471首利","110/08/02","宏遠-桃園",0,10,-10
"20511","1471首利","110/08/02","統一-桃園",12,0,12
"20512","1471首利","110/08/02","瑞士信貸",0,10,-10
"20513","1471首利","110/08/02","合庫-高雄",10,0,10
"20514","1471首利","110/08/02","大慶-苗栗",0,10,-10
"20515","1471首利","110/08/02","日盛-士林",10,0,10
"20516","1471首利","110/08/02","統一-新營",0,10,-10
"20517","1471首利","110/08/02","港商法國興業",10,0,10
"20518","1471首利","110/08/02","群益金鼎-三重",0,10,-10
"20519","1471首利","110/08/02","第一金-台南",10,0,10
"20520","1471首利","110/08/02","元大-基隆",0,10,-10
"20521","2883開發金","110/08/02","統一",3076,29,3047
"20522","2883開發金","110/08/02","中農",2,3126,-3124
"20523","2883開發金","110/08/02","凱基-台北",2789,192,2597
"20524","2883開發金","110/08/02","群益金鼎",11,2008,-1997
"20525","2883開發金","110/08/02","元富-城東",2139,5,2134
"20526","2883開發金","110/08/02","摩根大通",2081,3944,-1863
"20527","2883開發金","110/08/02","瑞士信貸",2184,316,1868
"20528","2883開發金","110/08/02","港商野村",949,2553,-1604
"20529","2883開發金","110/08/02","美林",1160,271,889
"20530","2883開發金","110/08/02","台灣匯立證券",198,1533,-1335
"20531","2883開發金","110/08/02","港商麥格理",855,0,855
"20532","2883開發金","110/08/02","中國信託",69,1041,-972
"20533","2883開發金","110/08/02","元大-金華",533,33,500
"20534","2883開發金","110/08/02","兆豐證券",1,863,-862
"20535","2883開發金","110/08/02","新加坡商瑞銀",1089,624,465
"20536","2883開發金","110/08/02","美商高盛",6,644,-638
"20537","2883開發金","110/08/02","法銀巴黎",441,0,441
"20538","2883開發金","110/08/02","華南永昌-中正",4,632,-628
"20539","2883開發金","110/08/02","富邦-嘉義",425,24,401
"20540","2883開發金","110/08/02","第一金-安和",156,757,-601
"20541","2883開發金","110/08/02","元富-烏日",367,3,364
"20542","2883開發金","110/08/02","國票",0,524,-524
"20543","2883開發金","110/08/02","台灣摩根士丹利",634,280,354
"20544","2883開發金","110/08/02","元富",266,770,-504
"20545","2883開發金","110/08/02","國泰-館前",516,180,336
"20546","2883開發金","110/08/02","新光",1651,1984,-333
"20547","2883開發金","110/08/02","聯邦-敦化",321,5,316
"20548","2883開發金","110/08/02","元富-安南",20,324,-304
"20549","2883開發金","110/08/02","玉山-士林",307,13,294
"20550","2883開發金","110/08/02","群益金鼎-東門",6,280,-274
"20551","6205詮欣","110/08/02","元大-館前",16,0,16
"20552","6205詮欣","110/08/02","永豐金-敦南",0,21,-21
"20553","6205詮欣","110/08/02","臺銀",11,0,11
"20554","6205詮欣","110/08/02","日盛-三重",0,17,-17
"20555","6205詮欣","110/08/02","臺銀-民權",10,0,10
"20556","6205詮欣","110/08/02","永豐金-博愛",0,10,-10
"20557","6205詮欣","110/08/02","摩根大通",11,1,10
"20558","6205詮欣","110/08/02","國票-台南",0,5,-5
"20559","6205詮欣","110/08/02","合庫-三重",5,0,5
"20560","6205詮欣","110/08/02","群益金鼎-三重",0,4,-4
"20561","6205詮欣","110/08/02","元大-東蘆",5,0,5
"20562","6205詮欣","110/08/02","元大-土城",0,4,-4
"20563","6205詮欣","110/08/02","凱基",3,0,3
"20564","6205詮欣","110/08/02","元大-草屯",0,4,-4
"20565","6205詮欣","110/08/02","日盛-雙和",2,0,2
"20566","6205詮欣","110/08/02","臺銀-新竹",1,4,-3
"20567","6205詮欣","110/08/02","兆豐-南京",2,0,2
"20568","6205詮欣","110/08/02","光和-嘉義",0,3,-3
"20569","6205詮欣","110/08/02","凱基-台北",3,1,2
"20570","6205詮欣","110/08/02","永豐金-內湖",0,3,-3
"20571","6205詮欣","110/08/02","元大-西螺",2,0,2
"20572","6205詮欣","110/08/02","第一金-華江",0,2,-2
"20573","6205詮欣","110/08/02","元大-新竹經國",2,0,2
"20574","6205詮欣","110/08/02","中國信託-高雄",0,2,-2
"20575","6205詮欣","110/08/02","元大-北成功",2,0,2
"20576","6205詮欣","110/08/02","兆豐-鹿港",0,2,-2
"20577","6205詮欣","110/08/02","臺銀-臺中",1,0,1
"20578","6205詮欣","110/08/02","統一-平鎮",0,1,-1
"20579","6205詮欣","110/08/02","德信-新營",1,0,1
"20580","6205詮欣","110/08/02","台新-台中",0,1,-1
"20581","1540喬福","110/08/02","富邦-南屯",10,0,10
"20582","1540喬福","110/08/02","永豐金-埔里",0,22,-22
"20583","1540喬福","110/08/02","元富-中原",10,2,8
"20584","1540喬福","110/08/02","統一-新台中",0,17,-17
"20585","1540喬福","110/08/02","德信-新營",6,0,6
"20586","1540喬福","110/08/02","統一-三多",0,3,-3
"20587","1540喬福","110/08/02","元大-龍潭",3,0,3
"20588","1540喬福","110/08/02","光和-高雄",0,2,-2
"20589","1540喬福","110/08/02","凱基-台北",3,0,3
"20590","1540喬福","110/08/02","兆豐-嘉義",0,2,-2
"20591","1540喬福","110/08/02","新光-桃園",3,0,3
"20592","1540喬福","110/08/02","台新-高雄",0,1,-1
"20593","1540喬福","110/08/02","永豐金-內湖",2,0,2
"20594","1540喬福","110/08/02","新光",0,1,-1
"20595","1540喬福","110/08/02","港商法國興業",2,0,2
"20596","1540喬福","110/08/02","國泰-館前",0,1,-1
"20597","1540喬福","110/08/02","統一-台南",2,0,2
"20598","1540喬福","110/08/02","群益金鼎-民權",0,1,-1
"20599","1540喬福","110/08/02","元富-桃園",2,0,2
"20600","1540喬福","110/08/02","富邦-嘉義",0,1,-1
"20601","1540喬福","110/08/02","台中銀-豐原",2,0,2
"20602","1540喬福","110/08/02","元大-新竹",0,1,-1
"20603","1540喬福","110/08/02","(牛牛牛)亞-網路",1,0,1
"20604","1540喬福","110/08/02","元大-豐原站前",0,1,-1
"20605","1540喬福","110/08/02","元富",1,0,1
"20606","1540喬福","110/08/02","臺銀-鳳山",0,0,0
"20607","1540喬福","110/08/02","第一金-桃園",1,0,1
"20608","1540喬福","110/08/02","第一金",0,0,0
"20609","1540喬福","110/08/02","瑞士信貸",1,0,1
"20610","1540喬福","110/08/02","華南永昌-南京",0,0,0
"20611","2888新光金","110/08/02","花旗環球",2291,0,2291
"20612","2888新光金","110/08/02","瑞士信貸",1405,3997,-2592
"20613","2888新光金","110/08/02","美林",2235,208,2027
"20614","2888新光金","110/08/02","新加坡商瑞銀",780,2173,-1393
"20615","2888新光金","110/08/02","群益金鼎-彰化",1014,2,1012
"20616","2888新光金","110/08/02","美商高盛",369,1356,-987
"20617","2888新光金","110/08/02","富邦-建國",823,9,814
"20618","2888新光金","110/08/02","元大-仁愛",69,795,-726
"20619","2888新光金","110/08/02","元大-華山",532,1,531
"20620","2888新光金","110/08/02","永興-台中",0,500,-500
"20621","2888新光金","110/08/02","法銀巴黎",666,166,500
"20622","2888新光金","110/08/02","凱基-站前",17,506,-489
"20623","2888新光金","110/08/02","台灣匯立證券",421,0,421
"20624","2888新光金","110/08/02","元富-城東",38,496,-458
"20625","2888新光金","110/08/02","凱基-台南",376,17,359
"20626","2888新光金","110/08/02","群益金鼎-中港",2,450,-448
"20627","2888新光金","110/08/02","永豐金-嘉義",352,0,352
"20628","2888新光金","110/08/02","華南永昌",25,461,-436
"20629","2888新光金","110/08/02","合庫-台中",339,1,338
"20630","2888新光金","110/08/02","港商野村",135,550,-415
"20631","2888新光金","110/08/02","港商麥格理",316,0,316
"20632","2888新光金","110/08/02","大慶-苗栗",1,406,-405
"20633","2888新光金","110/08/02","群益金鼎-建成",298,5,293
"20634","2888新光金","110/08/02","華南永昌-中正",34,419,-385
"20635","2888新光金","110/08/02","永豐金-板盛",221,0,221
"20636","2888新光金","110/08/02","玉山-台大",0,350,-350
"20637","2888新光金","110/08/02","台灣摩根士丹利",1700,1488,212
"20638","2888新光金","110/08/02","元大-汐止",66,363,-297
"20639","2888新光金","110/08/02","凱基-竹北",200,0,200
"20640","2888新光金","110/08/02","台新-新莊",14,265,-251
"20641","1340勝悅","110/08/02","國泰-台中",22,0,22
"20642","1340勝悅","110/08/02","中國信託",0,83,-83
"20643","1340勝悅","110/08/02","港商法國興業",14,0,14
"20644","1340勝悅","110/08/02","元大-開元",0,11,-11
"20645","1340勝悅","110/08/02","新光",18,5,13
"20646","1340勝悅","110/08/02","凱基-永康",0,10,-10
"20647","1340勝悅","110/08/02","元大-基隆孝二",11,0,11
"20648","1340勝悅","110/08/02","富邦-宜蘭",0,10,-10
"20649","1340勝悅","110/08/02","玉山-士林",10,0,10
"20650","1340勝悅","110/08/02","元大-大統",0,10,-10
"20651","1340勝悅","110/08/02","凱基",6,0,6
"20652","1340勝悅","110/08/02","富邦-板橋",0,5,-5
"20653","1340勝悅","110/08/02","摩根大通",4,0,4
"20654","1340勝悅","110/08/02","瑞士信貸",1,5,-4
"20655","1340勝悅","110/08/02","國泰-敦南",8,4,4
"20656","1340勝悅","110/08/02","華南永昌-忠孝",0,2,-2
"20657","1340勝悅","110/08/02","國泰-新莊",3,0,3
"20658","1340勝悅","110/08/02","元大-虎尾",0,2,-2
"20659","1340勝悅","110/08/02","凱基-嘉義",3,0,3
"20660","1340勝悅","110/08/02","元大-路竹",0,2,-2
"20661","1340勝悅","110/08/02","群益金鼎-館前",3,0,3
"20662","1340勝悅","110/08/02","元大-信義",0,2,-2
"20663","1340勝悅","110/08/02","國泰-館前",3,0,3
"20664","1340勝悅","110/08/02","華南永昌-高雄",0,1,-1
"20665","1340勝悅","110/08/02","臺銀-鳳山",3,0,3
"20666","1340勝悅","110/08/02","玉山-大里",0,0,0
"20667","1340勝悅","110/08/02","國泰-高雄",4,1,3
"20668","1340勝悅","110/08/02","群益金鼎-丹鳳",0,0,0
"20669","1340勝悅","110/08/02","美商高盛",3,0,3
"20670","1340勝悅","110/08/02","富邦-虎尾",0,0,0
"20671","6246臺龍","110/08/02","台新證券",19,1,18
"20672","6246臺龍","110/08/02","元大-新竹經國",0,6,-6
"20673","6246臺龍","110/08/02","凱基-台北",7,2,5
"20674","6246臺龍","110/08/02","台新-台南",0,5,-5
"20675","6246臺龍","110/08/02","國票-九鼎",3,0,3
"20676","6246臺龍","110/08/02","宏遠-新化",1,4,-3
"20677","6246臺龍","110/08/02","國票-南京",3,0,3
"20678","6246臺龍","110/08/02","元富-板橋",0,3,-3
"20679","6246臺龍","110/08/02","新光-台中",3,0,3
"20680","6246臺龍","110/08/02","國泰-敦南",0,3,-3
"20681","6246臺龍","110/08/02","元大-員林",3,0,3
"20682","6246臺龍","110/08/02","富邦-台中",0,3,-3
"20683","6246臺龍","110/08/02","元大-永和",3,0,3
"20684","6246臺龍","110/08/02","元大-大益",2,5,-3
"20685","6246臺龍","110/08/02","港商野村",2,0,2
"20686","6246臺龍","110/08/02","日盛-永康",0,2,-2
"20687","6246臺龍","110/08/02","台新-高雄",2,0,2
"20688","6246臺龍","110/08/02","日盛-宜蘭",0,2,-2
"20689","6246臺龍","110/08/02","新光-台南",2,0,2
"20690","6246臺龍","110/08/02","宏遠-台南",0,2,-2
"20691","6246臺龍","110/08/02","日盛-文化",1,0,1
"20692","6246臺龍","110/08/02","高橋-龍潭",0,2,-2
"20693","6246臺龍","110/08/02","國泰-忠孝",1,0,1
"20694","6246臺龍","110/08/02","群益金鼎-中壢",0,2,-2
"20695","6246臺龍","110/08/02","群益金鼎-崇德",3,2,1
"20696","6246臺龍","110/08/02","凱基-三多",0,2,-2
"20697","6246臺龍","110/08/02","富邦-員林",1,0,1
"20698","6246臺龍","110/08/02","統一-中壢",0,1,-1
"20699","6246臺龍","110/08/02","富邦-三重",1,0,1
"20700","6246臺龍","110/08/02","中國信託-嘉義",0,1,-1
"20701","00715L期街口布蘭特正2","110/08/02","元大證券",7296,1000,6296
"20702","00715L期街口布蘭特正2","110/08/02","富邦-基隆",0,850,-850
"20703","00715L期街口布蘭特正2","110/08/02","永豐金證券",2221,338,1883
"20704","00715L期街口布蘭特正2","110/08/02","(牛牛牛)亞-鑫豐",10,850,-840
"20705","00715L期街口布蘭特正2","110/08/02","統一",1460,100,1360
"20706","00715L期街口布蘭特正2","110/08/02","華南永昌-長虹",57,820,-763
"20707","00715L期街口布蘭特正2","110/08/02","國票-中港",1000,0,1000
"20708","00715L期街口布蘭特正2","110/08/02","富邦-彰化",0,700,-700
"20709","00715L期街口布蘭特正2","110/08/02","第一金-台中",900,13,887
"20710","00715L期街口布蘭特正2","110/08/02","第一金-路竹",0,682,-682
"20711","00715L期街口布蘭特正2","110/08/02","群益金鼎",728,0,728
"20712","00715L期街口布蘭特正2","110/08/02","台新證券",112,791,-679
"20713","00715L期街口布蘭特正2","110/08/02","群益金鼎-古亭",433,1,432
"20714","00715L期街口布蘭特正2","110/08/02","第一金-忠孝",45,483,-438
"20715","00715L期街口布蘭特正2","110/08/02","凱基-市政",525,125,400
"20716","00715L期街口布蘭特正2","110/08/02","玉山-台南",0,373,-373
"20717","00715L期街口布蘭特正2","110/08/02","元大-敦化",400,0,400
"20718","00715L期街口布蘭特正2","110/08/02","國泰-板橋",3,313,-310
"20719","00715L期街口布蘭特正2","110/08/02","元大-草屯",353,21,332
"20720","00715L期街口布蘭特正2","110/08/02","凱基",0,300,-300
"20721","00715L期街口布蘭特正2","110/08/02","元大-萬華",250,0,250
"20722","00715L期街口布蘭特正2","110/08/02","元大-嘉義",1,300,-299
"20723","00715L期街口布蘭特正2","110/08/02","統一-員林",180,0,180
"20724","00715L期街口布蘭特正2","110/08/02","元大-大灣",14,303,-289
"20725","00715L期街口布蘭特正2","110/08/02","富邦證券",282,152,130
"20726","00715L期街口布蘭特正2","110/08/02","新光-桃園",45,295,-250
"20727","00715L期街口布蘭特正2","110/08/02","元富-潮州",125,0,125
"20728","00715L期街口布蘭特正2","110/08/02","元大-新莊",76,306,-230
"20729","00715L期街口布蘭特正2","110/08/02","兆豐-台中港",106,0,106
"20730","00715L期街口布蘭特正2","110/08/02","富邦-台北",0,211,-211
"20731","8941關中","110/08/02","宏遠-館前",3,0,3
"20732","8941關中","110/08/02","富邦-台中",0,5,-5
"20733","8941關中","110/08/02","群益金鼎-彰化",2,0,2
"20734","8941關中","110/08/02","富邦-員林",0,4,-4
"20735","8941關中","110/08/02","第一金-台中",1,0,1
"20736","8941關中","110/08/02","元大-新竹經國",0,0,0
"20737","8941關中","110/08/02","台新-台中",1,0,1
"20738","8941關中","110/08/02","永豐金-萬盛",0,0,0
"20739","8941關中","110/08/02","華南永昌-南京",1,0,1
"20740","8941關中","110/08/02","",NA,NA,NA
"20741","8941關中","110/08/02","元大-桃興",2,1,1
"20742","8941關中","110/08/02","",NA,NA,NA
"20743","8941關中","110/08/02","元大-新竹經國",0,0,0
"20744","8941關中","110/08/02","",NA,NA,NA
"20745","8941關中","110/08/02","永豐金-萬盛",0,0,0
"20746","8941關中","110/08/02","",NA,NA,NA
"20747","8941關中","110/08/02","",NA,NA,NA
"20748","8941關中","110/08/02","",NA,NA,NA
"20749","8941關中","110/08/02","",NA,NA,NA
"20750","8941關中","110/08/02","",NA,NA,NA
"20751","8941關中","110/08/02","",NA,NA,NA
"20752","8941關中","110/08/02","",NA,NA,NA
"20753","8941關中","110/08/02","",NA,NA,NA
"20754","8941關中","110/08/02","",NA,NA,NA
"20755","8941關中","110/08/02","",NA,NA,NA
"20756","8941關中","110/08/02","",NA,NA,NA
"20757","8941關中","110/08/02","",NA,NA,NA
"20758","8941關中","110/08/02","",NA,NA,NA
"20759","8941關中","110/08/02","",NA,NA,NA
"20760","8941關中","110/08/02","",NA,NA,NA
"20761","8936國統","110/08/02","合庫-高雄",68,0,68
"20762","8936國統","110/08/02","凱基-台北",0,125,-125
"20763","8936國統","110/08/02","元大-蘆洲",33,0,33
"20764","8936國統","110/08/02","摩根大通",9,125,-116
"20765","8936國統","110/08/02","富邦-高雄",30,4,26
"20766","8936國統","110/08/02","永全-南崁",0,50,-50
"20767","8936國統","110/08/02","大慶-蘆洲",20,0,20
"20768","8936國統","110/08/02","新光-台中",16,55,-39
"20769","8936國統","110/08/02","兆豐-桃鶯",20,0,20
"20770","8936國統","110/08/02","凱基-市政",0,31,-31
"20771","8936國統","110/08/02","元大-東泰",20,0,20
"20772","8936國統","110/08/02","美商高盛",1,20,-19
"20773","8936國統","110/08/02","永豐金-忠孝",20,0,20
"20774","8936國統","110/08/02","元大-東港",3,20,-17
"20775","8936國統","110/08/02","元大-旗山",15,0,15
"20776","8936國統","110/08/02","台灣企銀-台中",0,15,-15
"20777","8936國統","110/08/02","中國信託-文心",12,0,12
"20778","8936國統","110/08/02","日盛-竹北",0,15,-15
"20779","8936國統","110/08/02","國泰-敦南",14,2,12
"20780","8936國統","110/08/02","瑞士信貸",0,11,-11
"20781","8936國統","110/08/02","元大-敦南",12,0,12
"20782","8936國統","110/08/02","港商野村",26,36,-10
"20783","8936國統","110/08/02","日盛-三峽",11,0,11
"20784","8936國統","110/08/02","統一-竹南",0,10,-10
"20785","8936國統","110/08/02","永豐金-苓雅",11,0,11
"20786","8936國統","110/08/02","國泰-高雄",1,11,-10
"20787","8936國統","110/08/02","宏遠-高雄",11,1,10
"20788","8936國統","110/08/02","元大-天母",0,9,-9
"20789","8936國統","110/08/02","第一金-嘉義",10,0,10
"20790","8936國統","110/08/02","元大-台中中港",0,9,-9
"20791","6226光鼎","110/08/02","新百王",283,0,283
"20792","6226光鼎","110/08/02","元富-安南",3,113,-110
"20793","6226光鼎","110/08/02","日盛-文化",219,3,216
"20794","6226光鼎","110/08/02","群益金鼎-東大",24,124,-100
"20795","6226光鼎","110/08/02","元大-嘉義",127,37,90
"20796","6226光鼎","110/08/02","富邦-南屯",3,100,-97
"20797","6226光鼎","110/08/02","統一-新竹",113,31,82
"20798","6226光鼎","110/08/02","元大-鳳中",2,99,-97
"20799","6226光鼎","110/08/02","台中銀-員林",111,47,64
"20800","6226光鼎","110/08/02","元大-忠孝鼎富",10,100,-90
"20801","6226光鼎","110/08/02","永豐金證券",66,5,61
"20802","6226光鼎","110/08/02","華南永昌-小港",0,84,-84
"20803","6226光鼎","110/08/02","日盛-員林",107,50,57
"20804","6226光鼎","110/08/02","國泰-敦南",247,324,-77
"20805","6226光鼎","110/08/02","國票-九鼎",72,24,48
"20806","6226光鼎","110/08/02","亞東",5,76,-71
"20807","6226光鼎","110/08/02","元大-士林",53,6,47
"20808","6226光鼎","110/08/02","中國信託-新竹",2,62,-60
"20809","6226光鼎","110/08/02","元大-鹿港",48,7,41
"20810","6226光鼎","110/08/02","元大-南屯",12,64,-52
"20811","6226光鼎","110/08/02","中國信託-文心",48,8,40
"20812","6226光鼎","110/08/02","元大-高雄",9,61,-52
"20813","6226光鼎","110/08/02","國泰-新莊",56,17,39
"20814","6226光鼎","110/08/02","元大-台北",2,53,-51
"20815","6226光鼎","110/08/02","元大-大同",39,0,39
"20816","6226光鼎","110/08/02","第一金-華江",8,52,-44
"20817","6226光鼎","110/08/02","富邦-建國",39,1,38
"20818","6226光鼎","110/08/02","元富-新莊",3,44,-41
"20819","6226光鼎","110/08/02","統一-三重",54,18,36
"20820","6226光鼎","110/08/02","玉山-桃園",3,40,-37
"20821","2363矽統","110/08/02","中國信託-忠孝",405,25,380
"20822","2363矽統","110/08/02","富邦證券",16,4082,-4066
"20823","2363矽統","110/08/02","群益金鼎-屏東",349,123,226
"20824","2363矽統","110/08/02","凱基-台北",2669,4466,-1797
"20825","2363矽統","110/08/02","群益金鼎-永和",233,20,213
"20826","2363矽統","110/08/02","台灣摩根士丹利",69,1749,-1680
"20827","2363矽統","110/08/02","富邦-中壢",299,91,208
"20828","2363矽統","110/08/02","新加坡商瑞銀",361,1486,-1125
"20829","2363矽統","110/08/02","永豐金-彰化",188,4,184
"20830","2363矽統","110/08/02","港商野村",619,1622,-1003
"20831","2363矽統","110/08/02","元大-承德",253,73,180
"20832","2363矽統","110/08/02","美商高盛",214,1077,-863
"20833","2363矽統","110/08/02","康和-台中",192,23,169
"20834","2363矽統","110/08/02","兆豐-復興",124,973,-849
"20835","2363矽統","110/08/02","新光",550,382,168
"20836","2363矽統","110/08/02","統一-仁愛",132,666,-534
"20837","2363矽統","110/08/02","元大-萬華",224,61,163
"20838","2363矽統","110/08/02","美林",520,1028,-508
"20839","2363矽統","110/08/02","元大-博愛",204,44,160
"20840","2363矽統","110/08/02","統一-土城",32,536,-504
"20841","2363矽統","110/08/02","兆豐-三民",171,17,154
"20842","2363矽統","110/08/02","華南永昌-斗六",33,526,-493
"20843","2363矽統","110/08/02","元大-新竹",196,44,152
"20844","2363矽統","110/08/02","統一-敦南",35,527,-492
"20845","2363矽統","110/08/02","凱基-三重",178,29,149
"20846","2363矽統","110/08/02","永豐金-員林",12,495,-483
"20847","2363矽統","110/08/02","元大-忠孝",181,38,143
"20848","2363矽統","110/08/02","統一-城中",117,589,-472
"20849","2363矽統","110/08/02","元富-世貿",142,4,138
"20850","2363矽統","110/08/02","摩根大通",1070,1471,-401
"20851","8112至上","110/08/02","合庫證券",213,0,213
"20852","8112至上","110/08/02","台灣摩根士丹利",9,287,-278
"20853","8112至上","110/08/02","凱基-台北",298,152,146
"20854","8112至上","110/08/02","凱基-三重",3,236,-233
"20855","8112至上","110/08/02","大慶",87,0,87
"20856","8112至上","110/08/02","臺銀-鳳山",11,124,-113
"20857","8112至上","110/08/02","凱基-新店",84,0,84
"20858","8112至上","110/08/02","合庫-台中",1,112,-111
"20859","8112至上","110/08/02","香港上海匯豐",76,0,76
"20860","8112至上","110/08/02","土銀-嘉義",0,105,-105
"20861","8112至上","110/08/02","群益金鼎-建成",65,1,64
"20862","8112至上","110/08/02","元大-新莊",2,106,-104
"20863","8112至上","110/08/02","玉山-板橋",63,0,63
"20864","8112至上","110/08/02","台新-建北",0,95,-95
"20865","8112至上","110/08/02","元大-前金",61,2,59
"20866","8112至上","110/08/02","華南永昌-彰化",2,64,-62
"20867","8112至上","110/08/02","台新-台中",58,5,53
"20868","8112至上","110/08/02","群益金鼎-北高雄",3,50,-47
"20869","8112至上","110/08/02","亞東",51,0,51
"20870","8112至上","110/08/02","元大-福營",1,45,-44
"20871","8112至上","110/08/02","美林",49,1,48
"20872","8112至上","110/08/02","永豐金-南京",2,38,-36
"20873","8112至上","110/08/02","摩根大通",114,67,47
"20874","8112至上","110/08/02","亞東-板橋",2,34,-32
"20875","8112至上","110/08/02","美商高盛",46,0,46
"20876","8112至上","110/08/02","元大-台南",2,33,-31
"20877","8112至上","110/08/02","凱基-松山",43,1,42
"20878","8112至上","110/08/02","統一-城中",0,30,-30
"20879","8112至上","110/08/02","群益金鼎-大安",40,0,40
"20880","8112至上","110/08/02","元富-板橋",5,35,-30
"20881","1570力肯","110/08/02","群益金鼎-高雄",11,0,11
"20882","1570力肯","110/08/02","大慶",0,5,-5
"20883","1570力肯","110/08/02","臺銀-臺南",4,0,4
"20884","1570力肯","110/08/02","元大-板橋",0,4,-4
"20885","1570力肯","110/08/02","新光-台中",4,0,4
"20886","1570力肯","110/08/02","玉山證券",0,4,-4
"20887","1570力肯","110/08/02","(牛牛牛)亞-鑫豐",3,0,3
"20888","1570力肯","110/08/02","國泰-台南",0,3,-3
"20889","1570力肯","110/08/02","土銀-白河",2,0,2
"20890","1570力肯","110/08/02","元富-新店",0,3,-3
"20891","1570力肯","110/08/02","統一-松江",2,0,2
"20892","1570力肯","110/08/02","元富-永和",0,2,-2
"20893","1570力肯","110/08/02","中國信託-永康",1,0,1
"20894","1570力肯","110/08/02","凱基-台北",0,2,-2
"20895","1570力肯","110/08/02","凱基-信義",1,0,1
"20896","1570力肯","110/08/02","統一-城中",0,2,-2
"20897","1570力肯","110/08/02","凱基-幸福",1,0,1
"20898","1570力肯","110/08/02","新光",0,1,-1
"20899","1570力肯","110/08/02","元大-歸仁",1,0,1
"20900","1570力肯","110/08/02","凱基-岡山",0,1,-1
"20901","1570力肯","110/08/02","合庫-台中",0,0,0
"20902","1570力肯","110/08/02","富邦-台南",0,1,-1
"20903","1570力肯","110/08/02","康和-板橋",0,0,0
"20904","1570力肯","110/08/02","元大-新盛",0,1,-1
"20905","1570力肯","110/08/02","群益金鼎-鳳山",0,0,0
"20906","1570力肯","110/08/02","永豐金-嘉義",0,1,-1
"20907","1570力肯","110/08/02","元大-樹林",0,0,0
"20908","1570力肯","110/08/02","康和-板橋",0,0,0
"20909","1570力肯","110/08/02","",NA,NA,NA
"20910","1570力肯","110/08/02","合庫-台中",0,0,0
"20911","2929淘帝","110/08/02","元大-民生",29,0,29
"20912","2929淘帝","110/08/02","新加坡商瑞銀",4,70,-66
"20913","2929淘帝","110/08/02","兆豐-桃園",20,0,20
"20914","2929淘帝","110/08/02","富邦-建國",0,26,-26
"20915","2929淘帝","110/08/02","新光",14,0,14
"20916","2929淘帝","110/08/02","美林",0,24,-24
"20917","2929淘帝","110/08/02","兆豐-忠孝",13,0,13
"20918","2929淘帝","110/08/02","元大-和平",0,13,-13
"20919","2929淘帝","110/08/02","兆豐-彰化",12,0,12
"20920","2929淘帝","110/08/02","元大-永和",0,10,-10
"20921","2929淘帝","110/08/02","合庫-高雄",10,0,10
"20922","2929淘帝","110/08/02","日盛-頭份",0,9,-9
"20923","2929淘帝","110/08/02","富邦-台北",10,0,10
"20924","2929淘帝","110/08/02","群益金鼎-中山",0,9,-9
"20925","2929淘帝","110/08/02","國泰-敦南",9,0,9
"20926","2929淘帝","110/08/02","華南永昌-頭份",0,7,-7
"20927","2929淘帝","110/08/02","元富-文心",10,2,8
"20928","2929淘帝","110/08/02","永豐金-敦南",0,7,-7
"20929","2929淘帝","110/08/02","台新-台中",7,0,7
"20930","2929淘帝","110/08/02","凱基-台北",5,11,-6
"20931","2929淘帝","110/08/02","元大-文心",6,0,6
"20932","2929淘帝","110/08/02","臺銀-鳳山",0,5,-5
"20933","2929淘帝","110/08/02","日盛-忠孝",5,0,5
"20934","2929淘帝","110/08/02","凱基-城中",0,5,-5
"20935","2929淘帝","110/08/02","第一金-高雄",5,0,5
"20936","2929淘帝","110/08/02","華南永昌-台中",0,5,-5
"20937","2929淘帝","110/08/02","富邦-基隆",6,1,5
"20938","2929淘帝","110/08/02","元大-博愛",0,5,-5
"20939","2929淘帝","110/08/02","富邦-新店",5,0,5
"20940","2929淘帝","110/08/02","元富-緯城",0,4,-4
"20941","5410國眾","110/08/02","新加坡商瑞銀",19,0,19
"20942","5410國眾","110/08/02","日盛-斗六",0,15,-15
"20943","5410國眾","110/08/02","兆豐-城中",18,0,18
"20944","5410國眾","110/08/02","元大-大同",0,15,-15
"20945","5410國眾","110/08/02","日盛-新莊",10,0,10
"20946","5410國眾","110/08/02","元大-博愛",0,10,-10
"20947","5410國眾","110/08/02","元富-佳里",10,0,10
"20948","5410國眾","110/08/02","凱基-台北",0,7,-7
"20949","5410國眾","110/08/02","摩根大通",9,0,9
"20950","5410國眾","110/08/02","臺銀-臺南",0,6,-6
"20951","5410國眾","110/08/02","國泰-桃園",6,0,6
"20952","5410國眾","110/08/02","元富-嘉義",0,6,-6
"20953","5410國眾","110/08/02","元富-新竹",5,0,5
"20954","5410國眾","110/08/02","第一金-中壢",0,5,-5
"20955","5410國眾","110/08/02","元大-復北",5,0,5
"20956","5410國眾","110/08/02","致和證券",0,5,-5
"20957","5410國眾","110/08/02","永豐金-桃園",5,0,5
"20958","5410國眾","110/08/02","群益金鼎-土城",0,5,-5
"20959","5410國眾","110/08/02","安泰-楠梓",4,0,4
"20960","5410國眾","110/08/02","華南永昌-中正",0,5,-5
"20961","5410國眾","110/08/02","台灣企銀-太平",3,0,3
"20962","5410國眾","110/08/02","元大-新莊",0,5,-5
"20963","5410國眾","110/08/02","新光",3,0,3
"20964","5410國眾","110/08/02","土銀-新竹",0,4,-4
"20965","5410國眾","110/08/02","富邦-內湖",3,0,3
"20966","5410國眾","110/08/02","日盛-員林",0,3,-3
"20967","5410國眾","110/08/02","中國信託-新竹",2,0,2
"20968","5410國眾","110/08/02","元大-新竹經國",0,3,-3
"20969","5410國眾","110/08/02","華南永昌-楠梓",2,0,2
"20970","5410國眾","110/08/02","元富-緯城",0,2,-2
"20971","2841台開","110/08/02","富邦-敦南",71,0,71
"20972","2841台開","110/08/02","永豐金-松山",0,91,-91
"20973","2841台開","110/08/02","國泰-館前",38,0,38
"20974","2841台開","110/08/02","元大-蘆洲",0,40,-40
"20975","2841台開","110/08/02","台中銀",19,0,19
"20976","2841台開","110/08/02","凱基-台北",2,33,-31
"20977","2841台開","110/08/02","元富-烏日",18,0,18
"20978","2841台開","110/08/02","兆豐-寶成",0,20,-20
"20979","2841台開","110/08/02","國泰-板橋",15,0,15
"20980","2841台開","110/08/02","華南永昌-民權",0,20,-20
"20981","2841台開","110/08/02","元大-台中",15,0,15
"20982","2841台開","110/08/02","國票-敦北法人",0,18,-18
"20983","2841台開","110/08/02","元大-福營",15,0,15
"20984","2841台開","110/08/02","第一金-路竹",0,17,-17
"20985","2841台開","110/08/02","日盛-花蓮",14,0,14
"20986","2841台開","110/08/02","中國信託-高雄",0,15,-15
"20987","2841台開","110/08/02","新光",12,0,12
"20988","2841台開","110/08/02","日進",0,10,-10
"20989","2841台開","110/08/02","永豐金-敦南",62,51,11
"20990","2841台開","110/08/02","統一-三多",0,10,-10
"20991","2841台開","110/08/02","日盛-台中",10,0,10
"20992","2841台開","110/08/02","元大-路竹",0,10,-10
"20993","2841台開","110/08/02","群益金鼎-崇德",10,0,10
"20994","2841台開","110/08/02","元大-中和",0,10,-10
"20995","2841台開","110/08/02","元大-南海",10,0,10
"20996","2841台開","110/08/02","宏遠-桃園",0,9,-9
"20997","2841台開","110/08/02","國泰-桃園",8,0,8
"20998","2841台開","110/08/02","大昌-新店",0,6,-6
"20999","2841台開","110/08/02","台新-台中",6,0,6
"21000","2841台開","110/08/02","國票-天祥",0,6,-6
"21001","6207雷科","110/08/02","摩根大通",173,19,154
"21002","6207雷科","110/08/02","凱基-高雄",0,50,-50
"21003","6207雷科","110/08/02","凱基-台北",150,10,140
"21004","6207雷科","110/08/02","群益金鼎-東門",0,26,-26
"21005","6207雷科","110/08/02","華南永昌-朴子",55,0,55
"21006","6207雷科","110/08/02","富邦-竹東",0,25,-25
"21007","6207雷科","110/08/02","新加坡商瑞銀",51,5,46
"21008","6207雷科","110/08/02","華南永昌-東勢",3,27,-24
"21009","6207雷科","110/08/02","元大-西門",54,12,42
"21010","6207雷科","110/08/02","富邦-岡山",1,25,-24
"21011","6207雷科","110/08/02","兆豐-景美",42,2,40
"21012","6207雷科","110/08/02","台灣摩根士丹利",0,22,-22
"21013","6207雷科","110/08/02","日盛-忠孝",35,0,35
"21014","6207雷科","110/08/02","國泰-高雄",1,23,-22
"21015","6207雷科","110/08/02","美林",25,0,25
"21016","6207雷科","110/08/02","富邦-建國",0,17,-17
"21017","6207雷科","110/08/02","日盛-北高雄",16,0,16
"21018","6207雷科","110/08/02","元大-上新莊",0,16,-16
"21019","6207雷科","110/08/02","統一-板橋",15,0,15
"21020","6207雷科","110/08/02","中國信託-高雄",0,15,-15
"21021","6207雷科","110/08/02","凱基-市政",15,0,15
"21022","6207雷科","110/08/02","宏遠證券",0,13,-13
"21023","6207雷科","110/08/02","新光-新竹",16,2,14
"21024","6207雷科","110/08/02","凱基-彰化",0,13,-13
"21025","6207雷科","110/08/02","港商野村",23,12,11
"21026","6207雷科","110/08/02","永豐金-內湖",0,13,-13
"21027","6207雷科","110/08/02","統一-南京",11,0,11
"21028","6207雷科","110/08/02","新百王",0,12,-12
"21029","6207雷科","110/08/02","元大-嘉義",11,0,11
"21030","6207雷科","110/08/02","玉山-大里",0,12,-12
"21031","3679新至陞","110/08/02","元大-成功",26,0,26
"21032","3679新至陞","110/08/02","富邦-陽明",1,34,-33
"21033","3679新至陞","110/08/02","元大-樹林",20,0,20
"21034","3679新至陞","110/08/02","富邦-中壢",0,20,-20
"21035","3679新至陞","110/08/02","(牛牛牛)亞-網路",18,0,18
"21036","3679新至陞","110/08/02","凱基-台北",34,48,-14
"21037","3679新至陞","110/08/02","凱基-中山",12,0,12
"21038","3679新至陞","110/08/02","永豐金證券",0,14,-14
"21039","3679新至陞","110/08/02","統一",21,11,10
"21040","3679新至陞","110/08/02","臺銀-臺南",2,14,-12
"21041","3679新至陞","110/08/02","玉山-台大",10,0,10
"21042","3679新至陞","110/08/02","摩根大通",20,32,-12
"21043","3679新至陞","110/08/02","台中銀",8,0,8
"21044","3679新至陞","110/08/02","富邦-嘉義",0,10,-10
"21045","3679新至陞","110/08/02","港商野村",8,2,6
"21046","3679新至陞","110/08/02","國票-北高雄",1,10,-9
"21047","3679新至陞","110/08/02","群益金鼎-丹鳳",6,0,6
"21048","3679新至陞","110/08/02","台新-台中",0,9,-9
"21049","3679新至陞","110/08/02","元大-高雄",6,0,6
"21050","3679新至陞","110/08/02","凱基-宜蘭",0,7,-7
"21051","3679新至陞","110/08/02","新加坡商瑞銀",5,0,5
"21052","3679新至陞","110/08/02","凱基-埔墘",0,7,-7
"21053","3679新至陞","110/08/02","台灣摩根士丹利",13,9,4
"21054","3679新至陞","110/08/02","永豐金-台中",0,7,-7
"21055","3679新至陞","110/08/02","第一金-華江",4,0,4
"21056","3679新至陞","110/08/02","永豐金-潮州",0,7,-7
"21057","3679新至陞","110/08/02","新光",11,7,4
"21058","3679新至陞","110/08/02","凱基-五股",0,6,-6
"21059","3679新至陞","110/08/02","國泰-館前",4,0,4
"21060","3679新至陞","110/08/02","富邦-建國",0,6,-6
"21061","2727王品","110/08/02","摩根大通",38,5,33
"21062","2727王品","110/08/02","台灣摩根士丹利",13,170,-157
"21063","2727王品","110/08/02","日盛-忠孝",33,3,30
"21064","2727王品","110/08/02","華南永昌",7,156,-149
"21065","2727王品","110/08/02","凱基-天母",30,0,30
"21066","2727王品","110/08/02","凱基-台北",37,57,-20
"21067","2727王品","110/08/02","花旗環球",17,0,17
"21068","2727王品","110/08/02","國票-北高雄",1,19,-18
"21069","2727王品","110/08/02","永豐金-竹科",20,5,15
"21070","2727王品","110/08/02","港商野村",39,54,-15
"21071","2727王品","110/08/02","彰銀-台中",16,2,14
"21072","2727王品","110/08/02","元大-四維",1,15,-14
"21073","2727王品","110/08/02","國票-內壢",14,0,14
"21074","2727王品","110/08/02","美林",12,25,-13
"21075","2727王品","110/08/02","新光-台中",17,3,14
"21076","2727王品","110/08/02","瑞士信貸",0,12,-12
"21077","2727王品","110/08/02","永豐金-南京",16,3,13
"21078","2727王品","110/08/02","元大-北成功",0,10,-10
"21079","2727王品","110/08/02","元大-樹林",13,1,12
"21080","2727王品","110/08/02","元大-崇德",0,8,-8
"21081","2727王品","110/08/02","國泰-板橋",17,7,10
"21082","2727王品","110/08/02","永豐金-內湖",3,10,-7
"21083","2727王品","110/08/02","凱基-埔墘",10,0,10
"21084","2727王品","110/08/02","大昌",5,11,-6
"21085","2727王品","110/08/02","元大-豐原",10,0,10
"21086","2727王品","110/08/02","華南永昌-斗六",2,8,-6
"21087","2727王品","110/08/02","元大-桃園",10,0,10
"21088","2727王品","110/08/02","國泰-台中",4,9,-5
"21089","2727王品","110/08/02","凱基-科園",9,0,9
"21090","2727王品","110/08/02","群益金鼎-土城",0,5,-5
"21091","1570力肯","110/08/02","群益金鼎-高雄",11,0,11
"21092","1570力肯","110/08/02","大慶",0,5,-5
"21093","1570力肯","110/08/02","臺銀-臺南",4,0,4
"21094","1570力肯","110/08/02","元大-板橋",0,4,-4
"21095","1570力肯","110/08/02","新光-台中",4,0,4
"21096","1570力肯","110/08/02","玉山證券",0,4,-4
"21097","1570力肯","110/08/02","(牛牛牛)亞-鑫豐",3,0,3
"21098","1570力肯","110/08/02","國泰-台南",0,3,-3
"21099","1570力肯","110/08/02","土銀-白河",2,0,2
"21100","1570力肯","110/08/02","元富-新店",0,3,-3
"21101","1570力肯","110/08/02","統一-松江",2,0,2
"21102","1570力肯","110/08/02","元富-永和",0,2,-2
"21103","1570力肯","110/08/02","中國信託-永康",1,0,1
"21104","1570力肯","110/08/02","凱基-台北",0,2,-2
"21105","1570力肯","110/08/02","凱基-信義",1,0,1
"21106","1570力肯","110/08/02","統一-城中",0,2,-2
"21107","1570力肯","110/08/02","凱基-幸福",1,0,1
"21108","1570力肯","110/08/02","新光",0,1,-1
"21109","1570力肯","110/08/02","元大-歸仁",1,0,1
"21110","1570力肯","110/08/02","凱基-岡山",0,1,-1
"21111","1570力肯","110/08/02","合庫-台中",0,0,0
"21112","1570力肯","110/08/02","富邦-台南",0,1,-1
"21113","1570力肯","110/08/02","康和-板橋",0,0,0
"21114","1570力肯","110/08/02","元大-新盛",0,1,-1
"21115","1570力肯","110/08/02","群益金鼎-鳳山",0,0,0
"21116","1570力肯","110/08/02","永豐金-嘉義",0,1,-1
"21117","1570力肯","110/08/02","元大-樹林",0,0,0
"21118","1570力肯","110/08/02","康和-板橋",0,0,0
"21119","1570力肯","110/08/02","",NA,NA,NA
"21120","1570力肯","110/08/02","合庫-台中",0,0,0
"21121","6180橘子","110/08/02","美商高盛",21,8,13
"21122","6180橘子","110/08/02","國票-嘉義",0,29,-29
"21123","6180橘子","110/08/02","統一-彰化",10,0,10
"21124","6180橘子","110/08/02","新加坡商瑞銀",0,21,-21
"21125","6180橘子","110/08/02","中國信託-高雄",10,0,10
"21126","6180橘子","110/08/02","凱基-台北",20,40,-20
"21127","6180橘子","110/08/02","兆豐-斗南",10,0,10
"21128","6180橘子","110/08/02","摩根大通",3,15,-12
"21129","6180橘子","110/08/02","兆豐-埔墘",10,0,10
"21130","6180橘子","110/08/02","第一金-桃園",0,10,-10
"21131","6180橘子","110/08/02","玉山證券",10,0,10
"21132","6180橘子","110/08/02","凱基-東港",0,10,-10
"21133","6180橘子","110/08/02","富邦-羅東",8,1,7
"21134","6180橘子","110/08/02","元大-桃園",0,10,-10
"21135","6180橘子","110/08/02","元大證券",7,0,7
"21136","6180橘子","110/08/02","元大-館前",0,9,-9
"21137","6180橘子","110/08/02","元大-復北",7,0,7
"21138","6180橘子","110/08/02","台灣摩根士丹利",3,10,-7
"21139","6180橘子","110/08/02","華南永昌-長虹",6,0,6
"21140","6180橘子","110/08/02","光和-花壇",0,5,-5
"21141","6180橘子","110/08/02","元富-文心",5,0,5
"21142","6180橘子","110/08/02","玉山-嘉義",0,5,-5
"21143","6180橘子","110/08/02","台新-新莊",5,0,5
"21144","6180橘子","110/08/02","凱基-松山",0,5,-5
"21145","6180橘子","110/08/02","康和-嘉義",5,0,5
"21146","6180橘子","110/08/02","永豐金-員林",0,4,-4
"21147","6180橘子","110/08/02","凱基-興隆",5,0,5
"21148","6180橘子","110/08/02","元富-大裕",0,3,-3
"21149","6180橘子","110/08/02","華南永昌-楠梓",5,0,5
"21150","6180橘子","110/08/02","富邦-板橋",0,3,-3
"21151","2390云辰","110/08/02","摩根大通",1945,913,1032
"21152","2390云辰","110/08/02","華南永昌-鳳山",154,448,-294
"21153","2390云辰","110/08/02","富邦-陽明",118,11,107
"21154","2390云辰","110/08/02","群益金鼎-三重",1,168,-167
"21155","2390云辰","110/08/02","兆豐-三民",153,62,91
"21156","2390云辰","110/08/02","統一-內湖",5,102,-97
"21157","2390云辰","110/08/02","光和-嘉義",83,4,79
"21158","2390云辰","110/08/02","台新證券",235,320,-85
"21159","2390云辰","110/08/02","華南永昌-新莊",78,4,74
"21160","2390云辰","110/08/02","統一-新台中",8,87,-79
"21161","2390云辰","110/08/02","統一-城中",182,111,71
"21162","2390云辰","110/08/02","美商高盛",10,88,-78
"21163","2390云辰","110/08/02","台灣摩根士丹利",153,85,68
"21164","2390云辰","110/08/02","元大-汐止",57,130,-73
"21165","2390云辰","110/08/02","凱基-和平",115,47,68
"21166","2390云辰","110/08/02","港商野村",580,638,-58
"21167","2390云辰","110/08/02","華南永昌-公誠",75,13,62
"21168","2390云辰","110/08/02","元富-板橋",5,61,-56
"21169","2390云辰","110/08/02","永豐金-竹科",71,9,62
"21170","2390云辰","110/08/02","新加坡商瑞銀",11,66,-55
"21171","2390云辰","110/08/02","新光",160,100,60
"21172","2390云辰","110/08/02","元大-豐原",6,56,-50
"21173","2390云辰","110/08/02","凱基-岡山",61,1,60
"21174","2390云辰","110/08/02","元大-土城",5,55,-50
"21175","2390云辰","110/08/02","美林",254,195,59
"21176","2390云辰","110/08/02","凱基-站前",1,49,-48
"21177","2390云辰","110/08/02","凱基-大里",76,22,54
"21178","2390云辰","110/08/02","元大-中壢",6,54,-48
"21179","2390云辰","110/08/02","元大-鳳中",60,8,52
"21180","2390云辰","110/08/02","日盛證券",48,95,-47
"21181","1471首利","110/07/29","宏遠-光隆",35,0,35
"21182","1471首利","110/07/29","摩根大通",24,132,-108
"21183","1471首利","110/07/29","玉山-桃園",33,3,30
"21184","1471首利","110/07/29","台灣企銀-太平",0,60,-60
"21185","1471首利","110/07/29","富邦-台南",30,0,30
"21186","1471首利","110/07/29","元大-斗六",0,40,-40
"21187","1471首利","110/07/29","臺灣企銀-桃園",25,0,25
"21188","1471首利","110/07/29","元大-歸仁",0,23,-23
"21189","1471首利","110/07/29","元富-草屯",15,0,15
"21190","1471首利","110/07/29","日盛-永康",0,20,-20
"21191","1471首利","110/07/29","新光-桃園",15,0,15
"21192","1471首利","110/07/29","台中銀-員林",0,20,-20
"21193","1471首利","110/07/29","元大-博愛",15,2,13
"21194","1471首利","110/07/29","凱基-東門",0,14,-14
"21195","1471首利","110/07/29","臺銀-鳳山",12,0,12
"21196","1471首利","110/07/29","元大-草屯",1,15,-14
"21197","1471首利","110/07/29","元富-新莊",11,0,11
"21198","1471首利","110/07/29","元大-新竹經國",0,13,-13
"21199","1471首利","110/07/29","兆豐-來福",11,0,11
"21200","1471首利","110/07/29","日盛-土城",0,10,-10
"21201","1471首利","110/07/29","統一-新營",10,0,10
"21202","1471首利","110/07/29","美林",0,10,-10
"21203","1471首利","110/07/29","光和-溪湖",10,0,10
"21204","1471首利","110/07/29","永興-水湳",0,10,-10
"21205","1471首利","110/07/29","台新-左楠",10,0,10
"21206","1471首利","110/07/29","玉山證券",0,10,-10
"21207","1471首利","110/07/29","群益金鼎-台中",10,0,10
"21208","1471首利","110/07/29","群益金鼎-海山",2,12,-10
"21209","1471首利","110/07/29","凱基-內埔",10,0,10
"21210","1471首利","110/07/29","凱基-羅東",0,10,-10
"21211","2883開發金","110/07/29","國泰證券",2782,3,2779
"21212","2883開發金","110/07/29","永豐金證券",223,3618,-3395
"21213","2883開發金","110/07/29","凱基-台北",2299,284,2015
"21214","2883開發金","110/07/29","摩根大通",411,2625,-2214
"21215","2883開發金","110/07/29","第一金",1539,7,1532
"21216","2883開發金","110/07/29","台灣企銀",5,1717,-1712
"21217","2883開發金","110/07/29","港商野村",1983,585,1398
"21218","2883開發金","110/07/29","新加坡商瑞銀",843,2324,-1481
"21219","2883開發金","110/07/29","元富",1805,427,1378
"21220","2883開發金","110/07/29","港商麥格理",0,1129,-1129
"21221","2883開發金","110/07/29","台灣摩根士丹利",1634,398,1236
"21222","2883開發金","110/07/29","元大-學甲",1,953,-952
"21223","2883開發金","110/07/29","花旗環球",932,0,932
"21224","2883開發金","110/07/29","國票-博愛",100,1025,-925
"21225","2883開發金","110/07/29","凱基-敦北",590,5,585
"21226","2883開發金","110/07/29","國泰-館前",220,944,-724
"21227","2883開發金","110/07/29","國票-長城",506,4,502
"21228","2883開發金","110/07/29","兆豐-高雄",33,650,-617
"21229","2883開發金","110/07/29","港商法國興業",506,18,488
"21230","2883開發金","110/07/29","元富-緯城",1,513,-512
"21231","2883開發金","110/07/29","台新證券",753,287,466
"21232","2883開發金","110/07/29","美林",232,698,-466
"21233","2883開發金","110/07/29","元大-鳳中",495,71,424
"21234","2883開發金","110/07/29","元富-城中",50,513,-463
"21235","2883開發金","110/07/29","日茂",374,3,371
"21236","2883開發金","110/07/29","致和-崇德",0,404,-404
"21237","2883開發金","110/07/29","大和國泰",368,0,368
"21238","2883開發金","110/07/29","永豐金-板橋",123,506,-383
"21239","2883開發金","110/07/29","新光",603,243,360
"21240","2883開發金","110/07/29","中國信託-忠孝",100,423,-323
"21241","6205詮欣","110/07/29","臺銀-鳳山",31,0,31
"21242","6205詮欣","110/07/29","永豐金-敦南",0,53,-53
"21243","6205詮欣","110/07/29","摩根大通",16,2,14
"21244","6205詮欣","110/07/29","元大-土城學府",2,16,-14
"21245","6205詮欣","110/07/29","臺銀",10,0,10
"21246","6205詮欣","110/07/29","元富-潮州",0,11,-11
"21247","6205詮欣","110/07/29","日盛證券",10,0,10
"21248","6205詮欣","110/07/29","元大-清水",0,10,-10
"21249","6205詮欣","110/07/29","兆豐-新莊",10,0,10
"21250","6205詮欣","110/07/29","日盛-三重",0,7,-7
"21251","6205詮欣","110/07/29","元大-南屯",10,0,10
"21252","6205詮欣","110/07/29","日盛-屏東",0,6,-6
"21253","6205詮欣","110/07/29","富邦-建國",4,0,4
"21254","6205詮欣","110/07/29","華南永昌-公誠",0,5,-5
"21255","6205詮欣","110/07/29","富邦-南屯",4,0,4
"21256","6205詮欣","110/07/29","元大-南京",0,5,-5
"21257","6205詮欣","110/07/29","臺銀-臺中",3,0,3
"21258","6205詮欣","110/07/29","瑞士信貸",0,4,-4
"21259","6205詮欣","110/07/29","日盛-和美",3,0,3
"21260","6205詮欣","110/07/29","凱基-大安",0,4,-4
"21261","6205詮欣","110/07/29","德信-新營",3,0,3
"21262","6205詮欣","110/07/29","元大-大里德芳",0,4,-4
"21263","6205詮欣","110/07/29","兆豐-景美",3,0,3
"21264","6205詮欣","110/07/29","合庫-基隆",0,2,-2
"21265","6205詮欣","110/07/29","國票",3,0,3
"21266","6205詮欣","110/07/29","中國信託-永康",0,2,-2
"21267","6205詮欣","110/07/29","國票-南崁",3,0,3
"21268","6205詮欣","110/07/29","兆豐-小港",0,2,-2
"21269","6205詮欣","110/07/29","元大-蘆洲",3,0,3
"21270","6205詮欣","110/07/29","康和-台中",0,2,-2
"21271","1540喬福","110/07/29","高橋-龍潭",10,0,10
"21272","1540喬福","110/07/29","統一-新台中",0,19,-19
"21273","1540喬福","110/07/29","富邦-南屯",10,0,10
"21274","1540喬福","110/07/29","元富-大昌",0,10,-10
"21275","1540喬福","110/07/29","元大-斗六",5,0,5
"21276","1540喬福","110/07/29","大昌-新店",0,6,-6
"21277","1540喬福","110/07/29","兆豐-北高雄",3,0,3
"21278","1540喬福","110/07/29","凱基-台北",0,3,-3
"21279","1540喬福","110/07/29","元大-大安",3,0,3
"21280","1540喬福","110/07/29","台新-台中",0,2,-2
"21281","1540喬福","110/07/29","永豐金-台中",3,0,3
"21282","1540喬福","110/07/29","群益金鼎-嘉義",0,2,-2
"21283","1540喬福","110/07/29","臺銀-金山",2,0,2
"21284","1540喬福","110/07/29","凱基-天母",0,2,-2
"21285","1540喬福","110/07/29","日盛-士林",2,0,2
"21286","1540喬福","110/07/29","花旗環球",0,1,-1
"21287","1540喬福","110/07/29","元大-土城學府",2,0,2
"21288","1540喬福","110/07/29","第一金-大稻埕",0,1,-1
"21289","1540喬福","110/07/29","元大-南京",2,0,2
"21290","1540喬福","110/07/29","統一-嘉義",0,1,-1
"21291","1540喬福","110/07/29","臺銀-臺南",1,0,1
"21292","1540喬福","110/07/29","元富-中港",0,1,-1
"21293","1540喬福","110/07/29","第一金-台南",1,0,1
"21294","1540喬福","110/07/29","(牛牛牛)亞-網路",0,1,-1
"21295","1540喬福","110/07/29","台中銀-豐原",1,0,1
"21296","1540喬福","110/07/29","玉山-高雄",0,1,-1
"21297","1540喬福","110/07/29","中國信託-高雄",1,0,1
"21298","1540喬福","110/07/29","群益金鼎-台南",0,1,-1
"21299","1540喬福","110/07/29","兆豐-台中港",1,0,1
"21300","1540喬福","110/07/29","凱基-鳳山",0,1,-1
"21301","2888新光金","110/07/29","美商高盛",6409,110,6299
"21302","2888新光金","110/07/29","元大-忠孝鼎富",0,6714,-6714
"21303","2888新光金","110/07/29","台灣摩根士丹利",4583,443,4140
"21304","2888新光金","110/07/29","凱基-台北",5855,11898,-6043
"21305","2888新光金","110/07/29","元富-草屯",2193,2,2191
"21306","2888新光金","110/07/29","瑞士信貸",161,6090,-5929
"21307","2888新光金","110/07/29","華南永昌-南京",2059,21,2038
"21308","2888新光金","110/07/29","永豐金-萬盛",124,3599,-3475
"21309","2888新光金","110/07/29","凱基-市政",1558,0,1558
"21310","2888新光金","110/07/29","群益金鼎-大安",2,3306,-3304
"21311","2888新光金","110/07/29","法銀巴黎",1234,0,1234
"21312","2888新光金","110/07/29","凱基-復興",15,3015,-3000
"21313","2888新光金","110/07/29","永豐金-台中",1166,49,1117
"21314","2888新光金","110/07/29","新加坡商瑞銀",1429,4265,-2836
"21315","2888新光金","110/07/29","群益金鼎-崇德",1083,10,1073
"21316","2888新光金","110/07/29","凱基-大安",10,2564,-2554
"21317","2888新光金","110/07/29","兆豐-竹北",1002,29,973
"21318","2888新光金","110/07/29","中國信託",46,2012,-1966
"21319","2888新光金","110/07/29","美林",1767,804,963
"21320","2888新光金","110/07/29","群益金鼎-台北",10,1875,-1865
"21321","2888新光金","110/07/29","元大-三重",882,0,882
"21322","2888新光金","110/07/29","元富-城東",142,1856,-1714
"21323","2888新光金","110/07/29","元大-豐原站前",983,114,869
"21324","2888新光金","110/07/29","華南永昌-忠孝",10,1600,-1590
"21325","2888新光金","110/07/29","元大-北港",868,5,863
"21326","2888新光金","110/07/29","永豐金-信義",10,1497,-1487
"21327","2888新光金","110/07/29","合庫-台中",891,54,837
"21328","2888新光金","110/07/29","富邦-建國",350,1736,-1386
"21329","2888新光金","110/07/29","統一-汐止",725,14,711
"21330","2888新光金","110/07/29","富邦-新營",60,1402,-1342
"21331","1340勝悅","110/07/29","新光-新竹",18,0,18
"21332","1340勝悅","110/07/29","瑞士信貸",0,8,-8
"21333","1340勝悅","110/07/29","華南永昌-彰化",5,0,5
"21334","1340勝悅","110/07/29","台新證券",0,7,-7
"21335","1340勝悅","110/07/29","元大-六合",5,0,5
"21336","1340勝悅","110/07/29","元富-緯城",0,5,-5
"21337","1340勝悅","110/07/29","第一金-自由",4,0,4
"21338","1340勝悅","110/07/29","兆豐-南京",0,5,-5
"21339","1340勝悅","110/07/29","新光",4,0,4
"21340","1340勝悅","110/07/29","富邦-南屯",0,5,-5
"21341","1340勝悅","110/07/29","美商高盛",3,0,3
"21342","1340勝悅","110/07/29","元富-安南",0,4,-4
"21343","1340勝悅","110/07/29","元富-彰化",3,0,3
"21344","1340勝悅","110/07/29","兆豐-三民",0,4,-4
"21345","1340勝悅","110/07/29","大昌",2,0,2
"21346","1340勝悅","110/07/29","兆豐-松德",0,4,-4
"21347","1340勝悅","110/07/29","兆豐-大安",2,0,2
"21348","1340勝悅","110/07/29","國票-台中",0,4,-4
"21349","1340勝悅","110/07/29","摩根大通",2,0,2
"21350","1340勝悅","110/07/29","第一金-路竹",0,3,-3
"21351","1340勝悅","110/07/29","新光-台中",2,0,2
"21352","1340勝悅","110/07/29","統一-城中",2,4,-2
"21353","1340勝悅","110/07/29","凱基-八德",2,0,2
"21354","1340勝悅","110/07/29","元富-同大",0,2,-2
"21355","1340勝悅","110/07/29","合庫-高雄",1,0,1
"21356","1340勝悅","110/07/29","台新-高雄",0,2,-2
"21357","1340勝悅","110/07/29","日進",1,0,1
"21358","1340勝悅","110/07/29","凱基-北門",0,2,-2
"21359","1340勝悅","110/07/29","新光-台南",1,0,1
"21360","1340勝悅","110/07/29","元大-汐止",0,2,-2
"21361","6246臺龍","110/07/29","港商野村",38,1,37
"21362","6246臺龍","110/07/29","玉山-台南",0,27,-27
"21363","6246臺龍","110/07/29","凱基-幸福",25,0,25
"21364","6246臺龍","110/07/29","國泰-忠孝",0,25,-25
"21365","6246臺龍","110/07/29","亞東-板橋",16,0,16
"21366","6246臺龍","110/07/29","光和",0,21,-21
"21367","6246臺龍","110/07/29","元大-台中",10,0,10
"21368","6246臺龍","110/07/29","第一金-安和",0,20,-20
"21369","6246臺龍","110/07/29","兆豐-松德",9,0,9
"21370","6246臺龍","110/07/29","兆豐-竹北",5,25,-20
"21371","6246臺龍","110/07/29","兆豐-公益",8,0,8
"21372","6246臺龍","110/07/29","元大-大里",0,20,-20
"21373","6246臺龍","110/07/29","華南永昌",7,0,7
"21374","6246臺龍","110/07/29","台新-台南",0,15,-15
"21375","6246臺龍","110/07/29","日盛-斗六",6,0,6
"21376","6246臺龍","110/07/29","永豐金-羅東",2,15,-13
"21377","6246臺龍","110/07/29","元富-中港",6,0,6
"21378","6246臺龍","110/07/29","元大-博愛",1,10,-9
"21379","6246臺龍","110/07/29","台新證券",8,2,6
"21380","6246臺龍","110/07/29","宏遠-台中",0,5,-5
"21381","6246臺龍","110/07/29","臺銀-臺中",5,0,5
"21382","6246臺龍","110/07/29","台新-左楠",0,5,-5
"21383","6246臺龍","110/07/29","元富-宜蘭",5,0,5
"21384","6246臺龍","110/07/29","中農",0,5,-5
"21385","6246臺龍","110/07/29","德信-新營",5,0,5
"21386","6246臺龍","110/07/29","群益金鼎-竹南",0,5,-5
"21387","6246臺龍","110/07/29","新光-新竹",5,0,5
"21388","6246臺龍","110/07/29","凱基-科園",0,5,-5
"21389","6246臺龍","110/07/29","國泰-敦南",10,5,5
"21390","6246臺龍","110/07/29","日盛-宜蘭",1,5,-4
"21391","00715L期街口布蘭特正2","110/07/29","永豐金證券",2129,2,2127
"21392","00715L期街口布蘭特正2","110/07/29","國票-博愛",55,702,-647
"21393","00715L期街口布蘭特正2","110/07/29","元大證券",1918,115,1803
"21394","00715L期街口布蘭特正2","110/07/29","富邦-彰化",0,605,-605
"21395","00715L期街口布蘭特正2","110/07/29","統一",1050,313,737
"21396","00715L期街口布蘭特正2","110/07/29","元大-前金",0,440,-440
"21397","00715L期街口布蘭特正2","110/07/29","港商野村",821,263,558
"21398","00715L期街口布蘭特正2","110/07/29","群益金鼎-崇德",0,340,-340
"21399","00715L期街口布蘭特正2","110/07/29","永豐金-內湖",500,0,500
"21400","00715L期街口布蘭特正2","110/07/29","元富-板橋",7,330,-323
"21401","00715L期街口布蘭特正2","110/07/29","元富-大裕",505,23,482
"21402","00715L期街口布蘭特正2","110/07/29","元大-三重",3,200,-197
"21403","00715L期街口布蘭特正2","110/07/29","國票-台中",276,0,276
"21404","00715L期街口布蘭特正2","110/07/29","凱基-東勢",5,194,-189
"21405","00715L期街口布蘭特正2","110/07/29","統一-高雄",300,118,182
"21406","00715L期街口布蘭特正2","110/07/29","富邦-台北",0,181,-181
"21407","00715L期街口布蘭特正2","110/07/29","群益金鼎-瑞豐",180,0,180
"21408","00715L期街口布蘭特正2","110/07/29","大慶-中和",0,174,-174
"21409","00715L期街口布蘭特正2","110/07/29","元大-南崁",128,0,128
"21410","00715L期街口布蘭特正2","110/07/29","永豐金-萬盛",0,153,-153
"21411","00715L期街口布蘭特正2","110/07/29","大慶-蘆洲",106,0,106
"21412","00715L期街口布蘭特正2","110/07/29","元大-開元",0,151,-151
"21413","00715L期街口布蘭特正2","110/07/29","統一-中壢",100,0,100
"21414","00715L期街口布蘭特正2","110/07/29","日盛-新竹",0,126,-126
"21415","00715L期街口布蘭特正2","110/07/29","第一金-自由",100,2,98
"21416","00715L期街口布蘭特正2","110/07/29","凱基-豐中",0,123,-123
"21417","00715L期街口布蘭特正2","110/07/29","華南永昌-內壢",100,2,98
"21418","00715L期街口布蘭特正2","110/07/29","元大-東泰",0,122,-122
"21419","00715L期街口布蘭特正2","110/07/29","永豐金-板橋",98,0,98
"21420","00715L期街口布蘭特正2","110/07/29","台新-高雄",0,121,-121
"21421","8941關中","110/07/29","富邦-仁愛",1,0,1
"21422","8941關中","110/07/29","富邦-員林",0,1,-1
"21423","8941關中","110/07/29","康和-板橋",0,0,0
"21424","8941關中","110/07/29","康和-板橋",0,0,0
"21425","8941關中","110/07/29","玉山證券",0,0,0
"21426","8941關中","110/07/29","玉山證券",0,0,0
"21427","8941關中","110/07/29","玉山-數位",0,0,0
"21428","8941關中","110/07/29","玉山-數位",0,0,0
"21429","8941關中","110/07/29","凱基-市府",0,0,0
"21430","8941關中","110/07/29","凱基-市府",0,0,0
"21431","8941關中","110/07/29","元大-鶯歌",0,0,0
"21432","8941關中","110/07/29","元大-鶯歌",0,0,0
"21433","8941關中","110/07/29","元大-花蓮",0,0,0
"21434","8941關中","110/07/29","元大-花蓮",0,0,0
"21435","8941關中","110/07/29","",NA,NA,NA
"21436","8941關中","110/07/29","",NA,NA,NA
"21437","8941關中","110/07/29","",NA,NA,NA
"21438","8941關中","110/07/29","",NA,NA,NA
"21439","8941關中","110/07/29","",NA,NA,NA
"21440","8941關中","110/07/29","",NA,NA,NA
"21441","8941關中","110/07/29","",NA,NA,NA
"21442","8941關中","110/07/29","",NA,NA,NA
"21443","8941關中","110/07/29","",NA,NA,NA
"21444","8941關中","110/07/29","",NA,NA,NA
"21445","8941關中","110/07/29","",NA,NA,NA
"21446","8941關中","110/07/29","",NA,NA,NA
"21447","8941關中","110/07/29","",NA,NA,NA
"21448","8941關中","110/07/29","",NA,NA,NA
"21449","8941關中","110/07/29","",NA,NA,NA
"21450","8941關中","110/07/29","",NA,NA,NA
"21451","8936國統","110/07/29","新加坡商瑞銀",89,19,70
"21452","8936國統","110/07/29","日盛-忠孝",11,135,-124
"21453","8936國統","110/07/29","瑞士信貸",55,3,52
"21454","8936國統","110/07/29","元富-敦南",0,80,-80
"21455","8936國統","110/07/29","凱基-台北",48,3,45
"21456","8936國統","110/07/29","康和",0,20,-20
"21457","8936國統","110/07/29","摩根大通",97,60,37
"21458","8936國統","110/07/29","元大-竹科",0,20,-20
"21459","8936國統","110/07/29","美林",27,2,25
"21460","8936國統","110/07/29","永豐金-桃園",0,19,-19
"21461","8936國統","110/07/29","凱基-三多",25,0,25
"21462","8936國統","110/07/29","群益金鼎-高盛",0,14,-14
"21463","8936國統","110/07/29","凱基-北門",27,2,25
"21464","8936國統","110/07/29","元富-安南",2,15,-13
"21465","8936國統","110/07/29","兆豐-桃鶯",30,10,20
"21466","8936國統","110/07/29","富邦-內湖",2,15,-13
"21467","8936國統","110/07/29","永豐金-台中",20,0,20
"21468","8936國統","110/07/29","元大-復北",0,11,-11
"21469","8936國統","110/07/29","台灣摩根士丹利",30,12,18
"21470","8936國統","110/07/29","合庫-鳳山",0,10,-10
"21471","8936國統","110/07/29","兆豐-大同",15,0,15
"21472","8936國統","110/07/29","元富-潮州",0,10,-10
"21473","8936國統","110/07/29","新光-台中",39,24,15
"21474","8936國統","110/07/29","群益金鼎-台北",0,10,-10
"21475","8936國統","110/07/29","兆豐-新營",10,0,10
"21476","8936國統","110/07/29","凱基-高雄",20,30,-10
"21477","8936國統","110/07/29","台新-高雄",10,0,10
"21478","8936國統","110/07/29","富邦-桃園",0,10,-10
"21479","8936國統","110/07/29","玉山-士林",10,0,10
"21480","8936國統","110/07/29","新光",1,10,-9
"21481","6226光鼎","110/07/29","台新-台中",396,46,350
"21482","6226光鼎","110/07/29","群益金鼎-東大",11,309,-298
"21483","6226光鼎","110/07/29","元富-永和",242,0,242
"21484","6226光鼎","110/07/29","日盛證券",2,176,-174
"21485","6226光鼎","110/07/29","永豐金-古亭",200,0,200
"21486","6226光鼎","110/07/29","國泰-敦南",90,197,-107
"21487","6226光鼎","110/07/29","華南永昌",216,46,170
"21488","6226光鼎","110/07/29","元大-雙和",16,111,-95
"21489","6226光鼎","110/07/29","國票-北高雄",188,36,152
"21490","6226光鼎","110/07/29","元大-大統",2,94,-92
"21491","6226光鼎","110/07/29","國票-台南",120,4,116
"21492","6226光鼎","110/07/29","元大-板橋",5,78,-73
"21493","6226光鼎","110/07/29","永豐金證券",101,3,98
"21494","6226光鼎","110/07/29","群益金鼎-萬華",46,111,-65
"21495","6226光鼎","110/07/29","富邦-建國",125,28,97
"21496","6226光鼎","110/07/29","華南永昌-竹北",1,60,-59
"21497","6226光鼎","110/07/29","群益金鼎-土城",94,9,85
"21498","6226光鼎","110/07/29","玉山證券",28,86,-58
"21499","6226光鼎","110/07/29","元富-四維",82,4,78
"21500","6226光鼎","110/07/29","元大-土城學府",13,68,-55
"21501","6226光鼎","110/07/29","元大-鳳中",69,15,54
"21502","6226光鼎","110/07/29","元大-豐原",5,59,-54
"21503","6226光鼎","110/07/29","台新-新莊",54,1,53
"21504","6226光鼎","110/07/29","統一",56,107,-51
"21505","6226光鼎","110/07/29","中國信託-新竹",63,13,50
"21506","6226光鼎","110/07/29","統一-內湖",0,48,-48
"21507","6226光鼎","110/07/29","群益金鼎-士林",50,0,50
"21508","6226光鼎","110/07/29","元大-東港",2,50,-48
"21509","6226光鼎","110/07/29","台新-高雄",125,80,45
"21510","6226光鼎","110/07/29","元大-太平",1,46,-45
"21511","2363矽統","110/07/29","凱基-台北",2235,1238,997
"21512","2363矽統","110/07/29","康和-台中",10,437,-427
"21513","2363矽統","110/07/29","摩根大通",1784,793,991
"21514","2363矽統","110/07/29","第一金-新興",11,310,-299
"21515","2363矽統","110/07/29","港商野村",1833,1300,533
"21516","2363矽統","110/07/29","瑞士信貸",9,190,-181
"21517","2363矽統","110/07/29","美林",652,288,364
"21518","2363矽統","110/07/29","台新證券",659,808,-149
"21519","2363矽統","110/07/29","元大-台中",376,38,338
"21520","2363矽統","110/07/29","元大-萬華",42,189,-147
"21521","2363矽統","110/07/29","新加坡商瑞銀",748,474,274
"21522","2363矽統","110/07/29","台新-左楠",26,171,-145
"21523","2363矽統","110/07/29","國泰-敦南",566,333,233
"21524","2363矽統","110/07/29","華南永昌-鳳山",116,241,-125
"21525","2363矽統","110/07/29","元大-旗山",299,66,233
"21526","2363矽統","110/07/29","永全-南崁",0,117,-117
"21527","2363矽統","110/07/29","美商高盛",600,433,167
"21528","2363矽統","110/07/29","群益金鼎-桃園",25,131,-106
"21529","2363矽統","110/07/29","元大-永和",146,12,134
"21530","2363矽統","110/07/29","宏遠-新化",3,103,-100
"21531","2363矽統","110/07/29","元大證券",137,9,128
"21532","2363矽統","110/07/29","新光",331,429,-98
"21533","2363矽統","110/07/29","永豐金-彰化",135,10,125
"21534","2363矽統","110/07/29","中國信託-忠孝",101,188,-87
"21535","2363矽統","110/07/29","北城證券",139,19,120
"21536","2363矽統","110/07/29","群益金鼎-建成",11,95,-84
"21537","2363矽統","110/07/29","富邦-高雄",153,34,119
"21538","2363矽統","110/07/29","群益金鼎-三民",23,105,-82
"21539","2363矽統","110/07/29","元大-蘆洲",120,19,101
"21540","2363矽統","110/07/29","元大-豐原",104,186,-82
"21541","8112至上","110/07/29","合庫證券",194,1,193
"21542","8112至上","110/07/29","摩根大通",4,424,-420
"21543","8112至上","110/07/29","美商高盛",154,5,149
"21544","8112至上","110/07/29","日盛-高雄",2,400,-398
"21545","8112至上","110/07/29","永豐金證券",144,0,144
"21546","8112至上","110/07/29","港商法國興業",0,374,-374
"21547","8112至上","110/07/29","新光-台中",123,12,111
"21548","8112至上","110/07/29","凱基-台北",50,312,-262
"21549","8112至上","110/07/29","新加坡商瑞銀",189,83,106
"21550","8112至上","110/07/29","美林",69,232,-163
"21551","8112至上","110/07/29","華南永昌-新莊",73,0,73
"21552","8112至上","110/07/29","兆豐-公益",0,120,-120
"21553","8112至上","110/07/29","新光",108,49,59
"21554","8112至上","110/07/29","瑞士信貸",1,109,-108
"21555","8112至上","110/07/29","元富-文心",45,3,42
"21556","8112至上","110/07/29","華南永昌-小港",4,30,-26
"21557","8112至上","110/07/29","華南永昌-林口",41,0,41
"21558","8112至上","110/07/29","富邦-中壢",1,24,-23
"21559","8112至上","110/07/29","港商野村",146,112,34
"21560","8112至上","110/07/29","元大-歸仁",2,24,-22
"21561","8112至上","110/07/29","臺銀-高雄",30,0,30
"21562","8112至上","110/07/29","華南永昌-麻豆",0,21,-21
"21563","8112至上","110/07/29","元富-佳里",30,0,30
"21564","8112至上","110/07/29","台新-松江",0,20,-20
"21565","8112至上","110/07/29","永豐金-內湖",30,1,29
"21566","8112至上","110/07/29","元大-新莊",1,20,-19
"21567","8112至上","110/07/29","台新-新營",31,3,28
"21568","8112至上","110/07/29","華南永昌-岡山",1,19,-18
"21569","8112至上","110/07/29","永豐金-彰化",27,0,27
"21570","8112至上","110/07/29","元大-崇德",3,20,-17
"21571","1570力肯","110/07/29","群益金鼎-高雄",20,0,20
"21572","1570力肯","110/07/29","聯邦-興中",0,17,-17
"21573","1570力肯","110/07/29","群益金鼎-板橋",16,0,16
"21574","1570力肯","110/07/29","富邦-建國",0,10,-10
"21575","1570力肯","110/07/29","統一-敦南",5,0,5
"21576","1570力肯","110/07/29","凱基-站前",0,5,-5
"21577","1570力肯","110/07/29","元富-松德",4,0,4
"21578","1570力肯","110/07/29","國泰-板橋",0,4,-4
"21579","1570力肯","110/07/29","元大-和平",4,0,4
"21580","1570力肯","110/07/29","統一-土城",0,3,-3
"21581","1570力肯","110/07/29","凱基-幸福",3,0,3
"21582","1570力肯","110/07/29","凱基-大里",0,3,-3
"21583","1570力肯","110/07/29","華南永昌-鳳山",3,0,3
"21584","1570力肯","110/07/29","凱基-台北",0,3,-3
"21585","1570力肯","110/07/29","元大-北港",4,2,2
"21586","1570力肯","110/07/29","元大-屏東民生",0,3,-3
"21587","1570力肯","110/07/29","美林",1,0,1
"21588","1570力肯","110/07/29","元富-緯城",0,2,-2
"21589","1570力肯","110/07/29","國泰-台南",1,0,1
"21590","1570力肯","110/07/29","台新-高雄",0,2,-2
"21591","1570力肯","110/07/29","元大-歸仁",1,0,1
"21592","1570力肯","110/07/29","華南永昌-楠梓",0,2,-2
"21593","1570力肯","110/07/29","元大-松山",1,0,1
"21594","1570力肯","110/07/29","元大-北成功",0,2,-2
"21595","1570力肯","110/07/29","元大-文心興安",1,0,1
"21596","1570力肯","110/07/29","元大-板橋",0,2,-2
"21597","1570力肯","110/07/29","元大-東蘆",1,0,1
"21598","1570力肯","110/07/29","統一-台南",0,1,-1
"21599","1570力肯","110/07/29","群益金鼎-鳳山",0,0,0
"21600","1570力肯","110/07/29","台新證券",0,1,-1
"21601","2929淘帝","110/07/29","新光-新竹",118,13,105
"21602","2929淘帝","110/07/29","元富-敦南",0,91,-91
"21603","2929淘帝","110/07/29","新加坡商瑞銀",56,0,56
"21604","2929淘帝","110/07/29","日盛-板橋中山",0,38,-38
"21605","2929淘帝","110/07/29","凱基-台北",39,4,35
"21606","2929淘帝","110/07/29","群益金鼎-士林",0,20,-20
"21607","2929淘帝","110/07/29","元大-民生",29,0,29
"21608","2929淘帝","110/07/29","華南永昌-敦南",0,20,-20
"21609","2929淘帝","110/07/29","美林",37,9,28
"21610","2929淘帝","110/07/29","高橋-龍潭",3,20,-17
"21611","2929淘帝","110/07/29","元大-承德",15,0,15
"21612","2929淘帝","110/07/29","凱基-中山",4,19,-15
"21613","2929淘帝","110/07/29","第一金-台南",10,0,10
"21614","2929淘帝","110/07/29","富邦-台北",0,15,-15
"21615","2929淘帝","110/07/29","富邦-桃園",9,0,9
"21616","2929淘帝","110/07/29","元富-台中",0,14,-14
"21617","2929淘帝","110/07/29","港商野村",17,10,7
"21618","2929淘帝","110/07/29","台新-建北",0,13,-13
"21619","2929淘帝","110/07/29","台中銀-豐原",6,0,6
"21620","2929淘帝","110/07/29","永豐金-敦南",0,12,-12
"21621","2929淘帝","110/07/29","元大-文心興安",6,0,6
"21622","2929淘帝","110/07/29","新光-台南",0,11,-11
"21623","2929淘帝","110/07/29","德信-新營",5,0,5
"21624","2929淘帝","110/07/29","宏遠-光隆",0,10,-10
"21625","2929淘帝","110/07/29","元大-博愛",5,0,5
"21626","2929淘帝","110/07/29","元大-嘉義",0,6,-6
"21627","2929淘帝","110/07/29","元大-員林",5,0,5
"21628","2929淘帝","110/07/29","日茂-南投",0,5,-5
"21629","2929淘帝","110/07/29","富邦-中壢",4,0,4
"21630","2929淘帝","110/07/29","新光",0,5,-5
"21631","5410國眾","110/07/29","兆豐-城中",32,0,32
"21632","5410國眾","110/07/29","第一金-台南",0,51,-51
"21633","5410國眾","110/07/29","新加坡商瑞銀",19,0,19
"21634","5410國眾","110/07/29","元富-大昌",0,13,-13
"21635","5410國眾","110/07/29","華南永昌-新莊",16,0,16
"21636","5410國眾","110/07/29","臺銀-臺南",0,12,-12
"21637","5410國眾","110/07/29","元大-小港",11,0,11
"21638","5410國眾","110/07/29","日盛-木柵",0,10,-10
"21639","5410國眾","110/07/29","臺銀",10,0,10
"21640","5410國眾","110/07/29","元富-安南",0,10,-10
"21641","5410國眾","110/07/29","臺銀-臺中",10,0,10
"21642","5410國眾","110/07/29","新光",4,13,-9
"21643","5410國眾","110/07/29","宏遠-館前",10,0,10
"21644","5410國眾","110/07/29","永豐金-屏東",0,5,-5
"21645","5410國眾","110/07/29","台新-中壢",10,0,10
"21646","5410國眾","110/07/29","永豐金-苓雅",0,5,-5
"21647","5410國眾","110/07/29","摩根大通",10,1,9
"21648","5410國眾","110/07/29","國票-台南",0,4,-4
"21649","5410國眾","110/07/29","元大-北投",9,0,9
"21650","5410國眾","110/07/29","永豐金-埔里",0,4,-4
"21651","5410國眾","110/07/29","台新證券",7,1,6
"21652","5410國眾","110/07/29","光和",0,3,-3
"21653","5410國眾","110/07/29","元富-新竹",5,0,5
"21654","5410國眾","110/07/29","凱基-汐止",0,3,-3
"21655","5410國眾","110/07/29","凱基-竹北",5,0,5
"21656","5410國眾","110/07/29","元大-善化",0,3,-3
"21657","5410國眾","110/07/29","永豐金-敦南",5,1,4
"21658","5410國眾","110/07/29","元大-員林",0,3,-3
"21659","5410國眾","110/07/29","美林",4,1,3
"21660","5410國眾","110/07/29","永豐金-台南",0,3,-3
"21661","2841台開","110/07/29","兆豐-台南",237,0,237
"21662","2841台開","110/07/29","元大-四維",0,184,-184
"21663","2841台開","110/07/29","永豐金-敦南",60,10,50
"21664","2841台開","110/07/29","玉山-新竹",0,145,-145
"21665","2841台開","110/07/29","永豐金-板新",50,0,50
"21666","2841台開","110/07/29","港商野村",0,124,-124
"21667","2841台開","110/07/29","華南永昌-南京",45,2,43
"21668","2841台開","110/07/29","永豐金-台南",0,32,-32
"21669","2841台開","110/07/29","群益金鼎-崇德",23,0,23
"21670","2841台開","110/07/29","華南永昌-公誠",0,23,-23
"21671","2841台開","110/07/29","日盛-園區",20,0,20
"21672","2841台開","110/07/29","元大-善化",0,22,-22
"21673","2841台開","110/07/29","台新-台中",20,0,20
"21674","2841台開","110/07/29","元大-豐原",0,20,-20
"21675","2841台開","110/07/29","華南永昌-新莊",20,0,20
"21676","2841台開","110/07/29","凱基-台北",0,15,-15
"21677","2841台開","110/07/29","富邦-仁愛",20,0,20
"21678","2841台開","110/07/29","富邦-台北",0,15,-15
"21679","2841台開","110/07/29","新光",15,0,15
"21680","2841台開","110/07/29","臺銀",0,10,-10
"21681","2841台開","110/07/29","華南永昌-台中",15,0,15
"21682","2841台開","110/07/29","元富-三重",0,10,-10
"21683","2841台開","110/07/29","凱基-彰化",13,0,13
"21684","2841台開","110/07/29","元大-林森",0,10,-10
"21685","2841台開","110/07/29","兆豐-台中",10,0,10
"21686","2841台開","110/07/29","光和-花壇",0,9,-9
"21687","2841台開","110/07/29","永豐金-松山",10,0,10
"21688","2841台開","110/07/29","國泰-桃園",1,10,-9
"21689","2841台開","110/07/29","國泰-館前",9,0,9
"21690","2841台開","110/07/29","玉山-嘉義",0,8,-8
"21691","6207雷科","110/07/29","永豐金-古亭",100,0,100
"21692","6207雷科","110/07/29","摩根大通",59,151,-92
"21693","6207雷科","110/07/29","國泰-館前",52,6,46
"21694","6207雷科","110/07/29","凱基-高雄",0,82,-82
"21695","6207雷科","110/07/29","新加坡商瑞銀",41,12,29
"21696","6207雷科","110/07/29","元大-松江",0,25,-25
"21697","6207雷科","110/07/29","大慶-蘆洲",29,6,23
"21698","6207雷科","110/07/29","元大-雙和",2,25,-23
"21699","6207雷科","110/07/29","永豐金-羅東",21,0,21
"21700","6207雷科","110/07/29","港商野村",16,36,-20
"21701","6207雷科","110/07/29","統一-南京",16,0,16
"21702","6207雷科","110/07/29","盈溢-楠梓",0,20,-20
"21703","6207雷科","110/07/29","凱基-台北",45,29,16
"21704","6207雷科","110/07/29","統一",2,20,-18
"21705","6207雷科","110/07/29","富邦-敦南",16,0,16
"21706","6207雷科","110/07/29","日盛-新竹",1,16,-15
"21707","6207雷科","110/07/29","統一-高雄",15,0,15
"21708","6207雷科","110/07/29","康和-台中",0,15,-15
"21709","6207雷科","110/07/29","台新-中壢",11,0,11
"21710","6207雷科","110/07/29","凱基-竹科",0,13,-13
"21711","6207雷科","110/07/29","台灣企銀-竹北",10,0,10
"21712","6207雷科","110/07/29","元大-鳳中",0,12,-12
"21713","6207雷科","110/07/29","宏遠證券",10,0,10
"21714","6207雷科","110/07/29","元大-土城",0,12,-12
"21715","6207雷科","110/07/29","中國信託-忠孝",10,0,10
"21716","6207雷科","110/07/29","華南永昌-高雄",0,11,-11
"21717","6207雷科","110/07/29","大昌-桃園",11,1,10
"21718","6207雷科","110/07/29","元大-木柵",0,10,-10
"21719","6207雷科","110/07/29","玉山-城中",11,1,10
"21720","6207雷科","110/07/29","日盛-板橋",1,10,-9
"21721","3679新至陞","110/07/29","華南永昌-淡水",5,0,5
"21722","3679新至陞","110/07/29","元富-板橋",0,16,-16
"21723","3679新至陞","110/07/29","富邦-新竹華信",5,0,5
"21724","3679新至陞","110/07/29","凱基-台北",0,8,-8
"21725","3679新至陞","110/07/29","永豐金-中和",5,0,5
"21726","3679新至陞","110/07/29","摩根大通",1,6,-5
"21727","3679新至陞","110/07/29","富邦-台北",4,0,4
"21728","3679新至陞","110/07/29","美林",0,4,-4
"21729","3679新至陞","110/07/29","元富-彰化",2,0,2
"21730","3679新至陞","110/07/29","瑞士信貸",0,4,-4
"21731","3679新至陞","110/07/29","兆豐-台中港",2,0,2
"21732","3679新至陞","110/07/29","元大-成功",0,3,-3
"21733","3679新至陞","110/07/29","富邦-三重",2,0,2
"21734","3679新至陞","110/07/29","統一-台南",0,2,-2
"21735","3679新至陞","110/07/29","元大-沙鹿",2,0,2
"21736","3679新至陞","110/07/29","元富-新興",0,2,-2
"21737","3679新至陞","110/07/29","元大-福營",2,0,2
"21738","3679新至陞","110/07/29","凱基-竹科",0,2,-2
"21739","3679新至陞","110/07/29","元大-花蓮",2,0,2
"21740","3679新至陞","110/07/29","元大證券",0,2,-2
"21741","3679新至陞","110/07/29","元大-板橋",2,0,2
"21742","3679新至陞","110/07/29","日盛-北高雄",0,1,-1
"21743","3679新至陞","110/07/29","永豐金-台南",2,0,2
"21744","3679新至陞","110/07/29","宏遠-高雄",0,1,-1
"21745","3679新至陞","110/07/29","合庫-彰化",1,0,1
"21746","3679新至陞","110/07/29","花旗環球",0,1,-1
"21747","3679新至陞","110/07/29","臺銀-臺南",1,0,1
"21748","3679新至陞","110/07/29","華南永昌-岡山",0,1,-1
"21749","3679新至陞","110/07/29","永興-水湳",1,0,1
"21750","3679新至陞","110/07/29","元大-佳里",0,1,-1
"21751","2727王品","110/07/29","第一金",30,0,30
"21752","2727王品","110/07/29","元大-高雄",1,93,-92
"21753","2727王品","110/07/29","港商麥格理",22,0,22
"21754","2727王品","110/07/29","新加坡商瑞銀",5,82,-77
"21755","2727王品","110/07/29","國票-北高雄",24,2,22
"21756","2727王品","110/07/29","美林",0,27,-27
"21757","2727王品","110/07/29","日盛-忠孝",21,0,21
"21758","2727王品","110/07/29","港商野村",21,48,-27
"21759","2727王品","110/07/29","新光",22,3,19
"21760","2727王品","110/07/29","凱基-台北",43,61,-18
"21761","2727王品","110/07/29","國泰-敦南",18,7,11
"21762","2727王品","110/07/29","華南永昌-麻豆",0,18,-18
"21763","2727王品","110/07/29","凱基-五股",11,0,11
"21764","2727王品","110/07/29","國泰-台中",2,17,-15
"21765","2727王品","110/07/29","兆豐-鹿港",12,2,10
"21766","2727王品","110/07/29","永豐金-桃盛",0,15,-15
"21767","2727王品","110/07/29","凱基-埔墘",10,0,10
"21768","2727王品","110/07/29","美商高盛",1,15,-14
"21769","2727王品","110/07/29","永豐金-潮州",10,0,10
"21770","2727王品","110/07/29","玉山證券",4,15,-11
"21771","2727王品","110/07/29","統一",12,4,8
"21772","2727王品","110/07/29","摩根大通",12,22,-10
"21773","2727王品","110/07/29","國泰-板橋",7,0,7
"21774","2727王品","110/07/29","元大-四維",2,12,-10
"21775","2727王品","110/07/29","彰銀-台中",7,1,6
"21776","2727王品","110/07/29","凱基-興隆",0,9,-9
"21777","2727王品","110/07/29","新光-高雄",12,6,6
"21778","2727王品","110/07/29","瑞士信貸",0,8,-8
"21779","2727王品","110/07/29","玉山-數位",6,0,6
"21780","2727王品","110/07/29","大昌-桃園",0,7,-7
"21781","1570力肯","110/07/29","群益金鼎-高雄",20,0,20
"21782","1570力肯","110/07/29","聯邦-興中",0,17,-17
"21783","1570力肯","110/07/29","群益金鼎-板橋",16,0,16
"21784","1570力肯","110/07/29","富邦-建國",0,10,-10
"21785","1570力肯","110/07/29","統一-敦南",5,0,5
"21786","1570力肯","110/07/29","凱基-站前",0,5,-5
"21787","1570力肯","110/07/29","元富-松德",4,0,4
"21788","1570力肯","110/07/29","國泰-板橋",0,4,-4
"21789","1570力肯","110/07/29","元大-和平",4,0,4
"21790","1570力肯","110/07/29","統一-土城",0,3,-3
"21791","1570力肯","110/07/29","凱基-幸福",3,0,3
"21792","1570力肯","110/07/29","凱基-大里",0,3,-3
"21793","1570力肯","110/07/29","華南永昌-鳳山",3,0,3
"21794","1570力肯","110/07/29","凱基-台北",0,3,-3
"21795","1570力肯","110/07/29","元大-北港",4,2,2
"21796","1570力肯","110/07/29","元大-屏東民生",0,3,-3
"21797","1570力肯","110/07/29","美林",1,0,1
"21798","1570力肯","110/07/29","元富-緯城",0,2,-2
"21799","1570力肯","110/07/29","國泰-台南",1,0,1
"21800","1570力肯","110/07/29","台新-高雄",0,2,-2
"21801","1570力肯","110/07/29","元大-歸仁",1,0,1
"21802","1570力肯","110/07/29","華南永昌-楠梓",0,2,-2
"21803","1570力肯","110/07/29","元大-松山",1,0,1
"21804","1570力肯","110/07/29","元大-北成功",0,2,-2
"21805","1570力肯","110/07/29","元大-文心興安",1,0,1
"21806","1570力肯","110/07/29","元大-板橋",0,2,-2
"21807","1570力肯","110/07/29","元大-東蘆",1,0,1
"21808","1570力肯","110/07/29","統一-台南",0,1,-1
"21809","1570力肯","110/07/29","群益金鼎-鳳山",0,0,0
"21810","1570力肯","110/07/29","台新證券",0,1,-1
"21811","6180橘子","110/07/29","凱基-台北",50,4,46
"21812","6180橘子","110/07/29","兆豐證券",0,95,-95
"21813","6180橘子","110/07/29","花旗環球",25,0,25
"21814","6180橘子","110/07/29","香港上海匯豐",0,74,-74
"21815","6180橘子","110/07/29","瑞士信貸",26,2,24
"21816","6180橘子","110/07/29","福勝",0,24,-24
"21817","6180橘子","110/07/29","兆豐-大同",20,0,20
"21818","6180橘子","110/07/29","第一金-安和",0,20,-20
"21819","6180橘子","110/07/29","新光-台中",17,0,17
"21820","6180橘子","110/07/29","永豐金-敦北",0,18,-18
"21821","6180橘子","110/07/29","元大-南屯",15,0,15
"21822","6180橘子","110/07/29","致和-崇德",0,10,-10
"21823","6180橘子","110/07/29","摩根大通",54,40,14
"21824","6180橘子","110/07/29","玉山-台大",0,10,-10
"21825","6180橘子","110/07/29","玉山-桃園",10,0,10
"21826","6180橘子","110/07/29","元大-四維",0,10,-10
"21827","6180橘子","110/07/29","永豐金-中正",10,0,10
"21828","6180橘子","110/07/29","元大-小港",0,8,-8
"21829","6180橘子","110/07/29","元富-三重",8,0,8
"21830","6180橘子","110/07/29","台灣摩根士丹利",7,13,-6
"21831","6180橘子","110/07/29","國泰-新莊",9,1,8
"21832","6180橘子","110/07/29","群益金鼎-丹鳳",0,6,-6
"21833","6180橘子","110/07/29","元大-木柵",8,0,8
"21834","6180橘子","110/07/29","永豐金-南京",2,8,-6
"21835","6180橘子","110/07/29","國票-敦北法人",7,0,7
"21836","6180橘子","110/07/29","日盛-頭份",5,10,-5
"21837","6180橘子","110/07/29","元大證券",7,0,7
"21838","6180橘子","110/07/29","宏遠-高雄",0,5,-5
"21839","6180橘子","110/07/29","高橋",6,0,6
"21840","6180橘子","110/07/29","第一金-中山",1,5,-4
"21841","2390云辰","110/07/29","元大-永和",561,61,500
"21842","2390云辰","110/07/29","摩根大通",152,377,-225
"21843","2390云辰","110/07/29","台灣摩根士丹利",163,1,162
"21844","2390云辰","110/07/29","元富-同大",3,139,-136
"21845","2390云辰","110/07/29","元大-善化",87,0,87
"21846","2390云辰","110/07/29","豐農",3,128,-125
"21847","2390云辰","110/07/29","元大-草屯",89,6,83
"21848","2390云辰","110/07/29","美商高盛",6,88,-82
"21849","2390云辰","110/07/29","富邦-羅東",74,10,64
"21850","2390云辰","110/07/29","美林",43,112,-69
"21851","2390云辰","110/07/29","元大-鑫永和",61,1,60
"21852","2390云辰","110/07/29","元大-發財",4,61,-57
"21853","2390云辰","110/07/29","元富-高雄",93,40,53
"21854","2390云辰","110/07/29","大慶-泰山",0,51,-51
"21855","2390云辰","110/07/29","台新-左楠",43,1,42
"21856","2390云辰","110/07/29","群益金鼎",5,49,-44
"21857","2390云辰","110/07/29","日盛-永康",35,2,33
"21858","2390云辰","110/07/29","元大-松江",0,40,-40
"21859","2390云辰","110/07/29","玉山-板橋",37,5,32
"21860","2390云辰","110/07/29","統一-新台中",123,161,-38
"21861","2390云辰","110/07/29","日盛-板橋中山",45,15,30
"21862","2390云辰","110/07/29","兆豐-員林",0,35,-35
"21863","2390云辰","110/07/29","元大-大統",30,0,30
"21864","2390云辰","110/07/29","第一金-新竹",1,35,-34
"21865","2390云辰","110/07/29","元大-竹北",30,1,29
"21866","2390云辰","110/07/29","日盛-員林",3,33,-30
"21867","2390云辰","110/07/29","元大-北屯",26,0,26
"21868","2390云辰","110/07/29","新光",40,70,-30
"21869","2390云辰","110/07/29","元大-林園",25,0,25
"21870","2390云辰","110/07/29","永豐金-松山",21,49,-28
"21871","1471首利","110/07/28","美林",138,26,112
"21872","1471首利","110/07/28","玉山-台大",0,234,-234
"21873","1471首利","110/07/28","摩根大通",164,80,84
"21874","1471首利","110/07/28","國票-九鼎",0,149,-149
"21875","1471首利","110/07/28","(牛牛牛)亞-鑫豐",65,0,65
"21876","1471首利","110/07/28","台中銀",0,69,-69
"21877","1471首利","110/07/28","大昌-新店",44,0,44
"21878","1471首利","110/07/28","元大-博愛",0,32,-32
"21879","1471首利","110/07/28","玉山-桃園",69,30,39
"21880","1471首利","110/07/28","凱基-竹北",0,30,-30
"21881","1471首利","110/07/28","兆豐-鹿港",28,0,28
"21882","1471首利","110/07/28","富邦-苗栗",0,30,-30
"21883","1471首利","110/07/28","聯邦-高雄",21,0,21
"21884","1471首利","110/07/28","港商法國興業",0,22,-22
"21885","1471首利","110/07/28","永豐金-中正",21,0,21
"21886","1471首利","110/07/28","國票-安和",0,20,-20
"21887","1471首利","110/07/28","第一金-高雄",16,0,16
"21888","1471首利","110/07/28","華南永昌-苑裡",0,15,-15
"21889","1471首利","110/07/28","統一-桃園",13,0,13
"21890","1471首利","110/07/28","日盛-中壢",0,13,-13
"21891","1471首利","110/07/28","新光-台中",19,6,13
"21892","1471首利","110/07/28","玉山-台南",0,13,-13
"21893","1471首利","110/07/28","彰銀-七賢",11,0,11
"21894","1471首利","110/07/28","凱基-桃園",0,12,-12
"21895","1471首利","110/07/28","第一金-台南",11,0,11
"21896","1471首利","110/07/28","聯邦-雙和",0,11,-11
"21897","1471首利","110/07/28","台新證券",11,0,11
"21898","1471首利","110/07/28","統一-新營",0,10,-10
"21899","1471首利","110/07/28","凱基-東勢",11,0,11
"21900","1471首利","110/07/28","凱基-城中",0,10,-10
"21901","2883開發金","110/07/28","摩根大通",5171,647,4524
"21902","2883開發金","110/07/28","台灣摩根士丹利",921,11451,-10530
"21903","2883開發金","110/07/28","瑞士信貸",4234,62,4172
"21904","2883開發金","110/07/28","美商高盛",522,3615,-3093
"21905","2883開發金","110/07/28","國泰證券",2247,28,2219
"21906","2883開發金","110/07/28","(牛牛牛)亞證券",0,3000,-3000
"21907","2883開發金","110/07/28","元大證券",2306,91,2215
"21908","2883開發金","110/07/28","康和-仁愛",17,3004,-2987
"21909","2883開發金","110/07/28","元富-城東",2203,113,2090
"21910","2883開發金","110/07/28","第一金",18,2301,-2283
"21911","2883開發金","110/07/28","新加坡商瑞銀",1840,81,1759
"21912","2883開發金","110/07/28","凱基-台北",3735,5169,-1434
"21913","2883開發金","110/07/28","永豐金-彰化",1682,27,1655
"21914","2883開發金","110/07/28","宏遠-高雄",4,1420,-1416
"21915","2883開發金","110/07/28","日盛證券",1637,9,1628
"21916","2883開發金","110/07/28","亞東-板橋",507,1722,-1215
"21917","2883開發金","110/07/28","元大-彰化",1183,11,1172
"21918","2883開發金","110/07/28","凱基-豐中",32,1127,-1095
"21919","2883開發金","110/07/28","美林",2507,1378,1129
"21920","2883開發金","110/07/28","群益金鼎-三重",65,993,-928
"21921","2883開發金","110/07/28","華南永昌",1204,239,965
"21922","2883開發金","110/07/28","元大-羅東",30,872,-842
"21923","2883開發金","110/07/28","日盛-台南",816,6,810
"21924","2883開發金","110/07/28","花旗環球",188,1004,-816
"21925","2883開發金","110/07/28","台新-松江",722,40,682
"21926","2883開發金","110/07/28","華南永昌-朴子",33,716,-683
"21927","2883開發金","110/07/28","新光-台中",858,231,627
"21928","2883開發金","110/07/28","元大-永和",31,700,-669
"21929","2883開發金","110/07/28","凱基-員林",634,25,609
"21930","2883開發金","110/07/28","玉山-台南",97,738,-641
"21931","6205詮欣","110/07/28","臺銀",30,0,30
"21932","6205詮欣","110/07/28","台灣摩根士丹利",0,59,-59
"21933","6205詮欣","110/07/28","元大-善化",30,0,30
"21934","6205詮欣","110/07/28","凱基-大安",0,50,-50
"21935","6205詮欣","110/07/28","日盛證券",16,0,16
"21936","6205詮欣","110/07/28","元大-板橋",0,20,-20
"21937","6205詮欣","110/07/28","元大-土城學府",15,3,12
"21938","6205詮欣","110/07/28","摩根大通",17,30,-13
"21939","6205詮欣","110/07/28","臺銀-民權",10,0,10
"21940","6205詮欣","110/07/28","凱基-台北",0,11,-11
"21941","6205詮欣","110/07/28","德信-新營",10,0,10
"21942","6205詮欣","110/07/28","新加坡商瑞銀",0,10,-10
"21943","6205詮欣","110/07/28","福勝",10,0,10
"21944","6205詮欣","110/07/28","第一金-新竹",0,10,-10
"21945","6205詮欣","110/07/28","元大-清水",10,0,10
"21946","6205詮欣","110/07/28","台新-高雄",0,6,-6
"21947","6205詮欣","110/07/28","新光",9,0,9
"21948","6205詮欣","110/07/28","凱基-三多",0,6,-6
"21949","6205詮欣","110/07/28","群益金鼎-屏東",7,0,7
"21950","6205詮欣","110/07/28","美林",2,7,-5
"21951","6205詮欣","110/07/28","元大-汐止",6,0,6
"21952","6205詮欣","110/07/28","瑞士信貸",0,5,-5
"21953","6205詮欣","110/07/28","統一-屏東",5,0,5
"21954","6205詮欣","110/07/28","中國信託-三重",0,5,-5
"21955","6205詮欣","110/07/28","日盛-三重",4,0,4
"21956","6205詮欣","110/07/28","日盛-雙和",0,4,-4
"21957","6205詮欣","110/07/28","亞東-板橋",4,0,4
"21958","6205詮欣","110/07/28","宏遠-光隆",0,4,-4
"21959","6205詮欣","110/07/28","台中銀",4,0,4
"21960","6205詮欣","110/07/28","兆豐-新莊",0,4,-4
"21961","1540喬福","110/07/28","兆豐-北高雄",48,0,48
"21962","1540喬福","110/07/28","合庫-台中",1,60,-59
"21963","1540喬福","110/07/28","兆豐-台中港",33,0,33
"21964","1540喬福","110/07/28","凱基-台北",0,44,-44
"21965","1540喬福","110/07/28","大慶-中壢",19,0,19
"21966","1540喬福","110/07/28","元大-學甲",0,35,-35
"21967","1540喬福","110/07/28","富邦-員林",18,0,18
"21968","1540喬福","110/07/28","統一-新台中",0,26,-26
"21969","1540喬福","110/07/28","(牛牛牛)亞-鑫豐",12,0,12
"21970","1540喬福","110/07/28","新光-新竹",0,21,-21
"21971","1540喬福","110/07/28","元富-文心",10,0,10
"21972","1540喬福","110/07/28","富邦-台北",0,20,-20
"21973","1540喬福","110/07/28","光和-和美",10,0,10
"21974","1540喬福","110/07/28","富邦-南屯",0,20,-20
"21975","1540喬福","110/07/28","永豐金-三重",9,0,9
"21976","1540喬福","110/07/28","元大-鶯歌",0,10,-10
"21977","1540喬福","110/07/28","臺銀-鳳山",8,0,8
"21978","1540喬福","110/07/28","元大-豐原",0,7,-7
"21979","1540喬福","110/07/28","元大-斗六",7,0,7
"21980","1540喬福","110/07/28","大昌-樹林",0,6,-6
"21981","1540喬福","110/07/28","台新-台中",6,0,6
"21982","1540喬福","110/07/28","新光-桃園",0,5,-5
"21983","1540喬福","110/07/28","華南永昌-中正",6,0,6
"21984","1540喬福","110/07/28","凱基-站前",0,5,-5
"21985","1540喬福","110/07/28","永豐金-台中",6,0,6
"21986","1540喬福","110/07/28","臺銀",0,4,-4
"21987","1540喬福","110/07/28","臺銀-民權",5,0,5
"21988","1540喬福","110/07/28","台新證券",0,3,-3
"21989","1540喬福","110/07/28","元富-中原",5,0,5
"21990","1540喬福","110/07/28","台新-高雄",0,3,-3
"21991","2888新光金","110/07/28","臺銀-高雄",3050,3,3047
"21992","2888新光金","110/07/28","摩根大通",2543,11316,-8773
"21993","2888新光金","110/07/28","元富-城東",2019,129,1890
"21994","2888新光金","110/07/28","香港上海匯豐",120,7576,-7456
"21995","2888新光金","110/07/28","元大證券",2106,407,1699
"21996","2888新光金","110/07/28","凱基-台北",1641,5238,-3597
"21997","2888新光金","110/07/28","凱基-台南",1068,33,1035
"21998","2888新光金","110/07/28","新加坡商瑞銀",0,3572,-3572
"21999","2888新光金","110/07/28","彰銀-台中",1098,75,1023
"22000","2888新光金","110/07/28","台灣摩根士丹利",4358,7129,-2771
"22001","2888新光金","110/07/28","元富-城中",1003,0,1003
"22002","2888新光金","110/07/28","元大-大統",103,2853,-2750
"22003","2888新光金","110/07/28","元大-大天母",1113,119,994
"22004","2888新光金","110/07/28","光和",204,2235,-2031
"22005","2888新光金","110/07/28","元大-仁愛",761,1,760
"22006","2888新光金","110/07/28","兆豐-鹿港",80,1755,-1675
"22007","2888新光金","110/07/28","日盛-雙和",927,179,748
"22008","2888新光金","110/07/28","凱基-市政",17,1447,-1430
"22009","2888新光金","110/07/28","元大-大里",648,0,648
"22010","2888新光金","110/07/28","華南永昌-敦南",66,1320,-1254
"22011","2888新光金","110/07/28","凱基-竹科",2665,2026,639
"22012","2888新光金","110/07/28","法銀巴黎",195,1423,-1228
"22013","2888新光金","110/07/28","日盛-高雄",619,11,608
"22014","2888新光金","110/07/28","臺銀",123,1343,-1220
"22015","2888新光金","110/07/28","群益金鼎-海山",710,151,559
"22016","2888新光金","110/07/28","花旗環球",0,865,-865
"22017","2888新光金","110/07/28","台新證券",855,305,550
"22018","2888新光金","110/07/28","元大-鹿港",46,848,-802
"22019","2888新光金","110/07/28","國泰-敦南",774,237,537
"22020","2888新光金","110/07/28","合庫-台中",121,800,-679
"22021","1340勝悅","110/07/28","新光-台南",50,0,50
"22022","1340勝悅","110/07/28","兆豐-南京",0,25,-25
"22023","1340勝悅","110/07/28","臺銀-臺中",6,0,6
"22024","1340勝悅","110/07/28","凱基-台北",0,22,-22
"22025","1340勝悅","110/07/28","新光",6,0,6
"22026","1340勝悅","110/07/28","美林",0,12,-12
"22027","1340勝悅","110/07/28","臺灣企銀-埔墘",5,0,5
"22028","1340勝悅","110/07/28","群益金鼎-台中",0,11,-11
"22029","1340勝悅","110/07/28","國票-敦北法人",5,0,5
"22030","1340勝悅","110/07/28","合庫-西台中",1,10,-9
"22031","1340勝悅","110/07/28","國泰-高雄",5,0,5
"22032","1340勝悅","110/07/28","元大-基隆孝二",0,8,-8
"22033","1340勝悅","110/07/28","國泰-台中",5,0,5
"22034","1340勝悅","110/07/28","統一-城中",0,7,-7
"22035","1340勝悅","110/07/28","群益金鼎-館前",5,0,5
"22036","1340勝悅","110/07/28","凱基-幸福",0,7,-7
"22037","1340勝悅","110/07/28","中國信託-文心",3,0,3
"22038","1340勝悅","110/07/28","臺銀-新竹",0,5,-5
"22039","1340勝悅","110/07/28","群益金鼎-崇德",3,0,3
"22040","1340勝悅","110/07/28","港商法國興業",0,5,-5
"22041","1340勝悅","110/07/28","元大-永春",3,0,3
"22042","1340勝悅","110/07/28","元大-新竹經國",0,5,-5
"22043","1340勝悅","110/07/28","永豐金-松山",3,0,3
"22044","1340勝悅","110/07/28","台新證券",0,4,-4
"22045","1340勝悅","110/07/28","永豐金-嘉義",3,0,3
"22046","1340勝悅","110/07/28","港商野村",0,3,-3
"22047","1340勝悅","110/07/28","日盛-木柵",2,0,2
"22048","1340勝悅","110/07/28","摩根大通",0,3,-3
"22049","1340勝悅","110/07/28","台新-台中",2,0,2
"22050","1340勝悅","110/07/28","富邦-台北",0,3,-3
"22051","6246臺龍","110/07/28","元大-基隆孝二",32,0,32
"22052","6246臺龍","110/07/28","永豐金-桃園",4,135,-131
"22053","6246臺龍","110/07/28","合庫-台中",30,0,30
"22054","6246臺龍","110/07/28","港商野村",5,93,-88
"22055","6246臺龍","110/07/28","元大-木柵",30,0,30
"22056","6246臺龍","110/07/28","凱基-台北",9,65,-56
"22057","6246臺龍","110/07/28","光和",21,0,21
"22058","6246臺龍","110/07/28","元大-西螺",0,31,-31
"22059","6246臺龍","110/07/28","宏遠-民生",20,0,20
"22060","6246臺龍","110/07/28","群益金鼎-鳳山",0,27,-27
"22061","6246臺龍","110/07/28","第一金-安和",20,0,20
"22062","6246臺龍","110/07/28","元大-西屯",0,25,-25
"22063","6246臺龍","110/07/28","兆豐-竹北",24,4,20
"22064","6246臺龍","110/07/28","永豐金-虎尾",6,27,-21
"22065","6246臺龍","110/07/28","凱基-幸福",20,0,20
"22066","6246臺龍","110/07/28","日盛-台中",1,20,-19
"22067","6246臺龍","110/07/28","德信-新營",19,0,19
"22068","6246臺龍","110/07/28","統一",0,16,-16
"22069","6246臺龍","110/07/28","台新證券",21,4,17
"22070","6246臺龍","110/07/28","群益金鼎-土城",0,16,-16
"22071","6246臺龍","110/07/28","華南永昌-公誠",17,0,17
"22072","6246臺龍","110/07/28","元大-員林",0,15,-15
"22073","6246臺龍","110/07/28","中國信託-文心",15,0,15
"22074","6246臺龍","110/07/28","華南永昌-長虹",0,11,-11
"22075","6246臺龍","110/07/28","群益金鼎-崇德",15,0,15
"22076","6246臺龍","110/07/28","日盛-中壢",0,10,-10
"22077","6246臺龍","110/07/28","兆豐-公益",12,0,12
"22078","6246臺龍","110/07/28","第一金-彰化",0,10,-10
"22079","6246臺龍","110/07/28","國票",12,0,12
"22080","6246臺龍","110/07/28","元富-中原",0,10,-10
"22081","00715L期街口布蘭特正2","110/07/28","永豐金證券",5725,30,5695
"22082","00715L期街口布蘭特正2","110/07/28","元大-四維",0,2013,-2013
"22083","00715L期街口布蘭特正2","110/07/28","元大證券",5235,705,4530
"22084","00715L期街口布蘭特正2","110/07/28","凱基-豐中",0,1536,-1536
"22085","00715L期街口布蘭特正2","110/07/28","國票",2733,11,2722
"22086","00715L期街口布蘭特正2","110/07/28","華南永昌-東昇",0,1010,-1010
"22087","00715L期街口布蘭特正2","110/07/28","富邦證券",2340,417,1923
"22088","00715L期街口布蘭特正2","110/07/28","兆豐-三民",0,1004,-1004
"22089","00715L期街口布蘭特正2","110/07/28","凱基-台北",2241,325,1916
"22090","00715L期街口布蘭特正2","110/07/28","元富-古亭",0,600,-600
"22091","00715L期街口布蘭特正2","110/07/28","統一",1635,132,1503
"22092","00715L期街口布蘭特正2","110/07/28","台新-新營",20,558,-538
"22093","00715L期街口布蘭特正2","110/07/28","國票-中港",1500,0,1500
"22094","00715L期街口布蘭特正2","110/07/28","富邦-台北",0,453,-453
"22095","00715L期街口布蘭特正2","110/07/28","兆豐-台中",525,6,519
"22096","00715L期街口布蘭特正2","110/07/28","港商野村",71,519,-448
"22097","00715L期街口布蘭特正2","110/07/28","合庫證券",1008,500,508
"22098","00715L期街口布蘭特正2","110/07/28","第一金-自由",10,405,-395
"22099","00715L期街口布蘭特正2","110/07/28","永豐金-三重",500,0,500
"22100","00715L期街口布蘭特正2","110/07/28","玉山-高雄",17,387,-370
"22101","00715L期街口布蘭特正2","110/07/28","凱基-市政",500,1,499
"22102","00715L期街口布蘭特正2","110/07/28","統一-桃園",0,331,-331
"22103","00715L期街口布蘭特正2","110/07/28","元富-大裕",500,8,492
"22104","00715L期街口布蘭特正2","110/07/28","元富-中壢",0,309,-309
"22105","00715L期街口布蘭特正2","110/07/28","永豐金-內湖",503,18,485
"22106","00715L期街口布蘭特正2","110/07/28","台新證券",21,329,-308
"22107","00715L期街口布蘭特正2","110/07/28","元富-吉利",280,0,280
"22108","00715L期街口布蘭特正2","110/07/28","國票-台中",0,275,-275
"22109","00715L期街口布蘭特正2","110/07/28","國票-博愛",200,0,200
"22110","00715L期街口布蘭特正2","110/07/28","日盛-木柵",0,268,-268
"22111","8941關中","110/07/28","第一金-台南",2,0,2
"22112","8941關中","110/07/28","聯邦-富強",0,3,-3
"22113","8941關中","110/07/28","元大-西屯",2,0,2
"22114","8941關中","110/07/28","富邦-員林",0,3,-3
"22115","8941關中","110/07/28","玉山證券",1,0,1
"22116","8941關中","110/07/28","第一金-安和",0,2,-2
"22117","8941關中","110/07/28","國泰-忠孝",1,0,1
"22118","8941關中","110/07/28","第一金-台中",0,1,-1
"22119","8941關中","110/07/28","凱基-岡山",1,0,1
"22120","8941關中","110/07/28","玉山-台中",0,0,0
"22121","8941關中","110/07/28","富邦-羅東",1,0,1
"22122","8941關中","110/07/28","元大-新竹經國",0,0,0
"22123","8941關中","110/07/28","永豐金-敦南",1,0,1
"22124","8941關中","110/07/28","元大-桃興",1,1,0
"22125","8941關中","110/07/28","玉山-台中",0,0,0
"22126","8941關中","110/07/28","",NA,NA,NA
"22127","8941關中","110/07/28","元大-新竹經國",0,0,0
"22128","8941關中","110/07/28","",NA,NA,NA
"22129","8941關中","110/07/28","元大-桃興",1,1,0
"22130","8941關中","110/07/28","",NA,NA,NA
"22131","8941關中","110/07/28","",NA,NA,NA
"22132","8941關中","110/07/28","",NA,NA,NA
"22133","8941關中","110/07/28","",NA,NA,NA
"22134","8941關中","110/07/28","",NA,NA,NA
"22135","8941關中","110/07/28","",NA,NA,NA
"22136","8941關中","110/07/28","",NA,NA,NA
"22137","8941關中","110/07/28","",NA,NA,NA
"22138","8941關中","110/07/28","",NA,NA,NA
"22139","8941關中","110/07/28","",NA,NA,NA
"22140","8941關中","110/07/28","",NA,NA,NA
"22141","8936國統","110/07/28","宏遠-高雄",141,1,140
"22142","8936國統","110/07/28","摩根大通",82,517,-435
"22143","8936國統","110/07/28","日盛-景美",100,0,100
"22144","8936國統","110/07/28","凱基-台北",5,290,-285
"22145","8936國統","110/07/28","永豐金-苓雅",67,0,67
"22146","8936國統","110/07/28","瑞士信貸",0,245,-245
"22147","8936國統","110/07/28","玉山-台南",64,0,64
"22148","8936國統","110/07/28","台灣摩根士丹利",16,176,-160
"22149","8936國統","110/07/28","國票-北高雄",61,1,60
"22150","8936國統","110/07/28","凱基-市政",11,110,-99
"22151","8936國統","110/07/28","玉山-高雄",49,0,49
"22152","8936國統","110/07/28","元大-東蘆",0,82,-82
"22153","8936國統","110/07/28","元大-小港",47,0,47
"22154","8936國統","110/07/28","新加坡商瑞銀",128,205,-77
"22155","8936國統","110/07/28","元大-台中",40,0,40
"22156","8936國統","110/07/28","元大-歸仁",30,75,-45
"22157","8936國統","110/07/28","新光-台中",41,7,34
"22158","8936國統","110/07/28","台新-台中",17,55,-38
"22159","8936國統","110/07/28","元大-豐原站前",32,0,32
"22160","8936國統","110/07/28","康和",20,58,-38
"22161","8936國統","110/07/28","玉山-台中",31,0,31
"22162","8936國統","110/07/28","第一金-新興",0,31,-31
"22163","8936國統","110/07/28","富邦-高雄",26,0,26
"22164","8936國統","110/07/28","元富-松德",0,30,-30
"22165","8936國統","110/07/28","元大-鳳中",30,5,25
"22166","8936國統","110/07/28","元大-中和",2,30,-28
"22167","8936國統","110/07/28","元富-林園",20,0,20
"22168","8936國統","110/07/28","兆豐-嘉義",0,22,-22
"22169","8936國統","110/07/28","兆豐-北高雄",20,0,20
"22170","8936國統","110/07/28","美林",11,32,-21
"22171","6226光鼎","110/07/28","群益金鼎-萬華",147,14,133
"22172","6226光鼎","110/07/28","群益金鼎-敦南",5,282,-277
"22173","6226光鼎","110/07/28","台新-台中",227,114,113
"22174","6226光鼎","110/07/28","華南永昌",19,142,-123
"22175","6226光鼎","110/07/28","摩根大通",109,0,109
"22176","6226光鼎","110/07/28","康和-台北",0,100,-100
"22177","6226光鼎","110/07/28","統一",107,0,107
"22178","6226光鼎","110/07/28","臺銀-民權",4,100,-96
"22179","6226光鼎","110/07/28","凱基-台北",103,1,102
"22180","6226光鼎","110/07/28","元大-潮州",11,102,-91
"22181","6226光鼎","110/07/28","台灣摩根士丹利",104,7,97
"22182","6226光鼎","110/07/28","華南永昌-嘉義",50,130,-80
"22183","6226光鼎","110/07/28","群益金鼎-館前",97,0,97
"22184","6226光鼎","110/07/28","台新證券",79,153,-74
"22185","6226光鼎","110/07/28","國泰-台中",97,20,77
"22186","6226光鼎","110/07/28","玉山-台南",4,74,-70
"22187","6226光鼎","110/07/28","元大-嘉義",83,16,67
"22188","6226光鼎","110/07/28","臺銀-臺中",6,65,-59
"22189","6226光鼎","110/07/28","新光-桃園",69,8,61
"22190","6226光鼎","110/07/28","富邦-仁愛",6,63,-57
"22191","6226光鼎","110/07/28","群益金鼎-三重",59,2,57
"22192","6226光鼎","110/07/28","凱基-大里",0,51,-51
"22193","6226光鼎","110/07/28","日盛-員林",63,12,51
"22194","6226光鼎","110/07/28","國泰-敦南",116,166,-50
"22195","6226光鼎","110/07/28","永豐金-松山",66,20,46
"22196","6226光鼎","110/07/28","元富-中港",2,51,-49
"22197","6226光鼎","110/07/28","統一-內湖",48,7,41
"22198","6226光鼎","110/07/28","群益金鼎-延平",0,49,-49
"22199","6226光鼎","110/07/28","凱基-高美館",51,10,41
"22200","6226光鼎","110/07/28","元大-新竹經國",5,53,-48
"22201","2363矽統","110/07/28","摩根大通",809,282,527
"22202","2363矽統","110/07/28","國泰-敦南",145,861,-716
"22203","2363矽統","110/07/28","美商高盛",532,264,268
"22204","2363矽統","110/07/28","元大-台中",18,384,-366
"22205","2363矽統","110/07/28","台新-三民",263,18,245
"22206","2363矽統","110/07/28","新光",197,525,-328
"22207","2363矽統","110/07/28","台新證券",929,703,226
"22208","2363矽統","110/07/28","群益金鼎-三民",24,266,-242
"22209","2363矽統","110/07/28","第一金-嘉義",154,0,154
"22210","2363矽統","110/07/28","凱基-斗六",0,187,-187
"22211","2363矽統","110/07/28","凱基-台北",1039,889,150
"22212","2363矽統","110/07/28","元大-上新莊",3,134,-131
"22213","2363矽統","110/07/28","永豐金-竹科",132,11,121
"22214","2363矽統","110/07/28","永豐金-彰化",5,134,-129
"22215","2363矽統","110/07/28","華南永昌-鳳山",146,34,112
"22216","2363矽統","110/07/28","日盛-二林",15,142,-127
"22217","2363矽統","110/07/28","第一金-新興",108,1,107
"22218","2363矽統","110/07/28","元大證券",18,125,-107
"22219","2363矽統","110/07/28","港商野村",673,568,105
"22220","2363矽統","110/07/28","新光-台南",25,129,-104
"22221","2363矽統","110/07/28","群益金鼎-桃園",111,11,100
"22222","2363矽統","110/07/28","統一",7,109,-102
"22223","2363矽統","110/07/28","台新-左楠",94,15,79
"22224","2363矽統","110/07/28","康和-南崁",11,108,-97
"22225","2363矽統","110/07/28","新加坡商瑞銀",789,711,78
"22226","2363矽統","110/07/28","國票",25,121,-96
"22227","2363矽統","110/07/28","國票-九鼎",99,26,73
"22228","2363矽統","110/07/28","群益金鼎-敦南",11,107,-96
"22229","2363矽統","110/07/28","兆豐-埔墘",62,0,62
"22230","2363矽統","110/07/28","兆豐-寶成",2,79,-77
"22231","8112至上","110/07/28","摩根大通",630,183,447
"22232","8112至上","110/07/28","永豐金-永康",0,242,-242
"22233","8112至上","110/07/28","合庫證券",317,21,296
"22234","8112至上","110/07/28","高橋",3,222,-219
"22235","8112至上","110/07/28","新加坡商瑞銀",417,132,285
"22236","8112至上","110/07/28","玉山證券",2,206,-204
"22237","8112至上","110/07/28","台灣摩根士丹利",253,58,195
"22238","8112至上","110/07/28","新光",50,206,-156
"22239","8112至上","110/07/28","港商野村",350,164,186
"22240","8112至上","110/07/28","永豐金-苓雅",2,102,-100
"22241","8112至上","110/07/28","美商高盛",184,7,177
"22242","8112至上","110/07/28","凱基-永和",0,80,-80
"22243","8112至上","110/07/28","美林",213,53,160
"22244","8112至上","110/07/28","華南永昌-新莊",60,134,-74
"22245","8112至上","110/07/28","花旗環球",86,16,70
"22246","8112至上","110/07/28","台新-松江",27,90,-63
"22247","8112至上","110/07/28","玉山-板橋",82,17,65
"22248","8112至上","110/07/28","宏遠證券",1,50,-49
"22249","8112至上","110/07/28","凱基-竹科",67,3,64
"22250","8112至上","110/07/28","元大-苑裡",23,72,-49
"22251","8112至上","110/07/28","元大-府城",56,0,56
"22252","8112至上","110/07/28","元大-基隆孝二",5,53,-48
"22253","8112至上","110/07/28","永豐金-內湖",37,0,37
"22254","8112至上","110/07/28","康和-仁愛",5,51,-46
"22255","8112至上","110/07/28","瑞士信貸",58,26,32
"22256","8112至上","110/07/28","台新證券",31,73,-42
"22257","8112至上","110/07/28","元大證券",60,29,31
"22258","8112至上","110/07/28","兆豐-公益",0,40,-40
"22259","8112至上","110/07/28","元富-新店",35,5,30
"22260","8112至上","110/07/28","中國信託-忠孝",1,37,-36
"22261","1570力肯","110/07/28","國泰-敦南",50,0,50
"22262","1570力肯","110/07/28","元大-高雄",0,42,-42
"22263","1570力肯","110/07/28","群益金鼎-高雄",31,0,31
"22264","1570力肯","110/07/28","國票-新莊",0,14,-14
"22265","1570力肯","110/07/28","元富-延平",15,0,15
"22266","1570力肯","110/07/28","凱基-站前",0,10,-10
"22267","1570力肯","110/07/28","(牛牛牛)亞-鑫豐",10,0,10
"22268","1570力肯","110/07/28","凱基-台北",0,10,-10
"22269","1570力肯","110/07/28","元富-緯城",6,0,6
"22270","1570力肯","110/07/28","元大-忠孝",0,10,-10
"22271","1570力肯","110/07/28","合庫-自強",5,0,5
"22272","1570力肯","110/07/28","台灣摩根士丹利",0,9,-9
"22273","1570力肯","110/07/28","臺銀-臺南",4,0,4
"22274","1570力肯","110/07/28","群益金鼎-板橋",0,8,-8
"22275","1570力肯","110/07/28","兆豐-台中港",3,0,3
"22276","1570力肯","110/07/28","永豐金-大園",0,7,-7
"22277","1570力肯","110/07/28","日盛-板橋",2,0,2
"22278","1570力肯","110/07/28","元大-台南",0,5,-5
"22279","1570力肯","110/07/28","統一-松江",2,0,2
"22280","1570力肯","110/07/28","合庫-台中",0,4,-4
"22281","1570力肯","110/07/28","台新-三民",2,0,2
"22282","1570力肯","110/07/28","富邦-板橋",0,3,-3
"22283","1570力肯","110/07/28","群益金鼎-土城",2,0,2
"22284","1570力肯","110/07/28","元大-板橋",0,3,-3
"22285","1570力肯","110/07/28","元大-和平",2,0,2
"22286","1570力肯","110/07/28","統一-桃園",0,2,-2
"22287","1570力肯","110/07/28","元大-土城永寧",2,0,2
"22288","1570力肯","110/07/28","凱基-三多",0,2,-2
"22289","1570力肯","110/07/28","大昌-樹林",1,0,1
"22290","1570力肯","110/07/28","華南永昌-高雄",0,2,-2
"22291","2929淘帝","110/07/28","日盛-八德",40,0,40
"22292","2929淘帝","110/07/28","凱基-林口",0,150,-150
"22293","2929淘帝","110/07/28","玉山-新竹",30,0,30
"22294","2929淘帝","110/07/28","日盛-台中",0,35,-35
"22295","2929淘帝","110/07/28","國泰-松江",33,3,30
"22296","2929淘帝","110/07/28","永豐金-永康",0,21,-21
"22297","2929淘帝","110/07/28","元大-民生",28,0,28
"22298","2929淘帝","110/07/28","新加坡商瑞銀",13,32,-19
"22299","2929淘帝","110/07/28","合庫-高雄",21,0,21
"22300","2929淘帝","110/07/28","國泰-敦南",2,20,-18
"22301","2929淘帝","110/07/28","華南永昌",20,0,20
"22302","2929淘帝","110/07/28","臺銀",2,17,-15
"22303","2929淘帝","110/07/28","台新證券",12,0,12
"22304","2929淘帝","110/07/28","群益金鼎-敦南",0,13,-13
"22305","2929淘帝","110/07/28","第一金-大稻埕",10,0,10
"22306","2929淘帝","110/07/28","富邦-建國",1,13,-12
"22307","2929淘帝","110/07/28","華南永昌-台中",10,0,10
"22308","2929淘帝","110/07/28","元富-城東",0,10,-10
"22309","2929淘帝","110/07/28","元大-士林",10,0,10
"22310","2929淘帝","110/07/28","兆豐-景美",0,8,-8
"22311","2929淘帝","110/07/28","元大-屏南",10,0,10
"22312","2929淘帝","110/07/28","美林",3,10,-7
"22313","2929淘帝","110/07/28","元大-員林",10,0,10
"22314","2929淘帝","110/07/28","元富-彰化",0,7,-7
"22315","2929淘帝","110/07/28","新光-桃園",9,0,9
"22316","2929淘帝","110/07/28","港商法國興業",0,6,-6
"22317","2929淘帝","110/07/28","日盛-景美",7,0,7
"22318","2929淘帝","110/07/28","新光-高雄",0,6,-6
"22319","2929淘帝","110/07/28","玉山證券",7,0,7
"22320","2929淘帝","110/07/28","港商野村",3,8,-5
"22321","5410國眾","110/07/28","兆豐-城中",38,0,38
"22322","5410國眾","110/07/28","兆豐-南門",3,80,-77
"22323","5410國眾","110/07/28","大展",20,0,20
"22324","5410國眾","110/07/28","摩根大通",12,56,-44
"22325","5410國眾","110/07/28","新光-桃園",20,0,20
"22326","5410國眾","110/07/28","凱基-台北",0,28,-28
"22327","5410國眾","110/07/28","凱基-竹北",20,0,20
"22328","5410國眾","110/07/28","亞東-板橋",0,20,-20
"22329","5410國眾","110/07/28","元大-新莊",17,0,17
"22330","5410國眾","110/07/28","統一-新台中",0,20,-20
"22331","5410國眾","110/07/28","新光",20,8,12
"22332","5410國眾","110/07/28","瑞士信貸",0,16,-16
"22333","5410國眾","110/07/28","國泰-敦南",11,0,11
"22334","5410國眾","110/07/28","新加坡商瑞銀",0,15,-15
"22335","5410國眾","110/07/28","日盛-內湖",10,0,10
"22336","5410國眾","110/07/28","統一-金門",0,15,-15
"22337","5410國眾","110/07/28","元富-新竹",10,0,10
"22338","5410國眾","110/07/28","元大-北投",0,12,-12
"22339","5410國眾","110/07/28","群益金鼎-永和",10,0,10
"22340","5410國眾","110/07/28","新百王",0,10,-10
"22341","5410國眾","110/07/28","華南永昌-中正",10,0,10
"22342","5410國眾","110/07/28","元大-館前",0,10,-10
"22343","5410國眾","110/07/28","元大-旗山",10,0,10
"22344","5410國眾","110/07/28","元富-安南",0,9,-9
"22345","5410國眾","110/07/28","元大-大天母",10,0,10
"22346","5410國眾","110/07/28","元大-龍潭",1,10,-9
"22347","5410國眾","110/07/28","大昌",9,0,9
"22348","5410國眾","110/07/28","港商野村",1,7,-6
"22349","5410國眾","110/07/28","臺銀-鳳山",8,0,8
"22350","5410國眾","110/07/28","元大-東泰",0,6,-6
"22351","2841台開","110/07/28","台新-台中",36,0,36
"22352","2841台開","110/07/28","元大-大雅",0,90,-90
"22353","2841台開","110/07/28","群益金鼎-大甲",24,0,24
"22354","2841台開","110/07/28","凱基-台北",0,73,-73
"22355","2841台開","110/07/28","永豐金-敦南",29,8,21
"22356","2841台開","110/07/28","港商野村",0,27,-27
"22357","2841台開","110/07/28","第一金-台中",20,0,20
"22358","2841台開","110/07/28","大慶-富順",0,20,-20
"22359","2841台開","110/07/28","元富-烏日",20,0,20
"22360","2841台開","110/07/28","豐農",0,17,-17
"22361","2841台開","110/07/28","元大-歸仁",20,0,20
"22362","2841台開","110/07/28","元大-大里德芳",0,15,-15
"22363","2841台開","110/07/28","永豐金-豐原",20,0,20
"22364","2841台開","110/07/28","日盛-大墩",0,10,-10
"22365","2841台開","110/07/28","日盛-花蓮",15,0,15
"22366","2841台開","110/07/28","元大-博愛",0,10,-10
"22367","2841台開","110/07/28","大昌-安康",18,3,15
"22368","2841台開","110/07/28","元大-豐原站前",0,10,-10
"22369","2841台開","110/07/28","陽信-石牌",13,0,13
"22370","2841台開","110/07/28","台新證券",6,13,-7
"22371","2841台開","110/07/28","台灣摩根士丹利",10,0,10
"22372","2841台開","110/07/28","台中銀",0,5,-5
"22373","2841台開","110/07/28","台新-高雄",10,0,10
"22374","2841台開","110/07/28","中國信託-中壢",0,5,-5
"22375","2841台開","110/07/28","國泰-忠孝",10,0,10
"22376","2841台開","110/07/28","元大-大同",0,5,-5
"22377","2841台開","110/07/28","元大-竹南",10,0,10
"22378","2841台開","110/07/28","元大-大益",0,4,-4
"22379","2841台開","110/07/28","元大-屏南",9,0,9
"22380","2841台開","110/07/28","元富-松德",0,3,-3
"22381","6207雷科","110/07/28","新加坡商瑞銀",153,44,109
"22382","6207雷科","110/07/28","康和-延平",0,48,-48
"22383","6207雷科","110/07/28","摩根大通",219,131,88
"22384","6207雷科","110/07/28","元富-大昌",0,33,-33
"22385","6207雷科","110/07/28","康和-台中",70,0,70
"22386","6207雷科","110/07/28","聯邦商銀",0,30,-30
"22387","6207雷科","110/07/28","凱基-台北",112,49,63
"22388","6207雷科","110/07/28","兆豐-三民",1,30,-29
"22389","6207雷科","110/07/28","凱基-復興",63,3,60
"22390","6207雷科","110/07/28","元大-龍潭",0,25,-25
"22391","6207雷科","110/07/28","群益金鼎-三民",59,8,51
"22392","6207雷科","110/07/28","宏遠證券",0,23,-23
"22393","6207雷科","110/07/28","永豐金-羅東",50,0,50
"22394","6207雷科","110/07/28","大昌-桃園",15,36,-21
"22395","6207雷科","110/07/28","美林",46,3,43
"22396","6207雷科","110/07/28","國泰-桃園",0,21,-21
"22397","6207雷科","110/07/28","群益金鼎-敦南",51,16,35
"22398","6207雷科","110/07/28","凱基-中壢",0,21,-21
"22399","6207雷科","110/07/28","日盛-忠孝",31,0,31
"22400","6207雷科","110/07/28","富邦-台北",4,24,-20
"22401","6207雷科","110/07/28","港商野村",32,8,24
"22402","6207雷科","110/07/28","臺銀-臺南",0,19,-19
"22403","6207雷科","110/07/28","群益金鼎-東門",22,0,22
"22404","6207雷科","110/07/28","新光",5,24,-19
"22405","6207雷科","110/07/28","統一-高雄",41,20,21
"22406","6207雷科","110/07/28","群益金鼎-大甲",1,20,-19
"22407","6207雷科","110/07/28","群益金鼎-延平",21,0,21
"22408","6207雷科","110/07/28","元大-中壢",10,28,-18
"22409","6207雷科","110/07/28","彰銀-台中",20,0,20
"22410","6207雷科","110/07/28","永豐金-北高雄",3,20,-17
"22411","3679新至陞","110/07/28","華南永昌-淡水",10,0,10
"22412","3679新至陞","110/07/28","瑞士信貸",0,25,-25
"22413","3679新至陞","110/07/28","富邦-嘉義",10,0,10
"22414","3679新至陞","110/07/28","凱基-台北",6,14,-8
"22415","3679新至陞","110/07/28","台中銀-員林",11,2,9
"22416","3679新至陞","110/07/28","美林",5,12,-7
"22417","3679新至陞","110/07/28","大昌-樹林",7,0,7
"22418","3679新至陞","110/07/28","摩根大通",5,11,-6
"22419","3679新至陞","110/07/28","康和-澎湖",5,0,5
"22420","3679新至陞","110/07/28","兆豐-新莊",0,5,-5
"22421","3679新至陞","110/07/28","富邦-台北",5,0,5
"22422","3679新至陞","110/07/28","群益金鼎-新莊",0,5,-5
"22423","3679新至陞","110/07/28","元大-成功",5,0,5
"22424","3679新至陞","110/07/28","台灣摩根士丹利",0,4,-4
"22425","3679新至陞","110/07/28","新加坡商瑞銀",3,0,3
"22426","3679新至陞","110/07/28","日盛-新竹",0,3,-3
"22427","3679新至陞","110/07/28","中國信託-新竹",3,0,3
"22428","3679新至陞","110/07/28","群益金鼎-東門",0,3,-3
"22429","3679新至陞","110/07/28","元大-新莊",3,0,3
"22430","3679新至陞","110/07/28","元大證券",0,3,-3
"22431","3679新至陞","110/07/28","宏遠-光隆",2,0,2
"22432","3679新至陞","110/07/28","元大-忠孝",0,3,-3
"22433","3679新至陞","110/07/28","大慶-蘆洲",2,0,2
"22434","3679新至陞","110/07/28","合庫-西台中",0,2,-2
"22435","3679新至陞","110/07/28","台新-左楠",2,0,2
"22436","3679新至陞","110/07/28","日盛-板橋",0,2,-2
"22437","3679新至陞","110/07/28","群益金鼎-三重",2,0,2
"22438","3679新至陞","110/07/28","國票-桃園",0,2,-2
"22439","3679新至陞","110/07/28","華南永昌-高雄",2,0,2
"22440","3679新至陞","110/07/28","台新-台南",0,2,-2
"22441","2727王品","110/07/28","凱基-台北",139,50,89
"22442","2727王品","110/07/28","新光-台中",9,68,-59
"22443","2727王品","110/07/28","美林",77,10,67
"22444","2727王品","110/07/28","瑞士信貸",16,54,-38
"22445","2727王品","110/07/28","港商野村",118,64,54
"22446","2727王品","110/07/28","華南永昌",4,41,-37
"22447","2727王品","110/07/28","國泰-敦南",51,30,21
"22448","2727王品","110/07/28","美商高盛",2,30,-28
"22449","2727王品","110/07/28","新加坡商瑞銀",58,38,20
"22450","2727王品","110/07/28","富邦-板橋",17,38,-21
"22451","2727王品","110/07/28","永豐金-中盛",24,4,20
"22452","2727王品","110/07/28","富邦-竹北",0,20,-20
"22453","2727王品","110/07/28","元大-南崁",20,2,18
"22454","2727王品","110/07/28","元大-小港",1,21,-20
"22455","2727王品","110/07/28","摩根大通",48,32,16
"22456","2727王品","110/07/28","凱基",0,18,-18
"22457","2727王品","110/07/28","臺銀-高雄",14,0,14
"22458","2727王品","110/07/28","統一",15,31,-16
"22459","2727王品","110/07/28","永豐金-桃盛",19,5,14
"22460","2727王品","110/07/28","國泰-台中",12,28,-16
"22461","2727王品","110/07/28","凱基-內湖",13,0,13
"22462","2727王品","110/07/28","元大-台中",7,22,-15
"22463","2727王品","110/07/28","永豐金-中正",15,2,13
"22464","2727王品","110/07/28","華南永昌-麻豆",0,14,-14
"22465","2727王品","110/07/28","富邦-建國",18,7,11
"22466","2727王品","110/07/28","永豐金-豐原",1,15,-14
"22467","2727王品","110/07/28","富邦-陽明",15,5,10
"22468","2727王品","110/07/28","國票-內壢",1,14,-13
"22469","2727王品","110/07/28","元大-南京",10,0,10
"22470","2727王品","110/07/28","永豐金證券",2,15,-13
"22471","1570力肯","110/07/28","國泰-敦南",50,0,50
"22472","1570力肯","110/07/28","元大-高雄",0,42,-42
"22473","1570力肯","110/07/28","群益金鼎-高雄",31,0,31
"22474","1570力肯","110/07/28","國票-新莊",0,14,-14
"22475","1570力肯","110/07/28","元富-延平",15,0,15
"22476","1570力肯","110/07/28","凱基-站前",0,10,-10
"22477","1570力肯","110/07/28","(牛牛牛)亞-鑫豐",10,0,10
"22478","1570力肯","110/07/28","凱基-台北",0,10,-10
"22479","1570力肯","110/07/28","元富-緯城",6,0,6
"22480","1570力肯","110/07/28","元大-忠孝",0,10,-10
"22481","1570力肯","110/07/28","合庫-自強",5,0,5
"22482","1570力肯","110/07/28","台灣摩根士丹利",0,9,-9
"22483","1570力肯","110/07/28","臺銀-臺南",4,0,4
"22484","1570力肯","110/07/28","群益金鼎-板橋",0,8,-8
"22485","1570力肯","110/07/28","兆豐-台中港",3,0,3
"22486","1570力肯","110/07/28","永豐金-大園",0,7,-7
"22487","1570力肯","110/07/28","日盛-板橋",2,0,2
"22488","1570力肯","110/07/28","元大-台南",0,5,-5
"22489","1570力肯","110/07/28","統一-松江",2,0,2
"22490","1570力肯","110/07/28","合庫-台中",0,4,-4
"22491","1570力肯","110/07/28","台新-三民",2,0,2
"22492","1570力肯","110/07/28","富邦-板橋",0,3,-3
"22493","1570力肯","110/07/28","群益金鼎-土城",2,0,2
"22494","1570力肯","110/07/28","元大-板橋",0,3,-3
"22495","1570力肯","110/07/28","元大-和平",2,0,2
"22496","1570力肯","110/07/28","統一-桃園",0,2,-2
"22497","1570力肯","110/07/28","元大-土城永寧",2,0,2
"22498","1570力肯","110/07/28","凱基-三多",0,2,-2
"22499","1570力肯","110/07/28","大昌-樹林",1,0,1
"22500","1570力肯","110/07/28","華南永昌-高雄",0,2,-2
"22501","6180橘子","110/07/28","凱基-台北",152,85,67
"22502","6180橘子","110/07/28","摩根大通",20,92,-72
"22503","6180橘子","110/07/28","新光",57,18,39
"22504","6180橘子","110/07/28","大慶-台中",0,33,-33
"22505","6180橘子","110/07/28","美商高盛",49,12,37
"22506","6180橘子","110/07/28","兆豐證券",0,25,-25
"22507","6180橘子","110/07/28","第一金-安和",20,0,20
"22508","6180橘子","110/07/28","元大-上新莊",0,22,-22
"22509","6180橘子","110/07/28","元富-桃園",20,0,20
"22510","6180橘子","110/07/28","新加坡商瑞銀",23,44,-21
"22511","6180橘子","110/07/28","第一金-員林",19,0,19
"22512","6180橘子","110/07/28","富邦-內湖",0,21,-21
"22513","6180橘子","110/07/28","富邦-嘉義",22,4,18
"22514","6180橘子","110/07/28","第一金-新興",0,20,-20
"22515","6180橘子","110/07/28","統一-嘉義",16,0,16
"22516","6180橘子","110/07/28","臺銀-臺南",5,22,-17
"22517","6180橘子","110/07/28","國票-九鼎",15,0,15
"22518","6180橘子","110/07/28","第一金-忠孝",0,10,-10
"22519","6180橘子","110/07/28","華南永昌-朴子",14,0,14
"22520","6180橘子","110/07/28","元富-屏東",0,10,-10
"22521","6180橘子","110/07/28","群益金鼎-台南",13,0,13
"22522","6180橘子","110/07/28","凱基-八德",1,11,-10
"22523","6180橘子","110/07/28","富邦-建國",13,1,12
"22524","6180橘子","110/07/28","元大-和平",1,11,-10
"22525","6180橘子","110/07/28","富邦-板橋",16,5,11
"22526","6180橘子","110/07/28","元大-台中中港",0,10,-10
"22527","6180橘子","110/07/28","元富-新店",10,0,10
"22528","6180橘子","110/07/28","元大-南屯",0,9,-9
"22529","6180橘子","110/07/28","元大-台南",10,0,10
"22530","6180橘子","110/07/28","永豐金-屏東",0,9,-9
"22531","2390云辰","110/07/28","摩根大通",1589,780,809
"22532","2390云辰","110/07/28","華南永昌-鳳山",34,290,-256
"22533","2390云辰","110/07/28","凱基-台北",457,300,157
"22534","2390云辰","110/07/28","凱基-基隆",0,224,-224
"22535","2390云辰","110/07/28","美林",330,206,124
"22536","2390云辰","110/07/28","元富-高雄",56,177,-121
"22537","2390云辰","110/07/28","元富-同大",159,35,124
"22538","2390云辰","110/07/28","元富-中港",1,100,-99
"22539","2390云辰","110/07/28","台灣摩根士丹利",193,71,122
"22540","2390云辰","110/07/28","兆豐-公益",4,100,-96
"22541","2390云辰","110/07/28","元大-前金",150,49,101
"22542","2390云辰","110/07/28","統一-新台中",180,274,-94
"22543","2390云辰","110/07/28","永豐金-鳳山",110,18,92
"22544","2390云辰","110/07/28","日盛-新莊",4,76,-72
"22545","2390云辰","110/07/28","元大-林園",99,11,88
"22546","2390云辰","110/07/28","永豐金-新店",0,57,-57
"22547","2390云辰","110/07/28","元大-信義",121,35,86
"22548","2390云辰","110/07/28","華南永昌-內壢",0,56,-56
"22549","2390云辰","110/07/28","美商高盛",206,123,83
"22550","2390云辰","110/07/28","第一金-豐原",9,63,-54
"22551","2390云辰","110/07/28","統一-城中",101,37,64
"22552","2390云辰","110/07/28","華南永昌-中正",13,67,-54
"22553","2390云辰","110/07/28","元大-竹山",75,20,55
"22554","2390云辰","110/07/28","元大-大益",7,59,-52
"22555","2390云辰","110/07/28","豐農",79,25,54
"22556","2390云辰","110/07/28","大慶",0,50,-50
"22557","2390云辰","110/07/28","新加坡商瑞銀",68,15,53
"22558","2390云辰","110/07/28","凱基-豐中",3,49,-46
"22559","2390云辰","110/07/28","統一-屏東",54,5,49
"22560","2390云辰","110/07/28","元大-彰化民生",7,51,-44
"22561","1471首利","110/07/27","永全-八德",50,0,50
"22562","1471首利","110/07/27","國票-九鼎",0,306,-306
"22563","1471首利","110/07/27","中國信託-松江",48,0,48
"22564","1471首利","110/07/27","兆豐-天母",1,115,-114
"22565","1471首利","110/07/27","富邦-嘉義",40,0,40
"22566","1471首利","110/07/27","美林",0,42,-42
"22567","1471首利","110/07/27","富邦-台南",33,0,33
"22568","1471首利","110/07/27","摩根大通",45,75,-30
"22569","1471首利","110/07/27","(牛牛牛)亞-鑫豐",32,0,32
"22570","1471首利","110/07/27","凱基-八德",0,30,-30
"22571","1471首利","110/07/27","台灣企銀-太平",25,0,25
"22572","1471首利","110/07/27","中國信託-高雄",0,25,-25
"22573","1471首利","110/07/27","群益金鼎-台中",23,0,23
"22574","1471首利","110/07/27","統一-新台中",0,24,-24
"22575","1471首利","110/07/27","元富-潮州",20,0,20
"22576","1471首利","110/07/27","聯邦-高雄",0,21,-21
"22577","1471首利","110/07/27","凱基-信義",20,0,20
"22578","1471首利","110/07/27","德信-中正",0,20,-20
"22579","1471首利","110/07/27","富邦-基隆",26,8,18
"22580","1471首利","110/07/27","元大-福營",3,20,-17
"22581","1471首利","110/07/27","日盛-高雄",17,0,17
"22582","1471首利","110/07/27","凱基-宜蘭",0,16,-16
"22583","1471首利","110/07/27","國泰-敦南",16,2,14
"22584","1471首利","110/07/27","凱基-天母",0,15,-15
"22585","1471首利","110/07/27","元大-大甲",13,0,13
"22586","1471首利","110/07/27","第一金-高雄",6,20,-14
"22587","1471首利","110/07/27","合庫-鳳山",12,0,12
"22588","1471首利","110/07/27","元大-中壢",0,13,-13
"22589","1471首利","110/07/27","日盛-大墩",12,0,12
"22590","1471首利","110/07/27","元富-安南",0,12,-12
"22591","2883開發金","110/07/27","元富",1762,67,1695
"22592","2883開發金","110/07/27","美林",0,11931,-11931
"22593","2883開發金","110/07/27","福邦證券",1450,0,1450
"22594","2883開發金","110/07/27","新加坡商瑞銀",1513,8370,-6857
"22595","2883開發金","110/07/27","凱基",1422,0,1422
"22596","2883開發金","110/07/27","凱基-台北",1081,5265,-4184
"22597","2883開發金","110/07/27","瑞士信貸",2044,731,1313
"22598","2883開發金","110/07/27","摩根大通",612,3392,-2780
"22599","2883開發金","110/07/27","台灣摩根士丹利",2112,921,1191
"22600","2883開發金","110/07/27","統一-仁愛",31,2002,-1971
"22601","2883開發金","110/07/27","新光",1474,461,1013
"22602","2883開發金","110/07/27","兆豐證券",192,1910,-1718
"22603","2883開發金","110/07/27","國票-長城",1003,20,983
"22604","2883開發金","110/07/27","(牛牛牛)亞-鑫豐",276,1815,-1539
"22605","2883開發金","110/07/27","台新證券",1207,362,845
"22606","2883開發金","110/07/27","永豐金-板橋",197,1610,-1413
"22607","2883開發金","110/07/27","港商野村",2209,1498,711
"22608","2883開發金","110/07/27","美商高盛",16,1337,-1321
"22609","2883開發金","110/07/27","永豐金-彰化",680,26,654
"22610","2883開發金","110/07/27","兆豐-北高雄",60,1360,-1300
"22611","2883開發金","110/07/27","台新-高雄",918,265,653
"22612","2883開發金","110/07/27","兆豐-景美",26,1070,-1044
"22613","2883開發金","110/07/27","國泰-敦南",1273,634,639
"22614","2883開發金","110/07/27","亞東-新竹",7,1001,-994
"22615","2883開發金","110/07/27","元大證券",876,246,630
"22616","2883開發金","110/07/27","富邦-羅東",201,1098,-897
"22617","2883開發金","110/07/27","致和證券",684,92,592
"22618","2883開發金","110/07/27","統一",159,811,-652
"22619","2883開發金","110/07/27","元大-民生",550,2,548
"22620","2883開發金","110/07/27","香港上海匯豐",0,584,-584
"22621","6205詮欣","110/07/27","土銀-和平",20,0,20
"22622","6205詮欣","110/07/27","摩根大通",3,22,-19
"22623","6205詮欣","110/07/27","臺銀-民權",20,6,14
"22624","6205詮欣","110/07/27","瑞士信貸",5,16,-11
"22625","6205詮欣","110/07/27","台新證券",5,0,5
"22626","6205詮欣","110/07/27","臺銀-鳳山",0,6,-6
"22627","6205詮欣","110/07/27","華南永昌-小港",5,0,5
"22628","6205詮欣","110/07/27","臺銀-新竹",0,5,-5
"22629","6205詮欣","110/07/27","日盛-新莊",4,0,4
"22630","6205詮欣","110/07/27","國票-和平",0,4,-4
"22631","6205詮欣","110/07/27","元富-三重",4,0,4
"22632","6205詮欣","110/07/27","凱基-東門",0,4,-4
"22633","6205詮欣","110/07/27","致和-佳里",4,1,3
"22634","6205詮欣","110/07/27","富邦-花蓮",0,3,-3
"22635","6205詮欣","110/07/27","華南永昌-岡山",3,0,3
"22636","6205詮欣","110/07/27","元大-北投",0,3,-3
"22637","6205詮欣","110/07/27","元大-成功",3,0,3
"22638","6205詮欣","110/07/27","元大-民生",2,5,-3
"22639","6205詮欣","110/07/27","土銀-嘉義",2,0,2
"22640","6205詮欣","110/07/27","日盛-三重",0,2,-2
"22641","6205詮欣","110/07/27","第一金-光復",2,0,2
"22642","6205詮欣","110/07/27","日盛-北高雄",0,2,-2
"22643","6205詮欣","110/07/27","統一-屏東",2,0,2
"22644","6205詮欣","110/07/27","港商野村",0,2,-2
"22645","6205詮欣","110/07/27","元富-新莊",2,0,2
"22646","6205詮欣","110/07/27","統一-彰化",0,2,-2
"22647","6205詮欣","110/07/27","兆豐-竹北",2,0,2
"22648","6205詮欣","110/07/27","永全",0,2,-2
"22649","6205詮欣","110/07/27","新光",2,0,2
"22650","6205詮欣","110/07/27","兆豐-西螺",0,2,-2
"22651","1540喬福","110/07/27","富邦-員林",10,0,10
"22652","1540喬福","110/07/27","合庫-台中",0,26,-26
"22653","1540喬福","110/07/27","元大-中壢",10,0,10
"22654","1540喬福","110/07/27","統一-新台中",0,25,-25
"22655","1540喬福","110/07/27","凱基-台中",8,0,8
"22656","1540喬福","110/07/27","元大-斗六",0,10,-10
"22657","1540喬福","110/07/27","大慶-中壢",5,0,5
"22658","1540喬福","110/07/27","凱基-中港",0,9,-9
"22659","1540喬福","110/07/27","兆豐-北高雄",5,0,5
"22660","1540喬福","110/07/27","國票-中正",0,8,-8
"22661","1540喬福","110/07/27","兆豐-三民",5,0,5
"22662","1540喬福","110/07/27","臺銀-臺中",0,5,-5
"22663","1540喬福","110/07/27","台新-台中",5,0,5
"22664","1540喬福","110/07/27","元富-中原",0,5,-5
"22665","1540喬福","110/07/27","國票-九鼎",4,0,4
"22666","1540喬福","110/07/27","新光-桃園",0,5,-5
"22667","1540喬福","110/07/27","富邦-高雄",5,1,4
"22668","1540喬福","110/07/27","大昌-新竹",0,4,-4
"22669","1540喬福","110/07/27","永豐金-羅東",4,0,4
"22670","1540喬福","110/07/27","元大-員林中山",0,4,-4
"22671","1540喬福","110/07/27","台新證券",3,0,3
"22672","1540喬福","110/07/27","群益金鼎-瑞豐",0,3,-3
"22673","1540喬福","110/07/27","華南永昌-台中",3,0,3
"22674","1540喬福","110/07/27","凱基-台北",0,3,-3
"22675","1540喬福","110/07/27","富邦-台東",3,0,3
"22676","1540喬福","110/07/27","富邦-建國",0,3,-3
"22677","1540喬福","110/07/27","元大-台中中港",3,0,3
"22678","1540喬福","110/07/27","國票-北投",0,2,-2
"22679","1540喬福","110/07/27","亞東",2,0,2
"22680","1540喬福","110/07/27","元大-鳳山",0,2,-2
"22681","2888新光金","110/07/27","台灣摩根士丹利",11737,746,10991
"22682","2888新光金","110/07/27","玉山-城中",112,6002,-5890
"22683","2888新光金","110/07/27","美林",3692,417,3275
"22684","2888新光金","110/07/27","新加坡商瑞銀",120,5935,-5815
"22685","2888新光金","110/07/27","凱基-台北",4378,2713,1665
"22686","2888新光金","110/07/27","摩根大通",1586,7187,-5601
"22687","2888新光金","110/07/27","凱基-台南",1551,3,1548
"22688","2888新光金","110/07/27","富邦-建國",298,5641,-5343
"22689","2888新光金","110/07/27","台新證券",1494,124,1370
"22690","2888新光金","110/07/27","第一金-高雄",81,5014,-4933
"22691","2888新光金","110/07/27","新光",2434,1212,1222
"22692","2888新光金","110/07/27","瑞士信貸",191,4524,-4333
"22693","2888新光金","110/07/27","元大-四維",1246,25,1221
"22694","2888新光金","110/07/27","兆豐-鹿港",45,2632,-2587
"22695","2888新光金","110/07/27","富隆-長安",1070,0,1070
"22696","2888新光金","110/07/27","國票-彰化",3,1803,-1800
"22697","2888新光金","110/07/27","永豐金-萬盛",1052,0,1052
"22698","2888新光金","110/07/27","港商野村",0,1434,-1434
"22699","2888新光金","110/07/27","法銀巴黎",1116,120,996
"22700","2888新光金","110/07/27","統一-高雄",173,1511,-1338
"22701","2888新光金","110/07/27","凱基-竹科",853,4,849
"22702","2888新光金","110/07/27","群益金鼎-古亭",40,1202,-1162
"22703","2888新光金","110/07/27","元大-斗信",874,50,824
"22704","2888新光金","110/07/27","日盛-樹林",34,1034,-1000
"22705","2888新光金","110/07/27","日盛-景美",811,119,692
"22706","2888新光金","110/07/27","統一-土城",18,1000,-982
"22707","2888新光金","110/07/27","元富-世貿",568,2,566
"22708","2888新光金","110/07/27","元大-鹿港",125,1057,-932
"22709","2888新光金","110/07/27","日盛-雙和",567,2,565
"22710","2888新光金","110/07/27","新光-桃園",91,993,-902
"22711","1340勝悅","110/07/27","亞東-台中",15,0,15
"22712","1340勝悅","110/07/27","凱基-岡山",0,25,-25
"22713","1340勝悅","110/07/27","元大-路竹",15,0,15
"22714","1340勝悅","110/07/27","合庫-嘉義",0,14,-14
"22715","1340勝悅","110/07/27","臺銀-臺中",7,0,7
"22716","1340勝悅","110/07/27","元大-北港",0,14,-14
"22717","1340勝悅","110/07/27","台新-台中",7,0,7
"22718","1340勝悅","110/07/27","凱基-台北",0,12,-12
"22719","1340勝悅","110/07/27","元大-屏南",6,0,6
"22720","1340勝悅","110/07/27","兆豐-三民",0,7,-7
"22721","1340勝悅","110/07/27","臺灣企銀-埔墘",5,0,5
"22722","1340勝悅","110/07/27","華南永昌-台中",1,7,-6
"22723","1340勝悅","110/07/27","日盛-板橋",5,0,5
"22724","1340勝悅","110/07/27","日盛-信義",0,5,-5
"22725","1340勝悅","110/07/27","日盛-新莊",5,0,5
"22726","1340勝悅","110/07/27","德信-和平",0,5,-5
"22727","1340勝悅","110/07/27","臺銀-鳳山",4,0,4
"22728","1340勝悅","110/07/27","台新證券",0,5,-5
"22729","1340勝悅","110/07/27","玉山-城中",4,0,4
"22730","1340勝悅","110/07/27","新光-高雄",0,4,-4
"22731","1340勝悅","110/07/27","美商高盛",3,0,3
"22732","1340勝悅","110/07/27","瑞士信貸",0,2,-2
"22733","1340勝悅","110/07/27","(牛牛牛)亞-鑫豐",3,0,3
"22734","1340勝悅","110/07/27","港商野村",0,2,-2
"22735","1340勝悅","110/07/27","國票-長城",2,0,2
"22736","1340勝悅","110/07/27","台新-高雄",1,3,-2
"22737","1340勝悅","110/07/27","新光",2,0,2
"22738","1340勝悅","110/07/27","玉山證券",0,2,-2
"22739","1340勝悅","110/07/27","群益金鼎-館前",2,0,2
"22740","1340勝悅","110/07/27","玉山-南京東路",0,2,-2
"22741","6246臺龍","110/07/27","永豐金-桃園",135,0,135
"22742","6246臺龍","110/07/27","元大-木柵",0,59,-59
"22743","6246臺龍","110/07/27","港商野村",111,30,81
"22744","6246臺龍","110/07/27","日盛-景美",0,52,-52
"22745","6246臺龍","110/07/27","元大-西螺",31,0,31
"22746","6246臺龍","110/07/27","華南永昌-彰化",0,46,-46
"22747","6246臺龍","110/07/27","群益金鼎-鳳山",27,0,27
"22748","6246臺龍","110/07/27","兆豐-松德",0,43,-43
"22749","6246臺龍","110/07/27","永豐金-虎尾",27,0,27
"22750","6246臺龍","110/07/27","華南永昌-公誠",5,35,-30
"22751","6246臺龍","110/07/27","玉山-台南",28,2,26
"22752","6246臺龍","110/07/27","凱基-幸福",0,28,-28
"22753","6246臺龍","110/07/27","元大-西屯",25,0,25
"22754","6246臺龍","110/07/27","元富-安南",0,22,-22
"22755","6246臺龍","110/07/27","國泰-忠孝",23,0,23
"22756","6246臺龍","110/07/27","日盛-文化",0,20,-20
"22757","6246臺龍","110/07/27","元大-大里",21,0,21
"22758","6246臺龍","110/07/27","兆豐-寶成",0,20,-20
"22759","6246臺龍","110/07/27","兆豐-竹北",20,0,20
"22760","6246臺龍","110/07/27","華南永昌-虎尾",0,20,-20
"22761","6246臺龍","110/07/27","元大-員林",20,0,20
"22762","6246臺龍","110/07/27","永豐金-埔里",0,19,-19
"22763","6246臺龍","110/07/27","永豐金-敦南",20,0,20
"22764","6246臺龍","110/07/27","兆豐-新營",2,20,-18
"22765","6246臺龍","110/07/27","永豐金-羅東",23,5,18
"22766","6246臺龍","110/07/27","新光-台中",3,20,-17
"22767","6246臺龍","110/07/27","永豐金-桃盛",18,0,18
"22768","6246臺龍","110/07/27","凱基-市政",0,17,-17
"22769","6246臺龍","110/07/27","統一",16,0,16
"22770","6246臺龍","110/07/27","元大-蘆洲",0,16,-16
"22771","00715L期街口布蘭特正2","110/07/27","元大證券",10436,28,10408
"22772","00715L期街口布蘭特正2","110/07/27","元大-萬華",0,751,-751
"22773","00715L期街口布蘭特正2","110/07/27","凱基-台北",4269,129,4140
"22774","00715L期街口布蘭特正2","110/07/27","元大-大里德芳",0,734,-734
"22775","00715L期街口布蘭特正2","110/07/27","群益金鼎",3798,0,3798
"22776","00715L期街口布蘭特正2","110/07/27","新光",380,1105,-725
"22777","00715L期街口布蘭特正2","110/07/27","永豐金證券",2610,22,2588
"22778","00715L期街口布蘭特正2","110/07/27","(牛牛牛)亞-網路",10,697,-687
"22779","00715L期街口布蘭特正2","110/07/27","國票",2605,21,2584
"22780","00715L期街口布蘭特正2","110/07/27","日盛-新莊",5,550,-545
"22781","00715L期街口布蘭特正2","110/07/27","富邦證券",1522,0,1522
"22782","00715L期街口布蘭特正2","110/07/27","玉山-高雄",7,494,-487
"22783","00715L期街口布蘭特正2","110/07/27","合庫證券",1507,239,1268
"22784","00715L期街口布蘭特正2","110/07/27","華南永昌",1,471,-470
"22785","00715L期街口布蘭特正2","110/07/27","元富",1102,0,1102
"22786","00715L期街口布蘭特正2","110/07/27","華南永昌-竹北",0,469,-469
"22787","00715L期街口布蘭特正2","110/07/27","凱基",980,0,980
"22788","00715L期街口布蘭特正2","110/07/27","兆豐-嘉義",0,420,-420
"22789","00715L期街口布蘭特正2","110/07/27","國票-博愛",702,0,702
"22790","00715L期街口布蘭特正2","110/07/27","國票-九鼎",0,409,-409
"22791","00715L期街口布蘭特正2","110/07/27","統一",796,117,679
"22792","00715L期街口布蘭特正2","110/07/27","統一-高雄",0,405,-405
"22793","00715L期街口布蘭特正2","110/07/27","華南永昌-長虹",810,185,625
"22794","00715L期街口布蘭特正2","110/07/27","富邦-彰化",0,402,-402
"22795","00715L期街口布蘭特正2","110/07/27","港商野村",1076,494,582
"22796","00715L期街口布蘭特正2","110/07/27","元大-羅東",0,400,-400
"22797","00715L期街口布蘭特正2","110/07/27","永豐金-三重",500,16,484
"22798","00715L期街口布蘭特正2","110/07/27","富邦-高雄",0,398,-398
"22799","00715L期街口布蘭特正2","110/07/27","元大-敦化",420,0,420
"22800","00715L期街口布蘭特正2","110/07/27","新光-台中",17,391,-374
"22801","8941關中","110/07/27","富邦-仁愛",4,0,4
"22802","8941關中","110/07/27","光和-溪湖",0,2,-2
"22803","8941關中","110/07/27","日盛-新莊",1,0,1
"22804","8941關中","110/07/27","富邦-園區",0,2,-2
"22805","8941關中","110/07/27","台新-高雄",1,0,1
"22806","8941關中","110/07/27","合庫-高雄",0,1,-1
"22807","8941關中","110/07/27","元大-金華",1,0,1
"22808","8941關中","110/07/27","凱基-台北",0,1,-1
"22809","8941關中","110/07/27","臺銀-鳳山",0,0,0
"22810","8941關中","110/07/27","富邦-台東",0,1,-1
"22811","8941關中","110/07/27","日盛-花蓮",0,0,0
"22812","8941關中","110/07/27","臺銀-鳳山",0,0,0
"22813","8941關中","110/07/27","康和-板橋",0,0,0
"22814","8941關中","110/07/27","日盛-花蓮",0,0,0
"22815","8941關中","110/07/27","富邦-宜蘭",0,0,0
"22816","8941關中","110/07/27","康和-板橋",0,0,0
"22817","8941關中","110/07/27","元大-新竹經國",0,0,0
"22818","8941關中","110/07/27","富邦-宜蘭",0,0,0
"22819","8941關中","110/07/27","永豐金-萬盛",0,0,0
"22820","8941關中","110/07/27","元大-新竹經國",0,0,0
"22821","8941關中","110/07/27","永豐金-桃盛",0,0,0
"22822","8941關中","110/07/27","永豐金-萬盛",0,0,0
"22823","8941關中","110/07/27","",NA,NA,NA
"22824","8941關中","110/07/27","永豐金-桃盛",0,0,0
"22825","8941關中","110/07/27","",NA,NA,NA
"22826","8941關中","110/07/27","",NA,NA,NA
"22827","8941關中","110/07/27","",NA,NA,NA
"22828","8941關中","110/07/27","",NA,NA,NA
"22829","8941關中","110/07/27","",NA,NA,NA
"22830","8941關中","110/07/27","",NA,NA,NA
"22831","8936國統","110/07/27","日盛-景美",100,0,100
"22832","8936國統","110/07/27","摩根大通",115,220,-105
"22833","8936國統","110/07/27","大慶-蘆洲",90,0,90
"22834","8936國統","110/07/27","玉山-桃園",0,75,-75
"22835","8936國統","110/07/27","台新-建北",60,0,60
"22836","8936國統","110/07/27","凱基-台北",13,77,-64
"22837","8936國統","110/07/27","日盛-忠孝",40,1,39
"22838","8936國統","110/07/27","元富-大昌",2,50,-48
"22839","8936國統","110/07/27","新加坡商瑞銀",109,71,38
"22840","8936國統","110/07/27","華南永昌-台中",4,45,-41
"22841","8936國統","110/07/27","華南永昌",30,0,30
"22842","8936國統","110/07/27","新光-台中",26,66,-40
"22843","8936國統","110/07/27","兆豐-來福",29,0,29
"22844","8936國統","110/07/27","台灣摩根士丹利",20,54,-34
"22845","8936國統","110/07/27","元大-旗山",28,0,28
"22846","8936國統","110/07/27","元大-東蘆",0,34,-34
"22847","8936國統","110/07/27","元大-松江",27,0,27
"22848","8936國統","110/07/27","富邦-仁愛",1,34,-33
"22849","8936國統","110/07/27","新光",41,19,22
"22850","8936國統","110/07/27","凱基-板橋",0,31,-31
"22851","8936國統","110/07/27","元富-林園",20,0,20
"22852","8936國統","110/07/27","凱基-信義",0,30,-30
"22853","8936國統","110/07/27","玉山-高雄",20,0,20
"22854","8936國統","110/07/27","瑞士信貸",1,30,-29
"22855","8936國統","110/07/27","凱基-桃園",23,3,20
"22856","8936國統","110/07/27","元大-花蓮",2,24,-22
"22857","8936國統","110/07/27","永豐金-永康",20,0,20
"22858","8936國統","110/07/27","元富-緯城",0,20,-20
"22859","8936國統","110/07/27","日盛-屏東",23,4,19
"22860","8936國統","110/07/27","群益金鼎-宜蘭",0,20,-20
"22861","6226光鼎","110/07/27","第一金-忠孝",405,4,401
"22862","6226光鼎","110/07/27","華南永昌-台南",5,240,-235
"22863","6226光鼎","110/07/27","台新-台中",272,75,197
"22864","6226光鼎","110/07/27","大慶-泰山",0,201,-201
"22865","6226光鼎","110/07/27","凱基-和平",155,7,148
"22866","6226光鼎","110/07/27","富邦-員林",2,151,-149
"22867","6226光鼎","110/07/27","新加坡商瑞銀",133,0,133
"22868","6226光鼎","110/07/27","群益金鼎-東大",23,165,-142
"22869","6226光鼎","110/07/27","統一-敦南",126,3,123
"22870","6226光鼎","110/07/27","元大-景美",3,132,-129
"22871","6226光鼎","110/07/27","台灣摩根士丹利",129,8,121
"22872","6226光鼎","110/07/27","台新-高雄",84,186,-102
"22873","6226光鼎","110/07/27","統一-新竹",117,1,116
"22874","6226光鼎","110/07/27","合庫證券",27,121,-94
"22875","6226光鼎","110/07/27","日盛證券",122,13,109
"22876","6226光鼎","110/07/27","致和-佳里",5,81,-76
"22877","6226光鼎","110/07/27","元大-潮州",101,1,100
"22878","6226光鼎","110/07/27","永豐金-南投",3,77,-74
"22879","6226光鼎","110/07/27","國泰-敦南",232,145,87
"22880","6226光鼎","110/07/27","台新-新莊",1,57,-56
"22881","6226光鼎","110/07/27","摩根大通",86,0,86
"22882","6226光鼎","110/07/27","日盛-中壢",11,64,-53
"22883","6226光鼎","110/07/27","元富",80,0,80
"22884","6226光鼎","110/07/27","日進",11,63,-52
"22885","6226光鼎","110/07/27","華南永昌-嘉義",80,1,79
"22886","6226光鼎","110/07/27","高橋",13,64,-51
"22887","6226光鼎","110/07/27","元大-高雄",70,3,67
"22888","6226光鼎","110/07/27","元大-土城",1,52,-51
"22889","6226光鼎","110/07/27","華南永昌",82,21,61
"22890","6226光鼎","110/07/27","華南永昌-林口",11,60,-49
"22891","2363矽統","110/07/27","國泰-敦南",541,118,423
"22892","2363矽統","110/07/27","摩根大通",317,1405,-1088
"22893","2363矽統","110/07/27","台新證券",564,333,231
"22894","2363矽統","110/07/27","美林",210,1095,-885
"22895","2363矽統","110/07/27","元大-沙鹿",196,9,187
"22896","2363矽統","110/07/27","港商野村",275,1065,-790
"22897","2363矽統","110/07/27","新光",300,151,149
"22898","2363矽統","110/07/27","凱基-台北",518,1192,-674
"22899","2363矽統","110/07/27","華南永昌-台南",108,3,105
"22900","2363矽統","110/07/27","新加坡商瑞銀",213,703,-490
"22901","2363矽統","110/07/27","華南永昌-朴子",140,43,97
"22902","2363矽統","110/07/27","富邦-南屯",6,272,-266
"22903","2363矽統","110/07/27","華南永昌-公誠",109,13,96
"22904","2363矽統","110/07/27","美商高盛",31,233,-202
"22905","2363矽統","110/07/27","元富-松德",95,1,94
"22906","2363矽統","110/07/27","元大證券",38,235,-197
"22907","2363矽統","110/07/27","中國信託-永康",102,8,94
"22908","2363矽統","110/07/27","永豐金證券",15,201,-186
"22909","2363矽統","110/07/27","台新-三民",111,21,90
"22910","2363矽統","110/07/27","亞東",46,206,-160
"22911","2363矽統","110/07/27","凱基-中港",85,3,82
"22912","2363矽統","110/07/27","群益金鼎",21,169,-148
"22913","2363矽統","110/07/27","元富-烏日",87,6,81
"22914","2363矽統","110/07/27","第一金-嘉義",0,100,-100
"22915","2363矽統","110/07/27","富邦-台北",135,56,79
"22916","2363矽統","110/07/27","凱基-彰化",9,100,-91
"22917","2363矽統","110/07/27","元大-復北",81,12,69
"22918","2363矽統","110/07/27","元富-佳里",27,97,-70
"22919","2363矽統","110/07/27","中國信託-忠孝",94,26,68
"22920","2363矽統","110/07/27","合庫-桃園",8,76,-68
"22921","8112至上","110/07/27","凱基-竹科",300,10,290
"22922","8112至上","110/07/27","凱基-三重",1,501,-500
"22923","8112至上","110/07/27","台灣摩根士丹利",271,49,222
"22924","8112至上","110/07/27","美林",21,339,-318
"22925","8112至上","110/07/27","摩根大通",488,427,61
"22926","8112至上","110/07/27","凱基-台北",423,615,-192
"22927","8112至上","110/07/27","香港上海匯豐",61,0,61
"22928","8112至上","110/07/27","港商野村",83,183,-100
"22929","8112至上","110/07/27","日盛證券",62,4,58
"22930","8112至上","110/07/27","永豐金-台南",2,79,-77
"22931","8112至上","110/07/27","元大-基隆孝二",52,0,52
"22932","8112至上","110/07/27","福邦證券",0,71,-71
"22933","8112至上","110/07/27","永豐金-中正",59,7,52
"22934","8112至上","110/07/27","兆豐-天母",0,50,-50
"22935","8112至上","110/07/27","群益金鼎-高盛",47,0,47
"22936","8112至上","110/07/27","元富-林園",3,52,-49
"22937","8112至上","110/07/27","永豐金-內湖",47,0,47
"22938","8112至上","110/07/27","永豐金-苓雅",1,50,-49
"22939","8112至上","110/07/27","富邦-台北",45,5,40
"22940","8112至上","110/07/27","元大-新莊",9,53,-44
"22941","8112至上","110/07/27","台新證券",78,39,39
"22942","8112至上","110/07/27","第一金-路竹",20,57,-37
"22943","8112至上","110/07/27","新光-台中",44,7,37
"22944","8112至上","110/07/27","新光-桃園",2,36,-34
"22945","8112至上","110/07/27","元大-羅東",38,1,37
"22946","8112至上","110/07/27","元大-東港",0,27,-27
"22947","8112至上","110/07/27","新光",101,65,36
"22948","8112至上","110/07/27","國泰-松江",2,28,-26
"22949","8112至上","110/07/27","元大-新竹",63,28,35
"22950","8112至上","110/07/27","群益金鼎-潭子",2,28,-26
"22951","1570力肯","110/07/27","國票-北高雄",7,0,7
"22952","1570力肯","110/07/27","元大-高雄",0,16,-16
"22953","1570力肯","110/07/27","富邦-陽明",5,0,5
"22954","1570力肯","110/07/27","國票-新莊",0,5,-5
"22955","1570力肯","110/07/27","元大-民雄",3,0,3
"22956","1570力肯","110/07/27","凱基-台北",0,5,-5
"22957","1570力肯","110/07/27","凱基-大里",3,0,3
"22958","1570力肯","110/07/27","美林",0,2,-2
"22959","1570力肯","110/07/27","凱基-長庚",3,0,3
"22960","1570力肯","110/07/27","富邦-南屯",0,2,-2
"22961","1570力肯","110/07/27","元大-新莊",2,0,2
"22962","1570力肯","110/07/27","元大-南崁",0,2,-2
"22963","1570力肯","110/07/27","大昌-樹林",2,0,2
"22964","1570力肯","110/07/27","元大-板橋",0,2,-2
"22965","1570力肯","110/07/27","台新-台中",2,0,2
"22966","1570力肯","110/07/27","新光",0,1,-1
"22967","1570力肯","110/07/27","新光-新竹",2,0,2
"22968","1570力肯","110/07/27","國泰-板橋",0,1,-1
"22969","1570力肯","110/07/27","富邦-左營",2,0,2
"22970","1570力肯","110/07/27","凱基-鳳山",0,1,-1
"22971","1570力肯","110/07/27","群益金鼎-土城",1,0,1
"22972","1570力肯","110/07/27","(牛牛牛)亞-鑫豐",2,2,0
"22973","1570力肯","110/07/27","凱基-竹東",1,0,1
"22974","1570力肯","110/07/27","元大-新盛",1,1,0
"22975","1570力肯","110/07/27","日盛-員林",1,0,1
"22976","1570力肯","110/07/27","",NA,NA,NA
"22977","1570力肯","110/07/27","玉山-板橋",1,0,1
"22978","1570力肯","110/07/27","",NA,NA,NA
"22979","1570力肯","110/07/27","元富-同大",1,0,1
"22980","1570力肯","110/07/27","",NA,NA,NA
"22981","2929淘帝","110/07/27","元大-民生",28,0,28
"22982","2929淘帝","110/07/27","元大-鳳山",0,20,-20
"22983","2929淘帝","110/07/27","臺銀-民權",18,0,18
"22984","2929淘帝","110/07/27","港商野村",1,18,-17
"22985","2929淘帝","110/07/27","合庫-高雄",13,0,13
"22986","2929淘帝","110/07/27","玉山-板橋",0,15,-15
"22987","2929淘帝","110/07/27","永興-水湳",10,0,10
"22988","2929淘帝","110/07/27","美林",0,10,-10
"22989","2929淘帝","110/07/27","富邦-陽明",10,0,10
"22990","2929淘帝","110/07/27","凱基-八德",0,10,-10
"22991","2929淘帝","110/07/27","元大-中和",10,0,10
"22992","2929淘帝","110/07/27","永豐金證券",0,9,-9
"22993","2929淘帝","110/07/27","國泰-館前",6,0,6
"22994","2929淘帝","110/07/27","新加坡商瑞銀",10,18,-8
"22995","2929淘帝","110/07/27","富邦-內湖",6,0,6
"22996","2929淘帝","110/07/27","富邦-台北",0,8,-8
"22997","2929淘帝","110/07/27","合庫-台南",5,0,5
"22998","2929淘帝","110/07/27","宏遠-台中",0,7,-7
"22999","2929淘帝","110/07/27","凱基-東門",5,0,5
"23000","2929淘帝","110/07/27","元富-潮州",0,7,-7
"23001","2929淘帝","110/07/27","元大-大益",5,0,5
"23002","2929淘帝","110/07/27","群益金鼎-延平",0,6,-6
"23003","2929淘帝","110/07/27","元大-屏南",5,0,5
"23004","2929淘帝","110/07/27","元大-文心",0,6,-6
"23005","2929淘帝","110/07/27","永豐金-板盛",5,0,5
"23006","2929淘帝","110/07/27","永豐金-中壢",0,6,-6
"23007","2929淘帝","110/07/27","臺銀",4,0,4
"23008","2929淘帝","110/07/27","美商高盛",0,5,-5
"23009","2929淘帝","110/07/27","永豐金-市政",4,0,4
"23010","2929淘帝","110/07/27","兆豐-南門",0,5,-5
"23011","5410國眾","110/07/27","摩根大通",47,0,47
"23012","5410國眾","110/07/27","元富-嘉義",0,48,-48
"23013","5410國眾","110/07/27","兆豐-城中",43,0,43
"23014","5410國眾","110/07/27","統一-平鎮",0,20,-20
"23015","5410國眾","110/07/27","香港上海匯豐",36,0,36
"23016","5410國眾","110/07/27","元大-大益",0,18,-18
"23017","5410國眾","110/07/27","港商麥格理",26,0,26
"23018","5410國眾","110/07/27","凱基-台北",0,16,-16
"23019","5410國眾","110/07/27","元富-大昌",21,0,21
"23020","5410國眾","110/07/27","凱基-站前",0,15,-15
"23021","5410國眾","110/07/27","元富-四維",20,0,20
"23022","5410國眾","110/07/27","元大-南勢角",0,13,-13
"23023","5410國眾","110/07/27","新光-台中",20,0,20
"23024","5410國眾","110/07/27","日盛-忠孝",0,11,-11
"23025","5410國眾","110/07/27","統一-金門",15,0,15
"23026","5410國眾","110/07/27","玉山-板橋",0,11,-11
"23027","5410國眾","110/07/27","玉山-高雄",15,0,15
"23028","5410國眾","110/07/27","元大-崇德",0,11,-11
"23029","5410國眾","110/07/27","凱基-竹北",15,0,15
"23030","5410國眾","110/07/27","元大-大天母",0,11,-11
"23031","5410國眾","110/07/27","元大-新莊",14,1,13
"23032","5410國眾","110/07/27","元富-松德",0,10,-10
"23033","5410國眾","110/07/27","華南永昌-中正",14,4,10
"23034","5410國眾","110/07/27","豐農",0,10,-10
"23035","5410國眾","110/07/27","元大-屏南",10,0,10
"23036","5410國眾","110/07/27","新光-新竹",0,10,-10
"23037","5410國眾","110/07/27","元大-中和",10,0,10
"23038","5410國眾","110/07/27","凱基-虎尾",0,10,-10
"23039","5410國眾","110/07/27","台新證券",10,1,9
"23040","5410國眾","110/07/27","元大-善化",0,10,-10
"23041","2841台開","110/07/27","日盛證券",620,0,620
"23042","2841台開","110/07/27","玉山-新竹",0,312,-312
"23043","2841台開","110/07/27","永豐金-豐原",65,0,65
"23044","2841台開","110/07/27","港商野村",0,216,-216
"23045","2841台開","110/07/27","元大-南投",50,0,50
"23046","2841台開","110/07/27","永興-水湳",0,90,-90
"23047","2841台開","110/07/27","台灣摩根士丹利",40,0,40
"23048","2841台開","110/07/27","凱基-興隆",0,64,-64
"23049","2841台開","110/07/27","玉山-高雄",29,0,29
"23050","2841台開","110/07/27","美林",0,30,-30
"23051","2841台開","110/07/27","第一金-台中",20,0,20
"23052","2841台開","110/07/27","國泰-松江",5,35,-30
"23053","2841台開","110/07/27","凱基-市政",20,0,20
"23054","2841台開","110/07/27","台新-左楠",0,25,-25
"23055","2841台開","110/07/27","群益金鼎-大甲",18,1,17
"23056","2841台開","110/07/27","大昌-樹林",0,20,-20
"23057","2841台開","110/07/27","台中銀",16,1,15
"23058","2841台開","110/07/27","富邦-仁愛",0,20,-20
"23059","2841台開","110/07/27","國泰-板橋",12,0,12
"23060","2841台開","110/07/27","致和-南京",0,16,-16
"23061","2841台開","110/07/27","群益金鼎-基隆",10,0,10
"23062","2841台開","110/07/27","凱基-台北",2,16,-14
"23063","2841台開","110/07/27","華南永昌-新莊",10,0,10
"23064","2841台開","110/07/27","日盛-台南",0,10,-10
"23065","2841台開","110/07/27","元大-福營",10,0,10
"23066","2841台開","110/07/27","國票-台東",0,10,-10
"23067","2841台開","110/07/27","元大-歸仁",10,0,10
"23068","2841台開","110/07/27","台新-台中",5,15,-10
"23069","2841台開","110/07/27","中國信託-文心",5,0,5
"23070","2841台開","110/07/27","凱基-台中",0,10,-10
"23071","6207雷科","110/07/27","摩根大通",249,119,130
"23072","6207雷科","110/07/27","永豐金-台南",2,82,-80
"23073","6207雷科","110/07/27","群益金鼎-丹鳳",70,0,70
"23074","6207雷科","110/07/27","永豐金-內湖",39,109,-70
"23075","6207雷科","110/07/27","群益金鼎-東門",42,0,42
"23076","6207雷科","110/07/27","新加坡商瑞銀",22,76,-54
"23077","6207雷科","110/07/27","永豐金-敦南",38,4,34
"23078","6207雷科","110/07/27","新光-高雄",4,57,-53
"23079","6207雷科","110/07/27","凱基-復興",30,0,30
"23080","6207雷科","110/07/27","瑞士信貸",0,40,-40
"23081","6207雷科","110/07/27","元大-東門",30,0,30
"23082","6207雷科","110/07/27","凱基-高雄",4,43,-39
"23083","6207雷科","110/07/27","大昌-桃園",33,8,25
"23084","6207雷科","110/07/27","華南永昌-高雄",4,40,-36
"23085","6207雷科","110/07/27","富邦-虎尾",24,0,24
"23086","6207雷科","110/07/27","新光",11,44,-33
"23087","6207雷科","110/07/27","凱基-羅東",24,2,22
"23088","6207雷科","110/07/27","日盛-板橋中山",0,29,-29
"23089","6207雷科","110/07/27","群益金鼎-延平",21,0,21
"23090","6207雷科","110/07/27","元大-六合",3,30,-27
"23091","6207雷科","110/07/27","群益金鼎-屏東",20,0,20
"23092","6207雷科","110/07/27","中國信託-新竹",7,33,-26
"23093","6207雷科","110/07/27","永豐金-埔里",20,0,20
"23094","6207雷科","110/07/27","元富-城中",0,23,-23
"23095","6207雷科","110/07/27","康和-延平",21,3,18
"23096","6207雷科","110/07/27","元大-大雅",2,20,-18
"23097","6207雷科","110/07/27","群益金鼎-中壢",20,2,18
"23098","6207雷科","110/07/27","永豐金-新莊",2,20,-18
"23099","6207雷科","110/07/27","宏遠證券",31,15,16
"23100","6207雷科","110/07/27","富邦-台中",5,21,-16
"23101","3679新至陞","110/07/27","凱基-市政",25,0,25
"23102","3679新至陞","110/07/27","瑞士信貸",0,13,-13
"23103","3679新至陞","110/07/27","兆豐-高雄",10,0,10
"23104","3679新至陞","110/07/27","元大-天母",0,9,-9
"23105","3679新至陞","110/07/27","光和-溪湖",8,0,8
"23106","3679新至陞","110/07/27","元大-彰化民生",0,6,-6
"23107","3679新至陞","110/07/27","臺銀-新竹",7,0,7
"23108","3679新至陞","110/07/27","康和-澎湖",2,7,-5
"23109","3679新至陞","110/07/27","新加坡商瑞銀",7,0,7
"23110","3679新至陞","110/07/27","聯邦-大業",0,5,-5
"23111","3679新至陞","110/07/27","永豐金-板橋",6,0,6
"23112","3679新至陞","110/07/27","元大-成功",0,5,-5
"23113","3679新至陞","110/07/27","宏遠-光隆",5,0,5
"23114","3679新至陞","110/07/27","康和-板橋",0,4,-4
"23115","3679新至陞","110/07/27","統一",5,0,5
"23116","3679新至陞","110/07/27","凱基-新豐",0,4,-4
"23117","3679新至陞","110/07/27","統一-新竹",5,0,5
"23118","3679新至陞","110/07/27","統一-高雄",0,3,-3
"23119","3679新至陞","110/07/27","元富-松德",5,0,5
"23120","3679新至陞","110/07/27","統一-新台中",0,3,-3
"23121","3679新至陞","110/07/27","元大-淡水",5,0,5
"23122","3679新至陞","110/07/27","元富-安南",0,3,-3
"23123","3679新至陞","110/07/27","日盛證券",4,0,4
"23124","3679新至陞","110/07/27","國票-北高雄",0,3,-3
"23125","3679新至陞","110/07/27","國泰-板橋",4,0,4
"23126","3679新至陞","110/07/27","玉山-新莊",0,3,-3
"23127","3679新至陞","110/07/27","(牛牛牛)亞-網路",3,0,3
"23128","3679新至陞","110/07/27","凱基-屏東",0,3,-3
"23129","3679新至陞","110/07/27","國票-九鼎",3,0,3
"23130","3679新至陞","110/07/27","台灣摩根士丹利",0,2,-2
"23131","2727王品","110/07/27","台灣摩根士丹利",103,12,91
"23132","2727王品","110/07/27","元大-彰化民生",11,420,-409
"23133","2727王品","110/07/27","華南永昌-麻豆",33,0,33
"23134","2727王品","110/07/27","美商高盛",0,247,-247
"23135","2727王品","110/07/27","元大-龍潭",31,1,30
"23136","2727王品","110/07/27","華南永昌",7,193,-186
"23137","2727王品","110/07/27","國泰-敦南",38,11,27
"23138","2727王品","110/07/27","花旗環球",0,86,-86
"23139","2727王品","110/07/27","群益金鼎-基隆",27,1,26
"23140","2727王品","110/07/27","凱基-台北",81,139,-58
"23141","2727王品","110/07/27","富邦-台中",26,0,26
"23142","2727王品","110/07/27","元大證券",23,64,-41
"23143","2727王品","110/07/27","元富",31,6,25
"23144","2727王品","110/07/27","瑞士信貸",0,37,-37
"23145","2727王品","110/07/27","元大-桃園",25,0,25
"23146","2727王品","110/07/27","富邦-建國",8,35,-27
"23147","2727王品","110/07/27","凱基-大直",21,1,20
"23148","2727王品","110/07/27","凱基-埔墘",6,29,-23
"23149","2727王品","110/07/27","日盛-士林",16,0,16
"23150","2727王品","110/07/27","美林",5,26,-21
"23151","2727王品","110/07/27","國票-敦北法人",17,1,16
"23152","2727王品","110/07/27","港商野村",12,30,-18
"23153","2727王品","110/07/27","群益金鼎-高雄",16,0,16
"23154","2727王品","110/07/27","華南永昌-林口",3,21,-18
"23155","2727王品","110/07/27","永豐金-忠孝",18,2,16
"23156","2727王品","110/07/27","彰銀-台中",4,20,-16
"23157","2727王品","110/07/27","臺銀-高雄",16,1,15
"23158","2727王品","110/07/27","統一",3,17,-14
"23159","2727王品","110/07/27","台新-台中",18,3,15
"23160","2727王品","110/07/27","富邦-新竹華信",2,15,-13
"23161","1570力肯","110/07/27","國票-北高雄",7,0,7
"23162","1570力肯","110/07/27","元大-高雄",0,16,-16
"23163","1570力肯","110/07/27","富邦-陽明",5,0,5
"23164","1570力肯","110/07/27","國票-新莊",0,5,-5
"23165","1570力肯","110/07/27","元大-民雄",3,0,3
"23166","1570力肯","110/07/27","凱基-台北",0,5,-5
"23167","1570力肯","110/07/27","凱基-大里",3,0,3
"23168","1570力肯","110/07/27","美林",0,2,-2
"23169","1570力肯","110/07/27","凱基-長庚",3,0,3
"23170","1570力肯","110/07/27","富邦-南屯",0,2,-2
"23171","1570力肯","110/07/27","元大-新莊",2,0,2
"23172","1570力肯","110/07/27","元大-南崁",0,2,-2
"23173","1570力肯","110/07/27","大昌-樹林",2,0,2
"23174","1570力肯","110/07/27","元大-板橋",0,2,-2
"23175","1570力肯","110/07/27","台新-台中",2,0,2
"23176","1570力肯","110/07/27","新光",0,1,-1
"23177","1570力肯","110/07/27","新光-新竹",2,0,2
"23178","1570力肯","110/07/27","國泰-板橋",0,1,-1
"23179","1570力肯","110/07/27","富邦-左營",2,0,2
"23180","1570力肯","110/07/27","凱基-鳳山",0,1,-1
"23181","1570力肯","110/07/27","群益金鼎-土城",1,0,1
"23182","1570力肯","110/07/27","(牛牛牛)亞-鑫豐",2,2,0
"23183","1570力肯","110/07/27","凱基-竹東",1,0,1
"23184","1570力肯","110/07/27","元大-新盛",1,1,0
"23185","1570力肯","110/07/27","日盛-員林",1,0,1
"23186","1570力肯","110/07/27","",NA,NA,NA
"23187","1570力肯","110/07/27","玉山-板橋",1,0,1
"23188","1570力肯","110/07/27","",NA,NA,NA
"23189","1570力肯","110/07/27","元富-同大",1,0,1
"23190","1570力肯","110/07/27","",NA,NA,NA
"23191","6180橘子","110/07/27","新加坡商瑞銀",166,24,142
"23192","6180橘子","110/07/27","花旗環球",31,87,-56
"23193","6180橘子","110/07/27","彰銀-台中",50,1,49
"23194","6180橘子","110/07/27","凱基-台北",53,108,-55
"23195","6180橘子","110/07/27","日盛-文化",48,8,40
"23196","6180橘子","110/07/27","新光",39,81,-42
"23197","6180橘子","110/07/27","美林",39,0,39
"23198","6180橘子","110/07/27","富邦-台北",1,25,-24
"23199","6180橘子","110/07/27","元大-草屯",54,17,37
"23200","6180橘子","110/07/27","第一金-員林",0,22,-22
"23201","6180橘子","110/07/27","美商高盛",35,1,34
"23202","6180橘子","110/07/27","富邦-新竹華信",7,28,-21
"23203","6180橘子","110/07/27","元大-上新莊",32,0,32
"23204","6180橘子","110/07/27","凱基-中山",5,24,-19
"23205","6180橘子","110/07/27","台灣摩根士丹利",30,0,30
"23206","6180橘子","110/07/27","國泰-敦南",22,37,-15
"23207","6180橘子","110/07/27","摩根大通",49,21,28
"23208","6180橘子","110/07/27","合庫-自強",2,16,-14
"23209","6180橘子","110/07/27","兆豐-大同",30,4,26
"23210","6180橘子","110/07/27","大昌-安康",1,14,-13
"23211","6180橘子","110/07/27","元大-羅東",21,0,21
"23212","6180橘子","110/07/27","高橋",0,11,-11
"23213","6180橘子","110/07/27","日盛-頭份",16,0,16
"23214","6180橘子","110/07/27","土銀-新竹",0,10,-10
"23215","6180橘子","110/07/27","瑞士信貸",24,8,16
"23216","6180橘子","110/07/27","兆豐-麻豆",0,10,-10
"23217","6180橘子","110/07/27","群益金鼎-士林",15,0,15
"23218","6180橘子","110/07/27","康和-永和",0,10,-10
"23219","6180橘子","110/07/27","永豐金-南京",15,1,14
"23220","6180橘子","110/07/27","永豐金-竹科",2,12,-10
"23221","2390云辰","110/07/27","凱基-基隆",207,3,204
"23222","2390云辰","110/07/27","凱基-台北",248,732,-484
"23223","2390云辰","110/07/27","摩根大通",730,560,170
"23224","2390云辰","110/07/27","美林",17,218,-201
"23225","2390云辰","110/07/27","華南永昌-中正",182,43,139
"23226","2390云辰","110/07/27","港商野村",85,277,-192
"23227","2390云辰","110/07/27","兆豐-北高雄",124,1,123
"23228","2390云辰","110/07/27","玉山-新莊",4,87,-83
"23229","2390云辰","110/07/27","元大-信義",108,5,103
"23230","2390云辰","110/07/27","新光",96,163,-67
"23231","2390云辰","110/07/27","富邦-陽明",94,22,72
"23232","2390云辰","110/07/27","新光-新竹",7,74,-67
"23233","2390云辰","110/07/27","日盛證券",140,71,69
"23234","2390云辰","110/07/27","富邦-左營",46,107,-61
"23235","2390云辰","110/07/27","第一金-豐原",56,0,56
"23236","2390云辰","110/07/27","大昌-新店",9,64,-55
"23237","2390云辰","110/07/27","統一-新台中",67,22,45
"23238","2390云辰","110/07/27","日盛-和美",28,81,-53
"23239","2390云辰","110/07/27","元大-復北",47,2,45
"23240","2390云辰","110/07/27","元大-台南",3,54,-51
"23241","2390云辰","110/07/27","富邦-建國",54,10,44
"23242","2390云辰","110/07/27","元富-世貿",10,60,-50
"23243","2390云辰","110/07/27","兆豐-桃鶯",46,5,41
"23244","2390云辰","110/07/27","華南永昌-鳳山",41,90,-49
"23245","2390云辰","110/07/27","富邦-中壢",45,4,41
"23246","2390云辰","110/07/27","聯邦商銀",6,52,-46
"23247","2390云辰","110/07/27","富邦-新竹華信",46,11,35
"23248","2390云辰","110/07/27","合庫-高雄",7,50,-43
"23249","2390云辰","110/07/27","第一金-華江",30,2,28
"23250","2390云辰","110/07/27","瑞士信貸",0,42,-42
"23251","2363矽統","110/07/26","凱基-台北",1994,468,1526
"23252","2363矽統","110/07/26","富邦-南屯",5,375,-370
"23253","2363矽統","110/07/26","新加坡商瑞銀",1537,208,1329
"23254","2363矽統","110/07/26","聯邦-興中",0,203,-203
"23255","2363矽統","110/07/26","摩根大通",2033,997,1036
"23256","2363矽統","110/07/26","台新證券",427,622,-195
"23257","2363矽統","110/07/26","瑞士信貸",930,0,930
"23258","2363矽統","110/07/26","元大-鳳中",10,203,-193
"23259","2363矽統","110/07/26","美林",985,76,909
"23260","2363矽統","110/07/26","國泰-板橋",69,209,-140
"23261","2363矽統","110/07/26","港商野村",1072,282,790
"23262","2363矽統","110/07/26","北城證券",6,132,-126
"23263","2363矽統","110/07/26","美商高盛",711,7,704
"23264","2363矽統","110/07/26","華南永昌-朴子",30,152,-122
"23265","2363矽統","110/07/26","新光",570,278,292
"23266","2363矽統","110/07/26","台新-台中",27,145,-118
"23267","2363矽統","110/07/26","台新-台南",244,39,205
"23268","2363矽統","110/07/26","群益金鼎-萬華",13,128,-115
"23269","2363矽統","110/07/26","元大證券",243,52,191
"23270","2363矽統","110/07/26","日盛-樹林",7,116,-109
"23271","2363矽統","110/07/26","永豐金證券",189,27,162
"23272","2363矽統","110/07/26","群益金鼎-屏東",200,303,-103
"23273","2363矽統","110/07/26","元大-楊梅",177,16,161
"23274","2363矽統","110/07/26","元大-潮州",6,102,-96
"23275","2363矽統","110/07/26","群益金鼎",158,21,137
"23276","2363矽統","110/07/26","新光-桃園",22,117,-95
"23277","2363矽統","110/07/26","元富-城東",107,8,99
"23278","2363矽統","110/07/26","凱基-和平",45,140,-95
"23279","2363矽統","110/07/26","日盛-雙和",109,14,95
"23280","2363矽統","110/07/26","合庫-台南",5,95,-90
"23281","8112至上","110/07/26","摩根大通",1728,41,1687
"23282","8112至上","110/07/26","玉山-左營",3,600,-597
"23283","8112至上","110/07/26","台灣摩根士丹利",408,10,398
"23284","8112至上","110/07/26","凱基-三重",1,527,-526
"23285","8112至上","110/07/26","凱基-台北",693,311,382
"23286","8112至上","110/07/26","中國信託-忠孝",0,103,-103
"23287","8112至上","110/07/26","港商法國興業",376,1,375
"23288","8112至上","110/07/26","凱基-站前",7,105,-98
"23289","8112至上","110/07/26","美商高盛",172,26,146
"23290","8112至上","110/07/26","國票-中港",0,96,-96
"23291","8112至上","110/07/26","新加坡商瑞銀",201,69,132
"23292","8112至上","110/07/26","兆豐-公益",3,84,-81
"23293","8112至上","110/07/26","美林",192,62,130
"23294","8112至上","110/07/26","玉山證券",2,65,-63
"23295","8112至上","110/07/26","港商野村",142,58,84
"23296","8112至上","110/07/26","統一-台中",1,62,-61
"23297","8112至上","110/07/26","凱基-永和",75,0,75
"23298","8112至上","110/07/26","富邦-陽明",3,60,-57
"23299","8112至上","110/07/26","凱基-竹科",65,2,63
"23300","8112至上","110/07/26","新光-新竹",86,141,-55
"23301","8112至上","110/07/26","華南永昌-敦南",63,1,62
"23302","8112至上","110/07/26","富邦-台北",2,57,-55
"23303","8112至上","110/07/26","兆豐-天母",50,0,50
"23304","8112至上","110/07/26","玉山-板橋",2,51,-49
"23305","8112至上","110/07/26","新光-桃園",57,11,46
"23306","8112至上","110/07/26","台新-新營",6,47,-41
"23307","8112至上","110/07/26","光和",35,1,34
"23308","8112至上","110/07/26","元大-虎尾",4,42,-38
"23309","8112至上","110/07/26","華南永昌-新莊",31,3,28
"23310","8112至上","110/07/26","日盛-新竹",1,38,-37
"23311","1570力肯","110/07/26","元大-民雄",10,0,10
"23312","1570力肯","110/07/26","元大-高雄",0,33,-33
"23313","1570力肯","110/07/26","新光-台中",10,1,9
"23314","1570力肯","110/07/26","日盛-宜蘭",0,8,-8
"23315","1570力肯","110/07/26","富邦-陽明",9,0,9
"23316","1570力肯","110/07/26","美林",0,5,-5
"23317","1570力肯","110/07/26","大慶-蘆洲",8,0,8
"23318","1570力肯","110/07/26","凱基-永康",0,5,-5
"23319","1570力肯","110/07/26","福勝",8,0,8
"23320","1570力肯","110/07/26","台新證券",0,4,-4
"23321","1570力肯","110/07/26","凱基-桃園",7,0,7
"23322","1570力肯","110/07/26","元大-汐止",0,4,-4
"23323","1570力肯","110/07/26","中國信託-永康",3,0,3
"23324","1570力肯","110/07/26","元大-桃興",0,3,-3
"23325","1570力肯","110/07/26","兆豐-台中港",3,0,3
"23326","1570力肯","110/07/26","元富-吉利",0,2,-2
"23327","1570力肯","110/07/26","國票-北高雄",3,0,3
"23328","1570力肯","110/07/26","國泰-板橋",0,2,-2
"23329","1570力肯","110/07/26","富邦-員林",3,0,3
"23330","1570力肯","110/07/26","元大-台中",0,2,-2
"23331","1570力肯","110/07/26","瑞士信貸",2,0,2
"23332","1570力肯","110/07/26","元大-西螺",0,2,-2
"23333","1570力肯","110/07/26","大昌-樹林",2,0,2
"23334","1570力肯","110/07/26","元大-苑裡",0,2,-2
"23335","1570力肯","110/07/26","兆豐-忠孝",2,0,2
"23336","1570力肯","110/07/26","合庫-三重",0,1,-1
"23337","1570力肯","110/07/26","新光",2,0,2
"23338","1570力肯","110/07/26","臺銀-臺南",0,1,-1
"23339","1570力肯","110/07/26","凱基-台北",2,0,2
"23340","1570力肯","110/07/26","元富-永和",0,1,-1
"23341","2929淘帝","110/07/26","合庫-高雄",47,0,47
"23342","2929淘帝","110/07/26","港商野村",11,42,-31
"23343","2929淘帝","110/07/26","元大-民生",28,0,28
"23344","2929淘帝","110/07/26","凱基-林口",0,30,-30
"23345","2929淘帝","110/07/26","臺銀-鳳山",10,0,10
"23346","2929淘帝","110/07/26","美林",1,28,-27
"23347","2929淘帝","110/07/26","華南永昌-鶯歌",10,0,10
"23348","2929淘帝","110/07/26","富邦-竹北",0,20,-20
"23349","2929淘帝","110/07/26","元大-永和",10,0,10
"23350","2929淘帝","110/07/26","凱基-台北",0,12,-12
"23351","2929淘帝","110/07/26","永豐金證券",8,0,8
"23352","2929淘帝","110/07/26","中國信託-永康",0,10,-10
"23353","2929淘帝","110/07/26","元大-太平",8,1,7
"23354","2929淘帝","110/07/26","摩根大通",0,10,-10
"23355","2929淘帝","110/07/26","德信-和平",6,0,6
"23356","2929淘帝","110/07/26","群益金鼎-高雄",0,10,-10
"23357","2929淘帝","110/07/26","兆豐-南門",6,0,6
"23358","2929淘帝","110/07/26","富邦-宜蘭",0,10,-10
"23359","2929淘帝","110/07/26","元大-新竹經國",6,0,6
"23360","2929淘帝","110/07/26","新加坡商瑞銀",4,13,-9
"23361","2929淘帝","110/07/26","合庫-台南",5,0,5
"23362","2929淘帝","110/07/26","元富-敦南",0,7,-7
"23363","2929淘帝","110/07/26","第一金-新興",5,0,5
"23364","2929淘帝","110/07/26","元大-基隆",0,6,-6
"23365","2929淘帝","110/07/26","玉山-新竹",5,0,5
"23366","2929淘帝","110/07/26","新光-台中",1,6,-5
"23367","2929淘帝","110/07/26","元大-金門",5,0,5
"23368","2929淘帝","110/07/26","華南永昌",0,5,-5
"23369","2929淘帝","110/07/26","台新-台中",4,0,4
"23370","2929淘帝","110/07/26","永豐金-中和",0,5,-5
"23371","5410國眾","110/07/26","摩根大通",71,0,71
"23372","5410國眾","110/07/26","日盛-忠孝",0,142,-142
"23373","5410國眾","110/07/26","凱基-台北",67,4,63
"23374","5410國眾","110/07/26","元富-嘉義",0,55,-55
"23375","5410國眾","110/07/26","兆豐-城中",47,0,47
"23376","5410國眾","110/07/26","國泰-敦南",2,30,-28
"23377","5410國眾","110/07/26","永豐金-內湖",45,0,45
"23378","5410國眾","110/07/26","群益金鼎-板橋",0,15,-15
"23379","5410國眾","110/07/26","元大-新莊",26,0,26
"23380","5410國眾","110/07/26","華南永昌-三重",0,11,-11
"23381","5410國眾","110/07/26","兆豐-麻豆",10,0,10
"23382","5410國眾","110/07/26","永全-南崁",0,10,-10
"23383","5410國眾","110/07/26","新光-台中",10,0,10
"23384","5410國眾","110/07/26","台新-建北",1,11,-10
"23385","5410國眾","110/07/26","元大-屏南",10,0,10
"23386","5410國眾","110/07/26","臺銀-臺南",0,8,-8
"23387","5410國眾","110/07/26","港商野村",9,0,9
"23388","5410國眾","110/07/26","群益金鼎-東大",0,7,-7
"23389","5410國眾","110/07/26","新光",13,4,9
"23390","5410國眾","110/07/26","永豐金-中正",0,7,-7
"23391","5410國眾","110/07/26","華南永昌-小港",7,0,7
"23392","5410國眾","110/07/26","永豐金-桃園",0,7,-7
"23393","5410國眾","110/07/26","玉山-左營",6,0,6
"23394","5410國眾","110/07/26","第一金-高雄",0,6,-6
"23395","5410國眾","110/07/26","土銀-台南",5,0,5
"23396","5410國眾","110/07/26","台中銀-豐原",0,6,-6
"23397","5410國眾","110/07/26","新加坡商瑞銀",5,0,5
"23398","5410國眾","110/07/26","亞東-高雄",0,5,-5
"23399","5410國眾","110/07/26","元富-三重",8,3,5
"23400","5410國眾","110/07/26","國票-北高雄",0,5,-5
"23401","2841台開","110/07/26","台新-台中",282,5,277
"23402","2841台開","110/07/26","港商野村",0,128,-128
"23403","2841台開","110/07/26","凱基-台北",41,0,41
"23404","2841台開","110/07/26","富邦-仁愛",0,70,-70
"23405","2841台開","110/07/26","台灣摩根士丹利",40,0,40
"23406","2841台開","110/07/26","元大-彰化",0,60,-60
"23407","2841台開","110/07/26","元富-緯城",40,0,40
"23408","2841台開","110/07/26","永興-水湳",0,30,-30
"23409","2841台開","110/07/26","玉山-高雄",38,0,38
"23410","2841台開","110/07/26","富邦-新竹華信",0,23,-23
"23411","2841台開","110/07/26","日盛-樹林",21,0,21
"23412","2841台開","110/07/26","宏遠-光隆",0,20,-20
"23413","2841台開","110/07/26","元大-松江",20,0,20
"23414","2841台開","110/07/26","玉山證券",0,20,-20
"23415","2841台開","110/07/26","元大-歸仁",20,0,20
"23416","2841台開","110/07/26","富邦-板橋",0,20,-20
"23417","2841台開","110/07/26","國泰-桃園",20,3,17
"23418","2841台開","110/07/26","元大-台中中港",0,19,-19
"23419","2841台開","110/07/26","新光-台中",15,0,15
"23420","2841台開","110/07/26","臺銀-臺南",0,18,-18
"23421","2841台開","110/07/26","群益金鼎-東門",11,0,11
"23422","2841台開","110/07/26","永豐金-敦南",3,19,-16
"23423","2841台開","110/07/26","華南永昌-內壢",11,0,11
"23424","2841台開","110/07/26","統一-桃園",0,13,-13
"23425","2841台開","110/07/26","元富-烏日",10,0,10
"23426","2841台開","110/07/26","國泰-台中",0,11,-11
"23427","2841台開","110/07/26","國泰-忠孝",10,2,8
"23428","2841台開","110/07/26","元大-福營",0,11,-11
"23429","2841台開","110/07/26","元大-潮州",6,0,6
"23430","2841台開","110/07/26","凱基-站前",0,10,-10
"23431","6207雷科","110/07/26","元大-向上",70,0,70
"23432","6207雷科","110/07/26","摩根大通",45,241,-196
"23433","6207雷科","110/07/26","國票-中和",67,5,62
"23434","6207雷科","110/07/26","華南永昌-台中",16,180,-164
"23435","6207雷科","110/07/26","永豐金-台南",63,2,61
"23436","6207雷科","110/07/26","瑞士信貸",4,69,-65
"23437","6207雷科","110/07/26","國泰-板橋",32,0,32
"23438","6207雷科","110/07/26","國票-天祥",11,76,-65
"23439","6207雷科","110/07/26","華南永昌-朴子",24,0,24
"23440","6207雷科","110/07/26","新加坡商瑞銀",15,78,-63
"23441","6207雷科","110/07/26","台新證券",35,12,23
"23442","6207雷科","110/07/26","凱基-台北",86,134,-48
"23443","6207雷科","110/07/26","永豐金-板盛",24,1,23
"23444","6207雷科","110/07/26","富邦-台中",58,100,-42
"23445","6207雷科","110/07/26","康和-台中",24,2,22
"23446","6207雷科","110/07/26","兆豐-大安",0,41,-41
"23447","6207雷科","110/07/26","台新-台南",22,2,20
"23448","6207雷科","110/07/26","群益金鼎-館前",0,40,-40
"23449","6207雷科","110/07/26","元大-大統",22,2,20
"23450","6207雷科","110/07/26","富邦-羅東",2,39,-37
"23451","6207雷科","110/07/26","元富-桃園",19,0,19
"23452","6207雷科","110/07/26","國票-台東",0,30,-30
"23453","6207雷科","110/07/26","高橋",17,0,17
"23454","6207雷科","110/07/26","凱基-士林",1,30,-29
"23455","6207雷科","110/07/26","元富-同大",30,13,17
"23456","6207雷科","110/07/26","元大-南京",3,31,-28
"23457","6207雷科","110/07/26","元大-內湖",17,0,17
"23458","6207雷科","110/07/26","宏遠-桃園",0,24,-24
"23459","6207雷科","110/07/26","永豐金-內湖",19,2,17
"23460","6207雷科","110/07/26","國票-和平",0,23,-23
"23461","3679新至陞","110/07/26","元富-板橋",16,0,16
"23462","3679新至陞","110/07/26","台新-台中",0,19,-19
"23463","3679新至陞","110/07/26","華南永昌-淡水",10,0,10
"23464","3679新至陞","110/07/26","元大-成功",0,10,-10
"23465","3679新至陞","110/07/26","光和-溪湖",8,0,8
"23466","3679新至陞","110/07/26","日進",0,9,-9
"23467","3679新至陞","110/07/26","宏遠-光隆",6,0,6
"23468","3679新至陞","110/07/26","臺銀-臺中",0,5,-5
"23469","3679新至陞","110/07/26","玉山-嘉義",5,0,5
"23470","3679新至陞","110/07/26","港商法國興業",0,4,-4
"23471","3679新至陞","110/07/26","元富-安南",3,0,3
"23472","3679新至陞","110/07/26","統一-新台中",0,3,-3
"23473","3679新至陞","110/07/26","摩根大通",4,1,3
"23474","3679新至陞","110/07/26","大慶-苗栗",1,3,-2
"23475","3679新至陞","110/07/26","凱基-台北",5,2,3
"23476","3679新至陞","110/07/26","元富-松德",0,2,-2
"23477","3679新至陞","110/07/26","凱基-站前",2,0,2
"23478","3679新至陞","110/07/26","富邦-仁愛",0,2,-2
"23479","3679新至陞","110/07/26","華南永昌",2,0,2
"23480","3679新至陞","110/07/26","元大-文心興安",0,2,-2
"23481","3679新至陞","110/07/26","元大-上新莊",2,0,2
"23482","3679新至陞","110/07/26","永豐金證券",0,2,-2
"23483","3679新至陞","110/07/26","美林",4,3,1
"23484","3679新至陞","110/07/26","臺銀-高雄",0,1,-1
"23485","3679新至陞","110/07/26","台灣摩根士丹利",2,1,1
"23486","3679新至陞","110/07/26","台灣企銀-屏東",0,1,-1
"23487","3679新至陞","110/07/26","美商高盛",1,0,1
"23488","3679新至陞","110/07/26","大慶-富順",0,1,-1
"23489","3679新至陞","110/07/26","富邦-台北",1,0,1
"23490","3679新至陞","110/07/26","統一-彰化",0,1,-1
"23491","2727王品","110/07/26","兆豐-南京",300,0,300
"23492","2727王品","110/07/26","元富-安南",0,62,-62
"23493","2727王品","110/07/26","凱基-台北",74,29,45
"23494","2727王品","110/07/26","瑞士信貸",0,44,-44
"23495","2727王品","110/07/26","富邦-建國",25,2,23
"23496","2727王品","110/07/26","新加坡商瑞銀",0,44,-44
"23497","2727王品","110/07/26","台灣摩根士丹利",22,0,22
"23498","2727王品","110/07/26","統一",11,54,-43
"23499","2727王品","110/07/26","永豐金-屏東",14,1,13
"23500","2727王品","110/07/26","美林",4,39,-35
"23501","2727王品","110/07/26","富邦-桃園",12,1,11
"23502","2727王品","110/07/26","第一金",0,30,-30
"23503","2727王品","110/07/26","日盛-鳳山",11,1,10
"23504","2727王品","110/07/26","康和-台中",0,30,-30
"23505","2727王品","110/07/26","元富-城中",10,0,10
"23506","2727王品","110/07/26","國泰證券",1,31,-30
"23507","2727王品","110/07/26","元大-龍潭",11,1,10
"23508","2727王品","110/07/26","元大證券",37,67,-30
"23509","2727王品","110/07/26","新光-台中",15,6,9
"23510","2727王品","110/07/26","康和",1,29,-28
"23511","2727王品","110/07/26","富邦-台中",10,1,9
"23512","2727王品","110/07/26","永豐金證券",0,27,-27
"23513","2727王品","110/07/26","元大-基隆孝二",10,1,9
"23514","2727王品","110/07/26","安泰",1,26,-25
"23515","2727王品","110/07/26","臺銀-臺中",10,2,8
"23516","2727王品","110/07/26","永豐金-古亭",2,20,-18
"23517","2727王品","110/07/26","元大-花蓮",8,0,8
"23518","2727王品","110/07/26","國票-天祥",0,16,-16
"23519","2727王品","110/07/26","元大-斗信",9,1,8
"23520","2727王品","110/07/26","摩根大通",17,33,-16
"23521","1570力肯","110/07/26","元大-民雄",10,0,10
"23522","1570力肯","110/07/26","元大-高雄",0,33,-33
"23523","1570力肯","110/07/26","新光-台中",10,1,9
"23524","1570力肯","110/07/26","日盛-宜蘭",0,8,-8
"23525","1570力肯","110/07/26","富邦-陽明",9,0,9
"23526","1570力肯","110/07/26","美林",0,5,-5
"23527","1570力肯","110/07/26","大慶-蘆洲",8,0,8
"23528","1570力肯","110/07/26","凱基-永康",0,5,-5
"23529","1570力肯","110/07/26","福勝",8,0,8
"23530","1570力肯","110/07/26","台新證券",0,4,-4
"23531","1570力肯","110/07/26","凱基-桃園",7,0,7
"23532","1570力肯","110/07/26","元大-汐止",0,4,-4
"23533","1570力肯","110/07/26","中國信託-永康",3,0,3
"23534","1570力肯","110/07/26","元大-桃興",0,3,-3
"23535","1570力肯","110/07/26","兆豐-台中港",3,0,3
"23536","1570力肯","110/07/26","元富-吉利",0,2,-2
"23537","1570力肯","110/07/26","國票-北高雄",3,0,3
"23538","1570力肯","110/07/26","國泰-板橋",0,2,-2
"23539","1570力肯","110/07/26","富邦-員林",3,0,3
"23540","1570力肯","110/07/26","元大-台中",0,2,-2
"23541","1570力肯","110/07/26","瑞士信貸",2,0,2
"23542","1570力肯","110/07/26","元大-西螺",0,2,-2
"23543","1570力肯","110/07/26","大昌-樹林",2,0,2
"23544","1570力肯","110/07/26","元大-苑裡",0,2,-2
"23545","1570力肯","110/07/26","兆豐-忠孝",2,0,2
"23546","1570力肯","110/07/26","合庫-三重",0,1,-1
"23547","1570力肯","110/07/26","新光",2,0,2
"23548","1570力肯","110/07/26","臺銀-臺南",0,1,-1
"23549","1570力肯","110/07/26","凱基-台北",2,0,2
"23550","1570力肯","110/07/26","元富-永和",0,1,-1
"23551","6180橘子","110/07/26","凱基-台北",121,1,120
"23552","6180橘子","110/07/26","元大-竹山",0,35,-35
"23553","6180橘子","110/07/26","新加坡商瑞銀",71,2,69
"23554","6180橘子","110/07/26","元大-和平",0,30,-30
"23555","6180橘子","110/07/26","摩根大通",70,4,66
"23556","6180橘子","110/07/26","元大-草屯",3,27,-24
"23557","6180橘子","110/07/26","美林",33,0,33
"23558","6180橘子","110/07/26","華南永昌-高雄",0,21,-21
"23559","6180橘子","110/07/26","台灣摩根士丹利",20,4,16
"23560","6180橘子","110/07/26","兆豐-埔墘",0,18,-18
"23561","6180橘子","110/07/26","合庫-高雄",11,0,11
"23562","6180橘子","110/07/26","元富-林園",0,17,-17
"23563","6180橘子","110/07/26","港商野村",10,0,10
"23564","6180橘子","110/07/26","元富-成功",0,16,-16
"23565","6180橘子","110/07/26","富邦-宜蘭",10,0,10
"23566","6180橘子","110/07/26","群益金鼎-台南",0,13,-13
"23567","6180橘子","110/07/26","統一-彰化",10,1,9
"23568","6180橘子","110/07/26","元大-開元",0,13,-13
"23569","6180橘子","110/07/26","兆豐-北高雄",9,1,8
"23570","6180橘子","110/07/26","富邦-台中",0,12,-12
"23571","6180橘子","110/07/26","元大-新店中正",10,2,8
"23572","6180橘子","110/07/26","(牛牛牛)亞-鑫豐",1,12,-11
"23573","6180橘子","110/07/26","國泰-敦南",10,3,7
"23574","6180橘子","110/07/26","台新-台南",0,11,-11
"23575","6180橘子","110/07/26","合庫-自強",5,0,5
"23576","6180橘子","110/07/26","聯邦-興中",0,11,-11
"23577","6180橘子","110/07/26","大慶-蘆洲",5,0,5
"23578","6180橘子","110/07/26","日盛-中和",0,10,-10
"23579","6180橘子","110/07/26","統一-中壢",5,0,5
"23580","6180橘子","110/07/26","康和-台北",0,10,-10
"23581","2390云辰","110/07/26","元大-大同",311,3,308
"23582","2390云辰","110/07/26","摩根大通",139,570,-431
"23583","2390云辰","110/07/26","華南永昌-鳳山",276,4,272
"23584","2390云辰","110/07/26","美林",103,243,-140
"23585","2390云辰","110/07/26","永豐金-竹北",201,6,195
"23586","2390云辰","110/07/26","元大-彰化民生",0,117,-117
"23587","2390云辰","110/07/26","富邦-左營",107,17,90
"23588","2390云辰","110/07/26","元富-中港",0,102,-102
"23589","2390云辰","110/07/26","元富-高雄",82,5,77
"23590","2390云辰","110/07/26","凱基-台北",161,249,-88
"23591","2390云辰","110/07/26","元大-太平",75,10,65
"23592","2390云辰","110/07/26","國票-新莊",15,78,-63
"23593","2390云辰","110/07/26","元大-大益",63,13,50
"23594","2390云辰","110/07/26","第一金-豐原",1,59,-58
"23595","2390云辰","110/07/26","元富-新竹",41,1,40
"23596","2390云辰","110/07/26","統一-竹南",5,48,-43
"23597","2390云辰","110/07/26","日盛-永康",42,4,38
"23598","2390云辰","110/07/26","第一金-台南",28,62,-34
"23599","2390云辰","110/07/26","群益金鼎-中壢",50,12,38
"23600","2390云辰","110/07/26","台灣摩根士丹利",38,70,-32
"23601","2390云辰","110/07/26","元大-鑫永和",54,18,36
"23602","2390云辰","110/07/26","群益金鼎-士林",20,52,-32
"23603","2390云辰","110/07/26","元富-同大",34,1,33
"23604","2390云辰","110/07/26","群益金鼎-延平",2,31,-29
"23605","2390云辰","110/07/26","致和-崇德",52,21,31
"23606","2390云辰","110/07/26","凱基-豐中",12,40,-28
"23607","2390云辰","110/07/26","永豐金-松山",32,2,30
"23608","2390云辰","110/07/26","富邦-中壢",19,47,-28
"23609","2390云辰","110/07/26","凱基-三重",36,8,28
"23610","2390云辰","110/07/26","統一-基隆",2,27,-25
"23611","2363矽統","110/07/20","第一金-忠孝",400,115,285
"23612","2363矽統","110/07/20","國票-長城",3,452,-449
"23613","2363矽統","110/07/20","第一金-高雄",188,0,188
"23614","2363矽統","110/07/20","美林",158,531,-373
"23615","2363矽統","110/07/20","凱基-高美館",199,14,185
"23616","2363矽統","110/07/20","台新-左楠",13,310,-297
"23617","2363矽統","110/07/20","凱基-台北",434,326,108
"23618","2363矽統","110/07/20","玉山-台大",4,228,-224
"23619","2363矽統","110/07/20","元富-松德",105,0,105
"23620","2363矽統","110/07/20","群益金鼎-大甲",11,227,-216
"23621","2363矽統","110/07/20","元大-竹科",109,7,102
"23622","2363矽統","110/07/20","群益金鼎-中港",2,111,-109
"23623","2363矽統","110/07/20","元大-成功",102,2,100
"23624","2363矽統","110/07/20","元大-大天母",0,109,-109
"23625","2363矽統","110/07/20","富邦-仁愛",116,17,99
"23626","2363矽統","110/07/20","國泰-敦南",114,218,-104
"23627","2363矽統","110/07/20","元大-上新莊",102,16,86
"23628","2363矽統","110/07/20","港商野村",250,350,-100
"23629","2363矽統","110/07/20","台新證券",286,208,78
"23630","2363矽統","110/07/20","康和-澎湖",0,90,-90
"23631","2363矽統","110/07/20","元大-新營",81,9,72
"23632","2363矽統","110/07/20","凱基-中壢",15,99,-84
"23633","2363矽統","110/07/20","華南永昌-鳳山",76,5,71
"23634","2363矽統","110/07/20","元大-學甲",0,81,-81
"23635","2363矽統","110/07/20","富邦-員林",65,2,63
"23636","2363矽統","110/07/20","凱基-三重",22,91,-69
"23637","2363矽統","110/07/20","元富-成功",67,6,61
"23638","2363矽統","110/07/20","永豐金-嘉義",24,92,-68
"23639","2363矽統","110/07/20","新光-新竹",62,1,61
"23640","2363矽統","110/07/20","大慶-蘆洲",23,89,-66
"23641","8112至上","110/07/20","摩根大通",1226,293,933
"23642","8112至上","110/07/20","凱基-三重",27,502,-475
"23643","8112至上","110/07/20","新加坡商瑞銀",358,83,275
"23644","8112至上","110/07/20","宏遠證券",0,418,-418
"23645","8112至上","110/07/20","台灣摩根士丹利",159,9,150
"23646","8112至上","110/07/20","台新-台中",11,291,-280
"23647","8112至上","110/07/20","統一-新竹",115,5,110
"23648","8112至上","110/07/20","美林",44,194,-150
"23649","8112至上","110/07/20","新光",233,126,107
"23650","8112至上","110/07/20","凱基-新莊",0,100,-100
"23651","8112至上","110/07/20","凱基-台北",367,260,107
"23652","8112至上","110/07/20","富邦-永和",14,104,-90
"23653","8112至上","110/07/20","兆豐-西螺",104,10,94
"23654","8112至上","110/07/20","國票-敦北法人",4,88,-84
"23655","8112至上","110/07/20","永豐金-中正",87,6,81
"23656","8112至上","110/07/20","凱基-市政",3,80,-77
"23657","8112至上","110/07/20","富邦-新店",102,24,78
"23658","8112至上","110/07/20","台新證券",68,142,-74
"23659","8112至上","110/07/20","元大-大同",83,5,78
"23660","8112至上","110/07/20","永豐金-中壢",11,80,-69
"23661","8112至上","110/07/20","富邦-園區",64,2,62
"23662","8112至上","110/07/20","永豐金-台南",22,91,-69
"23663","8112至上","110/07/20","新光-台南",73,14,59
"23664","8112至上","110/07/20","元大-大雅",22,87,-65
"23665","8112至上","110/07/20","統一-台中",60,2,58
"23666","8112至上","110/07/20","光和",10,67,-57
"23667","8112至上","110/07/20","元大-北成功",58,4,54
"23668","8112至上","110/07/20","元大-竹科",27,74,-47
"23669","8112至上","110/07/20","元富-林園",53,0,53
"23670","8112至上","110/07/20","兆豐-公益",1,47,-46
"23671","1570力肯","110/07/20","國票-北高雄",36,0,36
"23672","1570力肯","110/07/20","國泰-敦南",0,19,-19
"23673","1570力肯","110/07/20","群益金鼎-高雄",16,0,16
"23674","1570力肯","110/07/20","中國信託-永康",0,12,-12
"23675","1570力肯","110/07/20","臺銀-鳳山",10,0,10
"23676","1570力肯","110/07/20","第一金-路竹",0,10,-10
"23677","1570力肯","110/07/20","群益金鼎-新竹",6,0,6
"23678","1570力肯","110/07/20","福勝",0,10,-10
"23679","1570力肯","110/07/20","大昌-樹林",5,0,5
"23680","1570力肯","110/07/20","群益金鼎-板橋",0,10,-10
"23681","1570力肯","110/07/20","華南永昌-楠梓",5,0,5
"23682","1570力肯","110/07/20","日盛-鳳山",0,8,-8
"23683","1570力肯","110/07/20","元大-基隆孝二",5,0,5
"23684","1570力肯","110/07/20","永豐金-新竹",6,14,-8
"23685","1570力肯","110/07/20","元大-新竹經國",4,0,4
"23686","1570力肯","110/07/20","第一金-彰化",0,7,-7
"23687","1570力肯","110/07/20","土銀-高雄",2,0,2
"23688","1570力肯","110/07/20","元富-吉利",0,7,-7
"23689","1570力肯","110/07/20","台灣企銀-太平",2,0,2
"23690","1570力肯","110/07/20","台中銀-員林",0,7,-7
"23691","1570力肯","110/07/20","兆豐-忠孝",2,0,2
"23692","1570力肯","110/07/20","玉山證券",1,8,-7
"23693","1570力肯","110/07/20","玉山-城中",2,0,2
"23694","1570力肯","110/07/20","統一-三重",0,5,-5
"23695","1570力肯","110/07/20","國泰-板橋",2,0,2
"23696","1570力肯","110/07/20","光和-溪湖",0,3,-3
"23697","1570力肯","110/07/20","凱基-台北",2,0,2
"23698","1570力肯","110/07/20","康和-澎湖",0,3,-3
"23699","1570力肯","110/07/20","華南永昌-高雄",2,0,2
"23700","1570力肯","110/07/20","摩根大通",0,2,-2
"23701","2929淘帝","110/07/20","玉山-新竹",59,0,59
"23702","2929淘帝","110/07/20","臺銀",0,45,-45
"23703","2929淘帝","110/07/20","兆豐-新莊",50,0,50
"23704","2929淘帝","110/07/20","光和-嘉義",0,29,-29
"23705","2929淘帝","110/07/20","元大-大甲",30,0,30
"23706","2929淘帝","110/07/20","新加坡商瑞銀",27,55,-28
"23707","2929淘帝","110/07/20","元大-民生",29,0,29
"23708","2929淘帝","110/07/20","華南永昌-潮州",0,20,-20
"23709","2929淘帝","110/07/20","元大-員林",20,0,20
"23710","2929淘帝","110/07/20","玉山-高雄",0,14,-14
"23711","2929淘帝","110/07/20","元富-台南",18,0,18
"23712","2929淘帝","110/07/20","富邦-南屯",2,13,-11
"23713","2929淘帝","110/07/20","港商野村",63,50,13
"23714","2929淘帝","110/07/20","高橋-龍潭",0,10,-10
"23715","2929淘帝","110/07/20","高橋",10,0,10
"23716","2929淘帝","110/07/20","台新-建北",0,10,-10
"23717","2929淘帝","110/07/20","元富-林園",10,0,10
"23718","2929淘帝","110/07/20","群益金鼎-台中",0,10,-10
"23719","2929淘帝","110/07/20","玉山-台南",10,0,10
"23720","2929淘帝","110/07/20","華南永昌-苗栗",0,10,-10
"23721","2929淘帝","110/07/20","群益金鼎-士林",10,0,10
"23722","2929淘帝","110/07/20","群益金鼎-西松",0,9,-9
"23723","2929淘帝","110/07/20","凱基-台北",16,6,10
"23724","2929淘帝","110/07/20","台新-三民",0,8,-8
"23725","2929淘帝","110/07/20","合庫證券",9,0,9
"23726","2929淘帝","110/07/20","群益金鼎",0,8,-8
"23727","2929淘帝","110/07/20","永豐金證券",9,2,7
"23728","2929淘帝","110/07/20","富邦-永和",0,7,-7
"23729","2929淘帝","110/07/20","凱基-基隆",6,0,6
"23730","2929淘帝","110/07/20","國泰-台中",6,12,-6
"23731","5410國眾","110/07/20","日盛-內湖",27,0,27
"23732","5410國眾","110/07/20","永豐金-內湖",0,23,-23
"23733","5410國眾","110/07/20","富邦-新營",20,0,20
"23734","5410國眾","110/07/20","兆豐-台中港",0,20,-20
"23735","5410國眾","110/07/20","大昌",17,0,17
"23736","5410國眾","110/07/20","元富-嘉義",0,15,-15
"23737","5410國眾","110/07/20","永豐金-台南",17,0,17
"23738","5410國眾","110/07/20","元富-吉利",0,11,-11
"23739","5410國眾","110/07/20","凱基-站前",15,0,15
"23740","5410國眾","110/07/20","凱基-長庚",0,10,-10
"23741","5410國眾","110/07/20","凱基-竹北",11,0,11
"23742","5410國眾","110/07/20","元大-八德",0,10,-10
"23743","5410國眾","110/07/20","元富-民權",9,0,9
"23744","5410國眾","110/07/20","元大-天母",0,10,-10
"23745","5410國眾","110/07/20","群益金鼎-嘉義",6,0,6
"23746","5410國眾","110/07/20","國泰-桃園",0,9,-9
"23747","5410國眾","110/07/20","元大-土城學府",6,0,6
"23748","5410國眾","110/07/20","新光",5,12,-7
"23749","5410國眾","110/07/20","第一金-豐原",5,0,5
"23750","5410國眾","110/07/20","玉山-桃園",0,7,-7
"23751","5410國眾","110/07/20","華南永昌-林口",5,0,5
"23752","5410國眾","110/07/20","玉山-雙和",0,6,-6
"23753","5410國眾","110/07/20","元大-博愛",5,0,5
"23754","5410國眾","110/07/20","臺銀-臺南",0,5,-5
"23755","5410國眾","110/07/20","元大-竹南",5,0,5
"23756","5410國眾","110/07/20","彰銀-七賢",0,5,-5
"23757","5410國眾","110/07/20","元大-新店中正",5,0,5
"23758","5410國眾","110/07/20","宏遠證券",0,5,-5
"23759","5410國眾","110/07/20","元富-烏日",4,0,4
"23760","5410國眾","110/07/20","摩根大通",0,5,-5
"23761","2841台開","110/07/20","中國信託-忠孝",145,0,145
"23762","2841台開","110/07/20","凱基-松山",0,100,-100
"23763","2841台開","110/07/20","第一金-台中",68,0,68
"23764","2841台開","110/07/20","第一金-自由",0,33,-33
"23765","2841台開","110/07/20","美商高盛",37,0,37
"23766","2841台開","110/07/20","港商野村",0,29,-29
"23767","2841台開","110/07/20","台中銀",32,0,32
"23768","2841台開","110/07/20","國泰-敦南",11,31,-20
"23769","2841台開","110/07/20","台新-台中",20,0,20
"23770","2841台開","110/07/20","華南永昌-台中",0,20,-20
"23771","2841台開","110/07/20","凱基-東港",10,0,10
"23772","2841台開","110/07/20","元大-發財",0,15,-15
"23773","2841台開","110/07/20","大昌-安康",10,3,7
"23774","2841台開","110/07/20","元大-福營",9,23,-14
"23775","2841台開","110/07/20","豐農",7,0,7
"23776","2841台開","110/07/20","永豐金-敦南",5,18,-13
"23777","2841台開","110/07/20","元大-歸仁",7,0,7
"23778","2841台開","110/07/20","統一-城中",0,11,-11
"23779","2841台開","110/07/20","日盛-木柵",5,0,5
"23780","2841台開","110/07/20","日盛-台南",0,10,-10
"23781","2841台開","110/07/20","台新-台南",4,0,4
"23782","2841台開","110/07/20","兆豐-寶成",0,10,-10
"23783","2841台開","110/07/20","日盛證券",3,0,3
"23784","2841台開","110/07/20","國票-中港",0,10,-10
"23785","2841台開","110/07/20","台新證券",8,5,3
"23786","2841台開","110/07/20","群益金鼎",0,10,-10
"23787","2841台開","110/07/20","元大-沙鹿",3,0,3
"23788","2841台開","110/07/20","玉山證券",1,10,-9
"23789","2841台開","110/07/20","國泰-台中",2,0,2
"23790","2841台開","110/07/20","大昌-新店",0,6,-6
"23791","6207雷科","110/07/20","元大-西門",100,4,96
"23792","6207雷科","110/07/20","永豐金-內湖",0,109,-109
"23793","6207雷科","110/07/20","凱基-復興",50,0,50
"23794","6207雷科","110/07/20","國泰證券",0,90,-90
"23795","6207雷科","110/07/20","凱基-台北",47,1,46
"23796","6207雷科","110/07/20","元大-頭份",0,55,-55
"23797","6207雷科","110/07/20","玉山-城中",43,1,42
"23798","6207雷科","110/07/20","永豐金-虎尾",0,50,-50
"23799","6207雷科","110/07/20","華南永昌-長虹",44,5,39
"23800","6207雷科","110/07/20","元富-世貿",0,33,-33
"23801","6207雷科","110/07/20","凱基-板橋",38,1,37
"23802","6207雷科","110/07/20","元大-南崁",0,22,-22
"23803","6207雷科","110/07/20","元富-信義",39,3,36
"23804","6207雷科","110/07/20","永豐金-鳳山",0,21,-21
"23805","6207雷科","110/07/20","元富-彰化",35,0,35
"23806","6207雷科","110/07/20","永豐金-三重",6,27,-21
"23807","6207雷科","110/07/20","凱基-高美館",34,0,34
"23808","6207雷科","110/07/20","第一金-澎湖",0,20,-20
"23809","6207雷科","110/07/20","富邦-中壢",26,2,24
"23810","6207雷科","110/07/20","群益金鼎-東大",0,20,-20
"23811","6207雷科","110/07/20","大昌-桃園",23,0,23
"23812","6207雷科","110/07/20","兆豐-民生",0,19,-19
"23813","6207雷科","110/07/20","元大-四維",39,17,22
"23814","6207雷科","110/07/20","元大-北成功",1,20,-19
"23815","6207雷科","110/07/20","台灣摩根士丹利",18,0,18
"23816","6207雷科","110/07/20","元大-虎尾",1,18,-17
"23817","6207雷科","110/07/20","國票-中和",16,0,16
"23818","6207雷科","110/07/20","元大-文心興安",0,15,-15
"23819","6207雷科","110/07/20","永豐金-大園",16,0,16
"23820","6207雷科","110/07/20","瑞士信貸",0,14,-14
"23821","3679新至陞","110/07/20","國票-敦北法人",18,0,18
"23822","3679新至陞","110/07/20","華南永昌-台中",0,32,-32
"23823","3679新至陞","110/07/20","台中銀-員林",17,3,14
"23824","3679新至陞","110/07/20","凱基-台北",12,32,-20
"23825","3679新至陞","110/07/20","群益金鼎-高盛",13,0,13
"23826","3679新至陞","110/07/20","摩根大通",2,14,-12
"23827","3679新至陞","110/07/20","康和-澎湖",8,0,8
"23828","3679新至陞","110/07/20","國泰-桃園",0,11,-11
"23829","3679新至陞","110/07/20","台新證券",6,0,6
"23830","3679新至陞","110/07/20","群益金鼎-台南",0,10,-10
"23831","3679新至陞","110/07/20","宏遠-光隆",4,0,4
"23832","3679新至陞","110/07/20","群益金鼎-大安",0,10,-10
"23833","3679新至陞","110/07/20","玉山-大里",4,0,4
"23834","3679新至陞","110/07/20","永豐金證券",4,14,-10
"23835","3679新至陞","110/07/20","台中銀-豐原",3,0,3
"23836","3679新至陞","110/07/20","兆豐-大同",1,6,-5
"23837","3679新至陞","110/07/20","玉山-新莊",3,0,3
"23838","3679新至陞","110/07/20","群益金鼎-館前",0,4,-4
"23839","3679新至陞","110/07/20","凱基-中山",3,0,3
"23840","3679新至陞","110/07/20","富邦-南屯",0,4,-4
"23841","3679新至陞","110/07/20","富邦-台北",3,0,3
"23842","3679新至陞","110/07/20","瑞士信貸",3,6,-3
"23843","3679新至陞","110/07/20","元大-板橋",3,0,3
"23844","3679新至陞","110/07/20","國泰-板橋",0,3,-3
"23845","3679新至陞","110/07/20","日盛-八德",2,0,2
"23846","3679新至陞","110/07/20","富邦-中壢",1,4,-3
"23847","3679新至陞","110/07/20","日盛-復興",2,0,2
"23848","3679新至陞","110/07/20","台灣企銀",0,2,-2
"23849","3679新至陞","110/07/20","康和-板橋",2,0,2
"23850","3679新至陞","110/07/20","日盛-大墩",0,2,-2
"23851","2727王品","110/07/20","兆豐-南京",200,0,200
"23852","2727王品","110/07/20","凱基-市政",1,75,-74
"23853","2727王品","110/07/20","富邦證券",88,0,88
"23854","2727王品","110/07/20","美商高盛",6,38,-32
"23855","2727王品","110/07/20","台新證券",142,55,87
"23856","2727王品","110/07/20","富邦-陽明",7,38,-31
"23857","2727王品","110/07/20","瑞士信貸",50,0,50
"23858","2727王品","110/07/20","永豐金-中正",3,34,-31
"23859","2727王品","110/07/20","港商野村",106,57,49
"23860","2727王品","110/07/20","永豐金-潮州",0,31,-31
"23861","2727王品","110/07/20","凱基-台北",67,27,40
"23862","2727王品","110/07/20","兆豐-大安",0,30,-30
"23863","2727王品","110/07/20","永豐金-大園",29,2,27
"23864","2727王品","110/07/20","摩根大通",50,73,-23
"23865","2727王品","110/07/20","康和-高雄",20,0,20
"23866","2727王品","110/07/20","日盛證券",4,24,-20
"23867","2727王品","110/07/20","第一金-高雄",20,3,17
"23868","2727王品","110/07/20","凱基-大里",0,20,-20
"23869","2727王品","110/07/20","富邦-板橋",21,4,17
"23870","2727王品","110/07/20","群益金鼎-大甲",0,18,-18
"23871","2727王品","110/07/20","永豐金-桃盛",15,0,15
"23872","2727王品","110/07/20","統一",18,29,-11
"23873","2727王品","110/07/20","凱基",13,0,13
"23874","2727王品","110/07/20","國泰-台中",12,23,-11
"23875","2727王品","110/07/20","新加坡商瑞銀",23,11,12
"23876","2727王品","110/07/20","元大-彰化",0,11,-11
"23877","2727王品","110/07/20","亞東",10,0,10
"23878","2727王品","110/07/20","國泰-館前",4,14,-10
"23879","2727王品","110/07/20","康和-台中",13,4,9
"23880","2727王品","110/07/20","元大-學甲",0,10,-10
"23881","1570力肯","110/07/20","國票-北高雄",36,0,36
"23882","1570力肯","110/07/20","國泰-敦南",0,19,-19
"23883","1570力肯","110/07/20","群益金鼎-高雄",16,0,16
"23884","1570力肯","110/07/20","中國信託-永康",0,12,-12
"23885","1570力肯","110/07/20","臺銀-鳳山",10,0,10
"23886","1570力肯","110/07/20","第一金-路竹",0,10,-10
"23887","1570力肯","110/07/20","群益金鼎-新竹",6,0,6
"23888","1570力肯","110/07/20","福勝",0,10,-10
"23889","1570力肯","110/07/20","大昌-樹林",5,0,5
"23890","1570力肯","110/07/20","群益金鼎-板橋",0,10,-10
"23891","1570力肯","110/07/20","華南永昌-楠梓",5,0,5
"23892","1570力肯","110/07/20","日盛-鳳山",0,8,-8
"23893","1570力肯","110/07/20","元大-基隆孝二",5,0,5
"23894","1570力肯","110/07/20","永豐金-新竹",6,14,-8
"23895","1570力肯","110/07/20","元大-新竹經國",4,0,4
"23896","1570力肯","110/07/20","第一金-彰化",0,7,-7
"23897","1570力肯","110/07/20","土銀-高雄",2,0,2
"23898","1570力肯","110/07/20","元富-吉利",0,7,-7
"23899","1570力肯","110/07/20","台灣企銀-太平",2,0,2
"23900","1570力肯","110/07/20","台中銀-員林",0,7,-7
"23901","1570力肯","110/07/20","兆豐-忠孝",2,0,2
"23902","1570力肯","110/07/20","玉山證券",1,8,-7
"23903","1570力肯","110/07/20","玉山-城中",2,0,2
"23904","1570力肯","110/07/20","統一-三重",0,5,-5
"23905","1570力肯","110/07/20","國泰-板橋",2,0,2
"23906","1570力肯","110/07/20","光和-溪湖",0,3,-3
"23907","1570力肯","110/07/20","凱基-台北",2,0,2
"23908","1570力肯","110/07/20","康和-澎湖",0,3,-3
"23909","1570力肯","110/07/20","華南永昌-高雄",2,0,2
"23910","1570力肯","110/07/20","摩根大通",0,2,-2
"23911","6180橘子","110/07/20","摩根大通",89,31,58
"23912","6180橘子","110/07/20","群益金鼎-中山",0,80,-80
"23913","6180橘子","110/07/20","美商高盛",27,0,27
"23914","6180橘子","110/07/20","台中銀-台北",0,30,-30
"23915","6180橘子","110/07/20","新加坡商瑞銀",28,1,27
"23916","6180橘子","110/07/20","日盛-新莊",1,22,-21
"23917","6180橘子","110/07/20","新光",41,16,25
"23918","6180橘子","110/07/20","元富-緯城",2,20,-18
"23919","6180橘子","110/07/20","日盛-文化",21,0,21
"23920","6180橘子","110/07/20","日盛-新竹",2,15,-13
"23921","6180橘子","110/07/20","元富-潮州",20,0,20
"23922","6180橘子","110/07/20","元大-汐止",0,12,-12
"23923","6180橘子","110/07/20","凱基-台北",31,11,20
"23924","6180橘子","110/07/20","元大-豐原站前",0,12,-12
"23925","6180橘子","110/07/20","元大-草屯",18,0,18
"23926","6180橘子","110/07/20","德信-中正",0,10,-10
"23927","6180橘子","110/07/20","花旗環球",13,0,13
"23928","6180橘子","110/07/20","新光-台南",0,10,-10
"23929","6180橘子","110/07/20","元大-桃園",12,0,12
"23930","6180橘子","110/07/20","玉山-雙和",0,10,-10
"23931","6180橘子","110/07/20","群益金鼎",10,0,10
"23932","6180橘子","110/07/20","元大-四維",0,10,-10
"23933","6180橘子","110/07/20","元大-高雄",10,0,10
"23934","6180橘子","110/07/20","元大-永春",2,12,-10
"23935","6180橘子","110/07/20","群益金鼎-嘉義",9,0,9
"23936","6180橘子","110/07/20","凱基-高美館",0,8,-8
"23937","6180橘子","110/07/20","富邦-嘉義",9,0,9
"23938","6180橘子","110/07/20","華南永昌",2,10,-8
"23939","6180橘子","110/07/20","元富-草屯",10,2,8
"23940","6180橘子","110/07/20","富邦-台北",0,8,-8
"23941","2390云辰","110/07/20","元大證券",6043,11,6032
"23942","2390云辰","110/07/20","華南永昌-鳳山",2,312,-310
"23943","2390云辰","110/07/20","兆豐-復興",998,0,998
"23944","2390云辰","110/07/20","台灣摩根士丹利",0,247,-247
"23945","2390云辰","110/07/20","富邦-嘉義",775,7,768
"23946","2390云辰","110/07/20","元大-復北",4,239,-235
"23947","2390云辰","110/07/20","統一-台中",350,6,344
"23948","2390云辰","110/07/20","富邦-建國",25,236,-211
"23949","2390云辰","110/07/20","兆豐-城中",240,0,240
"23950","2390云辰","110/07/20","元富-中港",0,202,-202
"23951","2390云辰","110/07/20","群益金鼎-館前",204,2,202
"23952","2390云辰","110/07/20","國泰-敦南",20,194,-174
"23953","2390云辰","110/07/20","凱基-大直",187,0,187
"23954","2390云辰","110/07/20","元大-土城學府",10,156,-146
"23955","2390云辰","110/07/20","永豐金證券",160,10,150
"23956","2390云辰","110/07/20","中國信託-松江",0,130,-130
"23957","2390云辰","110/07/20","日盛-高雄",104,2,102
"23958","2390云辰","110/07/20","凱基-基隆",0,130,-130
"23959","2390云辰","110/07/20","凱基-中山",100,3,97
"23960","2390云辰","110/07/20","永豐金-中正",1,117,-116
"23961","2390云辰","110/07/20","元大-基隆",85,7,78
"23962","2390云辰","110/07/20","富邦-陽明",1,94,-93
"23963","2390云辰","110/07/20","群益金鼎-東大",64,2,62
"23964","2390云辰","110/07/20","元大-潮州",20,112,-92
"23965","2390云辰","110/07/20","元大-前金",60,1,59
"23966","2390云辰","110/07/20","宏遠證券",0,89,-89
"23967","2390云辰","110/07/20","國票-北高雄",63,14,49
"23968","2390云辰","110/07/20","兆豐-台中",0,75,-75
"23969","2390云辰","110/07/20","群益金鼎-三重",40,6,34
"23970","2390云辰","110/07/20","新光",8,82,-74
"23971","2363矽統","110/07/19","第一金-忠孝",210,0,210
"23972","2363矽統","110/07/19","富邦-仁愛",32,575,-543
"23973","2363矽統","110/07/19","中國信託-文心",191,9,182
"23974","2363矽統","110/07/19","新加坡商瑞銀",53,486,-433
"23975","2363矽統","110/07/19","華南永昌-鳳山",116,1,115
"23976","2363矽統","110/07/19","摩根大通",42,320,-278
"23977","2363矽統","110/07/19","元大-新竹",113,12,101
"23978","2363矽統","110/07/19","元大-竹科",3,201,-198
"23979","2363矽統","110/07/19","凱基-中山",89,1,88
"23980","2363矽統","110/07/19","元大-成功",7,183,-176
"23981","2363矽統","110/07/19","永豐金-嘉義",82,7,75
"23982","2363矽統","110/07/19","凱基-大里",0,150,-150
"23983","2363矽統","110/07/19","凱基-台南",72,4,68
"23984","2363矽統","110/07/19","瑞士信貸",80,215,-135
"23985","2363矽統","110/07/19","元富-城東",84,17,67
"23986","2363矽統","110/07/19","日盛-新莊",4,135,-131
"23987","2363矽統","110/07/19","群益金鼎-東湖",61,0,61
"23988","2363矽統","110/07/19","宏遠-桃園",20,150,-130
"23989","2363矽統","110/07/19","兆豐-中壢",55,0,55
"23990","2363矽統","110/07/19","凱基-三重",7,107,-100
"23991","2363矽統","110/07/19","康和-內湖",55,1,54
"23992","2363矽統","110/07/19","凱基-台北",384,476,-92
"23993","2363矽統","110/07/19","群益金鼎-桃園",55,2,53
"23994","2363矽統","110/07/19","合庫-台中",3,84,-81
"23995","2363矽統","110/07/19","群益金鼎-大興",50,0,50
"23996","2363矽統","110/07/19","致和-金華",1,80,-79
"23997","2363矽統","110/07/19","台新-台中",81,32,49
"23998","2363矽統","110/07/19","凱基-員林",5,77,-72
"23999","2363矽統","110/07/19","北城證券",58,10,48
"24000","2363矽統","110/07/19","華南永昌-合泰",2,70,-68
"24001","8112至上","110/07/19","摩根大通",1413,144,1269
"24002","8112至上","110/07/19","凱基-三重",3,600,-597
"24003","8112至上","110/07/19","凱基-台北",1053,266,787
"24004","8112至上","110/07/19","元大-府城",0,165,-165
"24005","8112至上","110/07/19","新加坡商瑞銀",523,2,521
"24006","8112至上","110/07/19","台灣企銀-台中",0,150,-150
"24007","8112至上","110/07/19","台灣摩根士丹利",487,8,479
"24008","8112至上","110/07/19","(牛牛牛)亞-鑫豐",26,119,-93
"24009","8112至上","110/07/19","美林",529,93,436
"24010","8112至上","110/07/19","永豐金-台南",15,95,-80
"24011","8112至上","110/07/19","港商野村",358,36,322
"24012","8112至上","110/07/19","亞東-板橋",2,81,-79
"24013","8112至上","110/07/19","美商高盛",276,3,273
"24014","8112至上","110/07/19","陽信",0,70,-70
"24015","8112至上","110/07/19","兆豐-公益",180,7,173
"24016","8112至上","110/07/19","元富-佳里",0,69,-69
"24017","8112至上","110/07/19","國泰-板橋",116,15,101
"24018","8112至上","110/07/19","臺銀-鳳山",7,72,-65
"24019","8112至上","110/07/19","凱基-新莊",100,1,99
"24020","8112至上","110/07/19","兆豐-竹北",4,65,-61
"24021","8112至上","110/07/19","凱基-市政",89,0,89
"24022","8112至上","110/07/19","國泰-新莊",2,62,-60
"24023","8112至上","110/07/19","玉山證券",73,7,66
"24024","8112至上","110/07/19","元富-大裕",2,60,-58
"24025","8112至上","110/07/19","花旗環球",64,0,64
"24026","8112至上","110/07/19","臺灣企銀-桃園",0,55,-55
"24027","8112至上","110/07/19","合庫-台中",55,3,52
"24028","8112至上","110/07/19","康和-台南",4,59,-55
"24029","8112至上","110/07/19","永豐金-中壢",50,1,49
"24030","8112至上","110/07/19","第一金-華江",3,55,-52
"24031","1570力肯","110/07/19","國票-北高雄",34,0,34
"24032","1570力肯","110/07/19","合庫-三重",0,8,-8
"24033","1570力肯","110/07/19","新光",30,3,27
"24034","1570力肯","110/07/19","元大-高雄",0,8,-8
"24035","1570力肯","110/07/19","凱基-台北",24,1,23
"24036","1570力肯","110/07/19","合庫-台中",0,7,-7
"24037","1570力肯","110/07/19","台灣摩根士丹利",7,0,7
"24038","1570力肯","110/07/19","臺銀-臺中",0,6,-6
"24039","1570力肯","110/07/19","元大-林森",5,0,5
"24040","1570力肯","110/07/19","摩根大通",6,11,-5
"24041","1570力肯","110/07/19","元大-士林",4,0,4
"24042","1570力肯","110/07/19","元富-緯城",0,4,-4
"24043","1570力肯","110/07/19","玉山證券",8,5,3
"24044","1570力肯","110/07/19","玉山-台大",0,4,-4
"24045","1570力肯","110/07/19","統一-城中",2,0,2
"24046","1570力肯","110/07/19","群益金鼎-三重",0,4,-4
"24047","1570力肯","110/07/19","元大-基隆孝二",2,0,2
"24048","1570力肯","110/07/19","凱基-鳳山",1,5,-4
"24049","1570力肯","110/07/19","土銀-建國",1,0,1
"24050","1570力肯","110/07/19","元大-板橋",0,4,-4
"24051","1570力肯","110/07/19","日盛-復興",1,0,1
"24052","1570力肯","110/07/19","日盛-和美",0,3,-3
"24053","1570力肯","110/07/19","瑞士信貸",1,0,1
"24054","1570力肯","110/07/19","元富-新店",2,5,-3
"24055","1570力肯","110/07/19","元富-四維",1,0,1
"24056","1570力肯","110/07/19","元大-新莊",0,3,-3
"24057","1570力肯","110/07/19","群益金鼎-北高雄",1,0,1
"24058","1570力肯","110/07/19","永豐金-敦南",0,3,-3
"24059","1570力肯","110/07/19","凱基-高美館",1,0,1
"24060","1570力肯","110/07/19","永豐金-台中",0,3,-3
"24061","2929淘帝","110/07/19","元大-民生",28,0,28
"24062","2929淘帝","110/07/19","元大-六合",0,40,-40
"24063","2929淘帝","110/07/19","宏遠-光隆",25,0,25
"24064","2929淘帝","110/07/19","新光-新竹",0,35,-35
"24065","2929淘帝","110/07/19","華南永昌-苗栗",20,0,20
"24066","2929淘帝","110/07/19","新加坡商瑞銀",1,30,-29
"24067","2929淘帝","110/07/19","元大-員林",20,0,20
"24068","2929淘帝","110/07/19","永豐金-永康",0,27,-27
"24069","2929淘帝","110/07/19","合庫-高雄",18,0,18
"24070","2929淘帝","110/07/19","凱基-復興",0,24,-24
"24071","2929淘帝","110/07/19","臺銀-鳳山",18,0,18
"24072","2929淘帝","110/07/19","日盛-豐原",0,22,-22
"24073","2929淘帝","110/07/19","日盛-雙和",17,0,17
"24074","2929淘帝","110/07/19","富邦-南屯",1,22,-21
"24075","2929淘帝","110/07/19","華南永昌-林口",15,0,15
"24076","2929淘帝","110/07/19","新光",1,21,-20
"24077","2929淘帝","110/07/19","元大-屏南",15,0,15
"24078","2929淘帝","110/07/19","華南永昌",0,20,-20
"24079","2929淘帝","110/07/19","台新-中壢",12,0,12
"24080","2929淘帝","110/07/19","富邦-竹東",2,22,-20
"24081","2929淘帝","110/07/19","新光-台中",11,0,11
"24082","2929淘帝","110/07/19","凱基-士林",0,16,-16
"24083","2929淘帝","110/07/19","凱基-台北",20,9,11
"24084","2929淘帝","110/07/19","福勝",0,15,-15
"24085","2929淘帝","110/07/19","富邦-台北",11,0,11
"24086","2929淘帝","110/07/19","港商野村",25,37,-12
"24087","2929淘帝","110/07/19","合庫-自強",10,0,10
"24088","2929淘帝","110/07/19","群益金鼎-建成",0,11,-11
"24089","2929淘帝","110/07/19","凱基-豐中",10,0,10
"24090","2929淘帝","110/07/19","華南永昌-朴子",0,11,-11
"24091","5410國眾","110/07/19","香港上海匯豐",28,0,28
"24092","5410國眾","110/07/19","群益金鼎-內湖",0,80,-80
"24093","5410國眾","110/07/19","大昌",26,0,26
"24094","5410國眾","110/07/19","永豐金-屏東",0,14,-14
"24095","5410國眾","110/07/19","兆豐-公益",20,0,20
"24096","5410國眾","110/07/19","永豐金-南京",0,10,-10
"24097","5410國眾","110/07/19","合庫-嘉義",10,0,10
"24098","5410國眾","110/07/19","元大-內湖",0,9,-9
"24099","5410國眾","110/07/19","台新-左楠",20,10,10
"24100","5410國眾","110/07/19","富邦-永和",0,8,-8
"24101","5410國眾","110/07/19","摩根大通",15,6,9
"24102","5410國眾","110/07/19","日盛-景美",0,6,-6
"24103","5410國眾","110/07/19","台灣企銀-民雄",8,0,8
"24104","5410國眾","110/07/19","光和",1,7,-6
"24105","5410國眾","110/07/19","元大-竹科",8,0,8
"24106","5410國眾","110/07/19","元大-士林",0,6,-6
"24107","5410國眾","110/07/19","凱基-台北",9,3,6
"24108","5410國眾","110/07/19","新光-台中",0,5,-5
"24109","5410國眾","110/07/19","元大-博愛",6,0,6
"24110","5410國眾","110/07/19","元大-景美",0,5,-5
"24111","5410國眾","110/07/19","台新-三民",5,0,5
"24112","5410國眾","110/07/19","大慶-蘆洲",0,4,-4
"24113","5410國眾","110/07/19","群益金鼎-中壢",5,0,5
"24114","5410國眾","110/07/19","中國信託-新竹",0,4,-4
"24115","5410國眾","110/07/19","群益金鼎-嘉義",5,0,5
"24116","5410國眾","110/07/19","新光",6,10,-4
"24117","5410國眾","110/07/19","日盛證券",4,0,4
"24118","5410國眾","110/07/19","元大-基隆孝二",0,4,-4
"24119","5410國眾","110/07/19","群益金鼎-新店",4,0,4
"24120","5410國眾","110/07/19","土銀-台中",0,3,-3
"24121","2841台開","110/07/19","元富-城東",150,0,150
"24122","2841台開","110/07/19","日進",0,80,-80
"24123","2841台開","110/07/19","中國信託-忠孝",80,0,80
"24124","2841台開","110/07/19","港商野村",0,77,-77
"24125","2841台開","110/07/19","凱基-台北",52,0,52
"24126","2841台開","110/07/19","摩根大通",0,41,-41
"24127","2841台開","110/07/19","美商高盛",48,0,48
"24128","2841台開","110/07/19","元大-三重",1,38,-37
"24129","2841台開","110/07/19","台中銀",43,0,43
"24130","2841台開","110/07/19","元大-福營",0,30,-30
"24131","2841台開","110/07/19","永豐金-豐原",32,0,32
"24132","2841台開","110/07/19","新光",4,28,-24
"24133","2841台開","110/07/19","豐農",20,0,20
"24134","2841台開","110/07/19","元大-竹科",0,22,-22
"24135","2841台開","110/07/19","台新-台中",30,10,20
"24136","2841台開","110/07/19","永豐金-敦南",33,55,-22
"24137","2841台開","110/07/19","華南永昌-新莊",20,0,20
"24138","2841台開","110/07/19","日盛-二林",0,15,-15
"24139","2841台開","110/07/19","第一金-台中",12,0,12
"24140","2841台開","110/07/19","元富-虎尾",0,15,-15
"24141","2841台開","110/07/19","國泰-台中",12,0,12
"24142","2841台開","110/07/19","華南永昌-世貿",0,15,-15
"24143","2841台開","110/07/19","日茂",10,0,10
"24144","2841台開","110/07/19","統一-三多",0,12,-12
"24145","2841台開","110/07/19","凱基-埔墘",10,0,10
"24146","2841台開","110/07/19","台中銀-豐原",0,10,-10
"24147","2841台開","110/07/19","永豐金-內湖",8,0,8
"24148","2841台開","110/07/19","元大-頭份",0,10,-10
"24149","2841台開","110/07/19","合庫-台中",7,0,7
"24150","2841台開","110/07/19","合庫-台南",0,8,-8
"24151","6207雷科","110/07/19","元富-信義",92,0,92
"24152","6207雷科","110/07/19","新加坡商瑞銀",5,104,-99
"24153","6207雷科","110/07/19","國泰證券",90,0,90
"24154","6207雷科","110/07/19","富邦-彰化",2,97,-95
"24155","6207雷科","110/07/19","元富-城中",80,4,76
"24156","6207雷科","110/07/19","永豐金-內湖",6,85,-79
"24157","6207雷科","110/07/19","元大-福營",71,5,66
"24158","6207雷科","110/07/19","摩根大通",102,164,-62
"24159","6207雷科","110/07/19","凱基-復興",60,0,60
"24160","6207雷科","110/07/19","瑞士信貸",0,51,-51
"24161","6207雷科","110/07/19","凱基-台北",91,46,45
"24162","6207雷科","110/07/19","凱基-板橋",10,55,-45
"24163","6207雷科","110/07/19","玉山-城中",42,0,42
"24164","6207雷科","110/07/19","華南永昌-大安",0,40,-40
"24165","6207雷科","110/07/19","華南永昌-長虹",40,0,40
"24166","6207雷科","110/07/19","群益金鼎-東大",1,40,-39
"24167","6207雷科","110/07/19","永豐金-羅東",38,0,38
"24168","6207雷科","110/07/19","台新-高雄",15,47,-32
"24169","6207雷科","110/07/19","日盛-忠孝",36,2,34
"24170","6207雷科","110/07/19","玉山-嘉義",1,32,-31
"24171","6207雷科","110/07/19","凱基-羅東",37,3,34
"24172","6207雷科","110/07/19","凱基-中港",0,30,-30
"24173","6207雷科","110/07/19","第一金-新竹",30,0,30
"24174","6207雷科","110/07/19","元大-六合",7,36,-29
"24175","6207雷科","110/07/19","玉山-數位",27,1,26
"24176","6207雷科","110/07/19","元富-花蓮",0,28,-28
"24177","6207雷科","110/07/19","凱基-長庚",22,0,22
"24178","6207雷科","110/07/19","群益金鼎-瑞豐",6,34,-28
"24179","6207雷科","110/07/19","台灣企銀-北高雄",20,0,20
"24180","6207雷科","110/07/19","新百王",0,26,-26
"24181","3679新至陞","110/07/19","元大-成功",7,0,7
"24182","3679新至陞","110/07/19","群益金鼎-大安",0,15,-15
"24183","3679新至陞","110/07/19","美商高盛",6,0,6
"24184","3679新至陞","110/07/19","凱基-民權",0,10,-10
"24185","3679新至陞","110/07/19","台新-高雄",5,0,5
"24186","3679新至陞","110/07/19","元大-西門",0,10,-10
"24187","3679新至陞","110/07/19","凱基-松山",5,0,5
"24188","3679新至陞","110/07/19","瑞士信貸",0,6,-6
"24189","3679新至陞","110/07/19","日盛-員林",4,0,4
"24190","3679新至陞","110/07/19","兆豐-高雄",0,6,-6
"24191","3679新至陞","110/07/19","台中銀-員林",4,0,4
"24192","3679新至陞","110/07/19","群益金鼎",0,5,-5
"24193","3679新至陞","110/07/19","(牛牛牛)亞-網路",3,0,3
"24194","3679新至陞","110/07/19","元大-永春",0,4,-4
"24195","3679新至陞","110/07/19","大昌-新店",3,0,3
"24196","3679新至陞","110/07/19","凱基-台北",2,5,-3
"24197","3679新至陞","110/07/19","凱基-埔墘",3,0,3
"24198","3679新至陞","110/07/19","港商法國興業",0,2,-2
"24199","3679新至陞","110/07/19","元大-板橋",3,0,3
"24200","3679新至陞","110/07/19","摩根大通",2,4,-2
"24201","3679新至陞","110/07/19","臺銀-金山",2,0,2
"24202","3679新至陞","110/07/19","元大-金門",0,2,-2
"24203","3679新至陞","110/07/19","日盛-樹林",2,0,2
"24204","3679新至陞","110/07/19","元大-土城",0,2,-2
"24205","3679新至陞","110/07/19","致和-東門",2,0,2
"24206","3679新至陞","110/07/19","日盛-鳳山",0,1,-1
"24207","3679新至陞","110/07/19","國票-敦北法人",2,0,2
"24208","3679新至陞","110/07/19","美林",1,2,-1
"24209","3679新至陞","110/07/19","台新證券",2,0,2
"24210","3679新至陞","110/07/19","第一金",0,1,-1
"24211","2727王品","110/07/19","台新證券",374,33,341
"24212","2727王品","110/07/19","台灣摩根士丹利",25,188,-163
"24213","2727王品","110/07/19","瑞士信貸",217,1,216
"24214","2727王品","110/07/19","港商野村",74,198,-124
"24215","2727王品","110/07/19","兆豐-南京",200,0,200
"24216","2727王品","110/07/19","統一",6,80,-74
"24217","2727王品","110/07/19","第一金",70,1,69
"24218","2727王品","110/07/19","合庫-台中",8,79,-71
"24219","2727王品","110/07/19","元大-小港",59,1,58
"24220","2727王品","110/07/19","凱基-台北",178,231,-53
"24221","2727王品","110/07/19","玉山-桃園",42,6,36
"24222","2727王品","110/07/19","富邦-中壢",3,52,-49
"24223","2727王品","110/07/19","永豐金-大園",31,0,31
"24224","2727王品","110/07/19","凱基-永華",0,43,-43
"24225","2727王品","110/07/19","兆豐-大安",30,0,30
"24226","2727王品","110/07/19","土銀-台中",0,36,-36
"24227","2727王品","110/07/19","美商高盛",38,15,23
"24228","2727王品","110/07/19","美林",8,41,-33
"24229","2727王品","110/07/19","康和-澎湖",23,1,22
"24230","2727王品","110/07/19","中國信託-忠孝",1,33,-32
"24231","2727王品","110/07/19","第一金-高雄",21,0,21
"24232","2727王品","110/07/19","新光",31,61,-30
"24233","2727王品","110/07/19","國票-內壢",21,0,21
"24234","2727王品","110/07/19","第一金-豐原",0,26,-26
"24235","2727王品","110/07/19","元大-桃興",19,3,16
"24236","2727王品","110/07/19","富邦-彰化",0,26,-26
"24237","2727王品","110/07/19","凱基-三重",16,1,15
"24238","2727王品","110/07/19","摩根大通",78,97,-19
"24239","2727王品","110/07/19","永豐金-南投",16,1,15
"24240","2727王品","110/07/19","國泰證券",2,21,-19
"24241","1570力肯","110/07/19","國票-北高雄",34,0,34
"24242","1570力肯","110/07/19","合庫-三重",0,8,-8
"24243","1570力肯","110/07/19","新光",30,3,27
"24244","1570力肯","110/07/19","元大-高雄",0,8,-8
"24245","1570力肯","110/07/19","凱基-台北",24,1,23
"24246","1570力肯","110/07/19","合庫-台中",0,7,-7
"24247","1570力肯","110/07/19","台灣摩根士丹利",7,0,7
"24248","1570力肯","110/07/19","臺銀-臺中",0,6,-6
"24249","1570力肯","110/07/19","元大-林森",5,0,5
"24250","1570力肯","110/07/19","摩根大通",6,11,-5
"24251","1570力肯","110/07/19","元大-士林",4,0,4
"24252","1570力肯","110/07/19","元富-緯城",0,4,-4
"24253","1570力肯","110/07/19","玉山證券",8,5,3
"24254","1570力肯","110/07/19","玉山-台大",0,4,-4
"24255","1570力肯","110/07/19","統一-城中",2,0,2
"24256","1570力肯","110/07/19","群益金鼎-三重",0,4,-4
"24257","1570力肯","110/07/19","元大-基隆孝二",2,0,2
"24258","1570力肯","110/07/19","凱基-鳳山",1,5,-4
"24259","1570力肯","110/07/19","土銀-建國",1,0,1
"24260","1570力肯","110/07/19","元大-板橋",0,4,-4
"24261","1570力肯","110/07/19","日盛-復興",1,0,1
"24262","1570力肯","110/07/19","日盛-和美",0,3,-3
"24263","1570力肯","110/07/19","瑞士信貸",1,0,1
"24264","1570力肯","110/07/19","元富-新店",2,5,-3
"24265","1570力肯","110/07/19","元富-四維",1,0,1
"24266","1570力肯","110/07/19","元大-新莊",0,3,-3
"24267","1570力肯","110/07/19","群益金鼎-北高雄",1,0,1
"24268","1570力肯","110/07/19","永豐金-敦南",0,3,-3
"24269","1570力肯","110/07/19","凱基-高美館",1,0,1
"24270","1570力肯","110/07/19","永豐金-台中",0,3,-3
"24271","6180橘子","110/07/19","兆豐證券",55,0,55
"24272","6180橘子","110/07/19","石橋證券",0,80,-80
"24273","6180橘子","110/07/19","凱基-台北",89,35,54
"24274","6180橘子","110/07/19","永豐金-大園",2,50,-48
"24275","6180橘子","110/07/19","合庫-自強",36,0,36
"24276","6180橘子","110/07/19","群益金鼎-屏東",0,40,-40
"24277","6180橘子","110/07/19","新光",50,25,25
"24278","6180橘子","110/07/19","國泰-敦南",0,19,-19
"24279","6180橘子","110/07/19","日盛-龍潭",20,0,20
"24280","6180橘子","110/07/19","日盛-新竹",2,20,-18
"24281","6180橘子","110/07/19","元大-斗信",16,1,15
"24282","6180橘子","110/07/19","摩根大通",17,35,-18
"24283","6180橘子","110/07/19","康和-台中",12,0,12
"24284","6180橘子","110/07/19","富邦-陽明",0,17,-17
"24285","6180橘子","110/07/19","國泰-台中",14,2,12
"24286","6180橘子","110/07/19","美商高盛",11,27,-16
"24287","6180橘子","110/07/19","富邦-嘉義",12,0,12
"24288","6180橘子","110/07/19","統一-宜蘭",0,14,-14
"24289","6180橘子","110/07/19","元大-草屯",12,0,12
"24290","6180橘子","110/07/19","凱基-興隆",0,12,-12
"24291","6180橘子","110/07/19","元富-桃園",11,0,11
"24292","6180橘子","110/07/19","台中銀-豐原",1,11,-10
"24293","6180橘子","110/07/19","兆豐-城中",10,0,10
"24294","6180橘子","110/07/19","永豐金-豐原",0,10,-10
"24295","6180橘子","110/07/19","元大-旗山",10,0,10
"24296","6180橘子","110/07/19","永豐金-竹科",0,10,-10
"24297","6180橘子","110/07/19","元大-大安",10,0,10
"24298","6180橘子","110/07/19","臺銀-鳳山",1,10,-9
"24299","6180橘子","110/07/19","大昌-新店",9,0,9
"24300","6180橘子","110/07/19","群益金鼎-台南",0,9,-9
"24301","2390云辰","110/07/19","摩根大通",1135,266,869
"24302","2390云辰","110/07/19","元富-成功",15,119,-104
"24303","2390云辰","110/07/19","台灣摩根士丹利",232,40,192
"24304","2390云辰","110/07/19","元富-中港",5,101,-96
"24305","2390云辰","110/07/19","凱基-台北",669,504,165
"24306","2390云辰","110/07/19","元富-嘉義",5,85,-80
"24307","2390云辰","110/07/19","美林",290,159,131
"24308","2390云辰","110/07/19","美商高盛",11,62,-51
"24309","2390云辰","110/07/19","統一",111,8,103
"24310","2390云辰","110/07/19","群益金鼎-西松",4,54,-50
"24311","2390云辰","110/07/19","元富-埔里",102,0,102
"24312","2390云辰","110/07/19","聯邦商銀",0,48,-48
"24313","2390云辰","110/07/19","華南永昌-台中",126,26,100
"24314","2390云辰","110/07/19","元大-萬華",15,57,-42
"24315","2390云辰","110/07/19","永豐金-豐原",100,32,68
"24316","2390云辰","110/07/19","群益金鼎-高雄",2,42,-40
"24317","2390云辰","110/07/19","台新-台南",87,25,62
"24318","2390云辰","110/07/19","國泰-敦南",117,154,-37
"24319","2390云辰","110/07/19","台新-左楠",67,11,56
"24320","2390云辰","110/07/19","中國信託-文心",5,40,-35
"24321","2390云辰","110/07/19","國泰-忠孝",52,0,52
"24322","2390云辰","110/07/19","凱基-城中",16,51,-35
"24323","2390云辰","110/07/19","台新證券",105,54,51
"24324","2390云辰","110/07/19","瑞士信貸",0,31,-31
"24325","2390云辰","110/07/19","華南永昌-頭份",53,3,50
"24326","2390云辰","110/07/19","中國信託-永康",1,32,-31
"24327","2390云辰","110/07/19","新光-台南",44,0,44
"24328","2390云辰","110/07/19","統一-彰化",2,32,-30
"24329","2390云辰","110/07/19","合庫-西台中",50,8,42
"24330","2390云辰","110/07/19","元大-館前",7,37,-30
"24331","2363矽統","110/07/16","國票-長城",461,21,440
"24332","2363矽統","110/07/16","新加坡商瑞銀",155,482,-327
"24333","2363矽統","110/07/16","凱基-豐中",201,3,198
"24334","2363矽統","110/07/16","港商野村",253,546,-293
"24335","2363矽統","110/07/16","凱基-土城",132,9,123
"24336","2363矽統","110/07/16","摩根大通",116,401,-285
"24337","2363矽統","110/07/16","台新證券",199,78,121
"24338","2363矽統","110/07/16","瑞士信貸",291,533,-242
"24339","2363矽統","110/07/16","日盛-中和",74,0,74
"24340","2363矽統","110/07/16","日盛-竹北",19,248,-229
"24341","2363矽統","110/07/16","日盛-員林",66,3,63
"24342","2363矽統","110/07/16","臺銀-金山",4,211,-207
"24343","2363矽統","110/07/16","國票-中和",60,3,57
"24344","2363矽統","110/07/16","元大-大統",13,138,-125
"24345","2363矽統","110/07/16","新光",240,184,56
"24346","2363矽統","110/07/16","永豐金證券",11,125,-114
"24347","2363矽統","110/07/16","富邦-竹東",65,9,56
"24348","2363矽統","110/07/16","兆豐-民生",2,101,-99
"24349","2363矽統","110/07/16","華南永昌-鳳山",56,1,55
"24350","2363矽統","110/07/16","群益金鼎-松山",2,100,-98
"24351","2363矽統","110/07/16","凱基-台北",520,466,54
"24352","2363矽統","110/07/16","元大-花蓮",8,99,-91
"24353","2363矽統","110/07/16","元富-城東",63,12,51
"24354","2363矽統","110/07/16","華南永昌-虎尾",68,154,-86
"24355","2363矽統","110/07/16","群益金鼎-桃園",56,5,51
"24356","2363矽統","110/07/16","富邦-新竹華信",7,89,-82
"24357","2363矽統","110/07/16","北城證券",60,10,50
"24358","2363矽統","110/07/16","元大-佳里",3,81,-78
"24359","2363矽統","110/07/16","國票-九鼎",57,7,50
"24360","2363矽統","110/07/16","玉山-南京東路",0,73,-73
"24361","8112至上","110/07/16","宏遠證券",551,6,545
"24362","8112至上","110/07/16","玉山-桃園",42,318,-276
"24363","8112至上","110/07/16","台灣摩根士丹利",317,11,306
"24364","8112至上","110/07/16","美林",64,305,-241
"24365","8112至上","110/07/16","新加坡商瑞銀",378,73,305
"24366","8112至上","110/07/16","宏遠-館前",16,212,-196
"24367","8112至上","110/07/16","凱基-台北",758,553,205
"24368","8112至上","110/07/16","玉山-嘉義",19,95,-76
"24369","8112至上","110/07/16","富邦證券",127,0,127
"24370","8112至上","110/07/16","群益金鼎-三民",7,82,-75
"24371","8112至上","110/07/16","台新證券",129,30,99
"24372","8112至上","110/07/16","日盛-二林",1,73,-72
"24373","8112至上","110/07/16","花旗環球",97,0,97
"24374","8112至上","110/07/16","玉山-台大",8,76,-68
"24375","8112至上","110/07/16","永豐金-台南",97,8,89
"24376","8112至上","110/07/16","元富-台南",1,68,-67
"24377","8112至上","110/07/16","元大-大天母",93,15,78
"24378","8112至上","110/07/16","玉山-板橋",4,71,-67
"24379","8112至上","110/07/16","亞東-板橋",72,2,70
"24380","8112至上","110/07/16","臺灣企銀-埔墘",0,60,-60
"24381","8112至上","110/07/16","永豐金-中正",64,9,55
"24382","8112至上","110/07/16","華南永昌-鶯歌",11,64,-53
"24383","8112至上","110/07/16","大昌-樹林",53,2,51
"24384","8112至上","110/07/16","元大-士林",7,59,-52
"24385","8112至上","110/07/16","凱基-永和",56,5,51
"24386","8112至上","110/07/16","元富-新店",8,57,-49
"24387","8112至上","110/07/16","兆豐-竹北",53,3,50
"24388","8112至上","110/07/16","富邦-陽明",9,58,-49
"24389","8112至上","110/07/16","日盛-豐原",48,0,48
"24390","8112至上","110/07/16","元大-發財",0,49,-49
"24391","1570力肯","110/07/16","新光",71,6,65
"24392","1570力肯","110/07/16","元大-高雄",0,23,-23
"24393","1570力肯","110/07/16","國票-北高雄",21,0,21
"24394","1570力肯","110/07/16","合庫-台南",0,20,-20
"24395","1570力肯","110/07/16","凱基-台北",17,1,16
"24396","1570力肯","110/07/16","元富-新店",0,15,-15
"24397","1570力肯","110/07/16","群益金鼎-高雄",15,0,15
"24398","1570力肯","110/07/16","元大-東港",0,10,-10
"24399","1570力肯","110/07/16","富邦-建國",10,0,10
"24400","1570力肯","110/07/16","中國信託",0,7,-7
"24401","1570力肯","110/07/16","元大-士林",5,0,5
"24402","1570力肯","110/07/16","台新證券",0,6,-6
"24403","1570力肯","110/07/16","瑞士信貸",3,0,3
"24404","1570力肯","110/07/16","日盛-信義",0,5,-5
"24405","1570力肯","110/07/16","臺銀-高雄",2,0,2
"24406","1570力肯","110/07/16","宏遠-館前",0,5,-5
"24407","1570力肯","110/07/16","華南永昌",2,0,2
"24408","1570力肯","110/07/16","國泰-館前",0,5,-5
"24409","1570力肯","110/07/16","元富-同大",1,0,1
"24410","1570力肯","110/07/16","富邦-園區",0,5,-5
"24411","1570力肯","110/07/16","兆豐-麻豆",1,0,1
"24412","1570力肯","110/07/16","永豐金-中正",0,5,-5
"24413","1570力肯","110/07/16","國泰-板橋",1,0,1
"24414","1570力肯","110/07/16","(牛牛牛)亞-鑫豐",0,4,-4
"24415","1570力肯","110/07/16","群益金鼎-東湖",1,0,1
"24416","1570力肯","110/07/16","台中銀-員林",0,3,-3
"24417","1570力肯","110/07/16","元大-東泰",1,0,1
"24418","1570力肯","110/07/16","玉山-新莊",0,3,-3
"24419","1570力肯","110/07/16","元大-南勢角",1,0,1
"24420","1570力肯","110/07/16","凱基-長庚",0,3,-3
"24421","2929淘帝","110/07/16","元大-民生",28,0,28
"24422","2929淘帝","110/07/16","玉山-新竹",0,30,-30
"24423","2929淘帝","110/07/16","元大-員林",20,0,20
"24424","2929淘帝","110/07/16","合庫證券",0,20,-20
"24425","2929淘帝","110/07/16","兆豐-桃鶯",12,0,12
"24426","2929淘帝","110/07/16","元大-六合",0,20,-20
"24427","2929淘帝","110/07/16","元大-大統",10,0,10
"24428","2929淘帝","110/07/16","摩根大通",0,12,-12
"24429","2929淘帝","110/07/16","新加坡商瑞銀",9,0,9
"24430","2929淘帝","110/07/16","永興",0,6,-6
"24431","2929淘帝","110/07/16","凱基-基隆",6,0,6
"24432","2929淘帝","110/07/16","凱基-長庚",0,5,-5
"24433","2929淘帝","110/07/16","合庫-高雄",5,0,5
"24434","2929淘帝","110/07/16","群益金鼎-潭子",0,4,-4
"24435","2929淘帝","110/07/16","台新-台中",6,1,5
"24436","2929淘帝","110/07/16","華南永昌-小港",2,6,-4
"24437","2929淘帝","110/07/16","元大-承德",5,0,5
"24438","2929淘帝","110/07/16","華南永昌-虎尾",0,4,-4
"24439","2929淘帝","110/07/16","元大-沙鹿",5,0,5
"24440","2929淘帝","110/07/16","日盛-和美",0,3,-3
"24441","2929淘帝","110/07/16","大慶-苗栗",5,1,4
"24442","2929淘帝","110/07/16","彰銀",0,3,-3
"24443","2929淘帝","110/07/16","台新-新營",4,0,4
"24444","2929淘帝","110/07/16","港商野村",7,10,-3
"24445","2929淘帝","110/07/16","凱基-台北",6,2,4
"24446","2929淘帝","110/07/16","群益金鼎-中山",1,4,-3
"24447","2929淘帝","110/07/16","兆豐-台中港",3,0,3
"24448","2929淘帝","110/07/16","凱基-嘉義",0,3,-3
"24449","2929淘帝","110/07/16","國票-北高雄",3,0,3
"24450","2929淘帝","110/07/16","元大-斗信",0,3,-3
"24451","5410國眾","110/07/16","盈溢-籬子內",49,0,49
"24452","5410國眾","110/07/16","元大-博愛",0,41,-41
"24453","5410國眾","110/07/16","香港上海匯豐",31,0,31
"24454","5410國眾","110/07/16","元富-嘉義",0,20,-20
"24455","5410國眾","110/07/16","元大-東泰",30,0,30
"24456","5410國眾","110/07/16","國泰-桃園",0,18,-18
"24457","5410國眾","110/07/16","兆豐-台中港",20,0,20
"24458","5410國眾","110/07/16","元富",0,17,-17
"24459","5410國眾","110/07/16","臺銀-臺南",11,0,11
"24460","5410國眾","110/07/16","元大-新竹",0,14,-14
"24461","5410國眾","110/07/16","富邦-新竹華信",11,0,11
"24462","5410國眾","110/07/16","安泰-大發",0,11,-11
"24463","5410國眾","110/07/16","臺銀",10,0,10
"24464","5410國眾","110/07/16","大昌-樹林",0,10,-10
"24465","5410國眾","110/07/16","凱基-台北",8,1,7
"24466","5410國眾","110/07/16","群益金鼎-內湖",0,10,-10
"24467","5410國眾","110/07/16","日盛-士林",5,0,5
"24468","5410國眾","110/07/16","元大-樹林",0,10,-10
"24469","5410國眾","110/07/16","新光-桃園",5,0,5
"24470","5410國眾","110/07/16","元大-內湖",0,9,-9
"24471","5410國眾","110/07/16","國泰-台南",5,0,5
"24472","5410國眾","110/07/16","群益金鼎-永和",0,5,-5
"24473","5410國眾","110/07/16","群益金鼎-嘉義",5,0,5
"24474","5410國眾","110/07/16","凱基-屏東",0,5,-5
"24475","5410國眾","110/07/16","元大-屏南",5,0,5
"24476","5410國眾","110/07/16","統一-員林",0,4,-4
"24477","5410國眾","110/07/16","日盛-員林",3,0,3
"24478","5410國眾","110/07/16","國泰-松江",0,4,-4
"24479","5410國眾","110/07/16","瑞士信貸",3,0,3
"24480","5410國眾","110/07/16","凱基-台南",0,4,-4
"24481","2841台開","110/07/16","日盛證券",250,0,250
"24482","2841台開","110/07/16","元大-歸仁",0,590,-590
"24483","2841台開","110/07/16","凱基-文心",204,0,204
"24484","2841台開","110/07/16","摩根大通",0,245,-245
"24485","2841台開","110/07/16","國泰-館前",114,0,114
"24486","2841台開","110/07/16","日盛-信義",0,145,-145
"24487","2841台開","110/07/16","永豐金-豐原",75,0,75
"24488","2841台開","110/07/16","港商野村",0,103,-103
"24489","2841台開","110/07/16","台新-台中",76,10,66
"24490","2841台開","110/07/16","玉山-嘉義",5,54,-49
"24491","2841台開","110/07/16","中國信託-文心",51,5,46
"24492","2841台開","110/07/16","台新證券",22,63,-41
"24493","2841台開","110/07/16","華南永昌-新莊",41,10,31
"24494","2841台開","110/07/16","美商高盛",0,39,-39
"24495","2841台開","110/07/16","富邦-嘉義",30,0,30
"24496","2841台開","110/07/16","亞東-板橋",0,30,-30
"24497","2841台開","110/07/16","新光",26,0,26
"24498","2841台開","110/07/16","永豐金-北高雄",0,30,-30
"24499","2841台開","110/07/16","富邦-板橋",25,0,25
"24500","2841台開","110/07/16","日盛-忠孝",0,20,-20
"24501","2841台開","110/07/16","新光-台中",22,0,22
"24502","2841台開","110/07/16","元富-草屯",0,15,-15
"24503","2841台開","110/07/16","元大-承德",22,0,22
"24504","2841台開","110/07/16","永豐金-板新",0,12,-12
"24505","2841台開","110/07/16","日盛-三重",20,0,20
"24506","2841台開","110/07/16","第一金-華江",0,10,-10
"24507","2841台開","110/07/16","日盛-新莊",20,0,20
"24508","2841台開","110/07/16","兆豐-南京",0,10,-10
"24509","2841台開","110/07/16","凱基-台南",20,0,20
"24510","2841台開","110/07/16","國票-中港",0,10,-10
"24511","6207雷科","110/07/16","統一-平鎮",215,4,211
"24512","6207雷科","110/07/16","凱基-台北",344,628,-284
"24513","6207雷科","110/07/16","凱基-復興",166,6,160
"24514","6207雷科","110/07/16","新加坡商瑞銀",104,370,-266
"24515","6207雷科","110/07/16","永豐金-南京",141,3,138
"24516","6207雷科","110/07/16","摩根大通",193,430,-237
"24517","6207雷科","110/07/16","永豐金-內湖",117,1,116
"24518","6207雷科","110/07/16","富邦證券",0,150,-150
"24519","6207雷科","110/07/16","日盛證券",104,2,102
"24520","6207雷科","110/07/16","華南永昌-中正",26,169,-143
"24521","6207雷科","110/07/16","群益金鼎-古亭",74,2,72
"24522","6207雷科","110/07/16","凱基-敦北",1,142,-141
"24523","6207雷科","110/07/16","群益金鼎-東門",76,12,64
"24524","6207雷科","110/07/16","凱基-板橋",0,120,-120
"24525","6207雷科","110/07/16","日盛-板橋",78,25,53
"24526","6207雷科","110/07/16","元富-大昌",30,136,-106
"24527","6207雷科","110/07/16","元大-斗六",57,6,51
"24528","6207雷科","110/07/16","元大-北成功",26,97,-71
"24529","6207雷科","110/07/16","元大-頭份",53,3,50
"24530","6207雷科","110/07/16","新光-桃園",29,93,-64
"24531","6207雷科","110/07/16","群益金鼎-東大",56,11,45
"24532","6207雷科","110/07/16","新百王",27,90,-63
"24533","6207雷科","110/07/16","永豐金-虎尾",50,8,42
"24534","6207雷科","110/07/16","玉山-左營",16,72,-56
"24535","6207雷科","110/07/16","元大-西門",39,1,38
"24536","6207雷科","110/07/16","群益金鼎-中壢",3,54,-51
"24537","6207雷科","110/07/16","凱基-竹科",38,1,37
"24538","6207雷科","110/07/16","元富-中原",21,67,-46
"24539","6207雷科","110/07/16","元富-世貿",50,15,35
"24540","6207雷科","110/07/16","大昌-桃園",26,70,-44
"24541","3679新至陞","110/07/16","元大-成功",17,1,16
"24542","3679新至陞","110/07/16","國票-桃園",0,11,-11
"24543","3679新至陞","110/07/16","玉山-台大",5,0,5
"24544","3679新至陞","110/07/16","富邦-台北",0,10,-10
"24545","3679新至陞","110/07/16","日盛-員林",4,0,4
"24546","3679新至陞","110/07/16","富邦-苗栗",0,10,-10
"24547","3679新至陞","110/07/16","凱基-台北",6,2,4
"24548","3679新至陞","110/07/16","元大-永春",0,6,-6
"24549","3679新至陞","110/07/16","台灣摩根士丹利",3,0,3
"24550","3679新至陞","110/07/16","美林",0,5,-5
"24551","3679新至陞","110/07/16","凱基-中山",3,0,3
"24552","3679新至陞","110/07/16","瑞士信貸",3,7,-4
"24553","3679新至陞","110/07/16","元大-承德",3,0,3
"24554","3679新至陞","110/07/16","宏遠-館前",0,3,-3
"24555","3679新至陞","110/07/16","元大-汐止",4,1,3
"24556","3679新至陞","110/07/16","元大-東港",0,3,-3
"24557","3679新至陞","110/07/16","日盛-大墩",2,0,2
"24558","3679新至陞","110/07/16","元大證券",0,2,-2
"24559","3679新至陞","110/07/16","玉山-城中",2,0,2
"24560","3679新至陞","110/07/16","永豐金-板新",0,2,-2
"24561","3679新至陞","110/07/16","華南永昌-內壢",2,0,2
"24562","3679新至陞","110/07/16","臺銀-民權",0,1,-1
"24563","3679新至陞","110/07/16","元大-台南",2,0,2
"24564","3679新至陞","110/07/16","日盛-台中",0,1,-1
"24565","3679新至陞","110/07/16","元大-大同",2,0,2
"24566","3679新至陞","110/07/16","日盛-鳳山",0,1,-1
"24567","3679新至陞","110/07/16","臺銀-高雄",1,0,1
"24568","3679新至陞","110/07/16","元富-古亭",0,1,-1
"24569","3679新至陞","110/07/16","日盛-樹林",1,0,1
"24570","3679新至陞","110/07/16","元富-新興",0,1,-1
"24571","2727王品","110/07/16","富邦證券",570,0,570
"24572","2727王品","110/07/16","台新證券",27,77,-50
"24573","2727王品","110/07/16","兆豐-南京",200,0,200
"24574","2727王品","110/07/16","台灣摩根士丹利",4,47,-43
"24575","2727王品","110/07/16","瑞士信貸",133,2,131
"24576","2727王品","110/07/16","永豐金-大園",0,33,-33
"24577","2727王品","110/07/16","美林",121,26,95
"24578","2727王品","110/07/16","元大-北屯",0,32,-32
"24579","2727王品","110/07/16","統一",103,43,60
"24580","2727王品","110/07/16","富邦-南屯",1,30,-29
"24581","2727王品","110/07/16","中國信託-忠孝",36,2,34
"24582","2727王品","110/07/16","元大-基隆孝二",0,29,-29
"24583","2727王品","110/07/16","元大證券",68,45,23
"24584","2727王品","110/07/16","日盛-忠孝",4,30,-26
"24585","2727王品","110/07/16","合庫-彰化",22,1,21
"24586","2727王品","110/07/16","新光-新竹",1,21,-20
"24587","2727王品","110/07/16","港商野村",126,105,21
"24588","2727王品","110/07/16","凱基-台北",94,113,-19
"24589","2727王品","110/07/16","元富-板橋",22,1,21
"24590","2727王品","110/07/16","富邦-虎尾",1,19,-18
"24591","2727王品","110/07/16","新加坡商瑞銀",36,18,18
"24592","2727王品","110/07/16","元大-南京",0,17,-17
"24593","2727王品","110/07/16","國泰證券",20,5,15
"24594","2727王品","110/07/16","日盛-鳳山",2,18,-16
"24595","2727王品","110/07/16","日盛-桃園",13,1,12
"24596","2727王品","110/07/16","新光",34,50,-16
"24597","2727王品","110/07/16","凱基-市政",12,1,11
"24598","2727王品","110/07/16","富邦-台北",2,18,-16
"24599","2727王品","110/07/16","元大-嘉義",14,3,11
"24600","2727王品","110/07/16","國票-內壢",1,15,-14
"24601","1570力肯","110/07/16","新光",71,6,65
"24602","1570力肯","110/07/16","元大-高雄",0,23,-23
"24603","1570力肯","110/07/16","國票-北高雄",21,0,21
"24604","1570力肯","110/07/16","合庫-台南",0,20,-20
"24605","1570力肯","110/07/16","凱基-台北",17,1,16
"24606","1570力肯","110/07/16","元富-新店",0,15,-15
"24607","1570力肯","110/07/16","群益金鼎-高雄",15,0,15
"24608","1570力肯","110/07/16","元大-東港",0,10,-10
"24609","1570力肯","110/07/16","富邦-建國",10,0,10
"24610","1570力肯","110/07/16","中國信託",0,7,-7
"24611","1570力肯","110/07/16","元大-士林",5,0,5
"24612","1570力肯","110/07/16","台新證券",0,6,-6
"24613","1570力肯","110/07/16","瑞士信貸",3,0,3
"24614","1570力肯","110/07/16","日盛-信義",0,5,-5
"24615","1570力肯","110/07/16","臺銀-高雄",2,0,2
"24616","1570力肯","110/07/16","宏遠-館前",0,5,-5
"24617","1570力肯","110/07/16","華南永昌",2,0,2
"24618","1570力肯","110/07/16","國泰-館前",0,5,-5
"24619","1570力肯","110/07/16","元富-同大",1,0,1
"24620","1570力肯","110/07/16","富邦-園區",0,5,-5
"24621","1570力肯","110/07/16","兆豐-麻豆",1,0,1
"24622","1570力肯","110/07/16","永豐金-中正",0,5,-5
"24623","1570力肯","110/07/16","國泰-板橋",1,0,1
"24624","1570力肯","110/07/16","(牛牛牛)亞-鑫豐",0,4,-4
"24625","1570力肯","110/07/16","群益金鼎-東湖",1,0,1
"24626","1570力肯","110/07/16","台中銀-員林",0,3,-3
"24627","1570力肯","110/07/16","元大-東泰",1,0,1
"24628","1570力肯","110/07/16","玉山-新莊",0,3,-3
"24629","1570力肯","110/07/16","元大-南勢角",1,0,1
"24630","1570力肯","110/07/16","凱基-長庚",0,3,-3
"24631","6180橘子","110/07/16","日盛-文化",71,5,66
"24632","6180橘子","110/07/16","凱基-台北",110,238,-128
"24633","6180橘子","110/07/16","新加坡商瑞銀",75,19,56
"24634","6180橘子","110/07/16","摩根大通",77,161,-84
"24635","6180橘子","110/07/16","瑞士信貸",51,0,51
"24636","6180橘子","110/07/16","元富-高雄",0,62,-62
"24637","6180橘子","110/07/16","台灣企銀-屏東",50,0,50
"24638","6180橘子","110/07/16","美商高盛",0,40,-40
"24639","6180橘子","110/07/16","元大-桃園",52,2,50
"24640","6180橘子","110/07/16","合庫-自強",0,37,-37
"24641","6180橘子","110/07/16","康和-台北",51,10,41
"24642","6180橘子","110/07/16","美林",15,48,-33
"24643","6180橘子","110/07/16","群益金鼎-屏東",61,20,41
"24644","6180橘子","110/07/16","元富-四維",0,32,-32
"24645","6180橘子","110/07/16","元大-彰化",33,2,31
"24646","6180橘子","110/07/16","新光",63,92,-29
"24647","6180橘子","110/07/16","台中銀-台北",30,0,30
"24648","6180橘子","110/07/16","新光-台南",6,28,-22
"24649","6180橘子","110/07/16","福勝",29,3,26
"24650","6180橘子","110/07/16","港商野村",28,49,-21
"24651","6180橘子","110/07/16","兆豐證券",21,0,21
"24652","6180橘子","110/07/16","統一",2,23,-21
"24653","6180橘子","110/07/16","華南永昌-頭份",20,0,20
"24654","6180橘子","110/07/16","元大-豐原站前",3,21,-18
"24655","6180橘子","110/07/16","富邦-台北",25,5,20
"24656","6180橘子","110/07/16","豐農",3,20,-17
"24657","6180橘子","110/07/16","富邦-員林",23,4,19
"24658","6180橘子","110/07/16","安泰-大發",0,17,-17
"24659","6180橘子","110/07/16","台新-新莊",20,2,18
"24660","6180橘子","110/07/16","群益金鼎",2,19,-17
"24661","2390云辰","110/07/16","兆豐-天母",642,7,635
"24662","2390云辰","110/07/16","凱基",0,5007,-5007
"24663","2390云辰","110/07/16","華南永昌-鳳山",339,35,304
"24664","2390云辰","110/07/16","凱基-台北",1224,2306,-1082
"24665","2390云辰","110/07/16","第一金-大稻埕",269,13,256
"24666","2390云辰","110/07/16","元大證券",206,1177,-971
"24667","2390云辰","110/07/16","國泰-敦南",665,427,238
"24668","2390云辰","110/07/16","摩根大通",1073,1967,-894
"24669","2390云辰","110/07/16","富邦-建國",272,50,222
"24670","2390云辰","110/07/16","台灣摩根士丹利",232,671,-439
"24671","2390云辰","110/07/16","元大-信義",180,15,165
"24672","2390云辰","110/07/16","美林",187,496,-309
"24673","2390云辰","110/07/16","瑞士信貸",155,0,155
"24674","2390云辰","110/07/16","港商野村",680,950,-270
"24675","2390云辰","110/07/16","台新證券",461,317,144
"24676","2390云辰","110/07/16","永豐金-中正",18,170,-152
"24677","2390云辰","110/07/16","兆豐-公益",148,11,137
"24678","2390云辰","110/07/16","元富-板橋",30,169,-139
"24679","2390云辰","110/07/16","元大-土城學府",197,61,136
"24680","2390云辰","110/07/16","新加坡商瑞銀",61,175,-114
"24681","2390云辰","110/07/16","元大-天母",232,122,110
"24682","2390云辰","110/07/16","聯邦商銀",54,167,-113
"24683","2390云辰","110/07/16","凱基-基隆",109,2,107
"24684","2390云辰","110/07/16","群益金鼎-大甲",13,111,-98
"24685","2390云辰","110/07/16","元富-成功",110,5,105
"24686","2390云辰","110/07/16","統一-屏東",4,92,-88
"24687","2390云辰","110/07/16","統一-新營",118,14,104
"24688","2390云辰","110/07/16","凱基-大直",3,80,-77
"24689","2390云辰","110/07/16","國泰-板橋",268,170,98
"24690","2390云辰","110/07/16","元大-桃興",46,117,-71
"24691","2363矽統","110/07/15","康和-台中",626,61,565
"24692","2363矽統","110/07/15","新加坡商瑞銀",202,838,-636
"24693","2363矽統","110/07/15","摩根大通",1271,932,339
"24694","2363矽統","110/07/15","美林",185,720,-535
"24695","2363矽統","110/07/15","瑞士信貸",530,230,300
"24696","2363矽統","110/07/15","富邦-仁愛",60,583,-523
"24697","2363矽統","110/07/15","宏遠-桃園",281,0,281
"24698","2363矽統","110/07/15","元大-板橋",35,368,-333
"24699","2363矽統","110/07/15","大展",252,19,233
"24700","2363矽統","110/07/15","花旗環球",0,308,-308
"24701","2363矽統","110/07/15","凱基-台北",683,498,185
"24702","2363矽統","110/07/15","元富-成功",2,113,-111
"24703","2363矽統","110/07/15","永豐金證券",166,11,155
"24704","2363矽統","110/07/15","富邦-新營",23,132,-109
"24705","2363矽統","110/07/15","群益金鼎",157,5,152
"24706","2363矽統","110/07/15","臺銀-金山",197,304,-107
"24707","2363矽統","110/07/15","新光",333,229,104
"24708","2363矽統","110/07/15","日盛-二林",13,116,-103
"24709","2363矽統","110/07/15","永豐金-台南",130,26,104
"24710","2363矽統","110/07/15","台新-左楠",40,126,-86
"24711","2363矽統","110/07/15","國票-南京",100,0,100
"24712","2363矽統","110/07/15","康和-南崁",15,100,-85
"24713","2363矽統","110/07/15","群益金鼎-松山",150,50,100
"24714","2363矽統","110/07/15","永豐金-員林",9,91,-82
"24715","2363矽統","110/07/15","中國信託-松江",103,5,98
"24716","2363矽統","110/07/15","光和-嘉義",5,78,-73
"24717","2363矽統","110/07/15","國票-新莊",187,92,95
"24718","2363矽統","110/07/15","日盛-板橋中山",3,73,-70
"24719","2363矽統","110/07/15","北城證券",216,126,90
"24720","2363矽統","110/07/15","元大證券",10,75,-65
"24721","8112至上","110/07/15","凱基-台北",535,32,503
"24722","8112至上","110/07/15","群益金鼎-台南",0,116,-116
"24723","8112至上","110/07/15","摩根大通",362,16,346
"24724","8112至上","110/07/15","華南永昌-高雄",2,112,-110
"24725","8112至上","110/07/15","台灣摩根士丹利",254,0,254
"24726","8112至上","110/07/15","永豐金-台南",27,128,-101
"24727","8112至上","110/07/15","花旗環球",159,0,159
"24728","8112至上","110/07/15","元大-東蘆",2,73,-71
"24729","8112至上","110/07/15","新加坡商瑞銀",95,2,93
"24730","8112至上","110/07/15","美林",3,66,-63
"24731","8112至上","110/07/15","玉山-嘉義",84,0,84
"24732","8112至上","110/07/15","元大-館前",0,62,-62
"24733","8112至上","110/07/15","新光",82,6,76
"24734","8112至上","110/07/15","元富-信義",0,50,-50
"24735","8112至上","110/07/15","瑞士信貸",80,7,73
"24736","8112至上","110/07/15","台新證券",35,82,-47
"24737","8112至上","110/07/15","美商高盛",64,0,64
"24738","8112至上","110/07/15","大慶-蘆洲",7,53,-46
"24739","8112至上","110/07/15","兆豐-小港",56,0,56
"24740","8112至上","110/07/15","國票-天祥",0,45,-45
"24741","8112至上","110/07/15","永豐金-內湖",60,11,49
"24742","8112至上","110/07/15","凱基-中山",1,45,-44
"24743","8112至上","110/07/15","永豐金-南投",46,1,45
"24744","8112至上","110/07/15","元大-士林",0,43,-43
"24745","8112至上","110/07/15","凱基-三重",40,0,40
"24746","8112至上","110/07/15","玉山-城中",4,44,-40
"24747","8112至上","110/07/15","台灣企銀",29,0,29
"24748","8112至上","110/07/15","凱基-彰化",0,39,-39
"24749","8112至上","110/07/15","元大-府城",42,14,28
"24750","8112至上","110/07/15","元富-花蓮",2,40,-38
"24751","1570力肯","110/07/15","群益金鼎-高雄",40,0,40
"24752","1570力肯","110/07/15","元大-高雄",0,12,-12
"24753","1570力肯","110/07/15","新光",40,8,32
"24754","1570力肯","110/07/15","永豐金-中正",0,10,-10
"24755","1570力肯","110/07/15","凱基-台北",20,2,18
"24756","1570力肯","110/07/15","國泰-松江",0,9,-9
"24757","1570力肯","110/07/15","凱基-天母",6,0,6
"24758","1570力肯","110/07/15","台新證券",0,8,-8
"24759","1570力肯","110/07/15","元富-新店",5,0,5
"24760","1570力肯","110/07/15","玉山證券",0,7,-7
"24761","1570力肯","110/07/15","凱基-中港",5,0,5
"24762","1570力肯","110/07/15","元大-府城",0,7,-7
"24763","1570力肯","110/07/15","富邦-園區",5,0,5
"24764","1570力肯","110/07/15","元大-板橋",0,6,-6
"24765","1570力肯","110/07/15","瑞士信貸",4,0,4
"24766","1570力肯","110/07/15","日盛-信義",0,5,-5
"24767","1570力肯","110/07/15","第一金-路竹",3,0,3
"24768","1570力肯","110/07/15","國票-和平",0,5,-5
"24769","1570力肯","110/07/15","摩根大通",3,0,3
"24770","1570力肯","110/07/15","元大-民雄",0,5,-5
"24771","1570力肯","110/07/15","凱基-桃園",3,0,3
"24772","1570力肯","110/07/15","統一-台中",0,4,-4
"24773","1570力肯","110/07/15","永豐金-苓雅",3,0,3
"24774","1570力肯","110/07/15","玉山-雙和",0,4,-4
"24775","1570力肯","110/07/15","統一-員林",2,0,2
"24776","1570力肯","110/07/15","凱基-敦北",0,4,-4
"24777","1570力肯","110/07/15","元大-永春",2,0,2
"24778","1570力肯","110/07/15","富邦-新店",0,4,-4
"24779","1570力肯","110/07/15","元大-土城永寧",2,0,2
"24780","1570力肯","110/07/15","日盛-板橋",0,3,-3
"24781","2929淘帝","110/07/15","港商野村",58,4,54
"24782","2929淘帝","110/07/15","日盛-園區",0,25,-25
"24783","2929淘帝","110/07/15","元大-民生",29,0,29
"24784","2929淘帝","110/07/15","兆豐-南京",0,20,-20
"24785","2929淘帝","110/07/15","新加坡商瑞銀",22,1,21
"24786","2929淘帝","110/07/15","玉山-高雄",0,18,-18
"24787","2929淘帝","110/07/15","凱基-台北",20,2,18
"24788","2929淘帝","110/07/15","富邦-南屯",1,15,-14
"24789","2929淘帝","110/07/15","大慶-中壢",15,1,14
"24790","2929淘帝","110/07/15","富邦-員林",0,13,-13
"24791","2929淘帝","110/07/15","日盛-和美",10,0,10
"24792","2929淘帝","110/07/15","凱基-站前",0,10,-10
"24793","2929淘帝","110/07/15","元大-員林",10,0,10
"24794","2929淘帝","110/07/15","元大-台中",0,10,-10
"24795","2929淘帝","110/07/15","凱基-基隆",6,0,6
"24796","2929淘帝","110/07/15","美林",10,19,-9
"24797","2929淘帝","110/07/15","臺銀-鳳山",5,0,5
"24798","2929淘帝","110/07/15","元大-新盛",0,8,-8
"24799","2929淘帝","110/07/15","第一金-路竹",5,0,5
"24800","2929淘帝","110/07/15","台新-台南",0,7,-7
"24801","2929淘帝","110/07/15","元富-大裕",5,0,5
"24802","2929淘帝","110/07/15","元大-大天母",0,7,-7
"24803","2929淘帝","110/07/15","玉山-大里",5,0,5
"24804","2929淘帝","110/07/15","華南永昌-虎尾",0,6,-6
"24805","2929淘帝","110/07/15","元大-博愛",5,0,5
"24806","2929淘帝","110/07/15","永豐金證券",0,6,-6
"24807","2929淘帝","110/07/15","永豐金-新莊",5,0,5
"24808","2929淘帝","110/07/15","兆豐-竹北",0,5,-5
"24809","2929淘帝","110/07/15","元大-南崁",4,0,4
"24810","2929淘帝","110/07/15","元大-文心興安",0,5,-5
"24811","5410國眾","110/07/15","香港上海匯豐",18,0,18
"24812","5410國眾","110/07/15","元大-南屯",0,18,-18
"24813","5410國眾","110/07/15","摩根大通",15,0,15
"24814","5410國眾","110/07/15","亞東-新竹",0,15,-15
"24815","5410國眾","110/07/15","日盛-士林",10,0,10
"24816","5410國眾","110/07/15","兆豐-台中港",0,15,-15
"24817","5410國眾","110/07/15","群益金鼎-嘉義",10,0,10
"24818","5410國眾","110/07/15","日盛-板橋",0,12,-12
"24819","5410國眾","110/07/15","元大-高雄",10,0,10
"24820","5410國眾","110/07/15","台中銀-豐原",0,9,-9
"24821","5410國眾","110/07/15","元大-東港",10,0,10
"24822","5410國眾","110/07/15","臺銀-臺南",3,10,-7
"24823","5410國眾","110/07/15","臺銀",10,5,5
"24824","5410國眾","110/07/15","瑞士信貸",0,5,-5
"24825","5410國眾","110/07/15","台新-新營",5,0,5
"24826","5410國眾","110/07/15","統一-員林",0,5,-5
"24827","5410國眾","110/07/15","富邦-台北",5,0,5
"24828","5410國眾","110/07/15","大昌-樹林",0,5,-5
"24829","5410國眾","110/07/15","日盛-屏東",4,0,4
"24830","5410國眾","110/07/15","兆豐-來福",0,5,-5
"24831","5410國眾","110/07/15","高橋",5,1,4
"24832","5410國眾","110/07/15","豐農",0,5,-5
"24833","5410國眾","110/07/15","中國信託-新竹",4,1,3
"24834","5410國眾","110/07/15","元大-大里",0,5,-5
"24835","5410國眾","110/07/15","富邦-建國",3,0,3
"24836","5410國眾","110/07/15","港商野村",0,3,-3
"24837","5410國眾","110/07/15","永豐金-桃園",3,0,3
"24838","5410國眾","110/07/15","中農",0,3,-3
"24839","5410國眾","110/07/15","大展",2,0,2
"24840","5410國眾","110/07/15","國泰-忠孝",0,3,-3
"24841","2841台開","110/07/15","日盛證券",310,0,310
"24842","2841台開","110/07/15","港商野村",0,97,-97
"24843","2841台開","110/07/15","元富-城東",100,0,100
"24844","2841台開","110/07/15","元大-員林",0,77,-77
"24845","2841台開","110/07/15","凱基-文心",30,0,30
"24846","2841台開","110/07/15","新光",3,73,-70
"24847","2841台開","110/07/15","日盛-雙和",24,0,24
"24848","2841台開","110/07/15","永豐金-北高雄",0,30,-30
"24849","2841台開","110/07/15","第一金-台中",20,0,20
"24850","2841台開","110/07/15","華南永昌",0,25,-25
"24851","2841台開","110/07/15","豐農",20,0,20
"24852","2841台開","110/07/15","日盛-台南",0,20,-20
"24853","2841台開","110/07/15","華南永昌-新莊",19,0,19
"24854","2841台開","110/07/15","致和-佳里",0,20,-20
"24855","2841台開","110/07/15","玉山-大里",12,0,12
"24856","2841台開","110/07/15","國票-中港",0,20,-20
"24857","2841台開","110/07/15","元富-安南",10,0,10
"24858","2841台開","110/07/15","元大-歸仁",0,20,-20
"24859","2841台開","110/07/15","凱基-市政",10,0,10
"24860","2841台開","110/07/15","統一-三多",0,19,-19
"24861","2841台開","110/07/15","凱基-竹科",10,0,10
"24862","2841台開","110/07/15","凱基-城中",0,18,-18
"24863","2841台開","110/07/15","國泰-板橋",10,1,9
"24864","2841台開","110/07/15","國票-中和",0,15,-15
"24865","2841台開","110/07/15","凱基-台北",9,0,9
"24866","2841台開","110/07/15","元大-彰化",0,15,-15
"24867","2841台開","110/07/15","合庫證券",6,0,6
"24868","2841台開","110/07/15","元大-復北",0,15,-15
"24869","2841台開","110/07/15","台中銀",6,0,6
"24870","2841台開","110/07/15","土銀-花蓮",0,14,-14
"24871","6207雷科","110/07/15","凱基-板橋",210,45,165
"24872","6207雷科","110/07/15","群益金鼎-台北",20,80,-60
"24873","6207雷科","110/07/15","富邦證券",150,0,150
"24874","6207雷科","110/07/15","元大-大天母",1,56,-55
"24875","6207雷科","110/07/15","凱基-復興",140,0,140
"24876","6207雷科","110/07/15","大慶-中壢",2,50,-48
"24877","6207雷科","110/07/15","華南永昌-中正",140,0,140
"24878","6207雷科","110/07/15","元富-林園",0,47,-47
"24879","6207雷科","110/07/15","永豐金-內湖",92,10,82
"24880","6207雷科","110/07/15","元大-東門",0,40,-40
"24881","6207雷科","110/07/15","富邦-彰化",81,11,70
"24882","6207雷科","110/07/15","第一金-安和",0,37,-37
"24883","6207雷科","110/07/15","(牛牛牛)亞-網路",67,0,67
"24884","6207雷科","110/07/15","凱基-台北",61,97,-36
"24885","6207雷科","110/07/15","台新證券",60,8,52
"24886","6207雷科","110/07/15","國票-南科",0,32,-32
"24887","6207雷科","110/07/15","華南永昌",50,3,47
"24888","6207雷科","110/07/15","元大-四維",0,32,-32
"24889","6207雷科","110/07/15","新加坡商瑞銀",68,26,42
"24890","6207雷科","110/07/15","元大-板橋",0,30,-30
"24891","6207雷科","110/07/15","日盛-景美",40,0,40
"24892","6207雷科","110/07/15","元大-南崁",1,30,-29
"24893","6207雷科","110/07/15","元富-大昌",40,0,40
"24894","6207雷科","110/07/15","凱基-岡山",0,27,-27
"24895","6207雷科","110/07/15","統一-高雄",38,5,33
"24896","6207雷科","110/07/15","統一-新竹",0,26,-26
"24897","6207雷科","110/07/15","日盛證券",32,0,32
"24898","6207雷科","110/07/15","群益金鼎-三民",1,27,-26
"24899","6207雷科","110/07/15","華南永昌-頭份",31,0,31
"24900","6207雷科","110/07/15","國票-台中",0,25,-25
"24901","3679新至陞","110/07/15","群益金鼎-大安",25,0,25
"24902","3679新至陞","110/07/15","元大-成功",0,10,-10
"24903","3679新至陞","110/07/15","元大-彰化",13,0,13
"24904","3679新至陞","110/07/15","群益金鼎-東大",0,8,-8
"24905","3679新至陞","110/07/15","國票-桃園",10,0,10
"24906","3679新至陞","110/07/15","凱基-台北",4,12,-8
"24907","3679新至陞","110/07/15","群益金鼎-台南",10,0,10
"24908","3679新至陞","110/07/15","第一金-華江",0,5,-5
"24909","3679新至陞","110/07/15","華南永昌-台中",10,0,10
"24910","3679新至陞","110/07/15","兆豐-來福",0,5,-5
"24911","3679新至陞","110/07/15","港商野村",9,0,9
"24912","3679新至陞","110/07/15","元大-北三重",0,5,-5
"24913","3679新至陞","110/07/15","元大-永春",6,0,6
"24914","3679新至陞","110/07/15","瑞士信貸",0,4,-4
"24915","3679新至陞","110/07/15","(牛牛牛)亞-網路",5,0,5
"24916","3679新至陞","110/07/15","新加坡商瑞銀",0,4,-4
"24917","3679新至陞","110/07/15","凱基-高雄",5,0,5
"24918","3679新至陞","110/07/15","元大-汐止",0,4,-4
"24919","3679新至陞","110/07/15","美商高盛",6,2,4
"24920","3679新至陞","110/07/15","台中銀-員林",0,3,-3
"24921","3679新至陞","110/07/15","台新證券",3,1,2
"24922","3679新至陞","110/07/15","兆豐-忠孝",0,3,-3
"24923","3679新至陞","110/07/15","群益金鼎-大興",2,0,2
"24924","3679新至陞","110/07/15","玉山-新莊",0,3,-3
"24925","3679新至陞","110/07/15","元大-六合",2,0,2
"24926","3679新至陞","110/07/15","永豐金-屏東",0,3,-3
"24927","3679新至陞","110/07/15","彰銀",1,0,1
"24928","3679新至陞","110/07/15","永豐金-敦南",0,3,-3
"24929","3679新至陞","110/07/15","美林",2,1,1
"24930","3679新至陞","110/07/15","永豐金-萬盛",0,3,-3
"24931","2727王品","110/07/15","兆豐-南京",101,0,101
"24932","2727王品","110/07/15","富邦-左營",0,102,-102
"24933","2727王品","110/07/15","港商野村",166,73,93
"24934","2727王品","110/07/15","日盛-忠孝",2,32,-30
"24935","2727王品","110/07/15","瑞士信貸",97,8,89
"24936","2727王品","110/07/15","群益金鼎-古亭",2,24,-22
"24937","2727王品","110/07/15","玉山證券",56,12,44
"24938","2727王品","110/07/15","日盛-八德",0,21,-21
"24939","2727王品","110/07/15","第一金-高雄",43,1,42
"24940","2727王品","110/07/15","元大-新盛",2,23,-21
"24941","2727王品","110/07/15","台新證券",74,45,29
"24942","2727王品","110/07/15","摩根大通",53,72,-19
"24943","2727王品","110/07/15","康和-澎湖",27,0,27
"24944","2727王品","110/07/15","富邦-彰化",8,26,-18
"24945","2727王品","110/07/15","富邦-陽明",31,4,27
"24946","2727王品","110/07/15","富邦-台中",7,24,-17
"24947","2727王品","110/07/15","國票-北高雄",27,1,26
"24948","2727王品","110/07/15","新加坡商瑞銀",13,29,-16
"24949","2727王品","110/07/15","國泰-板橋",38,12,26
"24950","2727王品","110/07/15","國泰-敦南",35,50,-15
"24951","2727王品","110/07/15","凱基-興隆",23,0,23
"24952","2727王品","110/07/15","元大-龍潭",0,14,-14
"24953","2727王品","110/07/15","凱基-板橋",29,7,22
"24954","2727王品","110/07/15","中國信託-文心",8,21,-13
"24955","2727王品","110/07/15","合庫-彰化",21,0,21
"24956","2727王品","110/07/15","永豐金-竹科",2,15,-13
"24957","2727王品","110/07/15","土銀-南港",20,0,20
"24958","2727王品","110/07/15","臺銀-臺南",2,14,-12
"24959","2727王品","110/07/15","美林",37,18,19
"24960","2727王品","110/07/15","凱基-台北",56,68,-12
"24961","1570力肯","110/07/15","群益金鼎-高雄",40,0,40
"24962","1570力肯","110/07/15","元大-高雄",0,12,-12
"24963","1570力肯","110/07/15","新光",40,8,32
"24964","1570力肯","110/07/15","永豐金-中正",0,10,-10
"24965","1570力肯","110/07/15","凱基-台北",20,2,18
"24966","1570力肯","110/07/15","國泰-松江",0,9,-9
"24967","1570力肯","110/07/15","凱基-天母",6,0,6
"24968","1570力肯","110/07/15","台新證券",0,8,-8
"24969","1570力肯","110/07/15","元富-新店",5,0,5
"24970","1570力肯","110/07/15","玉山證券",0,7,-7
"24971","1570力肯","110/07/15","凱基-中港",5,0,5
"24972","1570力肯","110/07/15","元大-府城",0,7,-7
"24973","1570力肯","110/07/15","富邦-園區",5,0,5
"24974","1570力肯","110/07/15","元大-板橋",0,6,-6
"24975","1570力肯","110/07/15","瑞士信貸",4,0,4
"24976","1570力肯","110/07/15","日盛-信義",0,5,-5
"24977","1570力肯","110/07/15","第一金-路竹",3,0,3
"24978","1570力肯","110/07/15","國票-和平",0,5,-5
"24979","1570力肯","110/07/15","摩根大通",3,0,3
"24980","1570力肯","110/07/15","元大-民雄",0,5,-5
"24981","1570力肯","110/07/15","凱基-桃園",3,0,3
"24982","1570力肯","110/07/15","統一-台中",0,4,-4
"24983","1570力肯","110/07/15","永豐金-苓雅",3,0,3
"24984","1570力肯","110/07/15","玉山-雙和",0,4,-4
"24985","1570力肯","110/07/15","統一-員林",2,0,2
"24986","1570力肯","110/07/15","凱基-敦北",0,4,-4
"24987","1570力肯","110/07/15","元大-永春",2,0,2
"24988","1570力肯","110/07/15","富邦-新店",0,4,-4
"24989","1570力肯","110/07/15","元大-土城永寧",2,0,2
"24990","1570力肯","110/07/15","日盛-板橋",0,3,-3
"24991","6180橘子","110/07/15","兆豐證券",130,0,130
"24992","6180橘子","110/07/15","港商野村",21,137,-116
"24993","6180橘子","110/07/15","摩根大通",111,0,111
"24994","6180橘子","110/07/15","高橋",0,40,-40
"24995","6180橘子","110/07/15","石橋證券",80,0,80
"24996","6180橘子","110/07/15","臺銀",1,40,-39
"24997","6180橘子","110/07/15","凱基-台北",78,26,52
"24998","6180橘子","110/07/15","玉山-桃園",0,35,-35
"24999","6180橘子","110/07/15","新加坡商瑞銀",38,1,37
"25000","6180橘子","110/07/15","玉山-台南",2,33,-31
"25001","6180橘子","110/07/15","富邦-員林",32,0,32
"25002","6180橘子","110/07/15","統一-南京",0,30,-30
"25003","6180橘子","110/07/15","日盛-文化",23,0,23
"25004","6180橘子","110/07/15","康和-台南",0,25,-25
"25005","6180橘子","110/07/15","元富-新店",20,0,20
"25006","6180橘子","110/07/15","大昌-樹林",0,22,-22
"25007","6180橘子","110/07/15","美林",15,0,15
"25008","6180橘子","110/07/15","康和-新竹",0,20,-20
"25009","6180橘子","110/07/15","新光-新竹",17,2,15
"25010","6180橘子","110/07/15","群益金鼎-台中",0,20,-20
"25011","6180橘子","110/07/15","富邦-嘉義",12,0,12
"25012","6180橘子","110/07/15","元大-彰化民生",0,18,-18
"25013","6180橘子","110/07/15","花旗環球",11,0,11
"25014","6180橘子","110/07/15","元大-草屯",0,16,-16
"25015","6180橘子","110/07/15","第一金-新興",11,0,11
"25016","6180橘子","110/07/15","元富-潮州",0,13,-13
"25017","6180橘子","110/07/15","第一金-桃園",10,0,10
"25018","6180橘子","110/07/15","宏遠-台南",0,11,-11
"25019","6180橘子","110/07/15","永興",10,0,10
"25020","6180橘子","110/07/15","大慶-泰山",0,10,-10
"25021","2390云辰","110/07/15","凱基",5007,0,5007
"25022","2390云辰","110/07/15","凱基-台北",382,616,-234
"25023","2390云辰","110/07/15","元大證券",1006,25,981
"25024","2390云辰","110/07/15","富邦-陽明",69,265,-196
"25025","2390云辰","110/07/15","元大-天母",456,20,436
"25026","2390云辰","110/07/15","永豐金-桃園",63,255,-192
"25027","2390云辰","110/07/15","港商野村",975,675,300
"25028","2390云辰","110/07/15","富邦-仁愛",17,187,-170
"25029","2390云辰","110/07/15","摩根大通",1318,1040,278
"25030","2390云辰","110/07/15","日盛-和美",2,165,-163
"25031","2390云辰","110/07/15","國票-博愛",184,7,177
"25032","2390云辰","110/07/15","國泰-敦南",142,290,-148
"25033","2390云辰","110/07/15","群益金鼎-大甲",113,13,100
"25034","2390云辰","110/07/15","台灣摩根士丹利",51,197,-146
"25035","2390云辰","110/07/15","凱基-大直",89,2,87
"25036","2390云辰","110/07/15","國票-嘉義",4,148,-144
"25037","2390云辰","110/07/15","玉山-台中",77,8,69
"25038","2390云辰","110/07/15","台中銀",8,139,-131
"25039","2390云辰","110/07/15","聯邦商銀",70,4,66
"25040","2390云辰","110/07/15","元大-彰化民生",7,138,-131
"25041","2390云辰","110/07/15","元大-大里",88,25,63
"25042","2390云辰","110/07/15","元富-成功",2,111,-109
"25043","2390云辰","110/07/15","富邦-嘉義",542,480,62
"25044","2390云辰","110/07/15","元大-東泰",3,106,-103
"25045","2390云辰","110/07/15","新加坡商瑞銀",158,97,61
"25046","2390云辰","110/07/15","合庫-三重",1,102,-101
"25047","2390云辰","110/07/15","華南永昌-台中",86,35,51
"25048","2390云辰","110/07/15","元富-大裕",4,87,-83
"25049","2390云辰","110/07/15","群益金鼎",51,6,45
"25050","2390云辰","110/07/15","凱基-和平",17,96,-79
"25051","2363矽統","110/07/14","台灣摩根士丹利",463,0,463
"25052","2363矽統","110/07/14","新加坡商瑞銀",568,1321,-753
"25053","2363矽統","110/07/14","台新證券",750,342,408
"25054","2363矽統","110/07/14","瑞士信貸",149,864,-715
"25055","2363矽統","110/07/14","玉山-台中",363,51,312
"25056","2363矽統","110/07/14","台新-屏東",115,380,-265
"25057","2363矽統","110/07/14","元大-斗六",223,25,198
"25058","2363矽統","110/07/14","永豐金證券",16,265,-249
"25059","2363矽統","110/07/14","華南永昌-朴子",208,38,170
"25060","2363矽統","110/07/14","美林",462,701,-239
"25061","2363矽統","110/07/14","元富-西松",169,12,157
"25062","2363矽統","110/07/14","宏遠-桃園",269,500,-231
"25063","2363矽統","110/07/14","永豐金-大園",146,6,140
"25064","2363矽統","110/07/14","凱基-竹北",36,254,-218
"25065","2363矽統","110/07/14","土銀-和平",134,0,134
"25066","2363矽統","110/07/14","港商法國興業",0,214,-214
"25067","2363矽統","110/07/14","富邦-新營",130,13,117
"25068","2363矽統","110/07/14","港商野村",835,1044,-209
"25069","2363矽統","110/07/14","元富-成功",118,11,107
"25070","2363矽統","110/07/14","北城證券",212,411,-199
"25071","2363矽統","110/07/14","元富-烏日",121,18,103
"25072","2363矽統","110/07/14","(牛牛牛)亞-鑫豐",51,241,-190
"25073","2363矽統","110/07/14","日盛-二林",120,18,102
"25074","2363矽統","110/07/14","國票-博愛",24,213,-189
"25075","2363矽統","110/07/14","兆豐-忠孝",98,2,96
"25076","2363矽統","110/07/14","大慶-蘆洲",134,316,-182
"25077","2363矽統","110/07/14","大慶-楊梅",92,3,89
"25078","2363矽統","110/07/14","彰銀-台中",15,193,-178
"25079","2363矽統","110/07/14","元富-三重",120,33,87
"25080","2363矽統","110/07/14","日盛-和美",18,185,-167
"25081","8112至上","110/07/14","新加坡商瑞銀",223,17,206
"25082","8112至上","110/07/14","瑞士信貸",8,170,-162
"25083","8112至上","110/07/14","摩根大通",285,129,156
"25084","8112至上","110/07/14","美林",55,202,-147
"25085","8112至上","110/07/14","花旗環球",124,0,124
"25086","8112至上","110/07/14","凱基-台北",325,436,-111
"25087","8112至上","110/07/14","兆豐-公益",117,4,113
"25088","8112至上","110/07/14","台中銀-台北",0,98,-98
"25089","8112至上","110/07/14","香港上海匯豐",111,0,111
"25090","8112至上","110/07/14","玉山-台大",17,107,-90
"25091","8112至上","110/07/14","永豐金-內湖",117,21,96
"25092","8112至上","110/07/14","康和-內湖",1,90,-89
"25093","8112至上","110/07/14","台灣摩根士丹利",108,16,92
"25094","8112至上","110/07/14","港商野村",21,84,-63
"25095","8112至上","110/07/14","元大-東蘆",77,0,77
"25096","8112至上","110/07/14","兆豐-北高雄",1,60,-59
"25097","8112至上","110/07/14","新光",108,48,60
"25098","8112至上","110/07/14","群益金鼎-海山",1,52,-51
"25099","8112至上","110/07/14","大慶-蘆洲",59,0,59
"25100","8112至上","110/07/14","群益金鼎-大安",0,50,-50
"25101","8112至上","110/07/14","華南永昌-台中",56,3,53
"25102","8112至上","110/07/14","富邦-仁愛",2,49,-47
"25103","8112至上","110/07/14","土銀-嘉義",52,2,50
"25104","8112至上","110/07/14","元大-金華",0,42,-42
"25105","8112至上","110/07/14","美商高盛",40,0,40
"25106","8112至上","110/07/14","元大-內湖",4,43,-39
"25107","8112至上","110/07/14","臺銀",63,29,34
"25108","8112至上","110/07/14","第一金-華江",2,37,-35
"25109","8112至上","110/07/14","元富-嘉義",31,0,31
"25110","8112至上","110/07/14","永豐金-苓雅",2,34,-32
"25111","1570力肯","110/07/14","國票-北高雄",68,0,68
"25112","1570力肯","110/07/14","摩根大通",0,21,-21
"25113","1570力肯","110/07/14","日盛-八德",30,1,29
"25114","1570力肯","110/07/14","新光",1,19,-18
"25115","1570力肯","110/07/14","玉山-高雄",7,0,7
"25116","1570力肯","110/07/14","(牛牛牛)亞-鑫豐",0,17,-17
"25117","1570力肯","110/07/14","臺銀-臺南",5,0,5
"25118","1570力肯","110/07/14","日盛-士林",0,10,-10
"25119","1570力肯","110/07/14","凱基-三峽",5,0,5
"25120","1570力肯","110/07/14","統一-員林",0,10,-10
"25121","1570力肯","110/07/14","元大-和平",5,0,5
"25122","1570力肯","110/07/14","國票-新莊",0,10,-10
"25123","1570力肯","110/07/14","合庫-三重",4,0,4
"25124","1570力肯","110/07/14","凱基-高美館",0,10,-10
"25125","1570力肯","110/07/14","瑞士信貸",4,0,4
"25126","1570力肯","110/07/14","元大-屏東民生",0,5,-5
"25127","1570力肯","110/07/14","統一-三多",4,0,4
"25128","1570力肯","110/07/14","元大-古亭",0,5,-5
"25129","1570力肯","110/07/14","華南永昌-古亭",4,0,4
"25130","1570力肯","110/07/14","日盛-木柵",0,4,-4
"25131","1570力肯","110/07/14","元大-高雄",3,0,3
"25132","1570力肯","110/07/14","大昌",0,4,-4
"25133","1570力肯","110/07/14","兆豐-忠孝",2,0,2
"25134","1570力肯","110/07/14","群益金鼎-東大",0,4,-4
"25135","1570力肯","110/07/14","富邦-陽明",2,0,2
"25136","1570力肯","110/07/14","凱基-台北",0,4,-4
"25137","1570力肯","110/07/14","元大-松山",2,0,2
"25138","1570力肯","110/07/14","元大-板橋",0,4,-4
"25139","1570力肯","110/07/14","元大-忠孝",2,0,2
"25140","1570力肯","110/07/14","第一金-中山",0,3,-3
"25141","2929淘帝","110/07/14","華南永昌-林口",60,0,60
"25142","2929淘帝","110/07/14","群益金鼎",25,540,-515
"25143","2929淘帝","110/07/14","美林",87,31,56
"25144","2929淘帝","110/07/14","國泰-台南",1,30,-29
"25145","2929淘帝","110/07/14","元富-台南",40,0,40
"25146","2929淘帝","110/07/14","宏遠-桃園",0,20,-20
"25147","2929淘帝","110/07/14","元大-民生",39,0,39
"25148","2929淘帝","110/07/14","摩根大通",11,31,-20
"25149","2929淘帝","110/07/14","臺銀-鳳山",34,0,34
"25150","2929淘帝","110/07/14","台新-建北",5,20,-15
"25151","2929淘帝","110/07/14","合庫-高雄",34,1,33
"25152","2929淘帝","110/07/14","新光",1,16,-15
"25153","2929淘帝","110/07/14","華南永昌-鶯歌",28,0,28
"25154","2929淘帝","110/07/14","玉山-板橋",0,15,-15
"25155","2929淘帝","110/07/14","永興",25,0,25
"25156","2929淘帝","110/07/14","凱基-羅東",0,15,-15
"25157","2929淘帝","110/07/14","元大-新盛",25,1,24
"25158","2929淘帝","110/07/14","元大-頭份",0,15,-15
"25159","2929淘帝","110/07/14","日盛-南京",23,0,23
"25160","2929淘帝","110/07/14","第一金-台南",0,13,-13
"25161","2929淘帝","110/07/14","日茂",20,0,20
"25162","2929淘帝","110/07/14","富邦-基隆",0,12,-12
"25163","2929淘帝","110/07/14","台新-台中",20,0,20
"25164","2929淘帝","110/07/14","日茂-南投",1,12,-11
"25165","2929淘帝","110/07/14","華南永昌",20,0,20
"25166","2929淘帝","110/07/14","元大-豐原站前",0,11,-11
"25167","2929淘帝","110/07/14","福勝",15,0,15
"25168","2929淘帝","110/07/14","玉山-士林",0,10,-10
"25169","2929淘帝","110/07/14","富邦-南屯",15,0,15
"25170","2929淘帝","110/07/14","富邦-台北",0,10,-10
"25171","5410國眾","110/07/14","兆豐-城中",35,0,35
"25172","5410國眾","110/07/14","瑞士信貸",0,29,-29
"25173","5410國眾","110/07/14","新光",21,1,20
"25174","5410國眾","110/07/14","國泰-板橋",1,30,-29
"25175","5410國眾","110/07/14","國泰-敦南",21,1,20
"25176","5410國眾","110/07/14","日盛-高雄",0,20,-20
"25177","5410國眾","110/07/14","國泰-台中",20,1,19
"25178","5410國眾","110/07/14","台新-左楠",1,20,-19
"25179","5410國眾","110/07/14","元大-崇德",19,0,19
"25180","5410國眾","110/07/14","元富-大昌",1,18,-17
"25181","5410國眾","110/07/14","土銀-士林",18,0,18
"25182","5410國眾","110/07/14","富邦-建國",0,15,-15
"25183","5410國眾","110/07/14","元大-新盛",20,2,18
"25184","5410國眾","110/07/14","元富-嘉義",0,12,-12
"25185","5410國眾","110/07/14","兆豐-高雄",15,0,15
"25186","5410國眾","110/07/14","永全-南崁",0,12,-12
"25187","5410國眾","110/07/14","宏遠-中和",10,0,10
"25188","5410國眾","110/07/14","元大-員林",0,11,-11
"25189","5410國眾","110/07/14","新光-桃園",10,0,10
"25190","5410國眾","110/07/14","高橋",0,10,-10
"25191","5410國眾","110/07/14","國泰-台南",10,0,10
"25192","5410國眾","110/07/14","永興",0,10,-10
"25193","5410國眾","110/07/14","元大-復北",10,0,10
"25194","5410國眾","110/07/14","華南永昌-三重",0,10,-10
"25195","5410國眾","110/07/14","元大-竹科",8,0,8
"25196","5410國眾","110/07/14","元大-苑裡",0,7,-7
"25197","5410國眾","110/07/14","台新-新營",6,0,6
"25198","5410國眾","110/07/14","港商野村",0,6,-6
"25199","5410國眾","110/07/14","日盛-士林",5,0,5
"25200","5410國眾","110/07/14","摩根大通",5,11,-6
"25201","2841台開","110/07/14","凱基-文心",73,0,73
"25202","2841台開","110/07/14","國泰-敦南",0,50,-50
"25203","2841台開","110/07/14","元富-潮州",30,0,30
"25204","2841台開","110/07/14","凱基-中壢",0,40,-40
"25205","2841台開","110/07/14","第一金-台中",20,0,20
"25206","2841台開","110/07/14","統一-新竹",0,24,-24
"25207","2841台開","110/07/14","華南永昌-新莊",20,0,20
"25208","2841台開","110/07/14","元富-草屯",0,20,-20
"25209","2841台開","110/07/14","永豐金-豐原",20,0,20
"25210","2841台開","110/07/14","台新-台南",0,20,-20
"25211","2841台開","110/07/14","國泰-館前",15,0,15
"25212","2841台開","110/07/14","永豐金-敦南",45,63,-18
"25213","2841台開","110/07/14","群益金鼎-基隆",12,0,12
"25214","2841台開","110/07/14","國票-北高雄",0,13,-13
"25215","2841台開","110/07/14","日盛-信義",10,0,10
"25216","2841台開","110/07/14","凱基-松山",0,10,-10
"25217","2841台開","110/07/14","台新-台中",10,0,10
"25218","2841台開","110/07/14","元大證券",0,10,-10
"25219","2841台開","110/07/14","新光",10,1,9
"25220","2841台開","110/07/14","元大-中壢",0,10,-10
"25221","2841台開","110/07/14","凱基-新店",8,0,8
"25222","2841台開","110/07/14","富邦-陽明",1,10,-9
"25223","2841台開","110/07/14","元大-斗信",7,0,7
"25224","2841台開","110/07/14","富邦-建國",0,9,-9
"25225","2841台開","110/07/14","元大-三重",6,0,6
"25226","2841台開","110/07/14","富邦-台南",0,8,-8
"25227","2841台開","110/07/14","永豐金-中和",6,0,6
"25228","2841台開","110/07/14","康和-澎湖",0,7,-7
"25229","2841台開","110/07/14","元富-成功",5,0,5
"25230","2841台開","110/07/14","日盛-斗六",0,6,-6
"25231","6207雷科","110/07/14","群益金鼎-台北",60,0,60
"25232","6207雷科","110/07/14","新加坡商瑞銀",10,56,-46
"25233","6207雷科","110/07/14","台新-高雄",43,3,40
"25234","6207雷科","110/07/14","國票-中和",0,41,-41
"25235","6207雷科","110/07/14","元大-高雄",19,0,19
"25236","6207雷科","110/07/14","元大-復北",0,33,-33
"25237","6207雷科","110/07/14","福勝",15,0,15
"25238","6207雷科","110/07/14","光和-和美",0,20,-20
"25239","6207雷科","110/07/14","群益金鼎-中山",15,0,15
"25240","6207雷科","110/07/14","群益金鼎-丹鳳",0,20,-20
"25241","6207雷科","110/07/14","元大-林園",15,0,15
"25242","6207雷科","110/07/14","第一金-路竹",0,10,-10
"25243","6207雷科","110/07/14","新光",12,0,12
"25244","6207雷科","110/07/14","元大-歸仁",0,10,-10
"25245","6207雷科","110/07/14","元大-大天母",10,0,10
"25246","6207雷科","110/07/14","宏遠-館前",0,9,-9
"25247","6207雷科","110/07/14","永豐金-忠孝",9,0,9
"25248","6207雷科","110/07/14","凱基-台北",12,20,-8
"25249","6207雷科","110/07/14","永豐金-新店",7,0,7
"25250","6207雷科","110/07/14","美林",0,7,-7
"25251","6207雷科","110/07/14","玉山-嘉義",6,0,6
"25252","6207雷科","110/07/14","摩根大通",16,23,-7
"25253","6207雷科","110/07/14","元大-屏東",6,0,6
"25254","6207雷科","110/07/14","凱基-高雄",1,7,-6
"25255","6207雷科","110/07/14","凱基-大安",5,0,5
"25256","6207雷科","110/07/14","台中銀-豐原",0,5,-5
"25257","6207雷科","110/07/14","富邦-台南",5,0,5
"25258","6207雷科","110/07/14","元大-新竹經國",0,5,-5
"25259","6207雷科","110/07/14","元大-成功",5,0,5
"25260","6207雷科","110/07/14","光和-田中",0,4,-4
"25261","3679新至陞","110/07/14","凱基-台北",31,6,25
"25262","3679新至陞","110/07/14","群益金鼎-東大",0,15,-15
"25263","3679新至陞","110/07/14","華南永昌-新莊",10,0,10
"25264","3679新至陞","110/07/14","瑞士信貸",0,12,-12
"25265","3679新至陞","110/07/14","新加坡商瑞銀",11,3,8
"25266","3679新至陞","110/07/14","群益金鼎-永和",0,10,-10
"25267","3679新至陞","110/07/14","美商高盛",6,0,6
"25268","3679新至陞","110/07/14","元大-成功",5,15,-10
"25269","3679新至陞","110/07/14","第一金-中壢",6,0,6
"25270","3679新至陞","110/07/14","統一-板橋",1,10,-9
"25271","3679新至陞","110/07/14","(牛牛牛)亞-網路",4,0,4
"25272","3679新至陞","110/07/14","玉山-左營",0,5,-5
"25273","3679新至陞","110/07/14","元大-六合",3,0,3
"25274","3679新至陞","110/07/14","群益金鼎-三民",0,4,-4
"25275","3679新至陞","110/07/14","合庫-自強",2,0,2
"25276","3679新至陞","110/07/14","富邦-宜蘭",0,4,-4
"25277","3679新至陞","110/07/14","高橋-內壢",2,0,2
"25278","3679新至陞","110/07/14","永豐金-苓雅",0,3,-3
"25279","3679新至陞","110/07/14","台中銀-員林",2,0,2
"25280","3679新至陞","110/07/14","摩根大通",5,7,-2
"25281","3679新至陞","110/07/14","凱基-高美館",2,0,2
"25282","3679新至陞","110/07/14","元大-板橋三民",0,2,-2
"25283","3679新至陞","110/07/14","元大-福營",2,0,2
"25284","3679新至陞","110/07/14","宏遠-中和",0,1,-1
"25285","3679新至陞","110/07/14","永豐金-松山",2,0,2
"25286","3679新至陞","110/07/14","元富-佳里",0,1,-1
"25287","3679新至陞","110/07/14","永豐金-萬盛",2,0,2
"25288","3679新至陞","110/07/14","(牛牛牛)亞-鑫豐",0,1,-1
"25289","3679新至陞","110/07/14","元富-松德",1,0,1
"25290","3679新至陞","110/07/14","中國信託-中壢",0,1,-1
"25291","2727王品","110/07/14","富邦-左營",102,1,101
"25292","2727王品","110/07/14","統一-城中",100,234,-134
"25293","2727王品","110/07/14","國泰-板橋",105,11,94
"25294","2727王品","110/07/14","富邦-台北",1,125,-124
"25295","2727王品","110/07/14","港商野村",149,72,77
"25296","2727王品","110/07/14","台灣摩根士丹利",1,48,-47
"25297","2727王品","110/07/14","合庫-台中",66,2,64
"25298","2727王品","110/07/14","國票-新莊",0,40,-40
"25299","2727王品","110/07/14","臺銀-金山",63,8,55
"25300","2727王品","110/07/14","永豐金-忠孝",2,39,-37
"25301","2727王品","110/07/14","摩根大通",83,39,44
"25302","2727王品","110/07/14","富邦-彰化",1,34,-33
"25303","2727王品","110/07/14","凱基-台北",84,42,42
"25304","2727王品","110/07/14","康和-高雄",0,30,-30
"25305","2727王品","110/07/14","土銀-台中",35,1,34
"25306","2727王品","110/07/14","安泰",0,26,-26
"25307","2727王品","110/07/14","華南永昌-麻豆",32,1,31
"25308","2727王品","110/07/14","富邦-新竹華信",0,21,-21
"25309","2727王品","110/07/14","元大證券",85,55,30
"25310","2727王品","110/07/14","元大-南崁",1,22,-21
"25311","2727王品","110/07/14","新加坡商瑞銀",40,15,25
"25312","2727王品","110/07/14","彰銀-台中",0,18,-18
"25313","2727王品","110/07/14","日盛-八德",19,0,19
"25314","2727王品","110/07/14","元富-同大",2,20,-18
"25315","2727王品","110/07/14","統一",35,17,18
"25316","2727王品","110/07/14","玉山-嘉義",1,17,-16
"25317","2727王品","110/07/14","元富-大昌",18,1,17
"25318","2727王品","110/07/14","國泰-館前",4,20,-16
"25319","2727王品","110/07/14","玉山-板橋",15,1,14
"25320","2727王品","110/07/14","第一金-嘉義",1,13,-12
"25321","1570力肯","110/07/14","國票-北高雄",68,0,68
"25322","1570力肯","110/07/14","摩根大通",0,21,-21
"25323","1570力肯","110/07/14","日盛-八德",30,1,29
"25324","1570力肯","110/07/14","新光",1,19,-18
"25325","1570力肯","110/07/14","玉山-高雄",7,0,7
"25326","1570力肯","110/07/14","(牛牛牛)亞-鑫豐",0,17,-17
"25327","1570力肯","110/07/14","臺銀-臺南",5,0,5
"25328","1570力肯","110/07/14","日盛-士林",0,10,-10
"25329","1570力肯","110/07/14","凱基-三峽",5,0,5
"25330","1570力肯","110/07/14","統一-員林",0,10,-10
"25331","1570力肯","110/07/14","元大-和平",5,0,5
"25332","1570力肯","110/07/14","國票-新莊",0,10,-10
"25333","1570力肯","110/07/14","合庫-三重",4,0,4
"25334","1570力肯","110/07/14","凱基-高美館",0,10,-10
"25335","1570力肯","110/07/14","瑞士信貸",4,0,4
"25336","1570力肯","110/07/14","元大-屏東民生",0,5,-5
"25337","1570力肯","110/07/14","統一-三多",4,0,4
"25338","1570力肯","110/07/14","元大-古亭",0,5,-5
"25339","1570力肯","110/07/14","華南永昌-古亭",4,0,4
"25340","1570力肯","110/07/14","日盛-木柵",0,4,-4
"25341","1570力肯","110/07/14","元大-高雄",3,0,3
"25342","1570力肯","110/07/14","大昌",0,4,-4
"25343","1570力肯","110/07/14","兆豐-忠孝",2,0,2
"25344","1570力肯","110/07/14","群益金鼎-東大",0,4,-4
"25345","1570力肯","110/07/14","富邦-陽明",2,0,2
"25346","1570力肯","110/07/14","凱基-台北",0,4,-4
"25347","1570力肯","110/07/14","元大-松山",2,0,2
"25348","1570力肯","110/07/14","元大-板橋",0,4,-4
"25349","1570力肯","110/07/14","元大-忠孝",2,0,2
"25350","1570力肯","110/07/14","第一金-中山",0,3,-3
"25351","6180橘子","110/07/14","新加坡商瑞銀",84,28,56
"25352","6180橘子","110/07/14","凱基-台北",4,37,-33
"25353","6180橘子","110/07/14","日盛-信義",29,1,28
"25354","6180橘子","110/07/14","玉山-台南",1,22,-21
"25355","6180橘子","110/07/14","豐農",28,4,24
"25356","6180橘子","110/07/14","日盛-新竹",1,21,-20
"25357","6180橘子","110/07/14","新光-新竹",24,1,23
"25358","6180橘子","110/07/14","元富-潮州",0,19,-19
"25359","6180橘子","110/07/14","華南永昌-高雄",20,0,20
"25360","6180橘子","110/07/14","元大-信義",0,17,-17
"25361","6180橘子","110/07/14","元大-羅東",20,0,20
"25362","6180橘子","110/07/14","台灣企銀-台中",1,16,-15
"25363","6180橘子","110/07/14","元大-台中中港",20,0,20
"25364","6180橘子","110/07/14","元大-北港",0,15,-15
"25365","6180橘子","110/07/14","富邦-嘉義",24,5,19
"25366","6180橘子","110/07/14","富邦-高雄",0,14,-14
"25367","6180橘子","110/07/14","富邦-仁愛",15,0,15
"25368","6180橘子","110/07/14","兆豐-埔墘",0,13,-13
"25369","6180橘子","110/07/14","國票-九鼎",13,0,13
"25370","6180橘子","110/07/14","第一金-中山",0,10,-10
"25371","6180橘子","110/07/14","日盛-木柵",12,0,12
"25372","6180橘子","110/07/14","元大-彰化民生",0,10,-10
"25373","6180橘子","110/07/14","元大-成功",10,0,10
"25374","6180橘子","110/07/14","福勝",1,10,-9
"25375","6180橘子","110/07/14","港商野村",10,2,8
"25376","6180橘子","110/07/14","群益金鼎-丹鳳",1,10,-9
"25377","6180橘子","110/07/14","玉山-左營",8,0,8
"25378","6180橘子","110/07/14","群益金鼎-板橋",0,8,-8
"25379","6180橘子","110/07/14","富邦-陽明",16,8,8
"25380","6180橘子","110/07/14","合庫-鳳山",0,7,-7
"25381","2390云辰","110/07/14","摩根大通",995,198,797
"25382","2390云辰","110/07/14","新加坡商瑞銀",28,399,-371
"25383","2390云辰","110/07/14","美林",383,22,361
"25384","2390云辰","110/07/14","凱基-新豐",3,198,-195
"25385","2390云辰","110/07/14","台灣摩根士丹利",684,358,326
"25386","2390云辰","110/07/14","元大-士林",1,152,-151
"25387","2390云辰","110/07/14","凱基-台北",656,402,254
"25388","2390云辰","110/07/14","元大-竹山",80,181,-101
"25389","2390云辰","110/07/14","日盛-和美",110,5,105
"25390","2390云辰","110/07/14","群益金鼎-開元",19,95,-76
"25391","2390云辰","110/07/14","元大-天母",72,0,72
"25392","2390云辰","110/07/14","新光",77,150,-73
"25393","2390云辰","110/07/14","永豐金-松山",57,0,57
"25394","2390云辰","110/07/14","元富-高雄",0,71,-71
"25395","2390云辰","110/07/14","統一-屏東",53,0,53
"25396","2390云辰","110/07/14","元大-土城學府",130,201,-71
"25397","2390云辰","110/07/14","港商野村",486,450,36
"25398","2390云辰","110/07/14","元大-善化",12,76,-64
"25399","2390云辰","110/07/14","致和-崇德",30,0,30
"25400","2390云辰","110/07/14","華南永昌-岡山",23,81,-58
"25401","2390云辰","110/07/14","富邦-台北",40,14,26
"25402","2390云辰","110/07/14","群益金鼎-大興",82,125,-43
"25403","2390云辰","110/07/14","台新-高雄",38,13,25
"25404","2390云辰","110/07/14","大慶-中壢",0,41,-41
"25405","2390云辰","110/07/14","富邦-板橋",32,7,25
"25406","2390云辰","110/07/14","玉山-板橋",6,47,-41
"25407","2390云辰","110/07/14","陽信-石牌",24,0,24
"25408","2390云辰","110/07/14","富邦-台東",2,42,-40
"25409","2390云辰","110/07/14","凱基-屏東",32,8,24
"25410","2390云辰","110/07/14","元大-新營",3,42,-39
"25411","2363矽統","110/07/14","台灣摩根士丹利",463,0,463
"25412","2363矽統","110/07/14","新加坡商瑞銀",568,1321,-753
"25413","2363矽統","110/07/14","台新證券",750,342,408
"25414","2363矽統","110/07/14","瑞士信貸",149,864,-715
"25415","2363矽統","110/07/14","玉山-台中",363,51,312
"25416","2363矽統","110/07/14","台新-屏東",115,380,-265
"25417","2363矽統","110/07/14","元大-斗六",223,25,198
"25418","2363矽統","110/07/14","永豐金證券",16,265,-249
"25419","2363矽統","110/07/14","華南永昌-朴子",208,38,170
"25420","2363矽統","110/07/14","美林",462,701,-239
"25421","2363矽統","110/07/14","元富-西松",169,12,157
"25422","2363矽統","110/07/14","宏遠-桃園",269,500,-231
"25423","2363矽統","110/07/14","永豐金-大園",146,6,140
"25424","2363矽統","110/07/14","凱基-竹北",36,254,-218
"25425","2363矽統","110/07/14","土銀-和平",134,0,134
"25426","2363矽統","110/07/14","港商法國興業",0,214,-214
"25427","2363矽統","110/07/14","富邦-新營",130,13,117
"25428","2363矽統","110/07/14","港商野村",835,1044,-209
"25429","2363矽統","110/07/14","元富-成功",118,11,107
"25430","2363矽統","110/07/14","北城證券",212,411,-199
"25431","2363矽統","110/07/14","元富-烏日",121,18,103
"25432","2363矽統","110/07/14","(牛牛牛)亞-鑫豐",51,241,-190
"25433","2363矽統","110/07/14","日盛-二林",120,18,102
"25434","2363矽統","110/07/14","國票-博愛",24,213,-189
"25435","2363矽統","110/07/14","兆豐-忠孝",98,2,96
"25436","2363矽統","110/07/14","大慶-蘆洲",134,316,-182
"25437","2363矽統","110/07/14","大慶-楊梅",92,3,89
"25438","2363矽統","110/07/14","彰銀-台中",15,193,-178
"25439","2363矽統","110/07/14","元富-三重",120,33,87
"25440","2363矽統","110/07/14","日盛-和美",18,185,-167
"25441","8112至上","110/07/14","新加坡商瑞銀",223,17,206
"25442","8112至上","110/07/14","瑞士信貸",8,170,-162
"25443","8112至上","110/07/14","摩根大通",285,129,156
"25444","8112至上","110/07/14","美林",55,202,-147
"25445","8112至上","110/07/14","花旗環球",124,0,124
"25446","8112至上","110/07/14","凱基-台北",325,436,-111
"25447","8112至上","110/07/14","兆豐-公益",117,4,113
"25448","8112至上","110/07/14","台中銀-台北",0,98,-98
"25449","8112至上","110/07/14","香港上海匯豐",111,0,111
"25450","8112至上","110/07/14","玉山-台大",17,107,-90
"25451","8112至上","110/07/14","永豐金-內湖",117,21,96
"25452","8112至上","110/07/14","康和-內湖",1,90,-89
"25453","8112至上","110/07/14","台灣摩根士丹利",108,16,92
"25454","8112至上","110/07/14","港商野村",21,84,-63
"25455","8112至上","110/07/14","元大-東蘆",77,0,77
"25456","8112至上","110/07/14","兆豐-北高雄",1,60,-59
"25457","8112至上","110/07/14","新光",108,48,60
"25458","8112至上","110/07/14","群益金鼎-海山",1,52,-51
"25459","8112至上","110/07/14","大慶-蘆洲",59,0,59
"25460","8112至上","110/07/14","群益金鼎-大安",0,50,-50
"25461","8112至上","110/07/14","華南永昌-台中",56,3,53
"25462","8112至上","110/07/14","富邦-仁愛",2,49,-47
"25463","8112至上","110/07/14","土銀-嘉義",52,2,50
"25464","8112至上","110/07/14","元大-金華",0,42,-42
"25465","8112至上","110/07/14","美商高盛",40,0,40
"25466","8112至上","110/07/14","元大-內湖",4,43,-39
"25467","8112至上","110/07/14","臺銀",63,29,34
"25468","8112至上","110/07/14","第一金-華江",2,37,-35
"25469","8112至上","110/07/14","元富-嘉義",31,0,31
"25470","8112至上","110/07/14","永豐金-苓雅",2,34,-32
"25471","1570力肯","110/07/14","國票-北高雄",68,0,68
"25472","1570力肯","110/07/14","摩根大通",0,21,-21
"25473","1570力肯","110/07/14","日盛-八德",30,1,29
"25474","1570力肯","110/07/14","新光",1,19,-18
"25475","1570力肯","110/07/14","玉山-高雄",7,0,7
"25476","1570力肯","110/07/14","(牛牛牛)亞-鑫豐",0,17,-17
"25477","1570力肯","110/07/14","臺銀-臺南",5,0,5
"25478","1570力肯","110/07/14","日盛-士林",0,10,-10
"25479","1570力肯","110/07/14","凱基-三峽",5,0,5
"25480","1570力肯","110/07/14","統一-員林",0,10,-10
"25481","1570力肯","110/07/14","元大-和平",5,0,5
"25482","1570力肯","110/07/14","國票-新莊",0,10,-10
"25483","1570力肯","110/07/14","合庫-三重",4,0,4
"25484","1570力肯","110/07/14","凱基-高美館",0,10,-10
"25485","1570力肯","110/07/14","瑞士信貸",4,0,4
"25486","1570力肯","110/07/14","元大-屏東民生",0,5,-5
"25487","1570力肯","110/07/14","統一-三多",4,0,4
"25488","1570力肯","110/07/14","元大-古亭",0,5,-5
"25489","1570力肯","110/07/14","華南永昌-古亭",4,0,4
"25490","1570力肯","110/07/14","日盛-木柵",0,4,-4
"25491","1570力肯","110/07/14","元大-高雄",3,0,3
"25492","1570力肯","110/07/14","大昌",0,4,-4
"25493","1570力肯","110/07/14","兆豐-忠孝",2,0,2
"25494","1570力肯","110/07/14","群益金鼎-東大",0,4,-4
"25495","1570力肯","110/07/14","富邦-陽明",2,0,2
"25496","1570力肯","110/07/14","凱基-台北",0,4,-4
"25497","1570力肯","110/07/14","元大-松山",2,0,2
"25498","1570力肯","110/07/14","元大-板橋",0,4,-4
"25499","1570力肯","110/07/14","元大-忠孝",2,0,2
"25500","1570力肯","110/07/14","第一金-中山",0,3,-3
"25501","2929淘帝","110/07/14","華南永昌-林口",60,0,60
"25502","2929淘帝","110/07/14","群益金鼎",25,540,-515
"25503","2929淘帝","110/07/14","美林",87,31,56
"25504","2929淘帝","110/07/14","國泰-台南",1,30,-29
"25505","2929淘帝","110/07/14","元富-台南",40,0,40
"25506","2929淘帝","110/07/14","宏遠-桃園",0,20,-20
"25507","2929淘帝","110/07/14","元大-民生",39,0,39
"25508","2929淘帝","110/07/14","摩根大通",11,31,-20
"25509","2929淘帝","110/07/14","臺銀-鳳山",34,0,34
"25510","2929淘帝","110/07/14","台新-建北",5,20,-15
"25511","2929淘帝","110/07/14","合庫-高雄",34,1,33
"25512","2929淘帝","110/07/14","新光",1,16,-15
"25513","2929淘帝","110/07/14","華南永昌-鶯歌",28,0,28
"25514","2929淘帝","110/07/14","玉山-板橋",0,15,-15
"25515","2929淘帝","110/07/14","永興",25,0,25
"25516","2929淘帝","110/07/14","凱基-羅東",0,15,-15
"25517","2929淘帝","110/07/14","元大-新盛",25,1,24
"25518","2929淘帝","110/07/14","元大-頭份",0,15,-15
"25519","2929淘帝","110/07/14","日盛-南京",23,0,23
"25520","2929淘帝","110/07/14","第一金-台南",0,13,-13
"25521","2929淘帝","110/07/14","日茂",20,0,20
"25522","2929淘帝","110/07/14","富邦-基隆",0,12,-12
"25523","2929淘帝","110/07/14","台新-台中",20,0,20
"25524","2929淘帝","110/07/14","日茂-南投",1,12,-11
"25525","2929淘帝","110/07/14","華南永昌",20,0,20
"25526","2929淘帝","110/07/14","元大-豐原站前",0,11,-11
"25527","2929淘帝","110/07/14","福勝",15,0,15
"25528","2929淘帝","110/07/14","玉山-士林",0,10,-10
"25529","2929淘帝","110/07/14","富邦-南屯",15,0,15
"25530","2929淘帝","110/07/14","富邦-台北",0,10,-10
"25531","5410國眾","110/07/14","兆豐-城中",35,0,35
"25532","5410國眾","110/07/14","瑞士信貸",0,29,-29
"25533","5410國眾","110/07/14","新光",21,1,20
"25534","5410國眾","110/07/14","國泰-板橋",1,30,-29
"25535","5410國眾","110/07/14","國泰-敦南",21,1,20
"25536","5410國眾","110/07/14","日盛-高雄",0,20,-20
"25537","5410國眾","110/07/14","國泰-台中",20,1,19
"25538","5410國眾","110/07/14","台新-左楠",1,20,-19
"25539","5410國眾","110/07/14","元大-崇德",19,0,19
"25540","5410國眾","110/07/14","元富-大昌",1,18,-17
"25541","5410國眾","110/07/14","土銀-士林",18,0,18
"25542","5410國眾","110/07/14","富邦-建國",0,15,-15
"25543","5410國眾","110/07/14","元大-新盛",20,2,18
"25544","5410國眾","110/07/14","元富-嘉義",0,12,-12
"25545","5410國眾","110/07/14","兆豐-高雄",15,0,15
"25546","5410國眾","110/07/14","永全-南崁",0,12,-12
"25547","5410國眾","110/07/14","宏遠-中和",10,0,10
"25548","5410國眾","110/07/14","元大-員林",0,11,-11
"25549","5410國眾","110/07/14","新光-桃園",10,0,10
"25550","5410國眾","110/07/14","高橋",0,10,-10
"25551","5410國眾","110/07/14","國泰-台南",10,0,10
"25552","5410國眾","110/07/14","永興",0,10,-10
"25553","5410國眾","110/07/14","元大-復北",10,0,10
"25554","5410國眾","110/07/14","華南永昌-三重",0,10,-10
"25555","5410國眾","110/07/14","元大-竹科",8,0,8
"25556","5410國眾","110/07/14","元大-苑裡",0,7,-7
"25557","5410國眾","110/07/14","台新-新營",6,0,6
"25558","5410國眾","110/07/14","港商野村",0,6,-6
"25559","5410國眾","110/07/14","日盛-士林",5,0,5
"25560","5410國眾","110/07/14","摩根大通",5,11,-6
"25561","2841台開","110/07/14","凱基-文心",73,0,73
"25562","2841台開","110/07/14","國泰-敦南",0,50,-50
"25563","2841台開","110/07/14","元富-潮州",30,0,30
"25564","2841台開","110/07/14","凱基-中壢",0,40,-40
"25565","2841台開","110/07/14","第一金-台中",20,0,20
"25566","2841台開","110/07/14","統一-新竹",0,24,-24
"25567","2841台開","110/07/14","華南永昌-新莊",20,0,20
"25568","2841台開","110/07/14","元富-草屯",0,20,-20
"25569","2841台開","110/07/14","永豐金-豐原",20,0,20
"25570","2841台開","110/07/14","台新-台南",0,20,-20
"25571","2841台開","110/07/14","國泰-館前",15,0,15
"25572","2841台開","110/07/14","永豐金-敦南",45,63,-18
"25573","2841台開","110/07/14","群益金鼎-基隆",12,0,12
"25574","2841台開","110/07/14","國票-北高雄",0,13,-13
"25575","2841台開","110/07/14","日盛-信義",10,0,10
"25576","2841台開","110/07/14","凱基-松山",0,10,-10
"25577","2841台開","110/07/14","台新-台中",10,0,10
"25578","2841台開","110/07/14","元大證券",0,10,-10
"25579","2841台開","110/07/14","新光",10,1,9
"25580","2841台開","110/07/14","元大-中壢",0,10,-10
"25581","2841台開","110/07/14","凱基-新店",8,0,8
"25582","2841台開","110/07/14","富邦-陽明",1,10,-9
"25583","2841台開","110/07/14","元大-斗信",7,0,7
"25584","2841台開","110/07/14","富邦-建國",0,9,-9
"25585","2841台開","110/07/14","元大-三重",6,0,6
"25586","2841台開","110/07/14","富邦-台南",0,8,-8
"25587","2841台開","110/07/14","永豐金-中和",6,0,6
"25588","2841台開","110/07/14","康和-澎湖",0,7,-7
"25589","2841台開","110/07/14","元富-成功",5,0,5
"25590","2841台開","110/07/14","日盛-斗六",0,6,-6
"25591","6207雷科","110/07/14","群益金鼎-台北",60,0,60
"25592","6207雷科","110/07/14","新加坡商瑞銀",10,56,-46
"25593","6207雷科","110/07/14","台新-高雄",43,3,40
"25594","6207雷科","110/07/14","國票-中和",0,41,-41
"25595","6207雷科","110/07/14","元大-高雄",19,0,19
"25596","6207雷科","110/07/14","元大-復北",0,33,-33
"25597","6207雷科","110/07/14","福勝",15,0,15
"25598","6207雷科","110/07/14","光和-和美",0,20,-20
"25599","6207雷科","110/07/14","群益金鼎-中山",15,0,15
"25600","6207雷科","110/07/14","群益金鼎-丹鳳",0,20,-20
"25601","6207雷科","110/07/14","元大-林園",15,0,15
"25602","6207雷科","110/07/14","第一金-路竹",0,10,-10
"25603","6207雷科","110/07/14","新光",12,0,12
"25604","6207雷科","110/07/14","元大-歸仁",0,10,-10
"25605","6207雷科","110/07/14","元大-大天母",10,0,10
"25606","6207雷科","110/07/14","宏遠-館前",0,9,-9
"25607","6207雷科","110/07/14","永豐金-忠孝",9,0,9
"25608","6207雷科","110/07/14","凱基-台北",12,20,-8
"25609","6207雷科","110/07/14","永豐金-新店",7,0,7
"25610","6207雷科","110/07/14","美林",0,7,-7
"25611","6207雷科","110/07/14","玉山-嘉義",6,0,6
"25612","6207雷科","110/07/14","摩根大通",16,23,-7
"25613","6207雷科","110/07/14","元大-屏東",6,0,6
"25614","6207雷科","110/07/14","凱基-高雄",1,7,-6
"25615","6207雷科","110/07/14","凱基-大安",5,0,5
"25616","6207雷科","110/07/14","台中銀-豐原",0,5,-5
"25617","6207雷科","110/07/14","富邦-台南",5,0,5
"25618","6207雷科","110/07/14","元大-新竹經國",0,5,-5
"25619","6207雷科","110/07/14","元大-成功",5,0,5
"25620","6207雷科","110/07/14","光和-田中",0,4,-4
"25621","3679新至陞","110/07/14","凱基-台北",31,6,25
"25622","3679新至陞","110/07/14","群益金鼎-東大",0,15,-15
"25623","3679新至陞","110/07/14","華南永昌-新莊",10,0,10
"25624","3679新至陞","110/07/14","瑞士信貸",0,12,-12
"25625","3679新至陞","110/07/14","新加坡商瑞銀",11,3,8
"25626","3679新至陞","110/07/14","群益金鼎-永和",0,10,-10
"25627","3679新至陞","110/07/14","美商高盛",6,0,6
"25628","3679新至陞","110/07/14","元大-成功",5,15,-10
"25629","3679新至陞","110/07/14","第一金-中壢",6,0,6
"25630","3679新至陞","110/07/14","統一-板橋",1,10,-9
"25631","3679新至陞","110/07/14","(牛牛牛)亞-網路",4,0,4
"25632","3679新至陞","110/07/14","玉山-左營",0,5,-5
"25633","3679新至陞","110/07/14","元大-六合",3,0,3
"25634","3679新至陞","110/07/14","群益金鼎-三民",0,4,-4
"25635","3679新至陞","110/07/14","合庫-自強",2,0,2
"25636","3679新至陞","110/07/14","富邦-宜蘭",0,4,-4
"25637","3679新至陞","110/07/14","高橋-內壢",2,0,2
"25638","3679新至陞","110/07/14","永豐金-苓雅",0,3,-3
"25639","3679新至陞","110/07/14","台中銀-員林",2,0,2
"25640","3679新至陞","110/07/14","摩根大通",5,7,-2
"25641","3679新至陞","110/07/14","凱基-高美館",2,0,2
"25642","3679新至陞","110/07/14","元大-板橋三民",0,2,-2
"25643","3679新至陞","110/07/14","元大-福營",2,0,2
"25644","3679新至陞","110/07/14","宏遠-中和",0,1,-1
"25645","3679新至陞","110/07/14","永豐金-松山",2,0,2
"25646","3679新至陞","110/07/14","元富-佳里",0,1,-1
"25647","3679新至陞","110/07/14","永豐金-萬盛",2,0,2
"25648","3679新至陞","110/07/14","(牛牛牛)亞-鑫豐",0,1,-1
"25649","3679新至陞","110/07/14","元富-松德",1,0,1
"25650","3679新至陞","110/07/14","中國信託-中壢",0,1,-1
"25651","2727王品","110/07/14","富邦-左營",102,1,101
"25652","2727王品","110/07/14","統一-城中",100,234,-134
"25653","2727王品","110/07/14","國泰-板橋",105,11,94
"25654","2727王品","110/07/14","富邦-台北",1,125,-124
"25655","2727王品","110/07/14","港商野村",149,72,77
"25656","2727王品","110/07/14","台灣摩根士丹利",1,48,-47
"25657","2727王品","110/07/14","合庫-台中",66,2,64
"25658","2727王品","110/07/14","國票-新莊",0,40,-40
"25659","2727王品","110/07/14","臺銀-金山",63,8,55
"25660","2727王品","110/07/14","永豐金-忠孝",2,39,-37
"25661","2727王品","110/07/14","摩根大通",83,39,44
"25662","2727王品","110/07/14","富邦-彰化",1,34,-33
"25663","2727王品","110/07/14","凱基-台北",84,42,42
"25664","2727王品","110/07/14","康和-高雄",0,30,-30
"25665","2727王品","110/07/14","土銀-台中",35,1,34
"25666","2727王品","110/07/14","安泰",0,26,-26
"25667","2727王品","110/07/14","華南永昌-麻豆",32,1,31
"25668","2727王品","110/07/14","富邦-新竹華信",0,21,-21
"25669","2727王品","110/07/14","元大證券",85,55,30
"25670","2727王品","110/07/14","元大-南崁",1,22,-21
"25671","2727王品","110/07/14","新加坡商瑞銀",40,15,25
"25672","2727王品","110/07/14","彰銀-台中",0,18,-18
"25673","2727王品","110/07/14","日盛-八德",19,0,19
"25674","2727王品","110/07/14","元富-同大",2,20,-18
"25675","2727王品","110/07/14","統一",35,17,18
"25676","2727王品","110/07/14","玉山-嘉義",1,17,-16
"25677","2727王品","110/07/14","元富-大昌",18,1,17
"25678","2727王品","110/07/14","國泰-館前",4,20,-16
"25679","2727王品","110/07/14","玉山-板橋",15,1,14
"25680","2727王品","110/07/14","第一金-嘉義",1,13,-12
"25681","1570力肯","110/07/14","國票-北高雄",68,0,68
"25682","1570力肯","110/07/14","摩根大通",0,21,-21
"25683","1570力肯","110/07/14","日盛-八德",30,1,29
"25684","1570力肯","110/07/14","新光",1,19,-18
"25685","1570力肯","110/07/14","玉山-高雄",7,0,7
"25686","1570力肯","110/07/14","(牛牛牛)亞-鑫豐",0,17,-17
"25687","1570力肯","110/07/14","臺銀-臺南",5,0,5
"25688","1570力肯","110/07/14","日盛-士林",0,10,-10
"25689","1570力肯","110/07/14","凱基-三峽",5,0,5
"25690","1570力肯","110/07/14","統一-員林",0,10,-10
"25691","1570力肯","110/07/14","元大-和平",5,0,5
"25692","1570力肯","110/07/14","國票-新莊",0,10,-10
"25693","1570力肯","110/07/14","合庫-三重",4,0,4
"25694","1570力肯","110/07/14","凱基-高美館",0,10,-10
"25695","1570力肯","110/07/14","瑞士信貸",4,0,4
"25696","1570力肯","110/07/14","元大-屏東民生",0,5,-5
"25697","1570力肯","110/07/14","統一-三多",4,0,4
"25698","1570力肯","110/07/14","元大-古亭",0,5,-5
"25699","1570力肯","110/07/14","華南永昌-古亭",4,0,4
"25700","1570力肯","110/07/14","日盛-木柵",0,4,-4
"25701","1570力肯","110/07/14","元大-高雄",3,0,3
"25702","1570力肯","110/07/14","大昌",0,4,-4
"25703","1570力肯","110/07/14","兆豐-忠孝",2,0,2
"25704","1570力肯","110/07/14","群益金鼎-東大",0,4,-4
"25705","1570力肯","110/07/14","富邦-陽明",2,0,2
"25706","1570力肯","110/07/14","凱基-台北",0,4,-4
"25707","1570力肯","110/07/14","元大-松山",2,0,2
"25708","1570力肯","110/07/14","元大-板橋",0,4,-4
"25709","1570力肯","110/07/14","元大-忠孝",2,0,2
"25710","1570力肯","110/07/14","第一金-中山",0,3,-3
"25711","6180橘子","110/07/14","新加坡商瑞銀",84,28,56
"25712","6180橘子","110/07/14","凱基-台北",4,37,-33
"25713","6180橘子","110/07/14","日盛-信義",29,1,28
"25714","6180橘子","110/07/14","玉山-台南",1,22,-21
"25715","6180橘子","110/07/14","豐農",28,4,24
"25716","6180橘子","110/07/14","日盛-新竹",1,21,-20
"25717","6180橘子","110/07/14","新光-新竹",24,1,23
"25718","6180橘子","110/07/14","元富-潮州",0,19,-19
"25719","6180橘子","110/07/14","華南永昌-高雄",20,0,20
"25720","6180橘子","110/07/14","元大-信義",0,17,-17
"25721","6180橘子","110/07/14","元大-羅東",20,0,20
"25722","6180橘子","110/07/14","台灣企銀-台中",1,16,-15
"25723","6180橘子","110/07/14","元大-台中中港",20,0,20
"25724","6180橘子","110/07/14","元大-北港",0,15,-15
"25725","6180橘子","110/07/14","富邦-嘉義",24,5,19
"25726","6180橘子","110/07/14","富邦-高雄",0,14,-14
"25727","6180橘子","110/07/14","富邦-仁愛",15,0,15
"25728","6180橘子","110/07/14","兆豐-埔墘",0,13,-13
"25729","6180橘子","110/07/14","國票-九鼎",13,0,13
"25730","6180橘子","110/07/14","第一金-中山",0,10,-10
"25731","6180橘子","110/07/14","日盛-木柵",12,0,12
"25732","6180橘子","110/07/14","元大-彰化民生",0,10,-10
"25733","6180橘子","110/07/14","元大-成功",10,0,10
"25734","6180橘子","110/07/14","福勝",1,10,-9
"25735","6180橘子","110/07/14","港商野村",10,2,8
"25736","6180橘子","110/07/14","群益金鼎-丹鳳",1,10,-9
"25737","6180橘子","110/07/14","玉山-左營",8,0,8
"25738","6180橘子","110/07/14","群益金鼎-板橋",0,8,-8
"25739","6180橘子","110/07/14","富邦-陽明",16,8,8
"25740","6180橘子","110/07/14","合庫-鳳山",0,7,-7
"25741","2390云辰","110/07/14","摩根大通",995,198,797
"25742","2390云辰","110/07/14","新加坡商瑞銀",28,399,-371
"25743","2390云辰","110/07/14","美林",383,22,361
"25744","2390云辰","110/07/14","凱基-新豐",3,198,-195
"25745","2390云辰","110/07/14","台灣摩根士丹利",684,358,326
"25746","2390云辰","110/07/14","元大-士林",1,152,-151
"25747","2390云辰","110/07/14","凱基-台北",656,402,254
"25748","2390云辰","110/07/14","元大-竹山",80,181,-101
"25749","2390云辰","110/07/14","日盛-和美",110,5,105
"25750","2390云辰","110/07/14","群益金鼎-開元",19,95,-76
"25751","2390云辰","110/07/14","元大-天母",72,0,72
"25752","2390云辰","110/07/14","新光",77,150,-73
"25753","2390云辰","110/07/14","永豐金-松山",57,0,57
"25754","2390云辰","110/07/14","元富-高雄",0,71,-71
"25755","2390云辰","110/07/14","統一-屏東",53,0,53
"25756","2390云辰","110/07/14","元大-土城學府",130,201,-71
"25757","2390云辰","110/07/14","港商野村",486,450,36
"25758","2390云辰","110/07/14","元大-善化",12,76,-64
"25759","2390云辰","110/07/14","致和-崇德",30,0,30
"25760","2390云辰","110/07/14","華南永昌-岡山",23,81,-58
"25761","2390云辰","110/07/14","富邦-台北",40,14,26
"25762","2390云辰","110/07/14","群益金鼎-大興",82,125,-43
"25763","2390云辰","110/07/14","台新-高雄",38,13,25
"25764","2390云辰","110/07/14","大慶-中壢",0,41,-41
"25765","2390云辰","110/07/14","富邦-板橋",32,7,25
"25766","2390云辰","110/07/14","玉山-板橋",6,47,-41
"25767","2390云辰","110/07/14","陽信-石牌",24,0,24
"25768","2390云辰","110/07/14","富邦-台東",2,42,-40
"25769","2390云辰","110/07/14","凱基-屏東",32,8,24
"25770","2390云辰","110/07/14","元大-新營",3,42,-39
"25771","2363矽統","110/07/14","台灣摩根士丹利",463,0,463
"25772","2363矽統","110/07/14","新加坡商瑞銀",568,1321,-753
"25773","2363矽統","110/07/14","台新證券",750,342,408
"25774","2363矽統","110/07/14","瑞士信貸",149,864,-715
"25775","2363矽統","110/07/14","玉山-台中",363,51,312
"25776","2363矽統","110/07/14","台新-屏東",115,380,-265
"25777","2363矽統","110/07/14","元大-斗六",223,25,198
"25778","2363矽統","110/07/14","永豐金證券",16,265,-249
"25779","2363矽統","110/07/14","華南永昌-朴子",208,38,170
"25780","2363矽統","110/07/14","美林",462,701,-239
"25781","2363矽統","110/07/14","元富-西松",169,12,157
"25782","2363矽統","110/07/14","宏遠-桃園",269,500,-231
"25783","2363矽統","110/07/14","永豐金-大園",146,6,140
"25784","2363矽統","110/07/14","凱基-竹北",36,254,-218
"25785","2363矽統","110/07/14","土銀-和平",134,0,134
"25786","2363矽統","110/07/14","港商法國興業",0,214,-214
"25787","2363矽統","110/07/14","富邦-新營",130,13,117
"25788","2363矽統","110/07/14","港商野村",835,1044,-209
"25789","2363矽統","110/07/14","元富-成功",118,11,107
"25790","2363矽統","110/07/14","北城證券",212,411,-199
"25791","2363矽統","110/07/14","元富-烏日",121,18,103
"25792","2363矽統","110/07/14","(牛牛牛)亞-鑫豐",51,241,-190
"25793","2363矽統","110/07/14","日盛-二林",120,18,102
"25794","2363矽統","110/07/14","國票-博愛",24,213,-189
"25795","2363矽統","110/07/14","兆豐-忠孝",98,2,96
"25796","2363矽統","110/07/14","大慶-蘆洲",134,316,-182
"25797","2363矽統","110/07/14","大慶-楊梅",92,3,89
"25798","2363矽統","110/07/14","彰銀-台中",15,193,-178
"25799","2363矽統","110/07/14","元富-三重",120,33,87
"25800","2363矽統","110/07/14","日盛-和美",18,185,-167
"25801","8112至上","110/07/14","新加坡商瑞銀",223,17,206
"25802","8112至上","110/07/14","瑞士信貸",8,170,-162
"25803","8112至上","110/07/14","摩根大通",285,129,156
"25804","8112至上","110/07/14","美林",55,202,-147
"25805","8112至上","110/07/14","花旗環球",124,0,124
"25806","8112至上","110/07/14","凱基-台北",325,436,-111
"25807","8112至上","110/07/14","兆豐-公益",117,4,113
"25808","8112至上","110/07/14","台中銀-台北",0,98,-98
"25809","8112至上","110/07/14","香港上海匯豐",111,0,111
"25810","8112至上","110/07/14","玉山-台大",17,107,-90
"25811","8112至上","110/07/14","永豐金-內湖",117,21,96
"25812","8112至上","110/07/14","康和-內湖",1,90,-89
"25813","8112至上","110/07/14","台灣摩根士丹利",108,16,92
"25814","8112至上","110/07/14","港商野村",21,84,-63
"25815","8112至上","110/07/14","元大-東蘆",77,0,77
"25816","8112至上","110/07/14","兆豐-北高雄",1,60,-59
"25817","8112至上","110/07/14","新光",108,48,60
"25818","8112至上","110/07/14","群益金鼎-海山",1,52,-51
"25819","8112至上","110/07/14","大慶-蘆洲",59,0,59
"25820","8112至上","110/07/14","群益金鼎-大安",0,50,-50
"25821","8112至上","110/07/14","華南永昌-台中",56,3,53
"25822","8112至上","110/07/14","富邦-仁愛",2,49,-47
"25823","8112至上","110/07/14","土銀-嘉義",52,2,50
"25824","8112至上","110/07/14","元大-金華",0,42,-42
"25825","8112至上","110/07/14","美商高盛",40,0,40
"25826","8112至上","110/07/14","元大-內湖",4,43,-39
"25827","8112至上","110/07/14","臺銀",63,29,34
"25828","8112至上","110/07/14","第一金-華江",2,37,-35
"25829","8112至上","110/07/14","元富-嘉義",31,0,31
"25830","8112至上","110/07/14","永豐金-苓雅",2,34,-32
"25831","1570力肯","110/07/14","國票-北高雄",68,0,68
"25832","1570力肯","110/07/14","摩根大通",0,21,-21
"25833","1570力肯","110/07/14","日盛-八德",30,1,29
"25834","1570力肯","110/07/14","新光",1,19,-18
"25835","1570力肯","110/07/14","玉山-高雄",7,0,7
"25836","1570力肯","110/07/14","(牛牛牛)亞-鑫豐",0,17,-17
"25837","1570力肯","110/07/14","臺銀-臺南",5,0,5
"25838","1570力肯","110/07/14","日盛-士林",0,10,-10
"25839","1570力肯","110/07/14","凱基-三峽",5,0,5
"25840","1570力肯","110/07/14","統一-員林",0,10,-10
"25841","1570力肯","110/07/14","元大-和平",5,0,5
"25842","1570力肯","110/07/14","國票-新莊",0,10,-10
"25843","1570力肯","110/07/14","合庫-三重",4,0,4
"25844","1570力肯","110/07/14","凱基-高美館",0,10,-10
"25845","1570力肯","110/07/14","瑞士信貸",4,0,4
"25846","1570力肯","110/07/14","元大-屏東民生",0,5,-5
"25847","1570力肯","110/07/14","統一-三多",4,0,4
"25848","1570力肯","110/07/14","元大-古亭",0,5,-5
"25849","1570力肯","110/07/14","華南永昌-古亭",4,0,4
"25850","1570力肯","110/07/14","日盛-木柵",0,4,-4
"25851","1570力肯","110/07/14","元大-高雄",3,0,3
"25852","1570力肯","110/07/14","大昌",0,4,-4
"25853","1570力肯","110/07/14","兆豐-忠孝",2,0,2
"25854","1570力肯","110/07/14","群益金鼎-東大",0,4,-4
"25855","1570力肯","110/07/14","富邦-陽明",2,0,2
"25856","1570力肯","110/07/14","凱基-台北",0,4,-4
"25857","1570力肯","110/07/14","元大-松山",2,0,2
"25858","1570力肯","110/07/14","元大-板橋",0,4,-4
"25859","1570力肯","110/07/14","元大-忠孝",2,0,2
"25860","1570力肯","110/07/14","第一金-中山",0,3,-3
"25861","2929淘帝","110/07/14","華南永昌-林口",60,0,60
"25862","2929淘帝","110/07/14","群益金鼎",25,540,-515
"25863","2929淘帝","110/07/14","美林",87,31,56
"25864","2929淘帝","110/07/14","國泰-台南",1,30,-29
"25865","2929淘帝","110/07/14","元富-台南",40,0,40
"25866","2929淘帝","110/07/14","宏遠-桃園",0,20,-20
"25867","2929淘帝","110/07/14","元大-民生",39,0,39
"25868","2929淘帝","110/07/14","摩根大通",11,31,-20
"25869","2929淘帝","110/07/14","臺銀-鳳山",34,0,34
"25870","2929淘帝","110/07/14","台新-建北",5,20,-15
"25871","2929淘帝","110/07/14","合庫-高雄",34,1,33
"25872","2929淘帝","110/07/14","新光",1,16,-15
"25873","2929淘帝","110/07/14","華南永昌-鶯歌",28,0,28
"25874","2929淘帝","110/07/14","玉山-板橋",0,15,-15
"25875","2929淘帝","110/07/14","永興",25,0,25
"25876","2929淘帝","110/07/14","凱基-羅東",0,15,-15
"25877","2929淘帝","110/07/14","元大-新盛",25,1,24
"25878","2929淘帝","110/07/14","元大-頭份",0,15,-15
"25879","2929淘帝","110/07/14","日盛-南京",23,0,23
"25880","2929淘帝","110/07/14","第一金-台南",0,13,-13
"25881","2929淘帝","110/07/14","日茂",20,0,20
"25882","2929淘帝","110/07/14","富邦-基隆",0,12,-12
"25883","2929淘帝","110/07/14","台新-台中",20,0,20
"25884","2929淘帝","110/07/14","日茂-南投",1,12,-11
"25885","2929淘帝","110/07/14","華南永昌",20,0,20
"25886","2929淘帝","110/07/14","元大-豐原站前",0,11,-11
"25887","2929淘帝","110/07/14","福勝",15,0,15
"25888","2929淘帝","110/07/14","玉山-士林",0,10,-10
"25889","2929淘帝","110/07/14","富邦-南屯",15,0,15
"25890","2929淘帝","110/07/14","富邦-台北",0,10,-10
"25891","5410國眾","110/07/14","兆豐-城中",35,0,35
"25892","5410國眾","110/07/14","瑞士信貸",0,29,-29
"25893","5410國眾","110/07/14","新光",21,1,20
"25894","5410國眾","110/07/14","國泰-板橋",1,30,-29
"25895","5410國眾","110/07/14","國泰-敦南",21,1,20
"25896","5410國眾","110/07/14","日盛-高雄",0,20,-20
"25897","5410國眾","110/07/14","國泰-台中",20,1,19
"25898","5410國眾","110/07/14","台新-左楠",1,20,-19
"25899","5410國眾","110/07/14","元大-崇德",19,0,19
"25900","5410國眾","110/07/14","元富-大昌",1,18,-17
"25901","5410國眾","110/07/14","土銀-士林",18,0,18
"25902","5410國眾","110/07/14","富邦-建國",0,15,-15
"25903","5410國眾","110/07/14","元大-新盛",20,2,18
"25904","5410國眾","110/07/14","元富-嘉義",0,12,-12
"25905","5410國眾","110/07/14","兆豐-高雄",15,0,15
"25906","5410國眾","110/07/14","永全-南崁",0,12,-12
"25907","5410國眾","110/07/14","宏遠-中和",10,0,10
"25908","5410國眾","110/07/14","元大-員林",0,11,-11
"25909","5410國眾","110/07/14","新光-桃園",10,0,10
"25910","5410國眾","110/07/14","高橋",0,10,-10
"25911","5410國眾","110/07/14","國泰-台南",10,0,10
"25912","5410國眾","110/07/14","永興",0,10,-10
"25913","5410國眾","110/07/14","元大-復北",10,0,10
"25914","5410國眾","110/07/14","華南永昌-三重",0,10,-10
"25915","5410國眾","110/07/14","元大-竹科",8,0,8
"25916","5410國眾","110/07/14","元大-苑裡",0,7,-7
"25917","5410國眾","110/07/14","台新-新營",6,0,6
"25918","5410國眾","110/07/14","港商野村",0,6,-6
"25919","5410國眾","110/07/14","日盛-士林",5,0,5
"25920","5410國眾","110/07/14","摩根大通",5,11,-6
"25921","2841台開","110/07/14","凱基-文心",73,0,73
"25922","2841台開","110/07/14","國泰-敦南",0,50,-50
"25923","2841台開","110/07/14","元富-潮州",30,0,30
"25924","2841台開","110/07/14","凱基-中壢",0,40,-40
"25925","2841台開","110/07/14","第一金-台中",20,0,20
"25926","2841台開","110/07/14","統一-新竹",0,24,-24
"25927","2841台開","110/07/14","華南永昌-新莊",20,0,20
"25928","2841台開","110/07/14","元富-草屯",0,20,-20
"25929","2841台開","110/07/14","永豐金-豐原",20,0,20
"25930","2841台開","110/07/14","台新-台南",0,20,-20
"25931","2841台開","110/07/14","國泰-館前",15,0,15
"25932","2841台開","110/07/14","永豐金-敦南",45,63,-18
"25933","2841台開","110/07/14","群益金鼎-基隆",12,0,12
"25934","2841台開","110/07/14","國票-北高雄",0,13,-13
"25935","2841台開","110/07/14","日盛-信義",10,0,10
"25936","2841台開","110/07/14","凱基-松山",0,10,-10
"25937","2841台開","110/07/14","台新-台中",10,0,10
"25938","2841台開","110/07/14","元大證券",0,10,-10
"25939","2841台開","110/07/14","新光",10,1,9
"25940","2841台開","110/07/14","元大-中壢",0,10,-10
"25941","2841台開","110/07/14","凱基-新店",8,0,8
"25942","2841台開","110/07/14","富邦-陽明",1,10,-9
"25943","2841台開","110/07/14","元大-斗信",7,0,7
"25944","2841台開","110/07/14","富邦-建國",0,9,-9
"25945","2841台開","110/07/14","元大-三重",6,0,6
"25946","2841台開","110/07/14","富邦-台南",0,8,-8
"25947","2841台開","110/07/14","永豐金-中和",6,0,6
"25948","2841台開","110/07/14","康和-澎湖",0,7,-7
"25949","2841台開","110/07/14","元富-成功",5,0,5
"25950","2841台開","110/07/14","日盛-斗六",0,6,-6
"25951","6207雷科","110/07/14","群益金鼎-台北",60,0,60
"25952","6207雷科","110/07/14","新加坡商瑞銀",10,56,-46
"25953","6207雷科","110/07/14","台新-高雄",43,3,40
"25954","6207雷科","110/07/14","國票-中和",0,41,-41
"25955","6207雷科","110/07/14","元大-高雄",19,0,19
"25956","6207雷科","110/07/14","元大-復北",0,33,-33
"25957","6207雷科","110/07/14","福勝",15,0,15
"25958","6207雷科","110/07/14","光和-和美",0,20,-20
"25959","6207雷科","110/07/14","群益金鼎-中山",15,0,15
"25960","6207雷科","110/07/14","群益金鼎-丹鳳",0,20,-20
"25961","6207雷科","110/07/14","元大-林園",15,0,15
"25962","6207雷科","110/07/14","第一金-路竹",0,10,-10
"25963","6207雷科","110/07/14","新光",12,0,12
"25964","6207雷科","110/07/14","元大-歸仁",0,10,-10
"25965","6207雷科","110/07/14","元大-大天母",10,0,10
"25966","6207雷科","110/07/14","宏遠-館前",0,9,-9
"25967","6207雷科","110/07/14","永豐金-忠孝",9,0,9
"25968","6207雷科","110/07/14","凱基-台北",12,20,-8
"25969","6207雷科","110/07/14","永豐金-新店",7,0,7
"25970","6207雷科","110/07/14","美林",0,7,-7
"25971","6207雷科","110/07/14","玉山-嘉義",6,0,6
"25972","6207雷科","110/07/14","摩根大通",16,23,-7
"25973","6207雷科","110/07/14","元大-屏東",6,0,6
"25974","6207雷科","110/07/14","凱基-高雄",1,7,-6
"25975","6207雷科","110/07/14","凱基-大安",5,0,5
"25976","6207雷科","110/07/14","台中銀-豐原",0,5,-5
"25977","6207雷科","110/07/14","富邦-台南",5,0,5
"25978","6207雷科","110/07/14","元大-新竹經國",0,5,-5
"25979","6207雷科","110/07/14","元大-成功",5,0,5
"25980","6207雷科","110/07/14","光和-田中",0,4,-4
"25981","3679新至陞","110/07/14","凱基-台北",31,6,25
"25982","3679新至陞","110/07/14","群益金鼎-東大",0,15,-15
"25983","3679新至陞","110/07/14","華南永昌-新莊",10,0,10
"25984","3679新至陞","110/07/14","瑞士信貸",0,12,-12
"25985","3679新至陞","110/07/14","新加坡商瑞銀",11,3,8
"25986","3679新至陞","110/07/14","群益金鼎-永和",0,10,-10
"25987","3679新至陞","110/07/14","美商高盛",6,0,6
"25988","3679新至陞","110/07/14","元大-成功",5,15,-10
"25989","3679新至陞","110/07/14","第一金-中壢",6,0,6
"25990","3679新至陞","110/07/14","統一-板橋",1,10,-9
"25991","3679新至陞","110/07/14","(牛牛牛)亞-網路",4,0,4
"25992","3679新至陞","110/07/14","玉山-左營",0,5,-5
"25993","3679新至陞","110/07/14","元大-六合",3,0,3
"25994","3679新至陞","110/07/14","群益金鼎-三民",0,4,-4
"25995","3679新至陞","110/07/14","合庫-自強",2,0,2
"25996","3679新至陞","110/07/14","富邦-宜蘭",0,4,-4
"25997","3679新至陞","110/07/14","高橋-內壢",2,0,2
"25998","3679新至陞","110/07/14","永豐金-苓雅",0,3,-3
"25999","3679新至陞","110/07/14","台中銀-員林",2,0,2
"26000","3679新至陞","110/07/14","摩根大通",5,7,-2
"26001","3679新至陞","110/07/14","凱基-高美館",2,0,2
"26002","3679新至陞","110/07/14","元大-板橋三民",0,2,-2
"26003","3679新至陞","110/07/14","元大-福營",2,0,2
"26004","3679新至陞","110/07/14","宏遠-中和",0,1,-1
"26005","3679新至陞","110/07/14","永豐金-松山",2,0,2
"26006","3679新至陞","110/07/14","元富-佳里",0,1,-1
"26007","3679新至陞","110/07/14","永豐金-萬盛",2,0,2
"26008","3679新至陞","110/07/14","(牛牛牛)亞-鑫豐",0,1,-1
"26009","3679新至陞","110/07/14","元富-松德",1,0,1
"26010","3679新至陞","110/07/14","中國信託-中壢",0,1,-1
"26011","2727王品","110/07/14","富邦-左營",102,1,101
"26012","2727王品","110/07/14","統一-城中",100,234,-134
"26013","2727王品","110/07/14","國泰-板橋",105,11,94
"26014","2727王品","110/07/14","富邦-台北",1,125,-124
"26015","2727王品","110/07/14","港商野村",149,72,77
"26016","2727王品","110/07/14","台灣摩根士丹利",1,48,-47
"26017","2727王品","110/07/14","合庫-台中",66,2,64
"26018","2727王品","110/07/14","國票-新莊",0,40,-40
"26019","2727王品","110/07/14","臺銀-金山",63,8,55
"26020","2727王品","110/07/14","永豐金-忠孝",2,39,-37
"26021","2727王品","110/07/14","摩根大通",83,39,44
"26022","2727王品","110/07/14","富邦-彰化",1,34,-33
"26023","2727王品","110/07/14","凱基-台北",84,42,42
"26024","2727王品","110/07/14","康和-高雄",0,30,-30
"26025","2727王品","110/07/14","土銀-台中",35,1,34
"26026","2727王品","110/07/14","安泰",0,26,-26
"26027","2727王品","110/07/14","華南永昌-麻豆",32,1,31
"26028","2727王品","110/07/14","富邦-新竹華信",0,21,-21
"26029","2727王品","110/07/14","元大證券",85,55,30
"26030","2727王品","110/07/14","元大-南崁",1,22,-21
"26031","2727王品","110/07/14","新加坡商瑞銀",40,15,25
"26032","2727王品","110/07/14","彰銀-台中",0,18,-18
"26033","2727王品","110/07/14","日盛-八德",19,0,19
"26034","2727王品","110/07/14","元富-同大",2,20,-18
"26035","2727王品","110/07/14","統一",35,17,18
"26036","2727王品","110/07/14","玉山-嘉義",1,17,-16
"26037","2727王品","110/07/14","元富-大昌",18,1,17
"26038","2727王品","110/07/14","國泰-館前",4,20,-16
"26039","2727王品","110/07/14","玉山-板橋",15,1,14
"26040","2727王品","110/07/14","第一金-嘉義",1,13,-12
"26041","1570力肯","110/07/14","國票-北高雄",68,0,68
"26042","1570力肯","110/07/14","摩根大通",0,21,-21
"26043","1570力肯","110/07/14","日盛-八德",30,1,29
"26044","1570力肯","110/07/14","新光",1,19,-18
"26045","1570力肯","110/07/14","玉山-高雄",7,0,7
"26046","1570力肯","110/07/14","(牛牛牛)亞-鑫豐",0,17,-17
"26047","1570力肯","110/07/14","臺銀-臺南",5,0,5
"26048","1570力肯","110/07/14","日盛-士林",0,10,-10
"26049","1570力肯","110/07/14","凱基-三峽",5,0,5
"26050","1570力肯","110/07/14","統一-員林",0,10,-10
"26051","1570力肯","110/07/14","元大-和平",5,0,5
"26052","1570力肯","110/07/14","國票-新莊",0,10,-10
"26053","1570力肯","110/07/14","合庫-三重",4,0,4
"26054","1570力肯","110/07/14","凱基-高美館",0,10,-10
"26055","1570力肯","110/07/14","瑞士信貸",4,0,4
"26056","1570力肯","110/07/14","元大-屏東民生",0,5,-5
"26057","1570力肯","110/07/14","統一-三多",4,0,4
"26058","1570力肯","110/07/14","元大-古亭",0,5,-5
"26059","1570力肯","110/07/14","華南永昌-古亭",4,0,4
"26060","1570力肯","110/07/14","日盛-木柵",0,4,-4
"26061","1570力肯","110/07/14","元大-高雄",3,0,3
"26062","1570力肯","110/07/14","大昌",0,4,-4
"26063","1570力肯","110/07/14","兆豐-忠孝",2,0,2
"26064","1570力肯","110/07/14","群益金鼎-東大",0,4,-4
"26065","1570力肯","110/07/14","富邦-陽明",2,0,2
"26066","1570力肯","110/07/14","凱基-台北",0,4,-4
"26067","1570力肯","110/07/14","元大-松山",2,0,2
"26068","1570力肯","110/07/14","元大-板橋",0,4,-4
"26069","1570力肯","110/07/14","元大-忠孝",2,0,2
"26070","1570力肯","110/07/14","第一金-中山",0,3,-3
"26071","6180橘子","110/07/14","新加坡商瑞銀",84,28,56
"26072","6180橘子","110/07/14","凱基-台北",4,37,-33
"26073","6180橘子","110/07/14","日盛-信義",29,1,28
"26074","6180橘子","110/07/14","玉山-台南",1,22,-21
"26075","6180橘子","110/07/14","豐農",28,4,24
"26076","6180橘子","110/07/14","日盛-新竹",1,21,-20
"26077","6180橘子","110/07/14","新光-新竹",24,1,23
"26078","6180橘子","110/07/14","元富-潮州",0,19,-19
"26079","6180橘子","110/07/14","華南永昌-高雄",20,0,20
"26080","6180橘子","110/07/14","元大-信義",0,17,-17
"26081","6180橘子","110/07/14","元大-羅東",20,0,20
"26082","6180橘子","110/07/14","台灣企銀-台中",1,16,-15
"26083","6180橘子","110/07/14","元大-台中中港",20,0,20
"26084","6180橘子","110/07/14","元大-北港",0,15,-15
"26085","6180橘子","110/07/14","富邦-嘉義",24,5,19
"26086","6180橘子","110/07/14","富邦-高雄",0,14,-14
"26087","6180橘子","110/07/14","富邦-仁愛",15,0,15
"26088","6180橘子","110/07/14","兆豐-埔墘",0,13,-13
"26089","6180橘子","110/07/14","國票-九鼎",13,0,13
"26090","6180橘子","110/07/14","第一金-中山",0,10,-10
"26091","6180橘子","110/07/14","日盛-木柵",12,0,12
"26092","6180橘子","110/07/14","元大-彰化民生",0,10,-10
"26093","6180橘子","110/07/14","元大-成功",10,0,10
"26094","6180橘子","110/07/14","福勝",1,10,-9
"26095","6180橘子","110/07/14","港商野村",10,2,8
"26096","6180橘子","110/07/14","群益金鼎-丹鳳",1,10,-9
"26097","6180橘子","110/07/14","玉山-左營",8,0,8
"26098","6180橘子","110/07/14","群益金鼎-板橋",0,8,-8
"26099","6180橘子","110/07/14","富邦-陽明",16,8,8
"26100","6180橘子","110/07/14","合庫-鳳山",0,7,-7
"26101","2390云辰","110/07/14","摩根大通",995,198,797
"26102","2390云辰","110/07/14","新加坡商瑞銀",28,399,-371
"26103","2390云辰","110/07/14","美林",383,22,361
"26104","2390云辰","110/07/14","凱基-新豐",3,198,-195
"26105","2390云辰","110/07/14","台灣摩根士丹利",684,358,326
"26106","2390云辰","110/07/14","元大-士林",1,152,-151
"26107","2390云辰","110/07/14","凱基-台北",656,402,254
"26108","2390云辰","110/07/14","元大-竹山",80,181,-101
"26109","2390云辰","110/07/14","日盛-和美",110,5,105
"26110","2390云辰","110/07/14","群益金鼎-開元",19,95,-76
"26111","2390云辰","110/07/14","元大-天母",72,0,72
"26112","2390云辰","110/07/14","新光",77,150,-73
"26113","2390云辰","110/07/14","永豐金-松山",57,0,57
"26114","2390云辰","110/07/14","元富-高雄",0,71,-71
"26115","2390云辰","110/07/14","統一-屏東",53,0,53
"26116","2390云辰","110/07/14","元大-土城學府",130,201,-71
"26117","2390云辰","110/07/14","港商野村",486,450,36
"26118","2390云辰","110/07/14","元大-善化",12,76,-64
"26119","2390云辰","110/07/14","致和-崇德",30,0,30
"26120","2390云辰","110/07/14","華南永昌-岡山",23,81,-58
"26121","2390云辰","110/07/14","富邦-台北",40,14,26
"26122","2390云辰","110/07/14","群益金鼎-大興",82,125,-43
"26123","2390云辰","110/07/14","台新-高雄",38,13,25
"26124","2390云辰","110/07/14","大慶-中壢",0,41,-41
"26125","2390云辰","110/07/14","富邦-板橋",32,7,25
"26126","2390云辰","110/07/14","玉山-板橋",6,47,-41
"26127","2390云辰","110/07/14","陽信-石牌",24,0,24
"26128","2390云辰","110/07/14","富邦-台東",2,42,-40
"26129","2390云辰","110/07/14","凱基-屏東",32,8,24
"26130","2390云辰","110/07/14","元大-新營",3,42,-39
"26131","2363矽統","110/07/14","台灣摩根士丹利",463,0,463
"26132","2363矽統","110/07/14","新加坡商瑞銀",568,1321,-753
"26133","2363矽統","110/07/14","台新證券",750,342,408
"26134","2363矽統","110/07/14","瑞士信貸",149,864,-715
"26135","2363矽統","110/07/14","玉山-台中",363,51,312
"26136","2363矽統","110/07/14","台新-屏東",115,380,-265
"26137","2363矽統","110/07/14","元大-斗六",223,25,198
"26138","2363矽統","110/07/14","永豐金證券",16,265,-249
"26139","2363矽統","110/07/14","華南永昌-朴子",208,38,170
"26140","2363矽統","110/07/14","美林",462,701,-239
"26141","2363矽統","110/07/14","元富-西松",169,12,157
"26142","2363矽統","110/07/14","宏遠-桃園",269,500,-231
"26143","2363矽統","110/07/14","永豐金-大園",146,6,140
"26144","2363矽統","110/07/14","凱基-竹北",36,254,-218
"26145","2363矽統","110/07/14","土銀-和平",134,0,134
"26146","2363矽統","110/07/14","港商法國興業",0,214,-214
"26147","2363矽統","110/07/14","富邦-新營",130,13,117
"26148","2363矽統","110/07/14","港商野村",835,1044,-209
"26149","2363矽統","110/07/14","元富-成功",118,11,107
"26150","2363矽統","110/07/14","北城證券",212,411,-199
"26151","2363矽統","110/07/14","元富-烏日",121,18,103
"26152","2363矽統","110/07/14","(牛牛牛)亞-鑫豐",51,241,-190
"26153","2363矽統","110/07/14","日盛-二林",120,18,102
"26154","2363矽統","110/07/14","國票-博愛",24,213,-189
"26155","2363矽統","110/07/14","兆豐-忠孝",98,2,96
"26156","2363矽統","110/07/14","大慶-蘆洲",134,316,-182
"26157","2363矽統","110/07/14","大慶-楊梅",92,3,89
"26158","2363矽統","110/07/14","彰銀-台中",15,193,-178
"26159","2363矽統","110/07/14","元富-三重",120,33,87
"26160","2363矽統","110/07/14","日盛-和美",18,185,-167
"26161","8112至上","110/07/14","新加坡商瑞銀",223,17,206
"26162","8112至上","110/07/14","瑞士信貸",8,170,-162
"26163","8112至上","110/07/14","摩根大通",285,129,156
"26164","8112至上","110/07/14","美林",55,202,-147
"26165","8112至上","110/07/14","花旗環球",124,0,124
"26166","8112至上","110/07/14","凱基-台北",325,436,-111
"26167","8112至上","110/07/14","兆豐-公益",117,4,113
"26168","8112至上","110/07/14","台中銀-台北",0,98,-98
"26169","8112至上","110/07/14","香港上海匯豐",111,0,111
"26170","8112至上","110/07/14","玉山-台大",17,107,-90
"26171","8112至上","110/07/14","永豐金-內湖",117,21,96
"26172","8112至上","110/07/14","康和-內湖",1,90,-89
"26173","8112至上","110/07/14","台灣摩根士丹利",108,16,92
"26174","8112至上","110/07/14","港商野村",21,84,-63
"26175","8112至上","110/07/14","元大-東蘆",77,0,77
"26176","8112至上","110/07/14","兆豐-北高雄",1,60,-59
"26177","8112至上","110/07/14","新光",108,48,60
"26178","8112至上","110/07/14","群益金鼎-海山",1,52,-51
"26179","8112至上","110/07/14","大慶-蘆洲",59,0,59
"26180","8112至上","110/07/14","群益金鼎-大安",0,50,-50
"26181","8112至上","110/07/14","華南永昌-台中",56,3,53
"26182","8112至上","110/07/14","富邦-仁愛",2,49,-47
"26183","8112至上","110/07/14","土銀-嘉義",52,2,50
"26184","8112至上","110/07/14","元大-金華",0,42,-42
"26185","8112至上","110/07/14","美商高盛",40,0,40
"26186","8112至上","110/07/14","元大-內湖",4,43,-39
"26187","8112至上","110/07/14","臺銀",63,29,34
"26188","8112至上","110/07/14","第一金-華江",2,37,-35
"26189","8112至上","110/07/14","元富-嘉義",31,0,31
"26190","8112至上","110/07/14","永豐金-苓雅",2,34,-32
"26191","1570力肯","110/07/14","國票-北高雄",68,0,68
"26192","1570力肯","110/07/14","摩根大通",0,21,-21
"26193","1570力肯","110/07/14","日盛-八德",30,1,29
"26194","1570力肯","110/07/14","新光",1,19,-18
"26195","1570力肯","110/07/14","玉山-高雄",7,0,7
"26196","1570力肯","110/07/14","(牛牛牛)亞-鑫豐",0,17,-17
"26197","1570力肯","110/07/14","臺銀-臺南",5,0,5
"26198","1570力肯","110/07/14","日盛-士林",0,10,-10
"26199","1570力肯","110/07/14","凱基-三峽",5,0,5
"26200","1570力肯","110/07/14","統一-員林",0,10,-10
"26201","1570力肯","110/07/14","元大-和平",5,0,5
"26202","1570力肯","110/07/14","國票-新莊",0,10,-10
"26203","1570力肯","110/07/14","合庫-三重",4,0,4
"26204","1570力肯","110/07/14","凱基-高美館",0,10,-10
"26205","1570力肯","110/07/14","瑞士信貸",4,0,4
"26206","1570力肯","110/07/14","元大-屏東民生",0,5,-5
"26207","1570力肯","110/07/14","統一-三多",4,0,4
"26208","1570力肯","110/07/14","元大-古亭",0,5,-5
"26209","1570力肯","110/07/14","華南永昌-古亭",4,0,4
"26210","1570力肯","110/07/14","日盛-木柵",0,4,-4
"26211","1570力肯","110/07/14","元大-高雄",3,0,3
"26212","1570力肯","110/07/14","大昌",0,4,-4
"26213","1570力肯","110/07/14","兆豐-忠孝",2,0,2
"26214","1570力肯","110/07/14","群益金鼎-東大",0,4,-4
"26215","1570力肯","110/07/14","富邦-陽明",2,0,2
"26216","1570力肯","110/07/14","凱基-台北",0,4,-4
"26217","1570力肯","110/07/14","元大-松山",2,0,2
"26218","1570力肯","110/07/14","元大-板橋",0,4,-4
"26219","1570力肯","110/07/14","元大-忠孝",2,0,2
"26220","1570力肯","110/07/14","第一金-中山",0,3,-3
"26221","2929淘帝","110/07/14","華南永昌-林口",60,0,60
"26222","2929淘帝","110/07/14","群益金鼎",25,540,-515
"26223","2929淘帝","110/07/14","美林",87,31,56
"26224","2929淘帝","110/07/14","國泰-台南",1,30,-29
"26225","2929淘帝","110/07/14","元富-台南",40,0,40
"26226","2929淘帝","110/07/14","宏遠-桃園",0,20,-20
"26227","2929淘帝","110/07/14","元大-民生",39,0,39
"26228","2929淘帝","110/07/14","摩根大通",11,31,-20
"26229","2929淘帝","110/07/14","臺銀-鳳山",34,0,34
"26230","2929淘帝","110/07/14","台新-建北",5,20,-15
"26231","2929淘帝","110/07/14","合庫-高雄",34,1,33
"26232","2929淘帝","110/07/14","新光",1,16,-15
"26233","2929淘帝","110/07/14","華南永昌-鶯歌",28,0,28
"26234","2929淘帝","110/07/14","玉山-板橋",0,15,-15
"26235","2929淘帝","110/07/14","永興",25,0,25
"26236","2929淘帝","110/07/14","凱基-羅東",0,15,-15
"26237","2929淘帝","110/07/14","元大-新盛",25,1,24
"26238","2929淘帝","110/07/14","元大-頭份",0,15,-15
"26239","2929淘帝","110/07/14","日盛-南京",23,0,23
"26240","2929淘帝","110/07/14","第一金-台南",0,13,-13
"26241","2929淘帝","110/07/14","日茂",20,0,20
"26242","2929淘帝","110/07/14","富邦-基隆",0,12,-12
"26243","2929淘帝","110/07/14","台新-台中",20,0,20
"26244","2929淘帝","110/07/14","日茂-南投",1,12,-11
"26245","2929淘帝","110/07/14","華南永昌",20,0,20
"26246","2929淘帝","110/07/14","元大-豐原站前",0,11,-11
"26247","2929淘帝","110/07/14","福勝",15,0,15
"26248","2929淘帝","110/07/14","玉山-士林",0,10,-10
"26249","2929淘帝","110/07/14","富邦-南屯",15,0,15
"26250","2929淘帝","110/07/14","富邦-台北",0,10,-10
"26251","5410國眾","110/07/14","兆豐-城中",35,0,35
"26252","5410國眾","110/07/14","瑞士信貸",0,29,-29
"26253","5410國眾","110/07/14","新光",21,1,20
"26254","5410國眾","110/07/14","國泰-板橋",1,30,-29
"26255","5410國眾","110/07/14","國泰-敦南",21,1,20
"26256","5410國眾","110/07/14","日盛-高雄",0,20,-20
"26257","5410國眾","110/07/14","國泰-台中",20,1,19
"26258","5410國眾","110/07/14","台新-左楠",1,20,-19
"26259","5410國眾","110/07/14","元大-崇德",19,0,19
"26260","5410國眾","110/07/14","元富-大昌",1,18,-17
"26261","5410國眾","110/07/14","土銀-士林",18,0,18
"26262","5410國眾","110/07/14","富邦-建國",0,15,-15
"26263","5410國眾","110/07/14","元大-新盛",20,2,18
"26264","5410國眾","110/07/14","元富-嘉義",0,12,-12
"26265","5410國眾","110/07/14","兆豐-高雄",15,0,15
"26266","5410國眾","110/07/14","永全-南崁",0,12,-12
"26267","5410國眾","110/07/14","宏遠-中和",10,0,10
"26268","5410國眾","110/07/14","元大-員林",0,11,-11
"26269","5410國眾","110/07/14","新光-桃園",10,0,10
"26270","5410國眾","110/07/14","高橋",0,10,-10
"26271","5410國眾","110/07/14","國泰-台南",10,0,10
"26272","5410國眾","110/07/14","永興",0,10,-10
"26273","5410國眾","110/07/14","元大-復北",10,0,10
"26274","5410國眾","110/07/14","華南永昌-三重",0,10,-10
"26275","5410國眾","110/07/14","元大-竹科",8,0,8
"26276","5410國眾","110/07/14","元大-苑裡",0,7,-7
"26277","5410國眾","110/07/14","台新-新營",6,0,6
"26278","5410國眾","110/07/14","港商野村",0,6,-6
"26279","5410國眾","110/07/14","日盛-士林",5,0,5
"26280","5410國眾","110/07/14","摩根大通",5,11,-6
"26281","2841台開","110/07/14","凱基-文心",73,0,73
"26282","2841台開","110/07/14","國泰-敦南",0,50,-50
"26283","2841台開","110/07/14","元富-潮州",30,0,30
"26284","2841台開","110/07/14","凱基-中壢",0,40,-40
"26285","2841台開","110/07/14","第一金-台中",20,0,20
"26286","2841台開","110/07/14","統一-新竹",0,24,-24
"26287","2841台開","110/07/14","華南永昌-新莊",20,0,20
"26288","2841台開","110/07/14","元富-草屯",0,20,-20
"26289","2841台開","110/07/14","永豐金-豐原",20,0,20
"26290","2841台開","110/07/14","台新-台南",0,20,-20
"26291","2841台開","110/07/14","國泰-館前",15,0,15
"26292","2841台開","110/07/14","永豐金-敦南",45,63,-18
"26293","2841台開","110/07/14","群益金鼎-基隆",12,0,12
"26294","2841台開","110/07/14","國票-北高雄",0,13,-13
"26295","2841台開","110/07/14","日盛-信義",10,0,10
"26296","2841台開","110/07/14","凱基-松山",0,10,-10
"26297","2841台開","110/07/14","台新-台中",10,0,10
"26298","2841台開","110/07/14","元大證券",0,10,-10
"26299","2841台開","110/07/14","新光",10,1,9
"26300","2841台開","110/07/14","元大-中壢",0,10,-10
"26301","2841台開","110/07/14","凱基-新店",8,0,8
"26302","2841台開","110/07/14","富邦-陽明",1,10,-9
"26303","2841台開","110/07/14","元大-斗信",7,0,7
"26304","2841台開","110/07/14","富邦-建國",0,9,-9
"26305","2841台開","110/07/14","元大-三重",6,0,6
"26306","2841台開","110/07/14","富邦-台南",0,8,-8
"26307","2841台開","110/07/14","永豐金-中和",6,0,6
"26308","2841台開","110/07/14","康和-澎湖",0,7,-7
"26309","2841台開","110/07/14","元富-成功",5,0,5
"26310","2841台開","110/07/14","日盛-斗六",0,6,-6
"26311","6207雷科","110/07/14","群益金鼎-台北",60,0,60
"26312","6207雷科","110/07/14","新加坡商瑞銀",10,56,-46
"26313","6207雷科","110/07/14","台新-高雄",43,3,40
"26314","6207雷科","110/07/14","國票-中和",0,41,-41
"26315","6207雷科","110/07/14","元大-高雄",19,0,19
"26316","6207雷科","110/07/14","元大-復北",0,33,-33
"26317","6207雷科","110/07/14","福勝",15,0,15
"26318","6207雷科","110/07/14","光和-和美",0,20,-20
"26319","6207雷科","110/07/14","群益金鼎-中山",15,0,15
"26320","6207雷科","110/07/14","群益金鼎-丹鳳",0,20,-20
"26321","6207雷科","110/07/14","元大-林園",15,0,15
"26322","6207雷科","110/07/14","第一金-路竹",0,10,-10
"26323","6207雷科","110/07/14","新光",12,0,12
"26324","6207雷科","110/07/14","元大-歸仁",0,10,-10
"26325","6207雷科","110/07/14","元大-大天母",10,0,10
"26326","6207雷科","110/07/14","宏遠-館前",0,9,-9
"26327","6207雷科","110/07/14","永豐金-忠孝",9,0,9
"26328","6207雷科","110/07/14","凱基-台北",12,20,-8
"26329","6207雷科","110/07/14","永豐金-新店",7,0,7
"26330","6207雷科","110/07/14","美林",0,7,-7
"26331","6207雷科","110/07/14","玉山-嘉義",6,0,6
"26332","6207雷科","110/07/14","摩根大通",16,23,-7
"26333","6207雷科","110/07/14","元大-屏東",6,0,6
"26334","6207雷科","110/07/14","凱基-高雄",1,7,-6
"26335","6207雷科","110/07/14","凱基-大安",5,0,5
"26336","6207雷科","110/07/14","台中銀-豐原",0,5,-5
"26337","6207雷科","110/07/14","富邦-台南",5,0,5
"26338","6207雷科","110/07/14","元大-新竹經國",0,5,-5
"26339","6207雷科","110/07/14","元大-成功",5,0,5
"26340","6207雷科","110/07/14","光和-田中",0,4,-4
"26341","3679新至陞","110/07/14","凱基-台北",31,6,25
"26342","3679新至陞","110/07/14","群益金鼎-東大",0,15,-15
"26343","3679新至陞","110/07/14","華南永昌-新莊",10,0,10
"26344","3679新至陞","110/07/14","瑞士信貸",0,12,-12
"26345","3679新至陞","110/07/14","新加坡商瑞銀",11,3,8
"26346","3679新至陞","110/07/14","群益金鼎-永和",0,10,-10
"26347","3679新至陞","110/07/14","美商高盛",6,0,6
"26348","3679新至陞","110/07/14","元大-成功",5,15,-10
"26349","3679新至陞","110/07/14","第一金-中壢",6,0,6
"26350","3679新至陞","110/07/14","統一-板橋",1,10,-9
"26351","3679新至陞","110/07/14","(牛牛牛)亞-網路",4,0,4
"26352","3679新至陞","110/07/14","玉山-左營",0,5,-5
"26353","3679新至陞","110/07/14","元大-六合",3,0,3
"26354","3679新至陞","110/07/14","群益金鼎-三民",0,4,-4
"26355","3679新至陞","110/07/14","合庫-自強",2,0,2
"26356","3679新至陞","110/07/14","富邦-宜蘭",0,4,-4
"26357","3679新至陞","110/07/14","高橋-內壢",2,0,2
"26358","3679新至陞","110/07/14","永豐金-苓雅",0,3,-3
"26359","3679新至陞","110/07/14","台中銀-員林",2,0,2
"26360","3679新至陞","110/07/14","摩根大通",5,7,-2
"26361","3679新至陞","110/07/14","凱基-高美館",2,0,2
"26362","3679新至陞","110/07/14","元大-板橋三民",0,2,-2
"26363","3679新至陞","110/07/14","元大-福營",2,0,2
"26364","3679新至陞","110/07/14","宏遠-中和",0,1,-1
"26365","3679新至陞","110/07/14","永豐金-松山",2,0,2
"26366","3679新至陞","110/07/14","元富-佳里",0,1,-1
"26367","3679新至陞","110/07/14","永豐金-萬盛",2,0,2
"26368","3679新至陞","110/07/14","(牛牛牛)亞-鑫豐",0,1,-1
"26369","3679新至陞","110/07/14","元富-松德",1,0,1
"26370","3679新至陞","110/07/14","中國信託-中壢",0,1,-1
"26371","2727王品","110/07/14","富邦-左營",102,1,101
"26372","2727王品","110/07/14","統一-城中",100,234,-134
"26373","2727王品","110/07/14","國泰-板橋",105,11,94
"26374","2727王品","110/07/14","富邦-台北",1,125,-124
"26375","2727王品","110/07/14","港商野村",149,72,77
"26376","2727王品","110/07/14","台灣摩根士丹利",1,48,-47
"26377","2727王品","110/07/14","合庫-台中",66,2,64
"26378","2727王品","110/07/14","國票-新莊",0,40,-40
"26379","2727王品","110/07/14","臺銀-金山",63,8,55
"26380","2727王品","110/07/14","永豐金-忠孝",2,39,-37
"26381","2727王品","110/07/14","摩根大通",83,39,44
"26382","2727王品","110/07/14","富邦-彰化",1,34,-33
"26383","2727王品","110/07/14","凱基-台北",84,42,42
"26384","2727王品","110/07/14","康和-高雄",0,30,-30
"26385","2727王品","110/07/14","土銀-台中",35,1,34
"26386","2727王品","110/07/14","安泰",0,26,-26
"26387","2727王品","110/07/14","華南永昌-麻豆",32,1,31
"26388","2727王品","110/07/14","富邦-新竹華信",0,21,-21
"26389","2727王品","110/07/14","元大證券",85,55,30
"26390","2727王品","110/07/14","元大-南崁",1,22,-21
"26391","2727王品","110/07/14","新加坡商瑞銀",40,15,25
"26392","2727王品","110/07/14","彰銀-台中",0,18,-18
"26393","2727王品","110/07/14","日盛-八德",19,0,19
"26394","2727王品","110/07/14","元富-同大",2,20,-18
"26395","2727王品","110/07/14","統一",35,17,18
"26396","2727王品","110/07/14","玉山-嘉義",1,17,-16
"26397","2727王品","110/07/14","元富-大昌",18,1,17
"26398","2727王品","110/07/14","國泰-館前",4,20,-16
"26399","2727王品","110/07/14","玉山-板橋",15,1,14
"26400","2727王品","110/07/14","第一金-嘉義",1,13,-12
"26401","1570力肯","110/07/14","國票-北高雄",68,0,68
"26402","1570力肯","110/07/14","摩根大通",0,21,-21
"26403","1570力肯","110/07/14","日盛-八德",30,1,29
"26404","1570力肯","110/07/14","新光",1,19,-18
"26405","1570力肯","110/07/14","玉山-高雄",7,0,7
"26406","1570力肯","110/07/14","(牛牛牛)亞-鑫豐",0,17,-17
"26407","1570力肯","110/07/14","臺銀-臺南",5,0,5
"26408","1570力肯","110/07/14","日盛-士林",0,10,-10
"26409","1570力肯","110/07/14","凱基-三峽",5,0,5
"26410","1570力肯","110/07/14","統一-員林",0,10,-10
"26411","1570力肯","110/07/14","元大-和平",5,0,5
"26412","1570力肯","110/07/14","國票-新莊",0,10,-10
"26413","1570力肯","110/07/14","合庫-三重",4,0,4
"26414","1570力肯","110/07/14","凱基-高美館",0,10,-10
"26415","1570力肯","110/07/14","瑞士信貸",4,0,4
"26416","1570力肯","110/07/14","元大-屏東民生",0,5,-5
"26417","1570力肯","110/07/14","統一-三多",4,0,4
"26418","1570力肯","110/07/14","元大-古亭",0,5,-5
"26419","1570力肯","110/07/14","華南永昌-古亭",4,0,4
"26420","1570力肯","110/07/14","日盛-木柵",0,4,-4
"26421","1570力肯","110/07/14","元大-高雄",3,0,3
"26422","1570力肯","110/07/14","大昌",0,4,-4
"26423","1570力肯","110/07/14","兆豐-忠孝",2,0,2
"26424","1570力肯","110/07/14","群益金鼎-東大",0,4,-4
"26425","1570力肯","110/07/14","富邦-陽明",2,0,2
"26426","1570力肯","110/07/14","凱基-台北",0,4,-4
"26427","1570力肯","110/07/14","元大-松山",2,0,2
"26428","1570力肯","110/07/14","元大-板橋",0,4,-4
"26429","1570力肯","110/07/14","元大-忠孝",2,0,2
"26430","1570力肯","110/07/14","第一金-中山",0,3,-3
"26431","6180橘子","110/07/14","新加坡商瑞銀",84,28,56
"26432","6180橘子","110/07/14","凱基-台北",4,37,-33
"26433","6180橘子","110/07/14","日盛-信義",29,1,28
"26434","6180橘子","110/07/14","玉山-台南",1,22,-21
"26435","6180橘子","110/07/14","豐農",28,4,24
"26436","6180橘子","110/07/14","日盛-新竹",1,21,-20
"26437","6180橘子","110/07/14","新光-新竹",24,1,23
"26438","6180橘子","110/07/14","元富-潮州",0,19,-19
"26439","6180橘子","110/07/14","華南永昌-高雄",20,0,20
"26440","6180橘子","110/07/14","元大-信義",0,17,-17
"26441","6180橘子","110/07/14","元大-羅東",20,0,20
"26442","6180橘子","110/07/14","台灣企銀-台中",1,16,-15
"26443","6180橘子","110/07/14","元大-台中中港",20,0,20
"26444","6180橘子","110/07/14","元大-北港",0,15,-15
"26445","6180橘子","110/07/14","富邦-嘉義",24,5,19
"26446","6180橘子","110/07/14","富邦-高雄",0,14,-14
"26447","6180橘子","110/07/14","富邦-仁愛",15,0,15
"26448","6180橘子","110/07/14","兆豐-埔墘",0,13,-13
"26449","6180橘子","110/07/14","國票-九鼎",13,0,13
"26450","6180橘子","110/07/14","第一金-中山",0,10,-10
"26451","6180橘子","110/07/14","日盛-木柵",12,0,12
"26452","6180橘子","110/07/14","元大-彰化民生",0,10,-10
"26453","6180橘子","110/07/14","元大-成功",10,0,10
"26454","6180橘子","110/07/14","福勝",1,10,-9
"26455","6180橘子","110/07/14","港商野村",10,2,8
"26456","6180橘子","110/07/14","群益金鼎-丹鳳",1,10,-9
"26457","6180橘子","110/07/14","玉山-左營",8,0,8
"26458","6180橘子","110/07/14","群益金鼎-板橋",0,8,-8
"26459","6180橘子","110/07/14","富邦-陽明",16,8,8
"26460","6180橘子","110/07/14","合庫-鳳山",0,7,-7
"26461","2390云辰","110/07/14","摩根大通",995,198,797
"26462","2390云辰","110/07/14","新加坡商瑞銀",28,399,-371
"26463","2390云辰","110/07/14","美林",383,22,361
"26464","2390云辰","110/07/14","凱基-新豐",3,198,-195
"26465","2390云辰","110/07/14","台灣摩根士丹利",684,358,326
"26466","2390云辰","110/07/14","元大-士林",1,152,-151
"26467","2390云辰","110/07/14","凱基-台北",656,402,254
"26468","2390云辰","110/07/14","元大-竹山",80,181,-101
"26469","2390云辰","110/07/14","日盛-和美",110,5,105
"26470","2390云辰","110/07/14","群益金鼎-開元",19,95,-76
"26471","2390云辰","110/07/14","元大-天母",72,0,72
"26472","2390云辰","110/07/14","新光",77,150,-73
"26473","2390云辰","110/07/14","永豐金-松山",57,0,57
"26474","2390云辰","110/07/14","元富-高雄",0,71,-71
"26475","2390云辰","110/07/14","統一-屏東",53,0,53
"26476","2390云辰","110/07/14","元大-土城學府",130,201,-71
"26477","2390云辰","110/07/14","港商野村",486,450,36
"26478","2390云辰","110/07/14","元大-善化",12,76,-64
"26479","2390云辰","110/07/14","致和-崇德",30,0,30
"26480","2390云辰","110/07/14","華南永昌-岡山",23,81,-58
"26481","2390云辰","110/07/14","富邦-台北",40,14,26
"26482","2390云辰","110/07/14","群益金鼎-大興",82,125,-43
"26483","2390云辰","110/07/14","台新-高雄",38,13,25
"26484","2390云辰","110/07/14","大慶-中壢",0,41,-41
"26485","2390云辰","110/07/14","富邦-板橋",32,7,25
"26486","2390云辰","110/07/14","玉山-板橋",6,47,-41
"26487","2390云辰","110/07/14","陽信-石牌",24,0,24
"26488","2390云辰","110/07/14","富邦-台東",2,42,-40
"26489","2390云辰","110/07/14","凱基-屏東",32,8,24
"26490","2390云辰","110/07/14","元大-新營",3,42,-39
"26491","2363矽統","110/07/14","台灣摩根士丹利",463,0,463
"26492","2363矽統","110/07/14","新加坡商瑞銀",568,1321,-753
"26493","2363矽統","110/07/14","台新證券",750,342,408
"26494","2363矽統","110/07/14","瑞士信貸",149,864,-715
"26495","2363矽統","110/07/14","玉山-台中",363,51,312
"26496","2363矽統","110/07/14","台新-屏東",115,380,-265
"26497","2363矽統","110/07/14","元大-斗六",223,25,198
"26498","2363矽統","110/07/14","永豐金證券",16,265,-249
"26499","2363矽統","110/07/14","華南永昌-朴子",208,38,170
"26500","2363矽統","110/07/14","美林",462,701,-239
"26501","2363矽統","110/07/14","元富-西松",169,12,157
"26502","2363矽統","110/07/14","宏遠-桃園",269,500,-231
"26503","2363矽統","110/07/14","永豐金-大園",146,6,140
"26504","2363矽統","110/07/14","凱基-竹北",36,254,-218
"26505","2363矽統","110/07/14","土銀-和平",134,0,134
"26506","2363矽統","110/07/14","港商法國興業",0,214,-214
"26507","2363矽統","110/07/14","富邦-新營",130,13,117
"26508","2363矽統","110/07/14","港商野村",835,1044,-209
"26509","2363矽統","110/07/14","元富-成功",118,11,107
"26510","2363矽統","110/07/14","北城證券",212,411,-199
"26511","2363矽統","110/07/14","元富-烏日",121,18,103
"26512","2363矽統","110/07/14","(牛牛牛)亞-鑫豐",51,241,-190
"26513","2363矽統","110/07/14","日盛-二林",120,18,102
"26514","2363矽統","110/07/14","國票-博愛",24,213,-189
"26515","2363矽統","110/07/14","兆豐-忠孝",98,2,96
"26516","2363矽統","110/07/14","大慶-蘆洲",134,316,-182
"26517","2363矽統","110/07/14","大慶-楊梅",92,3,89
"26518","2363矽統","110/07/14","彰銀-台中",15,193,-178
"26519","2363矽統","110/07/14","元富-三重",120,33,87
"26520","2363矽統","110/07/14","日盛-和美",18,185,-167
"26521","8112至上","110/07/14","新加坡商瑞銀",223,17,206
"26522","8112至上","110/07/14","瑞士信貸",8,170,-162
"26523","8112至上","110/07/14","摩根大通",285,129,156
"26524","8112至上","110/07/14","美林",55,202,-147
"26525","8112至上","110/07/14","花旗環球",124,0,124
"26526","8112至上","110/07/14","凱基-台北",325,436,-111
"26527","8112至上","110/07/14","兆豐-公益",117,4,113
"26528","8112至上","110/07/14","台中銀-台北",0,98,-98
"26529","8112至上","110/07/14","香港上海匯豐",111,0,111
"26530","8112至上","110/07/14","玉山-台大",17,107,-90
"26531","8112至上","110/07/14","永豐金-內湖",117,21,96
"26532","8112至上","110/07/14","康和-內湖",1,90,-89
"26533","8112至上","110/07/14","台灣摩根士丹利",108,16,92
"26534","8112至上","110/07/14","港商野村",21,84,-63
"26535","8112至上","110/07/14","元大-東蘆",77,0,77
"26536","8112至上","110/07/14","兆豐-北高雄",1,60,-59
"26537","8112至上","110/07/14","新光",108,48,60
"26538","8112至上","110/07/14","群益金鼎-海山",1,52,-51
"26539","8112至上","110/07/14","大慶-蘆洲",59,0,59
"26540","8112至上","110/07/14","群益金鼎-大安",0,50,-50
"26541","8112至上","110/07/14","華南永昌-台中",56,3,53
"26542","8112至上","110/07/14","富邦-仁愛",2,49,-47
"26543","8112至上","110/07/14","土銀-嘉義",52,2,50
"26544","8112至上","110/07/14","元大-金華",0,42,-42
"26545","8112至上","110/07/14","美商高盛",40,0,40
"26546","8112至上","110/07/14","元大-內湖",4,43,-39
"26547","8112至上","110/07/14","臺銀",63,29,34
"26548","8112至上","110/07/14","第一金-華江",2,37,-35
"26549","8112至上","110/07/14","元富-嘉義",31,0,31
"26550","8112至上","110/07/14","永豐金-苓雅",2,34,-32
"26551","1570力肯","110/07/14","國票-北高雄",68,0,68
"26552","1570力肯","110/07/14","摩根大通",0,21,-21
"26553","1570力肯","110/07/14","日盛-八德",30,1,29
"26554","1570力肯","110/07/14","新光",1,19,-18
"26555","1570力肯","110/07/14","玉山-高雄",7,0,7
"26556","1570力肯","110/07/14","(牛牛牛)亞-鑫豐",0,17,-17
"26557","1570力肯","110/07/14","臺銀-臺南",5,0,5
"26558","1570力肯","110/07/14","日盛-士林",0,10,-10
"26559","1570力肯","110/07/14","凱基-三峽",5,0,5
"26560","1570力肯","110/07/14","統一-員林",0,10,-10
"26561","1570力肯","110/07/14","元大-和平",5,0,5
"26562","1570力肯","110/07/14","國票-新莊",0,10,-10
"26563","1570力肯","110/07/14","合庫-三重",4,0,4
"26564","1570力肯","110/07/14","凱基-高美館",0,10,-10
"26565","1570力肯","110/07/14","瑞士信貸",4,0,4
"26566","1570力肯","110/07/14","元大-屏東民生",0,5,-5
"26567","1570力肯","110/07/14","統一-三多",4,0,4
"26568","1570力肯","110/07/14","元大-古亭",0,5,-5
"26569","1570力肯","110/07/14","華南永昌-古亭",4,0,4
"26570","1570力肯","110/07/14","日盛-木柵",0,4,-4
"26571","1570力肯","110/07/14","元大-高雄",3,0,3
"26572","1570力肯","110/07/14","大昌",0,4,-4
"26573","1570力肯","110/07/14","兆豐-忠孝",2,0,2
"26574","1570力肯","110/07/14","群益金鼎-東大",0,4,-4
"26575","1570力肯","110/07/14","富邦-陽明",2,0,2
"26576","1570力肯","110/07/14","凱基-台北",0,4,-4
"26577","1570力肯","110/07/14","元大-松山",2,0,2
"26578","1570力肯","110/07/14","元大-板橋",0,4,-4
"26579","1570力肯","110/07/14","元大-忠孝",2,0,2
"26580","1570力肯","110/07/14","第一金-中山",0,3,-3
"26581","2929淘帝","110/07/14","華南永昌-林口",60,0,60
"26582","2929淘帝","110/07/14","群益金鼎",25,540,-515
"26583","2929淘帝","110/07/14","美林",87,31,56
"26584","2929淘帝","110/07/14","國泰-台南",1,30,-29
"26585","2929淘帝","110/07/14","元富-台南",40,0,40
"26586","2929淘帝","110/07/14","宏遠-桃園",0,20,-20
"26587","2929淘帝","110/07/14","元大-民生",39,0,39
"26588","2929淘帝","110/07/14","摩根大通",11,31,-20
"26589","2929淘帝","110/07/14","臺銀-鳳山",34,0,34
"26590","2929淘帝","110/07/14","台新-建北",5,20,-15
"26591","2929淘帝","110/07/14","合庫-高雄",34,1,33
"26592","2929淘帝","110/07/14","新光",1,16,-15
"26593","2929淘帝","110/07/14","華南永昌-鶯歌",28,0,28
"26594","2929淘帝","110/07/14","玉山-板橋",0,15,-15
"26595","2929淘帝","110/07/14","永興",25,0,25
"26596","2929淘帝","110/07/14","凱基-羅東",0,15,-15
"26597","2929淘帝","110/07/14","元大-新盛",25,1,24
"26598","2929淘帝","110/07/14","元大-頭份",0,15,-15
"26599","2929淘帝","110/07/14","日盛-南京",23,0,23
"26600","2929淘帝","110/07/14","第一金-台南",0,13,-13
"26601","2929淘帝","110/07/14","日茂",20,0,20
"26602","2929淘帝","110/07/14","富邦-基隆",0,12,-12
"26603","2929淘帝","110/07/14","台新-台中",20,0,20
"26604","2929淘帝","110/07/14","日茂-南投",1,12,-11
"26605","2929淘帝","110/07/14","華南永昌",20,0,20
"26606","2929淘帝","110/07/14","元大-豐原站前",0,11,-11
"26607","2929淘帝","110/07/14","福勝",15,0,15
"26608","2929淘帝","110/07/14","玉山-士林",0,10,-10
"26609","2929淘帝","110/07/14","富邦-南屯",15,0,15
"26610","2929淘帝","110/07/14","富邦-台北",0,10,-10
"26611","5410國眾","110/07/14","兆豐-城中",35,0,35
"26612","5410國眾","110/07/14","瑞士信貸",0,29,-29
"26613","5410國眾","110/07/14","新光",21,1,20
"26614","5410國眾","110/07/14","國泰-板橋",1,30,-29
"26615","5410國眾","110/07/14","國泰-敦南",21,1,20
"26616","5410國眾","110/07/14","日盛-高雄",0,20,-20
"26617","5410國眾","110/07/14","國泰-台中",20,1,19
"26618","5410國眾","110/07/14","台新-左楠",1,20,-19
"26619","5410國眾","110/07/14","元大-崇德",19,0,19
"26620","5410國眾","110/07/14","元富-大昌",1,18,-17
"26621","5410國眾","110/07/14","土銀-士林",18,0,18
"26622","5410國眾","110/07/14","富邦-建國",0,15,-15
"26623","5410國眾","110/07/14","元大-新盛",20,2,18
"26624","5410國眾","110/07/14","元富-嘉義",0,12,-12
"26625","5410國眾","110/07/14","兆豐-高雄",15,0,15
"26626","5410國眾","110/07/14","永全-南崁",0,12,-12
"26627","5410國眾","110/07/14","宏遠-中和",10,0,10
"26628","5410國眾","110/07/14","元大-員林",0,11,-11
"26629","5410國眾","110/07/14","新光-桃園",10,0,10
"26630","5410國眾","110/07/14","高橋",0,10,-10
"26631","5410國眾","110/07/14","國泰-台南",10,0,10
"26632","5410國眾","110/07/14","永興",0,10,-10
"26633","5410國眾","110/07/14","元大-復北",10,0,10
"26634","5410國眾","110/07/14","華南永昌-三重",0,10,-10
"26635","5410國眾","110/07/14","元大-竹科",8,0,8
"26636","5410國眾","110/07/14","元大-苑裡",0,7,-7
"26637","5410國眾","110/07/14","台新-新營",6,0,6
"26638","5410國眾","110/07/14","港商野村",0,6,-6
"26639","5410國眾","110/07/14","日盛-士林",5,0,5
"26640","5410國眾","110/07/14","摩根大通",5,11,-6
"26641","2841台開","110/07/14","凱基-文心",73,0,73
"26642","2841台開","110/07/14","國泰-敦南",0,50,-50
"26643","2841台開","110/07/14","元富-潮州",30,0,30
"26644","2841台開","110/07/14","凱基-中壢",0,40,-40
"26645","2841台開","110/07/14","第一金-台中",20,0,20
"26646","2841台開","110/07/14","統一-新竹",0,24,-24
"26647","2841台開","110/07/14","華南永昌-新莊",20,0,20
"26648","2841台開","110/07/14","元富-草屯",0,20,-20
"26649","2841台開","110/07/14","永豐金-豐原",20,0,20
"26650","2841台開","110/07/14","台新-台南",0,20,-20
"26651","2841台開","110/07/14","國泰-館前",15,0,15
"26652","2841台開","110/07/14","永豐金-敦南",45,63,-18
"26653","2841台開","110/07/14","群益金鼎-基隆",12,0,12
"26654","2841台開","110/07/14","國票-北高雄",0,13,-13
"26655","2841台開","110/07/14","日盛-信義",10,0,10
"26656","2841台開","110/07/14","凱基-松山",0,10,-10
"26657","2841台開","110/07/14","台新-台中",10,0,10
"26658","2841台開","110/07/14","元大證券",0,10,-10
"26659","2841台開","110/07/14","新光",10,1,9
"26660","2841台開","110/07/14","元大-中壢",0,10,-10
"26661","2841台開","110/07/14","凱基-新店",8,0,8
"26662","2841台開","110/07/14","富邦-陽明",1,10,-9
"26663","2841台開","110/07/14","元大-斗信",7,0,7
"26664","2841台開","110/07/14","富邦-建國",0,9,-9
"26665","2841台開","110/07/14","元大-三重",6,0,6
"26666","2841台開","110/07/14","富邦-台南",0,8,-8
"26667","2841台開","110/07/14","永豐金-中和",6,0,6
"26668","2841台開","110/07/14","康和-澎湖",0,7,-7
"26669","2841台開","110/07/14","元富-成功",5,0,5
"26670","2841台開","110/07/14","日盛-斗六",0,6,-6
"26671","6207雷科","110/07/14","群益金鼎-台北",60,0,60
"26672","6207雷科","110/07/14","新加坡商瑞銀",10,56,-46
"26673","6207雷科","110/07/14","台新-高雄",43,3,40
"26674","6207雷科","110/07/14","國票-中和",0,41,-41
"26675","6207雷科","110/07/14","元大-高雄",19,0,19
"26676","6207雷科","110/07/14","元大-復北",0,33,-33
"26677","6207雷科","110/07/14","福勝",15,0,15
"26678","6207雷科","110/07/14","光和-和美",0,20,-20
"26679","6207雷科","110/07/14","群益金鼎-中山",15,0,15
"26680","6207雷科","110/07/14","群益金鼎-丹鳳",0,20,-20
"26681","6207雷科","110/07/14","元大-林園",15,0,15
"26682","6207雷科","110/07/14","第一金-路竹",0,10,-10
"26683","6207雷科","110/07/14","新光",12,0,12
"26684","6207雷科","110/07/14","元大-歸仁",0,10,-10
"26685","6207雷科","110/07/14","元大-大天母",10,0,10
"26686","6207雷科","110/07/14","宏遠-館前",0,9,-9
"26687","6207雷科","110/07/14","永豐金-忠孝",9,0,9
"26688","6207雷科","110/07/14","凱基-台北",12,20,-8
"26689","6207雷科","110/07/14","永豐金-新店",7,0,7
"26690","6207雷科","110/07/14","美林",0,7,-7
"26691","6207雷科","110/07/14","玉山-嘉義",6,0,6
"26692","6207雷科","110/07/14","摩根大通",16,23,-7
"26693","6207雷科","110/07/14","元大-屏東",6,0,6
"26694","6207雷科","110/07/14","凱基-高雄",1,7,-6
"26695","6207雷科","110/07/14","凱基-大安",5,0,5
"26696","6207雷科","110/07/14","台中銀-豐原",0,5,-5
"26697","6207雷科","110/07/14","富邦-台南",5,0,5
"26698","6207雷科","110/07/14","元大-新竹經國",0,5,-5
"26699","6207雷科","110/07/14","元大-成功",5,0,5
"26700","6207雷科","110/07/14","光和-田中",0,4,-4
"26701","3679新至陞","110/07/14","凱基-台北",31,6,25
"26702","3679新至陞","110/07/14","群益金鼎-東大",0,15,-15
"26703","3679新至陞","110/07/14","華南永昌-新莊",10,0,10
"26704","3679新至陞","110/07/14","瑞士信貸",0,12,-12
"26705","3679新至陞","110/07/14","新加坡商瑞銀",11,3,8
"26706","3679新至陞","110/07/14","群益金鼎-永和",0,10,-10
"26707","3679新至陞","110/07/14","美商高盛",6,0,6
"26708","3679新至陞","110/07/14","元大-成功",5,15,-10
"26709","3679新至陞","110/07/14","第一金-中壢",6,0,6
"26710","3679新至陞","110/07/14","統一-板橋",1,10,-9
"26711","3679新至陞","110/07/14","(牛牛牛)亞-網路",4,0,4
"26712","3679新至陞","110/07/14","玉山-左營",0,5,-5
"26713","3679新至陞","110/07/14","元大-六合",3,0,3
"26714","3679新至陞","110/07/14","群益金鼎-三民",0,4,-4
"26715","3679新至陞","110/07/14","合庫-自強",2,0,2
"26716","3679新至陞","110/07/14","富邦-宜蘭",0,4,-4
"26717","3679新至陞","110/07/14","高橋-內壢",2,0,2
"26718","3679新至陞","110/07/14","永豐金-苓雅",0,3,-3
"26719","3679新至陞","110/07/14","台中銀-員林",2,0,2
"26720","3679新至陞","110/07/14","摩根大通",5,7,-2
"26721","3679新至陞","110/07/14","凱基-高美館",2,0,2
"26722","3679新至陞","110/07/14","元大-板橋三民",0,2,-2
"26723","3679新至陞","110/07/14","元大-福營",2,0,2
"26724","3679新至陞","110/07/14","宏遠-中和",0,1,-1
"26725","3679新至陞","110/07/14","永豐金-松山",2,0,2
"26726","3679新至陞","110/07/14","元富-佳里",0,1,-1
"26727","3679新至陞","110/07/14","永豐金-萬盛",2,0,2
"26728","3679新至陞","110/07/14","(牛牛牛)亞-鑫豐",0,1,-1
"26729","3679新至陞","110/07/14","元富-松德",1,0,1
"26730","3679新至陞","110/07/14","中國信託-中壢",0,1,-1
"26731","2727王品","110/07/14","富邦-左營",102,1,101
"26732","2727王品","110/07/14","統一-城中",100,234,-134
"26733","2727王品","110/07/14","國泰-板橋",105,11,94
"26734","2727王品","110/07/14","富邦-台北",1,125,-124
"26735","2727王品","110/07/14","港商野村",149,72,77
"26736","2727王品","110/07/14","台灣摩根士丹利",1,48,-47
"26737","2727王品","110/07/14","合庫-台中",66,2,64
"26738","2727王品","110/07/14","國票-新莊",0,40,-40
"26739","2727王品","110/07/14","臺銀-金山",63,8,55
"26740","2727王品","110/07/14","永豐金-忠孝",2,39,-37
"26741","2727王品","110/07/14","摩根大通",83,39,44
"26742","2727王品","110/07/14","富邦-彰化",1,34,-33
"26743","2727王品","110/07/14","凱基-台北",84,42,42
"26744","2727王品","110/07/14","康和-高雄",0,30,-30
"26745","2727王品","110/07/14","土銀-台中",35,1,34
"26746","2727王品","110/07/14","安泰",0,26,-26
"26747","2727王品","110/07/14","華南永昌-麻豆",32,1,31
"26748","2727王品","110/07/14","富邦-新竹華信",0,21,-21
"26749","2727王品","110/07/14","元大證券",85,55,30
"26750","2727王品","110/07/14","元大-南崁",1,22,-21
"26751","2727王品","110/07/14","新加坡商瑞銀",40,15,25
"26752","2727王品","110/07/14","彰銀-台中",0,18,-18
"26753","2727王品","110/07/14","日盛-八德",19,0,19
"26754","2727王品","110/07/14","元富-同大",2,20,-18
"26755","2727王品","110/07/14","統一",35,17,18
"26756","2727王品","110/07/14","玉山-嘉義",1,17,-16
"26757","2727王品","110/07/14","元富-大昌",18,1,17
"26758","2727王品","110/07/14","國泰-館前",4,20,-16
"26759","2727王品","110/07/14","玉山-板橋",15,1,14
"26760","2727王品","110/07/14","第一金-嘉義",1,13,-12
"26761","1570力肯","110/07/14","國票-北高雄",68,0,68
"26762","1570力肯","110/07/14","摩根大通",0,21,-21
"26763","1570力肯","110/07/14","日盛-八德",30,1,29
"26764","1570力肯","110/07/14","新光",1,19,-18
"26765","1570力肯","110/07/14","玉山-高雄",7,0,7
"26766","1570力肯","110/07/14","(牛牛牛)亞-鑫豐",0,17,-17
"26767","1570力肯","110/07/14","臺銀-臺南",5,0,5
"26768","1570力肯","110/07/14","日盛-士林",0,10,-10
"26769","1570力肯","110/07/14","凱基-三峽",5,0,5
"26770","1570力肯","110/07/14","統一-員林",0,10,-10
"26771","1570力肯","110/07/14","元大-和平",5,0,5
"26772","1570力肯","110/07/14","國票-新莊",0,10,-10
"26773","1570力肯","110/07/14","合庫-三重",4,0,4
"26774","1570力肯","110/07/14","凱基-高美館",0,10,-10
"26775","1570力肯","110/07/14","瑞士信貸",4,0,4
"26776","1570力肯","110/07/14","元大-屏東民生",0,5,-5
"26777","1570力肯","110/07/14","統一-三多",4,0,4
"26778","1570力肯","110/07/14","元大-古亭",0,5,-5
"26779","1570力肯","110/07/14","華南永昌-古亭",4,0,4
"26780","1570力肯","110/07/14","日盛-木柵",0,4,-4
"26781","1570力肯","110/07/14","元大-高雄",3,0,3
"26782","1570力肯","110/07/14","大昌",0,4,-4
"26783","1570力肯","110/07/14","兆豐-忠孝",2,0,2
"26784","1570力肯","110/07/14","群益金鼎-東大",0,4,-4
"26785","1570力肯","110/07/14","富邦-陽明",2,0,2
"26786","1570力肯","110/07/14","凱基-台北",0,4,-4
"26787","1570力肯","110/07/14","元大-松山",2,0,2
"26788","1570力肯","110/07/14","元大-板橋",0,4,-4
"26789","1570力肯","110/07/14","元大-忠孝",2,0,2
"26790","1570力肯","110/07/14","第一金-中山",0,3,-3
"26791","6180橘子","110/07/14","新加坡商瑞銀",84,28,56
"26792","6180橘子","110/07/14","凱基-台北",4,37,-33
"26793","6180橘子","110/07/14","日盛-信義",29,1,28
"26794","6180橘子","110/07/14","玉山-台南",1,22,-21
"26795","6180橘子","110/07/14","豐農",28,4,24
"26796","6180橘子","110/07/14","日盛-新竹",1,21,-20
"26797","6180橘子","110/07/14","新光-新竹",24,1,23
"26798","6180橘子","110/07/14","元富-潮州",0,19,-19
"26799","6180橘子","110/07/14","華南永昌-高雄",20,0,20
"26800","6180橘子","110/07/14","元大-信義",0,17,-17
"26801","6180橘子","110/07/14","元大-羅東",20,0,20
"26802","6180橘子","110/07/14","台灣企銀-台中",1,16,-15
"26803","6180橘子","110/07/14","元大-台中中港",20,0,20
"26804","6180橘子","110/07/14","元大-北港",0,15,-15
"26805","6180橘子","110/07/14","富邦-嘉義",24,5,19
"26806","6180橘子","110/07/14","富邦-高雄",0,14,-14
"26807","6180橘子","110/07/14","富邦-仁愛",15,0,15
"26808","6180橘子","110/07/14","兆豐-埔墘",0,13,-13
"26809","6180橘子","110/07/14","國票-九鼎",13,0,13
"26810","6180橘子","110/07/14","第一金-中山",0,10,-10
"26811","6180橘子","110/07/14","日盛-木柵",12,0,12
"26812","6180橘子","110/07/14","元大-彰化民生",0,10,-10
"26813","6180橘子","110/07/14","元大-成功",10,0,10
"26814","6180橘子","110/07/14","福勝",1,10,-9
"26815","6180橘子","110/07/14","港商野村",10,2,8
"26816","6180橘子","110/07/14","群益金鼎-丹鳳",1,10,-9
"26817","6180橘子","110/07/14","玉山-左營",8,0,8
"26818","6180橘子","110/07/14","群益金鼎-板橋",0,8,-8
"26819","6180橘子","110/07/14","富邦-陽明",16,8,8
"26820","6180橘子","110/07/14","合庫-鳳山",0,7,-7
"26821","2390云辰","110/07/14","摩根大通",995,198,797
"26822","2390云辰","110/07/14","新加坡商瑞銀",28,399,-371
"26823","2390云辰","110/07/14","美林",383,22,361
"26824","2390云辰","110/07/14","凱基-新豐",3,198,-195
"26825","2390云辰","110/07/14","台灣摩根士丹利",684,358,326
"26826","2390云辰","110/07/14","元大-士林",1,152,-151
"26827","2390云辰","110/07/14","凱基-台北",656,402,254
"26828","2390云辰","110/07/14","元大-竹山",80,181,-101
"26829","2390云辰","110/07/14","日盛-和美",110,5,105
"26830","2390云辰","110/07/14","群益金鼎-開元",19,95,-76
"26831","2390云辰","110/07/14","元大-天母",72,0,72
"26832","2390云辰","110/07/14","新光",77,150,-73
"26833","2390云辰","110/07/14","永豐金-松山",57,0,57
"26834","2390云辰","110/07/14","元富-高雄",0,71,-71
"26835","2390云辰","110/07/14","統一-屏東",53,0,53
"26836","2390云辰","110/07/14","元大-土城學府",130,201,-71
"26837","2390云辰","110/07/14","港商野村",486,450,36
"26838","2390云辰","110/07/14","元大-善化",12,76,-64
"26839","2390云辰","110/07/14","致和-崇德",30,0,30
"26840","2390云辰","110/07/14","華南永昌-岡山",23,81,-58
"26841","2390云辰","110/07/14","富邦-台北",40,14,26
"26842","2390云辰","110/07/14","群益金鼎-大興",82,125,-43
"26843","2390云辰","110/07/14","台新-高雄",38,13,25
"26844","2390云辰","110/07/14","大慶-中壢",0,41,-41
"26845","2390云辰","110/07/14","富邦-板橋",32,7,25
"26846","2390云辰","110/07/14","玉山-板橋",6,47,-41
"26847","2390云辰","110/07/14","陽信-石牌",24,0,24
"26848","2390云辰","110/07/14","富邦-台東",2,42,-40
"26849","2390云辰","110/07/14","凱基-屏東",32,8,24
"26850","2390云辰","110/07/14","元大-新營",3,42,-39
"26851","2363矽統","110/07/14","台灣摩根士丹利",463,0,463
"26852","2363矽統","110/07/14","新加坡商瑞銀",568,1321,-753
"26853","2363矽統","110/07/14","台新證券",750,342,408
"26854","2363矽統","110/07/14","瑞士信貸",149,864,-715
"26855","2363矽統","110/07/14","玉山-台中",363,51,312
"26856","2363矽統","110/07/14","台新-屏東",115,380,-265
"26857","2363矽統","110/07/14","元大-斗六",223,25,198
"26858","2363矽統","110/07/14","永豐金證券",16,265,-249
"26859","2363矽統","110/07/14","華南永昌-朴子",208,38,170
"26860","2363矽統","110/07/14","美林",462,701,-239
"26861","2363矽統","110/07/14","元富-西松",169,12,157
"26862","2363矽統","110/07/14","宏遠-桃園",269,500,-231
"26863","2363矽統","110/07/14","永豐金-大園",146,6,140
"26864","2363矽統","110/07/14","凱基-竹北",36,254,-218
"26865","2363矽統","110/07/14","土銀-和平",134,0,134
"26866","2363矽統","110/07/14","港商法國興業",0,214,-214
"26867","2363矽統","110/07/14","富邦-新營",130,13,117
"26868","2363矽統","110/07/14","港商野村",835,1044,-209
"26869","2363矽統","110/07/14","元富-成功",118,11,107
"26870","2363矽統","110/07/14","北城證券",212,411,-199
"26871","2363矽統","110/07/14","元富-烏日",121,18,103
"26872","2363矽統","110/07/14","(牛牛牛)亞-鑫豐",51,241,-190
"26873","2363矽統","110/07/14","日盛-二林",120,18,102
"26874","2363矽統","110/07/14","國票-博愛",24,213,-189
"26875","2363矽統","110/07/14","兆豐-忠孝",98,2,96
"26876","2363矽統","110/07/14","大慶-蘆洲",134,316,-182
"26877","2363矽統","110/07/14","大慶-楊梅",92,3,89
"26878","2363矽統","110/07/14","彰銀-台中",15,193,-178
"26879","2363矽統","110/07/14","元富-三重",120,33,87
"26880","2363矽統","110/07/14","日盛-和美",18,185,-167
"26881","8112至上","110/07/14","新加坡商瑞銀",223,17,206
"26882","8112至上","110/07/14","瑞士信貸",8,170,-162
"26883","8112至上","110/07/14","摩根大通",285,129,156
"26884","8112至上","110/07/14","美林",55,202,-147
"26885","8112至上","110/07/14","花旗環球",124,0,124
"26886","8112至上","110/07/14","凱基-台北",325,436,-111
"26887","8112至上","110/07/14","兆豐-公益",117,4,113
"26888","8112至上","110/07/14","台中銀-台北",0,98,-98
"26889","8112至上","110/07/14","香港上海匯豐",111,0,111
"26890","8112至上","110/07/14","玉山-台大",17,107,-90
"26891","8112至上","110/07/14","永豐金-內湖",117,21,96
"26892","8112至上","110/07/14","康和-內湖",1,90,-89
"26893","8112至上","110/07/14","台灣摩根士丹利",108,16,92
"26894","8112至上","110/07/14","港商野村",21,84,-63
"26895","8112至上","110/07/14","元大-東蘆",77,0,77
"26896","8112至上","110/07/14","兆豐-北高雄",1,60,-59
"26897","8112至上","110/07/14","新光",108,48,60
"26898","8112至上","110/07/14","群益金鼎-海山",1,52,-51
"26899","8112至上","110/07/14","大慶-蘆洲",59,0,59
"26900","8112至上","110/07/14","群益金鼎-大安",0,50,-50
"26901","8112至上","110/07/14","華南永昌-台中",56,3,53
"26902","8112至上","110/07/14","富邦-仁愛",2,49,-47
"26903","8112至上","110/07/14","土銀-嘉義",52,2,50
"26904","8112至上","110/07/14","元大-金華",0,42,-42
"26905","8112至上","110/07/14","美商高盛",40,0,40
"26906","8112至上","110/07/14","元大-內湖",4,43,-39
"26907","8112至上","110/07/14","臺銀",63,29,34
"26908","8112至上","110/07/14","第一金-華江",2,37,-35
"26909","8112至上","110/07/14","元富-嘉義",31,0,31
"26910","8112至上","110/07/14","永豐金-苓雅",2,34,-32
"26911","1570力肯","110/07/14","國票-北高雄",68,0,68
"26912","1570力肯","110/07/14","摩根大通",0,21,-21
"26913","1570力肯","110/07/14","日盛-八德",30,1,29
"26914","1570力肯","110/07/14","新光",1,19,-18
"26915","1570力肯","110/07/14","玉山-高雄",7,0,7
"26916","1570力肯","110/07/14","(牛牛牛)亞-鑫豐",0,17,-17
"26917","1570力肯","110/07/14","臺銀-臺南",5,0,5
"26918","1570力肯","110/07/14","日盛-士林",0,10,-10
"26919","1570力肯","110/07/14","凱基-三峽",5,0,5
"26920","1570力肯","110/07/14","統一-員林",0,10,-10
"26921","1570力肯","110/07/14","元大-和平",5,0,5
"26922","1570力肯","110/07/14","國票-新莊",0,10,-10
"26923","1570力肯","110/07/14","合庫-三重",4,0,4
"26924","1570力肯","110/07/14","凱基-高美館",0,10,-10
"26925","1570力肯","110/07/14","瑞士信貸",4,0,4
"26926","1570力肯","110/07/14","元大-屏東民生",0,5,-5
"26927","1570力肯","110/07/14","統一-三多",4,0,4
"26928","1570力肯","110/07/14","元大-古亭",0,5,-5
"26929","1570力肯","110/07/14","華南永昌-古亭",4,0,4
"26930","1570力肯","110/07/14","日盛-木柵",0,4,-4
"26931","1570力肯","110/07/14","元大-高雄",3,0,3
"26932","1570力肯","110/07/14","大昌",0,4,-4
"26933","1570力肯","110/07/14","兆豐-忠孝",2,0,2
"26934","1570力肯","110/07/14","群益金鼎-東大",0,4,-4
"26935","1570力肯","110/07/14","富邦-陽明",2,0,2
"26936","1570力肯","110/07/14","凱基-台北",0,4,-4
"26937","1570力肯","110/07/14","元大-松山",2,0,2
"26938","1570力肯","110/07/14","元大-板橋",0,4,-4
"26939","1570力肯","110/07/14","元大-忠孝",2,0,2
"26940","1570力肯","110/07/14","第一金-中山",0,3,-3
"26941","2929淘帝","110/07/14","華南永昌-林口",60,0,60
"26942","2929淘帝","110/07/14","群益金鼎",25,540,-515
"26943","2929淘帝","110/07/14","美林",87,31,56
"26944","2929淘帝","110/07/14","國泰-台南",1,30,-29
"26945","2929淘帝","110/07/14","元富-台南",40,0,40
"26946","2929淘帝","110/07/14","宏遠-桃園",0,20,-20
"26947","2929淘帝","110/07/14","元大-民生",39,0,39
"26948","2929淘帝","110/07/14","摩根大通",11,31,-20
"26949","2929淘帝","110/07/14","臺銀-鳳山",34,0,34
"26950","2929淘帝","110/07/14","台新-建北",5,20,-15
"26951","2929淘帝","110/07/14","合庫-高雄",34,1,33
"26952","2929淘帝","110/07/14","新光",1,16,-15
"26953","2929淘帝","110/07/14","華南永昌-鶯歌",28,0,28
"26954","2929淘帝","110/07/14","玉山-板橋",0,15,-15
"26955","2929淘帝","110/07/14","永興",25,0,25
"26956","2929淘帝","110/07/14","凱基-羅東",0,15,-15
"26957","2929淘帝","110/07/14","元大-新盛",25,1,24
"26958","2929淘帝","110/07/14","元大-頭份",0,15,-15
"26959","2929淘帝","110/07/14","日盛-南京",23,0,23
"26960","2929淘帝","110/07/14","第一金-台南",0,13,-13
"26961","2929淘帝","110/07/14","日茂",20,0,20
"26962","2929淘帝","110/07/14","富邦-基隆",0,12,-12
"26963","2929淘帝","110/07/14","台新-台中",20,0,20
"26964","2929淘帝","110/07/14","日茂-南投",1,12,-11
"26965","2929淘帝","110/07/14","華南永昌",20,0,20
"26966","2929淘帝","110/07/14","元大-豐原站前",0,11,-11
"26967","2929淘帝","110/07/14","福勝",15,0,15
"26968","2929淘帝","110/07/14","玉山-士林",0,10,-10
"26969","2929淘帝","110/07/14","富邦-南屯",15,0,15
"26970","2929淘帝","110/07/14","富邦-台北",0,10,-10
"26971","5410國眾","110/07/14","兆豐-城中",35,0,35
"26972","5410國眾","110/07/14","瑞士信貸",0,29,-29
"26973","5410國眾","110/07/14","新光",21,1,20
"26974","5410國眾","110/07/14","國泰-板橋",1,30,-29
"26975","5410國眾","110/07/14","國泰-敦南",21,1,20
"26976","5410國眾","110/07/14","日盛-高雄",0,20,-20
"26977","5410國眾","110/07/14","國泰-台中",20,1,19
"26978","5410國眾","110/07/14","台新-左楠",1,20,-19
"26979","5410國眾","110/07/14","元大-崇德",19,0,19
"26980","5410國眾","110/07/14","元富-大昌",1,18,-17
"26981","5410國眾","110/07/14","土銀-士林",18,0,18
"26982","5410國眾","110/07/14","富邦-建國",0,15,-15
"26983","5410國眾","110/07/14","元大-新盛",20,2,18
"26984","5410國眾","110/07/14","元富-嘉義",0,12,-12
"26985","5410國眾","110/07/14","兆豐-高雄",15,0,15
"26986","5410國眾","110/07/14","永全-南崁",0,12,-12
"26987","5410國眾","110/07/14","宏遠-中和",10,0,10
"26988","5410國眾","110/07/14","元大-員林",0,11,-11
"26989","5410國眾","110/07/14","新光-桃園",10,0,10
"26990","5410國眾","110/07/14","高橋",0,10,-10
"26991","5410國眾","110/07/14","國泰-台南",10,0,10
"26992","5410國眾","110/07/14","永興",0,10,-10
"26993","5410國眾","110/07/14","元大-復北",10,0,10
"26994","5410國眾","110/07/14","華南永昌-三重",0,10,-10
"26995","5410國眾","110/07/14","元大-竹科",8,0,8
"26996","5410國眾","110/07/14","元大-苑裡",0,7,-7
"26997","5410國眾","110/07/14","台新-新營",6,0,6
"26998","5410國眾","110/07/14","港商野村",0,6,-6
"26999","5410國眾","110/07/14","日盛-士林",5,0,5
"27000","5410國眾","110/07/14","摩根大通",5,11,-6
"27001","2841台開","110/07/14","凱基-文心",73,0,73
"27002","2841台開","110/07/14","國泰-敦南",0,50,-50
"27003","2841台開","110/07/14","元富-潮州",30,0,30
"27004","2841台開","110/07/14","凱基-中壢",0,40,-40
"27005","2841台開","110/07/14","第一金-台中",20,0,20
"27006","2841台開","110/07/14","統一-新竹",0,24,-24
"27007","2841台開","110/07/14","華南永昌-新莊",20,0,20
"27008","2841台開","110/07/14","元富-草屯",0,20,-20
"27009","2841台開","110/07/14","永豐金-豐原",20,0,20
"27010","2841台開","110/07/14","台新-台南",0,20,-20
"27011","2841台開","110/07/14","國泰-館前",15,0,15
"27012","2841台開","110/07/14","永豐金-敦南",45,63,-18
"27013","2841台開","110/07/14","群益金鼎-基隆",12,0,12
"27014","2841台開","110/07/14","國票-北高雄",0,13,-13
"27015","2841台開","110/07/14","日盛-信義",10,0,10
"27016","2841台開","110/07/14","凱基-松山",0,10,-10
"27017","2841台開","110/07/14","台新-台中",10,0,10
"27018","2841台開","110/07/14","元大證券",0,10,-10
"27019","2841台開","110/07/14","新光",10,1,9
"27020","2841台開","110/07/14","元大-中壢",0,10,-10
"27021","2841台開","110/07/14","凱基-新店",8,0,8
"27022","2841台開","110/07/14","富邦-陽明",1,10,-9
"27023","2841台開","110/07/14","元大-斗信",7,0,7
"27024","2841台開","110/07/14","富邦-建國",0,9,-9
"27025","2841台開","110/07/14","元大-三重",6,0,6
"27026","2841台開","110/07/14","富邦-台南",0,8,-8
"27027","2841台開","110/07/14","永豐金-中和",6,0,6
"27028","2841台開","110/07/14","康和-澎湖",0,7,-7
"27029","2841台開","110/07/14","元富-成功",5,0,5
"27030","2841台開","110/07/14","日盛-斗六",0,6,-6
"27031","6207雷科","110/07/14","群益金鼎-台北",60,0,60
"27032","6207雷科","110/07/14","新加坡商瑞銀",10,56,-46
"27033","6207雷科","110/07/14","台新-高雄",43,3,40
"27034","6207雷科","110/07/14","國票-中和",0,41,-41
"27035","6207雷科","110/07/14","元大-高雄",19,0,19
"27036","6207雷科","110/07/14","元大-復北",0,33,-33
"27037","6207雷科","110/07/14","福勝",15,0,15
"27038","6207雷科","110/07/14","光和-和美",0,20,-20
"27039","6207雷科","110/07/14","群益金鼎-中山",15,0,15
"27040","6207雷科","110/07/14","群益金鼎-丹鳳",0,20,-20
"27041","6207雷科","110/07/14","元大-林園",15,0,15
"27042","6207雷科","110/07/14","第一金-路竹",0,10,-10
"27043","6207雷科","110/07/14","新光",12,0,12
"27044","6207雷科","110/07/14","元大-歸仁",0,10,-10
"27045","6207雷科","110/07/14","元大-大天母",10,0,10
"27046","6207雷科","110/07/14","宏遠-館前",0,9,-9
"27047","6207雷科","110/07/14","永豐金-忠孝",9,0,9
"27048","6207雷科","110/07/14","凱基-台北",12,20,-8
"27049","6207雷科","110/07/14","永豐金-新店",7,0,7
"27050","6207雷科","110/07/14","美林",0,7,-7
"27051","6207雷科","110/07/14","玉山-嘉義",6,0,6
"27052","6207雷科","110/07/14","摩根大通",16,23,-7
"27053","6207雷科","110/07/14","元大-屏東",6,0,6
"27054","6207雷科","110/07/14","凱基-高雄",1,7,-6
"27055","6207雷科","110/07/14","凱基-大安",5,0,5
"27056","6207雷科","110/07/14","台中銀-豐原",0,5,-5
"27057","6207雷科","110/07/14","富邦-台南",5,0,5
"27058","6207雷科","110/07/14","元大-新竹經國",0,5,-5
"27059","6207雷科","110/07/14","元大-成功",5,0,5
"27060","6207雷科","110/07/14","光和-田中",0,4,-4
"27061","3679新至陞","110/07/14","凱基-台北",31,6,25
"27062","3679新至陞","110/07/14","群益金鼎-東大",0,15,-15
"27063","3679新至陞","110/07/14","華南永昌-新莊",10,0,10
"27064","3679新至陞","110/07/14","瑞士信貸",0,12,-12
"27065","3679新至陞","110/07/14","新加坡商瑞銀",11,3,8
"27066","3679新至陞","110/07/14","群益金鼎-永和",0,10,-10
"27067","3679新至陞","110/07/14","美商高盛",6,0,6
"27068","3679新至陞","110/07/14","元大-成功",5,15,-10
"27069","3679新至陞","110/07/14","第一金-中壢",6,0,6
"27070","3679新至陞","110/07/14","統一-板橋",1,10,-9
"27071","3679新至陞","110/07/14","(牛牛牛)亞-網路",4,0,4
"27072","3679新至陞","110/07/14","玉山-左營",0,5,-5
"27073","3679新至陞","110/07/14","元大-六合",3,0,3
"27074","3679新至陞","110/07/14","群益金鼎-三民",0,4,-4
"27075","3679新至陞","110/07/14","合庫-自強",2,0,2
"27076","3679新至陞","110/07/14","富邦-宜蘭",0,4,-4
"27077","3679新至陞","110/07/14","高橋-內壢",2,0,2
"27078","3679新至陞","110/07/14","永豐金-苓雅",0,3,-3
"27079","3679新至陞","110/07/14","台中銀-員林",2,0,2
"27080","3679新至陞","110/07/14","摩根大通",5,7,-2
"27081","3679新至陞","110/07/14","凱基-高美館",2,0,2
"27082","3679新至陞","110/07/14","元大-板橋三民",0,2,-2
"27083","3679新至陞","110/07/14","元大-福營",2,0,2
"27084","3679新至陞","110/07/14","宏遠-中和",0,1,-1
"27085","3679新至陞","110/07/14","永豐金-松山",2,0,2
"27086","3679新至陞","110/07/14","元富-佳里",0,1,-1
"27087","3679新至陞","110/07/14","永豐金-萬盛",2,0,2
"27088","3679新至陞","110/07/14","(牛牛牛)亞-鑫豐",0,1,-1
"27089","3679新至陞","110/07/14","元富-松德",1,0,1
"27090","3679新至陞","110/07/14","中國信託-中壢",0,1,-1
"27091","2727王品","110/07/14","富邦-左營",102,1,101
"27092","2727王品","110/07/14","統一-城中",100,234,-134
"27093","2727王品","110/07/14","國泰-板橋",105,11,94
"27094","2727王品","110/07/14","富邦-台北",1,125,-124
"27095","2727王品","110/07/14","港商野村",149,72,77
"27096","2727王品","110/07/14","台灣摩根士丹利",1,48,-47
"27097","2727王品","110/07/14","合庫-台中",66,2,64
"27098","2727王品","110/07/14","國票-新莊",0,40,-40
"27099","2727王品","110/07/14","臺銀-金山",63,8,55
"27100","2727王品","110/07/14","永豐金-忠孝",2,39,-37
"27101","2727王品","110/07/14","摩根大通",83,39,44
"27102","2727王品","110/07/14","富邦-彰化",1,34,-33
"27103","2727王品","110/07/14","凱基-台北",84,42,42
"27104","2727王品","110/07/14","康和-高雄",0,30,-30
"27105","2727王品","110/07/14","土銀-台中",35,1,34
"27106","2727王品","110/07/14","安泰",0,26,-26
"27107","2727王品","110/07/14","華南永昌-麻豆",32,1,31
"27108","2727王品","110/07/14","富邦-新竹華信",0,21,-21
"27109","2727王品","110/07/14","元大證券",85,55,30
"27110","2727王品","110/07/14","元大-南崁",1,22,-21
"27111","2727王品","110/07/14","新加坡商瑞銀",40,15,25
"27112","2727王品","110/07/14","彰銀-台中",0,18,-18
"27113","2727王品","110/07/14","日盛-八德",19,0,19
"27114","2727王品","110/07/14","元富-同大",2,20,-18
"27115","2727王品","110/07/14","統一",35,17,18
"27116","2727王品","110/07/14","玉山-嘉義",1,17,-16
"27117","2727王品","110/07/14","元富-大昌",18,1,17
"27118","2727王品","110/07/14","國泰-館前",4,20,-16
"27119","2727王品","110/07/14","玉山-板橋",15,1,14
"27120","2727王品","110/07/14","第一金-嘉義",1,13,-12
"27121","1570力肯","110/07/14","國票-北高雄",68,0,68
"27122","1570力肯","110/07/14","摩根大通",0,21,-21
"27123","1570力肯","110/07/14","日盛-八德",30,1,29
"27124","1570力肯","110/07/14","新光",1,19,-18
"27125","1570力肯","110/07/14","玉山-高雄",7,0,7
"27126","1570力肯","110/07/14","(牛牛牛)亞-鑫豐",0,17,-17
"27127","1570力肯","110/07/14","臺銀-臺南",5,0,5
"27128","1570力肯","110/07/14","日盛-士林",0,10,-10
"27129","1570力肯","110/07/14","凱基-三峽",5,0,5
"27130","1570力肯","110/07/14","統一-員林",0,10,-10
"27131","1570力肯","110/07/14","元大-和平",5,0,5
"27132","1570力肯","110/07/14","國票-新莊",0,10,-10
"27133","1570力肯","110/07/14","合庫-三重",4,0,4
"27134","1570力肯","110/07/14","凱基-高美館",0,10,-10
"27135","1570力肯","110/07/14","瑞士信貸",4,0,4
"27136","1570力肯","110/07/14","元大-屏東民生",0,5,-5
"27137","1570力肯","110/07/14","統一-三多",4,0,4
"27138","1570力肯","110/07/14","元大-古亭",0,5,-5
"27139","1570力肯","110/07/14","華南永昌-古亭",4,0,4
"27140","1570力肯","110/07/14","日盛-木柵",0,4,-4
"27141","1570力肯","110/07/14","元大-高雄",3,0,3
"27142","1570力肯","110/07/14","大昌",0,4,-4
"27143","1570力肯","110/07/14","兆豐-忠孝",2,0,2
"27144","1570力肯","110/07/14","群益金鼎-東大",0,4,-4
"27145","1570力肯","110/07/14","富邦-陽明",2,0,2
"27146","1570力肯","110/07/14","凱基-台北",0,4,-4
"27147","1570力肯","110/07/14","元大-松山",2,0,2
"27148","1570力肯","110/07/14","元大-板橋",0,4,-4
"27149","1570力肯","110/07/14","元大-忠孝",2,0,2
"27150","1570力肯","110/07/14","第一金-中山",0,3,-3
"27151","6180橘子","110/07/14","新加坡商瑞銀",84,28,56
"27152","6180橘子","110/07/14","凱基-台北",4,37,-33
"27153","6180橘子","110/07/14","日盛-信義",29,1,28
"27154","6180橘子","110/07/14","玉山-台南",1,22,-21
"27155","6180橘子","110/07/14","豐農",28,4,24
"27156","6180橘子","110/07/14","日盛-新竹",1,21,-20
"27157","6180橘子","110/07/14","新光-新竹",24,1,23
"27158","6180橘子","110/07/14","元富-潮州",0,19,-19
"27159","6180橘子","110/07/14","華南永昌-高雄",20,0,20
"27160","6180橘子","110/07/14","元大-信義",0,17,-17
"27161","6180橘子","110/07/14","元大-羅東",20,0,20
"27162","6180橘子","110/07/14","台灣企銀-台中",1,16,-15
"27163","6180橘子","110/07/14","元大-台中中港",20,0,20
"27164","6180橘子","110/07/14","元大-北港",0,15,-15
"27165","6180橘子","110/07/14","富邦-嘉義",24,5,19
"27166","6180橘子","110/07/14","富邦-高雄",0,14,-14
"27167","6180橘子","110/07/14","富邦-仁愛",15,0,15
"27168","6180橘子","110/07/14","兆豐-埔墘",0,13,-13
"27169","6180橘子","110/07/14","國票-九鼎",13,0,13
"27170","6180橘子","110/07/14","第一金-中山",0,10,-10
"27171","6180橘子","110/07/14","日盛-木柵",12,0,12
"27172","6180橘子","110/07/14","元大-彰化民生",0,10,-10
"27173","6180橘子","110/07/14","元大-成功",10,0,10
"27174","6180橘子","110/07/14","福勝",1,10,-9
"27175","6180橘子","110/07/14","港商野村",10,2,8
"27176","6180橘子","110/07/14","群益金鼎-丹鳳",1,10,-9
"27177","6180橘子","110/07/14","玉山-左營",8,0,8
"27178","6180橘子","110/07/14","群益金鼎-板橋",0,8,-8
"27179","6180橘子","110/07/14","富邦-陽明",16,8,8
"27180","6180橘子","110/07/14","合庫-鳳山",0,7,-7
"27181","2390云辰","110/07/14","摩根大通",995,198,797
"27182","2390云辰","110/07/14","新加坡商瑞銀",28,399,-371
"27183","2390云辰","110/07/14","美林",383,22,361
"27184","2390云辰","110/07/14","凱基-新豐",3,198,-195
"27185","2390云辰","110/07/14","台灣摩根士丹利",684,358,326
"27186","2390云辰","110/07/14","元大-士林",1,152,-151
"27187","2390云辰","110/07/14","凱基-台北",656,402,254
"27188","2390云辰","110/07/14","元大-竹山",80,181,-101
"27189","2390云辰","110/07/14","日盛-和美",110,5,105
"27190","2390云辰","110/07/14","群益金鼎-開元",19,95,-76
"27191","2390云辰","110/07/14","元大-天母",72,0,72
"27192","2390云辰","110/07/14","新光",77,150,-73
"27193","2390云辰","110/07/14","永豐金-松山",57,0,57
"27194","2390云辰","110/07/14","元富-高雄",0,71,-71
"27195","2390云辰","110/07/14","統一-屏東",53,0,53
"27196","2390云辰","110/07/14","元大-土城學府",130,201,-71
"27197","2390云辰","110/07/14","港商野村",486,450,36
"27198","2390云辰","110/07/14","元大-善化",12,76,-64
"27199","2390云辰","110/07/14","致和-崇德",30,0,30
"27200","2390云辰","110/07/14","華南永昌-岡山",23,81,-58
"27201","2390云辰","110/07/14","富邦-台北",40,14,26
"27202","2390云辰","110/07/14","群益金鼎-大興",82,125,-43
"27203","2390云辰","110/07/14","台新-高雄",38,13,25
"27204","2390云辰","110/07/14","大慶-中壢",0,41,-41
"27205","2390云辰","110/07/14","富邦-板橋",32,7,25
"27206","2390云辰","110/07/14","玉山-板橋",6,47,-41
"27207","2390云辰","110/07/14","陽信-石牌",24,0,24
"27208","2390云辰","110/07/14","富邦-台東",2,42,-40
"27209","2390云辰","110/07/14","凱基-屏東",32,8,24
"27210","2390云辰","110/07/14","元大-新營",3,42,-39
"27211","2363矽統","110/07/13","凱基-南崁",2133,63,2070
"27212","2363矽統","110/07/13","凱基-幸福",36,4048,-4012
"27213","2363矽統","110/07/13","國泰-敦南",2195,1617,578
"27214","2363矽統","110/07/13","統一",192,3325,-3133
"27215","2363矽統","110/07/13","中農",670,139,531
"27216","2363矽統","110/07/13","新加坡商瑞銀",1000,2747,-1747
"27217","2363矽統","110/07/13","康和-台中",638,154,484
"27218","2363矽統","110/07/13","凱基-台北",5359,6609,-1250
"27219","2363矽統","110/07/13","群益金鼎-三民",577,137,440
"27220","2363矽統","110/07/13","摩根大通",1930,2858,-928
"27221","2363矽統","110/07/13","台新-屏東",510,88,422
"27222","2363矽統","110/07/13","港商野村",960,1679,-719
"27223","2363矽統","110/07/13","德信-中正",455,67,388
"27224","2363矽統","110/07/13","兆豐-復興",25,705,-680
"27225","2363矽統","110/07/13","日盛-竹北",365,70,295
"27226","2363矽統","110/07/13","統一-仁愛",114,755,-641
"27227","2363矽統","110/07/13","元大-佳里",452,189,263
"27228","2363矽統","110/07/13","統一-敦南",29,638,-609
"27229","2363矽統","110/07/13","國票-博愛",296,38,258
"27230","2363矽統","110/07/13","統一-土城",100,704,-604
"27231","2363矽統","110/07/13","元大-萬華",340,95,245
"27232","2363矽統","110/07/13","統一-城中",116,676,-560
"27233","2363矽統","110/07/13","新光",1259,1031,228
"27234","2363矽統","110/07/13","永豐金證券",306,859,-553
"27235","2363矽統","110/07/13","元富-成功",323,96,227
"27236","2363矽統","110/07/13","元富",54,567,-513
"27237","2363矽統","110/07/13","豐農",228,23,205
"27238","2363矽統","110/07/13","瑞士信貸",202,666,-464
"27239","2363矽統","110/07/13","台灣企銀-岡山",186,4,182
"27240","2363矽統","110/07/13","永豐金-嘉義",67,468,-401
"27241","8112至上","110/07/13","摩根大通",688,296,392
"27242","8112至上","110/07/13","國票-中和",0,401,-401
"27243","8112至上","110/07/13","港商野村",344,145,199
"27244","8112至上","110/07/13","永豐金-板盛",0,205,-205
"27245","8112至上","110/07/13","兆豐-公益",195,5,190
"27246","8112至上","110/07/13","凱基-五股",43,155,-112
"27247","8112至上","110/07/13","台灣摩根士丹利",183,0,183
"27248","8112至上","110/07/13","凱基-市政",0,100,-100
"27249","8112至上","110/07/13","群益金鼎-敦南",153,2,151
"27250","8112至上","110/07/13","元大-大里德芳",1,92,-91
"27251","8112至上","110/07/13","臺銀-金山",146,26,120
"27252","8112至上","110/07/13","玉山-桃園",26,110,-84
"27253","8112至上","110/07/13","臺銀",133,19,114
"27254","8112至上","110/07/13","兆豐-天母",0,81,-81
"27255","8112至上","110/07/13","合庫-台中",115,6,109
"27256","8112至上","110/07/13","凱基-城中",3,84,-81
"27257","8112至上","110/07/13","亞東-板橋",134,26,108
"27258","8112至上","110/07/13","日盛-新莊",9,85,-76
"27259","8112至上","110/07/13","凱基-台北",414,326,88
"27260","8112至上","110/07/13","日盛-台中",2,64,-62
"27261","8112至上","110/07/13","新加坡商瑞銀",181,100,81
"27262","8112至上","110/07/13","日盛-中壢",3,64,-61
"27263","8112至上","110/07/13","國泰-敦南",108,31,77
"27264","8112至上","110/07/13","元大-台中",2,59,-57
"27265","8112至上","110/07/13","第一金-華江",77,4,73
"27266","8112至上","110/07/13","元大-雙和",7,64,-57
"27267","8112至上","110/07/13","永豐金-內湖",73,1,72
"27268","8112至上","110/07/13","元大-高雄",8,62,-54
"27269","8112至上","110/07/13","元大-永和",68,1,67
"27270","8112至上","110/07/13","元大-館前",2,55,-53
"27271","1570力肯","110/07/13","新光",115,11,104
"27272","1570力肯","110/07/13","元大-北三重",0,162,-162
"27273","1570力肯","110/07/13","群益金鼎-高雄",54,0,54
"27274","1570力肯","110/07/13","元大-大灣",0,25,-25
"27275","1570力肯","110/07/13","國票-新莊",22,0,22
"27276","1570力肯","110/07/13","永豐金-苓雅",0,22,-22
"27277","1570力肯","110/07/13","日盛-桃園",12,0,12
"27278","1570力肯","110/07/13","永豐金-永康",0,19,-19
"27279","1570力肯","110/07/13","元大-高雄",12,0,12
"27280","1570力肯","110/07/13","富邦-員林",0,15,-15
"27281","1570力肯","110/07/13","合庫-自強",11,0,11
"27282","1570力肯","110/07/13","凱基-台南",0,11,-11
"27283","1570力肯","110/07/13","摩根大通",26,15,11
"27284","1570力肯","110/07/13","日盛-竹北",0,10,-10
"27285","1570力肯","110/07/13","永豐金-中盛",11,0,11
"27286","1570力肯","110/07/13","國票-九鼎",0,10,-10
"27287","1570力肯","110/07/13","兆豐-台中港",10,0,10
"27288","1570力肯","110/07/13","凱基-桃園",0,10,-10
"27289","1570力肯","110/07/13","國泰-松江",9,0,9
"27290","1570力肯","110/07/13","凱基-新豐",0,10,-10
"27291","1570力肯","110/07/13","元大-新盛",9,0,9
"27292","1570力肯","110/07/13","元大-學甲",0,10,-10
"27293","1570力肯","110/07/13","元富-緯城",6,0,6
"27294","1570力肯","110/07/13","群益金鼎-東湖",1,10,-9
"27295","1570力肯","110/07/13","統一-三重",5,0,5
"27296","1570力肯","110/07/13","大昌",0,6,-6
"27297","1570力肯","110/07/13","元大-前金",5,0,5
"27298","1570力肯","110/07/13","元大-土城學府",0,6,-6
"27299","1570力肯","110/07/13","永豐金證券",5,0,5
"27300","1570力肯","110/07/13","統一",0,5,-5
"27301","2929淘帝","110/07/13","玉山-新竹",130,0,130
"27302","2929淘帝","110/07/13","美商高盛",0,177,-177
"27303","2929淘帝","110/07/13","臺銀-民權",60,0,60
"27304","2929淘帝","110/07/13","凱基-台北",6,80,-74
"27305","2929淘帝","110/07/13","新百王",31,0,31
"27306","2929淘帝","110/07/13","元富-大裕",0,49,-49
"27307","2929淘帝","110/07/13","日盛-園區",30,0,30
"27308","2929淘帝","110/07/13","國泰-館前",3,51,-48
"27309","2929淘帝","110/07/13","元大-南投",31,1,30
"27310","2929淘帝","110/07/13","凱基-中壢",0,41,-41
"27311","2929淘帝","110/07/13","兆豐-忠孝",28,0,28
"27312","2929淘帝","110/07/13","港商野村",21,55,-34
"27313","2929淘帝","110/07/13","元大-民生",28,0,28
"27314","2929淘帝","110/07/13","華南永昌-南京",2,34,-32
"27315","2929淘帝","110/07/13","合庫-高雄",27,0,27
"27316","2929淘帝","110/07/13","群益金鼎-土城",0,30,-30
"27317","2929淘帝","110/07/13","凱基-豐中",27,0,27
"27318","2929淘帝","110/07/13","富邦-南屯",0,22,-22
"27319","2929淘帝","110/07/13","新光",21,4,17
"27320","2929淘帝","110/07/13","第一金-豐原",0,20,-20
"27321","2929淘帝","110/07/13","元大-天母",17,0,17
"27322","2929淘帝","110/07/13","元大-屏南",6,26,-20
"27323","2929淘帝","110/07/13","永興",14,0,14
"27324","2929淘帝","110/07/13","永豐金-敦南",1,21,-20
"27325","2929淘帝","110/07/13","富邦-台北",12,0,12
"27326","2929淘帝","110/07/13","凱基-三重",2,21,-19
"27327","2929淘帝","110/07/13","元大-永和",12,0,12
"27328","2929淘帝","110/07/13","富邦-仁愛",7,25,-18
"27329","2929淘帝","110/07/13","國票-天祥",11,0,11
"27330","2929淘帝","110/07/13","元大-北投",0,16,-16
"27331","5410國眾","110/07/13","兆豐-城中",274,0,274
"27332","5410國眾","110/07/13","元富-嘉義",0,103,-103
"27333","5410國眾","110/07/13","新光",50,4,46
"27334","5410國眾","110/07/13","凱基-台北",0,50,-50
"27335","5410國眾","110/07/13","國泰-台中",26,0,26
"27336","5410國眾","110/07/13","瑞士信貸",0,31,-31
"27337","5410國眾","110/07/13","新加坡商瑞銀",22,0,22
"27338","5410國眾","110/07/13","台新-新莊",0,27,-27
"27339","5410國眾","110/07/13","光和-嘉義",20,0,20
"27340","5410國眾","110/07/13","元大-汐止",0,20,-20
"27341","5410國眾","110/07/13","凱基-竹北",17,0,17
"27342","5410國眾","110/07/13","亞東-新竹",0,17,-17
"27343","5410國眾","110/07/13","新光-桃園",15,0,15
"27344","5410國眾","110/07/13","元大-南勢角",0,13,-13
"27345","5410國眾","110/07/13","凱基-台東",14,0,14
"27346","5410國眾","110/07/13","台新-台南",0,12,-12
"27347","5410國眾","110/07/13","富邦-竹北",11,0,11
"27348","5410國眾","110/07/13","中國信託",0,11,-11
"27349","5410國眾","110/07/13","元富-同大",10,0,10
"27350","5410國眾","110/07/13","華南永昌",0,11,-11
"27351","5410國眾","110/07/13","國泰-敦南",24,15,9
"27352","5410國眾","110/07/13","臺銀-臺南",0,10,-10
"27353","5410國眾","110/07/13","日盛-內湖",7,0,7
"27354","5410國眾","110/07/13","台灣企銀-民雄",0,10,-10
"27355","5410國眾","110/07/13","台新-左楠",7,0,7
"27356","5410國眾","110/07/13","高橋",0,10,-10
"27357","5410國眾","110/07/13","元大-新盛",18,12,6
"27358","5410國眾","110/07/13","康和-嘉義",0,10,-10
"27359","5410國眾","110/07/13","統一",5,0,5
"27360","5410國眾","110/07/13","凱基-基隆",0,10,-10
"27361","2841台開","110/07/13","中國信託-高雄",251,50,201
"27362","2841台開","110/07/13","兆豐-公益",0,177,-177
"27363","2841台開","110/07/13","日盛證券",210,13,197
"27364","2841台開","110/07/13","日進",0,152,-152
"27365","2841台開","110/07/13","第一金-台中",55,0,55
"27366","2841台開","110/07/13","港商野村",0,109,-109
"27367","2841台開","110/07/13","國泰-板橋",46,0,46
"27368","2841台開","110/07/13","日盛-信義",0,103,-103
"27369","2841台開","110/07/13","國泰-館前",48,3,45
"27370","2841台開","110/07/13","國泰-敦南",11,75,-64
"27371","2841台開","110/07/13","華南永昌-新莊",45,0,45
"27372","2841台開","110/07/13","永興",0,50,-50
"27373","2841台開","110/07/13","日盛-園區",42,0,42
"27374","2841台開","110/07/13","永豐金-敦南",61,104,-43
"27375","2841台開","110/07/13","台新證券",32,0,32
"27376","2841台開","110/07/13","富邦-台南",0,42,-42
"27377","2841台開","110/07/13","台新-高雄",32,2,30
"27378","2841台開","110/07/13","國票-安和",0,30,-30
"27379","2841台開","110/07/13","豐農",23,0,23
"27380","2841台開","110/07/13","元大-桃園",0,25,-25
"27381","2841台開","110/07/13","合庫-嘉義",20,0,20
"27382","2841台開","110/07/13","新光",8,32,-24
"27383","2841台開","110/07/13","華南永昌-高雄",20,0,20
"27384","2841台開","110/07/13","元大-仁愛",0,24,-24
"27385","2841台開","110/07/13","元大-樹林",16,0,16
"27386","2841台開","110/07/13","日盛-中和",0,20,-20
"27387","2841台開","110/07/13","第一金-華江",15,2,13
"27388","2841台開","110/07/13","元富",0,20,-20
"27389","2841台開","110/07/13","美商高盛",12,0,12
"27390","2841台開","110/07/13","富邦-宜蘭",0,20,-20
"27391","6207雷科","110/07/13","元大-高雄",121,0,121
"27392","6207雷科","110/07/13","華南永昌-朴子",1,60,-59
"27393","6207雷科","110/07/13","第一金-新興",20,0,20
"27394","6207雷科","110/07/13","元大-南海",0,36,-36
"27395","6207雷科","110/07/13","元富-三重",20,0,20
"27396","6207雷科","110/07/13","凱基-土城",0,35,-35
"27397","6207雷科","110/07/13","元大-林園",15,0,15
"27398","6207雷科","110/07/13","台灣企銀",0,20,-20
"27399","6207雷科","110/07/13","元大-金華",16,1,15
"27400","6207雷科","110/07/13","群益金鼎-丹鳳",0,20,-20
"27401","6207雷科","110/07/13","日盛證券",10,0,10
"27402","6207雷科","110/07/13","元大-博愛",0,17,-17
"27403","6207雷科","110/07/13","統一-台中",10,0,10
"27404","6207雷科","110/07/13","元大-北港",0,13,-13
"27405","6207雷科","110/07/13","群益金鼎-土城",10,0,10
"27406","6207雷科","110/07/13","新加坡商瑞銀",0,12,-12
"27407","6207雷科","110/07/13","群益金鼎-桃園",10,0,10
"27408","6207雷科","110/07/13","凱基-台北",4,16,-12
"27409","6207雷科","110/07/13","永豐金-新莊",10,0,10
"27410","6207雷科","110/07/13","日茂-埔里",0,11,-11
"27411","6207雷科","110/07/13","永豐金-新店",10,0,10
"27412","6207雷科","110/07/13","元大-莒光",0,11,-11
"27413","6207雷科","110/07/13","元大證券",9,0,9
"27414","6207雷科","110/07/13","統一-新竹",0,10,-10
"27415","6207雷科","110/07/13","日盛-木柵",9,1,8
"27416","6207雷科","110/07/13","元大-西螺",0,10,-10
"27417","6207雷科","110/07/13","兆豐-來福",8,0,8
"27418","6207雷科","110/07/13","康和-台中",0,8,-8
"27419","6207雷科","110/07/13","新光",7,0,7
"27420","6207雷科","110/07/13","兆豐-高雄",0,6,-6
"27421","3679新至陞","110/07/13","永豐金證券",50,0,50
"27422","3679新至陞","110/07/13","摩根大通",2,25,-23
"27423","3679新至陞","110/07/13","國泰-桃園",22,0,22
"27424","3679新至陞","110/07/13","元大-成功",0,22,-22
"27425","3679新至陞","110/07/13","台中銀-員林",11,0,11
"27426","3679新至陞","110/07/13","富邦-板橋",1,19,-18
"27427","3679新至陞","110/07/13","元大-文心興安",8,0,8
"27428","3679新至陞","110/07/13","日盛-新莊",0,10,-10
"27429","3679新至陞","110/07/13","美商高盛",6,0,6
"27430","3679新至陞","110/07/13","台新-台中",0,10,-10
"27431","3679新至陞","110/07/13","台新-高雄",6,0,6
"27432","3679新至陞","110/07/13","永豐金-新竹",0,8,-8
"27433","3679新至陞","110/07/13","凱基-台北",18,12,6
"27434","3679新至陞","110/07/13","瑞士信貸",12,19,-7
"27435","3679新至陞","110/07/13","日盛-復興",5,0,5
"27436","3679新至陞","110/07/13","統一-南京",0,7,-7
"27437","3679新至陞","110/07/13","(牛牛牛)亞-鑫豐",4,0,4
"27438","3679新至陞","110/07/13","凱基-新莊",0,7,-7
"27439","3679新至陞","110/07/13","元富-大昌",3,0,3
"27440","3679新至陞","110/07/13","新加坡商瑞銀",0,6,-6
"27441","3679新至陞","110/07/13","富邦-台北",3,0,3
"27442","3679新至陞","110/07/13","合庫-自強",0,5,-5
"27443","3679新至陞","110/07/13","日盛-樹林",2,0,2
"27444","3679新至陞","110/07/13","富邦-桃園",0,5,-5
"27445","3679新至陞","110/07/13","宏遠-光隆",2,0,2
"27446","3679新至陞","110/07/13","永豐金-潮州",0,4,-4
"27447","3679新至陞","110/07/13","美林",3,1,2
"27448","3679新至陞","110/07/13","臺銀-臺南",0,3,-3
"27449","3679新至陞","110/07/13","第一金-中壢",2,0,2
"27450","3679新至陞","110/07/13","元大-六合",0,3,-3
"27451","2727王品","110/07/13","富邦-台北",43,3,40
"27452","2727王品","110/07/13","台灣摩根士丹利",15,97,-82
"27453","2727王品","110/07/13","元大-基隆孝二",40,0,40
"27454","2727王品","110/07/13","玉山-台南",5,57,-52
"27455","2727王品","110/07/13","國票-新莊",40,1,39
"27456","2727王品","110/07/13","新加坡商瑞銀",0,48,-48
"27457","2727王品","110/07/13","第一金-豐原",66,42,24
"27458","2727王品","110/07/13","凱基-台北",41,77,-36
"27459","2727王品","110/07/13","永豐金-大園",34,10,24
"27460","2727王品","110/07/13","永豐金-永康",0,22,-22
"27461","2727王品","110/07/13","元大-北屯",22,0,22
"27462","2727王品","110/07/13","統一-台中",2,22,-20
"27463","2727王品","110/07/13","元大-東蘆",26,7,19
"27464","2727王品","110/07/13","國泰-台中",21,39,-18
"27465","2727王品","110/07/13","永豐金-萬盛",13,1,12
"27466","2727王品","110/07/13","合庫-彰化",3,20,-17
"27467","2727王品","110/07/13","日盛-嘉義",11,0,11
"27468","2727王品","110/07/13","港商野村",13,30,-17
"27469","2727王品","110/07/13","日盛-八德",11,0,11
"27470","2727王品","110/07/13","元大-楊梅",1,16,-15
"27471","2727王品","110/07/13","統一-竹南",11,0,11
"27472","2727王品","110/07/13","凱基-高美館",2,15,-13
"27473","2727王品","110/07/13","日盛-士林",12,2,10
"27474","2727王品","110/07/13","美商高盛",2,14,-12
"27475","2727王品","110/07/13","統一-敦南",10,0,10
"27476","2727王品","110/07/13","統一-平鎮",1,13,-12
"27477","2727王品","110/07/13","中國信託",15,5,10
"27478","2727王品","110/07/13","兆豐-台中港",4,16,-12
"27479","2727王品","110/07/13","兆豐-竹北",13,3,10
"27480","2727王品","110/07/13","凱基-八德",1,13,-12
"27481","1570力肯","110/07/13","新光",115,11,104
"27482","1570力肯","110/07/13","元大-北三重",0,162,-162
"27483","1570力肯","110/07/13","群益金鼎-高雄",54,0,54
"27484","1570力肯","110/07/13","元大-大灣",0,25,-25
"27485","1570力肯","110/07/13","國票-新莊",22,0,22
"27486","1570力肯","110/07/13","永豐金-苓雅",0,22,-22
"27487","1570力肯","110/07/13","日盛-桃園",12,0,12
"27488","1570力肯","110/07/13","永豐金-永康",0,19,-19
"27489","1570力肯","110/07/13","元大-高雄",12,0,12
"27490","1570力肯","110/07/13","富邦-員林",0,15,-15
"27491","1570力肯","110/07/13","合庫-自強",11,0,11
"27492","1570力肯","110/07/13","凱基-台南",0,11,-11
"27493","1570力肯","110/07/13","摩根大通",26,15,11
"27494","1570力肯","110/07/13","日盛-竹北",0,10,-10
"27495","1570力肯","110/07/13","永豐金-中盛",11,0,11
"27496","1570力肯","110/07/13","國票-九鼎",0,10,-10
"27497","1570力肯","110/07/13","兆豐-台中港",10,0,10
"27498","1570力肯","110/07/13","凱基-桃園",0,10,-10
"27499","1570力肯","110/07/13","國泰-松江",9,0,9
"27500","1570力肯","110/07/13","凱基-新豐",0,10,-10
"27501","1570力肯","110/07/13","元大-新盛",9,0,9
"27502","1570力肯","110/07/13","元大-學甲",0,10,-10
"27503","1570力肯","110/07/13","元富-緯城",6,0,6
"27504","1570力肯","110/07/13","群益金鼎-東湖",1,10,-9
"27505","1570力肯","110/07/13","統一-三重",5,0,5
"27506","1570力肯","110/07/13","大昌",0,6,-6
"27507","1570力肯","110/07/13","元大-前金",5,0,5
"27508","1570力肯","110/07/13","元大-土城學府",0,6,-6
"27509","1570力肯","110/07/13","永豐金證券",5,0,5
"27510","1570力肯","110/07/13","統一",0,5,-5
"27511","6180橘子","110/07/13","摩根大通",119,0,119
"27512","6180橘子","110/07/13","元大-崇德",2,61,-59
"27513","6180橘子","110/07/13","美商高盛",96,0,96
"27514","6180橘子","110/07/13","康和-台中",0,51,-51
"27515","6180橘子","110/07/13","新加坡商瑞銀",86,7,79
"27516","6180橘子","110/07/13","康和-台北",0,50,-50
"27517","6180橘子","110/07/13","元大-和平",40,0,40
"27518","6180橘子","110/07/13","元富-潮州",0,40,-40
"27519","6180橘子","110/07/13","凱基-台北",83,47,36
"27520","6180橘子","110/07/13","日盛-永康",0,26,-26
"27521","6180橘子","110/07/13","美林",39,5,34
"27522","6180橘子","110/07/13","永豐金-中正",0,24,-24
"27523","6180橘子","110/07/13","富邦-新竹華信",31,2,29
"27524","6180橘子","110/07/13","國泰-板橋",2,25,-23
"27525","6180橘子","110/07/13","統一-南京",21,0,21
"27526","6180橘子","110/07/13","日盛-大墩",0,20,-20
"27527","6180橘子","110/07/13","富邦-陽明",24,3,21
"27528","6180橘子","110/07/13","元大-草屯",13,32,-19
"27529","6180橘子","110/07/13","大昌-樹林",21,1,20
"27530","6180橘子","110/07/13","元富-林園",1,18,-17
"27531","6180橘子","110/07/13","花旗環球",19,0,19
"27532","6180橘子","110/07/13","新光-新竹",1,18,-17
"27533","6180橘子","110/07/13","華南永昌-台南",19,0,19
"27534","6180橘子","110/07/13","元大-土城永寧",0,17,-17
"27535","6180橘子","110/07/13","福勝",14,0,14
"27536","6180橘子","110/07/13","國泰-新莊",3,19,-16
"27537","6180橘子","110/07/13","富邦-嘉義",12,1,11
"27538","6180橘子","110/07/13","中國信託-永康",6,21,-15
"27539","6180橘子","110/07/13","元大-板橋三民",11,0,11
"27540","6180橘子","110/07/13","凱基-東港",1,15,-14
"27541","2390云辰","110/07/13","新加坡商瑞銀",562,75,487
"27542","2390云辰","110/07/13","大展-台南",0,532,-532
"27543","2390云辰","110/07/13","台灣摩根士丹利",330,155,175
"27544","2390云辰","110/07/13","凱基-台北",668,854,-186
"27545","2390云辰","110/07/13","兆豐-公益",126,25,101
"27546","2390云辰","110/07/13","凱基-三重",12,172,-160
"27547","2390云辰","110/07/13","元富-中港",100,2,98
"27548","2390云辰","110/07/13","兆豐-忠孝",4,161,-157
"27549","2390云辰","110/07/13","統一-新台中",106,9,97
"27550","2390云辰","110/07/13","元大-士林",19,170,-151
"27551","2390云辰","110/07/13","中國信託-松江",81,11,70
"27552","2390云辰","110/07/13","臺銀-新竹",14,117,-103
"27553","2390云辰","110/07/13","日盛-板橋",72,3,69
"27554","2390云辰","110/07/13","國票-台中",4,102,-98
"27555","2390云辰","110/07/13","日盛-和美",57,0,57
"27556","2390云辰","110/07/13","新光",147,232,-85
"27557","2390云辰","110/07/13","永豐金-桃園",88,36,52
"27558","2390云辰","110/07/13","致和-崇德",2,70,-68
"27559","2390云辰","110/07/13","玉山-士林",54,4,50
"27560","2390云辰","110/07/13","群益金鼎-屏東",2,70,-68
"27561","2390云辰","110/07/13","富邦-仁愛",56,6,50
"27562","2390云辰","110/07/13","元大-大里",35,98,-63
"27563","2390云辰","110/07/13","第一金-豐原",50,1,49
"27564","2390云辰","110/07/13","元大-萬華",35,94,-59
"27565","2390云辰","110/07/13","摩根大通",502,453,49
"27566","2390云辰","110/07/13","元富-吉利",2,60,-58
"27567","2390云辰","110/07/13","凱基-松山",61,13,48
"27568","2390云辰","110/07/13","兆豐-新竹",3,53,-50
"27569","2390云辰","110/07/13","大昌",64,22,42
"27570","2390云辰","110/07/13","富邦-嘉義",65,108,-43
"27571","2363矽統","110/07/13","凱基-南崁",2133,63,2070
"27572","2363矽統","110/07/13","凱基-幸福",36,4048,-4012
"27573","2363矽統","110/07/13","國泰-敦南",2195,1617,578
"27574","2363矽統","110/07/13","統一",192,3325,-3133
"27575","2363矽統","110/07/13","中農",670,139,531
"27576","2363矽統","110/07/13","新加坡商瑞銀",1000,2747,-1747
"27577","2363矽統","110/07/13","康和-台中",638,154,484
"27578","2363矽統","110/07/13","凱基-台北",5359,6609,-1250
"27579","2363矽統","110/07/13","群益金鼎-三民",577,137,440
"27580","2363矽統","110/07/13","摩根大通",1930,2858,-928
"27581","2363矽統","110/07/13","台新-屏東",510,88,422
"27582","2363矽統","110/07/13","港商野村",960,1679,-719
"27583","2363矽統","110/07/13","德信-中正",455,67,388
"27584","2363矽統","110/07/13","兆豐-復興",25,705,-680
"27585","2363矽統","110/07/13","日盛-竹北",365,70,295
"27586","2363矽統","110/07/13","統一-仁愛",114,755,-641
"27587","2363矽統","110/07/13","元大-佳里",452,189,263
"27588","2363矽統","110/07/13","統一-敦南",29,638,-609
"27589","2363矽統","110/07/13","國票-博愛",296,38,258
"27590","2363矽統","110/07/13","統一-土城",100,704,-604
"27591","2363矽統","110/07/13","元大-萬華",340,95,245
"27592","2363矽統","110/07/13","統一-城中",116,676,-560
"27593","2363矽統","110/07/13","新光",1259,1031,228
"27594","2363矽統","110/07/13","永豐金證券",306,859,-553
"27595","2363矽統","110/07/13","元富-成功",323,96,227
"27596","2363矽統","110/07/13","元富",54,567,-513
"27597","2363矽統","110/07/13","豐農",228,23,205
"27598","2363矽統","110/07/13","瑞士信貸",202,666,-464
"27599","2363矽統","110/07/13","台灣企銀-岡山",186,4,182
"27600","2363矽統","110/07/13","永豐金-嘉義",67,468,-401
"27601","8112至上","110/07/13","摩根大通",688,296,392
"27602","8112至上","110/07/13","國票-中和",0,401,-401
"27603","8112至上","110/07/13","港商野村",344,145,199
"27604","8112至上","110/07/13","永豐金-板盛",0,205,-205
"27605","8112至上","110/07/13","兆豐-公益",195,5,190
"27606","8112至上","110/07/13","凱基-五股",43,155,-112
"27607","8112至上","110/07/13","台灣摩根士丹利",183,0,183
"27608","8112至上","110/07/13","凱基-市政",0,100,-100
"27609","8112至上","110/07/13","群益金鼎-敦南",153,2,151
"27610","8112至上","110/07/13","元大-大里德芳",1,92,-91
"27611","8112至上","110/07/13","臺銀-金山",146,26,120
"27612","8112至上","110/07/13","玉山-桃園",26,110,-84
"27613","8112至上","110/07/13","臺銀",133,19,114
"27614","8112至上","110/07/13","兆豐-天母",0,81,-81
"27615","8112至上","110/07/13","合庫-台中",115,6,109
"27616","8112至上","110/07/13","凱基-城中",3,84,-81
"27617","8112至上","110/07/13","亞東-板橋",134,26,108
"27618","8112至上","110/07/13","日盛-新莊",9,85,-76
"27619","8112至上","110/07/13","凱基-台北",414,326,88
"27620","8112至上","110/07/13","日盛-台中",2,64,-62
"27621","8112至上","110/07/13","新加坡商瑞銀",181,100,81
"27622","8112至上","110/07/13","日盛-中壢",3,64,-61
"27623","8112至上","110/07/13","國泰-敦南",108,31,77
"27624","8112至上","110/07/13","元大-台中",2,59,-57
"27625","8112至上","110/07/13","第一金-華江",77,4,73
"27626","8112至上","110/07/13","元大-雙和",7,64,-57
"27627","8112至上","110/07/13","永豐金-內湖",73,1,72
"27628","8112至上","110/07/13","元大-高雄",8,62,-54
"27629","8112至上","110/07/13","元大-永和",68,1,67
"27630","8112至上","110/07/13","元大-館前",2,55,-53
"27631","1570力肯","110/07/13","新光",115,11,104
"27632","1570力肯","110/07/13","元大-北三重",0,162,-162
"27633","1570力肯","110/07/13","群益金鼎-高雄",54,0,54
"27634","1570力肯","110/07/13","元大-大灣",0,25,-25
"27635","1570力肯","110/07/13","國票-新莊",22,0,22
"27636","1570力肯","110/07/13","永豐金-苓雅",0,22,-22
"27637","1570力肯","110/07/13","日盛-桃園",12,0,12
"27638","1570力肯","110/07/13","永豐金-永康",0,19,-19
"27639","1570力肯","110/07/13","元大-高雄",12,0,12
"27640","1570力肯","110/07/13","富邦-員林",0,15,-15
"27641","1570力肯","110/07/13","合庫-自強",11,0,11
"27642","1570力肯","110/07/13","凱基-台南",0,11,-11
"27643","1570力肯","110/07/13","摩根大通",26,15,11
"27644","1570力肯","110/07/13","日盛-竹北",0,10,-10
"27645","1570力肯","110/07/13","永豐金-中盛",11,0,11
"27646","1570力肯","110/07/13","國票-九鼎",0,10,-10
"27647","1570力肯","110/07/13","兆豐-台中港",10,0,10
"27648","1570力肯","110/07/13","凱基-桃園",0,10,-10
"27649","1570力肯","110/07/13","國泰-松江",9,0,9
"27650","1570力肯","110/07/13","凱基-新豐",0,10,-10
"27651","1570力肯","110/07/13","元大-新盛",9,0,9
"27652","1570力肯","110/07/13","元大-學甲",0,10,-10
"27653","1570力肯","110/07/13","元富-緯城",6,0,6
"27654","1570力肯","110/07/13","群益金鼎-東湖",1,10,-9
"27655","1570力肯","110/07/13","統一-三重",5,0,5
"27656","1570力肯","110/07/13","大昌",0,6,-6
"27657","1570力肯","110/07/13","元大-前金",5,0,5
"27658","1570力肯","110/07/13","元大-土城學府",0,6,-6
"27659","1570力肯","110/07/13","永豐金證券",5,0,5
"27660","1570力肯","110/07/13","統一",0,5,-5
"27661","2929淘帝","110/07/13","玉山-新竹",130,0,130
"27662","2929淘帝","110/07/13","美商高盛",0,177,-177
"27663","2929淘帝","110/07/13","臺銀-民權",60,0,60
"27664","2929淘帝","110/07/13","凱基-台北",6,80,-74
"27665","2929淘帝","110/07/13","新百王",31,0,31
"27666","2929淘帝","110/07/13","元富-大裕",0,49,-49
"27667","2929淘帝","110/07/13","日盛-園區",30,0,30
"27668","2929淘帝","110/07/13","國泰-館前",3,51,-48
"27669","2929淘帝","110/07/13","元大-南投",31,1,30
"27670","2929淘帝","110/07/13","凱基-中壢",0,41,-41
"27671","2929淘帝","110/07/13","兆豐-忠孝",28,0,28
"27672","2929淘帝","110/07/13","港商野村",21,55,-34
"27673","2929淘帝","110/07/13","元大-民生",28,0,28
"27674","2929淘帝","110/07/13","華南永昌-南京",2,34,-32
"27675","2929淘帝","110/07/13","合庫-高雄",27,0,27
"27676","2929淘帝","110/07/13","群益金鼎-土城",0,30,-30
"27677","2929淘帝","110/07/13","凱基-豐中",27,0,27
"27678","2929淘帝","110/07/13","富邦-南屯",0,22,-22
"27679","2929淘帝","110/07/13","新光",21,4,17
"27680","2929淘帝","110/07/13","第一金-豐原",0,20,-20
"27681","2929淘帝","110/07/13","元大-天母",17,0,17
"27682","2929淘帝","110/07/13","元大-屏南",6,26,-20
"27683","2929淘帝","110/07/13","永興",14,0,14
"27684","2929淘帝","110/07/13","永豐金-敦南",1,21,-20
"27685","2929淘帝","110/07/13","富邦-台北",12,0,12
"27686","2929淘帝","110/07/13","凱基-三重",2,21,-19
"27687","2929淘帝","110/07/13","元大-永和",12,0,12
"27688","2929淘帝","110/07/13","富邦-仁愛",7,25,-18
"27689","2929淘帝","110/07/13","國票-天祥",11,0,11
"27690","2929淘帝","110/07/13","元大-北投",0,16,-16
"27691","5410國眾","110/07/13","兆豐-城中",274,0,274
"27692","5410國眾","110/07/13","元富-嘉義",0,103,-103
"27693","5410國眾","110/07/13","新光",50,4,46
"27694","5410國眾","110/07/13","凱基-台北",0,50,-50
"27695","5410國眾","110/07/13","國泰-台中",26,0,26
"27696","5410國眾","110/07/13","瑞士信貸",0,31,-31
"27697","5410國眾","110/07/13","新加坡商瑞銀",22,0,22
"27698","5410國眾","110/07/13","台新-新莊",0,27,-27
"27699","5410國眾","110/07/13","光和-嘉義",20,0,20
"27700","5410國眾","110/07/13","元大-汐止",0,20,-20
"27701","5410國眾","110/07/13","凱基-竹北",17,0,17
"27702","5410國眾","110/07/13","亞東-新竹",0,17,-17
"27703","5410國眾","110/07/13","新光-桃園",15,0,15
"27704","5410國眾","110/07/13","元大-南勢角",0,13,-13
"27705","5410國眾","110/07/13","凱基-台東",14,0,14
"27706","5410國眾","110/07/13","台新-台南",0,12,-12
"27707","5410國眾","110/07/13","富邦-竹北",11,0,11
"27708","5410國眾","110/07/13","中國信託",0,11,-11
"27709","5410國眾","110/07/13","元富-同大",10,0,10
"27710","5410國眾","110/07/13","華南永昌",0,11,-11
"27711","5410國眾","110/07/13","國泰-敦南",24,15,9
"27712","5410國眾","110/07/13","臺銀-臺南",0,10,-10
"27713","5410國眾","110/07/13","日盛-內湖",7,0,7
"27714","5410國眾","110/07/13","台灣企銀-民雄",0,10,-10
"27715","5410國眾","110/07/13","台新-左楠",7,0,7
"27716","5410國眾","110/07/13","高橋",0,10,-10
"27717","5410國眾","110/07/13","元大-新盛",18,12,6
"27718","5410國眾","110/07/13","康和-嘉義",0,10,-10
"27719","5410國眾","110/07/13","統一",5,0,5
"27720","5410國眾","110/07/13","凱基-基隆",0,10,-10
"27721","2841台開","110/07/13","中國信託-高雄",251,50,201
"27722","2841台開","110/07/13","兆豐-公益",0,177,-177
"27723","2841台開","110/07/13","日盛證券",210,13,197
"27724","2841台開","110/07/13","日進",0,152,-152
"27725","2841台開","110/07/13","第一金-台中",55,0,55
"27726","2841台開","110/07/13","港商野村",0,109,-109
"27727","2841台開","110/07/13","國泰-板橋",46,0,46
"27728","2841台開","110/07/13","日盛-信義",0,103,-103
"27729","2841台開","110/07/13","國泰-館前",48,3,45
"27730","2841台開","110/07/13","國泰-敦南",11,75,-64
"27731","2841台開","110/07/13","華南永昌-新莊",45,0,45
"27732","2841台開","110/07/13","永興",0,50,-50
"27733","2841台開","110/07/13","日盛-園區",42,0,42
"27734","2841台開","110/07/13","永豐金-敦南",61,104,-43
"27735","2841台開","110/07/13","台新證券",32,0,32
"27736","2841台開","110/07/13","富邦-台南",0,42,-42
"27737","2841台開","110/07/13","台新-高雄",32,2,30
"27738","2841台開","110/07/13","國票-安和",0,30,-30
"27739","2841台開","110/07/13","豐農",23,0,23
"27740","2841台開","110/07/13","元大-桃園",0,25,-25
"27741","2841台開","110/07/13","合庫-嘉義",20,0,20
"27742","2841台開","110/07/13","新光",8,32,-24
"27743","2841台開","110/07/13","華南永昌-高雄",20,0,20
"27744","2841台開","110/07/13","元大-仁愛",0,24,-24
"27745","2841台開","110/07/13","元大-樹林",16,0,16
"27746","2841台開","110/07/13","日盛-中和",0,20,-20
"27747","2841台開","110/07/13","第一金-華江",15,2,13
"27748","2841台開","110/07/13","元富",0,20,-20
"27749","2841台開","110/07/13","美商高盛",12,0,12
"27750","2841台開","110/07/13","富邦-宜蘭",0,20,-20
"27751","6207雷科","110/07/13","元大-高雄",121,0,121
"27752","6207雷科","110/07/13","華南永昌-朴子",1,60,-59
"27753","6207雷科","110/07/13","第一金-新興",20,0,20
"27754","6207雷科","110/07/13","元大-南海",0,36,-36
"27755","6207雷科","110/07/13","元富-三重",20,0,20
"27756","6207雷科","110/07/13","凱基-土城",0,35,-35
"27757","6207雷科","110/07/13","元大-林園",15,0,15
"27758","6207雷科","110/07/13","台灣企銀",0,20,-20
"27759","6207雷科","110/07/13","元大-金華",16,1,15
"27760","6207雷科","110/07/13","群益金鼎-丹鳳",0,20,-20
"27761","6207雷科","110/07/13","日盛證券",10,0,10
"27762","6207雷科","110/07/13","元大-博愛",0,17,-17
"27763","6207雷科","110/07/13","統一-台中",10,0,10
"27764","6207雷科","110/07/13","元大-北港",0,13,-13
"27765","6207雷科","110/07/13","群益金鼎-土城",10,0,10
"27766","6207雷科","110/07/13","新加坡商瑞銀",0,12,-12
"27767","6207雷科","110/07/13","群益金鼎-桃園",10,0,10
"27768","6207雷科","110/07/13","凱基-台北",4,16,-12
"27769","6207雷科","110/07/13","永豐金-新莊",10,0,10
"27770","6207雷科","110/07/13","日茂-埔里",0,11,-11
"27771","6207雷科","110/07/13","永豐金-新店",10,0,10
"27772","6207雷科","110/07/13","元大-莒光",0,11,-11
"27773","6207雷科","110/07/13","元大證券",9,0,9
"27774","6207雷科","110/07/13","統一-新竹",0,10,-10
"27775","6207雷科","110/07/13","日盛-木柵",9,1,8
"27776","6207雷科","110/07/13","元大-西螺",0,10,-10
"27777","6207雷科","110/07/13","兆豐-來福",8,0,8
"27778","6207雷科","110/07/13","康和-台中",0,8,-8
"27779","6207雷科","110/07/13","新光",7,0,7
"27780","6207雷科","110/07/13","兆豐-高雄",0,6,-6
"27781","3679新至陞","110/07/13","永豐金證券",50,0,50
"27782","3679新至陞","110/07/13","摩根大通",2,25,-23
"27783","3679新至陞","110/07/13","國泰-桃園",22,0,22
"27784","3679新至陞","110/07/13","元大-成功",0,22,-22
"27785","3679新至陞","110/07/13","台中銀-員林",11,0,11
"27786","3679新至陞","110/07/13","富邦-板橋",1,19,-18
"27787","3679新至陞","110/07/13","元大-文心興安",8,0,8
"27788","3679新至陞","110/07/13","日盛-新莊",0,10,-10
"27789","3679新至陞","110/07/13","美商高盛",6,0,6
"27790","3679新至陞","110/07/13","台新-台中",0,10,-10
"27791","3679新至陞","110/07/13","台新-高雄",6,0,6
"27792","3679新至陞","110/07/13","永豐金-新竹",0,8,-8
"27793","3679新至陞","110/07/13","凱基-台北",18,12,6
"27794","3679新至陞","110/07/13","瑞士信貸",12,19,-7
"27795","3679新至陞","110/07/13","日盛-復興",5,0,5
"27796","3679新至陞","110/07/13","統一-南京",0,7,-7
"27797","3679新至陞","110/07/13","(牛牛牛)亞-鑫豐",4,0,4
"27798","3679新至陞","110/07/13","凱基-新莊",0,7,-7
"27799","3679新至陞","110/07/13","元富-大昌",3,0,3
"27800","3679新至陞","110/07/13","新加坡商瑞銀",0,6,-6
"27801","3679新至陞","110/07/13","富邦-台北",3,0,3
"27802","3679新至陞","110/07/13","合庫-自強",0,5,-5
"27803","3679新至陞","110/07/13","日盛-樹林",2,0,2
"27804","3679新至陞","110/07/13","富邦-桃園",0,5,-5
"27805","3679新至陞","110/07/13","宏遠-光隆",2,0,2
"27806","3679新至陞","110/07/13","永豐金-潮州",0,4,-4
"27807","3679新至陞","110/07/13","美林",3,1,2
"27808","3679新至陞","110/07/13","臺銀-臺南",0,3,-3
"27809","3679新至陞","110/07/13","第一金-中壢",2,0,2
"27810","3679新至陞","110/07/13","元大-六合",0,3,-3
"27811","2727王品","110/07/13","富邦-台北",43,3,40
"27812","2727王品","110/07/13","台灣摩根士丹利",15,97,-82
"27813","2727王品","110/07/13","元大-基隆孝二",40,0,40
"27814","2727王品","110/07/13","玉山-台南",5,57,-52
"27815","2727王品","110/07/13","國票-新莊",40,1,39
"27816","2727王品","110/07/13","新加坡商瑞銀",0,48,-48
"27817","2727王品","110/07/13","第一金-豐原",66,42,24
"27818","2727王品","110/07/13","凱基-台北",41,77,-36
"27819","2727王品","110/07/13","永豐金-大園",34,10,24
"27820","2727王品","110/07/13","永豐金-永康",0,22,-22
"27821","2727王品","110/07/13","元大-北屯",22,0,22
"27822","2727王品","110/07/13","統一-台中",2,22,-20
"27823","2727王品","110/07/13","元大-東蘆",26,7,19
"27824","2727王品","110/07/13","國泰-台中",21,39,-18
"27825","2727王品","110/07/13","永豐金-萬盛",13,1,12
"27826","2727王品","110/07/13","合庫-彰化",3,20,-17
"27827","2727王品","110/07/13","日盛-嘉義",11,0,11
"27828","2727王品","110/07/13","港商野村",13,30,-17
"27829","2727王品","110/07/13","日盛-八德",11,0,11
"27830","2727王品","110/07/13","元大-楊梅",1,16,-15
"27831","2727王品","110/07/13","統一-竹南",11,0,11
"27832","2727王品","110/07/13","凱基-高美館",2,15,-13
"27833","2727王品","110/07/13","日盛-士林",12,2,10
"27834","2727王品","110/07/13","美商高盛",2,14,-12
"27835","2727王品","110/07/13","統一-敦南",10,0,10
"27836","2727王品","110/07/13","統一-平鎮",1,13,-12
"27837","2727王品","110/07/13","中國信託",15,5,10
"27838","2727王品","110/07/13","兆豐-台中港",4,16,-12
"27839","2727王品","110/07/13","兆豐-竹北",13,3,10
"27840","2727王品","110/07/13","凱基-八德",1,13,-12
"27841","1570力肯","110/07/13","新光",115,11,104
"27842","1570力肯","110/07/13","元大-北三重",0,162,-162
"27843","1570力肯","110/07/13","群益金鼎-高雄",54,0,54
"27844","1570力肯","110/07/13","元大-大灣",0,25,-25
"27845","1570力肯","110/07/13","國票-新莊",22,0,22
"27846","1570力肯","110/07/13","永豐金-苓雅",0,22,-22
"27847","1570力肯","110/07/13","日盛-桃園",12,0,12
"27848","1570力肯","110/07/13","永豐金-永康",0,19,-19
"27849","1570力肯","110/07/13","元大-高雄",12,0,12
"27850","1570力肯","110/07/13","富邦-員林",0,15,-15
"27851","1570力肯","110/07/13","合庫-自強",11,0,11
"27852","1570力肯","110/07/13","凱基-台南",0,11,-11
"27853","1570力肯","110/07/13","摩根大通",26,15,11
"27854","1570力肯","110/07/13","日盛-竹北",0,10,-10
"27855","1570力肯","110/07/13","永豐金-中盛",11,0,11
"27856","1570力肯","110/07/13","國票-九鼎",0,10,-10
"27857","1570力肯","110/07/13","兆豐-台中港",10,0,10
"27858","1570力肯","110/07/13","凱基-桃園",0,10,-10
"27859","1570力肯","110/07/13","國泰-松江",9,0,9
"27860","1570力肯","110/07/13","凱基-新豐",0,10,-10
"27861","1570力肯","110/07/13","元大-新盛",9,0,9
"27862","1570力肯","110/07/13","元大-學甲",0,10,-10
"27863","1570力肯","110/07/13","元富-緯城",6,0,6
"27864","1570力肯","110/07/13","群益金鼎-東湖",1,10,-9
"27865","1570力肯","110/07/13","統一-三重",5,0,5
"27866","1570力肯","110/07/13","大昌",0,6,-6
"27867","1570力肯","110/07/13","元大-前金",5,0,5
"27868","1570力肯","110/07/13","元大-土城學府",0,6,-6
"27869","1570力肯","110/07/13","永豐金證券",5,0,5
"27870","1570力肯","110/07/13","統一",0,5,-5
"27871","6180橘子","110/07/13","摩根大通",119,0,119
"27872","6180橘子","110/07/13","元大-崇德",2,61,-59
"27873","6180橘子","110/07/13","美商高盛",96,0,96
"27874","6180橘子","110/07/13","康和-台中",0,51,-51
"27875","6180橘子","110/07/13","新加坡商瑞銀",86,7,79
"27876","6180橘子","110/07/13","康和-台北",0,50,-50
"27877","6180橘子","110/07/13","元大-和平",40,0,40
"27878","6180橘子","110/07/13","元富-潮州",0,40,-40
"27879","6180橘子","110/07/13","凱基-台北",83,47,36
"27880","6180橘子","110/07/13","日盛-永康",0,26,-26
"27881","6180橘子","110/07/13","美林",39,5,34
"27882","6180橘子","110/07/13","永豐金-中正",0,24,-24
"27883","6180橘子","110/07/13","富邦-新竹華信",31,2,29
"27884","6180橘子","110/07/13","國泰-板橋",2,25,-23
"27885","6180橘子","110/07/13","統一-南京",21,0,21
"27886","6180橘子","110/07/13","日盛-大墩",0,20,-20
"27887","6180橘子","110/07/13","富邦-陽明",24,3,21
"27888","6180橘子","110/07/13","元大-草屯",13,32,-19
"27889","6180橘子","110/07/13","大昌-樹林",21,1,20
"27890","6180橘子","110/07/13","元富-林園",1,18,-17
"27891","6180橘子","110/07/13","花旗環球",19,0,19
"27892","6180橘子","110/07/13","新光-新竹",1,18,-17
"27893","6180橘子","110/07/13","華南永昌-台南",19,0,19
"27894","6180橘子","110/07/13","元大-土城永寧",0,17,-17
"27895","6180橘子","110/07/13","福勝",14,0,14
"27896","6180橘子","110/07/13","國泰-新莊",3,19,-16
"27897","6180橘子","110/07/13","富邦-嘉義",12,1,11
"27898","6180橘子","110/07/13","中國信託-永康",6,21,-15
"27899","6180橘子","110/07/13","元大-板橋三民",11,0,11
"27900","6180橘子","110/07/13","凱基-東港",1,15,-14
"27901","2390云辰","110/07/13","新加坡商瑞銀",562,75,487
"27902","2390云辰","110/07/13","大展-台南",0,532,-532
"27903","2390云辰","110/07/13","台灣摩根士丹利",330,155,175
"27904","2390云辰","110/07/13","凱基-台北",668,854,-186
"27905","2390云辰","110/07/13","兆豐-公益",126,25,101
"27906","2390云辰","110/07/13","凱基-三重",12,172,-160
"27907","2390云辰","110/07/13","元富-中港",100,2,98
"27908","2390云辰","110/07/13","兆豐-忠孝",4,161,-157
"27909","2390云辰","110/07/13","統一-新台中",106,9,97
"27910","2390云辰","110/07/13","元大-士林",19,170,-151
"27911","2390云辰","110/07/13","中國信託-松江",81,11,70
"27912","2390云辰","110/07/13","臺銀-新竹",14,117,-103
"27913","2390云辰","110/07/13","日盛-板橋",72,3,69
"27914","2390云辰","110/07/13","國票-台中",4,102,-98
"27915","2390云辰","110/07/13","日盛-和美",57,0,57
"27916","2390云辰","110/07/13","新光",147,232,-85
"27917","2390云辰","110/07/13","永豐金-桃園",88,36,52
"27918","2390云辰","110/07/13","致和-崇德",2,70,-68
"27919","2390云辰","110/07/13","玉山-士林",54,4,50
"27920","2390云辰","110/07/13","群益金鼎-屏東",2,70,-68
"27921","2390云辰","110/07/13","富邦-仁愛",56,6,50
"27922","2390云辰","110/07/13","元大-大里",35,98,-63
"27923","2390云辰","110/07/13","第一金-豐原",50,1,49
"27924","2390云辰","110/07/13","元大-萬華",35,94,-59
"27925","2390云辰","110/07/13","摩根大通",502,453,49
"27926","2390云辰","110/07/13","元富-吉利",2,60,-58
"27927","2390云辰","110/07/13","凱基-松山",61,13,48
"27928","2390云辰","110/07/13","兆豐-新竹",3,53,-50
"27929","2390云辰","110/07/13","大昌",64,22,42
"27930","2390云辰","110/07/13","富邦-嘉義",65,108,-43
"27931","2363矽統","110/07/13","凱基-南崁",2133,63,2070
"27932","2363矽統","110/07/13","凱基-幸福",36,4048,-4012
"27933","2363矽統","110/07/13","國泰-敦南",2195,1617,578
"27934","2363矽統","110/07/13","統一",192,3325,-3133
"27935","2363矽統","110/07/13","中農",670,139,531
"27936","2363矽統","110/07/13","新加坡商瑞銀",1000,2747,-1747
"27937","2363矽統","110/07/13","康和-台中",638,154,484
"27938","2363矽統","110/07/13","凱基-台北",5359,6609,-1250
"27939","2363矽統","110/07/13","群益金鼎-三民",577,137,440
"27940","2363矽統","110/07/13","摩根大通",1930,2858,-928
"27941","2363矽統","110/07/13","台新-屏東",510,88,422
"27942","2363矽統","110/07/13","港商野村",960,1679,-719
"27943","2363矽統","110/07/13","德信-中正",455,67,388
"27944","2363矽統","110/07/13","兆豐-復興",25,705,-680
"27945","2363矽統","110/07/13","日盛-竹北",365,70,295
"27946","2363矽統","110/07/13","統一-仁愛",114,755,-641
"27947","2363矽統","110/07/13","元大-佳里",452,189,263
"27948","2363矽統","110/07/13","統一-敦南",29,638,-609
"27949","2363矽統","110/07/13","國票-博愛",296,38,258
"27950","2363矽統","110/07/13","統一-土城",100,704,-604
"27951","2363矽統","110/07/13","元大-萬華",340,95,245
"27952","2363矽統","110/07/13","統一-城中",116,676,-560
"27953","2363矽統","110/07/13","新光",1259,1031,228
"27954","2363矽統","110/07/13","永豐金證券",306,859,-553
"27955","2363矽統","110/07/13","元富-成功",323,96,227
"27956","2363矽統","110/07/13","元富",54,567,-513
"27957","2363矽統","110/07/13","豐農",228,23,205
"27958","2363矽統","110/07/13","瑞士信貸",202,666,-464
"27959","2363矽統","110/07/13","台灣企銀-岡山",186,4,182
"27960","2363矽統","110/07/13","永豐金-嘉義",67,468,-401
"27961","2363矽統","110/07/13","凱基-南崁",2133,63,2070
"27962","2363矽統","110/07/13","凱基-幸福",36,4048,-4012
"27963","2363矽統","110/07/13","國泰-敦南",2195,1617,578
"27964","2363矽統","110/07/13","統一",192,3325,-3133
"27965","2363矽統","110/07/13","中農",670,139,531
"27966","2363矽統","110/07/13","新加坡商瑞銀",1000,2747,-1747
"27967","2363矽統","110/07/13","康和-台中",638,154,484
"27968","2363矽統","110/07/13","凱基-台北",5359,6609,-1250
"27969","2363矽統","110/07/13","群益金鼎-三民",577,137,440
"27970","2363矽統","110/07/13","摩根大通",1930,2858,-928
"27971","2363矽統","110/07/13","台新-屏東",510,88,422
"27972","2363矽統","110/07/13","港商野村",960,1679,-719
"27973","2363矽統","110/07/13","德信-中正",455,67,388
"27974","2363矽統","110/07/13","兆豐-復興",25,705,-680
"27975","2363矽統","110/07/13","日盛-竹北",365,70,295
"27976","2363矽統","110/07/13","統一-仁愛",114,755,-641
"27977","2363矽統","110/07/13","元大-佳里",452,189,263
"27978","2363矽統","110/07/13","統一-敦南",29,638,-609
"27979","2363矽統","110/07/13","國票-博愛",296,38,258
"27980","2363矽統","110/07/13","統一-土城",100,704,-604
"27981","2363矽統","110/07/13","元大-萬華",340,95,245
"27982","2363矽統","110/07/13","統一-城中",116,676,-560
"27983","2363矽統","110/07/13","新光",1259,1031,228
"27984","2363矽統","110/07/13","永豐金證券",306,859,-553
"27985","2363矽統","110/07/13","元富-成功",323,96,227
"27986","2363矽統","110/07/13","元富",54,567,-513
"27987","2363矽統","110/07/13","豐農",228,23,205
"27988","2363矽統","110/07/13","瑞士信貸",202,666,-464
"27989","2363矽統","110/07/13","台灣企銀-岡山",186,4,182
"27990","2363矽統","110/07/13","永豐金-嘉義",67,468,-401
"27991","2363矽統","110/07/13","凱基-南崁",2133,63,2070
"27992","2363矽統","110/07/13","凱基-幸福",36,4048,-4012
"27993","2363矽統","110/07/13","國泰-敦南",2195,1617,578
"27994","2363矽統","110/07/13","統一",192,3325,-3133
"27995","2363矽統","110/07/13","中農",670,139,531
"27996","2363矽統","110/07/13","新加坡商瑞銀",1000,2747,-1747
"27997","2363矽統","110/07/13","康和-台中",638,154,484
"27998","2363矽統","110/07/13","凱基-台北",5359,6609,-1250
"27999","2363矽統","110/07/13","群益金鼎-三民",577,137,440
"28000","2363矽統","110/07/13","摩根大通",1930,2858,-928
"28001","2363矽統","110/07/13","台新-屏東",510,88,422
"28002","2363矽統","110/07/13","港商野村",960,1679,-719
"28003","2363矽統","110/07/13","德信-中正",455,67,388
"28004","2363矽統","110/07/13","兆豐-復興",25,705,-680
"28005","2363矽統","110/07/13","日盛-竹北",365,70,295
"28006","2363矽統","110/07/13","統一-仁愛",114,755,-641
"28007","2363矽統","110/07/13","元大-佳里",452,189,263
"28008","2363矽統","110/07/13","統一-敦南",29,638,-609
"28009","2363矽統","110/07/13","國票-博愛",296,38,258
"28010","2363矽統","110/07/13","統一-土城",100,704,-604
"28011","2363矽統","110/07/13","元大-萬華",340,95,245
"28012","2363矽統","110/07/13","統一-城中",116,676,-560
"28013","2363矽統","110/07/13","新光",1259,1031,228
"28014","2363矽統","110/07/13","永豐金證券",306,859,-553
"28015","2363矽統","110/07/13","元富-成功",323,96,227
"28016","2363矽統","110/07/13","元富",54,567,-513
"28017","2363矽統","110/07/13","豐農",228,23,205
"28018","2363矽統","110/07/13","瑞士信貸",202,666,-464
"28019","2363矽統","110/07/13","台灣企銀-岡山",186,4,182
"28020","2363矽統","110/07/13","永豐金-嘉義",67,468,-401
"28021","1570力肯","110/07/13","新光",115,11,104
"28022","1570力肯","110/07/13","元大-北三重",0,162,-162
"28023","1570力肯","110/07/13","群益金鼎-高雄",54,0,54
"28024","1570力肯","110/07/13","元大-大灣",0,25,-25
"28025","1570力肯","110/07/13","國票-新莊",22,0,22
"28026","1570力肯","110/07/13","永豐金-苓雅",0,22,-22
"28027","1570力肯","110/07/13","日盛-桃園",12,0,12
"28028","1570力肯","110/07/13","永豐金-永康",0,19,-19
"28029","1570力肯","110/07/13","元大-高雄",12,0,12
"28030","1570力肯","110/07/13","富邦-員林",0,15,-15
"28031","1570力肯","110/07/13","合庫-自強",11,0,11
"28032","1570力肯","110/07/13","凱基-台南",0,11,-11
"28033","1570力肯","110/07/13","摩根大通",26,15,11
"28034","1570力肯","110/07/13","日盛-竹北",0,10,-10
"28035","1570力肯","110/07/13","永豐金-中盛",11,0,11
"28036","1570力肯","110/07/13","國票-九鼎",0,10,-10
"28037","1570力肯","110/07/13","兆豐-台中港",10,0,10
"28038","1570力肯","110/07/13","凱基-桃園",0,10,-10
"28039","1570力肯","110/07/13","國泰-松江",9,0,9
"28040","1570力肯","110/07/13","凱基-新豐",0,10,-10
"28041","1570力肯","110/07/13","元大-新盛",9,0,9
"28042","1570力肯","110/07/13","元大-學甲",0,10,-10
"28043","1570力肯","110/07/13","元富-緯城",6,0,6
"28044","1570力肯","110/07/13","群益金鼎-東湖",1,10,-9
"28045","1570力肯","110/07/13","統一-三重",5,0,5
"28046","1570力肯","110/07/13","大昌",0,6,-6
"28047","1570力肯","110/07/13","元大-前金",5,0,5
"28048","1570力肯","110/07/13","元大-土城學府",0,6,-6
"28049","1570力肯","110/07/13","永豐金證券",5,0,5
"28050","1570力肯","110/07/13","統一",0,5,-5
"28051","1570力肯","110/07/13","新光",115,11,104
"28052","1570力肯","110/07/13","元大-北三重",0,162,-162
"28053","1570力肯","110/07/13","群益金鼎-高雄",54,0,54
"28054","1570力肯","110/07/13","元大-大灣",0,25,-25
"28055","1570力肯","110/07/13","國票-新莊",22,0,22
"28056","1570力肯","110/07/13","永豐金-苓雅",0,22,-22
"28057","1570力肯","110/07/13","日盛-桃園",12,0,12
"28058","1570力肯","110/07/13","永豐金-永康",0,19,-19
"28059","1570力肯","110/07/13","元大-高雄",12,0,12
"28060","1570力肯","110/07/13","富邦-員林",0,15,-15
"28061","1570力肯","110/07/13","合庫-自強",11,0,11
"28062","1570力肯","110/07/13","凱基-台南",0,11,-11
"28063","1570力肯","110/07/13","摩根大通",26,15,11
"28064","1570力肯","110/07/13","日盛-竹北",0,10,-10
"28065","1570力肯","110/07/13","永豐金-中盛",11,0,11
"28066","1570力肯","110/07/13","國票-九鼎",0,10,-10
"28067","1570力肯","110/07/13","兆豐-台中港",10,0,10
"28068","1570力肯","110/07/13","凱基-桃園",0,10,-10
"28069","1570力肯","110/07/13","國泰-松江",9,0,9
"28070","1570力肯","110/07/13","凱基-新豐",0,10,-10
"28071","1570力肯","110/07/13","元大-新盛",9,0,9
"28072","1570力肯","110/07/13","元大-學甲",0,10,-10
"28073","1570力肯","110/07/13","元富-緯城",6,0,6
"28074","1570力肯","110/07/13","群益金鼎-東湖",1,10,-9
"28075","1570力肯","110/07/13","統一-三重",5,0,5
"28076","1570力肯","110/07/13","大昌",0,6,-6
"28077","1570力肯","110/07/13","元大-前金",5,0,5
"28078","1570力肯","110/07/13","元大-土城學府",0,6,-6
"28079","1570力肯","110/07/13","永豐金證券",5,0,5
"28080","1570力肯","110/07/13","統一",0,5,-5
"28081","6180橘子","110/07/13","摩根大通",119,0,119
"28082","6180橘子","110/07/13","元大-崇德",2,61,-59
"28083","6180橘子","110/07/13","美商高盛",96,0,96
"28084","6180橘子","110/07/13","康和-台中",0,51,-51
"28085","6180橘子","110/07/13","新加坡商瑞銀",86,7,79
"28086","6180橘子","110/07/13","康和-台北",0,50,-50
"28087","6180橘子","110/07/13","元大-和平",40,0,40
"28088","6180橘子","110/07/13","元富-潮州",0,40,-40
"28089","6180橘子","110/07/13","凱基-台北",83,47,36
"28090","6180橘子","110/07/13","日盛-永康",0,26,-26
"28091","6180橘子","110/07/13","美林",39,5,34
"28092","6180橘子","110/07/13","永豐金-中正",0,24,-24
"28093","6180橘子","110/07/13","富邦-新竹華信",31,2,29
"28094","6180橘子","110/07/13","國泰-板橋",2,25,-23
"28095","6180橘子","110/07/13","統一-南京",21,0,21
"28096","6180橘子","110/07/13","日盛-大墩",0,20,-20
"28097","6180橘子","110/07/13","富邦-陽明",24,3,21
"28098","6180橘子","110/07/13","元大-草屯",13,32,-19
"28099","6180橘子","110/07/13","大昌-樹林",21,1,20
"28100","6180橘子","110/07/13","元富-林園",1,18,-17
"28101","6180橘子","110/07/13","花旗環球",19,0,19
"28102","6180橘子","110/07/13","新光-新竹",1,18,-17
"28103","6180橘子","110/07/13","華南永昌-台南",19,0,19
"28104","6180橘子","110/07/13","元大-土城永寧",0,17,-17
"28105","6180橘子","110/07/13","福勝",14,0,14
"28106","6180橘子","110/07/13","國泰-新莊",3,19,-16
"28107","6180橘子","110/07/13","富邦-嘉義",12,1,11
"28108","6180橘子","110/07/13","中國信託-永康",6,21,-15
"28109","6180橘子","110/07/13","元大-板橋三民",11,0,11
"28110","6180橘子","110/07/13","凱基-東港",1,15,-14
"28111","1570力肯","110/07/13","新光",115,11,104
"28112","1570力肯","110/07/13","元大-北三重",0,162,-162
"28113","1570力肯","110/07/13","群益金鼎-高雄",54,0,54
"28114","1570力肯","110/07/13","元大-大灣",0,25,-25
"28115","1570力肯","110/07/13","國票-新莊",22,0,22
"28116","1570力肯","110/07/13","永豐金-苓雅",0,22,-22
"28117","1570力肯","110/07/13","日盛-桃園",12,0,12
"28118","1570力肯","110/07/13","永豐金-永康",0,19,-19
"28119","1570力肯","110/07/13","元大-高雄",12,0,12
"28120","1570力肯","110/07/13","富邦-員林",0,15,-15
"28121","1570力肯","110/07/13","合庫-自強",11,0,11
"28122","1570力肯","110/07/13","凱基-台南",0,11,-11
"28123","1570力肯","110/07/13","摩根大通",26,15,11
"28124","1570力肯","110/07/13","日盛-竹北",0,10,-10
"28125","1570力肯","110/07/13","永豐金-中盛",11,0,11
"28126","1570力肯","110/07/13","國票-九鼎",0,10,-10
"28127","1570力肯","110/07/13","兆豐-台中港",10,0,10
"28128","1570力肯","110/07/13","凱基-桃園",0,10,-10
"28129","1570力肯","110/07/13","國泰-松江",9,0,9
"28130","1570力肯","110/07/13","凱基-新豐",0,10,-10
"28131","1570力肯","110/07/13","元大-新盛",9,0,9
"28132","1570力肯","110/07/13","元大-學甲",0,10,-10
"28133","1570力肯","110/07/13","元富-緯城",6,0,6
"28134","1570力肯","110/07/13","群益金鼎-東湖",1,10,-9
"28135","1570力肯","110/07/13","統一-三重",5,0,5
"28136","1570力肯","110/07/13","大昌",0,6,-6
"28137","1570力肯","110/07/13","元大-前金",5,0,5
"28138","1570力肯","110/07/13","元大-土城學府",0,6,-6
"28139","1570力肯","110/07/13","永豐金證券",5,0,5
"28140","1570力肯","110/07/13","統一",0,5,-5
"28141","6180橘子","110/07/13","摩根大通",119,0,119
"28142","6180橘子","110/07/13","元大-崇德",2,61,-59
"28143","6180橘子","110/07/13","美商高盛",96,0,96
"28144","6180橘子","110/07/13","康和-台中",0,51,-51
"28145","6180橘子","110/07/13","新加坡商瑞銀",86,7,79
"28146","6180橘子","110/07/13","康和-台北",0,50,-50
"28147","6180橘子","110/07/13","元大-和平",40,0,40
"28148","6180橘子","110/07/13","元富-潮州",0,40,-40
"28149","6180橘子","110/07/13","凱基-台北",83,47,36
"28150","6180橘子","110/07/13","日盛-永康",0,26,-26
"28151","6180橘子","110/07/13","美林",39,5,34
"28152","6180橘子","110/07/13","永豐金-中正",0,24,-24
"28153","6180橘子","110/07/13","富邦-新竹華信",31,2,29
"28154","6180橘子","110/07/13","國泰-板橋",2,25,-23
"28155","6180橘子","110/07/13","統一-南京",21,0,21
"28156","6180橘子","110/07/13","日盛-大墩",0,20,-20
"28157","6180橘子","110/07/13","富邦-陽明",24,3,21
"28158","6180橘子","110/07/13","元大-草屯",13,32,-19
"28159","6180橘子","110/07/13","大昌-樹林",21,1,20
"28160","6180橘子","110/07/13","元富-林園",1,18,-17
"28161","6180橘子","110/07/13","花旗環球",19,0,19
"28162","6180橘子","110/07/13","新光-新竹",1,18,-17
"28163","6180橘子","110/07/13","華南永昌-台南",19,0,19
"28164","6180橘子","110/07/13","元大-土城永寧",0,17,-17
"28165","6180橘子","110/07/13","福勝",14,0,14
"28166","6180橘子","110/07/13","國泰-新莊",3,19,-16
"28167","6180橘子","110/07/13","富邦-嘉義",12,1,11
"28168","6180橘子","110/07/13","中國信託-永康",6,21,-15
"28169","6180橘子","110/07/13","元大-板橋三民",11,0,11
"28170","6180橘子","110/07/13","凱基-東港",1,15,-14
"28171","2390云辰","110/07/13","新加坡商瑞銀",562,75,487
"28172","2390云辰","110/07/13","大展-台南",0,532,-532
"28173","2390云辰","110/07/13","台灣摩根士丹利",330,155,175
"28174","2390云辰","110/07/13","凱基-台北",668,854,-186
"28175","2390云辰","110/07/13","兆豐-公益",126,25,101
"28176","2390云辰","110/07/13","凱基-三重",12,172,-160
"28177","2390云辰","110/07/13","元富-中港",100,2,98
"28178","2390云辰","110/07/13","兆豐-忠孝",4,161,-157
"28179","2390云辰","110/07/13","統一-新台中",106,9,97
"28180","2390云辰","110/07/13","元大-士林",19,170,-151
"28181","2390云辰","110/07/13","中國信託-松江",81,11,70
"28182","2390云辰","110/07/13","臺銀-新竹",14,117,-103
"28183","2390云辰","110/07/13","日盛-板橋",72,3,69
"28184","2390云辰","110/07/13","國票-台中",4,102,-98
"28185","2390云辰","110/07/13","日盛-和美",57,0,57
"28186","2390云辰","110/07/13","新光",147,232,-85
"28187","2390云辰","110/07/13","永豐金-桃園",88,36,52
"28188","2390云辰","110/07/13","致和-崇德",2,70,-68
"28189","2390云辰","110/07/13","玉山-士林",54,4,50
"28190","2390云辰","110/07/13","群益金鼎-屏東",2,70,-68
"28191","2390云辰","110/07/13","富邦-仁愛",56,6,50
"28192","2390云辰","110/07/13","元大-大里",35,98,-63
"28193","2390云辰","110/07/13","第一金-豐原",50,1,49
"28194","2390云辰","110/07/13","元大-萬華",35,94,-59
"28195","2390云辰","110/07/13","摩根大通",502,453,49
"28196","2390云辰","110/07/13","元富-吉利",2,60,-58
"28197","2390云辰","110/07/13","凱基-松山",61,13,48
"28198","2390云辰","110/07/13","兆豐-新竹",3,53,-50
"28199","2390云辰","110/07/13","大昌",64,22,42
"28200","2390云辰","110/07/13","富邦-嘉義",65,108,-43
"28201","2363矽統","110/07/13","凱基-南崁",2133,63,2070
"28202","2363矽統","110/07/13","凱基-幸福",36,4048,-4012
"28203","2363矽統","110/07/13","國泰-敦南",2195,1617,578
"28204","2363矽統","110/07/13","統一",192,3325,-3133
"28205","2363矽統","110/07/13","中農",670,139,531
"28206","2363矽統","110/07/13","新加坡商瑞銀",1000,2747,-1747
"28207","2363矽統","110/07/13","康和-台中",638,154,484
"28208","2363矽統","110/07/13","凱基-台北",5359,6609,-1250
"28209","2363矽統","110/07/13","群益金鼎-三民",577,137,440
"28210","2363矽統","110/07/13","摩根大通",1930,2858,-928
"28211","2363矽統","110/07/13","台新-屏東",510,88,422
"28212","2363矽統","110/07/13","港商野村",960,1679,-719
"28213","2363矽統","110/07/13","德信-中正",455,67,388
"28214","2363矽統","110/07/13","兆豐-復興",25,705,-680
"28215","2363矽統","110/07/13","日盛-竹北",365,70,295
"28216","2363矽統","110/07/13","統一-仁愛",114,755,-641
"28217","2363矽統","110/07/13","元大-佳里",452,189,263
"28218","2363矽統","110/07/13","統一-敦南",29,638,-609
"28219","2363矽統","110/07/13","國票-博愛",296,38,258
"28220","2363矽統","110/07/13","統一-土城",100,704,-604
"28221","2363矽統","110/07/13","元大-萬華",340,95,245
"28222","2363矽統","110/07/13","統一-城中",116,676,-560
"28223","2363矽統","110/07/13","新光",1259,1031,228
"28224","2363矽統","110/07/13","永豐金證券",306,859,-553
"28225","2363矽統","110/07/13","元富-成功",323,96,227
"28226","2363矽統","110/07/13","元富",54,567,-513
"28227","2363矽統","110/07/13","豐農",228,23,205
"28228","2363矽統","110/07/13","瑞士信貸",202,666,-464
"28229","2363矽統","110/07/13","台灣企銀-岡山",186,4,182
"28230","2363矽統","110/07/13","永豐金-嘉義",67,468,-401
"28231","8112至上","110/07/13","摩根大通",688,296,392
"28232","8112至上","110/07/13","國票-中和",0,401,-401
"28233","8112至上","110/07/13","港商野村",344,145,199
"28234","8112至上","110/07/13","永豐金-板盛",0,205,-205
"28235","8112至上","110/07/13","兆豐-公益",195,5,190
"28236","8112至上","110/07/13","凱基-五股",43,155,-112
"28237","8112至上","110/07/13","台灣摩根士丹利",183,0,183
"28238","8112至上","110/07/13","凱基-市政",0,100,-100
"28239","8112至上","110/07/13","群益金鼎-敦南",153,2,151
"28240","8112至上","110/07/13","元大-大里德芳",1,92,-91
"28241","8112至上","110/07/13","臺銀-金山",146,26,120
"28242","8112至上","110/07/13","玉山-桃園",26,110,-84
"28243","8112至上","110/07/13","臺銀",133,19,114
"28244","8112至上","110/07/13","兆豐-天母",0,81,-81
"28245","8112至上","110/07/13","合庫-台中",115,6,109
"28246","8112至上","110/07/13","凱基-城中",3,84,-81
"28247","8112至上","110/07/13","亞東-板橋",134,26,108
"28248","8112至上","110/07/13","日盛-新莊",9,85,-76
"28249","8112至上","110/07/13","凱基-台北",414,326,88
"28250","8112至上","110/07/13","日盛-台中",2,64,-62
"28251","8112至上","110/07/13","新加坡商瑞銀",181,100,81
"28252","8112至上","110/07/13","日盛-中壢",3,64,-61
"28253","8112至上","110/07/13","國泰-敦南",108,31,77
"28254","8112至上","110/07/13","元大-台中",2,59,-57
"28255","8112至上","110/07/13","第一金-華江",77,4,73
"28256","8112至上","110/07/13","元大-雙和",7,64,-57
"28257","8112至上","110/07/13","永豐金-內湖",73,1,72
"28258","8112至上","110/07/13","元大-高雄",8,62,-54
"28259","8112至上","110/07/13","元大-永和",68,1,67
"28260","8112至上","110/07/13","元大-館前",2,55,-53
"28261","2929淘帝","110/07/13","玉山-新竹",130,0,130
"28262","2929淘帝","110/07/13","美商高盛",0,177,-177
"28263","2929淘帝","110/07/13","臺銀-民權",60,0,60
"28264","2929淘帝","110/07/13","凱基-台北",6,80,-74
"28265","2929淘帝","110/07/13","新百王",31,0,31
"28266","2929淘帝","110/07/13","元富-大裕",0,49,-49
"28267","2929淘帝","110/07/13","日盛-園區",30,0,30
"28268","2929淘帝","110/07/13","國泰-館前",3,51,-48
"28269","2929淘帝","110/07/13","元大-南投",31,1,30
"28270","2929淘帝","110/07/13","凱基-中壢",0,41,-41
"28271","2929淘帝","110/07/13","兆豐-忠孝",28,0,28
"28272","2929淘帝","110/07/13","港商野村",21,55,-34
"28273","2929淘帝","110/07/13","元大-民生",28,0,28
"28274","2929淘帝","110/07/13","華南永昌-南京",2,34,-32
"28275","2929淘帝","110/07/13","合庫-高雄",27,0,27
"28276","2929淘帝","110/07/13","群益金鼎-土城",0,30,-30
"28277","2929淘帝","110/07/13","凱基-豐中",27,0,27
"28278","2929淘帝","110/07/13","富邦-南屯",0,22,-22
"28279","2929淘帝","110/07/13","新光",21,4,17
"28280","2929淘帝","110/07/13","第一金-豐原",0,20,-20
"28281","2929淘帝","110/07/13","元大-天母",17,0,17
"28282","2929淘帝","110/07/13","元大-屏南",6,26,-20
"28283","2929淘帝","110/07/13","永興",14,0,14
"28284","2929淘帝","110/07/13","永豐金-敦南",1,21,-20
"28285","2929淘帝","110/07/13","富邦-台北",12,0,12
"28286","2929淘帝","110/07/13","凱基-三重",2,21,-19
"28287","2929淘帝","110/07/13","元大-永和",12,0,12
"28288","2929淘帝","110/07/13","富邦-仁愛",7,25,-18
"28289","2929淘帝","110/07/13","國票-天祥",11,0,11
"28290","2929淘帝","110/07/13","元大-北投",0,16,-16
"28291","2841台開","110/07/13","中國信託-高雄",251,50,201
"28292","2841台開","110/07/13","兆豐-公益",0,177,-177
"28293","2841台開","110/07/13","日盛證券",210,13,197
"28294","2841台開","110/07/13","日進",0,152,-152
"28295","2841台開","110/07/13","第一金-台中",55,0,55
"28296","2841台開","110/07/13","港商野村",0,109,-109
"28297","2841台開","110/07/13","國泰-板橋",46,0,46
"28298","2841台開","110/07/13","日盛-信義",0,103,-103
"28299","2841台開","110/07/13","國泰-館前",48,3,45
"28300","2841台開","110/07/13","國泰-敦南",11,75,-64
"28301","2841台開","110/07/13","華南永昌-新莊",45,0,45
"28302","2841台開","110/07/13","永興",0,50,-50
"28303","2841台開","110/07/13","日盛-園區",42,0,42
"28304","2841台開","110/07/13","永豐金-敦南",61,104,-43
"28305","2841台開","110/07/13","台新證券",32,0,32
"28306","2841台開","110/07/13","富邦-台南",0,42,-42
"28307","2841台開","110/07/13","台新-高雄",32,2,30
"28308","2841台開","110/07/13","國票-安和",0,30,-30
"28309","2841台開","110/07/13","豐農",23,0,23
"28310","2841台開","110/07/13","元大-桃園",0,25,-25
"28311","2841台開","110/07/13","合庫-嘉義",20,0,20
"28312","2841台開","110/07/13","新光",8,32,-24
"28313","2841台開","110/07/13","華南永昌-高雄",20,0,20
"28314","2841台開","110/07/13","元大-仁愛",0,24,-24
"28315","2841台開","110/07/13","元大-樹林",16,0,16
"28316","2841台開","110/07/13","日盛-中和",0,20,-20
"28317","2841台開","110/07/13","第一金-華江",15,2,13
"28318","2841台開","110/07/13","元富",0,20,-20
"28319","2841台開","110/07/13","美商高盛",12,0,12
"28320","2841台開","110/07/13","富邦-宜蘭",0,20,-20
"28321","6207雷科","110/07/13","元大-高雄",121,0,121
"28322","6207雷科","110/07/13","華南永昌-朴子",1,60,-59
"28323","6207雷科","110/07/13","第一金-新興",20,0,20
"28324","6207雷科","110/07/13","元大-南海",0,36,-36
"28325","6207雷科","110/07/13","元富-三重",20,0,20
"28326","6207雷科","110/07/13","凱基-土城",0,35,-35
"28327","6207雷科","110/07/13","元大-林園",15,0,15
"28328","6207雷科","110/07/13","台灣企銀",0,20,-20
"28329","6207雷科","110/07/13","元大-金華",16,1,15
"28330","6207雷科","110/07/13","群益金鼎-丹鳳",0,20,-20
"28331","6207雷科","110/07/13","日盛證券",10,0,10
"28332","6207雷科","110/07/13","元大-博愛",0,17,-17
"28333","6207雷科","110/07/13","統一-台中",10,0,10
"28334","6207雷科","110/07/13","元大-北港",0,13,-13
"28335","6207雷科","110/07/13","群益金鼎-土城",10,0,10
"28336","6207雷科","110/07/13","新加坡商瑞銀",0,12,-12
"28337","6207雷科","110/07/13","群益金鼎-桃園",10,0,10
"28338","6207雷科","110/07/13","凱基-台北",4,16,-12
"28339","6207雷科","110/07/13","永豐金-新莊",10,0,10
"28340","6207雷科","110/07/13","日茂-埔里",0,11,-11
"28341","6207雷科","110/07/13","永豐金-新店",10,0,10
"28342","6207雷科","110/07/13","元大-莒光",0,11,-11
"28343","6207雷科","110/07/13","元大證券",9,0,9
"28344","6207雷科","110/07/13","統一-新竹",0,10,-10
"28345","6207雷科","110/07/13","日盛-木柵",9,1,8
"28346","6207雷科","110/07/13","元大-西螺",0,10,-10
"28347","6207雷科","110/07/13","兆豐-來福",8,0,8
"28348","6207雷科","110/07/13","康和-台中",0,8,-8
"28349","6207雷科","110/07/13","新光",7,0,7
"28350","6207雷科","110/07/13","兆豐-高雄",0,6,-6
"28351","3679新至陞","110/07/13","永豐金證券",50,0,50
"28352","3679新至陞","110/07/13","摩根大通",2,25,-23
"28353","3679新至陞","110/07/13","國泰-桃園",22,0,22
"28354","3679新至陞","110/07/13","元大-成功",0,22,-22
"28355","3679新至陞","110/07/13","台中銀-員林",11,0,11
"28356","3679新至陞","110/07/13","富邦-板橋",1,19,-18
"28357","3679新至陞","110/07/13","元大-文心興安",8,0,8
"28358","3679新至陞","110/07/13","日盛-新莊",0,10,-10
"28359","3679新至陞","110/07/13","美商高盛",6,0,6
"28360","3679新至陞","110/07/13","台新-台中",0,10,-10
"28361","3679新至陞","110/07/13","台新-高雄",6,0,6
"28362","3679新至陞","110/07/13","永豐金-新竹",0,8,-8
"28363","3679新至陞","110/07/13","凱基-台北",18,12,6
"28364","3679新至陞","110/07/13","瑞士信貸",12,19,-7
"28365","3679新至陞","110/07/13","日盛-復興",5,0,5
"28366","3679新至陞","110/07/13","統一-南京",0,7,-7
"28367","3679新至陞","110/07/13","(牛牛牛)亞-鑫豐",4,0,4
"28368","3679新至陞","110/07/13","凱基-新莊",0,7,-7
"28369","3679新至陞","110/07/13","元富-大昌",3,0,3
"28370","3679新至陞","110/07/13","新加坡商瑞銀",0,6,-6
"28371","3679新至陞","110/07/13","富邦-台北",3,0,3
"28372","3679新至陞","110/07/13","合庫-自強",0,5,-5
"28373","3679新至陞","110/07/13","日盛-樹林",2,0,2
"28374","3679新至陞","110/07/13","富邦-桃園",0,5,-5
"28375","3679新至陞","110/07/13","宏遠-光隆",2,0,2
"28376","3679新至陞","110/07/13","永豐金-潮州",0,4,-4
"28377","3679新至陞","110/07/13","美林",3,1,2
"28378","3679新至陞","110/07/13","臺銀-臺南",0,3,-3
"28379","3679新至陞","110/07/13","第一金-中壢",2,0,2
"28380","3679新至陞","110/07/13","元大-六合",0,3,-3
"28381","2727王品","110/07/13","富邦-台北",43,3,40
"28382","2727王品","110/07/13","台灣摩根士丹利",15,97,-82
"28383","2727王品","110/07/13","元大-基隆孝二",40,0,40
"28384","2727王品","110/07/13","玉山-台南",5,57,-52
"28385","2727王品","110/07/13","國票-新莊",40,1,39
"28386","2727王品","110/07/13","新加坡商瑞銀",0,48,-48
"28387","2727王品","110/07/13","第一金-豐原",66,42,24
"28388","2727王品","110/07/13","凱基-台北",41,77,-36
"28389","2727王品","110/07/13","永豐金-大園",34,10,24
"28390","2727王品","110/07/13","永豐金-永康",0,22,-22
"28391","2727王品","110/07/13","元大-北屯",22,0,22
"28392","2727王品","110/07/13","統一-台中",2,22,-20
"28393","2727王品","110/07/13","元大-東蘆",26,7,19
"28394","2727王品","110/07/13","國泰-台中",21,39,-18
"28395","2727王品","110/07/13","永豐金-萬盛",13,1,12
"28396","2727王品","110/07/13","合庫-彰化",3,20,-17
"28397","2727王品","110/07/13","日盛-嘉義",11,0,11
"28398","2727王品","110/07/13","港商野村",13,30,-17
"28399","2727王品","110/07/13","日盛-八德",11,0,11
"28400","2727王品","110/07/13","元大-楊梅",1,16,-15
"28401","2727王品","110/07/13","統一-竹南",11,0,11
"28402","2727王品","110/07/13","凱基-高美館",2,15,-13
"28403","2727王品","110/07/13","日盛-士林",12,2,10
"28404","2727王品","110/07/13","美商高盛",2,14,-12
"28405","2727王品","110/07/13","統一-敦南",10,0,10
"28406","2727王品","110/07/13","統一-平鎮",1,13,-12
"28407","2727王品","110/07/13","中國信託",15,5,10
"28408","2727王品","110/07/13","兆豐-台中港",4,16,-12
"28409","2727王品","110/07/13","兆豐-竹北",13,3,10
"28410","2727王品","110/07/13","凱基-八德",1,13,-12
"28411","1570力肯","110/07/13","新光",115,11,104
"28412","1570力肯","110/07/13","元大-北三重",0,162,-162
"28413","1570力肯","110/07/13","群益金鼎-高雄",54,0,54
"28414","1570力肯","110/07/13","元大-大灣",0,25,-25
"28415","1570力肯","110/07/13","國票-新莊",22,0,22
"28416","1570力肯","110/07/13","永豐金-苓雅",0,22,-22
"28417","1570力肯","110/07/13","日盛-桃園",12,0,12
"28418","1570力肯","110/07/13","永豐金-永康",0,19,-19
"28419","1570力肯","110/07/13","元大-高雄",12,0,12
"28420","1570力肯","110/07/13","富邦-員林",0,15,-15
"28421","1570力肯","110/07/13","合庫-自強",11,0,11
"28422","1570力肯","110/07/13","凱基-台南",0,11,-11
"28423","1570力肯","110/07/13","摩根大通",26,15,11
"28424","1570力肯","110/07/13","日盛-竹北",0,10,-10
"28425","1570力肯","110/07/13","永豐金-中盛",11,0,11
"28426","1570力肯","110/07/13","國票-九鼎",0,10,-10
"28427","1570力肯","110/07/13","兆豐-台中港",10,0,10
"28428","1570力肯","110/07/13","凱基-桃園",0,10,-10
"28429","1570力肯","110/07/13","國泰-松江",9,0,9
"28430","1570力肯","110/07/13","凱基-新豐",0,10,-10
"28431","1570力肯","110/07/13","元大-新盛",9,0,9
"28432","1570力肯","110/07/13","元大-學甲",0,10,-10
"28433","1570力肯","110/07/13","元富-緯城",6,0,6
"28434","1570力肯","110/07/13","群益金鼎-東湖",1,10,-9
"28435","1570力肯","110/07/13","統一-三重",5,0,5
"28436","1570力肯","110/07/13","大昌",0,6,-6
"28437","1570力肯","110/07/13","元大-前金",5,0,5
"28438","1570力肯","110/07/13","元大-土城學府",0,6,-6
"28439","1570力肯","110/07/13","永豐金證券",5,0,5
"28440","1570力肯","110/07/13","統一",0,5,-5
"28441","6180橘子","110/07/13","摩根大通",119,0,119
"28442","6180橘子","110/07/13","元大-崇德",2,61,-59
"28443","6180橘子","110/07/13","美商高盛",96,0,96
"28444","6180橘子","110/07/13","康和-台中",0,51,-51
"28445","6180橘子","110/07/13","新加坡商瑞銀",86,7,79
"28446","6180橘子","110/07/13","康和-台北",0,50,-50
"28447","6180橘子","110/07/13","元大-和平",40,0,40
"28448","6180橘子","110/07/13","元富-潮州",0,40,-40
"28449","6180橘子","110/07/13","凱基-台北",83,47,36
"28450","6180橘子","110/07/13","日盛-永康",0,26,-26
"28451","6180橘子","110/07/13","美林",39,5,34
"28452","6180橘子","110/07/13","永豐金-中正",0,24,-24
"28453","6180橘子","110/07/13","富邦-新竹華信",31,2,29
"28454","6180橘子","110/07/13","國泰-板橋",2,25,-23
"28455","6180橘子","110/07/13","統一-南京",21,0,21
"28456","6180橘子","110/07/13","日盛-大墩",0,20,-20
"28457","6180橘子","110/07/13","富邦-陽明",24,3,21
"28458","6180橘子","110/07/13","元大-草屯",13,32,-19
"28459","6180橘子","110/07/13","大昌-樹林",21,1,20
"28460","6180橘子","110/07/13","元富-林園",1,18,-17
"28461","6180橘子","110/07/13","花旗環球",19,0,19
"28462","6180橘子","110/07/13","新光-新竹",1,18,-17
"28463","6180橘子","110/07/13","華南永昌-台南",19,0,19
"28464","6180橘子","110/07/13","元大-土城永寧",0,17,-17
"28465","6180橘子","110/07/13","福勝",14,0,14
"28466","6180橘子","110/07/13","國泰-新莊",3,19,-16
"28467","6180橘子","110/07/13","富邦-嘉義",12,1,11
"28468","6180橘子","110/07/13","中國信託-永康",6,21,-15
"28469","6180橘子","110/07/13","元大-板橋三民",11,0,11
"28470","6180橘子","110/07/13","凱基-東港",1,15,-14
"28471","2390云辰","110/07/13","新加坡商瑞銀",562,75,487
"28472","2390云辰","110/07/13","大展-台南",0,532,-532
"28473","2390云辰","110/07/13","台灣摩根士丹利",330,155,175
"28474","2390云辰","110/07/13","凱基-台北",668,854,-186
"28475","2390云辰","110/07/13","兆豐-公益",126,25,101
"28476","2390云辰","110/07/13","凱基-三重",12,172,-160
"28477","2390云辰","110/07/13","元富-中港",100,2,98
"28478","2390云辰","110/07/13","兆豐-忠孝",4,161,-157
"28479","2390云辰","110/07/13","統一-新台中",106,9,97
"28480","2390云辰","110/07/13","元大-士林",19,170,-151
"28481","2390云辰","110/07/13","中國信託-松江",81,11,70
"28482","2390云辰","110/07/13","臺銀-新竹",14,117,-103
"28483","2390云辰","110/07/13","日盛-板橋",72,3,69
"28484","2390云辰","110/07/13","國票-台中",4,102,-98
"28485","2390云辰","110/07/13","日盛-和美",57,0,57
"28486","2390云辰","110/07/13","新光",147,232,-85
"28487","2390云辰","110/07/13","永豐金-桃園",88,36,52
"28488","2390云辰","110/07/13","致和-崇德",2,70,-68
"28489","2390云辰","110/07/13","玉山-士林",54,4,50
"28490","2390云辰","110/07/13","群益金鼎-屏東",2,70,-68
"28491","2390云辰","110/07/13","富邦-仁愛",56,6,50
"28492","2390云辰","110/07/13","元大-大里",35,98,-63
"28493","2390云辰","110/07/13","第一金-豐原",50,1,49
"28494","2390云辰","110/07/13","元大-萬華",35,94,-59
"28495","2390云辰","110/07/13","摩根大通",502,453,49
"28496","2390云辰","110/07/13","元富-吉利",2,60,-58
"28497","2390云辰","110/07/13","凱基-松山",61,13,48
"28498","2390云辰","110/07/13","兆豐-新竹",3,53,-50
"28499","2390云辰","110/07/13","大昌",64,22,42
"28500","2390云辰","110/07/13","富邦-嘉義",65,108,-43
"28501","2363矽統","110/07/13","凱基-南崁",2133,63,2070
"28502","2363矽統","110/07/13","凱基-幸福",36,4048,-4012
"28503","2363矽統","110/07/13","國泰-敦南",2195,1617,578
"28504","2363矽統","110/07/13","統一",192,3325,-3133
"28505","2363矽統","110/07/13","中農",670,139,531
"28506","2363矽統","110/07/13","新加坡商瑞銀",1000,2747,-1747
"28507","2363矽統","110/07/13","康和-台中",638,154,484
"28508","2363矽統","110/07/13","凱基-台北",5359,6609,-1250
"28509","2363矽統","110/07/13","群益金鼎-三民",577,137,440
"28510","2363矽統","110/07/13","摩根大通",1930,2858,-928
"28511","2363矽統","110/07/13","台新-屏東",510,88,422
"28512","2363矽統","110/07/13","港商野村",960,1679,-719
"28513","2363矽統","110/07/13","德信-中正",455,67,388
"28514","2363矽統","110/07/13","兆豐-復興",25,705,-680
"28515","2363矽統","110/07/13","日盛-竹北",365,70,295
"28516","2363矽統","110/07/13","統一-仁愛",114,755,-641
"28517","2363矽統","110/07/13","元大-佳里",452,189,263
"28518","2363矽統","110/07/13","統一-敦南",29,638,-609
"28519","2363矽統","110/07/13","國票-博愛",296,38,258
"28520","2363矽統","110/07/13","統一-土城",100,704,-604
"28521","2363矽統","110/07/13","元大-萬華",340,95,245
"28522","2363矽統","110/07/13","統一-城中",116,676,-560
"28523","2363矽統","110/07/13","新光",1259,1031,228
"28524","2363矽統","110/07/13","永豐金證券",306,859,-553
"28525","2363矽統","110/07/13","元富-成功",323,96,227
"28526","2363矽統","110/07/13","元富",54,567,-513
"28527","2363矽統","110/07/13","豐農",228,23,205
"28528","2363矽統","110/07/13","瑞士信貸",202,666,-464
"28529","2363矽統","110/07/13","台灣企銀-岡山",186,4,182
"28530","2363矽統","110/07/13","永豐金-嘉義",67,468,-401
"28531","8112至上","110/07/13","摩根大通",688,296,392
"28532","8112至上","110/07/13","國票-中和",0,401,-401
"28533","8112至上","110/07/13","港商野村",344,145,199
"28534","8112至上","110/07/13","永豐金-板盛",0,205,-205
"28535","8112至上","110/07/13","兆豐-公益",195,5,190
"28536","8112至上","110/07/13","凱基-五股",43,155,-112
"28537","8112至上","110/07/13","台灣摩根士丹利",183,0,183
"28538","8112至上","110/07/13","凱基-市政",0,100,-100
"28539","8112至上","110/07/13","群益金鼎-敦南",153,2,151
"28540","8112至上","110/07/13","元大-大里德芳",1,92,-91
"28541","8112至上","110/07/13","臺銀-金山",146,26,120
"28542","8112至上","110/07/13","玉山-桃園",26,110,-84
"28543","8112至上","110/07/13","臺銀",133,19,114
"28544","8112至上","110/07/13","兆豐-天母",0,81,-81
"28545","8112至上","110/07/13","合庫-台中",115,6,109
"28546","8112至上","110/07/13","凱基-城中",3,84,-81
"28547","8112至上","110/07/13","亞東-板橋",134,26,108
"28548","8112至上","110/07/13","日盛-新莊",9,85,-76
"28549","8112至上","110/07/13","凱基-台北",414,326,88
"28550","8112至上","110/07/13","日盛-台中",2,64,-62
"28551","8112至上","110/07/13","新加坡商瑞銀",181,100,81
"28552","8112至上","110/07/13","日盛-中壢",3,64,-61
"28553","8112至上","110/07/13","國泰-敦南",108,31,77
"28554","8112至上","110/07/13","元大-台中",2,59,-57
"28555","8112至上","110/07/13","第一金-華江",77,4,73
"28556","8112至上","110/07/13","元大-雙和",7,64,-57
"28557","8112至上","110/07/13","永豐金-內湖",73,1,72
"28558","8112至上","110/07/13","元大-高雄",8,62,-54
"28559","8112至上","110/07/13","元大-永和",68,1,67
"28560","8112至上","110/07/13","元大-館前",2,55,-53
"28561","2929淘帝","110/07/13","玉山-新竹",130,0,130
"28562","2929淘帝","110/07/13","美商高盛",0,177,-177
"28563","2929淘帝","110/07/13","臺銀-民權",60,0,60
"28564","2929淘帝","110/07/13","凱基-台北",6,80,-74
"28565","2929淘帝","110/07/13","新百王",31,0,31
"28566","2929淘帝","110/07/13","元富-大裕",0,49,-49
"28567","2929淘帝","110/07/13","日盛-園區",30,0,30
"28568","2929淘帝","110/07/13","國泰-館前",3,51,-48
"28569","2929淘帝","110/07/13","元大-南投",31,1,30
"28570","2929淘帝","110/07/13","凱基-中壢",0,41,-41
"28571","2929淘帝","110/07/13","兆豐-忠孝",28,0,28
"28572","2929淘帝","110/07/13","港商野村",21,55,-34
"28573","2929淘帝","110/07/13","元大-民生",28,0,28
"28574","2929淘帝","110/07/13","華南永昌-南京",2,34,-32
"28575","2929淘帝","110/07/13","合庫-高雄",27,0,27
"28576","2929淘帝","110/07/13","群益金鼎-土城",0,30,-30
"28577","2929淘帝","110/07/13","凱基-豐中",27,0,27
"28578","2929淘帝","110/07/13","富邦-南屯",0,22,-22
"28579","2929淘帝","110/07/13","新光",21,4,17
"28580","2929淘帝","110/07/13","第一金-豐原",0,20,-20
"28581","2929淘帝","110/07/13","元大-天母",17,0,17
"28582","2929淘帝","110/07/13","元大-屏南",6,26,-20
"28583","2929淘帝","110/07/13","永興",14,0,14
"28584","2929淘帝","110/07/13","永豐金-敦南",1,21,-20
"28585","2929淘帝","110/07/13","富邦-台北",12,0,12
"28586","2929淘帝","110/07/13","凱基-三重",2,21,-19
"28587","2929淘帝","110/07/13","元大-永和",12,0,12
"28588","2929淘帝","110/07/13","富邦-仁愛",7,25,-18
"28589","2929淘帝","110/07/13","國票-天祥",11,0,11
"28590","2929淘帝","110/07/13","元大-北投",0,16,-16
"28591","5410國眾","110/07/13","兆豐-城中",274,0,274
"28592","5410國眾","110/07/13","元富-嘉義",0,103,-103
"28593","5410國眾","110/07/13","新光",50,4,46
"28594","5410國眾","110/07/13","凱基-台北",0,50,-50
"28595","5410國眾","110/07/13","國泰-台中",26,0,26
"28596","5410國眾","110/07/13","瑞士信貸",0,31,-31
"28597","5410國眾","110/07/13","新加坡商瑞銀",22,0,22
"28598","5410國眾","110/07/13","台新-新莊",0,27,-27
"28599","5410國眾","110/07/13","光和-嘉義",20,0,20
"28600","5410國眾","110/07/13","元大-汐止",0,20,-20
"28601","5410國眾","110/07/13","凱基-竹北",17,0,17
"28602","5410國眾","110/07/13","亞東-新竹",0,17,-17
"28603","5410國眾","110/07/13","新光-桃園",15,0,15
"28604","5410國眾","110/07/13","元大-南勢角",0,13,-13
"28605","5410國眾","110/07/13","凱基-台東",14,0,14
"28606","5410國眾","110/07/13","台新-台南",0,12,-12
"28607","5410國眾","110/07/13","富邦-竹北",11,0,11
"28608","5410國眾","110/07/13","中國信託",0,11,-11
"28609","5410國眾","110/07/13","元富-同大",10,0,10
"28610","5410國眾","110/07/13","華南永昌",0,11,-11
"28611","5410國眾","110/07/13","國泰-敦南",24,15,9
"28612","5410國眾","110/07/13","臺銀-臺南",0,10,-10
"28613","5410國眾","110/07/13","日盛-內湖",7,0,7
"28614","5410國眾","110/07/13","台灣企銀-民雄",0,10,-10
"28615","5410國眾","110/07/13","台新-左楠",7,0,7
"28616","5410國眾","110/07/13","高橋",0,10,-10
"28617","5410國眾","110/07/13","元大-新盛",18,12,6
"28618","5410國眾","110/07/13","康和-嘉義",0,10,-10
"28619","5410國眾","110/07/13","統一",5,0,5
"28620","5410國眾","110/07/13","凱基-基隆",0,10,-10
"28621","2841台開","110/07/13","中國信託-高雄",251,50,201
"28622","2841台開","110/07/13","兆豐-公益",0,177,-177
"28623","2841台開","110/07/13","日盛證券",210,13,197
"28624","2841台開","110/07/13","日進",0,152,-152
"28625","2841台開","110/07/13","第一金-台中",55,0,55
"28626","2841台開","110/07/13","港商野村",0,109,-109
"28627","2841台開","110/07/13","國泰-板橋",46,0,46
"28628","2841台開","110/07/13","日盛-信義",0,103,-103
"28629","2841台開","110/07/13","國泰-館前",48,3,45
"28630","2841台開","110/07/13","國泰-敦南",11,75,-64
"28631","2841台開","110/07/13","華南永昌-新莊",45,0,45
"28632","2841台開","110/07/13","永興",0,50,-50
"28633","2841台開","110/07/13","日盛-園區",42,0,42
"28634","2841台開","110/07/13","永豐金-敦南",61,104,-43
"28635","2841台開","110/07/13","台新證券",32,0,32
"28636","2841台開","110/07/13","富邦-台南",0,42,-42
"28637","2841台開","110/07/13","台新-高雄",32,2,30
"28638","2841台開","110/07/13","國票-安和",0,30,-30
"28639","2841台開","110/07/13","豐農",23,0,23
"28640","2841台開","110/07/13","元大-桃園",0,25,-25
"28641","2841台開","110/07/13","合庫-嘉義",20,0,20
"28642","2841台開","110/07/13","新光",8,32,-24
"28643","2841台開","110/07/13","華南永昌-高雄",20,0,20
"28644","2841台開","110/07/13","元大-仁愛",0,24,-24
"28645","2841台開","110/07/13","元大-樹林",16,0,16
"28646","2841台開","110/07/13","日盛-中和",0,20,-20
"28647","2841台開","110/07/13","第一金-華江",15,2,13
"28648","2841台開","110/07/13","元富",0,20,-20
"28649","2841台開","110/07/13","美商高盛",12,0,12
"28650","2841台開","110/07/13","富邦-宜蘭",0,20,-20
"28651","6207雷科","110/07/13","元大-高雄",121,0,121
"28652","6207雷科","110/07/13","華南永昌-朴子",1,60,-59
"28653","6207雷科","110/07/13","第一金-新興",20,0,20
"28654","6207雷科","110/07/13","元大-南海",0,36,-36
"28655","6207雷科","110/07/13","元富-三重",20,0,20
"28656","6207雷科","110/07/13","凱基-土城",0,35,-35
"28657","6207雷科","110/07/13","元大-林園",15,0,15
"28658","6207雷科","110/07/13","台灣企銀",0,20,-20
"28659","6207雷科","110/07/13","元大-金華",16,1,15
"28660","6207雷科","110/07/13","群益金鼎-丹鳳",0,20,-20
"28661","6207雷科","110/07/13","日盛證券",10,0,10
"28662","6207雷科","110/07/13","元大-博愛",0,17,-17
"28663","6207雷科","110/07/13","統一-台中",10,0,10
"28664","6207雷科","110/07/13","元大-北港",0,13,-13
"28665","6207雷科","110/07/13","群益金鼎-土城",10,0,10
"28666","6207雷科","110/07/13","新加坡商瑞銀",0,12,-12
"28667","6207雷科","110/07/13","群益金鼎-桃園",10,0,10
"28668","6207雷科","110/07/13","凱基-台北",4,16,-12
"28669","6207雷科","110/07/13","永豐金-新莊",10,0,10
"28670","6207雷科","110/07/13","日茂-埔里",0,11,-11
"28671","6207雷科","110/07/13","永豐金-新店",10,0,10
"28672","6207雷科","110/07/13","元大-莒光",0,11,-11
"28673","6207雷科","110/07/13","元大證券",9,0,9
"28674","6207雷科","110/07/13","統一-新竹",0,10,-10
"28675","6207雷科","110/07/13","日盛-木柵",9,1,8
"28676","6207雷科","110/07/13","元大-西螺",0,10,-10
"28677","6207雷科","110/07/13","兆豐-來福",8,0,8
"28678","6207雷科","110/07/13","康和-台中",0,8,-8
"28679","6207雷科","110/07/13","新光",7,0,7
"28680","6207雷科","110/07/13","兆豐-高雄",0,6,-6
"28681","3679新至陞","110/07/13","永豐金證券",50,0,50
"28682","3679新至陞","110/07/13","摩根大通",2,25,-23
"28683","3679新至陞","110/07/13","國泰-桃園",22,0,22
"28684","3679新至陞","110/07/13","元大-成功",0,22,-22
"28685","3679新至陞","110/07/13","台中銀-員林",11,0,11
"28686","3679新至陞","110/07/13","富邦-板橋",1,19,-18
"28687","3679新至陞","110/07/13","元大-文心興安",8,0,8
"28688","3679新至陞","110/07/13","日盛-新莊",0,10,-10
"28689","3679新至陞","110/07/13","美商高盛",6,0,6
"28690","3679新至陞","110/07/13","台新-台中",0,10,-10
"28691","3679新至陞","110/07/13","台新-高雄",6,0,6
"28692","3679新至陞","110/07/13","永豐金-新竹",0,8,-8
"28693","3679新至陞","110/07/13","凱基-台北",18,12,6
"28694","3679新至陞","110/07/13","瑞士信貸",12,19,-7
"28695","3679新至陞","110/07/13","日盛-復興",5,0,5
"28696","3679新至陞","110/07/13","統一-南京",0,7,-7
"28697","3679新至陞","110/07/13","(牛牛牛)亞-鑫豐",4,0,4
"28698","3679新至陞","110/07/13","凱基-新莊",0,7,-7
"28699","3679新至陞","110/07/13","元富-大昌",3,0,3
"28700","3679新至陞","110/07/13","新加坡商瑞銀",0,6,-6
"28701","3679新至陞","110/07/13","富邦-台北",3,0,3
"28702","3679新至陞","110/07/13","合庫-自強",0,5,-5
"28703","3679新至陞","110/07/13","日盛-樹林",2,0,2
"28704","3679新至陞","110/07/13","富邦-桃園",0,5,-5
"28705","3679新至陞","110/07/13","宏遠-光隆",2,0,2
"28706","3679新至陞","110/07/13","永豐金-潮州",0,4,-4
"28707","3679新至陞","110/07/13","美林",3,1,2
"28708","3679新至陞","110/07/13","臺銀-臺南",0,3,-3
"28709","3679新至陞","110/07/13","第一金-中壢",2,0,2
"28710","3679新至陞","110/07/13","元大-六合",0,3,-3
"28711","2727王品","110/07/13","富邦-台北",43,3,40
"28712","2727王品","110/07/13","台灣摩根士丹利",15,97,-82
"28713","2727王品","110/07/13","元大-基隆孝二",40,0,40
"28714","2727王品","110/07/13","玉山-台南",5,57,-52
"28715","2727王品","110/07/13","國票-新莊",40,1,39
"28716","2727王品","110/07/13","新加坡商瑞銀",0,48,-48
"28717","2727王品","110/07/13","第一金-豐原",66,42,24
"28718","2727王品","110/07/13","凱基-台北",41,77,-36
"28719","2727王品","110/07/13","永豐金-大園",34,10,24
"28720","2727王品","110/07/13","永豐金-永康",0,22,-22
"28721","2727王品","110/07/13","元大-北屯",22,0,22
"28722","2727王品","110/07/13","統一-台中",2,22,-20
"28723","2727王品","110/07/13","元大-東蘆",26,7,19
"28724","2727王品","110/07/13","國泰-台中",21,39,-18
"28725","2727王品","110/07/13","永豐金-萬盛",13,1,12
"28726","2727王品","110/07/13","合庫-彰化",3,20,-17
"28727","2727王品","110/07/13","日盛-嘉義",11,0,11
"28728","2727王品","110/07/13","港商野村",13,30,-17
"28729","2727王品","110/07/13","日盛-八德",11,0,11
"28730","2727王品","110/07/13","元大-楊梅",1,16,-15
"28731","2727王品","110/07/13","統一-竹南",11,0,11
"28732","2727王品","110/07/13","凱基-高美館",2,15,-13
"28733","2727王品","110/07/13","日盛-士林",12,2,10
"28734","2727王品","110/07/13","美商高盛",2,14,-12
"28735","2727王品","110/07/13","統一-敦南",10,0,10
"28736","2727王品","110/07/13","統一-平鎮",1,13,-12
"28737","2727王品","110/07/13","中國信託",15,5,10
"28738","2727王品","110/07/13","兆豐-台中港",4,16,-12
"28739","2727王品","110/07/13","兆豐-竹北",13,3,10
"28740","2727王品","110/07/13","凱基-八德",1,13,-12
"28741","1570力肯","110/07/13","新光",115,11,104
"28742","1570力肯","110/07/13","元大-北三重",0,162,-162
"28743","1570力肯","110/07/13","群益金鼎-高雄",54,0,54
"28744","1570力肯","110/07/13","元大-大灣",0,25,-25
"28745","1570力肯","110/07/13","國票-新莊",22,0,22
"28746","1570力肯","110/07/13","永豐金-苓雅",0,22,-22
"28747","1570力肯","110/07/13","日盛-桃園",12,0,12
"28748","1570力肯","110/07/13","永豐金-永康",0,19,-19
"28749","1570力肯","110/07/13","元大-高雄",12,0,12
"28750","1570力肯","110/07/13","富邦-員林",0,15,-15
"28751","1570力肯","110/07/13","合庫-自強",11,0,11
"28752","1570力肯","110/07/13","凱基-台南",0,11,-11
"28753","1570力肯","110/07/13","摩根大通",26,15,11
"28754","1570力肯","110/07/13","日盛-竹北",0,10,-10
"28755","1570力肯","110/07/13","永豐金-中盛",11,0,11
"28756","1570力肯","110/07/13","國票-九鼎",0,10,-10
"28757","1570力肯","110/07/13","兆豐-台中港",10,0,10
"28758","1570力肯","110/07/13","凱基-桃園",0,10,-10
"28759","1570力肯","110/07/13","國泰-松江",9,0,9
"28760","1570力肯","110/07/13","凱基-新豐",0,10,-10
"28761","1570力肯","110/07/13","元大-新盛",9,0,9
"28762","1570力肯","110/07/13","元大-學甲",0,10,-10
"28763","1570力肯","110/07/13","元富-緯城",6,0,6
"28764","1570力肯","110/07/13","群益金鼎-東湖",1,10,-9
"28765","1570力肯","110/07/13","統一-三重",5,0,5
"28766","1570力肯","110/07/13","大昌",0,6,-6
"28767","1570力肯","110/07/13","元大-前金",5,0,5
"28768","1570力肯","110/07/13","元大-土城學府",0,6,-6
"28769","1570力肯","110/07/13","永豐金證券",5,0,5
"28770","1570力肯","110/07/13","統一",0,5,-5
"28771","6180橘子","110/07/13","摩根大通",119,0,119
"28772","6180橘子","110/07/13","元大-崇德",2,61,-59
"28773","6180橘子","110/07/13","美商高盛",96,0,96
"28774","6180橘子","110/07/13","康和-台中",0,51,-51
"28775","6180橘子","110/07/13","新加坡商瑞銀",86,7,79
"28776","6180橘子","110/07/13","康和-台北",0,50,-50
"28777","6180橘子","110/07/13","元大-和平",40,0,40
"28778","6180橘子","110/07/13","元富-潮州",0,40,-40
"28779","6180橘子","110/07/13","凱基-台北",83,47,36
"28780","6180橘子","110/07/13","日盛-永康",0,26,-26
"28781","6180橘子","110/07/13","美林",39,5,34
"28782","6180橘子","110/07/13","永豐金-中正",0,24,-24
"28783","6180橘子","110/07/13","富邦-新竹華信",31,2,29
"28784","6180橘子","110/07/13","國泰-板橋",2,25,-23
"28785","6180橘子","110/07/13","統一-南京",21,0,21
"28786","6180橘子","110/07/13","日盛-大墩",0,20,-20
"28787","6180橘子","110/07/13","富邦-陽明",24,3,21
"28788","6180橘子","110/07/13","元大-草屯",13,32,-19
"28789","6180橘子","110/07/13","大昌-樹林",21,1,20
"28790","6180橘子","110/07/13","元富-林園",1,18,-17
"28791","6180橘子","110/07/13","花旗環球",19,0,19
"28792","6180橘子","110/07/13","新光-新竹",1,18,-17
"28793","6180橘子","110/07/13","華南永昌-台南",19,0,19
"28794","6180橘子","110/07/13","元大-土城永寧",0,17,-17
"28795","6180橘子","110/07/13","福勝",14,0,14
"28796","6180橘子","110/07/13","國泰-新莊",3,19,-16
"28797","6180橘子","110/07/13","富邦-嘉義",12,1,11
"28798","6180橘子","110/07/13","中國信託-永康",6,21,-15
"28799","6180橘子","110/07/13","元大-板橋三民",11,0,11
"28800","6180橘子","110/07/13","凱基-東港",1,15,-14
"28801","2390云辰","110/07/13","新加坡商瑞銀",562,75,487
"28802","2390云辰","110/07/13","大展-台南",0,532,-532
"28803","2390云辰","110/07/13","台灣摩根士丹利",330,155,175
"28804","2390云辰","110/07/13","凱基-台北",668,854,-186
"28805","2390云辰","110/07/13","兆豐-公益",126,25,101
"28806","2390云辰","110/07/13","凱基-三重",12,172,-160
"28807","2390云辰","110/07/13","元富-中港",100,2,98
"28808","2390云辰","110/07/13","兆豐-忠孝",4,161,-157
"28809","2390云辰","110/07/13","統一-新台中",106,9,97
"28810","2390云辰","110/07/13","元大-士林",19,170,-151
"28811","2390云辰","110/07/13","中國信託-松江",81,11,70
"28812","2390云辰","110/07/13","臺銀-新竹",14,117,-103
"28813","2390云辰","110/07/13","日盛-板橋",72,3,69
"28814","2390云辰","110/07/13","國票-台中",4,102,-98
"28815","2390云辰","110/07/13","日盛-和美",57,0,57
"28816","2390云辰","110/07/13","新光",147,232,-85
"28817","2390云辰","110/07/13","永豐金-桃園",88,36,52
"28818","2390云辰","110/07/13","致和-崇德",2,70,-68
"28819","2390云辰","110/07/13","玉山-士林",54,4,50
"28820","2390云辰","110/07/13","群益金鼎-屏東",2,70,-68
"28821","2390云辰","110/07/13","富邦-仁愛",56,6,50
"28822","2390云辰","110/07/13","元大-大里",35,98,-63
"28823","2390云辰","110/07/13","第一金-豐原",50,1,49
"28824","2390云辰","110/07/13","元大-萬華",35,94,-59
"28825","2390云辰","110/07/13","摩根大通",502,453,49
"28826","2390云辰","110/07/13","元富-吉利",2,60,-58
"28827","2390云辰","110/07/13","凱基-松山",61,13,48
"28828","2390云辰","110/07/13","兆豐-新竹",3,53,-50
"28829","2390云辰","110/07/13","大昌",64,22,42
"28830","2390云辰","110/07/13","富邦-嘉義",65,108,-43
"28831","2363矽統","110/07/13","凱基-南崁",2133,63,2070
"28832","2363矽統","110/07/13","凱基-幸福",36,4048,-4012
"28833","2363矽統","110/07/13","國泰-敦南",2195,1617,578
"28834","2363矽統","110/07/13","統一",192,3325,-3133
"28835","2363矽統","110/07/13","中農",670,139,531
"28836","2363矽統","110/07/13","新加坡商瑞銀",1000,2747,-1747
"28837","2363矽統","110/07/13","康和-台中",638,154,484
"28838","2363矽統","110/07/13","凱基-台北",5359,6609,-1250
"28839","2363矽統","110/07/13","群益金鼎-三民",577,137,440
"28840","2363矽統","110/07/13","摩根大通",1930,2858,-928
"28841","2363矽統","110/07/13","台新-屏東",510,88,422
"28842","2363矽統","110/07/13","港商野村",960,1679,-719
"28843","2363矽統","110/07/13","德信-中正",455,67,388
"28844","2363矽統","110/07/13","兆豐-復興",25,705,-680
"28845","2363矽統","110/07/13","日盛-竹北",365,70,295
"28846","2363矽統","110/07/13","統一-仁愛",114,755,-641
"28847","2363矽統","110/07/13","元大-佳里",452,189,263
"28848","2363矽統","110/07/13","統一-敦南",29,638,-609
"28849","2363矽統","110/07/13","國票-博愛",296,38,258
"28850","2363矽統","110/07/13","統一-土城",100,704,-604
"28851","2363矽統","110/07/13","元大-萬華",340,95,245
"28852","2363矽統","110/07/13","統一-城中",116,676,-560
"28853","2363矽統","110/07/13","新光",1259,1031,228
"28854","2363矽統","110/07/13","永豐金證券",306,859,-553
"28855","2363矽統","110/07/13","元富-成功",323,96,227
"28856","2363矽統","110/07/13","元富",54,567,-513
"28857","2363矽統","110/07/13","豐農",228,23,205
"28858","2363矽統","110/07/13","瑞士信貸",202,666,-464
"28859","2363矽統","110/07/13","台灣企銀-岡山",186,4,182
"28860","2363矽統","110/07/13","永豐金-嘉義",67,468,-401
"28861","8112至上","110/07/13","摩根大通",688,296,392
"28862","8112至上","110/07/13","國票-中和",0,401,-401
"28863","8112至上","110/07/13","港商野村",344,145,199
"28864","8112至上","110/07/13","永豐金-板盛",0,205,-205
"28865","8112至上","110/07/13","兆豐-公益",195,5,190
"28866","8112至上","110/07/13","凱基-五股",43,155,-112
"28867","8112至上","110/07/13","台灣摩根士丹利",183,0,183
"28868","8112至上","110/07/13","凱基-市政",0,100,-100
"28869","8112至上","110/07/13","群益金鼎-敦南",153,2,151
"28870","8112至上","110/07/13","元大-大里德芳",1,92,-91
"28871","8112至上","110/07/13","臺銀-金山",146,26,120
"28872","8112至上","110/07/13","玉山-桃園",26,110,-84
"28873","8112至上","110/07/13","臺銀",133,19,114
"28874","8112至上","110/07/13","兆豐-天母",0,81,-81
"28875","8112至上","110/07/13","合庫-台中",115,6,109
"28876","8112至上","110/07/13","凱基-城中",3,84,-81
"28877","8112至上","110/07/13","亞東-板橋",134,26,108
"28878","8112至上","110/07/13","日盛-新莊",9,85,-76
"28879","8112至上","110/07/13","凱基-台北",414,326,88
"28880","8112至上","110/07/13","日盛-台中",2,64,-62
"28881","8112至上","110/07/13","新加坡商瑞銀",181,100,81
"28882","8112至上","110/07/13","日盛-中壢",3,64,-61
"28883","8112至上","110/07/13","國泰-敦南",108,31,77
"28884","8112至上","110/07/13","元大-台中",2,59,-57
"28885","8112至上","110/07/13","第一金-華江",77,4,73
"28886","8112至上","110/07/13","元大-雙和",7,64,-57
"28887","8112至上","110/07/13","永豐金-內湖",73,1,72
"28888","8112至上","110/07/13","元大-高雄",8,62,-54
"28889","8112至上","110/07/13","元大-永和",68,1,67
"28890","8112至上","110/07/13","元大-館前",2,55,-53
"28891","2929淘帝","110/07/13","玉山-新竹",130,0,130
"28892","2929淘帝","110/07/13","美商高盛",0,177,-177
"28893","2929淘帝","110/07/13","臺銀-民權",60,0,60
"28894","2929淘帝","110/07/13","凱基-台北",6,80,-74
"28895","2929淘帝","110/07/13","新百王",31,0,31
"28896","2929淘帝","110/07/13","元富-大裕",0,49,-49
"28897","2929淘帝","110/07/13","日盛-園區",30,0,30
"28898","2929淘帝","110/07/13","國泰-館前",3,51,-48
"28899","2929淘帝","110/07/13","元大-南投",31,1,30
"28900","2929淘帝","110/07/13","凱基-中壢",0,41,-41
"28901","2929淘帝","110/07/13","兆豐-忠孝",28,0,28
"28902","2929淘帝","110/07/13","港商野村",21,55,-34
"28903","2929淘帝","110/07/13","元大-民生",28,0,28
"28904","2929淘帝","110/07/13","華南永昌-南京",2,34,-32
"28905","2929淘帝","110/07/13","合庫-高雄",27,0,27
"28906","2929淘帝","110/07/13","群益金鼎-土城",0,30,-30
"28907","2929淘帝","110/07/13","凱基-豐中",27,0,27
"28908","2929淘帝","110/07/13","富邦-南屯",0,22,-22
"28909","2929淘帝","110/07/13","新光",21,4,17
"28910","2929淘帝","110/07/13","第一金-豐原",0,20,-20
"28911","2929淘帝","110/07/13","元大-天母",17,0,17
"28912","2929淘帝","110/07/13","元大-屏南",6,26,-20
"28913","2929淘帝","110/07/13","永興",14,0,14
"28914","2929淘帝","110/07/13","永豐金-敦南",1,21,-20
"28915","2929淘帝","110/07/13","富邦-台北",12,0,12
"28916","2929淘帝","110/07/13","凱基-三重",2,21,-19
"28917","2929淘帝","110/07/13","元大-永和",12,0,12
"28918","2929淘帝","110/07/13","富邦-仁愛",7,25,-18
"28919","2929淘帝","110/07/13","國票-天祥",11,0,11
"28920","2929淘帝","110/07/13","元大-北投",0,16,-16
"28921","5410國眾","110/07/13","兆豐-城中",274,0,274
"28922","5410國眾","110/07/13","元富-嘉義",0,103,-103
"28923","5410國眾","110/07/13","新光",50,4,46
"28924","5410國眾","110/07/13","凱基-台北",0,50,-50
"28925","5410國眾","110/07/13","國泰-台中",26,0,26
"28926","5410國眾","110/07/13","瑞士信貸",0,31,-31
"28927","5410國眾","110/07/13","新加坡商瑞銀",22,0,22
"28928","5410國眾","110/07/13","台新-新莊",0,27,-27
"28929","5410國眾","110/07/13","光和-嘉義",20,0,20
"28930","5410國眾","110/07/13","元大-汐止",0,20,-20
"28931","5410國眾","110/07/13","凱基-竹北",17,0,17
"28932","5410國眾","110/07/13","亞東-新竹",0,17,-17
"28933","5410國眾","110/07/13","新光-桃園",15,0,15
"28934","5410國眾","110/07/13","元大-南勢角",0,13,-13
"28935","5410國眾","110/07/13","凱基-台東",14,0,14
"28936","5410國眾","110/07/13","台新-台南",0,12,-12
"28937","5410國眾","110/07/13","富邦-竹北",11,0,11
"28938","5410國眾","110/07/13","中國信託",0,11,-11
"28939","5410國眾","110/07/13","元富-同大",10,0,10
"28940","5410國眾","110/07/13","華南永昌",0,11,-11
"28941","5410國眾","110/07/13","國泰-敦南",24,15,9
"28942","5410國眾","110/07/13","臺銀-臺南",0,10,-10
"28943","5410國眾","110/07/13","日盛-內湖",7,0,7
"28944","5410國眾","110/07/13","台灣企銀-民雄",0,10,-10
"28945","5410國眾","110/07/13","台新-左楠",7,0,7
"28946","5410國眾","110/07/13","高橋",0,10,-10
"28947","5410國眾","110/07/13","元大-新盛",18,12,6
"28948","5410國眾","110/07/13","康和-嘉義",0,10,-10
"28949","5410國眾","110/07/13","統一",5,0,5
"28950","5410國眾","110/07/13","凱基-基隆",0,10,-10
"28951","2841台開","110/07/13","中國信託-高雄",251,50,201
"28952","2841台開","110/07/13","兆豐-公益",0,177,-177
"28953","2841台開","110/07/13","日盛證券",210,13,197
"28954","2841台開","110/07/13","日進",0,152,-152
"28955","2841台開","110/07/13","第一金-台中",55,0,55
"28956","2841台開","110/07/13","港商野村",0,109,-109
"28957","2841台開","110/07/13","國泰-板橋",46,0,46
"28958","2841台開","110/07/13","日盛-信義",0,103,-103
"28959","2841台開","110/07/13","國泰-館前",48,3,45
"28960","2841台開","110/07/13","國泰-敦南",11,75,-64
"28961","2841台開","110/07/13","華南永昌-新莊",45,0,45
"28962","2841台開","110/07/13","永興",0,50,-50
"28963","2841台開","110/07/13","日盛-園區",42,0,42
"28964","2841台開","110/07/13","永豐金-敦南",61,104,-43
"28965","2841台開","110/07/13","台新證券",32,0,32
"28966","2841台開","110/07/13","富邦-台南",0,42,-42
"28967","2841台開","110/07/13","台新-高雄",32,2,30
"28968","2841台開","110/07/13","國票-安和",0,30,-30
"28969","2841台開","110/07/13","豐農",23,0,23
"28970","2841台開","110/07/13","元大-桃園",0,25,-25
"28971","2841台開","110/07/13","合庫-嘉義",20,0,20
"28972","2841台開","110/07/13","新光",8,32,-24
"28973","2841台開","110/07/13","華南永昌-高雄",20,0,20
"28974","2841台開","110/07/13","元大-仁愛",0,24,-24
"28975","2841台開","110/07/13","元大-樹林",16,0,16
"28976","2841台開","110/07/13","日盛-中和",0,20,-20
"28977","2841台開","110/07/13","第一金-華江",15,2,13
"28978","2841台開","110/07/13","元富",0,20,-20
"28979","2841台開","110/07/13","美商高盛",12,0,12
"28980","2841台開","110/07/13","富邦-宜蘭",0,20,-20
"28981","6207雷科","110/07/13","元大-高雄",121,0,121
"28982","6207雷科","110/07/13","華南永昌-朴子",1,60,-59
"28983","6207雷科","110/07/13","第一金-新興",20,0,20
"28984","6207雷科","110/07/13","元大-南海",0,36,-36
"28985","6207雷科","110/07/13","元富-三重",20,0,20
"28986","6207雷科","110/07/13","凱基-土城",0,35,-35
"28987","6207雷科","110/07/13","元大-林園",15,0,15
"28988","6207雷科","110/07/13","台灣企銀",0,20,-20
"28989","6207雷科","110/07/13","元大-金華",16,1,15
"28990","6207雷科","110/07/13","群益金鼎-丹鳳",0,20,-20
"28991","6207雷科","110/07/13","日盛證券",10,0,10
"28992","6207雷科","110/07/13","元大-博愛",0,17,-17
"28993","6207雷科","110/07/13","統一-台中",10,0,10
"28994","6207雷科","110/07/13","元大-北港",0,13,-13
"28995","6207雷科","110/07/13","群益金鼎-土城",10,0,10
"28996","6207雷科","110/07/13","新加坡商瑞銀",0,12,-12
"28997","6207雷科","110/07/13","群益金鼎-桃園",10,0,10
"28998","6207雷科","110/07/13","凱基-台北",4,16,-12
"28999","6207雷科","110/07/13","永豐金-新莊",10,0,10
"29000","6207雷科","110/07/13","日茂-埔里",0,11,-11
"29001","6207雷科","110/07/13","永豐金-新店",10,0,10
"29002","6207雷科","110/07/13","元大-莒光",0,11,-11
"29003","6207雷科","110/07/13","元大證券",9,0,9
"29004","6207雷科","110/07/13","統一-新竹",0,10,-10
"29005","6207雷科","110/07/13","日盛-木柵",9,1,8
"29006","6207雷科","110/07/13","元大-西螺",0,10,-10
"29007","6207雷科","110/07/13","兆豐-來福",8,0,8
"29008","6207雷科","110/07/13","康和-台中",0,8,-8
"29009","6207雷科","110/07/13","新光",7,0,7
"29010","6207雷科","110/07/13","兆豐-高雄",0,6,-6
"29011","3679新至陞","110/07/13","永豐金證券",50,0,50
"29012","3679新至陞","110/07/13","摩根大通",2,25,-23
"29013","3679新至陞","110/07/13","國泰-桃園",22,0,22
"29014","3679新至陞","110/07/13","元大-成功",0,22,-22
"29015","3679新至陞","110/07/13","台中銀-員林",11,0,11
"29016","3679新至陞","110/07/13","富邦-板橋",1,19,-18
"29017","3679新至陞","110/07/13","元大-文心興安",8,0,8
"29018","3679新至陞","110/07/13","日盛-新莊",0,10,-10
"29019","3679新至陞","110/07/13","美商高盛",6,0,6
"29020","3679新至陞","110/07/13","台新-台中",0,10,-10
"29021","3679新至陞","110/07/13","台新-高雄",6,0,6
"29022","3679新至陞","110/07/13","永豐金-新竹",0,8,-8
"29023","3679新至陞","110/07/13","凱基-台北",18,12,6
"29024","3679新至陞","110/07/13","瑞士信貸",12,19,-7
"29025","3679新至陞","110/07/13","日盛-復興",5,0,5
"29026","3679新至陞","110/07/13","統一-南京",0,7,-7
"29027","3679新至陞","110/07/13","(牛牛牛)亞-鑫豐",4,0,4
"29028","3679新至陞","110/07/13","凱基-新莊",0,7,-7
"29029","3679新至陞","110/07/13","元富-大昌",3,0,3
"29030","3679新至陞","110/07/13","新加坡商瑞銀",0,6,-6
"29031","3679新至陞","110/07/13","富邦-台北",3,0,3
"29032","3679新至陞","110/07/13","合庫-自強",0,5,-5
"29033","3679新至陞","110/07/13","日盛-樹林",2,0,2
"29034","3679新至陞","110/07/13","富邦-桃園",0,5,-5
"29035","3679新至陞","110/07/13","宏遠-光隆",2,0,2
"29036","3679新至陞","110/07/13","永豐金-潮州",0,4,-4
"29037","3679新至陞","110/07/13","美林",3,1,2
"29038","3679新至陞","110/07/13","臺銀-臺南",0,3,-3
"29039","3679新至陞","110/07/13","第一金-中壢",2,0,2
"29040","3679新至陞","110/07/13","元大-六合",0,3,-3
"29041","2727王品","110/07/13","富邦-台北",43,3,40
"29042","2727王品","110/07/13","台灣摩根士丹利",15,97,-82
"29043","2727王品","110/07/13","元大-基隆孝二",40,0,40
"29044","2727王品","110/07/13","玉山-台南",5,57,-52
"29045","2727王品","110/07/13","國票-新莊",40,1,39
"29046","2727王品","110/07/13","新加坡商瑞銀",0,48,-48
"29047","2727王品","110/07/13","第一金-豐原",66,42,24
"29048","2727王品","110/07/13","凱基-台北",41,77,-36
"29049","2727王品","110/07/13","永豐金-大園",34,10,24
"29050","2727王品","110/07/13","永豐金-永康",0,22,-22
"29051","2727王品","110/07/13","元大-北屯",22,0,22
"29052","2727王品","110/07/13","統一-台中",2,22,-20
"29053","2727王品","110/07/13","元大-東蘆",26,7,19
"29054","2727王品","110/07/13","國泰-台中",21,39,-18
"29055","2727王品","110/07/13","永豐金-萬盛",13,1,12
"29056","2727王品","110/07/13","合庫-彰化",3,20,-17
"29057","2727王品","110/07/13","日盛-嘉義",11,0,11
"29058","2727王品","110/07/13","港商野村",13,30,-17
"29059","2727王品","110/07/13","日盛-八德",11,0,11
"29060","2727王品","110/07/13","元大-楊梅",1,16,-15
"29061","2727王品","110/07/13","統一-竹南",11,0,11
"29062","2727王品","110/07/13","凱基-高美館",2,15,-13
"29063","2727王品","110/07/13","日盛-士林",12,2,10
"29064","2727王品","110/07/13","美商高盛",2,14,-12
"29065","2727王品","110/07/13","統一-敦南",10,0,10
"29066","2727王品","110/07/13","統一-平鎮",1,13,-12
"29067","2727王品","110/07/13","中國信託",15,5,10
"29068","2727王品","110/07/13","兆豐-台中港",4,16,-12
"29069","2727王品","110/07/13","兆豐-竹北",13,3,10
"29070","2727王品","110/07/13","凱基-八德",1,13,-12
"29071","1570力肯","110/07/13","新光",115,11,104
"29072","1570力肯","110/07/13","元大-北三重",0,162,-162
"29073","1570力肯","110/07/13","群益金鼎-高雄",54,0,54
"29074","1570力肯","110/07/13","元大-大灣",0,25,-25
"29075","1570力肯","110/07/13","國票-新莊",22,0,22
"29076","1570力肯","110/07/13","永豐金-苓雅",0,22,-22
"29077","1570力肯","110/07/13","日盛-桃園",12,0,12
"29078","1570力肯","110/07/13","永豐金-永康",0,19,-19
"29079","1570力肯","110/07/13","元大-高雄",12,0,12
"29080","1570力肯","110/07/13","富邦-員林",0,15,-15
"29081","1570力肯","110/07/13","合庫-自強",11,0,11
"29082","1570力肯","110/07/13","凱基-台南",0,11,-11
"29083","1570力肯","110/07/13","摩根大通",26,15,11
"29084","1570力肯","110/07/13","日盛-竹北",0,10,-10
"29085","1570力肯","110/07/13","永豐金-中盛",11,0,11
"29086","1570力肯","110/07/13","國票-九鼎",0,10,-10
"29087","1570力肯","110/07/13","兆豐-台中港",10,0,10
"29088","1570力肯","110/07/13","凱基-桃園",0,10,-10
"29089","1570力肯","110/07/13","國泰-松江",9,0,9
"29090","1570力肯","110/07/13","凱基-新豐",0,10,-10
"29091","1570力肯","110/07/13","元大-新盛",9,0,9
"29092","1570力肯","110/07/13","元大-學甲",0,10,-10
"29093","1570力肯","110/07/13","元富-緯城",6,0,6
"29094","1570力肯","110/07/13","群益金鼎-東湖",1,10,-9
"29095","1570力肯","110/07/13","統一-三重",5,0,5
"29096","1570力肯","110/07/13","大昌",0,6,-6
"29097","1570力肯","110/07/13","元大-前金",5,0,5
"29098","1570力肯","110/07/13","元大-土城學府",0,6,-6
"29099","1570力肯","110/07/13","永豐金證券",5,0,5
"29100","1570力肯","110/07/13","統一",0,5,-5
"29101","6180橘子","110/07/13","摩根大通",119,0,119
"29102","6180橘子","110/07/13","元大-崇德",2,61,-59
"29103","6180橘子","110/07/13","美商高盛",96,0,96
"29104","6180橘子","110/07/13","康和-台中",0,51,-51
"29105","6180橘子","110/07/13","新加坡商瑞銀",86,7,79
"29106","6180橘子","110/07/13","康和-台北",0,50,-50
"29107","6180橘子","110/07/13","元大-和平",40,0,40
"29108","6180橘子","110/07/13","元富-潮州",0,40,-40
"29109","6180橘子","110/07/13","凱基-台北",83,47,36
"29110","6180橘子","110/07/13","日盛-永康",0,26,-26
"29111","6180橘子","110/07/13","美林",39,5,34
"29112","6180橘子","110/07/13","永豐金-中正",0,24,-24
"29113","6180橘子","110/07/13","富邦-新竹華信",31,2,29
"29114","6180橘子","110/07/13","國泰-板橋",2,25,-23
"29115","6180橘子","110/07/13","統一-南京",21,0,21
"29116","6180橘子","110/07/13","日盛-大墩",0,20,-20
"29117","6180橘子","110/07/13","富邦-陽明",24,3,21
"29118","6180橘子","110/07/13","元大-草屯",13,32,-19
"29119","6180橘子","110/07/13","大昌-樹林",21,1,20
"29120","6180橘子","110/07/13","元富-林園",1,18,-17
"29121","6180橘子","110/07/13","花旗環球",19,0,19
"29122","6180橘子","110/07/13","新光-新竹",1,18,-17
"29123","6180橘子","110/07/13","華南永昌-台南",19,0,19
"29124","6180橘子","110/07/13","元大-土城永寧",0,17,-17
"29125","6180橘子","110/07/13","福勝",14,0,14
"29126","6180橘子","110/07/13","國泰-新莊",3,19,-16
"29127","6180橘子","110/07/13","富邦-嘉義",12,1,11
"29128","6180橘子","110/07/13","中國信託-永康",6,21,-15
"29129","6180橘子","110/07/13","元大-板橋三民",11,0,11
"29130","6180橘子","110/07/13","凱基-東港",1,15,-14
"29131","2390云辰","110/07/13","新加坡商瑞銀",562,75,487
"29132","2390云辰","110/07/13","大展-台南",0,532,-532
"29133","2390云辰","110/07/13","台灣摩根士丹利",330,155,175
"29134","2390云辰","110/07/13","凱基-台北",668,854,-186
"29135","2390云辰","110/07/13","兆豐-公益",126,25,101
"29136","2390云辰","110/07/13","凱基-三重",12,172,-160
"29137","2390云辰","110/07/13","元富-中港",100,2,98
"29138","2390云辰","110/07/13","兆豐-忠孝",4,161,-157
"29139","2390云辰","110/07/13","統一-新台中",106,9,97
"29140","2390云辰","110/07/13","元大-士林",19,170,-151
"29141","2390云辰","110/07/13","中國信託-松江",81,11,70
"29142","2390云辰","110/07/13","臺銀-新竹",14,117,-103
"29143","2390云辰","110/07/13","日盛-板橋",72,3,69
"29144","2390云辰","110/07/13","國票-台中",4,102,-98
"29145","2390云辰","110/07/13","日盛-和美",57,0,57
"29146","2390云辰","110/07/13","新光",147,232,-85
"29147","2390云辰","110/07/13","永豐金-桃園",88,36,52
"29148","2390云辰","110/07/13","致和-崇德",2,70,-68
"29149","2390云辰","110/07/13","玉山-士林",54,4,50
"29150","2390云辰","110/07/13","群益金鼎-屏東",2,70,-68
"29151","2390云辰","110/07/13","富邦-仁愛",56,6,50
"29152","2390云辰","110/07/13","元大-大里",35,98,-63
"29153","2390云辰","110/07/13","第一金-豐原",50,1,49
"29154","2390云辰","110/07/13","元大-萬華",35,94,-59
"29155","2390云辰","110/07/13","摩根大通",502,453,49
"29156","2390云辰","110/07/13","元富-吉利",2,60,-58
"29157","2390云辰","110/07/13","凱基-松山",61,13,48
"29158","2390云辰","110/07/13","兆豐-新竹",3,53,-50
"29159","2390云辰","110/07/13","大昌",64,22,42
"29160","2390云辰","110/07/13","富邦-嘉義",65,108,-43
"29161","2363矽統","110/07/13","凱基-南崁",2133,63,2070
"29162","2363矽統","110/07/13","凱基-幸福",36,4048,-4012
"29163","2363矽統","110/07/13","國泰-敦南",2195,1617,578
"29164","2363矽統","110/07/13","統一",192,3325,-3133
"29165","2363矽統","110/07/13","中農",670,139,531
"29166","2363矽統","110/07/13","新加坡商瑞銀",1000,2747,-1747
"29167","2363矽統","110/07/13","康和-台中",638,154,484
"29168","2363矽統","110/07/13","凱基-台北",5359,6609,-1250
"29169","2363矽統","110/07/13","群益金鼎-三民",577,137,440
"29170","2363矽統","110/07/13","摩根大通",1930,2858,-928
"29171","2363矽統","110/07/13","台新-屏東",510,88,422
"29172","2363矽統","110/07/13","港商野村",960,1679,-719
"29173","2363矽統","110/07/13","德信-中正",455,67,388
"29174","2363矽統","110/07/13","兆豐-復興",25,705,-680
"29175","2363矽統","110/07/13","日盛-竹北",365,70,295
"29176","2363矽統","110/07/13","統一-仁愛",114,755,-641
"29177","2363矽統","110/07/13","元大-佳里",452,189,263
"29178","2363矽統","110/07/13","統一-敦南",29,638,-609
"29179","2363矽統","110/07/13","國票-博愛",296,38,258
"29180","2363矽統","110/07/13","統一-土城",100,704,-604
"29181","2363矽統","110/07/13","元大-萬華",340,95,245
"29182","2363矽統","110/07/13","統一-城中",116,676,-560
"29183","2363矽統","110/07/13","新光",1259,1031,228
"29184","2363矽統","110/07/13","永豐金證券",306,859,-553
"29185","2363矽統","110/07/13","元富-成功",323,96,227
"29186","2363矽統","110/07/13","元富",54,567,-513
"29187","2363矽統","110/07/13","豐農",228,23,205
"29188","2363矽統","110/07/13","瑞士信貸",202,666,-464
"29189","2363矽統","110/07/13","台灣企銀-岡山",186,4,182
"29190","2363矽統","110/07/13","永豐金-嘉義",67,468,-401
"29191","8112至上","110/07/13","摩根大通",688,296,392
"29192","8112至上","110/07/13","國票-中和",0,401,-401
"29193","8112至上","110/07/13","港商野村",344,145,199
"29194","8112至上","110/07/13","永豐金-板盛",0,205,-205
"29195","8112至上","110/07/13","兆豐-公益",195,5,190
"29196","8112至上","110/07/13","凱基-五股",43,155,-112
"29197","8112至上","110/07/13","台灣摩根士丹利",183,0,183
"29198","8112至上","110/07/13","凱基-市政",0,100,-100
"29199","8112至上","110/07/13","群益金鼎-敦南",153,2,151
"29200","8112至上","110/07/13","元大-大里德芳",1,92,-91
"29201","8112至上","110/07/13","臺銀-金山",146,26,120
"29202","8112至上","110/07/13","玉山-桃園",26,110,-84
"29203","8112至上","110/07/13","臺銀",133,19,114
"29204","8112至上","110/07/13","兆豐-天母",0,81,-81
"29205","8112至上","110/07/13","合庫-台中",115,6,109
"29206","8112至上","110/07/13","凱基-城中",3,84,-81
"29207","8112至上","110/07/13","亞東-板橋",134,26,108
"29208","8112至上","110/07/13","日盛-新莊",9,85,-76
"29209","8112至上","110/07/13","凱基-台北",414,326,88
"29210","8112至上","110/07/13","日盛-台中",2,64,-62
"29211","8112至上","110/07/13","新加坡商瑞銀",181,100,81
"29212","8112至上","110/07/13","日盛-中壢",3,64,-61
"29213","8112至上","110/07/13","國泰-敦南",108,31,77
"29214","8112至上","110/07/13","元大-台中",2,59,-57
"29215","8112至上","110/07/13","第一金-華江",77,4,73
"29216","8112至上","110/07/13","元大-雙和",7,64,-57
"29217","8112至上","110/07/13","永豐金-內湖",73,1,72
"29218","8112至上","110/07/13","元大-高雄",8,62,-54
"29219","8112至上","110/07/13","元大-永和",68,1,67
"29220","8112至上","110/07/13","元大-館前",2,55,-53
"29221","4903聯光通","110/07/13","台灣企銀-太平",56,0,56
"29222","4903聯光通","110/07/13","土銀",0,32,-32
"29223","4903聯光通","110/07/13","元富-新興",23,0,23
"29224","4903聯光通","110/07/13","元大-樹林",0,19,-19
"29225","4903聯光通","110/07/13","日盛-樹林",22,0,22
"29226","4903聯光通","110/07/13","凱基-士林",0,17,-17
"29227","4903聯光通","110/07/13","兆豐-天母",20,0,20
"29228","4903聯光通","110/07/13","國票-博愛",0,14,-14
"29229","4903聯光通","110/07/13","華南永昌-桃園",20,0,20
"29230","4903聯光通","110/07/13","元富",0,10,-10
"29231","4903聯光通","110/07/13","富邦-新店",10,0,10
"29232","4903聯光通","110/07/13","新光",0,10,-10
"29233","4903聯光通","110/07/13","新光-台中",5,0,5
"29234","4903聯光通","110/07/13","玉山-南京東路",0,10,-10
"29235","4903聯光通","110/07/13","華南永昌-台中",5,0,5
"29236","4903聯光通","110/07/13","富邦-陽明",0,10,-10
"29237","4903聯光通","110/07/13","元大-崇德",5,0,5
"29238","4903聯光通","110/07/13","元大-大甲",0,8,-8
"29239","4903聯光通","110/07/13","元大-草屯",5,0,5
"29240","4903聯光通","110/07/13","富邦-台中",0,7,-7
"29241","4903聯光通","110/07/13","元富-草屯",4,0,4
"29242","4903聯光通","110/07/13","凱基-中壢",0,6,-6
"29243","4903聯光通","110/07/13","元大-清水",4,0,4
"29244","4903聯光通","110/07/13","臺銀-民權",0,5,-5
"29245","4903聯光通","110/07/13","元大-東泰",4,0,4
"29246","4903聯光通","110/07/13","日盛-板橋",0,5,-5
"29247","4903聯光通","110/07/13","元大-佳里",2,0,2
"29248","4903聯光通","110/07/13","中國信託-忠孝",0,5,-5
"29249","4903聯光通","110/07/13","永豐金-板橋",2,0,2
"29250","4903聯光通","110/07/13","永豐金-鳳山",0,5,-5
"29251","2929淘帝","110/07/13","玉山-新竹",130,0,130
"29252","2929淘帝","110/07/13","美商高盛",0,177,-177
"29253","2929淘帝","110/07/13","臺銀-民權",60,0,60
"29254","2929淘帝","110/07/13","凱基-台北",6,80,-74
"29255","2929淘帝","110/07/13","新百王",31,0,31
"29256","2929淘帝","110/07/13","元富-大裕",0,49,-49
"29257","2929淘帝","110/07/13","日盛-園區",30,0,30
"29258","2929淘帝","110/07/13","國泰-館前",3,51,-48
"29259","2929淘帝","110/07/13","元大-南投",31,1,30
"29260","2929淘帝","110/07/13","凱基-中壢",0,41,-41
"29261","2929淘帝","110/07/13","兆豐-忠孝",28,0,28
"29262","2929淘帝","110/07/13","港商野村",21,55,-34
"29263","2929淘帝","110/07/13","元大-民生",28,0,28
"29264","2929淘帝","110/07/13","華南永昌-南京",2,34,-32
"29265","2929淘帝","110/07/13","合庫-高雄",27,0,27
"29266","2929淘帝","110/07/13","群益金鼎-土城",0,30,-30
"29267","2929淘帝","110/07/13","凱基-豐中",27,0,27
"29268","2929淘帝","110/07/13","富邦-南屯",0,22,-22
"29269","2929淘帝","110/07/13","新光",21,4,17
"29270","2929淘帝","110/07/13","第一金-豐原",0,20,-20
"29271","2929淘帝","110/07/13","元大-天母",17,0,17
"29272","2929淘帝","110/07/13","元大-屏南",6,26,-20
"29273","2929淘帝","110/07/13","永興",14,0,14
"29274","2929淘帝","110/07/13","永豐金-敦南",1,21,-20
"29275","2929淘帝","110/07/13","富邦-台北",12,0,12
"29276","2929淘帝","110/07/13","凱基-三重",2,21,-19
"29277","2929淘帝","110/07/13","元大-永和",12,0,12
"29278","2929淘帝","110/07/13","富邦-仁愛",7,25,-18
"29279","2929淘帝","110/07/13","國票-天祥",11,0,11
"29280","2929淘帝","110/07/13","元大-北投",0,16,-16
"29281","5410國眾","110/07/13","兆豐-城中",274,0,274
"29282","5410國眾","110/07/13","元富-嘉義",0,103,-103
"29283","5410國眾","110/07/13","新光",50,4,46
"29284","5410國眾","110/07/13","凱基-台北",0,50,-50
"29285","5410國眾","110/07/13","國泰-台中",26,0,26
"29286","5410國眾","110/07/13","瑞士信貸",0,31,-31
"29287","5410國眾","110/07/13","新加坡商瑞銀",22,0,22
"29288","5410國眾","110/07/13","台新-新莊",0,27,-27
"29289","5410國眾","110/07/13","光和-嘉義",20,0,20
"29290","5410國眾","110/07/13","元大-汐止",0,20,-20
"29291","5410國眾","110/07/13","凱基-竹北",17,0,17
"29292","5410國眾","110/07/13","亞東-新竹",0,17,-17
"29293","5410國眾","110/07/13","新光-桃園",15,0,15
"29294","5410國眾","110/07/13","元大-南勢角",0,13,-13
"29295","5410國眾","110/07/13","凱基-台東",14,0,14
"29296","5410國眾","110/07/13","台新-台南",0,12,-12
"29297","5410國眾","110/07/13","富邦-竹北",11,0,11
"29298","5410國眾","110/07/13","中國信託",0,11,-11
"29299","5410國眾","110/07/13","元富-同大",10,0,10
"29300","5410國眾","110/07/13","華南永昌",0,11,-11
"29301","5410國眾","110/07/13","國泰-敦南",24,15,9
"29302","5410國眾","110/07/13","臺銀-臺南",0,10,-10
"29303","5410國眾","110/07/13","日盛-內湖",7,0,7
"29304","5410國眾","110/07/13","台灣企銀-民雄",0,10,-10
"29305","5410國眾","110/07/13","台新-左楠",7,0,7
"29306","5410國眾","110/07/13","高橋",0,10,-10
"29307","5410國眾","110/07/13","元大-新盛",18,12,6
"29308","5410國眾","110/07/13","康和-嘉義",0,10,-10
"29309","5410國眾","110/07/13","統一",5,0,5
"29310","5410國眾","110/07/13","凱基-基隆",0,10,-10
"29311","2841台開","110/07/13","中國信託-高雄",251,50,201
"29312","2841台開","110/07/13","兆豐-公益",0,177,-177
"29313","2841台開","110/07/13","日盛證券",210,13,197
"29314","2841台開","110/07/13","日進",0,152,-152
"29315","2841台開","110/07/13","第一金-台中",55,0,55
"29316","2841台開","110/07/13","港商野村",0,109,-109
"29317","2841台開","110/07/13","國泰-板橋",46,0,46
"29318","2841台開","110/07/13","日盛-信義",0,103,-103
"29319","2841台開","110/07/13","國泰-館前",48,3,45
"29320","2841台開","110/07/13","國泰-敦南",11,75,-64
"29321","2841台開","110/07/13","華南永昌-新莊",45,0,45
"29322","2841台開","110/07/13","永興",0,50,-50
"29323","2841台開","110/07/13","日盛-園區",42,0,42
"29324","2841台開","110/07/13","永豐金-敦南",61,104,-43
"29325","2841台開","110/07/13","台新證券",32,0,32
"29326","2841台開","110/07/13","富邦-台南",0,42,-42
"29327","2841台開","110/07/13","台新-高雄",32,2,30
"29328","2841台開","110/07/13","國票-安和",0,30,-30
"29329","2841台開","110/07/13","豐農",23,0,23
"29330","2841台開","110/07/13","元大-桃園",0,25,-25
"29331","2841台開","110/07/13","合庫-嘉義",20,0,20
"29332","2841台開","110/07/13","新光",8,32,-24
"29333","2841台開","110/07/13","華南永昌-高雄",20,0,20
"29334","2841台開","110/07/13","元大-仁愛",0,24,-24
"29335","2841台開","110/07/13","元大-樹林",16,0,16
"29336","2841台開","110/07/13","日盛-中和",0,20,-20
"29337","2841台開","110/07/13","第一金-華江",15,2,13
"29338","2841台開","110/07/13","元富",0,20,-20
"29339","2841台開","110/07/13","美商高盛",12,0,12
"29340","2841台開","110/07/13","富邦-宜蘭",0,20,-20
"29341","6207雷科","110/07/13","元大-高雄",121,0,121
"29342","6207雷科","110/07/13","華南永昌-朴子",1,60,-59
"29343","6207雷科","110/07/13","第一金-新興",20,0,20
"29344","6207雷科","110/07/13","元大-南海",0,36,-36
"29345","6207雷科","110/07/13","元富-三重",20,0,20
"29346","6207雷科","110/07/13","凱基-土城",0,35,-35
"29347","6207雷科","110/07/13","元大-林園",15,0,15
"29348","6207雷科","110/07/13","台灣企銀",0,20,-20
"29349","6207雷科","110/07/13","元大-金華",16,1,15
"29350","6207雷科","110/07/13","群益金鼎-丹鳳",0,20,-20
"29351","6207雷科","110/07/13","日盛證券",10,0,10
"29352","6207雷科","110/07/13","元大-博愛",0,17,-17
"29353","6207雷科","110/07/13","統一-台中",10,0,10
"29354","6207雷科","110/07/13","元大-北港",0,13,-13
"29355","6207雷科","110/07/13","群益金鼎-土城",10,0,10
"29356","6207雷科","110/07/13","新加坡商瑞銀",0,12,-12
"29357","6207雷科","110/07/13","群益金鼎-桃園",10,0,10
"29358","6207雷科","110/07/13","凱基-台北",4,16,-12
"29359","6207雷科","110/07/13","永豐金-新莊",10,0,10
"29360","6207雷科","110/07/13","日茂-埔里",0,11,-11
"29361","6207雷科","110/07/13","永豐金-新店",10,0,10
"29362","6207雷科","110/07/13","元大-莒光",0,11,-11
"29363","6207雷科","110/07/13","元大證券",9,0,9
"29364","6207雷科","110/07/13","統一-新竹",0,10,-10
"29365","6207雷科","110/07/13","日盛-木柵",9,1,8
"29366","6207雷科","110/07/13","元大-西螺",0,10,-10
"29367","6207雷科","110/07/13","兆豐-來福",8,0,8
"29368","6207雷科","110/07/13","康和-台中",0,8,-8
"29369","6207雷科","110/07/13","新光",7,0,7
"29370","6207雷科","110/07/13","兆豐-高雄",0,6,-6
"29371","3679新至陞","110/07/13","永豐金證券",50,0,50
"29372","3679新至陞","110/07/13","摩根大通",2,25,-23
"29373","3679新至陞","110/07/13","國泰-桃園",22,0,22
"29374","3679新至陞","110/07/13","元大-成功",0,22,-22
"29375","3679新至陞","110/07/13","台中銀-員林",11,0,11
"29376","3679新至陞","110/07/13","富邦-板橋",1,19,-18
"29377","3679新至陞","110/07/13","元大-文心興安",8,0,8
"29378","3679新至陞","110/07/13","日盛-新莊",0,10,-10
"29379","3679新至陞","110/07/13","美商高盛",6,0,6
"29380","3679新至陞","110/07/13","台新-台中",0,10,-10
"29381","3679新至陞","110/07/13","台新-高雄",6,0,6
"29382","3679新至陞","110/07/13","永豐金-新竹",0,8,-8
"29383","3679新至陞","110/07/13","凱基-台北",18,12,6
"29384","3679新至陞","110/07/13","瑞士信貸",12,19,-7
"29385","3679新至陞","110/07/13","日盛-復興",5,0,5
"29386","3679新至陞","110/07/13","統一-南京",0,7,-7
"29387","3679新至陞","110/07/13","(牛牛牛)亞-鑫豐",4,0,4
"29388","3679新至陞","110/07/13","凱基-新莊",0,7,-7
"29389","3679新至陞","110/07/13","元富-大昌",3,0,3
"29390","3679新至陞","110/07/13","新加坡商瑞銀",0,6,-6
"29391","3679新至陞","110/07/13","富邦-台北",3,0,3
"29392","3679新至陞","110/07/13","合庫-自強",0,5,-5
"29393","3679新至陞","110/07/13","日盛-樹林",2,0,2
"29394","3679新至陞","110/07/13","富邦-桃園",0,5,-5
"29395","3679新至陞","110/07/13","宏遠-光隆",2,0,2
"29396","3679新至陞","110/07/13","永豐金-潮州",0,4,-4
"29397","3679新至陞","110/07/13","美林",3,1,2
"29398","3679新至陞","110/07/13","臺銀-臺南",0,3,-3
"29399","3679新至陞","110/07/13","第一金-中壢",2,0,2
"29400","3679新至陞","110/07/13","元大-六合",0,3,-3
"29401","2727王品","110/07/13","富邦-台北",43,3,40
"29402","2727王品","110/07/13","台灣摩根士丹利",15,97,-82
"29403","2727王品","110/07/13","元大-基隆孝二",40,0,40
"29404","2727王品","110/07/13","玉山-台南",5,57,-52
"29405","2727王品","110/07/13","國票-新莊",40,1,39
"29406","2727王品","110/07/13","新加坡商瑞銀",0,48,-48
"29407","2727王品","110/07/13","第一金-豐原",66,42,24
"29408","2727王品","110/07/13","凱基-台北",41,77,-36
"29409","2727王品","110/07/13","永豐金-大園",34,10,24
"29410","2727王品","110/07/13","永豐金-永康",0,22,-22
"29411","2727王品","110/07/13","元大-北屯",22,0,22
"29412","2727王品","110/07/13","統一-台中",2,22,-20
"29413","2727王品","110/07/13","元大-東蘆",26,7,19
"29414","2727王品","110/07/13","國泰-台中",21,39,-18
"29415","2727王品","110/07/13","永豐金-萬盛",13,1,12
"29416","2727王品","110/07/13","合庫-彰化",3,20,-17
"29417","2727王品","110/07/13","日盛-嘉義",11,0,11
"29418","2727王品","110/07/13","港商野村",13,30,-17
"29419","2727王品","110/07/13","日盛-八德",11,0,11
"29420","2727王品","110/07/13","元大-楊梅",1,16,-15
"29421","2727王品","110/07/13","統一-竹南",11,0,11
"29422","2727王品","110/07/13","凱基-高美館",2,15,-13
"29423","2727王品","110/07/13","日盛-士林",12,2,10
"29424","2727王品","110/07/13","美商高盛",2,14,-12
"29425","2727王品","110/07/13","統一-敦南",10,0,10
"29426","2727王品","110/07/13","統一-平鎮",1,13,-12
"29427","2727王品","110/07/13","中國信託",15,5,10
"29428","2727王品","110/07/13","兆豐-台中港",4,16,-12
"29429","2727王品","110/07/13","兆豐-竹北",13,3,10
"29430","2727王品","110/07/13","凱基-八德",1,13,-12
"29431","1570力肯","110/07/13","新光",115,11,104
"29432","1570力肯","110/07/13","元大-北三重",0,162,-162
"29433","1570力肯","110/07/13","群益金鼎-高雄",54,0,54
"29434","1570力肯","110/07/13","元大-大灣",0,25,-25
"29435","1570力肯","110/07/13","國票-新莊",22,0,22
"29436","1570力肯","110/07/13","永豐金-苓雅",0,22,-22
"29437","1570力肯","110/07/13","日盛-桃園",12,0,12
"29438","1570力肯","110/07/13","永豐金-永康",0,19,-19
"29439","1570力肯","110/07/13","元大-高雄",12,0,12
"29440","1570力肯","110/07/13","富邦-員林",0,15,-15
"29441","1570力肯","110/07/13","合庫-自強",11,0,11
"29442","1570力肯","110/07/13","凱基-台南",0,11,-11
"29443","1570力肯","110/07/13","摩根大通",26,15,11
"29444","1570力肯","110/07/13","日盛-竹北",0,10,-10
"29445","1570力肯","110/07/13","永豐金-中盛",11,0,11
"29446","1570力肯","110/07/13","國票-九鼎",0,10,-10
"29447","1570力肯","110/07/13","兆豐-台中港",10,0,10
"29448","1570力肯","110/07/13","凱基-桃園",0,10,-10
"29449","1570力肯","110/07/13","國泰-松江",9,0,9
"29450","1570力肯","110/07/13","凱基-新豐",0,10,-10
"29451","1570力肯","110/07/13","元大-新盛",9,0,9
"29452","1570力肯","110/07/13","元大-學甲",0,10,-10
"29453","1570力肯","110/07/13","元富-緯城",6,0,6
"29454","1570力肯","110/07/13","群益金鼎-東湖",1,10,-9
"29455","1570力肯","110/07/13","統一-三重",5,0,5
"29456","1570力肯","110/07/13","大昌",0,6,-6
"29457","1570力肯","110/07/13","元大-前金",5,0,5
"29458","1570力肯","110/07/13","元大-土城學府",0,6,-6
"29459","1570力肯","110/07/13","永豐金證券",5,0,5
"29460","1570力肯","110/07/13","統一",0,5,-5
"29461","6180橘子","110/07/13","摩根大通",119,0,119
"29462","6180橘子","110/07/13","元大-崇德",2,61,-59
"29463","6180橘子","110/07/13","美商高盛",96,0,96
"29464","6180橘子","110/07/13","康和-台中",0,51,-51
"29465","6180橘子","110/07/13","新加坡商瑞銀",86,7,79
"29466","6180橘子","110/07/13","康和-台北",0,50,-50
"29467","6180橘子","110/07/13","元大-和平",40,0,40
"29468","6180橘子","110/07/13","元富-潮州",0,40,-40
"29469","6180橘子","110/07/13","凱基-台北",83,47,36
"29470","6180橘子","110/07/13","日盛-永康",0,26,-26
"29471","6180橘子","110/07/13","美林",39,5,34
"29472","6180橘子","110/07/13","永豐金-中正",0,24,-24
"29473","6180橘子","110/07/13","富邦-新竹華信",31,2,29
"29474","6180橘子","110/07/13","國泰-板橋",2,25,-23
"29475","6180橘子","110/07/13","統一-南京",21,0,21
"29476","6180橘子","110/07/13","日盛-大墩",0,20,-20
"29477","6180橘子","110/07/13","富邦-陽明",24,3,21
"29478","6180橘子","110/07/13","元大-草屯",13,32,-19
"29479","6180橘子","110/07/13","大昌-樹林",21,1,20
"29480","6180橘子","110/07/13","元富-林園",1,18,-17
"29481","6180橘子","110/07/13","花旗環球",19,0,19
"29482","6180橘子","110/07/13","新光-新竹",1,18,-17
"29483","6180橘子","110/07/13","華南永昌-台南",19,0,19
"29484","6180橘子","110/07/13","元大-土城永寧",0,17,-17
"29485","6180橘子","110/07/13","福勝",14,0,14
"29486","6180橘子","110/07/13","國泰-新莊",3,19,-16
"29487","6180橘子","110/07/13","富邦-嘉義",12,1,11
"29488","6180橘子","110/07/13","中國信託-永康",6,21,-15
"29489","6180橘子","110/07/13","元大-板橋三民",11,0,11
"29490","6180橘子","110/07/13","凱基-東港",1,15,-14
"29491","2390云辰","110/07/13","新加坡商瑞銀",562,75,487
"29492","2390云辰","110/07/13","大展-台南",0,532,-532
"29493","2390云辰","110/07/13","台灣摩根士丹利",330,155,175
"29494","2390云辰","110/07/13","凱基-台北",668,854,-186
"29495","2390云辰","110/07/13","兆豐-公益",126,25,101
"29496","2390云辰","110/07/13","凱基-三重",12,172,-160
"29497","2390云辰","110/07/13","元富-中港",100,2,98
"29498","2390云辰","110/07/13","兆豐-忠孝",4,161,-157
"29499","2390云辰","110/07/13","統一-新台中",106,9,97
"29500","2390云辰","110/07/13","元大-士林",19,170,-151
"29501","2390云辰","110/07/13","中國信託-松江",81,11,70
"29502","2390云辰","110/07/13","臺銀-新竹",14,117,-103
"29503","2390云辰","110/07/13","日盛-板橋",72,3,69
"29504","2390云辰","110/07/13","國票-台中",4,102,-98
"29505","2390云辰","110/07/13","日盛-和美",57,0,57
"29506","2390云辰","110/07/13","新光",147,232,-85
"29507","2390云辰","110/07/13","永豐金-桃園",88,36,52
"29508","2390云辰","110/07/13","致和-崇德",2,70,-68
"29509","2390云辰","110/07/13","玉山-士林",54,4,50
"29510","2390云辰","110/07/13","群益金鼎-屏東",2,70,-68
"29511","2390云辰","110/07/13","富邦-仁愛",56,6,50
"29512","2390云辰","110/07/13","元大-大里",35,98,-63
"29513","2390云辰","110/07/13","第一金-豐原",50,1,49
"29514","2390云辰","110/07/13","元大-萬華",35,94,-59
"29515","2390云辰","110/07/13","摩根大通",502,453,49
"29516","2390云辰","110/07/13","元富-吉利",2,60,-58
"29517","2390云辰","110/07/13","凱基-松山",61,13,48
"29518","2390云辰","110/07/13","兆豐-新竹",3,53,-50
"29519","2390云辰","110/07/13","大昌",64,22,42
"29520","2390云辰","110/07/13","富邦-嘉義",65,108,-43
"29521","2363矽統","110/07/13","凱基-南崁",2133,63,2070
"29522","2363矽統","110/07/13","凱基-幸福",36,4048,-4012
"29523","2363矽統","110/07/13","國泰-敦南",2195,1617,578
"29524","2363矽統","110/07/13","統一",192,3325,-3133
"29525","2363矽統","110/07/13","中農",670,139,531
"29526","2363矽統","110/07/13","新加坡商瑞銀",1000,2747,-1747
"29527","2363矽統","110/07/13","康和-台中",638,154,484
"29528","2363矽統","110/07/13","凱基-台北",5359,6609,-1250
"29529","2363矽統","110/07/13","群益金鼎-三民",577,137,440
"29530","2363矽統","110/07/13","摩根大通",1930,2858,-928
"29531","2363矽統","110/07/13","台新-屏東",510,88,422
"29532","2363矽統","110/07/13","港商野村",960,1679,-719
"29533","2363矽統","110/07/13","德信-中正",455,67,388
"29534","2363矽統","110/07/13","兆豐-復興",25,705,-680
"29535","2363矽統","110/07/13","日盛-竹北",365,70,295
"29536","2363矽統","110/07/13","統一-仁愛",114,755,-641
"29537","2363矽統","110/07/13","元大-佳里",452,189,263
"29538","2363矽統","110/07/13","統一-敦南",29,638,-609
"29539","2363矽統","110/07/13","國票-博愛",296,38,258
"29540","2363矽統","110/07/13","統一-土城",100,704,-604
"29541","2363矽統","110/07/13","元大-萬華",340,95,245
"29542","2363矽統","110/07/13","統一-城中",116,676,-560
"29543","2363矽統","110/07/13","新光",1259,1031,228
"29544","2363矽統","110/07/13","永豐金證券",306,859,-553
"29545","2363矽統","110/07/13","元富-成功",323,96,227
"29546","2363矽統","110/07/13","元富",54,567,-513
"29547","2363矽統","110/07/13","豐農",228,23,205
"29548","2363矽統","110/07/13","瑞士信貸",202,666,-464
"29549","2363矽統","110/07/13","台灣企銀-岡山",186,4,182
"29550","2363矽統","110/07/13","永豐金-嘉義",67,468,-401
"29551","8112至上","110/07/13","摩根大通",688,296,392
"29552","8112至上","110/07/13","國票-中和",0,401,-401
"29553","8112至上","110/07/13","港商野村",344,145,199
"29554","8112至上","110/07/13","永豐金-板盛",0,205,-205
"29555","8112至上","110/07/13","兆豐-公益",195,5,190
"29556","8112至上","110/07/13","凱基-五股",43,155,-112
"29557","8112至上","110/07/13","台灣摩根士丹利",183,0,183
"29558","8112至上","110/07/13","凱基-市政",0,100,-100
"29559","8112至上","110/07/13","群益金鼎-敦南",153,2,151
"29560","8112至上","110/07/13","元大-大里德芳",1,92,-91
"29561","8112至上","110/07/13","臺銀-金山",146,26,120
"29562","8112至上","110/07/13","玉山-桃園",26,110,-84
"29563","8112至上","110/07/13","臺銀",133,19,114
"29564","8112至上","110/07/13","兆豐-天母",0,81,-81
"29565","8112至上","110/07/13","合庫-台中",115,6,109
"29566","8112至上","110/07/13","凱基-城中",3,84,-81
"29567","8112至上","110/07/13","亞東-板橋",134,26,108
"29568","8112至上","110/07/13","日盛-新莊",9,85,-76
"29569","8112至上","110/07/13","凱基-台北",414,326,88
"29570","8112至上","110/07/13","日盛-台中",2,64,-62
"29571","8112至上","110/07/13","新加坡商瑞銀",181,100,81
"29572","8112至上","110/07/13","日盛-中壢",3,64,-61
"29573","8112至上","110/07/13","國泰-敦南",108,31,77
"29574","8112至上","110/07/13","元大-台中",2,59,-57
"29575","8112至上","110/07/13","第一金-華江",77,4,73
"29576","8112至上","110/07/13","元大-雙和",7,64,-57
"29577","8112至上","110/07/13","永豐金-內湖",73,1,72
"29578","8112至上","110/07/13","元大-高雄",8,62,-54
"29579","8112至上","110/07/13","元大-永和",68,1,67
"29580","8112至上","110/07/13","元大-館前",2,55,-53
"29581","4903聯光通","110/07/13","台灣企銀-太平",56,0,56
"29582","4903聯光通","110/07/13","土銀",0,32,-32
"29583","4903聯光通","110/07/13","元富-新興",23,0,23
"29584","4903聯光通","110/07/13","元大-樹林",0,19,-19
"29585","4903聯光通","110/07/13","日盛-樹林",22,0,22
"29586","4903聯光通","110/07/13","凱基-士林",0,17,-17
"29587","4903聯光通","110/07/13","兆豐-天母",20,0,20
"29588","4903聯光通","110/07/13","國票-博愛",0,14,-14
"29589","4903聯光通","110/07/13","華南永昌-桃園",20,0,20
"29590","4903聯光通","110/07/13","元富",0,10,-10
"29591","4903聯光通","110/07/13","富邦-新店",10,0,10
"29592","4903聯光通","110/07/13","新光",0,10,-10
"29593","4903聯光通","110/07/13","新光-台中",5,0,5
"29594","4903聯光通","110/07/13","玉山-南京東路",0,10,-10
"29595","4903聯光通","110/07/13","華南永昌-台中",5,0,5
"29596","4903聯光通","110/07/13","富邦-陽明",0,10,-10
"29597","4903聯光通","110/07/13","元大-崇德",5,0,5
"29598","4903聯光通","110/07/13","元大-大甲",0,8,-8
"29599","4903聯光通","110/07/13","元大-草屯",5,0,5
"29600","4903聯光通","110/07/13","富邦-台中",0,7,-7
"29601","4903聯光通","110/07/13","元富-草屯",4,0,4
"29602","4903聯光通","110/07/13","凱基-中壢",0,6,-6
"29603","4903聯光通","110/07/13","元大-清水",4,0,4
"29604","4903聯光通","110/07/13","臺銀-民權",0,5,-5
"29605","4903聯光通","110/07/13","元大-東泰",4,0,4
"29606","4903聯光通","110/07/13","日盛-板橋",0,5,-5
"29607","4903聯光通","110/07/13","元大-佳里",2,0,2
"29608","4903聯光通","110/07/13","中國信託-忠孝",0,5,-5
"29609","4903聯光通","110/07/13","永豐金-板橋",2,0,2
"29610","4903聯光通","110/07/13","永豐金-鳳山",0,5,-5
"29611","2929淘帝","110/07/13","玉山-新竹",130,0,130
"29612","2929淘帝","110/07/13","美商高盛",0,177,-177
"29613","2929淘帝","110/07/13","臺銀-民權",60,0,60
"29614","2929淘帝","110/07/13","凱基-台北",6,80,-74
"29615","2929淘帝","110/07/13","新百王",31,0,31
"29616","2929淘帝","110/07/13","元富-大裕",0,49,-49
"29617","2929淘帝","110/07/13","日盛-園區",30,0,30
"29618","2929淘帝","110/07/13","國泰-館前",3,51,-48
"29619","2929淘帝","110/07/13","元大-南投",31,1,30
"29620","2929淘帝","110/07/13","凱基-中壢",0,41,-41
"29621","2929淘帝","110/07/13","兆豐-忠孝",28,0,28
"29622","2929淘帝","110/07/13","港商野村",21,55,-34
"29623","2929淘帝","110/07/13","元大-民生",28,0,28
"29624","2929淘帝","110/07/13","華南永昌-南京",2,34,-32
"29625","2929淘帝","110/07/13","合庫-高雄",27,0,27
"29626","2929淘帝","110/07/13","群益金鼎-土城",0,30,-30
"29627","2929淘帝","110/07/13","凱基-豐中",27,0,27
"29628","2929淘帝","110/07/13","富邦-南屯",0,22,-22
"29629","2929淘帝","110/07/13","新光",21,4,17
"29630","2929淘帝","110/07/13","第一金-豐原",0,20,-20
"29631","2929淘帝","110/07/13","元大-天母",17,0,17
"29632","2929淘帝","110/07/13","元大-屏南",6,26,-20
"29633","2929淘帝","110/07/13","永興",14,0,14
"29634","2929淘帝","110/07/13","永豐金-敦南",1,21,-20
"29635","2929淘帝","110/07/13","富邦-台北",12,0,12
"29636","2929淘帝","110/07/13","凱基-三重",2,21,-19
"29637","2929淘帝","110/07/13","元大-永和",12,0,12
"29638","2929淘帝","110/07/13","富邦-仁愛",7,25,-18
"29639","2929淘帝","110/07/13","國票-天祥",11,0,11
"29640","2929淘帝","110/07/13","元大-北投",0,16,-16
"29641","5410國眾","110/07/13","兆豐-城中",274,0,274
"29642","5410國眾","110/07/13","元富-嘉義",0,103,-103
"29643","5410國眾","110/07/13","新光",50,4,46
"29644","5410國眾","110/07/13","凱基-台北",0,50,-50
"29645","5410國眾","110/07/13","國泰-台中",26,0,26
"29646","5410國眾","110/07/13","瑞士信貸",0,31,-31
"29647","5410國眾","110/07/13","新加坡商瑞銀",22,0,22
"29648","5410國眾","110/07/13","台新-新莊",0,27,-27
"29649","5410國眾","110/07/13","光和-嘉義",20,0,20
"29650","5410國眾","110/07/13","元大-汐止",0,20,-20
"29651","5410國眾","110/07/13","凱基-竹北",17,0,17
"29652","5410國眾","110/07/13","亞東-新竹",0,17,-17
"29653","5410國眾","110/07/13","新光-桃園",15,0,15
"29654","5410國眾","110/07/13","元大-南勢角",0,13,-13
"29655","5410國眾","110/07/13","凱基-台東",14,0,14
"29656","5410國眾","110/07/13","台新-台南",0,12,-12
"29657","5410國眾","110/07/13","富邦-竹北",11,0,11
"29658","5410國眾","110/07/13","中國信託",0,11,-11
"29659","5410國眾","110/07/13","元富-同大",10,0,10
"29660","5410國眾","110/07/13","華南永昌",0,11,-11
"29661","5410國眾","110/07/13","國泰-敦南",24,15,9
"29662","5410國眾","110/07/13","臺銀-臺南",0,10,-10
"29663","5410國眾","110/07/13","日盛-內湖",7,0,7
"29664","5410國眾","110/07/13","台灣企銀-民雄",0,10,-10
"29665","5410國眾","110/07/13","台新-左楠",7,0,7
"29666","5410國眾","110/07/13","高橋",0,10,-10
"29667","5410國眾","110/07/13","元大-新盛",18,12,6
"29668","5410國眾","110/07/13","康和-嘉義",0,10,-10
"29669","5410國眾","110/07/13","統一",5,0,5
"29670","5410國眾","110/07/13","凱基-基隆",0,10,-10
"29671","2841台開","110/07/13","中國信託-高雄",251,50,201
"29672","2841台開","110/07/13","兆豐-公益",0,177,-177
"29673","2841台開","110/07/13","日盛證券",210,13,197
"29674","2841台開","110/07/13","日進",0,152,-152
"29675","2841台開","110/07/13","第一金-台中",55,0,55
"29676","2841台開","110/07/13","港商野村",0,109,-109
"29677","2841台開","110/07/13","國泰-板橋",46,0,46
"29678","2841台開","110/07/13","日盛-信義",0,103,-103
"29679","2841台開","110/07/13","國泰-館前",48,3,45
"29680","2841台開","110/07/13","國泰-敦南",11,75,-64
"29681","2841台開","110/07/13","華南永昌-新莊",45,0,45
"29682","2841台開","110/07/13","永興",0,50,-50
"29683","2841台開","110/07/13","日盛-園區",42,0,42
"29684","2841台開","110/07/13","永豐金-敦南",61,104,-43
"29685","2841台開","110/07/13","台新證券",32,0,32
"29686","2841台開","110/07/13","富邦-台南",0,42,-42
"29687","2841台開","110/07/13","台新-高雄",32,2,30
"29688","2841台開","110/07/13","國票-安和",0,30,-30
"29689","2841台開","110/07/13","豐農",23,0,23
"29690","2841台開","110/07/13","元大-桃園",0,25,-25
"29691","2841台開","110/07/13","合庫-嘉義",20,0,20
"29692","2841台開","110/07/13","新光",8,32,-24
"29693","2841台開","110/07/13","華南永昌-高雄",20,0,20
"29694","2841台開","110/07/13","元大-仁愛",0,24,-24
"29695","2841台開","110/07/13","元大-樹林",16,0,16
"29696","2841台開","110/07/13","日盛-中和",0,20,-20
"29697","2841台開","110/07/13","第一金-華江",15,2,13
"29698","2841台開","110/07/13","元富",0,20,-20
"29699","2841台開","110/07/13","美商高盛",12,0,12
"29700","2841台開","110/07/13","富邦-宜蘭",0,20,-20
"29701","6207雷科","110/07/13","元大-高雄",121,0,121
"29702","6207雷科","110/07/13","華南永昌-朴子",1,60,-59
"29703","6207雷科","110/07/13","第一金-新興",20,0,20
"29704","6207雷科","110/07/13","元大-南海",0,36,-36
"29705","6207雷科","110/07/13","元富-三重",20,0,20
"29706","6207雷科","110/07/13","凱基-土城",0,35,-35
"29707","6207雷科","110/07/13","元大-林園",15,0,15
"29708","6207雷科","110/07/13","台灣企銀",0,20,-20
"29709","6207雷科","110/07/13","元大-金華",16,1,15
"29710","6207雷科","110/07/13","群益金鼎-丹鳳",0,20,-20
"29711","6207雷科","110/07/13","日盛證券",10,0,10
"29712","6207雷科","110/07/13","元大-博愛",0,17,-17
"29713","6207雷科","110/07/13","統一-台中",10,0,10
"29714","6207雷科","110/07/13","元大-北港",0,13,-13
"29715","6207雷科","110/07/13","群益金鼎-土城",10,0,10
"29716","6207雷科","110/07/13","新加坡商瑞銀",0,12,-12
"29717","6207雷科","110/07/13","群益金鼎-桃園",10,0,10
"29718","6207雷科","110/07/13","凱基-台北",4,16,-12
"29719","6207雷科","110/07/13","永豐金-新莊",10,0,10
"29720","6207雷科","110/07/13","日茂-埔里",0,11,-11
"29721","6207雷科","110/07/13","永豐金-新店",10,0,10
"29722","6207雷科","110/07/13","元大-莒光",0,11,-11
"29723","6207雷科","110/07/13","元大證券",9,0,9
"29724","6207雷科","110/07/13","統一-新竹",0,10,-10
"29725","6207雷科","110/07/13","日盛-木柵",9,1,8
"29726","6207雷科","110/07/13","元大-西螺",0,10,-10
"29727","6207雷科","110/07/13","兆豐-來福",8,0,8
"29728","6207雷科","110/07/13","康和-台中",0,8,-8
"29729","6207雷科","110/07/13","新光",7,0,7
"29730","6207雷科","110/07/13","兆豐-高雄",0,6,-6
"29731","3679新至陞","110/07/13","永豐金證券",50,0,50
"29732","3679新至陞","110/07/13","摩根大通",2,25,-23
"29733","3679新至陞","110/07/13","國泰-桃園",22,0,22
"29734","3679新至陞","110/07/13","元大-成功",0,22,-22
"29735","3679新至陞","110/07/13","台中銀-員林",11,0,11
"29736","3679新至陞","110/07/13","富邦-板橋",1,19,-18
"29737","3679新至陞","110/07/13","元大-文心興安",8,0,8
"29738","3679新至陞","110/07/13","日盛-新莊",0,10,-10
"29739","3679新至陞","110/07/13","美商高盛",6,0,6
"29740","3679新至陞","110/07/13","台新-台中",0,10,-10
"29741","3679新至陞","110/07/13","台新-高雄",6,0,6
"29742","3679新至陞","110/07/13","永豐金-新竹",0,8,-8
"29743","3679新至陞","110/07/13","凱基-台北",18,12,6
"29744","3679新至陞","110/07/13","瑞士信貸",12,19,-7
"29745","3679新至陞","110/07/13","日盛-復興",5,0,5
"29746","3679新至陞","110/07/13","統一-南京",0,7,-7
"29747","3679新至陞","110/07/13","(牛牛牛)亞-鑫豐",4,0,4
"29748","3679新至陞","110/07/13","凱基-新莊",0,7,-7
"29749","3679新至陞","110/07/13","元富-大昌",3,0,3
"29750","3679新至陞","110/07/13","新加坡商瑞銀",0,6,-6
"29751","3679新至陞","110/07/13","富邦-台北",3,0,3
"29752","3679新至陞","110/07/13","合庫-自強",0,5,-5
"29753","3679新至陞","110/07/13","日盛-樹林",2,0,2
"29754","3679新至陞","110/07/13","富邦-桃園",0,5,-5
"29755","3679新至陞","110/07/13","宏遠-光隆",2,0,2
"29756","3679新至陞","110/07/13","永豐金-潮州",0,4,-4
"29757","3679新至陞","110/07/13","美林",3,1,2
"29758","3679新至陞","110/07/13","臺銀-臺南",0,3,-3
"29759","3679新至陞","110/07/13","第一金-中壢",2,0,2
"29760","3679新至陞","110/07/13","元大-六合",0,3,-3
"29761","2727王品","110/07/13","富邦-台北",43,3,40
"29762","2727王品","110/07/13","台灣摩根士丹利",15,97,-82
"29763","2727王品","110/07/13","元大-基隆孝二",40,0,40
"29764","2727王品","110/07/13","玉山-台南",5,57,-52
"29765","2727王品","110/07/13","國票-新莊",40,1,39
"29766","2727王品","110/07/13","新加坡商瑞銀",0,48,-48
"29767","2727王品","110/07/13","第一金-豐原",66,42,24
"29768","2727王品","110/07/13","凱基-台北",41,77,-36
"29769","2727王品","110/07/13","永豐金-大園",34,10,24
"29770","2727王品","110/07/13","永豐金-永康",0,22,-22
"29771","2727王品","110/07/13","元大-北屯",22,0,22
"29772","2727王品","110/07/13","統一-台中",2,22,-20
"29773","2727王品","110/07/13","元大-東蘆",26,7,19
"29774","2727王品","110/07/13","國泰-台中",21,39,-18
"29775","2727王品","110/07/13","永豐金-萬盛",13,1,12
"29776","2727王品","110/07/13","合庫-彰化",3,20,-17
"29777","2727王品","110/07/13","日盛-嘉義",11,0,11
"29778","2727王品","110/07/13","港商野村",13,30,-17
"29779","2727王品","110/07/13","日盛-八德",11,0,11
"29780","2727王品","110/07/13","元大-楊梅",1,16,-15
"29781","2727王品","110/07/13","統一-竹南",11,0,11
"29782","2727王品","110/07/13","凱基-高美館",2,15,-13
"29783","2727王品","110/07/13","日盛-士林",12,2,10
"29784","2727王品","110/07/13","美商高盛",2,14,-12
"29785","2727王品","110/07/13","統一-敦南",10,0,10
"29786","2727王品","110/07/13","統一-平鎮",1,13,-12
"29787","2727王品","110/07/13","中國信託",15,5,10
"29788","2727王品","110/07/13","兆豐-台中港",4,16,-12
"29789","2727王品","110/07/13","兆豐-竹北",13,3,10
"29790","2727王品","110/07/13","凱基-八德",1,13,-12
"29791","1570力肯","110/07/13","新光",115,11,104
"29792","1570力肯","110/07/13","元大-北三重",0,162,-162
"29793","1570力肯","110/07/13","群益金鼎-高雄",54,0,54
"29794","1570力肯","110/07/13","元大-大灣",0,25,-25
"29795","1570力肯","110/07/13","國票-新莊",22,0,22
"29796","1570力肯","110/07/13","永豐金-苓雅",0,22,-22
"29797","1570力肯","110/07/13","日盛-桃園",12,0,12
"29798","1570力肯","110/07/13","永豐金-永康",0,19,-19
"29799","1570力肯","110/07/13","元大-高雄",12,0,12
"29800","1570力肯","110/07/13","富邦-員林",0,15,-15
"29801","1570力肯","110/07/13","合庫-自強",11,0,11
"29802","1570力肯","110/07/13","凱基-台南",0,11,-11
"29803","1570力肯","110/07/13","摩根大通",26,15,11
"29804","1570力肯","110/07/13","日盛-竹北",0,10,-10
"29805","1570力肯","110/07/13","永豐金-中盛",11,0,11
"29806","1570力肯","110/07/13","國票-九鼎",0,10,-10
"29807","1570力肯","110/07/13","兆豐-台中港",10,0,10
"29808","1570力肯","110/07/13","凱基-桃園",0,10,-10
"29809","1570力肯","110/07/13","國泰-松江",9,0,9
"29810","1570力肯","110/07/13","凱基-新豐",0,10,-10
"29811","1570力肯","110/07/13","元大-新盛",9,0,9
"29812","1570力肯","110/07/13","元大-學甲",0,10,-10
"29813","1570力肯","110/07/13","元富-緯城",6,0,6
"29814","1570力肯","110/07/13","群益金鼎-東湖",1,10,-9
"29815","1570力肯","110/07/13","統一-三重",5,0,5
"29816","1570力肯","110/07/13","大昌",0,6,-6
"29817","1570力肯","110/07/13","元大-前金",5,0,5
"29818","1570力肯","110/07/13","元大-土城學府",0,6,-6
"29819","1570力肯","110/07/13","永豐金證券",5,0,5
"29820","1570力肯","110/07/13","統一",0,5,-5
"29821","6180橘子","110/07/13","摩根大通",119,0,119
"29822","6180橘子","110/07/13","元大-崇德",2,61,-59
"29823","6180橘子","110/07/13","美商高盛",96,0,96
"29824","6180橘子","110/07/13","康和-台中",0,51,-51
"29825","6180橘子","110/07/13","新加坡商瑞銀",86,7,79
"29826","6180橘子","110/07/13","康和-台北",0,50,-50
"29827","6180橘子","110/07/13","元大-和平",40,0,40
"29828","6180橘子","110/07/13","元富-潮州",0,40,-40
"29829","6180橘子","110/07/13","凱基-台北",83,47,36
"29830","6180橘子","110/07/13","日盛-永康",0,26,-26
"29831","6180橘子","110/07/13","美林",39,5,34
"29832","6180橘子","110/07/13","永豐金-中正",0,24,-24
"29833","6180橘子","110/07/13","富邦-新竹華信",31,2,29
"29834","6180橘子","110/07/13","國泰-板橋",2,25,-23
"29835","6180橘子","110/07/13","統一-南京",21,0,21
"29836","6180橘子","110/07/13","日盛-大墩",0,20,-20
"29837","6180橘子","110/07/13","富邦-陽明",24,3,21
"29838","6180橘子","110/07/13","元大-草屯",13,32,-19
"29839","6180橘子","110/07/13","大昌-樹林",21,1,20
"29840","6180橘子","110/07/13","元富-林園",1,18,-17
"29841","6180橘子","110/07/13","花旗環球",19,0,19
"29842","6180橘子","110/07/13","新光-新竹",1,18,-17
"29843","6180橘子","110/07/13","華南永昌-台南",19,0,19
"29844","6180橘子","110/07/13","元大-土城永寧",0,17,-17
"29845","6180橘子","110/07/13","福勝",14,0,14
"29846","6180橘子","110/07/13","國泰-新莊",3,19,-16
"29847","6180橘子","110/07/13","富邦-嘉義",12,1,11
"29848","6180橘子","110/07/13","中國信託-永康",6,21,-15
"29849","6180橘子","110/07/13","元大-板橋三民",11,0,11
"29850","6180橘子","110/07/13","凱基-東港",1,15,-14
"29851","2390云辰","110/07/13","新加坡商瑞銀",562,75,487
"29852","2390云辰","110/07/13","大展-台南",0,532,-532
"29853","2390云辰","110/07/13","台灣摩根士丹利",330,155,175
"29854","2390云辰","110/07/13","凱基-台北",668,854,-186
"29855","2390云辰","110/07/13","兆豐-公益",126,25,101
"29856","2390云辰","110/07/13","凱基-三重",12,172,-160
"29857","2390云辰","110/07/13","元富-中港",100,2,98
"29858","2390云辰","110/07/13","兆豐-忠孝",4,161,-157
"29859","2390云辰","110/07/13","統一-新台中",106,9,97
"29860","2390云辰","110/07/13","元大-士林",19,170,-151
"29861","2390云辰","110/07/13","中國信託-松江",81,11,70
"29862","2390云辰","110/07/13","臺銀-新竹",14,117,-103
"29863","2390云辰","110/07/13","日盛-板橋",72,3,69
"29864","2390云辰","110/07/13","國票-台中",4,102,-98
"29865","2390云辰","110/07/13","日盛-和美",57,0,57
"29866","2390云辰","110/07/13","新光",147,232,-85
"29867","2390云辰","110/07/13","永豐金-桃園",88,36,52
"29868","2390云辰","110/07/13","致和-崇德",2,70,-68
"29869","2390云辰","110/07/13","玉山-士林",54,4,50
"29870","2390云辰","110/07/13","群益金鼎-屏東",2,70,-68
"29871","2390云辰","110/07/13","富邦-仁愛",56,6,50
"29872","2390云辰","110/07/13","元大-大里",35,98,-63
"29873","2390云辰","110/07/13","第一金-豐原",50,1,49
"29874","2390云辰","110/07/13","元大-萬華",35,94,-59
"29875","2390云辰","110/07/13","摩根大通",502,453,49
"29876","2390云辰","110/07/13","元富-吉利",2,60,-58
"29877","2390云辰","110/07/13","凱基-松山",61,13,48
"29878","2390云辰","110/07/13","兆豐-新竹",3,53,-50
"29879","2390云辰","110/07/13","大昌",64,22,42
"29880","2390云辰","110/07/13","富邦-嘉義",65,108,-43
"29881","2363矽統","110/07/13","凱基-南崁",2133,63,2070
"29882","2363矽統","110/07/13","凱基-幸福",36,4048,-4012
"29883","2363矽統","110/07/13","國泰-敦南",2195,1617,578
"29884","2363矽統","110/07/13","統一",192,3325,-3133
"29885","2363矽統","110/07/13","中農",670,139,531
"29886","2363矽統","110/07/13","新加坡商瑞銀",1000,2747,-1747
"29887","2363矽統","110/07/13","康和-台中",638,154,484
"29888","2363矽統","110/07/13","凱基-台北",5359,6609,-1250
"29889","2363矽統","110/07/13","群益金鼎-三民",577,137,440
"29890","2363矽統","110/07/13","摩根大通",1930,2858,-928
"29891","2363矽統","110/07/13","台新-屏東",510,88,422
"29892","2363矽統","110/07/13","港商野村",960,1679,-719
"29893","2363矽統","110/07/13","德信-中正",455,67,388
"29894","2363矽統","110/07/13","兆豐-復興",25,705,-680
"29895","2363矽統","110/07/13","日盛-竹北",365,70,295
"29896","2363矽統","110/07/13","統一-仁愛",114,755,-641
"29897","2363矽統","110/07/13","元大-佳里",452,189,263
"29898","2363矽統","110/07/13","統一-敦南",29,638,-609
"29899","2363矽統","110/07/13","國票-博愛",296,38,258
"29900","2363矽統","110/07/13","統一-土城",100,704,-604
"29901","2363矽統","110/07/13","元大-萬華",340,95,245
"29902","2363矽統","110/07/13","統一-城中",116,676,-560
"29903","2363矽統","110/07/13","新光",1259,1031,228
"29904","2363矽統","110/07/13","永豐金證券",306,859,-553
"29905","2363矽統","110/07/13","元富-成功",323,96,227
"29906","2363矽統","110/07/13","元富",54,567,-513
"29907","2363矽統","110/07/13","豐農",228,23,205
"29908","2363矽統","110/07/13","瑞士信貸",202,666,-464
"29909","2363矽統","110/07/13","台灣企銀-岡山",186,4,182
"29910","2363矽統","110/07/13","永豐金-嘉義",67,468,-401
"29911","8112至上","110/07/13","摩根大通",688,296,392
"29912","8112至上","110/07/13","國票-中和",0,401,-401
"29913","8112至上","110/07/13","港商野村",344,145,199
"29914","8112至上","110/07/13","永豐金-板盛",0,205,-205
"29915","8112至上","110/07/13","兆豐-公益",195,5,190
"29916","8112至上","110/07/13","凱基-五股",43,155,-112
"29917","8112至上","110/07/13","台灣摩根士丹利",183,0,183
"29918","8112至上","110/07/13","凱基-市政",0,100,-100
"29919","8112至上","110/07/13","群益金鼎-敦南",153,2,151
"29920","8112至上","110/07/13","元大-大里德芳",1,92,-91
"29921","8112至上","110/07/13","臺銀-金山",146,26,120
"29922","8112至上","110/07/13","玉山-桃園",26,110,-84
"29923","8112至上","110/07/13","臺銀",133,19,114
"29924","8112至上","110/07/13","兆豐-天母",0,81,-81
"29925","8112至上","110/07/13","合庫-台中",115,6,109
"29926","8112至上","110/07/13","凱基-城中",3,84,-81
"29927","8112至上","110/07/13","亞東-板橋",134,26,108
"29928","8112至上","110/07/13","日盛-新莊",9,85,-76
"29929","8112至上","110/07/13","凱基-台北",414,326,88
"29930","8112至上","110/07/13","日盛-台中",2,64,-62
"29931","8112至上","110/07/13","新加坡商瑞銀",181,100,81
"29932","8112至上","110/07/13","日盛-中壢",3,64,-61
"29933","8112至上","110/07/13","國泰-敦南",108,31,77
"29934","8112至上","110/07/13","元大-台中",2,59,-57
"29935","8112至上","110/07/13","第一金-華江",77,4,73
"29936","8112至上","110/07/13","元大-雙和",7,64,-57
"29937","8112至上","110/07/13","永豐金-內湖",73,1,72
"29938","8112至上","110/07/13","元大-高雄",8,62,-54
"29939","8112至上","110/07/13","元大-永和",68,1,67
"29940","8112至上","110/07/13","元大-館前",2,55,-53
"29941","4903聯光通","110/07/13","台灣企銀-太平",56,0,56
"29942","4903聯光通","110/07/13","土銀",0,32,-32
"29943","4903聯光通","110/07/13","元富-新興",23,0,23
"29944","4903聯光通","110/07/13","元大-樹林",0,19,-19
"29945","4903聯光通","110/07/13","日盛-樹林",22,0,22
"29946","4903聯光通","110/07/13","凱基-士林",0,17,-17
"29947","4903聯光通","110/07/13","兆豐-天母",20,0,20
"29948","4903聯光通","110/07/13","國票-博愛",0,14,-14
"29949","4903聯光通","110/07/13","華南永昌-桃園",20,0,20
"29950","4903聯光通","110/07/13","元富",0,10,-10
"29951","4903聯光通","110/07/13","富邦-新店",10,0,10
"29952","4903聯光通","110/07/13","新光",0,10,-10
"29953","4903聯光通","110/07/13","新光-台中",5,0,5
"29954","4903聯光通","110/07/13","玉山-南京東路",0,10,-10
"29955","4903聯光通","110/07/13","華南永昌-台中",5,0,5
"29956","4903聯光通","110/07/13","富邦-陽明",0,10,-10
"29957","4903聯光通","110/07/13","元大-崇德",5,0,5
"29958","4903聯光通","110/07/13","元大-大甲",0,8,-8
"29959","4903聯光通","110/07/13","元大-草屯",5,0,5
"29960","4903聯光通","110/07/13","富邦-台中",0,7,-7
"29961","4903聯光通","110/07/13","元富-草屯",4,0,4
"29962","4903聯光通","110/07/13","凱基-中壢",0,6,-6
"29963","4903聯光通","110/07/13","元大-清水",4,0,4
"29964","4903聯光通","110/07/13","臺銀-民權",0,5,-5
"29965","4903聯光通","110/07/13","元大-東泰",4,0,4
"29966","4903聯光通","110/07/13","日盛-板橋",0,5,-5
"29967","4903聯光通","110/07/13","元大-佳里",2,0,2
"29968","4903聯光通","110/07/13","中國信託-忠孝",0,5,-5
"29969","4903聯光通","110/07/13","永豐金-板橋",2,0,2
"29970","4903聯光通","110/07/13","永豐金-鳳山",0,5,-5
"29971","2929淘帝","110/07/13","玉山-新竹",130,0,130
"29972","2929淘帝","110/07/13","美商高盛",0,177,-177
"29973","2929淘帝","110/07/13","臺銀-民權",60,0,60
"29974","2929淘帝","110/07/13","凱基-台北",6,80,-74
"29975","2929淘帝","110/07/13","新百王",31,0,31
"29976","2929淘帝","110/07/13","元富-大裕",0,49,-49
"29977","2929淘帝","110/07/13","日盛-園區",30,0,30
"29978","2929淘帝","110/07/13","國泰-館前",3,51,-48
"29979","2929淘帝","110/07/13","元大-南投",31,1,30
"29980","2929淘帝","110/07/13","凱基-中壢",0,41,-41
"29981","2929淘帝","110/07/13","兆豐-忠孝",28,0,28
"29982","2929淘帝","110/07/13","港商野村",21,55,-34
"29983","2929淘帝","110/07/13","元大-民生",28,0,28
"29984","2929淘帝","110/07/13","華南永昌-南京",2,34,-32
"29985","2929淘帝","110/07/13","合庫-高雄",27,0,27
"29986","2929淘帝","110/07/13","群益金鼎-土城",0,30,-30
"29987","2929淘帝","110/07/13","凱基-豐中",27,0,27
"29988","2929淘帝","110/07/13","富邦-南屯",0,22,-22
"29989","2929淘帝","110/07/13","新光",21,4,17
"29990","2929淘帝","110/07/13","第一金-豐原",0,20,-20
"29991","2929淘帝","110/07/13","元大-天母",17,0,17
"29992","2929淘帝","110/07/13","元大-屏南",6,26,-20
"29993","2929淘帝","110/07/13","永興",14,0,14
"29994","2929淘帝","110/07/13","永豐金-敦南",1,21,-20
"29995","2929淘帝","110/07/13","富邦-台北",12,0,12
"29996","2929淘帝","110/07/13","凱基-三重",2,21,-19
"29997","2929淘帝","110/07/13","元大-永和",12,0,12
"29998","2929淘帝","110/07/13","富邦-仁愛",7,25,-18
"29999","2929淘帝","110/07/13","國票-天祥",11,0,11
"30000","2929淘帝","110/07/13","元大-北投",0,16,-16
"30001","5410國眾","110/07/13","兆豐-城中",274,0,274
"30002","5410國眾","110/07/13","元富-嘉義",0,103,-103
"30003","5410國眾","110/07/13","新光",50,4,46
"30004","5410國眾","110/07/13","凱基-台北",0,50,-50
"30005","5410國眾","110/07/13","國泰-台中",26,0,26
"30006","5410國眾","110/07/13","瑞士信貸",0,31,-31
"30007","5410國眾","110/07/13","新加坡商瑞銀",22,0,22
"30008","5410國眾","110/07/13","台新-新莊",0,27,-27
"30009","5410國眾","110/07/13","光和-嘉義",20,0,20
"30010","5410國眾","110/07/13","元大-汐止",0,20,-20
"30011","5410國眾","110/07/13","凱基-竹北",17,0,17
"30012","5410國眾","110/07/13","亞東-新竹",0,17,-17
"30013","5410國眾","110/07/13","新光-桃園",15,0,15
"30014","5410國眾","110/07/13","元大-南勢角",0,13,-13
"30015","5410國眾","110/07/13","凱基-台東",14,0,14
"30016","5410國眾","110/07/13","台新-台南",0,12,-12
"30017","5410國眾","110/07/13","富邦-竹北",11,0,11
"30018","5410國眾","110/07/13","中國信託",0,11,-11
"30019","5410國眾","110/07/13","元富-同大",10,0,10
"30020","5410國眾","110/07/13","華南永昌",0,11,-11
"30021","5410國眾","110/07/13","國泰-敦南",24,15,9
"30022","5410國眾","110/07/13","臺銀-臺南",0,10,-10
"30023","5410國眾","110/07/13","日盛-內湖",7,0,7
"30024","5410國眾","110/07/13","台灣企銀-民雄",0,10,-10
"30025","5410國眾","110/07/13","台新-左楠",7,0,7
"30026","5410國眾","110/07/13","高橋",0,10,-10
"30027","5410國眾","110/07/13","元大-新盛",18,12,6
"30028","5410國眾","110/07/13","康和-嘉義",0,10,-10
"30029","5410國眾","110/07/13","統一",5,0,5
"30030","5410國眾","110/07/13","凱基-基隆",0,10,-10
"30031","2841台開","110/07/13","中國信託-高雄",251,50,201
"30032","2841台開","110/07/13","兆豐-公益",0,177,-177
"30033","2841台開","110/07/13","日盛證券",210,13,197
"30034","2841台開","110/07/13","日進",0,152,-152
"30035","2841台開","110/07/13","第一金-台中",55,0,55
"30036","2841台開","110/07/13","港商野村",0,109,-109
"30037","2841台開","110/07/13","國泰-板橋",46,0,46
"30038","2841台開","110/07/13","日盛-信義",0,103,-103
"30039","2841台開","110/07/13","國泰-館前",48,3,45
"30040","2841台開","110/07/13","國泰-敦南",11,75,-64
"30041","2841台開","110/07/13","華南永昌-新莊",45,0,45
"30042","2841台開","110/07/13","永興",0,50,-50
"30043","2841台開","110/07/13","日盛-園區",42,0,42
"30044","2841台開","110/07/13","永豐金-敦南",61,104,-43
"30045","2841台開","110/07/13","台新證券",32,0,32
"30046","2841台開","110/07/13","富邦-台南",0,42,-42
"30047","2841台開","110/07/13","台新-高雄",32,2,30
"30048","2841台開","110/07/13","國票-安和",0,30,-30
"30049","2841台開","110/07/13","豐農",23,0,23
"30050","2841台開","110/07/13","元大-桃園",0,25,-25
"30051","2841台開","110/07/13","合庫-嘉義",20,0,20
"30052","2841台開","110/07/13","新光",8,32,-24
"30053","2841台開","110/07/13","華南永昌-高雄",20,0,20
"30054","2841台開","110/07/13","元大-仁愛",0,24,-24
"30055","2841台開","110/07/13","元大-樹林",16,0,16
"30056","2841台開","110/07/13","日盛-中和",0,20,-20
"30057","2841台開","110/07/13","第一金-華江",15,2,13
"30058","2841台開","110/07/13","元富",0,20,-20
"30059","2841台開","110/07/13","美商高盛",12,0,12
"30060","2841台開","110/07/13","富邦-宜蘭",0,20,-20
"30061","6207雷科","110/07/13","元大-高雄",121,0,121
"30062","6207雷科","110/07/13","華南永昌-朴子",1,60,-59
"30063","6207雷科","110/07/13","第一金-新興",20,0,20
"30064","6207雷科","110/07/13","元大-南海",0,36,-36
"30065","6207雷科","110/07/13","元富-三重",20,0,20
"30066","6207雷科","110/07/13","凱基-土城",0,35,-35
"30067","6207雷科","110/07/13","元大-林園",15,0,15
"30068","6207雷科","110/07/13","台灣企銀",0,20,-20
"30069","6207雷科","110/07/13","元大-金華",16,1,15
"30070","6207雷科","110/07/13","群益金鼎-丹鳳",0,20,-20
"30071","6207雷科","110/07/13","日盛證券",10,0,10
"30072","6207雷科","110/07/13","元大-博愛",0,17,-17
"30073","6207雷科","110/07/13","統一-台中",10,0,10
"30074","6207雷科","110/07/13","元大-北港",0,13,-13
"30075","6207雷科","110/07/13","群益金鼎-土城",10,0,10
"30076","6207雷科","110/07/13","新加坡商瑞銀",0,12,-12
"30077","6207雷科","110/07/13","群益金鼎-桃園",10,0,10
"30078","6207雷科","110/07/13","凱基-台北",4,16,-12
"30079","6207雷科","110/07/13","永豐金-新莊",10,0,10
"30080","6207雷科","110/07/13","日茂-埔里",0,11,-11
"30081","6207雷科","110/07/13","永豐金-新店",10,0,10
"30082","6207雷科","110/07/13","元大-莒光",0,11,-11
"30083","6207雷科","110/07/13","元大證券",9,0,9
"30084","6207雷科","110/07/13","統一-新竹",0,10,-10
"30085","6207雷科","110/07/13","日盛-木柵",9,1,8
"30086","6207雷科","110/07/13","元大-西螺",0,10,-10
"30087","6207雷科","110/07/13","兆豐-來福",8,0,8
"30088","6207雷科","110/07/13","康和-台中",0,8,-8
"30089","6207雷科","110/07/13","新光",7,0,7
"30090","6207雷科","110/07/13","兆豐-高雄",0,6,-6
"30091","3679新至陞","110/07/13","永豐金證券",50,0,50
"30092","3679新至陞","110/07/13","摩根大通",2,25,-23
"30093","3679新至陞","110/07/13","國泰-桃園",22,0,22
"30094","3679新至陞","110/07/13","元大-成功",0,22,-22
"30095","3679新至陞","110/07/13","台中銀-員林",11,0,11
"30096","3679新至陞","110/07/13","富邦-板橋",1,19,-18
"30097","3679新至陞","110/07/13","元大-文心興安",8,0,8
"30098","3679新至陞","110/07/13","日盛-新莊",0,10,-10
"30099","3679新至陞","110/07/13","美商高盛",6,0,6
"30100","3679新至陞","110/07/13","台新-台中",0,10,-10
"30101","3679新至陞","110/07/13","台新-高雄",6,0,6
"30102","3679新至陞","110/07/13","永豐金-新竹",0,8,-8
"30103","3679新至陞","110/07/13","凱基-台北",18,12,6
"30104","3679新至陞","110/07/13","瑞士信貸",12,19,-7
"30105","3679新至陞","110/07/13","日盛-復興",5,0,5
"30106","3679新至陞","110/07/13","統一-南京",0,7,-7
"30107","3679新至陞","110/07/13","(牛牛牛)亞-鑫豐",4,0,4
"30108","3679新至陞","110/07/13","凱基-新莊",0,7,-7
"30109","3679新至陞","110/07/13","元富-大昌",3,0,3
"30110","3679新至陞","110/07/13","新加坡商瑞銀",0,6,-6
"30111","3679新至陞","110/07/13","富邦-台北",3,0,3
"30112","3679新至陞","110/07/13","合庫-自強",0,5,-5
"30113","3679新至陞","110/07/13","日盛-樹林",2,0,2
"30114","3679新至陞","110/07/13","富邦-桃園",0,5,-5
"30115","3679新至陞","110/07/13","宏遠-光隆",2,0,2
"30116","3679新至陞","110/07/13","永豐金-潮州",0,4,-4
"30117","3679新至陞","110/07/13","美林",3,1,2
"30118","3679新至陞","110/07/13","臺銀-臺南",0,3,-3
"30119","3679新至陞","110/07/13","第一金-中壢",2,0,2
"30120","3679新至陞","110/07/13","元大-六合",0,3,-3
"30121","2727王品","110/07/13","富邦-台北",43,3,40
"30122","2727王品","110/07/13","台灣摩根士丹利",15,97,-82
"30123","2727王品","110/07/13","元大-基隆孝二",40,0,40
"30124","2727王品","110/07/13","玉山-台南",5,57,-52
"30125","2727王品","110/07/13","國票-新莊",40,1,39
"30126","2727王品","110/07/13","新加坡商瑞銀",0,48,-48
"30127","2727王品","110/07/13","第一金-豐原",66,42,24
"30128","2727王品","110/07/13","凱基-台北",41,77,-36
"30129","2727王品","110/07/13","永豐金-大園",34,10,24
"30130","2727王品","110/07/13","永豐金-永康",0,22,-22
"30131","2727王品","110/07/13","元大-北屯",22,0,22
"30132","2727王品","110/07/13","統一-台中",2,22,-20
"30133","2727王品","110/07/13","元大-東蘆",26,7,19
"30134","2727王品","110/07/13","國泰-台中",21,39,-18
"30135","2727王品","110/07/13","永豐金-萬盛",13,1,12
"30136","2727王品","110/07/13","合庫-彰化",3,20,-17
"30137","2727王品","110/07/13","日盛-嘉義",11,0,11
"30138","2727王品","110/07/13","港商野村",13,30,-17
"30139","2727王品","110/07/13","日盛-八德",11,0,11
"30140","2727王品","110/07/13","元大-楊梅",1,16,-15
"30141","2727王品","110/07/13","統一-竹南",11,0,11
"30142","2727王品","110/07/13","凱基-高美館",2,15,-13
"30143","2727王品","110/07/13","日盛-士林",12,2,10
"30144","2727王品","110/07/13","美商高盛",2,14,-12
"30145","2727王品","110/07/13","統一-敦南",10,0,10
"30146","2727王品","110/07/13","統一-平鎮",1,13,-12
"30147","2727王品","110/07/13","中國信託",15,5,10
"30148","2727王品","110/07/13","兆豐-台中港",4,16,-12
"30149","2727王品","110/07/13","兆豐-竹北",13,3,10
"30150","2727王品","110/07/13","凱基-八德",1,13,-12
"30151","1570力肯","110/07/13","新光",115,11,104
"30152","1570力肯","110/07/13","元大-北三重",0,162,-162
"30153","1570力肯","110/07/13","群益金鼎-高雄",54,0,54
"30154","1570力肯","110/07/13","元大-大灣",0,25,-25
"30155","1570力肯","110/07/13","國票-新莊",22,0,22
"30156","1570力肯","110/07/13","永豐金-苓雅",0,22,-22
"30157","1570力肯","110/07/13","日盛-桃園",12,0,12
"30158","1570力肯","110/07/13","永豐金-永康",0,19,-19
"30159","1570力肯","110/07/13","元大-高雄",12,0,12
"30160","1570力肯","110/07/13","富邦-員林",0,15,-15
"30161","1570力肯","110/07/13","合庫-自強",11,0,11
"30162","1570力肯","110/07/13","凱基-台南",0,11,-11
"30163","1570力肯","110/07/13","摩根大通",26,15,11
"30164","1570力肯","110/07/13","日盛-竹北",0,10,-10
"30165","1570力肯","110/07/13","永豐金-中盛",11,0,11
"30166","1570力肯","110/07/13","國票-九鼎",0,10,-10
"30167","1570力肯","110/07/13","兆豐-台中港",10,0,10
"30168","1570力肯","110/07/13","凱基-桃園",0,10,-10
"30169","1570力肯","110/07/13","國泰-松江",9,0,9
"30170","1570力肯","110/07/13","凱基-新豐",0,10,-10
"30171","1570力肯","110/07/13","元大-新盛",9,0,9
"30172","1570力肯","110/07/13","元大-學甲",0,10,-10
"30173","1570力肯","110/07/13","元富-緯城",6,0,6
"30174","1570力肯","110/07/13","群益金鼎-東湖",1,10,-9
"30175","1570力肯","110/07/13","統一-三重",5,0,5
"30176","1570力肯","110/07/13","大昌",0,6,-6
"30177","1570力肯","110/07/13","元大-前金",5,0,5
"30178","1570力肯","110/07/13","元大-土城學府",0,6,-6
"30179","1570力肯","110/07/13","永豐金證券",5,0,5
"30180","1570力肯","110/07/13","統一",0,5,-5
"30181","6180橘子","110/07/13","摩根大通",119,0,119
"30182","6180橘子","110/07/13","元大-崇德",2,61,-59
"30183","6180橘子","110/07/13","美商高盛",96,0,96
"30184","6180橘子","110/07/13","康和-台中",0,51,-51
"30185","6180橘子","110/07/13","新加坡商瑞銀",86,7,79
"30186","6180橘子","110/07/13","康和-台北",0,50,-50
"30187","6180橘子","110/07/13","元大-和平",40,0,40
"30188","6180橘子","110/07/13","元富-潮州",0,40,-40
"30189","6180橘子","110/07/13","凱基-台北",83,47,36
"30190","6180橘子","110/07/13","日盛-永康",0,26,-26
"30191","6180橘子","110/07/13","美林",39,5,34
"30192","6180橘子","110/07/13","永豐金-中正",0,24,-24
"30193","6180橘子","110/07/13","富邦-新竹華信",31,2,29
"30194","6180橘子","110/07/13","國泰-板橋",2,25,-23
"30195","6180橘子","110/07/13","統一-南京",21,0,21
"30196","6180橘子","110/07/13","日盛-大墩",0,20,-20
"30197","6180橘子","110/07/13","富邦-陽明",24,3,21
"30198","6180橘子","110/07/13","元大-草屯",13,32,-19
"30199","6180橘子","110/07/13","大昌-樹林",21,1,20
"30200","6180橘子","110/07/13","元富-林園",1,18,-17
"30201","6180橘子","110/07/13","花旗環球",19,0,19
"30202","6180橘子","110/07/13","新光-新竹",1,18,-17
"30203","6180橘子","110/07/13","華南永昌-台南",19,0,19
"30204","6180橘子","110/07/13","元大-土城永寧",0,17,-17
"30205","6180橘子","110/07/13","福勝",14,0,14
"30206","6180橘子","110/07/13","國泰-新莊",3,19,-16
"30207","6180橘子","110/07/13","富邦-嘉義",12,1,11
"30208","6180橘子","110/07/13","中國信託-永康",6,21,-15
"30209","6180橘子","110/07/13","元大-板橋三民",11,0,11
"30210","6180橘子","110/07/13","凱基-東港",1,15,-14
"30211","2390云辰","110/07/13","新加坡商瑞銀",562,75,487
"30212","2390云辰","110/07/13","大展-台南",0,532,-532
"30213","2390云辰","110/07/13","台灣摩根士丹利",330,155,175
"30214","2390云辰","110/07/13","凱基-台北",668,854,-186
"30215","2390云辰","110/07/13","兆豐-公益",126,25,101
"30216","2390云辰","110/07/13","凱基-三重",12,172,-160
"30217","2390云辰","110/07/13","元富-中港",100,2,98
"30218","2390云辰","110/07/13","兆豐-忠孝",4,161,-157
"30219","2390云辰","110/07/13","統一-新台中",106,9,97
"30220","2390云辰","110/07/13","元大-士林",19,170,-151
"30221","2390云辰","110/07/13","中國信託-松江",81,11,70
"30222","2390云辰","110/07/13","臺銀-新竹",14,117,-103
"30223","2390云辰","110/07/13","日盛-板橋",72,3,69
"30224","2390云辰","110/07/13","國票-台中",4,102,-98
"30225","2390云辰","110/07/13","日盛-和美",57,0,57
"30226","2390云辰","110/07/13","新光",147,232,-85
"30227","2390云辰","110/07/13","永豐金-桃園",88,36,52
"30228","2390云辰","110/07/13","致和-崇德",2,70,-68
"30229","2390云辰","110/07/13","玉山-士林",54,4,50
"30230","2390云辰","110/07/13","群益金鼎-屏東",2,70,-68
"30231","2390云辰","110/07/13","富邦-仁愛",56,6,50
"30232","2390云辰","110/07/13","元大-大里",35,98,-63
"30233","2390云辰","110/07/13","第一金-豐原",50,1,49
"30234","2390云辰","110/07/13","元大-萬華",35,94,-59
"30235","2390云辰","110/07/13","摩根大通",502,453,49
"30236","2390云辰","110/07/13","元富-吉利",2,60,-58
"30237","2390云辰","110/07/13","凱基-松山",61,13,48
"30238","2390云辰","110/07/13","兆豐-新竹",3,53,-50
"30239","2390云辰","110/07/13","大昌",64,22,42
"30240","2390云辰","110/07/13","富邦-嘉義",65,108,-43
"30241","2363矽統","110/07/13","凱基-南崁",2133,63,2070
"30242","2363矽統","110/07/13","凱基-幸福",36,4048,-4012
"30243","2363矽統","110/07/13","國泰-敦南",2195,1617,578
"30244","2363矽統","110/07/13","統一",192,3325,-3133
"30245","2363矽統","110/07/13","中農",670,139,531
"30246","2363矽統","110/07/13","新加坡商瑞銀",1000,2747,-1747
"30247","2363矽統","110/07/13","康和-台中",638,154,484
"30248","2363矽統","110/07/13","凱基-台北",5359,6609,-1250
"30249","2363矽統","110/07/13","群益金鼎-三民",577,137,440
"30250","2363矽統","110/07/13","摩根大通",1930,2858,-928
"30251","2363矽統","110/07/13","台新-屏東",510,88,422
"30252","2363矽統","110/07/13","港商野村",960,1679,-719
"30253","2363矽統","110/07/13","德信-中正",455,67,388
"30254","2363矽統","110/07/13","兆豐-復興",25,705,-680
"30255","2363矽統","110/07/13","日盛-竹北",365,70,295
"30256","2363矽統","110/07/13","統一-仁愛",114,755,-641
"30257","2363矽統","110/07/13","元大-佳里",452,189,263
"30258","2363矽統","110/07/13","統一-敦南",29,638,-609
"30259","2363矽統","110/07/13","國票-博愛",296,38,258
"30260","2363矽統","110/07/13","統一-土城",100,704,-604
"30261","2363矽統","110/07/13","元大-萬華",340,95,245
"30262","2363矽統","110/07/13","統一-城中",116,676,-560
"30263","2363矽統","110/07/13","新光",1259,1031,228
"30264","2363矽統","110/07/13","永豐金證券",306,859,-553
"30265","2363矽統","110/07/13","元富-成功",323,96,227
"30266","2363矽統","110/07/13","元富",54,567,-513
"30267","2363矽統","110/07/13","豐農",228,23,205
"30268","2363矽統","110/07/13","瑞士信貸",202,666,-464
"30269","2363矽統","110/07/13","台灣企銀-岡山",186,4,182
"30270","2363矽統","110/07/13","永豐金-嘉義",67,468,-401
"30271","8112至上","110/07/13","摩根大通",688,296,392
"30272","8112至上","110/07/13","國票-中和",0,401,-401
"30273","8112至上","110/07/13","港商野村",344,145,199
"30274","8112至上","110/07/13","永豐金-板盛",0,205,-205
"30275","8112至上","110/07/13","兆豐-公益",195,5,190
"30276","8112至上","110/07/13","凱基-五股",43,155,-112
"30277","8112至上","110/07/13","台灣摩根士丹利",183,0,183
"30278","8112至上","110/07/13","凱基-市政",0,100,-100
"30279","8112至上","110/07/13","群益金鼎-敦南",153,2,151
"30280","8112至上","110/07/13","元大-大里德芳",1,92,-91
"30281","8112至上","110/07/13","臺銀-金山",146,26,120
"30282","8112至上","110/07/13","玉山-桃園",26,110,-84
"30283","8112至上","110/07/13","臺銀",133,19,114
"30284","8112至上","110/07/13","兆豐-天母",0,81,-81
"30285","8112至上","110/07/13","合庫-台中",115,6,109
"30286","8112至上","110/07/13","凱基-城中",3,84,-81
"30287","8112至上","110/07/13","亞東-板橋",134,26,108
"30288","8112至上","110/07/13","日盛-新莊",9,85,-76
"30289","8112至上","110/07/13","凱基-台北",414,326,88
"30290","8112至上","110/07/13","日盛-台中",2,64,-62
"30291","8112至上","110/07/13","新加坡商瑞銀",181,100,81
"30292","8112至上","110/07/13","日盛-中壢",3,64,-61
"30293","8112至上","110/07/13","國泰-敦南",108,31,77
"30294","8112至上","110/07/13","元大-台中",2,59,-57
"30295","8112至上","110/07/13","第一金-華江",77,4,73
"30296","8112至上","110/07/13","元大-雙和",7,64,-57
"30297","8112至上","110/07/13","永豐金-內湖",73,1,72
"30298","8112至上","110/07/13","元大-高雄",8,62,-54
"30299","8112至上","110/07/13","元大-永和",68,1,67
"30300","8112至上","110/07/13","元大-館前",2,55,-53
"30301","4903聯光通","110/07/13","台灣企銀-太平",56,0,56
"30302","4903聯光通","110/07/13","土銀",0,32,-32
"30303","4903聯光通","110/07/13","元富-新興",23,0,23
"30304","4903聯光通","110/07/13","元大-樹林",0,19,-19
"30305","4903聯光通","110/07/13","日盛-樹林",22,0,22
"30306","4903聯光通","110/07/13","凱基-士林",0,17,-17
"30307","4903聯光通","110/07/13","兆豐-天母",20,0,20
"30308","4903聯光通","110/07/13","國票-博愛",0,14,-14
"30309","4903聯光通","110/07/13","華南永昌-桃園",20,0,20
"30310","4903聯光通","110/07/13","元富",0,10,-10
"30311","4903聯光通","110/07/13","富邦-新店",10,0,10
"30312","4903聯光通","110/07/13","新光",0,10,-10
"30313","4903聯光通","110/07/13","新光-台中",5,0,5
"30314","4903聯光通","110/07/13","玉山-南京東路",0,10,-10
"30315","4903聯光通","110/07/13","華南永昌-台中",5,0,5
"30316","4903聯光通","110/07/13","富邦-陽明",0,10,-10
"30317","4903聯光通","110/07/13","元大-崇德",5,0,5
"30318","4903聯光通","110/07/13","元大-大甲",0,8,-8
"30319","4903聯光通","110/07/13","元大-草屯",5,0,5
"30320","4903聯光通","110/07/13","富邦-台中",0,7,-7
"30321","4903聯光通","110/07/13","元富-草屯",4,0,4
"30322","4903聯光通","110/07/13","凱基-中壢",0,6,-6
"30323","4903聯光通","110/07/13","元大-清水",4,0,4
"30324","4903聯光通","110/07/13","臺銀-民權",0,5,-5
"30325","4903聯光通","110/07/13","元大-東泰",4,0,4
"30326","4903聯光通","110/07/13","日盛-板橋",0,5,-5
"30327","4903聯光通","110/07/13","元大-佳里",2,0,2
"30328","4903聯光通","110/07/13","中國信託-忠孝",0,5,-5
"30329","4903聯光通","110/07/13","永豐金-板橋",2,0,2
"30330","4903聯光通","110/07/13","永豐金-鳳山",0,5,-5
"30331","2929淘帝","110/07/13","玉山-新竹",130,0,130
"30332","2929淘帝","110/07/13","美商高盛",0,177,-177
"30333","2929淘帝","110/07/13","臺銀-民權",60,0,60
"30334","2929淘帝","110/07/13","凱基-台北",6,80,-74
"30335","2929淘帝","110/07/13","新百王",31,0,31
"30336","2929淘帝","110/07/13","元富-大裕",0,49,-49
"30337","2929淘帝","110/07/13","日盛-園區",30,0,30
"30338","2929淘帝","110/07/13","國泰-館前",3,51,-48
"30339","2929淘帝","110/07/13","元大-南投",31,1,30
"30340","2929淘帝","110/07/13","凱基-中壢",0,41,-41
"30341","2929淘帝","110/07/13","兆豐-忠孝",28,0,28
"30342","2929淘帝","110/07/13","港商野村",21,55,-34
"30343","2929淘帝","110/07/13","元大-民生",28,0,28
"30344","2929淘帝","110/07/13","華南永昌-南京",2,34,-32
"30345","2929淘帝","110/07/13","合庫-高雄",27,0,27
"30346","2929淘帝","110/07/13","群益金鼎-土城",0,30,-30
"30347","2929淘帝","110/07/13","凱基-豐中",27,0,27
"30348","2929淘帝","110/07/13","富邦-南屯",0,22,-22
"30349","2929淘帝","110/07/13","新光",21,4,17
"30350","2929淘帝","110/07/13","第一金-豐原",0,20,-20
"30351","2929淘帝","110/07/13","元大-天母",17,0,17
"30352","2929淘帝","110/07/13","元大-屏南",6,26,-20
"30353","2929淘帝","110/07/13","永興",14,0,14
"30354","2929淘帝","110/07/13","永豐金-敦南",1,21,-20
"30355","2929淘帝","110/07/13","富邦-台北",12,0,12
"30356","2929淘帝","110/07/13","凱基-三重",2,21,-19
"30357","2929淘帝","110/07/13","元大-永和",12,0,12
"30358","2929淘帝","110/07/13","富邦-仁愛",7,25,-18
"30359","2929淘帝","110/07/13","國票-天祥",11,0,11
"30360","2929淘帝","110/07/13","元大-北投",0,16,-16
"30361","5410國眾","110/07/13","兆豐-城中",274,0,274
"30362","5410國眾","110/07/13","元富-嘉義",0,103,-103
"30363","5410國眾","110/07/13","新光",50,4,46
"30364","5410國眾","110/07/13","凱基-台北",0,50,-50
"30365","5410國眾","110/07/13","國泰-台中",26,0,26
"30366","5410國眾","110/07/13","瑞士信貸",0,31,-31
"30367","5410國眾","110/07/13","新加坡商瑞銀",22,0,22
"30368","5410國眾","110/07/13","台新-新莊",0,27,-27
"30369","5410國眾","110/07/13","光和-嘉義",20,0,20
"30370","5410國眾","110/07/13","元大-汐止",0,20,-20
"30371","5410國眾","110/07/13","凱基-竹北",17,0,17
"30372","5410國眾","110/07/13","亞東-新竹",0,17,-17
"30373","5410國眾","110/07/13","新光-桃園",15,0,15
"30374","5410國眾","110/07/13","元大-南勢角",0,13,-13
"30375","5410國眾","110/07/13","凱基-台東",14,0,14
"30376","5410國眾","110/07/13","台新-台南",0,12,-12
"30377","5410國眾","110/07/13","富邦-竹北",11,0,11
"30378","5410國眾","110/07/13","中國信託",0,11,-11
"30379","5410國眾","110/07/13","元富-同大",10,0,10
"30380","5410國眾","110/07/13","華南永昌",0,11,-11
"30381","5410國眾","110/07/13","國泰-敦南",24,15,9
"30382","5410國眾","110/07/13","臺銀-臺南",0,10,-10
"30383","5410國眾","110/07/13","日盛-內湖",7,0,7
"30384","5410國眾","110/07/13","台灣企銀-民雄",0,10,-10
"30385","5410國眾","110/07/13","台新-左楠",7,0,7
"30386","5410國眾","110/07/13","高橋",0,10,-10
"30387","5410國眾","110/07/13","元大-新盛",18,12,6
"30388","5410國眾","110/07/13","康和-嘉義",0,10,-10
"30389","5410國眾","110/07/13","統一",5,0,5
"30390","5410國眾","110/07/13","凱基-基隆",0,10,-10
"30391","2841台開","110/07/13","中國信託-高雄",251,50,201
"30392","2841台開","110/07/13","兆豐-公益",0,177,-177
"30393","2841台開","110/07/13","日盛證券",210,13,197
"30394","2841台開","110/07/13","日進",0,152,-152
"30395","2841台開","110/07/13","第一金-台中",55,0,55
"30396","2841台開","110/07/13","港商野村",0,109,-109
"30397","2841台開","110/07/13","國泰-板橋",46,0,46
"30398","2841台開","110/07/13","日盛-信義",0,103,-103
"30399","2841台開","110/07/13","國泰-館前",48,3,45
"30400","2841台開","110/07/13","國泰-敦南",11,75,-64
"30401","2841台開","110/07/13","華南永昌-新莊",45,0,45
"30402","2841台開","110/07/13","永興",0,50,-50
"30403","2841台開","110/07/13","日盛-園區",42,0,42
"30404","2841台開","110/07/13","永豐金-敦南",61,104,-43
"30405","2841台開","110/07/13","台新證券",32,0,32
"30406","2841台開","110/07/13","富邦-台南",0,42,-42
"30407","2841台開","110/07/13","台新-高雄",32,2,30
"30408","2841台開","110/07/13","國票-安和",0,30,-30
"30409","2841台開","110/07/13","豐農",23,0,23
"30410","2841台開","110/07/13","元大-桃園",0,25,-25
"30411","2841台開","110/07/13","合庫-嘉義",20,0,20
"30412","2841台開","110/07/13","新光",8,32,-24
"30413","2841台開","110/07/13","華南永昌-高雄",20,0,20
"30414","2841台開","110/07/13","元大-仁愛",0,24,-24
"30415","2841台開","110/07/13","元大-樹林",16,0,16
"30416","2841台開","110/07/13","日盛-中和",0,20,-20
"30417","2841台開","110/07/13","第一金-華江",15,2,13
"30418","2841台開","110/07/13","元富",0,20,-20
"30419","2841台開","110/07/13","美商高盛",12,0,12
"30420","2841台開","110/07/13","富邦-宜蘭",0,20,-20
"30421","6207雷科","110/07/13","元大-高雄",121,0,121
"30422","6207雷科","110/07/13","華南永昌-朴子",1,60,-59
"30423","6207雷科","110/07/13","第一金-新興",20,0,20
"30424","6207雷科","110/07/13","元大-南海",0,36,-36
"30425","6207雷科","110/07/13","元富-三重",20,0,20
"30426","6207雷科","110/07/13","凱基-土城",0,35,-35
"30427","6207雷科","110/07/13","元大-林園",15,0,15
"30428","6207雷科","110/07/13","台灣企銀",0,20,-20
"30429","6207雷科","110/07/13","元大-金華",16,1,15
"30430","6207雷科","110/07/13","群益金鼎-丹鳳",0,20,-20
"30431","6207雷科","110/07/13","日盛證券",10,0,10
"30432","6207雷科","110/07/13","元大-博愛",0,17,-17
"30433","6207雷科","110/07/13","統一-台中",10,0,10
"30434","6207雷科","110/07/13","元大-北港",0,13,-13
"30435","6207雷科","110/07/13","群益金鼎-土城",10,0,10
"30436","6207雷科","110/07/13","新加坡商瑞銀",0,12,-12
"30437","6207雷科","110/07/13","群益金鼎-桃園",10,0,10
"30438","6207雷科","110/07/13","凱基-台北",4,16,-12
"30439","6207雷科","110/07/13","永豐金-新莊",10,0,10
"30440","6207雷科","110/07/13","日茂-埔里",0,11,-11
"30441","6207雷科","110/07/13","永豐金-新店",10,0,10
"30442","6207雷科","110/07/13","元大-莒光",0,11,-11
"30443","6207雷科","110/07/13","元大證券",9,0,9
"30444","6207雷科","110/07/13","統一-新竹",0,10,-10
"30445","6207雷科","110/07/13","日盛-木柵",9,1,8
"30446","6207雷科","110/07/13","元大-西螺",0,10,-10
"30447","6207雷科","110/07/13","兆豐-來福",8,0,8
"30448","6207雷科","110/07/13","康和-台中",0,8,-8
"30449","6207雷科","110/07/13","新光",7,0,7
"30450","6207雷科","110/07/13","兆豐-高雄",0,6,-6
"30451","3679新至陞","110/07/13","永豐金證券",50,0,50
"30452","3679新至陞","110/07/13","摩根大通",2,25,-23
"30453","3679新至陞","110/07/13","國泰-桃園",22,0,22
"30454","3679新至陞","110/07/13","元大-成功",0,22,-22
"30455","3679新至陞","110/07/13","台中銀-員林",11,0,11
"30456","3679新至陞","110/07/13","富邦-板橋",1,19,-18
"30457","3679新至陞","110/07/13","元大-文心興安",8,0,8
"30458","3679新至陞","110/07/13","日盛-新莊",0,10,-10
"30459","3679新至陞","110/07/13","美商高盛",6,0,6
"30460","3679新至陞","110/07/13","台新-台中",0,10,-10
"30461","3679新至陞","110/07/13","台新-高雄",6,0,6
"30462","3679新至陞","110/07/13","永豐金-新竹",0,8,-8
"30463","3679新至陞","110/07/13","凱基-台北",18,12,6
"30464","3679新至陞","110/07/13","瑞士信貸",12,19,-7
"30465","3679新至陞","110/07/13","日盛-復興",5,0,5
"30466","3679新至陞","110/07/13","統一-南京",0,7,-7
"30467","3679新至陞","110/07/13","(牛牛牛)亞-鑫豐",4,0,4
"30468","3679新至陞","110/07/13","凱基-新莊",0,7,-7
"30469","3679新至陞","110/07/13","元富-大昌",3,0,3
"30470","3679新至陞","110/07/13","新加坡商瑞銀",0,6,-6
"30471","3679新至陞","110/07/13","富邦-台北",3,0,3
"30472","3679新至陞","110/07/13","合庫-自強",0,5,-5
"30473","3679新至陞","110/07/13","日盛-樹林",2,0,2
"30474","3679新至陞","110/07/13","富邦-桃園",0,5,-5
"30475","3679新至陞","110/07/13","宏遠-光隆",2,0,2
"30476","3679新至陞","110/07/13","永豐金-潮州",0,4,-4
"30477","3679新至陞","110/07/13","美林",3,1,2
"30478","3679新至陞","110/07/13","臺銀-臺南",0,3,-3
"30479","3679新至陞","110/07/13","第一金-中壢",2,0,2
"30480","3679新至陞","110/07/13","元大-六合",0,3,-3
"30481","2727王品","110/07/13","富邦-台北",43,3,40
"30482","2727王品","110/07/13","台灣摩根士丹利",15,97,-82
"30483","2727王品","110/07/13","元大-基隆孝二",40,0,40
"30484","2727王品","110/07/13","玉山-台南",5,57,-52
"30485","2727王品","110/07/13","國票-新莊",40,1,39
"30486","2727王品","110/07/13","新加坡商瑞銀",0,48,-48
"30487","2727王品","110/07/13","第一金-豐原",66,42,24
"30488","2727王品","110/07/13","凱基-台北",41,77,-36
"30489","2727王品","110/07/13","永豐金-大園",34,10,24
"30490","2727王品","110/07/13","永豐金-永康",0,22,-22
"30491","2727王品","110/07/13","元大-北屯",22,0,22
"30492","2727王品","110/07/13","統一-台中",2,22,-20
"30493","2727王品","110/07/13","元大-東蘆",26,7,19
"30494","2727王品","110/07/13","國泰-台中",21,39,-18
"30495","2727王品","110/07/13","永豐金-萬盛",13,1,12
"30496","2727王品","110/07/13","合庫-彰化",3,20,-17
"30497","2727王品","110/07/13","日盛-嘉義",11,0,11
"30498","2727王品","110/07/13","港商野村",13,30,-17
"30499","2727王品","110/07/13","日盛-八德",11,0,11
"30500","2727王品","110/07/13","元大-楊梅",1,16,-15
"30501","2727王品","110/07/13","統一-竹南",11,0,11
"30502","2727王品","110/07/13","凱基-高美館",2,15,-13
"30503","2727王品","110/07/13","日盛-士林",12,2,10
"30504","2727王品","110/07/13","美商高盛",2,14,-12
"30505","2727王品","110/07/13","統一-敦南",10,0,10
"30506","2727王品","110/07/13","統一-平鎮",1,13,-12
"30507","2727王品","110/07/13","中國信託",15,5,10
"30508","2727王品","110/07/13","兆豐-台中港",4,16,-12
"30509","2727王品","110/07/13","兆豐-竹北",13,3,10
"30510","2727王品","110/07/13","凱基-八德",1,13,-12
"30511","1570力肯","110/07/13","新光",115,11,104
"30512","1570力肯","110/07/13","元大-北三重",0,162,-162
"30513","1570力肯","110/07/13","群益金鼎-高雄",54,0,54
"30514","1570力肯","110/07/13","元大-大灣",0,25,-25
"30515","1570力肯","110/07/13","國票-新莊",22,0,22
"30516","1570力肯","110/07/13","永豐金-苓雅",0,22,-22
"30517","1570力肯","110/07/13","日盛-桃園",12,0,12
"30518","1570力肯","110/07/13","永豐金-永康",0,19,-19
"30519","1570力肯","110/07/13","元大-高雄",12,0,12
"30520","1570力肯","110/07/13","富邦-員林",0,15,-15
"30521","1570力肯","110/07/13","合庫-自強",11,0,11
"30522","1570力肯","110/07/13","凱基-台南",0,11,-11
"30523","1570力肯","110/07/13","摩根大通",26,15,11
"30524","1570力肯","110/07/13","日盛-竹北",0,10,-10
"30525","1570力肯","110/07/13","永豐金-中盛",11,0,11
"30526","1570力肯","110/07/13","國票-九鼎",0,10,-10
"30527","1570力肯","110/07/13","兆豐-台中港",10,0,10
"30528","1570力肯","110/07/13","凱基-桃園",0,10,-10
"30529","1570力肯","110/07/13","國泰-松江",9,0,9
"30530","1570力肯","110/07/13","凱基-新豐",0,10,-10
"30531","1570力肯","110/07/13","元大-新盛",9,0,9
"30532","1570力肯","110/07/13","元大-學甲",0,10,-10
"30533","1570力肯","110/07/13","元富-緯城",6,0,6
"30534","1570力肯","110/07/13","群益金鼎-東湖",1,10,-9
"30535","1570力肯","110/07/13","統一-三重",5,0,5
"30536","1570力肯","110/07/13","大昌",0,6,-6
"30537","1570力肯","110/07/13","元大-前金",5,0,5
"30538","1570力肯","110/07/13","元大-土城學府",0,6,-6
"30539","1570力肯","110/07/13","永豐金證券",5,0,5
"30540","1570力肯","110/07/13","統一",0,5,-5
"30541","6180橘子","110/07/13","摩根大通",119,0,119
"30542","6180橘子","110/07/13","元大-崇德",2,61,-59
"30543","6180橘子","110/07/13","美商高盛",96,0,96
"30544","6180橘子","110/07/13","康和-台中",0,51,-51
"30545","6180橘子","110/07/13","新加坡商瑞銀",86,7,79
"30546","6180橘子","110/07/13","康和-台北",0,50,-50
"30547","6180橘子","110/07/13","元大-和平",40,0,40
"30548","6180橘子","110/07/13","元富-潮州",0,40,-40
"30549","6180橘子","110/07/13","凱基-台北",83,47,36
"30550","6180橘子","110/07/13","日盛-永康",0,26,-26
"30551","6180橘子","110/07/13","美林",39,5,34
"30552","6180橘子","110/07/13","永豐金-中正",0,24,-24
"30553","6180橘子","110/07/13","富邦-新竹華信",31,2,29
"30554","6180橘子","110/07/13","國泰-板橋",2,25,-23
"30555","6180橘子","110/07/13","統一-南京",21,0,21
"30556","6180橘子","110/07/13","日盛-大墩",0,20,-20
"30557","6180橘子","110/07/13","富邦-陽明",24,3,21
"30558","6180橘子","110/07/13","元大-草屯",13,32,-19
"30559","6180橘子","110/07/13","大昌-樹林",21,1,20
"30560","6180橘子","110/07/13","元富-林園",1,18,-17
"30561","6180橘子","110/07/13","花旗環球",19,0,19
"30562","6180橘子","110/07/13","新光-新竹",1,18,-17
"30563","6180橘子","110/07/13","華南永昌-台南",19,0,19
"30564","6180橘子","110/07/13","元大-土城永寧",0,17,-17
"30565","6180橘子","110/07/13","福勝",14,0,14
"30566","6180橘子","110/07/13","國泰-新莊",3,19,-16
"30567","6180橘子","110/07/13","富邦-嘉義",12,1,11
"30568","6180橘子","110/07/13","中國信託-永康",6,21,-15
"30569","6180橘子","110/07/13","元大-板橋三民",11,0,11
"30570","6180橘子","110/07/13","凱基-東港",1,15,-14
"30571","2390云辰","110/07/13","新加坡商瑞銀",562,75,487
"30572","2390云辰","110/07/13","大展-台南",0,532,-532
"30573","2390云辰","110/07/13","台灣摩根士丹利",330,155,175
"30574","2390云辰","110/07/13","凱基-台北",668,854,-186
"30575","2390云辰","110/07/13","兆豐-公益",126,25,101
"30576","2390云辰","110/07/13","凱基-三重",12,172,-160
"30577","2390云辰","110/07/13","元富-中港",100,2,98
"30578","2390云辰","110/07/13","兆豐-忠孝",4,161,-157
"30579","2390云辰","110/07/13","統一-新台中",106,9,97
"30580","2390云辰","110/07/13","元大-士林",19,170,-151
"30581","2390云辰","110/07/13","中國信託-松江",81,11,70
"30582","2390云辰","110/07/13","臺銀-新竹",14,117,-103
"30583","2390云辰","110/07/13","日盛-板橋",72,3,69
"30584","2390云辰","110/07/13","國票-台中",4,102,-98
"30585","2390云辰","110/07/13","日盛-和美",57,0,57
"30586","2390云辰","110/07/13","新光",147,232,-85
"30587","2390云辰","110/07/13","永豐金-桃園",88,36,52
"30588","2390云辰","110/07/13","致和-崇德",2,70,-68
"30589","2390云辰","110/07/13","玉山-士林",54,4,50
"30590","2390云辰","110/07/13","群益金鼎-屏東",2,70,-68
"30591","2390云辰","110/07/13","富邦-仁愛",56,6,50
"30592","2390云辰","110/07/13","元大-大里",35,98,-63
"30593","2390云辰","110/07/13","第一金-豐原",50,1,49
"30594","2390云辰","110/07/13","元大-萬華",35,94,-59
"30595","2390云辰","110/07/13","摩根大通",502,453,49
"30596","2390云辰","110/07/13","元富-吉利",2,60,-58
"30597","2390云辰","110/07/13","凱基-松山",61,13,48
"30598","2390云辰","110/07/13","兆豐-新竹",3,53,-50
"30599","2390云辰","110/07/13","大昌",64,22,42
"30600","2390云辰","110/07/13","富邦-嘉義",65,108,-43
"30601","2363矽統","110/07/13","凱基-南崁",2133,63,2070
"30602","2363矽統","110/07/13","凱基-幸福",36,4048,-4012
"30603","2363矽統","110/07/13","國泰-敦南",2195,1617,578
"30604","2363矽統","110/07/13","統一",192,3325,-3133
"30605","2363矽統","110/07/13","中農",670,139,531
"30606","2363矽統","110/07/13","新加坡商瑞銀",1000,2747,-1747
"30607","2363矽統","110/07/13","康和-台中",638,154,484
"30608","2363矽統","110/07/13","凱基-台北",5359,6609,-1250
"30609","2363矽統","110/07/13","群益金鼎-三民",577,137,440
"30610","2363矽統","110/07/13","摩根大通",1930,2858,-928
"30611","2363矽統","110/07/13","台新-屏東",510,88,422
"30612","2363矽統","110/07/13","港商野村",960,1679,-719
"30613","2363矽統","110/07/13","德信-中正",455,67,388
"30614","2363矽統","110/07/13","兆豐-復興",25,705,-680
"30615","2363矽統","110/07/13","日盛-竹北",365,70,295
"30616","2363矽統","110/07/13","統一-仁愛",114,755,-641
"30617","2363矽統","110/07/13","元大-佳里",452,189,263
"30618","2363矽統","110/07/13","統一-敦南",29,638,-609
"30619","2363矽統","110/07/13","國票-博愛",296,38,258
"30620","2363矽統","110/07/13","統一-土城",100,704,-604
"30621","2363矽統","110/07/13","元大-萬華",340,95,245
"30622","2363矽統","110/07/13","統一-城中",116,676,-560
"30623","2363矽統","110/07/13","新光",1259,1031,228
"30624","2363矽統","110/07/13","永豐金證券",306,859,-553
"30625","2363矽統","110/07/13","元富-成功",323,96,227
"30626","2363矽統","110/07/13","元富",54,567,-513
"30627","2363矽統","110/07/13","豐農",228,23,205
"30628","2363矽統","110/07/13","瑞士信貸",202,666,-464
"30629","2363矽統","110/07/13","台灣企銀-岡山",186,4,182
"30630","2363矽統","110/07/13","永豐金-嘉義",67,468,-401
"30631","8112至上","110/07/13","摩根大通",688,296,392
"30632","8112至上","110/07/13","國票-中和",0,401,-401
"30633","8112至上","110/07/13","港商野村",344,145,199
"30634","8112至上","110/07/13","永豐金-板盛",0,205,-205
"30635","8112至上","110/07/13","兆豐-公益",195,5,190
"30636","8112至上","110/07/13","凱基-五股",43,155,-112
"30637","8112至上","110/07/13","台灣摩根士丹利",183,0,183
"30638","8112至上","110/07/13","凱基-市政",0,100,-100
"30639","8112至上","110/07/13","群益金鼎-敦南",153,2,151
"30640","8112至上","110/07/13","元大-大里德芳",1,92,-91
"30641","8112至上","110/07/13","臺銀-金山",146,26,120
"30642","8112至上","110/07/13","玉山-桃園",26,110,-84
"30643","8112至上","110/07/13","臺銀",133,19,114
"30644","8112至上","110/07/13","兆豐-天母",0,81,-81
"30645","8112至上","110/07/13","合庫-台中",115,6,109
"30646","8112至上","110/07/13","凱基-城中",3,84,-81
"30647","8112至上","110/07/13","亞東-板橋",134,26,108
"30648","8112至上","110/07/13","日盛-新莊",9,85,-76
"30649","8112至上","110/07/13","凱基-台北",414,326,88
"30650","8112至上","110/07/13","日盛-台中",2,64,-62
"30651","8112至上","110/07/13","新加坡商瑞銀",181,100,81
"30652","8112至上","110/07/13","日盛-中壢",3,64,-61
"30653","8112至上","110/07/13","國泰-敦南",108,31,77
"30654","8112至上","110/07/13","元大-台中",2,59,-57
"30655","8112至上","110/07/13","第一金-華江",77,4,73
"30656","8112至上","110/07/13","元大-雙和",7,64,-57
"30657","8112至上","110/07/13","永豐金-內湖",73,1,72
"30658","8112至上","110/07/13","元大-高雄",8,62,-54
"30659","8112至上","110/07/13","元大-永和",68,1,67
"30660","8112至上","110/07/13","元大-館前",2,55,-53
"30661","4903聯光通","110/07/13","台灣企銀-太平",56,0,56
"30662","4903聯光通","110/07/13","土銀",0,32,-32
"30663","4903聯光通","110/07/13","元富-新興",23,0,23
"30664","4903聯光通","110/07/13","元大-樹林",0,19,-19
"30665","4903聯光通","110/07/13","日盛-樹林",22,0,22
"30666","4903聯光通","110/07/13","凱基-士林",0,17,-17
"30667","4903聯光通","110/07/13","兆豐-天母",20,0,20
"30668","4903聯光通","110/07/13","國票-博愛",0,14,-14
"30669","4903聯光通","110/07/13","華南永昌-桃園",20,0,20
"30670","4903聯光通","110/07/13","元富",0,10,-10
"30671","4903聯光通","110/07/13","富邦-新店",10,0,10
"30672","4903聯光通","110/07/13","新光",0,10,-10
"30673","4903聯光通","110/07/13","新光-台中",5,0,5
"30674","4903聯光通","110/07/13","玉山-南京東路",0,10,-10
"30675","4903聯光通","110/07/13","華南永昌-台中",5,0,5
"30676","4903聯光通","110/07/13","富邦-陽明",0,10,-10
"30677","4903聯光通","110/07/13","元大-崇德",5,0,5
"30678","4903聯光通","110/07/13","元大-大甲",0,8,-8
"30679","4903聯光通","110/07/13","元大-草屯",5,0,5
"30680","4903聯光通","110/07/13","富邦-台中",0,7,-7
"30681","4903聯光通","110/07/13","元富-草屯",4,0,4
"30682","4903聯光通","110/07/13","凱基-中壢",0,6,-6
"30683","4903聯光通","110/07/13","元大-清水",4,0,4
"30684","4903聯光通","110/07/13","臺銀-民權",0,5,-5
"30685","4903聯光通","110/07/13","元大-東泰",4,0,4
"30686","4903聯光通","110/07/13","日盛-板橋",0,5,-5
"30687","4903聯光通","110/07/13","元大-佳里",2,0,2
"30688","4903聯光通","110/07/13","中國信託-忠孝",0,5,-5
"30689","4903聯光通","110/07/13","永豐金-板橋",2,0,2
"30690","4903聯光通","110/07/13","永豐金-鳳山",0,5,-5
"30691","2929淘帝","110/07/13","玉山-新竹",130,0,130
"30692","2929淘帝","110/07/13","美商高盛",0,177,-177
"30693","2929淘帝","110/07/13","臺銀-民權",60,0,60
"30694","2929淘帝","110/07/13","凱基-台北",6,80,-74
"30695","2929淘帝","110/07/13","新百王",31,0,31
"30696","2929淘帝","110/07/13","元富-大裕",0,49,-49
"30697","2929淘帝","110/07/13","日盛-園區",30,0,30
"30698","2929淘帝","110/07/13","國泰-館前",3,51,-48
"30699","2929淘帝","110/07/13","元大-南投",31,1,30
"30700","2929淘帝","110/07/13","凱基-中壢",0,41,-41
"30701","2929淘帝","110/07/13","兆豐-忠孝",28,0,28
"30702","2929淘帝","110/07/13","港商野村",21,55,-34
"30703","2929淘帝","110/07/13","元大-民生",28,0,28
"30704","2929淘帝","110/07/13","華南永昌-南京",2,34,-32
"30705","2929淘帝","110/07/13","合庫-高雄",27,0,27
"30706","2929淘帝","110/07/13","群益金鼎-土城",0,30,-30
"30707","2929淘帝","110/07/13","凱基-豐中",27,0,27
"30708","2929淘帝","110/07/13","富邦-南屯",0,22,-22
"30709","2929淘帝","110/07/13","新光",21,4,17
"30710","2929淘帝","110/07/13","第一金-豐原",0,20,-20
"30711","2929淘帝","110/07/13","元大-天母",17,0,17
"30712","2929淘帝","110/07/13","元大-屏南",6,26,-20
"30713","2929淘帝","110/07/13","永興",14,0,14
"30714","2929淘帝","110/07/13","永豐金-敦南",1,21,-20
"30715","2929淘帝","110/07/13","富邦-台北",12,0,12
"30716","2929淘帝","110/07/13","凱基-三重",2,21,-19
"30717","2929淘帝","110/07/13","元大-永和",12,0,12
"30718","2929淘帝","110/07/13","富邦-仁愛",7,25,-18
"30719","2929淘帝","110/07/13","國票-天祥",11,0,11
"30720","2929淘帝","110/07/13","元大-北投",0,16,-16
"30721","5410國眾","110/07/13","兆豐-城中",274,0,274
"30722","5410國眾","110/07/13","元富-嘉義",0,103,-103
"30723","5410國眾","110/07/13","新光",50,4,46
"30724","5410國眾","110/07/13","凱基-台北",0,50,-50
"30725","5410國眾","110/07/13","國泰-台中",26,0,26
"30726","5410國眾","110/07/13","瑞士信貸",0,31,-31
"30727","5410國眾","110/07/13","新加坡商瑞銀",22,0,22
"30728","5410國眾","110/07/13","台新-新莊",0,27,-27
"30729","5410國眾","110/07/13","光和-嘉義",20,0,20
"30730","5410國眾","110/07/13","元大-汐止",0,20,-20
"30731","5410國眾","110/07/13","凱基-竹北",17,0,17
"30732","5410國眾","110/07/13","亞東-新竹",0,17,-17
"30733","5410國眾","110/07/13","新光-桃園",15,0,15
"30734","5410國眾","110/07/13","元大-南勢角",0,13,-13
"30735","5410國眾","110/07/13","凱基-台東",14,0,14
"30736","5410國眾","110/07/13","台新-台南",0,12,-12
"30737","5410國眾","110/07/13","富邦-竹北",11,0,11
"30738","5410國眾","110/07/13","中國信託",0,11,-11
"30739","5410國眾","110/07/13","元富-同大",10,0,10
"30740","5410國眾","110/07/13","華南永昌",0,11,-11
"30741","5410國眾","110/07/13","國泰-敦南",24,15,9
"30742","5410國眾","110/07/13","臺銀-臺南",0,10,-10
"30743","5410國眾","110/07/13","日盛-內湖",7,0,7
"30744","5410國眾","110/07/13","台灣企銀-民雄",0,10,-10
"30745","5410國眾","110/07/13","台新-左楠",7,0,7
"30746","5410國眾","110/07/13","高橋",0,10,-10
"30747","5410國眾","110/07/13","元大-新盛",18,12,6
"30748","5410國眾","110/07/13","康和-嘉義",0,10,-10
"30749","5410國眾","110/07/13","統一",5,0,5
"30750","5410國眾","110/07/13","凱基-基隆",0,10,-10
"30751","2841台開","110/07/13","中國信託-高雄",251,50,201
"30752","2841台開","110/07/13","兆豐-公益",0,177,-177
"30753","2841台開","110/07/13","日盛證券",210,13,197
"30754","2841台開","110/07/13","日進",0,152,-152
"30755","2841台開","110/07/13","第一金-台中",55,0,55
"30756","2841台開","110/07/13","港商野村",0,109,-109
"30757","2841台開","110/07/13","國泰-板橋",46,0,46
"30758","2841台開","110/07/13","日盛-信義",0,103,-103
"30759","2841台開","110/07/13","國泰-館前",48,3,45
"30760","2841台開","110/07/13","國泰-敦南",11,75,-64
"30761","2841台開","110/07/13","華南永昌-新莊",45,0,45
"30762","2841台開","110/07/13","永興",0,50,-50
"30763","2841台開","110/07/13","日盛-園區",42,0,42
"30764","2841台開","110/07/13","永豐金-敦南",61,104,-43
"30765","2841台開","110/07/13","台新證券",32,0,32
"30766","2841台開","110/07/13","富邦-台南",0,42,-42
"30767","2841台開","110/07/13","台新-高雄",32,2,30
"30768","2841台開","110/07/13","國票-安和",0,30,-30
"30769","2841台開","110/07/13","豐農",23,0,23
"30770","2841台開","110/07/13","元大-桃園",0,25,-25
"30771","2841台開","110/07/13","合庫-嘉義",20,0,20
"30772","2841台開","110/07/13","新光",8,32,-24
"30773","2841台開","110/07/13","華南永昌-高雄",20,0,20
"30774","2841台開","110/07/13","元大-仁愛",0,24,-24
"30775","2841台開","110/07/13","元大-樹林",16,0,16
"30776","2841台開","110/07/13","日盛-中和",0,20,-20
"30777","2841台開","110/07/13","第一金-華江",15,2,13
"30778","2841台開","110/07/13","元富",0,20,-20
"30779","2841台開","110/07/13","美商高盛",12,0,12
"30780","2841台開","110/07/13","富邦-宜蘭",0,20,-20
"30781","6207雷科","110/07/13","元大-高雄",121,0,121
"30782","6207雷科","110/07/13","華南永昌-朴子",1,60,-59
"30783","6207雷科","110/07/13","第一金-新興",20,0,20
"30784","6207雷科","110/07/13","元大-南海",0,36,-36
"30785","6207雷科","110/07/13","元富-三重",20,0,20
"30786","6207雷科","110/07/13","凱基-土城",0,35,-35
"30787","6207雷科","110/07/13","元大-林園",15,0,15
"30788","6207雷科","110/07/13","台灣企銀",0,20,-20
"30789","6207雷科","110/07/13","元大-金華",16,1,15
"30790","6207雷科","110/07/13","群益金鼎-丹鳳",0,20,-20
"30791","6207雷科","110/07/13","日盛證券",10,0,10
"30792","6207雷科","110/07/13","元大-博愛",0,17,-17
"30793","6207雷科","110/07/13","統一-台中",10,0,10
"30794","6207雷科","110/07/13","元大-北港",0,13,-13
"30795","6207雷科","110/07/13","群益金鼎-土城",10,0,10
"30796","6207雷科","110/07/13","新加坡商瑞銀",0,12,-12
"30797","6207雷科","110/07/13","群益金鼎-桃園",10,0,10
"30798","6207雷科","110/07/13","凱基-台北",4,16,-12
"30799","6207雷科","110/07/13","永豐金-新莊",10,0,10
"30800","6207雷科","110/07/13","日茂-埔里",0,11,-11
"30801","6207雷科","110/07/13","永豐金-新店",10,0,10
"30802","6207雷科","110/07/13","元大-莒光",0,11,-11
"30803","6207雷科","110/07/13","元大證券",9,0,9
"30804","6207雷科","110/07/13","統一-新竹",0,10,-10
"30805","6207雷科","110/07/13","日盛-木柵",9,1,8
"30806","6207雷科","110/07/13","元大-西螺",0,10,-10
"30807","6207雷科","110/07/13","兆豐-來福",8,0,8
"30808","6207雷科","110/07/13","康和-台中",0,8,-8
"30809","6207雷科","110/07/13","新光",7,0,7
"30810","6207雷科","110/07/13","兆豐-高雄",0,6,-6
"30811","3679新至陞","110/07/13","永豐金證券",50,0,50
"30812","3679新至陞","110/07/13","摩根大通",2,25,-23
"30813","3679新至陞","110/07/13","國泰-桃園",22,0,22
"30814","3679新至陞","110/07/13","元大-成功",0,22,-22
"30815","3679新至陞","110/07/13","台中銀-員林",11,0,11
"30816","3679新至陞","110/07/13","富邦-板橋",1,19,-18
"30817","3679新至陞","110/07/13","元大-文心興安",8,0,8
"30818","3679新至陞","110/07/13","日盛-新莊",0,10,-10
"30819","3679新至陞","110/07/13","美商高盛",6,0,6
"30820","3679新至陞","110/07/13","台新-台中",0,10,-10
"30821","3679新至陞","110/07/13","台新-高雄",6,0,6
"30822","3679新至陞","110/07/13","永豐金-新竹",0,8,-8
"30823","3679新至陞","110/07/13","凱基-台北",18,12,6
"30824","3679新至陞","110/07/13","瑞士信貸",12,19,-7
"30825","3679新至陞","110/07/13","日盛-復興",5,0,5
"30826","3679新至陞","110/07/13","統一-南京",0,7,-7
"30827","3679新至陞","110/07/13","(牛牛牛)亞-鑫豐",4,0,4
"30828","3679新至陞","110/07/13","凱基-新莊",0,7,-7
"30829","3679新至陞","110/07/13","元富-大昌",3,0,3
"30830","3679新至陞","110/07/13","新加坡商瑞銀",0,6,-6
"30831","3679新至陞","110/07/13","富邦-台北",3,0,3
"30832","3679新至陞","110/07/13","合庫-自強",0,5,-5
"30833","3679新至陞","110/07/13","日盛-樹林",2,0,2
"30834","3679新至陞","110/07/13","富邦-桃園",0,5,-5
"30835","3679新至陞","110/07/13","宏遠-光隆",2,0,2
"30836","3679新至陞","110/07/13","永豐金-潮州",0,4,-4
"30837","3679新至陞","110/07/13","美林",3,1,2
"30838","3679新至陞","110/07/13","臺銀-臺南",0,3,-3
"30839","3679新至陞","110/07/13","第一金-中壢",2,0,2
"30840","3679新至陞","110/07/13","元大-六合",0,3,-3
"30841","2727王品","110/07/13","富邦-台北",43,3,40
"30842","2727王品","110/07/13","台灣摩根士丹利",15,97,-82
"30843","2727王品","110/07/13","元大-基隆孝二",40,0,40
"30844","2727王品","110/07/13","玉山-台南",5,57,-52
"30845","2727王品","110/07/13","國票-新莊",40,1,39
"30846","2727王品","110/07/13","新加坡商瑞銀",0,48,-48
"30847","2727王品","110/07/13","第一金-豐原",66,42,24
"30848","2727王品","110/07/13","凱基-台北",41,77,-36
"30849","2727王品","110/07/13","永豐金-大園",34,10,24
"30850","2727王品","110/07/13","永豐金-永康",0,22,-22
"30851","2727王品","110/07/13","元大-北屯",22,0,22
"30852","2727王品","110/07/13","統一-台中",2,22,-20
"30853","2727王品","110/07/13","元大-東蘆",26,7,19
"30854","2727王品","110/07/13","國泰-台中",21,39,-18
"30855","2727王品","110/07/13","永豐金-萬盛",13,1,12
"30856","2727王品","110/07/13","合庫-彰化",3,20,-17
"30857","2727王品","110/07/13","日盛-嘉義",11,0,11
"30858","2727王品","110/07/13","港商野村",13,30,-17
"30859","2727王品","110/07/13","日盛-八德",11,0,11
"30860","2727王品","110/07/13","元大-楊梅",1,16,-15
"30861","2727王品","110/07/13","統一-竹南",11,0,11
"30862","2727王品","110/07/13","凱基-高美館",2,15,-13
"30863","2727王品","110/07/13","日盛-士林",12,2,10
"30864","2727王品","110/07/13","美商高盛",2,14,-12
"30865","2727王品","110/07/13","統一-敦南",10,0,10
"30866","2727王品","110/07/13","統一-平鎮",1,13,-12
"30867","2727王品","110/07/13","中國信託",15,5,10
"30868","2727王品","110/07/13","兆豐-台中港",4,16,-12
"30869","2727王品","110/07/13","兆豐-竹北",13,3,10
"30870","2727王品","110/07/13","凱基-八德",1,13,-12
"30871","1570力肯","110/07/13","新光",115,11,104
"30872","1570力肯","110/07/13","元大-北三重",0,162,-162
"30873","1570力肯","110/07/13","群益金鼎-高雄",54,0,54
"30874","1570力肯","110/07/13","元大-大灣",0,25,-25
"30875","1570力肯","110/07/13","國票-新莊",22,0,22
"30876","1570力肯","110/07/13","永豐金-苓雅",0,22,-22
"30877","1570力肯","110/07/13","日盛-桃園",12,0,12
"30878","1570力肯","110/07/13","永豐金-永康",0,19,-19
"30879","1570力肯","110/07/13","元大-高雄",12,0,12
"30880","1570力肯","110/07/13","富邦-員林",0,15,-15
"30881","1570力肯","110/07/13","合庫-自強",11,0,11
"30882","1570力肯","110/07/13","凱基-台南",0,11,-11
"30883","1570力肯","110/07/13","摩根大通",26,15,11
"30884","1570力肯","110/07/13","日盛-竹北",0,10,-10
"30885","1570力肯","110/07/13","永豐金-中盛",11,0,11
"30886","1570力肯","110/07/13","國票-九鼎",0,10,-10
"30887","1570力肯","110/07/13","兆豐-台中港",10,0,10
"30888","1570力肯","110/07/13","凱基-桃園",0,10,-10
"30889","1570力肯","110/07/13","國泰-松江",9,0,9
"30890","1570力肯","110/07/13","凱基-新豐",0,10,-10
"30891","1570力肯","110/07/13","元大-新盛",9,0,9
"30892","1570力肯","110/07/13","元大-學甲",0,10,-10
"30893","1570力肯","110/07/13","元富-緯城",6,0,6
"30894","1570力肯","110/07/13","群益金鼎-東湖",1,10,-9
"30895","1570力肯","110/07/13","統一-三重",5,0,5
"30896","1570力肯","110/07/13","大昌",0,6,-6
"30897","1570力肯","110/07/13","元大-前金",5,0,5
"30898","1570力肯","110/07/13","元大-土城學府",0,6,-6
"30899","1570力肯","110/07/13","永豐金證券",5,0,5
"30900","1570力肯","110/07/13","統一",0,5,-5
"30901","6180橘子","110/07/13","摩根大通",119,0,119
"30902","6180橘子","110/07/13","元大-崇德",2,61,-59
"30903","6180橘子","110/07/13","美商高盛",96,0,96
"30904","6180橘子","110/07/13","康和-台中",0,51,-51
"30905","6180橘子","110/07/13","新加坡商瑞銀",86,7,79
"30906","6180橘子","110/07/13","康和-台北",0,50,-50
"30907","6180橘子","110/07/13","元大-和平",40,0,40
"30908","6180橘子","110/07/13","元富-潮州",0,40,-40
"30909","6180橘子","110/07/13","凱基-台北",83,47,36
"30910","6180橘子","110/07/13","日盛-永康",0,26,-26
"30911","6180橘子","110/07/13","美林",39,5,34
"30912","6180橘子","110/07/13","永豐金-中正",0,24,-24
"30913","6180橘子","110/07/13","富邦-新竹華信",31,2,29
"30914","6180橘子","110/07/13","國泰-板橋",2,25,-23
"30915","6180橘子","110/07/13","統一-南京",21,0,21
"30916","6180橘子","110/07/13","日盛-大墩",0,20,-20
"30917","6180橘子","110/07/13","富邦-陽明",24,3,21
"30918","6180橘子","110/07/13","元大-草屯",13,32,-19
"30919","6180橘子","110/07/13","大昌-樹林",21,1,20
"30920","6180橘子","110/07/13","元富-林園",1,18,-17
"30921","6180橘子","110/07/13","花旗環球",19,0,19
"30922","6180橘子","110/07/13","新光-新竹",1,18,-17
"30923","6180橘子","110/07/13","華南永昌-台南",19,0,19
"30924","6180橘子","110/07/13","元大-土城永寧",0,17,-17
"30925","6180橘子","110/07/13","福勝",14,0,14
"30926","6180橘子","110/07/13","國泰-新莊",3,19,-16
"30927","6180橘子","110/07/13","富邦-嘉義",12,1,11
"30928","6180橘子","110/07/13","中國信託-永康",6,21,-15
"30929","6180橘子","110/07/13","元大-板橋三民",11,0,11
"30930","6180橘子","110/07/13","凱基-東港",1,15,-14
"30931","2390云辰","110/07/13","新加坡商瑞銀",562,75,487
"30932","2390云辰","110/07/13","大展-台南",0,532,-532
"30933","2390云辰","110/07/13","台灣摩根士丹利",330,155,175
"30934","2390云辰","110/07/13","凱基-台北",668,854,-186
"30935","2390云辰","110/07/13","兆豐-公益",126,25,101
"30936","2390云辰","110/07/13","凱基-三重",12,172,-160
"30937","2390云辰","110/07/13","元富-中港",100,2,98
"30938","2390云辰","110/07/13","兆豐-忠孝",4,161,-157
"30939","2390云辰","110/07/13","統一-新台中",106,9,97
"30940","2390云辰","110/07/13","元大-士林",19,170,-151
"30941","2390云辰","110/07/13","中國信託-松江",81,11,70
"30942","2390云辰","110/07/13","臺銀-新竹",14,117,-103
"30943","2390云辰","110/07/13","日盛-板橋",72,3,69
"30944","2390云辰","110/07/13","國票-台中",4,102,-98
"30945","2390云辰","110/07/13","日盛-和美",57,0,57
"30946","2390云辰","110/07/13","新光",147,232,-85
"30947","2390云辰","110/07/13","永豐金-桃園",88,36,52
"30948","2390云辰","110/07/13","致和-崇德",2,70,-68
"30949","2390云辰","110/07/13","玉山-士林",54,4,50
"30950","2390云辰","110/07/13","群益金鼎-屏東",2,70,-68
"30951","2390云辰","110/07/13","富邦-仁愛",56,6,50
"30952","2390云辰","110/07/13","元大-大里",35,98,-63
"30953","2390云辰","110/07/13","第一金-豐原",50,1,49
"30954","2390云辰","110/07/13","元大-萬華",35,94,-59
"30955","2390云辰","110/07/13","摩根大通",502,453,49
"30956","2390云辰","110/07/13","元富-吉利",2,60,-58
"30957","2390云辰","110/07/13","凱基-松山",61,13,48
"30958","2390云辰","110/07/13","兆豐-新竹",3,53,-50
"30959","2390云辰","110/07/13","大昌",64,22,42
"30960","2390云辰","110/07/13","富邦-嘉義",65,108,-43
"30961","2363矽統","110/07/12","凱基-幸福",4046,31,4015
"30962","2363矽統","110/07/12","台新證券",478,2105,-1627
"30963","2363矽統","110/07/12","統一",3504,120,3384
"30964","2363矽統","110/07/12","第一金-忠孝",4,1068,-1064
"30965","2363矽統","110/07/12","摩根大通",3006,2149,857
"30966","2363矽統","110/07/12","台新-台中",381,1003,-622
"30967","2363矽統","110/07/12","永豐金證券",1428,610,818
"30968","2363矽統","110/07/12","新光",1295,1822,-527
"30969","2363矽統","110/07/12","兆豐-復興",1936,1233,703
"30970","2363矽統","110/07/12","大昌-樹林",54,537,-483
"30971","2363矽統","110/07/12","台灣摩根士丹利",701,0,701
"30972","2363矽統","110/07/12","華南永昌-台中",90,549,-459
"30973","2363矽統","110/07/12","永豐金-南投",803,145,658
"30974","2363矽統","110/07/12","玉山-高雄",167,612,-445
"30975","2363矽統","110/07/12","統一-仁愛",1214,586,628
"30976","2363矽統","110/07/12","元富-同大",201,540,-339
"30977","2363矽統","110/07/12","統一-土城",688,75,613
"30978","2363矽統","110/07/12","華南永昌-東勢",31,367,-336
"30979","2363矽統","110/07/12","統一-城中",711,131,580
"30980","2363矽統","110/07/12","土銀-花蓮",9,333,-324
"30981","2363矽統","110/07/12","統一-敦南",632,54,578
"30982","2363矽統","110/07/12","凱基-豐中",120,434,-314
"30983","2363矽統","110/07/12","新加坡商瑞銀",1232,731,501
"30984","2363矽統","110/07/12","永豐金-竹科",54,323,-269
"30985","2363矽統","110/07/12","元富",2640,2142,498
"30986","2363矽統","110/07/12","元大-斗六",53,300,-247
"30987","2363矽統","110/07/12","凱基-永和",460,31,429
"30988","2363矽統","110/07/12","華南永昌-朴子",47,278,-231
"30989","2363矽統","110/07/12","第一金",380,22,358
"30990","2363矽統","110/07/12","永豐金-彰化",22,228,-206
"30991","8112至上","110/07/12","摩根大通",1167,290,877
"30992","8112至上","110/07/12","群益金鼎-新莊",1,156,-155
"30993","8112至上","110/07/12","凱基-台北",983,546,437
"30994","8112至上","110/07/12","國票-中港",0,131,-131
"30995","8112至上","110/07/12","新加坡商瑞銀",429,12,417
"30996","8112至上","110/07/12","元大證券",10,136,-126
"30997","8112至上","110/07/12","元大-屏南",360,2,358
"30998","8112至上","110/07/12","元大-中壢",11,135,-124
"30999","8112至上","110/07/12","美林",323,15,308
"31000","8112至上","110/07/12","合庫-基隆",0,122,-122
"31001","8112至上","110/07/12","台灣摩根士丹利",299,0,299
"31002","8112至上","110/07/12","群益金鼎-高盛",4,103,-99
"31003","8112至上","110/07/12","港商野村",267,28,239
"31004","8112至上","110/07/12","新光",110,202,-92
"31005","8112至上","110/07/12","大慶",165,3,162
"31006","8112至上","110/07/12","元大-府城",2,94,-92
"31007","8112至上","110/07/12","永豐金-台南",170,29,141
"31008","8112至上","110/07/12","富邦-板橋",5,92,-87
"31009","8112至上","110/07/12","華南永昌-長虹",128,2,126
"31010","8112至上","110/07/12","元大-土城",8,89,-81
"31011","8112至上","110/07/12","富邦-仁愛",157,51,106
"31012","8112至上","110/07/12","日盛-頭份",40,117,-77
"31013","8112至上","110/07/12","瑞士信貸",104,0,104
"31014","8112至上","110/07/12","玉山-嘉義",3,80,-77
"31015","8112至上","110/07/12","凱基-站前",100,11,89
"31016","8112至上","110/07/12","永豐金-松山",4,79,-75
"31017","8112至上","110/07/12","富邦-北港",90,3,87
"31018","8112至上","110/07/12","元大-敦南",3,75,-72
"31019","8112至上","110/07/12","元大-北港",101,20,81
"31020","8112至上","110/07/12","元富-大裕",6,77,-71
"31021","4903聯光通","110/07/12","台灣企銀-太平",19,0,19
"31022","4903聯光通","110/07/12","玉山-南京東路",0,16,-16
"31023","4903聯光通","110/07/12","統一-土城",17,0,17
"31024","4903聯光通","110/07/12","新光",0,14,-14
"31025","4903聯光通","110/07/12","國票-博愛",14,0,14
"31026","4903聯光通","110/07/12","兆豐-彰化",0,10,-10
"31027","4903聯光通","110/07/12","新光-台中",15,2,13
"31028","4903聯光通","110/07/12","國票",0,10,-10
"31029","4903聯光通","110/07/12","元大-彰化",11,0,11
"31030","4903聯光通","110/07/12","富邦-敦南",0,10,-10
"31031","4903聯光通","110/07/12","華南永昌-林口",10,0,10
"31032","4903聯光通","110/07/12","元大-前金",0,9,-9
"31033","4903聯光通","110/07/12","永豐金-南投",9,0,9
"31034","4903聯光通","110/07/12","日盛-頭份",0,8,-8
"31035","4903聯光通","110/07/12","元大-清水",8,0,8
"31036","4903聯光通","110/07/12","元大-太平",0,8,-8
"31037","4903聯光通","110/07/12","元大-博愛",8,0,8
"31038","4903聯光通","110/07/12","兆豐-埔墘",0,7,-7
"31039","4903聯光通","110/07/12","玉山-新莊",5,0,5
"31040","4903聯光通","110/07/12","臺銀-民權",0,5,-5
"31041","4903聯光通","110/07/12","凱基-士林",10,5,5
"31042","4903聯光通","110/07/12","富邦-板橋",0,5,-5
"31043","4903聯光通","110/07/12","元大-斗六",4,0,4
"31044","4903聯光通","110/07/12","元大-土城永寧",0,5,-5
"31045","4903聯光通","110/07/12","永豐金-羅東",4,0,4
"31046","4903聯光通","110/07/12","台新證券",0,4,-4
"31047","4903聯光通","110/07/12","日盛-樹林",3,0,3
"31048","4903聯光通","110/07/12","凱基-中壢",0,4,-4
"31049","4903聯光通","110/07/12","華南永昌-鶯歌",2,0,2
"31050","4903聯光通","110/07/12","元大-羅東",0,4,-4
"31051","2929淘帝","110/07/12","新光-台中",95,36,59
"31052","2929淘帝","110/07/12","華南永昌-林口",7,208,-201
"31053","2929淘帝","110/07/12","富邦-板橋",62,5,57
"31054","2929淘帝","110/07/12","富邦-台北",6,200,-194
"31055","2929淘帝","110/07/12","合庫-高雄",56,6,50
"31056","2929淘帝","110/07/12","元富-大裕",11,200,-189
"31057","2929淘帝","110/07/12","永興",41,0,41
"31058","2929淘帝","110/07/12","台中銀-台北",0,160,-160
"31059","2929淘帝","110/07/12","兆豐-忠孝",58,18,40
"31060","2929淘帝","110/07/12","日盛-園區",1,111,-110
"31061","2929淘帝","110/07/12","新光-高雄",39,3,36
"31062","2929淘帝","110/07/12","日盛-八德",0,88,-88
"31063","2929淘帝","110/07/12","凱基-豐中",36,0,36
"31064","2929淘帝","110/07/12","玉山-新竹",32,110,-78
"31065","2929淘帝","110/07/12","元大-民生",35,0,35
"31066","2929淘帝","110/07/12","元大-前金",0,72,-72
"31067","2929淘帝","110/07/12","臺銀-臺南",32,1,31
"31068","2929淘帝","110/07/12","元大-館前",12,83,-71
"31069","2929淘帝","110/07/12","台新證券",44,13,31
"31070","2929淘帝","110/07/12","華南永昌",1,57,-56
"31071","2929淘帝","110/07/12","新百王",30,0,30
"31072","2929淘帝","110/07/12","元大-南崁",4,59,-55
"31073","2929淘帝","110/07/12","群益金鼎-大興",30,0,30
"31074","2929淘帝","110/07/12","元大-嘉義",0,51,-51
"31075","2929淘帝","110/07/12","凱基-台北",32,5,27
"31076","2929淘帝","110/07/12","日茂",1,50,-49
"31077","2929淘帝","110/07/12","元富-城東",26,0,26
"31078","2929淘帝","110/07/12","新光",35,83,-48
"31079","2929淘帝","110/07/12","國泰-松江",26,0,26
"31080","2929淘帝","110/07/12","日盛-新竹",1,48,-47
"31081","5410國眾","110/07/12","群益金鼎-中壢",68,0,68
"31082","5410國眾","110/07/12","摩根大通",6,67,-61
"31083","5410國眾","110/07/12","凱基-市政",40,0,40
"31084","5410國眾","110/07/12","元富-嘉義",0,60,-60
"31085","5410國眾","110/07/12","凱基-竹北",38,0,38
"31086","5410國眾","110/07/12","凱基-台北",0,51,-51
"31087","5410國眾","110/07/12","華南永昌-三重",30,0,30
"31088","5410國眾","110/07/12","元富-大裕",0,33,-33
"31089","5410國眾","110/07/12","永興",20,0,20
"31090","5410國眾","110/07/12","日盛-木柵",0,15,-15
"31091","5410國眾","110/07/12","統一-新台中",20,0,20
"31092","5410國眾","110/07/12","群益金鼎-民權",0,15,-15
"31093","5410國眾","110/07/12","兆豐-三重",20,0,20
"31094","5410國眾","110/07/12","元富-緯城",0,14,-14
"31095","5410國眾","110/07/12","富邦-台中",20,0,20
"31096","5410國眾","110/07/12","元大-大同",0,12,-12
"31097","5410國眾","110/07/12","臺銀",15,0,15
"31098","5410國眾","110/07/12","元大-莒光",0,10,-10
"31099","5410國眾","110/07/12","新光-桃園",20,6,14
"31100","5410國眾","110/07/12","元大-博愛",0,10,-10
"31101","5410國眾","110/07/12","元大-員林",12,0,12
"31102","5410國眾","110/07/12","日盛-永康",0,8,-8
"31103","5410國眾","110/07/12","日盛-員林",10,0,10
"31104","5410國眾","110/07/12","元大-四維",5,13,-8
"31105","5410國眾","110/07/12","元大-新盛",10,0,10
"31106","5410國眾","110/07/12","新加坡商瑞銀",0,7,-7
"31107","5410國眾","110/07/12","永豐金-台南",10,0,10
"31108","5410國眾","110/07/12","致和-金華",0,7,-7
"31109","5410國眾","110/07/12","元富-新莊",8,0,8
"31110","5410國眾","110/07/12","新光-新竹",0,7,-7
"31111","2841台開","110/07/12","永豐金-敦南",139,26,113
"31112","2841台開","110/07/12","華南永昌-朴子",0,528,-528
"31113","2841台開","110/07/12","日盛-雙和",68,0,68
"31114","2841台開","110/07/12","元大-苑裡",2,50,-48
"31115","2841台開","110/07/12","台新證券",62,4,58
"31116","2841台開","110/07/12","群益金鼎-東湖",0,40,-40
"31117","2841台開","110/07/12","凱基-文心",50,0,50
"31118","2841台開","110/07/12","第一金-員林",0,30,-30
"31119","2841台開","110/07/12","第一金-台中",45,0,45
"31120","2841台開","110/07/12","德信-中正",0,20,-20
"31121","2841台開","110/07/12","富邦-嘉義",40,0,40
"31122","2841台開","110/07/12","兆豐-嘉義",0,20,-20
"31123","2841台開","110/07/12","日盛-木柵",30,0,30
"31124","2841台開","110/07/12","彰銀-七賢",0,15,-15
"31125","2841台開","110/07/12","中國信託-文心",31,3,28
"31126","2841台開","110/07/12","元大-承德",0,14,-14
"31127","2841台開","110/07/12","元大-福營",30,7,23
"31128","2841台開","110/07/12","元富",0,12,-12
"31129","2841台開","110/07/12","台中銀",20,0,20
"31130","2841台開","110/07/12","富邦-陽明",0,11,-11
"31131","2841台開","110/07/12","國泰-板橋",20,0,20
"31132","2841台開","110/07/12","元大證券",0,11,-11
"31133","2841台開","110/07/12","元大-前金",20,0,20
"31134","2841台開","110/07/12","元大-大甲",0,10,-10
"31135","2841台開","110/07/12","中國信託-高雄",16,1,15
"31136","2841台開","110/07/12","日盛-新竹",0,8,-8
"31137","2841台開","110/07/12","陽信-石牌",15,0,15
"31138","2841台開","110/07/12","元富-城東",0,8,-8
"31139","2841台開","110/07/12","永豐金-南投",15,0,15
"31140","2841台開","110/07/12","玉山-台南",2,10,-8
"31141","6207雷科","110/07/12","元大-高雄",34,0,34
"31142","6207雷科","110/07/12","永豐金-三重",1,32,-31
"31143","6207雷科","110/07/12","華南永昌-林口",16,1,15
"31144","6207雷科","110/07/12","永全-八德",0,30,-30
"31145","6207雷科","110/07/12","摩根大通",19,6,13
"31146","6207雷科","110/07/12","國泰-台中",0,14,-14
"31147","6207雷科","110/07/12","元富-埔里",10,0,10
"31148","6207雷科","110/07/12","第一金-澎湖",0,10,-10
"31149","6207雷科","110/07/12","凱基-台南",10,0,10
"31150","6207雷科","110/07/12","元富-林園",0,10,-10
"31151","6207雷科","110/07/12","新加坡商瑞銀",9,0,9
"31152","6207雷科","110/07/12","元大-東門",0,10,-10
"31153","6207雷科","110/07/12","瑞士信貸",8,0,8
"31154","6207雷科","110/07/12","兆豐-嘉義",0,4,-4
"31155","6207雷科","110/07/12","中國信託-高雄",9,1,8
"31156","6207雷科","110/07/12","新光",0,4,-4
"31157","6207雷科","110/07/12","凱基-高雄",6,0,6
"31158","6207雷科","110/07/12","新光-台中",0,4,-4
"31159","6207雷科","110/07/12","元大-六合",6,0,6
"31160","6207雷科","110/07/12","群益金鼎-開元",0,4,-4
"31161","6207雷科","110/07/12","永豐金-信義",6,0,6
"31162","6207雷科","110/07/12","凱基-桃園",0,4,-4
"31163","6207雷科","110/07/12","群益金鼎-土城",5,0,5
"31164","6207雷科","110/07/12","凱基-民權",0,4,-4
"31165","6207雷科","110/07/12","群益金鼎-竹南",5,0,5
"31166","6207雷科","110/07/12","玉山-新莊",0,3,-3
"31167","6207雷科","110/07/12","元大-大灣",5,1,4
"31168","6207雷科","110/07/12","國泰-松江",0,3,-3
"31169","6207雷科","110/07/12","永興",3,0,3
"31170","6207雷科","110/07/12","富邦-羅東",0,3,-3
"31171","3679新至陞","110/07/12","富邦-新竹華信",40,2,38
"31172","3679新至陞","110/07/12","瑞士信貸",0,45,-45
"31173","3679新至陞","110/07/12","台中銀-員林",28,2,26
"31174","3679新至陞","110/07/12","永豐金-天母",0,39,-39
"31175","3679新至陞","110/07/12","聯邦-大業",24,0,24
"31176","3679新至陞","110/07/12","摩根大通",7,35,-28
"31177","3679新至陞","110/07/12","永豐金證券",20,0,20
"31178","3679新至陞","110/07/12","凱基-台北",8,36,-28
"31179","3679新至陞","110/07/12","港商法國興業",14,0,14
"31180","3679新至陞","110/07/12","華南永昌-小港",1,23,-22
"31181","3679新至陞","110/07/12","日盛-樹林",13,1,12
"31182","3679新至陞","110/07/12","台新-台中",0,15,-15
"31183","3679新至陞","110/07/12","國泰-桃園",9,0,9
"31184","3679新至陞","110/07/12","統一-台中",0,12,-12
"31185","3679新至陞","110/07/12","宏遠-館前",8,0,8
"31186","3679新至陞","110/07/12","元大-成功",1,12,-11
"31187","3679新至陞","110/07/12","凱基",10,2,8
"31188","3679新至陞","110/07/12","康和-澎湖",0,8,-8
"31189","3679新至陞","110/07/12","(牛牛牛)亞-網路",7,0,7
"31190","3679新至陞","110/07/12","新加坡商瑞銀",0,7,-7
"31191","3679新至陞","110/07/12","兆豐-員林",7,0,7
"31192","3679新至陞","110/07/12","兆豐-來福",0,7,-7
"31193","3679新至陞","110/07/12","大慶-蘆洲",5,0,5
"31194","3679新至陞","110/07/12","元大-佳里",0,6,-6
"31195","3679新至陞","110/07/12","土銀-花蓮",4,0,4
"31196","3679新至陞","110/07/12","美商高盛",0,5,-5
"31197","3679新至陞","110/07/12","台新-高雄",5,1,4
"31198","3679新至陞","110/07/12","國票-新莊",0,5,-5
"31199","3679新至陞","110/07/12","元大-天母",4,0,4
"31200","3679新至陞","110/07/12","台新-屏東",0,5,-5
"31201","2727王品","110/07/12","凱基-台北",354,198,156
"31202","2727王品","110/07/12","台灣摩根士丹利",5,386,-381
"31203","2727王品","110/07/12","統一-城中",159,22,137
"31204","2727王品","110/07/12","元大-嘉義",4,60,-56
"31205","2727王品","110/07/12","日盛-忠孝",60,0,60
"31206","2727王品","110/07/12","元大-大同",2,44,-42
"31207","2727王品","110/07/12","永豐金-忠孝",45,5,40
"31208","2727王品","110/07/12","國泰-台中",32,73,-41
"31209","2727王品","110/07/12","合庫-新竹",31,0,31
"31210","2727王品","110/07/12","元大證券",127,163,-36
"31211","2727王品","110/07/12","富邦-台中",31,3,28
"31212","2727王品","110/07/12","凱基",1,33,-32
"31213","2727王品","110/07/12","元大-桃園",35,10,25
"31214","2727王品","110/07/12","永全-南崁",1,31,-30
"31215","2727王品","110/07/12","新加坡商瑞銀",28,4,24
"31216","2727王品","110/07/12","凱基-和平",2,32,-30
"31217","2727王品","110/07/12","群益金鼎-古亭",25,2,23
"31218","2727王品","110/07/12","永豐金-大園",8,38,-30
"31219","2727王品","110/07/12","元大-龍潭",29,7,22
"31220","2727王品","110/07/12","瑞士信貸",0,28,-28
"31221","2727王品","110/07/12","永豐金-永康",25,3,22
"31222","2727王品","110/07/12","元富",17,44,-27
"31223","2727王品","110/07/12","富邦-竹北",24,3,21
"31224","2727王品","110/07/12","元大-北屯",5,32,-27
"31225","2727王品","110/07/12","群益金鼎-松山",20,0,20
"31226","2727王品","110/07/12","華南永昌",3,28,-25
"31227","2727王品","110/07/12","元大-八德",20,0,20
"31228","2727王品","110/07/12","統一-竹南",1,23,-22
"31229","2727王品","110/07/12","元大-南京",25,6,19
"31230","2727王品","110/07/12","永豐金證券",4,26,-22
"31231","1570力肯","110/07/12","國票-北高雄",40,0,40
"31232","1570力肯","110/07/12","日盛-竹北",0,40,-40
"31233","1570力肯","110/07/12","摩根大通",16,0,16
"31234","1570力肯","110/07/12","第一金-華江",1,38,-37
"31235","1570力肯","110/07/12","新光",31,19,12
"31236","1570力肯","110/07/12","元大-永春",0,26,-26
"31237","1570力肯","110/07/12","元大-台中中港",12,0,12
"31238","1570力肯","110/07/12","元大-古亭",1,20,-19
"31239","1570力肯","110/07/12","日盛-高雄",10,0,10
"31240","1570力肯","110/07/12","國泰-松江",0,16,-16
"31241","1570力肯","110/07/12","第一金-路竹",10,0,10
"31242","1570力肯","110/07/12","台新-台南",0,15,-15
"31243","1570力肯","110/07/12","台新-新莊",10,0,10
"31244","1570力肯","110/07/12","康和-石牌",0,15,-15
"31245","1570力肯","110/07/12","元大-新盛",9,0,9
"31246","1570力肯","110/07/12","國泰-板橋",0,11,-11
"31247","1570力肯","110/07/12","凱基-台北",8,0,8
"31248","1570力肯","110/07/12","元大-高雄",0,11,-11
"31249","1570力肯","110/07/12","彰銀-七賢",6,0,6
"31250","1570力肯","110/07/12","兆豐-桃園",0,10,-10
"31251","1570力肯","110/07/12","元富-緯城",6,0,6
"31252","1570力肯","110/07/12","元大-大益",0,10,-10
"31253","1570力肯","110/07/12","華南永昌-古亭",6,0,6
"31254","1570力肯","110/07/12","中國信託-文心",0,5,-5
"31255","1570力肯","110/07/12","富邦-陽明",6,0,6
"31256","1570力肯","110/07/12","光和",0,5,-5
"31257","1570力肯","110/07/12","臺銀-臺南",5,0,5
"31258","1570力肯","110/07/12","陽信-石牌",0,5,-5
"31259","1570力肯","110/07/12","宏遠-館前",5,0,5
"31260","1570力肯","110/07/12","國泰-高雄",0,5,-5
"31261","6180橘子","110/07/12","康和-台中",32,2,30
"31262","6180橘子","110/07/12","新百王",1,40,-39
"31263","6180橘子","110/07/12","美林",32,3,29
"31264","6180橘子","110/07/12","富邦-陽明",4,42,-38
"31265","6180橘子","110/07/12","元大-羅東",21,0,21
"31266","6180橘子","110/07/12","新光",3,32,-29
"31267","6180橘子","110/07/12","兆豐-埔墘",16,0,16
"31268","6180橘子","110/07/12","日盛-文化",4,20,-16
"31269","6180橘子","110/07/12","元大-雙和",12,0,12
"31270","6180橘子","110/07/12","華南永昌-鶯歌",0,15,-15
"31271","6180橘子","110/07/12","美商高盛",18,7,11
"31272","6180橘子","110/07/12","中國信託-忠孝",7,20,-13
"31273","6180橘子","110/07/12","台新證券",14,3,11
"31274","6180橘子","110/07/12","凱基-台北",5,17,-12
"31275","6180橘子","110/07/12","元大-中壢",12,1,11
"31276","6180橘子","110/07/12","凱基-高雄",0,11,-11
"31277","6180橘子","110/07/12","統一-南京",10,0,10
"31278","6180橘子","110/07/12","凱基-大安",0,10,-10
"31279","6180橘子","110/07/12","致和-崇德",10,0,10
"31280","6180橘子","110/07/12","元大-北屯",0,10,-10
"31281","6180橘子","110/07/12","玉山-板橋",10,0,10
"31282","6180橘子","110/07/12","元大-南京",0,9,-9
"31283","6180橘子","110/07/12","富邦-仁愛",10,0,10
"31284","6180橘子","110/07/12","元大-台南",1,10,-9
"31285","6180橘子","110/07/12","摩根大通",10,1,9
"31286","6180橘子","110/07/12","康和-澎湖",0,8,-8
"31287","6180橘子","110/07/12","元富-林園",8,0,8
"31288","6180橘子","110/07/12","第一金-台中",0,7,-7
"31289","6180橘子","110/07/12","大慶-富順",7,0,7
"31290","6180橘子","110/07/12","台新-台南",1,8,-7
"31291","2390云辰","110/07/12","統一-新台中",170,0,170
"31292","2390云辰","110/07/12","元大-天母",2,450,-448
"31293","2390云辰","110/07/12","華南永昌-麻豆",137,2,135
"31294","2390云辰","110/07/12","國泰-忠孝",1,143,-142
"31295","2390云辰","110/07/12","元富-成功",103,14,89
"31296","2390云辰","110/07/12","摩根大通",377,512,-135
"31297","2390云辰","110/07/12","元大-土城學府",146,69,77
"31298","2390云辰","110/07/12","台灣摩根士丹利",0,91,-91
"31299","2390云辰","110/07/12","永豐金-永康",76,4,72
"31300","2390云辰","110/07/12","美林",84,146,-62
"31301","2390云辰","110/07/12","台中銀",73,2,71
"31302","2390云辰","110/07/12","華南永昌-嘉義",2,61,-59
"31303","2390云辰","110/07/12","大昌",63,3,60
"31304","2390云辰","110/07/12","永豐金-羅東",0,49,-49
"31305","2390云辰","110/07/12","合庫-三重",50,0,50
"31306","2390云辰","110/07/12","玉山-台中",6,53,-47
"31307","2390云辰","110/07/12","元富-高雄",93,50,43
"31308","2390云辰","110/07/12","玉山-新莊",2,48,-46
"31309","2390云辰","110/07/12","元大-館前",40,4,36
"31310","2390云辰","110/07/12","元大-大里",7,52,-45
"31311","2390云辰","110/07/12","港商野村",143,109,34
"31312","2390云辰","110/07/12","元大-內湖",3,48,-45
"31313","2390云辰","110/07/12","元大-雙和",34,0,34
"31314","2390云辰","110/07/12","永豐金-市政",1,42,-41
"31315","2390云辰","110/07/12","群益金鼎-民權",33,2,31
"31316","2390云辰","110/07/12","元大-學甲",1,41,-40
"31317","2390云辰","110/07/12","日盛-八德",40,10,30
"31318","2390云辰","110/07/12","兆豐-高雄",2,41,-39
"31319","2390云辰","110/07/12","國票-嘉義",30,0,30
"31320","2390云辰","110/07/12","新加坡商瑞銀",21,59,-38
"31321","4903聯光通","110/07/12","台灣企銀-太平",19,0,19
"31322","4903聯光通","110/07/12","玉山-南京東路",0,16,-16
"31323","4903聯光通","110/07/12","統一-土城",17,0,17
"31324","4903聯光通","110/07/12","新光",0,14,-14
"31325","4903聯光通","110/07/12","國票-博愛",14,0,14
"31326","4903聯光通","110/07/12","兆豐-彰化",0,10,-10
"31327","4903聯光通","110/07/12","新光-台中",15,2,13
"31328","4903聯光通","110/07/12","國票",0,10,-10
"31329","4903聯光通","110/07/12","元大-彰化",11,0,11
"31330","4903聯光通","110/07/12","富邦-敦南",0,10,-10
"31331","4903聯光通","110/07/12","華南永昌-林口",10,0,10
"31332","4903聯光通","110/07/12","元大-前金",0,9,-9
"31333","4903聯光通","110/07/12","永豐金-南投",9,0,9
"31334","4903聯光通","110/07/12","日盛-頭份",0,8,-8
"31335","4903聯光通","110/07/12","元大-清水",8,0,8
"31336","4903聯光通","110/07/12","元大-太平",0,8,-8
"31337","4903聯光通","110/07/12","元大-博愛",8,0,8
"31338","4903聯光通","110/07/12","兆豐-埔墘",0,7,-7
"31339","4903聯光通","110/07/12","玉山-新莊",5,0,5
"31340","4903聯光通","110/07/12","臺銀-民權",0,5,-5
"31341","4903聯光通","110/07/12","凱基-士林",10,5,5
"31342","4903聯光通","110/07/12","富邦-板橋",0,5,-5
"31343","4903聯光通","110/07/12","元大-斗六",4,0,4
"31344","4903聯光通","110/07/12","元大-土城永寧",0,5,-5
"31345","4903聯光通","110/07/12","永豐金-羅東",4,0,4
"31346","4903聯光通","110/07/12","台新證券",0,4,-4
"31347","4903聯光通","110/07/12","日盛-樹林",3,0,3
"31348","4903聯光通","110/07/12","凱基-中壢",0,4,-4
"31349","4903聯光通","110/07/12","華南永昌-鶯歌",2,0,2
"31350","4903聯光通","110/07/12","元大-羅東",0,4,-4
"31351","2929淘帝","110/07/12","新光-台中",95,36,59
"31352","2929淘帝","110/07/12","華南永昌-林口",7,208,-201
"31353","2929淘帝","110/07/12","富邦-板橋",62,5,57
"31354","2929淘帝","110/07/12","富邦-台北",6,200,-194
"31355","2929淘帝","110/07/12","合庫-高雄",56,6,50
"31356","2929淘帝","110/07/12","元富-大裕",11,200,-189
"31357","2929淘帝","110/07/12","永興",41,0,41
"31358","2929淘帝","110/07/12","台中銀-台北",0,160,-160
"31359","2929淘帝","110/07/12","兆豐-忠孝",58,18,40
"31360","2929淘帝","110/07/12","日盛-園區",1,111,-110
"31361","2929淘帝","110/07/12","新光-高雄",39,3,36
"31362","2929淘帝","110/07/12","日盛-八德",0,88,-88
"31363","2929淘帝","110/07/12","凱基-豐中",36,0,36
"31364","2929淘帝","110/07/12","玉山-新竹",32,110,-78
"31365","2929淘帝","110/07/12","元大-民生",35,0,35
"31366","2929淘帝","110/07/12","元大-前金",0,72,-72
"31367","2929淘帝","110/07/12","臺銀-臺南",32,1,31
"31368","2929淘帝","110/07/12","元大-館前",12,83,-71
"31369","2929淘帝","110/07/12","台新證券",44,13,31
"31370","2929淘帝","110/07/12","華南永昌",1,57,-56
"31371","2929淘帝","110/07/12","新百王",30,0,30
"31372","2929淘帝","110/07/12","元大-南崁",4,59,-55
"31373","2929淘帝","110/07/12","群益金鼎-大興",30,0,30
"31374","2929淘帝","110/07/12","元大-嘉義",0,51,-51
"31375","2929淘帝","110/07/12","凱基-台北",32,5,27
"31376","2929淘帝","110/07/12","日茂",1,50,-49
"31377","2929淘帝","110/07/12","元富-城東",26,0,26
"31378","2929淘帝","110/07/12","新光",35,83,-48
"31379","2929淘帝","110/07/12","國泰-松江",26,0,26
"31380","2929淘帝","110/07/12","日盛-新竹",1,48,-47
"31381","5410國眾","110/07/12","群益金鼎-中壢",68,0,68
"31382","5410國眾","110/07/12","摩根大通",6,67,-61
"31383","5410國眾","110/07/12","凱基-市政",40,0,40
"31384","5410國眾","110/07/12","元富-嘉義",0,60,-60
"31385","5410國眾","110/07/12","凱基-竹北",38,0,38
"31386","5410國眾","110/07/12","凱基-台北",0,51,-51
"31387","5410國眾","110/07/12","華南永昌-三重",30,0,30
"31388","5410國眾","110/07/12","元富-大裕",0,33,-33
"31389","5410國眾","110/07/12","永興",20,0,20
"31390","5410國眾","110/07/12","日盛-木柵",0,15,-15
"31391","5410國眾","110/07/12","統一-新台中",20,0,20
"31392","5410國眾","110/07/12","群益金鼎-民權",0,15,-15
"31393","5410國眾","110/07/12","兆豐-三重",20,0,20
"31394","5410國眾","110/07/12","元富-緯城",0,14,-14
"31395","5410國眾","110/07/12","富邦-台中",20,0,20
"31396","5410國眾","110/07/12","元大-大同",0,12,-12
"31397","5410國眾","110/07/12","臺銀",15,0,15
"31398","5410國眾","110/07/12","元大-莒光",0,10,-10
"31399","5410國眾","110/07/12","新光-桃園",20,6,14
"31400","5410國眾","110/07/12","元大-博愛",0,10,-10
"31401","5410國眾","110/07/12","元大-員林",12,0,12
"31402","5410國眾","110/07/12","日盛-永康",0,8,-8
"31403","5410國眾","110/07/12","日盛-員林",10,0,10
"31404","5410國眾","110/07/12","元大-四維",5,13,-8
"31405","5410國眾","110/07/12","元大-新盛",10,0,10
"31406","5410國眾","110/07/12","新加坡商瑞銀",0,7,-7
"31407","5410國眾","110/07/12","永豐金-台南",10,0,10
"31408","5410國眾","110/07/12","致和-金華",0,7,-7
"31409","5410國眾","110/07/12","元富-新莊",8,0,8
"31410","5410國眾","110/07/12","新光-新竹",0,7,-7
"31411","2841台開","110/07/12","永豐金-敦南",139,26,113
"31412","2841台開","110/07/12","華南永昌-朴子",0,528,-528
"31413","2841台開","110/07/12","日盛-雙和",68,0,68
"31414","2841台開","110/07/12","元大-苑裡",2,50,-48
"31415","2841台開","110/07/12","台新證券",62,4,58
"31416","2841台開","110/07/12","群益金鼎-東湖",0,40,-40
"31417","2841台開","110/07/12","凱基-文心",50,0,50
"31418","2841台開","110/07/12","第一金-員林",0,30,-30
"31419","2841台開","110/07/12","第一金-台中",45,0,45
"31420","2841台開","110/07/12","德信-中正",0,20,-20
"31421","2841台開","110/07/12","富邦-嘉義",40,0,40
"31422","2841台開","110/07/12","兆豐-嘉義",0,20,-20
"31423","2841台開","110/07/12","日盛-木柵",30,0,30
"31424","2841台開","110/07/12","彰銀-七賢",0,15,-15
"31425","2841台開","110/07/12","中國信託-文心",31,3,28
"31426","2841台開","110/07/12","元大-承德",0,14,-14
"31427","2841台開","110/07/12","元大-福營",30,7,23
"31428","2841台開","110/07/12","元富",0,12,-12
"31429","2841台開","110/07/12","台中銀",20,0,20
"31430","2841台開","110/07/12","富邦-陽明",0,11,-11
"31431","2841台開","110/07/12","國泰-板橋",20,0,20
"31432","2841台開","110/07/12","元大證券",0,11,-11
"31433","2841台開","110/07/12","元大-前金",20,0,20
"31434","2841台開","110/07/12","元大-大甲",0,10,-10
"31435","2841台開","110/07/12","中國信託-高雄",16,1,15
"31436","2841台開","110/07/12","日盛-新竹",0,8,-8
"31437","2841台開","110/07/12","陽信-石牌",15,0,15
"31438","2841台開","110/07/12","元富-城東",0,8,-8
"31439","2841台開","110/07/12","永豐金-南投",15,0,15
"31440","2841台開","110/07/12","玉山-台南",2,10,-8
"31441","6207雷科","110/07/12","元大-高雄",34,0,34
"31442","6207雷科","110/07/12","永豐金-三重",1,32,-31
"31443","6207雷科","110/07/12","華南永昌-林口",16,1,15
"31444","6207雷科","110/07/12","永全-八德",0,30,-30
"31445","6207雷科","110/07/12","摩根大通",19,6,13
"31446","6207雷科","110/07/12","國泰-台中",0,14,-14
"31447","6207雷科","110/07/12","元富-埔里",10,0,10
"31448","6207雷科","110/07/12","第一金-澎湖",0,10,-10
"31449","6207雷科","110/07/12","凱基-台南",10,0,10
"31450","6207雷科","110/07/12","元富-林園",0,10,-10
"31451","6207雷科","110/07/12","新加坡商瑞銀",9,0,9
"31452","6207雷科","110/07/12","元大-東門",0,10,-10
"31453","6207雷科","110/07/12","瑞士信貸",8,0,8
"31454","6207雷科","110/07/12","兆豐-嘉義",0,4,-4
"31455","6207雷科","110/07/12","中國信託-高雄",9,1,8
"31456","6207雷科","110/07/12","新光",0,4,-4
"31457","6207雷科","110/07/12","凱基-高雄",6,0,6
"31458","6207雷科","110/07/12","新光-台中",0,4,-4
"31459","6207雷科","110/07/12","元大-六合",6,0,6
"31460","6207雷科","110/07/12","群益金鼎-開元",0,4,-4
"31461","6207雷科","110/07/12","永豐金-信義",6,0,6
"31462","6207雷科","110/07/12","凱基-桃園",0,4,-4
"31463","6207雷科","110/07/12","群益金鼎-土城",5,0,5
"31464","6207雷科","110/07/12","凱基-民權",0,4,-4
"31465","6207雷科","110/07/12","群益金鼎-竹南",5,0,5
"31466","6207雷科","110/07/12","玉山-新莊",0,3,-3
"31467","6207雷科","110/07/12","元大-大灣",5,1,4
"31468","6207雷科","110/07/12","國泰-松江",0,3,-3
"31469","6207雷科","110/07/12","永興",3,0,3
"31470","6207雷科","110/07/12","富邦-羅東",0,3,-3
"31471","3679新至陞","110/07/12","富邦-新竹華信",40,2,38
"31472","3679新至陞","110/07/12","瑞士信貸",0,45,-45
"31473","3679新至陞","110/07/12","台中銀-員林",28,2,26
"31474","3679新至陞","110/07/12","永豐金-天母",0,39,-39
"31475","3679新至陞","110/07/12","聯邦-大業",24,0,24
"31476","3679新至陞","110/07/12","摩根大通",7,35,-28
"31477","3679新至陞","110/07/12","永豐金證券",20,0,20
"31478","3679新至陞","110/07/12","凱基-台北",8,36,-28
"31479","3679新至陞","110/07/12","港商法國興業",14,0,14
"31480","3679新至陞","110/07/12","華南永昌-小港",1,23,-22
"31481","3679新至陞","110/07/12","日盛-樹林",13,1,12
"31482","3679新至陞","110/07/12","台新-台中",0,15,-15
"31483","3679新至陞","110/07/12","國泰-桃園",9,0,9
"31484","3679新至陞","110/07/12","統一-台中",0,12,-12
"31485","3679新至陞","110/07/12","宏遠-館前",8,0,8
"31486","3679新至陞","110/07/12","元大-成功",1,12,-11
"31487","3679新至陞","110/07/12","凱基",10,2,8
"31488","3679新至陞","110/07/12","康和-澎湖",0,8,-8
"31489","3679新至陞","110/07/12","(牛牛牛)亞-網路",7,0,7
"31490","3679新至陞","110/07/12","新加坡商瑞銀",0,7,-7
"31491","3679新至陞","110/07/12","兆豐-員林",7,0,7
"31492","3679新至陞","110/07/12","兆豐-來福",0,7,-7
"31493","3679新至陞","110/07/12","大慶-蘆洲",5,0,5
"31494","3679新至陞","110/07/12","元大-佳里",0,6,-6
"31495","3679新至陞","110/07/12","土銀-花蓮",4,0,4
"31496","3679新至陞","110/07/12","美商高盛",0,5,-5
"31497","3679新至陞","110/07/12","台新-高雄",5,1,4
"31498","3679新至陞","110/07/12","國票-新莊",0,5,-5
"31499","3679新至陞","110/07/12","元大-天母",4,0,4
"31500","3679新至陞","110/07/12","台新-屏東",0,5,-5
"31501","2727王品","110/07/12","凱基-台北",354,198,156
"31502","2727王品","110/07/12","台灣摩根士丹利",5,386,-381
"31503","2727王品","110/07/12","統一-城中",159,22,137
"31504","2727王品","110/07/12","元大-嘉義",4,60,-56
"31505","2727王品","110/07/12","日盛-忠孝",60,0,60
"31506","2727王品","110/07/12","元大-大同",2,44,-42
"31507","2727王品","110/07/12","永豐金-忠孝",45,5,40
"31508","2727王品","110/07/12","國泰-台中",32,73,-41
"31509","2727王品","110/07/12","合庫-新竹",31,0,31
"31510","2727王品","110/07/12","元大證券",127,163,-36
"31511","2727王品","110/07/12","富邦-台中",31,3,28
"31512","2727王品","110/07/12","凱基",1,33,-32
"31513","2727王品","110/07/12","元大-桃園",35,10,25
"31514","2727王品","110/07/12","永全-南崁",1,31,-30
"31515","2727王品","110/07/12","新加坡商瑞銀",28,4,24
"31516","2727王品","110/07/12","凱基-和平",2,32,-30
"31517","2727王品","110/07/12","群益金鼎-古亭",25,2,23
"31518","2727王品","110/07/12","永豐金-大園",8,38,-30
"31519","2727王品","110/07/12","元大-龍潭",29,7,22
"31520","2727王品","110/07/12","瑞士信貸",0,28,-28
"31521","2727王品","110/07/12","永豐金-永康",25,3,22
"31522","2727王品","110/07/12","元富",17,44,-27
"31523","2727王品","110/07/12","富邦-竹北",24,3,21
"31524","2727王品","110/07/12","元大-北屯",5,32,-27
"31525","2727王品","110/07/12","群益金鼎-松山",20,0,20
"31526","2727王品","110/07/12","華南永昌",3,28,-25
"31527","2727王品","110/07/12","元大-八德",20,0,20
"31528","2727王品","110/07/12","統一-竹南",1,23,-22
"31529","2727王品","110/07/12","元大-南京",25,6,19
"31530","2727王品","110/07/12","永豐金證券",4,26,-22
"31531","1570力肯","110/07/12","國票-北高雄",40,0,40
"31532","1570力肯","110/07/12","日盛-竹北",0,40,-40
"31533","1570力肯","110/07/12","摩根大通",16,0,16
"31534","1570力肯","110/07/12","第一金-華江",1,38,-37
"31535","1570力肯","110/07/12","新光",31,19,12
"31536","1570力肯","110/07/12","元大-永春",0,26,-26
"31537","1570力肯","110/07/12","元大-台中中港",12,0,12
"31538","1570力肯","110/07/12","元大-古亭",1,20,-19
"31539","1570力肯","110/07/12","日盛-高雄",10,0,10
"31540","1570力肯","110/07/12","國泰-松江",0,16,-16
"31541","1570力肯","110/07/12","第一金-路竹",10,0,10
"31542","1570力肯","110/07/12","台新-台南",0,15,-15
"31543","1570力肯","110/07/12","台新-新莊",10,0,10
"31544","1570力肯","110/07/12","康和-石牌",0,15,-15
"31545","1570力肯","110/07/12","元大-新盛",9,0,9
"31546","1570力肯","110/07/12","國泰-板橋",0,11,-11
"31547","1570力肯","110/07/12","凱基-台北",8,0,8
"31548","1570力肯","110/07/12","元大-高雄",0,11,-11
"31549","1570力肯","110/07/12","彰銀-七賢",6,0,6
"31550","1570力肯","110/07/12","兆豐-桃園",0,10,-10
"31551","1570力肯","110/07/12","元富-緯城",6,0,6
"31552","1570力肯","110/07/12","元大-大益",0,10,-10
"31553","1570力肯","110/07/12","華南永昌-古亭",6,0,6
"31554","1570力肯","110/07/12","中國信託-文心",0,5,-5
"31555","1570力肯","110/07/12","富邦-陽明",6,0,6
"31556","1570力肯","110/07/12","光和",0,5,-5
"31557","1570力肯","110/07/12","臺銀-臺南",5,0,5
"31558","1570力肯","110/07/12","陽信-石牌",0,5,-5
"31559","1570力肯","110/07/12","宏遠-館前",5,0,5
"31560","1570力肯","110/07/12","國泰-高雄",0,5,-5
"31561","6180橘子","110/07/12","康和-台中",32,2,30
"31562","6180橘子","110/07/12","新百王",1,40,-39
"31563","6180橘子","110/07/12","美林",32,3,29
"31564","6180橘子","110/07/12","富邦-陽明",4,42,-38
"31565","6180橘子","110/07/12","元大-羅東",21,0,21
"31566","6180橘子","110/07/12","新光",3,32,-29
"31567","6180橘子","110/07/12","兆豐-埔墘",16,0,16
"31568","6180橘子","110/07/12","日盛-文化",4,20,-16
"31569","6180橘子","110/07/12","元大-雙和",12,0,12
"31570","6180橘子","110/07/12","華南永昌-鶯歌",0,15,-15
"31571","6180橘子","110/07/12","美商高盛",18,7,11
"31572","6180橘子","110/07/12","中國信託-忠孝",7,20,-13
"31573","6180橘子","110/07/12","台新證券",14,3,11
"31574","6180橘子","110/07/12","凱基-台北",5,17,-12
"31575","6180橘子","110/07/12","元大-中壢",12,1,11
"31576","6180橘子","110/07/12","凱基-高雄",0,11,-11
"31577","6180橘子","110/07/12","統一-南京",10,0,10
"31578","6180橘子","110/07/12","凱基-大安",0,10,-10
"31579","6180橘子","110/07/12","致和-崇德",10,0,10
"31580","6180橘子","110/07/12","元大-北屯",0,10,-10
"31581","6180橘子","110/07/12","玉山-板橋",10,0,10
"31582","6180橘子","110/07/12","元大-南京",0,9,-9
"31583","6180橘子","110/07/12","富邦-仁愛",10,0,10
"31584","6180橘子","110/07/12","元大-台南",1,10,-9
"31585","6180橘子","110/07/12","摩根大通",10,1,9
"31586","6180橘子","110/07/12","康和-澎湖",0,8,-8
"31587","6180橘子","110/07/12","元富-林園",8,0,8
"31588","6180橘子","110/07/12","第一金-台中",0,7,-7
"31589","6180橘子","110/07/12","大慶-富順",7,0,7
"31590","6180橘子","110/07/12","台新-台南",1,8,-7
"31591","2390云辰","110/07/12","統一-新台中",170,0,170
"31592","2390云辰","110/07/12","元大-天母",2,450,-448
"31593","2390云辰","110/07/12","華南永昌-麻豆",137,2,135
"31594","2390云辰","110/07/12","國泰-忠孝",1,143,-142
"31595","2390云辰","110/07/12","元富-成功",103,14,89
"31596","2390云辰","110/07/12","摩根大通",377,512,-135
"31597","2390云辰","110/07/12","元大-土城學府",146,69,77
"31598","2390云辰","110/07/12","台灣摩根士丹利",0,91,-91
"31599","2390云辰","110/07/12","永豐金-永康",76,4,72
"31600","2390云辰","110/07/12","美林",84,146,-62
"31601","2390云辰","110/07/12","台中銀",73,2,71
"31602","2390云辰","110/07/12","華南永昌-嘉義",2,61,-59
"31603","2390云辰","110/07/12","大昌",63,3,60
"31604","2390云辰","110/07/12","永豐金-羅東",0,49,-49
"31605","2390云辰","110/07/12","合庫-三重",50,0,50
"31606","2390云辰","110/07/12","玉山-台中",6,53,-47
"31607","2390云辰","110/07/12","元富-高雄",93,50,43
"31608","2390云辰","110/07/12","玉山-新莊",2,48,-46
"31609","2390云辰","110/07/12","元大-館前",40,4,36
"31610","2390云辰","110/07/12","元大-大里",7,52,-45
"31611","2390云辰","110/07/12","港商野村",143,109,34
"31612","2390云辰","110/07/12","元大-內湖",3,48,-45
"31613","2390云辰","110/07/12","元大-雙和",34,0,34
"31614","2390云辰","110/07/12","永豐金-市政",1,42,-41
"31615","2390云辰","110/07/12","群益金鼎-民權",33,2,31
"31616","2390云辰","110/07/12","元大-學甲",1,41,-40
"31617","2390云辰","110/07/12","日盛-八德",40,10,30
"31618","2390云辰","110/07/12","兆豐-高雄",2,41,-39
"31619","2390云辰","110/07/12","國票-嘉義",30,0,30
"31620","2390云辰","110/07/12","新加坡商瑞銀",21,59,-38
"31621","4903聯光通","110/07/09","元大-敦南",10,0,10
"31622","4903聯光通","110/07/09","第一金-台中",0,12,-12
"31623","4903聯光通","110/07/09","凱基-士林",5,0,5
"31624","4903聯光通","110/07/09","日盛-忠孝",0,3,-3
"31625","4903聯光通","110/07/09","元大-苗栗",5,0,5
"31626","4903聯光通","110/07/09","群益金鼎-崇德",0,3,-3
"31627","4903聯光通","110/07/09","元大-屏南",3,0,3
"31628","4903聯光通","110/07/09","國票-內壢",0,2,-2
"31629","4903聯光通","110/07/09","中國信託-永康",1,0,1
"31630","4903聯光通","110/07/09","康和-南崁",0,2,-2
"31631","4903聯光通","110/07/09","玉山證券",1,0,1
"31632","4903聯光通","110/07/09","新光-台中",0,2,-2
"31633","4903聯光通","110/07/09","元大-太平",4,3,1
"31634","4903聯光通","110/07/09","玉山-城中",0,2,-2
"31635","4903聯光通","110/07/09","永豐金-嘉義",1,0,1
"31636","4903聯光通","110/07/09","中國信託-文心",0,1,-1
"31637","4903聯光通","110/07/09","大昌",0,0,0
"31638","4903聯光通","110/07/09","大昌",0,0,0
"31639","4903聯光通","110/07/09","中農",0,0,0
"31640","4903聯光通","110/07/09","中農",0,0,0
"31641","4903聯光通","110/07/09","",NA,NA,NA
"31642","4903聯光通","110/07/09","",NA,NA,NA
"31643","4903聯光通","110/07/09","",NA,NA,NA
"31644","4903聯光通","110/07/09","",NA,NA,NA
"31645","4903聯光通","110/07/09","",NA,NA,NA
"31646","4903聯光通","110/07/09","",NA,NA,NA
"31647","4903聯光通","110/07/09","",NA,NA,NA
"31648","4903聯光通","110/07/09","",NA,NA,NA
"31649","4903聯光通","110/07/09","",NA,NA,NA
"31650","4903聯光通","110/07/09","",NA,NA,NA
"31651","2929淘帝","110/07/09","台中銀-台北",110,0,110
"31652","2929淘帝","110/07/09","新光",2,82,-80
"31653","2929淘帝","110/07/09","華南永昌-頭份",72,0,72
"31654","2929淘帝","110/07/09","摩根大通",2,63,-61
"31655","2929淘帝","110/07/09","合庫-高雄",71,0,71
"31656","2929淘帝","110/07/09","第一金-路竹",0,50,-50
"31657","2929淘帝","110/07/09","高橋-龍潭",37,0,37
"31658","2929淘帝","110/07/09","港商麥格理",0,42,-42
"31659","2929淘帝","110/07/09","新光-台中",60,26,34
"31660","2929淘帝","110/07/09","陽信-石牌",0,40,-40
"31661","2929淘帝","110/07/09","元富-大裕",22,1,21
"31662","2929淘帝","110/07/09","台新-左楠",1,39,-38
"31663","2929淘帝","110/07/09","合庫-鳳山",20,0,20
"31664","2929淘帝","110/07/09","凱基-桃園",3,29,-26
"31665","2929淘帝","110/07/09","元大-員林",22,2,20
"31666","2929淘帝","110/07/09","兆豐-內湖",0,25,-25
"31667","2929淘帝","110/07/09","台新-建北",15,0,15
"31668","2929淘帝","110/07/09","元大-北港",0,20,-20
"31669","2929淘帝","110/07/09","兆豐-桃園",13,0,13
"31670","2929淘帝","110/07/09","富邦-北港",0,19,-19
"31671","2929淘帝","110/07/09","兆豐-忠孝",10,0,10
"31672","2929淘帝","110/07/09","富邦-花蓮",0,17,-17
"31673","2929淘帝","110/07/09","國票-敦北法人",10,0,10
"31674","2929淘帝","110/07/09","國泰-台中",2,17,-15
"31675","2929淘帝","110/07/09","永豐金-博愛",10,0,10
"31676","2929淘帝","110/07/09","群益金鼎-彰化",0,15,-15
"31677","2929淘帝","110/07/09","群益金鼎-潭子",8,0,8
"31678","2929淘帝","110/07/09","元大-博愛",0,14,-14
"31679","2929淘帝","110/07/09","富邦-南屯",8,0,8
"31680","2929淘帝","110/07/09","日盛-板橋",0,13,-13
"31681","5410國眾","110/07/09","元大-新盛",14,0,14
"31682","5410國眾","110/07/09","(牛牛牛)亞-鑫豐",1,41,-40
"31683","5410國眾","110/07/09","台灣企銀-民雄",10,0,10
"31684","5410國眾","110/07/09","元富-嘉義",0,25,-25
"31685","5410國眾","110/07/09","元富-虎尾",9,0,9
"31686","5410國眾","110/07/09","凱基-高美館",0,10,-10
"31687","5410國眾","110/07/09","摩根大通",10,1,9
"31688","5410國眾","110/07/09","凱基-城中",0,10,-10
"31689","5410國眾","110/07/09","兆豐-北高雄",7,0,7
"31690","5410國眾","110/07/09","元大-頭份",0,10,-10
"31691","5410國眾","110/07/09","凱基-台北",8,1,7
"31692","5410國眾","110/07/09","群益金鼎-丹鳳",0,7,-7
"31693","5410國眾","110/07/09","華南永昌-公誠",7,0,7
"31694","5410國眾","110/07/09","凱基-復興",0,7,-7
"31695","5410國眾","110/07/09","香港上海匯豐",6,0,6
"31696","5410國眾","110/07/09","元大-員林",0,7,-7
"31697","5410國眾","110/07/09","凱基-中壢",6,0,6
"31698","5410國眾","110/07/09","富邦-竹東",0,6,-6
"31699","5410國眾","110/07/09","華南永昌-南京",6,0,6
"31700","5410國眾","110/07/09","亞東-高雄",0,5,-5
"31701","5410國眾","110/07/09","統一-三重",5,0,5
"31702","5410國眾","110/07/09","大慶-中壢",1,6,-5
"31703","5410國眾","110/07/09","富邦-宜蘭",5,0,5
"31704","5410國眾","110/07/09","群益金鼎-中港",0,5,-5
"31705","5410國眾","110/07/09","元大-崇德",5,0,5
"31706","5410國眾","110/07/09","元大-八德",0,5,-5
"31707","5410國眾","110/07/09","元大-博愛",5,0,5
"31708","5410國眾","110/07/09","富邦-基隆",0,4,-4
"31709","5410國眾","110/07/09","元大-龍潭",5,0,5
"31710","5410國眾","110/07/09","臺銀-新竹",0,3,-3
"31711","2841台開","110/07/09","日盛-雙和",102,0,102
"31712","2841台開","110/07/09","港商野村",0,129,-129
"31713","2841台開","110/07/09","元大-館前",70,0,70
"31714","2841台開","110/07/09","兆豐-永和",0,100,-100
"31715","2841台開","110/07/09","凱基-文心",50,0,50
"31716","2841台開","110/07/09","台新證券",7,28,-21
"31717","2841台開","110/07/09","富邦-嘉義",40,0,40
"31718","2841台開","110/07/09","國票-北高雄",0,20,-20
"31719","2841台開","110/07/09","美商高盛",15,0,15
"31720","2841台開","110/07/09","永豐金-敦南",29,46,-17
"31721","2841台開","110/07/09","台中銀",15,0,15
"31722","2841台開","110/07/09","合庫-基隆",0,12,-12
"31723","2841台開","110/07/09","新光",11,0,11
"31724","2841台開","110/07/09","中國信託-松江",0,12,-12
"31725","2841台開","110/07/09","華南永昌-長虹",10,0,10
"31726","2841台開","110/07/09","兆豐-城中",0,12,-12
"31727","2841台開","110/07/09","永豐金-南投",10,0,10
"31728","2841台開","110/07/09","台中銀-豐原",0,10,-10
"31729","2841台開","110/07/09","合庫-桃園",7,0,7
"31730","2841台開","110/07/09","兆豐-景美",0,10,-10
"31731","2841台開","110/07/09","群益金鼎-古亭",7,0,7
"31732","2841台開","110/07/09","群益金鼎-基隆",0,10,-10
"31733","2841台開","110/07/09","國泰-敦南",6,0,6
"31734","2841台開","110/07/09","元大-北三重",0,10,-10
"31735","2841台開","110/07/09","凱基-桃園",8,2,6
"31736","2841台開","110/07/09","(牛牛牛)亞-網路",0,9,-9
"31737","2841台開","110/07/09","日盛證券",5,0,5
"31738","2841台開","110/07/09","台新-高雄",1,10,-9
"31739","2841台開","110/07/09","元富-文心",5,0,5
"31740","2841台開","110/07/09","凱基-台北",0,7,-7
"31741","6207雷科","110/07/09","群益金鼎-新竹",47,0,47
"31742","6207雷科","110/07/09","新光",7,24,-17
"31743","6207雷科","110/07/09","永豐金-三重",31,0,31
"31744","6207雷科","110/07/09","日盛-和美",0,15,-15
"31745","6207雷科","110/07/09","新加坡商瑞銀",33,5,28
"31746","6207雷科","110/07/09","國泰-台南",0,15,-15
"31747","6207雷科","110/07/09","元大-高雄",26,0,26
"31748","6207雷科","110/07/09","華南永昌-古亭",0,14,-14
"31749","6207雷科","110/07/09","統一-員林",22,0,22
"31750","6207雷科","110/07/09","土銀-白河",0,11,-11
"31751","6207雷科","110/07/09","台新-高雄",22,0,22
"31752","6207雷科","110/07/09","日盛-台南",0,10,-10
"31753","6207雷科","110/07/09","摩根大通",34,17,17
"31754","6207雷科","110/07/09","元富-林園",0,10,-10
"31755","6207雷科","110/07/09","元大-博愛",17,1,16
"31756","6207雷科","110/07/09","富邦-園區",0,10,-10
"31757","6207雷科","110/07/09","日茂-埔里",12,0,12
"31758","6207雷科","110/07/09","元大-上新莊",0,10,-10
"31759","6207雷科","110/07/09","國泰-台中",17,6,11
"31760","6207雷科","110/07/09","永豐金-南京",0,10,-10
"31761","6207雷科","110/07/09","富邦-三重",10,0,10
"31762","6207雷科","110/07/09","兆豐-小港",0,6,-6
"31763","6207雷科","110/07/09","元大-沙鹿",10,0,10
"31764","6207雷科","110/07/09","富邦-羅東",1,7,-6
"31765","6207雷科","110/07/09","元大-八德",10,0,10
"31766","6207雷科","110/07/09","元大-土城永寧",0,6,-6
"31767","6207雷科","110/07/09","第一金-路竹",11,2,9
"31768","6207雷科","110/07/09","永豐金-板盛",0,6,-6
"31769","6207雷科","110/07/09","統一-南京",5,0,5
"31770","6207雷科","110/07/09","日盛-板橋",0,5,-5
"31771","3679新至陞","110/07/09","元大-大天母",10,0,10
"31772","3679新至陞","110/07/09","第一金-光復",0,11,-11
"31773","3679新至陞","110/07/09","日盛-樹林",9,0,9
"31774","3679新至陞","110/07/09","瑞士信貸",0,8,-8
"31775","3679新至陞","110/07/09","凱基-台北",11,2,9
"31776","3679新至陞","110/07/09","大慶-苗栗",0,5,-5
"31777","3679新至陞","110/07/09","華南永昌-小港",8,0,8
"31778","3679新至陞","110/07/09","元大-永春",0,5,-5
"31779","3679新至陞","110/07/09","兆豐-來福",7,0,7
"31780","3679新至陞","110/07/09","日盛-和美",0,4,-4
"31781","3679新至陞","110/07/09","香港上海匯豐",5,0,5
"31782","3679新至陞","110/07/09","元大-雙和",0,3,-3
"31783","3679新至陞","110/07/09","台中銀-員林",3,0,3
"31784","3679新至陞","110/07/09","永豐金-屏東",0,3,-3
"31785","3679新至陞","110/07/09","新光",3,0,3
"31786","3679新至陞","110/07/09","彰銀",0,2,-2
"31787","3679新至陞","110/07/09","土銀-花蓮",2,0,2
"31788","3679新至陞","110/07/09","宏遠-館前",0,2,-2
"31789","3679新至陞","110/07/09","第一金-澎湖",2,0,2
"31790","3679新至陞","110/07/09","港商野村",0,2,-2
"31791","3679新至陞","110/07/09","摩根大通",2,0,2
"31792","3679新至陞","110/07/09","大昌-新店",0,2,-2
"31793","3679新至陞","110/07/09","國泰-敦南",2,0,2
"31794","3679新至陞","110/07/09","元大-新莊",0,2,-2
"31795","3679新至陞","110/07/09","元大-淡水",4,2,2
"31796","3679新至陞","110/07/09","元大-板橋",0,2,-2
"31797","3679新至陞","110/07/09","日盛-士林",1,0,1
"31798","3679新至陞","110/07/09","台灣摩根士丹利",0,1,-1
"31799","3679新至陞","110/07/09","日盛-信義",1,0,1
"31800","3679新至陞","110/07/09","第一金-高雄",0,1,-1
"31801","2727王品","110/07/09","台灣匯立證券",90,0,90
"31802","2727王品","110/07/09","台灣摩根士丹利",0,267,-267
"31803","2727王品","110/07/09","國泰-敦南",166,84,82
"31804","2727王品","110/07/09","富邦-台北",35,299,-264
"31805","2727王品","110/07/09","富邦-仁愛",56,12,44
"31806","2727王品","110/07/09","凱基-台北",174,296,-122
"31807","2727王品","110/07/09","台新證券",109,66,43
"31808","2727王品","110/07/09","第一金",2,102,-100
"31809","2727王品","110/07/09","新光",117,87,30
"31810","2727王品","110/07/09","群益金鼎-大安",0,80,-80
"31811","2727王品","110/07/09","臺銀-臺中",35,6,29
"31812","2727王品","110/07/09","兆豐-大安",7,60,-53
"31813","2727王品","110/07/09","元大-桃園",32,3,29
"31814","2727王品","110/07/09","永豐金-南投",0,50,-50
"31815","2727王品","110/07/09","元富-宜蘭",34,6,28
"31816","2727王品","110/07/09","新加坡商瑞銀",6,46,-40
"31817","2727王品","110/07/09","玉山-台中",34,8,26
"31818","2727王品","110/07/09","合庫-彰化",11,50,-39
"31819","2727王品","110/07/09","群益金鼎-宜蘭",30,4,26
"31820","2727王品","110/07/09","永豐金-萬盛",13,52,-39
"31821","2727王品","110/07/09","富邦-台中",42,16,26
"31822","2727王品","110/07/09","瑞士信貸",0,34,-34
"31823","2727王品","110/07/09","第一金-豐原",25,1,24
"31824","2727王品","110/07/09","元大-和平",4,35,-31
"31825","2727王品","110/07/09","臺銀",30,8,22
"31826","2727王品","110/07/09","美林",14,44,-30
"31827","2727王品","110/07/09","兆豐-來福",23,1,22
"31828","2727王品","110/07/09","元大-員林",9,38,-29
"31829","2727王品","110/07/09","玉山-士林",22,2,20
"31830","2727王品","110/07/09","元富-西松",4,31,-27
"31831","1570力肯","110/07/09","凱基-台北",30,1,29
"31832","1570力肯","110/07/09","群益金鼎-彰化",0,20,-20
"31833","1570力肯","110/07/09","新光-台南",20,0,20
"31834","1570力肯","110/07/09","元大-土城學府",0,20,-20
"31835","1570力肯","110/07/09","元大-高雄",20,0,20
"31836","1570力肯","110/07/09","元大-大統",0,16,-16
"31837","1570力肯","110/07/09","國票-中正",12,0,12
"31838","1570力肯","110/07/09","元大-新營",0,11,-11
"31839","1570力肯","110/07/09","日盛-高雄",6,0,6
"31840","1570力肯","110/07/09","元大-和平",0,10,-10
"31841","1570力肯","110/07/09","元富-緯城",6,0,6
"31842","1570力肯","110/07/09","元大-草屯",0,10,-10
"31843","1570力肯","110/07/09","群益金鼎-台南",6,0,6
"31844","1570力肯","110/07/09","元大-鹿港",0,9,-9
"31845","1570力肯","110/07/09","華南永昌-岡山",6,0,6
"31846","1570力肯","110/07/09","合庫-基隆",0,7,-7
"31847","1570力肯","110/07/09","統一-中壢",5,0,5
"31848","1570力肯","110/07/09","摩根大通",2,8,-6
"31849","1570力肯","110/07/09","凱基-三峽",5,0,5
"31850","1570力肯","110/07/09","台灣企銀-豐原",0,4,-4
"31851","1570力肯","110/07/09","大昌-樹林",4,0,4
"31852","1570力肯","110/07/09","日盛-桃園",0,4,-4
"31853","1570力肯","110/07/09","新光",3,0,3
"31854","1570力肯","110/07/09","國泰-高雄",0,3,-3
"31855","1570力肯","110/07/09","富邦-新竹華信",3,0,3
"31856","1570力肯","110/07/09","永豐金-敦南",0,3,-3
"31857","1570力肯","110/07/09","合庫-台中",2,0,2
"31858","1570力肯","110/07/09","土銀-彰化",0,2,-2
"31859","1570力肯","110/07/09","臺銀-臺中",2,0,2
"31860","1570力肯","110/07/09","臺銀-鳳山",0,2,-2
"31861","6180橘子","110/07/09","摩根大通",63,1,62
"31862","6180橘子","110/07/09","元大-南京",1,32,-31
"31863","6180橘子","110/07/09","富邦-陽明",73,33,40
"31864","6180橘子","110/07/09","群益金鼎-台北",0,25,-25
"31865","6180橘子","110/07/09","新加坡商瑞銀",31,0,31
"31866","6180橘子","110/07/09","兆豐-復興",0,21,-21
"31867","6180橘子","110/07/09","美商高盛",25,0,25
"31868","6180橘子","110/07/09","永豐金-嘉義",0,21,-21
"31869","6180橘子","110/07/09","凱基-台北",26,10,16
"31870","6180橘子","110/07/09","凱基-中壢",8,24,-16
"31871","6180橘子","110/07/09","華南永昌-楠梓",13,0,13
"31872","6180橘子","110/07/09","致和-崇德",0,15,-15
"31873","6180橘子","110/07/09","華南永昌-朴子",11,0,11
"31874","6180橘子","110/07/09","群益金鼎-屏東",0,15,-15
"31875","6180橘子","110/07/09","元大-北港",11,0,11
"31876","6180橘子","110/07/09","群益金鼎-中山",0,15,-15
"31877","6180橘子","110/07/09","元大-成功",10,1,9
"31878","6180橘子","110/07/09","瑞士信貸",1,15,-14
"31879","6180橘子","110/07/09","新光",26,18,8
"31880","6180橘子","110/07/09","日盛-二林",0,10,-10
"31881","6180橘子","110/07/09","統一-三重",6,0,6
"31882","6180橘子","110/07/09","凱基-東門",0,10,-10
"31883","6180橘子","110/07/09","群益金鼎-嘉義",6,0,6
"31884","6180橘子","110/07/09","華南永昌-三重",0,10,-10
"31885","6180橘子","110/07/09","元大-員林中山",6,0,6
"31886","6180橘子","110/07/09","元大-彰化民生",1,11,-10
"31887","6180橘子","110/07/09","合庫-鳳山",5,0,5
"31888","6180橘子","110/07/09","永豐金-新店",1,11,-10
"31889","6180橘子","110/07/09","富邦-建國",6,1,5
"31890","6180橘子","110/07/09","群益金鼎-丹鳳",0,8,-8
"31891","2390云辰","110/07/09","摩根大通",279,56,223
"31892","2390云辰","110/07/09","元大-天母",0,127,-127
"31893","2390云辰","110/07/09","日盛-鳳山",110,2,108
"31894","2390云辰","110/07/09","中國信託-文心",5,109,-104
"31895","2390云辰","110/07/09","宏遠證券",100,0,100
"31896","2390云辰","110/07/09","永豐金-復興",0,55,-55
"31897","2390云辰","110/07/09","元大-大里",63,6,57
"31898","2390云辰","110/07/09","凱基-台北",239,286,-47
"31899","2390云辰","110/07/09","凱基-八德",59,10,49
"31900","2390云辰","110/07/09","德信",2,32,-30
"31901","2390云辰","110/07/09","合庫-新竹",40,0,40
"31902","2390云辰","110/07/09","兆豐-桃鶯",2,32,-30
"31903","2390云辰","110/07/09","國票",40,1,39
"31904","2390云辰","110/07/09","致和-南京",0,30,-30
"31905","2390云辰","110/07/09","新加坡商瑞銀",49,13,36
"31906","2390云辰","110/07/09","富邦-虎尾",1,31,-30
"31907","2390云辰","110/07/09","統一-新台中",36,2,34
"31908","2390云辰","110/07/09","元大-善化",2,31,-29
"31909","2390云辰","110/07/09","國票-嘉義",31,0,31
"31910","2390云辰","110/07/09","富邦-板橋",0,27,-27
"31911","2390云辰","110/07/09","華南永昌",35,7,28
"31912","2390云辰","110/07/09","富邦-永和",3,28,-25
"31913","2390云辰","110/07/09","玉山-台中",49,22,27
"31914","2390云辰","110/07/09","第一金-自由",20,44,-24
"31915","2390云辰","110/07/09","華南永昌-敦南",25,0,25
"31916","2390云辰","110/07/09","凱基-內湖",0,24,-24
"31917","2390云辰","110/07/09","新光-高雄",27,4,23
"31918","2390云辰","110/07/09","元大-汐止",1,24,-23
"31919","2390云辰","110/07/09","台灣摩根士丹利",85,63,22
"31920","2390云辰","110/07/09","新光-台中",12,33,-21
"31921","4903聯光通","110/07/09","元大-敦南",10,0,10
"31922","4903聯光通","110/07/09","第一金-台中",0,12,-12
"31923","4903聯光通","110/07/09","凱基-士林",5,0,5
"31924","4903聯光通","110/07/09","日盛-忠孝",0,3,-3
"31925","4903聯光通","110/07/09","元大-苗栗",5,0,5
"31926","4903聯光通","110/07/09","群益金鼎-崇德",0,3,-3
"31927","4903聯光通","110/07/09","元大-屏南",3,0,3
"31928","4903聯光通","110/07/09","國票-內壢",0,2,-2
"31929","4903聯光通","110/07/09","中國信託-永康",1,0,1
"31930","4903聯光通","110/07/09","康和-南崁",0,2,-2
"31931","4903聯光通","110/07/09","玉山證券",1,0,1
"31932","4903聯光通","110/07/09","新光-台中",0,2,-2
"31933","4903聯光通","110/07/09","元大-太平",4,3,1
"31934","4903聯光通","110/07/09","玉山-城中",0,2,-2
"31935","4903聯光通","110/07/09","永豐金-嘉義",1,0,1
"31936","4903聯光通","110/07/09","中國信託-文心",0,1,-1
"31937","4903聯光通","110/07/09","大昌",0,0,0
"31938","4903聯光通","110/07/09","大昌",0,0,0
"31939","4903聯光通","110/07/09","中農",0,0,0
"31940","4903聯光通","110/07/09","中農",0,0,0
"31941","4903聯光通","110/07/09","",NA,NA,NA
"31942","4903聯光通","110/07/09","",NA,NA,NA
"31943","4903聯光通","110/07/09","",NA,NA,NA
"31944","4903聯光通","110/07/09","",NA,NA,NA
"31945","4903聯光通","110/07/09","",NA,NA,NA
"31946","4903聯光通","110/07/09","",NA,NA,NA
"31947","4903聯光通","110/07/09","",NA,NA,NA
"31948","4903聯光通","110/07/09","",NA,NA,NA
"31949","4903聯光通","110/07/09","",NA,NA,NA
"31950","4903聯光通","110/07/09","",NA,NA,NA
"31951","2929淘帝","110/07/09","台中銀-台北",110,0,110
"31952","2929淘帝","110/07/09","新光",2,82,-80
"31953","2929淘帝","110/07/09","華南永昌-頭份",72,0,72
"31954","2929淘帝","110/07/09","摩根大通",2,63,-61
"31955","2929淘帝","110/07/09","合庫-高雄",71,0,71
"31956","2929淘帝","110/07/09","第一金-路竹",0,50,-50
"31957","2929淘帝","110/07/09","高橋-龍潭",37,0,37
"31958","2929淘帝","110/07/09","港商麥格理",0,42,-42
"31959","2929淘帝","110/07/09","新光-台中",60,26,34
"31960","2929淘帝","110/07/09","陽信-石牌",0,40,-40
"31961","2929淘帝","110/07/09","元富-大裕",22,1,21
"31962","2929淘帝","110/07/09","台新-左楠",1,39,-38
"31963","2929淘帝","110/07/09","合庫-鳳山",20,0,20
"31964","2929淘帝","110/07/09","凱基-桃園",3,29,-26
"31965","2929淘帝","110/07/09","元大-員林",22,2,20
"31966","2929淘帝","110/07/09","兆豐-內湖",0,25,-25
"31967","2929淘帝","110/07/09","台新-建北",15,0,15
"31968","2929淘帝","110/07/09","元大-北港",0,20,-20
"31969","2929淘帝","110/07/09","兆豐-桃園",13,0,13
"31970","2929淘帝","110/07/09","富邦-北港",0,19,-19
"31971","2929淘帝","110/07/09","兆豐-忠孝",10,0,10
"31972","2929淘帝","110/07/09","富邦-花蓮",0,17,-17
"31973","2929淘帝","110/07/09","國票-敦北法人",10,0,10
"31974","2929淘帝","110/07/09","國泰-台中",2,17,-15
"31975","2929淘帝","110/07/09","永豐金-博愛",10,0,10
"31976","2929淘帝","110/07/09","群益金鼎-彰化",0,15,-15
"31977","2929淘帝","110/07/09","群益金鼎-潭子",8,0,8
"31978","2929淘帝","110/07/09","元大-博愛",0,14,-14
"31979","2929淘帝","110/07/09","富邦-南屯",8,0,8
"31980","2929淘帝","110/07/09","日盛-板橋",0,13,-13
"31981","5410國眾","110/07/09","元大-新盛",14,0,14
"31982","5410國眾","110/07/09","(牛牛牛)亞-鑫豐",1,41,-40
"31983","5410國眾","110/07/09","台灣企銀-民雄",10,0,10
"31984","5410國眾","110/07/09","元富-嘉義",0,25,-25
"31985","5410國眾","110/07/09","元富-虎尾",9,0,9
"31986","5410國眾","110/07/09","凱基-高美館",0,10,-10
"31987","5410國眾","110/07/09","摩根大通",10,1,9
"31988","5410國眾","110/07/09","凱基-城中",0,10,-10
"31989","5410國眾","110/07/09","兆豐-北高雄",7,0,7
"31990","5410國眾","110/07/09","元大-頭份",0,10,-10
"31991","5410國眾","110/07/09","凱基-台北",8,1,7
"31992","5410國眾","110/07/09","群益金鼎-丹鳳",0,7,-7
"31993","5410國眾","110/07/09","華南永昌-公誠",7,0,7
"31994","5410國眾","110/07/09","凱基-復興",0,7,-7
"31995","5410國眾","110/07/09","香港上海匯豐",6,0,6
"31996","5410國眾","110/07/09","元大-員林",0,7,-7
"31997","5410國眾","110/07/09","凱基-中壢",6,0,6
"31998","5410國眾","110/07/09","富邦-竹東",0,6,-6
"31999","5410國眾","110/07/09","華南永昌-南京",6,0,6
"32000","5410國眾","110/07/09","亞東-高雄",0,5,-5
"32001","5410國眾","110/07/09","統一-三重",5,0,5
"32002","5410國眾","110/07/09","大慶-中壢",1,6,-5
"32003","5410國眾","110/07/09","富邦-宜蘭",5,0,5
"32004","5410國眾","110/07/09","群益金鼎-中港",0,5,-5
"32005","5410國眾","110/07/09","元大-崇德",5,0,5
"32006","5410國眾","110/07/09","元大-八德",0,5,-5
"32007","5410國眾","110/07/09","元大-博愛",5,0,5
"32008","5410國眾","110/07/09","富邦-基隆",0,4,-4
"32009","5410國眾","110/07/09","元大-龍潭",5,0,5
"32010","5410國眾","110/07/09","臺銀-新竹",0,3,-3
"32011","2841台開","110/07/09","日盛-雙和",102,0,102
"32012","2841台開","110/07/09","港商野村",0,129,-129
"32013","2841台開","110/07/09","元大-館前",70,0,70
"32014","2841台開","110/07/09","兆豐-永和",0,100,-100
"32015","2841台開","110/07/09","凱基-文心",50,0,50
"32016","2841台開","110/07/09","台新證券",7,28,-21
"32017","2841台開","110/07/09","富邦-嘉義",40,0,40
"32018","2841台開","110/07/09","國票-北高雄",0,20,-20
"32019","2841台開","110/07/09","美商高盛",15,0,15
"32020","2841台開","110/07/09","永豐金-敦南",29,46,-17
"32021","2841台開","110/07/09","台中銀",15,0,15
"32022","2841台開","110/07/09","合庫-基隆",0,12,-12
"32023","2841台開","110/07/09","新光",11,0,11
"32024","2841台開","110/07/09","中國信託-松江",0,12,-12
"32025","2841台開","110/07/09","華南永昌-長虹",10,0,10
"32026","2841台開","110/07/09","兆豐-城中",0,12,-12
"32027","2841台開","110/07/09","永豐金-南投",10,0,10
"32028","2841台開","110/07/09","台中銀-豐原",0,10,-10
"32029","2841台開","110/07/09","合庫-桃園",7,0,7
"32030","2841台開","110/07/09","兆豐-景美",0,10,-10
"32031","2841台開","110/07/09","群益金鼎-古亭",7,0,7
"32032","2841台開","110/07/09","群益金鼎-基隆",0,10,-10
"32033","2841台開","110/07/09","國泰-敦南",6,0,6
"32034","2841台開","110/07/09","元大-北三重",0,10,-10
"32035","2841台開","110/07/09","凱基-桃園",8,2,6
"32036","2841台開","110/07/09","(牛牛牛)亞-網路",0,9,-9
"32037","2841台開","110/07/09","日盛證券",5,0,5
"32038","2841台開","110/07/09","台新-高雄",1,10,-9
"32039","2841台開","110/07/09","元富-文心",5,0,5
"32040","2841台開","110/07/09","凱基-台北",0,7,-7
"32041","6207雷科","110/07/09","群益金鼎-新竹",47,0,47
"32042","6207雷科","110/07/09","新光",7,24,-17
"32043","6207雷科","110/07/09","永豐金-三重",31,0,31
"32044","6207雷科","110/07/09","日盛-和美",0,15,-15
"32045","6207雷科","110/07/09","新加坡商瑞銀",33,5,28
"32046","6207雷科","110/07/09","國泰-台南",0,15,-15
"32047","6207雷科","110/07/09","元大-高雄",26,0,26
"32048","6207雷科","110/07/09","華南永昌-古亭",0,14,-14
"32049","6207雷科","110/07/09","統一-員林",22,0,22
"32050","6207雷科","110/07/09","土銀-白河",0,11,-11
"32051","6207雷科","110/07/09","台新-高雄",22,0,22
"32052","6207雷科","110/07/09","日盛-台南",0,10,-10
"32053","6207雷科","110/07/09","摩根大通",34,17,17
"32054","6207雷科","110/07/09","元富-林園",0,10,-10
"32055","6207雷科","110/07/09","元大-博愛",17,1,16
"32056","6207雷科","110/07/09","富邦-園區",0,10,-10
"32057","6207雷科","110/07/09","日茂-埔里",12,0,12
"32058","6207雷科","110/07/09","元大-上新莊",0,10,-10
"32059","6207雷科","110/07/09","國泰-台中",17,6,11
"32060","6207雷科","110/07/09","永豐金-南京",0,10,-10
"32061","6207雷科","110/07/09","富邦-三重",10,0,10
"32062","6207雷科","110/07/09","兆豐-小港",0,6,-6
"32063","6207雷科","110/07/09","元大-沙鹿",10,0,10
"32064","6207雷科","110/07/09","富邦-羅東",1,7,-6
"32065","6207雷科","110/07/09","元大-八德",10,0,10
"32066","6207雷科","110/07/09","元大-土城永寧",0,6,-6
"32067","6207雷科","110/07/09","第一金-路竹",11,2,9
"32068","6207雷科","110/07/09","永豐金-板盛",0,6,-6
"32069","6207雷科","110/07/09","統一-南京",5,0,5
"32070","6207雷科","110/07/09","日盛-板橋",0,5,-5
"32071","3679新至陞","110/07/09","元大-大天母",10,0,10
"32072","3679新至陞","110/07/09","第一金-光復",0,11,-11
"32073","3679新至陞","110/07/09","日盛-樹林",9,0,9
"32074","3679新至陞","110/07/09","瑞士信貸",0,8,-8
"32075","3679新至陞","110/07/09","凱基-台北",11,2,9
"32076","3679新至陞","110/07/09","大慶-苗栗",0,5,-5
"32077","3679新至陞","110/07/09","華南永昌-小港",8,0,8
"32078","3679新至陞","110/07/09","元大-永春",0,5,-5
"32079","3679新至陞","110/07/09","兆豐-來福",7,0,7
"32080","3679新至陞","110/07/09","日盛-和美",0,4,-4
"32081","3679新至陞","110/07/09","香港上海匯豐",5,0,5
"32082","3679新至陞","110/07/09","元大-雙和",0,3,-3
"32083","3679新至陞","110/07/09","台中銀-員林",3,0,3
"32084","3679新至陞","110/07/09","永豐金-屏東",0,3,-3
"32085","3679新至陞","110/07/09","新光",3,0,3
"32086","3679新至陞","110/07/09","彰銀",0,2,-2
"32087","3679新至陞","110/07/09","土銀-花蓮",2,0,2
"32088","3679新至陞","110/07/09","宏遠-館前",0,2,-2
"32089","3679新至陞","110/07/09","第一金-澎湖",2,0,2
"32090","3679新至陞","110/07/09","港商野村",0,2,-2
"32091","3679新至陞","110/07/09","摩根大通",2,0,2
"32092","3679新至陞","110/07/09","大昌-新店",0,2,-2
"32093","3679新至陞","110/07/09","國泰-敦南",2,0,2
"32094","3679新至陞","110/07/09","元大-新莊",0,2,-2
"32095","3679新至陞","110/07/09","元大-淡水",4,2,2
"32096","3679新至陞","110/07/09","元大-板橋",0,2,-2
"32097","3679新至陞","110/07/09","日盛-士林",1,0,1
"32098","3679新至陞","110/07/09","台灣摩根士丹利",0,1,-1
"32099","3679新至陞","110/07/09","日盛-信義",1,0,1
"32100","3679新至陞","110/07/09","第一金-高雄",0,1,-1
"32101","2727王品","110/07/09","台灣匯立證券",90,0,90
"32102","2727王品","110/07/09","台灣摩根士丹利",0,267,-267
"32103","2727王品","110/07/09","國泰-敦南",166,84,82
"32104","2727王品","110/07/09","富邦-台北",35,299,-264
"32105","2727王品","110/07/09","富邦-仁愛",56,12,44
"32106","2727王品","110/07/09","凱基-台北",174,296,-122
"32107","2727王品","110/07/09","台新證券",109,66,43
"32108","2727王品","110/07/09","第一金",2,102,-100
"32109","2727王品","110/07/09","新光",117,87,30
"32110","2727王品","110/07/09","群益金鼎-大安",0,80,-80
"32111","2727王品","110/07/09","臺銀-臺中",35,6,29
"32112","2727王品","110/07/09","兆豐-大安",7,60,-53
"32113","2727王品","110/07/09","元大-桃園",32,3,29
"32114","2727王品","110/07/09","永豐金-南投",0,50,-50
"32115","2727王品","110/07/09","元富-宜蘭",34,6,28
"32116","2727王品","110/07/09","新加坡商瑞銀",6,46,-40
"32117","2727王品","110/07/09","玉山-台中",34,8,26
"32118","2727王品","110/07/09","合庫-彰化",11,50,-39
"32119","2727王品","110/07/09","群益金鼎-宜蘭",30,4,26
"32120","2727王品","110/07/09","永豐金-萬盛",13,52,-39
"32121","2727王品","110/07/09","富邦-台中",42,16,26
"32122","2727王品","110/07/09","瑞士信貸",0,34,-34
"32123","2727王品","110/07/09","第一金-豐原",25,1,24
"32124","2727王品","110/07/09","元大-和平",4,35,-31
"32125","2727王品","110/07/09","臺銀",30,8,22
"32126","2727王品","110/07/09","美林",14,44,-30
"32127","2727王品","110/07/09","兆豐-來福",23,1,22
"32128","2727王品","110/07/09","元大-員林",9,38,-29
"32129","2727王品","110/07/09","玉山-士林",22,2,20
"32130","2727王品","110/07/09","元富-西松",4,31,-27
"32131","1570力肯","110/07/09","凱基-台北",30,1,29
"32132","1570力肯","110/07/09","群益金鼎-彰化",0,20,-20
"32133","1570力肯","110/07/09","新光-台南",20,0,20
"32134","1570力肯","110/07/09","元大-土城學府",0,20,-20
"32135","1570力肯","110/07/09","元大-高雄",20,0,20
"32136","1570力肯","110/07/09","元大-大統",0,16,-16
"32137","1570力肯","110/07/09","國票-中正",12,0,12
"32138","1570力肯","110/07/09","元大-新營",0,11,-11
"32139","1570力肯","110/07/09","日盛-高雄",6,0,6
"32140","1570力肯","110/07/09","元大-和平",0,10,-10
"32141","1570力肯","110/07/09","元富-緯城",6,0,6
"32142","1570力肯","110/07/09","元大-草屯",0,10,-10
"32143","1570力肯","110/07/09","群益金鼎-台南",6,0,6
"32144","1570力肯","110/07/09","元大-鹿港",0,9,-9
"32145","1570力肯","110/07/09","華南永昌-岡山",6,0,6
"32146","1570力肯","110/07/09","合庫-基隆",0,7,-7
"32147","1570力肯","110/07/09","統一-中壢",5,0,5
"32148","1570力肯","110/07/09","摩根大通",2,8,-6
"32149","1570力肯","110/07/09","凱基-三峽",5,0,5
"32150","1570力肯","110/07/09","台灣企銀-豐原",0,4,-4
"32151","1570力肯","110/07/09","大昌-樹林",4,0,4
"32152","1570力肯","110/07/09","日盛-桃園",0,4,-4
"32153","1570力肯","110/07/09","新光",3,0,3
"32154","1570力肯","110/07/09","國泰-高雄",0,3,-3
"32155","1570力肯","110/07/09","富邦-新竹華信",3,0,3
"32156","1570力肯","110/07/09","永豐金-敦南",0,3,-3
"32157","1570力肯","110/07/09","合庫-台中",2,0,2
"32158","1570力肯","110/07/09","土銀-彰化",0,2,-2
"32159","1570力肯","110/07/09","臺銀-臺中",2,0,2
"32160","1570力肯","110/07/09","臺銀-鳳山",0,2,-2
"32161","6180橘子","110/07/09","摩根大通",63,1,62
"32162","6180橘子","110/07/09","元大-南京",1,32,-31
"32163","6180橘子","110/07/09","富邦-陽明",73,33,40
"32164","6180橘子","110/07/09","群益金鼎-台北",0,25,-25
"32165","6180橘子","110/07/09","新加坡商瑞銀",31,0,31
"32166","6180橘子","110/07/09","兆豐-復興",0,21,-21
"32167","6180橘子","110/07/09","美商高盛",25,0,25
"32168","6180橘子","110/07/09","永豐金-嘉義",0,21,-21
"32169","6180橘子","110/07/09","凱基-台北",26,10,16
"32170","6180橘子","110/07/09","凱基-中壢",8,24,-16
"32171","6180橘子","110/07/09","華南永昌-楠梓",13,0,13
"32172","6180橘子","110/07/09","致和-崇德",0,15,-15
"32173","6180橘子","110/07/09","華南永昌-朴子",11,0,11
"32174","6180橘子","110/07/09","群益金鼎-屏東",0,15,-15
"32175","6180橘子","110/07/09","元大-北港",11,0,11
"32176","6180橘子","110/07/09","群益金鼎-中山",0,15,-15
"32177","6180橘子","110/07/09","元大-成功",10,1,9
"32178","6180橘子","110/07/09","瑞士信貸",1,15,-14
"32179","6180橘子","110/07/09","新光",26,18,8
"32180","6180橘子","110/07/09","日盛-二林",0,10,-10
"32181","6180橘子","110/07/09","統一-三重",6,0,6
"32182","6180橘子","110/07/09","凱基-東門",0,10,-10
"32183","6180橘子","110/07/09","群益金鼎-嘉義",6,0,6
"32184","6180橘子","110/07/09","華南永昌-三重",0,10,-10
"32185","6180橘子","110/07/09","元大-員林中山",6,0,6
"32186","6180橘子","110/07/09","元大-彰化民生",1,11,-10
"32187","6180橘子","110/07/09","合庫-鳳山",5,0,5
"32188","6180橘子","110/07/09","永豐金-新店",1,11,-10
"32189","6180橘子","110/07/09","富邦-建國",6,1,5
"32190","6180橘子","110/07/09","群益金鼎-丹鳳",0,8,-8
"32191","2390云辰","110/07/09","摩根大通",279,56,223
"32192","2390云辰","110/07/09","元大-天母",0,127,-127
"32193","2390云辰","110/07/09","日盛-鳳山",110,2,108
"32194","2390云辰","110/07/09","中國信託-文心",5,109,-104
"32195","2390云辰","110/07/09","宏遠證券",100,0,100
"32196","2390云辰","110/07/09","永豐金-復興",0,55,-55
"32197","2390云辰","110/07/09","元大-大里",63,6,57
"32198","2390云辰","110/07/09","凱基-台北",239,286,-47
"32199","2390云辰","110/07/09","凱基-八德",59,10,49
"32200","2390云辰","110/07/09","德信",2,32,-30
"32201","2390云辰","110/07/09","合庫-新竹",40,0,40
"32202","2390云辰","110/07/09","兆豐-桃鶯",2,32,-30
"32203","2390云辰","110/07/09","國票",40,1,39
"32204","2390云辰","110/07/09","致和-南京",0,30,-30
"32205","2390云辰","110/07/09","新加坡商瑞銀",49,13,36
"32206","2390云辰","110/07/09","富邦-虎尾",1,31,-30
"32207","2390云辰","110/07/09","統一-新台中",36,2,34
"32208","2390云辰","110/07/09","元大-善化",2,31,-29
"32209","2390云辰","110/07/09","國票-嘉義",31,0,31
"32210","2390云辰","110/07/09","富邦-板橋",0,27,-27
"32211","2390云辰","110/07/09","華南永昌",35,7,28
"32212","2390云辰","110/07/09","富邦-永和",3,28,-25
"32213","2390云辰","110/07/09","玉山-台中",49,22,27
"32214","2390云辰","110/07/09","第一金-自由",20,44,-24
"32215","2390云辰","110/07/09","華南永昌-敦南",25,0,25
"32216","2390云辰","110/07/09","凱基-內湖",0,24,-24
"32217","2390云辰","110/07/09","新光-高雄",27,4,23
"32218","2390云辰","110/07/09","元大-汐止",1,24,-23
"32219","2390云辰","110/07/09","台灣摩根士丹利",85,63,22
"32220","2390云辰","110/07/09","新光-台中",12,33,-21
"32221","4903聯光通","110/07/09","元大-敦南",10,0,10
"32222","4903聯光通","110/07/09","第一金-台中",0,12,-12
"32223","4903聯光通","110/07/09","凱基-士林",5,0,5
"32224","4903聯光通","110/07/09","日盛-忠孝",0,3,-3
"32225","4903聯光通","110/07/09","元大-苗栗",5,0,5
"32226","4903聯光通","110/07/09","群益金鼎-崇德",0,3,-3
"32227","4903聯光通","110/07/09","元大-屏南",3,0,3
"32228","4903聯光通","110/07/09","國票-內壢",0,2,-2
"32229","4903聯光通","110/07/09","中國信託-永康",1,0,1
"32230","4903聯光通","110/07/09","康和-南崁",0,2,-2
"32231","4903聯光通","110/07/09","玉山證券",1,0,1
"32232","4903聯光通","110/07/09","新光-台中",0,2,-2
"32233","4903聯光通","110/07/09","元大-太平",4,3,1
"32234","4903聯光通","110/07/09","玉山-城中",0,2,-2
"32235","4903聯光通","110/07/09","永豐金-嘉義",1,0,1
"32236","4903聯光通","110/07/09","中國信託-文心",0,1,-1
"32237","4903聯光通","110/07/09","大昌",0,0,0
"32238","4903聯光通","110/07/09","大昌",0,0,0
"32239","4903聯光通","110/07/09","中農",0,0,0
"32240","4903聯光通","110/07/09","中農",0,0,0
"32241","4903聯光通","110/07/09","",NA,NA,NA
"32242","4903聯光通","110/07/09","",NA,NA,NA
"32243","4903聯光通","110/07/09","",NA,NA,NA
"32244","4903聯光通","110/07/09","",NA,NA,NA
"32245","4903聯光通","110/07/09","",NA,NA,NA
"32246","4903聯光通","110/07/09","",NA,NA,NA
"32247","4903聯光通","110/07/09","",NA,NA,NA
"32248","4903聯光通","110/07/09","",NA,NA,NA
"32249","4903聯光通","110/07/09","",NA,NA,NA
"32250","4903聯光通","110/07/09","",NA,NA,NA
"32251","2929淘帝","110/07/09","台中銀-台北",110,0,110
"32252","2929淘帝","110/07/09","新光",2,82,-80
"32253","2929淘帝","110/07/09","華南永昌-頭份",72,0,72
"32254","2929淘帝","110/07/09","摩根大通",2,63,-61
"32255","2929淘帝","110/07/09","合庫-高雄",71,0,71
"32256","2929淘帝","110/07/09","第一金-路竹",0,50,-50
"32257","2929淘帝","110/07/09","高橋-龍潭",37,0,37
"32258","2929淘帝","110/07/09","港商麥格理",0,42,-42
"32259","2929淘帝","110/07/09","新光-台中",60,26,34
"32260","2929淘帝","110/07/09","陽信-石牌",0,40,-40
"32261","2929淘帝","110/07/09","元富-大裕",22,1,21
"32262","2929淘帝","110/07/09","台新-左楠",1,39,-38
"32263","2929淘帝","110/07/09","合庫-鳳山",20,0,20
"32264","2929淘帝","110/07/09","凱基-桃園",3,29,-26
"32265","2929淘帝","110/07/09","元大-員林",22,2,20
"32266","2929淘帝","110/07/09","兆豐-內湖",0,25,-25
"32267","2929淘帝","110/07/09","台新-建北",15,0,15
"32268","2929淘帝","110/07/09","元大-北港",0,20,-20
"32269","2929淘帝","110/07/09","兆豐-桃園",13,0,13
"32270","2929淘帝","110/07/09","富邦-北港",0,19,-19
"32271","2929淘帝","110/07/09","兆豐-忠孝",10,0,10
"32272","2929淘帝","110/07/09","富邦-花蓮",0,17,-17
"32273","2929淘帝","110/07/09","國票-敦北法人",10,0,10
"32274","2929淘帝","110/07/09","國泰-台中",2,17,-15
"32275","2929淘帝","110/07/09","永豐金-博愛",10,0,10
"32276","2929淘帝","110/07/09","群益金鼎-彰化",0,15,-15
"32277","2929淘帝","110/07/09","群益金鼎-潭子",8,0,8
"32278","2929淘帝","110/07/09","元大-博愛",0,14,-14
"32279","2929淘帝","110/07/09","富邦-南屯",8,0,8
"32280","2929淘帝","110/07/09","日盛-板橋",0,13,-13
"32281","5410國眾","110/07/09","元大-新盛",14,0,14
"32282","5410國眾","110/07/09","(牛牛牛)亞-鑫豐",1,41,-40
"32283","5410國眾","110/07/09","台灣企銀-民雄",10,0,10
"32284","5410國眾","110/07/09","元富-嘉義",0,25,-25
"32285","5410國眾","110/07/09","元富-虎尾",9,0,9
"32286","5410國眾","110/07/09","凱基-高美館",0,10,-10
"32287","5410國眾","110/07/09","摩根大通",10,1,9
"32288","5410國眾","110/07/09","凱基-城中",0,10,-10
"32289","5410國眾","110/07/09","兆豐-北高雄",7,0,7
"32290","5410國眾","110/07/09","元大-頭份",0,10,-10
"32291","5410國眾","110/07/09","凱基-台北",8,1,7
"32292","5410國眾","110/07/09","群益金鼎-丹鳳",0,7,-7
"32293","5410國眾","110/07/09","華南永昌-公誠",7,0,7
"32294","5410國眾","110/07/09","凱基-復興",0,7,-7
"32295","5410國眾","110/07/09","香港上海匯豐",6,0,6
"32296","5410國眾","110/07/09","元大-員林",0,7,-7
"32297","5410國眾","110/07/09","凱基-中壢",6,0,6
"32298","5410國眾","110/07/09","富邦-竹東",0,6,-6
"32299","5410國眾","110/07/09","華南永昌-南京",6,0,6
"32300","5410國眾","110/07/09","亞東-高雄",0,5,-5
"32301","5410國眾","110/07/09","統一-三重",5,0,5
"32302","5410國眾","110/07/09","大慶-中壢",1,6,-5
"32303","5410國眾","110/07/09","富邦-宜蘭",5,0,5
"32304","5410國眾","110/07/09","群益金鼎-中港",0,5,-5
"32305","5410國眾","110/07/09","元大-崇德",5,0,5
"32306","5410國眾","110/07/09","元大-八德",0,5,-5
"32307","5410國眾","110/07/09","元大-博愛",5,0,5
"32308","5410國眾","110/07/09","富邦-基隆",0,4,-4
"32309","5410國眾","110/07/09","元大-龍潭",5,0,5
"32310","5410國眾","110/07/09","臺銀-新竹",0,3,-3
"32311","2841台開","110/07/09","日盛-雙和",102,0,102
"32312","2841台開","110/07/09","港商野村",0,129,-129
"32313","2841台開","110/07/09","元大-館前",70,0,70
"32314","2841台開","110/07/09","兆豐-永和",0,100,-100
"32315","2841台開","110/07/09","凱基-文心",50,0,50
"32316","2841台開","110/07/09","台新證券",7,28,-21
"32317","2841台開","110/07/09","富邦-嘉義",40,0,40
"32318","2841台開","110/07/09","國票-北高雄",0,20,-20
"32319","2841台開","110/07/09","美商高盛",15,0,15
"32320","2841台開","110/07/09","永豐金-敦南",29,46,-17
"32321","2841台開","110/07/09","台中銀",15,0,15
"32322","2841台開","110/07/09","合庫-基隆",0,12,-12
"32323","2841台開","110/07/09","新光",11,0,11
"32324","2841台開","110/07/09","中國信託-松江",0,12,-12
"32325","2841台開","110/07/09","華南永昌-長虹",10,0,10
"32326","2841台開","110/07/09","兆豐-城中",0,12,-12
"32327","2841台開","110/07/09","永豐金-南投",10,0,10
"32328","2841台開","110/07/09","台中銀-豐原",0,10,-10
"32329","2841台開","110/07/09","合庫-桃園",7,0,7
"32330","2841台開","110/07/09","兆豐-景美",0,10,-10
"32331","2841台開","110/07/09","群益金鼎-古亭",7,0,7
"32332","2841台開","110/07/09","群益金鼎-基隆",0,10,-10
"32333","2841台開","110/07/09","國泰-敦南",6,0,6
"32334","2841台開","110/07/09","元大-北三重",0,10,-10
"32335","2841台開","110/07/09","凱基-桃園",8,2,6
"32336","2841台開","110/07/09","(牛牛牛)亞-網路",0,9,-9
"32337","2841台開","110/07/09","日盛證券",5,0,5
"32338","2841台開","110/07/09","台新-高雄",1,10,-9
"32339","2841台開","110/07/09","元富-文心",5,0,5
"32340","2841台開","110/07/09","凱基-台北",0,7,-7
"32341","6207雷科","110/07/09","群益金鼎-新竹",47,0,47
"32342","6207雷科","110/07/09","新光",7,24,-17
"32343","6207雷科","110/07/09","永豐金-三重",31,0,31
"32344","6207雷科","110/07/09","日盛-和美",0,15,-15
"32345","6207雷科","110/07/09","新加坡商瑞銀",33,5,28
"32346","6207雷科","110/07/09","國泰-台南",0,15,-15
"32347","6207雷科","110/07/09","元大-高雄",26,0,26
"32348","6207雷科","110/07/09","華南永昌-古亭",0,14,-14
"32349","6207雷科","110/07/09","統一-員林",22,0,22
"32350","6207雷科","110/07/09","土銀-白河",0,11,-11
"32351","6207雷科","110/07/09","台新-高雄",22,0,22
"32352","6207雷科","110/07/09","日盛-台南",0,10,-10
"32353","6207雷科","110/07/09","摩根大通",34,17,17
"32354","6207雷科","110/07/09","元富-林園",0,10,-10
"32355","6207雷科","110/07/09","元大-博愛",17,1,16
"32356","6207雷科","110/07/09","富邦-園區",0,10,-10
"32357","6207雷科","110/07/09","日茂-埔里",12,0,12
"32358","6207雷科","110/07/09","元大-上新莊",0,10,-10
"32359","6207雷科","110/07/09","國泰-台中",17,6,11
"32360","6207雷科","110/07/09","永豐金-南京",0,10,-10
"32361","6207雷科","110/07/09","富邦-三重",10,0,10
"32362","6207雷科","110/07/09","兆豐-小港",0,6,-6
"32363","6207雷科","110/07/09","元大-沙鹿",10,0,10
"32364","6207雷科","110/07/09","富邦-羅東",1,7,-6
"32365","6207雷科","110/07/09","元大-八德",10,0,10
"32366","6207雷科","110/07/09","元大-土城永寧",0,6,-6
"32367","6207雷科","110/07/09","第一金-路竹",11,2,9
"32368","6207雷科","110/07/09","永豐金-板盛",0,6,-6
"32369","6207雷科","110/07/09","統一-南京",5,0,5
"32370","6207雷科","110/07/09","日盛-板橋",0,5,-5
"32371","3679新至陞","110/07/09","元大-大天母",10,0,10
"32372","3679新至陞","110/07/09","第一金-光復",0,11,-11
"32373","3679新至陞","110/07/09","日盛-樹林",9,0,9
"32374","3679新至陞","110/07/09","瑞士信貸",0,8,-8
"32375","3679新至陞","110/07/09","凱基-台北",11,2,9
"32376","3679新至陞","110/07/09","大慶-苗栗",0,5,-5
"32377","3679新至陞","110/07/09","華南永昌-小港",8,0,8
"32378","3679新至陞","110/07/09","元大-永春",0,5,-5
"32379","3679新至陞","110/07/09","兆豐-來福",7,0,7
"32380","3679新至陞","110/07/09","日盛-和美",0,4,-4
"32381","3679新至陞","110/07/09","香港上海匯豐",5,0,5
"32382","3679新至陞","110/07/09","元大-雙和",0,3,-3
"32383","3679新至陞","110/07/09","台中銀-員林",3,0,3
"32384","3679新至陞","110/07/09","永豐金-屏東",0,3,-3
"32385","3679新至陞","110/07/09","新光",3,0,3
"32386","3679新至陞","110/07/09","彰銀",0,2,-2
"32387","3679新至陞","110/07/09","土銀-花蓮",2,0,2
"32388","3679新至陞","110/07/09","宏遠-館前",0,2,-2
"32389","3679新至陞","110/07/09","第一金-澎湖",2,0,2
"32390","3679新至陞","110/07/09","港商野村",0,2,-2
"32391","3679新至陞","110/07/09","摩根大通",2,0,2
"32392","3679新至陞","110/07/09","大昌-新店",0,2,-2
"32393","3679新至陞","110/07/09","國泰-敦南",2,0,2
"32394","3679新至陞","110/07/09","元大-新莊",0,2,-2
"32395","3679新至陞","110/07/09","元大-淡水",4,2,2
"32396","3679新至陞","110/07/09","元大-板橋",0,2,-2
"32397","3679新至陞","110/07/09","日盛-士林",1,0,1
"32398","3679新至陞","110/07/09","台灣摩根士丹利",0,1,-1
"32399","3679新至陞","110/07/09","日盛-信義",1,0,1
"32400","3679新至陞","110/07/09","第一金-高雄",0,1,-1
"32401","2727王品","110/07/09","台灣匯立證券",90,0,90
"32402","2727王品","110/07/09","台灣摩根士丹利",0,267,-267
"32403","2727王品","110/07/09","國泰-敦南",166,84,82
"32404","2727王品","110/07/09","富邦-台北",35,299,-264
"32405","2727王品","110/07/09","富邦-仁愛",56,12,44
"32406","2727王品","110/07/09","凱基-台北",174,296,-122
"32407","2727王品","110/07/09","台新證券",109,66,43
"32408","2727王品","110/07/09","第一金",2,102,-100
"32409","2727王品","110/07/09","新光",117,87,30
"32410","2727王品","110/07/09","群益金鼎-大安",0,80,-80
"32411","2727王品","110/07/09","臺銀-臺中",35,6,29
"32412","2727王品","110/07/09","兆豐-大安",7,60,-53
"32413","2727王品","110/07/09","元大-桃園",32,3,29
"32414","2727王品","110/07/09","永豐金-南投",0,50,-50
"32415","2727王品","110/07/09","元富-宜蘭",34,6,28
"32416","2727王品","110/07/09","新加坡商瑞銀",6,46,-40
"32417","2727王品","110/07/09","玉山-台中",34,8,26
"32418","2727王品","110/07/09","合庫-彰化",11,50,-39
"32419","2727王品","110/07/09","群益金鼎-宜蘭",30,4,26
"32420","2727王品","110/07/09","永豐金-萬盛",13,52,-39
"32421","2727王品","110/07/09","富邦-台中",42,16,26
"32422","2727王品","110/07/09","瑞士信貸",0,34,-34
"32423","2727王品","110/07/09","第一金-豐原",25,1,24
"32424","2727王品","110/07/09","元大-和平",4,35,-31
"32425","2727王品","110/07/09","臺銀",30,8,22
"32426","2727王品","110/07/09","美林",14,44,-30
"32427","2727王品","110/07/09","兆豐-來福",23,1,22
"32428","2727王品","110/07/09","元大-員林",9,38,-29
"32429","2727王品","110/07/09","玉山-士林",22,2,20
"32430","2727王品","110/07/09","元富-西松",4,31,-27
"32431","1570力肯","110/07/09","凱基-台北",30,1,29
"32432","1570力肯","110/07/09","群益金鼎-彰化",0,20,-20
"32433","1570力肯","110/07/09","新光-台南",20,0,20
"32434","1570力肯","110/07/09","元大-土城學府",0,20,-20
"32435","1570力肯","110/07/09","元大-高雄",20,0,20
"32436","1570力肯","110/07/09","元大-大統",0,16,-16
"32437","1570力肯","110/07/09","國票-中正",12,0,12
"32438","1570力肯","110/07/09","元大-新營",0,11,-11
"32439","1570力肯","110/07/09","日盛-高雄",6,0,6
"32440","1570力肯","110/07/09","元大-和平",0,10,-10
"32441","1570力肯","110/07/09","元富-緯城",6,0,6
"32442","1570力肯","110/07/09","元大-草屯",0,10,-10
"32443","1570力肯","110/07/09","群益金鼎-台南",6,0,6
"32444","1570力肯","110/07/09","元大-鹿港",0,9,-9
"32445","1570力肯","110/07/09","華南永昌-岡山",6,0,6
"32446","1570力肯","110/07/09","合庫-基隆",0,7,-7
"32447","1570力肯","110/07/09","統一-中壢",5,0,5
"32448","1570力肯","110/07/09","摩根大通",2,8,-6
"32449","1570力肯","110/07/09","凱基-三峽",5,0,5
"32450","1570力肯","110/07/09","台灣企銀-豐原",0,4,-4
"32451","1570力肯","110/07/09","大昌-樹林",4,0,4
"32452","1570力肯","110/07/09","日盛-桃園",0,4,-4
"32453","1570力肯","110/07/09","新光",3,0,3
"32454","1570力肯","110/07/09","國泰-高雄",0,3,-3
"32455","1570力肯","110/07/09","富邦-新竹華信",3,0,3
"32456","1570力肯","110/07/09","永豐金-敦南",0,3,-3
"32457","1570力肯","110/07/09","合庫-台中",2,0,2
"32458","1570力肯","110/07/09","土銀-彰化",0,2,-2
"32459","1570力肯","110/07/09","臺銀-臺中",2,0,2
"32460","1570力肯","110/07/09","臺銀-鳳山",0,2,-2
"32461","6180橘子","110/07/09","摩根大通",63,1,62
"32462","6180橘子","110/07/09","元大-南京",1,32,-31
"32463","6180橘子","110/07/09","富邦-陽明",73,33,40
"32464","6180橘子","110/07/09","群益金鼎-台北",0,25,-25
"32465","6180橘子","110/07/09","新加坡商瑞銀",31,0,31
"32466","6180橘子","110/07/09","兆豐-復興",0,21,-21
"32467","6180橘子","110/07/09","美商高盛",25,0,25
"32468","6180橘子","110/07/09","永豐金-嘉義",0,21,-21
"32469","6180橘子","110/07/09","凱基-台北",26,10,16
"32470","6180橘子","110/07/09","凱基-中壢",8,24,-16
"32471","6180橘子","110/07/09","華南永昌-楠梓",13,0,13
"32472","6180橘子","110/07/09","致和-崇德",0,15,-15
"32473","6180橘子","110/07/09","華南永昌-朴子",11,0,11
"32474","6180橘子","110/07/09","群益金鼎-屏東",0,15,-15
"32475","6180橘子","110/07/09","元大-北港",11,0,11
"32476","6180橘子","110/07/09","群益金鼎-中山",0,15,-15
"32477","6180橘子","110/07/09","元大-成功",10,1,9
"32478","6180橘子","110/07/09","瑞士信貸",1,15,-14
"32479","6180橘子","110/07/09","新光",26,18,8
"32480","6180橘子","110/07/09","日盛-二林",0,10,-10
"32481","6180橘子","110/07/09","統一-三重",6,0,6
"32482","6180橘子","110/07/09","凱基-東門",0,10,-10
"32483","6180橘子","110/07/09","群益金鼎-嘉義",6,0,6
"32484","6180橘子","110/07/09","華南永昌-三重",0,10,-10
"32485","6180橘子","110/07/09","元大-員林中山",6,0,6
"32486","6180橘子","110/07/09","元大-彰化民生",1,11,-10
"32487","6180橘子","110/07/09","合庫-鳳山",5,0,5
"32488","6180橘子","110/07/09","永豐金-新店",1,11,-10
"32489","6180橘子","110/07/09","富邦-建國",6,1,5
"32490","6180橘子","110/07/09","群益金鼎-丹鳳",0,8,-8
"32491","2390云辰","110/07/09","摩根大通",279,56,223
"32492","2390云辰","110/07/09","元大-天母",0,127,-127
"32493","2390云辰","110/07/09","日盛-鳳山",110,2,108
"32494","2390云辰","110/07/09","中國信託-文心",5,109,-104
"32495","2390云辰","110/07/09","宏遠證券",100,0,100
"32496","2390云辰","110/07/09","永豐金-復興",0,55,-55
"32497","2390云辰","110/07/09","元大-大里",63,6,57
"32498","2390云辰","110/07/09","凱基-台北",239,286,-47
"32499","2390云辰","110/07/09","凱基-八德",59,10,49
"32500","2390云辰","110/07/09","德信",2,32,-30
"32501","2390云辰","110/07/09","合庫-新竹",40,0,40
"32502","2390云辰","110/07/09","兆豐-桃鶯",2,32,-30
"32503","2390云辰","110/07/09","國票",40,1,39
"32504","2390云辰","110/07/09","致和-南京",0,30,-30
"32505","2390云辰","110/07/09","新加坡商瑞銀",49,13,36
"32506","2390云辰","110/07/09","富邦-虎尾",1,31,-30
"32507","2390云辰","110/07/09","統一-新台中",36,2,34
"32508","2390云辰","110/07/09","元大-善化",2,31,-29
"32509","2390云辰","110/07/09","國票-嘉義",31,0,31
"32510","2390云辰","110/07/09","富邦-板橋",0,27,-27
"32511","2390云辰","110/07/09","華南永昌",35,7,28
"32512","2390云辰","110/07/09","富邦-永和",3,28,-25
"32513","2390云辰","110/07/09","玉山-台中",49,22,27
"32514","2390云辰","110/07/09","第一金-自由",20,44,-24
"32515","2390云辰","110/07/09","華南永昌-敦南",25,0,25
"32516","2390云辰","110/07/09","凱基-內湖",0,24,-24
"32517","2390云辰","110/07/09","新光-高雄",27,4,23
"32518","2390云辰","110/07/09","元大-汐止",1,24,-23
"32519","2390云辰","110/07/09","台灣摩根士丹利",85,63,22
"32520","2390云辰","110/07/09","新光-台中",12,33,-21
"32521","4903聯光通","110/07/09","元大-敦南",10,0,10
"32522","4903聯光通","110/07/09","第一金-台中",0,12,-12
"32523","4903聯光通","110/07/09","凱基-士林",5,0,5
"32524","4903聯光通","110/07/09","日盛-忠孝",0,3,-3
"32525","4903聯光通","110/07/09","元大-苗栗",5,0,5
"32526","4903聯光通","110/07/09","群益金鼎-崇德",0,3,-3
"32527","4903聯光通","110/07/09","元大-屏南",3,0,3
"32528","4903聯光通","110/07/09","國票-內壢",0,2,-2
"32529","4903聯光通","110/07/09","中國信託-永康",1,0,1
"32530","4903聯光通","110/07/09","康和-南崁",0,2,-2
"32531","4903聯光通","110/07/09","玉山證券",1,0,1
"32532","4903聯光通","110/07/09","新光-台中",0,2,-2
"32533","4903聯光通","110/07/09","元大-太平",4,3,1
"32534","4903聯光通","110/07/09","玉山-城中",0,2,-2
"32535","4903聯光通","110/07/09","永豐金-嘉義",1,0,1
"32536","4903聯光通","110/07/09","中國信託-文心",0,1,-1
"32537","4903聯光通","110/07/09","大昌",0,0,0
"32538","4903聯光通","110/07/09","大昌",0,0,0
"32539","4903聯光通","110/07/09","中農",0,0,0
"32540","4903聯光通","110/07/09","中農",0,0,0
"32541","4903聯光通","110/07/09","",NA,NA,NA
"32542","4903聯光通","110/07/09","",NA,NA,NA
"32543","4903聯光通","110/07/09","",NA,NA,NA
"32544","4903聯光通","110/07/09","",NA,NA,NA
"32545","4903聯光通","110/07/09","",NA,NA,NA
"32546","4903聯光通","110/07/09","",NA,NA,NA
"32547","4903聯光通","110/07/09","",NA,NA,NA
"32548","4903聯光通","110/07/09","",NA,NA,NA
"32549","4903聯光通","110/07/09","",NA,NA,NA
"32550","4903聯光通","110/07/09","",NA,NA,NA
"32551","2929淘帝","110/07/09","台中銀-台北",110,0,110
"32552","2929淘帝","110/07/09","新光",2,82,-80
"32553","2929淘帝","110/07/09","華南永昌-頭份",72,0,72
"32554","2929淘帝","110/07/09","摩根大通",2,63,-61
"32555","2929淘帝","110/07/09","合庫-高雄",71,0,71
"32556","2929淘帝","110/07/09","第一金-路竹",0,50,-50
"32557","2929淘帝","110/07/09","高橋-龍潭",37,0,37
"32558","2929淘帝","110/07/09","港商麥格理",0,42,-42
"32559","2929淘帝","110/07/09","新光-台中",60,26,34
"32560","2929淘帝","110/07/09","陽信-石牌",0,40,-40
"32561","2929淘帝","110/07/09","元富-大裕",22,1,21
"32562","2929淘帝","110/07/09","台新-左楠",1,39,-38
"32563","2929淘帝","110/07/09","合庫-鳳山",20,0,20
"32564","2929淘帝","110/07/09","凱基-桃園",3,29,-26
"32565","2929淘帝","110/07/09","元大-員林",22,2,20
"32566","2929淘帝","110/07/09","兆豐-內湖",0,25,-25
"32567","2929淘帝","110/07/09","台新-建北",15,0,15
"32568","2929淘帝","110/07/09","元大-北港",0,20,-20
"32569","2929淘帝","110/07/09","兆豐-桃園",13,0,13
"32570","2929淘帝","110/07/09","富邦-北港",0,19,-19
"32571","2929淘帝","110/07/09","兆豐-忠孝",10,0,10
"32572","2929淘帝","110/07/09","富邦-花蓮",0,17,-17
"32573","2929淘帝","110/07/09","國票-敦北法人",10,0,10
"32574","2929淘帝","110/07/09","國泰-台中",2,17,-15
"32575","2929淘帝","110/07/09","永豐金-博愛",10,0,10
"32576","2929淘帝","110/07/09","群益金鼎-彰化",0,15,-15
"32577","2929淘帝","110/07/09","群益金鼎-潭子",8,0,8
"32578","2929淘帝","110/07/09","元大-博愛",0,14,-14
"32579","2929淘帝","110/07/09","富邦-南屯",8,0,8
"32580","2929淘帝","110/07/09","日盛-板橋",0,13,-13
"32581","5410國眾","110/07/09","元大-新盛",14,0,14
"32582","5410國眾","110/07/09","(牛牛牛)亞-鑫豐",1,41,-40
"32583","5410國眾","110/07/09","台灣企銀-民雄",10,0,10
"32584","5410國眾","110/07/09","元富-嘉義",0,25,-25
"32585","5410國眾","110/07/09","元富-虎尾",9,0,9
"32586","5410國眾","110/07/09","凱基-高美館",0,10,-10
"32587","5410國眾","110/07/09","摩根大通",10,1,9
"32588","5410國眾","110/07/09","凱基-城中",0,10,-10
"32589","5410國眾","110/07/09","兆豐-北高雄",7,0,7
"32590","5410國眾","110/07/09","元大-頭份",0,10,-10
"32591","5410國眾","110/07/09","凱基-台北",8,1,7
"32592","5410國眾","110/07/09","群益金鼎-丹鳳",0,7,-7
"32593","5410國眾","110/07/09","華南永昌-公誠",7,0,7
"32594","5410國眾","110/07/09","凱基-復興",0,7,-7
"32595","5410國眾","110/07/09","香港上海匯豐",6,0,6
"32596","5410國眾","110/07/09","元大-員林",0,7,-7
"32597","5410國眾","110/07/09","凱基-中壢",6,0,6
"32598","5410國眾","110/07/09","富邦-竹東",0,6,-6
"32599","5410國眾","110/07/09","華南永昌-南京",6,0,6
"32600","5410國眾","110/07/09","亞東-高雄",0,5,-5
"32601","5410國眾","110/07/09","統一-三重",5,0,5
"32602","5410國眾","110/07/09","大慶-中壢",1,6,-5
"32603","5410國眾","110/07/09","富邦-宜蘭",5,0,5
"32604","5410國眾","110/07/09","群益金鼎-中港",0,5,-5
"32605","5410國眾","110/07/09","元大-崇德",5,0,5
"32606","5410國眾","110/07/09","元大-八德",0,5,-5
"32607","5410國眾","110/07/09","元大-博愛",5,0,5
"32608","5410國眾","110/07/09","富邦-基隆",0,4,-4
"32609","5410國眾","110/07/09","元大-龍潭",5,0,5
"32610","5410國眾","110/07/09","臺銀-新竹",0,3,-3
"32611","2841台開","110/07/09","日盛-雙和",102,0,102
"32612","2841台開","110/07/09","港商野村",0,129,-129
"32613","2841台開","110/07/09","元大-館前",70,0,70
"32614","2841台開","110/07/09","兆豐-永和",0,100,-100
"32615","2841台開","110/07/09","凱基-文心",50,0,50
"32616","2841台開","110/07/09","台新證券",7,28,-21
"32617","2841台開","110/07/09","富邦-嘉義",40,0,40
"32618","2841台開","110/07/09","國票-北高雄",0,20,-20
"32619","2841台開","110/07/09","美商高盛",15,0,15
"32620","2841台開","110/07/09","永豐金-敦南",29,46,-17
"32621","2841台開","110/07/09","台中銀",15,0,15
"32622","2841台開","110/07/09","合庫-基隆",0,12,-12
"32623","2841台開","110/07/09","新光",11,0,11
"32624","2841台開","110/07/09","中國信託-松江",0,12,-12
"32625","2841台開","110/07/09","華南永昌-長虹",10,0,10
"32626","2841台開","110/07/09","兆豐-城中",0,12,-12
"32627","2841台開","110/07/09","永豐金-南投",10,0,10
"32628","2841台開","110/07/09","台中銀-豐原",0,10,-10
"32629","2841台開","110/07/09","合庫-桃園",7,0,7
"32630","2841台開","110/07/09","兆豐-景美",0,10,-10
"32631","2841台開","110/07/09","群益金鼎-古亭",7,0,7
"32632","2841台開","110/07/09","群益金鼎-基隆",0,10,-10
"32633","2841台開","110/07/09","國泰-敦南",6,0,6
"32634","2841台開","110/07/09","元大-北三重",0,10,-10
"32635","2841台開","110/07/09","凱基-桃園",8,2,6
"32636","2841台開","110/07/09","(牛牛牛)亞-網路",0,9,-9
"32637","2841台開","110/07/09","日盛證券",5,0,5
"32638","2841台開","110/07/09","台新-高雄",1,10,-9
"32639","2841台開","110/07/09","元富-文心",5,0,5
"32640","2841台開","110/07/09","凱基-台北",0,7,-7
"32641","6207雷科","110/07/09","群益金鼎-新竹",47,0,47
"32642","6207雷科","110/07/09","新光",7,24,-17
"32643","6207雷科","110/07/09","永豐金-三重",31,0,31
"32644","6207雷科","110/07/09","日盛-和美",0,15,-15
"32645","6207雷科","110/07/09","新加坡商瑞銀",33,5,28
"32646","6207雷科","110/07/09","國泰-台南",0,15,-15
"32647","6207雷科","110/07/09","元大-高雄",26,0,26
"32648","6207雷科","110/07/09","華南永昌-古亭",0,14,-14
"32649","6207雷科","110/07/09","統一-員林",22,0,22
"32650","6207雷科","110/07/09","土銀-白河",0,11,-11
"32651","6207雷科","110/07/09","台新-高雄",22,0,22
"32652","6207雷科","110/07/09","日盛-台南",0,10,-10
"32653","6207雷科","110/07/09","摩根大通",34,17,17
"32654","6207雷科","110/07/09","元富-林園",0,10,-10
"32655","6207雷科","110/07/09","元大-博愛",17,1,16
"32656","6207雷科","110/07/09","富邦-園區",0,10,-10
"32657","6207雷科","110/07/09","日茂-埔里",12,0,12
"32658","6207雷科","110/07/09","元大-上新莊",0,10,-10
"32659","6207雷科","110/07/09","國泰-台中",17,6,11
"32660","6207雷科","110/07/09","永豐金-南京",0,10,-10
"32661","6207雷科","110/07/09","富邦-三重",10,0,10
"32662","6207雷科","110/07/09","兆豐-小港",0,6,-6
"32663","6207雷科","110/07/09","元大-沙鹿",10,0,10
"32664","6207雷科","110/07/09","富邦-羅東",1,7,-6
"32665","6207雷科","110/07/09","元大-八德",10,0,10
"32666","6207雷科","110/07/09","元大-土城永寧",0,6,-6
"32667","6207雷科","110/07/09","第一金-路竹",11,2,9
"32668","6207雷科","110/07/09","永豐金-板盛",0,6,-6
"32669","6207雷科","110/07/09","統一-南京",5,0,5
"32670","6207雷科","110/07/09","日盛-板橋",0,5,-5
"32671","3679新至陞","110/07/09","元大-大天母",10,0,10
"32672","3679新至陞","110/07/09","第一金-光復",0,11,-11
"32673","3679新至陞","110/07/09","日盛-樹林",9,0,9
"32674","3679新至陞","110/07/09","瑞士信貸",0,8,-8
"32675","3679新至陞","110/07/09","凱基-台北",11,2,9
"32676","3679新至陞","110/07/09","大慶-苗栗",0,5,-5
"32677","3679新至陞","110/07/09","華南永昌-小港",8,0,8
"32678","3679新至陞","110/07/09","元大-永春",0,5,-5
"32679","3679新至陞","110/07/09","兆豐-來福",7,0,7
"32680","3679新至陞","110/07/09","日盛-和美",0,4,-4
"32681","3679新至陞","110/07/09","香港上海匯豐",5,0,5
"32682","3679新至陞","110/07/09","元大-雙和",0,3,-3
"32683","3679新至陞","110/07/09","台中銀-員林",3,0,3
"32684","3679新至陞","110/07/09","永豐金-屏東",0,3,-3
"32685","3679新至陞","110/07/09","新光",3,0,3
"32686","3679新至陞","110/07/09","彰銀",0,2,-2
"32687","3679新至陞","110/07/09","土銀-花蓮",2,0,2
"32688","3679新至陞","110/07/09","宏遠-館前",0,2,-2
"32689","3679新至陞","110/07/09","第一金-澎湖",2,0,2
"32690","3679新至陞","110/07/09","港商野村",0,2,-2
"32691","3679新至陞","110/07/09","摩根大通",2,0,2
"32692","3679新至陞","110/07/09","大昌-新店",0,2,-2
"32693","3679新至陞","110/07/09","國泰-敦南",2,0,2
"32694","3679新至陞","110/07/09","元大-新莊",0,2,-2
"32695","3679新至陞","110/07/09","元大-淡水",4,2,2
"32696","3679新至陞","110/07/09","元大-板橋",0,2,-2
"32697","3679新至陞","110/07/09","日盛-士林",1,0,1
"32698","3679新至陞","110/07/09","台灣摩根士丹利",0,1,-1
"32699","3679新至陞","110/07/09","日盛-信義",1,0,1
"32700","3679新至陞","110/07/09","第一金-高雄",0,1,-1
"32701","2727王品","110/07/09","台灣匯立證券",90,0,90
"32702","2727王品","110/07/09","台灣摩根士丹利",0,267,-267
"32703","2727王品","110/07/09","國泰-敦南",166,84,82
"32704","2727王品","110/07/09","富邦-台北",35,299,-264
"32705","2727王品","110/07/09","富邦-仁愛",56,12,44
"32706","2727王品","110/07/09","凱基-台北",174,296,-122
"32707","2727王品","110/07/09","台新證券",109,66,43
"32708","2727王品","110/07/09","第一金",2,102,-100
"32709","2727王品","110/07/09","新光",117,87,30
"32710","2727王品","110/07/09","群益金鼎-大安",0,80,-80
"32711","2727王品","110/07/09","臺銀-臺中",35,6,29
"32712","2727王品","110/07/09","兆豐-大安",7,60,-53
"32713","2727王品","110/07/09","元大-桃園",32,3,29
"32714","2727王品","110/07/09","永豐金-南投",0,50,-50
"32715","2727王品","110/07/09","元富-宜蘭",34,6,28
"32716","2727王品","110/07/09","新加坡商瑞銀",6,46,-40
"32717","2727王品","110/07/09","玉山-台中",34,8,26
"32718","2727王品","110/07/09","合庫-彰化",11,50,-39
"32719","2727王品","110/07/09","群益金鼎-宜蘭",30,4,26
"32720","2727王品","110/07/09","永豐金-萬盛",13,52,-39
"32721","2727王品","110/07/09","富邦-台中",42,16,26
"32722","2727王品","110/07/09","瑞士信貸",0,34,-34
"32723","2727王品","110/07/09","第一金-豐原",25,1,24
"32724","2727王品","110/07/09","元大-和平",4,35,-31
"32725","2727王品","110/07/09","臺銀",30,8,22
"32726","2727王品","110/07/09","美林",14,44,-30
"32727","2727王品","110/07/09","兆豐-來福",23,1,22
"32728","2727王品","110/07/09","元大-員林",9,38,-29
"32729","2727王品","110/07/09","玉山-士林",22,2,20
"32730","2727王品","110/07/09","元富-西松",4,31,-27
"32731","1570力肯","110/07/09","凱基-台北",30,1,29
"32732","1570力肯","110/07/09","群益金鼎-彰化",0,20,-20
"32733","1570力肯","110/07/09","新光-台南",20,0,20
"32734","1570力肯","110/07/09","元大-土城學府",0,20,-20
"32735","1570力肯","110/07/09","元大-高雄",20,0,20
"32736","1570力肯","110/07/09","元大-大統",0,16,-16
"32737","1570力肯","110/07/09","國票-中正",12,0,12
"32738","1570力肯","110/07/09","元大-新營",0,11,-11
"32739","1570力肯","110/07/09","日盛-高雄",6,0,6
"32740","1570力肯","110/07/09","元大-和平",0,10,-10
"32741","1570力肯","110/07/09","元富-緯城",6,0,6
"32742","1570力肯","110/07/09","元大-草屯",0,10,-10
"32743","1570力肯","110/07/09","群益金鼎-台南",6,0,6
"32744","1570力肯","110/07/09","元大-鹿港",0,9,-9
"32745","1570力肯","110/07/09","華南永昌-岡山",6,0,6
"32746","1570力肯","110/07/09","合庫-基隆",0,7,-7
"32747","1570力肯","110/07/09","統一-中壢",5,0,5
"32748","1570力肯","110/07/09","摩根大通",2,8,-6
"32749","1570力肯","110/07/09","凱基-三峽",5,0,5
"32750","1570力肯","110/07/09","台灣企銀-豐原",0,4,-4
"32751","1570力肯","110/07/09","大昌-樹林",4,0,4
"32752","1570力肯","110/07/09","日盛-桃園",0,4,-4
"32753","1570力肯","110/07/09","新光",3,0,3
"32754","1570力肯","110/07/09","國泰-高雄",0,3,-3
"32755","1570力肯","110/07/09","富邦-新竹華信",3,0,3
"32756","1570力肯","110/07/09","永豐金-敦南",0,3,-3
"32757","1570力肯","110/07/09","合庫-台中",2,0,2
"32758","1570力肯","110/07/09","土銀-彰化",0,2,-2
"32759","1570力肯","110/07/09","臺銀-臺中",2,0,2
"32760","1570力肯","110/07/09","臺銀-鳳山",0,2,-2
"32761","6180橘子","110/07/09","摩根大通",63,1,62
"32762","6180橘子","110/07/09","元大-南京",1,32,-31
"32763","6180橘子","110/07/09","富邦-陽明",73,33,40
"32764","6180橘子","110/07/09","群益金鼎-台北",0,25,-25
"32765","6180橘子","110/07/09","新加坡商瑞銀",31,0,31
"32766","6180橘子","110/07/09","兆豐-復興",0,21,-21
"32767","6180橘子","110/07/09","美商高盛",25,0,25
"32768","6180橘子","110/07/09","永豐金-嘉義",0,21,-21
"32769","6180橘子","110/07/09","凱基-台北",26,10,16
"32770","6180橘子","110/07/09","凱基-中壢",8,24,-16
"32771","6180橘子","110/07/09","華南永昌-楠梓",13,0,13
"32772","6180橘子","110/07/09","致和-崇德",0,15,-15
"32773","6180橘子","110/07/09","華南永昌-朴子",11,0,11
"32774","6180橘子","110/07/09","群益金鼎-屏東",0,15,-15
"32775","6180橘子","110/07/09","元大-北港",11,0,11
"32776","6180橘子","110/07/09","群益金鼎-中山",0,15,-15
"32777","6180橘子","110/07/09","元大-成功",10,1,9
"32778","6180橘子","110/07/09","瑞士信貸",1,15,-14
"32779","6180橘子","110/07/09","新光",26,18,8
"32780","6180橘子","110/07/09","日盛-二林",0,10,-10
"32781","6180橘子","110/07/09","統一-三重",6,0,6
"32782","6180橘子","110/07/09","凱基-東門",0,10,-10
"32783","6180橘子","110/07/09","群益金鼎-嘉義",6,0,6
"32784","6180橘子","110/07/09","華南永昌-三重",0,10,-10
"32785","6180橘子","110/07/09","元大-員林中山",6,0,6
"32786","6180橘子","110/07/09","元大-彰化民生",1,11,-10
"32787","6180橘子","110/07/09","合庫-鳳山",5,0,5
"32788","6180橘子","110/07/09","永豐金-新店",1,11,-10
"32789","6180橘子","110/07/09","富邦-建國",6,1,5
"32790","6180橘子","110/07/09","群益金鼎-丹鳳",0,8,-8
"32791","2390云辰","110/07/09","摩根大通",279,56,223
"32792","2390云辰","110/07/09","元大-天母",0,127,-127
"32793","2390云辰","110/07/09","日盛-鳳山",110,2,108
"32794","2390云辰","110/07/09","中國信託-文心",5,109,-104
"32795","2390云辰","110/07/09","宏遠證券",100,0,100
"32796","2390云辰","110/07/09","永豐金-復興",0,55,-55
"32797","2390云辰","110/07/09","元大-大里",63,6,57
"32798","2390云辰","110/07/09","凱基-台北",239,286,-47
"32799","2390云辰","110/07/09","凱基-八德",59,10,49
"32800","2390云辰","110/07/09","德信",2,32,-30
"32801","2390云辰","110/07/09","合庫-新竹",40,0,40
"32802","2390云辰","110/07/09","兆豐-桃鶯",2,32,-30
"32803","2390云辰","110/07/09","國票",40,1,39
"32804","2390云辰","110/07/09","致和-南京",0,30,-30
"32805","2390云辰","110/07/09","新加坡商瑞銀",49,13,36
"32806","2390云辰","110/07/09","富邦-虎尾",1,31,-30
"32807","2390云辰","110/07/09","統一-新台中",36,2,34
"32808","2390云辰","110/07/09","元大-善化",2,31,-29
"32809","2390云辰","110/07/09","國票-嘉義",31,0,31
"32810","2390云辰","110/07/09","富邦-板橋",0,27,-27
"32811","2390云辰","110/07/09","華南永昌",35,7,28
"32812","2390云辰","110/07/09","富邦-永和",3,28,-25
"32813","2390云辰","110/07/09","玉山-台中",49,22,27
"32814","2390云辰","110/07/09","第一金-自由",20,44,-24
"32815","2390云辰","110/07/09","華南永昌-敦南",25,0,25
"32816","2390云辰","110/07/09","凱基-內湖",0,24,-24
"32817","2390云辰","110/07/09","新光-高雄",27,4,23
"32818","2390云辰","110/07/09","元大-汐止",1,24,-23
"32819","2390云辰","110/07/09","台灣摩根士丹利",85,63,22
"32820","2390云辰","110/07/09","新光-台中",12,33,-21
"32821","4903聯光通","110/07/09","元大-敦南",10,0,10
"32822","4903聯光通","110/07/09","第一金-台中",0,12,-12
"32823","4903聯光通","110/07/09","凱基-士林",5,0,5
"32824","4903聯光通","110/07/09","日盛-忠孝",0,3,-3
"32825","4903聯光通","110/07/09","元大-苗栗",5,0,5
"32826","4903聯光通","110/07/09","群益金鼎-崇德",0,3,-3
"32827","4903聯光通","110/07/09","元大-屏南",3,0,3
"32828","4903聯光通","110/07/09","國票-內壢",0,2,-2
"32829","4903聯光通","110/07/09","中國信託-永康",1,0,1
"32830","4903聯光通","110/07/09","康和-南崁",0,2,-2
"32831","4903聯光通","110/07/09","玉山證券",1,0,1
"32832","4903聯光通","110/07/09","新光-台中",0,2,-2
"32833","4903聯光通","110/07/09","元大-太平",4,3,1
"32834","4903聯光通","110/07/09","玉山-城中",0,2,-2
"32835","4903聯光通","110/07/09","永豐金-嘉義",1,0,1
"32836","4903聯光通","110/07/09","中國信託-文心",0,1,-1
"32837","4903聯光通","110/07/09","大昌",0,0,0
"32838","4903聯光通","110/07/09","大昌",0,0,0
"32839","4903聯光通","110/07/09","中農",0,0,0
"32840","4903聯光通","110/07/09","中農",0,0,0
"32841","4903聯光通","110/07/09","",NA,NA,NA
"32842","4903聯光通","110/07/09","",NA,NA,NA
"32843","4903聯光通","110/07/09","",NA,NA,NA
"32844","4903聯光通","110/07/09","",NA,NA,NA
"32845","4903聯光通","110/07/09","",NA,NA,NA
"32846","4903聯光通","110/07/09","",NA,NA,NA
"32847","4903聯光通","110/07/09","",NA,NA,NA
"32848","4903聯光通","110/07/09","",NA,NA,NA
"32849","4903聯光通","110/07/09","",NA,NA,NA
"32850","4903聯光通","110/07/09","",NA,NA,NA
"32851","2929淘帝","110/07/09","台中銀-台北",110,0,110
"32852","2929淘帝","110/07/09","新光",2,82,-80
"32853","2929淘帝","110/07/09","華南永昌-頭份",72,0,72
"32854","2929淘帝","110/07/09","摩根大通",2,63,-61
"32855","2929淘帝","110/07/09","合庫-高雄",71,0,71
"32856","2929淘帝","110/07/09","第一金-路竹",0,50,-50
"32857","2929淘帝","110/07/09","高橋-龍潭",37,0,37
"32858","2929淘帝","110/07/09","港商麥格理",0,42,-42
"32859","2929淘帝","110/07/09","新光-台中",60,26,34
"32860","2929淘帝","110/07/09","陽信-石牌",0,40,-40
"32861","2929淘帝","110/07/09","元富-大裕",22,1,21
"32862","2929淘帝","110/07/09","台新-左楠",1,39,-38
"32863","2929淘帝","110/07/09","合庫-鳳山",20,0,20
"32864","2929淘帝","110/07/09","凱基-桃園",3,29,-26
"32865","2929淘帝","110/07/09","元大-員林",22,2,20
"32866","2929淘帝","110/07/09","兆豐-內湖",0,25,-25
"32867","2929淘帝","110/07/09","台新-建北",15,0,15
"32868","2929淘帝","110/07/09","元大-北港",0,20,-20
"32869","2929淘帝","110/07/09","兆豐-桃園",13,0,13
"32870","2929淘帝","110/07/09","富邦-北港",0,19,-19
"32871","2929淘帝","110/07/09","兆豐-忠孝",10,0,10
"32872","2929淘帝","110/07/09","富邦-花蓮",0,17,-17
"32873","2929淘帝","110/07/09","國票-敦北法人",10,0,10
"32874","2929淘帝","110/07/09","國泰-台中",2,17,-15
"32875","2929淘帝","110/07/09","永豐金-博愛",10,0,10
"32876","2929淘帝","110/07/09","群益金鼎-彰化",0,15,-15
"32877","2929淘帝","110/07/09","群益金鼎-潭子",8,0,8
"32878","2929淘帝","110/07/09","元大-博愛",0,14,-14
"32879","2929淘帝","110/07/09","富邦-南屯",8,0,8
"32880","2929淘帝","110/07/09","日盛-板橋",0,13,-13
"32881","5410國眾","110/07/09","元大-新盛",14,0,14
"32882","5410國眾","110/07/09","(牛牛牛)亞-鑫豐",1,41,-40
"32883","5410國眾","110/07/09","台灣企銀-民雄",10,0,10
"32884","5410國眾","110/07/09","元富-嘉義",0,25,-25
"32885","5410國眾","110/07/09","元富-虎尾",9,0,9
"32886","5410國眾","110/07/09","凱基-高美館",0,10,-10
"32887","5410國眾","110/07/09","摩根大通",10,1,9
"32888","5410國眾","110/07/09","凱基-城中",0,10,-10
"32889","5410國眾","110/07/09","兆豐-北高雄",7,0,7
"32890","5410國眾","110/07/09","元大-頭份",0,10,-10
"32891","5410國眾","110/07/09","凱基-台北",8,1,7
"32892","5410國眾","110/07/09","群益金鼎-丹鳳",0,7,-7
"32893","5410國眾","110/07/09","華南永昌-公誠",7,0,7
"32894","5410國眾","110/07/09","凱基-復興",0,7,-7
"32895","5410國眾","110/07/09","香港上海匯豐",6,0,6
"32896","5410國眾","110/07/09","元大-員林",0,7,-7
"32897","5410國眾","110/07/09","凱基-中壢",6,0,6
"32898","5410國眾","110/07/09","富邦-竹東",0,6,-6
"32899","5410國眾","110/07/09","華南永昌-南京",6,0,6
"32900","5410國眾","110/07/09","亞東-高雄",0,5,-5
"32901","5410國眾","110/07/09","統一-三重",5,0,5
"32902","5410國眾","110/07/09","大慶-中壢",1,6,-5
"32903","5410國眾","110/07/09","富邦-宜蘭",5,0,5
"32904","5410國眾","110/07/09","群益金鼎-中港",0,5,-5
"32905","5410國眾","110/07/09","元大-崇德",5,0,5
"32906","5410國眾","110/07/09","元大-八德",0,5,-5
"32907","5410國眾","110/07/09","元大-博愛",5,0,5
"32908","5410國眾","110/07/09","富邦-基隆",0,4,-4
"32909","5410國眾","110/07/09","元大-龍潭",5,0,5
"32910","5410國眾","110/07/09","臺銀-新竹",0,3,-3
"32911","2841台開","110/07/09","日盛-雙和",102,0,102
"32912","2841台開","110/07/09","港商野村",0,129,-129
"32913","2841台開","110/07/09","元大-館前",70,0,70
"32914","2841台開","110/07/09","兆豐-永和",0,100,-100
"32915","2841台開","110/07/09","凱基-文心",50,0,50
"32916","2841台開","110/07/09","台新證券",7,28,-21
"32917","2841台開","110/07/09","富邦-嘉義",40,0,40
"32918","2841台開","110/07/09","國票-北高雄",0,20,-20
"32919","2841台開","110/07/09","美商高盛",15,0,15
"32920","2841台開","110/07/09","永豐金-敦南",29,46,-17
"32921","2841台開","110/07/09","台中銀",15,0,15
"32922","2841台開","110/07/09","合庫-基隆",0,12,-12
"32923","2841台開","110/07/09","新光",11,0,11
"32924","2841台開","110/07/09","中國信託-松江",0,12,-12
"32925","2841台開","110/07/09","華南永昌-長虹",10,0,10
"32926","2841台開","110/07/09","兆豐-城中",0,12,-12
"32927","2841台開","110/07/09","永豐金-南投",10,0,10
"32928","2841台開","110/07/09","台中銀-豐原",0,10,-10
"32929","2841台開","110/07/09","合庫-桃園",7,0,7
"32930","2841台開","110/07/09","兆豐-景美",0,10,-10
"32931","2841台開","110/07/09","群益金鼎-古亭",7,0,7
"32932","2841台開","110/07/09","群益金鼎-基隆",0,10,-10
"32933","2841台開","110/07/09","國泰-敦南",6,0,6
"32934","2841台開","110/07/09","元大-北三重",0,10,-10
"32935","2841台開","110/07/09","凱基-桃園",8,2,6
"32936","2841台開","110/07/09","(牛牛牛)亞-網路",0,9,-9
"32937","2841台開","110/07/09","日盛證券",5,0,5
"32938","2841台開","110/07/09","台新-高雄",1,10,-9
"32939","2841台開","110/07/09","元富-文心",5,0,5
"32940","2841台開","110/07/09","凱基-台北",0,7,-7
"32941","6207雷科","110/07/09","群益金鼎-新竹",47,0,47
"32942","6207雷科","110/07/09","新光",7,24,-17
"32943","6207雷科","110/07/09","永豐金-三重",31,0,31
"32944","6207雷科","110/07/09","日盛-和美",0,15,-15
"32945","6207雷科","110/07/09","新加坡商瑞銀",33,5,28
"32946","6207雷科","110/07/09","國泰-台南",0,15,-15
"32947","6207雷科","110/07/09","元大-高雄",26,0,26
"32948","6207雷科","110/07/09","華南永昌-古亭",0,14,-14
"32949","6207雷科","110/07/09","統一-員林",22,0,22
"32950","6207雷科","110/07/09","土銀-白河",0,11,-11
"32951","6207雷科","110/07/09","台新-高雄",22,0,22
"32952","6207雷科","110/07/09","日盛-台南",0,10,-10
"32953","6207雷科","110/07/09","摩根大通",34,17,17
"32954","6207雷科","110/07/09","元富-林園",0,10,-10
"32955","6207雷科","110/07/09","元大-博愛",17,1,16
"32956","6207雷科","110/07/09","富邦-園區",0,10,-10
"32957","6207雷科","110/07/09","日茂-埔里",12,0,12
"32958","6207雷科","110/07/09","元大-上新莊",0,10,-10
"32959","6207雷科","110/07/09","國泰-台中",17,6,11
"32960","6207雷科","110/07/09","永豐金-南京",0,10,-10
"32961","6207雷科","110/07/09","富邦-三重",10,0,10
"32962","6207雷科","110/07/09","兆豐-小港",0,6,-6
"32963","6207雷科","110/07/09","元大-沙鹿",10,0,10
"32964","6207雷科","110/07/09","富邦-羅東",1,7,-6
"32965","6207雷科","110/07/09","元大-八德",10,0,10
"32966","6207雷科","110/07/09","元大-土城永寧",0,6,-6
"32967","6207雷科","110/07/09","第一金-路竹",11,2,9
"32968","6207雷科","110/07/09","永豐金-板盛",0,6,-6
"32969","6207雷科","110/07/09","統一-南京",5,0,5
"32970","6207雷科","110/07/09","日盛-板橋",0,5,-5
"32971","3679新至陞","110/07/09","元大-大天母",10,0,10
"32972","3679新至陞","110/07/09","第一金-光復",0,11,-11
"32973","3679新至陞","110/07/09","日盛-樹林",9,0,9
"32974","3679新至陞","110/07/09","瑞士信貸",0,8,-8
"32975","3679新至陞","110/07/09","凱基-台北",11,2,9
"32976","3679新至陞","110/07/09","大慶-苗栗",0,5,-5
"32977","3679新至陞","110/07/09","華南永昌-小港",8,0,8
"32978","3679新至陞","110/07/09","元大-永春",0,5,-5
"32979","3679新至陞","110/07/09","兆豐-來福",7,0,7
"32980","3679新至陞","110/07/09","日盛-和美",0,4,-4
"32981","3679新至陞","110/07/09","香港上海匯豐",5,0,5
"32982","3679新至陞","110/07/09","元大-雙和",0,3,-3
"32983","3679新至陞","110/07/09","台中銀-員林",3,0,3
"32984","3679新至陞","110/07/09","永豐金-屏東",0,3,-3
"32985","3679新至陞","110/07/09","新光",3,0,3
"32986","3679新至陞","110/07/09","彰銀",0,2,-2
"32987","3679新至陞","110/07/09","土銀-花蓮",2,0,2
"32988","3679新至陞","110/07/09","宏遠-館前",0,2,-2
"32989","3679新至陞","110/07/09","第一金-澎湖",2,0,2
"32990","3679新至陞","110/07/09","港商野村",0,2,-2
"32991","3679新至陞","110/07/09","摩根大通",2,0,2
"32992","3679新至陞","110/07/09","大昌-新店",0,2,-2
"32993","3679新至陞","110/07/09","國泰-敦南",2,0,2
"32994","3679新至陞","110/07/09","元大-新莊",0,2,-2
"32995","3679新至陞","110/07/09","元大-淡水",4,2,2
"32996","3679新至陞","110/07/09","元大-板橋",0,2,-2
"32997","3679新至陞","110/07/09","日盛-士林",1,0,1
"32998","3679新至陞","110/07/09","台灣摩根士丹利",0,1,-1
"32999","3679新至陞","110/07/09","日盛-信義",1,0,1
"33000","3679新至陞","110/07/09","第一金-高雄",0,1,-1
"33001","2727王品","110/07/09","台灣匯立證券",90,0,90
"33002","2727王品","110/07/09","台灣摩根士丹利",0,267,-267
"33003","2727王品","110/07/09","國泰-敦南",166,84,82
"33004","2727王品","110/07/09","富邦-台北",35,299,-264
"33005","2727王品","110/07/09","富邦-仁愛",56,12,44
"33006","2727王品","110/07/09","凱基-台北",174,296,-122
"33007","2727王品","110/07/09","台新證券",109,66,43
"33008","2727王品","110/07/09","第一金",2,102,-100
"33009","2727王品","110/07/09","新光",117,87,30
"33010","2727王品","110/07/09","群益金鼎-大安",0,80,-80
"33011","2727王品","110/07/09","臺銀-臺中",35,6,29
"33012","2727王品","110/07/09","兆豐-大安",7,60,-53
"33013","2727王品","110/07/09","元大-桃園",32,3,29
"33014","2727王品","110/07/09","永豐金-南投",0,50,-50
"33015","2727王品","110/07/09","元富-宜蘭",34,6,28
"33016","2727王品","110/07/09","新加坡商瑞銀",6,46,-40
"33017","2727王品","110/07/09","玉山-台中",34,8,26
"33018","2727王品","110/07/09","合庫-彰化",11,50,-39
"33019","2727王品","110/07/09","群益金鼎-宜蘭",30,4,26
"33020","2727王品","110/07/09","永豐金-萬盛",13,52,-39
"33021","2727王品","110/07/09","富邦-台中",42,16,26
"33022","2727王品","110/07/09","瑞士信貸",0,34,-34
"33023","2727王品","110/07/09","第一金-豐原",25,1,24
"33024","2727王品","110/07/09","元大-和平",4,35,-31
"33025","2727王品","110/07/09","臺銀",30,8,22
"33026","2727王品","110/07/09","美林",14,44,-30
"33027","2727王品","110/07/09","兆豐-來福",23,1,22
"33028","2727王品","110/07/09","元大-員林",9,38,-29
"33029","2727王品","110/07/09","玉山-士林",22,2,20
"33030","2727王品","110/07/09","元富-西松",4,31,-27
"33031","1570力肯","110/07/09","凱基-台北",30,1,29
"33032","1570力肯","110/07/09","群益金鼎-彰化",0,20,-20
"33033","1570力肯","110/07/09","新光-台南",20,0,20
"33034","1570力肯","110/07/09","元大-土城學府",0,20,-20
"33035","1570力肯","110/07/09","元大-高雄",20,0,20
"33036","1570力肯","110/07/09","元大-大統",0,16,-16
"33037","1570力肯","110/07/09","國票-中正",12,0,12
"33038","1570力肯","110/07/09","元大-新營",0,11,-11
"33039","1570力肯","110/07/09","日盛-高雄",6,0,6
"33040","1570力肯","110/07/09","元大-和平",0,10,-10
"33041","1570力肯","110/07/09","元富-緯城",6,0,6
"33042","1570力肯","110/07/09","元大-草屯",0,10,-10
"33043","1570力肯","110/07/09","群益金鼎-台南",6,0,6
"33044","1570力肯","110/07/09","元大-鹿港",0,9,-9
"33045","1570力肯","110/07/09","華南永昌-岡山",6,0,6
"33046","1570力肯","110/07/09","合庫-基隆",0,7,-7
"33047","1570力肯","110/07/09","統一-中壢",5,0,5
"33048","1570力肯","110/07/09","摩根大通",2,8,-6
"33049","1570力肯","110/07/09","凱基-三峽",5,0,5
"33050","1570力肯","110/07/09","台灣企銀-豐原",0,4,-4
"33051","1570力肯","110/07/09","大昌-樹林",4,0,4
"33052","1570力肯","110/07/09","日盛-桃園",0,4,-4
"33053","1570力肯","110/07/09","新光",3,0,3
"33054","1570力肯","110/07/09","國泰-高雄",0,3,-3
"33055","1570力肯","110/07/09","富邦-新竹華信",3,0,3
"33056","1570力肯","110/07/09","永豐金-敦南",0,3,-3
"33057","1570力肯","110/07/09","合庫-台中",2,0,2
"33058","1570力肯","110/07/09","土銀-彰化",0,2,-2
"33059","1570力肯","110/07/09","臺銀-臺中",2,0,2
"33060","1570力肯","110/07/09","臺銀-鳳山",0,2,-2
"33061","6180橘子","110/07/09","摩根大通",63,1,62
"33062","6180橘子","110/07/09","元大-南京",1,32,-31
"33063","6180橘子","110/07/09","富邦-陽明",73,33,40
"33064","6180橘子","110/07/09","群益金鼎-台北",0,25,-25
"33065","6180橘子","110/07/09","新加坡商瑞銀",31,0,31
"33066","6180橘子","110/07/09","兆豐-復興",0,21,-21
"33067","6180橘子","110/07/09","美商高盛",25,0,25
"33068","6180橘子","110/07/09","永豐金-嘉義",0,21,-21
"33069","6180橘子","110/07/09","凱基-台北",26,10,16
"33070","6180橘子","110/07/09","凱基-中壢",8,24,-16
"33071","6180橘子","110/07/09","華南永昌-楠梓",13,0,13
"33072","6180橘子","110/07/09","致和-崇德",0,15,-15
"33073","6180橘子","110/07/09","華南永昌-朴子",11,0,11
"33074","6180橘子","110/07/09","群益金鼎-屏東",0,15,-15
"33075","6180橘子","110/07/09","元大-北港",11,0,11
"33076","6180橘子","110/07/09","群益金鼎-中山",0,15,-15
"33077","6180橘子","110/07/09","元大-成功",10,1,9
"33078","6180橘子","110/07/09","瑞士信貸",1,15,-14
"33079","6180橘子","110/07/09","新光",26,18,8
"33080","6180橘子","110/07/09","日盛-二林",0,10,-10
"33081","6180橘子","110/07/09","統一-三重",6,0,6
"33082","6180橘子","110/07/09","凱基-東門",0,10,-10
"33083","6180橘子","110/07/09","群益金鼎-嘉義",6,0,6
"33084","6180橘子","110/07/09","華南永昌-三重",0,10,-10
"33085","6180橘子","110/07/09","元大-員林中山",6,0,6
"33086","6180橘子","110/07/09","元大-彰化民生",1,11,-10
"33087","6180橘子","110/07/09","合庫-鳳山",5,0,5
"33088","6180橘子","110/07/09","永豐金-新店",1,11,-10
"33089","6180橘子","110/07/09","富邦-建國",6,1,5
"33090","6180橘子","110/07/09","群益金鼎-丹鳳",0,8,-8
"33091","2390云辰","110/07/09","摩根大通",279,56,223
"33092","2390云辰","110/07/09","元大-天母",0,127,-127
"33093","2390云辰","110/07/09","日盛-鳳山",110,2,108
"33094","2390云辰","110/07/09","中國信託-文心",5,109,-104
"33095","2390云辰","110/07/09","宏遠證券",100,0,100
"33096","2390云辰","110/07/09","永豐金-復興",0,55,-55
"33097","2390云辰","110/07/09","元大-大里",63,6,57
"33098","2390云辰","110/07/09","凱基-台北",239,286,-47
"33099","2390云辰","110/07/09","凱基-八德",59,10,49
"33100","2390云辰","110/07/09","德信",2,32,-30
"33101","2390云辰","110/07/09","合庫-新竹",40,0,40
"33102","2390云辰","110/07/09","兆豐-桃鶯",2,32,-30
"33103","2390云辰","110/07/09","國票",40,1,39
"33104","2390云辰","110/07/09","致和-南京",0,30,-30
"33105","2390云辰","110/07/09","新加坡商瑞銀",49,13,36
"33106","2390云辰","110/07/09","富邦-虎尾",1,31,-30
"33107","2390云辰","110/07/09","統一-新台中",36,2,34
"33108","2390云辰","110/07/09","元大-善化",2,31,-29
"33109","2390云辰","110/07/09","國票-嘉義",31,0,31
"33110","2390云辰","110/07/09","富邦-板橋",0,27,-27
"33111","2390云辰","110/07/09","華南永昌",35,7,28
"33112","2390云辰","110/07/09","富邦-永和",3,28,-25
"33113","2390云辰","110/07/09","玉山-台中",49,22,27
"33114","2390云辰","110/07/09","第一金-自由",20,44,-24
"33115","2390云辰","110/07/09","華南永昌-敦南",25,0,25
"33116","2390云辰","110/07/09","凱基-內湖",0,24,-24
"33117","2390云辰","110/07/09","新光-高雄",27,4,23
"33118","2390云辰","110/07/09","元大-汐止",1,24,-23
"33119","2390云辰","110/07/09","台灣摩根士丹利",85,63,22
"33120","2390云辰","110/07/09","新光-台中",12,33,-21
"33121","4903聯光通","110/07/09","元大-敦南",10,0,10
"33122","4903聯光通","110/07/09","第一金-台中",0,12,-12
"33123","4903聯光通","110/07/09","凱基-士林",5,0,5
"33124","4903聯光通","110/07/09","日盛-忠孝",0,3,-3
"33125","4903聯光通","110/07/09","元大-苗栗",5,0,5
"33126","4903聯光通","110/07/09","群益金鼎-崇德",0,3,-3
"33127","4903聯光通","110/07/09","元大-屏南",3,0,3
"33128","4903聯光通","110/07/09","國票-內壢",0,2,-2
"33129","4903聯光通","110/07/09","中國信託-永康",1,0,1
"33130","4903聯光通","110/07/09","康和-南崁",0,2,-2
"33131","4903聯光通","110/07/09","玉山證券",1,0,1
"33132","4903聯光通","110/07/09","新光-台中",0,2,-2
"33133","4903聯光通","110/07/09","元大-太平",4,3,1
"33134","4903聯光通","110/07/09","玉山-城中",0,2,-2
"33135","4903聯光通","110/07/09","永豐金-嘉義",1,0,1
"33136","4903聯光通","110/07/09","中國信託-文心",0,1,-1
"33137","4903聯光通","110/07/09","大昌",0,0,0
"33138","4903聯光通","110/07/09","大昌",0,0,0
"33139","4903聯光通","110/07/09","中農",0,0,0
"33140","4903聯光通","110/07/09","中農",0,0,0
"33141","4903聯光通","110/07/09","",NA,NA,NA
"33142","4903聯光通","110/07/09","",NA,NA,NA
"33143","4903聯光通","110/07/09","",NA,NA,NA
"33144","4903聯光通","110/07/09","",NA,NA,NA
"33145","4903聯光通","110/07/09","",NA,NA,NA
"33146","4903聯光通","110/07/09","",NA,NA,NA
"33147","4903聯光通","110/07/09","",NA,NA,NA
"33148","4903聯光通","110/07/09","",NA,NA,NA
"33149","4903聯光通","110/07/09","",NA,NA,NA
"33150","4903聯光通","110/07/09","",NA,NA,NA
"33151","2929淘帝","110/07/09","台中銀-台北",110,0,110
"33152","2929淘帝","110/07/09","新光",2,82,-80
"33153","2929淘帝","110/07/09","華南永昌-頭份",72,0,72
"33154","2929淘帝","110/07/09","摩根大通",2,63,-61
"33155","2929淘帝","110/07/09","合庫-高雄",71,0,71
"33156","2929淘帝","110/07/09","第一金-路竹",0,50,-50
"33157","2929淘帝","110/07/09","高橋-龍潭",37,0,37
"33158","2929淘帝","110/07/09","港商麥格理",0,42,-42
"33159","2929淘帝","110/07/09","新光-台中",60,26,34
"33160","2929淘帝","110/07/09","陽信-石牌",0,40,-40
"33161","2929淘帝","110/07/09","元富-大裕",22,1,21
"33162","2929淘帝","110/07/09","台新-左楠",1,39,-38
"33163","2929淘帝","110/07/09","合庫-鳳山",20,0,20
"33164","2929淘帝","110/07/09","凱基-桃園",3,29,-26
"33165","2929淘帝","110/07/09","元大-員林",22,2,20
"33166","2929淘帝","110/07/09","兆豐-內湖",0,25,-25
"33167","2929淘帝","110/07/09","台新-建北",15,0,15
"33168","2929淘帝","110/07/09","元大-北港",0,20,-20
"33169","2929淘帝","110/07/09","兆豐-桃園",13,0,13
"33170","2929淘帝","110/07/09","富邦-北港",0,19,-19
"33171","2929淘帝","110/07/09","兆豐-忠孝",10,0,10
"33172","2929淘帝","110/07/09","富邦-花蓮",0,17,-17
"33173","2929淘帝","110/07/09","國票-敦北法人",10,0,10
"33174","2929淘帝","110/07/09","國泰-台中",2,17,-15
"33175","2929淘帝","110/07/09","永豐金-博愛",10,0,10
"33176","2929淘帝","110/07/09","群益金鼎-彰化",0,15,-15
"33177","2929淘帝","110/07/09","群益金鼎-潭子",8,0,8
"33178","2929淘帝","110/07/09","元大-博愛",0,14,-14
"33179","2929淘帝","110/07/09","富邦-南屯",8,0,8
"33180","2929淘帝","110/07/09","日盛-板橋",0,13,-13
"33181","5410國眾","110/07/09","元大-新盛",14,0,14
"33182","5410國眾","110/07/09","(牛牛牛)亞-鑫豐",1,41,-40
"33183","5410國眾","110/07/09","台灣企銀-民雄",10,0,10
"33184","5410國眾","110/07/09","元富-嘉義",0,25,-25
"33185","5410國眾","110/07/09","元富-虎尾",9,0,9
"33186","5410國眾","110/07/09","凱基-高美館",0,10,-10
"33187","5410國眾","110/07/09","摩根大通",10,1,9
"33188","5410國眾","110/07/09","凱基-城中",0,10,-10
"33189","5410國眾","110/07/09","兆豐-北高雄",7,0,7
"33190","5410國眾","110/07/09","元大-頭份",0,10,-10
"33191","5410國眾","110/07/09","凱基-台北",8,1,7
"33192","5410國眾","110/07/09","群益金鼎-丹鳳",0,7,-7
"33193","5410國眾","110/07/09","華南永昌-公誠",7,0,7
"33194","5410國眾","110/07/09","凱基-復興",0,7,-7
"33195","5410國眾","110/07/09","香港上海匯豐",6,0,6
"33196","5410國眾","110/07/09","元大-員林",0,7,-7
"33197","5410國眾","110/07/09","凱基-中壢",6,0,6
"33198","5410國眾","110/07/09","富邦-竹東",0,6,-6
"33199","5410國眾","110/07/09","華南永昌-南京",6,0,6
"33200","5410國眾","110/07/09","亞東-高雄",0,5,-5
"33201","5410國眾","110/07/09","統一-三重",5,0,5
"33202","5410國眾","110/07/09","大慶-中壢",1,6,-5
"33203","5410國眾","110/07/09","富邦-宜蘭",5,0,5
"33204","5410國眾","110/07/09","群益金鼎-中港",0,5,-5
"33205","5410國眾","110/07/09","元大-崇德",5,0,5
"33206","5410國眾","110/07/09","元大-八德",0,5,-5
"33207","5410國眾","110/07/09","元大-博愛",5,0,5
"33208","5410國眾","110/07/09","富邦-基隆",0,4,-4
"33209","5410國眾","110/07/09","元大-龍潭",5,0,5
"33210","5410國眾","110/07/09","臺銀-新竹",0,3,-3
"33211","2841台開","110/07/09","日盛-雙和",102,0,102
"33212","2841台開","110/07/09","港商野村",0,129,-129
"33213","2841台開","110/07/09","元大-館前",70,0,70
"33214","2841台開","110/07/09","兆豐-永和",0,100,-100
"33215","2841台開","110/07/09","凱基-文心",50,0,50
"33216","2841台開","110/07/09","台新證券",7,28,-21
"33217","2841台開","110/07/09","富邦-嘉義",40,0,40
"33218","2841台開","110/07/09","國票-北高雄",0,20,-20
"33219","2841台開","110/07/09","美商高盛",15,0,15
"33220","2841台開","110/07/09","永豐金-敦南",29,46,-17
"33221","2841台開","110/07/09","台中銀",15,0,15
"33222","2841台開","110/07/09","合庫-基隆",0,12,-12
"33223","2841台開","110/07/09","新光",11,0,11
"33224","2841台開","110/07/09","中國信託-松江",0,12,-12
"33225","2841台開","110/07/09","華南永昌-長虹",10,0,10
"33226","2841台開","110/07/09","兆豐-城中",0,12,-12
"33227","2841台開","110/07/09","永豐金-南投",10,0,10
"33228","2841台開","110/07/09","台中銀-豐原",0,10,-10
"33229","2841台開","110/07/09","合庫-桃園",7,0,7
"33230","2841台開","110/07/09","兆豐-景美",0,10,-10
"33231","2841台開","110/07/09","群益金鼎-古亭",7,0,7
"33232","2841台開","110/07/09","群益金鼎-基隆",0,10,-10
"33233","2841台開","110/07/09","國泰-敦南",6,0,6
"33234","2841台開","110/07/09","元大-北三重",0,10,-10
"33235","2841台開","110/07/09","凱基-桃園",8,2,6
"33236","2841台開","110/07/09","(牛牛牛)亞-網路",0,9,-9
"33237","2841台開","110/07/09","日盛證券",5,0,5
"33238","2841台開","110/07/09","台新-高雄",1,10,-9
"33239","2841台開","110/07/09","元富-文心",5,0,5
"33240","2841台開","110/07/09","凱基-台北",0,7,-7
"33241","6207雷科","110/07/09","群益金鼎-新竹",47,0,47
"33242","6207雷科","110/07/09","新光",7,24,-17
"33243","6207雷科","110/07/09","永豐金-三重",31,0,31
"33244","6207雷科","110/07/09","日盛-和美",0,15,-15
"33245","6207雷科","110/07/09","新加坡商瑞銀",33,5,28
"33246","6207雷科","110/07/09","國泰-台南",0,15,-15
"33247","6207雷科","110/07/09","元大-高雄",26,0,26
"33248","6207雷科","110/07/09","華南永昌-古亭",0,14,-14
"33249","6207雷科","110/07/09","統一-員林",22,0,22
"33250","6207雷科","110/07/09","土銀-白河",0,11,-11
"33251","6207雷科","110/07/09","台新-高雄",22,0,22
"33252","6207雷科","110/07/09","日盛-台南",0,10,-10
"33253","6207雷科","110/07/09","摩根大通",34,17,17
"33254","6207雷科","110/07/09","元富-林園",0,10,-10
"33255","6207雷科","110/07/09","元大-博愛",17,1,16
"33256","6207雷科","110/07/09","富邦-園區",0,10,-10
"33257","6207雷科","110/07/09","日茂-埔里",12,0,12
"33258","6207雷科","110/07/09","元大-上新莊",0,10,-10
"33259","6207雷科","110/07/09","國泰-台中",17,6,11
"33260","6207雷科","110/07/09","永豐金-南京",0,10,-10
"33261","6207雷科","110/07/09","富邦-三重",10,0,10
"33262","6207雷科","110/07/09","兆豐-小港",0,6,-6
"33263","6207雷科","110/07/09","元大-沙鹿",10,0,10
"33264","6207雷科","110/07/09","富邦-羅東",1,7,-6
"33265","6207雷科","110/07/09","元大-八德",10,0,10
"33266","6207雷科","110/07/09","元大-土城永寧",0,6,-6
"33267","6207雷科","110/07/09","第一金-路竹",11,2,9
"33268","6207雷科","110/07/09","永豐金-板盛",0,6,-6
"33269","6207雷科","110/07/09","統一-南京",5,0,5
"33270","6207雷科","110/07/09","日盛-板橋",0,5,-5
"33271","3679新至陞","110/07/09","元大-大天母",10,0,10
"33272","3679新至陞","110/07/09","第一金-光復",0,11,-11
"33273","3679新至陞","110/07/09","日盛-樹林",9,0,9
"33274","3679新至陞","110/07/09","瑞士信貸",0,8,-8
"33275","3679新至陞","110/07/09","凱基-台北",11,2,9
"33276","3679新至陞","110/07/09","大慶-苗栗",0,5,-5
"33277","3679新至陞","110/07/09","華南永昌-小港",8,0,8
"33278","3679新至陞","110/07/09","元大-永春",0,5,-5
"33279","3679新至陞","110/07/09","兆豐-來福",7,0,7
"33280","3679新至陞","110/07/09","日盛-和美",0,4,-4
"33281","3679新至陞","110/07/09","香港上海匯豐",5,0,5
"33282","3679新至陞","110/07/09","元大-雙和",0,3,-3
"33283","3679新至陞","110/07/09","台中銀-員林",3,0,3
"33284","3679新至陞","110/07/09","永豐金-屏東",0,3,-3
"33285","3679新至陞","110/07/09","新光",3,0,3
"33286","3679新至陞","110/07/09","彰銀",0,2,-2
"33287","3679新至陞","110/07/09","土銀-花蓮",2,0,2
"33288","3679新至陞","110/07/09","宏遠-館前",0,2,-2
"33289","3679新至陞","110/07/09","第一金-澎湖",2,0,2
"33290","3679新至陞","110/07/09","港商野村",0,2,-2
"33291","3679新至陞","110/07/09","摩根大通",2,0,2
"33292","3679新至陞","110/07/09","大昌-新店",0,2,-2
"33293","3679新至陞","110/07/09","國泰-敦南",2,0,2
"33294","3679新至陞","110/07/09","元大-新莊",0,2,-2
"33295","3679新至陞","110/07/09","元大-淡水",4,2,2
"33296","3679新至陞","110/07/09","元大-板橋",0,2,-2
"33297","3679新至陞","110/07/09","日盛-士林",1,0,1
"33298","3679新至陞","110/07/09","台灣摩根士丹利",0,1,-1
"33299","3679新至陞","110/07/09","日盛-信義",1,0,1
"33300","3679新至陞","110/07/09","第一金-高雄",0,1,-1
"33301","2727王品","110/07/09","台灣匯立證券",90,0,90
"33302","2727王品","110/07/09","台灣摩根士丹利",0,267,-267
"33303","2727王品","110/07/09","國泰-敦南",166,84,82
"33304","2727王品","110/07/09","富邦-台北",35,299,-264
"33305","2727王品","110/07/09","富邦-仁愛",56,12,44
"33306","2727王品","110/07/09","凱基-台北",174,296,-122
"33307","2727王品","110/07/09","台新證券",109,66,43
"33308","2727王品","110/07/09","第一金",2,102,-100
"33309","2727王品","110/07/09","新光",117,87,30
"33310","2727王品","110/07/09","群益金鼎-大安",0,80,-80
"33311","2727王品","110/07/09","臺銀-臺中",35,6,29
"33312","2727王品","110/07/09","兆豐-大安",7,60,-53
"33313","2727王品","110/07/09","元大-桃園",32,3,29
"33314","2727王品","110/07/09","永豐金-南投",0,50,-50
"33315","2727王品","110/07/09","元富-宜蘭",34,6,28
"33316","2727王品","110/07/09","新加坡商瑞銀",6,46,-40
"33317","2727王品","110/07/09","玉山-台中",34,8,26
"33318","2727王品","110/07/09","合庫-彰化",11,50,-39
"33319","2727王品","110/07/09","群益金鼎-宜蘭",30,4,26
"33320","2727王品","110/07/09","永豐金-萬盛",13,52,-39
"33321","2727王品","110/07/09","富邦-台中",42,16,26
"33322","2727王品","110/07/09","瑞士信貸",0,34,-34
"33323","2727王品","110/07/09","第一金-豐原",25,1,24
"33324","2727王品","110/07/09","元大-和平",4,35,-31
"33325","2727王品","110/07/09","臺銀",30,8,22
"33326","2727王品","110/07/09","美林",14,44,-30
"33327","2727王品","110/07/09","兆豐-來福",23,1,22
"33328","2727王品","110/07/09","元大-員林",9,38,-29
"33329","2727王品","110/07/09","玉山-士林",22,2,20
"33330","2727王品","110/07/09","元富-西松",4,31,-27
"33331","1570力肯","110/07/09","凱基-台北",30,1,29
"33332","1570力肯","110/07/09","群益金鼎-彰化",0,20,-20
"33333","1570力肯","110/07/09","新光-台南",20,0,20
"33334","1570力肯","110/07/09","元大-土城學府",0,20,-20
"33335","1570力肯","110/07/09","元大-高雄",20,0,20
"33336","1570力肯","110/07/09","元大-大統",0,16,-16
"33337","1570力肯","110/07/09","國票-中正",12,0,12
"33338","1570力肯","110/07/09","元大-新營",0,11,-11
"33339","1570力肯","110/07/09","日盛-高雄",6,0,6
"33340","1570力肯","110/07/09","元大-和平",0,10,-10
"33341","1570力肯","110/07/09","元富-緯城",6,0,6
"33342","1570力肯","110/07/09","元大-草屯",0,10,-10
"33343","1570力肯","110/07/09","群益金鼎-台南",6,0,6
"33344","1570力肯","110/07/09","元大-鹿港",0,9,-9
"33345","1570力肯","110/07/09","華南永昌-岡山",6,0,6
"33346","1570力肯","110/07/09","合庫-基隆",0,7,-7
"33347","1570力肯","110/07/09","統一-中壢",5,0,5
"33348","1570力肯","110/07/09","摩根大通",2,8,-6
"33349","1570力肯","110/07/09","凱基-三峽",5,0,5
"33350","1570力肯","110/07/09","台灣企銀-豐原",0,4,-4
"33351","1570力肯","110/07/09","大昌-樹林",4,0,4
"33352","1570力肯","110/07/09","日盛-桃園",0,4,-4
"33353","1570力肯","110/07/09","新光",3,0,3
"33354","1570力肯","110/07/09","國泰-高雄",0,3,-3
"33355","1570力肯","110/07/09","富邦-新竹華信",3,0,3
"33356","1570力肯","110/07/09","永豐金-敦南",0,3,-3
"33357","1570力肯","110/07/09","合庫-台中",2,0,2
"33358","1570力肯","110/07/09","土銀-彰化",0,2,-2
"33359","1570力肯","110/07/09","臺銀-臺中",2,0,2
"33360","1570力肯","110/07/09","臺銀-鳳山",0,2,-2
"33361","6180橘子","110/07/09","摩根大通",63,1,62
"33362","6180橘子","110/07/09","元大-南京",1,32,-31
"33363","6180橘子","110/07/09","富邦-陽明",73,33,40
"33364","6180橘子","110/07/09","群益金鼎-台北",0,25,-25
"33365","6180橘子","110/07/09","新加坡商瑞銀",31,0,31
"33366","6180橘子","110/07/09","兆豐-復興",0,21,-21
"33367","6180橘子","110/07/09","美商高盛",25,0,25
"33368","6180橘子","110/07/09","永豐金-嘉義",0,21,-21
"33369","6180橘子","110/07/09","凱基-台北",26,10,16
"33370","6180橘子","110/07/09","凱基-中壢",8,24,-16
"33371","6180橘子","110/07/09","華南永昌-楠梓",13,0,13
"33372","6180橘子","110/07/09","致和-崇德",0,15,-15
"33373","6180橘子","110/07/09","華南永昌-朴子",11,0,11
"33374","6180橘子","110/07/09","群益金鼎-屏東",0,15,-15
"33375","6180橘子","110/07/09","元大-北港",11,0,11
"33376","6180橘子","110/07/09","群益金鼎-中山",0,15,-15
"33377","6180橘子","110/07/09","元大-成功",10,1,9
"33378","6180橘子","110/07/09","瑞士信貸",1,15,-14
"33379","6180橘子","110/07/09","新光",26,18,8
"33380","6180橘子","110/07/09","日盛-二林",0,10,-10
"33381","6180橘子","110/07/09","統一-三重",6,0,6
"33382","6180橘子","110/07/09","凱基-東門",0,10,-10
"33383","6180橘子","110/07/09","群益金鼎-嘉義",6,0,6
"33384","6180橘子","110/07/09","華南永昌-三重",0,10,-10
"33385","6180橘子","110/07/09","元大-員林中山",6,0,6
"33386","6180橘子","110/07/09","元大-彰化民生",1,11,-10
"33387","6180橘子","110/07/09","合庫-鳳山",5,0,5
"33388","6180橘子","110/07/09","永豐金-新店",1,11,-10
"33389","6180橘子","110/07/09","富邦-建國",6,1,5
"33390","6180橘子","110/07/09","群益金鼎-丹鳳",0,8,-8
"33391","2390云辰","110/07/09","摩根大通",279,56,223
"33392","2390云辰","110/07/09","元大-天母",0,127,-127
"33393","2390云辰","110/07/09","日盛-鳳山",110,2,108
"33394","2390云辰","110/07/09","中國信託-文心",5,109,-104
"33395","2390云辰","110/07/09","宏遠證券",100,0,100
"33396","2390云辰","110/07/09","永豐金-復興",0,55,-55
"33397","2390云辰","110/07/09","元大-大里",63,6,57
"33398","2390云辰","110/07/09","凱基-台北",239,286,-47
"33399","2390云辰","110/07/09","凱基-八德",59,10,49
"33400","2390云辰","110/07/09","德信",2,32,-30
"33401","2390云辰","110/07/09","合庫-新竹",40,0,40
"33402","2390云辰","110/07/09","兆豐-桃鶯",2,32,-30
"33403","2390云辰","110/07/09","國票",40,1,39
"33404","2390云辰","110/07/09","致和-南京",0,30,-30
"33405","2390云辰","110/07/09","新加坡商瑞銀",49,13,36
"33406","2390云辰","110/07/09","富邦-虎尾",1,31,-30
"33407","2390云辰","110/07/09","統一-新台中",36,2,34
"33408","2390云辰","110/07/09","元大-善化",2,31,-29
"33409","2390云辰","110/07/09","國票-嘉義",31,0,31
"33410","2390云辰","110/07/09","富邦-板橋",0,27,-27
"33411","2390云辰","110/07/09","華南永昌",35,7,28
"33412","2390云辰","110/07/09","富邦-永和",3,28,-25
"33413","2390云辰","110/07/09","玉山-台中",49,22,27
"33414","2390云辰","110/07/09","第一金-自由",20,44,-24
"33415","2390云辰","110/07/09","華南永昌-敦南",25,0,25
"33416","2390云辰","110/07/09","凱基-內湖",0,24,-24
"33417","2390云辰","110/07/09","新光-高雄",27,4,23
"33418","2390云辰","110/07/09","元大-汐止",1,24,-23
"33419","2390云辰","110/07/09","台灣摩根士丹利",85,63,22
"33420","2390云辰","110/07/09","新光-台中",12,33,-21
"33421","4903聯光通","110/07/09","元大-敦南",10,0,10
"33422","4903聯光通","110/07/09","第一金-台中",0,12,-12
"33423","4903聯光通","110/07/09","凱基-士林",5,0,5
"33424","4903聯光通","110/07/09","日盛-忠孝",0,3,-3
"33425","4903聯光通","110/07/09","元大-苗栗",5,0,5
"33426","4903聯光通","110/07/09","群益金鼎-崇德",0,3,-3
"33427","4903聯光通","110/07/09","元大-屏南",3,0,3
"33428","4903聯光通","110/07/09","國票-內壢",0,2,-2
"33429","4903聯光通","110/07/09","中國信託-永康",1,0,1
"33430","4903聯光通","110/07/09","康和-南崁",0,2,-2
"33431","4903聯光通","110/07/09","玉山證券",1,0,1
"33432","4903聯光通","110/07/09","新光-台中",0,2,-2
"33433","4903聯光通","110/07/09","元大-太平",4,3,1
"33434","4903聯光通","110/07/09","玉山-城中",0,2,-2
"33435","4903聯光通","110/07/09","永豐金-嘉義",1,0,1
"33436","4903聯光通","110/07/09","中國信託-文心",0,1,-1
"33437","4903聯光通","110/07/09","大昌",0,0,0
"33438","4903聯光通","110/07/09","大昌",0,0,0
"33439","4903聯光通","110/07/09","中農",0,0,0
"33440","4903聯光通","110/07/09","中農",0,0,0
"33441","4903聯光通","110/07/09","",NA,NA,NA
"33442","4903聯光通","110/07/09","",NA,NA,NA
"33443","4903聯光通","110/07/09","",NA,NA,NA
"33444","4903聯光通","110/07/09","",NA,NA,NA
"33445","4903聯光通","110/07/09","",NA,NA,NA
"33446","4903聯光通","110/07/09","",NA,NA,NA
"33447","4903聯光通","110/07/09","",NA,NA,NA
"33448","4903聯光通","110/07/09","",NA,NA,NA
"33449","4903聯光通","110/07/09","",NA,NA,NA
"33450","4903聯光通","110/07/09","",NA,NA,NA
"33451","2929淘帝","110/07/09","台中銀-台北",110,0,110
"33452","2929淘帝","110/07/09","新光",2,82,-80
"33453","2929淘帝","110/07/09","華南永昌-頭份",72,0,72
"33454","2929淘帝","110/07/09","摩根大通",2,63,-61
"33455","2929淘帝","110/07/09","合庫-高雄",71,0,71
"33456","2929淘帝","110/07/09","第一金-路竹",0,50,-50
"33457","2929淘帝","110/07/09","高橋-龍潭",37,0,37
"33458","2929淘帝","110/07/09","港商麥格理",0,42,-42
"33459","2929淘帝","110/07/09","新光-台中",60,26,34
"33460","2929淘帝","110/07/09","陽信-石牌",0,40,-40
"33461","2929淘帝","110/07/09","元富-大裕",22,1,21
"33462","2929淘帝","110/07/09","台新-左楠",1,39,-38
"33463","2929淘帝","110/07/09","合庫-鳳山",20,0,20
"33464","2929淘帝","110/07/09","凱基-桃園",3,29,-26
"33465","2929淘帝","110/07/09","元大-員林",22,2,20
"33466","2929淘帝","110/07/09","兆豐-內湖",0,25,-25
"33467","2929淘帝","110/07/09","台新-建北",15,0,15
"33468","2929淘帝","110/07/09","元大-北港",0,20,-20
"33469","2929淘帝","110/07/09","兆豐-桃園",13,0,13
"33470","2929淘帝","110/07/09","富邦-北港",0,19,-19
"33471","2929淘帝","110/07/09","兆豐-忠孝",10,0,10
"33472","2929淘帝","110/07/09","富邦-花蓮",0,17,-17
"33473","2929淘帝","110/07/09","國票-敦北法人",10,0,10
"33474","2929淘帝","110/07/09","國泰-台中",2,17,-15
"33475","2929淘帝","110/07/09","永豐金-博愛",10,0,10
"33476","2929淘帝","110/07/09","群益金鼎-彰化",0,15,-15
"33477","2929淘帝","110/07/09","群益金鼎-潭子",8,0,8
"33478","2929淘帝","110/07/09","元大-博愛",0,14,-14
"33479","2929淘帝","110/07/09","富邦-南屯",8,0,8
"33480","2929淘帝","110/07/09","日盛-板橋",0,13,-13
"33481","5410國眾","110/07/09","元大-新盛",14,0,14
"33482","5410國眾","110/07/09","(牛牛牛)亞-鑫豐",1,41,-40
"33483","5410國眾","110/07/09","台灣企銀-民雄",10,0,10
"33484","5410國眾","110/07/09","元富-嘉義",0,25,-25
"33485","5410國眾","110/07/09","元富-虎尾",9,0,9
"33486","5410國眾","110/07/09","凱基-高美館",0,10,-10
"33487","5410國眾","110/07/09","摩根大通",10,1,9
"33488","5410國眾","110/07/09","凱基-城中",0,10,-10
"33489","5410國眾","110/07/09","兆豐-北高雄",7,0,7
"33490","5410國眾","110/07/09","元大-頭份",0,10,-10
"33491","5410國眾","110/07/09","凱基-台北",8,1,7
"33492","5410國眾","110/07/09","群益金鼎-丹鳳",0,7,-7
"33493","5410國眾","110/07/09","華南永昌-公誠",7,0,7
"33494","5410國眾","110/07/09","凱基-復興",0,7,-7
"33495","5410國眾","110/07/09","香港上海匯豐",6,0,6
"33496","5410國眾","110/07/09","元大-員林",0,7,-7
"33497","5410國眾","110/07/09","凱基-中壢",6,0,6
"33498","5410國眾","110/07/09","富邦-竹東",0,6,-6
"33499","5410國眾","110/07/09","華南永昌-南京",6,0,6
"33500","5410國眾","110/07/09","亞東-高雄",0,5,-5
"33501","5410國眾","110/07/09","統一-三重",5,0,5
"33502","5410國眾","110/07/09","大慶-中壢",1,6,-5
"33503","5410國眾","110/07/09","富邦-宜蘭",5,0,5
"33504","5410國眾","110/07/09","群益金鼎-中港",0,5,-5
"33505","5410國眾","110/07/09","元大-崇德",5,0,5
"33506","5410國眾","110/07/09","元大-八德",0,5,-5
"33507","5410國眾","110/07/09","元大-博愛",5,0,5
"33508","5410國眾","110/07/09","富邦-基隆",0,4,-4
"33509","5410國眾","110/07/09","元大-龍潭",5,0,5
"33510","5410國眾","110/07/09","臺銀-新竹",0,3,-3
"33511","2841台開","110/07/09","日盛-雙和",102,0,102
"33512","2841台開","110/07/09","港商野村",0,129,-129
"33513","2841台開","110/07/09","元大-館前",70,0,70
"33514","2841台開","110/07/09","兆豐-永和",0,100,-100
"33515","2841台開","110/07/09","凱基-文心",50,0,50
"33516","2841台開","110/07/09","台新證券",7,28,-21
"33517","2841台開","110/07/09","富邦-嘉義",40,0,40
"33518","2841台開","110/07/09","國票-北高雄",0,20,-20
"33519","2841台開","110/07/09","美商高盛",15,0,15
"33520","2841台開","110/07/09","永豐金-敦南",29,46,-17
"33521","2841台開","110/07/09","台中銀",15,0,15
"33522","2841台開","110/07/09","合庫-基隆",0,12,-12
"33523","2841台開","110/07/09","新光",11,0,11
"33524","2841台開","110/07/09","中國信託-松江",0,12,-12
"33525","2841台開","110/07/09","華南永昌-長虹",10,0,10
"33526","2841台開","110/07/09","兆豐-城中",0,12,-12
"33527","2841台開","110/07/09","永豐金-南投",10,0,10
"33528","2841台開","110/07/09","台中銀-豐原",0,10,-10
"33529","2841台開","110/07/09","合庫-桃園",7,0,7
"33530","2841台開","110/07/09","兆豐-景美",0,10,-10
"33531","2841台開","110/07/09","群益金鼎-古亭",7,0,7
"33532","2841台開","110/07/09","群益金鼎-基隆",0,10,-10
"33533","2841台開","110/07/09","國泰-敦南",6,0,6
"33534","2841台開","110/07/09","元大-北三重",0,10,-10
"33535","2841台開","110/07/09","凱基-桃園",8,2,6
"33536","2841台開","110/07/09","(牛牛牛)亞-網路",0,9,-9
"33537","2841台開","110/07/09","日盛證券",5,0,5
"33538","2841台開","110/07/09","台新-高雄",1,10,-9
"33539","2841台開","110/07/09","元富-文心",5,0,5
"33540","2841台開","110/07/09","凱基-台北",0,7,-7
"33541","6207雷科","110/07/09","群益金鼎-新竹",47,0,47
"33542","6207雷科","110/07/09","新光",7,24,-17
"33543","6207雷科","110/07/09","永豐金-三重",31,0,31
"33544","6207雷科","110/07/09","日盛-和美",0,15,-15
"33545","6207雷科","110/07/09","新加坡商瑞銀",33,5,28
"33546","6207雷科","110/07/09","國泰-台南",0,15,-15
"33547","6207雷科","110/07/09","元大-高雄",26,0,26
"33548","6207雷科","110/07/09","華南永昌-古亭",0,14,-14
"33549","6207雷科","110/07/09","統一-員林",22,0,22
"33550","6207雷科","110/07/09","土銀-白河",0,11,-11
"33551","6207雷科","110/07/09","台新-高雄",22,0,22
"33552","6207雷科","110/07/09","日盛-台南",0,10,-10
"33553","6207雷科","110/07/09","摩根大通",34,17,17
"33554","6207雷科","110/07/09","元富-林園",0,10,-10
"33555","6207雷科","110/07/09","元大-博愛",17,1,16
"33556","6207雷科","110/07/09","富邦-園區",0,10,-10
"33557","6207雷科","110/07/09","日茂-埔里",12,0,12
"33558","6207雷科","110/07/09","元大-上新莊",0,10,-10
"33559","6207雷科","110/07/09","國泰-台中",17,6,11
"33560","6207雷科","110/07/09","永豐金-南京",0,10,-10
"33561","6207雷科","110/07/09","富邦-三重",10,0,10
"33562","6207雷科","110/07/09","兆豐-小港",0,6,-6
"33563","6207雷科","110/07/09","元大-沙鹿",10,0,10
"33564","6207雷科","110/07/09","富邦-羅東",1,7,-6
"33565","6207雷科","110/07/09","元大-八德",10,0,10
"33566","6207雷科","110/07/09","元大-土城永寧",0,6,-6
"33567","6207雷科","110/07/09","第一金-路竹",11,2,9
"33568","6207雷科","110/07/09","永豐金-板盛",0,6,-6
"33569","6207雷科","110/07/09","統一-南京",5,0,5
"33570","6207雷科","110/07/09","日盛-板橋",0,5,-5
"33571","3679新至陞","110/07/09","元大-大天母",10,0,10
"33572","3679新至陞","110/07/09","第一金-光復",0,11,-11
"33573","3679新至陞","110/07/09","日盛-樹林",9,0,9
"33574","3679新至陞","110/07/09","瑞士信貸",0,8,-8
"33575","3679新至陞","110/07/09","凱基-台北",11,2,9
"33576","3679新至陞","110/07/09","大慶-苗栗",0,5,-5
"33577","3679新至陞","110/07/09","華南永昌-小港",8,0,8
"33578","3679新至陞","110/07/09","元大-永春",0,5,-5
"33579","3679新至陞","110/07/09","兆豐-來福",7,0,7
"33580","3679新至陞","110/07/09","日盛-和美",0,4,-4
"33581","3679新至陞","110/07/09","香港上海匯豐",5,0,5
"33582","3679新至陞","110/07/09","元大-雙和",0,3,-3
"33583","3679新至陞","110/07/09","台中銀-員林",3,0,3
"33584","3679新至陞","110/07/09","永豐金-屏東",0,3,-3
"33585","3679新至陞","110/07/09","新光",3,0,3
"33586","3679新至陞","110/07/09","彰銀",0,2,-2
"33587","3679新至陞","110/07/09","土銀-花蓮",2,0,2
"33588","3679新至陞","110/07/09","宏遠-館前",0,2,-2
"33589","3679新至陞","110/07/09","第一金-澎湖",2,0,2
"33590","3679新至陞","110/07/09","港商野村",0,2,-2
"33591","3679新至陞","110/07/09","摩根大通",2,0,2
"33592","3679新至陞","110/07/09","大昌-新店",0,2,-2
"33593","3679新至陞","110/07/09","國泰-敦南",2,0,2
"33594","3679新至陞","110/07/09","元大-新莊",0,2,-2
"33595","3679新至陞","110/07/09","元大-淡水",4,2,2
"33596","3679新至陞","110/07/09","元大-板橋",0,2,-2
"33597","3679新至陞","110/07/09","日盛-士林",1,0,1
"33598","3679新至陞","110/07/09","台灣摩根士丹利",0,1,-1
"33599","3679新至陞","110/07/09","日盛-信義",1,0,1
"33600","3679新至陞","110/07/09","第一金-高雄",0,1,-1
"33601","2727王品","110/07/09","台灣匯立證券",90,0,90
"33602","2727王品","110/07/09","台灣摩根士丹利",0,267,-267
"33603","2727王品","110/07/09","國泰-敦南",166,84,82
"33604","2727王品","110/07/09","富邦-台北",35,299,-264
"33605","2727王品","110/07/09","富邦-仁愛",56,12,44
"33606","2727王品","110/07/09","凱基-台北",174,296,-122
"33607","2727王品","110/07/09","台新證券",109,66,43
"33608","2727王品","110/07/09","第一金",2,102,-100
"33609","2727王品","110/07/09","新光",117,87,30
"33610","2727王品","110/07/09","群益金鼎-大安",0,80,-80
"33611","2727王品","110/07/09","臺銀-臺中",35,6,29
"33612","2727王品","110/07/09","兆豐-大安",7,60,-53
"33613","2727王品","110/07/09","元大-桃園",32,3,29
"33614","2727王品","110/07/09","永豐金-南投",0,50,-50
"33615","2727王品","110/07/09","元富-宜蘭",34,6,28
"33616","2727王品","110/07/09","新加坡商瑞銀",6,46,-40
"33617","2727王品","110/07/09","玉山-台中",34,8,26
"33618","2727王品","110/07/09","合庫-彰化",11,50,-39
"33619","2727王品","110/07/09","群益金鼎-宜蘭",30,4,26
"33620","2727王品","110/07/09","永豐金-萬盛",13,52,-39
"33621","2727王品","110/07/09","富邦-台中",42,16,26
"33622","2727王品","110/07/09","瑞士信貸",0,34,-34
"33623","2727王品","110/07/09","第一金-豐原",25,1,24
"33624","2727王品","110/07/09","元大-和平",4,35,-31
"33625","2727王品","110/07/09","臺銀",30,8,22
"33626","2727王品","110/07/09","美林",14,44,-30
"33627","2727王品","110/07/09","兆豐-來福",23,1,22
"33628","2727王品","110/07/09","元大-員林",9,38,-29
"33629","2727王品","110/07/09","玉山-士林",22,2,20
"33630","2727王品","110/07/09","元富-西松",4,31,-27
"33631","1570力肯","110/07/09","凱基-台北",30,1,29
"33632","1570力肯","110/07/09","群益金鼎-彰化",0,20,-20
"33633","1570力肯","110/07/09","新光-台南",20,0,20
"33634","1570力肯","110/07/09","元大-土城學府",0,20,-20
"33635","1570力肯","110/07/09","元大-高雄",20,0,20
"33636","1570力肯","110/07/09","元大-大統",0,16,-16
"33637","1570力肯","110/07/09","國票-中正",12,0,12
"33638","1570力肯","110/07/09","元大-新營",0,11,-11
"33639","1570力肯","110/07/09","日盛-高雄",6,0,6
"33640","1570力肯","110/07/09","元大-和平",0,10,-10
"33641","1570力肯","110/07/09","元富-緯城",6,0,6
"33642","1570力肯","110/07/09","元大-草屯",0,10,-10
"33643","1570力肯","110/07/09","群益金鼎-台南",6,0,6
"33644","1570力肯","110/07/09","元大-鹿港",0,9,-9
"33645","1570力肯","110/07/09","華南永昌-岡山",6,0,6
"33646","1570力肯","110/07/09","合庫-基隆",0,7,-7
"33647","1570力肯","110/07/09","統一-中壢",5,0,5
"33648","1570力肯","110/07/09","摩根大通",2,8,-6
"33649","1570力肯","110/07/09","凱基-三峽",5,0,5
"33650","1570力肯","110/07/09","台灣企銀-豐原",0,4,-4
"33651","1570力肯","110/07/09","大昌-樹林",4,0,4
"33652","1570力肯","110/07/09","日盛-桃園",0,4,-4
"33653","1570力肯","110/07/09","新光",3,0,3
"33654","1570力肯","110/07/09","國泰-高雄",0,3,-3
"33655","1570力肯","110/07/09","富邦-新竹華信",3,0,3
"33656","1570力肯","110/07/09","永豐金-敦南",0,3,-3
"33657","1570力肯","110/07/09","合庫-台中",2,0,2
"33658","1570力肯","110/07/09","土銀-彰化",0,2,-2
"33659","1570力肯","110/07/09","臺銀-臺中",2,0,2
"33660","1570力肯","110/07/09","臺銀-鳳山",0,2,-2
"33661","6180橘子","110/07/09","摩根大通",63,1,62
"33662","6180橘子","110/07/09","元大-南京",1,32,-31
"33663","6180橘子","110/07/09","富邦-陽明",73,33,40
"33664","6180橘子","110/07/09","群益金鼎-台北",0,25,-25
"33665","6180橘子","110/07/09","新加坡商瑞銀",31,0,31
"33666","6180橘子","110/07/09","兆豐-復興",0,21,-21
"33667","6180橘子","110/07/09","美商高盛",25,0,25
"33668","6180橘子","110/07/09","永豐金-嘉義",0,21,-21
"33669","6180橘子","110/07/09","凱基-台北",26,10,16
"33670","6180橘子","110/07/09","凱基-中壢",8,24,-16
"33671","6180橘子","110/07/09","華南永昌-楠梓",13,0,13
"33672","6180橘子","110/07/09","致和-崇德",0,15,-15
"33673","6180橘子","110/07/09","華南永昌-朴子",11,0,11
"33674","6180橘子","110/07/09","群益金鼎-屏東",0,15,-15
"33675","6180橘子","110/07/09","元大-北港",11,0,11
"33676","6180橘子","110/07/09","群益金鼎-中山",0,15,-15
"33677","6180橘子","110/07/09","元大-成功",10,1,9
"33678","6180橘子","110/07/09","瑞士信貸",1,15,-14
"33679","6180橘子","110/07/09","新光",26,18,8
"33680","6180橘子","110/07/09","日盛-二林",0,10,-10
"33681","6180橘子","110/07/09","統一-三重",6,0,6
"33682","6180橘子","110/07/09","凱基-東門",0,10,-10
"33683","6180橘子","110/07/09","群益金鼎-嘉義",6,0,6
"33684","6180橘子","110/07/09","華南永昌-三重",0,10,-10
"33685","6180橘子","110/07/09","元大-員林中山",6,0,6
"33686","6180橘子","110/07/09","元大-彰化民生",1,11,-10
"33687","6180橘子","110/07/09","合庫-鳳山",5,0,5
"33688","6180橘子","110/07/09","永豐金-新店",1,11,-10
"33689","6180橘子","110/07/09","富邦-建國",6,1,5
"33690","6180橘子","110/07/09","群益金鼎-丹鳳",0,8,-8
"33691","2390云辰","110/07/09","摩根大通",279,56,223
"33692","2390云辰","110/07/09","元大-天母",0,127,-127
"33693","2390云辰","110/07/09","日盛-鳳山",110,2,108
"33694","2390云辰","110/07/09","中國信託-文心",5,109,-104
"33695","2390云辰","110/07/09","宏遠證券",100,0,100
"33696","2390云辰","110/07/09","永豐金-復興",0,55,-55
"33697","2390云辰","110/07/09","元大-大里",63,6,57
"33698","2390云辰","110/07/09","凱基-台北",239,286,-47
"33699","2390云辰","110/07/09","凱基-八德",59,10,49
"33700","2390云辰","110/07/09","德信",2,32,-30
"33701","2390云辰","110/07/09","合庫-新竹",40,0,40
"33702","2390云辰","110/07/09","兆豐-桃鶯",2,32,-30
"33703","2390云辰","110/07/09","國票",40,1,39
"33704","2390云辰","110/07/09","致和-南京",0,30,-30
"33705","2390云辰","110/07/09","新加坡商瑞銀",49,13,36
"33706","2390云辰","110/07/09","富邦-虎尾",1,31,-30
"33707","2390云辰","110/07/09","統一-新台中",36,2,34
"33708","2390云辰","110/07/09","元大-善化",2,31,-29
"33709","2390云辰","110/07/09","國票-嘉義",31,0,31
"33710","2390云辰","110/07/09","富邦-板橋",0,27,-27
"33711","2390云辰","110/07/09","華南永昌",35,7,28
"33712","2390云辰","110/07/09","富邦-永和",3,28,-25
"33713","2390云辰","110/07/09","玉山-台中",49,22,27
"33714","2390云辰","110/07/09","第一金-自由",20,44,-24
"33715","2390云辰","110/07/09","華南永昌-敦南",25,0,25
"33716","2390云辰","110/07/09","凱基-內湖",0,24,-24
"33717","2390云辰","110/07/09","新光-高雄",27,4,23
"33718","2390云辰","110/07/09","元大-汐止",1,24,-23
"33719","2390云辰","110/07/09","台灣摩根士丹利",85,63,22
"33720","2390云辰","110/07/09","新光-台中",12,33,-21
"33721","4903聯光通","110/07/09","元大-敦南",10,0,10
"33722","4903聯光通","110/07/09","第一金-台中",0,12,-12
"33723","4903聯光通","110/07/09","凱基-士林",5,0,5
"33724","4903聯光通","110/07/09","日盛-忠孝",0,3,-3
"33725","4903聯光通","110/07/09","元大-苗栗",5,0,5
"33726","4903聯光通","110/07/09","群益金鼎-崇德",0,3,-3
"33727","4903聯光通","110/07/09","元大-屏南",3,0,3
"33728","4903聯光通","110/07/09","國票-內壢",0,2,-2
"33729","4903聯光通","110/07/09","中國信託-永康",1,0,1
"33730","4903聯光通","110/07/09","康和-南崁",0,2,-2
"33731","4903聯光通","110/07/09","玉山證券",1,0,1
"33732","4903聯光通","110/07/09","新光-台中",0,2,-2
"33733","4903聯光通","110/07/09","元大-太平",4,3,1
"33734","4903聯光通","110/07/09","玉山-城中",0,2,-2
"33735","4903聯光通","110/07/09","永豐金-嘉義",1,0,1
"33736","4903聯光通","110/07/09","中國信託-文心",0,1,-1
"33737","4903聯光通","110/07/09","大昌",0,0,0
"33738","4903聯光通","110/07/09","大昌",0,0,0
"33739","4903聯光通","110/07/09","中農",0,0,0
"33740","4903聯光通","110/07/09","中農",0,0,0
"33741","4903聯光通","110/07/09","",NA,NA,NA
"33742","4903聯光通","110/07/09","",NA,NA,NA
"33743","4903聯光通","110/07/09","",NA,NA,NA
"33744","4903聯光通","110/07/09","",NA,NA,NA
"33745","4903聯光通","110/07/09","",NA,NA,NA
"33746","4903聯光通","110/07/09","",NA,NA,NA
"33747","4903聯光通","110/07/09","",NA,NA,NA
"33748","4903聯光通","110/07/09","",NA,NA,NA
"33749","4903聯光通","110/07/09","",NA,NA,NA
"33750","4903聯光通","110/07/09","",NA,NA,NA
"33751","2929淘帝","110/07/09","台中銀-台北",110,0,110
"33752","2929淘帝","110/07/09","新光",2,82,-80
"33753","2929淘帝","110/07/09","華南永昌-頭份",72,0,72
"33754","2929淘帝","110/07/09","摩根大通",2,63,-61
"33755","2929淘帝","110/07/09","合庫-高雄",71,0,71
"33756","2929淘帝","110/07/09","第一金-路竹",0,50,-50
"33757","2929淘帝","110/07/09","高橋-龍潭",37,0,37
"33758","2929淘帝","110/07/09","港商麥格理",0,42,-42
"33759","2929淘帝","110/07/09","新光-台中",60,26,34
"33760","2929淘帝","110/07/09","陽信-石牌",0,40,-40
"33761","2929淘帝","110/07/09","元富-大裕",22,1,21
"33762","2929淘帝","110/07/09","台新-左楠",1,39,-38
"33763","2929淘帝","110/07/09","合庫-鳳山",20,0,20
"33764","2929淘帝","110/07/09","凱基-桃園",3,29,-26
"33765","2929淘帝","110/07/09","元大-員林",22,2,20
"33766","2929淘帝","110/07/09","兆豐-內湖",0,25,-25
"33767","2929淘帝","110/07/09","台新-建北",15,0,15
"33768","2929淘帝","110/07/09","元大-北港",0,20,-20
"33769","2929淘帝","110/07/09","兆豐-桃園",13,0,13
"33770","2929淘帝","110/07/09","富邦-北港",0,19,-19
"33771","2929淘帝","110/07/09","兆豐-忠孝",10,0,10
"33772","2929淘帝","110/07/09","富邦-花蓮",0,17,-17
"33773","2929淘帝","110/07/09","國票-敦北法人",10,0,10
"33774","2929淘帝","110/07/09","國泰-台中",2,17,-15
"33775","2929淘帝","110/07/09","永豐金-博愛",10,0,10
"33776","2929淘帝","110/07/09","群益金鼎-彰化",0,15,-15
"33777","2929淘帝","110/07/09","群益金鼎-潭子",8,0,8
"33778","2929淘帝","110/07/09","元大-博愛",0,14,-14
"33779","2929淘帝","110/07/09","富邦-南屯",8,0,8
"33780","2929淘帝","110/07/09","日盛-板橋",0,13,-13
"33781","5410國眾","110/07/09","元大-新盛",14,0,14
"33782","5410國眾","110/07/09","(牛牛牛)亞-鑫豐",1,41,-40
"33783","5410國眾","110/07/09","台灣企銀-民雄",10,0,10
"33784","5410國眾","110/07/09","元富-嘉義",0,25,-25
"33785","5410國眾","110/07/09","元富-虎尾",9,0,9
"33786","5410國眾","110/07/09","凱基-高美館",0,10,-10
"33787","5410國眾","110/07/09","摩根大通",10,1,9
"33788","5410國眾","110/07/09","凱基-城中",0,10,-10
"33789","5410國眾","110/07/09","兆豐-北高雄",7,0,7
"33790","5410國眾","110/07/09","元大-頭份",0,10,-10
"33791","5410國眾","110/07/09","凱基-台北",8,1,7
"33792","5410國眾","110/07/09","群益金鼎-丹鳳",0,7,-7
"33793","5410國眾","110/07/09","華南永昌-公誠",7,0,7
"33794","5410國眾","110/07/09","凱基-復興",0,7,-7
"33795","5410國眾","110/07/09","香港上海匯豐",6,0,6
"33796","5410國眾","110/07/09","元大-員林",0,7,-7
"33797","5410國眾","110/07/09","凱基-中壢",6,0,6
"33798","5410國眾","110/07/09","富邦-竹東",0,6,-6
"33799","5410國眾","110/07/09","華南永昌-南京",6,0,6
"33800","5410國眾","110/07/09","亞東-高雄",0,5,-5
"33801","5410國眾","110/07/09","統一-三重",5,0,5
"33802","5410國眾","110/07/09","大慶-中壢",1,6,-5
"33803","5410國眾","110/07/09","富邦-宜蘭",5,0,5
"33804","5410國眾","110/07/09","群益金鼎-中港",0,5,-5
"33805","5410國眾","110/07/09","元大-崇德",5,0,5
"33806","5410國眾","110/07/09","元大-八德",0,5,-5
"33807","5410國眾","110/07/09","元大-博愛",5,0,5
"33808","5410國眾","110/07/09","富邦-基隆",0,4,-4
"33809","5410國眾","110/07/09","元大-龍潭",5,0,5
"33810","5410國眾","110/07/09","臺銀-新竹",0,3,-3
"33811","2841台開","110/07/09","日盛-雙和",102,0,102
"33812","2841台開","110/07/09","港商野村",0,129,-129
"33813","2841台開","110/07/09","元大-館前",70,0,70
"33814","2841台開","110/07/09","兆豐-永和",0,100,-100
"33815","2841台開","110/07/09","凱基-文心",50,0,50
"33816","2841台開","110/07/09","台新證券",7,28,-21
"33817","2841台開","110/07/09","富邦-嘉義",40,0,40
"33818","2841台開","110/07/09","國票-北高雄",0,20,-20
"33819","2841台開","110/07/09","美商高盛",15,0,15
"33820","2841台開","110/07/09","永豐金-敦南",29,46,-17
"33821","2841台開","110/07/09","台中銀",15,0,15
"33822","2841台開","110/07/09","合庫-基隆",0,12,-12
"33823","2841台開","110/07/09","新光",11,0,11
"33824","2841台開","110/07/09","中國信託-松江",0,12,-12
"33825","2841台開","110/07/09","華南永昌-長虹",10,0,10
"33826","2841台開","110/07/09","兆豐-城中",0,12,-12
"33827","2841台開","110/07/09","永豐金-南投",10,0,10
"33828","2841台開","110/07/09","台中銀-豐原",0,10,-10
"33829","2841台開","110/07/09","合庫-桃園",7,0,7
"33830","2841台開","110/07/09","兆豐-景美",0,10,-10
"33831","2841台開","110/07/09","群益金鼎-古亭",7,0,7
"33832","2841台開","110/07/09","群益金鼎-基隆",0,10,-10
"33833","2841台開","110/07/09","國泰-敦南",6,0,6
"33834","2841台開","110/07/09","元大-北三重",0,10,-10
"33835","2841台開","110/07/09","凱基-桃園",8,2,6
"33836","2841台開","110/07/09","(牛牛牛)亞-網路",0,9,-9
"33837","2841台開","110/07/09","日盛證券",5,0,5
"33838","2841台開","110/07/09","台新-高雄",1,10,-9
"33839","2841台開","110/07/09","元富-文心",5,0,5
"33840","2841台開","110/07/09","凱基-台北",0,7,-7
"33841","6207雷科","110/07/09","群益金鼎-新竹",47,0,47
"33842","6207雷科","110/07/09","新光",7,24,-17
"33843","6207雷科","110/07/09","永豐金-三重",31,0,31
"33844","6207雷科","110/07/09","日盛-和美",0,15,-15
"33845","6207雷科","110/07/09","新加坡商瑞銀",33,5,28
"33846","6207雷科","110/07/09","國泰-台南",0,15,-15
"33847","6207雷科","110/07/09","元大-高雄",26,0,26
"33848","6207雷科","110/07/09","華南永昌-古亭",0,14,-14
"33849","6207雷科","110/07/09","統一-員林",22,0,22
"33850","6207雷科","110/07/09","土銀-白河",0,11,-11
"33851","6207雷科","110/07/09","台新-高雄",22,0,22
"33852","6207雷科","110/07/09","日盛-台南",0,10,-10
"33853","6207雷科","110/07/09","摩根大通",34,17,17
"33854","6207雷科","110/07/09","元富-林園",0,10,-10
"33855","6207雷科","110/07/09","元大-博愛",17,1,16
"33856","6207雷科","110/07/09","富邦-園區",0,10,-10
"33857","6207雷科","110/07/09","日茂-埔里",12,0,12
"33858","6207雷科","110/07/09","元大-上新莊",0,10,-10
"33859","6207雷科","110/07/09","國泰-台中",17,6,11
"33860","6207雷科","110/07/09","永豐金-南京",0,10,-10
"33861","6207雷科","110/07/09","富邦-三重",10,0,10
"33862","6207雷科","110/07/09","兆豐-小港",0,6,-6
"33863","6207雷科","110/07/09","元大-沙鹿",10,0,10
"33864","6207雷科","110/07/09","富邦-羅東",1,7,-6
"33865","6207雷科","110/07/09","元大-八德",10,0,10
"33866","6207雷科","110/07/09","元大-土城永寧",0,6,-6
"33867","6207雷科","110/07/09","第一金-路竹",11,2,9
"33868","6207雷科","110/07/09","永豐金-板盛",0,6,-6
"33869","6207雷科","110/07/09","統一-南京",5,0,5
"33870","6207雷科","110/07/09","日盛-板橋",0,5,-5
"33871","3679新至陞","110/07/09","元大-大天母",10,0,10
"33872","3679新至陞","110/07/09","第一金-光復",0,11,-11
"33873","3679新至陞","110/07/09","日盛-樹林",9,0,9
"33874","3679新至陞","110/07/09","瑞士信貸",0,8,-8
"33875","3679新至陞","110/07/09","凱基-台北",11,2,9
"33876","3679新至陞","110/07/09","大慶-苗栗",0,5,-5
"33877","3679新至陞","110/07/09","華南永昌-小港",8,0,8
"33878","3679新至陞","110/07/09","元大-永春",0,5,-5
"33879","3679新至陞","110/07/09","兆豐-來福",7,0,7
"33880","3679新至陞","110/07/09","日盛-和美",0,4,-4
"33881","3679新至陞","110/07/09","香港上海匯豐",5,0,5
"33882","3679新至陞","110/07/09","元大-雙和",0,3,-3
"33883","3679新至陞","110/07/09","台中銀-員林",3,0,3
"33884","3679新至陞","110/07/09","永豐金-屏東",0,3,-3
"33885","3679新至陞","110/07/09","新光",3,0,3
"33886","3679新至陞","110/07/09","彰銀",0,2,-2
"33887","3679新至陞","110/07/09","土銀-花蓮",2,0,2
"33888","3679新至陞","110/07/09","宏遠-館前",0,2,-2
"33889","3679新至陞","110/07/09","第一金-澎湖",2,0,2
"33890","3679新至陞","110/07/09","港商野村",0,2,-2
"33891","3679新至陞","110/07/09","摩根大通",2,0,2
"33892","3679新至陞","110/07/09","大昌-新店",0,2,-2
"33893","3679新至陞","110/07/09","國泰-敦南",2,0,2
"33894","3679新至陞","110/07/09","元大-新莊",0,2,-2
"33895","3679新至陞","110/07/09","元大-淡水",4,2,2
"33896","3679新至陞","110/07/09","元大-板橋",0,2,-2
"33897","3679新至陞","110/07/09","日盛-士林",1,0,1
"33898","3679新至陞","110/07/09","台灣摩根士丹利",0,1,-1
"33899","3679新至陞","110/07/09","日盛-信義",1,0,1
"33900","3679新至陞","110/07/09","第一金-高雄",0,1,-1
"33901","2727王品","110/07/09","台灣匯立證券",90,0,90
"33902","2727王品","110/07/09","台灣摩根士丹利",0,267,-267
"33903","2727王品","110/07/09","國泰-敦南",166,84,82
"33904","2727王品","110/07/09","富邦-台北",35,299,-264
"33905","2727王品","110/07/09","富邦-仁愛",56,12,44
"33906","2727王品","110/07/09","凱基-台北",174,296,-122
"33907","2727王品","110/07/09","台新證券",109,66,43
"33908","2727王品","110/07/09","第一金",2,102,-100
"33909","2727王品","110/07/09","新光",117,87,30
"33910","2727王品","110/07/09","群益金鼎-大安",0,80,-80
"33911","2727王品","110/07/09","臺銀-臺中",35,6,29
"33912","2727王品","110/07/09","兆豐-大安",7,60,-53
"33913","2727王品","110/07/09","元大-桃園",32,3,29
"33914","2727王品","110/07/09","永豐金-南投",0,50,-50
"33915","2727王品","110/07/09","元富-宜蘭",34,6,28
"33916","2727王品","110/07/09","新加坡商瑞銀",6,46,-40
"33917","2727王品","110/07/09","玉山-台中",34,8,26
"33918","2727王品","110/07/09","合庫-彰化",11,50,-39
"33919","2727王品","110/07/09","群益金鼎-宜蘭",30,4,26
"33920","2727王品","110/07/09","永豐金-萬盛",13,52,-39
"33921","2727王品","110/07/09","富邦-台中",42,16,26
"33922","2727王品","110/07/09","瑞士信貸",0,34,-34
"33923","2727王品","110/07/09","第一金-豐原",25,1,24
"33924","2727王品","110/07/09","元大-和平",4,35,-31
"33925","2727王品","110/07/09","臺銀",30,8,22
"33926","2727王品","110/07/09","美林",14,44,-30
"33927","2727王品","110/07/09","兆豐-來福",23,1,22
"33928","2727王品","110/07/09","元大-員林",9,38,-29
"33929","2727王品","110/07/09","玉山-士林",22,2,20
"33930","2727王品","110/07/09","元富-西松",4,31,-27
"33931","1570力肯","110/07/09","凱基-台北",30,1,29
"33932","1570力肯","110/07/09","群益金鼎-彰化",0,20,-20
"33933","1570力肯","110/07/09","新光-台南",20,0,20
"33934","1570力肯","110/07/09","元大-土城學府",0,20,-20
"33935","1570力肯","110/07/09","元大-高雄",20,0,20
"33936","1570力肯","110/07/09","元大-大統",0,16,-16
"33937","1570力肯","110/07/09","國票-中正",12,0,12
"33938","1570力肯","110/07/09","元大-新營",0,11,-11
"33939","1570力肯","110/07/09","日盛-高雄",6,0,6
"33940","1570力肯","110/07/09","元大-和平",0,10,-10
"33941","1570力肯","110/07/09","元富-緯城",6,0,6
"33942","1570力肯","110/07/09","元大-草屯",0,10,-10
"33943","1570力肯","110/07/09","群益金鼎-台南",6,0,6
"33944","1570力肯","110/07/09","元大-鹿港",0,9,-9
"33945","1570力肯","110/07/09","華南永昌-岡山",6,0,6
"33946","1570力肯","110/07/09","合庫-基隆",0,7,-7
"33947","1570力肯","110/07/09","統一-中壢",5,0,5
"33948","1570力肯","110/07/09","摩根大通",2,8,-6
"33949","1570力肯","110/07/09","凱基-三峽",5,0,5
"33950","1570力肯","110/07/09","台灣企銀-豐原",0,4,-4
"33951","1570力肯","110/07/09","大昌-樹林",4,0,4
"33952","1570力肯","110/07/09","日盛-桃園",0,4,-4
"33953","1570力肯","110/07/09","新光",3,0,3
"33954","1570力肯","110/07/09","國泰-高雄",0,3,-3
"33955","1570力肯","110/07/09","富邦-新竹華信",3,0,3
"33956","1570力肯","110/07/09","永豐金-敦南",0,3,-3
"33957","1570力肯","110/07/09","合庫-台中",2,0,2
"33958","1570力肯","110/07/09","土銀-彰化",0,2,-2
"33959","1570力肯","110/07/09","臺銀-臺中",2,0,2
"33960","1570力肯","110/07/09","臺銀-鳳山",0,2,-2
"33961","6180橘子","110/07/09","摩根大通",63,1,62
"33962","6180橘子","110/07/09","元大-南京",1,32,-31
"33963","6180橘子","110/07/09","富邦-陽明",73,33,40
"33964","6180橘子","110/07/09","群益金鼎-台北",0,25,-25
"33965","6180橘子","110/07/09","新加坡商瑞銀",31,0,31
"33966","6180橘子","110/07/09","兆豐-復興",0,21,-21
"33967","6180橘子","110/07/09","美商高盛",25,0,25
"33968","6180橘子","110/07/09","永豐金-嘉義",0,21,-21
"33969","6180橘子","110/07/09","凱基-台北",26,10,16
"33970","6180橘子","110/07/09","凱基-中壢",8,24,-16
"33971","6180橘子","110/07/09","華南永昌-楠梓",13,0,13
"33972","6180橘子","110/07/09","致和-崇德",0,15,-15
"33973","6180橘子","110/07/09","華南永昌-朴子",11,0,11
"33974","6180橘子","110/07/09","群益金鼎-屏東",0,15,-15
"33975","6180橘子","110/07/09","元大-北港",11,0,11
"33976","6180橘子","110/07/09","群益金鼎-中山",0,15,-15
"33977","6180橘子","110/07/09","元大-成功",10,1,9
"33978","6180橘子","110/07/09","瑞士信貸",1,15,-14
"33979","6180橘子","110/07/09","新光",26,18,8
"33980","6180橘子","110/07/09","日盛-二林",0,10,-10
"33981","6180橘子","110/07/09","統一-三重",6,0,6
"33982","6180橘子","110/07/09","凱基-東門",0,10,-10
"33983","6180橘子","110/07/09","群益金鼎-嘉義",6,0,6
"33984","6180橘子","110/07/09","華南永昌-三重",0,10,-10
"33985","6180橘子","110/07/09","元大-員林中山",6,0,6
"33986","6180橘子","110/07/09","元大-彰化民生",1,11,-10
"33987","6180橘子","110/07/09","合庫-鳳山",5,0,5
"33988","6180橘子","110/07/09","永豐金-新店",1,11,-10
"33989","6180橘子","110/07/09","富邦-建國",6,1,5
"33990","6180橘子","110/07/09","群益金鼎-丹鳳",0,8,-8
"33991","2390云辰","110/07/09","摩根大通",279,56,223
"33992","2390云辰","110/07/09","元大-天母",0,127,-127
"33993","2390云辰","110/07/09","日盛-鳳山",110,2,108
"33994","2390云辰","110/07/09","中國信託-文心",5,109,-104
"33995","2390云辰","110/07/09","宏遠證券",100,0,100
"33996","2390云辰","110/07/09","永豐金-復興",0,55,-55
"33997","2390云辰","110/07/09","元大-大里",63,6,57
"33998","2390云辰","110/07/09","凱基-台北",239,286,-47
"33999","2390云辰","110/07/09","凱基-八德",59,10,49
"34000","2390云辰","110/07/09","德信",2,32,-30
"34001","2390云辰","110/07/09","合庫-新竹",40,0,40
"34002","2390云辰","110/07/09","兆豐-桃鶯",2,32,-30
"34003","2390云辰","110/07/09","國票",40,1,39
"34004","2390云辰","110/07/09","致和-南京",0,30,-30
"34005","2390云辰","110/07/09","新加坡商瑞銀",49,13,36
"34006","2390云辰","110/07/09","富邦-虎尾",1,31,-30
"34007","2390云辰","110/07/09","統一-新台中",36,2,34
"34008","2390云辰","110/07/09","元大-善化",2,31,-29
"34009","2390云辰","110/07/09","國票-嘉義",31,0,31
"34010","2390云辰","110/07/09","富邦-板橋",0,27,-27
"34011","2390云辰","110/07/09","華南永昌",35,7,28
"34012","2390云辰","110/07/09","富邦-永和",3,28,-25
"34013","2390云辰","110/07/09","玉山-台中",49,22,27
"34014","2390云辰","110/07/09","第一金-自由",20,44,-24
"34015","2390云辰","110/07/09","華南永昌-敦南",25,0,25
"34016","2390云辰","110/07/09","凱基-內湖",0,24,-24
"34017","2390云辰","110/07/09","新光-高雄",27,4,23
"34018","2390云辰","110/07/09","元大-汐止",1,24,-23
"34019","2390云辰","110/07/09","台灣摩根士丹利",85,63,22
"34020","2390云辰","110/07/09","新光-台中",12,33,-21
"34021","4903聯光通","110/07/09","元大-敦南",10,0,10
"34022","4903聯光通","110/07/09","第一金-台中",0,12,-12
"34023","4903聯光通","110/07/09","凱基-士林",5,0,5
"34024","4903聯光通","110/07/09","日盛-忠孝",0,3,-3
"34025","4903聯光通","110/07/09","元大-苗栗",5,0,5
"34026","4903聯光通","110/07/09","群益金鼎-崇德",0,3,-3
"34027","4903聯光通","110/07/09","元大-屏南",3,0,3
"34028","4903聯光通","110/07/09","國票-內壢",0,2,-2
"34029","4903聯光通","110/07/09","中國信託-永康",1,0,1
"34030","4903聯光通","110/07/09","康和-南崁",0,2,-2
"34031","4903聯光通","110/07/09","玉山證券",1,0,1
"34032","4903聯光通","110/07/09","新光-台中",0,2,-2
"34033","4903聯光通","110/07/09","元大-太平",4,3,1
"34034","4903聯光通","110/07/09","玉山-城中",0,2,-2
"34035","4903聯光通","110/07/09","永豐金-嘉義",1,0,1
"34036","4903聯光通","110/07/09","中國信託-文心",0,1,-1
"34037","4903聯光通","110/07/09","大昌",0,0,0
"34038","4903聯光通","110/07/09","大昌",0,0,0
"34039","4903聯光通","110/07/09","中農",0,0,0
"34040","4903聯光通","110/07/09","中農",0,0,0
"34041","2929淘帝","110/07/09","台中銀-台北",110,0,110
"34042","2929淘帝","110/07/09","新光",2,82,-80
"34043","2929淘帝","110/07/09","華南永昌-頭份",72,0,72
"34044","2929淘帝","110/07/09","摩根大通",2,63,-61
"34045","2929淘帝","110/07/09","合庫-高雄",71,0,71
"34046","2929淘帝","110/07/09","第一金-路竹",0,50,-50
"34047","2929淘帝","110/07/09","高橋-龍潭",37,0,37
"34048","2929淘帝","110/07/09","港商麥格理",0,42,-42
"34049","2929淘帝","110/07/09","新光-台中",60,26,34
"34050","2929淘帝","110/07/09","陽信-石牌",0,40,-40
"34051","2929淘帝","110/07/09","元富-大裕",22,1,21
"34052","2929淘帝","110/07/09","台新-左楠",1,39,-38
"34053","2929淘帝","110/07/09","合庫-鳳山",20,0,20
"34054","2929淘帝","110/07/09","凱基-桃園",3,29,-26
"34055","2929淘帝","110/07/09","元大-員林",22,2,20
"34056","2929淘帝","110/07/09","兆豐-內湖",0,25,-25
"34057","2929淘帝","110/07/09","台新-建北",15,0,15
"34058","2929淘帝","110/07/09","元大-北港",0,20,-20
"34059","2929淘帝","110/07/09","兆豐-桃園",13,0,13
"34060","2929淘帝","110/07/09","富邦-北港",0,19,-19
"34061","2929淘帝","110/07/09","兆豐-忠孝",10,0,10
"34062","2929淘帝","110/07/09","富邦-花蓮",0,17,-17
"34063","2929淘帝","110/07/09","國票-敦北法人",10,0,10
"34064","2929淘帝","110/07/09","國泰-台中",2,17,-15
"34065","2929淘帝","110/07/09","永豐金-博愛",10,0,10
"34066","2929淘帝","110/07/09","群益金鼎-彰化",0,15,-15
"34067","2929淘帝","110/07/09","群益金鼎-潭子",8,0,8
"34068","2929淘帝","110/07/09","元大-博愛",0,14,-14
"34069","2929淘帝","110/07/09","富邦-南屯",8,0,8
"34070","2929淘帝","110/07/09","日盛-板橋",0,13,-13
"34071","5410國眾","110/07/09","元大-新盛",14,0,14
"34072","5410國眾","110/07/09","(牛牛牛)亞-鑫豐",1,41,-40
"34073","5410國眾","110/07/09","台灣企銀-民雄",10,0,10
"34074","5410國眾","110/07/09","元富-嘉義",0,25,-25
"34075","5410國眾","110/07/09","元富-虎尾",9,0,9
"34076","5410國眾","110/07/09","凱基-高美館",0,10,-10
"34077","5410國眾","110/07/09","摩根大通",10,1,9
"34078","5410國眾","110/07/09","凱基-城中",0,10,-10
"34079","5410國眾","110/07/09","兆豐-北高雄",7,0,7
"34080","5410國眾","110/07/09","元大-頭份",0,10,-10
"34081","5410國眾","110/07/09","凱基-台北",8,1,7
"34082","5410國眾","110/07/09","群益金鼎-丹鳳",0,7,-7
"34083","5410國眾","110/07/09","華南永昌-公誠",7,0,7
"34084","5410國眾","110/07/09","凱基-復興",0,7,-7
"34085","5410國眾","110/07/09","香港上海匯豐",6,0,6
"34086","5410國眾","110/07/09","元大-員林",0,7,-7
"34087","5410國眾","110/07/09","凱基-中壢",6,0,6
"34088","5410國眾","110/07/09","富邦-竹東",0,6,-6
"34089","5410國眾","110/07/09","華南永昌-南京",6,0,6
"34090","5410國眾","110/07/09","亞東-高雄",0,5,-5
"34091","5410國眾","110/07/09","統一-三重",5,0,5
"34092","5410國眾","110/07/09","大慶-中壢",1,6,-5
"34093","5410國眾","110/07/09","富邦-宜蘭",5,0,5
"34094","5410國眾","110/07/09","群益金鼎-中港",0,5,-5
"34095","5410國眾","110/07/09","元大-崇德",5,0,5
"34096","5410國眾","110/07/09","元大-八德",0,5,-5
"34097","5410國眾","110/07/09","元大-博愛",5,0,5
"34098","5410國眾","110/07/09","富邦-基隆",0,4,-4
"34099","5410國眾","110/07/09","元大-龍潭",5,0,5
"34100","5410國眾","110/07/09","臺銀-新竹",0,3,-3
"34101","2841台開","110/07/09","日盛-雙和",102,0,102
"34102","2841台開","110/07/09","港商野村",0,129,-129
"34103","2841台開","110/07/09","元大-館前",70,0,70
"34104","2841台開","110/07/09","兆豐-永和",0,100,-100
"34105","2841台開","110/07/09","凱基-文心",50,0,50
"34106","2841台開","110/07/09","台新證券",7,28,-21
"34107","2841台開","110/07/09","富邦-嘉義",40,0,40
"34108","2841台開","110/07/09","國票-北高雄",0,20,-20
"34109","2841台開","110/07/09","美商高盛",15,0,15
"34110","2841台開","110/07/09","永豐金-敦南",29,46,-17
"34111","2841台開","110/07/09","台中銀",15,0,15
"34112","2841台開","110/07/09","合庫-基隆",0,12,-12
"34113","2841台開","110/07/09","新光",11,0,11
"34114","2841台開","110/07/09","中國信託-松江",0,12,-12
"34115","2841台開","110/07/09","華南永昌-長虹",10,0,10
"34116","2841台開","110/07/09","兆豐-城中",0,12,-12
"34117","2841台開","110/07/09","永豐金-南投",10,0,10
"34118","2841台開","110/07/09","台中銀-豐原",0,10,-10
"34119","2841台開","110/07/09","合庫-桃園",7,0,7
"34120","2841台開","110/07/09","兆豐-景美",0,10,-10
"34121","2841台開","110/07/09","群益金鼎-古亭",7,0,7
"34122","2841台開","110/07/09","群益金鼎-基隆",0,10,-10
"34123","2841台開","110/07/09","國泰-敦南",6,0,6
"34124","2841台開","110/07/09","元大-北三重",0,10,-10
"34125","2841台開","110/07/09","凱基-桃園",8,2,6
"34126","2841台開","110/07/09","(牛牛牛)亞-網路",0,9,-9
"34127","2841台開","110/07/09","日盛證券",5,0,5
"34128","2841台開","110/07/09","台新-高雄",1,10,-9
"34129","2841台開","110/07/09","元富-文心",5,0,5
"34130","2841台開","110/07/09","凱基-台北",0,7,-7
"34131","6207雷科","110/07/09","群益金鼎-新竹",47,0,47
"34132","6207雷科","110/07/09","新光",7,24,-17
"34133","6207雷科","110/07/09","永豐金-三重",31,0,31
"34134","6207雷科","110/07/09","日盛-和美",0,15,-15
"34135","6207雷科","110/07/09","新加坡商瑞銀",33,5,28
"34136","6207雷科","110/07/09","國泰-台南",0,15,-15
"34137","6207雷科","110/07/09","元大-高雄",26,0,26
"34138","6207雷科","110/07/09","華南永昌-古亭",0,14,-14
"34139","6207雷科","110/07/09","統一-員林",22,0,22
"34140","6207雷科","110/07/09","土銀-白河",0,11,-11
"34141","6207雷科","110/07/09","台新-高雄",22,0,22
"34142","6207雷科","110/07/09","日盛-台南",0,10,-10
"34143","6207雷科","110/07/09","摩根大通",34,17,17
"34144","6207雷科","110/07/09","元富-林園",0,10,-10
"34145","6207雷科","110/07/09","元大-博愛",17,1,16
"34146","6207雷科","110/07/09","富邦-園區",0,10,-10
"34147","6207雷科","110/07/09","日茂-埔里",12,0,12
"34148","6207雷科","110/07/09","元大-上新莊",0,10,-10
"34149","6207雷科","110/07/09","國泰-台中",17,6,11
"34150","6207雷科","110/07/09","永豐金-南京",0,10,-10
"34151","6207雷科","110/07/09","富邦-三重",10,0,10
"34152","6207雷科","110/07/09","兆豐-小港",0,6,-6
"34153","6207雷科","110/07/09","元大-沙鹿",10,0,10
"34154","6207雷科","110/07/09","富邦-羅東",1,7,-6
"34155","6207雷科","110/07/09","元大-八德",10,0,10
"34156","6207雷科","110/07/09","元大-土城永寧",0,6,-6
"34157","6207雷科","110/07/09","第一金-路竹",11,2,9
"34158","6207雷科","110/07/09","永豐金-板盛",0,6,-6
"34159","6207雷科","110/07/09","統一-南京",5,0,5
"34160","6207雷科","110/07/09","日盛-板橋",0,5,-5
"34161","3679新至陞","110/07/09","元大-大天母",10,0,10
"34162","3679新至陞","110/07/09","第一金-光復",0,11,-11
"34163","3679新至陞","110/07/09","日盛-樹林",9,0,9
"34164","3679新至陞","110/07/09","瑞士信貸",0,8,-8
"34165","3679新至陞","110/07/09","凱基-台北",11,2,9
"34166","3679新至陞","110/07/09","大慶-苗栗",0,5,-5
"34167","3679新至陞","110/07/09","華南永昌-小港",8,0,8
"34168","3679新至陞","110/07/09","元大-永春",0,5,-5
"34169","3679新至陞","110/07/09","兆豐-來福",7,0,7
"34170","3679新至陞","110/07/09","日盛-和美",0,4,-4
"34171","3679新至陞","110/07/09","香港上海匯豐",5,0,5
"34172","3679新至陞","110/07/09","元大-雙和",0,3,-3
"34173","3679新至陞","110/07/09","台中銀-員林",3,0,3
"34174","3679新至陞","110/07/09","永豐金-屏東",0,3,-3
"34175","3679新至陞","110/07/09","新光",3,0,3
"34176","3679新至陞","110/07/09","彰銀",0,2,-2
"34177","3679新至陞","110/07/09","土銀-花蓮",2,0,2
"34178","3679新至陞","110/07/09","宏遠-館前",0,2,-2
"34179","3679新至陞","110/07/09","第一金-澎湖",2,0,2
"34180","3679新至陞","110/07/09","港商野村",0,2,-2
"34181","3679新至陞","110/07/09","摩根大通",2,0,2
"34182","3679新至陞","110/07/09","大昌-新店",0,2,-2
"34183","3679新至陞","110/07/09","國泰-敦南",2,0,2
"34184","3679新至陞","110/07/09","元大-新莊",0,2,-2
"34185","3679新至陞","110/07/09","元大-淡水",4,2,2
"34186","3679新至陞","110/07/09","元大-板橋",0,2,-2
"34187","3679新至陞","110/07/09","日盛-士林",1,0,1
"34188","3679新至陞","110/07/09","台灣摩根士丹利",0,1,-1
"34189","3679新至陞","110/07/09","日盛-信義",1,0,1
"34190","3679新至陞","110/07/09","第一金-高雄",0,1,-1
"34191","2727王品","110/07/09","台灣匯立證券",90,0,90
"34192","2727王品","110/07/09","台灣摩根士丹利",0,267,-267
"34193","2727王品","110/07/09","國泰-敦南",166,84,82
"34194","2727王品","110/07/09","富邦-台北",35,299,-264
"34195","2727王品","110/07/09","富邦-仁愛",56,12,44
"34196","2727王品","110/07/09","凱基-台北",174,296,-122
"34197","2727王品","110/07/09","台新證券",109,66,43
"34198","2727王品","110/07/09","第一金",2,102,-100
"34199","2727王品","110/07/09","新光",117,87,30
"34200","2727王品","110/07/09","群益金鼎-大安",0,80,-80
"34201","2727王品","110/07/09","臺銀-臺中",35,6,29
"34202","2727王品","110/07/09","兆豐-大安",7,60,-53
"34203","2727王品","110/07/09","元大-桃園",32,3,29
"34204","2727王品","110/07/09","永豐金-南投",0,50,-50
"34205","2727王品","110/07/09","元富-宜蘭",34,6,28
"34206","2727王品","110/07/09","新加坡商瑞銀",6,46,-40
"34207","2727王品","110/07/09","玉山-台中",34,8,26
"34208","2727王品","110/07/09","合庫-彰化",11,50,-39
"34209","2727王品","110/07/09","群益金鼎-宜蘭",30,4,26
"34210","2727王品","110/07/09","永豐金-萬盛",13,52,-39
"34211","2727王品","110/07/09","富邦-台中",42,16,26
"34212","2727王品","110/07/09","瑞士信貸",0,34,-34
"34213","2727王品","110/07/09","第一金-豐原",25,1,24
"34214","2727王品","110/07/09","元大-和平",4,35,-31
"34215","2727王品","110/07/09","臺銀",30,8,22
"34216","2727王品","110/07/09","美林",14,44,-30
"34217","2727王品","110/07/09","兆豐-來福",23,1,22
"34218","2727王品","110/07/09","元大-員林",9,38,-29
"34219","2727王品","110/07/09","玉山-士林",22,2,20
"34220","2727王品","110/07/09","元富-西松",4,31,-27
"34221","1570力肯","110/07/09","凱基-台北",30,1,29
"34222","1570力肯","110/07/09","群益金鼎-彰化",0,20,-20
"34223","1570力肯","110/07/09","新光-台南",20,0,20
"34224","1570力肯","110/07/09","元大-土城學府",0,20,-20
"34225","1570力肯","110/07/09","元大-高雄",20,0,20
"34226","1570力肯","110/07/09","元大-大統",0,16,-16
"34227","1570力肯","110/07/09","國票-中正",12,0,12
"34228","1570力肯","110/07/09","元大-新營",0,11,-11
"34229","1570力肯","110/07/09","日盛-高雄",6,0,6
"34230","1570力肯","110/07/09","元大-和平",0,10,-10
"34231","1570力肯","110/07/09","元富-緯城",6,0,6
"34232","1570力肯","110/07/09","元大-草屯",0,10,-10
"34233","1570力肯","110/07/09","群益金鼎-台南",6,0,6
"34234","1570力肯","110/07/09","元大-鹿港",0,9,-9
"34235","1570力肯","110/07/09","華南永昌-岡山",6,0,6
"34236","1570力肯","110/07/09","合庫-基隆",0,7,-7
"34237","1570力肯","110/07/09","統一-中壢",5,0,5
"34238","1570力肯","110/07/09","摩根大通",2,8,-6
"34239","1570力肯","110/07/09","凱基-三峽",5,0,5
"34240","1570力肯","110/07/09","台灣企銀-豐原",0,4,-4
"34241","1570力肯","110/07/09","大昌-樹林",4,0,4
"34242","1570力肯","110/07/09","日盛-桃園",0,4,-4
"34243","1570力肯","110/07/09","新光",3,0,3
"34244","1570力肯","110/07/09","國泰-高雄",0,3,-3
"34245","1570力肯","110/07/09","富邦-新竹華信",3,0,3
"34246","1570力肯","110/07/09","永豐金-敦南",0,3,-3
"34247","1570力肯","110/07/09","合庫-台中",2,0,2
"34248","1570力肯","110/07/09","土銀-彰化",0,2,-2
"34249","1570力肯","110/07/09","臺銀-臺中",2,0,2
"34250","1570力肯","110/07/09","臺銀-鳳山",0,2,-2
"34251","6180橘子","110/07/09","摩根大通",63,1,62
"34252","6180橘子","110/07/09","元大-南京",1,32,-31
"34253","6180橘子","110/07/09","富邦-陽明",73,33,40
"34254","6180橘子","110/07/09","群益金鼎-台北",0,25,-25
"34255","6180橘子","110/07/09","新加坡商瑞銀",31,0,31
"34256","6180橘子","110/07/09","兆豐-復興",0,21,-21
"34257","6180橘子","110/07/09","美商高盛",25,0,25
"34258","6180橘子","110/07/09","永豐金-嘉義",0,21,-21
"34259","6180橘子","110/07/09","凱基-台北",26,10,16
"34260","6180橘子","110/07/09","凱基-中壢",8,24,-16
"34261","6180橘子","110/07/09","華南永昌-楠梓",13,0,13
"34262","6180橘子","110/07/09","致和-崇德",0,15,-15
"34263","6180橘子","110/07/09","華南永昌-朴子",11,0,11
"34264","6180橘子","110/07/09","群益金鼎-屏東",0,15,-15
"34265","6180橘子","110/07/09","元大-北港",11,0,11
"34266","6180橘子","110/07/09","群益金鼎-中山",0,15,-15
"34267","6180橘子","110/07/09","元大-成功",10,1,9
"34268","6180橘子","110/07/09","瑞士信貸",1,15,-14
"34269","6180橘子","110/07/09","新光",26,18,8
"34270","6180橘子","110/07/09","日盛-二林",0,10,-10
"34271","6180橘子","110/07/09","統一-三重",6,0,6
"34272","6180橘子","110/07/09","凱基-東門",0,10,-10
"34273","6180橘子","110/07/09","群益金鼎-嘉義",6,0,6
"34274","6180橘子","110/07/09","華南永昌-三重",0,10,-10
"34275","6180橘子","110/07/09","元大-員林中山",6,0,6
"34276","6180橘子","110/07/09","元大-彰化民生",1,11,-10
"34277","6180橘子","110/07/09","合庫-鳳山",5,0,5
"34278","6180橘子","110/07/09","永豐金-新店",1,11,-10
"34279","6180橘子","110/07/09","富邦-建國",6,1,5
"34280","6180橘子","110/07/09","群益金鼎-丹鳳",0,8,-8
"34281","2390云辰","110/07/09","摩根大通",279,56,223
"34282","2390云辰","110/07/09","元大-天母",0,127,-127
"34283","2390云辰","110/07/09","日盛-鳳山",110,2,108
"34284","2390云辰","110/07/09","中國信託-文心",5,109,-104
"34285","2390云辰","110/07/09","宏遠證券",100,0,100
"34286","2390云辰","110/07/09","永豐金-復興",0,55,-55
"34287","2390云辰","110/07/09","元大-大里",63,6,57
"34288","2390云辰","110/07/09","凱基-台北",239,286,-47
"34289","2390云辰","110/07/09","凱基-八德",59,10,49
"34290","2390云辰","110/07/09","德信",2,32,-30
"34291","2390云辰","110/07/09","合庫-新竹",40,0,40
"34292","2390云辰","110/07/09","兆豐-桃鶯",2,32,-30
"34293","2390云辰","110/07/09","國票",40,1,39
"34294","2390云辰","110/07/09","致和-南京",0,30,-30
"34295","2390云辰","110/07/09","新加坡商瑞銀",49,13,36
"34296","2390云辰","110/07/09","富邦-虎尾",1,31,-30
"34297","2390云辰","110/07/09","統一-新台中",36,2,34
"34298","2390云辰","110/07/09","元大-善化",2,31,-29
"34299","2390云辰","110/07/09","國票-嘉義",31,0,31
"34300","2390云辰","110/07/09","富邦-板橋",0,27,-27
"34301","2390云辰","110/07/09","華南永昌",35,7,28
"34302","2390云辰","110/07/09","富邦-永和",3,28,-25
"34303","2390云辰","110/07/09","玉山-台中",49,22,27
"34304","2390云辰","110/07/09","第一金-自由",20,44,-24
"34305","2390云辰","110/07/09","華南永昌-敦南",25,0,25
"34306","2390云辰","110/07/09","凱基-內湖",0,24,-24
"34307","2390云辰","110/07/09","新光-高雄",27,4,23
"34308","2390云辰","110/07/09","元大-汐止",1,24,-23
"34309","2390云辰","110/07/09","台灣摩根士丹利",85,63,22
"34310","2390云辰","110/07/09","新光-台中",12,33,-21
"34311","4903聯光通","110/07/08","元富-新興",18,0,18
"34312","4903聯光通","110/07/08","中國信託-中壢",0,14,-14
"34313","4903聯光通","110/07/08","元大-苗栗",9,0,9
"34314","4903聯光通","110/07/08","彰銀",0,7,-7
"34315","4903聯光通","110/07/08","兆豐-鹿港",3,0,3
"34316","4903聯光通","110/07/08","中國信託-松江",0,5,-5
"34317","4903聯光通","110/07/08","群益金鼎-萬華",2,0,2
"34318","4903聯光通","110/07/08","光和",0,2,-2
"34319","4903聯光通","110/07/08","元大-屏南",1,0,1
"34320","4903聯光通","110/07/08","元大-鶯歌",0,2,-2
"34321","4903聯光通","110/07/08","華南永昌-新莊",0,0,0
"34322","4903聯光通","110/07/08","群益金鼎-館前",0,1,-1
"34323","4903聯光通","110/07/08","元大-羅東",0,0,0
"34324","4903聯光通","110/07/08","華南永昌",0,1,-1
"34325","4903聯光通","110/07/08","元大-太平",2,3,-1
"34326","4903聯光通","110/07/08","華南永昌-新莊",0,0,0
"34327","4903聯光通","110/07/08","元大-羅東",0,0,0
"34328","2929淘帝","110/07/08","日盛-園區",90,6,84
"34329","2929淘帝","110/07/08","元大-太平",1,111,-110
"34330","2929淘帝","110/07/08","華南永昌-頭份",54,0,54
"34331","2929淘帝","110/07/08","港商野村",31,106,-75
"34332","2929淘帝","110/07/08","美商高盛",50,0,50
"34333","2929淘帝","110/07/08","凱基-板橋",62,111,-49
"34334","2929淘帝","110/07/08","台中銀-台北",50,0,50
"34335","2929淘帝","110/07/08","新光-台中",30,78,-48
"34336","2929淘帝","110/07/08","臺銀-臺南",30,0,30
"34337","2929淘帝","110/07/08","元富-永和",1,41,-40
"34338","2929淘帝","110/07/08","永豐金-大園",42,12,30
"34339","2929淘帝","110/07/08","永豐金-鳳山",0,28,-28
"34340","2929淘帝","110/07/08","元富-三重",30,1,29
"34341","2929淘帝","110/07/08","元大-南崁",0,26,-26
"34342","2929淘帝","110/07/08","兆豐-桃鶯",29,0,29
"34343","2929淘帝","110/07/08","元大-花蓮",2,27,-25
"34344","2929淘帝","110/07/08","元大-承德",20,3,17
"34345","2929淘帝","110/07/08","元大-府城",0,24,-24
"34346","2929淘帝","110/07/08","新光-新竹",13,0,13
"34347","2929淘帝","110/07/08","新光",21,43,-22
"34348","2929淘帝","110/07/08","富邦-內湖",13,0,13
"34349","2929淘帝","110/07/08","臺銀-民權",0,20,-20
"34350","2929淘帝","110/07/08","國泰-板橋",13,1,12
"34351","2929淘帝","110/07/08","摩根大通",66,84,-18
"34352","2929淘帝","110/07/08","第一金-大稻埕",10,0,10
"34353","2929淘帝","110/07/08","凱基-台北",0,17,-17
"34354","2929淘帝","110/07/08","統一-汐止",10,0,10
"34355","2929淘帝","110/07/08","元大-博愛",6,23,-17
"34356","2929淘帝","110/07/08","元富-大裕",10,0,10
"34357","2929淘帝","110/07/08","永豐金-桃盛",0,16,-16
"34358","5410國眾","110/07/08","元大-新盛",15,0,15
"34359","5410國眾","110/07/08","元大-旗山",0,50,-50
"34360","5410國眾","110/07/08","元大-屏南",10,0,10
"34361","5410國眾","110/07/08","元大-頭份",0,14,-14
"34362","5410國眾","110/07/08","元大-成功",10,0,10
"34363","5410國眾","110/07/08","國泰-高雄",0,8,-8
"34364","5410國眾","110/07/08","元大-東泰",7,0,7
"34365","5410國眾","110/07/08","元大-小港",0,7,-7
"34366","5410國眾","110/07/08","富邦-陽明",6,0,6
"34367","5410國眾","110/07/08","統一-嘉義",0,5,-5
"34368","5410國眾","110/07/08","臺銀-金山",5,0,5
"34369","5410國眾","110/07/08","兆豐-台中港",0,5,-5
"34370","5410國眾","110/07/08","日盛-員林",5,0,5
"34371","5410國眾","110/07/08","凱基-屏東",0,5,-5
"34372","5410國眾","110/07/08","摩根大通",5,0,5
"34373","5410國眾","110/07/08","元大-八德",0,5,-5
"34374","5410國眾","110/07/08","富邦-桃園",5,0,5
"34375","5410國眾","110/07/08","元富-嘉義",0,4,-4
"34376","5410國眾","110/07/08","元富-大昌",4,0,4
"34377","5410國眾","110/07/08","玉山-雙和",0,4,-4
"34378","5410國眾","110/07/08","台新-台中",4,0,4
"34379","5410國眾","110/07/08","凱基-高美館",1,5,-4
"34380","5410國眾","110/07/08","華南永昌-小港",5,1,4
"34381","5410國眾","110/07/08","統一-員林",0,3,-3
"34382","5410國眾","110/07/08","元大-新竹",5,1,4
"34383","5410國眾","110/07/08","臺銀-鳳山",0,2,-2
"34384","5410國眾","110/07/08","元大-土城學府",4,0,4
"34385","5410國眾","110/07/08","亞東",0,2,-2
"34386","5410國眾","110/07/08","元大-新莊",4,0,4
"34387","5410國眾","110/07/08","新光",0,2,-2
"34388","2841台開","110/07/08","元大-樹林",653,0,653
"34389","2841台開","110/07/08","港商野村",0,868,-868
"34390","2841台開","110/07/08","台新證券",115,0,115
"34391","2841台開","110/07/08","群益金鼎-忠孝",0,100,-100
"34392","2841台開","110/07/08","永豐金-豐原",105,0,105
"34393","2841台開","110/07/08","宏遠-高雄",0,56,-56
"34394","2841台開","110/07/08","元富-新興",100,0,100
"34395","2841台開","110/07/08","新光",3,38,-35
"34396","2841台開","110/07/08","凱基-文心",50,0,50
"34397","2841台開","110/07/08","花旗環球",0,29,-29
"34398","2841台開","110/07/08","元大-八德",40,0,40
"34399","2841台開","110/07/08","富邦-仁愛",2,30,-28
"34400","2841台開","110/07/08","日盛-雙和",30,0,30
"34401","2841台開","110/07/08","元富-潮州",0,24,-24
"34402","2841台開","110/07/08","統一-竹南",30,0,30
"34403","2841台開","110/07/08","元大-沙鹿",0,20,-20
"34404","2841台開","110/07/08","凱基-台南",30,0,30
"34405","2841台開","110/07/08","元大-汐止",0,20,-20
"34406","2841台開","110/07/08","元大-福營",30,0,30
"34407","2841台開","110/07/08","合庫-嘉義",2,20,-18
"34408","2841台開","110/07/08","合庫-台中",22,0,22
"34409","2841台開","110/07/08","國泰-敦南",3,21,-18
"34410","2841台開","110/07/08","大昌-安康",28,10,18
"34411","2841台開","110/07/08","日盛-竹北",0,15,-15
"34412","2841台開","110/07/08","元大-斗信",15,0,15
"34413","2841台開","110/07/08","元大-三重",0,15,-15
"34414","2841台開","110/07/08","富邦-台北",13,0,13
"34415","2841台開","110/07/08","永豐金-敦南",45,60,-15
"34416","2841台開","110/07/08","合庫-桃園",10,0,10
"34417","2841台開","110/07/08","(牛牛牛)亞-網路",0,12,-12
"34418","6207雷科","110/07/08","台新-高雄",54,2,52
"34419","6207雷科","110/07/08","群益金鼎-丹鳳",0,60,-60
"34420","6207雷科","110/07/08","新光-台中",18,0,18
"34421","6207雷科","110/07/08","元大-頭份",1,56,-55
"34422","6207雷科","110/07/08","日盛-嘉義",16,0,16
"34423","6207雷科","110/07/08","國票-中和",0,30,-30
"34424","6207雷科","110/07/08","合庫-鳳山",15,0,15
"34425","6207雷科","110/07/08","凱基-台北",1,29,-28
"34426","6207雷科","110/07/08","臺銀-臺中",12,0,12
"34427","6207雷科","110/07/08","兆豐-板橋",0,25,-25
"34428","6207雷科","110/07/08","群益金鼎-土城",12,0,12
"34429","6207雷科","110/07/08","凱基-城中",4,25,-21
"34430","6207雷科","110/07/08","新光",25,14,11
"34431","6207雷科","110/07/08","日進",0,20,-20
"34432","6207雷科","110/07/08","凱基-中壢",11,0,11
"34433","6207雷科","110/07/08","台新證券",3,20,-17
"34434","6207雷科","110/07/08","台灣企銀",10,0,10
"34435","6207雷科","110/07/08","群益金鼎-中山",0,16,-16
"34436","6207雷科","110/07/08","第一金-新興",11,1,10
"34437","6207雷科","110/07/08","元大-東門",0,16,-16
"34438","6207雷科","110/07/08","元富-吉利",10,0,10
"34439","6207雷科","110/07/08","群益金鼎-大甲",0,13,-13
"34440","6207雷科","110/07/08","光和-和美",10,0,10
"34441","6207雷科","110/07/08","日盛-板橋",0,10,-10
"34442","6207雷科","110/07/08","永豐金-南京",10,0,10
"34443","6207雷科","110/07/08","日盛-中壢",0,10,-10
"34444","6207雷科","110/07/08","土銀",8,0,8
"34445","6207雷科","110/07/08","摩根大通",125,135,-10
"34446","6207雷科","110/07/08","中國信託-高雄",8,0,8
"34447","6207雷科","110/07/08","凱基-五股",0,10,-10
"34448","3679新至陞","110/07/08","華南永昌-台中",17,0,17
"34449","3679新至陞","110/07/08","大慶-蘆洲",0,10,-10
"34450","3679新至陞","110/07/08","國泰-桃園",6,0,6
"34451","3679新至陞","110/07/08","華南永昌-小港",0,7,-7
"34452","3679新至陞","110/07/08","元大-永春",6,0,6
"34453","3679新至陞","110/07/08","國泰-館前",0,3,-3
"34454","3679新至陞","110/07/08","香港上海匯豐",4,0,4
"34455","3679新至陞","110/07/08","元大-板橋",0,3,-3
"34456","3679新至陞","110/07/08","中國信託-新竹",3,0,3
"34457","3679新至陞","110/07/08","港商法國興業",0,2,-2
"34458","3679新至陞","110/07/08","國票-敦北法人",3,0,3
"34459","3679新至陞","110/07/08","第一金-忠孝",0,2,-2
"34460","3679新至陞","110/07/08","群益金鼎-台南",2,0,2
"34461","3679新至陞","110/07/08","元富-古亭",0,2,-2
"34462","3679新至陞","110/07/08","凱基",2,0,2
"34463","3679新至陞","110/07/08","摩根大通",1,3,-2
"34464","3679新至陞","110/07/08","凱基-台北",6,4,2
"34465","3679新至陞","110/07/08","富邦-板橋",0,2,-2
"34466","3679新至陞","110/07/08","日盛-信義",1,0,1
"34467","3679新至陞","110/07/08","元大-文心興安",0,2,-2
"34468","3679新至陞","110/07/08","日盛-新莊",1,0,1
"34469","3679新至陞","110/07/08","臺銀-高雄",0,1,-1
"34470","3679新至陞","110/07/08","大慶",1,0,1
"34471","3679新至陞","110/07/08","日盛-高雄",0,1,-1
"34472","3679新至陞","110/07/08","兆豐-三重",1,0,1
"34473","3679新至陞","110/07/08","日盛-文化",0,1,-1
"34474","3679新至陞","110/07/08","致和-東門",1,0,1
"34475","3679新至陞","110/07/08","美商高盛",0,1,-1
"34476","3679新至陞","110/07/08","台新證券",1,0,1
"34477","3679新至陞","110/07/08","瑞士信貸",0,1,-1
"34478","2727王品","110/07/08","群益金鼎-大安",80,0,80
"34479","2727王品","110/07/08","台灣摩根士丹利",1,300,-299
"34480","2727王品","110/07/08","富邦-台北",237,165,72
"34481","2727王品","110/07/08","元大證券",173,439,-266
"34482","2727王品","110/07/08","永豐金-萬盛",55,5,50
"34483","2727王品","110/07/08","統一",33,200,-167
"34484","2727王品","110/07/08","永豐金-南投",53,10,43
"34485","2727王品","110/07/08","凱基-台北",476,615,-139
"34486","2727王品","110/07/08","國泰-敦南",190,148,42
"34487","2727王品","110/07/08","永豐金-松山",8,138,-130
"34488","2727王品","110/07/08","台新-高雄",71,36,35
"34489","2727王品","110/07/08","新加坡商瑞銀",38,138,-100
"34490","2727王品","110/07/08","富邦-建國",62,27,35
"34491","2727王品","110/07/08","富邦-嘉義",84,182,-98
"34492","2727王品","110/07/08","永豐金證券",50,15,35
"34493","2727王品","110/07/08","元富-台南",4,99,-95
"34494","2727王品","110/07/08","港商野村",185,152,33
"34495","2727王品","110/07/08","凱基-永華",4,92,-88
"34496","2727王品","110/07/08","元大-嘉義",35,3,32
"34497","2727王品","110/07/08","凱基-大直",2,73,-71
"34498","2727王品","110/07/08","台新-三民",35,4,31
"34499","2727王品","110/07/08","美林",105,164,-59
"34500","2727王品","110/07/08","凱基-桃園",35,4,31
"34501","2727王品","110/07/08","第一金-台南",11,63,-52
"34502","2727王品","110/07/08","元大-和平",41,10,31
"34503","2727王品","110/07/08","摩根大通",216,259,-43
"34504","2727王品","110/07/08","兆豐-大安",33,5,28
"34505","2727王品","110/07/08","元大-員林",9,50,-41
"34506","2727王品","110/07/08","元大-新盛",33,6,27
"34507","2727王品","110/07/08","兆豐-虎尾",1,41,-40
"34508","1570力肯","110/07/08","群益金鼎-三重",20,0,20
"34509","1570力肯","110/07/08","中國信託-永康",0,26,-26
"34510","1570力肯","110/07/08","凱基-中壢",20,0,20
"34511","1570力肯","110/07/08","統一-敦南",0,12,-12
"34512","1570力肯","110/07/08","群益金鼎-台南",14,0,14
"34513","1570力肯","110/07/08","國票-博愛",0,10,-10
"34514","1570力肯","110/07/08","元富-緯城",10,0,10
"34515","1570力肯","110/07/08","元大-西門",0,10,-10
"34516","1570力肯","110/07/08","瑞士信貸",7,0,7
"34517","1570力肯","110/07/08","新光",0,9,-9
"34518","1570力肯","110/07/08","摩根大通",6,0,6
"34519","1570力肯","110/07/08","永豐金-大園",0,9,-9
"34520","1570力肯","110/07/08","土銀-白河",5,0,5
"34521","1570力肯","110/07/08","日盛-大墩",0,6,-6
"34522","1570力肯","110/07/08","台灣摩根士丹利",4,0,4
"34523","1570力肯","110/07/08","台新證券",0,6,-6
"34524","1570力肯","110/07/08","元大-新莊",3,0,3
"34525","1570力肯","110/07/08","永全",0,5,-5
"34526","1570力肯","110/07/08","永豐金-苓雅",3,0,3
"34527","1570力肯","110/07/08","元大-天母",0,5,-5
"34528","1570力肯","110/07/08","合庫-三重",2,0,2
"34529","1570力肯","110/07/08","元富-吉利",0,3,-3
"34530","1570力肯","110/07/08","(牛牛牛)亞-鑫豐",2,0,2
"34531","1570力肯","110/07/08","國泰-高雄",0,3,-3
"34532","1570力肯","110/07/08","玉山-大里",2,0,2
"34533","1570力肯","110/07/08","群益金鼎-北高雄",0,3,-3
"34534","1570力肯","110/07/08","國泰-敦南",2,0,2
"34535","1570力肯","110/07/08","群益金鼎-東門",0,2,-2
"34536","1570力肯","110/07/08","華南永昌-岡山",2,0,2
"34537","1570力肯","110/07/08","日盛-高雄",5,6,-1
"34538","6180橘子","110/07/08","新光",30,4,26
"34539","6180橘子","110/07/08","元大-土城學府",0,89,-89
"34540","6180橘子","110/07/08","康和-台南",22,0,22
"34541","6180橘子","110/07/08","凱基-東勢",1,66,-65
"34542","6180橘子","110/07/08","國泰-板橋",22,0,22
"34543","6180橘子","110/07/08","光和",0,64,-64
"34544","6180橘子","110/07/08","日盛-文化",21,0,21
"34545","6180橘子","110/07/08","中國信託-忠孝",0,50,-50
"34546","6180橘子","110/07/08","中國信託-文心",20,2,18
"34547","6180橘子","110/07/08","元富-大裕",0,25,-25
"34548","6180橘子","110/07/08","凱基-台北",39,24,15
"34549","6180橘子","110/07/08","統一-基隆",1,25,-24
"34550","6180橘子","110/07/08","元富-新店",14,0,14
"34551","6180橘子","110/07/08","美商高盛",1,21,-20
"34552","6180橘子","110/07/08","元大-土城永寧",11,0,11
"34553","6180橘子","110/07/08","元大證券",1,19,-18
"34554","6180橘子","110/07/08","永豐金-南京",11,0,11
"34555","6180橘子","110/07/08","元大-太平",2,20,-18
"34556","6180橘子","110/07/08","宏遠-館前",10,0,10
"34557","6180橘子","110/07/08","合庫證券",2,18,-16
"34558","6180橘子","110/07/08","國泰-新莊",10,0,10
"34559","6180橘子","110/07/08","台灣摩根士丹利",1,12,-11
"34560","6180橘子","110/07/08","群益金鼎",10,0,10
"34561","6180橘子","110/07/08","瑞士信貸",0,11,-11
"34562","6180橘子","110/07/08","凱基-高雄",10,0,10
"34563","6180橘子","110/07/08","元富-嘉義",0,11,-11
"34564","6180橘子","110/07/08","凱基-大安",10,0,10
"34565","6180橘子","110/07/08","新光-高雄",0,11,-11
"34566","6180橘子","110/07/08","富邦-仁愛",10,0,10
"34567","6180橘子","110/07/08","大慶-苗栗",0,10,-10
"34568","2390云辰","110/07/08","統一-新台中",126,1,125
"34569","2390云辰","110/07/08","摩根大通",62,661,-599
"34570","2390云辰","110/07/08","元大-員林",111,0,111
"34571","2390云辰","110/07/08","新加坡商瑞銀",0,173,-173
"34572","2390云辰","110/07/08","合庫-高雄",105,0,105
"34573","2390云辰","110/07/08","元大-天母",7,150,-143
"34574","2390云辰","110/07/08","凱基-台北",255,177,78
"34575","2390云辰","110/07/08","台灣摩根士丹利",0,134,-134
"34576","2390云辰","110/07/08","新光",71,17,54
"34577","2390云辰","110/07/08","玉山-台中",17,120,-103
"34578","2390云辰","110/07/08","國票-嘉義",53,0,53
"34579","2390云辰","110/07/08","美商高盛",0,78,-78
"34580","2390云辰","110/07/08","富邦-仁愛",53,4,49
"34581","2390云辰","110/07/08","美林",11,82,-71
"34582","2390云辰","110/07/08","兆豐-城中",48,0,48
"34583","2390云辰","110/07/08","群益金鼎-大興",35,106,-71
"34584","2390云辰","110/07/08","元大-新營",47,0,47
"34585","2390云辰","110/07/08","光和",11,71,-60
"34586","2390云辰","110/07/08","國泰-敦南",89,55,34
"34587","2390云辰","110/07/08","國泰-台中",28,70,-42
"34588","2390云辰","110/07/08","兆豐-台中",40,7,33
"34589","2390云辰","110/07/08","玉山-新莊",6,46,-40
"34590","2390云辰","110/07/08","永豐金-中正",36,6,30
"34591","2390云辰","110/07/08","富邦-台北",21,57,-36
"34592","2390云辰","110/07/08","中國信託-三重",29,0,29
"34593","2390云辰","110/07/08","土銀-台中",0,30,-30
"34594","2390云辰","110/07/08","富邦-陽明",33,5,28
"34595","2390云辰","110/07/08","兆豐-埔墘",1,31,-30
"34596","2390云辰","110/07/08","元富-桃園",27,0,27
"34597","2390云辰","110/07/08","玉山-南京東路",3,33,-30
"34598","4903聯光通","110/07/07","元大-太平",47,4,43
"34599","4903聯光通","110/07/07","日盛-板橋",0,15,-15
"34600","4903聯光通","110/07/07","華南永昌-桃園",10,0,10
"34601","4903聯光通","110/07/07","元大-八德",0,9,-9
"34602","4903聯光通","110/07/07","元大-南投",9,0,9
"34603","4903聯光通","110/07/07","宏遠證券",0,7,-7
"34604","4903聯光通","110/07/07","新光-台中",3,0,3
"34605","4903聯光通","110/07/07","大慶",0,7,-7
"34606","4903聯光通","110/07/07","國泰-敦南",1,0,1
"34607","4903聯光通","110/07/07","群益金鼎-館前",0,6,-6
"34608","4903聯光通","110/07/07","國票-中正",0,0,0
"34609","4903聯光通","110/07/07","元大-羅東",0,5,-5
"34610","4903聯光通","110/07/07","康和-內湖",0,0,0
"34611","4903聯光通","110/07/07","新光",8,12,-4
"34612","4903聯光通","110/07/07","凱基-站前",0,0,0
"34613","4903聯光通","110/07/07","國泰-高雄",0,3,-3
"34614","4903聯光通","110/07/07","華南永昌",1,1,0
"34615","4903聯光通","110/07/07","第一金-台中",0,3,-3
"34616","4903聯光通","110/07/07","華南永昌-新莊",0,0,0
"34617","4903聯光通","110/07/07","中農",0,1,-1
"34618","4903聯光通","110/07/07","臺灣企銀-桃園",0,1,-1
"34619","4903聯光通","110/07/07","台新-新營",0,1,-1
"34620","4903聯光通","110/07/07","元大-鶯歌",2,3,-1
"34621","4903聯光通","110/07/07","元大-永和",0,1,-1
"34622","4903聯光通","110/07/07","元大-苑裡",0,1,-1
"34623","2929淘帝","110/07/07","統一",163,0,163
"34624","2929淘帝","110/07/07","新光-台中",57,142,-85
"34625","2929淘帝","110/07/07","港商野村",323,181,142
"34626","2929淘帝","110/07/07","兆豐-忠孝",0,76,-76
"34627","2929淘帝","110/07/07","日盛-中壢",132,10,122
"34628","2929淘帝","110/07/07","台新-建北",0,53,-53
"34629","2929淘帝","110/07/07","新加坡商瑞銀",140,19,121
"34630","2929淘帝","110/07/07","臺銀-鳳山",0,44,-44
"34631","2929淘帝","110/07/07","日盛-嘉義",101,0,101
"34632","2929淘帝","110/07/07","元大-新盛",0,42,-42
"34633","2929淘帝","110/07/07","摩根大通",101,16,85
"34634","2929淘帝","110/07/07","富邦-建國",6,47,-41
"34635","2929淘帝","110/07/07","元大-太平",55,2,53
"34636","2929淘帝","110/07/07","日盛-園區",0,40,-40
"34637","2929淘帝","110/07/07","元富-松德",50,1,49
"34638","2929淘帝","110/07/07","新光-高雄",1,38,-37
"34639","2929淘帝","110/07/07","凱基-板橋",53,5,48
"34640","2929淘帝","110/07/07","永豐金-三重",1,34,-33
"34641","2929淘帝","110/07/07","美林",80,34,46
"34642","2929淘帝","110/07/07","元大-彰化",0,31,-31
"34643","2929淘帝","110/07/07","元富-台南",41,0,41
"34644","2929淘帝","110/07/07","第一金-大稻埕",0,30,-30
"34645","2929淘帝","110/07/07","兆豐-竹北",39,0,39
"34646","2929淘帝","110/07/07","國泰-敦南",3,33,-30
"34647","2929淘帝","110/07/07","元大-西門",36,0,36
"34648","2929淘帝","110/07/07","富邦-員林",0,30,-30
"34649","2929淘帝","110/07/07","華南永昌",39,4,35
"34650","2929淘帝","110/07/07","元大-蘆洲",1,30,-29
"34651","2929淘帝","110/07/07","日盛-板橋中山",30,0,30
"34652","2929淘帝","110/07/07","台新-台南",4,32,-28
"34653","5410國眾","110/07/07","兆豐-城中",66,0,66
"34654","5410國眾","110/07/07","富邦-仁愛",0,115,-115
"34655","5410國眾","110/07/07","摩根大通",21,0,21
"34656","5410國眾","110/07/07","亞東-板橋",0,38,-38
"34657","5410國眾","110/07/07","元大-北投",21,0,21
"34658","5410國眾","110/07/07","凱基-台北",2,24,-22
"34659","5410國眾","110/07/07","亞東-新竹",15,0,15
"34660","5410國眾","110/07/07","彰銀-七賢",0,10,-10
"34661","5410國眾","110/07/07","元大-福營",12,0,12
"34662","5410國眾","110/07/07","凱基-基隆",0,10,-10
"34663","5410國眾","110/07/07","新光-高雄",11,0,11
"34664","5410國眾","110/07/07","凱基-屏東",0,10,-10
"34665","5410國眾","110/07/07","華南永昌-小港",10,0,10
"34666","5410國眾","110/07/07","凱基-鳳山",0,10,-10
"34667","5410國眾","110/07/07","元大-大灣",10,0,10
"34668","5410國眾","110/07/07","永豐金-忠孝",0,10,-10
"34669","5410國眾","110/07/07","元大-莒光",10,0,10
"34670","5410國眾","110/07/07","日盛-板橋中山",0,9,-9
"34671","5410國眾","110/07/07","台中銀-豐原",9,0,9
"34672","5410國眾","110/07/07","統一-高雄",0,5,-5
"34673","5410國眾","110/07/07","元大-南屯",9,0,9
"34674","5410國眾","110/07/07","元大-斗六",0,5,-5
"34675","5410國眾","110/07/07","日盛-新莊",7,0,7
"34676","5410國眾","110/07/07","元大-大益",0,5,-5
"34677","5410國眾","110/07/07","元富-大昌",6,0,6
"34678","5410國眾","110/07/07","元大-南投",0,5,-5
"34679","5410國眾","110/07/07","新光-新竹",6,0,6
"34680","5410國眾","110/07/07","永豐金-員林",0,5,-5
"34681","5410國眾","110/07/07","臺銀-金山",5,0,5
"34682","5410國眾","110/07/07","華南永昌-楠梓",0,4,-4
"34683","2841台開","110/07/07","永豐金-豐原",268,0,268
"34684","2841台開","110/07/07","凱基-市政",0,200,-200
"34685","2841台開","110/07/07","永豐金-南投",200,0,200
"34686","2841台開","110/07/07","永豐金-彰化",0,100,-100
"34687","2841台開","110/07/07","新光",139,9,130
"34688","2841台開","110/07/07","元大-開元",1,93,-92
"34689","2841台開","110/07/07","中國信託-高雄",50,1,49
"34690","2841台開","110/07/07","港商野村",0,80,-80
"34691","2841台開","110/07/07","元大-歸仁",40,0,40
"34692","2841台開","110/07/07","凱基-台南",25,85,-60
"34693","2841台開","110/07/07","台中銀",35,0,35
"34694","2841台開","110/07/07","美商高盛",1,58,-57
"34695","2841台開","110/07/07","台新-新營",30,0,30
"34696","2841台開","110/07/07","統一-三重",0,55,-55
"34697","2841台開","110/07/07","富邦-台南",30,0,30
"34698","2841台開","110/07/07","台新證券",12,50,-38
"34699","2841台開","110/07/07","國泰-板橋",30,1,29
"34700","2841台開","110/07/07","陽信-石牌",0,31,-31
"34701","2841台開","110/07/07","凱基-文心",28,0,28
"34702","2841台開","110/07/07","元大-福營",0,31,-31
"34703","2841台開","110/07/07","凱基-站前",27,0,27
"34704","2841台開","110/07/07","第一金-澎湖",0,30,-30
"34705","2841台開","110/07/07","大昌-安康",38,16,22
"34706","2841台開","110/07/07","元大-新莊",0,30,-30
"34707","2841台開","110/07/07","合庫-台中",20,0,20
"34708","2841台開","110/07/07","國泰-館前",0,28,-28
"34709","2841台開","110/07/07","日盛-台南",20,0,20
"34710","2841台開","110/07/07","元大-竹科",0,25,-25
"34711","2841台開","110/07/07","台中銀-員林",20,0,20
"34712","2841台開","110/07/07","富邦-仁愛",1,22,-21
"34713","6207雷科","110/07/07","元大-大天母",21,0,21
"34714","6207雷科","110/07/07","元大-高雄",0,105,-105
"34715","6207雷科","110/07/07","元大-頭份",18,0,18
"34716","6207雷科","110/07/07","永豐金-中正",0,35,-35
"34717","6207雷科","110/07/07","第一金-新興",16,0,16
"34718","6207雷科","110/07/07","摩根大通",8,39,-31
"34719","6207雷科","110/07/07","富邦-虎尾",12,0,12
"34720","6207雷科","110/07/07","元大-林園",0,30,-30
"34721","6207雷科","110/07/07","兆豐-板橋",10,0,10
"34722","6207雷科","110/07/07","凱基-台北",0,19,-19
"34723","6207雷科","110/07/07","玉山-台大",10,0,10
"34724","6207雷科","110/07/07","國票-中和",13,25,-12
"34725","6207雷科","110/07/07","元大-四維",10,0,10
"34726","6207雷科","110/07/07","新加坡商瑞銀",0,9,-9
"34727","6207雷科","110/07/07","元大-鹿港",10,0,10
"34728","6207雷科","110/07/07","玉山-高雄",0,8,-8
"34729","6207雷科","110/07/07","元大-信義",10,0,10
"34730","6207雷科","110/07/07","玉山-台南",0,8,-8
"34731","6207雷科","110/07/07","台新-三民",8,0,8
"34732","6207雷科","110/07/07","宏遠-高雄",0,5,-5
"34733","6207雷科","110/07/07","元大-上新莊",8,0,8
"34734","6207雷科","110/07/07","元大-南海",0,5,-5
"34735","6207雷科","110/07/07","大昌-桃園",7,0,7
"34736","6207雷科","110/07/07","元大-莒光",0,4,-4
"34737","6207雷科","110/07/07","新光-台中",10,4,6
"34738","6207雷科","110/07/07","港商野村",0,3,-3
"34739","6207雷科","110/07/07","日盛-頭份",5,0,5
"34740","6207雷科","110/07/07","大慶-台南",0,3,-3
"34741","6207雷科","110/07/07","日茂-埔里",5,0,5
"34742","6207雷科","110/07/07","凱基-站前",0,3,-3
"34743","3679新至陞","110/07/07","永豐金證券",18,0,18
"34744","3679新至陞","110/07/07","美林",0,13,-13
"34745","3679新至陞","110/07/07","元大-文心興安",6,0,6
"34746","3679新至陞","110/07/07","兆豐-大安",0,10,-10
"34747","3679新至陞","110/07/07","中農",5,0,5
"34748","3679新至陞","110/07/07","國泰-桃園",0,4,-4
"34749","3679新至陞","110/07/07","台新證券",4,0,4
"34750","3679新至陞","110/07/07","永豐金-虎尾",0,4,-4
"34751","3679新至陞","110/07/07","華南永昌-小港",4,0,4
"34752","3679新至陞","110/07/07","台灣摩根士丹利",0,3,-3
"34753","3679新至陞","110/07/07","元大-天母",4,0,4
"34754","3679新至陞","110/07/07","瑞士信貸",0,3,-3
"34755","3679新至陞","110/07/07","台中銀-員林",4,1,3
"34756","3679新至陞","110/07/07","統一-新竹",0,3,-3
"34757","3679新至陞","110/07/07","摩根大通",4,1,3
"34758","3679新至陞","110/07/07","統一-三重",0,3,-3
"34759","3679新至陞","110/07/07","凱基-台北",7,4,3
"34760","3679新至陞","110/07/07","凱基-竹北",0,3,-3
"34761","3679新至陞","110/07/07","華南永昌-高雄",3,0,3
"34762","3679新至陞","110/07/07","元富-世貿",0,2,-2
"34763","3679新至陞","110/07/07","永豐金-潮州",2,0,2
"34764","3679新至陞","110/07/07","兆豐-鹿港",0,2,-2
"34765","3679新至陞","110/07/07","合庫-新竹",1,0,1
"34766","3679新至陞","110/07/07","玉山-台大",0,2,-2
"34767","3679新至陞","110/07/07","土銀-高雄",1,0,1
"34768","3679新至陞","110/07/07","國泰-館前",0,2,-2
"34769","3679新至陞","110/07/07","元富-新興",1,0,1
"34770","3679新至陞","110/07/07","群益金鼎-新莊",0,2,-2
"34771","3679新至陞","110/07/07","富邦-中壢",1,0,1
"34772","3679新至陞","110/07/07","元大-桃園",0,2,-2
"34773","2727王品","110/07/07","第一金",62,0,62
"34774","2727王品","110/07/07","台灣摩根士丹利",1,177,-176
"34775","2727王品","110/07/07","凱基-埔墘",40,0,40
"34776","2727王品","110/07/07","凱基-台北",49,151,-102
"34777","2727王品","110/07/07","中國信託-忠孝",40,1,39
"34778","2727王品","110/07/07","摩根大通",19,107,-88
"34779","2727王品","110/07/07","玉山-板橋",40,6,34
"34780","2727王品","110/07/07","美商高盛",2,86,-84
"34781","2727王品","110/07/07","亞東-新竹",31,1,30
"34782","2727王品","110/07/07","元大-北屯",1,52,-51
"34783","2727王品","110/07/07","群益金鼎-宜蘭",25,1,24
"34784","2727王品","110/07/07","國泰證券",1,47,-46
"34785","2727王品","110/07/07","富邦-竹北",23,0,23
"34786","2727王品","110/07/07","統一",3,33,-30
"34787","2727王品","110/07/07","元大-旗山",23,0,23
"34788","2727王品","110/07/07","第一金-台中",1,30,-29
"34789","2727王品","110/07/07","元富-宜蘭",21,0,21
"34790","2727王品","110/07/07","華南永昌-中正",4,29,-25
"34791","2727王品","110/07/07","國票-長城",20,0,20
"34792","2727王品","110/07/07","美林",0,23,-23
"34793","2727王品","110/07/07","台新證券",47,28,19
"34794","2727王品","110/07/07","群益金鼎-館前",0,20,-20
"34795","2727王品","110/07/07","富邦-新竹華信",18,1,17
"34796","2727王品","110/07/07","國票-內壢",0,16,-16
"34797","2727王品","110/07/07","永豐金-中正",18,1,17
"34798","2727王品","110/07/07","兆豐-新莊",0,15,-15
"34799","2727王品","110/07/07","華南永昌-麻豆",17,1,16
"34800","2727王品","110/07/07","港商野村",15,28,-13
"34801","2727王品","110/07/07","永豐金-潮州",15,0,15
"34802","2727王品","110/07/07","元大-善化",1,13,-12
"34803","1570力肯","110/07/07","台新證券",88,0,88
"34804","1570力肯","110/07/07","新光",0,54,-54
"34805","1570力肯","110/07/07","摩根大通",49,15,34
"34806","1570力肯","110/07/07","元大-高雄",0,40,-40
"34807","1570力肯","110/07/07","合庫-桃園",20,0,20
"34808","1570力肯","110/07/07","國票-北高雄",38,50,-12
"34809","1570力肯","110/07/07","元大-土城學府",20,0,20
"34810","1570力肯","110/07/07","群益金鼎-嘉義",0,10,-10
"34811","1570力肯","110/07/07","永豐金-板盛",18,0,18
"34812","1570力肯","110/07/07","元大-草屯",0,10,-10
"34813","1570力肯","110/07/07","永豐金-永康",18,0,18
"34814","1570力肯","110/07/07","日盛-高雄",0,9,-9
"34815","1570力肯","110/07/07","統一-員林",14,0,14
"34816","1570力肯","110/07/07","第一金-路竹",0,9,-9
"34817","1570力肯","110/07/07","元大-竹山",6,0,6
"34818","1570力肯","110/07/07","元大-古亭",0,9,-9
"34819","1570力肯","110/07/07","統一-敦南",5,0,5
"34820","1570力肯","110/07/07","國票-中正",0,8,-8
"34821","1570力肯","110/07/07","元大-永和",5,0,5
"34822","1570力肯","110/07/07","群益金鼎-鳳山",0,6,-6
"34823","1570力肯","110/07/07","元富-大裕",4,0,4
"34824","1570力肯","110/07/07","元大-土城永寧",0,6,-6
"34825","1570力肯","110/07/07","華南永昌-斗六",4,0,4
"34826","1570力肯","110/07/07","中國信託",0,5,-5
"34827","1570力肯","110/07/07","永豐金-松山",6,3,3
"34828","1570力肯","110/07/07","日盛-板橋",0,4,-4
"34829","1570力肯","110/07/07","永豐金-南投",4,1,3
"34830","1570力肯","110/07/07","日盛-木柵",0,4,-4
"34831","1570力肯","110/07/07","土銀-彰化",2,0,2
"34832","1570力肯","110/07/07","玉山-桃園",0,4,-4
"34833","6180橘子","110/07/07","臺銀-金山",27,0,27
"34834","6180橘子","110/07/07","凱基-台北",6,36,-30
"34835","6180橘子","110/07/07","元富-潮州",20,0,20
"34836","6180橘子","110/07/07","元大-天母",1,26,-25
"34837","6180橘子","110/07/07","凱基-中山",20,0,20
"34838","6180橘子","110/07/07","富邦-陽明",0,22,-22
"34839","6180橘子","110/07/07","元大-太平",23,4,19
"34840","6180橘子","110/07/07","日盛-頭份",0,20,-20
"34841","6180橘子","110/07/07","摩根大通",17,0,17
"34842","6180橘子","110/07/07","富邦-仁愛",0,20,-20
"34843","6180橘子","110/07/07","元大-草屯",20,3,17
"34844","6180橘子","110/07/07","永豐金-新莊",0,20,-20
"34845","6180橘子","110/07/07","華南永昌-楠梓",15,1,14
"34846","6180橘子","110/07/07","台灣摩根士丹利",0,18,-18
"34847","6180橘子","110/07/07","中國信託-永康",12,0,12
"34848","6180橘子","110/07/07","華南永昌-長虹",1,16,-15
"34849","6180橘子","110/07/07","日盛-文化",10,0,10
"34850","6180橘子","110/07/07","新光-新竹",0,12,-12
"34851","6180橘子","110/07/07","國泰-館前",10,0,10
"34852","6180橘子","110/07/07","凱基-中壢",0,12,-12
"34853","6180橘子","110/07/07","華南永昌-鶯歌",10,0,10
"34854","6180橘子","110/07/07","第一金-忠孝",0,11,-11
"34855","6180橘子","110/07/07","元大-豐原站前",10,0,10
"34856","6180橘子","110/07/07","元大-沙鹿",0,11,-11
"34857","6180橘子","110/07/07","元大-北屯",10,0,10
"34858","6180橘子","110/07/07","永豐金-羅東",0,11,-11
"34859","6180橘子","110/07/07","兆豐-台中",10,1,9
"34860","6180橘子","110/07/07","兆豐-埔墘",0,10,-10
"34861","6180橘子","110/07/07","群益金鼎-開元",9,0,9
"34862","6180橘子","110/07/07","華南永昌-台中",0,10,-10
"34863","2390云辰","110/07/07","元大-向上",144,0,144
"34864","2390云辰","110/07/07","摩根大通",18,674,-656
"34865","2390云辰","110/07/07","元富-中港",102,0,102
"34866","2390云辰","110/07/07","凱基-台北",141,625,-484
"34867","2390云辰","110/07/07","群益金鼎-民權",104,4,100
"34868","2390云辰","110/07/07","美林",32,261,-229
"34869","2390云辰","110/07/07","兆豐-忠孝",81,0,81
"34870","2390云辰","110/07/07","新加坡商瑞銀",50,149,-99
"34871","2390云辰","110/07/07","合庫-新竹",60,0,60
"34872","2390云辰","110/07/07","台灣摩根士丹利",7,87,-80
"34873","2390云辰","110/07/07","元大-土城學府",59,1,58
"34874","2390云辰","110/07/07","元大-金華",2,68,-66
"34875","2390云辰","110/07/07","玉山-大里",58,3,55
"34876","2390云辰","110/07/07","國票-新莊",13,65,-52
"34877","2390云辰","110/07/07","元大-東蘆",54,1,53
"34878","2390云辰","110/07/07","凱基-三重",12,56,-44
"34879","2390云辰","110/07/07","元富-三重",51,0,51
"34880","2390云辰","110/07/07","新光-台中",23,65,-42
"34881","2390云辰","110/07/07","元富-埔里",50,0,50
"34882","2390云辰","110/07/07","第一金-中壢",5,45,-40
"34883","2390云辰","110/07/07","中國信託-三重",52,3,49
"34884","2390云辰","110/07/07","華南永昌-斗六",0,40,-40
"34885","2390云辰","110/07/07","元大-彰化民生",64,15,49
"34886","2390云辰","110/07/07","富邦-新竹華信",25,61,-36
"34887","2390云辰","110/07/07","元大-潮州",50,5,45
"34888","2390云辰","110/07/07","玉山-新莊",2,32,-30
"34889","2390云辰","110/07/07","元富-高雄",57,14,43
"34890","2390云辰","110/07/07","凱基-新豐",17,47,-30
"34891","2390云辰","110/07/07","凱基-和平",40,0,40
"34892","2390云辰","110/07/07","統一-汐止",1,29,-28
"34893","4903聯光通","110/07/06","元大-苗栗",10,0,10
"34894","4903聯光通","110/07/06","宏遠證券",0,13,-13
"34895","4903聯光通","110/07/06","彰銀",5,0,5
"34896","4903聯光通","110/07/06","富邦-新營",0,4,-4
"34897","4903聯光通","110/07/06","元大-松山",5,0,5
"34898","4903聯光通","110/07/06","元富-草屯",0,3,-3
"34899","4903聯光通","110/07/06","新光",3,0,3
"34900","4903聯光通","110/07/06","元大-羅東",0,3,-3
"34901","4903聯光通","110/07/06","群益金鼎-館前",1,0,1
"34902","4903聯光通","110/07/06","元大-北三重",0,2,-2
"34903","4903聯光通","110/07/06","華南永昌-鶯歌",1,0,1
"34904","4903聯光通","110/07/06","國泰-敦南",0,1,-1
"34905","4903聯光通","110/07/06","永豐金-市政",1,0,1
"34906","4903聯光通","110/07/06","元富-板橋",0,0,0
"34907","4903聯光通","110/07/06","元富-板橋",0,0,0
"34908","4903聯光通","110/07/06","華南永昌",0,0,0
"34909","4903聯光通","110/07/06","華南永昌",0,0,0
"34910","4903聯光通","110/07/06","元大-太平",2,2,0
"34911","4903聯光通","110/07/06","元大-太平",2,2,0
"34912","2929淘帝","110/07/06","新光",204,85,119
"34913","2929淘帝","110/07/06","港商野村",62,282,-220
"34914","2929淘帝","110/07/06","日盛-中壢",94,0,94
"34915","2929淘帝","110/07/06","摩根大通",64,264,-200
"34916","2929淘帝","110/07/06","元富-城東",84,0,84
"34917","2929淘帝","110/07/06","統一",0,163,-163
"34918","2929淘帝","110/07/06","日盛-雙和",55,0,55
"34919","2929淘帝","110/07/06","香港上海匯豐",0,141,-141
"34920","2929淘帝","110/07/06","第一金-路竹",71,17,54
"34921","2929淘帝","110/07/06","新加坡商瑞銀",54,179,-125
"34922","2929淘帝","110/07/06","元大-花蓮",44,2,42
"34923","2929淘帝","110/07/06","合庫-高雄",3,122,-119
"34924","2929淘帝","110/07/06","永豐金-大園",73,33,40
"34925","2929淘帝","110/07/06","美林",34,118,-84
"34926","2929淘帝","110/07/06","元大-太平",44,6,38
"34927","2929淘帝","110/07/06","元大-員林",2,82,-80
"34928","2929淘帝","110/07/06","國泰-板橋",40,5,35
"34929","2929淘帝","110/07/06","元富-松德",26,75,-49
"34930","2929淘帝","110/07/06","兆豐-內湖",33,1,32
"34931","2929淘帝","110/07/06","臺銀-臺南",9,52,-43
"34932","2929淘帝","110/07/06","元大-博愛",43,11,32
"34933","2929淘帝","110/07/06","元大-北投",5,48,-43
"34934","2929淘帝","110/07/06","日盛-竹北",40,10,30
"34935","2929淘帝","110/07/06","臺銀-民權",1,41,-40
"34936","2929淘帝","110/07/06","元大-善化",52,22,30
"34937","2929淘帝","110/07/06","兆豐-忠孝",1,41,-40
"34938","2929淘帝","110/07/06","富邦-北港",29,0,29
"34939","2929淘帝","110/07/06","元大-西門",1,36,-35
"34940","2929淘帝","110/07/06","凱基-湖口",27,0,27
"34941","2929淘帝","110/07/06","玉山-嘉義",3,35,-32
"34942","5410國眾","110/07/06","兆豐-城中",28,0,28
"34943","5410國眾","110/07/06","凱基-高美館",1,18,-17
"34944","5410國眾","110/07/06","元大-小港",20,0,20
"34945","5410國眾","110/07/06","國泰-館前",0,15,-15
"34946","5410國眾","110/07/06","元大-新盛",18,0,18
"34947","5410國眾","110/07/06","國泰-板橋",2,17,-15
"34948","5410國眾","110/07/06","香港上海匯豐",15,0,15
"34949","5410國眾","110/07/06","新光",0,13,-13
"34950","5410國眾","110/07/06","華南永昌-小港",15,0,15
"34951","5410國眾","110/07/06","元富-緯城",0,10,-10
"34952","5410國眾","110/07/06","元富-大昌",13,0,13
"34953","5410國眾","110/07/06","中農",0,10,-10
"34954","5410國眾","110/07/06","臺銀-臺南",10,0,10
"34955","5410國眾","110/07/06","凱基-屏東",0,10,-10
"34956","5410國眾","110/07/06","元富-延平",8,0,8
"34957","5410國眾","110/07/06","新光-桃園",0,6,-6
"34958","5410國眾","110/07/06","元大-八德",17,9,8
"34959","5410國眾","110/07/06","高橋-龍潭",0,5,-5
"34960","5410國眾","110/07/06","摩根大通",7,0,7
"34961","5410國眾","110/07/06","元富-世貿",0,5,-5
"34962","5410國眾","110/07/06","凱基-桃園",7,0,7
"34963","5410國眾","110/07/06","群益金鼎-瑞豐",0,5,-5
"34964","5410國眾","110/07/06","永豐金-屏東",7,0,7
"34965","5410國眾","110/07/06","富邦-台中",0,5,-5
"34966","5410國眾","110/07/06","台新-左楠",5,0,5
"34967","5410國眾","110/07/06","永豐金-板橋",0,5,-5
"34968","5410國眾","110/07/06","富邦-竹東",5,0,5
"34969","5410國眾","110/07/06","富邦-台南",0,4,-4
"34970","5410國眾","110/07/06","元大-新莊",5,0,5
"34971","5410國眾","110/07/06","凱基-站前",0,3,-3
"34972","2841台開","110/07/06","群益金鼎-忠孝",100,0,100
"34973","2841台開","110/07/06","港商野村",0,295,-295
"34974","2841台開","110/07/06","台新證券",58,0,58
"34975","2841台開","110/07/06","元大-善化",0,50,-50
"34976","2841台開","110/07/06","台新-台中",58,0,58
"34977","2841台開","110/07/06","元大-四維",0,50,-50
"34978","2841台開","110/07/06","永豐金-敦南",50,0,50
"34979","2841台開","110/07/06","台新-新營",0,30,-30
"34980","2841台開","110/07/06","元大-台中",45,0,45
"34981","2841台開","110/07/06","群益金鼎-桃園",0,21,-21
"34982","2841台開","110/07/06","凱基-文心",43,0,43
"34983","2841台開","110/07/06","台中銀-員林",0,20,-20
"34984","2841台開","110/07/06","永豐金-潮州",30,0,30
"34985","2841台開","110/07/06","群益金鼎-延平",0,15,-15
"34986","2841台開","110/07/06","第一金-自由",25,0,25
"34987","2841台開","110/07/06","元大-三重",0,13,-13
"34988","2841台開","110/07/06","美商高盛",17,0,17
"34989","2841台開","110/07/06","元富-古亭",0,10,-10
"34990","2841台開","110/07/06","大昌-安康",39,22,17
"34991","2841台開","110/07/06","群益金鼎-北高雄",0,10,-10
"34992","2841台開","110/07/06","台中銀",15,0,15
"34993","2841台開","110/07/06","華南永昌-南京",0,10,-10
"34994","2841台開","110/07/06","玉山-嘉義",15,0,15
"34995","2841台開","110/07/06","富邦-花蓮",0,10,-10
"34996","2841台開","110/07/06","新光",11,0,11
"34997","2841台開","110/07/06","富邦-高雄",0,10,-10
"34998","2841台開","110/07/06","兆豐-永和",10,0,10
"34999","2841台開","110/07/06","元大-竹山",0,10,-10
"35000","2841台開","110/07/06","康和-內湖",10,0,10
"35001","2841台開","110/07/06","元大-屏東",0,10,-10
"35002","6207雷科","110/07/06","新光",45,4,41
"35003","6207雷科","110/07/06","凱基-高美館",1,104,-103
"35004","6207雷科","110/07/06","統一-基隆",30,0,30
"35005","6207雷科","110/07/06","摩根大通",11,45,-34
"35006","6207雷科","110/07/06","康和-南崁",13,0,13
"35007","6207雷科","110/07/06","群益金鼎-新竹",0,22,-22
"35008","6207雷科","110/07/06","宏遠-台南",10,0,10
"35009","6207雷科","110/07/06","港商野村",2,23,-21
"35010","6207雷科","110/07/06","國票-和平",10,0,10
"35011","6207雷科","110/07/06","凱基-台北",0,14,-14
"35012","6207雷科","110/07/06","永豐金-天母",10,0,10
"35013","6207雷科","110/07/06","台新-三民",0,12,-12
"35014","6207雷科","110/07/06","台新證券",10,1,9
"35015","6207雷科","110/07/06","群益金鼎-開元",1,11,-10
"35016","6207雷科","110/07/06","群益金鼎-士林",8,0,8
"35017","6207雷科","110/07/06","富邦-南屯",0,8,-8
"35018","6207雷科","110/07/06","群益金鼎-瑞豐",7,0,7
"35019","6207雷科","110/07/06","元大-善化",0,8,-8
"35020","6207雷科","110/07/06","元大-四維",7,0,7
"35021","6207雷科","110/07/06","日盛-頭份",0,5,-5
"35022","6207雷科","110/07/06","國票-中和",6,0,6
"35023","6207雷科","110/07/06","第一金-高雄",0,5,-5
"35024","6207雷科","110/07/06","台新-中壢",6,0,6
"35025","6207雷科","110/07/06","凱基-八德",0,5,-5
"35026","6207雷科","110/07/06","凱基-高雄",6,0,6
"35027","6207雷科","110/07/06","凱基-頭份",0,5,-5
"35028","6207雷科","110/07/06","富邦-彰化",6,0,6
"35029","6207雷科","110/07/06","合庫-新竹",0,4,-4
"35030","6207雷科","110/07/06","凱基-大安",5,0,5
"35031","6207雷科","110/07/06","新光-高雄",0,4,-4
"35032","3679新至陞","110/07/06","凱基",11,0,11
"35033","3679新至陞","110/07/06","摩根大通",0,22,-22
"35034","3679新至陞","110/07/06","台中銀-員林",11,1,10
"35035","3679新至陞","110/07/06","凱基-台北",6,21,-15
"35036","3679新至陞","110/07/06","安泰-大發",10,0,10
"35037","3679新至陞","110/07/06","瑞士信貸",0,13,-13
"35038","3679新至陞","110/07/06","香港上海匯豐",8,0,8
"35039","3679新至陞","110/07/06","富邦-苗栗",0,10,-10
"35040","3679新至陞","110/07/06","永豐金證券",8,2,6
"35041","3679新至陞","110/07/06","元大-永春",0,6,-6
"35042","3679新至陞","110/07/06","第一金-高雄",5,0,5
"35043","3679新至陞","110/07/06","凱基-興隆",0,5,-5
"35044","3679新至陞","110/07/06","群益金鼎-高盛",3,0,3
"35045","3679新至陞","110/07/06","國泰-桃園",0,3,-3
"35046","3679新至陞","110/07/06","元大-嘉義",3,0,3
"35047","3679新至陞","110/07/06","元大-萬華",2,5,-3
"35048","3679新至陞","110/07/06","臺銀-高雄",2,0,2
"35049","3679新至陞","110/07/06","美林",0,2,-2
"35050","3679新至陞","110/07/06","日盛-復興",2,0,2
"35051","3679新至陞","110/07/06","第一金-華江",0,2,-2
"35052","3679新至陞","110/07/06","日盛-樹林",4,2,2
"35053","3679新至陞","110/07/06","新光-台中",0,2,-2
"35054","3679新至陞","110/07/06","宏遠-館前",2,0,2
"35055","3679新至陞","110/07/06","華南永昌-民權",0,2,-2
"35056","3679新至陞","110/07/06","台新證券",2,0,2
"35057","3679新至陞","110/07/06","元大-板橋",0,2,-2
"35058","3679新至陞","110/07/06","康和-板橋",2,0,2
"35059","3679新至陞","110/07/06","日盛-板橋中山",0,1,-1
"35060","3679新至陞","110/07/06","群益金鼎-台南",2,0,2
"35061","3679新至陞","110/07/06","宏遠證券",0,1,-1
"35062","2727王品","110/07/06","元大證券",1033,729,304
"35063","2727王品","110/07/06","台灣摩根士丹利",35,184,-149
"35064","2727王品","110/07/06","富邦-台北",332,46,286
"35065","2727王品","110/07/06","元大-北屯",11,79,-68
"35066","2727王品","110/07/06","統一",252,43,209
"35067","2727王品","110/07/06","元富-敦南",4,70,-66
"35068","2727王品","110/07/06","永豐金-松山",147,14,133
"35069","2727王品","110/07/06","元大-基隆孝二",11,75,-64
"35070","2727王品","110/07/06","富邦-嘉義",301,198,103
"35071","2727王品","110/07/06","臺銀-臺南",9,69,-60
"35072","2727王品","110/07/06","新加坡商瑞銀",128,34,94
"35073","2727王品","110/07/06","中國信託-忠孝",5,48,-43
"35074","2727王品","110/07/06","元富-台南",97,6,91
"35075","2727王品","110/07/06","永豐金-市政",5,46,-41
"35076","2727王品","110/07/06","台新證券",169,105,64
"35077","2727王品","110/07/06","彰銀-台中",19,56,-37
"35078","2727王品","110/07/06","美林",115,58,57
"35079","2727王品","110/07/06","玉山證券",30,67,-37
"35080","2727王品","110/07/06","華南永昌",75,23,52
"35081","2727王品","110/07/06","凱基-埔墘",4,41,-37
"35082","2727王品","110/07/06","凱基-台北",445,398,47
"35083","2727王品","110/07/06","永豐金-大園",3,40,-37
"35084","2727王品","110/07/06","凱基-大直",48,7,41
"35085","2727王品","110/07/06","元富",2,37,-35
"35086","2727王品","110/07/06","凱基-林口",45,4,41
"35087","2727王品","110/07/06","富邦-仁愛",32,64,-32
"35088","2727王品","110/07/06","德信",40,1,39
"35089","2727王品","110/07/06","玉山-板橋",52,82,-30
"35090","2727王品","110/07/06","第一金",42,5,37
"35091","2727王品","110/07/06","中國信託-文心",10,39,-29
"35092","1570力肯","110/07/06","香港上海匯豐",47,0,47
"35093","1570力肯","110/07/06","新光",2,107,-105
"35094","1570力肯","110/07/06","元大-高雄",55,16,39
"35095","1570力肯","110/07/06","摩根大通",11,58,-47
"35096","1570力肯","110/07/06","元富-緯城",37,0,37
"35097","1570力肯","110/07/06","高橋",4,50,-46
"35098","1570力肯","110/07/06","台新-台南",16,0,16
"35099","1570力肯","110/07/06","合庫-桃園",0,20,-20
"35100","1570力肯","110/07/06","元大-新竹經國",14,0,14
"35101","1570力肯","110/07/06","永豐金-板盛",0,18,-18
"35102","1570力肯","110/07/06","富邦-左營",12,0,12
"35103","1570力肯","110/07/06","華南永昌-公誠",0,9,-9
"35104","1570力肯","110/07/06","國票-中正",12,2,10
"35105","1570力肯","110/07/06","凱基-台北",1,9,-8
"35106","1570力肯","110/07/06","國票-博愛",10,0,10
"35107","1570力肯","110/07/06","臺銀-臺中",0,6,-6
"35108","1570力肯","110/07/06","統一-敦南",12,5,7
"35109","1570力肯","110/07/06","台新-三民",0,5,-5
"35110","1570力肯","110/07/06","群益金鼎-三重",7,0,7
"35111","1570力肯","110/07/06","華南永昌-麻豆",0,5,-5
"35112","1570力肯","110/07/06","臺銀-臺南",6,0,6
"35113","1570力肯","110/07/06","合庫-台南",0,4,-4
"35114","1570力肯","110/07/06","大慶-蘆洲",6,0,6
"35115","1570力肯","110/07/06","統一-員林",0,4,-4
"35116","1570力肯","110/07/06","元富-新店",6,0,6
"35117","1570力肯","110/07/06","康和-澎湖",0,4,-4
"35118","1570力肯","110/07/06","玉山-雙和",7,1,6
"35119","1570力肯","110/07/06","華南永昌-斗六",0,4,-4
"35120","1570力肯","110/07/06","永豐金-敦南",9,3,6
"35121","1570力肯","110/07/06","元大-和平",0,4,-4
"35122","6180橘子","110/07/06","凱基-台北",72,12,60
"35123","6180橘子","110/07/06","臺銀-金山",5,105,-100
"35124","6180橘子","110/07/06","美林",29,0,29
"35125","6180橘子","110/07/06","元大-台中",0,100,-100
"35126","6180橘子","110/07/06","合庫-自強",21,0,21
"35127","6180橘子","110/07/06","康和-台南",3,50,-47
"35128","6180橘子","110/07/06","凱基-三峽",17,0,17
"35129","6180橘子","110/07/06","元大-中和",0,35,-35
"35130","6180橘子","110/07/06","富邦-虎尾",15,1,14
"35131","6180橘子","110/07/06","中國信託-忠孝",0,16,-16
"35132","6180橘子","110/07/06","元富-潮州",13,0,13
"35133","6180橘子","110/07/06","玉山-高雄",0,12,-12
"35134","6180橘子","110/07/06","中國信託-永康",13,0,13
"35135","6180橘子","110/07/06","港商野村",0,11,-11
"35136","6180橘子","110/07/06","元大-草屯",18,5,13
"35137","6180橘子","110/07/06","群益金鼎-松山",0,11,-11
"35138","6180橘子","110/07/06","臺銀",11,0,11
"35139","6180橘子","110/07/06","永豐金-豐原",0,11,-11
"35140","6180橘子","110/07/06","新光",15,4,11
"35141","6180橘子","110/07/06","元富-嘉義",5,15,-10
"35142","6180橘子","110/07/06","元大-竹東",11,0,11
"35143","6180橘子","110/07/06","玉山-士林",0,10,-10
"35144","6180橘子","110/07/06","宏遠-台中",10,0,10
"35145","6180橘子","110/07/06","凱基-北門",0,10,-10
"35146","6180橘子","110/07/06","第一金-台南",10,0,10
"35147","6180橘子","110/07/06","第一金-忠孝",0,9,-9
"35148","6180橘子","110/07/06","國泰-敦南",10,0,10
"35149","6180橘子","110/07/06","統一-基隆",0,9,-9
"35150","6180橘子","110/07/06","富邦-嘉義",10,0,10
"35151","6180橘子","110/07/06","安泰-大發",1,10,-9
"35152","2390云辰","110/07/06","元大-天母",975,276,699
"35153","2390云辰","110/07/06","台灣摩根士丹利",3,265,-262
"35154","2390云辰","110/07/06","摩根大通",688,312,376
"35155","2390云辰","110/07/06","群益金鼎-海山",3,166,-163
"35156","2390云辰","110/07/06","國泰-忠孝",164,3,161
"35157","2390云辰","110/07/06","國泰-敦南",188,339,-151
"35158","2390云辰","110/07/06","富邦-北港",140,7,133
"35159","2390云辰","110/07/06","元大-土城學府",12,119,-107
"35160","2390云辰","110/07/06","聯邦商銀",151,22,129
"35161","2390云辰","110/07/06","永豐金-高雄",4,103,-99
"35162","2390云辰","110/07/06","中國信託-文心",143,17,126
"35163","2390云辰","110/07/06","土銀-士林",0,94,-94
"35164","2390云辰","110/07/06","永豐金-中正",133,7,126
"35165","2390云辰","110/07/06","元大-佳里",11,91,-80
"35166","2390云辰","110/07/06","群益金鼎-大興",178,76,102
"35167","2390云辰","110/07/06","玉山-台中",10,86,-76
"35168","2390云辰","110/07/06","元富-中港",103,3,100
"35169","2390云辰","110/07/06","新光",251,324,-73
"35170","2390云辰","110/07/06","統一-新台中",104,12,92
"35171","2390云辰","110/07/06","富邦-敦南",29,101,-72
"35172","2390云辰","110/07/06","新加坡商瑞銀",211,120,91
"35173","2390云辰","110/07/06","兆豐-台中",0,58,-58
"35174","2390云辰","110/07/06","兆豐-忠孝",100,11,89
"35175","2390云辰","110/07/06","日盛證券",16,73,-57
"35176","2390云辰","110/07/06","凱基-林口",87,9,78
"35177","2390云辰","110/07/06","元大-東泰",5,61,-56
"35178","2390云辰","110/07/06","元富-西松",72,4,68
"35179","2390云辰","110/07/06","台新證券",136,190,-54
"35180","2390云辰","110/07/06","台新-左楠",66,9,57
"35181","2390云辰","110/07/06","元大-六合",10,63,-53
