"","stake","date","name","buy","sell","total"
"1","2834臺企銀","110/09/08","凱基-台北",32669,19953,12716
"2","2834臺企銀","110/09/08","國票-敦北法人",2,10010,-10008
"3","2834臺企銀","110/09/08","國票-長城",3050,50,3000
"4","2834臺企銀","110/09/08","美林",1498,4535,-3037
"5","2834臺企銀","110/09/08","凱基-松山",1133,66,1067
"6","2834臺企銀","110/09/08","港商麥格理",0,3008,-3008
"7","2834臺企銀","110/09/08","聯邦-富強",901,0,901
"8","2834臺企銀","110/09/08","瑞士信貸",869,3189,-2320
"9","2834臺企銀","110/09/08","元大-蘆洲",836,5,831
"10","2834臺企銀","110/09/08","國票-南港",13,1013,-1000
"11","2834臺企銀","110/09/08","元大-民雄",624,12,612
"12","2834臺企銀","110/09/08","台灣企銀-竹北",6,1000,-994
"13","2834臺企銀","110/09/08","永豐金-台南",630,86,544
"14","2834臺企銀","110/09/08","新光",437,1428,-991
"15","2834臺企銀","110/09/08","(牛牛牛)亞-鑫豐",683,158,525
"16","2834臺企銀","110/09/08","元大證券",14,843,-829
"17","2834臺企銀","110/09/08","國泰-敦南",623,136,487
"18","2834臺企銀","110/09/08","凱基-桃園",70,781,-711
"19","2834臺企銀","110/09/08","台新證券",584,124,460
"20","2834臺企銀","110/09/08","元大-竹南",34,658,-624
"21","2834臺企銀","110/09/08","玉山-新莊",560,111,449
"22","2834臺企銀","110/09/08","花旗環球",0,550,-550
"23","2834臺企銀","110/09/08","華南永昌-嘉義",424,2,422
"24","2834臺企銀","110/09/08","永豐金-埔里",51,568,-517
"25","2834臺企銀","110/09/08","兆豐-忠孝",418,5,413
"26","2834臺企銀","110/09/08","凱基-林口",213,651,-438
"27","2834臺企銀","110/09/08","國泰-板橋",898,506,392
"28","2834臺企銀","110/09/08","美商高盛",525,930,-405
"29","2834臺企銀","110/09/08","元富-嘉義",354,2,352
"30","2834臺企銀","110/09/08","群益金鼎-板橋",7,405,-398
"31","5511德昌","110/09/08","玉山-台大",5,0,5
"32","5511德昌","110/09/08","日盛-新竹",0,9,-9
"33","5511德昌","110/09/08","第一金-台中",3,0,3
"34","5511德昌","110/09/08","台中銀-豐原",0,4,-4
"35","5511德昌","110/09/08","美商高盛",2,0,2
"36","5511德昌","110/09/08","國泰-台中",0,4,-4
"37","5511德昌","110/09/08","新光-高雄",2,0,2
"38","5511德昌","110/09/08","華南永昌-內壢",0,2,-2
"39","5511德昌","110/09/08","富邦-岡山",2,0,2
"40","5511德昌","110/09/08","第一金-中山",0,1,-1
"41","5511德昌","110/09/08","瑞士信貸",1,0,1
"42","5511德昌","110/09/08","國票-九鼎",0,1,-1
"43","5511德昌","110/09/08","元大-東蘆",1,0,1
"44","5511德昌","110/09/08","台新-屏東",0,1,-1
"45","5511德昌","110/09/08","元大-清水",1,0,1
"46","5511德昌","110/09/08","元大-土城永寧",0,1,-1
"47","5511德昌","110/09/08","富邦-台北",1,0,1
"48","5511德昌","110/09/08","台新-台中",0,0,0
"49","5511德昌","110/09/08","華南永昌-台中",1,0,1
"50","5511德昌","110/09/08","玉山-數位",0,0,0
"51","5511德昌","110/09/08","凱基-幸福",1,0,1
"52","5511德昌","110/09/08","國泰-敦南",0,0,0
"53","5511德昌","110/09/08","凱基-高雄",1,0,1
"54","5511德昌","110/09/08","群益金鼎-崇德",0,0,0
"55","5511德昌","110/09/08","玉山證券",1,0,1
"56","5511德昌","110/09/08","凱基-台北",2,2,0
"57","5511德昌","110/09/08","台新證券",1,0,1
"58","5511德昌","110/09/08","元大-大益",0,0,0
"59","5511德昌","110/09/08","群益金鼎-崇德",0,0,0
"60","5511德昌","110/09/08","元大-忠孝",0,0,0
"61","2489瑞軒","110/09/08","元大-斗六",245,5,240
"62","2489瑞軒","110/09/08","凱基-台北",76,557,-481
"63","2489瑞軒","110/09/08","凱基-桃園",91,0,91
"64","2489瑞軒","110/09/08","瑞士信貸",8,300,-292
"65","2489瑞軒","110/09/08","元大-內湖",72,0,72
"66","2489瑞軒","110/09/08","元大-豐原",0,200,-200
"67","2489瑞軒","110/09/08","華南永昌-高雄",60,0,60
"68","2489瑞軒","110/09/08","港商野村",38,179,-141
"69","2489瑞軒","110/09/08","華南永昌",59,0,59
"70","2489瑞軒","110/09/08","台灣摩根士丹利",10,145,-135
"71","2489瑞軒","110/09/08","合庫-台南",58,0,58
"72","2489瑞軒","110/09/08","美商高盛",3,138,-135
"73","2489瑞軒","110/09/08","合庫-台中",55,0,55
"74","2489瑞軒","110/09/08","香港上海匯豐",0,100,-100
"75","2489瑞軒","110/09/08","凱基-文心",50,8,42
"76","2489瑞軒","110/09/08","永豐金-板盛",0,100,-100
"77","2489瑞軒","110/09/08","群益金鼎-南京",37,0,37
"78","2489瑞軒","110/09/08","摩根大通",151,246,-95
"79","2489瑞軒","110/09/08","統一-桃園",35,0,35
"80","2489瑞軒","110/09/08","元大證券",10,83,-73
"81","2489瑞軒","110/09/08","華南永昌-虎尾",36,1,35
"82","2489瑞軒","110/09/08","美林",109,173,-64
"83","2489瑞軒","110/09/08","富邦-仁愛",35,0,35
"84","2489瑞軒","110/09/08","元大-大同",11,75,-64
"85","2489瑞軒","110/09/08","元大-台南",34,0,34
"86","2489瑞軒","110/09/08","國票",7,69,-62
"87","2489瑞軒","110/09/08","群益金鼎-崇德",33,0,33
"88","2489瑞軒","110/09/08","中國信託-嘉義",0,60,-60
"89","2489瑞軒","110/09/08","元大-清水",33,0,33
"90","2489瑞軒","110/09/08","元大-民雄",0,50,-50
"91","2428興勤","110/09/08","摩根大通",43,24,19
"92","2428興勤","110/09/08","國票-安和",1,55,-54
"93","2428興勤","110/09/08","凱基-台北",34,15,19
"94","2428興勤","110/09/08","永豐金-信義",1,33,-32
"95","2428興勤","110/09/08","新加坡商瑞銀",21,6,15
"96","2428興勤","110/09/08","香港上海匯豐",0,28,-28
"97","2428興勤","110/09/08","台灣摩根士丹利",19,6,13
"98","2428興勤","110/09/08","中國信託",0,23,-23
"99","2428興勤","110/09/08","元富-城東",13,0,13
"100","2428興勤","110/09/08","凱基-市府",0,19,-19
"101","2428興勤","110/09/08","凱基-鳳山",10,1,9
"102","2428興勤","110/09/08","元大證券",2,14,-12
"103","2428興勤","110/09/08","美商高盛",20,12,8
"104","2428興勤","110/09/08","國票-博愛",0,11,-11
"105","2428興勤","110/09/08","元富-緯城",9,1,8
"106","2428興勤","110/09/08","新光-台南",1,12,-11
"107","2428興勤","110/09/08","康和-內湖",8,0,8
"108","2428興勤","110/09/08","合庫-自強",0,10,-10
"109","2428興勤","110/09/08","臺銀-民權",7,0,7
"110","2428興勤","110/09/08","富邦-敦南",0,7,-7
"111","2428興勤","110/09/08","群益金鼎-屏東",10,3,7
"112","2428興勤","110/09/08","元大-大雅",0,6,-6
"113","2428興勤","110/09/08","富邦-高雄",7,0,7
"114","2428興勤","110/09/08","凱基-中港",1,6,-5
"115","2428興勤","110/09/08","港商野村",13,7,6
"116","2428興勤","110/09/08","永興",0,4,-4
"117","2428興勤","110/09/08","新光",8,2,6
"118","2428興勤","110/09/08","群益金鼎-土城",0,4,-4
"119","2428興勤","110/09/08","凱基-三重",6,0,6
"120","2428興勤","110/09/08","凱基-中山",0,4,-4
"121","3176基亞","110/09/08","統一-仁愛",58,0,58
"122","3176基亞","110/09/08","新加坡商瑞銀",14,43,-29
"123","3176基亞","110/09/08","富邦-台北",11,0,11
"124","3176基亞","110/09/08","元大-南京",2,25,-23
"125","3176基亞","110/09/08","元大-和平",10,0,10
"126","3176基亞","110/09/08","第一金-新興",0,20,-20
"127","3176基亞","110/09/08","國泰-敦南",9,1,8
"128","3176基亞","110/09/08","摩根大通",1,19,-18
"129","3176基亞","110/09/08","元大-路竹",10,2,8
"130","3176基亞","110/09/08","新光",3,21,-18
"131","3176基亞","110/09/08","元大-新竹經國",7,0,7
"132","3176基亞","110/09/08","美商高盛",1,17,-16
"133","3176基亞","110/09/08","日盛-文化",6,0,6
"134","3176基亞","110/09/08","第一金-台中",0,16,-16
"135","3176基亞","110/09/08","元大證券",6,0,6
"136","3176基亞","110/09/08","凱基-屏東",0,15,-15
"137","3176基亞","110/09/08","統一-基隆",5,0,5
"138","3176基亞","110/09/08","第一金-路竹",0,12,-12
"139","3176基亞","110/09/08","大昌-新店",5,0,5
"140","3176基亞","110/09/08","富邦-新店",1,12,-11
"141","3176基亞","110/09/08","凱基-中壢",5,0,5
"142","3176基亞","110/09/08","宏遠-館前",0,10,-10
"143","3176基亞","110/09/08","華南永昌-三重",5,0,5
"144","3176基亞","110/09/08","台新-左楠",0,10,-10
"145","3176基亞","110/09/08","元大-土城永寧",5,0,5
"146","3176基亞","110/09/08","元大-松江",0,10,-10
"147","3176基亞","110/09/08","合庫-鳳山",4,0,4
"148","3176基亞","110/09/08","富邦-員林",3,12,-9
"149","3176基亞","110/09/08","致和證券",4,0,4
"150","3176基亞","110/09/08","永豐金-中壢",0,8,-8
"151","2409友達","110/09/08","玉山證券",9286,169,9117
"152","2409友達","110/09/08","瑞士信貸",247,5798,-5551
"153","2409友達","110/09/08","永豐金證券",7987,183,7804
"154","2409友達","110/09/08","美林",3248,6260,-3012
"155","2409友達","110/09/08","摩根大通",10674,5233,5441
"156","2409友達","110/09/08","港商野村",880,3790,-2910
"157","2409友達","110/09/08","美商高盛",4361,2004,2357
"158","2409友達","110/09/08","台灣匯立證券",0,2625,-2625
"159","2409友達","110/09/08","港商麥格理",1547,438,1109
"160","2409友達","110/09/08","台灣摩根士丹利",278,2251,-1973
"161","2409友達","110/09/08","凱基-復興",641,34,607
"162","2409友達","110/09/08","花旗環球",487,1744,-1257
"163","2409友達","110/09/08","土銀-台南",501,3,498
"164","2409友達","110/09/08","國泰證券",95,797,-702
"165","2409友達","110/09/08","兆豐-天母",505,19,486
"166","2409友達","110/09/08","元大-館前",17,661,-644
"167","2409友達","110/09/08","華南永昌-民權",503,27,476
"168","2409友達","110/09/08","新光",905,1468,-563
"169","2409友達","110/09/08","凱基-羅東",482,8,474
"170","2409友達","110/09/08","永豐金-中壢",34,565,-531
"171","2409友達","110/09/08","元大證券",2786,2326,460
"172","2409友達","110/09/08","國泰-敦南",454,967,-513
"173","2409友達","110/09/08","國票-敦北法人",638,200,438
"174","2409友達","110/09/08","玉山-台大",346,767,-421
"175","2409友達","110/09/08","元大-中壢",545,150,395
"176","2409友達","110/09/08","香港上海匯豐",0,410,-410
"177","2409友達","110/09/08","國票",544,152,392
"178","2409友達","110/09/08","群益金鼎-西松",14,417,-403
"179","2409友達","110/09/08","康和",345,15,330
"180","2409友達","110/09/08","台中銀-台北",2,400,-398
"181","1315達新","110/09/08","凱基-中港",10,0,10
"182","1315達新","110/09/08","新光",0,12,-12
"183","1315達新","110/09/08","(牛牛牛)亞-鑫豐",5,0,5
"184","1315達新","110/09/08","美林",0,10,-10
"185","1315達新","110/09/08","元大-文心興安",5,0,5
"186","1315達新","110/09/08","港商法國興業",0,9,-9
"187","1315達新","110/09/08","永豐金-中正",3,0,3
"188","1315達新","110/09/08","大昌-樹林",0,3,-3
"189","1315達新","110/09/08","元大-花蓮",3,0,3
"190","1315達新","110/09/08","大慶-楊梅",0,2,-2
"191","1315達新","110/09/08","永豐金-高雄",2,0,2
"192","1315達新","110/09/08","國泰-台中",0,2,-2
"193","1315達新","110/09/08","永豐金證券",2,0,2
"194","1315達新","110/09/08","元富-新竹",0,1,-1
"195","1315達新","110/09/08","元大-台中中港",2,0,2
"196","1315達新","110/09/08","國票-安和",0,1,-1
"197","1315達新","110/09/08","元富-安南",2,0,2
"198","1315達新","110/09/08","群益金鼎-古亭",0,1,-1
"199","1315達新","110/09/08","台灣摩根士丹利",2,0,2
"200","1315達新","110/09/08","群益金鼎-丹鳳",0,1,-1
"201","1315達新","110/09/08","摩根大通",1,0,1
"202","1315達新","110/09/08","凱基-台北",0,1,-1
"203","1315達新","110/09/08","兆豐-台中",1,0,1
"204","1315達新","110/09/08","華南永昌-高雄",0,1,-1
"205","1315達新","110/09/08","第一金-忠孝",1,0,1
"206","1315達新","110/09/08","玉山-大里",0,0,0
"207","1315達新","110/09/08","台灣企銀",1,0,1
"208","1315達新","110/09/08","華南永昌-內壢",0,0,0
"209","1315達新","110/09/08","合庫-台中",1,0,1
"210","1315達新","110/09/08","富邦-仁愛",0,0,0
"211","2609陽明","110/09/08","瑞士信貸",2143,342,1801
"212","2609陽明","110/09/08","摩根大通",2455,4905,-2450
"213","2609陽明","110/09/08","台灣匯立證券",1516,13,1503
"214","2609陽明","110/09/08","美商高盛",915,2392,-1477
"215","2609陽明","110/09/08","北城證券",1574,110,1464
"216","2609陽明","110/09/08","凱基-台北",2675,3280,-605
"217","2609陽明","110/09/08","台灣摩根士丹利",1814,353,1461
"218","2609陽明","110/09/08","元富",25,610,-585
"219","2609陽明","110/09/08","元大-土城永寧",1552,562,990
"220","2609陽明","110/09/08","日盛-雙和",74,611,-537
"221","2609陽明","110/09/08","美林",3488,2625,863
"222","2609陽明","110/09/08","第一金-桃園",67,571,-504
"223","2609陽明","110/09/08","永豐金-中和",1355,583,772
"224","2609陽明","110/09/08","兆豐-嘉義",25,507,-482
"225","2609陽明","110/09/08","群益金鼎-大安",689,39,650
"226","2609陽明","110/09/08","華南永昌-竹北",32,432,-400
"227","2609陽明","110/09/08","日盛-台中",842,200,642
"228","2609陽明","110/09/08","凱基-板橋",103,391,-288
"229","2609陽明","110/09/08","統一-土城",667,74,593
"230","2609陽明","110/09/08","凱基-民權",11,285,-274
"231","2609陽明","110/09/08","兆豐-復興",513,29,484
"232","2609陽明","110/09/08","元大-竹北",107,367,-260
"233","2609陽明","110/09/08","日盛-板橋",571,105,466
"234","2609陽明","110/09/08","凱基-大直",622,879,-257
"235","2609陽明","110/09/08","新加坡商瑞銀",691,272,419
"236","2609陽明","110/09/08","富邦-北港",56,263,-207
"237","2609陽明","110/09/08","統一-城中",612,205,407
"238","2609陽明","110/09/08","群益金鼎-內湖",33,238,-205
"239","2609陽明","110/09/08","統一-仁愛",1572,1166,406
"240","2609陽明","110/09/08","凱基-虎尾",57,261,-204
"241","2636台驊投控","110/09/08","瑞士信貸",511,81,430
"242","2636台驊投控","110/09/08","日盛-板橋",4,171,-167
"243","2636台驊投控","110/09/08","富邦-建國",411,18,393
"244","2636台驊投控","110/09/08","第一金-桃園",3,144,-141
"245","2636台驊投控","110/09/08","美林",771,487,284
"246","2636台驊投控","110/09/08","新光-新竹",13,131,-118
"247","2636台驊投控","110/09/08","台灣摩根士丹利",149,6,143
"248","2636台驊投控","110/09/08","元大證券",134,238,-104
"249","2636台驊投控","110/09/08","兆豐-中壢",117,0,117
"250","2636台驊投控","110/09/08","統一-基隆",4,89,-85
"251","2636台驊投控","110/09/08","兆豐-虎尾",80,0,80
"252","2636台驊投控","110/09/08","華南永昌-竹北",10,58,-48
"253","2636台驊投控","110/09/08","美商高盛",142,72,70
"254","2636台驊投控","110/09/08","新光-桃園",19,62,-43
"255","2636台驊投控","110/09/08","摩根大通",519,458,61
"256","2636台驊投控","110/09/08","致和-台北",0,40,-40
"257","2636台驊投控","110/09/08","凱基-台北",419,368,51
"258","2636台驊投控","110/09/08","富邦-虎尾",4,44,-40
"259","2636台驊投控","110/09/08","統一-新台中",38,2,36
"260","2636台驊投控","110/09/08","元大-羅東",8,48,-40
"261","2636台驊投控","110/09/08","新加坡商瑞銀",47,13,34
"262","2636台驊投控","110/09/08","統一-南京",39,74,-35
"263","2636台驊投控","110/09/08","統一-仁愛",34,3,31
"264","2636台驊投控","110/09/08","元大-花蓮",8,40,-32
"265","2636台驊投控","110/09/08","群益金鼎-台南",41,11,30
"266","2636台驊投控","110/09/08","凱基-中山",5,36,-31
"267","2636台驊投控","110/09/08","富邦證券",25,0,25
"268","2636台驊投控","110/09/08","宏遠-台中",0,30,-30
"269","2636台驊投控","110/09/08","元富",25,4,21
"270","2636台驊投控","110/09/08","國泰-台中",59,86,-27
"271","2867三商壽","110/09/08","富邦-新營",390,12,378
"272","2867三商壽","110/09/08","元大-桃園",0,517,-517
"273","2867三商壽","110/09/08","新光",181,63,118
"274","2867三商壽","110/09/08","元大證券",1,287,-286
"275","2867三商壽","110/09/08","臺銀-鳳山",116,0,116
"276","2867三商壽","110/09/08","摩根大通",43,248,-205
"277","2867三商壽","110/09/08","瑞士信貸",112,0,112
"278","2867三商壽","110/09/08","統一-士林",0,180,-180
"279","2867三商壽","110/09/08","富邦-三重",90,0,90
"280","2867三商壽","110/09/08","凱基-台北",53,204,-151
"281","2867三商壽","110/09/08","華南永昌-虎尾",89,0,89
"282","2867三商壽","110/09/08","元大-崇德",0,90,-90
"283","2867三商壽","110/09/08","國票-南京",80,0,80
"284","2867三商壽","110/09/08","法銀巴黎",0,80,-80
"285","2867三商壽","110/09/08","新光-台中",70,1,69
"286","2867三商壽","110/09/08","玉山-台中",0,71,-71
"287","2867三商壽","110/09/08","元大-大甲",67,0,67
"288","2867三商壽","110/09/08","美商高盛",4,69,-65
"289","2867三商壽","110/09/08","元大-嘉義",65,0,65
"290","2867三商壽","110/09/08","花旗環球",0,42,-42
"291","2867三商壽","110/09/08","統一-平鎮",50,0,50
"292","2867三商壽","110/09/08","永豐金-台南",0,37,-37
"293","2867三商壽","110/09/08","華南永昌-淡水",50,0,50
"294","2867三商壽","110/09/08","玉山-板橋",0,34,-34
"295","2867三商壽","110/09/08","新光-高雄",46,0,46
"296","2867三商壽","110/09/08","兆豐-岡山",0,30,-30
"297","2867三商壽","110/09/08","永豐金-永康",41,0,41
"298","2867三商壽","110/09/08","聯邦-三重",0,30,-30
"299","2867三商壽","110/09/08","富邦-桃園",40,0,40
"300","2867三商壽","110/09/08","華南永昌-古亭",0,30,-30
"301","5521工信","110/09/08","華南永昌-苗栗",160,0,160
"302","5521工信","110/09/08","富邦-台北",54,366,-312
"303","5521工信","110/09/08","國泰-台中",165,6,159
"304","5521工信","110/09/08","元富",60,370,-310
"305","5521工信","110/09/08","群益金鼎-大甲",85,0,85
"306","5521工信","110/09/08","摩根大通",57,355,-298
"307","5521工信","110/09/08","元大-潮州",80,0,80
"308","5521工信","110/09/08","美商高盛",0,259,-259
"309","5521工信","110/09/08","元大-博愛",80,0,80
"310","5521工信","110/09/08","凱基-台北",37,195,-158
"311","5521工信","110/09/08","元大-大里德芳",55,0,55
"312","5521工信","110/09/08","凱基-城中",0,126,-126
"313","5521工信","110/09/08","華南永昌-鶯歌",50,0,50
"314","5521工信","110/09/08","瑞士信貸",1,123,-122
"315","5521工信","110/09/08","華南永昌-東昇",50,0,50
"316","5521工信","110/09/08","元富-大昌",0,100,-100
"317","5521工信","110/09/08","永豐金-彰化",50,0,50
"318","5521工信","110/09/08","元大證券",4,90,-86
"319","5521工信","110/09/08","台新證券",43,0,43
"320","5521工信","110/09/08","台灣摩根士丹利",2,82,-80
"321","5521工信","110/09/08","元大-南屯",42,0,42
"322","5521工信","110/09/08","玉山-板橋",0,77,-77
"323","5521工信","110/09/08","(牛牛牛)亞-網路",39,0,39
"324","5521工信","110/09/08","元大-左營",4,50,-46
"325","5521工信","110/09/08","國泰-敦南",50,13,37
"326","5521工信","110/09/08","兆豐-北高雄",2,46,-44
"327","5521工信","110/09/08","新光-高雄",36,0,36
"328","5521工信","110/09/08","凱基-宜蘭",0,40,-40
"329","5521工信","110/09/08","土銀-高雄",34,0,34
"330","5521工信","110/09/08","凱基-三峽",8,40,-32
"331","1471首利","110/09/08","日盛-新莊",50,0,50
"332","1471首利","110/09/08","摩根大通",11,50,-39
"333","1471首利","110/09/08","台新-松江",36,0,36
"334","1471首利","110/09/08","永豐金-市政",0,35,-35
"335","1471首利","110/09/08","凱基-竹北",20,0,20
"336","1471首利","110/09/08","永豐金-忠孝",0,32,-32
"337","1471首利","110/09/08","華南永昌-台中",17,0,17
"338","1471首利","110/09/08","永豐金-古亭",0,31,-31
"339","1471首利","110/09/08","元大-八德",12,0,12
"340","1471首利","110/09/08","瑞士信貸",0,27,-27
"341","1471首利","110/09/08","兆豐-桃園",10,0,10
"342","1471首利","110/09/08","大慶",0,25,-25
"343","1471首利","110/09/08","群益金鼎-東門",10,0,10
"344","1471首利","110/09/08","富邦-員林",0,16,-16
"345","1471首利","110/09/08","凱基-市府",10,0,10
"346","1471首利","110/09/08","群益金鼎-鳳山",0,15,-15
"347","1471首利","110/09/08","元大-土城永寧",10,0,10
"348","1471首利","110/09/08","凱基-台北",0,12,-12
"349","1471首利","110/09/08","兆豐-西螺",9,0,9
"350","1471首利","110/09/08","國泰-敦南",3,14,-11
"351","1471首利","110/09/08","富邦-永和",9,0,9
"352","1471首利","110/09/08","元富-潮州",0,10,-10
"353","1471首利","110/09/08","富邦-中壢",8,0,8
"354","1471首利","110/09/08","元大-民雄",0,10,-10
"355","1471首利","110/09/08","元大-竹山",8,0,8
"356","1471首利","110/09/08","元大-大雅",0,10,-10
"357","1471首利","110/09/08","大慶-楊梅",7,0,7
"358","1471首利","110/09/08","美林",0,5,-5
"359","1471首利","110/09/08","日盛-八德",6,0,6
"360","1471首利","110/09/08","德信-中正",0,5,-5
"361","2883開發金","110/09/08","臺銀",5051,40,5011
"362","2883開發金","110/09/08","凱基-台北",724,3138,-2414
"363","2883開發金","110/09/08","新加坡商瑞銀",3432,15,3417
"364","2883開發金","110/09/08","元大證券",2022,3577,-1555
"365","2883開發金","110/09/08","群益金鼎-古亭",588,20,568
"366","2883開發金","110/09/08","凱基-復興",53,1328,-1275
"367","2883開發金","110/09/08","富邦證券",602,43,559
"368","2883開發金","110/09/08","台灣摩根士丹利",1953,3133,-1180
"369","2883開發金","110/09/08","華南永昌",610,62,548
"370","2883開發金","110/09/08","美林",896,1828,-932
"371","2883開發金","110/09/08","永豐金-苓雅",433,11,422
"372","2883開發金","110/09/08","港商野村",660,1509,-849
"373","2883開發金","110/09/08","港商麥格理",971,552,419
"374","2883開發金","110/09/08","台灣企銀-竹北",2,740,-738
"375","2883開發金","110/09/08","亞東-新竹",766,383,383
"376","2883開發金","110/09/08","美商高盛",2064,2757,-693
"377","2883開發金","110/09/08","臺銀-高雄",346,13,333
"378","2883開發金","110/09/08","凱基-台中",24,704,-680
"379","2883開發金","110/09/08","摩根大通",1004,693,311
"380","2883開發金","110/09/08","台新-建北",15,645,-630
"381","2883開發金","110/09/08","永興",303,0,303
"382","2883開發金","110/09/08","凱基-東港",103,638,-535
"383","2883開發金","110/09/08","瑞士信貸",415,176,239
"384","2883開發金","110/09/08","新光",1007,1474,-467
"385","2883開發金","110/09/08","臺銀-臺中",253,25,228
"386","2883開發金","110/09/08","元大-士林",44,462,-418
"387","2883開發金","110/09/08","彰銀-台中",205,0,205
"388","2883開發金","110/09/08","群益金鼎-鳳山",14,381,-367
"389","2883開發金","110/09/08","群益金鼎-開元",207,4,203
"390","2883開發金","110/09/08","花旗環球",0,341,-341
"391","6205詮欣","110/09/08","日盛-三重",29,0,29
"392","6205詮欣","110/09/08","華南永昌-麻豆",0,11,-11
"393","6205詮欣","110/09/08","臺銀-民權",11,0,11
"394","6205詮欣","110/09/08","凱基-台北",0,11,-11
"395","6205詮欣","110/09/08","華南永昌-長虹",11,0,11
"396","6205詮欣","110/09/08","德信-新營",0,9,-9
"397","6205詮欣","110/09/08","元富-宜蘭",10,0,10
"398","6205詮欣","110/09/08","瑞士信貸",0,6,-6
"399","6205詮欣","110/09/08","玉山-城中",9,0,9
"400","6205詮欣","110/09/08","凱基-東門",0,5,-5
"401","6205詮欣","110/09/08","臺銀",5,0,5
"402","6205詮欣","110/09/08","統一-汐止",0,5,-5
"403","6205詮欣","110/09/08","新加坡商瑞銀",3,0,3
"404","6205詮欣","110/09/08","港商法國興業",0,5,-5
"405","6205詮欣","110/09/08","玉山-高雄",2,0,2
"406","6205詮欣","110/09/08","群益金鼎-新莊",0,4,-4
"407","6205詮欣","110/09/08","元大-汐止",2,0,2
"408","6205詮欣","110/09/08","元大-虎尾",0,4,-4
"409","6205詮欣","110/09/08","美林",1,0,1
"410","6205詮欣","110/09/08","元大-屏東民生",0,4,-4
"411","6205詮欣","110/09/08","亞東-板橋",1,0,1
"412","6205詮欣","110/09/08","凱基-和平",0,3,-3
"413","6205詮欣","110/09/08","兆豐-景美",1,0,1
"414","6205詮欣","110/09/08","凱基-內湖",0,3,-3
"415","6205詮欣","110/09/08","元大-莒光",1,0,1
"416","6205詮欣","110/09/08","日盛-台中",0,2,-2
"417","6205詮欣","110/09/08","康和-板橋",0,0,0
"418","6205詮欣","110/09/08","凱基-林口",0,2,-2
"419","6205詮欣","110/09/08","國泰-高雄",0,0,0
"420","6205詮欣","110/09/08","元大-博愛",0,2,-2
"421","1540喬福","110/09/08","華南永昌",11,0,11
"422","1540喬福","110/09/08","元大-土城永寧",0,31,-31
"423","1540喬福","110/09/08","日盛-士林",6,0,6
"424","1540喬福","110/09/08","日盛-文化",0,25,-25
"425","1540喬福","110/09/08","元富-新竹",6,0,6
"426","1540喬福","110/09/08","元大-古亭",0,10,-10
"427","1540喬福","110/09/08","元大-新店中正",5,0,5
"428","1540喬福","110/09/08","摩根大通",0,5,-5
"429","1540喬福","110/09/08","華南永昌-東勢",5,0,5
"430","1540喬福","110/09/08","凱基-台北",0,5,-5
"431","1540喬福","110/09/08","德信-新營",5,0,5
"432","1540喬福","110/09/08","元大-忠孝",0,3,-3
"433","1540喬福","110/09/08","群益金鼎-台北",5,0,5
"434","1540喬福","110/09/08","兆豐-大安",0,2,-2
"435","1540喬福","110/09/08","台新證券",3,0,3
"436","1540喬福","110/09/08","華南永昌-中正",0,2,-2
"437","1540喬福","110/09/08","元大-大雅",3,0,3
"438","1540喬福","110/09/08","美林",0,1,-1
"439","1540喬福","110/09/08","凱基-高雄",3,0,3
"440","1540喬福","110/09/08","永興",0,1,-1
"441","1540喬福","110/09/08","日盛-景美",3,0,3
"442","1540喬福","110/09/08","國票-台中",0,1,-1
"443","1540喬福","110/09/08","安泰",2,0,2
"444","1540喬福","110/09/08","統一-新台中",0,0,0
"445","1540喬福","110/09/08","臺銀-新竹",2,0,2
"446","1540喬福","110/09/08","國票",0,0,0
"447","1540喬福","110/09/08","兆豐-北高雄",2,0,2
"448","1540喬福","110/09/08","康和-板橋",0,0,0
"449","1540喬福","110/09/08","日盛-台中",2,0,2
"450","1540喬福","110/09/08","國泰-板橋",7,7,0
"451","2888新光金","110/09/08","美商高盛",2902,113,2789
"452","2888新光金","110/09/08","凱基-台北",1269,8241,-6972
"453","2888新光金","110/09/08","新加坡商瑞銀",1081,42,1039
"454","2888新光金","110/09/08","瑞士信貸",521,2812,-2291
"455","2888新光金","110/09/08","兆豐-西螺",1019,1,1018
"456","2888新光金","110/09/08","國票-長城",5,1500,-1495
"457","2888新光金","110/09/08","統一-板橋",1195,302,893
"458","2888新光金","110/09/08","永豐金證券",76,1023,-947
"459","2888新光金","110/09/08","摩根大通",1716,1084,632
"460","2888新光金","110/09/08","元大證券",675,1584,-909
"461","2888新光金","110/09/08","港商麥格理",768,309,459
"462","2888新光金","110/09/08","元富-城東",111,683,-572
"463","2888新光金","110/09/08","華南永昌-虎尾",388,20,368
"464","2888新光金","110/09/08","兆豐-台中港",23,501,-478
"465","2888新光金","110/09/08","台新-台中",425,72,353
"466","2888新光金","110/09/08","元大-四維",23,450,-427
"467","2888新光金","110/09/08","富邦-虎尾",333,0,333
"468","2888新光金","110/09/08","兆豐證券",0,411,-411
"469","2888新光金","110/09/08","群益金鼎-新莊",301,1,300
"470","2888新光金","110/09/08","大昌-樹林",97,485,-388
"471","2888新光金","110/09/08","新光",718,430,288
"472","2888新光金","110/09/08","港商野村",1,377,-376
"473","2888新光金","110/09/08","臺銀-鳳山",297,12,285
"474","2888新光金","110/09/08","元大-內湖",30,339,-309
"475","2888新光金","110/09/08","永豐金-鳳山",278,0,278
"476","2888新光金","110/09/08","日盛-中和",12,319,-307
"477","2888新光金","110/09/08","元大-古亭",263,2,261
"478","2888新光金","110/09/08","群益金鼎-台中",191,492,-301
"479","2888新光金","110/09/08","元大-大里",264,5,259
"480","2888新光金","110/09/08","花旗環球",79,364,-285
"481","1340勝悅","110/09/08","凱基-台南",30,0,30
"482","1340勝悅","110/09/08","元富-彰化",0,30,-30
"483","1340勝悅","110/09/08","臺銀-鳳山",7,0,7
"484","1340勝悅","110/09/08","永全",0,18,-18
"485","1340勝悅","110/09/08","日盛-板橋",5,0,5
"486","1340勝悅","110/09/08","凱基-台北",0,13,-13
"487","1340勝悅","110/09/08","宏遠-桃園",5,0,5
"488","1340勝悅","110/09/08","美林",0,12,-12
"489","1340勝悅","110/09/08","統一-城中",8,3,5
"490","1340勝悅","110/09/08","摩根大通",0,6,-6
"491","1340勝悅","110/09/08","華南永昌-鳳山",5,0,5
"492","1340勝悅","110/09/08","臺銀-民權",0,5,-5
"493","1340勝悅","110/09/08","元富-新店",4,0,4
"494","1340勝悅","110/09/08","日盛-員林",0,5,-5
"495","1340勝悅","110/09/08","新光",4,0,4
"496","1340勝悅","110/09/08","群益金鼎-台中",0,5,-5
"497","1340勝悅","110/09/08","國泰-敦南",5,1,4
"498","1340勝悅","110/09/08","元大-忠孝鼎富",0,5,-5
"499","1340勝悅","110/09/08","凱基-台中",4,0,4
"500","1340勝悅","110/09/08","元大-新莊",0,5,-5
"501","1340勝悅","110/09/08","美商高盛",3,0,3
"502","1340勝悅","110/09/08","元大-蘆洲",0,5,-5
"503","1340勝悅","110/09/08","中國信託-嘉義",3,0,3
"504","1340勝悅","110/09/08","富邦-台中",0,4,-4
"505","1340勝悅","110/09/08","新光-桃園",3,0,3
"506","1340勝悅","110/09/08","花旗環球",0,3,-3
"507","1340勝悅","110/09/08","國泰-高雄",3,0,3
"508","1340勝悅","110/09/08","元富-文心",0,2,-2
"509","1340勝悅","110/09/08","國泰-館前",3,0,3
"510","1340勝悅","110/09/08","台中銀-豐原",0,2,-2
"511","6246臺龍","110/09/08","統一-土城",36,0,36
"512","6246臺龍","110/09/08","新光-台南",0,24,-24
"513","6246臺龍","110/09/08","台新證券",5,0,5
"514","6246臺龍","110/09/08","國泰-新莊",0,5,-5
"515","6246臺龍","110/09/08","永豐金-板新",4,0,4
"516","6246臺龍","110/09/08","元大-南崁",0,5,-5
"517","6246臺龍","110/09/08","元富-中港",2,0,2
"518","6246臺龍","110/09/08","元大-大雅",0,4,-4
"519","6246臺龍","110/09/08","德信-中正",2,0,2
"520","6246臺龍","110/09/08","台新-屏東",0,2,-2
"521","6246臺龍","110/09/08","元大-大里",2,0,2
"522","6246臺龍","110/09/08","玉山證券",0,2,-2
"523","6246臺龍","110/09/08","永豐金-嘉義",2,0,2
"524","6246臺龍","110/09/08","凱基-中港",0,2,-2
"525","6246臺龍","110/09/08","日盛-八德",1,0,1
"526","6246臺龍","110/09/08","華南永昌-台中",0,2,-2
"527","6246臺龍","110/09/08","華南永昌",1,0,1
"528","6246臺龍","110/09/08","永豐金-永康",0,2,-2
"529","6246臺龍","110/09/08","華南永昌-長虹",1,0,1
"530","6246臺龍","110/09/08","臺銀-金山",0,1,-1
"531","6246臺龍","110/09/08","華南永昌-中正",1,0,1
"532","6246臺龍","110/09/08","元富-台中",0,1,-1
"533","6246臺龍","110/09/08","富邦-新竹",1,0,1
"534","6246臺龍","110/09/08","康和-嘉義",0,1,-1
"535","6246臺龍","110/09/08","元大-新盛",1,0,1
"536","6246臺龍","110/09/08","新光-新竹",0,1,-1
"537","6246臺龍","110/09/08","永豐金-屏東",1,0,1
"538","6246臺龍","110/09/08","新光-桃園",0,1,-1
"539","6246臺龍","110/09/08","元大證券",0,0,0
"540","6246臺龍","110/09/08","玉山-桃園",0,1,-1
"541","00715L期街口布蘭特正2","110/09/08","永豐金證券",2051,0,2051
"542","00715L期街口布蘭特正2","110/09/08","元大-南崁",0,2310,-2310
"543","00715L期街口布蘭特正2","110/09/08","元富",1148,0,1148
"544","00715L期街口布蘭特正2","110/09/08","兆豐-鹿港",0,1000,-1000
"545","00715L期街口布蘭特正2","110/09/08","統一",991,0,991
"546","00715L期街口布蘭特正2","110/09/08","兆豐證券",0,960,-960
"547","00715L期街口布蘭特正2","110/09/08","富邦證券",1894,927,967
"548","00715L期街口布蘭特正2","110/09/08","元大-西屯",25,669,-644
"549","00715L期街口布蘭特正2","110/09/08","合庫證券",815,0,815
"550","00715L期街口布蘭特正2","110/09/08","港商野村",0,640,-640
"551","00715L期街口布蘭特正2","110/09/08","康和",914,200,714
"552","00715L期街口布蘭特正2","110/09/08","群益金鼎-潭子",2,551,-549
"553","00715L期街口布蘭特正2","110/09/08","台新證券",504,5,499
"554","00715L期街口布蘭特正2","110/09/08","第一金-桃園",0,500,-500
"555","00715L期街口布蘭特正2","110/09/08","群益金鼎-士林",430,5,425
"556","00715L期街口布蘭特正2","110/09/08","元大-金門",10,353,-343
"557","00715L期街口布蘭特正2","110/09/08","日盛-和美",301,11,290
"558","00715L期街口布蘭特正2","110/09/08","臺銀-民權",5,312,-307
"559","00715L期街口布蘭特正2","110/09/08","國票-中港",287,0,287
"560","00715L期街口布蘭特正2","110/09/08","富邦-嘉義",22,305,-283
"561","00715L期街口布蘭特正2","110/09/08","富邦-彰化",302,25,277
"562","00715L期街口布蘭特正2","110/09/08","群益金鼎-崇德",0,240,-240
"563","00715L期街口布蘭特正2","110/09/08","元大證券",1728,1508,220
"564","00715L期街口布蘭特正2","110/09/08","元大-復北",0,225,-225
"565","00715L期街口布蘭特正2","110/09/08","元大-中和",190,0,190
"566","00715L期街口布蘭特正2","110/09/08","元大-萬華",0,210,-210
"567","00715L期街口布蘭特正2","110/09/08","玉山-高雄",162,45,117
"568","00715L期街口布蘭特正2","110/09/08","新光",86,289,-203
"569","00715L期街口布蘭特正2","110/09/08","元大-花蓮",200,95,105
"570","00715L期街口布蘭特正2","110/09/08","臺銀-金山",9,210,-201
"571","8941關中","110/09/08","國泰-新莊",1,0,1
"572","8941關中","110/09/08","統一-台中",0,1,-1
"573","8941關中","110/09/08","群益金鼎-三重",1,0,1
"574","8941關中","110/09/08","富邦-台中",0,1,-1
"575","8941關中","110/09/08","亞東-台中",0,0,0
"576","8941關中","110/09/08","亞東-台中",0,0,0
"577","8941關中","110/09/08","元大-竹山",0,0,0
"578","8941關中","110/09/08","元大-竹山",0,0,0
"579","8941關中","110/09/08","元大-羅東",0,0,0
"580","8941關中","110/09/08","元大-羅東",0,0,0
"581","8941關中","110/09/08","元大-金華",1,1,0
"582","8941關中","110/09/08","元大-金華",1,1,0
"583","8941關中","110/09/08","永豐金-敦北",0,0,0
"584","8941關中","110/09/08","永豐金-敦北",0,0,0
"585","8941關中","110/09/08","永豐金-南投",0,0,0
"586","8941關中","110/09/08","永豐金-南投",0,0,0
"587","8941關中","110/09/08","",NA,NA,NA
"588","8941關中","110/09/08","",NA,NA,NA
"589","8941關中","110/09/08","",NA,NA,NA
"590","8941關中","110/09/08","",NA,NA,NA
"591","8941關中","110/09/08","",NA,NA,NA
"592","8941關中","110/09/08","",NA,NA,NA
"593","8941關中","110/09/08","",NA,NA,NA
"594","8941關中","110/09/08","",NA,NA,NA
"595","8941關中","110/09/08","",NA,NA,NA
"596","8941關中","110/09/08","",NA,NA,NA
"597","8941關中","110/09/08","",NA,NA,NA
"598","8941關中","110/09/08","",NA,NA,NA
"599","8941關中","110/09/08","",NA,NA,NA
"600","8941關中","110/09/08","",NA,NA,NA
"601","8936國統","110/09/08","臺銀",60,6,54
"602","8936國統","110/09/08","台灣摩根士丹利",0,68,-68
"603","8936國統","110/09/08","元大-東泰",50,0,50
"604","8936國統","110/09/08","摩根大通",6,61,-55
"605","8936國統","110/09/08","華南永昌-高雄",158,121,37
"606","8936國統","110/09/08","美商高盛",5,56,-51
"607","8936國統","110/09/08","日盛-北高雄",20,0,20
"608","8936國統","110/09/08","新加坡商瑞銀",35,73,-38
"609","8936國統","110/09/08","台中銀-高雄",16,0,16
"610","8936國統","110/09/08","元大-復北",0,23,-23
"611","8936國統","110/09/08","台新-松江",19,4,15
"612","8936國統","110/09/08","永豐金-中正",0,21,-21
"613","8936國統","110/09/08","富邦-建國",13,0,13
"614","8936國統","110/09/08","日盛-台中",0,20,-20
"615","8936國統","110/09/08","元大-台中",13,0,13
"616","8936國統","110/09/08","凱基-台北",48,66,-18
"617","8936國統","110/09/08","元大-土城學府",13,0,13
"618","8936國統","110/09/08","台新證券",3,19,-16
"619","8936國統","110/09/08","台灣企銀-北高雄",11,0,11
"620","8936國統","110/09/08","華南永昌-岡山",5,20,-15
"621","8936國統","110/09/08","新光-新竹",11,0,11
"622","8936國統","110/09/08","新光-台南",2,13,-11
"623","8936國統","110/09/08","富邦-陽明",11,0,11
"624","8936國統","110/09/08","日盛-八德",0,10,-10
"625","8936國統","110/09/08","元富-同大",10,0,10
"626","8936國統","110/09/08","台新-屏東",0,10,-10
"627","8936國統","110/09/08","國票-九鼎",10,0,10
"628","8936國統","110/09/08","凱基-三多",0,10,-10
"629","8936國統","110/09/08","玉山-高雄",10,0,10
"630","8936國統","110/09/08","元大-福營",0,10,-10
"631","6226光鼎","110/09/08","瑞士信貸",141,26,115
"632","6226光鼎","110/09/08","美商高盛",45,232,-187
"633","6226光鼎","110/09/08","永豐金-大園",91,2,89
"634","6226光鼎","110/09/08","美林",90,264,-174
"635","6226光鼎","110/09/08","摩根大通",107,48,59
"636","6226光鼎","110/09/08","元大-台中",91,237,-146
"637","6226光鼎","110/09/08","台灣摩根士丹利",55,0,55
"638","6226光鼎","110/09/08","統一-竹南",0,100,-100
"639","6226光鼎","110/09/08","第一金-自由",50,0,50
"640","6226光鼎","110/09/08","元大-仁愛",0,82,-82
"641","6226光鼎","110/09/08","元大-開元",33,0,33
"642","6226光鼎","110/09/08","華南永昌-楠梓",12,77,-65
"643","6226光鼎","110/09/08","元富-埔里",34,6,28
"644","6226光鼎","110/09/08","中國信託",9,63,-54
"645","6226光鼎","110/09/08","元大-草屯",29,1,28
"646","6226光鼎","110/09/08","富邦-宜蘭",0,51,-51
"647","6226光鼎","110/09/08","華南永昌-小港",27,0,27
"648","6226光鼎","110/09/08","元大-大灣",2,40,-38
"649","6226光鼎","110/09/08","元大-大里德芳",26,0,26
"650","6226光鼎","110/09/08","玉山-士林",9,39,-30
"651","6226光鼎","110/09/08","日盛-桃園",23,0,23
"652","6226光鼎","110/09/08","玉山-台中",8,38,-30
"653","6226光鼎","110/09/08","富邦-敦南",48,26,22
"654","6226光鼎","110/09/08","元大-東蘆",2,30,-28
"655","6226光鼎","110/09/08","永豐金-鳳山",21,0,21
"656","6226光鼎","110/09/08","元大-高雄",0,27,-27
"657","6226光鼎","110/09/08","合庫證券",20,0,20
"658","6226光鼎","110/09/08","富邦-中壢",13,39,-26
"659","6226光鼎","110/09/08","宏遠證券",20,0,20
"660","6226光鼎","110/09/08","台新-台中",10,34,-24
"661","2363矽統","110/09/08","瑞士信貸",1191,413,778
"662","2363矽統","110/09/08","新加坡商瑞銀",389,1526,-1137
"663","2363矽統","110/09/08","第一金-桃園",460,71,389
"664","2363矽統","110/09/08","永豐金-竹科",205,908,-703
"665","2363矽統","110/09/08","兆豐-新竹",611,322,289
"666","2363矽統","110/09/08","群益金鼎-敦南",24,416,-392
"667","2363矽統","110/09/08","兆豐-南京",229,20,209
"668","2363矽統","110/09/08","合庫-高雄",37,428,-391
"669","2363矽統","110/09/08","康和-板橋",193,17,176
"670","2363矽統","110/09/08","陽信-石牌",514,874,-360
"671","2363矽統","110/09/08","元大-佳里",185,28,157
"672","2363矽統","110/09/08","永豐金證券",74,424,-350
"673","2363矽統","110/09/08","永豐金-板新",272,127,145
"674","2363矽統","110/09/08","凱基-台北",2085,2402,-317
"675","2363矽統","110/09/08","台新-建北",174,35,139
"676","2363矽統","110/09/08","美商高盛",186,413,-227
"677","2363矽統","110/09/08","凱基-南崁",136,7,129
"678","2363矽統","110/09/08","富邦證券",6,223,-217
"679","2363矽統","110/09/08","元大-土城",200,75,125
"680","2363矽統","110/09/08","富隆-長安",2,203,-201
"681","2363矽統","110/09/08","元大-龍潭",245,131,114
"682","2363矽統","110/09/08","新光-高雄",127,325,-198
"683","2363矽統","110/09/08","永豐金-南投",260,153,107
"684","2363矽統","110/09/08","群益金鼎",171,359,-188
"685","2363矽統","110/09/08","富邦-嘉義",286,180,106
"686","2363矽統","110/09/08","永豐金-羅東",199,383,-184
"687","2363矽統","110/09/08","國泰-高雄",229,125,104
"688","2363矽統","110/09/08","摩根大通",771,935,-164
"689","2363矽統","110/09/08","元富-永和",120,17,103
"690","2363矽統","110/09/08","元大-前金",75,234,-159
"691","8112至上","110/09/08","摩根大通",165,13,152
"692","8112至上","110/09/08","國票-中港",0,125,-125
"693","8112至上","110/09/08","元大-清水",83,1,82
"694","8112至上","110/09/08","宏遠證券",0,100,-100
"695","8112至上","110/09/08","華南永昌-中正",60,0,60
"696","8112至上","110/09/08","台新-台中",0,84,-84
"697","8112至上","110/09/08","美商高盛",73,17,56
"698","8112至上","110/09/08","凱基-台北",109,172,-63
"699","8112至上","110/09/08","凱基-三重",54,1,53
"700","8112至上","110/09/08","兆豐-來福",0,60,-60
"701","8112至上","110/09/08","凱基-嘉義",47,0,47
"702","8112至上","110/09/08","凱基-高雄",0,50,-50
"703","8112至上","110/09/08","美林",62,19,43
"704","8112至上","110/09/08","新光-台南",7,49,-42
"705","8112至上","110/09/08","元大-竹東",48,10,38
"706","8112至上","110/09/08","永豐金-敦南",4,42,-38
"707","8112至上","110/09/08","台新-新營",35,0,35
"708","8112至上","110/09/08","大展-台南",0,36,-36
"709","8112至上","110/09/08","中國信託",24,0,24
"710","8112至上","110/09/08","元大證券",2,36,-34
"711","8112至上","110/09/08","瑞士信貸",22,0,22
"712","8112至上","110/09/08","兆豐-忠孝",0,32,-32
"713","8112至上","110/09/08","富邦-仁愛",25,3,22
"714","8112至上","110/09/08","台新-新莊",0,30,-30
"715","8112至上","110/09/08","富邦-台北",21,0,21
"716","8112至上","110/09/08","法銀巴黎",0,29,-29
"717","8112至上","110/09/08","統一-南京",20,0,20
"718","8112至上","110/09/08","臺銀",2,28,-26
"719","8112至上","110/09/08","華南永昌",25,5,20
"720","8112至上","110/09/08","國泰-敦南",9,33,-24
"721","1570力肯","110/09/08","國票-和平",76,0,76
"722","1570力肯","110/09/08","凱基-台北",0,64,-64
"723","1570力肯","110/09/08","陽信",34,0,34
"724","1570力肯","110/09/08","新光",2,36,-34
"725","1570力肯","110/09/08","日盛-宜蘭",25,0,25
"726","1570力肯","110/09/08","元大-內湖",0,30,-30
"727","1570力肯","110/09/08","群益金鼎-中港",10,0,10
"728","1570力肯","110/09/08","新光-新竹",0,18,-18
"729","1570力肯","110/09/08","群益金鼎-中壢",10,0,10
"730","1570力肯","110/09/08","摩根大通",0,14,-14
"731","1570力肯","110/09/08","富邦-彰化",10,0,10
"732","1570力肯","110/09/08","日盛-板橋",0,13,-13
"733","1570力肯","110/09/08","永豐金-屏東",10,0,10
"734","1570力肯","110/09/08","兆豐-新營",0,11,-11
"735","1570力肯","110/09/08","國票-南科",8,0,8
"736","1570力肯","110/09/08","群益金鼎-高雄",0,11,-11
"737","1570力肯","110/09/08","永豐金-苓雅",8,0,8
"738","1570力肯","110/09/08","富邦-新店",0,10,-10
"739","1570力肯","110/09/08","元大-龍潭",7,0,7
"740","1570力肯","110/09/08","永豐金-新竹",0,9,-9
"741","1570力肯","110/09/08","彰銀-七賢",6,0,6
"742","1570力肯","110/09/08","台灣摩根士丹利",0,7,-7
"743","1570力肯","110/09/08","臺銀-新竹",5,0,5
"744","1570力肯","110/09/08","凱基-文心",5,12,-7
"745","1570力肯","110/09/08","群益金鼎-鳳山",5,0,5
"746","1570力肯","110/09/08","統一-新竹",0,5,-5
"747","1570力肯","110/09/08","元大-大里",5,0,5
"748","1570力肯","110/09/08","元大-竹科",0,5,-5
"749","1570力肯","110/09/08","元大-新竹經國",5,0,5
"750","1570力肯","110/09/08","元大-敦化",0,5,-5
"751","2929淘帝","110/09/08","富邦-新竹",19,0,19
"752","2929淘帝","110/09/08","群益金鼎-三重",0,29,-29
"753","2929淘帝","110/09/08","新光-台中",16,1,15
"754","2929淘帝","110/09/08","永豐金-敦南",0,24,-24
"755","2929淘帝","110/09/08","大昌",10,0,10
"756","2929淘帝","110/09/08","國泰-松江",0,20,-20
"757","2929淘帝","110/09/08","摩根大通",10,0,10
"758","2929淘帝","110/09/08","日盛-龍潭",0,11,-11
"759","2929淘帝","110/09/08","日盛-雙和",8,0,8
"760","2929淘帝","110/09/08","統一-汐止",0,10,-10
"761","2929淘帝","110/09/08","台新證券",8,0,8
"762","2929淘帝","110/09/08","日盛-新莊",0,8,-8
"763","2929淘帝","110/09/08","台新-台中",7,0,7
"764","2929淘帝","110/09/08","美林",1,8,-7
"765","2929淘帝","110/09/08","富邦-台南",5,0,5
"766","2929淘帝","110/09/08","亞東",0,6,-6
"767","2929淘帝","110/09/08","元大-土城",5,0,5
"768","2929淘帝","110/09/08","凱基-中山",1,6,-5
"769","2929淘帝","110/09/08","元大-左營",5,0,5
"770","2929淘帝","110/09/08","群益金鼎",0,4,-4
"771","2929淘帝","110/09/08","永豐金-博愛",5,0,5
"772","2929淘帝","110/09/08","華南永昌-南京",0,4,-4
"773","2929淘帝","110/09/08","第一金-華江",5,1,4
"774","2929淘帝","110/09/08","中國信託-永康",0,3,-3
"775","2929淘帝","110/09/08","元富-吉利",4,0,4
"776","2929淘帝","110/09/08","兆豐-台中港",0,2,-2
"777","2929淘帝","110/09/08","光和-花壇",4,0,4
"778","2929淘帝","110/09/08","兆豐-大同",0,2,-2
"779","2929淘帝","110/09/08","兆豐-忠孝",4,0,4
"780","2929淘帝","110/09/08","國泰-板橋",1,3,-2
"781","5410國眾","110/09/08","華南永昌-高雄",20,0,20
"782","5410國眾","110/09/08","國泰-敦南",3,28,-25
"783","5410國眾","110/09/08","玉山-嘉義",4,0,4
"784","5410國眾","110/09/08","亞東-新竹",0,19,-19
"785","5410國眾","110/09/08","元大-高雄",3,0,3
"786","5410國眾","110/09/08","凱基-台北",0,6,-6
"787","5410國眾","110/09/08","兆豐-岡山",3,0,3
"788","5410國眾","110/09/08","亞東-板橋",0,5,-5
"789","5410國眾","110/09/08","凱基-中壢",3,0,3
"790","5410國眾","110/09/08","日盛-二林",0,4,-4
"791","5410國眾","110/09/08","華南永昌-台中",2,0,2
"792","5410國眾","110/09/08","摩根大通",0,4,-4
"793","5410國眾","110/09/08","元大-蘆洲",2,0,2
"794","5410國眾","110/09/08","美林",0,2,-2
"795","5410國眾","110/09/08","元大-大統",2,0,2
"796","5410國眾","110/09/08","日盛-雙和",0,1,-1
"797","5410國眾","110/09/08","華南永昌-林口",2,0,2
"798","5410國眾","110/09/08","新加坡商瑞銀",0,1,-1
"799","5410國眾","110/09/08","統一-台中",2,0,2
"800","5410國眾","110/09/08","群益金鼎-建成",0,1,-1
"801","5410國眾","110/09/08","日盛-士林",2,0,2
"802","5410國眾","110/09/08","元大-新營",0,1,-1
"803","5410國眾","110/09/08","臺銀-金山",1,0,1
"804","5410國眾","110/09/08","華南永昌-內壢",0,0,0
"805","5410國眾","110/09/08","日盛-新竹",1,0,1
"806","5410國眾","110/09/08","富邦-員林",0,0,0
"807","5410國眾","110/09/08","日盛-景美",1,0,1
"808","5410國眾","110/09/08","元大-台中中港",0,0,0
"809","5410國眾","110/09/08","日盛-八德",1,0,1
"810","5410國眾","110/09/08","元大-左營",0,0,0
"811","2841台開","110/09/08","日盛證券",143,24,119
"812","2841台開","110/09/08","元大-善化",0,130,-130
"813","2841台開","110/09/08","元大-南投",84,0,84
"814","2841台開","110/09/08","元大-台中中港",0,50,-50
"815","2841台開","110/09/08","永豐金-敦南",117,43,74
"816","2841台開","110/09/08","永豐金-員林",0,35,-35
"817","2841台開","110/09/08","新光",67,7,60
"818","2841台開","110/09/08","富邦-台北",1,34,-33
"819","2841台開","110/09/08","國泰-館前",38,0,38
"820","2841台開","110/09/08","富邦-台南",0,30,-30
"821","2841台開","110/09/08","元大-大里",30,0,30
"822","2841台開","110/09/08","光和-高雄",0,29,-29
"823","2841台開","110/09/08","群益金鼎-彰化",29,0,29
"824","2841台開","110/09/08","群益金鼎-竹南",0,29,-29
"825","2841台開","110/09/08","華南永昌-東昇",26,0,26
"826","2841台開","110/09/08","元大-西屯",0,20,-20
"827","2841台開","110/09/08","宏遠-館前",20,0,20
"828","2841台開","110/09/08","元大-復北",0,18,-18
"829","2841台開","110/09/08","元大-松江",20,0,20
"830","2841台開","110/09/08","台灣摩根士丹利",0,17,-17
"831","2841台開","110/09/08","大昌-安康",18,6,12
"832","2841台開","110/09/08","合庫-台南",0,11,-11
"833","2841台開","110/09/08","大慶-蘆洲",10,0,10
"834","2841台開","110/09/08","元大-崇德",0,11,-11
"835","2841台開","110/09/08","華南永昌",10,0,10
"836","2841台開","110/09/08","台灣企銀-太平",0,10,-10
"837","2841台開","110/09/08","元大-天母",10,0,10
"838","2841台開","110/09/08","統一-員林",0,10,-10
"839","2841台開","110/09/08","元大-仁愛",10,0,10
"840","2841台開","110/09/08","台中銀-豐原",0,10,-10
"841","6207雷科","110/09/08","台新-高雄",19,0,19
"842","6207雷科","110/09/08","凱基-三重",2,45,-43
"843","6207雷科","110/09/08","永全-八德",13,0,13
"844","6207雷科","110/09/08","新加坡商瑞銀",8,26,-18
"845","6207雷科","110/09/08","兆豐-台南",10,0,10
"846","6207雷科","110/09/08","摩根大通",24,36,-12
"847","6207雷科","110/09/08","凱基-台南",10,0,10
"848","6207雷科","110/09/08","台灣企銀-屏東",0,10,-10
"849","6207雷科","110/09/08","兆豐-高雄",9,2,7
"850","6207雷科","110/09/08","國票-台南",0,10,-10
"851","6207雷科","110/09/08","永豐金-高雄",7,0,7
"852","6207雷科","110/09/08","富邦-虎尾",0,10,-10
"853","6207雷科","110/09/08","統一-敦南",5,0,5
"854","6207雷科","110/09/08","中國信託-三重",0,8,-8
"855","6207雷科","110/09/08","新光",5,0,5
"856","6207雷科","110/09/08","凱基-台北",20,28,-8
"857","6207雷科","110/09/08","元大-苑裡",5,0,5
"858","6207雷科","110/09/08","元大-樹林",0,7,-7
"859","6207雷科","110/09/08","玉山-大里",4,0,4
"860","6207雷科","110/09/08","玉山-左營",1,7,-6
"861","6207雷科","110/09/08","群益金鼎-瑞豐",4,0,4
"862","6207雷科","110/09/08","台新-台南",0,5,-5
"863","6207雷科","110/09/08","元大-南海",4,0,4
"864","6207雷科","110/09/08","華南永昌-內壢",0,5,-5
"865","6207雷科","110/09/08","臺銀-高雄",3,0,3
"866","6207雷科","110/09/08","國泰-板橋",0,4,-4
"867","6207雷科","110/09/08","高橋",3,0,3
"868","6207雷科","110/09/08","日盛-士林",0,3,-3
"869","6207雷科","110/09/08","新光-台中",3,0,3
"870","6207雷科","110/09/08","華南永昌-淡水",0,3,-3
"871","3679新至陞","110/09/08","元大-大天母",10,0,10
"872","3679新至陞","110/09/08","華南永昌-台中",0,21,-21
"873","3679新至陞","110/09/08","凱基-長庚",8,0,8
"874","3679新至陞","110/09/08","瑞士信貸",0,14,-14
"875","3679新至陞","110/09/08","華南永昌-小港",5,0,5
"876","3679新至陞","110/09/08","摩根大通",0,9,-9
"877","3679新至陞","110/09/08","元大-北三重",5,0,5
"878","3679新至陞","110/09/08","凱基-台北",3,10,-7
"879","3679新至陞","110/09/08","日盛-台中",4,0,4
"880","3679新至陞","110/09/08","台灣摩根士丹利",0,6,-6
"881","3679新至陞","110/09/08","日盛-嘉義",3,0,3
"882","3679新至陞","110/09/08","元富-基隆",0,5,-5
"883","3679新至陞","110/09/08","國票-台東",3,0,3
"884","3679新至陞","110/09/08","富邦-陽明",0,5,-5
"885","3679新至陞","110/09/08","元大-板橋",3,0,3
"886","3679新至陞","110/09/08","玉山-台大",0,4,-4
"887","3679新至陞","110/09/08","土銀-士林",2,0,2
"888","3679新至陞","110/09/08","元大證券",2,6,-4
"889","3679新至陞","110/09/08","宏遠-館前",2,0,2
"890","3679新至陞","110/09/08","凱基-東勢",0,3,-3
"891","3679新至陞","110/09/08","元富-緯城",2,0,2
"892","3679新至陞","110/09/08","華南永昌-麻豆",0,3,-3
"893","3679新至陞","110/09/08","日茂",2,0,2
"894","3679新至陞","110/09/08","元大-竹北",0,3,-3
"895","3679新至陞","110/09/08","兆豐-竹北",2,0,2
"896","3679新至陞","110/09/08","凱基-彰化",0,2,-2
"897","3679新至陞","110/09/08","國票-九鼎",2,0,2
"898","3679新至陞","110/09/08","富邦-板橋",0,2,-2
"899","3679新至陞","110/09/08","玉山-嘉義",2,0,2
"900","3679新至陞","110/09/08","元大-土城",0,2,-2
"901","2727王品","110/09/08","元大-台中中港",268,0,268
"902","2727王品","110/09/08","宏遠證券",0,81,-81
"903","2727王品","110/09/08","台灣摩根士丹利",93,4,89
"904","2727王品","110/09/08","台灣匯立證券",0,58,-58
"905","2727王品","110/09/08","凱基-台北",117,41,76
"906","2727王品","110/09/08","元大-忠孝",1,59,-58
"907","2727王品","110/09/08","港商野村",91,17,74
"908","2727王品","110/09/08","美商高盛",91,148,-57
"909","2727王品","110/09/08","新加坡商瑞銀",22,0,22
"910","2727王品","110/09/08","新光-台中",2,47,-45
"911","2727王品","110/09/08","摩根大通",71,50,21
"912","2727王品","110/09/08","元富-安南",0,31,-31
"913","2727王品","110/09/08","美林",49,32,17
"914","2727王品","110/09/08","永豐金證券",3,33,-30
"915","2727王品","110/09/08","兆豐-新莊",18,1,17
"916","2727王品","110/09/08","永豐金-松山",0,27,-27
"917","2727王品","110/09/08","(牛牛牛)亞-鑫豐",17,2,15
"918","2727王品","110/09/08","國泰-敦南",22,46,-24
"919","2727王品","110/09/08","日盛-屏東",15,1,14
"920","2727王品","110/09/08","富邦-南屯",6,25,-19
"921","2727王品","110/09/08","新光",25,13,12
"922","2727王品","110/09/08","凱基-台東",1,19,-18
"923","2727王品","110/09/08","德信",10,0,10
"924","2727王品","110/09/08","瑞士信貸",2,19,-17
"925","2727王品","110/09/08","台新證券",23,14,9
"926","2727王品","110/09/08","永豐金-中和",0,17,-17
"927","2727王品","110/09/08","凱基-板橋",10,2,8
"928","2727王品","110/09/08","富邦-台中",2,16,-14
"929","2727王品","110/09/08","永豐金-嘉義",7,0,7
"930","2727王品","110/09/08","中國信託-忠孝",0,13,-13
"931","1570力肯","110/09/08","國票-和平",76,0,76
"932","1570力肯","110/09/08","凱基-台北",0,64,-64
"933","1570力肯","110/09/08","陽信",34,0,34
"934","1570力肯","110/09/08","新光",2,36,-34
"935","1570力肯","110/09/08","日盛-宜蘭",25,0,25
"936","1570力肯","110/09/08","元大-內湖",0,30,-30
"937","1570力肯","110/09/08","群益金鼎-中港",10,0,10
"938","1570力肯","110/09/08","新光-新竹",0,18,-18
"939","1570力肯","110/09/08","群益金鼎-中壢",10,0,10
"940","1570力肯","110/09/08","摩根大通",0,14,-14
"941","1570力肯","110/09/08","富邦-彰化",10,0,10
"942","1570力肯","110/09/08","日盛-板橋",0,13,-13
"943","1570力肯","110/09/08","永豐金-屏東",10,0,10
"944","1570力肯","110/09/08","兆豐-新營",0,11,-11
"945","1570力肯","110/09/08","國票-南科",8,0,8
"946","1570力肯","110/09/08","群益金鼎-高雄",0,11,-11
"947","1570力肯","110/09/08","永豐金-苓雅",8,0,8
"948","1570力肯","110/09/08","富邦-新店",0,10,-10
"949","1570力肯","110/09/08","元大-龍潭",7,0,7
"950","1570力肯","110/09/08","永豐金-新竹",0,9,-9
"951","1570力肯","110/09/08","彰銀-七賢",6,0,6
"952","1570力肯","110/09/08","台灣摩根士丹利",0,7,-7
"953","1570力肯","110/09/08","臺銀-新竹",5,0,5
"954","1570力肯","110/09/08","凱基-文心",5,12,-7
"955","1570力肯","110/09/08","群益金鼎-鳳山",5,0,5
"956","1570力肯","110/09/08","統一-新竹",0,5,-5
"957","1570力肯","110/09/08","元大-大里",5,0,5
"958","1570力肯","110/09/08","元大-竹科",0,5,-5
"959","1570力肯","110/09/08","元大-新竹經國",5,0,5
"960","1570力肯","110/09/08","元大-敦化",0,5,-5
"961","6180橘子","110/09/08","富邦-仁愛",40,0,40
"962","6180橘子","110/09/08","摩根大通",28,50,-22
"963","6180橘子","110/09/08","新光-桃園",17,0,17
"964","6180橘子","110/09/08","兆豐-埔墘",0,10,-10
"965","6180橘子","110/09/08","群益金鼎-台中",10,0,10
"966","6180橘子","110/09/08","元大-大安",0,10,-10
"967","6180橘子","110/09/08","富邦-中壢",8,0,8
"968","6180橘子","110/09/08","國泰-敦南",1,10,-9
"969","6180橘子","110/09/08","中國信託",8,1,7
"970","6180橘子","110/09/08","凱基-三重",0,9,-9
"971","6180橘子","110/09/08","中國信託-文心",55,50,5
"972","6180橘子","110/09/08","富邦-員林",0,9,-9
"973","6180橘子","110/09/08","台新證券",5,0,5
"974","6180橘子","110/09/08","元大-台南",1,10,-9
"975","6180橘子","110/09/08","群益金鼎-東湖",5,0,5
"976","6180橘子","110/09/08","美商高盛",0,8,-8
"977","6180橘子","110/09/08","凱基-台北",20,15,5
"978","6180橘子","110/09/08","國票-南港",0,6,-6
"979","6180橘子","110/09/08","華南永昌-公誠",5,0,5
"980","6180橘子","110/09/08","新光",2,8,-6
"981","6180橘子","110/09/08","日盛-園區",4,0,4
"982","6180橘子","110/09/08","富邦-嘉義",0,6,-6
"983","6180橘子","110/09/08","臺銀-民權",3,0,3
"984","6180橘子","110/09/08","新加坡商瑞銀",5,10,-5
"985","6180橘子","110/09/08","統一-台中",3,0,3
"986","6180橘子","110/09/08","元富-民權",0,5,-5
"987","6180橘子","110/09/08","元富-台中",3,0,3
"988","6180橘子","110/09/08","元富-新興",0,5,-5
"989","6180橘子","110/09/08","玉山-高雄",3,0,3
"990","6180橘子","110/09/08","台中銀-員林",0,5,-5
"991","2390云辰","110/09/08","元大-土城學府",222,60,162
"992","2390云辰","110/09/08","摩根大通",5,343,-338
"993","2390云辰","110/09/08","國票-安和",150,0,150
"994","2390云辰","110/09/08","台灣摩根士丹利",78,309,-231
"995","2390云辰","110/09/08","美商高盛",200,58,142
"996","2390云辰","110/09/08","美林",31,179,-148
"997","2390云辰","110/09/08","元大證券",127,35,92
"998","2390云辰","110/09/08","華南永昌-中正",6,113,-107
"999","2390云辰","110/09/08","元富-安南",93,2,91
"1000","2390云辰","110/09/08","統一-新台中",0,85,-85
"1001","2390云辰","110/09/08","凱基-高雄",70,6,64
"1002","2390云辰","110/09/08","港商野村",251,318,-67
"1003","2390云辰","110/09/08","華南永昌-楠梓",95,35,60
"1004","2390云辰","110/09/08","玉山-台中",3,57,-54
"1005","2390云辰","110/09/08","新光-高雄",60,20,40
"1006","2390云辰","110/09/08","國票-博愛",60,110,-50
"1007","2390云辰","110/09/08","凱基-八德",40,0,40
"1008","2390云辰","110/09/08","玉山-新莊",10,50,-40
"1009","2390云辰","110/09/08","元大-南屯",51,21,30
"1010","2390云辰","110/09/08","大慶-富順",10,39,-29
"1011","2390云辰","110/09/08","凱基-台北",200,174,26
"1012","2390云辰","110/09/08","元大-松江",1,30,-29
"1013","2390云辰","110/09/08","康和",25,0,25
"1014","2390云辰","110/09/08","凱基-虎尾",1,28,-27
"1015","2390云辰","110/09/08","永豐金-中壢",25,0,25
"1016","2390云辰","110/09/08","富邦-竹北",13,40,-27
"1017","2390云辰","110/09/08","台新-高雄",26,2,24
"1018","2390云辰","110/09/08","新加坡商瑞銀",93,115,-22
"1019","2390云辰","110/09/08","台新-台中",59,36,23
"1020","2390云辰","110/09/08","凱基-長庚",1,21,-20
