"","stake","date","name","buy","sell","total"
"1","1315達新","110/08/25","凱基-中港",7,0,7
"2","1315達新","110/08/25","群益金鼎-東湖",0,9,-9
"3","1315達新","110/08/25","富邦-台中",7,0,7
"4","1315達新","110/08/25","永豐金證券",0,8,-8
"5","1315達新","110/08/25","台灣摩根士丹利",4,0,4
"6","1315達新","110/08/25","群益金鼎-瑞豐",0,3,-3
"7","1315達新","110/08/25","元大-歸仁",2,0,2
"8","1315達新","110/08/25","元富-世貿",0,2,-2
"9","1315達新","110/08/25","元大-南屯",2,0,2
"10","1315達新","110/08/25","元富-花蓮",0,2,-2
"11","1315達新","110/08/25","永豐金-中正",2,0,2
"12","1315達新","110/08/25","元大-文心興安",0,2,-2
"13","1315達新","110/08/25","統一-城中",1,0,1
"14","1315達新","110/08/25","宏遠-館前",0,1,-1
"15","1315達新","110/08/25","統一-三重",1,0,1
"16","1315達新","110/08/25","統一-敦南",0,1,-1
"17","1315達新","110/08/25","德信-中正",1,0,1
"18","1315達新","110/08/25","元富-文心",0,1,-1
"19","1315達新","110/08/25","玉山-新莊",1,0,1
"20","1315達新","110/08/25","兆豐-嘉義",0,1,-1
"21","1315達新","110/08/25","國泰-台南",1,0,1
"22","1315達新","110/08/25","凱基-市政",0,1,-1
"23","1315達新","110/08/25","群益金鼎-建成",1,0,1
"24","1315達新","110/08/25","元大-開元",0,1,-1
"25","1315達新","110/08/25","群益金鼎-鳳山",1,0,1
"26","1315達新","110/08/25","元大-東蘆",0,1,-1
"27","1315達新","110/08/25","凱基",1,0,1
"28","1315達新","110/08/25","元大-桃園",0,1,-1
"29","1315達新","110/08/25","凱基-台北",1,0,1
"30","1315達新","110/08/25","元大-北投",0,1,-1
"31","2609陽明","110/08/25","康和",4817,1130,3687
"32","2609陽明","110/08/25","富邦證券",20,1499,-1479
"33","2609陽明","110/08/25","富邦-虎尾",5954,3739,2215
"34","2609陽明","110/08/25","華南永昌-虎尾",60,1507,-1447
"35","2609陽明","110/08/25","台灣摩根士丹利",2126,25,2101
"36","2609陽明","110/08/25","華南永昌-竹北",35,1362,-1327
"37","2609陽明","110/08/25","凱基-台北",2778,942,1836
"38","2609陽明","110/08/25","富邦-建國",327,1397,-1070
"39","2609陽明","110/08/25","兆豐-虎尾",5704,4355,1349
"40","2609陽明","110/08/25","群益金鼎-大安",177,815,-638
"41","2609陽明","110/08/25","元大-開元",1090,150,940
"42","2609陽明","110/08/25","永豐金-松山",135,646,-511
"43","2609陽明","110/08/25","新加坡商瑞銀",1582,730,852
"44","2609陽明","110/08/25","華南永昌-長虹",344,810,-466
"45","2609陽明","110/08/25","統一-仁愛",961,139,822
"46","2609陽明","110/08/25","新光",1804,2222,-418
"47","2609陽明","110/08/25","瑞士信貸",1307,553,754
"48","2609陽明","110/08/25","合庫-桃園",48,447,-399
"49","2609陽明","110/08/25","美林",4574,3894,680
"50","2609陽明","110/08/25","元大-雙和",203,536,-333
"51","2609陽明","110/08/25","國票-彰化",685,112,573
"52","2609陽明","110/08/25","永豐金證券",145,468,-323
"53","2609陽明","110/08/25","摩根大通",4654,4103,551
"54","2609陽明","110/08/25","兆豐-板橋",88,398,-310
"55","2609陽明","110/08/25","日盛-板橋",648,186,462
"56","2609陽明","110/08/25","群益金鼎-敦南",98,346,-248
"57","2609陽明","110/08/25","兆豐-彰化",904,448,456
"58","2609陽明","110/08/25","國泰-敦南",1686,1916,-230
"59","2609陽明","110/08/25","兆豐-中壢",425,15,410
"60","2609陽明","110/08/25","元大-佳里",54,271,-217
"61","2636台驊投控","110/08/25","凱基-台北",791,245,546
"62","2636台驊投控","110/08/25","日進",10,242,-232
"63","2636台驊投控","110/08/25","美商高盛",508,168,340
"64","2636台驊投控","110/08/25","兆豐-中壢",0,209,-209
"65","2636台驊投控","110/08/25","國票-彰化",292,29,263
"66","2636台驊投控","110/08/25","元大-松江",3,68,-65
"67","2636台驊投控","110/08/25","美林",331,117,214
"68","2636台驊投控","110/08/25","國泰-敦南",61,106,-45
"69","2636台驊投控","110/08/25","摩根大通",424,213,211
"70","2636台驊投控","110/08/25","富邦-嘉義",10,55,-45
"71","2636台驊投控","110/08/25","港商野村",852,674,178
"72","2636台驊投控","110/08/25","群益金鼎-大安",2,43,-41
"73","2636台驊投控","110/08/25","台灣摩根士丹利",205,89,116
"74","2636台驊投控","110/08/25","元大-林森",45,84,-39
"75","2636台驊投控","110/08/25","瑞士信貸",148,86,62
"76","2636台驊投控","110/08/25","華南永昌-合泰",0,36,-36
"77","2636台驊投控","110/08/25","元大-士林",43,0,43
"78","2636台驊投控","110/08/25","富邦-建國",17,52,-35
"79","2636台驊投控","110/08/25","宏遠-台南",37,3,34
"80","2636台驊投控","110/08/25","兆豐-城中",1,31,-30
"81","2636台驊投控","110/08/25","永豐金-萬盛",38,4,34
"82","2636台驊投控","110/08/25","新光-台中",33,62,-29
"83","2636台驊投控","110/08/25","凱基-鳳山",32,2,30
"84","2636台驊投控","110/08/25","台新-台中",13,40,-27
"85","2636台驊投控","110/08/25","元大-桃園",29,1,28
"86","2636台驊投控","110/08/25","玉山證券",20,47,-27
"87","2636台驊投控","110/08/25","新加坡商瑞銀",58,33,25
"88","2636台驊投控","110/08/25","永豐金-天母",3,30,-27
"89","2636台驊投控","110/08/25","兆豐-三民",21,0,21
"90","2636台驊投控","110/08/25","元大-成功",2,24,-22
"91","2867三商壽","110/08/25","華南永昌-大安",201,0,201
"92","2867三商壽","110/08/25","元大-北投",0,384,-384
"93","2867三商壽","110/08/25","元大-竹科",140,0,140
"94","2867三商壽","110/08/25","摩根大通",78,315,-237
"95","2867三商壽","110/08/25","美林",174,50,124
"96","2867三商壽","110/08/25","國泰證券",0,150,-150
"97","2867三商壽","110/08/25","凱基-台北",125,26,99
"98","2867三商壽","110/08/25","土銀-台中",0,120,-120
"99","2867三商壽","110/08/25","瑞士信貸",98,0,98
"100","2867三商壽","110/08/25","台灣摩根士丹利",0,120,-120
"101","2867三商壽","110/08/25","兆豐-新營",70,0,70
"102","2867三商壽","110/08/25","日盛-員林",0,99,-99
"103","2867三商壽","110/08/25","兆豐-永和",64,0,64
"104","2867三商壽","110/08/25","兆豐-斗南",0,40,-40
"105","2867三商壽","110/08/25","群益金鼎-大甲",47,4,43
"106","2867三商壽","110/08/25","中國信託-永康",0,35,-35
"107","2867三商壽","110/08/25","群益金鼎-東門",40,0,40
"108","2867三商壽","110/08/25","群益金鼎-屏東",0,32,-32
"109","2867三商壽","110/08/25","元大-沙鹿",40,0,40
"110","2867三商壽","110/08/25","群益金鼎-彰化",2,32,-30
"111","2867三商壽","110/08/25","國泰-板橋",40,1,39
"112","2867三商壽","110/08/25","元大-基隆孝二",0,30,-30
"113","2867三商壽","110/08/25","元大-桃園",36,0,36
"114","2867三商壽","110/08/25","元大-四維",0,25,-25
"115","2867三商壽","110/08/25","合庫-基隆",30,0,30
"116","2867三商壽","110/08/25","國票-北高雄",0,20,-20
"117","2867三商壽","110/08/25","凱基",26,0,26
"118","2867三商壽","110/08/25","華南永昌-南京",0,20,-20
"119","2867三商壽","110/08/25","兆豐-台南",25,0,25
"120","2867三商壽","110/08/25","宏遠-台中",0,16,-16
"121","5521工信","110/08/25","凱基-台北",112,46,66
"122","5521工信","110/08/25","兆豐-桃園",0,207,-207
"123","5521工信","110/08/25","元大證券",66,0,66
"124","5521工信","110/08/25","台灣摩根士丹利",1,206,-205
"125","5521工信","110/08/25","元大-大統",42,0,42
"126","5521工信","110/08/25","華南永昌-朴子",10,53,-43
"127","5521工信","110/08/25","元大-南屯",40,0,40
"128","5521工信","110/08/25","美林",0,35,-35
"129","5521工信","110/08/25","華南永昌",38,0,38
"130","5521工信","110/08/25","國泰-板橋",0,34,-34
"131","5521工信","110/08/25","合庫-台南",30,0,30
"132","5521工信","110/08/25","豐農",0,30,-30
"133","5521工信","110/08/25","高橋-內壢",30,0,30
"134","5521工信","110/08/25","富邦-新竹",0,21,-21
"135","5521工信","110/08/25","摩根大通",121,91,30
"136","5521工信","110/08/25","群益金鼎-萬華",0,20,-20
"137","5521工信","110/08/25","台新-左楠",28,0,28
"138","5521工信","110/08/25","元大-基隆孝二",0,20,-20
"139","5521工信","110/08/25","日盛-斗六",26,0,26
"140","5521工信","110/08/25","凱基-斗六",2,20,-18
"141","5521工信","110/08/25","元大-東蘆",21,0,21
"142","5521工信","110/08/25","富邦-陽明",0,16,-16
"143","5521工信","110/08/25","第一金-新竹",21,3,18
"144","5521工信","110/08/25","港商野村",0,13,-13
"145","5521工信","110/08/25","玉山-新莊",16,0,16
"146","5521工信","110/08/25","群益金鼎-館前",0,11,-11
"147","5521工信","110/08/25","元大-北投",15,0,15
"148","5521工信","110/08/25","土銀-高雄",0,10,-10
"149","5521工信","110/08/25","凱基-台東",15,1,14
"150","5521工信","110/08/25","統一",0,10,-10
"151","1471首利","110/08/25","元大-敦化",86,0,86
"152","1471首利","110/08/25","元大-清水",0,111,-111
"153","1471首利","110/08/25","凱基-台北",46,0,46
"154","1471首利","110/08/25","群益金鼎-東大",0,78,-78
"155","1471首利","110/08/25","美林",34,0,34
"156","1471首利","110/08/25","新光",0,39,-39
"157","1471首利","110/08/25","摩根大通",53,26,27
"158","1471首利","110/08/25","國票-北高雄",0,25,-25
"159","1471首利","110/08/25","凱基-五股",25,0,25
"160","1471首利","110/08/25","富邦-高雄",0,15,-15
"161","1471首利","110/08/25","日盛-樹林",20,0,20
"162","1471首利","110/08/25","兆豐-員林",0,14,-14
"163","1471首利","110/08/25","瑞士信貸",20,0,20
"164","1471首利","110/08/25","元大-土城永寧",0,13,-13
"165","1471首利","110/08/25","元大-莒光",21,5,16
"166","1471首利","110/08/25","盈溢-楠梓",0,11,-11
"167","1471首利","110/08/25","統一-新台中",15,0,15
"168","1471首利","110/08/25","元大-大里",0,11,-11
"169","1471首利","110/08/25","永豐金-敦南",15,0,15
"170","1471首利","110/08/25","日盛-高雄",5,15,-10
"171","1471首利","110/08/25","光和-溪湖",13,0,13
"172","1471首利","110/08/25","凱基-竹科",0,10,-10
"173","1471首利","110/08/25","日盛-屏東",10,0,10
"174","1471首利","110/08/25","元大-斗信",0,10,-10
"175","1471首利","110/08/25","兆豐-高雄",10,0,10
"176","1471首利","110/08/25","第一金-台南",1,10,-9
"177","1471首利","110/08/25","中農",10,0,10
"178","1471首利","110/08/25","台灣企銀-太平",0,8,-8
"179","1471首利","110/08/25","華南永昌-合泰",10,0,10
"180","1471首利","110/08/25","新光-台中",5,12,-7
"181","2883開發金","110/08/25","凱基",4004,0,4004
"182","2883開發金","110/08/25","摩根大通",106,4873,-4767
"183","2883開發金","110/08/25","群益金鼎",2728,3,2725
"184","2883開發金","110/08/25","瑞士信貸",1180,3777,-2597
"185","2883開發金","110/08/25","美林",2122,57,2065
"186","2883開發金","110/08/25","元大-開元",29,2542,-2513
"187","2883開發金","110/08/25","凱基-台北",2581,555,2026
"188","2883開發金","110/08/25","聯邦商銀",1,1900,-1899
"189","2883開發金","110/08/25","富邦-建國",2069,82,1987
"190","2883開發金","110/08/25","台灣摩根士丹利",3322,4605,-1283
"191","2883開發金","110/08/25","中國信託",3132,1528,1604
"192","2883開發金","110/08/25","元大-忠孝",10,1219,-1209
"193","2883開發金","110/08/25","兆豐-北高雄",1657,83,1574
"194","2883開發金","110/08/25","香港上海匯豐",0,1001,-1001
"195","2883開發金","110/08/25","統一",1311,107,1204
"196","2883開發金","110/08/25","新光",1050,1828,-778
"197","2883開發金","110/08/25","永豐金-南京",1030,3,1027
"198","2883開發金","110/08/25","港商野村",1304,2000,-696
"199","2883開發金","110/08/25","美商高盛",1733,815,918
"200","2883開發金","110/08/25","元富",314,1002,-688
"201","2883開發金","110/08/25","台灣匯立證券",638,0,638
"202","2883開發金","110/08/25","國泰-敦南",289,975,-686
"203","2883開發金","110/08/25","合庫-台中",608,38,570
"204","2883開發金","110/08/25","新光-台南",23,521,-498
"205","2883開發金","110/08/25","臺銀",1016,450,566
"206","2883開發金","110/08/25","合庫證券",19,461,-442
"207","2883開發金","110/08/25","元大-豐原",556,25,531
"208","2883開發金","110/08/25","(牛牛牛)亞-鑫豐",134,538,-404
"209","2883開發金","110/08/25","台中銀-員林",501,13,488
"210","2883開發金","110/08/25","元大-士林",8,385,-377
"211","6205詮欣","110/08/25","日盛-新莊",12,2,10
"212","6205詮欣","110/08/25","日盛-樹林",0,12,-12
"213","6205詮欣","110/08/25","康和-台北",10,0,10
"214","6205詮欣","110/08/25","臺銀-民權",0,10,-10
"215","6205詮欣","110/08/25","臺銀-臺中",9,0,9
"216","6205詮欣","110/08/25","元大-博愛",20,30,-10
"217","6205詮欣","110/08/25","瑞士信貸",10,2,8
"218","6205詮欣","110/08/25","元大-羅東",0,8,-8
"219","6205詮欣","110/08/25","摩根大通",17,10,7
"220","6205詮欣","110/08/25","元富-三重",0,6,-6
"221","6205詮欣","110/08/25","凱基-台南",6,0,6
"222","6205詮欣","110/08/25","群益金鼎-永和",0,5,-5
"223","6205詮欣","110/08/25","玉山證券",5,0,5
"224","6205詮欣","110/08/25","元大-館前",0,5,-5
"225","6205詮欣","110/08/25","元大-東泰",5,0,5
"226","6205詮欣","110/08/25","凱基-汐止",0,4,-4
"227","6205詮欣","110/08/25","元富-潮州",4,0,4
"228","6205詮欣","110/08/25","元大-大益",0,4,-4
"229","6205詮欣","110/08/25","大慶-泰山",3,0,3
"230","6205詮欣","110/08/25","永豐金證券",0,4,-4
"231","6205詮欣","110/08/25","亞東-台南",2,0,2
"232","6205詮欣","110/08/25","永豐金-台南",0,4,-4
"233","6205詮欣","110/08/25","兆豐-台南",2,0,2
"234","6205詮欣","110/08/25","台灣企銀-九如",0,3,-3
"235","6205詮欣","110/08/25","兆豐-公益",2,0,2
"236","6205詮欣","110/08/25","兆豐-景美",0,3,-3
"237","6205詮欣","110/08/25","凱基-松山",2,0,2
"238","6205詮欣","110/08/25","北城證券",0,3,-3
"239","6205詮欣","110/08/25","凱基-台北",2,0,2
"240","6205詮欣","110/08/25","元大-忠孝",0,3,-3
"241","1540喬福","110/08/25","元大-士林",8,0,8
"242","1540喬福","110/08/25","摩根大通",0,13,-13
"243","1540喬福","110/08/25","元富-文心",5,0,5
"244","1540喬福","110/08/25","永豐金-永康",0,6,-6
"245","1540喬福","110/08/25","凱基-台北",4,0,4
"246","1540喬福","110/08/25","群益金鼎-丹鳳",0,5,-5
"247","1540喬福","110/08/25","元大-土城永寧",2,0,2
"248","1540喬福","110/08/25","合庫-鳳山",0,1,-1
"249","1540喬福","110/08/25","元大-頭份",2,0,2
"250","1540喬福","110/08/25","美商高盛",0,1,-1
"251","1540喬福","110/08/25","兆豐-北高雄",2,0,2
"252","1540喬福","110/08/25","中國信託-忠孝",0,1,-1
"253","1540喬福","110/08/25","凱基-中壢",2,0,2
"254","1540喬福","110/08/25","致和-南京",0,1,-1
"255","1540喬福","110/08/25","美林",1,0,1
"256","1540喬福","110/08/25","富邦-仁愛",0,1,-1
"257","1540喬福","110/08/25","永豐金-中正",1,0,1
"258","1540喬福","110/08/25","元大-大里德芳",0,1,-1
"259","1540喬福","110/08/25","元大-文心興安",1,0,1
"260","1540喬福","110/08/25","元大-左營",0,1,-1
"261","1540喬福","110/08/25","華南永昌-公誠",1,0,1
"262","1540喬福","110/08/25","元大-汐止",0,1,-1
"263","1540喬福","110/08/25","大昌-新店",1,0,1
"264","1540喬福","110/08/25","日盛-內湖",0,0,0
"265","1540喬福","110/08/25","元富-大昌",1,0,1
"266","1540喬福","110/08/25","(牛牛牛)亞-網路",0,0,0
"267","1540喬福","110/08/25","元富",1,0,1
"268","1540喬福","110/08/25","康和-板橋",0,0,0
"269","1540喬福","110/08/25","凱基-竹北",0,0,0
"270","1540喬福","110/08/25","凱基-竹北",0,0,0
"271","2888新光金","110/08/25","統一",11078,277,10801
"272","2888新光金","110/08/25","元富-城東",162,17808,-17646
"273","2888新光金","110/08/25","元大-忠孝鼎富",10200,0,10200
"274","2888新光金","110/08/25","康和-台中",45,10015,-9970
"275","2888新光金","110/08/25","華南永昌-岡山",9944,105,9839
"276","2888新光金","110/08/25","第一金-華江",266,9839,-9573
"277","2888新光金","110/08/25","日盛證券",8935,66,8869
"278","2888新光金","110/08/25","元富-新店",37,2975,-2938
"279","2888新光金","110/08/25","瑞士信貸",8347,1175,7172
"280","2888新光金","110/08/25","元富-世貿",332,3270,-2938
"281","2888新光金","110/08/25","富邦-岡山",5039,52,4987
"282","2888新光金","110/08/25","元富-新興",31,2160,-2129
"283","2888新光金","110/08/25","國票-九鼎",4662,102,4560
"284","2888新光金","110/08/25","元富-敦南",19,2135,-2116
"285","2888新光金","110/08/25","國票-長城",4288,5,4283
"286","2888新光金","110/08/25","元富",7,2039,-2032
"287","2888新光金","110/08/25","國票-北高雄",2515,38,2477
"288","2888新光金","110/08/25","元富-成功",184,2095,-1911
"289","2888新光金","110/08/25","新光",2800,661,2139
"290","2888新光金","110/08/25","元富-板橋",65,1967,-1902
"291","2888新光金","110/08/25","統一-板橋",1762,10,1752
"292","2888新光金","110/08/25","彰銀",0,1865,-1865
"293","2888新光金","110/08/25","玉山-板橋",1714,21,1693
"294","2888新光金","110/08/25","元富-文心",159,1916,-1757
"295","2888新光金","110/08/25","美商高盛",2345,739,1606
"296","2888新光金","110/08/25","元富-吉利",45,1701,-1656
"297","2888新光金","110/08/25","國票-博愛",1264,4,1260
"298","2888新光金","110/08/25","元富-花蓮",13,1602,-1589
"299","2888新光金","110/08/25","富邦-中壢",1278,95,1183
"300","2888新光金","110/08/25","凱基-台北",1875,3353,-1478
"301","1340勝悅","110/08/25","凱基-台北",13,0,13
"302","1340勝悅","110/08/25","日盛-永康",0,10,-10
"303","1340勝悅","110/08/25","華南永昌-公誠",10,0,10
"304","1340勝悅","110/08/25","元大-忠孝鼎富",0,10,-10
"305","1340勝悅","110/08/25","臺灣企銀-埔墘",5,0,5
"306","1340勝悅","110/08/25","華南永昌-東昇",0,9,-9
"307","1340勝悅","110/08/25","美商高盛",3,0,3
"308","1340勝悅","110/08/25","摩根大通",1,9,-8
"309","1340勝悅","110/08/25","元大-仁愛",3,0,3
"310","1340勝悅","110/08/25","華南永昌-林口",0,6,-6
"311","1340勝悅","110/08/25","永豐金-永康",3,0,3
"312","1340勝悅","110/08/25","兆豐-新營",0,5,-5
"313","1340勝悅","110/08/25","國泰-敦南",3,1,2
"314","1340勝悅","110/08/25","富邦-羅東",0,3,-3
"315","1340勝悅","110/08/25","富邦-北港",2,0,2
"316","1340勝悅","110/08/25","元大-竹山",0,3,-3
"317","1340勝悅","110/08/25","元大-南勢角",2,0,2
"318","1340勝悅","110/08/25","元大-復北",0,3,-3
"319","1340勝悅","110/08/25","合庫-台中",1,0,1
"320","1340勝悅","110/08/25","元大-嘉義",0,3,-3
"321","1340勝悅","110/08/25","日盛-新莊",1,0,1
"322","1340勝悅","110/08/25","元大-草屯",0,2,-2
"323","1340勝悅","110/08/25","日盛-頭份",1,0,1
"324","1340勝悅","110/08/25","國票-和平",0,1,-1
"325","1340勝悅","110/08/25","國泰-台中",6,5,1
"326","1340勝悅","110/08/25","新光",0,1,-1
"327","1340勝悅","110/08/25","國泰-台南",1,0,1
"328","1340勝悅","110/08/25","群益金鼎-高盛",0,1,-1
"329","1340勝悅","110/08/25","元大-竹東",1,0,1
"330","1340勝悅","110/08/25","元大-新竹經國",0,1,-1
"331","6246臺龍","110/08/25","統一-台南",15,0,15
"332","6246臺龍","110/08/25","日盛-斗六",0,9,-9
"333","6246臺龍","110/08/25","新光-台中",7,0,7
"334","6246臺龍","110/08/25","新光-高雄",0,5,-5
"335","6246臺龍","110/08/25","永豐金-嘉義",4,0,4
"336","6246臺龍","110/08/25","光和-高雄",0,3,-3
"337","6246臺龍","110/08/25","台新證券",4,1,3
"338","6246臺龍","110/08/25","永全",0,3,-3
"339","6246臺龍","110/08/25","凱基-竹科",3,0,3
"340","6246臺龍","110/08/25","國泰-敦南",0,3,-3
"341","6246臺龍","110/08/25","統一-中壢",2,0,2
"342","6246臺龍","110/08/25","元大-員林",4,7,-3
"343","6246臺龍","110/08/25","兆豐-竹北",2,0,2
"344","6246臺龍","110/08/25","元大-小港",0,3,-3
"345","6246臺龍","110/08/25","兆豐-景美",2,0,2
"346","6246臺龍","110/08/25","土銀-花蓮",0,2,-2
"347","6246臺龍","110/08/25","元大-內湖",4,2,2
"348","6246臺龍","110/08/25","日盛-文化",0,2,-2
"349","6246臺龍","110/08/25","元大-北屯",2,0,2
"350","6246臺龍","110/08/25","統一-新竹",0,2,-2
"351","6246臺龍","110/08/25","日盛-中壢",1,0,1
"352","6246臺龍","110/08/25","台新-台南",0,2,-2
"353","6246臺龍","110/08/25","日盛-八德",1,0,1
"354","6246臺龍","110/08/25","國泰-板橋",0,2,-2
"355","6246臺龍","110/08/25","日盛-新竹",1,0,1
"356","6246臺龍","110/08/25","富邦-竹東",0,2,-2
"357","6246臺龍","110/08/25","日盛-宜蘭",1,0,1
"358","6246臺龍","110/08/25","合庫-西台中",0,1,-1
"359","6246臺龍","110/08/25","日盛-頭份",1,0,1
"360","6246臺龍","110/08/25","日盛-新莊",0,1,-1
"361","00715L期街口布蘭特正2","110/08/25","元大證券",19583,546,19037
"362","00715L期街口布蘭特正2","110/08/25","第一金-豐原",0,1000,-1000
"363","00715L期街口布蘭特正2","110/08/25","合庫證券",4367,15,4352
"364","00715L期街口布蘭特正2","110/08/25","新光",311,1182,-871
"365","00715L期街口布蘭特正2","110/08/25","永豐金證券",3240,15,3225
"366","00715L期街口布蘭特正2","110/08/25","兆豐-台中",0,798,-798
"367","00715L期街口布蘭特正2","110/08/25","元富",3115,0,3115
"368","00715L期街口布蘭特正2","110/08/25","玉山-新莊",2,634,-632
"369","00715L期街口布蘭特正2","110/08/25","統一",2701,40,2661
"370","00715L期街口布蘭特正2","110/08/25","元富-中壢",22,630,-608
"371","00715L期街口布蘭特正2","110/08/25","第一金-台中",800,2,798
"372","00715L期街口布蘭特正2","110/08/25","玉山-板橋",1,563,-562
"373","00715L期街口布蘭特正2","110/08/25","聯邦-三重",750,10,740
"374","00715L期街口布蘭特正2","110/08/25","華南永昌-台中",105,642,-537
"375","00715L期街口布蘭特正2","110/08/25","富邦證券",945,420,525
"376","00715L期街口布蘭特正2","110/08/25","(牛牛牛)亞-鑫豐",31,557,-526
"377","00715L期街口布蘭特正2","110/08/25","元大-三重",500,3,497
"378","00715L期街口布蘭特正2","110/08/25","玉山-新竹",0,508,-508
"379","00715L期街口布蘭特正2","110/08/25","台新證券",955,537,418
"380","00715L期街口布蘭特正2","110/08/25","新光-台中",52,556,-504
"381","00715L期街口布蘭特正2","110/08/25","國票-博愛",260,0,260
"382","00715L期街口布蘭特正2","110/08/25","富邦-陽明",2,475,-473
"383","00715L期街口布蘭特正2","110/08/25","元大-蘆洲",262,15,247
"384","00715L期街口布蘭特正2","110/08/25","中國信託-新竹",0,455,-455
"385","00715L期街口布蘭特正2","110/08/25","台新-台中",390,161,229
"386","00715L期街口布蘭特正2","110/08/25","群益金鼎-宜蘭",1,448,-447
"387","00715L期街口布蘭特正2","110/08/25","康和-嘉義",250,36,214
"388","00715L期街口布蘭特正2","110/08/25","臺銀-新竹",34,435,-401
"389","00715L期街口布蘭特正2","110/08/25","凱基-站前",245,36,209
"390","00715L期街口布蘭特正2","110/08/25","第一金-台南",1,400,-399
"391","8941關中","110/08/25","國泰-新莊",2,0,2
"392","8941關中","110/08/25","富邦-左營",0,1,-1
"393","8941關中","110/08/25","(牛牛牛)亞-鑫豐",0,0,0
"394","8941關中","110/08/25","富邦-員林",0,1,-1
"395","8941關中","110/08/25","康和-板橋",0,0,0
"396","8941關中","110/08/25","(牛牛牛)亞-鑫豐",0,0,0
"397","8941關中","110/08/25","凱基-板橋",0,0,0
"398","8941關中","110/08/25","康和-板橋",0,0,0
"399","8941關中","110/08/25","富邦-竹北",0,0,0
"400","8941關中","110/08/25","凱基-板橋",0,0,0
"401","8941關中","110/08/25","元大-花蓮",0,0,0
"402","8941關中","110/08/25","富邦-竹北",0,0,0
"403","8941關中","110/08/25","元大-土城",0,0,0
"404","8941關中","110/08/25","元大-花蓮",0,0,0
"405","8941關中","110/08/25","永豐金-萬盛",0,0,0
"406","8941關中","110/08/25","元大-土城",0,0,0
"407","8941關中","110/08/25","永豐金-南投",0,0,0
"408","8941關中","110/08/25","永豐金-萬盛",0,0,0
"409","8941關中","110/08/25","",NA,NA,NA
"410","8941關中","110/08/25","永豐金-南投",0,0,0
"411","8941關中","110/08/25","",NA,NA,NA
"412","8941關中","110/08/25","",NA,NA,NA
"413","8941關中","110/08/25","",NA,NA,NA
"414","8941關中","110/08/25","",NA,NA,NA
"415","8941關中","110/08/25","",NA,NA,NA
"416","8941關中","110/08/25","",NA,NA,NA
"417","8941關中","110/08/25","",NA,NA,NA
"418","8941關中","110/08/25","",NA,NA,NA
"419","8941關中","110/08/25","",NA,NA,NA
"420","8941關中","110/08/25","",NA,NA,NA
"421","8936國統","110/08/25","台灣摩根士丹利",132,11,121
"422","8936國統","110/08/25","第一金-高雄",1,100,-99
"423","8936國統","110/08/25","元富-新興",96,0,96
"424","8936國統","110/08/25","美商高盛",1,63,-62
"425","8936國統","110/08/25","瑞士信貸",74,0,74
"426","8936國統","110/08/25","元大-蘆洲",0,50,-50
"427","8936國統","110/08/25","摩根大通",113,52,61
"428","8936國統","110/08/25","凱基-市政",0,35,-35
"429","8936國統","110/08/25","永豐金-松山",50,0,50
"430","8936國統","110/08/25","元大-北港",0,31,-31
"431","8936國統","110/08/25","凱基-台北",84,52,32
"432","8936國統","110/08/25","港商野村",4,26,-22
"433","8936國統","110/08/25","新光",66,36,30
"434","8936國統","110/08/25","日盛-豐原",0,20,-20
"435","8936國統","110/08/25","新光-台中",50,24,26
"436","8936國統","110/08/25","元大-鳳山",0,19,-19
"437","8936國統","110/08/25","凱基-信義",20,0,20
"438","8936國統","110/08/25","新加坡商瑞銀",27,45,-18
"439","8936國統","110/08/25","永豐金-苓雅",20,0,20
"440","8936國統","110/08/25","群益金鼎-嘉義",0,16,-16
"441","8936國統","110/08/25","元大-天母",49,30,19
"442","8936國統","110/08/25","凱基-林口",0,15,-15
"443","8936國統","110/08/25","華南永昌",21,3,18
"444","8936國統","110/08/25","台新-高雄",2,16,-14
"445","8936國統","110/08/25","日盛-板橋",23,7,16
"446","8936國統","110/08/25","國票-內壢",0,13,-13
"447","8936國統","110/08/25","元富-敦南",15,0,15
"448","8936國統","110/08/25","元富-三重",0,12,-12
"449","8936國統","110/08/25","群益金鼎-古亭",15,0,15
"450","8936國統","110/08/25","元富-緯城",5,17,-12
"451","6226光鼎","110/08/25","摩根大通",1583,220,1363
"452","6226光鼎","110/08/25","瑞士信貸",30,229,-199
"453","6226光鼎","110/08/25","統一",1723,948,775
"454","6226光鼎","110/08/25","國泰-敦南",442,580,-138
"455","6226光鼎","110/08/25","元大-大同",1456,903,553
"456","6226光鼎","110/08/25","台新-中壢",5,141,-136
"457","6226光鼎","110/08/25","港商野村",688,373,315
"458","6226光鼎","110/08/25","宏遠-光隆",22,137,-115
"459","6226光鼎","110/08/25","凱基-永和",505,200,305
"460","6226光鼎","110/08/25","元大-虎尾",5,96,-91
"461","6226光鼎","110/08/25","統一-南京",303,106,197
"462","6226光鼎","110/08/25","新加坡商瑞銀",49,134,-85
"463","6226光鼎","110/08/25","美商高盛",243,76,167
"464","6226光鼎","110/08/25","元大-板橋",2,83,-81
"465","6226光鼎","110/08/25","台灣摩根士丹利",142,0,142
"466","6226光鼎","110/08/25","玉山-桃園",46,126,-80
"467","6226光鼎","110/08/25","兆豐-松德",145,46,99
"468","6226光鼎","110/08/25","富邦-台北",27,101,-74
"469","6226光鼎","110/08/25","玉山-城中",115,19,96
"470","6226光鼎","110/08/25","兆豐-埔墘",0,67,-67
"471","6226光鼎","110/08/25","富邦證券",148,53,95
"472","6226光鼎","110/08/25","凱基-台北",51,113,-62
"473","6226光鼎","110/08/25","富邦-建國",206,126,80
"474","6226光鼎","110/08/25","台新-高雄",45,101,-56
"475","6226光鼎","110/08/25","凱基-大直",81,2,79
"476","6226光鼎","110/08/25","華南永昌-麻豆",5,61,-56
"477","6226光鼎","110/08/25","元大-四維",149,71,78
"478","6226光鼎","110/08/25","凱基-內埔",0,52,-52
"479","6226光鼎","110/08/25","大展-台南",75,0,75
"480","6226光鼎","110/08/25","日盛-復興",58,109,-51
"481","2363矽統","110/08/25","合庫-基隆",894,406,488
"482","2363矽統","110/08/25","元大-萬華",51,751,-700
"483","2363矽統","110/08/25","瑞士信貸",448,0,448
"484","2363矽統","110/08/25","美商高盛",260,879,-619
"485","2363矽統","110/08/25","華南永昌-林口",256,17,239
"486","2363矽統","110/08/25","凱基-台北",1409,1709,-300
"487","2363矽統","110/08/25","元大-東泰",360,132,228
"488","2363矽統","110/08/25","美林",337,633,-296
"489","2363矽統","110/08/25","元大-員林中山",246,46,200
"490","2363矽統","110/08/25","摩根大通",712,999,-287
"491","2363矽統","110/08/25","富邦-新店",246,104,142
"492","2363矽統","110/08/25","新加坡商瑞銀",671,900,-229
"493","2363矽統","110/08/25","統一-城中",173,37,136
"494","2363矽統","110/08/25","大昌-桃園",138,342,-204
"495","2363矽統","110/08/25","富邦-板橋",196,72,124
"496","2363矽統","110/08/25","中國信託-忠孝",134,313,-179
"497","2363矽統","110/08/25","土銀-士林",100,0,100
"498","2363矽統","110/08/25","元大-淡水",23,201,-178
"499","2363矽統","110/08/25","新光",427,328,99
"500","2363矽統","110/08/25","富邦-苗栗",215,356,-141
"501","2363矽統","110/08/25","元大-員林",121,22,99
"502","2363矽統","110/08/25","北城證券",23,144,-121
"503","2363矽統","110/08/25","凱基-台中",107,11,96
"504","2363矽統","110/08/25","新光-台中",92,210,-118
"505","2363矽統","110/08/25","富邦-北港",212,117,95
"506","2363矽統","110/08/25","永豐金-天母",17,132,-115
"507","2363矽統","110/08/25","統一-高雄",110,18,92
"508","2363矽統","110/08/25","日盛-台南",256,356,-100
"509","2363矽統","110/08/25","凱基-苗栗",91,1,90
"510","2363矽統","110/08/25","元大-大同",22,118,-96
"511","8112至上","110/08/25","台灣匯立證券",237,0,237
"512","8112至上","110/08/25","群益金鼎-基隆",1,95,-94
"513","8112至上","110/08/25","摩根大通",283,173,110
"514","8112至上","110/08/25","元大-路竹",2,74,-72
"515","8112至上","110/08/25","第一金-桃園",96,0,96
"516","8112至上","110/08/25","台灣摩根士丹利",1,61,-60
"517","8112至上","110/08/25","凱基-台北",126,33,93
"518","8112至上","110/08/25","永豐金-台中",2,55,-53
"519","8112至上","110/08/25","國票-南京",80,0,80
"520","8112至上","110/08/25","(牛牛牛)亞-鑫豐",5,49,-44
"521","8112至上","110/08/25","瑞士信貸",78,1,77
"522","8112至上","110/08/25","群益金鼎-高盛",0,43,-43
"523","8112至上","110/08/25","富邦-仁愛",110,35,75
"524","8112至上","110/08/25","永豐金-永康",3,46,-43
"525","8112至上","110/08/25","群益金鼎-敦南",72,0,72
"526","8112至上","110/08/25","日盛-花蓮",0,40,-40
"527","8112至上","110/08/25","新加坡商瑞銀",63,9,54
"528","8112至上","110/08/25","凱基-東勢",0,35,-35
"529","8112至上","110/08/25","華南永昌-南京",50,0,50
"530","8112至上","110/08/25","元大-仁愛",0,34,-34
"531","8112至上","110/08/25","港商野村",45,2,43
"532","8112至上","110/08/25","台新-台中",0,31,-31
"533","8112至上","110/08/25","元大-新竹經國",34,3,31
"534","8112至上","110/08/25","元大-佳里",0,31,-31
"535","8112至上","110/08/25","康和-仁愛",30,0,30
"536","8112至上","110/08/25","兆豐-西螺",10,40,-30
"537","8112至上","110/08/25","凱基-士林",30,0,30
"538","8112至上","110/08/25","元大-楊梅",0,30,-30
"539","8112至上","110/08/25","元大-永和",25,0,25
"540","8112至上","110/08/25","永豐金證券",0,28,-28
"541","1570力肯","110/08/25","永豐金-虎尾",52,0,52
"542","1570力肯","110/08/25","元大-竹山",0,14,-14
"543","1570力肯","110/08/25","國票-南科",26,0,26
"544","1570力肯","110/08/25","日盛-忠孝",0,12,-12
"545","1570力肯","110/08/25","凱基-台北",22,3,19
"546","1570力肯","110/08/25","凱基-高美館",0,10,-10
"547","1570力肯","110/08/25","日茂-南投",17,0,17
"548","1570力肯","110/08/25","元富-緯城",3,12,-9
"549","1570力肯","110/08/25","兆豐-台中港",12,0,12
"550","1570力肯","110/08/25","(牛牛牛)亞-鑫豐",2,11,-9
"551","1570力肯","110/08/25","合庫-嘉義",10,0,10
"552","1570力肯","110/08/25","元大-鳳山",0,8,-8
"553","1570力肯","110/08/25","凱基-復興",10,0,10
"554","1570力肯","110/08/25","台灣摩根士丹利",0,7,-7
"555","1570力肯","110/08/25","國票-博愛",16,7,9
"556","1570力肯","110/08/25","兆豐-中壢",0,6,-6
"557","1570力肯","110/08/25","香港上海匯豐",9,0,9
"558","1570力肯","110/08/25","國票",0,6,-6
"559","1570力肯","110/08/25","瑞士信貸",8,0,8
"560","1570力肯","110/08/25","國票-天祥",0,6,-6
"561","1570力肯","110/08/25","富邦-高雄",8,0,8
"562","1570力肯","110/08/25","群益金鼎-桃園",0,6,-6
"563","1570力肯","110/08/25","摩根大通",12,9,3
"564","1570力肯","110/08/25","華南永昌-大安",0,6,-6
"565","1570力肯","110/08/25","新光-新竹",3,0,3
"566","1570力肯","110/08/25","永豐金-桃園",0,6,-6
"567","1570力肯","110/08/25","群益金鼎-民權",3,0,3
"568","1570力肯","110/08/25","兆豐-松德",0,5,-5
"569","1570力肯","110/08/25","富邦-建國",5,2,3
"570","1570力肯","110/08/25","群益金鼎-鳳山",0,5,-5
"571","2929淘帝","110/08/25","摩根大通",64,0,64
"572","2929淘帝","110/08/25","康和-仁愛",0,44,-44
"573","2929淘帝","110/08/25","港商野村",37,8,29
"574","2929淘帝","110/08/25","新光-台中",20,43,-23
"575","2929淘帝","110/08/25","新加坡商瑞銀",36,12,24
"576","2929淘帝","110/08/25","台新-台中",0,11,-11
"577","2929淘帝","110/08/25","美林",29,6,23
"578","2929淘帝","110/08/25","日盛-中壢",0,10,-10
"579","2929淘帝","110/08/25","群益金鼎-三重",21,0,21
"580","2929淘帝","110/08/25","日盛-中和",0,10,-10
"581","2929淘帝","110/08/25","元大-豐原站前",20,0,20
"582","2929淘帝","110/08/25","兆豐-忠孝",0,10,-10
"583","2929淘帝","110/08/25","富邦-高雄",20,2,18
"584","2929淘帝","110/08/25","華南永昌-台中",0,10,-10
"585","2929淘帝","110/08/25","日盛-台中",16,0,16
"586","2929淘帝","110/08/25","華南永昌-麻豆",0,10,-10
"587","2929淘帝","110/08/25","新光-新竹",17,4,13
"588","2929淘帝","110/08/25","富邦-陽明",0,10,-10
"589","2929淘帝","110/08/25","凱基-豐中",13,0,13
"590","2929淘帝","110/08/25","新光",1,9,-8
"591","2929淘帝","110/08/25","元富-花蓮",10,0,10
"592","2929淘帝","110/08/25","元大-大里",0,8,-8
"593","2929淘帝","110/08/25","元富-板橋",8,0,8
"594","2929淘帝","110/08/25","永豐金-市政",0,8,-8
"595","2929淘帝","110/08/25","元大-太平",7,0,7
"596","2929淘帝","110/08/25","合庫-台中",0,7,-7
"597","2929淘帝","110/08/25","元大-永和",6,0,6
"598","2929淘帝","110/08/25","元大-文心",0,7,-7
"599","2929淘帝","110/08/25","日盛-八德",6,1,5
"600","2929淘帝","110/08/25","日盛-員林",4,10,-6
"601","5410國眾","110/08/25","華南永昌-高雄",23,0,23
"602","5410國眾","110/08/25","元大-崇德",0,30,-30
"603","5410國眾","110/08/25","香港上海匯豐",12,0,12
"604","5410國眾","110/08/25","日盛-木柵",0,20,-20
"605","5410國眾","110/08/25","永豐金-內湖",6,0,6
"606","5410國眾","110/08/25","大展",0,5,-5
"607","5410國眾","110/08/25","土銀",5,0,5
"608","5410國眾","110/08/25","國泰-敦南",0,5,-5
"609","5410國眾","110/08/25","日盛-屏東",5,0,5
"610","5410國眾","110/08/25","凱基-基隆",0,5,-5
"611","5410國眾","110/08/25","國泰-板橋",5,0,5
"612","5410國眾","110/08/25","華南永昌-淡水",0,5,-5
"613","5410國眾","110/08/25","元大-南京",5,0,5
"614","5410國眾","110/08/25","元大-新莊",0,5,-5
"615","5410國眾","110/08/25","新光-台中",4,0,4
"616","5410國眾","110/08/25","群益金鼎-新店",0,4,-4
"617","5410國眾","110/08/25","臺銀-金山",3,0,3
"618","5410國眾","110/08/25","華南永昌-公誠",0,4,-4
"619","5410國眾","110/08/25","摩根大通",3,0,3
"620","5410國眾","110/08/25","元大-龍潭",0,4,-4
"621","5410國眾","110/08/25","元大-鳳山",3,0,3
"622","5410國眾","110/08/25","元富-大裕",0,3,-3
"623","5410國眾","110/08/25","台新-中壢",2,0,2
"624","5410國眾","110/08/25","富邦-建國",0,3,-3
"625","5410國眾","110/08/25","新光",2,0,2
"626","5410國眾","110/08/25","美林",0,2,-2
"627","5410國眾","110/08/25","群益金鼎-新竹",2,0,2
"628","5410國眾","110/08/25","新光-桃園",0,2,-2
"629","5410國眾","110/08/25","群益金鼎-三民",2,0,2
"630","5410國眾","110/08/25","元大-花蓮",0,2,-2
"631","2841台開","110/08/25","宏遠-館前",155,0,155
"632","2841台開","110/08/25","台中銀",0,45,-45
"633","2841台開","110/08/25","元大-仁愛",50,0,50
"634","2841台開","110/08/25","元大-承德",0,40,-40
"635","2841台開","110/08/25","永豐金-豐原",50,0,50
"636","2841台開","110/08/25","永豐金-桃盛",0,40,-40
"637","2841台開","110/08/25","元大-草屯",40,0,40
"638","2841台開","110/08/25","港商野村",0,34,-34
"639","2841台開","110/08/25","永豐金-敦南",45,12,33
"640","2841台開","110/08/25","永豐金-台中",0,18,-18
"641","2841台開","110/08/25","元大-沙鹿",10,0,10
"642","2841台開","110/08/25","國票-中和",0,17,-17
"643","2841台開","110/08/25","第一金",8,0,8
"644","2841台開","110/08/25","凱基-高美館",0,16,-16
"645","2841台開","110/08/25","康和-內湖",7,0,7
"646","2841台開","110/08/25","永豐金-桃園",0,15,-15
"647","2841台開","110/08/25","富邦-台北",5,0,5
"648","2841台開","110/08/25","台灣摩根士丹利",0,11,-11
"649","2841台開","110/08/25","玉山證券",4,0,4
"650","2841台開","110/08/25","元富-三重",0,10,-10
"651","2841台開","110/08/25","富邦-新竹",4,0,4
"652","2841台開","110/08/25","華南永昌-虎尾",0,10,-10
"653","2841台開","110/08/25","元大-大里",3,0,3
"654","2841台開","110/08/25","富邦-基隆",0,10,-10
"655","2841台開","110/08/25","兆豐-忠孝",2,0,2
"656","2841台開","110/08/25","元大-成功",0,10,-10
"657","2841台開","110/08/25","新光",4,2,2
"658","2841台開","110/08/25","元大-北三重",0,10,-10
"659","2841台開","110/08/25","元大-南崁",2,0,2
"660","2841台開","110/08/25","新光-高雄",0,9,-9
"661","6207雷科","110/08/25","摩根大通",76,0,76
"662","6207雷科","110/08/25","凱基-復興",0,160,-160
"663","6207雷科","110/08/25","永豐金證券",63,9,54
"664","6207雷科","110/08/25","元大-高雄",0,100,-100
"665","6207雷科","110/08/25","凱基-台北",50,5,45
"666","6207雷科","110/08/25","元大-林園",0,65,-65
"667","6207雷科","110/08/25","美商高盛",25,0,25
"668","6207雷科","110/08/25","臺灣企銀-埔墘",0,20,-20
"669","6207雷科","110/08/25","港商野村",24,3,21
"670","6207雷科","110/08/25","第一金-高雄",0,20,-20
"671","6207雷科","110/08/25","台新-高雄",20,1,19
"672","6207雷科","110/08/25","元大-大里德芳",0,18,-18
"673","6207雷科","110/08/25","兆豐-高雄",17,0,17
"674","6207雷科","110/08/25","元大-敦南",2,18,-16
"675","6207雷科","110/08/25","新加坡商瑞銀",32,21,11
"676","6207雷科","110/08/25","玉山-高雄",0,15,-15
"677","6207雷科","110/08/25","台灣企銀-屏東",10,0,10
"678","6207雷科","110/08/25","臺銀-鳳山",1,13,-12
"679","6207雷科","110/08/25","富邦-虎尾",10,0,10
"680","6207雷科","110/08/25","第一金-中山",10,20,-10
"681","6207雷科","110/08/25","永豐金-博愛",10,0,10
"682","6207雷科","110/08/25","元大-鳳山",0,10,-10
"683","6207雷科","110/08/25","永豐金-中壢",10,0,10
"684","6207雷科","110/08/25","華南永昌-古亭",5,14,-9
"685","6207雷科","110/08/25","兆豐-城中",9,0,9
"686","6207雷科","110/08/25","華南永昌-高雄",3,10,-7
"687","6207雷科","110/08/25","兆豐-嘉義",7,0,7
"688","6207雷科","110/08/25","永豐金-市政",0,6,-6
"689","6207雷科","110/08/25","兆豐-三民",6,0,6
"690","6207雷科","110/08/25","群益金鼎-嘉義",1,6,-5
"691","3679新至陞","110/08/25","永豐金-南投",11,0,11
"692","3679新至陞","110/08/25","台灣摩根士丹利",6,14,-8
"693","3679新至陞","110/08/25","港商法國興業",10,0,10
"694","3679新至陞","110/08/25","瑞士信貸",0,6,-6
"695","3679新至陞","110/08/25","兆豐-公益",3,0,3
"696","3679新至陞","110/08/25","永豐金-敦北",0,5,-5
"697","3679新至陞","110/08/25","(牛牛牛)亞-網路",2,0,2
"698","3679新至陞","110/08/25","群益金鼎-高盛",0,4,-4
"699","3679新至陞","110/08/25","玉山-嘉義",2,0,2
"700","3679新至陞","110/08/25","元大-文心興安",0,4,-4
"701","3679新至陞","110/08/25","元大-華山",2,0,2
"702","3679新至陞","110/08/25","臺銀-臺中",0,3,-3
"703","3679新至陞","110/08/25","臺銀",1,0,1
"704","3679新至陞","110/08/25","美商高盛",0,3,-3
"705","3679新至陞","110/08/25","美林",3,2,1
"706","3679新至陞","110/08/25","臺銀-新竹",0,2,-2
"707","3679新至陞","110/08/25","港商野村",1,0,1
"708","3679新至陞","110/08/25","宏遠-中和",0,2,-2
"709","3679新至陞","110/08/25","富隆-長安",1,0,1
"710","3679新至陞","110/08/25","摩根大通",5,7,-2
"711","3679新至陞","110/08/25","大慶-富順",1,0,1
"712","3679新至陞","110/08/25","合庫-彰化",0,1,-1
"713","3679新至陞","110/08/25","元富-林園",1,0,1
"714","3679新至陞","110/08/25","臺銀-高雄",0,1,-1
"715","3679新至陞","110/08/25","元富-嘉義",1,0,1
"716","3679新至陞","110/08/25","日盛-木柵",0,1,-1
"717","3679新至陞","110/08/25","元富-埔里",1,0,1
"718","3679新至陞","110/08/25","日盛-文化",0,1,-1
"719","3679新至陞","110/08/25","台中銀-員林",1,0,1
"720","3679新至陞","110/08/25","玉山證券",0,1,-1
"721","2727王品","110/08/25","美商高盛",121,6,115
"722","2727王品","110/08/25","美林",9,114,-105
"723","2727王品","110/08/25","台灣摩根士丹利",139,57,82
"724","2727王品","110/08/25","永豐金證券",3,71,-68
"725","2727王品","110/08/25","凱基-台北",105,26,79
"726","2727王品","110/08/25","元大證券",52,108,-56
"727","2727王品","110/08/25","新光-台中",34,5,29
"728","2727王品","110/08/25","摩根大通",35,73,-38
"729","2727王品","110/08/25","瑞士信貸",20,0,20
"730","2727王品","110/08/25","華南永昌-麻豆",1,21,-20
"731","2727王品","110/08/25","凱基-信義",19,1,18
"732","2727王品","110/08/25","國泰-台中",5,19,-14
"733","2727王品","110/08/25","國票-內壢",13,0,13
"734","2727王品","110/08/25","富邦-羅東",2,16,-14
"735","2727王品","110/08/25","中國信託",12,0,12
"736","2727王品","110/08/25","富邦-高雄",2,16,-14
"737","2727王品","110/08/25","元大-中壢",15,3,12
"738","2727王品","110/08/25","富邦-台中",2,16,-14
"739","2727王品","110/08/25","日盛-景美",11,0,11
"740","2727王品","110/08/25","華南永昌",61,73,-12
"741","2727王品","110/08/25","富邦-板橋",11,0,11
"742","2727王品","110/08/25","群益金鼎",1,12,-11
"743","2727王品","110/08/25","元大-台中",11,0,11
"744","2727王品","110/08/25","群益金鼎-松山",0,10,-10
"745","2727王品","110/08/25","台新-高雄",14,4,10
"746","2727王品","110/08/25","凱基-市府",0,10,-10
"747","2727王品","110/08/25","康和",12,2,10
"748","2727王品","110/08/25","凱基-市政",1,10,-9
"749","2727王品","110/08/25","新加坡商瑞銀",9,0,9
"750","2727王品","110/08/25","富邦-台北",2,10,-8
"751","1570力肯","110/08/25","永豐金-虎尾",52,0,52
"752","1570力肯","110/08/25","元大-竹山",0,14,-14
"753","1570力肯","110/08/25","國票-南科",26,0,26
"754","1570力肯","110/08/25","日盛-忠孝",0,12,-12
"755","1570力肯","110/08/25","凱基-台北",22,3,19
"756","1570力肯","110/08/25","凱基-高美館",0,10,-10
"757","1570力肯","110/08/25","日茂-南投",17,0,17
"758","1570力肯","110/08/25","元富-緯城",3,12,-9
"759","1570力肯","110/08/25","兆豐-台中港",12,0,12
"760","1570力肯","110/08/25","(牛牛牛)亞-鑫豐",2,11,-9
"761","1570力肯","110/08/25","合庫-嘉義",10,0,10
"762","1570力肯","110/08/25","元大-鳳山",0,8,-8
"763","1570力肯","110/08/25","凱基-復興",10,0,10
"764","1570力肯","110/08/25","台灣摩根士丹利",0,7,-7
"765","1570力肯","110/08/25","國票-博愛",16,7,9
"766","1570力肯","110/08/25","兆豐-中壢",0,6,-6
"767","1570力肯","110/08/25","香港上海匯豐",9,0,9
"768","1570力肯","110/08/25","國票",0,6,-6
"769","1570力肯","110/08/25","瑞士信貸",8,0,8
"770","1570力肯","110/08/25","國票-天祥",0,6,-6
"771","1570力肯","110/08/25","富邦-高雄",8,0,8
"772","1570力肯","110/08/25","群益金鼎-桃園",0,6,-6
"773","1570力肯","110/08/25","摩根大通",12,9,3
"774","1570力肯","110/08/25","華南永昌-大安",0,6,-6
"775","1570力肯","110/08/25","新光-新竹",3,0,3
"776","1570力肯","110/08/25","永豐金-桃園",0,6,-6
"777","1570力肯","110/08/25","群益金鼎-民權",3,0,3
"778","1570力肯","110/08/25","兆豐-松德",0,5,-5
"779","1570力肯","110/08/25","富邦-建國",5,2,3
"780","1570力肯","110/08/25","群益金鼎-鳳山",0,5,-5
"781","6180橘子","110/08/25","摩根大通",127,3,124
"782","6180橘子","110/08/25","台灣摩根士丹利",5,98,-93
"783","6180橘子","110/08/25","凱基-台北",387,266,121
"784","6180橘子","110/08/25","元大-頭份",2,44,-42
"785","6180橘子","110/08/25","港商野村",106,5,101
"786","6180橘子","110/08/25","元富-古亭",0,27,-27
"787","6180橘子","110/08/25","國票-南港",70,1,69
"788","6180橘子","110/08/25","富邦-陽明",1,28,-27
"789","6180橘子","110/08/25","美林",47,0,47
"790","6180橘子","110/08/25","富邦-高雄",0,27,-27
"791","6180橘子","110/08/25","新加坡商瑞銀",51,6,45
"792","6180橘子","110/08/25","元大-新店中正",2,25,-23
"793","6180橘子","110/08/25","美商高盛",43,5,38
"794","6180橘子","110/08/25","第一金-中山",1,22,-21
"795","6180橘子","110/08/25","富邦-員林",28,0,28
"796","6180橘子","110/08/25","合庫-自強",0,20,-20
"797","6180橘子","110/08/25","大慶-富順",22,0,22
"798","6180橘子","110/08/25","兆豐證券",0,20,-20
"799","6180橘子","110/08/25","第一金",20,0,20
"800","6180橘子","110/08/25","元大-台中中港",1,20,-19
"801","6180橘子","110/08/25","元富-高雄",20,1,19
"802","6180橘子","110/08/25","康和-新竹",0,15,-15
"803","6180橘子","110/08/25","北城證券",18,1,17
"804","6180橘子","110/08/25","國泰-敦南",3,18,-15
"805","6180橘子","110/08/25","大昌",15,1,14
"806","6180橘子","110/08/25","元大-和平",0,15,-15
"807","6180橘子","110/08/25","元大-六合",13,0,13
"808","6180橘子","110/08/25","日盛-中壢",0,13,-13
"809","6180橘子","110/08/25","統一-彰化",13,1,12
"810","6180橘子","110/08/25","福勝",0,13,-13
"811","2390云辰","110/08/25","元大-永和",583,40,543
"812","2390云辰","110/08/25","港商野村",593,815,-222
"813","2390云辰","110/08/25","元富-安南",400,0,400
"814","2390云辰","110/08/25","合庫-高雄",19,149,-130
"815","2390云辰","110/08/25","凱基-台北",361,93,268
"816","2390云辰","110/08/25","新光-台中",28,149,-121
"817","2390云辰","110/08/25","凱基-湖口",101,0,101
"818","2390云辰","110/08/25","致和-崇德",0,116,-116
"819","2390云辰","110/08/25","元大-土城學府",153,76,77
"820","2390云辰","110/08/25","美商高盛",11,122,-111
"821","2390云辰","110/08/25","富邦-陽明",97,28,69
"822","2390云辰","110/08/25","第一金-豐原",9,109,-100
"823","2390云辰","110/08/25","群益金鼎-基隆",62,2,60
"824","2390云辰","110/08/25","元大-雙和",16,113,-97
"825","2390云辰","110/08/25","元大-南屯",54,4,50
"826","2390云辰","110/08/25","統一-新台中",81,161,-80
"827","2390云辰","110/08/25","摩根大通",166,118,48
"828","2390云辰","110/08/25","富邦-新店",0,80,-80
"829","2390云辰","110/08/25","元大證券",64,18,46
"830","2390云辰","110/08/25","國泰-桃園",13,86,-73
"831","2390云辰","110/08/25","華南永昌-合泰",40,0,40
"832","2390云辰","110/08/25","台新證券",57,129,-72
"833","2390云辰","110/08/25","土銀-花蓮",39,0,39
"834","2390云辰","110/08/25","新光",207,273,-66
"835","2390云辰","110/08/25","大昌",50,11,39
"836","2390云辰","110/08/25","華南永昌-楠梓",21,70,-49
"837","2390云辰","110/08/25","元富-桃園",38,1,37
"838","2390云辰","110/08/25","群益金鼎-敦南",87,133,-46
"839","2390云辰","110/08/25","光和-溪湖",32,1,31
"840","2390云辰","110/08/25","永豐金-敦北",0,40,-40
"841","1315達新","110/08/23","元大-文心興安",22,0,22
"842","1315達新","110/08/23","香港上海匯豐",0,25,-25
"843","1315達新","110/08/23","元大-北屯",9,0,9
"844","1315達新","110/08/23","港商麥格理",0,22,-22
"845","1315達新","110/08/23","元大-中壢",6,0,6
"846","1315達新","110/08/23","群益金鼎-東湖",0,17,-17
"847","1315達新","110/08/23","新光",5,0,5
"848","1315達新","110/08/23","日盛-台中",0,9,-9
"849","1315達新","110/08/23","國泰-桃園",5,0,5
"850","1315達新","110/08/23","台新-台南",0,8,-8
"851","1315達新","110/08/23","凱基-中港",5,0,5
"852","1315達新","110/08/23","元大-四維",0,5,-5
"853","1315達新","110/08/23","元大-豐原",5,0,5
"854","1315達新","110/08/23","美林",0,4,-4
"855","1315達新","110/08/23","致和-東門",3,0,3
"856","1315達新","110/08/23","群益金鼎-瑞豐",0,3,-3
"857","1315達新","110/08/23","華南永昌-鳳山",3,0,3
"858","1315達新","110/08/23","元大-松山",0,2,-2
"859","1315達新","110/08/23","元大-屏南",3,0,3
"860","1315達新","110/08/23","元大-板橋",0,2,-2
"861","1315達新","110/08/23","元大-仁愛",3,0,3
"862","1315達新","110/08/23","永豐金證券",0,2,-2
"863","1315達新","110/08/23","日盛-頭份",2,0,2
"864","1315達新","110/08/23","元富-信義",0,1,-1
"865","1315達新","110/08/23","港商法國興業",2,0,2
"866","1315達新","110/08/23","華南永昌-中正",0,1,-1
"867","1315達新","110/08/23","新加坡商瑞銀",2,0,2
"868","1315達新","110/08/23","富邦-板橋",0,1,-1
"869","1315達新","110/08/23","第一金",2,0,2
"870","1315達新","110/08/23","富邦-仁愛",0,1,-1
"871","2609陽明","110/08/23","摩根大通",18636,4559,14077
"872","2609陽明","110/08/23","富邦證券",10185,12443,-2258
"873","2609陽明","110/08/23","康和",2421,208,2213
"874","2609陽明","110/08/23","富邦-虎尾",7091,8076,-985
"875","2609陽明","110/08/23","台灣摩根士丹利",2570,528,2042
"876","2609陽明","110/08/23","華南永昌-竹北",340,1185,-845
"877","2609陽明","110/08/23","凱基-台北",2772,1398,1374
"878","2609陽明","110/08/23","新光-新竹",958,1746,-788
"879","2609陽明","110/08/23","美林",7570,6327,1243
"880","2609陽明","110/08/23","凱基-長庚",161,815,-654
"881","2609陽明","110/08/23","瑞士信貸",1505,326,1179
"882","2609陽明","110/08/23","凱基-市府",164,817,-653
"883","2609陽明","110/08/23","日盛-板橋",1087,183,904
"884","2609陽明","110/08/23","國泰-敦南",5133,5754,-621
"885","2609陽明","110/08/23","凱基-復興",1293,497,796
"886","2609陽明","110/08/23","國泰-館前",1329,1670,-341
"887","2609陽明","110/08/23","元大證券",3275,2760,515
"888","2609陽明","110/08/23","富邦-建國",489,824,-335
"889","2609陽明","110/08/23","元大-頭份",776,338,438
"890","2609陽明","110/08/23","元大-大同",246,569,-323
"891","2609陽明","110/08/23","富邦-仁愛",1292,875,417
"892","2609陽明","110/08/23","元大-和平",98,405,-307
"893","2609陽明","110/08/23","凱基-市政",2414,2002,412
"894","2609陽明","110/08/23","元大-台中中港",128,429,-301
"895","2609陽明","110/08/23","元大-士林",2427,2036,391
"896","2609陽明","110/08/23","玉山證券",756,1049,-293
"897","2609陽明","110/08/23","宏遠證券",1542,1153,389
"898","2609陽明","110/08/23","群益金鼎-內湖",32,319,-287
"899","2609陽明","110/08/23","新加坡商瑞銀",746,375,371
"900","2609陽明","110/08/23","群益金鼎-大安",1012,1296,-284
"901","2636台驊投控","110/08/23","摩根大通",1383,622,761
"902","2636台驊投控","110/08/23","第一金-桃園",32,181,-149
"903","2636台驊投控","110/08/23","瑞士信貸",679,89,590
"904","2636台驊投控","110/08/23","永豐金-新竹",6,139,-133
"905","2636台驊投控","110/08/23","台灣摩根士丹利",413,93,320
"906","2636台驊投控","110/08/23","日盛-景美",5,108,-103
"907","2636台驊投控","110/08/23","美商高盛",400,167,233
"908","2636台驊投控","110/08/23","台新證券",155,215,-60
"909","2636台驊投控","110/08/23","新加坡商瑞銀",215,57,158
"910","2636台驊投控","110/08/23","日盛-台中",0,55,-55
"911","2636台驊投控","110/08/23","元大-松江",81,17,64
"912","2636台驊投控","110/08/23","富邦-苗栗",2,57,-55
"913","2636台驊投控","110/08/23","新光",303,240,63
"914","2636台驊投控","110/08/23","日盛-信義",12,66,-54
"915","2636台驊投控","110/08/23","凱基-台北",601,539,62
"916","2636台驊投控","110/08/23","富邦-北港",7,56,-49
"917","2636台驊投控","110/08/23","富邦-彰化",116,55,61
"918","2636台驊投控","110/08/23","中國信託-文心",19,67,-48
"919","2636台驊投控","110/08/23","永豐金-萬盛",84,36,48
"920","2636台驊投控","110/08/23","統一-城中",34,81,-47
"921","2636台驊投控","110/08/23","兆豐-中壢",67,22,45
"922","2636台驊投控","110/08/23","土銀-南港",0,45,-45
"923","2636台驊投控","110/08/23","兆豐-鹿港",44,4,40
"924","2636台驊投控","110/08/23","永豐金-桃園",19,64,-45
"925","2636台驊投控","110/08/23","元大-林森",77,40,37
"926","2636台驊投控","110/08/23","台新-台中",63,107,-44
"927","2636台驊投控","110/08/23","富邦-虎尾",255,221,34
"928","2636台驊投控","110/08/23","日盛證券",24,67,-43
"929","2636台驊投控","110/08/23","元富-成功",37,6,31
"930","2636台驊投控","110/08/23","凱基-竹科",80,118,-38
"931","2867三商壽","110/08/23","凱基-台北",292,9,283
"932","2867三商壽","110/08/23","宏遠證券",0,1024,-1024
"933","2867三商壽","110/08/23","康和-台中",273,3,270
"934","2867三商壽","110/08/23","富邦-陽明",0,280,-280
"935","2867三商壽","110/08/23","土銀-台中",150,0,150
"936","2867三商壽","110/08/23","元大-北投",0,100,-100
"937","2867三商壽","110/08/23","新光",135,10,125
"938","2867三商壽","110/08/23","元富",0,75,-75
"939","2867三商壽","110/08/23","新加坡商瑞銀",109,5,104
"940","2867三商壽","110/08/23","摩根大通",309,368,-59
"941","2867三商壽","110/08/23","元大-桃園",100,0,100
"942","2867三商壽","110/08/23","台灣摩根士丹利",6,57,-51
"943","2867三商壽","110/08/23","元大-沙鹿",76,0,76
"944","2867三商壽","110/08/23","元富-城東",0,51,-51
"945","2867三商壽","110/08/23","凱基",75,0,75
"946","2867三商壽","110/08/23","美林",9,59,-50
"947","2867三商壽","110/08/23","元大-彰化民生",72,0,72
"948","2867三商壽","110/08/23","宏遠-中和",3,50,-47
"949","2867三商壽","110/08/23","國泰-台南",78,10,68
"950","2867三商壽","110/08/23","元大-永和",0,42,-42
"951","2867三商壽","110/08/23","元大-屏東",60,0,60
"952","2867三商壽","110/08/23","土銀-白河",0,36,-36
"953","2867三商壽","110/08/23","華南永昌-公誠",60,1,59
"954","2867三商壽","110/08/23","元大-博愛",0,31,-31
"955","2867三商壽","110/08/23","國票-安和",50,0,50
"956","2867三商壽","110/08/23","凱基-八德",0,30,-30
"957","2867三商壽","110/08/23","國泰-板橋",50,0,50
"958","2867三商壽","110/08/23","元大-永康",0,30,-30
"959","2867三商壽","110/08/23","永豐金-新莊",50,0,50
"960","2867三商壽","110/08/23","日盛-二林",20,40,-20
"961","5521工信","110/08/23","摩根大通",142,16,126
"962","5521工信","110/08/23","港商野村",0,134,-134
"963","5521工信","110/08/23","群益金鼎-台中",123,0,123
"964","5521工信","110/08/23","元大-南屯",10,135,-125
"965","5521工信","110/08/23","元大證券",106,0,106
"966","5521工信","110/08/23","國泰-敦南",1,34,-33
"967","5521工信","110/08/23","凱基-台北",117,24,93
"968","5521工信","110/08/23","台新-台中",2,30,-28
"969","5521工信","110/08/23","中國信託-三重",44,0,44
"970","5521工信","110/08/23","群益金鼎-三民",0,25,-25
"971","5521工信","110/08/23","日盛-宜蘭",20,0,20
"972","5521工信","110/08/23","福勝",0,20,-20
"973","5521工信","110/08/23","元大-桃園",20,0,20
"974","5521工信","110/08/23","元大-內湖",0,20,-20
"975","5521工信","110/08/23","日茂",14,0,14
"976","5521工信","110/08/23","第一金-新竹",0,15,-15
"977","5521工信","110/08/23","富邦-苗栗",12,0,12
"978","5521工信","110/08/23","統一-員林",0,15,-15
"979","5521工信","110/08/23","港商法國興業",11,0,11
"980","5521工信","110/08/23","新光",0,15,-15
"981","5521工信","110/08/23","統一-新台中",66,55,11
"982","5521工信","110/08/23","華南永昌-高雄",0,15,-15
"983","5521工信","110/08/23","宏遠-桃園",10,0,10
"984","5521工信","110/08/23","第一金-桃園",0,12,-12
"985","5521工信","110/08/23","日進",10,0,10
"986","5521工信","110/08/23","群益金鼎-萬華",0,12,-12
"987","5521工信","110/08/23","群益金鼎-中壢",10,0,10
"988","5521工信","110/08/23","兆豐-新竹",0,11,-11
"989","5521工信","110/08/23","富邦-虎尾",10,0,10
"990","5521工信","110/08/23","群益金鼎-忠孝",0,10,-10
"991","1471首利","110/08/23","摩根大通",143,11,132
"992","1471首利","110/08/23","元大-草屯",0,153,-153
"993","1471首利","110/08/23","瑞士信貸",79,0,79
"994","1471首利","110/08/23","富邦-台北",0,30,-30
"995","1471首利","110/08/23","美林",27,1,26
"996","1471首利","110/08/23","第一金-路竹",0,28,-28
"997","1471首利","110/08/23","凱基-台北",23,0,23
"998","1471首利","110/08/23","光和-嘉義",0,20,-20
"999","1471首利","110/08/23","港商法國興業",16,0,16
"1000","1471首利","110/08/23","兆豐-台中港",0,20,-20
"1001","1471首利","110/08/23","兆豐-員林",13,1,12
"1002","1471首利","110/08/23","新光-台南",0,20,-20
"1003","1471首利","110/08/23","台新-台南",10,0,10
"1004","1471首利","110/08/23","永豐金-松山",0,20,-20
"1005","1471首利","110/08/23","玉山-新莊",10,0,10
"1006","1471首利","110/08/23","永興-大墩",0,12,-12
"1007","1471首利","110/08/23","元大-南崁",10,0,10
"1008","1471首利","110/08/23","元富-民權",0,12,-12
"1009","1471首利","110/08/23","國泰-敦南",9,0,9
"1010","1471首利","110/08/23","光和",0,11,-11
"1011","1471首利","110/08/23","中農",7,0,7
"1012","1471首利","110/08/23","凱基-嘉義",0,11,-11
"1013","1471首利","110/08/23","元大-南投",7,0,7
"1014","1471首利","110/08/23","宏遠-光隆",0,10,-10
"1015","1471首利","110/08/23","臺銀-鳳山",5,0,5
"1016","1471首利","110/08/23","元富-台南",0,10,-10
"1017","1471首利","110/08/23","臺銀-新竹",5,0,5
"1018","1471首利","110/08/23","國票-天祥",1,7,-6
"1019","1471首利","110/08/23","台新-松江",5,0,5
"1020","1471首利","110/08/23","凱基-新店",1,7,-6
"1021","2883開發金","110/08/23","港商野村",10106,1311,8795
"1022","2883開發金","110/08/23","凱基",0,12731,-12731
"1023","2883開發金","110/08/23","國泰-館前",3231,61,3170
"1024","2883開發金","110/08/23","華南永昌",206,3525,-3319
"1025","2883開發金","110/08/23","美林",3113,860,2253
"1026","2883開發金","110/08/23","台灣摩根士丹利",274,2928,-2654
"1027","2883開發金","110/08/23","元大-開元",2066,52,2014
"1028","2883開發金","110/08/23","凱基-台北",1073,3532,-2459
"1029","2883開發金","110/08/23","統一",1542,16,1526
"1030","2883開發金","110/08/23","新加坡商瑞銀",404,2862,-2458
"1031","2883開發金","110/08/23","永豐金-新莊",1111,2,1109
"1032","2883開發金","110/08/23","群益金鼎",2,1833,-1831
"1033","2883開發金","110/08/23","永豐金-台南",1055,155,900
"1034","2883開發金","110/08/23","摩根大通",987,2808,-1821
"1035","2883開發金","110/08/23","統一-基隆",542,0,542
"1036","2883開發金","110/08/23","聯邦商銀",4,1800,-1796
"1037","2883開發金","110/08/23","花旗環球",650,117,533
"1038","2883開發金","110/08/23","康和",5,1485,-1480
"1039","2883開發金","110/08/23","群益金鼎-開元",531,23,508
"1040","2883開發金","110/08/23","新光",1648,2512,-864
"1041","2883開發金","110/08/23","港商法國興業",484,0,484
"1042","2883開發金","110/08/23","美商高盛",11,687,-676
"1043","2883開發金","110/08/23","統一-台中",496,32,464
"1044","2883開發金","110/08/23","大慶-基隆",3,503,-500
"1045","2883開發金","110/08/23","(牛牛牛)亞-鑫豐",475,48,427
"1046","2883開發金","110/08/23","瑞士信貸",206,641,-435
"1047","2883開發金","110/08/23","元大證券",560,198,362
"1048","2883開發金","110/08/23","第一金-台南",79,494,-415
"1049","2883開發金","110/08/23","台新證券",488,128,360
"1050","2883開發金","110/08/23","華南永昌-苑裡",2,315,-313
"1051","6205詮欣","110/08/23","合庫-三重",49,0,49
"1052","6205詮欣","110/08/23","永豐金-敦南",0,52,-52
"1053","6205詮欣","110/08/23","摩根大通",8,0,8
"1054","6205詮欣","110/08/23","統一-中壢",0,10,-10
"1055","6205詮欣","110/08/23","日盛-高雄",5,0,5
"1056","6205詮欣","110/08/23","瑞士信貸",3,11,-8
"1057","6205詮欣","110/08/23","新光-台南",5,0,5
"1058","6205詮欣","110/08/23","群益金鼎-永和",0,5,-5
"1059","6205詮欣","110/08/23","元大-復北",4,0,4
"1060","6205詮欣","110/08/23","華南永昌-公誠",0,5,-5
"1061","6205詮欣","110/08/23","永豐金證券",4,0,4
"1062","6205詮欣","110/08/23","元大-屏東",0,5,-5
"1063","6205詮欣","110/08/23","臺銀-高雄",3,0,3
"1064","6205詮欣","110/08/23","元大-汐止",1,5,-4
"1065","6205詮欣","110/08/23","港商法國興業",3,0,3
"1066","6205詮欣","110/08/23","統一-汐止",0,3,-3
"1067","6205詮欣","110/08/23","凱基-汐止",3,0,3
"1068","6205詮欣","110/08/23","元富-嘉義",0,2,-2
"1069","6205詮欣","110/08/23","凱基-台北",4,1,3
"1070","6205詮欣","110/08/23","北城證券",0,2,-2
"1071","6205詮欣","110/08/23","日盛-三重",2,0,2
"1072","6205詮欣","110/08/23","凱基-新莊",0,2,-2
"1073","6205詮欣","110/08/23","華南永昌-潮州",2,0,2
"1074","6205詮欣","110/08/23","富邦-仁愛",0,2,-2
"1075","6205詮欣","110/08/23","元大-成功",2,0,2
"1076","6205詮欣","110/08/23","永豐金-新莊",0,2,-2
"1077","6205詮欣","110/08/23","美林",1,0,1
"1078","6205詮欣","110/08/23","永豐金-台中",0,2,-2
"1079","6205詮欣","110/08/23","第一金-大稻埕",1,0,1
"1080","6205詮欣","110/08/23","第一金-路竹",0,1,-1
"1081","1540喬福","110/08/23","玉山證券",6,1,5
"1082","1540喬福","110/08/23","元富-新竹",0,5,-5
"1083","1540喬福","110/08/23","港商法國興業",3,0,3
"1084","1540喬福","110/08/23","玉山-城中",0,5,-5
"1085","1540喬福","110/08/23","元富-敦南",3,0,3
"1086","1540喬福","110/08/23","兆豐-台中港",0,4,-4
"1087","1540喬福","110/08/23","凱基-台北",2,0,2
"1088","1540喬福","110/08/23","元大-太平",0,4,-4
"1089","1540喬福","110/08/23","國泰-敦南",1,0,1
"1090","1540喬福","110/08/23","美林",0,1,-1
"1091","1540喬福","110/08/23","永豐金-豐原",1,0,1
"1092","1540喬福","110/08/23","元富",0,1,-1
"1093","1540喬福","110/08/23","永豐金-敦南",1,0,1
"1094","1540喬福","110/08/23","群益金鼎-海山",0,1,-1
"1095","1540喬福","110/08/23","元大-文心興安",1,0,1
"1096","1540喬福","110/08/23","富邦-嘉義",0,1,-1
"1097","1540喬福","110/08/23","群益金鼎-丹鳳",1,0,1
"1098","1540喬福","110/08/23","日盛-八德",0,0,0
"1099","1540喬福","110/08/23","群益金鼎-高雄",1,0,1
"1100","1540喬福","110/08/23","統一-三重",0,0,0
"1101","1540喬福","110/08/23","合庫-高雄",1,0,1
"1102","1540喬福","110/08/23","(牛牛牛)亞-網路",0,0,0
"1103","1540喬福","110/08/23","致和-南京",2,1,1
"1104","1540喬福","110/08/23","國泰-高雄",0,0,0
"1105","1540喬福","110/08/23","新加坡商瑞銀",1,0,1
"1106","1540喬福","110/08/23","凱基-竹北",0,0,0
"1107","1540喬福","110/08/23","國泰-高雄",0,0,0
"1108","1540喬福","110/08/23","華南永昌-嘉義",0,0,0
"1109","1540喬福","110/08/23","凱基-竹北",0,0,0
"1110","1540喬福","110/08/23","元大-西門",0,0,0
"1111","2888新光金","110/08/23","港商野村",2200,82,2118
"1112","2888新光金","110/08/23","元富-城東",72,2108,-2036
"1113","2888新光金","110/08/23","凱基-台北",1553,74,1479
"1114","2888新光金","110/08/23","元大-北投",15,1631,-1616
"1115","2888新光金","110/08/23","合庫-新竹",800,0,800
"1116","2888新光金","110/08/23","美商高盛",264,1857,-1593
"1117","2888新光金","110/08/23","法銀巴黎",688,38,650
"1118","2888新光金","110/08/23","摩根大通",2146,3664,-1518
"1119","2888新光金","110/08/23","元富",590,17,573
"1120","2888新光金","110/08/23","元大證券",87,1208,-1121
"1121","2888新光金","110/08/23","第一金-新竹",572,0,572
"1122","2888新光金","110/08/23","凱基-頭份",0,1100,-1100
"1123","2888新光金","110/08/23","台灣摩根士丹利",597,168,429
"1124","2888新光金","110/08/23","玉山-板橋",93,712,-619
"1125","2888新光金","110/08/23","福邦-新竹",412,0,412
"1126","2888新光金","110/08/23","瑞士信貸",535,1122,-587
"1127","2888新光金","110/08/23","新光",504,139,365
"1128","2888新光金","110/08/23","元富-嘉義",27,583,-556
"1129","2888新光金","110/08/23","元大-屏南",343,4,339
"1130","2888新光金","110/08/23","凱基-敦北",2,500,-498
"1131","2888新光金","110/08/23","(牛牛牛)亞-鑫豐",398,63,335
"1132","2888新光金","110/08/23","華南永昌-林口",130,620,-490
"1133","2888新光金","110/08/23","永豐金-嘉義",300,0,300
"1134","2888新光金","110/08/23","元大-草屯",27,442,-415
"1135","2888新光金","110/08/23","富邦-台北",309,14,295
"1136","2888新光金","110/08/23","元大-大天母",5,255,-250
"1137","2888新光金","110/08/23","元富-彰化",254,2,252
"1138","2888新光金","110/08/23","土銀-嘉義",10,250,-240
"1139","2888新光金","110/08/23","群益金鼎-竹南",282,32,250
"1140","2888新光金","110/08/23","富邦-高雄",42,266,-224
"1141","1340勝悅","110/08/23","港商法國興業",20,0,20
"1142","1340勝悅","110/08/23","凱基-永華",0,26,-26
"1143","1340勝悅","110/08/23","凱基-台北",15,1,14
"1144","1340勝悅","110/08/23","元大-四維",0,20,-20
"1145","1340勝悅","110/08/23","美林",12,0,12
"1146","1340勝悅","110/08/23","元大-向上",0,19,-19
"1147","1340勝悅","110/08/23","元富-宜蘭",7,0,7
"1148","1340勝悅","110/08/23","元大-竹北",0,18,-18
"1149","1340勝悅","110/08/23","美商高盛",6,0,6
"1150","1340勝悅","110/08/23","永豐金-內湖",0,15,-15
"1151","1340勝悅","110/08/23","國泰-台中",6,0,6
"1152","1340勝悅","110/08/23","摩根大通",0,9,-9
"1153","1340勝悅","110/08/23","臺灣企銀-埔墘",5,0,5
"1154","1340勝悅","110/08/23","元大-忠孝鼎富",0,9,-9
"1155","1340勝悅","110/08/23","元富-彰化",5,0,5
"1156","1340勝悅","110/08/23","凱基-高美館",0,4,-4
"1157","1340勝悅","110/08/23","台中銀",5,0,5
"1158","1340勝悅","110/08/23","臺銀-鳳山",0,3,-3
"1159","1340勝悅","110/08/23","新光",5,0,5
"1160","1340勝悅","110/08/23","統一-城中",3,6,-3
"1161","1340勝悅","110/08/23","瑞士信貸",4,0,4
"1162","1340勝悅","110/08/23","陽信-石牌",0,2,-2
"1163","1340勝悅","110/08/23","華南永昌-新莊",4,0,4
"1164","1340勝悅","110/08/23","群益金鼎-屏東",0,2,-2
"1165","1340勝悅","110/08/23","富邦-新店",5,1,4
"1166","1340勝悅","110/08/23","富邦-羅東",0,2,-2
"1167","1340勝悅","110/08/23","群益金鼎-館前",3,0,3
"1168","1340勝悅","110/08/23","元大-新竹經國",0,2,-2
"1169","1340勝悅","110/08/23","國泰-桃園",2,0,2
"1170","1340勝悅","110/08/23","新光-台南",0,1,-1
"1171","6246臺龍","110/08/23","台新-高雄",46,22,24
"1172","6246臺龍","110/08/23","元富-高雄",0,26,-26
"1173","6246臺龍","110/08/23","凱基-台北",10,1,9
"1174","6246臺龍","110/08/23","元大-台北",0,8,-8
"1175","6246臺龍","110/08/23","臺銀-臺中",6,0,6
"1176","6246臺龍","110/08/23","日進",0,6,-6
"1177","6246臺龍","110/08/23","國票-北高雄",6,0,6
"1178","6246臺龍","110/08/23","第一金-高雄",0,5,-5
"1179","6246臺龍","110/08/23","第一金-安和",5,0,5
"1180","6246臺龍","110/08/23","玉山-桃園",0,5,-5
"1181","6246臺龍","110/08/23","元富-宜蘭",5,0,5
"1182","6246臺龍","110/08/23","群益金鼎-東門",0,5,-5
"1183","6246臺龍","110/08/23","康和-內湖",5,0,5
"1184","6246臺龍","110/08/23","永豐金-三重",0,5,-5
"1185","6246臺龍","110/08/23","兆豐-公益",4,0,4
"1186","6246臺龍","110/08/23","元富-潮州",0,4,-4
"1187","6246臺龍","110/08/23","台新-屏東",20,16,4
"1188","6246臺龍","110/08/23","元大-新莊",0,4,-4
"1189","6246臺龍","110/08/23","元大-高雄",4,0,4
"1190","6246臺龍","110/08/23","宏遠-新化",0,3,-3
"1191","6246臺龍","110/08/23","兆豐-景美",3,0,3
"1192","6246臺龍","110/08/23","富邦-嘉義",0,3,-3
"1193","6246臺龍","110/08/23","國票-敦北法人",5,2,3
"1194","6246臺龍","110/08/23","日盛-新莊",0,2,-2
"1195","6246臺龍","110/08/23","新光-台中",3,0,3
"1196","6246臺龍","110/08/23","元富-花蓮",0,2,-2
"1197","6246臺龍","110/08/23","元大-竹山",3,0,3
"1198","6246臺龍","110/08/23","兆豐-高雄",0,2,-2
"1199","6246臺龍","110/08/23","元大-土城",3,0,3
"1200","6246臺龍","110/08/23","國泰-敦南",1,3,-2
"1201","00715L期街口布蘭特正2","110/08/23","中國信託-永康",1679,1,1678
"1202","00715L期街口布蘭特正2","110/08/23","元大證券",181,15885,-15704
"1203","00715L期街口布蘭特正2","110/08/23","元大-新竹",1242,37,1205
"1204","00715L期街口布蘭特正2","110/08/23","凱基",0,4277,-4277
"1205","00715L期街口布蘭特正2","110/08/23","兆豐-鹿港",790,10,780
"1206","00715L期街口布蘭特正2","110/08/23","合庫證券",25,3475,-3450
"1207","00715L期街口布蘭特正2","110/08/23","凱基-台北",1274,502,772
"1208","00715L期街口布蘭特正2","110/08/23","永豐金證券",100,3461,-3361
"1209","00715L期街口布蘭特正2","110/08/23","新光",913,226,687
"1210","00715L期街口布蘭特正2","110/08/23","元富",11,2829,-2818
"1211","00715L期街口布蘭特正2","110/08/23","台中銀",639,24,615
"1212","00715L期街口布蘭特正2","110/08/23","康和",0,2551,-2551
"1213","00715L期街口布蘭特正2","110/08/23","元大-嘉義",584,0,584
"1214","00715L期街口布蘭特正2","110/08/23","富邦證券",1628,2629,-1001
"1215","00715L期街口布蘭特正2","110/08/23","兆豐-台中港",613,30,583
"1216","00715L期街口布蘭特正2","110/08/23","元大-林森",45,602,-557
"1217","00715L期街口布蘭特正2","110/08/23","永豐金-板盛",506,0,506
"1218","00715L期街口布蘭特正2","110/08/23","元大-三重",21,550,-529
"1219","00715L期街口布蘭特正2","110/08/23","群益金鼎-屏東",501,0,501
"1220","00715L期街口布蘭特正2","110/08/23","元大-民雄",92,575,-483
"1221","00715L期街口布蘭特正2","110/08/23","元大-北港",496,10,486
"1222","00715L期街口布蘭特正2","110/08/23","元大-蘆洲",15,316,-301
"1223","00715L期街口布蘭特正2","110/08/23","新光-台中",463,36,427
"1224","00715L期街口布蘭特正2","110/08/23","群益金鼎-台中",10,300,-290
"1225","00715L期街口布蘭特正2","110/08/23","永豐金-市政",420,15,405
"1226","00715L期街口布蘭特正2","110/08/23","群益金鼎-丹鳳",37,320,-283
"1227","00715L期街口布蘭特正2","110/08/23","元大-復北",415,11,404
"1228","00715L期街口布蘭特正2","110/08/23","富邦-嘉義",346,628,-282
"1229","00715L期街口布蘭特正2","110/08/23","中國信託-高雄",428,28,400
"1230","00715L期街口布蘭特正2","110/08/23","大昌-樹林",48,295,-247
"1231","8941關中","110/08/23","凱基-市府",1,0,1
"1232","8941關中","110/08/23","元大-金華",0,1,-1
"1233","8941關中","110/08/23","元富-台中",0,0,0
"1234","8941關中","110/08/23","元富-台中",0,0,0
"1235","8941關中","110/08/23","康和-板橋",0,0,0
"1236","8941關中","110/08/23","康和-板橋",0,0,0
"1237","8941關中","110/08/23","凱基-市政",0,0,0
"1238","8941關中","110/08/23","凱基-市政",0,0,0
"1239","8941關中","110/08/23","永豐金-敦北",0,0,0
"1240","8941關中","110/08/23","永豐金-敦北",0,0,0
"1241","8941關中","110/08/23","永豐金-南投",0,0,0
"1242","8941關中","110/08/23","永豐金-南投",0,0,0
"1243","8941關中","110/08/23","",NA,NA,NA
"1244","8941關中","110/08/23","",NA,NA,NA
"1245","8941關中","110/08/23","",NA,NA,NA
"1246","8941關中","110/08/23","",NA,NA,NA
"1247","8941關中","110/08/23","",NA,NA,NA
"1248","8941關中","110/08/23","",NA,NA,NA
"1249","8941關中","110/08/23","",NA,NA,NA
"1250","8941關中","110/08/23","",NA,NA,NA
"1251","8941關中","110/08/23","",NA,NA,NA
"1252","8941關中","110/08/23","",NA,NA,NA
"1253","8941關中","110/08/23","",NA,NA,NA
"1254","8941關中","110/08/23","",NA,NA,NA
"1255","8941關中","110/08/23","",NA,NA,NA
"1256","8941關中","110/08/23","",NA,NA,NA
"1257","8941關中","110/08/23","",NA,NA,NA
"1258","8941關中","110/08/23","",NA,NA,NA
"1259","8941關中","110/08/23","",NA,NA,NA
"1260","8941關中","110/08/23","",NA,NA,NA
"1261","8936國統","110/08/23","新加坡商瑞銀",220,12,208
"1262","8936國統","110/08/23","宏遠-台南",0,264,-264
"1263","8936國統","110/08/23","第一金-高雄",100,0,100
"1264","8936國統","110/08/23","康和-高雄",0,156,-156
"1265","8936國統","110/08/23","美商高盛",89,5,84
"1266","8936國統","110/08/23","凱基-高美館",0,56,-56
"1267","8936國統","110/08/23","瑞士信貸",77,0,77
"1268","8936國統","110/08/23","凱基-台北",7,50,-43
"1269","8936國統","110/08/23","中國信託-高雄",55,0,55
"1270","8936國統","110/08/23","大慶-楊梅",0,19,-19
"1271","8936國統","110/08/23","摩根大通",44,0,44
"1272","8936國統","110/08/23","富邦-台北",1,17,-16
"1273","8936國統","110/08/23","港商野村",68,31,37
"1274","8936國統","110/08/23","國票-中正",0,15,-15
"1275","8936國統","110/08/23","富邦-陽明",30,0,30
"1276","8936國統","110/08/23","兆豐-北高雄",0,14,-14
"1277","8936國統","110/08/23","美林",15,0,15
"1278","8936國統","110/08/23","日盛-和美",1,12,-11
"1279","8936國統","110/08/23","華南永昌",15,0,15
"1280","8936國統","110/08/23","統一-新竹",2,13,-11
"1281","8936國統","110/08/23","新光-台中",13,1,12
"1282","8936國統","110/08/23","永興-水湳",0,10,-10
"1283","8936國統","110/08/23","臺銀-鳳山",11,0,11
"1284","8936國統","110/08/23","國票-北高雄",0,10,-10
"1285","8936國統","110/08/23","元富-城東",10,0,10
"1286","8936國統","110/08/23","凱基-科園",0,10,-10
"1287","8936國統","110/08/23","宏遠-高雄",11,2,9
"1288","8936國統","110/08/23","元大-高雄",0,10,-10
"1289","8936國統","110/08/23","元富-古亭",9,0,9
"1290","8936國統","110/08/23","元大-西螺",0,8,-8
"1291","6226光鼎","110/08/23","摩根大通",432,89,343
"1292","6226光鼎","110/08/23","元大-文心興安",17,248,-231
"1293","6226光鼎","110/08/23","凱基-台北",234,13,221
"1294","6226光鼎","110/08/23","台新-台南",5,92,-87
"1295","6226光鼎","110/08/23","瑞士信貸",176,1,175
"1296","6226光鼎","110/08/23","致和-佳里",0,50,-50
"1297","6226光鼎","110/08/23","美林",77,4,73
"1298","6226光鼎","110/08/23","永豐金-大園",1,50,-49
"1299","6226光鼎","110/08/23","元大-板橋",51,4,47
"1300","6226光鼎","110/08/23","永豐金-竹北",0,40,-40
"1301","6226光鼎","110/08/23","港商法國興業",41,0,41
"1302","6226光鼎","110/08/23","凱基-台中",10,46,-36
"1303","6226光鼎","110/08/23","富邦-陽明",60,20,40
"1304","6226光鼎","110/08/23","統一",0,35,-35
"1305","6226光鼎","110/08/23","華南永昌-中正",38,0,38
"1306","6226光鼎","110/08/23","國泰-板橋",13,47,-34
"1307","6226光鼎","110/08/23","美商高盛",120,86,34
"1308","6226光鼎","110/08/23","富邦-岡山",0,34,-34
"1309","6226光鼎","110/08/23","永豐金-虎尾",54,21,33
"1310","6226光鼎","110/08/23","元富-城中",4,37,-33
"1311","6226光鼎","110/08/23","元大-中壢",43,11,32
"1312","6226光鼎","110/08/23","永豐金-中盛",2,35,-33
"1313","6226光鼎","110/08/23","元大-松山",30,0,30
"1314","6226光鼎","110/08/23","新光",29,60,-31
"1315","6226光鼎","110/08/23","華南永昌-麻豆",29,0,29
"1316","6226光鼎","110/08/23","第一金-台南",3,28,-25
"1317","6226光鼎","110/08/23","國泰-敦南",108,80,28
"1318","6226光鼎","110/08/23","元富-同大",0,23,-23
"1319","6226光鼎","110/08/23","凱基-內埔",31,10,21
"1320","6226光鼎","110/08/23","元大-高雄",0,23,-23
"1321","2363矽統","110/08/23","摩根大通",2511,676,1835
"1322","2363矽統","110/08/23","凱基-南崁",11,1553,-1542
"1323","2363矽統","110/08/23","凱基-台北",1871,888,983
"1324","2363矽統","110/08/23","玉山-台中",25,549,-524
"1325","2363矽統","110/08/23","合庫-基隆",965,24,941
"1326","2363矽統","110/08/23","台灣摩根士丹利",0,504,-504
"1327","2363矽統","110/08/23","瑞士信貸",553,0,553
"1328","2363矽統","110/08/23","永豐金-板盛",4,302,-298
"1329","2363矽統","110/08/23","美商高盛",1636,1099,537
"1330","2363矽統","110/08/23","大展",13,289,-276
"1331","2363矽統","110/08/23","港商野村",2021,1501,520
"1332","2363矽統","110/08/23","元大-汐止",123,391,-268
"1333","2363矽統","110/08/23","美林",395,80,315
"1334","2363矽統","110/08/23","台新證券",332,525,-193
"1335","2363矽統","110/08/23","富邦-苗栗",360,53,307
"1336","2363矽統","110/08/23","富邦-新竹",45,201,-156
"1337","2363矽統","110/08/23","統一-土城",254,6,248
"1338","2363矽統","110/08/23","群益金鼎-桃園",4,107,-103
"1339","2363矽統","110/08/23","統一-仁愛",281,48,233
"1340","2363矽統","110/08/23","台新-屏東",58,156,-98
"1341","2363矽統","110/08/23","統一-敦南",261,40,221
"1342","2363矽統","110/08/23","元富-永和",9,103,-94
"1343","2363矽統","110/08/23","統一-城中",276,57,219
"1344","2363矽統","110/08/23","富邦-新店",19,107,-88
"1345","2363矽統","110/08/23","群益金鼎-敦南",209,13,196
"1346","2363矽統","110/08/23","群益金鼎-南京",24,111,-87
"1347","2363矽統","110/08/23","華南永昌-林口",174,12,162
"1348","2363矽統","110/08/23","台新-左楠",4,88,-84
"1349","2363矽統","110/08/23","元大-淡水",210,57,153
"1350","2363矽統","110/08/23","元大-沙鹿",58,137,-79
"1351","8112至上","110/08/23","美林",116,9,107
"1352","8112至上","110/08/23","群益金鼎-基隆",0,172,-172
"1353","8112至上","110/08/23","摩根大通",133,59,74
"1354","8112至上","110/08/23","香港上海匯豐",0,120,-120
"1355","8112至上","110/08/23","第一金-桃園",99,30,69
"1356","8112至上","110/08/23","台灣摩根士丹利",0,110,-110
"1357","8112至上","110/08/23","凱基-台北",129,78,51
"1358","8112至上","110/08/23","群益金鼎",0,100,-100
"1359","8112至上","110/08/23","元大-成功",50,1,49
"1360","8112至上","110/08/23","元大-佳里",5,92,-87
"1361","8112至上","110/08/23","日盛-花蓮",40,0,40
"1362","8112至上","110/08/23","港商野村",77,140,-63
"1363","8112至上","110/08/23","國票-天祥",40,0,40
"1364","8112至上","110/08/23","元大-永和",0,45,-45
"1365","8112至上","110/08/23","群益金鼎-板橋",40,0,40
"1366","8112至上","110/08/23","富邦-仁愛",31,66,-35
"1367","8112至上","110/08/23","元大-萬華",49,10,39
"1368","8112至上","110/08/23","日盛-文化",0,26,-26
"1369","8112至上","110/08/23","合庫-西台中",40,5,35
"1370","8112至上","110/08/23","元富-佳里",4,30,-26
"1371","8112至上","110/08/23","瑞士信貸",33,0,33
"1372","8112至上","110/08/23","第一金-大稻埕",0,25,-25
"1373","8112至上","110/08/23","中國信託-永康",31,0,31
"1374","8112至上","110/08/23","大慶-蘆洲",0,22,-22
"1375","8112至上","110/08/23","亞東",30,0,30
"1376","8112至上","110/08/23","永豐金-敦南",2,23,-21
"1377","8112至上","110/08/23","亞東-台中",26,0,26
"1378","8112至上","110/08/23","台中銀",0,20,-20
"1379","8112至上","110/08/23","富邦-北港",35,11,24
"1380","8112至上","110/08/23","兆豐-西螺",0,20,-20
"1381","1570力肯","110/08/23","國票-和平",39,0,39
"1382","1570力肯","110/08/23","統一",0,28,-28
"1383","1570力肯","110/08/23","摩根大通",22,1,21
"1384","1570力肯","110/08/23","群益金鼎-東門",0,20,-20
"1385","1570力肯","110/08/23","臺銀",18,0,18
"1386","1570力肯","110/08/23","中國信託-嘉義",0,15,-15
"1387","1570力肯","110/08/23","台新-台中",18,0,18
"1388","1570力肯","110/08/23","台新證券",0,15,-15
"1389","1570力肯","110/08/23","凱基-台北",25,8,17
"1390","1570力肯","110/08/23","元富-世貿",0,10,-10
"1391","1570力肯","110/08/23","中農",10,0,10
"1392","1570力肯","110/08/23","國票-博愛",0,10,-10
"1393","1570力肯","110/08/23","瑞士信貸",5,0,5
"1394","1570力肯","110/08/23","元富-新興",0,9,-9
"1395","1570力肯","110/08/23","兆豐-松德",5,0,5
"1396","1570力肯","110/08/23","新光",0,9,-9
"1397","1570力肯","110/08/23","凱基-高美館",5,0,5
"1398","1570力肯","110/08/23","元大-四維",1,7,-6
"1399","1570力肯","110/08/23","凱基-幸福",5,0,5
"1400","1570力肯","110/08/23","元大-淡水",0,4,-4
"1401","1570力肯","110/08/23","元大-和平",20,15,5
"1402","1570力肯","110/08/23","元大-民生",0,4,-4
"1403","1570力肯","110/08/23","元大-草屯",5,0,5
"1404","1570力肯","110/08/23","元大-東港",0,4,-4
"1405","1570力肯","110/08/23","日盛-中壢",4,0,4
"1406","1570力肯","110/08/23","永豐金-松山",0,4,-4
"1407","1570力肯","110/08/23","國票-天祥",3,0,3
"1408","1570力肯","110/08/23","日盛-景美",0,3,-3
"1409","1570力肯","110/08/23","台灣企銀-屏東",2,0,2
"1410","1570力肯","110/08/23","中國信託-新竹",0,3,-3
"1411","2929淘帝","110/08/23","凱基-台北",27,2,25
"1412","2929淘帝","110/08/23","花旗環球",0,22,-22
"1413","2929淘帝","110/08/23","元大-太平",23,0,23
"1414","2929淘帝","110/08/23","宏遠-館前",0,20,-20
"1415","2929淘帝","110/08/23","元大-萬華",20,0,20
"1416","2929淘帝","110/08/23","富邦-高雄",0,20,-20
"1417","2929淘帝","110/08/23","港商野村",14,0,14
"1418","2929淘帝","110/08/23","兆豐-北高雄",0,17,-17
"1419","2929淘帝","110/08/23","摩根大通",14,0,14
"1420","2929淘帝","110/08/23","致和-高雄",0,10,-10
"1421","2929淘帝","110/08/23","富邦-陽明",11,0,11
"1422","2929淘帝","110/08/23","康和-內湖",0,10,-10
"1423","2929淘帝","110/08/23","元大-文心興安",10,0,10
"1424","2929淘帝","110/08/23","元大-沙鹿",0,9,-9
"1425","2929淘帝","110/08/23","永豐金-大園",10,0,10
"1426","2929淘帝","110/08/23","元大-豐原站前",0,8,-8
"1427","2929淘帝","110/08/23","凱基-林口",7,0,7
"1428","2929淘帝","110/08/23","高橋-龍潭",0,7,-7
"1429","2929淘帝","110/08/23","新加坡商瑞銀",9,3,6
"1430","2929淘帝","110/08/23","臺銀-高雄",0,6,-6
"1431","2929淘帝","110/08/23","日盛-員林",5,0,5
"1432","2929淘帝","110/08/23","元富-新竹",0,6,-6
"1433","2929淘帝","110/08/23","元大-虎尾",5,0,5
"1434","2929淘帝","110/08/23","富邦-竹北",0,6,-6
"1435","2929淘帝","110/08/23","美林",6,2,4
"1436","2929淘帝","110/08/23","元大-莒光",0,5,-5
"1437","2929淘帝","110/08/23","港商法國興業",4,0,4
"1438","2929淘帝","110/08/23","元大-左營",0,5,-5
"1439","2929淘帝","110/08/23","凱基-東門",4,0,4
"1440","2929淘帝","110/08/23","元大-鹿港",0,5,-5
"1441","5410國眾","110/08/23","港商野村",14,0,14
"1442","5410國眾","110/08/23","元大-崇德",0,22,-22
"1443","5410國眾","110/08/23","凱基-台北",14,3,11
"1444","5410國眾","110/08/23","元大-清水",0,15,-15
"1445","5410國眾","110/08/23","凱基-科園",10,0,10
"1446","5410國眾","110/08/23","元大-金華",0,10,-10
"1447","5410國眾","110/08/23","華南永昌-高雄",7,0,7
"1448","5410國眾","110/08/23","元大-中壢",0,9,-9
"1449","5410國眾","110/08/23","新加坡商瑞銀",6,0,6
"1450","5410國眾","110/08/23","日盛-台中",0,8,-8
"1451","5410國眾","110/08/23","國泰-台中",5,0,5
"1452","5410國眾","110/08/23","元大-前金",0,6,-6
"1453","5410國眾","110/08/23","國泰-桃園",5,0,5
"1454","5410國眾","110/08/23","華南永昌-公誠",0,5,-5
"1455","5410國眾","110/08/23","華南永昌-淡水",5,0,5
"1456","5410國眾","110/08/23","臺銀-高雄",0,4,-4
"1457","5410國眾","110/08/23","新光",2,0,2
"1458","5410國眾","110/08/23","華南永昌-鶯歌",1,5,-4
"1459","5410國眾","110/08/23","國泰-台南",2,0,2
"1460","5410國眾","110/08/23","元富-烏日",0,3,-3
"1461","5410國眾","110/08/23","凱基-桃園",2,0,2
"1462","5410國眾","110/08/23","富邦-桃園",0,3,-3
"1463","5410國眾","110/08/23","富邦-建國",2,0,2
"1464","5410國眾","110/08/23","元大-發財",0,2,-2
"1465","5410國眾","110/08/23","永豐金-敦北",2,0,2
"1466","5410國眾","110/08/23","元大-雙和",0,2,-2
"1467","5410國眾","110/08/23","日盛-園區",1,0,1
"1468","5410國眾","110/08/23","日盛-中和",0,1,-1
"1469","5410國眾","110/08/23","第一金-中壢",1,0,1
"1470","5410國眾","110/08/23","彰銀",0,1,-1
"1471","2841台開","110/08/23","宏遠-館前",300,0,300
"1472","2841台開","110/08/23","台中銀",0,74,-74
"1473","2841台開","110/08/23","第一金",54,0,54
"1474","2841台開","110/08/23","港商野村",0,62,-62
"1475","2841台開","110/08/23","元大-仁愛",38,0,38
"1476","2841台開","110/08/23","永豐金-敦南",10,58,-48
"1477","2841台開","110/08/23","合庫-三重",15,0,15
"1478","2841台開","110/08/23","台新-三民",0,39,-39
"1479","2841台開","110/08/23","玉山-新竹",15,0,15
"1480","2841台開","110/08/23","日盛證券",0,27,-27
"1481","2841台開","110/08/23","元大-大里德芳",10,0,10
"1482","2841台開","110/08/23","新光",13,37,-24
"1483","2841台開","110/08/23","元大-新莊",10,0,10
"1484","2841台開","110/08/23","凱基-虎尾",0,20,-20
"1485","2841台開","110/08/23","元富-緯城",5,0,5
"1486","2841台開","110/08/23","永豐金-忠孝",0,20,-20
"1487","2841台開","110/08/23","第一金-台南",4,0,4
"1488","2841台開","110/08/23","富邦-板橋",0,19,-19
"1489","2841台開","110/08/23","富邦-岡山",4,0,4
"1490","2841台開","110/08/23","凱基-東港",0,15,-15
"1491","2841台開","110/08/23","元大-虎尾",4,0,4
"1492","2841台開","110/08/23","國泰-敦南",0,11,-11
"1493","2841台開","110/08/23","元大-學甲",2,0,2
"1494","2841台開","110/08/23","元大-竹北",0,10,-10
"1495","2841台開","110/08/23","元大-草屯",2,0,2
"1496","2841台開","110/08/23","元大-彰化",1,11,-10
"1497","2841台開","110/08/23","台中銀-員林",1,0,1
"1498","2841台開","110/08/23","元大-北三重",0,10,-10
"1499","2841台開","110/08/23","台新-新營",1,0,1
"1500","2841台開","110/08/23","國泰-桃園",1,9,-8
"1501","6207雷科","110/08/23","摩根大通",29,6,23
"1502","6207雷科","110/08/23","元大-高雄",0,75,-75
"1503","6207雷科","110/08/23","凱基-台北",18,3,15
"1504","6207雷科","110/08/23","華南永昌-世貿",0,38,-38
"1505","6207雷科","110/08/23","安泰-楠梓",11,0,11
"1506","6207雷科","110/08/23","凱基-高雄",0,13,-13
"1507","6207雷科","110/08/23","凱基-頭份",12,1,11
"1508","6207雷科","110/08/23","港商野村",7,19,-12
"1509","6207雷科","110/08/23","群益金鼎-中壢",10,0,10
"1510","6207雷科","110/08/23","新加坡商瑞銀",1,13,-12
"1511","6207雷科","110/08/23","統一-中壢",9,0,9
"1512","6207雷科","110/08/23","元大-新莊",0,7,-7
"1513","6207雷科","110/08/23","元大-敦南",9,0,9
"1514","6207雷科","110/08/23","兆豐-公益",0,6,-6
"1515","6207雷科","110/08/23","瑞士信貸",8,0,8
"1516","6207雷科","110/08/23","合庫-高雄",0,5,-5
"1517","6207雷科","110/08/23","兆豐-嘉義",8,0,8
"1518","6207雷科","110/08/23","宏遠-高雄",0,5,-5
"1519","6207雷科","110/08/23","華南永昌-古亭",7,0,7
"1520","6207雷科","110/08/23","凱基-板橋",0,5,-5
"1521","6207雷科","110/08/23","富邦-陽明",7,0,7
"1522","6207雷科","110/08/23","群益金鼎-三民",0,4,-4
"1523","6207雷科","110/08/23","日盛-員林",6,0,6
"1524","6207雷科","110/08/23","群益金鼎-東門",0,4,-4
"1525","6207雷科","110/08/23","德信-新營",5,0,5
"1526","6207雷科","110/08/23","富邦-羅東",0,4,-4
"1527","6207雷科","110/08/23","凱基-高美館",5,0,5
"1528","6207雷科","110/08/23","元富-虎尾",0,3,-3
"1529","6207雷科","110/08/23","玉山-高雄",4,0,4
"1530","6207雷科","110/08/23","國泰-桃園",0,3,-3
"1531","3679新至陞","110/08/23","永豐金-南投",17,0,17
"1532","3679新至陞","110/08/23","港商法國興業",0,8,-8
"1533","3679新至陞","110/08/23","元富-埔里",9,0,9
"1534","3679新至陞","110/08/23","凱基-長庚",0,8,-8
"1535","3679新至陞","110/08/23","(牛牛牛)亞-網路",7,0,7
"1536","3679新至陞","110/08/23","宏遠-光隆",0,6,-6
"1537","3679新至陞","110/08/23","美林",7,1,6
"1538","3679新至陞","110/08/23","玉山-高雄",0,5,-5
"1539","3679新至陞","110/08/23","台灣摩根士丹利",5,0,5
"1540","3679新至陞","110/08/23","群益金鼎-高盛",0,3,-3
"1541","3679新至陞","110/08/23","瑞士信貸",6,1,5
"1542","3679新至陞","110/08/23","華南永昌-林口",0,3,-3
"1543","3679新至陞","110/08/23","元大-樹林",5,0,5
"1544","3679新至陞","110/08/23","元大證券",0,3,-3
"1545","3679新至陞","110/08/23","元大-文心興安",6,2,4
"1546","3679新至陞","110/08/23","元大-小港",0,3,-3
"1547","3679新至陞","110/08/23","凱基-台北",3,0,3
"1548","3679新至陞","110/08/23","統一-敦南",0,2,-2
"1549","3679新至陞","110/08/23","臺銀",2,0,2
"1550","3679新至陞","110/08/23","元富-大昌",0,2,-2
"1551","3679新至陞","110/08/23","臺銀-臺中",3,1,2
"1552","3679新至陞","110/08/23","玉山-新莊",0,2,-2
"1553","3679新至陞","110/08/23","新光-高雄",2,0,2
"1554","3679新至陞","110/08/23","群益金鼎-三民",0,2,-2
"1555","3679新至陞","110/08/23","華南永昌",2,0,2
"1556","3679新至陞","110/08/23","富邦-新竹",0,2,-2
"1557","3679新至陞","110/08/23","日盛-二林",1,0,1
"1558","3679新至陞","110/08/23","元大-敦化",0,2,-2
"1559","3679新至陞","110/08/23","新加坡商瑞銀",1,0,1
"1560","3679新至陞","110/08/23","永豐金-內湖",0,2,-2
"1561","2727王品","110/08/23","凱基-台北",163,48,115
"1562","2727王品","110/08/23","港商麥格理",0,51,-51
"1563","2727王品","110/08/23","台灣摩根士丹利",62,0,62
"1564","2727王品","110/08/23","國票-南港",0,50,-50
"1565","2727王品","110/08/23","元大-台中中港",58,0,58
"1566","2727王品","110/08/23","台新證券",9,35,-26
"1567","2727王品","110/08/23","美林",48,0,48
"1568","2727王品","110/08/23","元大-景美",2,21,-19
"1569","2727王品","110/08/23","摩根大通",73,41,32
"1570","2727王品","110/08/23","大慶-台南",0,15,-15
"1571","2727王品","110/08/23","港商野村",61,35,26
"1572","2727王品","110/08/23","中國信託-高雄",1,15,-14
"1573","2727王品","110/08/23","統一",21,4,17
"1574","2727王品","110/08/23","永豐金-市政",2,13,-11
"1575","2727王品","110/08/23","群益金鼎-大興",15,0,15
"1576","2727王品","110/08/23","第一金-桃園",0,10,-10
"1577","2727王品","110/08/23","台灣企銀",12,0,12
"1578","2727王品","110/08/23","玉山證券",1,11,-10
"1579","2727王品","110/08/23","新加坡商瑞銀",11,0,11
"1580","2727王品","110/08/23","凱基-三重",0,10,-10
"1581","2727王品","110/08/23","統一-三重",10,0,10
"1582","2727王品","110/08/23","富邦-建國",0,10,-10
"1583","2727王品","110/08/23","永豐金-竹科",13,3,10
"1584","2727王品","110/08/23","美商高盛",7,16,-9
"1585","2727王品","110/08/23","合庫-台中",10,1,9
"1586","2727王品","110/08/23","群益金鼎-三重",0,9,-9
"1587","2727王品","110/08/23","香港上海匯豐",9,0,9
"1588","2727王品","110/08/23","群益金鼎-宜蘭",0,9,-9
"1589","2727王品","110/08/23","凱基-台南",10,2,8
"1590","2727王品","110/08/23","凱基-高美館",0,9,-9
"1591","1570力肯","110/08/23","國票-和平",39,0,39
"1592","1570力肯","110/08/23","統一",0,28,-28
"1593","1570力肯","110/08/23","摩根大通",22,1,21
"1594","1570力肯","110/08/23","群益金鼎-東門",0,20,-20
"1595","1570力肯","110/08/23","臺銀",18,0,18
"1596","1570力肯","110/08/23","中國信託-嘉義",0,15,-15
"1597","1570力肯","110/08/23","台新-台中",18,0,18
"1598","1570力肯","110/08/23","台新證券",0,15,-15
"1599","1570力肯","110/08/23","凱基-台北",25,8,17
"1600","1570力肯","110/08/23","元富-世貿",0,10,-10
"1601","1570力肯","110/08/23","中農",10,0,10
"1602","1570力肯","110/08/23","國票-博愛",0,10,-10
"1603","1570力肯","110/08/23","瑞士信貸",5,0,5
"1604","1570力肯","110/08/23","元富-新興",0,9,-9
"1605","1570力肯","110/08/23","兆豐-松德",5,0,5
"1606","1570力肯","110/08/23","新光",0,9,-9
"1607","1570力肯","110/08/23","凱基-高美館",5,0,5
"1608","1570力肯","110/08/23","元大-四維",1,7,-6
"1609","1570力肯","110/08/23","凱基-幸福",5,0,5
"1610","1570力肯","110/08/23","元大-淡水",0,4,-4
"1611","1570力肯","110/08/23","元大-和平",20,15,5
"1612","1570力肯","110/08/23","元大-民生",0,4,-4
"1613","1570力肯","110/08/23","元大-草屯",5,0,5
"1614","1570力肯","110/08/23","元大-東港",0,4,-4
"1615","1570力肯","110/08/23","日盛-中壢",4,0,4
"1616","1570力肯","110/08/23","永豐金-松山",0,4,-4
"1617","1570力肯","110/08/23","國票-天祥",3,0,3
"1618","1570力肯","110/08/23","日盛-景美",0,3,-3
"1619","1570力肯","110/08/23","台灣企銀-屏東",2,0,2
"1620","1570力肯","110/08/23","中國信託-新竹",0,3,-3
"1621","6180橘子","110/08/23","凱基-台北",107,15,92
"1622","6180橘子","110/08/23","國泰-館前",2,28,-26
"1623","6180橘子","110/08/23","美林",50,0,50
"1624","6180橘子","110/08/23","元大-中壢",0,22,-22
"1625","6180橘子","110/08/23","摩根大通",66,24,42
"1626","6180橘子","110/08/23","華南永昌-鶯歌",0,21,-21
"1627","6180橘子","110/08/23","港商野村",38,2,36
"1628","6180橘子","110/08/23","台灣企銀-屏東",0,18,-18
"1629","6180橘子","110/08/23","元富-高雄",22,0,22
"1630","6180橘子","110/08/23","永豐金-中壢",0,18,-18
"1631","6180橘子","110/08/23","元大-上新莊",21,0,21
"1632","6180橘子","110/08/23","兆豐-台中",0,17,-17
"1633","6180橘子","110/08/23","福勝",19,1,18
"1634","6180橘子","110/08/23","新光-高雄",1,18,-17
"1635","6180橘子","110/08/23","富邦-內湖",13,2,11
"1636","6180橘子","110/08/23","台灣摩根士丹利",9,21,-12
"1637","6180橘子","110/08/23","永豐金證券",11,0,11
"1638","6180橘子","110/08/23","富邦-永和",0,12,-12
"1639","6180橘子","110/08/23","彰銀-七賢",10,0,10
"1640","6180橘子","110/08/23","合庫-自強",0,11,-11
"1641","6180橘子","110/08/23","中國信託-高雄",10,0,10
"1642","6180橘子","110/08/23","元大-發財",0,11,-11
"1643","6180橘子","110/08/23","兆豐-埔墘",10,0,10
"1644","6180橘子","110/08/23","第一金-新興",0,10,-10
"1645","6180橘子","110/08/23","群益金鼎-敦南",10,0,10
"1646","6180橘子","110/08/23","統一-中壢",0,10,-10
"1647","6180橘子","110/08/23","元大-台南",10,0,10
"1648","6180橘子","110/08/23","台新-屏東",0,10,-10
"1649","6180橘子","110/08/23","元大-左營",11,1,10
"1650","6180橘子","110/08/23","元大-旗山",0,10,-10
"1651","2390云辰","110/08/23","元大-土城學府",197,0,197
"1652","2390云辰","110/08/23","凱基-台北",87,301,-214
"1653","2390云辰","110/08/23","新光-台中",154,34,120
"1654","2390云辰","110/08/23","兆豐-公益",4,173,-169
"1655","2390云辰","110/08/23","宏遠證券",100,0,100
"1656","2390云辰","110/08/23","國票-博愛",65,200,-135
"1657","2390云辰","110/08/23","凱基-林口",92,0,92
"1658","2390云辰","110/08/23","群益金鼎-三重",8,112,-104
"1659","2390云辰","110/08/23","統一-新台中",83,1,82
"1660","2390云辰","110/08/23","日盛-園區",4,104,-100
"1661","2390云辰","110/08/23","凱基-竹北",62,8,54
"1662","2390云辰","110/08/23","凱基-屏東",1,101,-100
"1663","2390云辰","110/08/23","華南永昌-公誠",66,15,51
"1664","2390云辰","110/08/23","富邦-花蓮",2,100,-98
"1665","2390云辰","110/08/23","國泰-敦南",172,129,43
"1666","2390云辰","110/08/23","摩根大通",83,162,-79
"1667","2390云辰","110/08/23","統一-新竹",44,7,37
"1668","2390云辰","110/08/23","元富-花蓮",2,74,-72
"1669","2390云辰","110/08/23","元大-沙鹿",73,39,34
"1670","2390云辰","110/08/23","第一金-安和",32,101,-69
"1671","2390云辰","110/08/23","元大-新盛",47,16,31
"1672","2390云辰","110/08/23","美商高盛",26,92,-66
"1673","2390云辰","110/08/23","華南永昌-鳳山",29,3,26
"1674","2390云辰","110/08/23","統一-三重",6,71,-65
"1675","2390云辰","110/08/23","大昌-樹林",34,9,25
"1676","2390云辰","110/08/23","富邦-嘉義",195,260,-65
"1677","2390云辰","110/08/23","富邦-陽明",59,34,25
"1678","2390云辰","110/08/23","元大-忠孝鼎富",0,50,-50
"1679","2390云辰","110/08/23","富邦-宜蘭",28,3,25
"1680","2390云辰","110/08/23","統一-城中",7,53,-46
"1681","1315達新","110/08/20","日盛-和美",16,0,16
"1682","1315達新","110/08/20","香港上海匯豐",0,41,-41
"1683","1315達新","110/08/20","元富-成功",10,0,10
"1684","1315達新","110/08/20","元大-文心興安",2,36,-34
"1685","1315達新","110/08/20","兆豐-台中",10,0,10
"1686","1315達新","110/08/20","港商麥格理",0,26,-26
"1687","1315達新","110/08/20","凱基-中港",10,0,10
"1688","1315達新","110/08/20","元富",0,14,-14
"1689","1315達新","110/08/20","元大-桃園",8,0,8
"1690","1315達新","110/08/20","元富-敦南",0,8,-8
"1691","1315達新","110/08/20","凱基-高美館",7,0,7
"1692","1315達新","110/08/20","凱基-台北",7,15,-8
"1693","1315達新","110/08/20","統一",5,0,5
"1694","1315達新","110/08/20","元大-花蓮",2,10,-8
"1695","1315達新","110/08/20","中國信託-高雄",5,0,5
"1696","1315達新","110/08/20","摩根大通",0,7,-7
"1697","1315達新","110/08/20","致和-東門",5,0,5
"1698","1315達新","110/08/20","(牛牛牛)亞證券",0,6,-6
"1699","1315達新","110/08/20","國票-北高雄",5,0,5
"1700","1315達新","110/08/20","群益金鼎-鳳山",0,6,-6
"1701","1315達新","110/08/20","國票-桃園",5,0,5
"1702","1315達新","110/08/20","美林",3,8,-5
"1703","1315達新","110/08/20","凱基-高雄",5,0,5
"1704","1315達新","110/08/20","玉山-大里",0,4,-4
"1705","1315達新","110/08/20","凱基-大安",5,0,5
"1706","1315達新","110/08/20","國票-安和",1,4,-3
"1707","1315達新","110/08/20","新光",5,1,4
"1708","1315達新","110/08/20","永興-台中",0,1,-1
"1709","1315達新","110/08/20","國泰-敦南",4,0,4
"1710","1315達新","110/08/20","光和-花壇",0,1,-1
"1711","2609陽明","110/08/20","摩根大通",7094,4108,2986
"1712","2609陽明","110/08/20","富邦證券",916,4167,-3251
"1713","2609陽明","110/08/20","凱基-台北",3009,829,2180
"1714","2609陽明","110/08/20","瑞士信貸",1961,3747,-1786
"1715","2609陽明","110/08/20","永豐金-信義",2022,49,1973
"1716","2609陽明","110/08/20","美林",3367,4938,-1571
"1717","2609陽明","110/08/20","富邦-虎尾",14038,12509,1529
"1718","2609陽明","110/08/20","元大證券",1688,3204,-1516
"1719","2609陽明","110/08/20","華南永昌-竹北",2009,531,1478
"1720","2609陽明","110/08/20","凱基-高美館",303,786,-483
"1721","2609陽明","110/08/20","群益金鼎-大安",1208,64,1144
"1722","2609陽明","110/08/20","日盛-板橋",125,587,-462
"1723","2609陽明","110/08/20","康和",5625,4754,871
"1724","2609陽明","110/08/20","富邦-北港",163,571,-408
"1725","2609陽明","110/08/20","兆豐-虎尾",919,77,842
"1726","2609陽明","110/08/20","凱基-台南",165,557,-392
"1727","2609陽明","110/08/20","新加坡商瑞銀",1133,390,743
"1728","2609陽明","110/08/20","元大-樹林",215,599,-384
"1729","2609陽明","110/08/20","統一-仁愛",1379,702,677
"1730","2609陽明","110/08/20","富邦-台中",246,596,-350
"1731","2609陽明","110/08/20","美商高盛",1051,452,599
"1732","2609陽明","110/08/20","凱基-復興",141,467,-326
"1733","2609陽明","110/08/20","凱基-市府",658,82,576
"1734","2609陽明","110/08/20","台新-高雄",483,807,-324
"1735","2609陽明","110/08/20","元大-新莊",665,169,496
"1736","2609陽明","110/08/20","日盛證券",323,619,-296
"1737","2609陽明","110/08/20","台灣摩根士丹利",773,365,408
"1738","2609陽明","110/08/20","法銀巴黎",0,292,-292
"1739","2609陽明","110/08/20","日盛-雙和",550,197,353
"1740","2609陽明","110/08/20","元大-北投",454,729,-275
"1741","2636台驊投控","110/08/20","摩根大通",709,415,294
"1742","2636台驊投控","110/08/20","台灣摩根士丹利",146,252,-106
"1743","2636台驊投控","110/08/20","台新-台中",176,64,112
"1744","2636台驊投控","110/08/20","港商野村",1266,1357,-91
"1745","2636台驊投控","110/08/20","統一",191,91,100
"1746","2636台驊投控","110/08/20","美林",246,335,-89
"1747","2636台驊投控","110/08/20","永豐金-萬盛",136,39,97
"1748","2636台驊投控","110/08/20","宏遠-新化",1,75,-74
"1749","2636台驊投控","110/08/20","永豐金-南京",105,33,72
"1750","2636台驊投控","110/08/20","群益金鼎-竹南",5,69,-64
"1751","2636台驊投控","110/08/20","日盛-景美",102,32,70
"1752","2636台驊投控","110/08/20","日盛-大墩",4,56,-52
"1753","2636台驊投控","110/08/20","日盛證券",154,103,51
"1754","2636台驊投控","110/08/20","第一金-台中",5,56,-51
"1755","2636台驊投控","110/08/20","第一金-桃園",54,7,47
"1756","2636台驊投控","110/08/20","日盛-宜蘭",2,52,-50
"1757","2636台驊投控","110/08/20","統一-基隆",47,5,42
"1758","2636台驊投控","110/08/20","兆豐-南京",0,49,-49
"1759","2636台驊投控","110/08/20","元富-城東",63,22,41
"1760","2636台驊投控","110/08/20","合庫-新竹",4,47,-43
"1761","2636台驊投控","110/08/20","富邦-建國",67,35,32
"1762","2636台驊投控","110/08/20","統一-城中",6,33,-27
"1763","2636台驊投控","110/08/20","元大-桃興",40,10,30
"1764","2636台驊投控","110/08/20","凱基-科園",7,34,-27
"1765","2636台驊投控","110/08/20","土銀-南港",34,6,28
"1766","2636台驊投控","110/08/20","新光",167,193,-26
"1767","2636台驊投控","110/08/20","永豐金-台南",54,27,27
"1768","2636台驊投控","110/08/20","群益金鼎-古亭",51,75,-24
"1769","2636台驊投控","110/08/20","富邦-台北",45,19,26
"1770","2636台驊投控","110/08/20","富邦-仁愛",51,74,-23
"1771","2867三商壽","110/08/20","凱基-台北",225,43,182
"1772","2867三商壽","110/08/20","宏遠證券",0,1023,-1023
"1773","2867三商壽","110/08/20","元大-土城永寧",150,2,148
"1774","2867三商壽","110/08/20","摩根大通",123,551,-428
"1775","2867三商壽","110/08/20","新光",213,72,141
"1776","2867三商壽","110/08/20","美商高盛",62,194,-132
"1777","2867三商壽","110/08/20","臺銀-鳳山",131,26,105
"1778","2867三商壽","110/08/20","國票-中正",0,130,-130
"1779","2867三商壽","110/08/20","元大-屏東民生",100,0,100
"1780","2867三商壽","110/08/20","美林",1,114,-113
"1781","2867三商壽","110/08/20","元大-桃園",100,1,99
"1782","2867三商壽","110/08/20","台灣摩根士丹利",31,107,-76
"1783","2867三商壽","110/08/20","永豐金-埔里",94,20,74
"1784","2867三商壽","110/08/20","富邦-中壢",1,75,-74
"1785","2867三商壽","110/08/20","土銀-台中",60,0,60
"1786","2867三商壽","110/08/20","華南永昌-南京",10,70,-60
"1787","2867三商壽","110/08/20","臺銀-高雄",56,1,55
"1788","2867三商壽","110/08/20","富邦-彰化",10,67,-57
"1789","2867三商壽","110/08/20","統一-台南",55,0,55
"1790","2867三商壽","110/08/20","凱基-高美館",0,50,-50
"1791","2867三商壽","110/08/20","富邦-仁愛",53,0,53
"1792","2867三商壽","110/08/20","港商野村",35,68,-33
"1793","2867三商壽","110/08/20","富邦-台北",44,1,43
"1794","2867三商壽","110/08/20","台新-高雄",1,31,-30
"1795","2867三商壽","110/08/20","合庫-高雄",40,0,40
"1796","2867三商壽","110/08/20","元大-北屯",9,36,-27
"1797","2867三商壽","110/08/20","華南永昌-虎尾",50,10,40
"1798","2867三商壽","110/08/20","法銀巴黎",1,27,-26
"1799","2867三商壽","110/08/20","富邦-宜蘭",40,0,40
"1800","2867三商壽","110/08/20","日盛-中壢",0,20,-20
"1801","5521工信","110/08/20","元大-內湖",55,0,55
"1802","5521工信","110/08/20","美商高盛",0,182,-182
"1803","5521工信","110/08/20","日進",36,0,36
"1804","5521工信","110/08/20","摩根大通",39,180,-141
"1805","5521工信","110/08/20","兆豐-來福",30,0,30
"1806","5521工信","110/08/20","凱基-台北",0,101,-101
"1807","5521工信","110/08/20","元大-屏南",30,0,30
"1808","5521工信","110/08/20","富邦-岡山",0,50,-50
"1809","5521工信","110/08/20","台新證券",26,4,22
"1810","5521工信","110/08/20","港商野村",0,41,-41
"1811","5521工信","110/08/20","玉山-台大",25,5,20
"1812","5521工信","110/08/20","台灣摩根士丹利",1,30,-29
"1813","5521工信","110/08/20","群益金鼎-忠孝",20,0,20
"1814","5521工信","110/08/20","群益金鼎-高雄",0,20,-20
"1815","5521工信","110/08/20","富邦-台北",20,0,20
"1816","5521工信","110/08/20","華南永昌-中正",0,20,-20
"1817","5521工信","110/08/20","永豐金-中正",19,0,19
"1818","5521工信","110/08/20","台新-新營",0,19,-19
"1819","5521工信","110/08/20","統一-員林",15,0,15
"1820","5521工信","110/08/20","華南永昌-彰化",2,20,-18
"1821","5521工信","110/08/20","合庫-桃園",12,0,12
"1822","5521工信","110/08/20","群益金鼎-潭子",0,15,-15
"1823","5521工信","110/08/20","陽信-石牌",11,0,11
"1824","5521工信","110/08/20","元大-板橋",0,15,-15
"1825","5521工信","110/08/20","元大-基隆孝二",11,0,11
"1826","5521工信","110/08/20","元大-南屯",1,15,-14
"1827","5521工信","110/08/20","土銀-白河",10,0,10
"1828","5521工信","110/08/20","永豐金-桃盛",0,10,-10
"1829","5521工信","110/08/20","華南永昌-大安",10,0,10
"1830","5521工信","110/08/20","聯邦-雙和",0,8,-8
"1831","1471首利","110/08/20","富邦-員林",41,0,41
"1832","1471首利","110/08/20","元大-草屯",1,100,-99
"1833","1471首利","110/08/20","摩根大通",88,63,25
"1834","1471首利","110/08/20","元富-民權",0,41,-41
"1835","1471首利","110/08/20","永豐金-板盛",23,0,23
"1836","1471首利","110/08/20","致和-府前",0,20,-20
"1837","1471首利","110/08/20","台新證券",30,11,19
"1838","1471首利","110/08/20","大慶-蘆洲",0,14,-14
"1839","1471首利","110/08/20","日盛-高雄",15,0,15
"1840","1471首利","110/08/20","凱基-台北",3,16,-13
"1841","1471首利","110/08/20","瑞士信貸",36,21,15
"1842","1471首利","110/08/20","玉山-新莊",1,12,-11
"1843","1471首利","110/08/20","元大-成功",15,0,15
"1844","1471首利","110/08/20","日盛-樹林",0,10,-10
"1845","1471首利","110/08/20","元大-鳳山",13,0,13
"1846","1471首利","110/08/20","台中銀-豐原",0,10,-10
"1847","1471首利","110/08/20","美林",11,0,11
"1848","1471首利","110/08/20","國票-新莊",0,10,-10
"1849","1471首利","110/08/20","兆豐-西螺",10,0,10
"1850","1471首利","110/08/20","元大-開元",0,10,-10
"1851","1471首利","110/08/20","台新-台南",10,0,10
"1852","1471首利","110/08/20","新光",9,18,-9
"1853","1471首利","110/08/20","新光-台中",7,0,7
"1854","1471首利","110/08/20","元大-台中",0,8,-8
"1855","1471首利","110/08/20","凱基-長庚",7,0,7
"1856","1471首利","110/08/20","富邦-竹東",0,7,-7
"1857","1471首利","110/08/20","日盛-大墩",6,0,6
"1858","1471首利","110/08/20","元大-善化",0,7,-7
"1859","1471首利","110/08/20","國泰-敦南",6,0,6
"1860","1471首利","110/08/20","永豐金-忠孝",0,7,-7
"1861","2883開發金","110/08/20","美商高盛",5045,274,4771
"1862","2883開發金","110/08/20","元大-草屯",110,5813,-5703
"1863","2883開發金","110/08/20","摩根大通",6375,3996,2379
"1864","2883開發金","110/08/20","元大-雙和",35,5050,-5015
"1865","2883開發金","110/08/20","瑞士信貸",2180,184,1996
"1866","2883開發金","110/08/20","元富",228,2528,-2300
"1867","2883開發金","110/08/20","港商野村",4455,2645,1810
"1868","2883開發金","110/08/20","新光",2896,4495,-1599
"1869","2883開發金","110/08/20","美林",1695,187,1508
"1870","2883開發金","110/08/20","法銀巴黎",12,1549,-1537
"1871","2883開發金","110/08/20","凱基-台北",3659,2336,1323
"1872","2883開發金","110/08/20","統一",61,1390,-1329
"1873","2883開發金","110/08/20","富邦證券",1343,39,1304
"1874","2883開發金","110/08/20","台灣匯立證券",0,995,-995
"1875","2883開發金","110/08/20","臺銀",1447,177,1270
"1876","2883開發金","110/08/20","台灣摩根士丹利",1050,1929,-879
"1877","2883開發金","110/08/20","國泰證券",1228,72,1156
"1878","2883開發金","110/08/20","元大-前金",15,785,-770
"1879","2883開發金","110/08/20","華南永昌",1230,198,1032
"1880","2883開發金","110/08/20","元大-桃興",64,796,-732
"1881","2883開發金","110/08/20","元大證券",1137,317,820
"1882","2883開發金","110/08/20","宏遠-台南",80,759,-679
"1883","2883開發金","110/08/20","致和證券",819,0,819
"1884","2883開發金","110/08/20","合庫證券",245,861,-616
"1885","2883開發金","110/08/20","元大-善化",756,83,673
"1886","2883開發金","110/08/20","元大-大灣",46,660,-614
"1887","2883開發金","110/08/20","元大-新莊",731,108,623
"1888","2883開發金","110/08/20","國票-南港",32,641,-609
"1889","2883開發金","110/08/20","凱基",520,10,510
"1890","2883開發金","110/08/20","群益金鼎-開元",30,551,-521
"1891","6205詮欣","110/08/20","聯邦商銀",27,0,27
"1892","6205詮欣","110/08/20","凱基-新店",0,24,-24
"1893","6205詮欣","110/08/20","凱基-汐止",25,0,25
"1894","6205詮欣","110/08/20","元大-忠孝",0,18,-18
"1895","6205詮欣","110/08/20","元大-汐止",10,0,10
"1896","6205詮欣","110/08/20","瑞士信貸",0,17,-17
"1897","6205詮欣","110/08/20","臺銀-臺中",7,0,7
"1898","6205詮欣","110/08/20","摩根大通",2,11,-9
"1899","6205詮欣","110/08/20","統一-基隆",7,0,7
"1900","6205詮欣","110/08/20","日盛-永康",0,5,-5
"1901","6205詮欣","110/08/20","臺銀-高雄",6,0,6
"1902","6205詮欣","110/08/20","聯邦-興中",0,5,-5
"1903","6205詮欣","110/08/20","臺銀-民權",5,0,5
"1904","6205詮欣","110/08/20","華南永昌-公誠",0,5,-5
"1905","6205詮欣","110/08/20","亞東",4,0,4
"1906","6205詮欣","110/08/20","元大-西螺",0,5,-5
"1907","6205詮欣","110/08/20","玉山證券",4,0,4
"1908","6205詮欣","110/08/20","群益金鼎-永和",0,4,-4
"1909","6205詮欣","110/08/20","華南永昌-古亭",4,0,4
"1910","6205詮欣","110/08/20","元大-新竹經國",0,4,-4
"1911","6205詮欣","110/08/20","元大-博愛",4,0,4
"1912","6205詮欣","110/08/20","永興-大墩",0,3,-3
"1913","6205詮欣","110/08/20","元富-草屯",3,0,3
"1914","6205詮欣","110/08/20","國票-和平",0,3,-3
"1915","6205詮欣","110/08/20","合庫-鳳山",2,0,2
"1916","6205詮欣","110/08/20","國泰-敦南",0,3,-3
"1917","6205詮欣","110/08/20","日進",2,0,2
"1918","6205詮欣","110/08/20","華南永昌",0,3,-3
"1919","6205詮欣","110/08/20","凱基-苗栗",2,0,2
"1920","6205詮欣","110/08/20","永豐金-新竹",0,3,-3
"1921","1540喬福","110/08/20","富邦-員林",11,0,11
"1922","1540喬福","110/08/20","元大-北三重",0,12,-12
"1923","1540喬福","110/08/20","永豐金-鳳山",5,0,5
"1924","1540喬福","110/08/20","元大-土城永寧",0,10,-10
"1925","1540喬福","110/08/20","亞東",4,0,4
"1926","1540喬福","110/08/20","新光-新竹",1,6,-5
"1927","1540喬福","110/08/20","新光",3,0,3
"1928","1540喬福","110/08/20","富邦-台南",0,5,-5
"1929","1540喬福","110/08/20","日盛-頭份",2,0,2
"1930","1540喬福","110/08/20","元大-龍潭",0,5,-5
"1931","1540喬福","110/08/20","第一金-嘉義",2,0,2
"1932","1540喬福","110/08/20","日盛-台中",0,2,-2
"1933","1540喬福","110/08/20","兆豐-鹿港",2,0,2
"1934","1540喬福","110/08/20","元大-東港",0,1,-1
"1935","1540喬福","110/08/20","摩根大通",2,0,2
"1936","1540喬福","110/08/20","日盛-板橋",0,0,0
"1937","1540喬福","110/08/20","玉山-桃園",1,0,1
"1938","1540喬福","110/08/20","元富",1,1,0
"1939","1540喬福","110/08/20","凱基-台北",1,0,1
"1940","1540喬福","110/08/20","康和-板橋",0,0,0
"1941","1540喬福","110/08/20","凱基-嘉義",1,0,1
"1942","1540喬福","110/08/20","國泰-敦南",0,0,0
"1943","1540喬福","110/08/20","凱基-市府",1,0,1
"1944","1540喬福","110/08/20","群益金鼎-板橋",0,0,0
"1945","1540喬福","110/08/20","群益金鼎-潭子",1,0,1
"1946","1540喬福","110/08/20","富邦-桃園",0,0,0
"1947","1540喬福","110/08/20","台灣企銀-建成",1,0,1
"1948","1540喬福","110/08/20","元大-西門",0,0,0
"1949","1540喬福","110/08/20","國票-天祥",1,0,1
"1950","1540喬福","110/08/20","元大-草屯",0,0,0
"1951","2888新光金","110/08/20","元富",2479,10,2469
"1952","2888新光金","110/08/20","摩根大通",2428,8920,-6492
"1953","2888新光金","110/08/20","華南永昌",1300,1,1299
"1954","2888新光金","110/08/20","台灣摩根士丹利",272,5505,-5233
"1955","2888新光金","110/08/20","凱基-頭份",1104,10,1094
"1956","2888新光金","110/08/20","美商高盛",23,4545,-4522
"1957","2888新光金","110/08/20","新光",1484,401,1083
"1958","2888新光金","110/08/20","瑞士信貸",62,1483,-1421
"1959","2888新光金","110/08/20","元大證券",1044,239,805
"1960","2888新光金","110/08/20","港商法國興業",66,1075,-1009
"1961","2888新光金","110/08/20","國票-北高雄",711,0,711
"1962","2888新光金","110/08/20","元大-大雅",47,998,-951
"1963","2888新光金","110/08/20","兆豐-台中港",629,0,629
"1964","2888新光金","110/08/20","法銀巴黎",449,1363,-914
"1965","2888新光金","110/08/20","臺銀",509,9,500
"1966","2888新光金","110/08/20","國票-九鼎",27,911,-884
"1967","2888新光金","110/08/20","國泰-忠孝",491,53,438
"1968","2888新光金","110/08/20","港商野村",79,637,-558
"1969","2888新光金","110/08/20","國泰-敦南",466,37,429
"1970","2888新光金","110/08/20","群益金鼎-瑞豐",11,560,-549
"1971","2888新光金","110/08/20","台中銀",442,30,412
"1972","2888新光金","110/08/20","德信-和平",8,500,-492
"1973","2888新光金","110/08/20","富邦-南屯",429,30,399
"1974","2888新光金","110/08/20","元大-大天母",54,452,-398
"1975","2888新光金","110/08/20","元大-三重",338,11,327
"1976","2888新光金","110/08/20","合庫證券",34,393,-359
"1977","2888新光金","110/08/20","永豐金-大園",326,10,316
"1978","2888新光金","110/08/20","群益金鼎",16,358,-342
"1979","2888新光金","110/08/20","北城證券",306,6,300
"1980","2888新光金","110/08/20","群益金鼎-板橋",6,304,-298
"1981","1340勝悅","110/08/20","元富-成功",23,0,23
"1982","1340勝悅","110/08/20","摩根大通",0,13,-13
"1983","1340勝悅","110/08/20","華南永昌-高雄",11,0,11
"1984","1340勝悅","110/08/20","港商法國興業",0,10,-10
"1985","1340勝悅","110/08/20","統一-城中",8,2,6
"1986","1340勝悅","110/08/20","凱基-東勢",0,10,-10
"1987","1340勝悅","110/08/20","元大-北成功",6,0,6
"1988","1340勝悅","110/08/20","元大-楊梅",0,10,-10
"1989","1340勝悅","110/08/20","臺銀-臺中",5,0,5
"1990","1340勝悅","110/08/20","華南永昌-東昇",0,9,-9
"1991","1340勝悅","110/08/20","臺灣企銀-埔墘",5,0,5
"1992","1340勝悅","110/08/20","合庫-自強",0,5,-5
"1993","1340勝悅","110/08/20","日盛-板橋",5,0,5
"1994","1340勝悅","110/08/20","兆豐-新竹",0,5,-5
"1995","1340勝悅","110/08/20","美商高盛",4,0,4
"1996","1340勝悅","110/08/20","玉山-桃園",0,5,-5
"1997","1340勝悅","110/08/20","大昌",3,0,3
"1998","1340勝悅","110/08/20","元大-復北",0,5,-5
"1999","1340勝悅","110/08/20","台中銀",2,0,2
"2000","1340勝悅","110/08/20","兆豐-來福",0,4,-4
"2001","1340勝悅","110/08/20","新光-台中",2,0,2
"2002","1340勝悅","110/08/20","新光",0,4,-4
"2003","1340勝悅","110/08/20","群益金鼎-崇德",2,0,2
"2004","1340勝悅","110/08/20","瑞士信貸",0,3,-3
"2005","1340勝悅","110/08/20","群益金鼎-館前",2,0,2
"2006","1340勝悅","110/08/20","台新證券",0,3,-3
"2007","1340勝悅","110/08/20","華南永昌-忠孝",2,0,2
"2008","1340勝悅","110/08/20","臺銀-鳳山",0,2,-2
"2009","1340勝悅","110/08/20","富邦-北港",2,0,2
"2010","1340勝悅","110/08/20","美林",0,2,-2
"2011","6246臺龍","110/08/20","新光-台中",18,0,18
"2012","6246臺龍","110/08/20","元大-林園",0,20,-20
"2013","6246臺龍","110/08/20","凱基-台北",15,0,15
"2014","6246臺龍","110/08/20","凱基-永和",1,15,-14
"2015","6246臺龍","110/08/20","元大-台北",8,0,8
"2016","6246臺龍","110/08/20","凱基-竹北",0,12,-12
"2017","6246臺龍","110/08/20","元大-北屯",6,0,6
"2018","6246臺龍","110/08/20","富邦-桃園",0,6,-6
"2019","6246臺龍","110/08/20","臺銀-臺中",4,0,4
"2020","6246臺龍","110/08/20","國泰-敦南",0,5,-5
"2021","6246臺龍","110/08/20","元富-吉利",4,0,4
"2022","6246臺龍","110/08/20","日盛證券",0,3,-3
"2023","6246臺龍","110/08/20","凱基-內湖",4,0,4
"2024","6246臺龍","110/08/20","第一金-台南",0,3,-3
"2025","6246臺龍","110/08/20","富邦-建國",4,0,4
"2026","6246臺龍","110/08/20","第一金-桃園",0,3,-3
"2027","6246臺龍","110/08/20","宏遠-新化",3,0,3
"2028","6246臺龍","110/08/20","群益金鼎-北高雄",0,3,-3
"2029","6246臺龍","110/08/20","第一金-大稻埕",2,0,2
"2030","6246臺龍","110/08/20","凱基-虎尾",0,3,-3
"2031","6246臺龍","110/08/20","國票-敦北法人",2,0,2
"2032","6246臺龍","110/08/20","元大-博愛",0,3,-3
"2033","6246臺龍","110/08/20","群益金鼎-開元",2,0,2
"2034","6246臺龍","110/08/20","統一-新竹",0,2,-2
"2035","6246臺龍","110/08/20","元大-竹山",2,0,2
"2036","6246臺龍","110/08/20","元富-新店",0,2,-2
"2037","6246臺龍","110/08/20","元大-上新莊",2,0,2
"2038","6246臺龍","110/08/20","元富-烏日",0,2,-2
"2039","6246臺龍","110/08/20","元大-土城",2,0,2
"2040","6246臺龍","110/08/20","台新-中壢",0,2,-2
"2041","00715L期街口布蘭特正2","110/08/20","新光",1501,206,1295
"2042","00715L期街口布蘭特正2","110/08/20","元大證券",460,5183,-4723
"2043","00715L期街口布蘭特正2","110/08/20","富邦-南屯",671,15,656
"2044","00715L期街口布蘭特正2","110/08/20","合庫證券",9,3350,-3341
"2045","00715L期街口布蘭特正2","110/08/20","元大-復北",756,120,636
"2046","00715L期街口布蘭特正2","110/08/20","康和",603,2255,-1652
"2047","00715L期街口布蘭特正2","110/08/20","華南永昌",555,0,555
"2048","00715L期街口布蘭特正2","110/08/20","群益金鼎",0,1488,-1488
"2049","00715L期街口布蘭特正2","110/08/20","玉山證券",525,32,493
"2050","00715L期街口布蘭特正2","110/08/20","凱基-台北",57,1280,-1223
"2051","00715L期街口布蘭特正2","110/08/20","第一金-華江",472,1,471
"2052","00715L期街口布蘭特正2","110/08/20","統一-台中",34,1238,-1204
"2053","00715L期街口布蘭特正2","110/08/20","元大-西屯",412,0,412
"2054","00715L期街口布蘭特正2","110/08/20","國票",306,1276,-970
"2055","00715L期街口布蘭特正2","110/08/20","第一金-豐原",390,0,390
"2056","00715L期街口布蘭特正2","110/08/20","富邦證券",2234,2995,-761
"2057","00715L期街口布蘭特正2","110/08/20","元大-北港",374,0,374
"2058","00715L期街口布蘭特正2","110/08/20","日盛-新莊",221,825,-604
"2059","00715L期街口布蘭特正2","110/08/20","華南永昌-台中",379,10,369
"2060","00715L期街口布蘭特正2","110/08/20","台新-台中",169,711,-542
"2061","00715L期街口布蘭特正2","110/08/20","玉山-新竹",345,10,335
"2062","00715L期街口布蘭特正2","110/08/20","元富",0,507,-507
"2063","00715L期街口布蘭特正2","110/08/20","元大-草屯",413,88,325
"2064","00715L期街口布蘭特正2","110/08/20","台中銀",90,452,-362
"2065","00715L期街口布蘭特正2","110/08/20","日盛-二林",307,1,306
"2066","00715L期街口布蘭特正2","110/08/20","凱基-中壢",98,442,-344
"2067","00715L期街口布蘭特正2","110/08/20","凱基-站前",306,0,306
"2068","00715L期街口布蘭特正2","110/08/20","台新證券",312,644,-332
"2069","00715L期街口布蘭特正2","110/08/20","新光-台中",308,23,285
"2070","00715L期街口布蘭特正2","110/08/20","元大-林森",1,252,-251
"2071","8941關中","110/08/20","合庫-彰化",1,0,1
"2072","8941關中","110/08/20","大慶-富順",0,1,-1
"2073","8941關中","110/08/20","凱基-市府",1,0,1
"2074","8941關中","110/08/20","國泰-忠孝",0,1,-1
"2075","8941關中","110/08/20","玉山-台大",0,0,0
"2076","8941關中","110/08/20","玉山-台大",0,0,0
"2077","8941關中","110/08/20","國泰-高雄",0,0,0
"2078","8941關中","110/08/20","國泰-高雄",0,0,0
"2079","8941關中","110/08/20","元大-南投",0,0,0
"2080","8941關中","110/08/20","元大-南投",0,0,0
"2081","8941關中","110/08/20","永豐金-萬盛",0,0,0
"2082","8941關中","110/08/20","永豐金-萬盛",0,0,0
"2083","8941關中","110/08/20","永豐金-南投",0,0,0
"2084","8941關中","110/08/20","永豐金-南投",0,0,0
"2085","8941關中","110/08/20","",NA,NA,NA
"2086","8941關中","110/08/20","",NA,NA,NA
"2087","8941關中","110/08/20","",NA,NA,NA
"2088","8941關中","110/08/20","",NA,NA,NA
"2089","8941關中","110/08/20","",NA,NA,NA
"2090","8941關中","110/08/20","",NA,NA,NA
"2091","8941關中","110/08/20","",NA,NA,NA
"2092","8941關中","110/08/20","",NA,NA,NA
"2093","8941關中","110/08/20","",NA,NA,NA
"2094","8941關中","110/08/20","",NA,NA,NA
"2095","8941關中","110/08/20","",NA,NA,NA
"2096","8941關中","110/08/20","",NA,NA,NA
"2097","8941關中","110/08/20","",NA,NA,NA
"2098","8941關中","110/08/20","",NA,NA,NA
"2099","8941關中","110/08/20","",NA,NA,NA
"2100","8941關中","110/08/20","",NA,NA,NA
"2101","8936國統","110/08/20","美林",81,0,81
"2102","8936國統","110/08/20","國票-和平",0,75,-75
"2103","8936國統","110/08/20","宏遠-台南",82,29,53
"2104","8936國統","110/08/20","台灣摩根士丹利",9,55,-46
"2105","8936國統","110/08/20","台中銀-高雄",51,0,51
"2106","8936國統","110/08/20","美商高盛",6,33,-27
"2107","8936國統","110/08/20","富邦-岡山",35,0,35
"2108","8936國統","110/08/20","凱基-高美館",6,33,-27
"2109","8936國統","110/08/20","港商野村",73,43,30
"2110","8936國統","110/08/20","新光-台中",18,43,-25
"2111","8936國統","110/08/20","康和-高雄",30,0,30
"2112","8936國統","110/08/20","凱基-中山",0,17,-17
"2113","8936國統","110/08/20","瑞士信貸",15,0,15
"2114","8936國統","110/08/20","玉山-城中",3,17,-14
"2115","8936國統","110/08/20","兆豐-北高雄",14,0,14
"2116","8936國統","110/08/20","日盛-頭份",0,12,-12
"2117","8936國統","110/08/20","元大-汐止",11,0,11
"2118","8936國統","110/08/20","日盛-大墩",0,10,-10
"2119","8936國統","110/08/20","玉山-左營",10,0,10
"2120","8936國統","110/08/20","凱基-台北",34,44,-10
"2121","8936國統","110/08/20","元大-路竹",10,0,10
"2122","8936國統","110/08/20","元大-高雄",0,10,-10
"2123","8936國統","110/08/20","永豐金-南投",10,0,10
"2124","8936國統","110/08/20","元富-同大",0,8,-8
"2125","8936國統","110/08/20","臺銀",8,2,6
"2126","8936國統","110/08/20","元大-鑫永和",0,8,-8
"2127","8936國統","110/08/20","大昌-新店",5,0,5
"2128","8936國統","110/08/20","日盛-豐原",0,7,-7
"2129","8936國統","110/08/20","國票-內壢",5,0,5
"2130","8936國統","110/08/20","第一金-路竹",0,7,-7
"2131","6226光鼎","110/08/20","美商高盛",388,14,374
"2132","6226光鼎","110/08/20","國泰-台中",62,142,-80
"2133","6226光鼎","110/08/20","台灣摩根士丹利",347,26,321
"2134","6226光鼎","110/08/20","元大-北屯",27,101,-74
"2135","6226光鼎","110/08/20","元大-文心興安",238,8,230
"2136","6226光鼎","110/08/20","永豐金-竹科",0,69,-69
"2137","6226光鼎","110/08/20","美林",265,60,205
"2138","6226光鼎","110/08/20","臺銀-高雄",0,61,-61
"2139","6226光鼎","110/08/20","凱基-台北",211,59,152
"2140","6226光鼎","110/08/20","日盛-信義",0,60,-60
"2141","6226光鼎","110/08/20","摩根大通",172,72,100
"2142","6226光鼎","110/08/20","元大證券",18,76,-58
"2143","6226光鼎","110/08/20","新加坡商瑞銀",162,78,84
"2144","6226光鼎","110/08/20","中國信託",31,81,-50
"2145","6226光鼎","110/08/20","港商野村",168,89,79
"2146","6226光鼎","110/08/20","華南永昌-長虹",1,51,-50
"2147","6226光鼎","110/08/20","中國信託-永康",70,28,42
"2148","6226光鼎","110/08/20","富邦-板橋",6,55,-49
"2149","6226光鼎","110/08/20","致和-佳里",39,5,34
"2150","6226光鼎","110/08/20","土銀-彰化",8,53,-45
"2151","6226光鼎","110/08/20","兆豐-桃鶯",30,0,30
"2152","6226光鼎","110/08/20","新光",49,94,-45
"2153","6226光鼎","110/08/20","永豐金-中盛",38,10,28
"2154","6226光鼎","110/08/20","台新證券",86,129,-43
"2155","6226光鼎","110/08/20","凱基-站前",27,0,27
"2156","6226光鼎","110/08/20","元大-竹科",14,57,-43
"2157","6226光鼎","110/08/20","群益金鼎-永和",25,0,25
"2158","6226光鼎","110/08/20","兆豐-寶成",1,43,-42
"2159","6226光鼎","110/08/20","國票-台南",23,0,23
"2160","6226光鼎","110/08/20","國泰-館前",13,55,-42
"2161","2363矽統","110/08/20","凱基-台北",909,319,590
"2162","2363矽統","110/08/20","群益金鼎",10,183,-173
"2163","2363矽統","110/08/20","港商野村",1346,1106,240
"2164","2363矽統","110/08/20","國票-台東",2,153,-151
"2165","2363矽統","110/08/20","美林",332,137,195
"2166","2363矽統","110/08/20","元大-前金",44,169,-125
"2167","2363矽統","110/08/20","摩根大通",268,88,180
"2168","2363矽統","110/08/20","元大-汐止",32,121,-89
"2169","2363矽統","110/08/20","美商高盛",270,113,157
"2170","2363矽統","110/08/20","統一-屏東",14,90,-76
"2171","2363矽統","110/08/20","統一-三重",108,0,108
"2172","2363矽統","110/08/20","國泰-敦南",202,271,-69
"2173","2363矽統","110/08/20","日盛-中和",110,13,97
"2174","2363矽統","110/08/20","凱基-長庚",12,76,-64
"2175","2363矽統","110/08/20","台新-新營",84,14,70
"2176","2363矽統","110/08/20","凱基-鳳山",4,61,-57
"2177","2363矽統","110/08/20","富邦-台北",183,117,66
"2178","2363矽統","110/08/20","群益金鼎-中壢",25,81,-56
"2179","2363矽統","110/08/20","新光",238,178,60
"2180","2363矽統","110/08/20","合庫-高雄",23,78,-55
"2181","2363矽統","110/08/20","元大-士林",56,1,55
"2182","2363矽統","110/08/20","永豐金-市政",23,75,-52
"2183","2363矽統","110/08/20","凱基-台南",54,6,48
"2184","2363矽統","110/08/20","國泰-館前",98,148,-50
"2185","2363矽統","110/08/20","光和",45,4,41
"2186","2363矽統","110/08/20","國票-九鼎",14,62,-48
"2187","2363矽統","110/08/20","凱基-敦北",40,0,40
"2188","2363矽統","110/08/20","台新-左楠",2,47,-45
"2189","2363矽統","110/08/20","永豐金-台中",45,7,38
"2190","2363矽統","110/08/20","永豐金-潮州",3,46,-43
"2191","8112至上","110/08/20","港商法國興業",188,0,188
"2192","8112至上","110/08/20","台灣摩根士丹利",0,152,-152
"2193","8112至上","110/08/20","港商野村",229,78,151
"2194","8112至上","110/08/20","合庫-西台中",0,130,-130
"2195","8112至上","110/08/20","凱基-台北",95,12,83
"2196","8112至上","110/08/20","富邦-仁愛",7,102,-95
"2197","8112至上","110/08/20","美商高盛",100,23,77
"2198","8112至上","110/08/20","元大-永春",0,88,-88
"2199","8112至上","110/08/20","瑞士信貸",54,1,53
"2200","8112至上","110/08/20","元大-佳里",5,60,-55
"2201","8112至上","110/08/20","元大-路竹",38,7,31
"2202","8112至上","110/08/20","群益金鼎-基隆",1,49,-48
"2203","8112至上","110/08/20","富邦-新竹",37,7,30
"2204","8112至上","110/08/20","新加坡商瑞銀",34,73,-39
"2205","8112至上","110/08/20","元大-竹東",23,0,23
"2206","8112至上","110/08/20","摩根大通",183,214,-31
"2207","8112至上","110/08/20","凱基-桃園",22,1,21
"2208","8112至上","110/08/20","亞東-新竹",0,30,-30
"2209","8112至上","110/08/20","群益金鼎-大興",20,0,20
"2210","8112至上","110/08/20","亞東-台中",0,30,-30
"2211","8112至上","110/08/20","富邦-北港",20,0,20
"2212","8112至上","110/08/20","美林",32,61,-29
"2213","8112至上","110/08/20","元大-東港",20,0,20
"2214","8112至上","110/08/20","合庫-基隆",0,21,-21
"2215","8112至上","110/08/20","第一金-頭份",23,5,18
"2216","8112至上","110/08/20","(牛牛牛)亞-鑫豐",14,35,-21
"2217","8112至上","110/08/20","元大-仁愛",17,0,17
"2218","8112至上","110/08/20","國票-南港",5,26,-21
"2219","8112至上","110/08/20","國票-天祥",16,0,16
"2220","8112至上","110/08/20","國泰-台中",5,26,-21
"2221","1570力肯","110/08/20","國票-北高雄",27,0,27
"2222","1570力肯","110/08/20","元大-大雅",8,58,-50
"2223","1570力肯","110/08/20","元大-鹿港",29,4,25
"2224","1570力肯","110/08/20","凱基-三峽",0,30,-30
"2225","1570力肯","110/08/20","摩根大通",27,5,22
"2226","1570力肯","110/08/20","元大-樹林",0,30,-30
"2227","1570力肯","110/08/20","富邦-花蓮",20,0,20
"2228","1570力肯","110/08/20","統一",0,28,-28
"2229","1570力肯","110/08/20","群益金鼎-高雄",18,0,18
"2230","1570力肯","110/08/20","國票-南科",0,13,-13
"2231","1570力肯","110/08/20","元大-草屯",13,0,13
"2232","1570力肯","110/08/20","元大-鑫永和",0,12,-12
"2233","1570力肯","110/08/20","元富-緯城",12,0,12
"2234","1570力肯","110/08/20","台新證券",0,11,-11
"2235","1570力肯","110/08/20","元富-世貿",10,0,10
"2236","1570力肯","110/08/20","群益金鼎-民權",0,10,-10
"2237","1570力肯","110/08/20","大慶-蘆洲",7,0,7
"2238","1570力肯","110/08/20","國票-台中",3,11,-8
"2239","1570力肯","110/08/20","(牛牛牛)亞-鑫豐",25,18,7
"2240","1570力肯","110/08/20","土銀-新竹",1,7,-6
"2241","1570力肯","110/08/20","國票-天祥",6,0,6
"2242","1570力肯","110/08/20","台灣摩根士丹利",0,6,-6
"2243","1570力肯","110/08/20","凱基-台北",7,1,6
"2244","1570力肯","110/08/20","國泰-敦南",1,7,-6
"2245","1570力肯","110/08/20","元富-城東",5,0,5
"2246","1570力肯","110/08/20","高橋-龍潭",0,5,-5
"2247","1570力肯","110/08/20","國票",5,0,5
"2248","1570力肯","110/08/20","玉山-高雄",0,5,-5
"2249","1570力肯","110/08/20","萬泰",5,0,5
"2250","1570力肯","110/08/20","永豐金-苓雅",0,5,-5
"2251","2929淘帝","110/08/20","元大-太平",35,0,35
"2252","2929淘帝","110/08/20","元大-莒光",0,25,-25
"2253","2929淘帝","110/08/20","港商野村",17,5,12
"2254","2929淘帝","110/08/20","富邦-新營",0,20,-20
"2255","2929淘帝","110/08/20","摩根大通",16,6,10
"2256","2929淘帝","110/08/20","華南永昌-古亭",0,16,-16
"2257","2929淘帝","110/08/20","永豐金-板新",10,0,10
"2258","2929淘帝","110/08/20","兆豐-桃鶯",0,12,-12
"2259","2929淘帝","110/08/20","美林",10,1,9
"2260","2929淘帝","110/08/20","中國信託",0,10,-10
"2261","2929淘帝","110/08/20","兆豐-忠孝",8,0,8
"2262","2929淘帝","110/08/20","元大-竹科",0,10,-10
"2263","2929淘帝","110/08/20","凱基-東門",8,0,8
"2264","2929淘帝","110/08/20","永豐金-新莊",0,10,-10
"2265","2929淘帝","110/08/20","高橋-龍潭",5,0,5
"2266","2929淘帝","110/08/20","兆豐-東門",0,8,-8
"2267","2929淘帝","110/08/20","玉山-台南",5,0,5
"2268","2929淘帝","110/08/20","凱基-三峽",0,7,-7
"2269","2929淘帝","110/08/20","凱基-中山",5,0,5
"2270","2929淘帝","110/08/20","宏遠-館前",0,5,-5
"2271","2929淘帝","110/08/20","華南永昌-小港",5,0,5
"2272","2929淘帝","110/08/20","瑞士信貸",0,5,-5
"2273","2929淘帝","110/08/20","元大-員林",5,0,5
"2274","2929淘帝","110/08/20","富邦-陽明",0,5,-5
"2275","2929淘帝","110/08/20","元大-永和",5,0,5
"2276","2929淘帝","110/08/20","中國信託-松江",0,4,-4
"2277","2929淘帝","110/08/20","永豐金-永康",5,0,5
"2278","2929淘帝","110/08/20","玉山-新竹",11,15,-4
"2279","2929淘帝","110/08/20","群益金鼎-潭子",4,0,4
"2280","2929淘帝","110/08/20","元富-成功",0,3,-3
"2281","5410國眾","110/08/20","大昌",5,0,5
"2282","5410國眾","110/08/20","元大-發財",0,9,-9
"2283","5410國眾","110/08/20","華南永昌-高雄",5,0,5
"2284","5410國眾","110/08/20","元大-士林",2,8,-6
"2285","5410國眾","110/08/20","元大-東泰",5,0,5
"2286","5410國眾","110/08/20","日盛-屏東",0,5,-5
"2287","5410國眾","110/08/20","元大-中壢",5,0,5
"2288","5410國眾","110/08/20","新加坡商瑞銀",3,8,-5
"2289","5410國眾","110/08/20","中國信託-新竹",4,0,4
"2290","5410國眾","110/08/20","凱基-台北",0,4,-4
"2291","5410國眾","110/08/20","新光",3,0,3
"2292","5410國眾","110/08/20","元大-南勢角",0,4,-4
"2293","5410國眾","110/08/20","凱基-竹北",3,0,3
"2294","5410國眾","110/08/20","寶盛",0,3,-3
"2295","5410國眾","110/08/20","國泰-松江",2,0,2
"2296","5410國眾","110/08/20","元富-台南",0,2,-2
"2297","5410國眾","110/08/20","群益金鼎-海山",2,0,2
"2298","5410國眾","110/08/20","華南永昌-小港",0,2,-2
"2299","5410國眾","110/08/20","凱基-彰化",2,0,2
"2300","5410國眾","110/08/20","富邦-竹北",1,3,-2
"2301","5410國眾","110/08/20","日盛-二林",1,0,1
"2302","5410國眾","110/08/20","富邦-永和",0,2,-2
"2303","5410國眾","110/08/20","美林",1,0,1
"2304","5410國眾","110/08/20","元大-華山",0,2,-2
"2305","5410國眾","110/08/20","大慶-蘆洲",1,0,1
"2306","5410國眾","110/08/20","中國信託-文心",0,1,-1
"2307","5410國眾","110/08/20","中國信託-嘉義",1,0,1
"2308","5410國眾","110/08/20","國泰-敦南",4,5,-1
"2309","5410國眾","110/08/20","國泰-台南",1,0,1
"2310","5410國眾","110/08/20","華南永昌-楠梓",0,1,-1
"2311","2841台開","110/08/20","宏遠-館前",465,0,465
"2312","2841台開","110/08/20","台中銀",0,113,-113
"2313","2841台開","110/08/20","第一金",102,0,102
"2314","2841台開","110/08/20","國票-敦北法人",0,51,-51
"2315","2841台開","110/08/20","富邦-岡山",18,0,18
"2316","2841台開","110/08/20","高橋",0,50,-50
"2317","2841台開","110/08/20","台新證券",15,2,13
"2318","2841台開","110/08/20","日盛證券",0,43,-43
"2319","2841台開","110/08/20","元大-新竹經國",10,0,10
"2320","2841台開","110/08/20","永豐金-三重",0,39,-39
"2321","2841台開","110/08/20","日盛-新竹",6,0,6
"2322","2841台開","110/08/20","玉山-高雄",0,30,-30
"2323","2841台開","110/08/20","元富-文心",5,0,5
"2324","2841台開","110/08/20","元大-竹山",0,30,-30
"2325","2841台開","110/08/20","第一金-路竹",3,0,3
"2326","2841台開","110/08/20","光和-高雄",0,28,-28
"2327","2841台開","110/08/20","永豐金-中盛",3,0,3
"2328","2841台開","110/08/20","永豐金-敦南",15,37,-22
"2329","2841台開","110/08/20","新光-台中",2,0,2
"2330","2841台開","110/08/20","新光-台南",0,21,-21
"2331","2841台開","110/08/20","群益金鼎-館前",2,0,2
"2332","2841台開","110/08/20","玉山-嘉義",0,20,-20
"2333","2841台開","110/08/20","群益金鼎-東湖",2,0,2
"2334","2841台開","110/08/20","富邦-員林",0,20,-20
"2335","2841台開","110/08/20","元大-屏東民生",2,0,2
"2336","2841台開","110/08/20","元大-竹科",0,20,-20
"2337","2841台開","110/08/20","國泰-板橋",1,0,1
"2338","2841台開","110/08/20","元大-善化",0,15,-15
"2339","2841台開","110/08/20","群益金鼎-崇德",1,0,1
"2340","2841台開","110/08/20","永豐金-忠孝",0,15,-15
"2341","6207雷科","110/08/20","日盛-員林",20,0,20
"2342","6207雷科","110/08/20","凱基-敦北",0,26,-26
"2343","6207雷科","110/08/20","美林",16,0,16
"2344","6207雷科","110/08/20","新加坡商瑞銀",12,27,-15
"2345","6207雷科","110/08/20","凱基-台北",20,8,12
"2346","6207雷科","110/08/20","國票-南科",1,13,-12
"2347","6207雷科","110/08/20","瑞士信貸",11,0,11
"2348","6207雷科","110/08/20","台新證券",0,10,-10
"2349","6207雷科","110/08/20","港商野村",23,12,11
"2350","6207雷科","110/08/20","國票-九鼎",2,10,-8
"2351","6207雷科","110/08/20","摩根大通",33,22,11
"2352","6207雷科","110/08/20","台新-台中",0,5,-5
"2353","6207雷科","110/08/20","凱基-羅東",6,0,6
"2354","6207雷科","110/08/20","玉山-嘉義",0,5,-5
"2355","6207雷科","110/08/20","富邦-中壢",6,0,6
"2356","6207雷科","110/08/20","群益金鼎-三民",0,5,-5
"2357","6207雷科","110/08/20","元大-大灣",6,0,6
"2358","6207雷科","110/08/20","元大-博愛",0,5,-5
"2359","6207雷科","110/08/20","日盛-台南",5,0,5
"2360","6207雷科","110/08/20","中國信託-中壢",0,4,-4
"2361","6207雷科","110/08/20","富邦-台北",5,0,5
"2362","6207雷科","110/08/20","兆豐-彰化",0,4,-4
"2363","6207雷科","110/08/20","富邦-新店",5,0,5
"2364","6207雷科","110/08/20","群益金鼎-東門",0,4,-4
"2365","6207雷科","110/08/20","元大-府城",5,0,5
"2366","6207雷科","110/08/20","致和-高雄",0,3,-3
"2367","6207雷科","110/08/20","中農",3,0,3
"2368","6207雷科","110/08/20","新光-高雄",0,3,-3
"2369","6207雷科","110/08/20","華南永昌-古亭",3,0,3
"2370","6207雷科","110/08/20","凱基-高雄",0,3,-3
"2371","3679新至陞","110/08/20","元大-大天母",10,0,10
"2372","3679新至陞","110/08/20","台灣企銀-建成",0,6,-6
"2373","3679新至陞","110/08/20","港商野村",3,0,3
"2374","3679新至陞","110/08/20","美林",0,6,-6
"2375","3679新至陞","110/08/20","(牛牛牛)亞-網路",3,0,3
"2376","3679新至陞","110/08/20","花旗環球",0,5,-5
"2377","3679新至陞","110/08/20","富邦-花蓮",3,0,3
"2378","3679新至陞","110/08/20","新加坡商瑞銀",0,5,-5
"2379","3679新至陞","110/08/20","凱基-中山",2,0,2
"2380","3679新至陞","110/08/20","日盛-忠孝",0,4,-4
"2381","3679新至陞","110/08/20","日盛-木柵",1,0,1
"2382","3679新至陞","110/08/20","元大證券",1,4,-3
"2383","3679新至陞","110/08/20","日盛-員林",1,0,1
"2384","3679新至陞","110/08/20","摩根大通",4,6,-2
"2385","3679新至陞","110/08/20","日盛-文化",1,0,1
"2386","3679新至陞","110/08/20","凱基-埔墘",0,2,-2
"2387","3679新至陞","110/08/20","台灣摩根士丹利",1,0,1
"2388","3679新至陞","110/08/20","日盛-板橋",0,1,-1
"2389","3679新至陞","110/08/20","瑞士信貸",1,0,1
"2390","3679新至陞","110/08/20","美商高盛",0,1,-1
"2391","3679新至陞","110/08/20","第一金-澎湖",1,0,1
"2392","3679新至陞","110/08/20","第一金-台南",0,1,-1
"2393","3679新至陞","110/08/20","統一-松江",1,0,1
"2394","3679新至陞","110/08/20","台中銀-員林",0,1,-1
"2395","3679新至陞","110/08/20","元富-草屯",1,0,1
"2396","3679新至陞","110/08/20","北城證券",0,1,-1
"2397","3679新至陞","110/08/20","光和-溪湖",1,0,1
"2398","3679新至陞","110/08/20","國票-九鼎",0,1,-1
"2399","3679新至陞","110/08/20","兆豐-三重",1,0,1
"2400","3679新至陞","110/08/20","富邦-陽明",0,1,-1
"2401","2727王品","110/08/20","元大-台中中港",339,0,339
"2402","2727王品","110/08/20","兆豐-南京",0,980,-980
"2403","2727王品","110/08/20","台灣摩根士丹利",93,12,81
"2404","2727王品","110/08/20","港商麥格理",0,65,-65
"2405","2727王品","110/08/20","摩根大通",63,4,59
"2406","2727王品","110/08/20","玉山證券",2,25,-23
"2407","2727王品","110/08/20","瑞士信貸",62,7,55
"2408","2727王品","110/08/20","元大證券",2,22,-20
"2409","2727王品","110/08/20","國票-南港",50,0,50
"2410","2727王品","110/08/20","永豐金-桃盛",0,20,-20
"2411","2727王品","110/08/20","玉山-板橋",40,10,30
"2412","2727王品","110/08/20","元富-西松",0,18,-18
"2413","2727王品","110/08/20","美林",38,9,29
"2414","2727王品","110/08/20","美商高盛",5,17,-12
"2415","2727王品","110/08/20","國泰-敦南",23,2,21
"2416","2727王品","110/08/20","台新-中壢",0,11,-11
"2417","2727王品","110/08/20","富邦-台北",16,2,14
"2418","2727王品","110/08/20","富邦-桃園",0,11,-11
"2419","2727王品","110/08/20","凱基-科園",15,2,13
"2420","2727王品","110/08/20","永豐金-新竹",0,11,-11
"2421","2727王品","110/08/20","凱基-台北",68,56,12
"2422","2727王品","110/08/20","彰銀-台中",0,10,-10
"2423","2727王品","110/08/20","宏遠-高雄",11,0,11
"2424","2727王品","110/08/20","兆豐-新莊",0,10,-10
"2425","2727王品","110/08/20","日茂-埔里",11,0,11
"2426","2727王品","110/08/20","元大-學甲",0,10,-10
"2427","2727王品","110/08/20","港商野村",58,48,10
"2428","2727王品","110/08/20","群益金鼎-延平",0,9,-9
"2429","2727王品","110/08/20","群益金鼎-潭子",10,0,10
"2430","2727王品","110/08/20","永豐金-松山",2,10,-8
"2431","1570力肯","110/08/20","國票-北高雄",27,0,27
"2432","1570力肯","110/08/20","元大-大雅",8,58,-50
"2433","1570力肯","110/08/20","元大-鹿港",29,4,25
"2434","1570力肯","110/08/20","凱基-三峽",0,30,-30
"2435","1570力肯","110/08/20","摩根大通",27,5,22
"2436","1570力肯","110/08/20","元大-樹林",0,30,-30
"2437","1570力肯","110/08/20","富邦-花蓮",20,0,20
"2438","1570力肯","110/08/20","統一",0,28,-28
"2439","1570力肯","110/08/20","群益金鼎-高雄",18,0,18
"2440","1570力肯","110/08/20","國票-南科",0,13,-13
"2441","1570力肯","110/08/20","元大-草屯",13,0,13
"2442","1570力肯","110/08/20","元大-鑫永和",0,12,-12
"2443","1570力肯","110/08/20","元富-緯城",12,0,12
"2444","1570力肯","110/08/20","台新證券",0,11,-11
"2445","1570力肯","110/08/20","元富-世貿",10,0,10
"2446","1570力肯","110/08/20","群益金鼎-民權",0,10,-10
"2447","1570力肯","110/08/20","大慶-蘆洲",7,0,7
"2448","1570力肯","110/08/20","國票-台中",3,11,-8
"2449","1570力肯","110/08/20","(牛牛牛)亞-鑫豐",25,18,7
"2450","1570力肯","110/08/20","土銀-新竹",1,7,-6
"2451","1570力肯","110/08/20","國票-天祥",6,0,6
"2452","1570力肯","110/08/20","台灣摩根士丹利",0,6,-6
"2453","1570力肯","110/08/20","凱基-台北",7,1,6
"2454","1570力肯","110/08/20","國泰-敦南",1,7,-6
"2455","1570力肯","110/08/20","元富-城東",5,0,5
"2456","1570力肯","110/08/20","高橋-龍潭",0,5,-5
"2457","1570力肯","110/08/20","國票",5,0,5
"2458","1570力肯","110/08/20","玉山-高雄",0,5,-5
"2459","1570力肯","110/08/20","萬泰",5,0,5
"2460","1570力肯","110/08/20","永豐金-苓雅",0,5,-5
"2461","6180橘子","110/08/20","港商野村",272,0,272
"2462","6180橘子","110/08/20","元大-博愛",0,42,-42
"2463","6180橘子","110/08/20","美林",47,0,47
"2464","6180橘子","110/08/20","群益金鼎-永和",1,40,-39
"2465","6180橘子","110/08/20","兆豐-埔墘",10,0,10
"2466","6180橘子","110/08/20","台灣摩根士丹利",4,39,-35
"2467","6180橘子","110/08/20","元大-天母",9,0,9
"2468","6180橘子","110/08/20","摩根大通",11,46,-35
"2469","6180橘子","110/08/20","永豐金-桃園",10,1,9
"2470","6180橘子","110/08/20","新光-桃園",0,35,-35
"2471","6180橘子","110/08/20","凱基-大里",8,0,8
"2472","6180橘子","110/08/20","臺銀",2,34,-32
"2473","6180橘子","110/08/20","元大-草屯",7,0,7
"2474","6180橘子","110/08/20","國泰-館前",1,33,-32
"2475","6180橘子","110/08/20","日盛-雙和",5,0,5
"2476","6180橘子","110/08/20","新光",7,38,-31
"2477","6180橘子","110/08/20","第一金-高雄",5,0,5
"2478","6180橘子","110/08/20","宏遠-館前",0,21,-21
"2479","6180橘子","110/08/20","第一金-新竹",5,0,5
"2480","6180橘子","110/08/20","富邦-竹東",0,21,-21
"2481","6180橘子","110/08/20","群益金鼎-大興",5,0,5
"2482","6180橘子","110/08/20","日盛-景美",0,20,-20
"2483","6180橘子","110/08/20","群益金鼎-開元",5,0,5
"2484","6180橘子","110/08/20","第一金-新興",0,20,-20
"2485","6180橘子","110/08/20","元大-東泰",5,0,5
"2486","6180橘子","110/08/20","凱基-彰化",0,16,-16
"2487","6180橘子","110/08/20","元大-士林",5,0,5
"2488","6180橘子","110/08/20","新加坡商瑞銀",5,15,-10
"2489","6180橘子","110/08/20","元大-土城",5,0,5
"2490","6180橘子","110/08/20","國票-長城",0,10,-10
"2491","2390云辰","110/08/20","國票-安和",130,0,130
"2492","2390云辰","110/08/20","統一-新台中",0,200,-200
"2493","2390云辰","110/08/20","凱基-屏東",100,0,100
"2494","2390云辰","110/08/20","聯邦-敦化",0,68,-68
"2495","2390云辰","110/08/20","摩根大通",233,161,72
"2496","2390云辰","110/08/20","美林",62,127,-65
"2497","2390云辰","110/08/20","美商高盛",101,30,71
"2498","2390云辰","110/08/20","新加坡商瑞銀",0,61,-61
"2499","2390云辰","110/08/20","兆豐-高雄",78,11,67
"2500","2390云辰","110/08/20","統一-新營",26,71,-45
"2501","2390云辰","110/08/20","凱基-台北",257,199,58
"2502","2390云辰","110/08/20","國泰-敦南",114,153,-39
"2503","2390云辰","110/08/20","第一金-安和",62,8,54
"2504","2390云辰","110/08/20","華南永昌-朴子",2,41,-39
"2505","2390云辰","110/08/20","統一-城中",60,10,50
"2506","2390云辰","110/08/20","元大-土城學府",156,192,-36
"2507","2390云辰","110/08/20","富邦-宜蘭",52,4,48
"2508","2390云辰","110/08/20","元大-六合",17,53,-36
"2509","2390云辰","110/08/20","元大-鳳山",60,12,48
"2510","2390云辰","110/08/20","土銀-嘉義",0,35,-35
"2511","2390云辰","110/08/20","元大-板橋三民",50,2,48
"2512","2390云辰","110/08/20","大昌",5,36,-31
"2513","2390云辰","110/08/20","國票-博愛",178,141,37
"2514","2390云辰","110/08/20","宏遠-台南",0,27,-27
"2515","2390云辰","110/08/20","華南永昌-岡山",33,1,32
"2516","2390云辰","110/08/20","群益金鼎-民權",6,31,-25
"2517","2390云辰","110/08/20","元大-北三重",32,1,31
"2518","2390云辰","110/08/20","國泰-館前",28,52,-24
"2519","2390云辰","110/08/20","第一金-豐原",30,0,30
"2520","2390云辰","110/08/20","富邦-建國",13,36,-23
"2521","2609陽明","110/08/19","美商高盛",2352,641,1711
"2522","2609陽明","110/08/19","凱基-台北",2247,12187,-9940
"2523","2609陽明","110/08/19","華南永昌-竹北",1335,536,799
"2524","2609陽明","110/08/19","康和",1685,8746,-7061
"2525","2609陽明","110/08/19","國泰-敦南",5999,5202,797
"2526","2609陽明","110/08/19","富邦證券",159,6808,-6649
"2527","2609陽明","110/08/19","日盛-雙和",967,217,750
"2528","2609陽明","110/08/19","台灣摩根士丹利",66,2608,-2542
"2529","2609陽明","110/08/19","國泰-館前",1665,1071,594
"2530","2609陽明","110/08/19","兆豐-南京",144,2129,-1985
"2531","2609陽明","110/08/19","台新證券",3672,3095,577
"2532","2609陽明","110/08/19","兆豐-虎尾",7267,9058,-1791
"2533","2609陽明","110/08/19","統一-三重",826,296,530
"2534","2609陽明","110/08/19","美林",2631,4379,-1748
"2535","2609陽明","110/08/19","玉山證券",1424,939,485
"2536","2609陽明","110/08/19","永豐金-信義",140,1816,-1676
"2537","2609陽明","110/08/19","富邦-建國",1115,663,452
"2538","2609陽明","110/08/19","富邦-仁愛",873,2277,-1404
"2539","2609陽明","110/08/19","統一-士林",809,391,418
"2540","2609陽明","110/08/19","摩根大通",4652,6019,-1367
"2541","2609陽明","110/08/19","凱基-城中",614,199,415
"2542","2609陽明","110/08/19","凱基-斗六",3347,4638,-1291
"2543","2609陽明","110/08/19","華南永昌-台中",863,449,414
"2544","2609陽明","110/08/19","富邦-虎尾",11651,12857,-1206
"2545","2609陽明","110/08/19","新光-新竹",1263,857,406
"2546","2609陽明","110/08/19","元大證券",2875,3808,-933
"2547","2609陽明","110/08/19","國泰-台中",1878,1503,375
"2548","2609陽明","110/08/19","統一-仁愛",1484,2392,-908
"2549","2609陽明","110/08/19","玉山-左營",623,251,372
"2550","2609陽明","110/08/19","元大-頭份",315,1194,-879
"2551","2636台驊投控","110/08/19","華南永昌-竹北",257,10,247
"2552","2636台驊投控","110/08/19","富邦證券",8,1056,-1048
"2553","2636台驊投控","110/08/19","國泰-敦南",483,306,177
"2554","2636台驊投控","110/08/19","摩根大通",329,1288,-959
"2555","2636台驊投控","110/08/19","新光-新竹",174,42,132
"2556","2636台驊投控","110/08/19","台灣摩根士丹利",168,753,-585
"2557","2636台驊投控","110/08/19","港商野村",2255,2136,119
"2558","2636台驊投控","110/08/19","凱基-台北",574,996,-422
"2559","2636台驊投控","110/08/19","台新證券",257,150,107
"2560","2636台驊投控","110/08/19","瑞士信貸",75,421,-346
"2561","2636台驊投控","110/08/19","新光",389,312,77
"2562","2636台驊投控","110/08/19","統一",98,420,-322
"2563","2636台驊投控","110/08/19","華南永昌-楠梓",98,27,71
"2564","2636台驊投控","110/08/19","凱基",21,323,-302
"2565","2636台驊投控","110/08/19","華南永昌-南京",104,40,64
"2566","2636台驊投控","110/08/19","富邦-員林",377,670,-293
"2567","2636台驊投控","110/08/19","富邦-苗栗",99,35,64
"2568","2636台驊投控","110/08/19","日盛-台中",26,244,-218
"2569","2636台驊投控","110/08/19","元大-竹北",79,16,63
"2570","2636台驊投控","110/08/19","美商高盛",87,244,-157
"2571","2636台驊投控","110/08/19","凱基-市政",265,203,62
"2572","2636台驊投控","110/08/19","日盛-板橋",40,163,-123
"2573","2636台驊投控","110/08/19","中國信託-文心",80,21,59
"2574","2636台驊投控","110/08/19","大慶",2,120,-118
"2575","2636台驊投控","110/08/19","大昌-安康",60,4,56
"2576","2636台驊投控","110/08/19","日盛-大墩",73,184,-111
"2577","2636台驊投控","110/08/19","日盛-宜蘭",53,0,53
"2578","2636台驊投控","110/08/19","宏遠證券",60,152,-92
"2579","2636台驊投控","110/08/19","元富-大昌",81,28,53
"2580","2636台驊投控","110/08/19","新加坡商瑞銀",88,173,-85
"2581","2867三商壽","110/08/19","美林",389,60,329
"2582","2867三商壽","110/08/19","宏遠證券",0,969,-969
"2583","2867三商壽","110/08/19","元大-土城永寧",252,2,250
"2584","2867三商壽","110/08/19","摩根大通",111,691,-580
"2585","2867三商壽","110/08/19","玉山-板橋",127,0,127
"2586","2867三商壽","110/08/19","土銀-建國",0,240,-240
"2587","2867三商壽","110/08/19","元大-大里德芳",110,0,110
"2588","2867三商壽","110/08/19","日盛-中壢",0,122,-122
"2589","2867三商壽","110/08/19","國泰-台中",103,1,102
"2590","2867三商壽","110/08/19","台新-高雄",4,121,-117
"2591","2867三商壽","110/08/19","新加坡商瑞銀",114,19,95
"2592","2867三商壽","110/08/19","德信-中正",0,100,-100
"2593","2867三商壽","110/08/19","玉山-城中",86,0,86
"2594","2867三商壽","110/08/19","華南永昌-南京",0,100,-100
"2595","2867三商壽","110/08/19","合庫-西台中",80,0,80
"2596","2867三商壽","110/08/19","台新證券",15,101,-86
"2597","2867三商壽","110/08/19","永豐金-竹科",80,1,79
"2598","2867三商壽","110/08/19","凱基-台北",42,118,-76
"2599","2867三商壽","110/08/19","玉山-台中",61,0,61
"2600","2867三商壽","110/08/19","富邦-建國",1,71,-70
"2601","2867三商壽","110/08/19","土銀-台中",60,0,60
"2602","2867三商壽","110/08/19","元大-八德",0,70,-70
"2603","2867三商壽","110/08/19","富邦-台南",60,0,60
"2604","2867三商壽","110/08/19","凱基",0,68,-68
"2605","2867三商壽","110/08/19","元大-中壢",56,0,56
"2606","2867三商壽","110/08/19","富邦-三重",0,55,-55
"2607","2867三商壽","110/08/19","群益金鼎-彰化",62,8,54
"2608","2867三商壽","110/08/19","元大-彰化民生",0,50,-50
"2609","2867三商壽","110/08/19","永豐金-埔里",67,13,54
"2610","2867三商壽","110/08/19","亞東",0,45,-45
"2611","5521工信","110/08/19","元大證券",232,28,204
"2612","5521工信","110/08/19","凱基-台北",0,178,-178
"2613","5521工信","110/08/19","中國信託-三重",70,0,70
"2614","5521工信","110/08/19","福勝",0,80,-80
"2615","5521工信","110/08/19","台新證券",37,0,37
"2616","5521工信","110/08/19","新光-新竹",1,80,-79
"2617","5521工信","110/08/19","日盛-高雄",27,0,27
"2618","5521工信","110/08/19","港商法國興業",0,67,-67
"2619","5521工信","110/08/19","元富-埔里",20,0,20
"2620","5521工信","110/08/19","摩根大通",194,256,-62
"2621","5521工信","110/08/19","玉山-雙和",20,0,20
"2622","5521工信","110/08/19","群益金鼎-敦南",0,50,-50
"2623","5521工信","110/08/19","富邦-台北",20,0,20
"2624","5521工信","110/08/19","第一金-桃園",0,36,-36
"2625","5521工信","110/08/19","永豐金-竹科",19,0,19
"2626","5521工信","110/08/19","德信-中正",0,29,-29
"2627","5521工信","110/08/19","臺銀-鳳山",18,0,18
"2628","5521工信","110/08/19","元大-基隆孝二",0,28,-28
"2629","5521工信","110/08/19","華南永昌-高雄",20,2,18
"2630","5521工信","110/08/19","美林",1,27,-26
"2631","5521工信","110/08/19","華南永昌-彰化",23,8,15
"2632","5521工信","110/08/19","兆豐-員林",0,25,-25
"2633","5521工信","110/08/19","元大-大天母",15,0,15
"2634","5521工信","110/08/19","群益金鼎-土城",0,20,-20
"2635","5521工信","110/08/19","富邦-宜蘭",14,0,14
"2636","5521工信","110/08/19","元富-宜蘭",0,18,-18
"2637","5521工信","110/08/19","台新-台中",12,0,12
"2638","5521工信","110/08/19","富邦-高雄",1,15,-14
"2639","5521工信","110/08/19","臺銀-高雄",11,0,11
"2640","5521工信","110/08/19","元大-歸仁",2,16,-14
"2641","1471首利","110/08/19","新光",35,0,35
"2642","1471首利","110/08/19","摩根大通",42,206,-164
"2643","1471首利","110/08/19","新光-台南",24,0,24
"2644","1471首利","110/08/19","瑞士信貸",1,39,-38
"2645","1471首利","110/08/19","元大-太平",20,2,18
"2646","1471首利","110/08/19","凱基-五股",0,23,-23
"2647","1471首利","110/08/19","土銀-花蓮",15,0,15
"2648","1471首利","110/08/19","凱基-台北",6,29,-23
"2649","1471首利","110/08/19","玉山-桃園",15,0,15
"2650","1471首利","110/08/19","元大-虎尾",7,27,-20
"2651","1471首利","110/08/19","元富-三重",13,0,13
"2652","1471首利","110/08/19","光和",9,24,-15
"2653","1471首利","110/08/19","台新證券",12,0,12
"2654","1471首利","110/08/19","致和-府前",0,15,-15
"2655","1471首利","110/08/19","元大-員林中山",11,0,11
"2656","1471首利","110/08/19","兆豐-員林",0,12,-12
"2657","1471首利","110/08/19","台灣企銀-屏東",10,0,10
"2658","1471首利","110/08/19","凱基-新店",0,12,-12
"2659","1471首利","110/08/19","兆豐-台中港",10,0,10
"2660","1471首利","110/08/19","美林",0,11,-11
"2661","1471首利","110/08/19","致和-崇德",10,0,10
"2662","1471首利","110/08/19","凱基-頭份",0,10,-10
"2663","1471首利","110/08/19","凱基-高美館",10,0,10
"2664","1471首利","110/08/19","華南永昌-台中",0,10,-10
"2665","1471首利","110/08/19","華南永昌-公誠",10,0,10
"2666","1471首利","110/08/19","元大-大甲",0,9,-9
"2667","1471首利","110/08/19","華南永昌-楠梓",10,0,10
"2668","1471首利","110/08/19","凱基-三重",3,10,-7
"2669","1471首利","110/08/19","富邦-南屯",10,0,10
"2670","1471首利","110/08/19","永豐金-新店",0,7,-7
"2671","2883開發金","110/08/19","香港上海匯豐",6827,846,5981
"2672","2883開發金","110/08/19","凱基-台北",1722,11079,-9357
"2673","2883開發金","110/08/19","中國信託-文心",4667,49,4618
"2674","2883開發金","110/08/19","花旗環球",1244,7162,-5918
"2675","2883開發金","110/08/19","新光",3917,1918,1999
"2676","2883開發金","110/08/19","國泰證券",51,3659,-3608
"2677","2883開發金","110/08/19","凱基",1952,0,1952
"2678","2883開發金","110/08/19","台新證券",1038,4320,-3282
"2679","2883開發金","110/08/19","玉山證券",2183,465,1718
"2680","2883開發金","110/08/19","兆豐證券",7,1979,-1972
"2681","2883開發金","110/08/19","元大-忠孝",1666,40,1626
"2682","2883開發金","110/08/19","統一",51,1553,-1502
"2683","2883開發金","110/08/19","國泰-敦南",2025,483,1542
"2684","2883開發金","110/08/19","日盛證券",70,1356,-1286
"2685","2883開發金","110/08/19","新加坡商瑞銀",5707,4366,1341
"2686","2883開發金","110/08/19","合庫-彰化",31,1273,-1242
"2687","2883開發金","110/08/19","瑞士信貸",1645,478,1167
"2688","2883開發金","110/08/19","元大證券",2109,3261,-1152
"2689","2883開發金","110/08/19","康和-仁愛",1143,1,1142
"2690","2883開發金","110/08/19","宏遠證券",11,1083,-1072
"2691","2883開發金","110/08/19","凱基-竹科",753,16,737
"2692","2883開發金","110/08/19","富邦-北港",134,1188,-1054
"2693","2883開發金","110/08/19","國泰-板橋",919,284,635
"2694","2883開發金","110/08/19","元大-福營",55,1070,-1015
"2695","2883開發金","110/08/19","新光-台南",757,132,625
"2696","2883開發金","110/08/19","台灣企銀-民雄",23,1022,-999
"2697","2883開發金","110/08/19","元大-萬華",559,62,497
"2698","2883開發金","110/08/19","永豐金-南京",131,1128,-997
"2699","2883開發金","110/08/19","元大-中壢",533,53,480
"2700","2883開發金","110/08/19","群益金鼎-大安",38,965,-927
"2701","6205詮欣","110/08/19","日盛-三重",23,0,23
"2702","6205詮欣","110/08/19","高橋-內壢",0,20,-20
"2703","6205詮欣","110/08/19","凱基-汐止",21,0,21
"2704","6205詮欣","110/08/19","摩根大通",1,12,-11
"2705","6205詮欣","110/08/19","日茂-埔里",10,0,10
"2706","6205詮欣","110/08/19","福邦證券",0,10,-10
"2707","6205詮欣","110/08/19","凱基-台北",3,0,3
"2708","6205詮欣","110/08/19","元富-安南",0,6,-6
"2709","6205詮欣","110/08/19","永豐金證券",3,0,3
"2710","6205詮欣","110/08/19","永興-大墩",0,4,-4
"2711","6205詮欣","110/08/19","元富-草屯",2,0,2
"2712","6205詮欣","110/08/19","元大-豐原",0,2,-2
"2713","6205詮欣","110/08/19","臺銀-臺中",1,0,1
"2714","6205詮欣","110/08/19","統一-中壢",0,2,-2
"2715","6205詮欣","110/08/19","兆豐-景美",1,0,1
"2716","6205詮欣","110/08/19","中國信託-文心",0,2,-2
"2717","6205詮欣","110/08/19","凱基-桃園",1,0,1
"2718","6205詮欣","110/08/19","大慶-台南",0,1,-1
"2719","6205詮欣","110/08/19","凱基-復興",1,0,1
"2720","6205詮欣","110/08/19","元大-南投",0,1,-1
"2721","6205詮欣","110/08/19","華南永昌-台南",1,0,1
"2722","6205詮欣","110/08/19","華南永昌-虎尾",0,1,-1
"2723","6205詮欣","110/08/19","華南永昌-新莊",0,0,0
"2724","6205詮欣","110/08/19","凱基-和平",0,1,-1
"2725","6205詮欣","110/08/19","元大-大里",0,0,0
"2726","6205詮欣","110/08/19","豐農",0,1,-1
"2727","6205詮欣","110/08/19","永豐金-中和",1,1,0
"2728","6205詮欣","110/08/19","元富-文心",0,1,-1
"2729","6205詮欣","110/08/19","",NA,NA,NA
"2730","6205詮欣","110/08/19","美商高盛",0,1,-1
"2731","1540喬福","110/08/19","日盛-台南",20,0,20
"2732","1540喬福","110/08/19","兆豐-小港",0,30,-30
"2733","1540喬福","110/08/19","元大-板橋三民",11,0,11
"2734","1540喬福","110/08/19","富邦-台南",0,10,-10
"2735","1540喬福","110/08/19","富邦-陽明",10,0,10
"2736","1540喬福","110/08/19","元富-桃園",0,9,-9
"2737","1540喬福","110/08/19","富邦-南屯",10,0,10
"2738","1540喬福","110/08/19","元大-龍潭",0,9,-9
"2739","1540喬福","110/08/19","元大-桃興",10,0,10
"2740","1540喬福","110/08/19","元大-雙和",0,6,-6
"2741","1540喬福","110/08/19","元大-成功",10,0,10
"2742","1540喬福","110/08/19","元大-台南",0,5,-5
"2743","1540喬福","110/08/19","(牛牛牛)亞-網路",7,0,7
"2744","1540喬福","110/08/19","台中銀",0,4,-4
"2745","1540喬福","110/08/19","凱基-中壢",3,0,3
"2746","1540喬福","110/08/19","港商法國興業",0,3,-3
"2747","1540喬福","110/08/19","臺銀-新竹",2,0,2
"2748","1540喬福","110/08/19","富邦-員林",0,3,-3
"2749","1540喬福","110/08/19","國票-南崁",2,0,2
"2750","1540喬福","110/08/19","元富",0,2,-2
"2751","1540喬福","110/08/19","摩根大通",5,3,2
"2752","1540喬福","110/08/19","康和-板橋",0,2,-2
"2753","1540喬福","110/08/19","華南永昌-高雄",2,0,2
"2754","1540喬福","110/08/19","玉山-城中",0,2,-2
"2755","1540喬福","110/08/19","台中銀-豐原",1,0,1
"2756","1540喬福","110/08/19","元大-南崁",0,2,-2
"2757","1540喬福","110/08/19","國票-桃園",1,0,1
"2758","1540喬福","110/08/19","元大-敦南",0,2,-2
"2759","1540喬福","110/08/19","玉山-新竹",1,0,1
"2760","1540喬福","110/08/19","國票-台中",0,1,-1
"2761","2888新光金","110/08/19","兆豐-公益",5003,799,4204
"2762","2888新光金","110/08/19","摩根大通",1356,4583,-3227
"2763","2888新光金","110/08/19","凱基-台北",4068,1621,2447
"2764","2888新光金","110/08/19","凱基",0,3218,-3218
"2765","2888新光金","110/08/19","福邦-新竹",982,0,982
"2766","2888新光金","110/08/19","瑞士信貸",1,3126,-3125
"2767","2888新光金","110/08/19","美商高盛",1215,342,873
"2768","2888新光金","110/08/19","大昌-新竹",2,1424,-1422
"2769","2888新光金","110/08/19","統一-板橋",650,15,635
"2770","2888新光金","110/08/19","元富-虎尾",4,1276,-1272
"2771","2888新光金","110/08/19","凱基-中山",634,3,631
"2772","2888新光金","110/08/19","玉山-台南",134,1204,-1070
"2773","2888新光金","110/08/19","永豐金-鳳山",569,12,557
"2774","2888新光金","110/08/19","宏遠-光隆",25,1050,-1025
"2775","2888新光金","110/08/19","新光",855,323,532
"2776","2888新光金","110/08/19","玉山-板橋",106,841,-735
"2777","2888新光金","110/08/19","統一-台中",558,30,528
"2778","2888新光金","110/08/19","香港上海匯豐",0,728,-728
"2779","2888新光金","110/08/19","凱基-鳳山",525,0,525
"2780","2888新光金","110/08/19","台灣摩根士丹利",940,1609,-669
"2781","2888新光金","110/08/19","統一",577,100,477
"2782","2888新光金","110/08/19","中國信託",15,637,-622
"2783","2888新光金","110/08/19","元大證券",1048,635,413
"2784","2888新光金","110/08/19","元大-永和",20,600,-580
"2785","2888新光金","110/08/19","美林",1075,740,335
"2786","2888新光金","110/08/19","福勝",67,600,-533
"2787","2888新光金","110/08/19","元大-嘉義",315,10,305
"2788","2888新光金","110/08/19","凱基-中港",71,580,-509
"2789","2888新光金","110/08/19","元大-大統",304,13,291
"2790","2888新光金","110/08/19","群益金鼎",50,520,-470
"2791","1340勝悅","110/08/19","國泰-台南",99,3,96
"2792","1340勝悅","110/08/19","元大-成功",0,204,-204
"2793","1340勝悅","110/08/19","台中銀",38,0,38
"2794","1340勝悅","110/08/19","摩根大通",0,20,-20
"2795","1340勝悅","110/08/19","國泰-板橋",13,0,13
"2796","1340勝悅","110/08/19","瑞士信貸",0,12,-12
"2797","1340勝悅","110/08/19","臺銀-金山",10,0,10
"2798","1340勝悅","110/08/19","國票-敦北法人",0,12,-12
"2799","1340勝悅","110/08/19","元富-中港",10,0,10
"2800","1340勝悅","110/08/19","華南永昌-東昇",0,12,-12
"2801","1340勝悅","110/08/19","國泰-敦南",13,3,10
"2802","1340勝悅","110/08/19","永豐金-台南",0,12,-12
"2803","1340勝悅","110/08/19","元富-新店",10,2,8
"2804","1340勝悅","110/08/19","合庫-自強",0,11,-11
"2805","1340勝悅","110/08/19","合庫-新竹",7,0,7
"2806","1340勝悅","110/08/19","富邦-台中",0,5,-5
"2807","1340勝悅","110/08/19","群益金鼎-館前",10,3,7
"2808","1340勝悅","110/08/19","港商法國興業",0,4,-4
"2809","1340勝悅","110/08/19","致和-東門",6,0,6
"2810","1340勝悅","110/08/19","致和-金華",0,4,-4
"2811","1340勝悅","110/08/19","元大-屏南",6,0,6
"2812","1340勝悅","110/08/19","新光-台南",0,4,-4
"2813","1340勝悅","110/08/19","臺灣企銀-埔墘",5,0,5
"2814","1340勝悅","110/08/19","凱基-台北",1,5,-4
"2815","1340勝悅","110/08/19","日盛-和美",5,0,5
"2816","1340勝悅","110/08/19","土銀-南港",0,2,-2
"2817","1340勝悅","110/08/19","第一金-新竹",5,0,5
"2818","1340勝悅","110/08/19","元富-世貿",0,2,-2
"2819","1340勝悅","110/08/19","新光-桃園",5,0,5
"2820","1340勝悅","110/08/19","元大-信義",0,2,-2
"2821","6246臺龍","110/08/19","新光-台中",18,1,17
"2822","6246臺龍","110/08/19","日盛-和美",0,10,-10
"2823","6246臺龍","110/08/19","台灣企銀-台南",10,0,10
"2824","6246臺龍","110/08/19","元大-基隆孝二",0,9,-9
"2825","6246臺龍","110/08/19","凱基-台北",8,2,6
"2826","6246臺龍","110/08/19","港商野村",0,6,-6
"2827","6246臺龍","110/08/19","華南永昌-彰化",5,0,5
"2828","6246臺龍","110/08/19","臺銀-高雄",0,5,-5
"2829","6246臺龍","110/08/19","元大-南投",5,0,5
"2830","6246臺龍","110/08/19","兆豐-公益",0,5,-5
"2831","6246臺龍","110/08/19","元大-林園",5,0,5
"2832","6246臺龍","110/08/19","永豐金-三重",0,5,-5
"2833","6246臺龍","110/08/19","日盛-斗六",4,0,4
"2834","6246臺龍","110/08/19","中國信託",0,4,-4
"2835","6246臺龍","110/08/19","兆豐-新營",4,0,4
"2836","6246臺龍","110/08/19","元大-北成功",0,4,-4
"2837","6246臺龍","110/08/19","(牛牛牛)亞-鑫豐",3,0,3
"2838","6246臺龍","110/08/19","元大-台南",0,4,-4
"2839","6246臺龍","110/08/19","台新-台中",3,0,3
"2840","6246臺龍","110/08/19","元富-烏日",0,3,-3
"2841","6246臺龍","110/08/19","元大-大統",3,0,3
"2842","6246臺龍","110/08/19","玉山-城中",0,3,-3
"2843","6246臺龍","110/08/19","臺銀-民權",2,0,2
"2844","6246臺龍","110/08/19","元大-長庚",0,3,-3
"2845","6246臺龍","110/08/19","第一金-大稻埕",2,0,2
"2846","6246臺龍","110/08/19","元大-苑裡",0,3,-3
"2847","6246臺龍","110/08/19","元富-大昌",2,0,2
"2848","6246臺龍","110/08/19","永豐金-屏東",0,3,-3
"2849","6246臺龍","110/08/19","國票-敦北法人",2,0,2
"2850","6246臺龍","110/08/19","統一-永和",0,2,-2
"2851","00715L期街口布蘭特正2","110/08/19","台新證券",1458,205,1253
"2852","00715L期街口布蘭特正2","110/08/19","元大證券",4224,11178,-6954
"2853","00715L期街口布蘭特正2","110/08/19","富邦-南屯",1119,14,1105
"2854","00715L期街口布蘭特正2","110/08/19","合庫證券",266,2599,-2333
"2855","00715L期街口布蘭特正2","110/08/19","元大-永康",1118,19,1099
"2856","00715L期街口布蘭特正2","110/08/19","永豐金證券",8,2207,-2199
"2857","00715L期街口布蘭特正2","110/08/19","豐農",1023,30,993
"2858","00715L期街口布蘭特正2","110/08/19","元大-屏東民生",14,2200,-2186
"2859","00715L期街口布蘭特正2","110/08/19","元大-復北",954,74,880
"2860","00715L期街口布蘭特正2","110/08/19","凱基-台北",245,1890,-1645
"2861","00715L期街口布蘭特正2","110/08/19","中國信託-新竹",840,0,840
"2862","00715L期街口布蘭特正2","110/08/19","國票-博愛",10,1405,-1395
"2863","00715L期街口布蘭特正2","110/08/19","富邦證券",2317,1629,688
"2864","00715L期街口布蘭特正2","110/08/19","元富",10,1165,-1155
"2865","00715L期街口布蘭特正2","110/08/19","第一金-台南",540,0,540
"2866","00715L期街口布蘭特正2","110/08/19","新光",791,1810,-1019
"2867","00715L期街口布蘭特正2","110/08/19","兆豐-台中港",523,30,493
"2868","00715L期街口布蘭特正2","110/08/19","統一",3,978,-975
"2869","00715L期街口布蘭特正2","110/08/19","兆豐-嘉義",465,110,355
"2870","00715L期街口布蘭特正2","110/08/19","華南永昌-長虹",82,830,-748
"2871","00715L期街口布蘭特正2","110/08/19","元大-大里德芳",323,0,323
"2872","00715L期街口布蘭特正2","110/08/19","群益金鼎-宜蘭",20,737,-717
"2873","00715L期街口布蘭特正2","110/08/19","富邦-基隆",336,20,316
"2874","00715L期街口布蘭特正2","110/08/19","亞東",21,512,-491
"2875","00715L期街口布蘭特正2","110/08/19","元大-草屯",434,124,310
"2876","00715L期街口布蘭特正2","110/08/19","永豐金-板盛",6,420,-414
"2877","00715L期街口布蘭特正2","110/08/19","國泰-敦南",552,280,272
"2878","00715L期街口布蘭特正2","110/08/19","第一金-自由",28,419,-391
"2879","00715L期街口布蘭特正2","110/08/19","永豐金-羅東",270,2,268
"2880","00715L期街口布蘭特正2","110/08/19","元大-高雄",128,502,-374
"2881","8941關中","110/08/19","宏遠-館前",2,0,2
"2882","8941關中","110/08/19","富邦-台中",0,6,-6
"2883","8941關中","110/08/19","元大-西門",2,0,2
"2884","8941關中","110/08/19","兆豐-台中",0,2,-2
"2885","8941關中","110/08/19","新光-台中",1,0,1
"2886","8941關中","110/08/19","元大-金華",1,2,-1
"2887","8941關中","110/08/19","玉山-桃園",1,0,1
"2888","8941關中","110/08/19","兆豐-南京",0,0,0
"2889","8941關中","110/08/19","國泰-忠孝",1,0,1
"2890","8941關中","110/08/19","富邦-仁愛",0,0,0
"2891","8941關中","110/08/19","元大-華山",1,0,1
"2892","8941關中","110/08/19","元大-大雅",0,0,0
"2893","8941關中","110/08/19","元大-桃興",1,0,1
"2894","8941關中","110/08/19","永豐金-敦北",0,0,0
"2895","8941關中","110/08/19","兆豐-南京",0,0,0
"2896","8941關中","110/08/19","永豐金-南投",0,0,0
"2897","8941關中","110/08/19","富邦-仁愛",0,0,0
"2898","8941關中","110/08/19","",NA,NA,NA
"2899","8941關中","110/08/19","元大-大雅",0,0,0
"2900","8941關中","110/08/19","",NA,NA,NA
"2901","8941關中","110/08/19","永豐金-敦北",0,0,0
"2902","8941關中","110/08/19","",NA,NA,NA
"2903","8941關中","110/08/19","永豐金-南投",0,0,0
"2904","8941關中","110/08/19","",NA,NA,NA
"2905","8941關中","110/08/19","",NA,NA,NA
"2906","8941關中","110/08/19","",NA,NA,NA
"2907","8941關中","110/08/19","",NA,NA,NA
"2908","8941關中","110/08/19","",NA,NA,NA
"2909","8941關中","110/08/19","",NA,NA,NA
"2910","8941關中","110/08/19","",NA,NA,NA
"2911","8936國統","110/08/19","宏遠-台南",211,0,211
"2912","8936國統","110/08/19","元大-高雄",0,40,-40
"2913","8936國統","110/08/19","康和-高雄",126,1,125
"2914","8936國統","110/08/19","永豐金-苓雅",0,38,-38
"2915","8936國統","110/08/19","凱基-台北",122,66,56
"2916","8936國統","110/08/19","美商高盛",6,38,-32
"2917","8936國統","110/08/19","美林",54,0,54
"2918","8936國統","110/08/19","港商野村",17,38,-21
"2919","8936國統","110/08/19","新加坡商瑞銀",46,20,26
"2920","8936國統","110/08/19","日盛-頭份",0,20,-20
"2921","8936國統","110/08/19","元富-緯城",25,0,25
"2922","8936國統","110/08/19","兆豐-三重",0,20,-20
"2923","8936國統","110/08/19","富邦-高雄",14,0,14
"2924","8936國統","110/08/19","玉山-桃園",0,20,-20
"2925","8936國統","110/08/19","日盛-復興",10,0,10
"2926","8936國統","110/08/19","國泰-高雄",4,22,-18
"2927","8936國統","110/08/19","宏遠-高雄",18,8,10
"2928","8936國統","110/08/19","台灣摩根士丹利",0,17,-17
"2929","8936國統","110/08/19","中國信託-高雄",20,12,8
"2930","8936國統","110/08/19","凱基-竹科",0,16,-16
"2931","8936國統","110/08/19","日盛-豐原",7,0,7
"2932","8936國統","110/08/19","元大-大里德芳",0,16,-16
"2933","8936國統","110/08/19","元富-三重",7,0,7
"2934","8936國統","110/08/19","大昌-樹林",0,15,-15
"2935","8936國統","110/08/19","台新-高雄",10,3,7
"2936","8936國統","110/08/19","台新-屏東",0,12,-12
"2937","8936國統","110/08/19","臺銀-高雄",6,0,6
"2938","8936國統","110/08/19","中農",0,11,-11
"2939","8936國統","110/08/19","第一金-路竹",6,0,6
"2940","8936國統","110/08/19","臺銀-新竹",0,10,-10
"2941","6226光鼎","110/08/19","富邦-左營",110,2,108
"2942","6226光鼎","110/08/19","凱基-台北",177,732,-555
"2943","6226光鼎","110/08/19","元大-北屯",151,50,101
"2944","6226光鼎","110/08/19","摩根大通",28,396,-368
"2945","6226光鼎","110/08/19","國泰-敦南",201,125,76
"2946","6226光鼎","110/08/19","台灣摩根士丹利",0,254,-254
"2947","6226光鼎","110/08/19","元大-敦化",56,4,52
"2948","6226光鼎","110/08/19","元大-文心興安",1,230,-229
"2949","6226光鼎","110/08/19","兆豐-中壢",50,1,49
"2950","6226光鼎","110/08/19","美商高盛",33,233,-200
"2951","6226光鼎","110/08/19","凱基-台中",44,2,42
"2952","6226光鼎","110/08/19","富邦-台北",22,202,-180
"2953","6226光鼎","110/08/19","新光",121,81,40
"2954","6226光鼎","110/08/19","美林",72,160,-88
"2955","6226光鼎","110/08/19","合庫-西台中",47,10,37
"2956","6226光鼎","110/08/19","新加坡商瑞銀",138,225,-87
"2957","6226光鼎","110/08/19","元大-龍潭",42,5,37
"2958","6226光鼎","110/08/19","元大-南勢角",0,70,-70
"2959","6226光鼎","110/08/19","兆豐-東門",36,0,36
"2960","6226光鼎","110/08/19","臺銀-高雄",0,67,-67
"2961","6226光鼎","110/08/19","新光-台中",83,48,35
"2962","6226光鼎","110/08/19","港商野村",178,231,-53
"2963","6226光鼎","110/08/19","玉山-桃園",39,4,35
"2964","6226光鼎","110/08/19","永豐金-內湖",6,56,-50
"2965","6226光鼎","110/08/19","元大-竹科",59,24,35
"2966","6226光鼎","110/08/19","高橋-內壢",5,54,-49
"2967","6226光鼎","110/08/19","第一金-台南",33,0,33
"2968","6226光鼎","110/08/19","凱基-員林",7,53,-46
"2969","6226光鼎","110/08/19","台新證券",66,33,33
"2970","6226光鼎","110/08/19","台新-台中",28,65,-37
"2971","2363矽統","110/08/19","日盛-樹林",300,12,288
"2972","2363矽統","110/08/19","凱基-台北",560,1671,-1111
"2973","2363矽統","110/08/19","永豐金-板盛",200,2,198
"2974","2363矽統","110/08/19","摩根大通",3,713,-710
"2975","2363矽統","110/08/19","凱基-三峽",134,18,116
"2976","2363矽統","110/08/19","台新-三民",50,291,-241
"2977","2363矽統","110/08/19","富邦-新竹",94,7,87
"2978","2363矽統","110/08/19","台灣摩根士丹利",0,206,-206
"2979","2363矽統","110/08/19","元大-汐止",75,8,67
"2980","2363矽統","110/08/19","凱基-和平",1,132,-131
"2981","2363矽統","110/08/19","元大-斗六",67,2,65
"2982","2363矽統","110/08/19","永豐金證券",12,125,-113
"2983","2363矽統","110/08/19","大慶-蘆洲",69,13,56
"2984","2363矽統","110/08/19","石橋證券",50,155,-105
"2985","2363矽統","110/08/19","永豐金-豐原",55,2,53
"2986","2363矽統","110/08/19","港商野村",838,925,-87
"2987","2363矽統","110/08/19","日盛-豐原",59,10,49
"2988","2363矽統","110/08/19","新光-桃園",4,87,-83
"2989","2363矽統","110/08/19","群益金鼎-中壢",54,7,47
"2990","2363矽統","110/08/19","新光",212,282,-70
"2991","2363矽統","110/08/19","元大-南投",58,12,46
"2992","2363矽統","110/08/19","陽信-石牌",18,83,-65
"2993","2363矽統","110/08/19","富邦-板橋",51,7,44
"2994","2363矽統","110/08/19","美林",31,91,-60
"2995","2363矽統","110/08/19","台新證券",117,74,43
"2996","2363矽統","110/08/19","永豐金-新店",1,59,-58
"2997","2363矽統","110/08/19","元大-東港",45,2,43
"2998","2363矽統","110/08/19","台新-左楠",19,76,-57
"2999","2363矽統","110/08/19","元大-旗山",47,5,42
"3000","2363矽統","110/08/19","永全-南崁",7,53,-46
"3001","8112至上","110/08/19","元大-敦化",60,0,60
"3002","8112至上","110/08/19","港商野村",22,279,-257
"3003","8112至上","110/08/19","玉山-城中",60,2,58
"3004","8112至上","110/08/19","瑞士信貸",0,239,-239
"3005","8112至上","110/08/19","永豐金-敦南",52,4,48
"3006","8112至上","110/08/19","凱基-台北",101,275,-174
"3007","8112至上","110/08/19","統一",41,0,41
"3008","8112至上","110/08/19","摩根大通",161,332,-171
"3009","8112至上","110/08/19","元大-竹東",36,0,36
"3010","8112至上","110/08/19","凱基-市政",0,80,-80
"3011","8112至上","110/08/19","凱基-嘉義",35,0,35
"3012","8112至上","110/08/19","台灣摩根士丹利",6,75,-69
"3013","8112至上","110/08/19","新光-台南",32,0,32
"3014","8112至上","110/08/19","美商高盛",18,76,-58
"3015","8112至上","110/08/19","永興-水湳",30,0,30
"3016","8112至上","110/08/19","新加坡商瑞銀",22,76,-54
"3017","8112至上","110/08/19","元大-永和",29,0,29
"3018","8112至上","110/08/19","美林",9,61,-52
"3019","8112至上","110/08/19","凱基-東勢",26,1,25
"3020","8112至上","110/08/19","富邦-花蓮",1,51,-50
"3021","8112至上","110/08/19","臺銀-臺南",28,4,24
"3022","8112至上","110/08/19","元大-路竹",8,52,-44
"3023","8112至上","110/08/19","富邦-中壢",29,5,24
"3024","8112至上","110/08/19","(牛牛牛)亞-鑫豐",34,77,-43
"3025","8112至上","110/08/19","第一金-桃園",24,1,23
"3026","8112至上","110/08/19","台新-中壢",2,42,-40
"3027","8112至上","110/08/19","國泰-敦南",27,4,23
"3028","8112至上","110/08/19","國泰證券",0,40,-40
"3029","8112至上","110/08/19","凱基-文心",23,0,23
"3030","8112至上","110/08/19","永豐金-苓雅",0,40,-40
"3031","1570力肯","110/08/19","國票-北高雄",37,0,37
"3032","1570力肯","110/08/19","新光-台南",3,44,-41
"3033","1570力肯","110/08/19","康和-台南",30,0,30
"3034","1570力肯","110/08/19","元大-大統",0,20,-20
"3035","1570力肯","110/08/19","國票-內壢",25,0,25
"3036","1570力肯","110/08/19","元富-新店",0,18,-18
"3037","1570力肯","110/08/19","元富-虎尾",20,0,20
"3038","1570力肯","110/08/19","元大-民生",2,19,-17
"3039","1570力肯","110/08/19","國票-博愛",17,0,17
"3040","1570力肯","110/08/19","國泰-敦南",1,16,-15
"3041","1570力肯","110/08/19","日盛-高雄",15,0,15
"3042","1570力肯","110/08/19","富邦-敦南",0,15,-15
"3043","1570力肯","110/08/19","元大-南投",15,0,15
"3044","1570力肯","110/08/19","元大-大雅",10,25,-15
"3045","1570力肯","110/08/19","富邦-嘉義",15,1,14
"3046","1570力肯","110/08/19","日盛-板橋",2,16,-14
"3047","1570力肯","110/08/19","元大-北投",13,0,13
"3048","1570力肯","110/08/19","華南永昌-嘉義",0,12,-12
"3049","1570力肯","110/08/19","元富-緯城",12,0,12
"3050","1570力肯","110/08/19","凱基-台北",3,14,-11
"3051","1570力肯","110/08/19","土銀-新竹",11,0,11
"3052","1570力肯","110/08/19","元富-草屯",0,10,-10
"3053","1570力肯","110/08/19","日盛-嘉義",11,0,11
"3054","1570力肯","110/08/19","新光",7,17,-10
"3055","1570力肯","110/08/19","富邦-羅東",11,0,11
"3056","1570力肯","110/08/19","富邦-內湖",3,13,-10
"3057","1570力肯","110/08/19","富邦-仁愛",10,0,10
"3058","1570力肯","110/08/19","元大-福營",0,10,-10
"3059","1570力肯","110/08/19","元大-羅東",10,0,10
"3060","1570力肯","110/08/19","元大-松山",0,10,-10
"3061","2929淘帝","110/08/19","元大-太平",54,0,54
"3062","2929淘帝","110/08/19","摩根大通",0,58,-58
"3063","2929淘帝","110/08/19","凱基-東門",32,0,32
"3064","2929淘帝","110/08/19","宏遠-館前",0,35,-35
"3065","2929淘帝","110/08/19","日盛-桃園",20,0,20
"3066","2929淘帝","110/08/19","元富-台南",0,32,-32
"3067","2929淘帝","110/08/19","富邦-高雄",16,0,16
"3068","2929淘帝","110/08/19","日茂",0,20,-20
"3069","2929淘帝","110/08/19","元大-員林",11,0,11
"3070","2929淘帝","110/08/19","美商高盛",0,11,-11
"3071","2929淘帝","110/08/19","凱基-中山",10,0,10
"3072","2929淘帝","110/08/19","凱基-站前",0,10,-10
"3073","2929淘帝","110/08/19","富邦-南屯",7,0,7
"3074","2929淘帝","110/08/19","統一-三重",0,8,-8
"3075","2929淘帝","110/08/19","日盛-雙和",6,0,6
"3076","2929淘帝","110/08/19","群益金鼎",0,7,-7
"3077","2929淘帝","110/08/19","亞東-新竹",6,0,6
"3078","2929淘帝","110/08/19","凱基-八德",0,7,-7
"3079","2929淘帝","110/08/19","兆豐-桃鶯",6,0,6
"3080","2929淘帝","110/08/19","港商野村",3,9,-6
"3081","2929淘帝","110/08/19","新光",6,0,6
"3082","2929淘帝","110/08/19","安泰",0,5,-5
"3083","2929淘帝","110/08/19","群益金鼎-三重",5,0,5
"3084","2929淘帝","110/08/19","元大-金門",0,5,-5
"3085","2929淘帝","110/08/19","元大-左營",5,0,5
"3086","2929淘帝","110/08/19","永豐金-竹科",0,5,-5
"3087","2929淘帝","110/08/19","台新-新莊",9,5,4
"3088","2929淘帝","110/08/19","致和證券",0,4,-4
"3089","2929淘帝","110/08/19","群益金鼎-新店",4,0,4
"3090","2929淘帝","110/08/19","元大-苑裡",0,4,-4
"3091","5410國眾","110/08/19","土銀-嘉義",14,0,14
"3092","5410國眾","110/08/19","致和-台北",0,60,-60
"3093","5410國眾","110/08/19","國票-北高雄",10,0,10
"3094","5410國眾","110/08/19","凱基-台北",1,20,-19
"3095","5410國眾","110/08/19","玉山-城中",10,0,10
"3096","5410國眾","110/08/19","新加坡商瑞銀",0,14,-14
"3097","5410國眾","110/08/19","元大-中壢",9,0,9
"3098","5410國眾","110/08/19","亞東-新竹",0,14,-14
"3099","5410國眾","110/08/19","台新證券",8,0,8
"3100","5410國眾","110/08/19","富邦-永和",0,7,-7
"3101","5410國眾","110/08/19","新光",7,1,6
"3102","5410國眾","110/08/19","摩根大通",0,5,-5
"3103","5410國眾","110/08/19","日盛-八德",5,0,5
"3104","5410國眾","110/08/19","元大-南勢角",0,3,-3
"3105","5410國眾","110/08/19","元大-旗山",5,0,5
"3106","5410國眾","110/08/19","元大-板橋三民",0,3,-3
"3107","5410國眾","110/08/19","元大-博愛",5,0,5
"3108","5410國眾","110/08/19","元富-大昌",0,2,-2
"3109","5410國眾","110/08/19","元大-左營",5,0,5
"3110","5410國眾","110/08/19","台中銀-員林",0,2,-2
"3111","5410國眾","110/08/19","臺銀-金山",6,2,4
"3112","5410國眾","110/08/19","台新-左楠",0,2,-2
"3113","5410國眾","110/08/19","統一-台中",4,0,4
"3114","5410國眾","110/08/19","群益金鼎-東門",0,2,-2
"3115","5410國眾","110/08/19","元大-開元",4,0,4
"3116","5410國眾","110/08/19","凱基-汐止",0,2,-2
"3117","5410國眾","110/08/19","日盛-園區",3,0,3
"3118","5410國眾","110/08/19","華南永昌-小港",0,2,-2
"3119","5410國眾","110/08/19","國泰-敦南",3,0,3
"3120","5410國眾","110/08/19","富邦-新店",0,2,-2
"3121","2841台開","110/08/19","宏遠-館前",360,0,360
"3122","2841台開","110/08/19","元大證券",0,108,-108
"3123","2841台開","110/08/19","第一金",104,0,104
"3124","2841台開","110/08/19","國票-敦北法人",0,98,-98
"3125","2841台開","110/08/19","日盛-台中",35,1,34
"3126","2841台開","110/08/19","台中銀",0,93,-93
"3127","2841台開","110/08/19","合庫證券",20,0,20
"3128","2841台開","110/08/19","元大-府城",0,51,-51
"3129","2841台開","110/08/19","第一金-台中",20,0,20
"3130","2841台開","110/08/19","日盛-信義",0,50,-50
"3131","2841台開","110/08/19","富邦-基隆",20,0,20
"3132","2841台開","110/08/19","新光-台南",0,46,-46
"3133","2841台開","110/08/19","富邦-三重",20,0,20
"3134","2841台開","110/08/19","永豐金-桃園",0,41,-41
"3135","2841台開","110/08/19","元大-六合",17,0,17
"3136","2841台開","110/08/19","凱基-高美館",0,30,-30
"3137","2841台開","110/08/19","國泰-館前",11,0,11
"3138","2841台開","110/08/19","凱基-新豐",0,30,-30
"3139","2841台開","110/08/19","統一-新台中",10,0,10
"3140","2841台開","110/08/19","第一金-忠孝",0,20,-20
"3141","2841台開","110/08/19","玉山證券",10,0,10
"3142","2841台開","110/08/19","富邦-員林",0,20,-20
"3143","2841台開","110/08/19","國泰-台中",10,0,10
"3144","2841台開","110/08/19","日盛證券",22,38,-16
"3145","2841台開","110/08/19","國泰-忠孝",10,0,10
"3146","2841台開","110/08/19","國泰-敦南",3,19,-16
"3147","2841台開","110/08/19","元大-東泰",10,0,10
"3148","2841台開","110/08/19","中國信託-嘉義",0,15,-15
"3149","2841台開","110/08/19","元大-高雄",10,0,10
"3150","2841台開","110/08/19","永豐金-敦南",17,29,-12
"3151","6207雷科","110/08/19","元大-高雄",76,0,76
"3152","6207雷科","110/08/19","凱基-大安",0,50,-50
"3153","6207雷科","110/08/19","光和-和美",53,0,53
"3154","6207雷科","110/08/19","凱基-復興",2,30,-28
"3155","6207雷科","110/08/19","日盛-桃園",10,0,10
"3156","6207雷科","110/08/19","日盛-三重",0,23,-23
"3157","6207雷科","110/08/19","元大-六合",10,0,10
"3158","6207雷科","110/08/19","港商野村",8,30,-22
"3159","6207雷科","110/08/19","凱基-台北",21,13,8
"3160","6207雷科","110/08/19","新加坡商瑞銀",12,29,-17
"3161","6207雷科","110/08/19","永豐金-高雄",8,0,8
"3162","6207雷科","110/08/19","日茂-埔里",0,17,-17
"3163","6207雷科","110/08/19","凱基-高雄",7,0,7
"3164","6207雷科","110/08/19","摩根大通",7,21,-14
"3165","6207雷科","110/08/19","元大-沙鹿",6,0,6
"3166","6207雷科","110/08/19","群益金鼎-東門",0,12,-12
"3167","6207雷科","110/08/19","元大-東門",6,0,6
"3168","6207雷科","110/08/19","富邦-虎尾",0,10,-10
"3169","6207雷科","110/08/19","元富-吉利",5,0,5
"3170","6207雷科","110/08/19","凱基-高美館",5,14,-9
"3171","6207雷科","110/08/19","大昌-桃園",5,0,5
"3172","6207雷科","110/08/19","富邦-板橋",0,8,-8
"3173","6207雷科","110/08/19","玉山-大里",5,0,5
"3174","6207雷科","110/08/19","元富-潮州",0,7,-7
"3175","6207雷科","110/08/19","元大-大益",5,0,5
"3176","6207雷科","110/08/19","凱基-員林",0,7,-7
"3177","6207雷科","110/08/19","元大-福營",4,0,4
"3178","6207雷科","110/08/19","華南永昌-林口",0,7,-7
"3179","6207雷科","110/08/19","臺銀-臺中",3,0,3
"3180","6207雷科","110/08/19","日盛-八德",0,6,-6
"3181","3679新至陞","110/08/19","台灣摩根士丹利",7,0,7
"3182","3679新至陞","110/08/19","摩根大通",3,11,-8
"3183","3679新至陞","110/08/19","元大-板橋",6,0,6
"3184","3679新至陞","110/08/19","瑞士信貸",1,6,-5
"3185","3679新至陞","110/08/19","美林",10,5,5
"3186","3679新至陞","110/08/19","美商高盛",0,3,-3
"3187","3679新至陞","110/08/19","日盛-土城",2,0,2
"3188","3679新至陞","110/08/19","宏遠-館前",0,2,-2
"3189","3679新至陞","110/08/19","富邦-新店",2,0,2
"3190","3679新至陞","110/08/19","港商野村",0,2,-2
"3191","3679新至陞","110/08/19","土銀-新竹",1,0,1
"3192","3679新至陞","110/08/19","花旗環球",0,2,-2
"3193","3679新至陞","110/08/19","臺銀-高雄",1,0,1
"3194","3679新至陞","110/08/19","國泰-高雄",0,2,-2
"3195","3679新至陞","110/08/19","(牛牛牛)亞-網路",1,0,1
"3196","3679新至陞","110/08/19","元大證券",1,3,-2
"3197","3679新至陞","110/08/19","中國信託-永康",1,0,1
"3198","3679新至陞","110/08/19","元大-新店中正",0,2,-2
"3199","3679新至陞","110/08/19","光和-溪湖",1,0,1
"3200","3679新至陞","110/08/19","元大-成功",0,2,-2
"3201","3679新至陞","110/08/19","兆豐證券",1,0,1
"3202","3679新至陞","110/08/19","永豐金-板新",0,2,-2
"3203","3679新至陞","110/08/19","國票-台東",1,0,1
"3204","3679新至陞","110/08/19","土銀-和平",0,1,-1
"3205","3679新至陞","110/08/19","玉山-新莊",1,0,1
"3206","3679新至陞","110/08/19","新加坡商瑞銀",0,1,-1
"3207","3679新至陞","110/08/19","玉山-嘉義",1,0,1
"3208","3679新至陞","110/08/19","第一金-忠孝",0,1,-1
"3209","3679新至陞","110/08/19","群益金鼎-高盛",1,0,1
"3210","3679新至陞","110/08/19","凱基",0,1,-1
"3211","2727王品","110/08/19","日盛-忠孝",36,0,36
"3212","2727王品","110/08/19","宏遠證券",0,75,-75
"3213","2727王品","110/08/19","中國信託-高雄",12,0,12
"3214","2727王品","110/08/19","美林",0,49,-49
"3215","2727王品","110/08/19","國泰-敦南",17,6,11
"3216","2727王品","110/08/19","摩根大通",1,47,-46
"3217","2727王品","110/08/19","群益金鼎-新店",10,0,10
"3218","2727王品","110/08/19","永豐金證券",2,45,-43
"3219","2727王品","110/08/19","富邦-羅東",10,0,10
"3220","2727王品","110/08/19","美商高盛",2,39,-37
"3221","2727王品","110/08/19","富邦-仁愛",9,0,9
"3222","2727王品","110/08/19","凱基-台北",27,56,-29
"3223","2727王品","110/08/19","國泰-台中",14,6,8
"3224","2727王品","110/08/19","新光-台中",5,28,-23
"3225","2727王品","110/08/19","元大-北屯",10,2,8
"3226","2727王品","110/08/19","台灣摩根士丹利",1,21,-20
"3227","2727王品","110/08/19","元富-大昌",7,0,7
"3228","2727王品","110/08/19","凱基-東門",0,18,-18
"3229","2727王品","110/08/19","台新-台中",9,2,7
"3230","2727王品","110/08/19","統一",0,17,-17
"3231","2727王品","110/08/19","新光-新竹",7,0,7
"3232","2727王品","110/08/19","瑞士信貸",2,13,-11
"3233","2727王品","110/08/19","凱基-基隆",7,0,7
"3234","2727王品","110/08/19","新加坡商瑞銀",0,11,-11
"3235","2727王品","110/08/19","宏遠-高雄",6,0,6
"3236","2727王品","110/08/19","港商野村",18,28,-10
"3237","2727王品","110/08/19","台新證券",6,0,6
"3238","2727王品","110/08/19","富邦-新店",1,11,-10
"3239","2727王品","110/08/19","玉山證券",6,0,6
"3240","2727王品","110/08/19","元大-善化",0,10,-10
"3241","1570力肯","110/08/19","國票-北高雄",37,0,37
"3242","1570力肯","110/08/19","新光-台南",3,44,-41
"3243","1570力肯","110/08/19","康和-台南",30,0,30
"3244","1570力肯","110/08/19","元大-大統",0,20,-20
"3245","1570力肯","110/08/19","國票-內壢",25,0,25
"3246","1570力肯","110/08/19","元富-新店",0,18,-18
"3247","1570力肯","110/08/19","元富-虎尾",20,0,20
"3248","1570力肯","110/08/19","元大-民生",2,19,-17
"3249","1570力肯","110/08/19","國票-博愛",17,0,17
"3250","1570力肯","110/08/19","國泰-敦南",1,16,-15
"3251","1570力肯","110/08/19","日盛-高雄",15,0,15
"3252","1570力肯","110/08/19","富邦-敦南",0,15,-15
"3253","1570力肯","110/08/19","元大-南投",15,0,15
"3254","1570力肯","110/08/19","元大-大雅",10,25,-15
"3255","1570力肯","110/08/19","富邦-嘉義",15,1,14
"3256","1570力肯","110/08/19","日盛-板橋",2,16,-14
"3257","1570力肯","110/08/19","元大-北投",13,0,13
"3258","1570力肯","110/08/19","華南永昌-嘉義",0,12,-12
"3259","1570力肯","110/08/19","元富-緯城",12,0,12
"3260","1570力肯","110/08/19","凱基-台北",3,14,-11
"3261","1570力肯","110/08/19","土銀-新竹",11,0,11
"3262","1570力肯","110/08/19","元富-草屯",0,10,-10
"3263","1570力肯","110/08/19","日盛-嘉義",11,0,11
"3264","1570力肯","110/08/19","新光",7,17,-10
"3265","1570力肯","110/08/19","富邦-羅東",11,0,11
"3266","1570力肯","110/08/19","富邦-內湖",3,13,-10
"3267","1570力肯","110/08/19","富邦-仁愛",10,0,10
"3268","1570力肯","110/08/19","元大-福營",0,10,-10
"3269","1570力肯","110/08/19","元大-羅東",10,0,10
"3270","1570力肯","110/08/19","元大-松山",0,10,-10
"3271","6180橘子","110/08/19","美林",29,0,29
"3272","6180橘子","110/08/19","新光-台中",4,23,-19
"3273","6180橘子","110/08/19","美商高盛",24,0,24
"3274","6180橘子","110/08/19","元大-大甲",0,16,-16
"3275","6180橘子","110/08/19","富邦-竹東",21,0,21
"3276","6180橘子","110/08/19","元富-城東",1,13,-12
"3277","6180橘子","110/08/19","第一金-新竹",20,0,20
"3278","6180橘子","110/08/19","凱基-台北",2,13,-11
"3279","6180橘子","110/08/19","富邦-永和",11,0,11
"3280","6180橘子","110/08/19","凱基-竹科",1,12,-11
"3281","6180橘子","110/08/19","合庫-自強",10,0,10
"3282","6180橘子","110/08/19","元富-草屯",0,10,-10
"3283","6180橘子","110/08/19","富邦-新竹",12,2,10
"3284","6180橘子","110/08/19","新光",8,18,-10
"3285","6180橘子","110/08/19","元大-中壢",10,1,9
"3286","6180橘子","110/08/19","凱基-站前",0,10,-10
"3287","6180橘子","110/08/19","國泰-板橋",7,1,6
"3288","6180橘子","110/08/19","元大-文心興安",0,10,-10
"3289","6180橘子","110/08/19","富隆-長安",5,0,5
"3290","6180橘子","110/08/19","永豐金-新店",0,10,-10
"3291","6180橘子","110/08/19","大慶-苗栗",5,0,5
"3292","6180橘子","110/08/19","兆豐-新營",1,10,-9
"3293","6180橘子","110/08/19","台新-屏東",5,0,5
"3294","6180橘子","110/08/19","元大-北屯",1,10,-9
"3295","6180橘子","110/08/19","元大-向上",5,0,5
"3296","6180橘子","110/08/19","摩根大通",28,36,-8
"3297","6180橘子","110/08/19","永豐金-竹科",5,0,5
"3298","6180橘子","110/08/19","凱基-市政",0,7,-7
"3299","6180橘子","110/08/19","土銀-新竹",4,0,4
"3300","6180橘子","110/08/19","台灣摩根士丹利",11,17,-6
"3301","2390云辰","110/08/19","富邦-花蓮",100,0,100
"3302","2390云辰","110/08/19","摩根大通",96,805,-709
"3303","2390云辰","110/08/19","統一-新台中",86,0,86
"3304","2390云辰","110/08/19","美林",195,271,-76
"3305","2390云辰","110/08/19","凱基-台北",335,254,81
"3306","2390云辰","110/08/19","兆豐-桃園",15,90,-75
"3307","2390云辰","110/08/19","國票-博愛",132,54,78
"3308","2390云辰","110/08/19","大昌-新店",27,92,-65
"3309","2390云辰","110/08/19","凱基-台中",77,1,76
"3310","2390云辰","110/08/19","宏遠-桃園",1,63,-62
"3311","2390云辰","110/08/19","凱基-和平",60,2,58
"3312","2390云辰","110/08/19","華南永昌-公誠",53,110,-57
"3313","2390云辰","110/08/19","國票-安和",53,10,43
"3314","2390云辰","110/08/19","大慶-富順",11,67,-56
"3315","2390云辰","110/08/19","元大-四維",46,10,36
"3316","2390云辰","110/08/19","元大-歸仁",2,55,-53
"3317","2390云辰","110/08/19","中農",55,20,35
"3318","2390云辰","110/08/19","日茂",7,58,-51
"3319","2390云辰","110/08/19","第一金-安和",55,22,33
"3320","2390云辰","110/08/19","元大-大灣",10,60,-50
"3321","2390云辰","110/08/19","元大-雙和",42,12,30
"3322","2390云辰","110/08/19","凱基-三重",1,48,-47
"3323","2390云辰","110/08/19","國泰-館前",77,48,29
"3324","2390云辰","110/08/19","國票-台東",2,41,-39
"3325","2390云辰","110/08/19","元大-文心興安",42,13,29
"3326","2390云辰","110/08/19","豐農",7,41,-34
"3327","2390云辰","110/08/19","(牛牛牛)亞-鑫豐",59,31,28
"3328","2390云辰","110/08/19","凱基-中港",5,36,-31
"3329","2390云辰","110/08/19","國泰-高雄",44,18,26
"3330","2390云辰","110/08/19","永豐金-嘉義",3,32,-29
"3331","2609陽明","110/08/18","凱基-台北",15132,4630,10502
"3332","2609陽明","110/08/18","兆豐-復興",1580,3572,-1992
"3333","2609陽明","110/08/18","康和",4145,283,3862
"3334","2609陽明","110/08/18","日盛-板橋",943,2532,-1589
"3335","2609陽明","110/08/18","美林",6982,3580,3402
"3336","2609陽明","110/08/18","國泰-敦南",4957,6082,-1125
"3337","2609陽明","110/08/18","富邦證券",5335,3049,2286
"3338","2609陽明","110/08/18","新光",3470,4443,-973
"3339","2609陽明","110/08/18","兆豐-南京",2352,209,2143
"3340","2609陽明","110/08/18","玉山證券",1002,1913,-911
"3341","2609陽明","110/08/18","兆豐-虎尾",4490,2388,2102
"3342","2609陽明","110/08/18","台新證券",2873,3601,-728
"3343","2609陽明","110/08/18","永豐金-信義",1719,99,1620
"3344","2609陽明","110/08/18","國泰-館前",1002,1633,-631
"3345","2609陽明","110/08/18","摩根大通",9173,7611,1562
"3346","2609陽明","110/08/18","日盛-中壢",255,825,-570
"3347","2609陽明","110/08/18","台灣摩根士丹利",2544,1230,1314
"3348","2609陽明","110/08/18","兆豐-板橋",646,1122,-476
"3349","2609陽明","110/08/18","凱基-斗六",4335,3037,1298
"3350","2609陽明","110/08/18","第一金-嘉義",153,589,-436
"3351","2609陽明","110/08/18","統一",1895,653,1242
"3352","2609陽明","110/08/18","第一金-桃園",168,595,-427
"3353","2609陽明","110/08/18","元大證券",3293,2063,1230
"3354","2609陽明","110/08/18","(牛牛牛)亞-鑫豐",283,690,-407
"3355","2609陽明","110/08/18","富邦-仁愛",2205,1064,1141
"3356","2609陽明","110/08/18","國泰-板橋",1508,1913,-405
"3357","2609陽明","110/08/18","富邦-虎尾",10781,9680,1101
"3358","2609陽明","110/08/18","凱基-市政",9806,10201,-395
"3359","2609陽明","110/08/18","元大-頭份",1219,381,838
"3360","2609陽明","110/08/18","凱基-高美館",607,1000,-393
"3361","2636台驊投控","110/08/18","富邦證券",1190,0,1190
"3362","2636台驊投控","110/08/18","凱基",21,470,-449
"3363","2636台驊投控","110/08/18","摩根大通",1639,646,993
"3364","2636台驊投控","110/08/18","玉山-南京東路",3,355,-352
"3365","2636台驊投控","110/08/18","台灣摩根士丹利",825,36,789
"3366","2636台驊投控","110/08/18","統一-新台中",15,291,-276
"3367","2636台驊投控","110/08/18","凱基-台北",881,309,572
"3368","2636台驊投控","110/08/18","永豐金-新竹",38,292,-254
"3369","2636台驊投控","110/08/18","統一",503,143,360
"3370","2636台驊投控","110/08/18","國票-彰化",518,760,-242
"3371","2636台驊投控","110/08/18","富邦-員林",373,78,295
"3372","2636台驊投控","110/08/18","國泰-敦南",456,601,-145
"3373","2636台驊投控","110/08/18","新加坡商瑞銀",307,50,257
"3374","2636台驊投控","110/08/18","日盛-宜蘭",12,143,-131
"3375","2636台驊投控","110/08/18","美林",863,611,252
"3376","2636台驊投控","110/08/18","日盛-景美",26,156,-130
"3377","2636台驊投控","110/08/18","日盛-台中",273,57,216
"3378","2636台驊投控","110/08/18","日盛證券",180,298,-118
"3379","2636台驊投控","110/08/18","日盛-板橋",166,13,153
"3380","2636台驊投控","110/08/18","第一金-桃園",36,154,-118
"3381","2636台驊投控","110/08/18","兆豐-虎尾",169,20,149
"3382","2636台驊投控","110/08/18","新光",402,503,-101
"3383","2636台驊投控","110/08/18","華南永昌-竹北",221,84,137
"3384","2636台驊投控","110/08/18","凱基-市政",93,185,-92
"3385","2636台驊投控","110/08/18","大慶",123,6,117
"3386","2636台驊投控","110/08/18","台新證券",371,450,-79
"3387","2636台驊投控","110/08/18","美商高盛",432,323,109
"3388","2636台驊投控","110/08/18","凱基-天母",2,81,-79
"3389","2636台驊投控","110/08/18","統一-南京",102,33,69
"3390","2636台驊投控","110/08/18","華南永昌-南京",30,101,-71
"3391","2867三商壽","110/08/18","摩根大通",776,115,661
"3392","2867三商壽","110/08/18","華南永昌",2,804,-802
"3393","2867三商壽","110/08/18","美林",510,38,472
"3394","2867三商壽","110/08/18","富邦-陽明",0,253,-253
"3395","2867三商壽","110/08/18","元富-世貿",164,15,149
"3396","2867三商壽","110/08/18","宏遠證券",0,220,-220
"3397","2867三商壽","110/08/18","元大-桃園",110,1,109
"3398","2867三商壽","110/08/18","元大-崇德",0,178,-178
"3399","2867三商壽","110/08/18","新加坡商瑞銀",168,73,95
"3400","2867三商壽","110/08/18","元大證券",7,143,-136
"3401","2867三商壽","110/08/18","台新證券",97,2,95
"3402","2867三商壽","110/08/18","土銀-新竹",0,86,-86
"3403","2867三商壽","110/08/18","康和-台中",90,1,89
"3404","2867三商壽","110/08/18","統一-台中",0,82,-82
"3405","2867三商壽","110/08/18","富邦-三重",90,6,84
"3406","2867三商壽","110/08/18","富邦-嘉義",0,70,-70
"3407","2867三商壽","110/08/18","元富",70,0,70
"3408","2867三商壽","110/08/18","宏遠-台中",7,71,-64
"3409","2867三商壽","110/08/18","兆豐-寶成",70,1,69
"3410","2867三商壽","110/08/18","富邦-南屯",0,63,-63
"3411","2867三商壽","110/08/18","台新-台中",68,13,55
"3412","2867三商壽","110/08/18","元大-大甲",1,61,-60
"3413","2867三商壽","110/08/18","凱基",51,0,51
"3414","2867三商壽","110/08/18","美商高盛",32,87,-55
"3415","2867三商壽","110/08/18","元大-開元",51,0,51
"3416","2867三商壽","110/08/18","元富-大裕",0,50,-50
"3417","2867三商壽","110/08/18","日盛-頭份",50,0,50
"3418","2867三商壽","110/08/18","富邦-高雄",1,48,-47
"3419","2867三商壽","110/08/18","兆豐-台中",50,0,50
"3420","2867三商壽","110/08/18","元大-台北",0,40,-40
"3421","5521工信","110/08/18","台新證券",144,10,134
"3422","5521工信","110/08/18","台新-台中",0,200,-200
"3423","5521工信","110/08/18","群益金鼎-台中",43,0,43
"3424","5521工信","110/08/18","香港上海匯豐",0,143,-143
"3425","5521工信","110/08/18","富邦-嘉義",31,0,31
"3426","5521工信","110/08/18","日盛-雙和",0,100,-100
"3427","5521工信","110/08/18","華南永昌-林口",30,1,29
"3428","5521工信","110/08/18","元大-沙鹿",0,61,-61
"3429","5521工信","110/08/18","日進",25,0,25
"3430","5521工信","110/08/18","凱基-台北",57,116,-59
"3431","5521工信","110/08/18","國泰-敦南",26,3,23
"3432","5521工信","110/08/18","美林",3,61,-58
"3433","5521工信","110/08/18","群益金鼎-高雄",20,0,20
"3434","5521工信","110/08/18","永豐金-桃盛",0,50,-50
"3435","5521工信","110/08/18","元大-屏南",20,0,20
"3436","5521工信","110/08/18","摩根大通",106,150,-44
"3437","5521工信","110/08/18","元大-基隆孝二",20,0,20
"3438","5521工信","110/08/18","大慶-富順",0,42,-42
"3439","5521工信","110/08/18","永豐金-新店",20,0,20
"3440","5521工信","110/08/18","元大-鳳山",0,30,-30
"3441","5521工信","110/08/18","元大-龍潭",17,0,17
"3442","5521工信","110/08/18","凱基-三重",25,50,-25
"3443","5521工信","110/08/18","兆豐-北高雄",16,0,16
"3444","5521工信","110/08/18","光和-田中",2,24,-22
"3445","5521工信","110/08/18","元富-文心",15,0,15
"3446","5521工信","110/08/18","元大-和平",0,20,-20
"3447","5521工信","110/08/18","元大-前金",15,0,15
"3448","5521工信","110/08/18","華南永昌",0,15,-15
"3449","5521工信","110/08/18","元大-北投",15,0,15
"3450","5521工信","110/08/18","凱基-南崁",0,12,-12
"3451","1471首利","110/08/18","摩根大通",195,17,178
"3452","1471首利","110/08/18","元大-西門",16,81,-65
"3453","1471首利","110/08/18","永豐金-板盛",42,0,42
"3454","1471首利","110/08/18","高橋-龍潭",0,35,-35
"3455","1471首利","110/08/18","台新證券",35,13,22
"3456","1471首利","110/08/18","新光",14,41,-27
"3457","1471首利","110/08/18","台灣企銀-九如",20,0,20
"3458","1471首利","110/08/18","台新-高雄",2,25,-23
"3459","1471首利","110/08/18","凱基-五股",20,0,20
"3460","1471首利","110/08/18","元富-世貿",0,20,-20
"3461","1471首利","110/08/18","瑞士信貸",25,13,12
"3462","1471首利","110/08/18","台新-中壢",0,20,-20
"3463","1471首利","110/08/18","群益金鼎-三重",10,0,10
"3464","1471首利","110/08/18","玉山-高雄",1,21,-20
"3465","1471首利","110/08/18","凱基-台南",10,0,10
"3466","1471首利","110/08/18","富邦-基隆",13,30,-17
"3467","1471首利","110/08/18","華南永昌-鳳山",10,0,10
"3468","1471首利","110/08/18","凱基-彰化",0,14,-14
"3469","1471首利","110/08/18","富邦-嘉義",10,0,10
"3470","1471首利","110/08/18","元富-民權",0,12,-12
"3471","1471首利","110/08/18","元大-開元",10,0,10
"3472","1471首利","110/08/18","凱基-羅東",0,11,-11
"3473","1471首利","110/08/18","元大-內湖",10,0,10
"3474","1471首利","110/08/18","合庫證券",0,10,-10
"3475","1471首利","110/08/18","元大-東港",10,0,10
"3476","1471首利","110/08/18","日盛-斗六",0,10,-10
"3477","1471首利","110/08/18","永豐金-台南",10,0,10
"3478","1471首利","110/08/18","群益金鼎-潭子",0,10,-10
"3479","1471首利","110/08/18","凱基-台北",25,16,9
"3480","1471首利","110/08/18","元大-汐止",0,10,-10
"3481","2883開發金","110/08/18","合庫-台中",6579,11,6568
"3482","2883開發金","110/08/18","新加坡商瑞銀",902,7117,-6215
"3483","2883開發金","110/08/18","香港上海匯豐",4579,0,4579
"3484","2883開發金","110/08/18","台灣摩根士丹利",375,5303,-4928
"3485","2883開發金","110/08/18","富邦-台中",3720,12,3708
"3486","2883開發金","110/08/18","凱基",0,4582,-4582
"3487","2883開發金","110/08/18","中國信託-文心",3128,2,3126
"3488","2883開發金","110/08/18","台新證券",425,4594,-4169
"3489","2883開發金","110/08/18","元大-福營",1063,19,1044
"3490","2883開發金","110/08/18","國泰證券",11,3677,-3666
"3491","2883開發金","110/08/18","華南永昌-南京",1046,43,1003
"3492","2883開發金","110/08/18","富邦證券",47,3305,-3258
"3493","2883開發金","110/08/18","合庫證券",999,7,992
"3494","2883開發金","110/08/18","元大證券",1065,3675,-2610
"3495","2883開發金","110/08/18","瑞士信貸",1041,53,988
"3496","2883開發金","110/08/18","凱基-台北",1972,4074,-2102
"3497","2883開發金","110/08/18","摩根大通",2088,1332,756
"3498","2883開發金","110/08/18","國票-長城",711,2005,-1294
"3499","2883開發金","110/08/18","新光",2279,1577,702
"3500","2883開發金","110/08/18","日盛證券",88,1002,-914
"3501","2883開發金","110/08/18","元大-金華",559,0,559
"3502","2883開發金","110/08/18","群益金鼎-西松",38,786,-748
"3503","2883開發金","110/08/18","花旗環球",652,184,468
"3504","2883開發金","110/08/18","兆豐-高雄",12,668,-656
"3505","2883開發金","110/08/18","港商野村",1145,723,422
"3506","2883開發金","110/08/18","元富-四維",2,606,-604
"3507","2883開發金","110/08/18","國泰-敦南",609,244,365
"3508","2883開發金","110/08/18","宏遠-光隆",14,615,-601
"3509","2883開發金","110/08/18","元富",353,0,353
"3510","2883開發金","110/08/18","永豐金-苓雅",30,595,-565
"3511","6205詮欣","110/08/18","摩根大通",14,1,13
"3512","6205詮欣","110/08/18","合庫證券",0,15,-15
"3513","6205詮欣","110/08/18","凱基-汐止",10,0,10
"3514","6205詮欣","110/08/18","國票-南港",0,14,-14
"3515","6205詮欣","110/08/18","臺銀-臺中",9,0,9
"3516","6205詮欣","110/08/18","元大-大天母",0,8,-8
"3517","6205詮欣","110/08/18","德信-新營",7,0,7
"3518","6205詮欣","110/08/18","富邦-仁愛",0,6,-6
"3519","6205詮欣","110/08/18","元富-安南",6,0,6
"3520","6205詮欣","110/08/18","兆豐-竹北",0,5,-5
"3521","6205詮欣","110/08/18","凱基-台北",5,0,5
"3522","6205詮欣","110/08/18","兆豐-台中",0,4,-4
"3523","6205詮欣","110/08/18","美林",4,0,4
"3524","6205詮欣","110/08/18","元大-土城學府",0,3,-3
"3525","6205詮欣","110/08/18","華南永昌-古亭",6,2,4
"3526","6205詮欣","110/08/18","永豐金-台南",0,3,-3
"3527","6205詮欣","110/08/18","永豐金證券",4,0,4
"3528","6205詮欣","110/08/18","日盛-板橋中山",0,2,-2
"3529","6205詮欣","110/08/18","玉山證券",3,0,3
"3530","6205詮欣","110/08/18","亞東-高雄",0,2,-2
"3531","6205詮欣","110/08/18","永豐金-中正",3,0,3
"3532","6205詮欣","110/08/18","大昌-安康",0,2,-2
"3533","6205詮欣","110/08/18","大慶-台南",2,0,2
"3534","6205詮欣","110/08/18","大昌-新店",0,2,-2
"3535","6205詮欣","110/08/18","元富-草屯",2,0,2
"3536","6205詮欣","110/08/18","玉山-高雄",0,2,-2
"3537","6205詮欣","110/08/18","元大-豐原",2,0,2
"3538","6205詮欣","110/08/18","日盛-板橋",0,1,-1
"3539","6205詮欣","110/08/18","日盛-三重",1,0,1
"3540","6205詮欣","110/08/18","宏遠-民生",0,1,-1
"3541","1540喬福","110/08/18","凱基-台北",26,5,21
"3542","1540喬福","110/08/18","兆豐-小港",0,45,-45
"3543","1540喬福","110/08/18","元大-土城永寧",15,0,15
"3544","1540喬福","110/08/18","群益金鼎-館前",1,40,-39
"3545","1540喬福","110/08/18","凱基-中壢",12,0,12
"3546","1540喬福","110/08/18","新光-台南",0,10,-10
"3547","1540喬福","110/08/18","日盛-二林",10,0,10
"3548","1540喬福","110/08/18","元大-北屯",0,6,-6
"3549","1540喬福","110/08/18","日盛-鳳山",6,0,6
"3550","1540喬福","110/08/18","新光-桃園",0,5,-5
"3551","1540喬福","110/08/18","兆豐-北高雄",6,0,6
"3552","1540喬福","110/08/18","元富",0,4,-4
"3553","1540喬福","110/08/18","元大-龍潭",6,0,6
"3554","1540喬福","110/08/18","元大-館前",0,4,-4
"3555","1540喬福","110/08/18","日盛-樹林",5,0,5
"3556","1540喬福","110/08/18","國票-台東",0,3,-3
"3557","1540喬福","110/08/18","瑞士信貸",3,0,3
"3558","1540喬福","110/08/18","富邦-台南",0,3,-3
"3559","1540喬福","110/08/18","兆豐-三民",3,0,3
"3560","1540喬福","110/08/18","第一金-大稻埕",0,2,-2
"3561","1540喬福","110/08/18","國票-彰化",3,0,3
"3562","1540喬福","110/08/18","致和-南京",0,2,-2
"3563","1540喬福","110/08/18","富邦-員林",3,0,3
"3564","1540喬福","110/08/18","玉山-城中",0,2,-2
"3565","1540喬福","110/08/18","永豐金-敦南",3,0,3
"3566","1540喬福","110/08/18","元大-南崁",0,2,-2
"3567","1540喬福","110/08/18","日盛-板橋",2,0,2
"3568","1540喬福","110/08/18","元大-府城",1,3,-2
"3569","1540喬福","110/08/18","兆豐-台中港",2,0,2
"3570","1540喬福","110/08/18","元大-松山",0,2,-2
"3571","2888新光金","110/08/18","兆豐-公益",6495,300,6195
"3572","2888新光金","110/08/18","美商高盛",222,4409,-4187
"3573","2888新光金","110/08/18","元大-忠孝鼎富",4187,0,4187
"3574","2888新光金","110/08/18","元富-城東",12,2101,-2089
"3575","2888新光金","110/08/18","瑞士信貸",2917,33,2884
"3576","2888新光金","110/08/18","華南永昌",26,1674,-1648
"3577","2888新光金","110/08/18","華南永昌-大安",1071,5,1066
"3578","2888新光金","110/08/18","華南永昌-忠孝",0,1211,-1211
"3579","2888新光金","110/08/18","宏遠-光隆",1044,6,1038
"3580","2888新光金","110/08/18","群益金鼎-彰化",14,1211,-1197
"3581","2888新光金","110/08/18","元富",805,90,715
"3582","2888新光金","110/08/18","元大-大同",5,711,-706
"3583","2888新光金","110/08/18","凱基-台北",2712,2138,574
"3584","2888新光金","110/08/18","凱基-桃園",93,755,-662
"3585","2888新光金","110/08/18","台灣摩根士丹利",742,305,437
"3586","2888新光金","110/08/18","新光-台南",2,610,-608
"3587","2888新光金","110/08/18","富邦證券",385,20,365
"3588","2888新光金","110/08/18","第一金-新竹",100,706,-606
"3589","2888新光金","110/08/18","摩根大通",2204,1868,336
"3590","2888新光金","110/08/18","福勝",2,600,-598
"3591","2888新光金","110/08/18","永興-台中",303,29,274
"3592","2888新光金","110/08/18","華南永昌-岡山",12,457,-445
"3593","2888新光金","110/08/18","元大-六合",302,28,274
"3594","2888新光金","110/08/18","花旗環球",38,466,-428
"3595","2888新光金","110/08/18","華南永昌-敦南",262,10,252
"3596","2888新光金","110/08/18","元富-民權",0,300,-300
"3597","2888新光金","110/08/18","新加坡商瑞銀",287,70,217
"3598","2888新光金","110/08/18","華南永昌-合泰",4,303,-299
"3599","2888新光金","110/08/18","統一-板橋",170,5,165
"3600","2888新光金","110/08/18","元富-中港",3,300,-297
"3601","1340勝悅","110/08/18","摩根大通",139,18,121
"3602","1340勝悅","110/08/18","聯邦-三重",0,100,-100
"3603","1340勝悅","110/08/18","華南永昌-敦南",8,0,8
"3604","1340勝悅","110/08/18","華南永昌",1,20,-19
"3605","1340勝悅","110/08/18","永豐金-板盛",7,0,7
"3606","1340勝悅","110/08/18","合庫證券",0,10,-10
"3607","1340勝悅","110/08/18","美商高盛",6,0,6
"3608","1340勝悅","110/08/18","新光-新竹",0,10,-10
"3609","1340勝悅","110/08/18","臺灣企銀-埔墘",5,0,5
"3610","1340勝悅","110/08/18","富邦-嘉義",0,8,-8
"3611","1340勝悅","110/08/18","國泰-台中",5,0,5
"3612","1340勝悅","110/08/18","元大-新竹經國",0,7,-7
"3613","1340勝悅","110/08/18","凱基-松山",5,0,5
"3614","1340勝悅","110/08/18","臺銀-鳳山",5,10,-5
"3615","1340勝悅","110/08/18","新光",4,0,4
"3616","1340勝悅","110/08/18","瑞士信貸",0,5,-5
"3617","1340勝悅","110/08/18","中國信託-文心",3,0,3
"3618","1340勝悅","110/08/18","統一-城中",9,13,-4
"3619","1340勝悅","110/08/18","康和-延平",3,0,3
"3620","1340勝悅","110/08/18","元大-歸仁",0,4,-4
"3621","1340勝悅","110/08/18","新光-桃園",3,0,3
"3622","1340勝悅","110/08/18","元大-桃興",1,5,-4
"3623","1340勝悅","110/08/18","凱基-基隆",3,0,3
"3624","1340勝悅","110/08/18","(牛牛牛)亞-鑫豐",1,4,-3
"3625","1340勝悅","110/08/18","合庫-鳳山",2,0,2
"3626","1340勝悅","110/08/18","台新證券",0,3,-3
"3627","1340勝悅","110/08/18","元富-板橋",2,0,2
"3628","1340勝悅","110/08/18","合庫-高雄",0,2,-2
"3629","1340勝悅","110/08/18","大昌-安康",2,0,2
"3630","1340勝悅","110/08/18","日盛-文化",0,2,-2
"3631","6246臺龍","110/08/18","港商野村",62,7,55
"3632","6246臺龍","110/08/18","元富-高雄",0,20,-20
"3633","6246臺龍","110/08/18","台新-三民",20,0,20
"3634","6246臺龍","110/08/18","新光",1,16,-15
"3635","6246臺龍","110/08/18","台新證券",19,0,19
"3636","6246臺龍","110/08/18","日盛-板橋",0,10,-10
"3637","6246臺龍","110/08/18","元富-林園",10,0,10
"3638","6246臺龍","110/08/18","致和-台北",0,10,-10
"3639","6246臺龍","110/08/18","光和-和美",10,0,10
"3640","6246臺龍","110/08/18","凱基-永和",0,10,-10
"3641","6246臺龍","110/08/18","凱基-屏東",10,0,10
"3642","6246臺龍","110/08/18","華南永昌-公誠",0,10,-10
"3643","6246臺龍","110/08/18","元大-永康",10,0,10
"3644","6246臺龍","110/08/18","凱基-台北",1,10,-9
"3645","6246臺龍","110/08/18","元大-竹科",5,0,5
"3646","6246臺龍","110/08/18","元大-北港",0,9,-9
"3647","6246臺龍","110/08/18","元大-北成功",4,0,4
"3648","6246臺龍","110/08/18","日盛-和美",0,6,-6
"3649","6246臺龍","110/08/18","大慶-苗栗",3,0,3
"3650","6246臺龍","110/08/18","群益金鼎-北高雄",0,6,-6
"3651","6246臺龍","110/08/18","統一-彰化",3,0,3
"3652","6246臺龍","110/08/18","日進",0,5,-5
"3653","6246臺龍","110/08/18","日茂-南投",3,0,3
"3654","6246臺龍","110/08/18","凱基-松山",0,5,-5
"3655","6246臺龍","110/08/18","兆豐-新營",3,0,3
"3656","6246臺龍","110/08/18","凱基-三多",2,7,-5
"3657","6246臺龍","110/08/18","元大-南投",3,0,3
"3658","6246臺龍","110/08/18","元富-烏日",0,4,-4
"3659","6246臺龍","110/08/18","元富-大裕",2,0,2
"3660","6246臺龍","110/08/18","兆豐-景美",0,4,-4
"3661","00715L期街口布蘭特正2","110/08/18","兆豐-鹿港",751,0,751
"3662","00715L期街口布蘭特正2","110/08/18","元大證券",368,4666,-4298
"3663","00715L期街口布蘭特正2","110/08/18","合庫-新竹",597,1,596
"3664","00715L期街口布蘭特正2","110/08/18","凱基-台北",310,4173,-3863
"3665","00715L期街口布蘭特正2","110/08/18","(牛牛牛)亞-鑫豐",606,24,582
"3666","00715L期街口布蘭特正2","110/08/18","統一",5,1703,-1698
"3667","00715L期街口布蘭特正2","110/08/18","元富-古亭",499,0,499
"3668","00715L期街口布蘭特正2","110/08/18","元大-台中",8,1176,-1168
"3669","00715L期街口布蘭特正2","110/08/18","統一-新竹",411,0,411
"3670","00715L期街口布蘭特正2","110/08/18","兆豐-來福",0,590,-590
"3671","00715L期街口布蘭特正2","110/08/18","永豐金-北高雄",331,0,331
"3672","00715L期街口布蘭特正2","110/08/18","元富",5,588,-583
"3673","00715L期街口布蘭特正2","110/08/18","中國信託-新竹",327,0,327
"3674","00715L期街口布蘭特正2","110/08/18","康和",686,1184,-498
"3675","00715L期街口布蘭特正2","110/08/18","新光",396,124,272
"3676","00715L期街口布蘭特正2","110/08/18","新光-台中",143,525,-382
"3677","00715L期街口布蘭特正2","110/08/18","元大-沙鹿",216,0,216
"3678","00715L期街口布蘭特正2","110/08/18","元大-雙和",25,380,-355
"3679","00715L期街口布蘭特正2","110/08/18","國泰-敦南",244,30,214
"3680","00715L期街口布蘭特正2","110/08/18","玉山-新竹",8,324,-316
"3681","00715L期街口布蘭特正2","110/08/18","元大-花蓮",229,20,209
"3682","00715L期街口布蘭特正2","110/08/18","玉山-台南",19,285,-266
"3683","00715L期街口布蘭特正2","110/08/18","兆豐-台中",226,36,190
"3684","00715L期街口布蘭特正2","110/08/18","永豐金證券",4,240,-236
"3685","00715L期街口布蘭特正2","110/08/18","元大-復北",200,10,190
"3686","00715L期街口布蘭特正2","110/08/18","永豐金-台南",13,230,-217
"3687","00715L期街口布蘭特正2","110/08/18","台新-新營",221,32,189
"3688","00715L期街口布蘭特正2","110/08/18","中國信託-永康",15,210,-195
"3689","00715L期街口布蘭特正2","110/08/18","新光-新竹",204,17,187
"3690","00715L期街口布蘭特正2","110/08/18","凱基-大里",2,189,-187
"3691","8941關中","110/08/18","元大-華山",1,0,1
"3692","8941關中","110/08/18","群益金鼎-開元",0,2,-2
"3693","8941關中","110/08/18","元大-南京",1,0,1
"3694","8941關中","110/08/18","元大-桃興",0,1,-1
"3695","8941關中","110/08/18","元大-西門",1,0,1
"3696","8941關中","110/08/18","華南永昌-淡水",0,0,0
"3697","8941關中","110/08/18","華南永昌-淡水",0,0,0
"3698","8941關中","110/08/18","富邦-台北",0,0,0
"3699","8941關中","110/08/18","富邦-台北",0,0,0
"3700","8941關中","110/08/18","元大-金華",1,1,0
"3701","8941關中","110/08/18","元大-金華",1,1,0
"3702","8941關中","110/08/18","永豐金-敦北",0,0,0
"3703","8941關中","110/08/18","永豐金-敦北",0,0,0
"3704","8941關中","110/08/18","",NA,NA,NA
"3705","8941關中","110/08/18","",NA,NA,NA
"3706","8941關中","110/08/18","",NA,NA,NA
"3707","8941關中","110/08/18","",NA,NA,NA
"3708","8941關中","110/08/18","",NA,NA,NA
"3709","8941關中","110/08/18","",NA,NA,NA
"3710","8941關中","110/08/18","",NA,NA,NA
"3711","8941關中","110/08/18","",NA,NA,NA
"3712","8941關中","110/08/18","",NA,NA,NA
"3713","8941關中","110/08/18","",NA,NA,NA
"3714","8941關中","110/08/18","",NA,NA,NA
"3715","8941關中","110/08/18","",NA,NA,NA
"3716","8941關中","110/08/18","",NA,NA,NA
"3717","8941關中","110/08/18","",NA,NA,NA
"3718","8941關中","110/08/18","",NA,NA,NA
"3719","8941關中","110/08/18","",NA,NA,NA
"3720","8941關中","110/08/18","",NA,NA,NA
"3721","8936國統","110/08/18","凱基-台北",120,29,91
"3722","8936國統","110/08/18","新光-高雄",0,70,-70
"3723","8936國統","110/08/18","美林",66,1,65
"3724","8936國統","110/08/18","華南永昌-林口",1,70,-69
"3725","8936國統","110/08/18","元大-萬華",50,0,50
"3726","8936國統","110/08/18","台新-高雄",36,97,-61
"3727","8936國統","110/08/18","摩根大通",95,54,41
"3728","8936國統","110/08/18","永豐金-忠孝",12,44,-32
"3729","8936國統","110/08/18","港商野村",92,58,34
"3730","8936國統","110/08/18","台灣摩根士丹利",26,53,-27
"3731","8936國統","110/08/18","中國信託-高雄",12,0,12
"3732","8936國統","110/08/18","台新-中壢",0,25,-25
"3733","8936國統","110/08/18","玉山-台南",12,0,12
"3734","8936國統","110/08/18","元大-高雄",5,30,-25
"3735","8936國統","110/08/18","國泰-敦南",18,6,12
"3736","8936國統","110/08/18","玉山-嘉義",5,25,-20
"3737","8936國統","110/08/18","元大-成功",11,0,11
"3738","8936國統","110/08/18","新加坡商瑞銀",120,137,-17
"3739","8936國統","110/08/18","臺銀-新竹",10,0,10
"3740","8936國統","110/08/18","美商高盛",7,23,-16
"3741","8936國統","110/08/18","大慶-楊梅",10,0,10
"3742","8936國統","110/08/18","國泰-板橋",0,13,-13
"3743","8936國統","110/08/18","兆豐-三重",10,0,10
"3744","8936國統","110/08/18","群益金鼎-潭子",0,12,-12
"3745","8936國統","110/08/18","兆豐-北高雄",10,0,10
"3746","8936國統","110/08/18","群益金鼎-鳳山",0,12,-12
"3747","8936國統","110/08/18","元大-大里德芳",10,0,10
"3748","8936國統","110/08/18","合庫-高雄",0,10,-10
"3749","8936國統","110/08/18","永豐金-新莊",10,0,10
"3750","8936國統","110/08/18","第一金-新興",0,10,-10
"3751","6226光鼎","110/08/18","凱基-台北",625,134,491
"3752","6226光鼎","110/08/18","國泰-台中",21,655,-634
"3753","6226光鼎","110/08/18","元大-文心興安",224,4,220
"3754","6226光鼎","110/08/18","群益金鼎-士林",0,100,-100
"3755","6226光鼎","110/08/18","美商高盛",231,46,185
"3756","6226光鼎","110/08/18","元大-竹科",24,122,-98
"3757","6226光鼎","110/08/18","美林",213,118,95
"3758","6226光鼎","110/08/18","新光-桃園",22,96,-74
"3759","6226光鼎","110/08/18","新加坡商瑞銀",165,83,82
"3760","6226光鼎","110/08/18","永豐金-南投",15,83,-68
"3761","6226光鼎","110/08/18","凱基-竹科",67,4,63
"3762","6226光鼎","110/08/18","富邦-建國",21,80,-59
"3763","6226光鼎","110/08/18","元大證券",92,29,63
"3764","6226光鼎","110/08/18","元富-信義",2,58,-56
"3765","6226光鼎","110/08/18","元大-敦化",63,11,52
"3766","6226光鼎","110/08/18","凱基-新豐",15,69,-54
"3767","6226光鼎","110/08/18","兆豐-鹿港",54,4,50
"3768","6226光鼎","110/08/18","群益金鼎-台中",2,54,-52
"3769","6226光鼎","110/08/18","群益金鼎-萬華",54,9,45
"3770","6226光鼎","110/08/18","宏遠-光隆",0,50,-50
"3771","6226光鼎","110/08/18","大昌",48,12,36
"3772","6226光鼎","110/08/18","元大-福營",5,53,-48
"3773","6226光鼎","110/08/18","凱基-站前",35,1,34
"3774","6226光鼎","110/08/18","永豐金-竹北",2,43,-41
"3775","6226光鼎","110/08/18","日盛-和美",47,16,31
"3776","6226光鼎","110/08/18","兆豐-民生",0,40,-40
"3777","6226光鼎","110/08/18","群益金鼎-永和",30,0,30
"3778","6226光鼎","110/08/18","玉山證券",10,50,-40
"3779","6226光鼎","110/08/18","凱基-中港",30,0,30
"3780","6226光鼎","110/08/18","凱基-民權",11,51,-40
"3781","2363矽統","110/08/18","凱基-南崁",1528,19,1509
"3782","2363矽統","110/08/18","台灣摩根士丹利",64,1051,-987
"3783","2363矽統","110/08/18","凱基-台北",1850,671,1179
"3784","2363矽統","110/08/18","美商高盛",386,711,-325
"3785","2363矽統","110/08/18","摩根大通",1073,563,510
"3786","2363矽統","110/08/18","台新-三民",47,361,-314
"3787","2363矽統","110/08/18","富邦-板橋",403,71,332
"3788","2363矽統","110/08/18","新加坡商瑞銀",699,987,-288
"3789","2363矽統","110/08/18","玉山-高雄",391,228,163
"3790","2363矽統","110/08/18","富邦-台北",82,251,-169
"3791","2363矽統","110/08/18","群益金鼎",154,21,133
"3792","2363矽統","110/08/18","富邦-新店",28,140,-112
"3793","2363矽統","110/08/18","永豐金證券",155,31,124
"3794","2363矽統","110/08/18","中國信託-忠孝",89,200,-111
"3795","2363矽統","110/08/18","日盛-樹林",159,39,120
"3796","2363矽統","110/08/18","玉山-台中",14,122,-108
"3797","2363矽統","110/08/18","石橋證券",112,1,111
"3798","2363矽統","110/08/18","元大-汐止",112,215,-103
"3799","2363矽統","110/08/18","合庫-高雄",123,15,108
"3800","2363矽統","110/08/18","永豐金-板盛",2,105,-103
"3801","2363矽統","110/08/18","凱基-汐止",103,1,102
"3802","2363矽統","110/08/18","群益金鼎-南京",59,160,-101
"3803","2363矽統","110/08/18","永興",94,4,90
"3804","2363矽統","110/08/18","永豐金-天母",14,112,-98
"3805","2363矽統","110/08/18","元大-前金",207,139,68
"3806","2363矽統","110/08/18","凱基-竹科",22,110,-88
"3807","2363矽統","110/08/18","新光-桃園",84,17,67
"3808","2363矽統","110/08/18","華南永昌-台中",35,122,-87
"3809","2363矽統","110/08/18","富邦-台南",95,30,65
"3810","2363矽統","110/08/18","國泰-敦南",437,521,-84
"3811","8112至上","110/08/18","港商野村",371,52,319
"3812","8112至上","110/08/18","新加坡商瑞銀",70,220,-150
"3813","8112至上","110/08/18","凱基-台北",202,29,173
"3814","8112至上","110/08/18","元大證券",3,102,-99
"3815","8112至上","110/08/18","美林",135,39,96
"3816","8112至上","110/08/18","凱基-新店",0,91,-91
"3817","8112至上","110/08/18","凱基-市政",81,0,81
"3818","8112至上","110/08/18","台灣摩根士丹利",0,87,-87
"3819","8112至上","110/08/18","摩根大通",287,209,78
"3820","8112至上","110/08/18","元大-佳里",3,82,-79
"3821","8112至上","110/08/18","美商高盛",97,25,72
"3822","8112至上","110/08/18","合庫-台中",5,67,-62
"3823","8112至上","110/08/18","台新證券",71,13,58
"3824","8112至上","110/08/18","宏遠證券",0,59,-59
"3825","8112至上","110/08/18","大慶",60,10,50
"3826","8112至上","110/08/18","凱基-文心",0,53,-53
"3827","8112至上","110/08/18","凱基-站前",52,13,39
"3828","8112至上","110/08/18","元大-樹林",8,60,-52
"3829","8112至上","110/08/18","元大-大灣",38,0,38
"3830","8112至上","110/08/18","元大-永春",2,43,-41
"3831","8112至上","110/08/18","永豐金-中盛",31,3,28
"3832","8112至上","110/08/18","富邦-新營",2,40,-38
"3833","8112至上","110/08/18","國票-北高雄",25,0,25
"3834","8112至上","110/08/18","永豐金-員林",1,38,-37
"3835","8112至上","110/08/18","富邦-竹東",21,0,21
"3836","8112至上","110/08/18","玉山-高雄",23,55,-32
"3837","8112至上","110/08/18","彰銀-七賢",20,0,20
"3838","8112至上","110/08/18","大昌-桃園",1,30,-29
"3839","8112至上","110/08/18","元富-新莊",20,0,20
"3840","8112至上","110/08/18","新光-台南",1,30,-29
"3841","1570力肯","110/08/18","凱基-台北",129,5,124
"3842","1570力肯","110/08/18","華南永昌-桃園",0,102,-102
"3843","1570力肯","110/08/18","香港上海匯豐",36,0,36
"3844","1570力肯","110/08/18","中國信託-高雄",0,49,-49
"3845","1570力肯","110/08/18","統一",30,0,30
"3846","1570力肯","110/08/18","元富-世貿",0,20,-20
"3847","1570力肯","110/08/18","群益金鼎-北高雄",27,0,27
"3848","1570力肯","110/08/18","國泰證券",0,20,-20
"3849","1570力肯","110/08/18","國票-北高雄",21,3,18
"3850","1570力肯","110/08/18","元大-屏南",0,15,-15
"3851","1570力肯","110/08/18","元大-南投",20,4,16
"3852","1570力肯","110/08/18","元大-和平",5,20,-15
"3853","1570力肯","110/08/18","新光-台南",15,0,15
"3854","1570力肯","110/08/18","元大-基隆",0,12,-12
"3855","1570力肯","110/08/18","富邦-高雄",15,0,15
"3856","1570力肯","110/08/18","玉山-台中",0,10,-10
"3857","1570力肯","110/08/18","華南永昌-嘉義",12,0,12
"3858","1570力肯","110/08/18","元大-苗栗",0,10,-10
"3859","1570力肯","110/08/18","富邦-花蓮",10,0,10
"3860","1570力肯","110/08/18","元大-草屯",0,10,-10
"3861","1570力肯","110/08/18","元富-新店",10,2,8
"3862","1570力肯","110/08/18","富邦-彰化",0,8,-8
"3863","1570力肯","110/08/18","富邦-台東",12,4,8
"3864","1570力肯","110/08/18","日盛-嘉義",0,7,-7
"3865","1570力肯","110/08/18","日盛-高雄",7,0,7
"3866","1570力肯","110/08/18","永豐金-桃園",3,10,-7
"3867","1570力肯","110/08/18","元大-羅東",7,0,7
"3868","1570力肯","110/08/18","大昌-安康",0,6,-6
"3869","1570力肯","110/08/18","大慶-蘆洲",9,3,6
"3870","1570力肯","110/08/18","國票-和平",0,6,-6
"3871","2929淘帝","110/08/18","摩根大通",42,2,40
"3872","2929淘帝","110/08/18","日盛-嘉義",0,30,-30
"3873","2929淘帝","110/08/18","元富-板橋",23,0,23
"3874","2929淘帝","110/08/18","兆豐-復興",0,16,-16
"3875","2929淘帝","110/08/18","元大-太平",19,0,19
"3876","2929淘帝","110/08/18","兆豐-桃鶯",0,13,-13
"3877","2929淘帝","110/08/18","永豐金-中盛",10,0,10
"3878","2929淘帝","110/08/18","中國信託",4,14,-10
"3879","2929淘帝","110/08/18","新光",18,9,9
"3880","2929淘帝","110/08/18","宏遠-高雄",0,6,-6
"3881","2929淘帝","110/08/18","永豐金證券",8,0,8
"3882","2929淘帝","110/08/18","元大-東泰",0,5,-5
"3883","2929淘帝","110/08/18","元富-新竹",5,0,5
"3884","2929淘帝","110/08/18","港商野村",5,9,-4
"3885","2929淘帝","110/08/18","富邦-新店",5,0,5
"3886","2929淘帝","110/08/18","(牛牛牛)亞-鑫豐",0,4,-4
"3887","2929淘帝","110/08/18","凱基-豐中",4,0,4
"3888","2929淘帝","110/08/18","群益金鼎-潭子",0,4,-4
"3889","2929淘帝","110/08/18","永豐金-竹北",4,0,4
"3890","2929淘帝","110/08/18","亞東",0,3,-3
"3891","2929淘帝","110/08/18","亞東-板橋",4,1,3
"3892","2929淘帝","110/08/18","台新-高雄",0,3,-3
"3893","2929淘帝","110/08/18","中國信託-中壢",3,0,3
"3894","2929淘帝","110/08/18","國泰-板橋",0,3,-3
"3895","2929淘帝","110/08/18","凱基-中山",7,4,3
"3896","2929淘帝","110/08/18","元大-土城學府",0,3,-3
"3897","2929淘帝","110/08/18","富邦-陽明",5,2,3
"3898","2929淘帝","110/08/18","元大-楊梅",0,3,-3
"3899","2929淘帝","110/08/18","臺銀-鳳山",2,0,2
"3900","2929淘帝","110/08/18","日盛-高雄",0,2,-2
"3901","5410國眾","110/08/18","元大-中壢",31,0,31
"3902","5410國眾","110/08/18","凱基-台北",3,57,-54
"3903","5410國眾","110/08/18","康和-台北",10,0,10
"3904","5410國眾","110/08/18","台灣企銀-北高雄",0,20,-20
"3905","5410國眾","110/08/18","土銀-嘉義",9,0,9
"3906","5410國眾","110/08/18","摩根大通",5,22,-17
"3907","5410國眾","110/08/18","凱基-中山",8,0,8
"3908","5410國眾","110/08/18","臺銀-臺南",1,16,-15
"3909","5410國眾","110/08/18","凱基-彰化",7,0,7
"3910","5410國眾","110/08/18","大昌-樹林",5,20,-15
"3911","5410國眾","110/08/18","永豐金-員林",8,1,7
"3912","5410國眾","110/08/18","宏遠-民生",0,10,-10
"3913","5410國眾","110/08/18","玉山-城中",6,0,6
"3914","5410國眾","110/08/18","兆豐-高雄",0,10,-10
"3915","5410國眾","110/08/18","富邦-員林",6,0,6
"3916","5410國眾","110/08/18","富邦-仁愛",1,10,-9
"3917","5410國眾","110/08/18","元大-崇德",6,0,6
"3918","5410國眾","110/08/18","元大-土城學府",2,11,-9
"3919","5410國眾","110/08/18","永豐金-敦南",6,0,6
"3920","5410國眾","110/08/18","元大-豐原",0,7,-7
"3921","5410國眾","110/08/18","國泰-敦南",5,0,5
"3922","5410國眾","110/08/18","台新-高雄",0,6,-6
"3923","5410國眾","110/08/18","凱基-科園",5,0,5
"3924","5410國眾","110/08/18","元大-大里",0,6,-6
"3925","5410國眾","110/08/18","元大-博愛",5,0,5
"3926","5410國眾","110/08/18","永豐金-復興",0,6,-6
"3927","5410國眾","110/08/18","元大-新盛",5,0,5
"3928","5410國眾","110/08/18","元大-大天母",0,5,-5
"3929","5410國眾","110/08/18","國泰-松江",4,0,4
"3930","5410國眾","110/08/18","永豐金-板新",0,5,-5
"3931","2841台開","110/08/18","宏遠-館前",479,0,479
"3932","2841台開","110/08/18","兆豐-鹿港",0,200,-200
"3933","2841台開","110/08/18","第一金",46,0,46
"3934","2841台開","110/08/18","兆豐-台南",0,120,-120
"3935","2841台開","110/08/18","凱基-竹科",25,0,25
"3936","2841台開","110/08/18","摩根大通",0,100,-100
"3937","2841台開","110/08/18","合庫證券",24,0,24
"3938","2841台開","110/08/18","日盛-信義",0,69,-69
"3939","2841台開","110/08/18","第一金-台中",20,0,20
"3940","2841台開","110/08/18","玉山-高雄",0,51,-51
"3941","2841台開","110/08/18","富邦-板橋",24,5,19
"3942","2841台開","110/08/18","台新證券",5,40,-35
"3943","2841台開","110/08/18","永豐金-中盛",16,0,16
"3944","2841台開","110/08/18","華南永昌-鳳山",0,30,-30
"3945","2841台開","110/08/18","統一-新台中",15,0,15
"3946","2841台開","110/08/18","中國信託-嘉義",0,24,-24
"3947","2841台開","110/08/18","統一-士林",20,5,15
"3948","2841台開","110/08/18","元大-竹山",0,21,-21
"3949","2841台開","110/08/18","華南永昌-台中",14,0,14
"3950","2841台開","110/08/18","凱基-高美館",0,20,-20
"3951","2841台開","110/08/18","元大-彰化",20,7,13
"3952","2841台開","110/08/18","華南永昌-高雄",5,25,-20
"3953","2841台開","110/08/18","元大-六合",13,0,13
"3954","2841台開","110/08/18","元大-嘉義",0,20,-20
"3955","2841台開","110/08/18","兆豐-台中",10,0,10
"3956","2841台開","110/08/18","兆豐-天母",0,10,-10
"3957","2841台開","110/08/18","玉山-桃園",10,0,10
"3958","2841台開","110/08/18","群益金鼎-敦南",0,10,-10
"3959","2841台開","110/08/18","元大-台南",10,0,10
"3960","2841台開","110/08/18","元大-北三重",0,10,-10
"3961","6207雷科","110/08/18","凱基-台北",77,2,75
"3962","6207雷科","110/08/18","元大-高雄",0,106,-106
"3963","6207雷科","110/08/18","摩根大通",94,60,34
"3964","6207雷科","110/08/18","凱基-高雄",4,34,-30
"3965","6207雷科","110/08/18","港商野村",48,17,31
"3966","6207雷科","110/08/18","凱基-復興",0,30,-30
"3967","6207雷科","110/08/18","兆豐-南京",30,0,30
"3968","6207雷科","110/08/18","日盛證券",0,29,-29
"3969","6207雷科","110/08/18","元大-六合",30,0,30
"3970","6207雷科","110/08/18","凱基-敦北",1,28,-27
"3971","6207雷科","110/08/18","新加坡商瑞銀",66,40,26
"3972","6207雷科","110/08/18","群益金鼎-東門",0,16,-16
"3973","6207雷科","110/08/18","台新-高雄",21,0,21
"3974","6207雷科","110/08/18","元大-天母",0,11,-11
"3975","6207雷科","110/08/18","光和-和美",17,0,17
"3976","6207雷科","110/08/18","美商高盛",4,13,-9
"3977","6207雷科","110/08/18","凱基-三重",13,0,13
"3978","6207雷科","110/08/18","新光",0,8,-8
"3979","6207雷科","110/08/18","元富-安南",10,0,10
"3980","6207雷科","110/08/18","永豐金-忠孝",0,8,-8
"3981","6207雷科","110/08/18","元大-東門",9,0,9
"3982","6207雷科","110/08/18","合庫證券",0,7,-7
"3983","6207雷科","110/08/18","第一金-華江",8,2,6
"3984","6207雷科","110/08/18","康和-台中",0,6,-6
"3985","6207雷科","110/08/18","永豐金-高雄",6,0,6
"3986","6207雷科","110/08/18","元大-大天母",0,6,-6
"3987","6207雷科","110/08/18","玉山-台大",5,0,5
"3988","6207雷科","110/08/18","統一-三多",0,5,-5
"3989","6207雷科","110/08/18","凱基-岡山",5,0,5
"3990","6207雷科","110/08/18","中國信託-忠孝",0,5,-5
"3991","3679新至陞","110/08/18","摩根大通",52,6,46
"3992","3679新至陞","110/08/18","統一-三重",0,21,-21
"3993","3679新至陞","110/08/18","凱基-台北",46,13,33
"3994","3679新至陞","110/08/18","元大-北成功",0,19,-19
"3995","3679新至陞","110/08/18","台灣摩根士丹利",31,0,31
"3996","3679新至陞","110/08/18","華南永昌-大安",0,18,-18
"3997","3679新至陞","110/08/18","瑞士信貸",26,1,25
"3998","3679新至陞","110/08/18","台新證券",0,14,-14
"3999","3679新至陞","110/08/18","美林",23,5,18
"4000","3679新至陞","110/08/18","萬泰",0,12,-12
"4001","3679新至陞","110/08/18","元大-文心興安",15,0,15
"4002","3679新至陞","110/08/18","大慶-苗栗",0,10,-10
"4003","3679新至陞","110/08/18","(牛牛牛)亞-網路",8,0,8
"4004","3679新至陞","110/08/18","元大-成功",0,10,-10
"4005","3679新至陞","110/08/18","永豐金-板橋",5,0,5
"4006","3679新至陞","110/08/18","富邦-嘉義",0,8,-8
"4007","3679新至陞","110/08/18","美商高盛",3,0,3
"4008","3679新至陞","110/08/18","凱基-長庚",0,7,-7
"4009","3679新至陞","110/08/18","兆豐-公益",3,0,3
"4010","3679新至陞","110/08/18","凱基-文心",0,6,-6
"4011","3679新至陞","110/08/18","聯邦-三重",3,0,3
"4012","3679新至陞","110/08/18","統一",0,5,-5
"4013","3679新至陞","110/08/18","土銀-台中",2,0,2
"4014","3679新至陞","110/08/18","元大-敦化",0,4,-4
"4015","3679新至陞","110/08/18","土銀-新竹",2,0,2
"4016","3679新至陞","110/08/18","日盛-文化",1,4,-3
"4017","3679新至陞","110/08/18","國泰-高雄",2,0,2
"4018","3679新至陞","110/08/18","彰銀",0,3,-3
"4019","3679新至陞","110/08/18","土銀-士林",1,0,1
"4020","3679新至陞","110/08/18","元富-大昌",0,3,-3
"4021","2727王品","110/08/18","凱基-台北",94,29,65
"4022","2727王品","110/08/18","港商麥格理",0,65,-65
"4023","2727王品","110/08/18","摩根大通",42,13,29
"4024","2727王品","110/08/18","華南永昌",1,39,-38
"4025","2727王品","110/08/18","彰銀-台中",27,0,27
"4026","2727王品","110/08/18","元富-板橋",1,16,-15
"4027","2727王品","110/08/18","瑞士信貸",18,3,15
"4028","2727王品","110/08/18","港商野村",66,79,-13
"4029","2727王品","110/08/18","凱基-埔墘",10,0,10
"4030","2727王品","110/08/18","第一金-桃園",0,11,-11
"4031","2727王品","110/08/18","富邦-建國",13,3,10
"4032","2727王品","110/08/18","元大-汐止",0,11,-11
"4033","2727王品","110/08/18","元大-學甲",10,0,10
"4034","2727王品","110/08/18","凱基-三峽",0,10,-10
"4035","2727王品","110/08/18","國泰-台中",28,19,9
"4036","2727王品","110/08/18","凱基-板橋",3,12,-9
"4037","2727王品","110/08/18","凱基-高美館",7,0,7
"4038","2727王品","110/08/18","凱基-林口",5,14,-9
"4039","2727王品","110/08/18","凱基-竹北",9,2,7
"4040","2727王品","110/08/18","富邦-中壢",2,11,-9
"4041","2727王品","110/08/18","元大-四維",7,0,7
"4042","2727王品","110/08/18","福勝",0,8,-8
"4043","2727王品","110/08/18","元大-敦南",8,1,7
"4044","2727王品","110/08/18","國泰-敦南",4,12,-8
"4045","2727王品","110/08/18","統一",19,13,6
"4046","2727王品","110/08/18","台新-三民",1,8,-7
"4047","2727王品","110/08/18","日盛-屏東",5,0,5
"4048","2727王品","110/08/18","華南永昌-林口",0,7,-7
"4049","2727王品","110/08/18","國泰-館前",6,1,5
"4050","2727王品","110/08/18","永豐金-內湖",0,7,-7
"4051","1570力肯","110/08/18","凱基-台北",129,5,124
"4052","1570力肯","110/08/18","華南永昌-桃園",0,102,-102
"4053","1570力肯","110/08/18","香港上海匯豐",36,0,36
"4054","1570力肯","110/08/18","中國信託-高雄",0,49,-49
"4055","1570力肯","110/08/18","統一",30,0,30
"4056","1570力肯","110/08/18","元富-世貿",0,20,-20
"4057","1570力肯","110/08/18","群益金鼎-北高雄",27,0,27
"4058","1570力肯","110/08/18","國泰證券",0,20,-20
"4059","1570力肯","110/08/18","國票-北高雄",21,3,18
"4060","1570力肯","110/08/18","元大-屏南",0,15,-15
"4061","1570力肯","110/08/18","元大-南投",20,4,16
"4062","1570力肯","110/08/18","元大-和平",5,20,-15
"4063","1570力肯","110/08/18","新光-台南",15,0,15
"4064","1570力肯","110/08/18","元大-基隆",0,12,-12
"4065","1570力肯","110/08/18","富邦-高雄",15,0,15
"4066","1570力肯","110/08/18","玉山-台中",0,10,-10
"4067","1570力肯","110/08/18","華南永昌-嘉義",12,0,12
"4068","1570力肯","110/08/18","元大-苗栗",0,10,-10
"4069","1570力肯","110/08/18","富邦-花蓮",10,0,10
"4070","1570力肯","110/08/18","元大-草屯",0,10,-10
"4071","1570力肯","110/08/18","元富-新店",10,2,8
"4072","1570力肯","110/08/18","富邦-彰化",0,8,-8
"4073","1570力肯","110/08/18","富邦-台東",12,4,8
"4074","1570力肯","110/08/18","日盛-嘉義",0,7,-7
"4075","1570力肯","110/08/18","日盛-高雄",7,0,7
"4076","1570力肯","110/08/18","永豐金-桃園",3,10,-7
"4077","1570力肯","110/08/18","元大-羅東",7,0,7
"4078","1570力肯","110/08/18","大昌-安康",0,6,-6
"4079","1570力肯","110/08/18","大慶-蘆洲",9,3,6
"4080","1570力肯","110/08/18","國票-和平",0,6,-6
"4081","6180橘子","110/08/18","美林",40,0,40
"4082","6180橘子","110/08/18","香港上海匯豐",0,102,-102
"4083","6180橘子","110/08/18","新加坡商瑞銀",23,1,22
"4084","6180橘子","110/08/18","台灣摩根士丹利",2,73,-71
"4085","6180橘子","110/08/18","凱基-基隆",18,2,16
"4086","6180橘子","110/08/18","美商高盛",1,31,-30
"4087","6180橘子","110/08/18","華南永昌-虎尾",15,0,15
"4088","6180橘子","110/08/18","凱基-市政",1,25,-24
"4089","6180橘子","110/08/18","元富-城東",14,1,13
"4090","6180橘子","110/08/18","日盛-板橋",1,20,-19
"4091","6180橘子","110/08/18","富邦-台北",16,3,13
"4092","6180橘子","110/08/18","新光-高雄",1,14,-13
"4093","6180橘子","110/08/18","富邦-中壢",11,2,9
"4094","6180橘子","110/08/18","凱基-東門",2,15,-13
"4095","6180橘子","110/08/18","富邦-宜蘭",9,0,9
"4096","6180橘子","110/08/18","元大-基隆孝二",0,12,-12
"4097","6180橘子","110/08/18","元大-前金",10,1,9
"4098","6180橘子","110/08/18","兆豐-三重",0,11,-11
"4099","6180橘子","110/08/18","中國信託",8,0,8
"4100","6180橘子","110/08/18","日盛證券",0,10,-10
"4101","6180橘子","110/08/18","元大-中壢",12,4,8
"4102","6180橘子","110/08/18","摩根大通",80,89,-9
"4103","6180橘子","110/08/18","凱基-大直",7,0,7
"4104","6180橘子","110/08/18","新光",9,18,-9
"4105","6180橘子","110/08/18","元大證券",9,2,7
"4106","6180橘子","110/08/18","富邦-南屯",0,9,-9
"4107","6180橘子","110/08/18","大慶-楊梅",6,0,6
"4108","6180橘子","110/08/18","元大-板橋三民",0,9,-9
"4109","6180橘子","110/08/18","華南永昌",7,1,6
"4110","6180橘子","110/08/18","元大-桃園",2,11,-9
"4111","2390云辰","110/08/18","兆豐-公益",192,31,161
"4112","2390云辰","110/08/18","摩根大通",1314,1582,-268
"4113","2390云辰","110/08/18","元大-土城學府",406,260,146
"4114","2390云辰","110/08/18","凱基-台北",727,962,-235
"4115","2390云辰","110/08/18","群益金鼎-敦南",106,4,102
"4116","2390云辰","110/08/18","國泰-桃園",53,264,-211
"4117","2390云辰","110/08/18","元大-竹科",136,36,100
"4118","2390云辰","110/08/18","富邦-內湖",0,201,-201
"4119","2390云辰","110/08/18","元大-館前",151,52,99
"4120","2390云辰","110/08/18","元大-復北",5,193,-188
"4121","2390云辰","110/08/18","日盛-園區",128,46,82
"4122","2390云辰","110/08/18","凱基-民權",2,160,-158
"4123","2390云辰","110/08/18","元大-東泰",84,9,75
"4124","2390云辰","110/08/18","國票-安和",98,231,-133
"4125","2390云辰","110/08/18","福勝",68,8,60
"4126","2390云辰","110/08/18","新加坡商瑞銀",102,225,-123
"4127","2390云辰","110/08/18","宏遠-光隆",73,14,59
"4128","2390云辰","110/08/18","港商野村",1128,1238,-110
"4129","2390云辰","110/08/18","元富",66,10,56
"4130","2390云辰","110/08/18","台灣摩根士丹利",3,100,-97
"4131","2390云辰","110/08/18","華南永昌-合泰",54,1,53
"4132","2390云辰","110/08/18","永豐金-嘉義",4,97,-93
"4133","2390云辰","110/08/18","凱基-中港",60,9,51
"4134","2390云辰","110/08/18","統一-城中",57,147,-90
"4135","2390云辰","110/08/18","第一金-忠孝",54,5,49
"4136","2390云辰","110/08/18","富邦-彰化",47,128,-81
"4137","2390云辰","110/08/18","統一-新台中",140,91,49
"4138","2390云辰","110/08/18","美林",341,412,-71
"4139","2390云辰","110/08/18","群益金鼎-台中",53,6,47
"4140","2390云辰","110/08/18","新光",312,382,-70
"4141","2609陽明","110/08/17","兆豐-中壢",5227,708,4519
"4142","2609陽明","110/08/17","康和",48,4865,-4817
"4143","2609陽明","110/08/17","凱基-台北",5969,1780,4189
"4144","2609陽明","110/08/17","永豐金-信義",84,2643,-2559
"4145","2609陽明","110/08/17","兆豐-三民",2114,136,1978
"4146","2609陽明","110/08/17","凱基-虎尾",487,2286,-1799
"4147","2609陽明","110/08/17","兆豐-復興",3638,1682,1956
"4148","2609陽明","110/08/17","港商野村",1127,2155,-1028
"4149","2609陽明","110/08/17","台灣摩根士丹利",2505,858,1647
"4150","2609陽明","110/08/17","兆豐-虎尾",1846,2756,-910
"4151","2609陽明","110/08/17","日盛-板橋",1734,262,1472
"4152","2609陽明","110/08/17","富邦-嘉義",7219,8100,-881
"4153","2609陽明","110/08/17","美林",3468,2882,586
"4154","2609陽明","110/08/17","元大-頭份",78,810,-732
"4155","2609陽明","110/08/17","香港上海匯豐",593,100,493
"4156","2609陽明","110/08/17","摩根大通",1422,2133,-711
"4157","2609陽明","110/08/17","統一-土城",366,14,352
"4158","2609陽明","110/08/17","元大-永春",281,971,-690
"4159","2609陽明","110/08/17","統一-敦南",899,577,322
"4160","2609陽明","110/08/17","宏遠證券",948,1614,-666
"4161","2609陽明","110/08/17","富邦-桃園",413,123,290
"4162","2609陽明","110/08/17","凱基-竹東",20,668,-648
"4163","2609陽明","110/08/17","日盛-中壢",537,256,281
"4164","2609陽明","110/08/17","元大證券",1377,2001,-624
"4165","2609陽明","110/08/17","兆豐-板橋",545,318,227
"4166","2609陽明","110/08/17","元富-新店",74,549,-475
"4167","2609陽明","110/08/17","凱基-桃園",367,142,225
"4168","2609陽明","110/08/17","華南永昌-楠梓",73,486,-413
"4169","2609陽明","110/08/17","統一-城中",390,169,221
"4170","2609陽明","110/08/17","臺銀",286,681,-395
"4171","2636台驊投控","110/08/17","元富-文心",272,9,263
"4172","2636台驊投控","110/08/17","凱基-彰化",0,689,-689
"4173","2636台驊投控","110/08/17","日盛-大墩",185,19,166
"4174","2636台驊投控","110/08/17","摩根大通",347,761,-414
"4175","2636台驊投控","110/08/17","第一金-桃園",147,26,121
"4176","2636台驊投控","110/08/17","富邦-花蓮",106,366,-260
"4177","2636台驊投控","110/08/17","元富-大昌",84,15,69
"4178","2636台驊投控","110/08/17","凱基-台北",395,566,-171
"4179","2636台驊投控","110/08/17","新光",258,192,66
"4180","2636台驊投控","110/08/17","大慶",15,175,-160
"4181","2636台驊投控","110/08/17","統一-新台中",64,4,60
"4182","2636台驊投控","110/08/17","統一",111,247,-136
"4183","2636台驊投控","110/08/17","華南永昌-竹北",308,252,56
"4184","2636台驊投控","110/08/17","富邦證券",0,134,-134
"4185","2636台驊投控","110/08/17","日盛-木柵",60,8,52
"4186","2636台驊投控","110/08/17","富邦-虎尾",294,414,-120
"4187","2636台驊投控","110/08/17","國泰-敦南",335,283,52
"4188","2636台驊投控","110/08/17","元大-士林",4,114,-110
"4189","2636台驊投控","110/08/17","美商高盛",96,54,42
"4190","2636台驊投控","110/08/17","美林",320,401,-81
"4191","2636台驊投控","110/08/17","凱基-市政",60,22,38
"4192","2636台驊投控","110/08/17","瑞士信貸",62,134,-72
"4193","2636台驊投控","110/08/17","元大-龍潭",50,13,37
"4194","2636台驊投控","110/08/17","兆豐-東門",70,140,-70
"4195","2636台驊投控","110/08/17","國票-九鼎",50,16,34
"4196","2636台驊投控","110/08/17","凱基-高美館",89,158,-69
"4197","2636台驊投控","110/08/17","元大-東門",37,3,34
"4198","2636台驊投控","110/08/17","日盛證券",103,170,-67
"4199","2636台驊投控","110/08/17","富邦-三重",33,1,32
"4200","2636台驊投控","110/08/17","宏遠-桃園",4,44,-40
"4201","2867三商壽","110/08/17","摩根大通",670,119,551
"4202","2867三商壽","110/08/17","玉山-左營",10,1173,-1163
"4203","2867三商壽","110/08/17","元富-世貿",288,0,288
"4204","2867三商壽","110/08/17","華南永昌",50,736,-686
"4205","2867三商壽","110/08/17","日盛-中和",276,10,266
"4206","2867三商壽","110/08/17","台灣摩根士丹利",37,195,-158
"4207","2867三商壽","110/08/17","新光-台中",243,7,236
"4208","2867三商壽","110/08/17","兆豐-北高雄",0,135,-135
"4209","2867三商壽","110/08/17","台新-台中",198,1,197
"4210","2867三商壽","110/08/17","宏遠證券",9,141,-132
"4211","2867三商壽","110/08/17","華南永昌-長虹",136,0,136
"4212","2867三商壽","110/08/17","永豐金-市政",0,115,-115
"4213","2867三商壽","110/08/17","美林",137,2,135
"4214","2867三商壽","110/08/17","兆豐-新竹",0,113,-113
"4215","2867三商壽","110/08/17","元大-土城永寧",100,1,99
"4216","2867三商壽","110/08/17","永豐金證券",0,82,-82
"4217","2867三商壽","110/08/17","國泰-台中",99,2,97
"4218","2867三商壽","110/08/17","元大-彰化民生",0,80,-80
"4219","2867三商壽","110/08/17","元富-古亭",100,4,96
"4220","2867三商壽","110/08/17","永豐金-中盛",4,77,-73
"4221","2867三商壽","110/08/17","合庫-西台中",80,0,80
"4222","2867三商壽","110/08/17","元富",0,70,-70
"4223","2867三商壽","110/08/17","新加坡商瑞銀",83,4,79
"4224","2867三商壽","110/08/17","宏遠-中和",10,57,-47
"4225","2867三商壽","110/08/17","永豐金-埔里",64,5,59
"4226","2867三商壽","110/08/17","富邦-嘉義",4,50,-46
"4227","2867三商壽","110/08/17","元富-緯城",50,0,50
"4228","2867三商壽","110/08/17","第一金-華江",0,30,-30
"4229","2867三商壽","110/08/17","台新-建北",49,0,49
"4230","2867三商壽","110/08/17","台新證券",2,32,-30
"4231","5521工信","110/08/17","元大-沙鹿",60,0,60
"4232","5521工信","110/08/17","摩根大通",75,227,-152
"4233","5521工信","110/08/17","群益金鼎-萬華",46,0,46
"4234","5521工信","110/08/17","凱基-台北",5,68,-63
"4235","5521工信","110/08/17","台新證券",37,1,36
"4236","5521工信","110/08/17","群益金鼎-敦南",0,60,-60
"4237","5521工信","110/08/17","華南永昌-竹北",31,0,31
"4238","5521工信","110/08/17","台灣摩根士丹利",5,64,-59
"4239","5521工信","110/08/17","元大-北投",30,0,30
"4240","5521工信","110/08/17","元富-古亭",0,40,-40
"4241","5521工信","110/08/17","元富-屏東",24,0,24
"4242","5521工信","110/08/17","台灣企銀-嘉義",0,35,-35
"4243","5521工信","110/08/17","富邦-台北",23,0,23
"4244","5521工信","110/08/17","美林",5,37,-32
"4245","5521工信","110/08/17","元大-屏南",23,0,23
"4246","5521工信","110/08/17","華南永昌",0,27,-27
"4247","5521工信","110/08/17","國泰-敦南",40,18,22
"4248","5521工信","110/08/17","華南永昌-潮州",0,25,-25
"4249","5521工信","110/08/17","兆豐-中壢",20,0,20
"4250","5521工信","110/08/17","台新-高雄",0,24,-24
"4251","5521工信","110/08/17","新光-台南",20,0,20
"4252","5521工信","110/08/17","大慶-楊梅",0,22,-22
"4253","5521工信","110/08/17","臺銀-鳳山",19,0,19
"4254","5521工信","110/08/17","凱基-桃園",0,20,-20
"4255","5521工信","110/08/17","日進",18,0,18
"4256","5521工信","110/08/17","元大-東蘆",0,20,-20
"4257","5521工信","110/08/17","永豐金-鳳山",17,0,17
"4258","5521工信","110/08/17","第一金-桃園",0,18,-18
"4259","5521工信","110/08/17","玉山證券",14,0,14
"4260","5521工信","110/08/17","新光-新竹",3,20,-17
"4261","1471首利","110/08/17","摩根大通",110,14,96
"4262","1471首利","110/08/17","元大-台南",0,54,-54
"4263","1471首利","110/08/17","臺銀-臺中",40,0,40
"4264","1471首利","110/08/17","高橋-龍潭",0,50,-50
"4265","1471首利","110/08/17","瑞士信貸",33,0,33
"4266","1471首利","110/08/17","元大-竹南",0,35,-35
"4267","1471首利","110/08/17","凱基-台北",30,6,24
"4268","1471首利","110/08/17","台新證券",1,31,-30
"4269","1471首利","110/08/17","元大-竹山",23,0,23
"4270","1471首利","110/08/17","國泰-敦南",7,33,-26
"4271","1471首利","110/08/17","大慶-蘆洲",14,0,14
"4272","1471首利","110/08/17","元大-西門",0,23,-23
"4273","1471首利","110/08/17","兆豐-員林",13,1,12
"4274","1471首利","110/08/17","元富-埔里",0,20,-20
"4275","1471首利","110/08/17","致和-府前",11,0,11
"4276","1471首利","110/08/17","富邦-台中",0,20,-20
"4277","1471首利","110/08/17","國票-彰化",11,0,11
"4278","1471首利","110/08/17","日茂",0,11,-11
"4279","1471首利","110/08/17","元富-新莊",10,0,10
"4280","1471首利","110/08/17","高橋",0,10,-10
"4281","1471首利","110/08/17","國票",10,0,10
"4282","1471首利","110/08/17","大昌-新店",0,10,-10
"4283","1471首利","110/08/17","富邦-永和",10,0,10
"4284","1471首利","110/08/17","元富-文心",1,10,-9
"4285","1471首利","110/08/17","元大-新莊",10,0,10
"4286","1471首利","110/08/17","凱基-雙和",0,8,-8
"4287","1471首利","110/08/17","元大-鹿港",10,0,10
"4288","1471首利","110/08/17","凱基-屏東",0,8,-8
"4289","1471首利","110/08/17","元大-清水",11,2,9
"4290","1471首利","110/08/17","日盛-永康",0,7,-7
"4291","2883開發金","110/08/17","中國信託-文心",3524,26,3498
"4292","2883開發金","110/08/17","新加坡商瑞銀",513,7792,-7279
"4293","2883開發金","110/08/17","元大證券",1912,297,1615
"4294","2883開發金","110/08/17","亞東-新竹",206,2692,-2486
"4295","2883開發金","110/08/17","摩根大通",4110,2504,1606
"4296","2883開發金","110/08/17","凱基-台北",2263,4277,-2014
"4297","2883開發金","110/08/17","美林",2099,733,1366
"4298","2883開發金","110/08/17","永豐金證券",103,1899,-1796
"4299","2883開發金","110/08/17","日盛證券",2406,1218,1188
"4300","2883開發金","110/08/17","華南永昌-苑裡",13,1229,-1216
"4301","2883開發金","110/08/17","國泰-館前",942,128,814
"4302","2883開發金","110/08/17","統一-新營",39,1202,-1163
"4303","2883開發金","110/08/17","元富-城中",808,6,802
"4304","2883開發金","110/08/17","兆豐-高雄",68,1153,-1085
"4305","2883開發金","110/08/17","港商法國興業",764,0,764
"4306","2883開發金","110/08/17","凱基-斗六",3,812,-809
"4307","2883開發金","110/08/17","元大-南屯",759,75,684
"4308","2883開發金","110/08/17","元大-四維",736,1467,-731
"4309","2883開發金","110/08/17","康和-仁愛",514,10,504
"4310","2883開發金","110/08/17","台新證券",682,1391,-709
"4311","2883開發金","110/08/17","新光",1403,910,493
"4312","2883開發金","110/08/17","凱基-豐中",7,617,-610
"4313","2883開發金","110/08/17","統一-汐止",489,5,484
"4314","2883開發金","110/08/17","土銀-嘉義",10,580,-570
"4315","2883開發金","110/08/17","永豐金-忠孝",650,206,444
"4316","2883開發金","110/08/17","港商麥格理",1131,1682,-551
"4317","2883開發金","110/08/17","港商野村",2803,2361,442
"4318","2883開發金","110/08/17","富邦-陽明",158,680,-522
"4319","2883開發金","110/08/17","元富-大裕",454,22,432
"4320","2883開發金","110/08/17","台灣摩根士丹利",2238,2750,-512
"4321","6205詮欣","110/08/17","日盛-三重",15,0,15
"4322","6205詮欣","110/08/17","元富-松德",0,10,-10
"4323","6205詮欣","110/08/17","臺銀-民權",5,0,5
"4324","6205詮欣","110/08/17","元富-安南",0,8,-8
"4325","6205詮欣","110/08/17","華南永昌-長虹",5,0,5
"4326","6205詮欣","110/08/17","元大-大雅",0,3,-3
"4327","6205詮欣","110/08/17","德信-新營",4,0,4
"4328","6205詮欣","110/08/17","兆豐-南門",0,3,-3
"4329","6205詮欣","110/08/17","凱基-汐止",4,0,4
"4330","6205詮欣","110/08/17","兆豐-南京",0,3,-3
"4331","6205詮欣","110/08/17","富邦-陽明",4,0,4
"4332","6205詮欣","110/08/17","元大-豐原",0,2,-2
"4333","6205詮欣","110/08/17","元大-汐止",4,0,4
"4334","6205詮欣","110/08/17","大昌",0,1,-1
"4335","6205詮欣","110/08/17","華南永昌-古亭",3,0,3
"4336","6205詮欣","110/08/17","永豐金-中正",0,1,-1
"4337","6205詮欣","110/08/17","凱基-台北",1,0,1
"4338","6205詮欣","110/08/17","大昌-安康",0,1,-1
"4339","6205詮欣","110/08/17","元大-鑫永和",1,0,1
"4340","6205詮欣","110/08/17","日盛-台中",0,1,-1
"4341","6205詮欣","110/08/17","統一-士林",0,0,0
"4342","6205詮欣","110/08/17","新百王",0,1,-1
"4343","6205詮欣","110/08/17","統一-南京",0,0,0
"4344","6205詮欣","110/08/17","元富-文心",0,1,-1
"4345","6205詮欣","110/08/17","國泰證券",0,0,0
"4346","6205詮欣","110/08/17","統一",0,1,-1
"4347","6205詮欣","110/08/17","華南永昌-高雄",0,0,0
"4348","6205詮欣","110/08/17","第一金-中壢",0,1,-1
"4349","6205詮欣","110/08/17","永豐金-中和",1,1,0
"4350","6205詮欣","110/08/17","大慶-基隆",0,1,-1
"4351","1540喬福","110/08/17","元大-松山",20,0,20
"4352","1540喬福","110/08/17","群益金鼎-館前",0,31,-31
"4353","1540喬福","110/08/17","凱基-中壢",17,0,17
"4354","1540喬福","110/08/17","日盛-文化",0,30,-30
"4355","1540喬福","110/08/17","元大-左營",11,0,11
"4356","1540喬福","110/08/17","兆豐-民生",0,17,-17
"4357","1540喬福","110/08/17","元富-文心",10,0,10
"4358","1540喬福","110/08/17","凱基-台北",0,5,-5
"4359","1540喬福","110/08/17","元大-土城永寧",10,0,10
"4360","1540喬福","110/08/17","國票-台中",0,3,-3
"4361","1540喬福","110/08/17","元大-成功",10,0,10
"4362","1540喬福","110/08/17","元大-大益",0,3,-3
"4363","1540喬福","110/08/17","富邦-板橋",6,0,6
"4364","1540喬福","110/08/17","致和-南京",0,2,-2
"4365","1540喬福","110/08/17","新光",4,0,4
"4366","1540喬福","110/08/17","國泰-館前",0,2,-2
"4367","1540喬福","110/08/17","亞東",2,0,2
"4368","1540喬福","110/08/17","富邦-陽明",0,2,-2
"4369","1540喬福","110/08/17","群益金鼎-新店",2,0,2
"4370","1540喬福","110/08/17","元大-龍潭",0,2,-2
"4371","1540喬福","110/08/17","日盛-員林",1,0,1
"4372","1540喬福","110/08/17","日盛-台中",0,1,-1
"4373","1540喬福","110/08/17","日盛-鳳山",1,0,1
"4374","1540喬福","110/08/17","美林",0,1,-1
"4375","1540喬福","110/08/17","統一-屏東",1,0,1
"4376","1540喬福","110/08/17","第一金-高雄",0,1,-1
"4377","1540喬福","110/08/17","元富-大昌",1,0,1
"4378","1540喬福","110/08/17","元富",1,2,-1
"4379","1540喬福","110/08/17","台新-高雄",1,0,1
"4380","1540喬福","110/08/17","新光-新竹",0,1,-1
"4381","2888新光金","110/08/17","華南永昌-岡山",6623,36,6587
"4382","2888新光金","110/08/17","元富-城東",11,13997,-13986
"4383","2888新光金","110/08/17","元大-忠孝鼎富",4976,0,4976
"4384","2888新光金","110/08/17","永豐金證券",19,2260,-2241
"4385","2888新光金","110/08/17","永豐金-萬盛",3955,15,3940
"4386","2888新光金","110/08/17","國票-博愛",0,2051,-2051
"4387","2888新光金","110/08/17","摩根大通",3699,247,3452
"4388","2888新光金","110/08/17","群益金鼎",0,1836,-1836
"4389","2888新光金","110/08/17","瑞士信貸",3064,605,2459
"4390","2888新光金","110/08/17","華南永昌",10,1624,-1614
"4391","2888新光金","110/08/17","凱基-大安",2179,2,2177
"4392","2888新光金","110/08/17","元大-大同",0,714,-714
"4393","2888新光金","110/08/17","國票-台東",1935,23,1912
"4394","2888新光金","110/08/17","安泰",0,598,-598
"4395","2888新光金","110/08/17","永豐金-信義",1497,5,1492
"4396","2888新光金","110/08/17","大昌",3,555,-552
"4397","2888新光金","110/08/17","國票-北投",1304,0,1304
"4398","2888新光金","110/08/17","福勝",3,510,-507
"4399","2888新光金","110/08/17","兆豐-松德",1251,0,1251
"4400","2888新光金","110/08/17","元大-太平",20,525,-505
"4401","2888新光金","110/08/17","花旗環球",1101,147,954
"4402","2888新光金","110/08/17","中國信託-三重",0,503,-503
"4403","2888新光金","110/08/17","港商法國興業",1031,180,851
"4404","2888新光金","110/08/17","台灣摩根士丹利",1136,1627,-491
"4405","2888新光金","110/08/17","凱基-站前",788,13,775
"4406","2888新光金","110/08/17","美林",141,604,-463
"4407","2888新光金","110/08/17","台灣匯立證券",763,0,763
"4408","2888新光金","110/08/17","群益金鼎-土城",0,415,-415
"4409","2888新光金","110/08/17","群益金鼎-崇德",735,3,732
"4410","2888新光金","110/08/17","凱基-台北",632,1033,-401
"4411","1340勝悅","110/08/17","國泰-台中",12,0,12
"4412","1340勝悅","110/08/17","永豐金-潮州",0,20,-20
"4413","1340勝悅","110/08/17","新光-新竹",10,0,10
"4414","1340勝悅","110/08/17","臺灣企銀-桃園",0,10,-10
"4415","1340勝悅","110/08/17","元富-成功",8,0,8
"4416","1340勝悅","110/08/17","瑞士信貸",0,6,-6
"4417","1340勝悅","110/08/17","臺灣企銀-埔墘",5,0,5
"4418","1340勝悅","110/08/17","玉山-桃園",0,5,-5
"4419","1340勝悅","110/08/17","華南永昌-敦南",5,0,5
"4420","1340勝悅","110/08/17","華南永昌-虎尾",0,5,-5
"4421","1340勝悅","110/08/17","富邦-新店",11,6,5
"4422","1340勝悅","110/08/17","永豐金-博愛",0,5,-5
"4423","1340勝悅","110/08/17","美商高盛",4,0,4
"4424","1340勝悅","110/08/17","日盛-永康",0,4,-4
"4425","1340勝悅","110/08/17","新光-桃園",3,0,3
"4426","1340勝悅","110/08/17","元富-世貿",0,4,-4
"4427","1340勝悅","110/08/17","日盛-八德",2,0,2
"4428","1340勝悅","110/08/17","摩根大通",2,6,-4
"4429","1340勝悅","110/08/17","凱基-基隆",2,0,2
"4430","1340勝悅","110/08/17","玉山-新莊",0,3,-3
"4431","1340勝悅","110/08/17","元大-松江",2,0,2
"4432","1340勝悅","110/08/17","國泰-敦南",5,8,-3
"4433","1340勝悅","110/08/17","元大-崇德",2,0,2
"4434","1340勝悅","110/08/17","富邦-桃園",0,3,-3
"4435","1340勝悅","110/08/17","國泰-館前",1,0,1
"4436","1340勝悅","110/08/17","元大-和平",0,3,-3
"4437","1340勝悅","110/08/17","群益金鼎-民權",1,0,1
"4438","1340勝悅","110/08/17","永豐金-南投",0,3,-3
"4439","1340勝悅","110/08/17","華南永昌-大安",1,0,1
"4440","1340勝悅","110/08/17","富邦-羅東",2,4,-2
"4441","6246臺龍","110/08/17","台新-三民",90,0,90
"4442","6246臺龍","110/08/17","日盛證券",0,52,-52
"4443","6246臺龍","110/08/17","港商野村",63,28,35
"4444","6246臺龍","110/08/17","凱基-幸福",0,10,-10
"4445","6246臺龍","110/08/17","台新證券",20,0,20
"4446","6246臺龍","110/08/17","元富-新店",0,9,-9
"4447","6246臺龍","110/08/17","凱基-信義",7,0,7
"4448","6246臺龍","110/08/17","凱基-科園",0,8,-8
"4449","6246臺龍","110/08/17","凱基-站前",5,0,5
"4450","6246臺龍","110/08/17","元富-世貿",0,7,-7
"4451","6246臺龍","110/08/17","合庫-嘉義",5,1,4
"4452","6246臺龍","110/08/17","兆豐-公益",0,7,-7
"4453","6246臺龍","110/08/17","元大-林園",10,6,4
"4454","6246臺龍","110/08/17","元大-東蘆",0,7,-7
"4455","6246臺龍","110/08/17","元大-永康",4,0,4
"4456","6246臺龍","110/08/17","群益金鼎-嘉義",0,6,-6
"4457","6246臺龍","110/08/17","元大-基隆孝二",4,0,4
"4458","6246臺龍","110/08/17","華南永昌-頭份",0,6,-6
"4459","6246臺龍","110/08/17","日盛-斗六",3,0,3
"4460","6246臺龍","110/08/17","元大-北港",0,5,-5
"4461","6246臺龍","110/08/17","永全",3,0,3
"4462","6246臺龍","110/08/17","日盛-和美",0,4,-4
"4463","6246臺龍","110/08/17","兆豐-景美",3,0,3
"4464","6246臺龍","110/08/17","國泰-敦南",1,5,-4
"4465","6246臺龍","110/08/17","台新-台中",3,0,3
"4466","6246臺龍","110/08/17","群益金鼎-新竹",0,4,-4
"4467","6246臺龍","110/08/17","元大-雙和",3,0,3
"4468","6246臺龍","110/08/17","凱基-台北",0,4,-4
"4469","6246臺龍","110/08/17","土銀",2,0,2
"4470","6246臺龍","110/08/17","元大-府城",0,4,-4
"4471","00715L期街口布蘭特正2","110/08/17","華南永昌-長虹",860,0,860
"4472","00715L期街口布蘭特正2","110/08/17","元大證券",78,4339,-4261
"4473","00715L期街口布蘭特正2","110/08/17","永豐金-台中",823,20,803
"4474","00715L期街口布蘭特正2","110/08/17","元富",2,3940,-3938
"4475","00715L期街口布蘭特正2","110/08/17","日盛-和美",595,0,595
"4476","00715L期街口布蘭特正2","110/08/17","永豐金證券",41,1048,-1007
"4477","00715L期街口布蘭特正2","110/08/17","第一金-豐原",420,0,420
"4478","00715L期街口布蘭特正2","110/08/17","統一-桃園",5,850,-845
"4479","00715L期街口布蘭特正2","110/08/17","元大-前金",419,0,419
"4480","00715L期街口布蘭特正2","110/08/17","富邦證券",258,1081,-823
"4481","00715L期街口布蘭特正2","110/08/17","華南永昌-台中",419,5,414
"4482","00715L期街口布蘭特正2","110/08/17","元大-台中",9,534,-525
"4483","00715L期街口布蘭特正2","110/08/17","元大-北三重",403,0,403
"4484","00715L期街口布蘭特正2","110/08/17","合庫-高雄",10,310,-300
"4485","00715L期街口布蘭特正2","110/08/17","日盛-新莊",375,0,375
"4486","00715L期街口布蘭特正2","110/08/17","港商野村",1,240,-239
"4487","00715L期街口布蘭特正2","110/08/17","富邦-基隆",310,0,310
"4488","00715L期街口布蘭特正2","110/08/17","群益金鼎-民權",2,208,-206
"4489","00715L期街口布蘭特正2","110/08/17","臺銀-新竹",311,10,301
"4490","00715L期街口布蘭特正2","110/08/17","元大-大里德芳",1,200,-199
"4491","00715L期街口布蘭特正2","110/08/17","元富-中港",300,0,300
"4492","00715L期街口布蘭特正2","110/08/17","元大-中和",1,187,-186
"4493","00715L期街口布蘭特正2","110/08/17","新光",368,82,286
"4494","00715L期街口布蘭特正2","110/08/17","康和",0,133,-133
"4495","00715L期街口布蘭特正2","110/08/17","中國信託-新竹",263,0,263
"4496","00715L期街口布蘭特正2","110/08/17","永豐金-板新",25,150,-125
"4497","00715L期街口布蘭特正2","110/08/17","台中銀",253,0,253
"4498","00715L期街口布蘭特正2","110/08/17","兆豐-桃鶯",6,110,-104
"4499","00715L期街口布蘭特正2","110/08/17","統一-台中",230,0,230
"4500","00715L期街口布蘭特正2","110/08/17","凱基-大直",2,100,-98
"4501","8941關中","110/08/17","宏遠-館前",4,0,4
"4502","8941關中","110/08/17","凱基-高美館",0,1,-1
"4503","8941關中","110/08/17","",NA,NA,NA
"4504","8941關中","110/08/17","凱基-台北",0,1,-1
"4505","8941關中","110/08/17","",NA,NA,NA
"4506","8941關中","110/08/17","元大-南投",0,1,-1
"4507","8941關中","110/08/17","",NA,NA,NA
"4508","8941關中","110/08/17","元大-華山",0,1,-1
"4509","8941關中","110/08/17","",NA,NA,NA
"4510","8941關中","110/08/17","",NA,NA,NA
"4511","8941關中","110/08/17","",NA,NA,NA
"4512","8941關中","110/08/17","",NA,NA,NA
"4513","8941關中","110/08/17","",NA,NA,NA
"4514","8941關中","110/08/17","",NA,NA,NA
"4515","8941關中","110/08/17","",NA,NA,NA
"4516","8941關中","110/08/17","",NA,NA,NA
"4517","8941關中","110/08/17","",NA,NA,NA
"4518","8941關中","110/08/17","",NA,NA,NA
"4519","8941關中","110/08/17","",NA,NA,NA
"4520","8941關中","110/08/17","",NA,NA,NA
"4521","8941關中","110/08/17","",NA,NA,NA
"4522","8941關中","110/08/17","",NA,NA,NA
"4523","8941關中","110/08/17","",NA,NA,NA
"4524","8941關中","110/08/17","",NA,NA,NA
"4525","8941關中","110/08/17","",NA,NA,NA
"4526","8941關中","110/08/17","",NA,NA,NA
"4527","8941關中","110/08/17","",NA,NA,NA
"4528","8941關中","110/08/17","",NA,NA,NA
"4529","8941關中","110/08/17","",NA,NA,NA
"4530","8941關中","110/08/17","",NA,NA,NA
"4531","8936國統","110/08/17","台新-高雄",511,7,504
"4532","8936國統","110/08/17","凱基-高美館",20,157,-137
"4533","8936國統","110/08/17","美林",60,0,60
"4534","8936國統","110/08/17","台灣摩根士丹利",7,56,-49
"4535","8936國統","110/08/17","台中銀-高雄",33,0,33
"4536","8936國統","110/08/17","永豐金-大園",5,52,-47
"4537","8936國統","110/08/17","摩根大通",71,39,32
"4538","8936國統","110/08/17","新光-台中",16,60,-44
"4539","8936國統","110/08/17","元大-豐原站前",30,0,30
"4540","8936國統","110/08/17","國泰-敦南",14,44,-30
"4541","8936國統","110/08/17","第一金-新興",25,0,25
"4542","8936國統","110/08/17","港商野村",41,64,-23
"4543","8936國統","110/08/17","凱基-台北",45,24,21
"4544","8936國統","110/08/17","凱基-站前",0,20,-20
"4545","8936國統","110/08/17","日盛-忠孝",20,0,20
"4546","8936國統","110/08/17","國泰-高雄",3,20,-17
"4547","8936國統","110/08/17","日盛-高雄",15,0,15
"4548","8936國統","110/08/17","富邦-嘉義",0,17,-17
"4549","8936國統","110/08/17","新加坡商瑞銀",66,53,13
"4550","8936國統","110/08/17","元大-敦化",0,17,-17
"4551","8936國統","110/08/17","玉山-台南",14,3,11
"4552","8936國統","110/08/17","統一-台中",0,15,-15
"4553","8936國統","110/08/17","日盛-斗六",10,0,10
"4554","8936國統","110/08/17","兆豐-高雄",0,15,-15
"4555","8936國統","110/08/17","統一-新營",10,0,10
"4556","8936國統","110/08/17","陽信-石牌",0,15,-15
"4557","8936國統","110/08/17","元富-三重",15,5,10
"4558","8936國統","110/08/17","元大-文心",0,15,-15
"4559","8936國統","110/08/17","群益金鼎-台中",10,0,10
"4560","8936國統","110/08/17","美商高盛",8,22,-14
"4561","6226光鼎","110/08/17","國泰-台中",693,66,627
"4562","6226光鼎","110/08/17","美商高盛",21,669,-648
"4563","6226光鼎","110/08/17","摩根大通",453,306,147
"4564","6226光鼎","110/08/17","凱基-台北",116,705,-589
"4565","6226光鼎","110/08/17","日盛-員林",105,1,104
"4566","6226光鼎","110/08/17","第一金-大稻埕",101,627,-526
"4567","6226光鼎","110/08/17","永豐金-南投",80,0,80
"4568","6226光鼎","110/08/17","瑞士信貸",0,356,-356
"4569","6226光鼎","110/08/17","宏遠-光隆",60,0,60
"4570","6226光鼎","110/08/17","美林",48,202,-154
"4571","6226光鼎","110/08/17","元大-員林中山",52,0,52
"4572","6226光鼎","110/08/17","新光",74,175,-101
"4573","6226光鼎","110/08/17","合庫-鳳山",54,4,50
"4574","6226光鼎","110/08/17","元大-北屯",1,101,-100
"4575","6226光鼎","110/08/17","元大-福營",51,5,46
"4576","6226光鼎","110/08/17","台新-屏東",0,70,-70
"4577","6226光鼎","110/08/17","凱基-市府",46,4,42
"4578","6226光鼎","110/08/17","永豐金-南京",6,74,-68
"4579","6226光鼎","110/08/17","兆豐-永和",41,1,40
"4580","6226光鼎","110/08/17","元大-西螺",2,55,-53
"4581","6226光鼎","110/08/17","凱基-永和",40,1,39
"4582","6226光鼎","110/08/17","統一-基隆",0,50,-50
"4583","6226光鼎","110/08/17","元大-敦化",38,0,38
"4584","6226光鼎","110/08/17","永豐金-板橋",2,46,-44
"4585","6226光鼎","110/08/17","凱基-中山",42,5,37
"4586","6226光鼎","110/08/17","元大-草屯",2,33,-31
"4587","6226光鼎","110/08/17","國泰-桃園",131,97,34
"4588","6226光鼎","110/08/17","元大-西門",0,28,-28
"4589","6226光鼎","110/08/17","富邦-台北",55,21,34
"4590","6226光鼎","110/08/17","凱基-屏東",1,27,-26
"4591","2363矽統","110/08/17","第一金-高雄",356,4,352
"4592","2363矽統","110/08/17","瑞士信貸",86,1495,-1409
"4593","2363矽統","110/08/17","元富-永和",241,5,236
"4594","2363矽統","110/08/17","凱基-台北",737,1867,-1130
"4595","2363矽統","110/08/17","凱基-高美館",254,23,231
"4596","2363矽統","110/08/17","台灣摩根士丹利",0,438,-438
"4597","2363矽統","110/08/17","台新證券",511,295,216
"4598","2363矽統","110/08/17","元富-城東",13,409,-396
"4599","2363矽統","110/08/17","土銀-士林",189,0,189
"4600","2363矽統","110/08/17","(牛牛牛)亞-鑫豐",24,247,-223
"4601","2363矽統","110/08/17","永豐金-天母",155,0,155
"4602","2363矽統","110/08/17","美林",97,274,-177
"4603","2363矽統","110/08/17","玉山-台中",301,164,137
"4604","2363矽統","110/08/17","凱基-長庚",11,134,-123
"4605","2363矽統","110/08/17","凱基-竹北",122,5,117
"4606","2363矽統","110/08/17","元富-新店",4,115,-111
"4607","2363矽統","110/08/17","群益金鼎-三民",115,8,107
"4608","2363矽統","110/08/17","元大-北成功",142,237,-95
"4609","2363矽統","110/08/17","港商野村",1447,1350,97
"4610","2363矽統","110/08/17","日盛-木柵",70,160,-90
"4611","2363矽統","110/08/17","永豐金-新竹",105,20,85
"4612","2363矽統","110/08/17","摩根大通",240,322,-82
"4613","2363矽統","110/08/17","永豐金-松山",77,0,77
"4614","2363矽統","110/08/17","第一金-新竹",266,342,-76
"4615","2363矽統","110/08/17","富邦-宜蘭",84,11,73
"4616","2363矽統","110/08/17","華南永昌-岡山",42,110,-68
"4617","2363矽統","110/08/17","永豐金-南投",72,1,71
"4618","2363矽統","110/08/17","康和",48,112,-64
"4619","2363矽統","110/08/17","富邦-仁愛",90,22,68
"4620","2363矽統","110/08/17","華南永昌-楠梓",30,90,-60
"4621","8112至上","110/08/17","港商麥格理",158,0,158
"4622","8112至上","110/08/17","瑞士信貸",0,249,-249
"4623","8112至上","110/08/17","凱基-台北",177,49,128
"4624","8112至上","110/08/17","摩根大通",56,233,-177
"4625","8112至上","110/08/17","德信",120,0,120
"4626","8112至上","110/08/17","新加坡商瑞銀",19,179,-160
"4627","8112至上","110/08/17","台新證券",116,19,97
"4628","8112至上","110/08/17","富邦-仁愛",13,141,-128
"4629","8112至上","110/08/17","合庫-台中",75,2,73
"4630","8112至上","110/08/17","凱基-復興",1,108,-107
"4631","8112至上","110/08/17","美林",79,10,69
"4632","8112至上","110/08/17","台灣摩根士丹利",0,101,-101
"4633","8112至上","110/08/17","統一",46,0,46
"4634","8112至上","110/08/17","香港上海匯豐",0,96,-96
"4635","8112至上","110/08/17","群益金鼎-瑞豐",40,0,40
"4636","8112至上","110/08/17","群益金鼎-基隆",1,70,-69
"4637","8112至上","110/08/17","臺銀-金山",37,0,37
"4638","8112至上","110/08/17","日盛-花蓮",0,52,-52
"4639","8112至上","110/08/17","新光-高雄",37,4,33
"4640","8112至上","110/08/17","國票-北高雄",0,50,-50
"4641","8112至上","110/08/17","臺銀",41,15,26
"4642","8112至上","110/08/17","永豐金-新竹",0,48,-48
"4643","8112至上","110/08/17","元大證券",27,2,25
"4644","8112至上","110/08/17","日進",0,45,-45
"4645","8112至上","110/08/17","元大-內湖",24,0,24
"4646","8112至上","110/08/17","大展",0,30,-30
"4647","8112至上","110/08/17","國票-天祥",23,0,23
"4648","8112至上","110/08/17","港商野村",30,52,-22
"4649","8112至上","110/08/17","元大-土城永寧",23,0,23
"4650","8112至上","110/08/17","凱基-市府",1,21,-20
"4651","1570力肯","110/08/17","元大-南投",88,1,87
"4652","1570力肯","110/08/17","富邦-仁愛",0,42,-42
"4653","1570力肯","110/08/17","群益金鼎-高雄",51,10,41
"4654","1570力肯","110/08/17","元富-新竹",0,30,-30
"4655","1570力肯","110/08/17","凱基-台北",47,7,40
"4656","1570力肯","110/08/17","元大-新盛",2,28,-26
"4657","1570力肯","110/08/17","統一",29,4,25
"4658","1570力肯","110/08/17","凱基-台南",0,20,-20
"4659","1570力肯","110/08/17","元大-大雅",25,0,25
"4660","1570力肯","110/08/17","日盛-復興",0,15,-15
"4661","1570力肯","110/08/17","台新證券",24,10,14
"4662","1570力肯","110/08/17","元大-前金",1,15,-14
"4663","1570力肯","110/08/17","元大證券",14,0,14
"4664","1570力肯","110/08/17","元大-北成功",0,14,-14
"4665","1570力肯","110/08/17","日盛-板橋",12,0,12
"4666","1570力肯","110/08/17","臺銀-臺南",0,11,-11
"4667","1570力肯","110/08/17","元大-鑫永和",11,0,11
"4668","1570力肯","110/08/17","凱基-彰化",0,11,-11
"4669","1570力肯","110/08/17","富邦-內湖",10,0,10
"4670","1570力肯","110/08/17","合庫-桃園",0,10,-10
"4671","1570力肯","110/08/17","元富-緯城",10,1,9
"4672","1570力肯","110/08/17","凱基-南崁",0,10,-10
"4673","1570力肯","110/08/17","元大-開元",10,2,8
"4674","1570力肯","110/08/17","凱基-台中",0,9,-9
"4675","1570力肯","110/08/17","元大-桃興",8,1,7
"4676","1570力肯","110/08/17","華南永昌-嘉義",0,8,-8
"4677","1570力肯","110/08/17","日盛-員林",6,0,6
"4678","1570力肯","110/08/17","元大-鹿港",1,9,-8
"4679","1570力肯","110/08/17","陽信",5,0,5
"4680","1570力肯","110/08/17","國票-中正",0,7,-7
"4681","2929淘帝","110/08/17","元大-太平",48,0,48
"4682","2929淘帝","110/08/17","華南永昌-苗栗",0,30,-30
"4683","2929淘帝","110/08/17","永豐金-敦南",22,0,22
"4684","2929淘帝","110/08/17","兆豐-復興",0,15,-15
"4685","2929淘帝","110/08/17","永興",12,0,12
"4686","2929淘帝","110/08/17","凱基-長庚",0,13,-13
"4687","2929淘帝","110/08/17","日盛-復興",10,0,10
"4688","2929淘帝","110/08/17","美林",1,13,-12
"4689","2929淘帝","110/08/17","第一金-大稻埕",10,0,10
"4690","2929淘帝","110/08/17","永豐金-豐原",0,10,-10
"4691","2929淘帝","110/08/17","華南永昌-長虹",10,0,10
"4692","2929淘帝","110/08/17","華南永昌-高雄",1,10,-9
"4693","2929淘帝","110/08/17","元大-高雄",8,0,8
"4694","2929淘帝","110/08/17","日盛-南京",0,8,-8
"4695","2929淘帝","110/08/17","港商野村",12,5,7
"4696","2929淘帝","110/08/17","兆豐-大同",0,7,-7
"4697","2929淘帝","110/08/17","亞東-板橋",7,0,7
"4698","2929淘帝","110/08/17","摩根大通",0,6,-6
"4699","2929淘帝","110/08/17","國票-北高雄",6,0,6
"4700","2929淘帝","110/08/17","凱基-台中",0,5,-5
"4701","2929淘帝","110/08/17","國票-九鼎",6,0,6
"4702","2929淘帝","110/08/17","元大-鶯歌",0,5,-5
"4703","2929淘帝","110/08/17","亞東-新竹",5,0,5
"4704","2929淘帝","110/08/17","元大-上新莊",0,5,-5
"4705","2929淘帝","110/08/17","新加坡商瑞銀",4,0,4
"4706","2929淘帝","110/08/17","元大-北三重",0,5,-5
"4707","2929淘帝","110/08/17","凱基-中山",6,2,4
"4708","2929淘帝","110/08/17","第一金-澎湖",4,8,-4
"4709","2929淘帝","110/08/17","富邦-南屯",4,0,4
"4710","2929淘帝","110/08/17","日進",1,5,-4
"4711","5410國眾","110/08/17","元大-博愛",50,3,47
"4712","5410國眾","110/08/17","瑞士信貸",0,61,-61
"4713","5410國眾","110/08/17","土銀-嘉義",38,0,38
"4714","5410國眾","110/08/17","新光",3,41,-38
"4715","5410國眾","110/08/17","國票-北高雄",20,0,20
"4716","5410國眾","110/08/17","凱基-台南",2,30,-28
"4717","5410國眾","110/08/17","凱基-台北",37,22,15
"4718","5410國眾","110/08/17","元富-基隆",0,21,-21
"4719","5410國眾","110/08/17","兆豐-永和",14,0,14
"4720","5410國眾","110/08/17","富邦-新竹",1,16,-15
"4721","5410國眾","110/08/17","富邦-台北",22,10,12
"4722","5410國眾","110/08/17","亞東-新竹",0,14,-14
"4723","5410國眾","110/08/17","元大-中壢",12,0,12
"4724","5410國眾","110/08/17","群益金鼎-新竹",1,15,-14
"4725","5410國眾","110/08/17","摩根大通",25,14,11
"4726","5410國眾","110/08/17","富邦-永和",1,14,-13
"4727","5410國眾","110/08/17","日盛-花蓮",10,0,10
"4728","5410國眾","110/08/17","元大-新竹經國",0,12,-12
"4729","5410國眾","110/08/17","元富-同大",11,1,10
"4730","5410國眾","110/08/17","群益金鼎-三民",0,11,-11
"4731","5410國眾","110/08/17","凱基-科園",10,0,10
"4732","5410國眾","110/08/17","寶盛",0,10,-10
"4733","5410國眾","110/08/17","元大-潮州",10,0,10
"4734","5410國眾","110/08/17","永豐金-板橋",0,10,-10
"4735","5410國眾","110/08/17","台新-左楠",10,1,9
"4736","5410國眾","110/08/17","永豐金-竹科",1,11,-10
"4737","5410國眾","110/08/17","群益金鼎-古亭",14,5,9
"4738","5410國眾","110/08/17","臺銀",1,9,-8
"4739","5410國眾","110/08/17","永豐金-萬盛",9,0,9
"4740","5410國眾","110/08/17","群益金鼎-南京",0,8,-8
"4741","2841台開","110/08/17","宏遠-館前",169,2,167
"4742","2841台開","110/08/17","光和-溪湖",0,120,-120
"4743","2841台開","110/08/17","第一金",54,0,54
"4744","2841台開","110/08/17","兆豐-台南",0,109,-109
"4745","2841台開","110/08/17","台新-三民",50,0,50
"4746","2841台開","110/08/17","永豐金-台南",0,50,-50
"4747","2841台開","110/08/17","日盛證券",52,24,28
"4748","2841台開","110/08/17","兆豐-高雄",0,38,-38
"4749","2841台開","110/08/17","華南永昌-台中",20,0,20
"4750","2841台開","110/08/17","元大-林園",0,30,-30
"4751","2841台開","110/08/17","永豐金-中盛",17,0,17
"4752","2841台開","110/08/17","兆豐-台中",0,20,-20
"4753","2841台開","110/08/17","日盛-台中",15,0,15
"4754","2841台開","110/08/17","元大-敦化",0,20,-20
"4755","2841台開","110/08/17","日盛-園區",15,0,15
"4756","2841台開","110/08/17","元大-彰化民生",2,21,-19
"4757","2841台開","110/08/17","國泰-館前",15,0,15
"4758","2841台開","110/08/17","凱基-彰化",1,14,-13
"4759","2841台開","110/08/17","日盛-大墩",10,0,10
"4760","2841台開","110/08/17","元大-大灣",0,13,-13
"4761","2841台開","110/08/17","大慶-蘆洲",10,0,10
"4762","2841台開","110/08/17","元大-鹿港",0,11,-11
"4763","2841台開","110/08/17","凱基-員林",10,0,10
"4764","2841台開","110/08/17","兆豐-公益",0,10,-10
"4765","2841台開","110/08/17","富邦-基隆",10,0,10
"4766","2841台開","110/08/17","元大-北三重",0,10,-10
"4767","2841台開","110/08/17","元大-新竹經國",10,0,10
"4768","2841台開","110/08/17","華南永昌-鳳山",0,7,-7
"4769","2841台開","110/08/17","元富-成功",8,0,8
"4770","2841台開","110/08/17","元大-南海",0,7,-7
"4771","6207雷科","110/08/17","台新-高雄",82,2,80
"4772","6207雷科","110/08/17","第一金-員林",0,60,-60
"4773","6207雷科","110/08/17","凱基-台北",42,16,26
"4774","6207雷科","110/08/17","元大-高雄",0,47,-47
"4775","6207雷科","110/08/17","摩根大通",26,5,21
"4776","6207雷科","110/08/17","凱基-復興",0,20,-20
"4777","6207雷科","110/08/17","安泰",20,0,20
"4778","6207雷科","110/08/17","元大-新盛",1,20,-19
"4779","6207雷科","110/08/17","富邦-中壢",20,0,20
"4780","6207雷科","110/08/17","元富-大昌",0,12,-12
"4781","6207雷科","110/08/17","新加坡商瑞銀",23,6,17
"4782","6207雷科","110/08/17","華南永昌-岡山",1,12,-11
"4783","6207雷科","110/08/17","日盛-桃園",10,0,10
"4784","6207雷科","110/08/17","日盛-板橋",0,10,-10
"4785","6207雷科","110/08/17","兆豐-西螺",10,0,10
"4786","6207雷科","110/08/17","凱基-中壢",0,10,-10
"4787","6207雷科","110/08/17","中國信託-高雄",8,0,8
"4788","6207雷科","110/08/17","港商野村",7,16,-9
"4789","6207雷科","110/08/17","大昌-桃園",8,0,8
"4790","6207雷科","110/08/17","凱基-三重",1,10,-9
"4791","6207雷科","110/08/17","群益金鼎-士林",6,0,6
"4792","6207雷科","110/08/17","台新-台中",0,8,-8
"4793","6207雷科","110/08/17","美林",5,0,5
"4794","6207雷科","110/08/17","富邦-板橋",0,8,-8
"4795","6207雷科","110/08/17","中國信託-三重",5,0,5
"4796","6207雷科","110/08/17","兆豐-公益",0,6,-6
"4797","6207雷科","110/08/17","康和-內湖",5,0,5
"4798","6207雷科","110/08/17","新光-桃園",0,6,-6
"4799","6207雷科","110/08/17","新光",9,4,5
"4800","6207雷科","110/08/17","凱基-大里",0,6,-6
"4801","3679新至陞","110/08/17","台灣摩根士丹利",20,0,20
"4802","3679新至陞","110/08/17","台新證券",1,31,-30
"4803","3679新至陞","110/08/17","凱基-長庚",12,0,12
"4804","3679新至陞","110/08/17","統一",0,27,-27
"4805","3679新至陞","110/08/17","元大-大天母",12,0,12
"4806","3679新至陞","110/08/17","國票-南科",0,20,-20
"4807","3679新至陞","110/08/17","瑞士信貸",24,15,9
"4808","3679新至陞","110/08/17","國泰-忠孝",0,7,-7
"4809","3679新至陞","110/08/17","康和-板橋",6,0,6
"4810","3679新至陞","110/08/17","美林",10,15,-5
"4811","3679新至陞","110/08/17","元大-四維",6,0,6
"4812","3679新至陞","110/08/17","國泰-桃園",0,5,-5
"4813","3679新至陞","110/08/17","日盛-台中",5,0,5
"4814","3679新至陞","110/08/17","凱基-頭份",0,4,-4
"4815","3679新至陞","110/08/17","第一金-彰化",5,0,5
"4816","3679新至陞","110/08/17","港商野村",1,4,-3
"4817","3679新至陞","110/08/17","凱基-文心",5,1,4
"4818","3679新至陞","110/08/17","凱基-台北",8,11,-3
"4819","3679新至陞","110/08/17","元大-雙和",4,0,4
"4820","3679新至陞","110/08/17","元大證券",1,4,-3
"4821","3679新至陞","110/08/17","元大-草屯",4,0,4
"4822","3679新至陞","110/08/17","元大-新莊",0,3,-3
"4823","3679新至陞","110/08/17","合庫-彰化",2,0,2
"4824","3679新至陞","110/08/17","港商法國興業",0,2,-2
"4825","3679新至陞","110/08/17","臺銀-臺中",2,0,2
"4826","3679新至陞","110/08/17","元富-板橋",0,2,-2
"4827","3679新至陞","110/08/17","日盛-文化",3,1,2
"4828","3679新至陞","110/08/17","康和-高雄",0,2,-2
"4829","3679新至陞","110/08/17","永豐金-敦南",2,0,2
"4830","3679新至陞","110/08/17","群益金鼎-三重",0,2,-2
"4831","2727王品","110/08/17","凱基-台北",63,1,62
"4832","2727王品","110/08/17","第一金-高雄",1,111,-110
"4833","2727王品","110/08/17","台灣摩根士丹利",86,37,49
"4834","2727王品","110/08/17","摩根大通",29,118,-89
"4835","2727王品","110/08/17","瑞士信貸",32,0,32
"4836","2727王品","110/08/17","永豐金證券",0,83,-83
"4837","2727王品","110/08/17","元大-北屯",32,1,31
"4838","2727王品","110/08/17","華南永昌",1,38,-37
"4839","2727王品","110/08/17","美林",37,8,29
"4840","2727王品","110/08/17","合庫-新竹",1,31,-30
"4841","2727王品","110/08/17","凱基-市政",23,0,23
"4842","2727王品","110/08/17","中國信託-新竹",1,23,-22
"4843","2727王品","110/08/17","港商野村",74,54,20
"4844","2727王品","110/08/17","玉山證券",16,33,-17
"4845","2727王品","110/08/17","元大-板橋",20,0,20
"4846","2727王品","110/08/17","富邦-台北",5,19,-14
"4847","2727王品","110/08/17","元大-汐止",12,0,12
"4848","2727王品","110/08/17","群益金鼎-中壢",1,14,-13
"4849","2727王品","110/08/17","元大-龍潭",19,8,11
"4850","2727王品","110/08/17","富邦證券",0,13,-13
"4851","2727王品","110/08/17","元富",10,0,10
"4852","2727王品","110/08/17","元大證券",9,22,-13
"4853","2727王品","110/08/17","彰銀-台中",9,0,9
"4854","2727王品","110/08/17","聯邦商銀",0,12,-12
"4855","2727王品","110/08/17","中國信託",11,2,9
"4856","2727王品","110/08/17","日盛-屏東",7,17,-10
"4857","2727王品","110/08/17","群益金鼎-西松",10,1,9
"4858","2727王品","110/08/17","康和-高雄",0,10,-10
"4859","2727王品","110/08/17","第一金-自由",8,0,8
"4860","2727王品","110/08/17","新光-高雄",1,11,-10
"4861","1570力肯","110/08/17","元大-南投",88,1,87
"4862","1570力肯","110/08/17","富邦-仁愛",0,42,-42
"4863","1570力肯","110/08/17","群益金鼎-高雄",51,10,41
"4864","1570力肯","110/08/17","元富-新竹",0,30,-30
"4865","1570力肯","110/08/17","凱基-台北",47,7,40
"4866","1570力肯","110/08/17","元大-新盛",2,28,-26
"4867","1570力肯","110/08/17","統一",29,4,25
"4868","1570力肯","110/08/17","凱基-台南",0,20,-20
"4869","1570力肯","110/08/17","元大-大雅",25,0,25
"4870","1570力肯","110/08/17","日盛-復興",0,15,-15
"4871","1570力肯","110/08/17","台新證券",24,10,14
"4872","1570力肯","110/08/17","元大-前金",1,15,-14
"4873","1570力肯","110/08/17","元大證券",14,0,14
"4874","1570力肯","110/08/17","元大-北成功",0,14,-14
"4875","1570力肯","110/08/17","日盛-板橋",12,0,12
"4876","1570力肯","110/08/17","臺銀-臺南",0,11,-11
"4877","1570力肯","110/08/17","元大-鑫永和",11,0,11
"4878","1570力肯","110/08/17","凱基-彰化",0,11,-11
"4879","1570力肯","110/08/17","富邦-內湖",10,0,10
"4880","1570力肯","110/08/17","合庫-桃園",0,10,-10
"4881","1570力肯","110/08/17","元富-緯城",10,1,9
"4882","1570力肯","110/08/17","凱基-南崁",0,10,-10
"4883","1570力肯","110/08/17","元大-開元",10,2,8
"4884","1570力肯","110/08/17","凱基-台中",0,9,-9
"4885","1570力肯","110/08/17","元大-桃興",8,1,7
"4886","1570力肯","110/08/17","華南永昌-嘉義",0,8,-8
"4887","1570力肯","110/08/17","日盛-員林",6,0,6
"4888","1570力肯","110/08/17","元大-鹿港",1,9,-8
"4889","1570力肯","110/08/17","陽信",5,0,5
"4890","1570力肯","110/08/17","國票-中正",0,7,-7
"4891","6180橘子","110/08/17","摩根大通",107,25,82
"4892","6180橘子","110/08/17","元大-高雄",0,50,-50
"4893","6180橘子","110/08/17","美林",59,0,59
"4894","6180橘子","110/08/17","第一金-新竹",1,30,-29
"4895","6180橘子","110/08/17","美商高盛",31,0,31
"4896","6180橘子","110/08/17","台新-建北",1,25,-24
"4897","6180橘子","110/08/17","凱基-台北",32,6,26
"4898","6180橘子","110/08/17","群益金鼎-大安",0,20,-20
"4899","6180橘子","110/08/17","合庫-自強",10,0,10
"4900","6180橘子","110/08/17","台灣摩根士丹利",37,54,-17
"4901","6180橘子","110/08/17","元富-世貿",10,0,10
"4902","6180橘子","110/08/17","玉山-台南",1,13,-12
"4903","6180橘子","110/08/17","元大-台中中港",10,0,10
"4904","6180橘子","110/08/17","富邦-基隆",0,11,-11
"4905","6180橘子","110/08/17","臺銀-金山",11,2,9
"4906","6180橘子","110/08/17","日盛-雙和",0,10,-10
"4907","6180橘子","110/08/17","華南永昌-虎尾",8,0,8
"4908","6180橘子","110/08/17","統一-台南",0,10,-10
"4909","6180橘子","110/08/17","元大-彰化民生",7,0,7
"4910","6180橘子","110/08/17","新光-桃園",0,10,-10
"4911","6180橘子","110/08/17","群益金鼎-嘉義",6,0,6
"4912","6180橘子","110/08/17","凱基-竹北",0,10,-10
"4913","6180橘子","110/08/17","元大-太平",6,0,6
"4914","6180橘子","110/08/17","元大-基隆孝二",0,10,-10
"4915","6180橘子","110/08/17","永豐金-敦北",6,0,6
"4916","6180橘子","110/08/17","永豐金-大園",0,10,-10
"4917","6180橘子","110/08/17","華南永昌-台中",5,0,5
"4918","6180橘子","110/08/17","第一金-中山",0,8,-8
"4919","6180橘子","110/08/17","元大-永春",5,0,5
"4920","6180橘子","110/08/17","台新證券",4,12,-8
"4921","2390云辰","110/08/17","美林",601,355,246
"4922","2390云辰","110/08/17","富邦-虎尾",786,1240,-454
"4923","2390云辰","110/08/17","凱基-台北",999,859,140
"4924","2390云辰","110/08/17","富隆-長安",2,262,-260
"4925","2390云辰","110/08/17","新光",1508,1370,138
"4926","2390云辰","110/08/17","摩根大通",2924,3174,-250
"4927","2390云辰","110/08/17","國泰-敦南",1264,1133,131
"4928","2390云辰","110/08/17","元大-木柵",204,419,-215
"4929","2390云辰","110/08/17","富邦-內湖",143,18,125
"4930","2390云辰","110/08/17","兆豐-埔墘",10,165,-155
"4931","2390云辰","110/08/17","統一-新營",142,28,114
"4932","2390云辰","110/08/17","美商高盛",332,483,-151
"4933","2390云辰","110/08/17","兆豐-虎尾",107,5,102
"4934","2390云辰","110/08/17","元大-大同",829,966,-137
"4935","2390云辰","110/08/17","新加坡商瑞銀",274,177,97
"4936","2390云辰","110/08/17","元大-土城學府",236,367,-131
"4937","2390云辰","110/08/17","元大-上新莊",82,9,73
"4938","2390云辰","110/08/17","富邦-花蓮",5,107,-102
"4939","2390云辰","110/08/17","凱基-民權",145,78,67
"4940","2390云辰","110/08/17","元大-台中",20,118,-98
"4941","2390云辰","110/08/17","富邦-彰化",200,133,67
"4942","2390云辰","110/08/17","群益金鼎-開元",70,150,-80
"4943","2390云辰","110/08/17","宏遠-桃園",67,5,62
"4944","2390云辰","110/08/17","永豐金-古亭",27,106,-79
"4945","2390云辰","110/08/17","港商野村",2090,2030,60
"4946","2390云辰","110/08/17","土銀-士林",0,78,-78
"4947","2390云辰","110/08/17","永豐金-萬盛",76,17,59
"4948","2390云辰","110/08/17","元富-高雄",94,166,-72
"4949","2390云辰","110/08/17","元大-歸仁",85,34,51
"4950","2390云辰","110/08/17","富邦-敦南",40,108,-68
"4951","2609陽明","110/08/16","康和",4181,128,4053
"4952","2609陽明","110/08/16","凱基-台北",1053,19933,-18880
"4953","2609陽明","110/08/16","宏遠證券",2579,659,1920
"4954","2609陽明","110/08/16","群益金鼎-三重",162,5149,-4987
"4955","2609陽明","110/08/16","華南永昌-竹北",2072,225,1847
"4956","2609陽明","110/08/16","兆豐-南京",3041,5871,-2830
"4957","2609陽明","110/08/16","凱基-虎尾",4140,2400,1740
"4958","2609陽明","110/08/16","中國信託-松江",116,2823,-2707
"4959","2609陽明","110/08/16","元大證券",8157,7010,1147
"4960","2609陽明","110/08/16","兆豐-復興",107,2607,-2500
"4961","2609陽明","110/08/16","摩根大通",5939,5074,865
"4962","2609陽明","110/08/16","美林",2802,5073,-2271
"4963","2609陽明","110/08/16","永豐金-信義",865,85,780
"4964","2609陽明","110/08/16","兆豐-三民",182,2181,-1999
"4965","2609陽明","110/08/16","元大-頭份",1005,248,757
"4966","2609陽明","110/08/16","新加坡商瑞銀",561,2511,-1950
"4967","2609陽明","110/08/16","港商野村",2920,2184,736
"4968","2609陽明","110/08/16","凱基-城中",585,1560,-975
"4969","2609陽明","110/08/16","元大-信義",944,209,735
"4970","2609陽明","110/08/16","元大-竹科",394,1326,-932
"4971","2609陽明","110/08/16","凱基-市政",14533,13859,674
"4972","2609陽明","110/08/16","群益金鼎-大安",89,951,-862
"4973","2609陽明","110/08/16","富邦-嘉義",7027,6481,546
"4974","2609陽明","110/08/16","瑞士信貸",910,1607,-697
"4975","2609陽明","110/08/16","新光-新竹",1792,1331,461
"4976","2609陽明","110/08/16","兆豐-新竹",305,932,-627
"4977","2609陽明","110/08/16","凱基-台南",808,378,430
"4978","2609陽明","110/08/16","元大-永春",376,856,-480
"4979","2609陽明","110/08/16","凱基-信義",434,31,403
"4980","2609陽明","110/08/16","元富",483,956,-473
"4981","2636台驊投控","110/08/16","凱基",893,138,755
"4982","2636台驊投控","110/08/16","日盛-台中",36,221,-185
"4983","2636台驊投控","110/08/16","瑞士信貸",524,17,507
"4984","2636台驊投控","110/08/16","統一-新竹",4,188,-184
"4985","2636台驊投控","110/08/16","台灣摩根士丹利",534,35,499
"4986","2636台驊投控","110/08/16","國泰-敦南",291,403,-112
"4987","2636台驊投控","110/08/16","富邦-花蓮",283,25,258
"4988","2636台驊投控","110/08/16","新光",259,366,-107
"4989","2636台驊投控","110/08/16","新光-新竹",349,144,205
"4990","2636台驊投控","110/08/16","群益金鼎",89,185,-96
"4991","2636台驊投控","110/08/16","國票-彰化",442,282,160
"4992","2636台驊投控","110/08/16","新光-桃園",22,98,-76
"4993","2636台驊投控","110/08/16","大慶",160,1,159
"4994","2636台驊投控","110/08/16","群益金鼎-南京",57,126,-69
"4995","2636台驊投控","110/08/16","富邦-虎尾",144,13,131
"4996","2636台驊投控","110/08/16","玉山-台南",61,127,-66
"4997","2636台驊投控","110/08/16","元大-士林",118,2,116
"4998","2636台驊投控","110/08/16","元富-大昌",5,66,-61
"4999","2636台驊投控","110/08/16","摩根大通",799,698,101
"5000","2636台驊投控","110/08/16","日盛證券",78,137,-59
"5001","2636台驊投控","110/08/16","日盛-宜蘭",100,3,97
"5002","2636台驊投控","110/08/16","凱基-市政",13,68,-55
"5003","2636台驊投控","110/08/16","凱基-台北",786,690,96
"5004","2636台驊投控","110/08/16","兆豐-城中",7,58,-51
"5005","2636台驊投控","110/08/16","兆豐-東門",101,31,70
"5006","2636台驊投控","110/08/16","永豐金-新竹",33,83,-50
"5007","2636台驊投控","110/08/16","凱基-長庚",66,6,60
"5008","2636台驊投控","110/08/16","國泰-台中",69,115,-46
"5009","2636台驊投控","110/08/16","元富-中壢",76,18,58
"5010","2636台驊投控","110/08/16","國票-九鼎",18,61,-43
"5011","2867三商壽","110/08/16","兆豐-大同",800,0,800
"5012","2867三商壽","110/08/16","台新證券",7,983,-976
"5013","2867三商壽","110/08/16","元富-世貿",646,5,641
"5014","2867三商壽","110/08/16","美林",0,406,-406
"5015","2867三商壽","110/08/16","元大-土城永寧",320,0,320
"5016","2867三商壽","110/08/16","(牛牛牛)亞-鑫豐",15,120,-105
"5017","2867三商壽","110/08/16","新加坡商瑞銀",241,18,223
"5018","2867三商壽","110/08/16","土銀",0,100,-100
"5019","2867三商壽","110/08/16","玉山-城中",156,0,156
"5020","2867三商壽","110/08/16","兆豐-來福",0,100,-100
"5021","2867三商壽","110/08/16","元大-桃園",100,0,100
"5022","2867三商壽","110/08/16","凱基-虎尾",0,90,-90
"5023","2867三商壽","110/08/16","高橋-龍潭",87,1,86
"5024","2867三商壽","110/08/16","瑞士信貸",53,140,-87
"5025","2867三商壽","110/08/16","富邦-員林",79,0,79
"5026","2867三商壽","110/08/16","花旗環球",7,83,-76
"5027","2867三商壽","110/08/16","華南永昌-高雄",50,0,50
"5028","2867三商壽","110/08/16","元大-大同",0,67,-67
"5029","2867三商壽","110/08/16","元大-崇德",50,0,50
"5030","2867三商壽","110/08/16","日盛-板橋",0,60,-60
"5031","2867三商壽","110/08/16","華南永昌-虎尾",40,0,40
"5032","2867三商壽","110/08/16","元大-博愛",2,62,-60
"5033","2867三商壽","110/08/16","元大-大統",40,0,40
"5034","2867三商壽","110/08/16","(牛牛牛)亞-網路",0,55,-55
"5035","2867三商壽","110/08/16","新光",87,48,39
"5036","2867三商壽","110/08/16","美商高盛",105,158,-53
"5037","2867三商壽","110/08/16","元大-大安",36,0,36
"5038","2867三商壽","110/08/16","永豐金-屏東",1,52,-51
"5039","2867三商壽","110/08/16","群益金鼎-西松",35,0,35
"5040","2867三商壽","110/08/16","兆豐-台中港",0,50,-50
"5041","5521工信","110/08/16","第一金-新竹",84,0,84
"5042","5521工信","110/08/16","摩根大通",83,306,-223
"5043","5521工信","110/08/16","日進",60,0,60
"5044","5521工信","110/08/16","日盛證券",0,70,-70
"5045","5521工信","110/08/16","凱基-中壢",40,0,40
"5046","5521工信","110/08/16","群益金鼎-海山",0,40,-40
"5047","5521工信","110/08/16","台新證券",37,0,37
"5048","5521工信","110/08/16","華南永昌",0,39,-39
"5049","5521工信","110/08/16","群益金鼎-台中",35,0,35
"5050","5521工信","110/08/16","美林",5,43,-38
"5051","5521工信","110/08/16","富邦-台北",30,0,30
"5052","5521工信","110/08/16","康和-澎湖",0,30,-30
"5053","5521工信","110/08/16","元大-永和",30,0,30
"5054","5521工信","110/08/16","華南永昌-彰化",5,34,-29
"5055","5521工信","110/08/16","華南永昌-潮州",28,0,28
"5056","5521工信","110/08/16","元大-龍潭",0,25,-25
"5057","5521工信","110/08/16","玉山-嘉義",23,0,23
"5058","5521工信","110/08/16","兆豐-桃園",0,24,-24
"5059","5521工信","110/08/16","元大-新莊",40,17,23
"5060","5521工信","110/08/16","華南永昌-林口",1,25,-24
"5061","5521工信","110/08/16","第一金-桃園",22,0,22
"5062","5521工信","110/08/16","台灣企銀-台中",0,20,-20
"5063","5521工信","110/08/16","凱基-鳳山",20,0,20
"5064","5521工信","110/08/16","第一金-台南",0,20,-20
"5065","5521工信","110/08/16","元大-路竹",20,0,20
"5066","5521工信","110/08/16","元富-古亭",0,20,-20
"5067","5521工信","110/08/16","合庫-桃園",20,1,19
"5068","5521工信","110/08/16","兆豐-中壢",0,20,-20
"5069","5521工信","110/08/16","臺銀-鳳山",21,2,19
"5070","5521工信","110/08/16","元大-仁愛",0,20,-20
"5071","1471首利","110/08/16","摩根大通",196,88,108
"5072","1471首利","110/08/16","元大-草屯",1,200,-199
"5073","1471首利","110/08/16","瑞士信貸",95,17,78
"5074","1471首利","110/08/16","元富-埔里",0,51,-51
"5075","1471首利","110/08/16","新加坡商瑞銀",38,0,38
"5076","1471首利","110/08/16","凱基-雙和",0,40,-40
"5077","1471首利","110/08/16","國泰-敦南",37,2,35
"5078","1471首利","110/08/16","華南永昌-公誠",0,40,-40
"5079","1471首利","110/08/16","凱基-彰化",31,0,31
"5080","1471首利","110/08/16","元大-大灣",0,36,-36
"5081","1471首利","110/08/16","光和-溪湖",20,0,20
"5082","1471首利","110/08/16","新光-台中",17,42,-25
"5083","1471首利","110/08/16","國票-中港",20,0,20
"5084","1471首利","110/08/16","富邦-仁愛",0,25,-25
"5085","1471首利","110/08/16","美林",15,0,15
"5086","1471首利","110/08/16","群益金鼎-台北",0,24,-24
"5087","1471首利","110/08/16","元大-板橋",15,0,15
"5088","1471首利","110/08/16","永豐金-竹北",0,22,-22
"5089","1471首利","110/08/16","凱基-長庚",16,2,14
"5090","1471首利","110/08/16","合庫-台中",0,20,-20
"5091","1471首利","110/08/16","元大-斗信",14,0,14
"5092","1471首利","110/08/16","高橋-龍潭",2,22,-20
"5093","1471首利","110/08/16","第一金-高雄",12,0,12
"5094","1471首利","110/08/16","國票-台中",0,20,-20
"5095","1471首利","110/08/16","玉山-大里",12,0,12
"5096","1471首利","110/08/16","群益金鼎-潭子",0,20,-20
"5097","1471首利","110/08/16","永豐金-大園",12,0,12
"5098","1471首利","110/08/16","台新證券",2,19,-17
"5099","1471首利","110/08/16","永豐金-中正",12,0,12
"5100","1471首利","110/08/16","聯邦-高雄",0,15,-15
"5101","2883開發金","110/08/16","中國信託-文心",4881,27,4854
"5102","2883開發金","110/08/16","摩根大通",1712,30864,-29152
"5103","2883開發金","110/08/16","國泰-敦南",3101,627,2474
"5104","2883開發金","110/08/16","台灣摩根士丹利",453,18916,-18463
"5105","2883開發金","110/08/16","亞東-新竹",3614,1222,2392
"5106","2883開發金","110/08/16","凱基-台北",8208,20874,-12666
"5107","2883開發金","110/08/16","花旗環球",3115,841,2274
"5108","2883開發金","110/08/16","新加坡商瑞銀",363,11873,-11510
"5109","2883開發金","110/08/16","元大證券",3308,1099,2209
"5110","2883開發金","110/08/16","美林",130,9722,-9592
"5111","2883開發金","110/08/16","康和-仁愛",2103,0,2103
"5112","2883開發金","110/08/16","統一",766,7210,-6444
"5113","2883開發金","110/08/16","玉山-大里",1874,31,1843
"5114","2883開發金","110/08/16","元富",48,5683,-5635
"5115","2883開發金","110/08/16","第一金-忠孝",1836,3,1833
"5116","2883開發金","110/08/16","富邦證券",147,4117,-3970
"5117","2883開發金","110/08/16","宏遠證券",1825,5,1820
"5118","2883開發金","110/08/16","國票-長城",22,2713,-2691
"5119","2883開發金","110/08/16","統一-新竹",1630,2,1628
"5120","2883開發金","110/08/16","台新證券",1753,4439,-2686
"5121","2883開發金","110/08/16","國泰-板橋",1493,346,1147
"5122","2883開發金","110/08/16","元大-士林",417,2698,-2281
"5123","2883開發金","110/08/16","國泰-館前",1856,775,1081
"5124","2883開發金","110/08/16","港商野村",3026,5159,-2133
"5125","2883開發金","110/08/16","群益金鼎-高盛",1005,12,993
"5126","2883開發金","110/08/16","瑞士信貸",1295,3237,-1942
"5127","2883開發金","110/08/16","元大-新莊",860,16,844
"5128","2883開發金","110/08/16","美商高盛",162,1917,-1755
"5129","2883開發金","110/08/16","臺銀",807,32,775
"5130","2883開發金","110/08/16","國泰證券",290,1593,-1303
"5131","6205詮欣","110/08/16","凱基-汐止",22,0,22
"5132","6205詮欣","110/08/16","凱基-台北",0,10,-10
"5133","6205詮欣","110/08/16","臺銀-民權",10,0,10
"5134","6205詮欣","110/08/16","永興-水湳",0,6,-6
"5135","6205詮欣","110/08/16","德信-新營",6,0,6
"5136","6205詮欣","110/08/16","國票-博愛",0,6,-6
"5137","6205詮欣","110/08/16","玉山證券",5,0,5
"5138","6205詮欣","110/08/16","日盛-三重",5,10,-5
"5139","6205詮欣","110/08/16","亞東-板橋",4,0,4
"5140","6205詮欣","110/08/16","日盛-永康",0,5,-5
"5141","6205詮欣","110/08/16","元大-羅東",4,0,4
"5142","6205詮欣","110/08/16","摩根大通",0,5,-5
"5143","6205詮欣","110/08/16","元大-汐止",4,0,4
"5144","6205詮欣","110/08/16","玉山-台南",0,5,-5
"5145","6205詮欣","110/08/16","臺銀-高雄",3,0,3
"5146","6205詮欣","110/08/16","元大-大天母",0,4,-4
"5147","6205詮欣","110/08/16","美林",2,0,2
"5148","6205詮欣","110/08/16","永豐金-中盛",0,3,-3
"5149","6205詮欣","110/08/16","群益金鼎-基隆",2,0,2
"5150","6205詮欣","110/08/16","華南永昌-彰化",0,2,-2
"5151","6205詮欣","110/08/16","合庫-三重",1,0,1
"5152","6205詮欣","110/08/16","富邦-中壢",0,2,-2
"5153","6205詮欣","110/08/16","(牛牛牛)亞-網路",1,0,1
"5154","6205詮欣","110/08/16","元大-成功",0,2,-2
"5155","6205詮欣","110/08/16","豐農",1,0,1
"5156","6205詮欣","110/08/16","統一-士林",0,1,-1
"5157","6205詮欣","110/08/16","凱基-站前",1,0,1
"5158","6205詮欣","110/08/16","統一-金門",0,1,-1
"5159","6205詮欣","110/08/16","富邦-建國",1,0,1
"5160","6205詮欣","110/08/16","元富-文心",0,1,-1
"5161","1540喬福","110/08/16","元大-成功",25,0,25
"5162","1540喬福","110/08/16","凱基-台北",0,51,-51
"5163","1540喬福","110/08/16","新光",16,0,16
"5164","1540喬福","110/08/16","新光-新竹",10,29,-19
"5165","1540喬福","110/08/16","日盛-鳳山",10,0,10
"5166","1540喬福","110/08/16","元大-北屯",0,18,-18
"5167","1540喬福","110/08/16","台新-左楠",10,0,10
"5168","1540喬福","110/08/16","北城證券",0,16,-16
"5169","1540喬福","110/08/16","玉山-左營",10,0,10
"5170","1540喬福","110/08/16","國泰-敦南",2,18,-16
"5171","1540喬福","110/08/16","富邦-南屯",10,0,10
"5172","1540喬福","110/08/16","新光-桃園",0,15,-15
"5173","1540喬福","110/08/16","富邦-板橋",8,0,8
"5174","1540喬福","110/08/16","新光-台南",0,12,-12
"5175","1540喬福","110/08/16","凱基-中壢",7,0,7
"5176","1540喬福","110/08/16","凱基-台中",0,12,-12
"5177","1540喬福","110/08/16","元富-新竹",5,0,5
"5178","1540喬福","110/08/16","元大-汐止",0,10,-10
"5179","1540喬福","110/08/16","兆豐-北高雄",5,0,5
"5180","1540喬福","110/08/16","凱基-竹北",0,7,-7
"5181","1540喬福","110/08/16","台新-台中",5,0,5
"5182","1540喬福","110/08/16","日盛-文化",0,4,-4
"5183","1540喬福","110/08/16","凱基-台南",5,0,5
"5184","1540喬福","110/08/16","富邦-桃園",0,3,-3
"5185","1540喬福","110/08/16","元大-龍潭",5,0,5
"5186","1540喬福","110/08/16","摩根大通",1,3,-2
"5187","1540喬福","110/08/16","元富-緯城",4,0,4
"5188","1540喬福","110/08/16","玉山-城中",0,2,-2
"5189","1540喬福","110/08/16","元大-大安",4,0,4
"5190","1540喬福","110/08/16","永豐金-桃園",0,2,-2
"5191","2888新光金","110/08/16","兆豐-公益",12939,12,12927
"5192","2888新光金","110/08/16","摩根大通",2056,10998,-8942
"5193","2888新光金","110/08/16","元大-忠孝鼎富",11100,189,10911
"5194","2888新光金","110/08/16","元富-城東",25,8381,-8356
"5195","2888新光金","110/08/16","港商麥格理",9753,0,9753
"5196","2888新光金","110/08/16","元富",6,7491,-7485
"5197","2888新光金","110/08/16","群益金鼎-大安",3294,0,3294
"5198","2888新光金","110/08/16","美林",136,3975,-3839
"5199","2888新光金","110/08/16","凱基-復興",3020,0,3020
"5200","2888新光金","110/08/16","臺銀-高雄",19,3007,-2988
"5201","2888新光金","110/08/16","美商高盛",5603,3216,2387
"5202","2888新光金","110/08/16","台灣摩根士丹利",419,2562,-2143
"5203","2888新光金","110/08/16","國票-台東",2067,0,2067
"5204","2888新光金","110/08/16","瑞士信貸",58,1618,-1560
"5205","2888新光金","110/08/16","群益金鼎-台北",1872,0,1872
"5206","2888新光金","110/08/16","玉山-新竹",0,1497,-1497
"5207","2888新光金","110/08/16","新加坡商瑞銀",2005,179,1826
"5208","2888新光金","110/08/16","國票-博愛",3,1208,-1205
"5209","2888新光金","110/08/16","華南永昌-忠孝",1827,90,1737
"5210","2888新光金","110/08/16","元大-士林",85,1185,-1100
"5211","2888新光金","110/08/16","富邦-新營",1400,0,1400
"5212","2888新光金","110/08/16","臺銀-民權",19,1095,-1076
"5213","2888新光金","110/08/16","華南永昌-鳳山",1174,11,1163
"5214","2888新光金","110/08/16","法銀巴黎",0,868,-868
"5215","2888新光金","110/08/16","元大-員林",1051,12,1039
"5216","2888新光金","110/08/16","群益金鼎",10,847,-837
"5217","2888新光金","110/08/16","富邦-高雄",1015,11,1004
"5218","2888新光金","110/08/16","元富-世貿",7,794,-787
"5219","2888新光金","110/08/16","日盛-南京",1000,5,995
"5220","2888新光金","110/08/16","國票-安和",0,724,-724
"5221","1340勝悅","110/08/16","元富-成功",30,0,30
"5222","1340勝悅","110/08/16","元富-城東",0,107,-107
"5223","1340勝悅","110/08/16","華南永昌-公誠",30,0,30
"5224","1340勝悅","110/08/16","永豐金-竹科",0,38,-38
"5225","1340勝悅","110/08/16","華南永昌-敦南",25,0,25
"5226","1340勝悅","110/08/16","德信-新營",0,30,-30
"5227","1340勝悅","110/08/16","合庫-自強",15,0,15
"5228","1340勝悅","110/08/16","國泰-松江",0,15,-15
"5229","1340勝悅","110/08/16","臺銀-鳳山",15,0,15
"5230","1340勝悅","110/08/16","摩根大通",5,17,-12
"5231","1340勝悅","110/08/16","元富-中港",10,0,10
"5232","1340勝悅","110/08/16","港商法國興業",0,11,-11
"5233","1340勝悅","110/08/16","永豐金-南京",10,0,10
"5234","1340勝悅","110/08/16","玉山-高雄",0,10,-10
"5235","1340勝悅","110/08/16","新光",9,0,9
"5236","1340勝悅","110/08/16","凱基-台北",0,10,-10
"5237","1340勝悅","110/08/16","國泰-台中",14,7,7
"5238","1340勝悅","110/08/16","華南永昌-嘉義",0,10,-10
"5239","1340勝悅","110/08/16","元大-苗栗",6,0,6
"5240","1340勝悅","110/08/16","合庫-台南",0,6,-6
"5241","1340勝悅","110/08/16","元大-屏南",6,0,6
"5242","1340勝悅","110/08/16","玉山-桃園",0,5,-5
"5243","1340勝悅","110/08/16","臺灣企銀-埔墘",5,0,5
"5244","1340勝悅","110/08/16","永豐金-博愛",0,5,-5
"5245","1340勝悅","110/08/16","日盛-板橋",5,0,5
"5246","1340勝悅","110/08/16","美林",0,2,-2
"5247","1340勝悅","110/08/16","致和-東門",5,0,5
"5248","1340勝悅","110/08/16","兆豐-城中",0,2,-2
"5249","1340勝悅","110/08/16","群益金鼎-館前",7,2,5
"5250","1340勝悅","110/08/16","元大-大雅",0,2,-2
"5251","6246臺龍","110/08/16","元大-南投",25,5,20
"5252","6246臺龍","110/08/16","元大-中壢",9,26,-17
"5253","6246臺龍","110/08/16","港商野村",65,46,19
"5254","6246臺龍","110/08/16","台新-台中",1,15,-14
"5255","6246臺龍","110/08/16","華南永昌",23,5,18
"5256","6246臺龍","110/08/16","群益金鼎-開元",0,12,-12
"5257","6246臺龍","110/08/16","華南永昌-彰化",15,4,11
"5258","6246臺龍","110/08/16","凱基-苗栗",0,7,-7
"5259","6246臺龍","110/08/16","統一-台中",10,0,10
"5260","6246臺龍","110/08/16","日盛-鳳山",0,6,-6
"5261","6246臺龍","110/08/16","兆豐-新營",11,1,10
"5262","6246臺龍","110/08/16","台新證券",4,10,-6
"5263","6246臺龍","110/08/16","玉山-桃園",10,0,10
"5264","6246臺龍","110/08/16","新光",4,10,-6
"5265","6246臺龍","110/08/16","凱基-台北",12,2,10
"5266","6246臺龍","110/08/16","華南永昌-嘉義",0,6,-6
"5267","6246臺龍","110/08/16","群益金鼎-東大",9,0,9
"5268","6246臺龍","110/08/16","元大-竹北",0,6,-6
"5269","6246臺龍","110/08/16","元富-中港",6,0,6
"5270","6246臺龍","110/08/16","元大-永康",0,6,-6
"5271","6246臺龍","110/08/16","德信-新營",6,0,6
"5272","6246臺龍","110/08/16","元富-新店",0,5,-5
"5273","6246臺龍","110/08/16","兆豐-西螺",5,0,5
"5274","6246臺龍","110/08/16","台中銀",0,5,-5
"5275","6246臺龍","110/08/16","群益金鼎-土城",5,0,5
"5276","6246臺龍","110/08/16","群益金鼎-永和",0,5,-5
"5277","6246臺龍","110/08/16","富邦-仁愛",5,0,5
"5278","6246臺龍","110/08/16","元大-台南",0,5,-5
"5279","6246臺龍","110/08/16","元大-基隆孝二",7,2,5
"5280","6246臺龍","110/08/16","元大-土城",0,5,-5
"5281","00715L期街口布蘭特正2","110/08/16","元富",1720,5,1715
"5282","00715L期街口布蘭特正2","110/08/16","元大證券",365,4674,-4309
"5283","00715L期街口布蘭特正2","110/08/16","港商野村",1350,660,690
"5284","00715L期街口布蘭特正2","110/08/16","華南永昌-長虹",50,820,-770
"5285","00715L期街口布蘭特正2","110/08/16","(牛牛牛)亞-鑫豐",587,51,536
"5286","00715L期街口布蘭特正2","110/08/16","凱基-台北",42,470,-428
"5287","00715L期街口布蘭特正2","110/08/16","富邦-嘉義",405,0,405
"5288","00715L期街口布蘭特正2","110/08/16","永豐金證券",5,360,-355
"5289","00715L期街口布蘭特正2","110/08/16","兆豐-嘉義",303,0,303
"5290","00715L期街口布蘭特正2","110/08/16","元大-復北",1,333,-332
"5291","00715L期街口布蘭特正2","110/08/16","元大-學甲",272,0,272
"5292","00715L期街口布蘭特正2","110/08/16","兆豐-新莊",0,306,-306
"5293","00715L期街口布蘭特正2","110/08/16","元大-中和",308,52,256
"5294","00715L期街口布蘭特正2","110/08/16","凱基-松山",0,302,-302
"5295","00715L期街口布蘭特正2","110/08/16","新光",318,84,234
"5296","00715L期街口布蘭特正2","110/08/16","統一-桃園",7,280,-273
"5297","00715L期街口布蘭特正2","110/08/16","元大-北港",165,0,165
"5298","00715L期街口布蘭特正2","110/08/16","日盛-板橋",31,300,-269
"5299","00715L期街口布蘭特正2","110/08/16","台中銀",202,45,157
"5300","00715L期街口布蘭特正2","110/08/16","凱基",0,250,-250
"5301","00715L期街口布蘭特正2","110/08/16","元大-台中中港",157,0,157
"5302","00715L期街口布蘭特正2","110/08/16","富邦-仁愛",11,250,-239
"5303","00715L期街口布蘭特正2","110/08/16","元大-花蓮",150,4,146
"5304","00715L期街口布蘭特正2","110/08/16","台新-台中",34,262,-228
"5305","00715L期街口布蘭特正2","110/08/16","統一-台中",165,32,133
"5306","00715L期街口布蘭特正2","110/08/16","元富-吉利",5,210,-205
"5307","00715L期街口布蘭特正2","110/08/16","永全-南崁",130,0,130
"5308","00715L期街口布蘭特正2","110/08/16","康和",0,150,-150
"5309","00715L期街口布蘭特正2","110/08/16","元富-中壢",223,100,123
"5310","00715L期街口布蘭特正2","110/08/16","兆豐-台中港",53,190,-137
"5311","8941關中","110/08/16","凱基-市府",4,0,4
"5312","8941關中","110/08/16","統一-台中",0,3,-3
"5313","8941關中","110/08/16","(牛牛牛)亞-鑫豐",2,1,1
"5314","8941關中","110/08/16","宏遠-中和",0,1,-1
"5315","8941關中","110/08/16","富邦-左營",1,0,1
"5316","8941關中","110/08/16","富邦-竹北",0,1,-1
"5317","8941關中","110/08/16","元大-路竹",1,0,1
"5318","8941關中","110/08/16","元大-華山",0,1,-1
"5319","8941關中","110/08/16","統一-新台中",0,0,0
"5320","8941關中","110/08/16","永豐金-中正",0,1,-1
"5321","8941關中","110/08/16","元富-中港",0,0,0
"5322","8941關中","110/08/16","統一-新台中",0,0,0
"5323","8941關中","110/08/16","元大證券",0,0,0
"5324","8941關中","110/08/16","元富-中港",0,0,0
"5325","8941關中","110/08/16","元大-龍潭",0,0,0
"5326","8941關中","110/08/16","元大證券",0,0,0
"5327","8941關中","110/08/16","永豐金-南投",0,0,0
"5328","8941關中","110/08/16","元大-龍潭",0,0,0
"5329","8941關中","110/08/16","",NA,NA,NA
"5330","8941關中","110/08/16","永豐金-南投",0,0,0
"5331","8941關中","110/08/16","",NA,NA,NA
"5332","8941關中","110/08/16","",NA,NA,NA
"5333","8941關中","110/08/16","",NA,NA,NA
"5334","8941關中","110/08/16","",NA,NA,NA
"5335","8941關中","110/08/16","",NA,NA,NA
"5336","8941關中","110/08/16","",NA,NA,NA
"5337","8941關中","110/08/16","",NA,NA,NA
"5338","8941關中","110/08/16","",NA,NA,NA
"5339","8941關中","110/08/16","",NA,NA,NA
"5340","8941關中","110/08/16","",NA,NA,NA
"5341","8936國統","110/08/16","台中銀-高雄",200,0,200
"5342","8936國統","110/08/16","摩根大通",39,181,-142
"5343","8936國統","110/08/16","美林",139,31,108
"5344","8936國統","110/08/16","新加坡商瑞銀",48,178,-130
"5345","8936國統","110/08/16","元大-天母",50,0,50
"5346","8936國統","110/08/16","凱基-台北",66,161,-95
"5347","8936國統","110/08/16","中國信託",50,2,48
"5348","8936國統","110/08/16","新光-桃園",2,90,-88
"5349","8936國統","110/08/16","元大-豐原站前",40,0,40
"5350","8936國統","110/08/16","台灣摩根士丹利",1,79,-78
"5351","8936國統","110/08/16","元大-北港",32,0,32
"5352","8936國統","110/08/16","永豐金-苓雅",10,80,-70
"5353","8936國統","110/08/16","永豐金-竹科",28,0,28
"5354","8936國統","110/08/16","富邦-南屯",15,64,-49
"5355","8936國統","110/08/16","凱基-岡山",27,0,27
"5356","8936國統","110/08/16","台新-高雄",10,56,-46
"5357","8936國統","110/08/16","第一金-自由",20,0,20
"5358","8936國統","110/08/16","國票-北高雄",5,30,-25
"5359","8936國統","110/08/16","港商野村",68,50,18
"5360","8936國統","110/08/16","台新-屏東",0,25,-25
"5361","8936國統","110/08/16","華南永昌-岡山",16,0,16
"5362","8936國統","110/08/16","元大-高雄",0,23,-23
"5363","8936國統","110/08/16","新光-台中",59,44,15
"5364","8936國統","110/08/16","台灣企銀-豐原",0,22,-22
"5365","8936國統","110/08/16","日盛證券",14,0,14
"5366","8936國統","110/08/16","玉山證券",0,19,-19
"5367","8936國統","110/08/16","元富-林園",12,0,12
"5368","8936國統","110/08/16","日盛-中壢",0,16,-16
"5369","8936國統","110/08/16","兆豐-景美",12,0,12
"5370","8936國統","110/08/16","美商高盛",6,21,-15
"5371","6226光鼎","110/08/16","凱基-台北",1070,545,525
"5372","6226光鼎","110/08/16","台新證券",86,218,-132
"5373","6226光鼎","110/08/16","美林",291,133,158
"5374","6226光鼎","110/08/16","元富-新竹",10,139,-129
"5375","6226光鼎","110/08/16","瑞士信貸",144,6,138
"5376","6226光鼎","110/08/16","元大-台南",0,101,-101
"5377","6226光鼎","110/08/16","摩根大通",340,206,134
"5378","6226光鼎","110/08/16","永豐金-南投",1,100,-99
"5379","6226光鼎","110/08/16","美商高盛",222,102,120
"5380","6226光鼎","110/08/16","華南永昌-高雄",1,63,-62
"5381","6226光鼎","110/08/16","新光",195,77,118
"5382","6226光鼎","110/08/16","元大-仁愛",1,61,-60
"5383","6226光鼎","110/08/16","第一金-大稻埕",103,1,102
"5384","6226光鼎","110/08/16","群益金鼎-士林",39,98,-59
"5385","6226光鼎","110/08/16","元大-北投",101,4,97
"5386","6226光鼎","110/08/16","元大-府城",20,72,-52
"5387","6226光鼎","110/08/16","元大-竹科",101,10,91
"5388","6226光鼎","110/08/16","合庫-鳳山",4,53,-49
"5389","6226光鼎","110/08/16","元大-北屯",104,15,89
"5390","6226光鼎","110/08/16","國票-九鼎",2,44,-42
"5391","6226光鼎","110/08/16","國泰-桃園",98,29,69
"5392","6226光鼎","110/08/16","元大-金華",13,55,-42
"5393","6226光鼎","110/08/16","群益金鼎-東門",67,0,67
"5394","6226光鼎","110/08/16","富邦-竹東",5,43,-38
"5395","6226光鼎","110/08/16","港商野村",277,215,62
"5396","6226光鼎","110/08/16","元大-雙和",6,43,-37
"5397","6226光鼎","110/08/16","群益金鼎-西松",51,1,50
"5398","6226光鼎","110/08/16","中國信託-忠孝",2,36,-34
"5399","6226光鼎","110/08/16","元富-古亭",50,3,47
"5400","6226光鼎","110/08/16","華南永昌-三重",3,37,-34
"5401","2363矽統","110/08/16","凱基-台北",2187,1127,1060
"5402","2363矽統","110/08/16","元大-東泰",32,339,-307
"5403","2363矽統","110/08/16","美商高盛",1277,381,896
"5404","2363矽統","110/08/16","國泰-敦南",408,608,-200
"5405","2363矽統","110/08/16","美林",777,172,605
"5406","2363矽統","110/08/16","台灣摩根士丹利",6,185,-179
"5407","2363矽統","110/08/16","新加坡商瑞銀",764,476,288
"5408","2363矽統","110/08/16","群益金鼎",14,154,-140
"5409","2363矽統","110/08/16","永豐金-嘉義",250,2,248
"5410","2363矽統","110/08/16","富邦-新竹",103,229,-126
"5411","2363矽統","110/08/16","瑞士信貸",247,11,236
"5412","2363矽統","110/08/16","凱基",0,120,-120
"5413","2363矽統","110/08/16","群益金鼎-士林",173,17,156
"5414","2363矽統","110/08/16","元大-大統",25,138,-113
"5415","2363矽統","110/08/16","統一-新竹",151,2,149
"5416","2363矽統","110/08/16","富邦-中壢",17,125,-108
"5417","2363矽統","110/08/16","港商野村",1539,1409,130
"5418","2363矽統","110/08/16","兆豐-天母",1,102,-101
"5419","2363矽統","110/08/16","凱基-長庚",136,12,124
"5420","2363矽統","110/08/16","陽信-石牌",13,105,-92
"5421","2363矽統","110/08/16","台新-三民",156,49,107
"5422","2363矽統","110/08/16","永豐金-新店",8,100,-92
"5423","2363矽統","110/08/16","凱基-南崁",98,26,72
"5424","2363矽統","110/08/16","日盛-北高雄",25,105,-80
"5425","2363矽統","110/08/16","元富-城東",78,9,69
"5426","2363矽統","110/08/16","元大-萬華",36,116,-80
"5427","2363矽統","110/08/16","元大-汐止",144,79,65
"5428","2363矽統","110/08/16","玉山證券",37,116,-79
"5429","2363矽統","110/08/16","永豐金-中壢",91,28,63
"5430","2363矽統","110/08/16","元大-敦南",3,81,-78
"5431","8112至上","110/08/16","合庫證券",140,7,133
"5432","8112至上","110/08/16","摩根大通",19,588,-569
"5433","8112至上","110/08/16","新光-桃園",102,4,98
"5434","8112至上","110/08/16","新加坡商瑞銀",17,338,-321
"5435","8112至上","110/08/16","元大-敦化",80,2,78
"5436","8112至上","110/08/16","瑞士信貸",3,181,-178
"5437","8112至上","110/08/16","元大-台北",71,0,71
"5438","8112至上","110/08/16","美林",84,183,-99
"5439","8112至上","110/08/16","凱基-嘉義",97,37,60
"5440","8112至上","110/08/16","台灣摩根士丹利",9,101,-92
"5441","8112至上","110/08/16","元大-開元",44,1,43
"5442","8112至上","110/08/16","凱基-台北",133,201,-68
"5443","8112至上","110/08/16","永豐金-台中",43,0,43
"5444","8112至上","110/08/16","新光-高雄",3,57,-54
"5445","8112至上","110/08/16","元大-仁愛",40,0,40
"5446","8112至上","110/08/16","新百王",1,51,-50
"5447","8112至上","110/08/16","富邦-仁愛",65,27,38
"5448","8112至上","110/08/16","華南永昌-新莊",2,47,-45
"5449","8112至上","110/08/16","元大-前金",40,3,37
"5450","8112至上","110/08/16","華南永昌-潮州",0,30,-30
"5451","8112至上","110/08/16","富邦-中壢",33,1,32
"5452","8112至上","110/08/16","國票-長城",18,45,-27
"5453","8112至上","110/08/16","統一-中壢",31,0,31
"5454","8112至上","110/08/16","群益金鼎-海山",3,30,-27
"5455","8112至上","110/08/16","台新-台中",32,1,31
"5456","8112至上","110/08/16","元大-發財",1,28,-27
"5457","8112至上","110/08/16","新光",38,11,27
"5458","8112至上","110/08/16","兆豐-斗南",4,30,-26
"5459","8112至上","110/08/16","合庫-嘉義",25,0,25
"5460","8112至上","110/08/16","國泰-板橋",9,32,-23
"5461","1570力肯","110/08/16","兆豐-民生",80,0,80
"5462","1570力肯","110/08/16","台新證券",17,184,-167
"5463","1570力肯","110/08/16","國票-北高雄",145,85,60
"5464","1570力肯","110/08/16","凱基-台北",61,183,-122
"5465","1570力肯","110/08/16","新光",83,31,52
"5466","1570力肯","110/08/16","摩根大通",18,89,-71
"5467","1570力肯","110/08/16","凱基-三峽",40,0,40
"5468","1570力肯","110/08/16","新光-台南",1,50,-49
"5469","1570力肯","110/08/16","元大-大雅",40,0,40
"5470","1570力肯","110/08/16","國泰-松江",0,30,-30
"5471","1570力肯","110/08/16","元富-新竹",30,0,30
"5472","1570力肯","110/08/16","永豐金-桃園",0,30,-30
"5473","1570力肯","110/08/16","富邦-花蓮",29,0,29
"5474","1570力肯","110/08/16","元富-文心",1,23,-22
"5475","1570力肯","110/08/16","統一-高雄",26,1,25
"5476","1570力肯","110/08/16","永豐金-屏東",3,25,-22
"5477","1570力肯","110/08/16","元大-雙和",24,0,24
"5478","1570力肯","110/08/16","台灣摩根士丹利",0,18,-18
"5479","1570力肯","110/08/16","日盛-高雄",21,0,21
"5480","1570力肯","110/08/16","元富-新店",2,20,-18
"5481","1570力肯","110/08/16","國票-和平",27,6,21
"5482","1570力肯","110/08/16","康和-屏東",0,16,-16
"5483","1570力肯","110/08/16","國泰證券",20,0,20
"5484","1570力肯","110/08/16","聯邦-三重",0,15,-15
"5485","1570力肯","110/08/16","群益金鼎-東門",20,0,20
"5486","1570力肯","110/08/16","富邦-內湖",8,21,-13
"5487","1570力肯","110/08/16","元大-民生",19,0,19
"5488","1570力肯","110/08/16","新光-台中",8,20,-12
"5489","1570力肯","110/08/16","元富-民權",15,0,15
"5490","1570力肯","110/08/16","國泰-館前",0,12,-12
"5491","2929淘帝","110/08/16","日盛-中壢",55,1,54
"5492","2929淘帝","110/08/16","摩根大通",10,80,-70
"5493","2929淘帝","110/08/16","元大-太平",31,0,31
"5494","2929淘帝","110/08/16","港商野村",13,57,-44
"5495","2929淘帝","110/08/16","宏遠-館前",30,0,30
"5496","2929淘帝","110/08/16","元大-西門",0,37,-37
"5497","2929淘帝","110/08/16","凱基-東門",24,0,24
"5498","2929淘帝","110/08/16","新加坡商瑞銀",4,26,-22
"5499","2929淘帝","110/08/16","台新-台中",21,0,21
"5500","2929淘帝","110/08/16","元大-大里",0,22,-22
"5501","2929淘帝","110/08/16","日盛-八德",16,0,16
"5502","2929淘帝","110/08/16","兆豐-三重",0,20,-20
"5503","2929淘帝","110/08/16","元富-文心",10,0,10
"5504","2929淘帝","110/08/16","永豐金-鳳山",0,14,-14
"5505","2929淘帝","110/08/16","兆豐-桃園",10,0,10
"5506","2929淘帝","110/08/16","美林",6,17,-11
"5507","2929淘帝","110/08/16","群益金鼎-基隆",10,0,10
"5508","2929淘帝","110/08/16","臺銀-金山",0,10,-10
"5509","2929淘帝","110/08/16","永豐金證券",10,0,10
"5510","2929淘帝","110/08/16","國票-博愛",0,10,-10
"5511","2929淘帝","110/08/16","新光",10,2,8
"5512","2929淘帝","110/08/16","元大-上新莊",2,12,-10
"5513","2929淘帝","110/08/16","元大-承德",8,0,8
"5514","2929淘帝","110/08/16","兆豐-大同",0,9,-9
"5515","2929淘帝","110/08/16","亞東-新竹",7,0,7
"5516","2929淘帝","110/08/16","台新-建北",0,9,-9
"5517","2929淘帝","110/08/16","凱基-林口",7,0,7
"5518","2929淘帝","110/08/16","國泰-館前",0,7,-7
"5519","2929淘帝","110/08/16","凱基-新豐",6,0,6
"5520","2929淘帝","110/08/16","兆豐-台南",0,6,-6
"5521","5410國眾","110/08/16","兆豐-城中",85,0,85
"5522","5410國眾","110/08/16","國泰-敦南",15,99,-84
"5523","5410國眾","110/08/16","元大-六合",42,0,42
"5524","5410國眾","110/08/16","凱基-高雄",0,50,-50
"5525","5410國眾","110/08/16","兆豐-小港",36,0,36
"5526","5410國眾","110/08/16","瑞士信貸",0,44,-44
"5527","5410國眾","110/08/16","凱基-台南",30,0,30
"5528","5410國眾","110/08/16","摩根大通",46,87,-41
"5529","5410國眾","110/08/16","富邦-建國",31,1,30
"5530","5410國眾","110/08/16","元大-士林",0,38,-38
"5531","5410國眾","110/08/16","國票-安和",31,4,27
"5532","5410國眾","110/08/16","兆豐-台中港",0,30,-30
"5533","5410國眾","110/08/16","凱基-竹北",24,0,24
"5534","5410國眾","110/08/16","凱基-台北",27,55,-28
"5535","5410國眾","110/08/16","玉山-新莊",15,0,15
"5536","5410國眾","110/08/16","元大-古亭",0,26,-26
"5537","5410國眾","110/08/16","元大-木柵",12,0,12
"5538","5410國眾","110/08/16","臺銀",1,24,-23
"5539","5410國眾","110/08/16","元大-新盛",12,0,12
"5540","5410國眾","110/08/16","元大-中壢",3,26,-23
"5541","5410國眾","110/08/16","永豐金-台南",12,1,11
"5542","5410國眾","110/08/16","元大-北港",0,21,-21
"5543","5410國眾","110/08/16","合庫-桃園",10,0,10
"5544","5410國眾","110/08/16","元大-北投",0,20,-20
"5545","5410國眾","110/08/16","日盛-屏東",10,0,10
"5546","5410國眾","110/08/16","元富-潮州",0,15,-15
"5547","5410國眾","110/08/16","元富-城東",10,0,10
"5548","5410國眾","110/08/16","臺銀-鳳山",1,15,-14
"5549","5410國眾","110/08/16","富邦-陽明",10,0,10
"5550","5410國眾","110/08/16","元大-屏東",0,14,-14
"5551","2841台開","110/08/16","宏遠-館前",190,0,190
"5552","2841台開","110/08/16","港商野村",0,44,-44
"5553","2841台開","110/08/16","合庫證券",30,0,30
"5554","2841台開","110/08/16","新光-台南",0,33,-33
"5555","2841台開","110/08/16","凱基-竹科",20,0,20
"5556","2841台開","110/08/16","台新證券",10,42,-32
"5557","2841台開","110/08/16","永豐金-中盛",13,0,13
"5558","2841台開","110/08/16","元大-大里德芳",0,30,-30
"5559","2841台開","110/08/16","大慶-蘆洲",10,0,10
"5560","2841台開","110/08/16","合庫-台中",0,28,-28
"5561","2841台開","110/08/16","新光",13,3,10
"5562","2841台開","110/08/16","元大-善化",0,20,-20
"5563","2841台開","110/08/16","元大-新店中正",10,0,10
"5564","2841台開","110/08/16","永豐金-敦南",30,50,-20
"5565","2841台開","110/08/16","群益金鼎-崇德",8,0,8
"5566","2841台開","110/08/16","新加坡商瑞銀",0,16,-16
"5567","2841台開","110/08/16","元富-成功",7,0,7
"5568","2841台開","110/08/16","玉山-新莊",0,16,-16
"5569","2841台開","110/08/16","元大-彰化",7,0,7
"5570","2841台開","110/08/16","日盛-內湖",0,15,-15
"5571","2841台開","110/08/16","台中銀",5,0,5
"5572","2841台開","110/08/16","兆豐-民生",0,15,-15
"5573","2841台開","110/08/16","中國信託-文心",5,0,5
"5574","2841台開","110/08/16","華南永昌-高雄",0,15,-15
"5575","2841台開","110/08/16","兆豐-台中",5,0,5
"5576","2841台開","110/08/16","元大-永康",0,10,-10
"5577","2841台開","110/08/16","台新-新營",5,0,5
"5578","2841台開","110/08/16","元大-北三重",0,10,-10
"5579","2841台開","110/08/16","凱基-東港",10,5,5
"5580","2841台開","110/08/16","永豐金證券",0,10,-10
"5581","6207雷科","110/08/16","台新-高雄",131,3,128
"5582","6207雷科","110/08/16","元大-高雄",0,52,-52
"5583","6207雷科","110/08/16","凱基-台北",70,20,50
"5584","6207雷科","110/08/16","摩根大通",62,112,-50
"5585","6207雷科","110/08/16","元大-東門",42,0,42
"5586","6207雷科","110/08/16","華南永昌-三重",0,50,-50
"5587","6207雷科","110/08/16","永豐金證券",30,0,30
"5588","6207雷科","110/08/16","凱基-復興",0,40,-40
"5589","6207雷科","110/08/16","元大-六合",21,0,21
"5590","6207雷科","110/08/16","元大-潮州",0,40,-40
"5591","6207雷科","110/08/16","群益金鼎-東門",20,0,20
"5592","6207雷科","110/08/16","日盛證券",2,37,-35
"5593","6207雷科","110/08/16","元大-松江",20,0,20
"5594","6207雷科","110/08/16","新加坡商瑞銀",45,80,-35
"5595","6207雷科","110/08/16","大昌-桃園",28,10,18
"5596","6207雷科","110/08/16","玉山-士林",0,27,-27
"5597","6207雷科","110/08/16","統一-新竹",16,0,16
"5598","6207雷科","110/08/16","元大-大統",0,22,-22
"5599","6207雷科","110/08/16","台中銀",15,0,15
"5600","6207雷科","110/08/16","元大-民生",2,24,-22
"5601","6207雷科","110/08/16","中國信託-三重",13,0,13
"5602","6207雷科","110/08/16","凱基-高雄",6,27,-21
"5603","6207雷科","110/08/16","凱基-岡山",11,0,11
"5604","6207雷科","110/08/16","國票-北高雄",0,15,-15
"5605","6207雷科","110/08/16","富邦-中壢",11,0,11
"5606","6207雷科","110/08/16","新光",0,12,-12
"5607","6207雷科","110/08/16","港商野村",27,17,10
"5608","6207雷科","110/08/16","台新-左楠",1,12,-11
"5609","6207雷科","110/08/16","第一金-安和",10,0,10
"5610","6207雷科","110/08/16","新光-台南",0,10,-10
"5611","3679新至陞","110/08/16","凱基-台北",15,2,13
"5612","3679新至陞","110/08/16","摩根大通",7,19,-12
"5613","3679新至陞","110/08/16","台灣摩根士丹利",8,3,5
"5614","3679新至陞","110/08/16","瑞士信貸",0,11,-11
"5615","3679新至陞","110/08/16","國泰-桃園",5,0,5
"5616","3679新至陞","110/08/16","永豐金-苓雅",1,5,-4
"5617","3679新至陞","110/08/16","美商高盛",3,0,3
"5618","3679新至陞","110/08/16","國泰-松江",0,3,-3
"5619","3679新至陞","110/08/16","華南永昌",3,0,3
"5620","3679新至陞","110/08/16","凱基-台南",0,3,-3
"5621","3679新至陞","110/08/16","日盛-竹北",2,0,2
"5622","3679新至陞","110/08/16","彰銀",0,2,-2
"5623","3679新至陞","110/08/16","日盛-文化",3,1,2
"5624","3679新至陞","110/08/16","新加坡商瑞銀",0,2,-2
"5625","3679新至陞","110/08/16","大慶-蘆洲",3,1,2
"5626","3679新至陞","110/08/16","第一金-頭份",0,2,-2
"5627","3679新至陞","110/08/16","國票-九鼎",2,0,2
"5628","3679新至陞","110/08/16","康和-嘉義",0,2,-2
"5629","3679新至陞","110/08/16","華南永昌-高雄",2,0,2
"5630","3679新至陞","110/08/16","凱基-站前",0,2,-2
"5631","3679新至陞","110/08/16","元大-新店中正",2,0,2
"5632","3679新至陞","110/08/16","元大證券",0,2,-2
"5633","3679新至陞","110/08/16","土銀-士林",1,0,1
"5634","3679新至陞","110/08/16","元大-頭份",0,2,-2
"5635","3679新至陞","110/08/16","日盛證券",1,0,1
"5636","3679新至陞","110/08/16","元大-斗信",0,2,-2
"5637","3679新至陞","110/08/16","美林",10,9,1
"5638","3679新至陞","110/08/16","元大-嘉義",0,2,-2
"5639","3679新至陞","110/08/16","第一金-忠孝",1,0,1
"5640","3679新至陞","110/08/16","日盛-龍潭",0,1,-1
"5641","2727王品","110/08/16","瑞士信貸",49,0,49
"5642","2727王品","110/08/16","台新證券",4,162,-158
"5643","2727王品","110/08/16","台灣摩根士丹利",33,3,30
"5644","2727王品","110/08/16","臺銀-鳳山",5,81,-76
"5645","2727王品","110/08/16","新光",37,12,25
"5646","2727王品","110/08/16","玉山-台南",2,33,-31
"5647","2727王品","110/08/16","日盛-忠孝",20,0,20
"5648","2727王品","110/08/16","美商高盛",0,23,-23
"5649","2727王品","110/08/16","元大-東蘆",16,1,15
"5650","2727王品","110/08/16","兆豐-南京",0,20,-20
"5651","2727王品","110/08/16","第一金-台中",15,1,14
"5652","2727王品","110/08/16","凱基-虎尾",0,20,-20
"5653","2727王品","110/08/16","國泰-敦南",29,15,14
"5654","2727王品","110/08/16","中國信託",2,20,-18
"5655","2727王品","110/08/16","第一金-桃園",13,0,13
"5656","2727王品","110/08/16","新光-桃園",2,20,-18
"5657","2727王品","110/08/16","第一金-忠孝",13,1,12
"5658","2727王品","110/08/16","永豐金證券",2,20,-18
"5659","2727王品","110/08/16","摩根大通",24,12,12
"5660","2727王品","110/08/16","統一",6,22,-16
"5661","2727王品","110/08/16","富邦-陽明",15,3,12
"5662","2727王品","110/08/16","合庫證券",2,14,-12
"5663","2727王品","110/08/16","元富-西松",13,2,11
"5664","2727王品","110/08/16","富邦-仁愛",7,19,-12
"5665","2727王品","110/08/16","聯邦-興中",11,0,11
"5666","2727王品","110/08/16","元大-竹科",4,16,-12
"5667","2727王品","110/08/16","中國信託-松江",10,0,10
"5668","2727王品","110/08/16","元大-和平",0,12,-12
"5669","2727王品","110/08/16","凱基-市府",10,0,10
"5670","2727王品","110/08/16","凱基-興隆",1,12,-11
"5671","1570力肯","110/08/16","兆豐-民生",80,0,80
"5672","1570力肯","110/08/16","台新證券",17,184,-167
"5673","1570力肯","110/08/16","國票-北高雄",145,85,60
"5674","1570力肯","110/08/16","凱基-台北",61,183,-122
"5675","1570力肯","110/08/16","新光",83,31,52
"5676","1570力肯","110/08/16","摩根大通",18,89,-71
"5677","1570力肯","110/08/16","凱基-三峽",40,0,40
"5678","1570力肯","110/08/16","新光-台南",1,50,-49
"5679","1570力肯","110/08/16","元大-大雅",40,0,40
"5680","1570力肯","110/08/16","國泰-松江",0,30,-30
"5681","1570力肯","110/08/16","元富-新竹",30,0,30
"5682","1570力肯","110/08/16","永豐金-桃園",0,30,-30
"5683","1570力肯","110/08/16","富邦-花蓮",29,0,29
"5684","1570力肯","110/08/16","元富-文心",1,23,-22
"5685","1570力肯","110/08/16","統一-高雄",26,1,25
"5686","1570力肯","110/08/16","永豐金-屏東",3,25,-22
"5687","1570力肯","110/08/16","元大-雙和",24,0,24
"5688","1570力肯","110/08/16","台灣摩根士丹利",0,18,-18
"5689","1570力肯","110/08/16","日盛-高雄",21,0,21
"5690","1570力肯","110/08/16","元富-新店",2,20,-18
"5691","1570力肯","110/08/16","國票-和平",27,6,21
"5692","1570力肯","110/08/16","康和-屏東",0,16,-16
"5693","1570力肯","110/08/16","國泰證券",20,0,20
"5694","1570力肯","110/08/16","聯邦-三重",0,15,-15
"5695","1570力肯","110/08/16","群益金鼎-東門",20,0,20
"5696","1570力肯","110/08/16","富邦-內湖",8,21,-13
"5697","1570力肯","110/08/16","元大-民生",19,0,19
"5698","1570力肯","110/08/16","新光-台中",8,20,-12
"5699","1570力肯","110/08/16","元富-民權",15,0,15
"5700","1570力肯","110/08/16","國泰-館前",0,12,-12
"5701","6180橘子","110/08/16","美林",85,0,85
"5702","6180橘子","110/08/16","合庫-高雄",2,121,-119
"5703","6180橘子","110/08/16","新加坡商瑞銀",42,8,34
"5704","6180橘子","110/08/16","群益金鼎-三民",0,100,-100
"5705","6180橘子","110/08/16","合庫-自強",30,0,30
"5706","6180橘子","110/08/16","台灣摩根士丹利",0,50,-50
"5707","6180橘子","110/08/16","元大-中壢",23,0,23
"5708","6180橘子","110/08/16","統一",0,30,-30
"5709","6180橘子","110/08/16","新光-桃園",24,2,22
"5710","6180橘子","110/08/16","凱基-台北",0,27,-27
"5711","6180橘子","110/08/16","日盛-板橋",20,0,20
"5712","6180橘子","110/08/16","群益金鼎-大安",0,20,-20
"5713","6180橘子","110/08/16","康和-嘉義",19,0,19
"5714","6180橘子","110/08/16","元大-博愛",1,20,-19
"5715","6180橘子","110/08/16","永豐金-敦北",19,1,18
"5716","6180橘子","110/08/16","元大-文心興安",2,20,-18
"5717","6180橘子","110/08/16","元大-四維",16,0,16
"5718","6180橘子","110/08/16","統一-中壢",0,15,-15
"5719","6180橘子","110/08/16","元大-和平",16,0,16
"5720","6180橘子","110/08/16","元富-宜蘭",2,15,-13
"5721","6180橘子","110/08/16","港商野村",27,12,15
"5722","6180橘子","110/08/16","元大-沙鹿",0,12,-12
"5723","6180橘子","110/08/16","富隆-長安",15,0,15
"5724","6180橘子","110/08/16","元大-清水",0,12,-12
"5725","6180橘子","110/08/16","摩根大通",51,36,15
"5726","6180橘子","110/08/16","臺銀-鳳山",3,14,-11
"5727","6180橘子","110/08/16","美商高盛",15,1,14
"5728","6180橘子","110/08/16","盈溢",0,10,-10
"5729","6180橘子","110/08/16","元大-永和",13,0,13
"5730","6180橘子","110/08/16","元富-世貿",0,10,-10
"5731","2390云辰","110/08/16","富邦-虎尾",514,48,466
"5732","2390云辰","110/08/16","凱基-台北",495,1222,-727
"5733","2390云辰","110/08/16","摩根大通",2747,2369,378
"5734","2390云辰","110/08/16","元富-西松",194,423,-229
"5735","2390云辰","110/08/16","國泰-桃園",291,66,225
"5736","2390云辰","110/08/16","國票-安和",121,349,-228
"5737","2390云辰","110/08/16","元大-木柵",237,23,214
"5738","2390云辰","110/08/16","元大-信義",10,155,-145
"5739","2390云辰","110/08/16","新光",859,695,164
"5740","2390云辰","110/08/16","統一-新台中",6,137,-131
"5741","2390云辰","110/08/16","元大證券",229,67,162
"5742","2390云辰","110/08/16","美林",355,470,-115
"5743","2390云辰","110/08/16","兆豐-埔墘",719,573,146
"5744","2390云辰","110/08/16","台新-高雄",113,208,-95
"5745","2390云辰","110/08/16","永豐金-嘉義",144,20,124
"5746","2390云辰","110/08/16","豐農",37,114,-77
"5747","2390云辰","110/08/16","元大-台中",126,26,100
"5748","2390云辰","110/08/16","國泰-忠孝",15,85,-70
"5749","2390云辰","110/08/16","瑞士信貸",124,28,96
"5750","2390云辰","110/08/16","富邦-北港",154,223,-69
"5751","2390云辰","110/08/16","永豐金-古亭",120,24,96
"5752","2390云辰","110/08/16","凱基-科園",11,79,-68
"5753","2390云辰","110/08/16","富邦-嘉義",2108,2013,95
"5754","2390云辰","110/08/16","華南永昌-台中",82,149,-67
"5755","2390云辰","110/08/16","富邦-內湖",120,26,94
"5756","2390云辰","110/08/16","台新-左楠",61,126,-65
"5757","2390云辰","110/08/16","群益金鼎-三重",142,56,86
"5758","2390云辰","110/08/16","元大-林園",3,67,-64
"5759","2390云辰","110/08/16","元大-前金",200,123,77
"5760","2390云辰","110/08/16","永豐金-萬盛",23,84,-61
"5761","2867三商壽","110/08/13","美商高盛",295,16,279
"5762","2867三商壽","110/08/13","摩根大通",109,286,-177
"5763","2867三商壽","110/08/13","大慶-中壢",183,1,182
"5764","2867三商壽","110/08/13","元大-佳里",0,113,-113
"5765","2867三商壽","110/08/13","新加坡商瑞銀",121,0,121
"5766","2867三商壽","110/08/13","元大-崇德",0,103,-103
"5767","2867三商壽","110/08/13","凱基-五股",100,0,100
"5768","2867三商壽","110/08/13","台灣摩根士丹利",9,83,-74
"5769","2867三商壽","110/08/13","元大-桃園",100,1,99
"5770","2867三商壽","110/08/13","國泰-台南",1,73,-72
"5771","2867三商壽","110/08/13","凱基-虎尾",90,0,90
"5772","2867三商壽","110/08/13","元大證券",1,62,-61
"5773","2867三商壽","110/08/13","華南永昌-高雄",100,10,90
"5774","2867三商壽","110/08/13","元大-台中",0,60,-60
"5775","2867三商壽","110/08/13","兆豐-北高雄",81,2,79
"5776","2867三商壽","110/08/13","元大-大同",0,53,-53
"5777","2867三商壽","110/08/13","新光",105,39,66
"5778","2867三商壽","110/08/13","兆豐-鹿港",0,50,-50
"5779","2867三商壽","110/08/13","富邦-彰化",60,0,60
"5780","2867三商壽","110/08/13","合庫-西台中",2,50,-48
"5781","2867三商壽","110/08/13","富邦-台南",60,0,60
"5782","2867三商壽","110/08/13","新光-台中",7,53,-46
"5783","2867三商壽","110/08/13","玉山-板橋",60,1,59
"5784","2867三商壽","110/08/13","元大-大益",0,44,-44
"5785","2867三商壽","110/08/13","群益金鼎-新竹",56,0,56
"5786","2867三商壽","110/08/13","亞東-板橋",0,36,-36
"5787","2867三商壽","110/08/13","元大-大統",53,0,53
"5788","2867三商壽","110/08/13","福邦證券",0,34,-34
"5789","2867三商壽","110/08/13","瑞士信貸",55,3,52
"5790","2867三商壽","110/08/13","元大-博愛",16,50,-34
"5791","5521工信","110/08/13","日進",100,0,100
"5792","5521工信","110/08/13","美林",1,87,-86
"5793","5521工信","110/08/13","摩根大通",180,102,78
"5794","5521工信","110/08/13","日盛-復興",1,70,-69
"5795","5521工信","110/08/13","元大-鳳山",30,0,30
"5796","5521工信","110/08/13","永豐金-鳳山",1,60,-59
"5797","5521工信","110/08/13","(牛牛牛)亞-鑫豐",28,2,26
"5798","5521工信","110/08/13","中國信託-三重",0,52,-52
"5799","5521工信","110/08/13","新光",24,0,24
"5800","5521工信","110/08/13","華南永昌-民權",0,50,-50
"5801","5521工信","110/08/13","華南永昌-彰化",21,0,21
"5802","5521工信","110/08/13","第一金-新竹",0,34,-34
"5803","5521工信","110/08/13","台灣企銀-建成",20,0,20
"5804","5521工信","110/08/13","凱基-台北",18,49,-31
"5805","5521工信","110/08/13","大昌",20,0,20
"5806","5521工信","110/08/13","元大-新莊",10,38,-28
"5807","5521工信","110/08/13","兆豐-中壢",20,0,20
"5808","5521工信","110/08/13","台灣摩根士丹利",2,28,-26
"5809","5521工信","110/08/13","國票-和平",20,0,20
"5810","5521工信","110/08/13","華南永昌",0,23,-23
"5811","5521工信","110/08/13","元大-基隆孝二",20,0,20
"5812","5521工信","110/08/13","統一-板橋",0,20,-20
"5813","5521工信","110/08/13","日盛-中和",19,0,19
"5814","5521工信","110/08/13","港商法國興業",0,17,-17
"5815","5521工信","110/08/13","兆豐-小港",19,0,19
"5816","5521工信","110/08/13","元大-府城",0,16,-16
"5817","5521工信","110/08/13","富邦-高雄",17,0,17
"5818","5521工信","110/08/13","元大-敦化",0,16,-16
"5819","5521工信","110/08/13","統一-員林",15,0,15
"5820","5521工信","110/08/13","新光-新竹",5,20,-15
"5821","1471首利","110/08/13","聯邦-高雄",42,0,42
"5822","1471首利","110/08/13","摩根大通",41,220,-179
"5823","1471首利","110/08/13","元大-西門",40,0,40
"5824","1471首利","110/08/13","元大-敦化",0,100,-100
"5825","1471首利","110/08/13","元大-大灣",37,0,37
"5826","1471首利","110/08/13","美林",0,69,-69
"5827","1471首利","110/08/13","第一金-台南",30,0,30
"5828","1471首利","110/08/13","瑞士信貸",5,65,-60
"5829","1471首利","110/08/13","元富-大昌",25,0,25
"5830","1471首利","110/08/13","美商高盛",0,51,-51
"5831","1471首利","110/08/13","大慶-中壢",20,0,20
"5832","1471首利","110/08/13","華南永昌-苗栗",5,30,-25
"5833","1471首利","110/08/13","凱基-台南",20,0,20
"5834","1471首利","110/08/13","玉山-台南",0,22,-22
"5835","1471首利","110/08/13","新光",19,0,19
"5836","1471首利","110/08/13","元富-民權",0,20,-20
"5837","1471首利","110/08/13","凱基-羅東",17,0,17
"5838","1471首利","110/08/13","中國信託",0,20,-20
"5839","1471首利","110/08/13","永豐金-台南",20,4,16
"5840","1471首利","110/08/13","凱基-五股",0,20,-20
"5841","1471首利","110/08/13","元大-屏東",14,0,14
"5842","1471首利","110/08/13","台灣摩根士丹利",0,17,-17
"5843","1471首利","110/08/13","新光-台中",16,4,12
"5844","1471首利","110/08/13","兆豐-員林",2,15,-13
"5845","1471首利","110/08/13","元大-頭份",12,0,12
"5846","1471首利","110/08/13","日盛-宜蘭",0,10,-10
"5847","1471首利","110/08/13","凱基-三重",11,0,11
"5848","1471首利","110/08/13","元富-緯城",1,10,-9
"5849","1471首利","110/08/13","日盛-鳳山",10,0,10
"5850","1471首利","110/08/13","國泰-台中",2,8,-6
"5851","2883開發金","110/08/13","凱基-台北",23196,4416,18780
"5852","2883開發金","110/08/13","永豐金-彰化",79,4793,-4714
"5853","2883開發金","110/08/13","摩根大通",24818,6057,18761
"5854","2883開發金","110/08/13","第一金-忠孝",55,4613,-4558
"5855","2883開發金","110/08/13","新加坡商瑞銀",6645,205,6440
"5856","2883開發金","110/08/13","台新證券",1316,5539,-4223
"5857","2883開發金","110/08/13","中國信託-文心",4723,123,4600
"5858","2883開發金","110/08/13","日盛證券",587,3754,-3167
"5859","2883開發金","110/08/13","美林",6276,1780,4496
"5860","2883開發金","110/08/13","群益金鼎-大甲",48,2429,-2381
"5861","2883開發金","110/08/13","國泰證券",3682,17,3665
"5862","2883開發金","110/08/13","永豐金證券",169,1849,-1680
"5863","2883開發金","110/08/13","台灣摩根士丹利",3927,582,3345
"5864","2883開發金","110/08/13","華南永昌-南京",169,1407,-1238
"5865","2883開發金","110/08/13","群益金鼎",2401,367,2034
"5866","2883開發金","110/08/13","凱基-台東",270,1494,-1224
"5867","2883開發金","110/08/13","香港上海匯豐",2006,0,2006
"5868","2883開發金","110/08/13","日盛-板橋",207,1398,-1191
"5869","2883開發金","110/08/13","兆豐證券",1776,128,1648
"5870","2883開發金","110/08/13","元大-萬華",78,1243,-1165
"5871","2883開發金","110/08/13","瑞士信貸",3551,2174,1377
"5872","2883開發金","110/08/13","富邦-台北",295,1428,-1133
"5873","2883開發金","110/08/13","港商野村",7299,6088,1211
"5874","2883開發金","110/08/13","元大-成功",216,1287,-1071
"5875","2883開發金","110/08/13","美商高盛",1016,0,1016
"5876","2883開發金","110/08/13","新光-台中",485,1519,-1034
"5877","2883開發金","110/08/13","元大-大灣",1183,214,969
"5878","2883開發金","110/08/13","國票",232,1261,-1029
"5879","2883開發金","110/08/13","花旗環球",1104,284,820
"5880","2883開發金","110/08/13","永豐金-桃園",141,1157,-1016
"5881","6205詮欣","110/08/13","合庫-三重",15,0,15
"5882","6205詮欣","110/08/13","摩根大通",3,17,-14
"5883","6205詮欣","110/08/13","港商法國興業",11,0,11
"5884","6205詮欣","110/08/13","元大-善化",0,10,-10
"5885","6205詮欣","110/08/13","臺銀-民權",7,0,7
"5886","6205詮欣","110/08/13","元大-台中中港",0,3,-3
"5887","6205詮欣","110/08/13","日盛-三重",5,0,5
"5888","6205詮欣","110/08/13","合庫-鳳山",0,2,-2
"5889","6205詮欣","110/08/13","群益金鼎-屏東",5,0,5
"5890","6205詮欣","110/08/13","元富-潮州",0,2,-2
"5891","6205詮欣","110/08/13","德信-新營",3,0,3
"5892","6205詮欣","110/08/13","兆豐-桃鶯",0,2,-2
"5893","6205詮欣","110/08/13","美林",2,0,2
"5894","6205詮欣","110/08/13","致和-台北",0,2,-2
"5895","6205詮欣","110/08/13","兆豐-西螺",1,0,1
"5896","6205詮欣","110/08/13","華南永昌-三重",0,2,-2
"5897","6205詮欣","110/08/13","新光-台中",1,0,1
"5898","6205詮欣","110/08/13","土銀-台中",0,1,-1
"5899","6205詮欣","110/08/13","聯邦-嘉義",1,0,1
"5900","6205詮欣","110/08/13","日盛-中壢",0,1,-1
"5901","6205詮欣","110/08/13","玉山-南京東路",1,0,1
"5902","6205詮欣","110/08/13","美商高盛",0,1,-1
"5903","6205詮欣","110/08/13","群益金鼎-中港",1,0,1
"5904","6205詮欣","110/08/13","大展-台南",0,1,-1
"5905","6205詮欣","110/08/13","凱基-大安",1,0,1
"5906","6205詮欣","110/08/13","第一金-彰化",0,1,-1
"5907","6205詮欣","110/08/13","元大-仁愛",1,0,1
"5908","6205詮欣","110/08/13","統一-三重",1,2,-1
"5909","6205詮欣","110/08/13","元大-台南",1,0,1
"5910","6205詮欣","110/08/13","元富-桃園",0,1,-1
"5911","1540喬福","110/08/13","元富-中原",100,0,100
"5912","1540喬福","110/08/13","日盛-文化",0,48,-48
"5913","1540喬福","110/08/13","台新-台中",31,0,31
"5914","1540喬福","110/08/13","凱基-台北",0,33,-33
"5915","1540喬福","110/08/13","兆豐-北高雄",18,0,18
"5916","1540喬福","110/08/13","元大-大安",0,32,-32
"5917","1540喬福","110/08/13","元大-土城永寧",11,0,11
"5918","1540喬福","110/08/13","合庫-台中",2,23,-21
"5919","1540喬福","110/08/13","(牛牛牛)亞-鑫豐",10,0,10
"5920","1540喬福","110/08/13","華南永昌-楠梓",0,20,-20
"5921","1540喬福","110/08/13","凱基-中壢",7,0,7
"5922","1540喬福","110/08/13","群益金鼎-館前",1,20,-19
"5923","1540喬福","110/08/13","安泰",5,0,5
"5924","1540喬福","110/08/13","富邦-花蓮",0,15,-15
"5925","1540喬福","110/08/13","群益金鼎-古亭",5,0,5
"5926","1540喬福","110/08/13","日盛-景美",0,10,-10
"5927","1540喬福","110/08/13","元富-緯城",4,0,4
"5928","1540喬福","110/08/13","台新-高雄",0,9,-9
"5929","1540喬福","110/08/13","兆豐-南京",4,0,4
"5930","1540喬福","110/08/13","玉山-大里",0,8,-8
"5931","1540喬福","110/08/13","凱基-台中",4,0,4
"5932","1540喬福","110/08/13","元大-斗信",0,8,-8
"5933","1540喬福","110/08/13","凱基-台南",5,1,4
"5934","1540喬福","110/08/13","新光-台南",0,6,-6
"5935","1540喬福","110/08/13","元大-龍潭",4,0,4
"5936","1540喬福","110/08/13","兆豐-板橋",0,5,-5
"5937","1540喬福","110/08/13","兆豐-高雄",3,0,3
"5938","1540喬福","110/08/13","富邦-彰化",0,5,-5
"5939","1540喬福","110/08/13","兆豐-鹿港",3,0,3
"5940","1540喬福","110/08/13","美林",0,4,-4
"5941","2888新光金","110/08/13","永豐金-天母",2112,0,2112
"5942","2888新光金","110/08/13","摩根大通",308,3587,-3279
"5943","2888新光金","110/08/13","合庫-西台中",2116,5,2111
"5944","2888新光金","110/08/13","玉山-嘉義",7,1514,-1507
"5945","2888新光金","110/08/13","統一-新竹",1706,0,1706
"5946","2888新光金","110/08/13","國票-台東",0,1500,-1500
"5947","2888新光金","110/08/13","凱基-台北",3076,1640,1436
"5948","2888新光金","110/08/13","台灣摩根士丹利",127,1148,-1021
"5949","2888新光金","110/08/13","元大證券",1418,10,1408
"5950","2888新光金","110/08/13","華南永昌-岡山",62,930,-868
"5951","2888新光金","110/08/13","康和",761,2,759
"5952","2888新光金","110/08/13","港商野村",47,827,-780
"5953","2888新光金","110/08/13","富邦-仁愛",739,52,687
"5954","2888新光金","110/08/13","美商高盛",697,1236,-539
"5955","2888新光金","110/08/13","新加坡商瑞銀",716,121,595
"5956","2888新光金","110/08/13","日盛-八德",88,572,-484
"5957","2888新光金","110/08/13","富邦-彰化",588,12,576
"5958","2888新光金","110/08/13","群益金鼎-三重",1,437,-436
"5959","2888新光金","110/08/13","玉山證券",558,12,546
"5960","2888新光金","110/08/13","永豐金-嘉義",52,472,-420
"5961","2888新光金","110/08/13","群益金鼎-瑞豐",550,10,540
"5962","2888新光金","110/08/13","元富-城東",7,390,-383
"5963","2888新光金","110/08/13","元大-三重",523,0,523
"5964","2888新光金","110/08/13","群益金鼎-高雄",6,387,-381
"5965","2888新光金","110/08/13","永豐金-博愛",420,27,393
"5966","2888新光金","110/08/13","凱基-宜蘭",9,379,-370
"5967","2888新光金","110/08/13","第一金-豐原",364,20,344
"5968","2888新光金","110/08/13","美林",938,1287,-349
"5969","2888新光金","110/08/13","國票-九鼎",317,3,314
"5970","2888新光金","110/08/13","華南永昌-台中",0,329,-329
"5971","1340勝悅","110/08/13","元富-成功",72,0,72
"5972","1340勝悅","110/08/13","元大-忠孝",0,36,-36
"5973","1340勝悅","110/08/13","元大-博愛",10,0,10
"5974","1340勝悅","110/08/13","新光",4,21,-17
"5975","1340勝悅","110/08/13","臺灣企銀-埔墘",5,0,5
"5976","1340勝悅","110/08/13","摩根大通",3,19,-16
"5977","1340勝悅","110/08/13","元大-新莊",5,0,5
"5978","1340勝悅","110/08/13","群益金鼎-三重",0,15,-15
"5979","1340勝悅","110/08/13","美商高盛",4,0,4
"5980","1340勝悅","110/08/13","日盛-永康",0,10,-10
"5981","1340勝悅","110/08/13","國泰-敦南",6,2,4
"5982","1340勝悅","110/08/13","華南永昌-合泰",0,10,-10
"5983","1340勝悅","110/08/13","統一-城中",6,3,3
"5984","1340勝悅","110/08/13","日盛-木柵",0,8,-8
"5985","1340勝悅","110/08/13","元富-新店",3,0,3
"5986","1340勝悅","110/08/13","港商法國興業",0,6,-6
"5987","1340勝悅","110/08/13","玉山-士林",3,0,3
"5988","1340勝悅","110/08/13","群益金鼎-中港",0,5,-5
"5989","1340勝悅","110/08/13","群益金鼎-館前",4,1,3
"5990","1340勝悅","110/08/13","第一金-自由",0,4,-4
"5991","1340勝悅","110/08/13","元富-安南",2,0,2
"5992","1340勝悅","110/08/13","兆豐-新營",0,4,-4
"5993","1340勝悅","110/08/13","大昌-樹林",2,0,2
"5994","1340勝悅","110/08/13","國泰-台中",1,5,-4
"5995","1340勝悅","110/08/13","群益金鼎",2,0,2
"5996","1340勝悅","110/08/13","元大-林園",0,4,-4
"5997","1340勝悅","110/08/13","群益金鼎-北高雄",2,0,2
"5998","1340勝悅","110/08/13","元大-四維",0,4,-4
"5999","1340勝悅","110/08/13","華南永昌",2,0,2
"6000","1340勝悅","110/08/13","美林",0,2,-2
"6001","6246臺龍","110/08/13","華南永昌-彰化",31,0,31
"6002","6246臺龍","110/08/13","永豐金-內湖",0,95,-95
"6003","6246臺龍","110/08/13","合庫-台中",23,0,23
"6004","6246臺龍","110/08/13","玉山-大里",0,21,-21
"6005","6246臺龍","110/08/13","兆豐-忠孝",24,3,21
"6006","6246臺龍","110/08/13","新光-新竹",0,20,-20
"6007","6246臺龍","110/08/13","元大-台北",16,0,16
"6008","6246臺龍","110/08/13","台新-台中",1,19,-18
"6009","6246臺龍","110/08/13","元大-新莊",11,1,10
"6010","6246臺龍","110/08/13","光和",2,17,-15
"6011","6246臺龍","110/08/13","德信-新營",9,0,9
"6012","6246臺龍","110/08/13","日盛-高雄",0,10,-10
"6013","6246臺龍","110/08/13","凱基-永和",9,0,9
"6014","6246臺龍","110/08/13","元富-世貿",0,10,-10
"6015","6246臺龍","110/08/13","港商野村",20,12,8
"6016","6246臺龍","110/08/13","(牛牛牛)亞-鑫豐",1,11,-10
"6017","6246臺龍","110/08/13","富邦-建國",8,0,8
"6018","6246臺龍","110/08/13","國泰-敦南",6,16,-10
"6019","6246臺龍","110/08/13","群益金鼎-開元",12,5,7
"6020","6246臺龍","110/08/13","永豐金-市政",1,10,-9
"6021","6246臺龍","110/08/13","群益金鼎-古亭",7,0,7
"6022","6246臺龍","110/08/13","華南永昌-嘉義",0,8,-8
"6023","6246臺龍","110/08/13","凱基-高美館",7,0,7
"6024","6246臺龍","110/08/13","富邦-敦南",4,11,-7
"6025","6246臺龍","110/08/13","元大-東蘆",10,3,7
"6026","6246臺龍","110/08/13","第一金-彰化",6,12,-6
"6027","6246臺龍","110/08/13","元大-金華",8,1,7
"6028","6246臺龍","110/08/13","新光-桃園",2,8,-6
"6029","6246臺龍","110/08/13","永豐金-松山",7,0,7
"6030","6246臺龍","110/08/13","凱基-竹科",0,6,-6
"6031","00715L期街口布蘭特正2","110/08/13","元大證券",6162,789,5373
"6032","00715L期街口布蘭特正2","110/08/13","元大-四維",2,1000,-998
"6033","00715L期街口布蘭特正2","110/08/13","元富",1528,0,1528
"6034","00715L期街口布蘭特正2","110/08/13","玉山-嘉義",20,1016,-996
"6035","00715L期街口布蘭特正2","110/08/13","合庫證券",1153,0,1153
"6036","00715L期街口布蘭特正2","110/08/13","群益金鼎-古亭",0,666,-666
"6037","00715L期街口布蘭特正2","110/08/13","富邦證券",1029,290,739
"6038","00715L期街口布蘭特正2","110/08/13","富邦-員林",9,489,-480
"6039","00715L期街口布蘭特正2","110/08/13","台新-台中",284,9,275
"6040","00715L期街口布蘭特正2","110/08/13","元大-嘉義",1,400,-399
"6041","00715L期街口布蘭特正2","110/08/13","兆豐-台中",238,0,238
"6042","00715L期街口布蘭特正2","110/08/13","臺銀-新竹",2,360,-358
"6043","00715L期街口布蘭特正2","110/08/13","統一-桃園",283,80,203
"6044","00715L期街口布蘭特正2","110/08/13","日盛-二林",0,300,-300
"6045","00715L期街口布蘭特正2","110/08/13","群益金鼎-屏東",200,0,200
"6046","00715L期街口布蘭特正2","110/08/13","群益金鼎-延平",100,400,-300
"6047","00715L期街口布蘭特正2","110/08/13","元富-虎尾",172,0,172
"6048","00715L期街口布蘭特正2","110/08/13","元大-中和",175,450,-275
"6049","00715L期街口布蘭特正2","110/08/13","凱基-五股",163,0,163
"6050","00715L期街口布蘭特正2","110/08/13","第一金-彰化",5,230,-225
"6051","00715L期街口布蘭特正2","110/08/13","國泰-台南",155,19,136
"6052","00715L期街口布蘭特正2","110/08/13","元大-大里",16,225,-209
"6053","00715L期街口布蘭特正2","110/08/13","永豐金證券",482,350,132
"6054","00715L期街口布蘭特正2","110/08/13","港商野村",7,212,-205
"6055","00715L期街口布蘭特正2","110/08/13","元大-內湖",110,0,110
"6056","00715L期街口布蘭特正2","110/08/13","合庫-新竹",1,199,-198
"6057","00715L期街口布蘭特正2","110/08/13","兆豐-嘉義",103,0,103
"6058","00715L期街口布蘭特正2","110/08/13","高橋",9,205,-196
"6059","00715L期街口布蘭特正2","110/08/13","群益金鼎-土城",100,0,100
"6060","00715L期街口布蘭特正2","110/08/13","國泰-敦南",78,271,-193
"6061","8941關中","110/08/13","宏遠-館前",3,0,3
"6062","8941關中","110/08/13","日盛-信義",0,2,-2
"6063","8941關中","110/08/13","國泰-忠孝",1,0,1
"6064","8941關中","110/08/13","宏遠-中和",0,1,-1
"6065","8941關中","110/08/13","康和-板橋",0,0,0
"6066","8941關中","110/08/13","康和-嘉義",0,1,-1
"6067","8941關中","110/08/13","富邦-左營",0,0,0
"6068","8941關中","110/08/13","康和-板橋",0,0,0
"6069","8941關中","110/08/13","元大-松江",0,0,0
"6070","8941關中","110/08/13","富邦-左營",0,0,0
"6071","8941關中","110/08/13","元大-淡水",0,0,0
"6072","8941關中","110/08/13","元大-松江",0,0,0
"6073","8941關中","110/08/13","",NA,NA,NA
"6074","8941關中","110/08/13","元大-淡水",0,0,0
"6075","8941關中","110/08/13","",NA,NA,NA
"6076","8941關中","110/08/13","",NA,NA,NA
"6077","8941關中","110/08/13","",NA,NA,NA
"6078","8941關中","110/08/13","",NA,NA,NA
"6079","8941關中","110/08/13","",NA,NA,NA
"6080","8941關中","110/08/13","",NA,NA,NA
"6081","8941關中","110/08/13","",NA,NA,NA
"6082","8941關中","110/08/13","",NA,NA,NA
"6083","8941關中","110/08/13","",NA,NA,NA
"6084","8941關中","110/08/13","",NA,NA,NA
"6085","8941關中","110/08/13","",NA,NA,NA
"6086","8941關中","110/08/13","",NA,NA,NA
"6087","8941關中","110/08/13","",NA,NA,NA
"6088","8941關中","110/08/13","",NA,NA,NA
"6089","8941關中","110/08/13","",NA,NA,NA
"6090","8941關中","110/08/13","",NA,NA,NA
"6091","8936國統","110/08/13","台新-高雄",127,0,127
"6092","8936國統","110/08/13","第一金-豐原",0,60,-60
"6093","8936國統","110/08/13","美林",84,18,66
"6094","8936國統","110/08/13","凱基-台北",1,50,-49
"6095","8936國統","110/08/13","摩根大通",40,14,26
"6096","8936國統","110/08/13","凱基-高美館",8,51,-43
"6097","8936國統","110/08/13","凱基-台南",23,0,23
"6098","8936國統","110/08/13","港商野村",8,39,-31
"6099","8936國統","110/08/13","第一金-路竹",20,0,20
"6100","8936國統","110/08/13","日盛-忠孝",0,25,-25
"6101","8936國統","110/08/13","元大-敦化",17,0,17
"6102","8936國統","110/08/13","群益金鼎-台中",0,20,-20
"6103","8936國統","110/08/13","新光-台中",22,6,16
"6104","8936國統","110/08/13","台新-台南",0,15,-15
"6105","8936國統","110/08/13","元大-文心",15,0,15
"6106","8936國統","110/08/13","元大-博愛",0,14,-14
"6107","8936國統","110/08/13","元大-敦南",14,0,14
"6108","8936國統","110/08/13","合庫-台南",0,10,-10
"6109","8936國統","110/08/13","日盛-北高雄",12,0,12
"6110","8936國統","110/08/13","新光-桃園",0,10,-10
"6111","8936國統","110/08/13","元大-西螺",10,0,10
"6112","8936國統","110/08/13","永豐金-南投",0,10,-10
"6113","8936國統","110/08/13","彰銀",8,0,8
"6114","8936國統","110/08/13","永豐金-竹科",0,10,-10
"6115","8936國統","110/08/13","元富-大昌",8,0,8
"6116","8936國統","110/08/13","富邦-竹北",0,8,-8
"6117","8936國統","110/08/13","富邦-南屯",10,2,8
"6118","8936國統","110/08/13","元大-大里德芳",5,13,-8
"6119","8936國統","110/08/13","元大-天母",7,0,7
"6120","8936國統","110/08/13","台新證券",0,7,-7
"6121","6226光鼎","110/08/13","國泰-敦南",676,469,207
"6122","6226光鼎","110/08/13","摩根大通",267,1531,-1264
"6123","6226光鼎","110/08/13","元富-新竹",163,19,144
"6124","6226光鼎","110/08/13","美商高盛",149,1352,-1203
"6125","6226光鼎","110/08/13","合庫-台中",461,334,127
"6126","6226光鼎","110/08/13","瑞士信貸",52,752,-700
"6127","6226光鼎","110/08/13","國泰-台中",734,609,125
"6128","6226光鼎","110/08/13","凱基-台北",84,488,-404
"6129","6226光鼎","110/08/13","元大-小港",198,88,110
"6130","6226光鼎","110/08/13","台新-中壢",2,226,-224
"6131","6226光鼎","110/08/13","凱基-永和",91,0,91
"6132","6226光鼎","110/08/13","元大-文心興安",44,216,-172
"6133","6226光鼎","110/08/13","元大-西螺",82,5,77
"6134","6226光鼎","110/08/13","美林",234,376,-142
"6135","6226光鼎","110/08/13","永豐金-南京",78,1,77
"6136","6226光鼎","110/08/13","凱基-嘉義",12,126,-114
"6137","6226光鼎","110/08/13","群益金鼎-萬華",78,9,69
"6138","6226光鼎","110/08/13","富邦-陽明",23,117,-94
"6139","6226光鼎","110/08/13","日盛-八德",63,1,62
"6140","6226光鼎","110/08/13","兆豐-大安",4,85,-81
"6141","6226光鼎","110/08/13","凱基-桃園",88,27,61
"6142","6226光鼎","110/08/13","永豐金-中盛",27,107,-80
"6143","6226光鼎","110/08/13","凱基-岡山",62,1,61
"6144","6226光鼎","110/08/13","元大證券",232,304,-72
"6145","6226光鼎","110/08/13","臺銀-鳳山",110,52,58
"6146","6226光鼎","110/08/13","凱基-台中",19,84,-65
"6147","6226光鼎","110/08/13","元大-板橋三民",114,56,58
"6148","6226光鼎","110/08/13","元大-士林",107,171,-64
"6149","6226光鼎","110/08/13","凱基-板橋",195,140,55
"6150","6226光鼎","110/08/13","富邦-高雄",15,69,-54
"6151","2363矽統","110/08/13","美商高盛",416,10,406
"6152","2363矽統","110/08/13","元大-佳里",319,1216,-897
"6153","2363矽統","110/08/13","土銀",374,14,360
"6154","2363矽統","110/08/13","瑞士信貸",0,836,-836
"6155","2363矽統","110/08/13","玉山-台中",289,18,271
"6156","2363矽統","110/08/13","永豐金-中正",22,676,-654
"6157","2363矽統","110/08/13","大展",244,10,234
"6158","2363矽統","110/08/13","台灣摩根士丹利",116,566,-450
"6159","2363矽統","110/08/13","永豐金-板盛",172,22,150
"6160","2363矽統","110/08/13","宏遠-桃園",11,359,-348
"6161","2363矽統","110/08/13","富邦-仁愛",198,49,149
"6162","2363矽統","110/08/13","國泰-敦南",671,911,-240
"6163","2363矽統","110/08/13","日盛-北高雄",206,85,121
"6164","2363矽統","110/08/13","元大證券",126,352,-226
"6165","2363矽統","110/08/13","台新-三民",163,55,108
"6166","2363矽統","110/08/13","花旗環球",0,223,-223
"6167","2363矽統","110/08/13","元富-新店",130,23,107
"6168","2363矽統","110/08/13","臺銀",48,259,-211
"6169","2363矽統","110/08/13","永豐金-桃盛",108,5,103
"6170","2363矽統","110/08/13","摩根大通",268,460,-192
"6171","2363矽統","110/08/13","元大-復北",129,28,101
"6172","2363矽統","110/08/13","國票",63,248,-185
"6173","2363矽統","110/08/13","台新-屏東",116,18,98
"6174","2363矽統","110/08/13","台新-高雄",91,263,-172
"6175","2363矽統","110/08/13","華南永昌-虎尾",180,87,93
"6176","2363矽統","110/08/13","合庫證券",18,177,-159
"6177","2363矽統","110/08/13","元大-板橋",101,10,91
"6178","2363矽統","110/08/13","第一金-華江",65,206,-141
"6179","2363矽統","110/08/13","新光",343,260,83
"6180","2363矽統","110/08/13","中國信託-忠孝",65,201,-136
"6181","8112至上","110/08/13","合庫證券",160,5,155
"6182","8112至上","110/08/13","摩根大通",123,818,-695
"6183","8112至上","110/08/13","凱基-竹科",140,12,128
"6184","8112至上","110/08/13","美林",22,299,-277
"6185","8112至上","110/08/13","臺灣企銀-桃園",126,0,126
"6186","8112至上","110/08/13","第一金-華江",4,158,-154
"6187","8112至上","110/08/13","統一-中壢",79,1,78
"6188","8112至上","110/08/13","群益金鼎-基隆",1,117,-116
"6189","8112至上","110/08/13","港商麥格理",86,9,77
"6190","8112至上","110/08/13","新光-桃園",2,100,-98
"6191","8112至上","110/08/13","富邦-新竹",78,2,76
"6192","8112至上","110/08/13","永興-水湳",0,95,-95
"6193","8112至上","110/08/13","凱基-復興",67,0,67
"6194","8112至上","110/08/13","凱基-新店",50,141,-91
"6195","8112至上","110/08/13","合庫-西台中",62,2,60
"6196","8112至上","110/08/13","元富-新興",3,91,-88
"6197","8112至上","110/08/13","大慶",60,0,60
"6198","8112至上","110/08/13","凱基-台北",60,148,-88
"6199","8112至上","110/08/13","日盛-新竹",59,2,57
"6200","8112至上","110/08/13","國票-中和",4,90,-86
"6201","8112至上","110/08/13","元大-開元",53,0,53
"6202","8112至上","110/08/13","新加坡商瑞銀",5,88,-83
"6203","8112至上","110/08/13","富邦-中壢",51,4,47
"6204","8112至上","110/08/13","宏遠-民生",2,52,-50
"6205","8112至上","110/08/13","富邦-桃園",46,0,46
"6206","8112至上","110/08/13","群益金鼎-竹南",0,50,-50
"6207","8112至上","110/08/13","合庫-嘉義",44,0,44
"6208","8112至上","110/08/13","新百王",2,50,-48
"6209","8112至上","110/08/13","元大-府城",55,11,44
"6210","8112至上","110/08/13","港商野村",13,60,-47
"6211","1570力肯","110/08/13","新光",147,12,135
"6212","1570力肯","110/08/13","(牛牛牛)亞-鑫豐",15,136,-121
"6213","1570力肯","110/08/13","國票-北高雄",128,0,128
"6214","1570力肯","110/08/13","富邦-台中",0,51,-51
"6215","1570力肯","110/08/13","凱基-台北",80,24,56
"6216","1570力肯","110/08/13","日盛-頭份",0,50,-50
"6217","1570力肯","110/08/13","統一",54,0,54
"6218","1570力肯","110/08/13","元富-高雄",0,40,-40
"6219","1570力肯","110/08/13","國票-內壢",49,1,48
"6220","1570力肯","110/08/13","凱基-高美館",2,41,-39
"6221","1570力肯","110/08/13","美林",37,0,37
"6222","1570力肯","110/08/13","日盛-忠孝",0,38,-38
"6223","1570力肯","110/08/13","國票-天祥",45,8,37
"6224","1570力肯","110/08/13","元大-羅東",0,20,-20
"6225","1570力肯","110/08/13","摩根大通",67,45,22
"6226","1570力肯","110/08/13","元大-大天母",0,20,-20
"6227","1570力肯","110/08/13","永豐金-屏東",22,0,22
"6228","1570力肯","110/08/13","永豐金-嘉義",0,20,-20
"6229","1570力肯","110/08/13","元富-新店",20,0,20
"6230","1570力肯","110/08/13","國泰-敦南",2,20,-18
"6231","1570力肯","110/08/13","(牛牛牛)亞證券",20,0,20
"6232","1570力肯","110/08/13","元大-沙鹿",1,18,-17
"6233","1570力肯","110/08/13","凱基-台南",20,0,20
"6234","1570力肯","110/08/13","元大-林森",0,16,-16
"6235","1570力肯","110/08/13","元大-開元",20,0,20
"6236","1570力肯","110/08/13","永豐金-市政",1,16,-15
"6237","1570力肯","110/08/13","元大-花蓮",20,0,20
"6238","1570力肯","110/08/13","統一-三重",5,19,-14
"6239","1570力肯","110/08/13","元大-基隆",19,0,19
"6240","1570力肯","110/08/13","國泰-新莊",1,15,-14
"6241","2929淘帝","110/08/13","新光-新竹",488,287,201
"6242","2929淘帝","110/08/13","美林",17,84,-67
"6243","2929淘帝","110/08/13","元大-西門",38,1,37
"6244","2929淘帝","110/08/13","摩根大通",0,63,-63
"6245","2929淘帝","110/08/13","元富-文心",30,0,30
"6246","2929淘帝","110/08/13","港商野村",14,69,-55
"6247","2929淘帝","110/08/13","華南永昌-苗栗",30,0,30
"6248","2929淘帝","110/08/13","玉山-新竹",0,50,-50
"6249","2929淘帝","110/08/13","元大-豐原站前",31,1,30
"6250","2929淘帝","110/08/13","臺銀-新竹",0,30,-30
"6251","2929淘帝","110/08/13","元富-台南",22,0,22
"6252","2929淘帝","110/08/13","元富-三重",23,52,-29
"6253","2929淘帝","110/08/13","凱基-東門",20,0,20
"6254","2929淘帝","110/08/13","新加坡商瑞銀",18,41,-23
"6255","2929淘帝","110/08/13","永豐金-敦南",17,0,17
"6256","2929淘帝","110/08/13","兆豐-大同",0,21,-21
"6257","2929淘帝","110/08/13","新光",44,29,15
"6258","2929淘帝","110/08/13","美商高盛",0,20,-20
"6259","2929淘帝","110/08/13","元大-蘆洲",14,0,14
"6260","2929淘帝","110/08/13","台新-左楠",6,25,-19
"6261","2929淘帝","110/08/13","國票-博愛",12,0,12
"6262","2929淘帝","110/08/13","港商法國興業",0,14,-14
"6263","2929淘帝","110/08/13","合庫-自強",10,0,10
"6264","2929淘帝","110/08/13","台新證券",7,21,-14
"6265","2929淘帝","110/08/13","兆豐-桃園",10,0,10
"6266","2929淘帝","110/08/13","元大-館前",0,14,-14
"6267","2929淘帝","110/08/13","凱基-頭份",10,0,10
"6268","2929淘帝","110/08/13","亞東-新竹",0,13,-13
"6269","2929淘帝","110/08/13","華南永昌-大安",10,0,10
"6270","2929淘帝","110/08/13","元大-永和",7,20,-13
"6271","5410國眾","110/08/13","土銀-嘉義",21,0,21
"6272","5410國眾","110/08/13","國泰-敦南",20,102,-82
"6273","5410國眾","110/08/13","日盛-大墩",15,0,15
"6274","5410國眾","110/08/13","元大-大雅",0,64,-64
"6275","5410國眾","110/08/13","群益金鼎-民權",14,0,14
"6276","5410國眾","110/08/13","大昌-新店",0,37,-37
"6277","5410國眾","110/08/13","玉山-嘉義",12,0,12
"6278","5410國眾","110/08/13","陽信-石牌",0,33,-33
"6279","5410國眾","110/08/13","元大-新竹經國",12,0,12
"6280","5410國眾","110/08/13","摩根大通",0,26,-26
"6281","5410國眾","110/08/13","日盛-屏東",10,0,10
"6282","5410國眾","110/08/13","瑞士信貸",0,18,-18
"6283","5410國眾","110/08/13","富邦-竹北",10,0,10
"6284","5410國眾","110/08/13","元大-北投",8,22,-14
"6285","5410國眾","110/08/13","元富",10,1,9
"6286","5410國眾","110/08/13","合庫-台中",0,10,-10
"6287","5410國眾","110/08/13","凱基-八德",9,0,9
"6288","5410國眾","110/08/13","合庫-新竹",0,10,-10
"6289","5410國眾","110/08/13","富邦-台北",9,0,9
"6290","5410國眾","110/08/13","元大-善化",0,10,-10
"6291","5410國眾","110/08/13","富邦-新店",10,1,9
"6292","5410國眾","110/08/13","大昌",0,9,-9
"6293","5410國眾","110/08/13","元富-虎尾",8,0,8
"6294","5410國眾","110/08/13","兆豐-三重",0,9,-9
"6295","5410國眾","110/08/13","統一",7,0,7
"6296","5410國眾","110/08/13","新光",17,25,-8
"6297","5410國眾","110/08/13","日茂-南投",7,0,7
"6298","5410國眾","110/08/13","亞東-新竹",0,5,-5
"6299","5410國眾","110/08/13","元大-彰化",7,0,7
"6300","5410國眾","110/08/13","兆豐-桃鶯",0,5,-5
"6301","2841台開","110/08/13","宏遠-館前",181,0,181
"6302","2841台開","110/08/13","永豐金-內湖",0,77,-77
"6303","2841台開","110/08/13","日盛證券",70,1,69
"6304","2841台開","110/08/13","富邦-岡山",0,72,-72
"6305","2841台開","110/08/13","台新-三民",50,0,50
"6306","2841台開","110/08/13","永豐金-屏東",0,50,-50
"6307","2841台開","110/08/13","凱基-市政",18,0,18
"6308","2841台開","110/08/13","港商野村",0,38,-38
"6309","2841台開","110/08/13","新光",32,16,16
"6310","2841台開","110/08/13","元大-林園",0,30,-30
"6311","2841台開","110/08/13","兆豐-新營",15,0,15
"6312","2841台開","110/08/13","永豐金-敦南",13,42,-29
"6313","2841台開","110/08/13","日盛-內湖",12,0,12
"6314","2841台開","110/08/13","臺銀-民權",0,20,-20
"6315","2841台開","110/08/13","群益金鼎-基隆",11,0,11
"6316","2841台開","110/08/13","元大-崇德",0,19,-19
"6317","2841台開","110/08/13","富邦-台北",10,0,10
"6318","2841台開","110/08/13","日盛-中壢",0,18,-18
"6319","2841台開","110/08/13","元大-歸仁",10,0,10
"6320","2841台開","110/08/13","兆豐-板橋",0,10,-10
"6321","2841台開","110/08/13","凱基-台北",9,2,7
"6322","2841台開","110/08/13","豐農",0,10,-10
"6323","2841台開","110/08/13","元大-福營",10,3,7
"6324","2841台開","110/08/13","元大-北三重",0,10,-10
"6325","2841台開","110/08/13","元富-文心",5,0,5
"6326","2841台開","110/08/13","台新證券",6,13,-7
"6327","2841台開","110/08/13","凱基-東港",5,0,5
"6328","2841台開","110/08/13","光和-嘉義",0,6,-6
"6329","2841台開","110/08/13","元富-成功",3,0,3
"6330","2841台開","110/08/13","中國信託-高雄",0,5,-5
"6331","6207雷科","110/08/13","安泰",51,0,51
"6332","6207雷科","110/08/13","摩根大通",12,80,-68
"6333","6207雷科","110/08/13","永豐金證券",34,0,34
"6334","6207雷科","110/08/13","美林",1,34,-33
"6335","6207雷科","110/08/13","元大-潮州",32,0,32
"6336","6207雷科","110/08/13","新加坡商瑞銀",18,45,-27
"6337","6207雷科","110/08/13","元大-六合",30,0,30
"6338","6207雷科","110/08/13","凱基-復興",0,20,-20
"6339","6207雷科","110/08/13","富邦-中壢",20,0,20
"6340","6207雷科","110/08/13","凱基-台北",15,31,-16
"6341","6207雷科","110/08/13","統一-台中",10,0,10
"6342","6207雷科","110/08/13","港商野村",1,13,-12
"6343","6207雷科","110/08/13","凱基-岡山",10,0,10
"6344","6207雷科","110/08/13","群益金鼎-東門",0,12,-12
"6345","6207雷科","110/08/13","元大-東門",10,0,10
"6346","6207雷科","110/08/13","凱基-三峽",4,15,-11
"6347","6207雷科","110/08/13","元大-大天母",13,3,10
"6348","6207雷科","110/08/13","兆豐-公益",0,9,-9
"6349","6207雷科","110/08/13","元大-路竹",8,0,8
"6350","6207雷科","110/08/13","元大-鳳山",0,8,-8
"6351","6207雷科","110/08/13","富邦-敦南",7,0,7
"6352","6207雷科","110/08/13","合庫-鳳山",0,6,-6
"6353","6207雷科","110/08/13","兆豐-彰化",6,0,6
"6354","6207雷科","110/08/13","凱基-三重",0,6,-6
"6355","6207雷科","110/08/13","群益金鼎-土城",6,0,6
"6356","6207雷科","110/08/13","凱基-幸福",0,6,-6
"6357","6207雷科","110/08/13","玉山-台南",5,0,5
"6358","6207雷科","110/08/13","富邦-基隆",0,6,-6
"6359","6207雷科","110/08/13","凱基-湖口",5,0,5
"6360","6207雷科","110/08/13","元大-清水",0,6,-6
"6361","3679新至陞","110/08/13","元大-大天母",20,0,20
"6362","3679新至陞","110/08/13","摩根大通",2,27,-25
"6363","3679新至陞","110/08/13","台灣摩根士丹利",12,0,12
"6364","3679新至陞","110/08/13","瑞士信貸",1,16,-15
"6365","3679新至陞","110/08/13","元大-成功",10,0,10
"6366","3679新至陞","110/08/13","美林",0,10,-10
"6367","3679新至陞","110/08/13","兆豐-高雄",9,0,9
"6368","3679新至陞","110/08/13","凱基-台北",11,16,-5
"6369","3679新至陞","110/08/13","國泰-松江",4,0,4
"6370","3679新至陞","110/08/13","元大-東蘆",0,5,-5
"6371","3679新至陞","110/08/13","元大-大同",3,0,3
"6372","3679新至陞","110/08/13","元大-北成功",0,4,-4
"6373","3679新至陞","110/08/13","合庫-台中",2,0,2
"6374","3679新至陞","110/08/13","富邦-中壢",0,3,-3
"6375","3679新至陞","110/08/13","台中銀-員林",2,0,2
"6376","3679新至陞","110/08/13","彰銀",0,2,-2
"6377","3679新至陞","110/08/13","康和-板橋",2,0,2
"6378","3679新至陞","110/08/13","凱基-大安",0,2,-2
"6379","3679新至陞","110/08/13","新光-高雄",2,0,2
"6380","3679新至陞","110/08/13","華南永昌-鶯歌",0,2,-2
"6381","3679新至陞","110/08/13","凱基-文心",5,3,2
"6382","3679新至陞","110/08/13","富邦-仁愛",0,2,-2
"6383","3679新至陞","110/08/13","元大-景美",2,0,2
"6384","3679新至陞","110/08/13","元大證券",1,3,-2
"6385","3679新至陞","110/08/13","元大-土城永寧",2,0,2
"6386","3679新至陞","110/08/13","元大-土城",0,2,-2
"6387","3679新至陞","110/08/13","美商高盛",1,0,1
"6388","3679新至陞","110/08/13","台灣企銀-民雄",0,1,-1
"6389","3679新至陞","110/08/13","台新證券",1,0,1
"6390","3679新至陞","110/08/13","日盛證券",0,1,-1
"6391","2727王品","110/08/13","新光",27,6,21
"6392","2727王品","110/08/13","摩根大通",1,53,-52
"6393","2727王品","110/08/13","大慶-富順",20,0,20
"6394","2727王品","110/08/13","土銀-南港",0,40,-40
"6395","2727王品","110/08/13","兆豐-東門",17,0,17
"6396","2727王品","110/08/13","港商麥格理",0,24,-24
"6397","2727王品","110/08/13","新光-台中",19,2,17
"6398","2727王品","110/08/13","新加坡商瑞銀",0,21,-21
"6399","2727王品","110/08/13","元大-竹科",11,0,11
"6400","2727王品","110/08/13","康和-台南",1,22,-21
"6401","2727王品","110/08/13","日盛-屏東",10,0,10
"6402","2727王品","110/08/13","富邦-員林",0,17,-17
"6403","2727王品","110/08/13","彰銀-七賢",10,0,10
"6404","2727王品","110/08/13","港商野村",3,18,-15
"6405","2727王品","110/08/13","玉山-大里",10,0,10
"6406","2727王品","110/08/13","富邦-新營",0,15,-15
"6407","2727王品","110/08/13","富邦-台中",12,2,10
"6408","2727王品","110/08/13","台灣企銀-竹北",3,17,-14
"6409","2727王品","110/08/13","國泰-敦南",15,6,9
"6410","2727王品","110/08/13","國泰-板橋",3,17,-14
"6411","2727王品","110/08/13","臺銀",9,1,8
"6412","2727王品","110/08/13","凱基-板橋",0,13,-13
"6413","2727王品","110/08/13","元大-台中",8,0,8
"6414","2727王品","110/08/13","日盛-中和",1,13,-12
"6415","2727王品","110/08/13","國泰-台中",11,4,7
"6416","2727王品","110/08/13","第一金-新竹",1,12,-11
"6417","2727王品","110/08/13","永豐金-彰化",7,0,7
"6418","2727王品","110/08/13","統一",1,12,-11
"6419","2727王品","110/08/13","新光-桃園",6,0,6
"6420","2727王品","110/08/13","統一-竹南",0,10,-10
"6421","1570力肯","110/08/13","新光",147,12,135
"6422","1570力肯","110/08/13","(牛牛牛)亞-鑫豐",15,136,-121
"6423","1570力肯","110/08/13","國票-北高雄",128,0,128
"6424","1570力肯","110/08/13","富邦-台中",0,51,-51
"6425","1570力肯","110/08/13","凱基-台北",80,24,56
"6426","1570力肯","110/08/13","日盛-頭份",0,50,-50
"6427","1570力肯","110/08/13","統一",54,0,54
"6428","1570力肯","110/08/13","元富-高雄",0,40,-40
"6429","1570力肯","110/08/13","國票-內壢",49,1,48
"6430","1570力肯","110/08/13","凱基-高美館",2,41,-39
"6431","1570力肯","110/08/13","美林",37,0,37
"6432","1570力肯","110/08/13","日盛-忠孝",0,38,-38
"6433","1570力肯","110/08/13","國票-天祥",45,8,37
"6434","1570力肯","110/08/13","元大-羅東",0,20,-20
"6435","1570力肯","110/08/13","摩根大通",67,45,22
"6436","1570力肯","110/08/13","元大-大天母",0,20,-20
"6437","1570力肯","110/08/13","永豐金-屏東",22,0,22
"6438","1570力肯","110/08/13","永豐金-嘉義",0,20,-20
"6439","1570力肯","110/08/13","元富-新店",20,0,20
"6440","1570力肯","110/08/13","國泰-敦南",2,20,-18
"6441","1570力肯","110/08/13","(牛牛牛)亞證券",20,0,20
"6442","1570力肯","110/08/13","元大-沙鹿",1,18,-17
"6443","1570力肯","110/08/13","凱基-台南",20,0,20
"6444","1570力肯","110/08/13","元大-林森",0,16,-16
"6445","1570力肯","110/08/13","元大-開元",20,0,20
"6446","1570力肯","110/08/13","永豐金-市政",1,16,-15
"6447","1570力肯","110/08/13","元大-花蓮",20,0,20
"6448","1570力肯","110/08/13","統一-三重",5,19,-14
"6449","1570力肯","110/08/13","元大-基隆",19,0,19
"6450","1570力肯","110/08/13","國泰-新莊",1,15,-14
"6451","6180橘子","110/08/13","美商高盛",48,0,48
"6452","6180橘子","110/08/13","玉山-桃園",1,30,-29
"6453","6180橘子","110/08/13","美林",37,0,37
"6454","6180橘子","110/08/13","元大-成功",0,22,-22
"6455","6180橘子","110/08/13","凱基-台北",17,1,16
"6456","6180橘子","110/08/13","群益金鼎",0,11,-11
"6457","6180橘子","110/08/13","台新證券",15,1,14
"6458","6180橘子","110/08/13","亞東-高雄",0,10,-10
"6459","6180橘子","110/08/13","台灣摩根士丹利",13,0,13
"6460","6180橘子","110/08/13","元大-北港",0,10,-10
"6461","6180橘子","110/08/13","元大-北投",11,0,11
"6462","6180橘子","110/08/13","統一-彰化",3,10,-7
"6463","6180橘子","110/08/13","合庫-自強",10,0,10
"6464","6180橘子","110/08/13","摩根大通",6,13,-7
"6465","6180橘子","110/08/13","統一-台南",10,0,10
"6466","6180橘子","110/08/13","群益金鼎-中山",1,8,-7
"6467","6180橘子","110/08/13","兆豐-台中",10,0,10
"6468","6180橘子","110/08/13","元大-敦南",0,7,-7
"6469","6180橘子","110/08/13","群益金鼎-台中",10,0,10
"6470","6180橘子","110/08/13","國泰-板橋",0,6,-6
"6471","6180橘子","110/08/13","康和-台中",6,0,6
"6472","6180橘子","110/08/13","富邦-宜蘭",0,6,-6
"6473","6180橘子","110/08/13","凱基-汐止",5,0,5
"6474","6180橘子","110/08/13","元大-台北",0,6,-6
"6475","6180橘子","110/08/13","日盛-景美",6,2,4
"6476","6180橘子","110/08/13","永豐金-板橋",0,6,-6
"6477","6180橘子","110/08/13","新光-台中",4,0,4
"6478","6180橘子","110/08/13","亞東",0,5,-5
"6479","6180橘子","110/08/13","國泰-敦南",4,0,4
"6480","6180橘子","110/08/13","兆豐-竹北",0,5,-5
"6481","2390云辰","110/08/13","摩根大通",643,393,250
"6482","2390云辰","110/08/13","元大-信義",0,202,-202
"6483","2390云辰","110/08/13","美商高盛",269,138,131
"6484","2390云辰","110/08/13","美林",169,289,-120
"6485","2390云辰","110/08/13","凱基-台北",418,293,125
"6486","2390云辰","110/08/13","元大-東港",9,102,-93
"6487","2390云辰","110/08/13","元富-板橋",94,13,81
"6488","2390云辰","110/08/13","元富-高雄",17,94,-77
"6489","2390云辰","110/08/13","土銀-士林",78,0,78
"6490","2390云辰","110/08/13","凱基-竹科",5,76,-71
"6491","2390云辰","110/08/13","元大-前金",92,16,76
"6492","2390云辰","110/08/13","國票-博愛",40,107,-67
"6493","2390云辰","110/08/13","台新-台中",89,24,65
"6494","2390云辰","110/08/13","群益金鼎-開元",26,90,-64
"6495","2390云辰","110/08/13","光和-嘉義",73,10,63
"6496","2390云辰","110/08/13","新加坡商瑞銀",4,61,-57
"6497","2390云辰","110/08/13","富邦-敦南",59,0,59
"6498","2390云辰","110/08/13","港商野村",277,333,-56
"6499","2390云辰","110/08/13","富邦-彰化",69,11,58
"6500","2390云辰","110/08/13","新光",144,197,-53
"6501","2390云辰","110/08/13","元大-草屯",75,17,58
"6502","2390云辰","110/08/13","統一",23,75,-52
"6503","2390云辰","110/08/13","光和-溪湖",54,1,53
"6504","2390云辰","110/08/13","元大-林園",0,51,-51
"6505","2390云辰","110/08/13","元大-土城學府",263,210,53
"6506","2390云辰","110/08/13","富邦-新營",1,48,-47
"6507","2390云辰","110/08/13","元大-文心興安",64,11,53
"6508","2390云辰","110/08/13","元大-新莊",33,80,-47
"6509","2390云辰","110/08/13","國泰-忠孝",50,0,50
"6510","2390云辰","110/08/13","日盛-園區",10,55,-45
"6511","2867三商壽","110/08/12","新光",292,1,291
"6512","2867三商壽","110/08/12","摩根大通",53,266,-213
"6513","2867三商壽","110/08/12","元大-土城永寧",200,0,200
"6514","2867三商壽","110/08/12","元大-崇德",3,201,-198
"6515","2867三商壽","110/08/12","合庫證券",100,0,100
"6516","2867三商壽","110/08/12","美商高盛",31,159,-128
"6517","2867三商壽","110/08/12","土銀",100,0,100
"6518","2867三商壽","110/08/12","富邦證券",0,120,-120
"6519","2867三商壽","110/08/12","臺銀-臺南",100,0,100
"6520","2867三商壽","110/08/12","凱基-信義",0,117,-117
"6521","2867三商壽","110/08/12","元富-古亭",100,0,100
"6522","2867三商壽","110/08/12","凱基-台北",2,113,-111
"6523","2867三商壽","110/08/12","元大-新莊",100,0,100
"6524","2867三商壽","110/08/12","凱基-虎尾",0,100,-100
"6525","2867三商壽","110/08/12","凱基",97,0,97
"6526","2867三商壽","110/08/12","元大-南投",0,92,-92
"6527","2867三商壽","110/08/12","元大-桃園",60,0,60
"6528","2867三商壽","110/08/12","台灣摩根士丹利",0,70,-70
"6529","2867三商壽","110/08/12","合庫-西台中",51,0,51
"6530","2867三商壽","110/08/12","美林",8,72,-64
"6531","2867三商壽","110/08/12","華南永昌-鳳山",51,1,50
"6532","2867三商壽","110/08/12","新加坡商瑞銀",0,61,-61
"6533","2867三商壽","110/08/12","元大-沙鹿",39,0,39
"6534","2867三商壽","110/08/12","群益金鼎-台北",0,60,-60
"6535","2867三商壽","110/08/12","光和",30,0,30
"6536","2867三商壽","110/08/12","富邦-宜蘭",0,50,-50
"6537","2867三商壽","110/08/12","元大-龍潭",30,0,30
"6538","2867三商壽","110/08/12","元大-旗山",0,50,-50
"6539","2867三商壽","110/08/12","永豐金-員林",30,0,30
"6540","2867三商壽","110/08/12","元富-吉利",0,27,-27
"6541","5521工信","110/08/12","日進",900,0,900
"6542","5521工信","110/08/12","永豐金證券",14,200,-186
"6543","5521工信","110/08/12","摩根大通",678,57,621
"6544","5521工信","110/08/12","富邦-中壢",2,112,-110
"6545","5521工信","110/08/12","國票-安和",254,20,234
"6546","5521工信","110/08/12","中國信託-嘉義",0,100,-100
"6547","5521工信","110/08/12","凱基-台北",194,46,148
"6548","5521工信","110/08/12","元大-南屯",0,58,-58
"6549","5521工信","110/08/12","日盛-中和",103,10,93
"6550","5521工信","110/08/12","凱基-中壢",0,55,-55
"6551","5521工信","110/08/12","新光-新竹",80,5,75
"6552","5521工信","110/08/12","(牛牛牛)亞-鑫豐",1,52,-51
"6553","5521工信","110/08/12","美林",69,10,59
"6554","5521工信","110/08/12","台新證券",1,51,-50
"6555","5521工信","110/08/12","富邦-台北",69,20,49
"6556","5521工信","110/08/12","群益金鼎-崇德",0,48,-48
"6557","5521工信","110/08/12","新光-台南",37,0,37
"6558","5521工信","110/08/12","康和-內湖",0,46,-46
"6559","5521工信","110/08/12","永豐金-鳳山",32,0,32
"6560","5521工信","110/08/12","日盛-新莊",0,45,-45
"6561","5521工信","110/08/12","第一金-台南",67,42,25
"6562","5521工信","110/08/12","元大-旗山",1,46,-45
"6563","5521工信","110/08/12","台灣企銀-台中",20,0,20
"6564","5521工信","110/08/12","元大-內湖",0,45,-45
"6565","5521工信","110/08/12","康和-澎湖",20,0,20
"6566","5521工信","110/08/12","日盛-高雄",0,42,-42
"6567","5521工信","110/08/12","凱基-三多",20,0,20
"6568","5521工信","110/08/12","元大-大同",0,42,-42
"6569","5521工信","110/08/12","元大-仁愛",20,0,20
"6570","5521工信","110/08/12","第一金-新竹",0,40,-40
"6571","1471首利","110/08/12","摩根大通",190,21,169
"6572","1471首利","110/08/12","光和-溪湖",0,75,-75
"6573","1471首利","110/08/12","元大-敦化",100,0,100
"6574","1471首利","110/08/12","富邦-基隆",2,41,-39
"6575","1471首利","110/08/12","瑞士信貸",86,0,86
"6576","1471首利","110/08/12","凱基-台南",0,30,-30
"6577","1471首利","110/08/12","美商高盛",51,0,51
"6578","1471首利","110/08/12","元富-民權",0,29,-29
"6579","1471首利","110/08/12","美林",49,0,49
"6580","1471首利","110/08/12","凱基-東門",0,24,-24
"6581","1471首利","110/08/12","國票-北高雄",20,0,20
"6582","1471首利","110/08/12","永興-大墩",0,20,-20
"6583","1471首利","110/08/12","凱基-五股",20,0,20
"6584","1471首利","110/08/12","元大-土城",1,21,-20
"6585","1471首利","110/08/12","永豐金-中壢",20,0,20
"6586","1471首利","110/08/12","凱基-內埔",1,20,-19
"6587","1471首利","110/08/12","凱基-台北",16,0,16
"6588","1471首利","110/08/12","中國信託",0,17,-17
"6589","1471首利","110/08/12","台新證券",16,3,13
"6590","1471首利","110/08/12","華南永昌-中正",2,19,-17
"6591","1471首利","110/08/12","兆豐-員林",15,3,12
"6592","1471首利","110/08/12","中國信託-文心",0,16,-16
"6593","1471首利","110/08/12","中國信託-永康",10,0,10
"6594","1471首利","110/08/12","兆豐-台南",1,17,-16
"6595","1471首利","110/08/12","華南永昌-麻豆",11,1,10
"6596","1471首利","110/08/12","凱基-新豐",0,15,-15
"6597","1471首利","110/08/12","元大-新營",10,0,10
"6598","1471首利","110/08/12","永豐金-新莊",0,15,-15
"6599","1471首利","110/08/12","新加坡商瑞銀",6,0,6
"6600","1471首利","110/08/12","凱基-彰化",6,20,-14
"6601","2883開發金","110/08/12","美林",2636,759,1877
"6602","2883開發金","110/08/12","摩根大通",28,5087,-5059
"6603","2883開發金","110/08/12","華南永昌",889,3,886
"6604","2883開發金","110/08/12","新加坡商瑞銀",111,2619,-2508
"6605","2883開發金","110/08/12","美商高盛",1037,275,762
"6606","2883開發金","110/08/12","富邦-彰化",7,809,-802
"6607","2883開發金","110/08/12","凱基-員林",600,0,600
"6608","2883開發金","110/08/12","瑞士信貸",773,1528,-755
"6609","2883開發金","110/08/12","日盛-中壢",532,9,523
"6610","2883開發金","110/08/12","港商野村",2,600,-598
"6611","2883開發金","110/08/12","元大證券",631,169,462
"6612","2883開發金","110/08/12","宏遠-民生",0,500,-500
"6613","2883開發金","110/08/12","玉山-高雄",457,5,452
"6614","2883開發金","110/08/12","元大-桃園",19,504,-485
"6615","2883開發金","110/08/12","元大-員林",435,0,435
"6616","2883開發金","110/08/12","台灣摩根士丹利",1506,1983,-477
"6617","2883開發金","110/08/12","永豐金-高雄",343,20,323
"6618","2883開發金","110/08/12","永豐金-台南",29,495,-466
"6619","2883開發金","110/08/12","日盛-大墩",321,0,321
"6620","2883開發金","110/08/12","元大-斗六",4,457,-453
"6621","2883開發金","110/08/12","台新-三民",338,19,319
"6622","2883開發金","110/08/12","群益金鼎-桃園",36,314,-278
"6623","2883開發金","110/08/12","國泰-敦南",468,170,298
"6624","2883開發金","110/08/12","群益金鼎-開元",15,221,-206
"6625","2883開發金","110/08/12","兆豐-北高雄",258,6,252
"6626","2883開發金","110/08/12","土銀-台中",1,202,-201
"6627","2883開發金","110/08/12","安泰",272,53,219
"6628","2883開發金","110/08/12","凱基-台中",12,204,-192
"6629","2883開發金","110/08/12","群益金鼎-彰化",218,4,214
"6630","2883開發金","110/08/12","永豐金-中盛",55,246,-191
"6631","6205詮欣","110/08/12","元大-新竹經國",12,0,12
"6632","6205詮欣","110/08/12","元大-善化",0,20,-20
"6633","6205詮欣","110/08/12","臺銀-民權",8,0,8
"6634","6205詮欣","110/08/12","瑞士信貸",0,4,-4
"6635","6205詮欣","110/08/12","聯邦-嘉義",5,0,5
"6636","6205詮欣","110/08/12","群益金鼎-板橋",0,4,-4
"6637","6205詮欣","110/08/12","中國信託-三重",3,0,3
"6638","6205詮欣","110/08/12","元大-屏東民生",0,4,-4
"6639","6205詮欣","110/08/12","德信-新營",3,0,3
"6640","6205詮欣","110/08/12","臺銀-高雄",0,3,-3
"6641","6205詮欣","110/08/12","合庫-彰化",2,0,2
"6642","6205詮欣","110/08/12","凱基-南崁",0,3,-3
"6643","6205詮欣","110/08/12","新光-台南",2,0,2
"6644","6205詮欣","110/08/12","元大-華山",0,3,-3
"6645","6205詮欣","110/08/12","玉山-雙和",2,0,2
"6646","6205詮欣","110/08/12","摩根大通",0,2,-2
"6647","6205詮欣","110/08/12","元大-南投",2,0,2
"6648","6205詮欣","110/08/12","兆豐-新營",0,1,-1
"6649","6205詮欣","110/08/12","統一-三重",1,0,1
"6650","6205詮欣","110/08/12","兆豐-中壢",0,1,-1
"6651","6205詮欣","110/08/12","元富-安南",1,0,1
"6652","6205詮欣","110/08/12","凱基-台北",0,1,-1
"6653","6205詮欣","110/08/12","豐農",1,0,1
"6654","6205詮欣","110/08/12","凱基-竹科",0,1,-1
"6655","6205詮欣","110/08/12","北城證券",1,0,1
"6656","6205詮欣","110/08/12","富邦-高雄",0,1,-1
"6657","6205詮欣","110/08/12","玉山-嘉義",1,0,1
"6658","6205詮欣","110/08/12","元大-路竹",0,1,-1
"6659","6205詮欣","110/08/12","凱基-五股",1,0,1
"6660","6205詮欣","110/08/12","元大-屏南",0,1,-1
"6661","1540喬福","110/08/12","元富-中原",20,0,20
"6662","1540喬福","110/08/12","永豐金-豐原",0,64,-64
"6663","1540喬福","110/08/12","台中銀",17,0,17
"6664","1540喬福","110/08/12","統一-新台中",0,19,-19
"6665","1540喬福","110/08/12","凱基-中壢",11,0,11
"6666","1540喬福","110/08/12","凱基-興隆",0,7,-7
"6667","1540喬福","110/08/12","凱基-台中",8,0,8
"6668","1540喬福","110/08/12","玉山-城中",0,6,-6
"6669","1540喬福","110/08/12","亞東",5,0,5
"6670","1540喬福","110/08/12","富邦-台北",1,5,-4
"6671","1540喬福","110/08/12","群益金鼎-古亭",5,0,5
"6672","1540喬福","110/08/12","元大-左營",0,2,-2
"6673","1540喬福","110/08/12","美林",4,0,4
"6674","1540喬福","110/08/12","國泰-敦南",0,1,-1
"6675","1540喬福","110/08/12","兆豐-鹿港",4,0,4
"6676","1540喬福","110/08/12","凱基-基隆",0,1,-1
"6677","1540喬福","110/08/12","港商法國興業",3,0,3
"6678","1540喬福","110/08/12","凱基-大里",0,1,-1
"6679","1540喬福","110/08/12","凱基-苗栗",3,0,3
"6680","1540喬福","110/08/12","元富-中壢",0,0,0
"6681","1540喬福","110/08/12","國票-台中",2,0,2
"6682","1540喬福","110/08/12","凱基-竹北",0,0,0
"6683","1540喬福","110/08/12","兆豐-高雄",2,0,2
"6684","1540喬福","110/08/12","凱基-台北",1,1,0
"6685","1540喬福","110/08/12","元富-緯城",2,0,2
"6686","1540喬福","110/08/12","華南永昌-南京",0,0,0
"6687","1540喬福","110/08/12","華南永昌-台中",2,0,2
"6688","1540喬福","110/08/12","富邦-高雄",0,0,0
"6689","1540喬福","110/08/12","富邦-中壢",2,0,2
"6690","1540喬福","110/08/12","富邦-三重",0,0,0
"6691","2888新光金","110/08/12","群益金鼎-崇德",2118,3,2115
"6692","2888新光金","110/08/12","國票-台東",12,1903,-1891
"6693","2888新光金","110/08/12","國票-九鼎",2175,141,2034
"6694","2888新光金","110/08/12","永豐金-竹科",0,1186,-1186
"6695","2888新光金","110/08/12","元大-忠孝鼎富",986,4,982
"6696","2888新光金","110/08/12","群益金鼎-民權",1,1049,-1048
"6697","2888新光金","110/08/12","台灣摩根士丹利",992,319,673
"6698","2888新光金","110/08/12","凱基-台北",1172,2195,-1023
"6699","2888新光金","110/08/12","港商法國興業",670,0,670
"6700","2888新光金","110/08/12","摩根大通",829,1704,-875
"6701","2888新光金","110/08/12","富邦-內湖",605,0,605
"6702","2888新光金","110/08/12","美林",248,668,-420
"6703","2888新光金","110/08/12","華南永昌-台中",600,3,597
"6704","2888新光金","110/08/12","群益金鼎-鳳山",2,404,-402
"6705","2888新光金","110/08/12","元大-豐原站前",556,38,518
"6706","2888新光金","110/08/12","新加坡商瑞銀",470,857,-387
"6707","2888新光金","110/08/12","瑞士信貸",643,139,504
"6708","2888新光金","110/08/12","香港上海匯豐",22,270,-248
"6709","2888新光金","110/08/12","元大-永和",505,8,497
"6710","2888新光金","110/08/12","合庫證券",2,232,-230
"6711","2888新光金","110/08/12","法銀巴黎",498,9,489
"6712","2888新光金","110/08/12","元大-大同",0,214,-214
"6713","2888新光金","110/08/12","福邦-新竹",430,0,430
"6714","2888新光金","110/08/12","元富-文心",2,210,-208
"6715","2888新光金","110/08/12","凱基-鳳山",379,3,376
"6716","2888新光金","110/08/12","新光",154,346,-192
"6717","2888新光金","110/08/12","康和-內湖",306,7,299
"6718","2888新光金","110/08/12","元富-城東",28,215,-187
"6719","2888新光金","110/08/12","元大-樹林",300,10,290
"6720","2888新光金","110/08/12","富邦-彰化",23,201,-178
"6721","1340勝悅","110/08/12","國泰-台中",11,0,11
"6722","1340勝悅","110/08/12","中國信託",0,76,-76
"6723","1340勝悅","110/08/12","元大-博愛",10,0,10
"6724","1340勝悅","110/08/12","日盛-八德",0,14,-14
"6725","1340勝悅","110/08/12","凱基-台北",8,1,7
"6726","1340勝悅","110/08/12","摩根大通",3,13,-10
"6727","1340勝悅","110/08/12","臺灣企銀-埔墘",5,0,5
"6728","1340勝悅","110/08/12","日盛-木柵",0,7,-7
"6729","1340勝悅","110/08/12","第一金-新竹",5,0,5
"6730","1340勝悅","110/08/12","元大-路竹",0,7,-7
"6731","1340勝悅","110/08/12","元富-新興",5,0,5
"6732","1340勝悅","110/08/12","群益金鼎-內湖",0,4,-4
"6733","1340勝悅","110/08/12","兆豐-台南",5,0,5
"6734","1340勝悅","110/08/12","凱基-彰化",0,4,-4
"6735","1340勝悅","110/08/12","玉山-士林",5,0,5
"6736","1340勝悅","110/08/12","元大-大天母",0,3,-3
"6737","1340勝悅","110/08/12","華南永昌-新莊",5,0,5
"6738","1340勝悅","110/08/12","統一-城中",4,6,-2
"6739","1340勝悅","110/08/12","美商高盛",4,0,4
"6740","1340勝悅","110/08/12","兆豐-新竹",0,2,-2
"6741","1340勝悅","110/08/12","港商法國興業",3,0,3
"6742","1340勝悅","110/08/12","台新證券",0,2,-2
"6743","1340勝悅","110/08/12","台新-台中",3,0,3
"6744","1340勝悅","110/08/12","富邦-台南",0,2,-2
"6745","1340勝悅","110/08/12","玉山-台大",3,0,3
"6746","1340勝悅","110/08/12","元大-新營",0,2,-2
"6747","1340勝悅","110/08/12","國泰-高雄",3,0,3
"6748","1340勝悅","110/08/12","瑞士信貸",2,3,-1
"6749","1340勝悅","110/08/12","元大-竹南",3,0,3
"6750","1340勝悅","110/08/12","永豐金-中正",0,1,-1
"6751","6246臺龍","110/08/12","元大-南投",75,0,75
"6752","6246臺龍","110/08/12","統一-台中",0,58,-58
"6753","6246臺龍","110/08/12","元大-台北",32,0,32
"6754","6246臺龍","110/08/12","合庫-台中",1,41,-40
"6755","6246臺龍","110/08/12","元富-世貿",30,2,28
"6756","6246臺龍","110/08/12","凱基-市府",0,40,-40
"6757","6246臺龍","110/08/12","凱基-永和",25,0,25
"6758","6246臺龍","110/08/12","日盛-木柵",4,33,-29
"6759","6246臺龍","110/08/12","元富-新店",18,3,15
"6760","6246臺龍","110/08/12","凱基-台北",1,29,-28
"6761","6246臺龍","110/08/12","華南永昌-忠孝",12,0,12
"6762","6246臺龍","110/08/12","永豐金-內湖",2,30,-28
"6763","6246臺龍","110/08/12","永豐金-復興",12,0,12
"6764","6246臺龍","110/08/12","元大-中壢",23,44,-21
"6765","6246臺龍","110/08/12","富邦-敦南",11,0,11
"6766","6246臺龍","110/08/12","永全-南崁",0,20,-20
"6767","6246臺龍","110/08/12","元大證券",13,2,11
"6768","6246臺龍","110/08/12","國泰-敦南",7,27,-20
"6769","6246臺龍","110/08/12","大慶-蘆洲",10,0,10
"6770","6246臺龍","110/08/12","大昌",0,18,-18
"6771","6246臺龍","110/08/12","元大-新莊",10,0,10
"6772","6246臺龍","110/08/12","新光-台中",3,17,-14
"6773","6246臺龍","110/08/12","元大-林園",10,1,9
"6774","6246臺龍","110/08/12","元大-金門",3,16,-13
"6775","6246臺龍","110/08/12","元大-西屯",10,2,8
"6776","6246臺龍","110/08/12","永全",0,10,-10
"6777","6246臺龍","110/08/12","兆豐-公益",7,0,7
"6778","6246臺龍","110/08/12","元大-新店中正",0,10,-10
"6779","6246臺龍","110/08/12","群益金鼎-開元",7,0,7
"6780","6246臺龍","110/08/12","日盛-八德",0,8,-8
"6781","00715L期街口布蘭特正2","110/08/12","元大證券",13644,167,13477
"6782","00715L期街口布蘭特正2","110/08/12","元大-林森",0,780,-780
"6783","00715L期街口布蘭特正2","110/08/12","永豐金證券",2789,2,2787
"6784","00715L期街口布蘭特正2","110/08/12","台新-新營",12,600,-588
"6785","00715L期街口布蘭特正2","110/08/12","統一",2972,199,2773
"6786","00715L期街口布蘭特正2","110/08/12","台中銀",10,592,-582
"6787","00715L期街口布蘭特正2","110/08/12","元富",1524,5,1519
"6788","00715L期街口布蘭特正2","110/08/12","群益金鼎-屏東",0,575,-575
"6789","00715L期街口布蘭特正2","110/08/12","統一-嘉義",466,26,440
"6790","00715L期街口布蘭特正2","110/08/12","元大-北港",10,505,-495
"6791","00715L期街口布蘭特正2","110/08/12","群益金鼎-延平",300,4,296
"6792","00715L期街口布蘭特正2","110/08/12","兆豐-台中",0,476,-476
"6793","00715L期街口布蘭特正2","110/08/12","台新-三民",300,24,276
"6794","00715L期街口布蘭特正2","110/08/12","宏遠-桃園",0,438,-438
"6795","00715L期街口布蘭特正2","110/08/12","群益金鼎-瑞豐",210,14,196
"6796","00715L期街口布蘭特正2","110/08/12","台新-台中",65,474,-409
"6797","00715L期街口布蘭特正2","110/08/12","港商野村",320,140,180
"6798","00715L期街口布蘭特正2","110/08/12","元大-西螺",3,382,-379
"6799","00715L期街口布蘭特正2","110/08/12","台新-松江",200,35,165
"6800","00715L期街口布蘭特正2","110/08/12","凱基-城中",0,370,-370
"6801","00715L期街口布蘭特正2","110/08/12","合庫證券",121,0,121
"6802","00715L期街口布蘭特正2","110/08/12","元大-歸仁",20,384,-364
"6803","00715L期街口布蘭特正2","110/08/12","元大-旗山",120,1,119
"6804","00715L期街口布蘭特正2","110/08/12","群益金鼎-古亭",13,367,-354
"6805","00715L期街口布蘭特正2","110/08/12","富邦-員林",362,251,111
"6806","00715L期街口布蘭特正2","110/08/12","元大-竹科",6,327,-321
"6807","00715L期街口布蘭特正2","110/08/12","日盛-木柵",130,22,108
"6808","00715L期街口布蘭特正2","110/08/12","臺銀-新竹",0,320,-320
"6809","00715L期街口布蘭特正2","110/08/12","大慶-苗栗",107,2,105
"6810","00715L期街口布蘭特正2","110/08/12","統一-台中",7,325,-318
"6811","8941關中","110/08/12","元大-金華",1,0,1
"6812","8941關中","110/08/12","凱基-士林",0,2,-2
"6813","8941關中","110/08/12","元大-桃興",1,0,1
"6814","8941關中","110/08/12","(牛牛牛)亞-鑫豐",0,0,0
"6815","8941關中","110/08/12","(牛牛牛)亞-鑫豐",0,0,0
"6816","8941關中","110/08/12","台新-三民",0,0,0
"6817","8941關中","110/08/12","台新-三民",0,0,0
"6818","8941關中","110/08/12","國泰-忠孝",1,1,0
"6819","8941關中","110/08/12","國泰-忠孝",1,1,0
"6820","8941關中","110/08/12","凱基-市府",1,1,0
"6821","8941關中","110/08/12","凱基-市府",1,1,0
"6822","8941關中","110/08/12","",NA,NA,NA
"6823","8941關中","110/08/12","",NA,NA,NA
"6824","8941關中","110/08/12","",NA,NA,NA
"6825","8941關中","110/08/12","",NA,NA,NA
"6826","8941關中","110/08/12","",NA,NA,NA
"6827","8941關中","110/08/12","",NA,NA,NA
"6828","8941關中","110/08/12","",NA,NA,NA
"6829","8941關中","110/08/12","",NA,NA,NA
"6830","8941關中","110/08/12","",NA,NA,NA
"6831","8941關中","110/08/12","",NA,NA,NA
"6832","8941關中","110/08/12","",NA,NA,NA
"6833","8941關中","110/08/12","",NA,NA,NA
"6834","8941關中","110/08/12","",NA,NA,NA
"6835","8941關中","110/08/12","",NA,NA,NA
"6836","8941關中","110/08/12","",NA,NA,NA
"6837","8941關中","110/08/12","",NA,NA,NA
"6838","8941關中","110/08/12","",NA,NA,NA
"6839","8941關中","110/08/12","",NA,NA,NA
"6840","8941關中","110/08/12","",NA,NA,NA
"6841","8936國統","110/08/12","台新-高雄",410,32,378
"6842","8936國統","110/08/12","日盛-景美",0,70,-70
"6843","8936國統","110/08/12","元富-林園",65,0,65
"6844","8936國統","110/08/12","臺銀-金山",0,55,-55
"6845","8936國統","110/08/12","摩根大通",64,12,52
"6846","8936國統","110/08/12","元大-敦南",0,32,-32
"6847","8936國統","110/08/12","新加坡商瑞銀",53,31,22
"6848","8936國統","110/08/12","華南永昌-南京",0,30,-30
"6849","8936國統","110/08/12","元大-莒光",19,0,19
"6850","8936國統","110/08/12","玉山-台南",0,23,-23
"6851","8936國統","110/08/12","第一金-高雄",10,0,10
"6852","8936國統","110/08/12","兆豐-岡山",1,21,-20
"6853","8936國統","110/08/12","統一-高雄",10,0,10
"6854","8936國統","110/08/12","統一-新竹",0,14,-14
"6855","8936國統","110/08/12","元富-桃園",10,0,10
"6856","8936國統","110/08/12","國泰-敦南",1,14,-13
"6857","8936國統","110/08/12","台新-台南",10,0,10
"6858","8936國統","110/08/12","台灣摩根士丹利",2,14,-12
"6859","8936國統","110/08/12","元大-竹山",9,0,9
"6860","8936國統","110/08/12","凱基-台南",3,14,-11
"6861","8936國統","110/08/12","港商野村",15,8,7
"6862","8936國統","110/08/12","凱基-高美館",0,11,-11
"6863","8936國統","110/08/12","華南永昌-高雄",6,0,6
"6864","8936國統","110/08/12","元大-博愛",0,10,-10
"6865","8936國統","110/08/12","土銀-高雄",5,0,5
"6866","8936國統","110/08/12","第一金-新興",0,9,-9
"6867","8936國統","110/08/12","大昌-安康",5,0,5
"6868","8936國統","110/08/12","元大-沙鹿",0,9,-9
"6869","8936國統","110/08/12","兆豐-斗南",5,0,5
"6870","8936國統","110/08/12","元大-左營",3,12,-9
"6871","6226光鼎","110/08/12","摩根大通",1930,830,1100
"6872","6226光鼎","110/08/12","凱基-台北",224,675,-451
"6873","6226光鼎","110/08/12","第一金-大稻埕",418,0,418
"6874","6226光鼎","110/08/12","統一-高雄",1,353,-352
"6875","6226光鼎","110/08/12","台新-中壢",239,3,236
"6876","6226光鼎","110/08/12","美林",153,291,-138
"6877","6226光鼎","110/08/12","元大-文心興安",223,27,196
"6878","6226光鼎","110/08/12","大昌",88,225,-137
"6879","6226光鼎","110/08/12","富邦-陽明",112,9,103
"6880","6226光鼎","110/08/12","元大-土城永寧",3,126,-123
"6881","6226光鼎","110/08/12","華南永昌-高雄",96,13,83
"6882","6226光鼎","110/08/12","元大-北屯",16,107,-91
"6883","6226光鼎","110/08/12","永豐金-南投",95,13,82
"6884","6226光鼎","110/08/12","統一-板橋",0,88,-88
"6885","6226光鼎","110/08/12","永豐金-中盛",102,26,76
"6886","6226光鼎","110/08/12","群益金鼎-東大",5,91,-86
"6887","6226光鼎","110/08/12","元大證券",90,15,75
"6888","6226光鼎","110/08/12","富邦-南屯",40,111,-71
"6889","6226光鼎","110/08/12","元大-屏東民生",85,15,70
"6890","6226光鼎","110/08/12","新光",240,309,-69
"6891","6226光鼎","110/08/12","台灣摩根士丹利",93,32,61
"6892","6226光鼎","110/08/12","台新-高雄",75,143,-68
"6893","6226光鼎","110/08/12","富邦-高雄",121,66,55
"6894","6226光鼎","110/08/12","日盛證券",10,76,-66
"6895","6226光鼎","110/08/12","臺銀",106,54,52
"6896","6226光鼎","110/08/12","國泰-敦南",391,457,-66
"6897","6226光鼎","110/08/12","台灣企銀-三民",58,8,50
"6898","6226光鼎","110/08/12","富邦-台北",31,97,-66
"6899","6226光鼎","110/08/12","元大-新竹",250,200,50
"6900","6226光鼎","110/08/12","凱基-永和",30,91,-61
"6901","2363矽統","110/08/12","元大-佳里",810,33,777
"6902","2363矽統","110/08/12","凱基-台北",1783,3582,-1799
"6903","2363矽統","110/08/12","元大-大同",455,30,425
"6904","2363矽統","110/08/12","台灣摩根士丹利",0,959,-959
"6905","2363矽統","110/08/12","富邦-建國",503,100,403
"6906","2363矽統","110/08/12","華南永昌-斗六",90,1037,-947
"6907","2363矽統","110/08/12","北城證券",434,34,400
"6908","2363矽統","110/08/12","群益金鼎-敦南",27,331,-304
"6909","2363矽統","110/08/12","元大-開元",321,33,288
"6910","2363矽統","110/08/12","美商高盛",57,327,-270
"6911","2363矽統","110/08/12","台新-三民",287,84,203
"6912","2363矽統","110/08/12","大慶-蘆洲",26,233,-207
"6913","2363矽統","110/08/12","台中銀",157,23,134
"6914","2363矽統","110/08/12","新光-台南",130,324,-194
"6915","2363矽統","110/08/12","元大-新竹經國",152,21,131
"6916","2363矽統","110/08/12","美林",927,1076,-149
"6917","2363矽統","110/08/12","台新-高雄",449,322,127
"6918","2363矽統","110/08/12","華南永昌-頭份",187,328,-141
"6919","2363矽統","110/08/12","華南永昌",254,163,91
"6920","2363矽統","110/08/12","陽信-石牌",157,276,-119
"6921","2363矽統","110/08/12","凱基-城中",98,13,85
"6922","2363矽統","110/08/12","兆豐證券",0,104,-104
"6923","2363矽統","110/08/12","台中銀-台北",85,4,81
"6924","2363矽統","110/08/12","元大-忠孝鼎富",32,132,-100
"6925","2363矽統","110/08/12","元大-新莊",140,60,80
"6926","2363矽統","110/08/12","元大-鳳中",85,185,-100
"6927","2363矽統","110/08/12","玉山-台中",116,41,75
"6928","2363矽統","110/08/12","永豐金-桃盛",24,119,-95
"6929","2363矽統","110/08/12","元富-彰化",88,23,65
"6930","2363矽統","110/08/12","元大證券",51,145,-94
"6931","8112至上","110/08/12","摩根大通",1492,130,1362
"6932","8112至上","110/08/12","永豐金-台中",0,274,-274
"6933","8112至上","110/08/12","美林",712,13,699
"6934","8112至上","110/08/12","永豐金證券",8,272,-264
"6935","8112至上","110/08/12","台灣摩根士丹利",696,41,655
"6936","8112至上","110/08/12","群益金鼎-基隆",0,249,-249
"6937","8112至上","110/08/12","凱基-台北",582,82,500
"6938","8112至上","110/08/12","國票-長城",2,228,-226
"6939","8112至上","110/08/12","新加坡商瑞銀",359,18,341
"6940","8112至上","110/08/12","新光-新竹",19,208,-189
"6941","8112至上","110/08/12","花旗環球",266,0,266
"6942","8112至上","110/08/12","玉山-嘉義",20,168,-148
"6943","8112至上","110/08/12","富邦-仁愛",231,25,206
"6944","8112至上","110/08/12","元大-高雄",0,131,-131
"6945","8112至上","110/08/12","美商高盛",190,3,187
"6946","8112至上","110/08/12","臺灣企銀-桃園",128,251,-123
"6947","8112至上","110/08/12","凱基-三重",121,6,115
"6948","8112至上","110/08/12","元大-府城",0,115,-115
"6949","8112至上","110/08/12","港商野村",198,88,110
"6950","8112至上","110/08/12","台新證券",100,203,-103
"6951","8112至上","110/08/12","國票-中港",101,0,101
"6952","8112至上","110/08/12","康和-板橋",5,106,-101
"6953","8112至上","110/08/12","日盛-新竹",80,3,77
"6954","8112至上","110/08/12","元大-北成功",0,101,-101
"6955","8112至上","110/08/12","兆豐-斗南",71,8,63
"6956","8112至上","110/08/12","元大-永和",5,88,-83
"6957","8112至上","110/08/12","大慶",63,1,62
"6958","8112至上","110/08/12","群益金鼎-內湖",0,80,-80
"6959","8112至上","110/08/12","群益金鼎-竹南",57,1,56
"6960","8112至上","110/08/12","元大-南勢角",0,80,-80
"6961","1570力肯","110/08/12","台新證券",91,15,76
"6962","1570力肯","110/08/12","國票-北高雄",2,361,-359
"6963","1570力肯","110/08/12","元大-南投",81,5,76
"6964","1570力肯","110/08/12","新光",95,222,-127
"6965","1570力肯","110/08/12","永全-南崁",94,20,74
"6966","1570力肯","110/08/12","(牛牛牛)亞-鑫豐",28,120,-92
"6967","1570力肯","110/08/12","日盛-忠孝",57,0,57
"6968","1570力肯","110/08/12","華南永昌-高雄",0,52,-52
"6969","1570力肯","110/08/12","永豐金-北高雄",55,0,55
"6970","1570力肯","110/08/12","群益金鼎-三重",0,42,-42
"6971","1570力肯","110/08/12","中國信託-高雄",72,22,50
"6972","1570力肯","110/08/12","日盛-八德",2,39,-37
"6973","1570力肯","110/08/12","凱基-天母",49,0,49
"6974","1570力肯","110/08/12","新光-台中",130,167,-37
"6975","1570力肯","110/08/12","新光-台南",56,18,38
"6976","1570力肯","110/08/12","日盛-樹林",1,31,-30
"6977","1570力肯","110/08/12","兆豐-嘉義",35,0,35
"6978","1570力肯","110/08/12","元大-竹北",0,30,-30
"6979","1570力肯","110/08/12","國票-天祥",32,1,31
"6980","1570力肯","110/08/12","元大-楊梅",6,35,-29
"6981","1570力肯","110/08/12","國泰-松江",81,51,30
"6982","1570力肯","110/08/12","元大-桃興",4,32,-28
"6983","1570力肯","110/08/12","元大-新店中正",33,3,30
"6984","1570力肯","110/08/12","亞東-台中",0,26,-26
"6985","1570力肯","110/08/12","統一",48,21,27
"6986","1570力肯","110/08/12","永豐金-屏東",5,30,-25
"6987","1570力肯","110/08/12","國票-內壢",26,0,26
"6988","1570力肯","110/08/12","國泰-館前",0,24,-24
"6989","1570力肯","110/08/12","元大-大益",27,1,26
"6990","1570力肯","110/08/12","摩根大通",173,193,-20
"6991","2929淘帝","110/08/12","摩根大通",47,0,47
"6992","2929淘帝","110/08/12","華南永昌-彰化",0,30,-30
"6993","2929淘帝","110/08/12","宏遠-館前",40,0,40
"6994","2929淘帝","110/08/12","第一金-大稻埕",0,10,-10
"6995","2929淘帝","110/08/12","富邦-高雄",16,0,16
"6996","2929淘帝","110/08/12","統一-敦南",0,10,-10
"6997","2929淘帝","110/08/12","兆豐-內湖",15,0,15
"6998","2929淘帝","110/08/12","玉山-台南",0,10,-10
"6999","2929淘帝","110/08/12","港商野村",29,15,14
"7000","2929淘帝","110/08/12","元大-花蓮",0,10,-10
"7001","2929淘帝","110/08/12","元富-台南",10,0,10
"7002","2929淘帝","110/08/12","凱基-台中",0,9,-9
"7003","2929淘帝","110/08/12","豐農",10,0,10
"7004","2929淘帝","110/08/12","群益金鼎-潭子",0,8,-8
"7005","2929淘帝","110/08/12","群益金鼎-三重",10,0,10
"7006","2929淘帝","110/08/12","新加坡商瑞銀",10,17,-7
"7007","2929淘帝","110/08/12","永豐金證券",10,0,10
"7008","2929淘帝","110/08/12","新光-高雄",0,7,-7
"7009","2929淘帝","110/08/12","永豐金-敦南",10,0,10
"7010","2929淘帝","110/08/12","亞東-板橋",0,6,-6
"7011","2929淘帝","110/08/12","凱基-八德",6,0,6
"7012","2929淘帝","110/08/12","元富-中港",0,6,-6
"7013","2929淘帝","110/08/12","台新-新莊",5,0,5
"7014","2929淘帝","110/08/12","國泰-敦南",1,7,-6
"7015","2929淘帝","110/08/12","群益金鼎-中山",5,0,5
"7016","2929淘帝","110/08/12","永豐金-市政",0,6,-6
"7017","2929淘帝","110/08/12","凱基-幸福",5,0,5
"7018","2929淘帝","110/08/12","永豐金-中盛",10,16,-6
"7019","2929淘帝","110/08/12","元富-新竹",4,0,4
"7020","2929淘帝","110/08/12","台新-三民",0,5,-5
"7021","5410國眾","110/08/12","凱基-八德",23,0,23
"7022","5410國眾","110/08/12","國泰-敦南",1,101,-100
"7023","5410國眾","110/08/12","元大-大灣",11,0,11
"7024","5410國眾","110/08/12","第一金-華江",0,27,-27
"7025","5410國眾","110/08/12","合庫-新竹",10,0,10
"7026","5410國眾","110/08/12","元大-竹科",0,17,-17
"7027","5410國眾","110/08/12","凱基-虎尾",10,0,10
"7028","5410國眾","110/08/12","元大-歸仁",1,15,-14
"7029","5410國眾","110/08/12","富邦-竹北",10,0,10
"7030","5410國眾","110/08/12","日盛-八德",0,10,-10
"7031","5410國眾","110/08/12","玉山-新莊",9,0,9
"7032","5410國眾","110/08/12","華南永昌-潮州",0,10,-10
"7033","5410國眾","110/08/12","玉山-台大",8,0,8
"7034","5410國眾","110/08/12","富邦-板橋",0,7,-7
"7035","5410國眾","110/08/12","凱基-桃園",8,0,8
"7036","5410國眾","110/08/12","凱基-高雄",0,6,-6
"7037","5410國眾","110/08/12","日盛-永康",7,0,7
"7038","5410國眾","110/08/12","元大-忠孝",0,6,-6
"7039","5410國眾","110/08/12","玉山-雙和",7,0,7
"7040","5410國眾","110/08/12","凱基-汐止",0,5,-5
"7041","5410國眾","110/08/12","元大-彰化",7,0,7
"7042","5410國眾","110/08/12","凱基-台北",0,5,-5
"7043","5410國眾","110/08/12","元大-崇德",7,0,7
"7044","5410國眾","110/08/12","元富-花蓮",0,4,-4
"7045","5410國眾","110/08/12","國泰-館前",6,0,6
"7046","5410國眾","110/08/12","凱基-岡山",0,4,-4
"7047","5410國眾","110/08/12","國泰-板橋",8,2,6
"7048","5410國眾","110/08/12","瑞士信貸",0,3,-3
"7049","5410國眾","110/08/12","元富-桃園",5,0,5
"7050","5410國眾","110/08/12","富邦-台中",0,3,-3
"7051","2841台開","110/08/12","宏遠-館前",370,0,370
"7052","2841台開","110/08/12","永豐金-敦南",4,134,-130
"7053","2841台開","110/08/12","永豐金-豐原",94,0,94
"7054","2841台開","110/08/12","港商野村",0,85,-85
"7055","2841台開","110/08/12","富邦-北港",53,0,53
"7056","2841台開","110/08/12","國泰-忠孝",1,40,-39
"7057","2841台開","110/08/12","新光-台中",20,0,20
"7058","2841台開","110/08/12","富邦-仁愛",0,38,-38
"7059","2841台開","110/08/12","凱基-高美館",20,0,20
"7060","2841台開","110/08/12","新加坡商瑞銀",0,27,-27
"7061","2841台開","110/08/12","元大-左營",20,0,20
"7062","2841台開","110/08/12","統一-嘉義",0,21,-21
"7063","2841台開","110/08/12","元大-基隆孝二",11,0,11
"7064","2841台開","110/08/12","日盛-忠孝",0,20,-20
"7065","2841台開","110/08/12","元大-路竹",10,0,10
"7066","2841台開","110/08/12","日盛-中壢",0,20,-20
"7067","2841台開","110/08/12","華南永昌-虎尾",9,0,9
"7068","2841台開","110/08/12","宏遠-桃園",0,20,-20
"7069","2841台開","110/08/12","康和-台北",6,0,6
"7070","2841台開","110/08/12","群益金鼎-南京",0,20,-20
"7071","2841台開","110/08/12","致和-東門",5,0,5
"7072","2841台開","110/08/12","合庫-基隆",0,18,-18
"7073","2841台開","110/08/12","元大-虎尾",5,0,5
"7074","2841台開","110/08/12","日盛證券",0,17,-17
"7075","2841台開","110/08/12","元大-莒光",5,0,5
"7076","2841台開","110/08/12","元大-歸仁",0,15,-15
"7077","2841台開","110/08/12","永豐金-桃園",5,0,5
"7078","2841台開","110/08/12","新光",10,21,-11
"7079","2841台開","110/08/12","新光-台南",4,0,4
"7080","2841台開","110/08/12","群益金鼎-天母",0,11,-11
"7081","6207雷科","110/08/12","摩根大通",125,11,114
"7082","6207雷科","110/08/12","凱基-復興",0,120,-120
"7083","6207雷科","110/08/12","凱基-台北",96,1,95
"7084","6207雷科","110/08/12","元大-鳳山",0,62,-62
"7085","6207雷科","110/08/12","美林",38,3,35
"7086","6207雷科","110/08/12","日盛證券",0,56,-56
"7087","6207雷科","110/08/12","兆豐-南京",30,0,30
"7088","6207雷科","110/08/12","日盛-忠孝",0,48,-48
"7089","6207雷科","110/08/12","港商野村",27,1,26
"7090","6207雷科","110/08/12","日盛-桃園",0,11,-11
"7091","6207雷科","110/08/12","元大-南京",20,0,20
"7092","6207雷科","110/08/12","中國信託-高雄",0,10,-10
"7093","6207雷科","110/08/12","臺銀-臺南",12,0,12
"7094","6207雷科","110/08/12","元大-土城永寧",0,10,-10
"7095","6207雷科","110/08/12","瑞士信貸",11,0,11
"7096","6207雷科","110/08/12","凱基-湖口",0,8,-8
"7097","6207雷科","110/08/12","新加坡商瑞銀",20,11,9
"7098","6207雷科","110/08/12","富邦-敦南",0,7,-7
"7099","6207雷科","110/08/12","第一金-新興",6,0,6
"7100","6207雷科","110/08/12","凱基-三峽",0,6,-6
"7101","6207雷科","110/08/12","群益金鼎-士林",6,0,6
"7102","6207雷科","110/08/12","永豐金-高雄",0,6,-6
"7103","6207雷科","110/08/12","群益金鼎-瑞豐",6,0,6
"7104","6207雷科","110/08/12","宏遠證券",0,5,-5
"7105","6207雷科","110/08/12","兆豐-來福",5,0,5
"7106","6207雷科","110/08/12","元富-彰化",0,5,-5
"7107","6207雷科","110/08/12","華南永昌-彰化",5,0,5
"7108","6207雷科","110/08/12","凱基-岡山",0,5,-5
"7109","6207雷科","110/08/12","富邦-中壢",5,0,5
"7110","6207雷科","110/08/12","富邦-建國",0,5,-5
"7111","3679新至陞","110/08/12","台灣摩根士丹利",10,0,10
"7112","3679新至陞","110/08/12","元大-成功",0,10,-10
"7113","3679新至陞","110/08/12","國泰-松江",8,0,8
"7114","3679新至陞","110/08/12","新加坡商瑞銀",0,7,-7
"7115","3679新至陞","110/08/12","元大-大同",3,0,3
"7116","3679新至陞","110/08/12","摩根大通",2,6,-4
"7117","3679新至陞","110/08/12","聯邦-三重",2,0,2
"7118","3679新至陞","110/08/12","瑞士信貸",0,3,-3
"7119","3679新至陞","110/08/12","凱基-站前",2,0,2
"7120","3679新至陞","110/08/12","港商野村",0,3,-3
"7121","3679新至陞","110/08/12","日盛-板橋",1,0,1
"7122","3679新至陞","110/08/12","凱基-新豐",0,3,-3
"7123","3679新至陞","110/08/12","日盛-龍潭",1,0,1
"7124","3679新至陞","110/08/12","元大證券",0,3,-3
"7125","3679新至陞","110/08/12","美商高盛",1,0,1
"7126","3679新至陞","110/08/12","康和-板橋",0,2,-2
"7127","3679新至陞","110/08/12","大慶-蘆洲",1,0,1
"7128","3679新至陞","110/08/12","富邦-台北",0,2,-2
"7129","3679新至陞","110/08/12","元富-民權",1,0,1
"7130","3679新至陞","110/08/12","元大-土城永寧",0,2,-2
"7131","3679新至陞","110/08/12","元富-花蓮",1,0,1
"7132","3679新至陞","110/08/12","彰銀",0,1,-1
"7133","3679新至陞","110/08/12","(牛牛牛)亞-網路",1,0,1
"7134","3679新至陞","110/08/12","大慶-富順",0,1,-1
"7135","3679新至陞","110/08/12","光和-溪湖",1,0,1
"7136","3679新至陞","110/08/12","台中銀-豐原",0,1,-1
"7137","3679新至陞","110/08/12","兆豐-城中",1,0,1
"7138","3679新至陞","110/08/12","兆豐-東門",0,1,-1
"7139","3679新至陞","110/08/12","兆豐-岡山",1,0,1
"7140","3679新至陞","110/08/12","凱基-新店",0,1,-1
"7141","2727王品","110/08/12","新光",25,8,17
"7142","2727王品","110/08/12","美林",0,76,-76
"7143","2727王品","110/08/12","彰銀-台中",14,2,12
"7144","2727王品","110/08/12","新加坡商瑞銀",0,52,-52
"7145","2727王品","110/08/12","康和-澎湖",10,0,10
"7146","2727王品","110/08/12","凱基-台北",2,38,-36
"7147","2727王品","110/08/12","富邦-建國",10,1,9
"7148","2727王品","110/08/12","國泰證券",0,22,-22
"7149","2727王品","110/08/12","永豐金-中正",9,0,9
"7150","2727王品","110/08/12","統一",1,19,-18
"7151","2727王品","110/08/12","中國信託",12,4,8
"7152","2727王品","110/08/12","元大證券",5,21,-16
"7153","2727王品","110/08/12","國泰-敦南",9,1,8
"7154","2727王品","110/08/12","永豐金證券",0,16,-16
"7155","2727王品","110/08/12","日盛-景美",8,1,7
"7156","2727王品","110/08/12","港商野村",4,15,-11
"7157","2727王品","110/08/12","元富-永和",7,0,7
"7158","2727王品","110/08/12","元富-大昌",0,8,-8
"7159","2727王品","110/08/12","富邦-新店",7,0,7
"7160","2727王品","110/08/12","元大-沙鹿",0,8,-8
"7161","2727王品","110/08/12","日盛-木柵",6,0,6
"7162","2727王品","110/08/12","元大-板橋",5,10,-5
"7163","2727王品","110/08/12","日盛-屏東",7,1,6
"7164","2727王品","110/08/12","永豐金-彰化",0,5,-5
"7165","2727王品","110/08/12","台新-三民",7,1,6
"7166","2727王品","110/08/12","大慶-泰山",0,4,-4
"7167","2727王品","110/08/12","凱基-三重",6,0,6
"7168","2727王品","110/08/12","台中銀",0,4,-4
"7169","2727王品","110/08/12","第一金-台南",5,0,5
"7170","2727王品","110/08/12","康和",0,4,-4
"7171","1570力肯","110/08/12","台新證券",91,15,76
"7172","1570力肯","110/08/12","國票-北高雄",2,361,-359
"7173","1570力肯","110/08/12","元大-南投",81,5,76
"7174","1570力肯","110/08/12","新光",95,222,-127
"7175","1570力肯","110/08/12","永全-南崁",94,20,74
"7176","1570力肯","110/08/12","(牛牛牛)亞-鑫豐",28,120,-92
"7177","1570力肯","110/08/12","日盛-忠孝",57,0,57
"7178","1570力肯","110/08/12","華南永昌-高雄",0,52,-52
"7179","1570力肯","110/08/12","永豐金-北高雄",55,0,55
"7180","1570力肯","110/08/12","群益金鼎-三重",0,42,-42
"7181","1570力肯","110/08/12","中國信託-高雄",72,22,50
"7182","1570力肯","110/08/12","日盛-八德",2,39,-37
"7183","1570力肯","110/08/12","凱基-天母",49,0,49
"7184","1570力肯","110/08/12","新光-台中",130,167,-37
"7185","1570力肯","110/08/12","新光-台南",56,18,38
"7186","1570力肯","110/08/12","日盛-樹林",1,31,-30
"7187","1570力肯","110/08/12","兆豐-嘉義",35,0,35
"7188","1570力肯","110/08/12","元大-竹北",0,30,-30
"7189","1570力肯","110/08/12","國票-天祥",32,1,31
"7190","1570力肯","110/08/12","元大-楊梅",6,35,-29
"7191","1570力肯","110/08/12","國泰-松江",81,51,30
"7192","1570力肯","110/08/12","元大-桃興",4,32,-28
"7193","1570力肯","110/08/12","元大-新店中正",33,3,30
"7194","1570力肯","110/08/12","亞東-台中",0,26,-26
"7195","1570力肯","110/08/12","統一",48,21,27
"7196","1570力肯","110/08/12","永豐金-屏東",5,30,-25
"7197","1570力肯","110/08/12","國票-內壢",26,0,26
"7198","1570力肯","110/08/12","國泰-館前",0,24,-24
"7199","1570力肯","110/08/12","元大-大益",27,1,26
"7200","1570力肯","110/08/12","摩根大通",173,193,-20
"7201","6180橘子","110/08/12","第一金-忠孝",54,0,54
"7202","6180橘子","110/08/12","台灣企銀-屏東",0,30,-30
"7203","6180橘子","110/08/12","美林",35,0,35
"7204","6180橘子","110/08/12","元大-斗信",0,20,-20
"7205","6180橘子","110/08/12","凱基-台北",27,0,27
"7206","6180橘子","110/08/12","永豐金-信義",0,15,-15
"7207","6180橘子","110/08/12","美商高盛",23,2,21
"7208","6180橘子","110/08/12","玉山-桃園",0,14,-14
"7209","6180橘子","110/08/12","元大-前金",20,0,20
"7210","6180橘子","110/08/12","兆豐-埔墘",0,10,-10
"7211","6180橘子","110/08/12","摩根大通",21,5,16
"7212","6180橘子","110/08/12","富邦-高雄",0,10,-10
"7213","6180橘子","110/08/12","元大-敦南",11,0,11
"7214","6180橘子","110/08/12","台新-新營",1,10,-9
"7215","6180橘子","110/08/12","統一-基隆",10,0,10
"7216","6180橘子","110/08/12","富邦-員林",0,9,-9
"7217","6180橘子","110/08/12","元大證券",6,0,6
"7218","6180橘子","110/08/12","台灣摩根士丹利",4,11,-7
"7219","6180橘子","110/08/12","日盛-樹林",5,0,5
"7220","6180橘子","110/08/12","大慶-蘆洲",0,7,-7
"7221","6180橘子","110/08/12","新光-新竹",6,1,5
"7222","6180橘子","110/08/12","元大-北三重",0,7,-7
"7223","6180橘子","110/08/12","元大-上新莊",5,0,5
"7224","6180橘子","110/08/12","新光",1,6,-5
"7225","6180橘子","110/08/12","新加坡商瑞銀",3,0,3
"7226","6180橘子","110/08/12","華南永昌-虎尾",0,5,-5
"7227","6180橘子","110/08/12","統一-中壢",3,0,3
"7228","6180橘子","110/08/12","元大-屏南",0,5,-5
"7229","6180橘子","110/08/12","元富-新店",3,0,3
"7230","6180橘子","110/08/12","群益金鼎-東湖",1,5,-4
"7231","2390云辰","110/08/12","美林",245,9,236
"7232","2390云辰","110/08/12","臺銀-臺中",2,218,-216
"7233","2390云辰","110/08/12","新加坡商瑞銀",90,20,70
"7234","2390云辰","110/08/12","兆豐-寶成",0,185,-185
"7235","2390云辰","110/08/12","台灣摩根士丹利",59,2,57
"7236","2390云辰","110/08/12","元大-板橋三民",1,70,-69
"7237","2390云辰","110/08/12","凱基-台北",127,72,55
"7238","2390云辰","110/08/12","永豐金-松山",5,70,-65
"7239","2390云辰","110/08/12","元大-豐原站前",51,1,50
"7240","2390云辰","110/08/12","富邦-建國",11,62,-51
"7241","2390云辰","110/08/12","港商野村",198,154,44
"7242","2390云辰","110/08/12","元大-土城學府",36,70,-34
"7243","2390云辰","110/08/12","凱基-站前",54,10,44
"7244","2390云辰","110/08/12","元大-土城永寧",10,39,-29
"7245","2390云辰","110/08/12","元大-北三重",34,2,32
"7246","2390云辰","110/08/12","群益金鼎-中壢",3,30,-27
"7247","2390云辰","110/08/12","凱基-民權",30,0,30
"7248","2390云辰","110/08/12","元大-新竹",3,30,-27
"7249","2390云辰","110/08/12","華南永昌-岡山",28,0,28
"7250","2390云辰","110/08/12","元富-城東",2,28,-26
"7251","2390云辰","110/08/12","元富-同大",34,7,27
"7252","2390云辰","110/08/12","群益金鼎-三民",2,26,-24
"7253","2390云辰","110/08/12","元大-路竹",45,20,25
"7254","2390云辰","110/08/12","台新-左楠",28,50,-22
"7255","2390云辰","110/08/12","國票-博愛",34,11,23
"7256","2390云辰","110/08/12","中農",1,23,-22
"7257","2390云辰","110/08/12","元大-台南",25,2,23
"7258","2390云辰","110/08/12","聯邦商銀",0,22,-22
"7259","2390云辰","110/08/12","群益金鼎-開元",30,8,22
"7260","2390云辰","110/08/12","元富-新店",2,23,-21
"7261","2867三商壽","110/08/11","摩根大通",509,31,478
"7262","2867三商壽","110/08/11","港商野村",13,188,-175
"7263","2867三商壽","110/08/11","美商高盛",157,17,140
"7264","2867三商壽","110/08/11","宏遠-高雄",0,150,-150
"7265","2867三商壽","110/08/11","凱基-台北",123,14,109
"7266","2867三商壽","110/08/11","日盛-鳳山",0,73,-73
"7267","2867三商壽","110/08/11","凱基-八德",101,0,101
"7268","2867三商壽","110/08/11","德信-中正",0,71,-71
"7269","2867三商壽","110/08/11","統一-平鎮",100,0,100
"7270","2867三商壽","110/08/11","凱基-新豐",1,67,-66
"7271","2867三商壽","110/08/11","元大-土城永寧",94,5,89
"7272","2867三商壽","110/08/11","土銀-新竹",0,60,-60
"7273","2867三商壽","110/08/11","元大-沙鹿",63,0,63
"7274","2867三商壽","110/08/11","凱基-中港",0,55,-55
"7275","2867三商壽","110/08/11","新加坡商瑞銀",55,1,54
"7276","2867三商壽","110/08/11","中國信託-文心",11,61,-50
"7277","2867三商壽","110/08/11","台灣摩根士丹利",60,10,50
"7278","2867三商壽","110/08/11","國泰-新莊",2,50,-48
"7279","2867三商壽","110/08/11","元富-潮州",41,0,41
"7280","2867三商壽","110/08/11","群益金鼎",0,40,-40
"7281","2867三商壽","110/08/11","統一-汐止",40,0,40
"7282","2867三商壽","110/08/11","元大-大益",0,40,-40
"7283","2867三商壽","110/08/11","新光-高雄",40,4,36
"7284","2867三商壽","110/08/11","富邦-板橋",5,38,-33
"7285","2867三商壽","110/08/11","玉山-板橋",31,1,30
"7286","2867三商壽","110/08/11","元富-古亭",0,30,-30
"7287","2867三商壽","110/08/11","美林",194,168,26
"7288","2867三商壽","110/08/11","元大-金華",0,30,-30
"7289","2867三商壽","110/08/11","凱基",24,0,24
"7290","2867三商壽","110/08/11","元大-汐止",13,42,-29
"7291","5521工信","110/08/11","摩根大通",417,16,401
"7292","5521工信","110/08/11","元大-沙鹿",0,103,-103
"7293","5521工信","110/08/11","凱基-台北",86,5,81
"7294","5521工信","110/08/11","華南永昌",0,43,-43
"7295","5521工信","110/08/11","日進",73,0,73
"7296","5521工信","110/08/11","聯邦-雙和",0,42,-42
"7297","5521工信","110/08/11","日盛證券",70,0,70
"7298","5521工信","110/08/11","元富-基隆",0,38,-38
"7299","5521工信","110/08/11","富邦-台北",65,0,65
"7300","5521工信","110/08/11","第一金-路竹",0,37,-37
"7301","5521工信","110/08/11","富邦-苗栗",50,0,50
"7302","5521工信","110/08/11","土銀-台中",0,35,-35
"7303","5521工信","110/08/11","永豐金-鳳山",40,1,39
"7304","5521工信","110/08/11","玉山-高雄",0,30,-30
"7305","5521工信","110/08/11","台灣企銀-北高雄",30,0,30
"7306","5521工信","110/08/11","凱基-台南",0,30,-30
"7307","5521工信","110/08/11","美林",71,42,29
"7308","5521工信","110/08/11","凱基-復興",0,30,-30
"7309","5521工信","110/08/11","台新-台中",31,6,25
"7310","5521工信","110/08/11","元大-屏南",0,30,-30
"7311","5521工信","110/08/11","凱基-鳳山",20,0,20
"7312","5521工信","110/08/11","永豐金-天母",0,30,-30
"7313","5521工信","110/08/11","元大-東蘆",20,0,20
"7314","5521工信","110/08/11","華南永昌-潮州",4,32,-28
"7315","5521工信","110/08/11","群益金鼎-士林",21,3,18
"7316","5521工信","110/08/11","華南永昌-彰化",13,39,-26
"7317","5521工信","110/08/11","永豐金證券",14,0,14
"7318","5521工信","110/08/11","日盛-新莊",0,25,-25
"7319","5521工信","110/08/11","瑞士信貸",13,0,13
"7320","5521工信","110/08/11","群益金鼎-敦南",0,25,-25
"7321","1471首利","110/08/11","瑞士信貸",162,0,162
"7322","1471首利","110/08/11","日盛-和美",1,55,-54
"7323","1471首利","110/08/11","永全-八德",100,0,100
"7324","1471首利","110/08/11","臺銀-臺中",3,55,-52
"7325","1471首利","110/08/11","摩根大通",128,46,82
"7326","1471首利","110/08/11","永豐金-板盛",0,42,-42
"7327","1471首利","110/08/11","台新證券",48,7,41
"7328","1471首利","110/08/11","兆豐-桃園",0,40,-40
"7329","1471首利","110/08/11","凱基-台南",30,0,30
"7330","1471首利","110/08/11","凱基-東門",0,40,-40
"7331","1471首利","110/08/11","凱基-內埔",20,0,20
"7332","1471首利","110/08/11","元大-新竹經國",0,40,-40
"7333","1471首利","110/08/11","元大-蘆洲",20,0,20
"7334","1471首利","110/08/11","群益金鼎-中港",0,35,-35
"7335","1471首利","110/08/11","台新-高雄",16,0,16
"7336","1471首利","110/08/11","元大-竹山",0,30,-30
"7337","1471首利","110/08/11","大慶-富順",13,0,13
"7338","1471首利","110/08/11","富邦-新竹",1,30,-29
"7339","1471首利","110/08/11","群益金鼎-海山",13,0,13
"7340","1471首利","110/08/11","日盛-八德",0,27,-27
"7341","1471首利","110/08/11","日盛-大墩",12,0,12
"7342","1471首利","110/08/11","大慶-蘆洲",5,30,-25
"7343","1471首利","110/08/11","凱基-三重",12,0,12
"7344","1471首利","110/08/11","元富-林園",0,25,-25
"7345","1471首利","110/08/11","華南永昌-林口",12,0,12
"7346","1471首利","110/08/11","元富-大昌",0,25,-25
"7347","1471首利","110/08/11","富邦-中壢",13,2,11
"7348","1471首利","110/08/11","新光",9,34,-25
"7349","1471首利","110/08/11","合庫-台中",10,0,10
"7350","1471首利","110/08/11","兆豐-寶成",0,24,-24
"7351","2883開發金","110/08/11","瑞士信貸",5796,0,5796
"7352","2883開發金","110/08/11","元富",772,4335,-3563
"7353","2883開發金","110/08/11","元大-板橋三民",4182,53,4129
"7354","2883開發金","110/08/11","美林",2516,5260,-2744
"7355","2883開發金","110/08/11","合庫證券",3532,28,3504
"7356","2883開發金","110/08/11","永豐金-彰化",42,2447,-2405
"7357","2883開發金","110/08/11","兆豐證券",2123,44,2079
"7358","2883開發金","110/08/11","元大證券",1279,3467,-2188
"7359","2883開發金","110/08/11","台灣摩根士丹利",2946,1744,1202
"7360","2883開發金","110/08/11","國票-長城",0,2014,-2014
"7361","2883開發金","110/08/11","富邦-建國",1195,92,1103
"7362","2883開發金","110/08/11","港商野村",3121,4600,-1479
"7363","2883開發金","110/08/11","新光-新竹",1140,38,1102
"7364","2883開發金","110/08/11","元大-金華",31,1341,-1310
"7365","2883開發金","110/08/11","美商高盛",1600,535,1065
"7366","2883開發金","110/08/11","元大-彰化",67,1218,-1151
"7367","2883開發金","110/08/11","群益金鼎-南京",1083,202,881
"7368","2883開發金","110/08/11","玉山-高雄",99,986,-887
"7369","2883開發金","110/08/11","凱基-台北",5046,4258,788
"7370","2883開發金","110/08/11","元富-彰化",27,813,-786
"7371","2883開發金","110/08/11","港商法國興業",728,0,728
"7372","2883開發金","110/08/11","摩根大通",3362,4085,-723
"7373","2883開發金","110/08/11","玉山證券",716,98,618
"7374","2883開發金","110/08/11","國泰證券",21,658,-637
"7375","2883開發金","110/08/11","凱基-豐中",634,76,558
"7376","2883開發金","110/08/11","富邦-新店",61,662,-601
"7377","2883開發金","110/08/11","永豐金-忠孝",1406,858,548
"7378","2883開發金","110/08/11","元大-小港",71,667,-596
"7379","2883開發金","110/08/11","元大-民生",532,2,530
"7380","2883開發金","110/08/11","富邦-台北",213,798,-585
"7381","6205詮欣","110/08/11","臺銀-民權",25,0,25
"7382","6205詮欣","110/08/11","摩根大通",2,46,-44
"7383","6205詮欣","110/08/11","合庫-三重",20,0,20
"7384","6205詮欣","110/08/11","永豐金-敦南",0,14,-14
"7385","6205詮欣","110/08/11","元富-宜蘭",20,0,20
"7386","6205詮欣","110/08/11","瑞士信貸",0,11,-11
"7387","6205詮欣","110/08/11","德信-新營",10,0,10
"7388","6205詮欣","110/08/11","永豐金-忠孝",0,10,-10
"7389","6205詮欣","110/08/11","元大-西屯",10,0,10
"7390","6205詮欣","110/08/11","統一-汐止",0,6,-6
"7391","6205詮欣","110/08/11","永豐金-中正",9,0,9
"7392","6205詮欣","110/08/11","港商野村",0,5,-5
"7393","6205詮欣","110/08/11","日盛-三重",5,0,5
"7394","6205詮欣","110/08/11","新光",0,5,-5
"7395","6205詮欣","110/08/11","日盛-花蓮",5,0,5
"7396","6205詮欣","110/08/11","群益金鼎-開元",0,5,-5
"7397","6205詮欣","110/08/11","宏遠證券",5,0,5
"7398","6205詮欣","110/08/11","富邦-陽明",0,5,-5
"7399","6205詮欣","110/08/11","高橋",5,0,5
"7400","6205詮欣","110/08/11","元大-館前",0,5,-5
"7401","6205詮欣","110/08/11","亞東-板橋",4,0,4
"7402","6205詮欣","110/08/11","大慶-中壢",0,4,-4
"7403","6205詮欣","110/08/11","元富-基隆",3,0,3
"7404","6205詮欣","110/08/11","凱基-和平",0,4,-4
"7405","6205詮欣","110/08/11","元大-台中中港",3,0,3
"7406","6205詮欣","110/08/11","富邦-台北",0,4,-4
"7407","6205詮欣","110/08/11","合庫-彰化",2,0,2
"7408","6205詮欣","110/08/11","元大-南投",0,4,-4
"7409","6205詮欣","110/08/11","元大-西門",2,0,2
"7410","6205詮欣","110/08/11","元大-東蘆",0,4,-4
"7411","1540喬福","110/08/11","元富-中原",30,0,30
"7412","1540喬福","110/08/11","統一-新台中",0,18,-18
"7413","1540喬福","110/08/11","台中銀",17,0,17
"7414","1540喬福","110/08/11","凱基-台北",0,16,-16
"7415","1540喬福","110/08/11","富邦-竹北",11,0,11
"7416","1540喬福","110/08/11","永豐金-板新",0,15,-15
"7417","1540喬福","110/08/11","國泰-敦南",8,0,8
"7418","1540喬福","110/08/11","永豐金-中盛",0,11,-11
"7419","1540喬福","110/08/11","凱基-中壢",6,0,6
"7420","1540喬福","110/08/11","元大-中壢",0,10,-10
"7421","1540喬福","110/08/11","凱基-台南",5,0,5
"7422","1540喬福","110/08/11","玉山-台南",0,4,-4
"7423","1540喬福","110/08/11","元大-土城永寧",3,0,3
"7424","1540喬福","110/08/11","國票-南科",0,3,-3
"7425","1540喬福","110/08/11","臺銀-鳳山",2,0,2
"7426","1540喬福","110/08/11","元大-龍潭",0,3,-3
"7427","1540喬福","110/08/11","日盛-台中",2,0,2
"7428","1540喬福","110/08/11","臺銀-臺中",0,2,-2
"7429","1540喬福","110/08/11","兆豐-北高雄",2,0,2
"7430","1540喬福","110/08/11","(牛牛牛)亞-網路",0,2,-2
"7431","1540喬福","110/08/11","兆豐-三民",2,0,2
"7432","1540喬福","110/08/11","新光-台南",0,2,-2
"7433","1540喬福","110/08/11","合庫-桃園",1,0,1
"7434","1540喬福","110/08/11","凱基-永和",0,2,-2
"7435","1540喬福","110/08/11","臺銀-民權",1,0,1
"7436","1540喬福","110/08/11","元大-南崁",0,2,-2
"7437","1540喬福","110/08/11","臺銀-高雄",1,0,1
"7438","1540喬福","110/08/11","美林",0,1,-1
"7439","1540喬福","110/08/11","日盛-永康",1,0,1
"7440","1540喬福","110/08/11","美商高盛",0,1,-1
"7441","2888新光金","110/08/11","摩根大通",6950,1470,5480
"7442","2888新光金","110/08/11","第一金-高雄",5,5018,-5013
"7443","2888新光金","110/08/11","元大-忠孝鼎富",4314,11,4303
"7444","2888新光金","110/08/11","永豐金-天母",0,2241,-2241
"7445","2888新光金","110/08/11","美商高盛",4420,228,4192
"7446","2888新光金","110/08/11","統一-中壢",11,1720,-1709
"7447","2888新光金","110/08/11","瑞士信貸",2928,166,2762
"7448","2888新光金","110/08/11","美林",1510,3170,-1660
"7449","2888新光金","110/08/11","群益金鼎",1859,0,1859
"7450","2888新光金","110/08/11","國票-台東",21,1606,-1585
"7451","2888新光金","110/08/11","凱基-台北",5335,3700,1635
"7452","2888新光金","110/08/11","元富-城東",25,1082,-1057
"7453","2888新光金","110/08/11","新加坡商瑞銀",1506,65,1441
"7454","2888新光金","110/08/11","台灣摩根士丹利",916,1951,-1035
"7455","2888新光金","110/08/11","港商法國興業",1338,0,1338
"7456","2888新光金","110/08/11","中國信託",25,740,-715
"7457","2888新光金","110/08/11","元富-中港",1250,9,1241
"7458","2888新光金","110/08/11","新光",391,1047,-656
"7459","2888新光金","110/08/11","福邦-新竹",1176,0,1176
"7460","2888新光金","110/08/11","合庫-高雄",1,567,-566
"7461","2888新光金","110/08/11","凱基-林口",1005,35,970
"7462","2888新光金","110/08/11","康和-台中",1,463,-462
"7463","2888新光金","110/08/11","港商野村",1301,434,867
"7464","2888新光金","110/08/11","玉山證券",260,691,-431
"7465","2888新光金","110/08/11","國票-安和",1179,519,660
"7466","2888新光金","110/08/11","元大-和平",4,382,-378
"7467","2888新光金","110/08/11","富邦-敦南",569,19,550
"7468","2888新光金","110/08/11","日盛-新莊",0,350,-350
"7469","2888新光金","110/08/11","香港上海匯豐",441,0,441
"7470","2888新光金","110/08/11","群益金鼎-大興",1,341,-340
"7471","1340勝悅","110/08/11","華南永昌-高雄",24,4,20
"7472","1340勝悅","110/08/11","元大-大統",0,42,-42
"7473","1340勝悅","110/08/11","亞東-板橋",18,0,18
"7474","1340勝悅","110/08/11","(牛牛牛)亞-鑫豐",0,25,-25
"7475","1340勝悅","110/08/11","永豐金-台南",12,0,12
"7476","1340勝悅","110/08/11","美林",0,20,-20
"7477","1340勝悅","110/08/11","永豐金-板盛",10,0,10
"7478","1340勝悅","110/08/11","摩根大通",0,18,-18
"7479","1340勝悅","110/08/11","永豐金-天母",9,0,9
"7480","1340勝悅","110/08/11","元富-基隆",0,12,-12
"7481","1340勝悅","110/08/11","國泰-敦南",15,7,8
"7482","1340勝悅","110/08/11","玉山-高雄",0,12,-12
"7483","1340勝悅","110/08/11","群益金鼎-館前",8,0,8
"7484","1340勝悅","110/08/11","元大-桃興",0,10,-10
"7485","1340勝悅","110/08/11","凱基-台中",7,0,7
"7486","1340勝悅","110/08/11","永豐金-博愛",0,10,-10
"7487","1340勝悅","110/08/11","統一-城中",6,0,6
"7488","1340勝悅","110/08/11","瑞士信貸",0,8,-8
"7489","1340勝悅","110/08/11","群益金鼎-崇德",6,0,6
"7490","1340勝悅","110/08/11","日盛-台中",0,6,-6
"7491","1340勝悅","110/08/11","永豐金-松山",6,0,6
"7492","1340勝悅","110/08/11","元大-景美",0,6,-6
"7493","1340勝悅","110/08/11","臺銀-鳳山",5,0,5
"7494","1340勝悅","110/08/11","日盛-信義",0,5,-5
"7495","1340勝悅","110/08/11","永全-南崁",5,0,5
"7496","1340勝悅","110/08/11","台新證券",0,5,-5
"7497","1340勝悅","110/08/11","玉山-士林",5,0,5
"7498","1340勝悅","110/08/11","元大-忠孝鼎富",0,5,-5
"7499","1340勝悅","110/08/11","國泰-台中",15,10,5
"7500","1340勝悅","110/08/11","元大-中壢",0,5,-5
"7501","6246臺龍","110/08/11","永興",40,3,37
"7502","6246臺龍","110/08/11","港商野村",6,139,-133
"7503","6246臺龍","110/08/11","永豐金-內湖",42,9,33
"7504","6246臺龍","110/08/11","統一",0,97,-97
"7505","6246臺龍","110/08/11","元大-豐原站前",68,41,27
"7506","6246臺龍","110/08/11","兆豐-松德",0,82,-82
"7507","6246臺龍","110/08/11","日盛-員林",21,1,20
"7508","6246臺龍","110/08/11","元大-新盛",24,80,-56
"7509","6246臺龍","110/08/11","康和-澎湖",20,0,20
"7510","6246臺龍","110/08/11","元大-北港",0,35,-35
"7511","6246臺龍","110/08/11","元大-歸仁",18,0,18
"7512","6246臺龍","110/08/11","元大-西門",0,28,-28
"7513","6246臺龍","110/08/11","元大-中壢",35,17,18
"7514","6246臺龍","110/08/11","永興-台中",0,27,-27
"7515","6246臺龍","110/08/11","玉山-大里",17,0,17
"7516","6246臺龍","110/08/11","永興-水湳",0,25,-25
"7517","6246臺龍","110/08/11","大慶-泰山",15,0,15
"7518","6246臺龍","110/08/11","元大-西螺",6,30,-24
"7519","6246臺龍","110/08/11","永豐金-松山",15,1,14
"7520","6246臺龍","110/08/11","元大-西屯",2,25,-23
"7521","6246臺龍","110/08/11","凱基-永和",13,0,13
"7522","6246臺龍","110/08/11","新光",45,67,-22
"7523","6246臺龍","110/08/11","華南永昌-嘉義",13,0,13
"7524","6246臺龍","110/08/11","第一金-台中",0,20,-20
"7525","6246臺龍","110/08/11","富邦-三重",13,0,13
"7526","6246臺龍","110/08/11","兆豐-南京",0,20,-20
"7527","6246臺龍","110/08/11","日盛-高雄",12,0,12
"7528","6246臺龍","110/08/11","日盛-頭份",2,20,-18
"7529","6246臺龍","110/08/11","群益金鼎-北高雄",12,0,12
"7530","6246臺龍","110/08/11","宏遠-桃園",0,17,-17
"7531","00715L期街口布蘭特正2","110/08/11","元大證券",11593,2378,9215
"7532","00715L期街口布蘭特正2","110/08/11","凱基-台北",313,3001,-2688
"7533","00715L期街口布蘭特正2","110/08/11","永豐金-新店",1600,4,1596
"7534","00715L期街口布蘭特正2","110/08/11","富邦-南屯",403,1908,-1505
"7535","00715L期街口布蘭特正2","110/08/11","第一金-台中",1282,31,1251
"7536","00715L期街口布蘭特正2","110/08/11","新光",152,1165,-1013
"7537","00715L期街口布蘭特正2","110/08/11","元大-敦化",1200,20,1180
"7538","00715L期街口布蘭特正2","110/08/11","第一金-台南",0,519,-519
"7539","00715L期街口布蘭特正2","110/08/11","永豐金證券",1128,53,1075
"7540","00715L期街口布蘭特正2","110/08/11","統一-新竹",13,506,-493
"7541","00715L期街口布蘭特正2","110/08/11","元大-復北",556,21,535
"7542","00715L期街口布蘭特正2","110/08/11","台新-三民",0,438,-438
"7543","00715L期街口布蘭特正2","110/08/11","日盛-永康",340,0,340
"7544","00715L期街口布蘭特正2","110/08/11","富邦-彰化",30,391,-361
"7545","00715L期街口布蘭特正2","110/08/11","群益金鼎-板橋",350,17,333
"7546","00715L期街口布蘭特正2","110/08/11","元富-中壢",5,316,-311
"7547","00715L期街口布蘭特正2","110/08/11","元富",325,2,323
"7548","00715L期街口布蘭特正2","110/08/11","凱基-豐中",0,302,-302
"7549","00715L期街口布蘭特正2","110/08/11","凱基-科園",300,0,300
"7550","00715L期街口布蘭特正2","110/08/11","康和",359,645,-286
"7551","00715L期街口布蘭特正2","110/08/11","元大-蘆洲",311,59,252
"7552","00715L期街口布蘭特正2","110/08/11","元富-成功",5,290,-285
"7553","00715L期街口布蘭特正2","110/08/11","群益金鼎-崇德",251,20,231
"7554","00715L期街口布蘭特正2","110/08/11","台新-松江",0,268,-268
"7555","00715L期街口布蘭特正2","110/08/11","富邦-建國",265,42,223
"7556","00715L期街口布蘭特正2","110/08/11","元大-前金",21,279,-258
"7557","00715L期街口布蘭特正2","110/08/11","富邦-嘉義",300,99,201
"7558","00715L期街口布蘭特正2","110/08/11","國泰-高雄",13,236,-223
"7559","00715L期街口布蘭特正2","110/08/11","元大-竹科",314,115,199
"7560","00715L期街口布蘭特正2","110/08/11","中國信託-嘉義",4,223,-219
"7561","8941關中","110/08/11","凱基-市府",1,0,1
"7562","8941關中","110/08/11","元大-古亭",0,1,-1
"7563","8941關中","110/08/11","康和-板橋",0,0,0
"7564","8941關中","110/08/11","康和-板橋",0,0,0
"7565","8941關中","110/08/11","國泰-忠孝",0,0,0
"7566","8941關中","110/08/11","國泰-忠孝",0,0,0
"7567","8941關中","110/08/11","富邦-北港",0,0,0
"7568","8941關中","110/08/11","富邦-北港",0,0,0
"7569","8941關中","110/08/11","元大證券",0,0,0
"7570","8941關中","110/08/11","元大證券",0,0,0
"7571","8941關中","110/08/11","",NA,NA,NA
"7572","8941關中","110/08/11","",NA,NA,NA
"7573","8941關中","110/08/11","",NA,NA,NA
"7574","8941關中","110/08/11","",NA,NA,NA
"7575","8941關中","110/08/11","",NA,NA,NA
"7576","8941關中","110/08/11","",NA,NA,NA
"7577","8941關中","110/08/11","",NA,NA,NA
"7578","8941關中","110/08/11","",NA,NA,NA
"7579","8941關中","110/08/11","",NA,NA,NA
"7580","8941關中","110/08/11","",NA,NA,NA
"7581","8941關中","110/08/11","",NA,NA,NA
"7582","8941關中","110/08/11","",NA,NA,NA
"7583","8941關中","110/08/11","",NA,NA,NA
"7584","8941關中","110/08/11","",NA,NA,NA
"7585","8941關中","110/08/11","",NA,NA,NA
"7586","8941關中","110/08/11","",NA,NA,NA
"7587","8941關中","110/08/11","",NA,NA,NA
"7588","8941關中","110/08/11","",NA,NA,NA
"7589","8941關中","110/08/11","",NA,NA,NA
"7590","8941關中","110/08/11","",NA,NA,NA
"7591","8936國統","110/08/11","台新-高雄",218,1,217
"7592","8936國統","110/08/11","凱基-內埔",0,70,-70
"7593","8936國統","110/08/11","新光-桃園",105,3,102
"7594","8936國統","110/08/11","元大-太平",0,60,-60
"7595","8936國統","110/08/11","新加坡商瑞銀",124,59,65
"7596","8936國統","110/08/11","永豐金-板盛",0,48,-48
"7597","8936國統","110/08/11","美林",61,0,61
"7598","8936國統","110/08/11","兆豐-高雄",0,29,-29
"7599","8936國統","110/08/11","摩根大通",71,16,55
"7600","8936國統","110/08/11","群益金鼎-屏東",0,27,-27
"7601","8936國統","110/08/11","元富-同大",41,5,36
"7602","8936國統","110/08/11","新光",0,24,-24
"7603","8936國統","110/08/11","凱基-台北",38,6,32
"7604","8936國統","110/08/11","凱基-台南",0,22,-22
"7605","8936國統","110/08/11","華南永昌-高雄",22,0,22
"7606","8936國統","110/08/11","合庫-高雄",0,20,-20
"7607","8936國統","110/08/11","日盛-三峽",21,0,21
"7608","8936國統","110/08/11","永豐金-大園",0,20,-20
"7609","8936國統","110/08/11","兆豐-大同",30,9,21
"7610","8936國統","110/08/11","永豐金-台中",0,20,-20
"7611","8936國統","110/08/11","宏遠-台南",20,0,20
"7612","8936國統","110/08/11","永豐金-竹科",0,20,-20
"7613","8936國統","110/08/11","美商高盛",17,1,16
"7614","8936國統","110/08/11","港商野村",49,67,-18
"7615","8936國統","110/08/11","日盛-斗六",15,0,15
"7616","8936國統","110/08/11","第一金-新興",0,16,-16
"7617","8936國統","110/08/11","元富-大裕",15,0,15
"7618","8936國統","110/08/11","新光-台中",14,29,-15
"7619","8936國統","110/08/11","台新-台中",15,2,13
"7620","8936國統","110/08/11","凱基-永和",0,15,-15
"7621","6226光鼎","110/08/11","美商高盛",595,148,447
"7622","6226光鼎","110/08/11","瑞士信貸",297,751,-454
"7623","6226光鼎","110/08/11","凱基-台北",506,69,437
"7624","6226光鼎","110/08/11","摩根大通",911,1317,-406
"7625","6226光鼎","110/08/11","統一-高雄",503,150,353
"7626","6226光鼎","110/08/11","凱基-站前",29,313,-284
"7627","6226光鼎","110/08/11","美林",507,312,195
"7628","6226光鼎","110/08/11","台中銀-台北",0,280,-280
"7629","6226光鼎","110/08/11","合庫-台中",143,4,139
"7630","6226光鼎","110/08/11","國泰-台中",75,176,-101
"7631","6226光鼎","110/08/11","大昌",139,0,139
"7632","6226光鼎","110/08/11","元富-潮州",10,107,-97
"7633","6226光鼎","110/08/11","台灣摩根士丹利",229,101,128
"7634","6226光鼎","110/08/11","中國信託-永康",63,159,-96
"7635","6226光鼎","110/08/11","元大-北投",123,4,119
"7636","6226光鼎","110/08/11","國泰-高雄",15,96,-81
"7637","6226光鼎","110/08/11","富邦-南屯",170,63,107
"7638","6226光鼎","110/08/11","凱基-三多",23,100,-77
"7639","6226光鼎","110/08/11","群益金鼎-西松",176,93,83
"7640","6226光鼎","110/08/11","玉山-高雄",17,90,-73
"7641","6226光鼎","110/08/11","台新證券",167,99,68
"7642","6226光鼎","110/08/11","元大-新盛",8,81,-73
"7643","6226光鼎","110/08/11","永豐金-內湖",79,22,57
"7644","6226光鼎","110/08/11","元大-府城",7,72,-65
"7645","6226光鼎","110/08/11","日盛證券",51,6,45
"7646","6226光鼎","110/08/11","統一-仁愛",13,75,-62
"7647","6226光鼎","110/08/11","臺銀-高雄",70,26,44
"7648","6226光鼎","110/08/11","高橋",4,61,-57
"7649","6226光鼎","110/08/11","富邦-陽明",84,40,44
"7650","6226光鼎","110/08/11","台新-屏東",16,71,-55
"7651","2363矽統","110/08/11","瑞士信貸",547,0,547
"7652","2363矽統","110/08/11","凱基-台北",2934,4385,-1451
"7653","2363矽統","110/08/11","台灣摩根士丹利",677,160,517
"7654","2363矽統","110/08/11","陽信-石牌",34,626,-592
"7655","2363矽統","110/08/11","玉山-台中",331,139,192
"7656","2363矽統","110/08/11","永豐金證券",103,405,-302
"7657","2363矽統","110/08/11","台新-左楠",191,33,158
"7658","2363矽統","110/08/11","元大-成功",60,289,-229
"7659","2363矽統","110/08/11","華南永昌-頭份",197,45,152
"7660","2363矽統","110/08/11","美林",747,959,-212
"7661","2363矽統","110/08/11","元大-忠孝鼎富",196,51,145
"7662","2363矽統","110/08/11","元大-員林中山",83,286,-203
"7663","2363矽統","110/08/11","元大-汐止",279,150,129
"7664","2363矽統","110/08/11","凱基-市府",42,242,-200
"7665","2363矽統","110/08/11","大慶-蘆洲",135,26,109
"7666","2363矽統","110/08/11","永豐金-埔里",4,181,-177
"7667","2363矽統","110/08/11","合庫-高雄",135,30,105
"7668","2363矽統","110/08/11","群益金鼎-內湖",41,195,-154
"7669","2363矽統","110/08/11","兆豐證券",105,1,104
"7670","2363矽統","110/08/11","元大-旗山",157,307,-150
"7671","2363矽統","110/08/11","永豐金-竹科",112,15,97
"7672","2363矽統","110/08/11","兆豐-台中港",38,178,-140
"7673","2363矽統","110/08/11","國票-彰化",95,0,95
"7674","2363矽統","110/08/11","元大-新竹",55,194,-139
"7675","2363矽統","110/08/11","元大-斗信",152,65,87
"7676","2363矽統","110/08/11","凱基-永和",32,161,-129
"7677","2363矽統","110/08/11","亞東",95,10,85
"7678","2363矽統","110/08/11","第一金-桃園",59,183,-124
"7679","2363矽統","110/08/11","美商高盛",906,822,84
"7680","2363矽統","110/08/11","台新證券",525,640,-115
"7681","8112至上","110/08/11","港商野村",188,11,177
"7682","8112至上","110/08/11","新加坡商瑞銀",35,847,-812
"7683","8112至上","110/08/11","大昌-桃園",173,0,173
"7684","8112至上","110/08/11","宏遠證券",2,536,-534
"7685","8112至上","110/08/11","合庫證券",142,3,139
"7686","8112至上","110/08/11","富邦-仁愛",67,324,-257
"7687","8112至上","110/08/11","美商高盛",145,14,131
"7688","8112至上","110/08/11","凱基-市政",0,202,-202
"7689","8112至上","110/08/11","群益金鼎-內湖",132,10,122
"7690","8112至上","110/08/11","凱基-復興",16,190,-174
"7691","8112至上","110/08/11","國票-長城",130,30,100
"7692","8112至上","110/08/11","瑞士信貸",136,306,-170
"7693","8112至上","110/08/11","玉山-板橋",84,0,84
"7694","8112至上","110/08/11","兆豐-公益",1,120,-119
"7695","8112至上","110/08/11","臺灣企銀-桃園",60,0,60
"7696","8112至上","110/08/11","元大-萬華",12,131,-119
"7697","8112至上","110/08/11","新光",103,44,59
"7698","8112至上","110/08/11","凱基-台北",211,321,-110
"7699","8112至上","110/08/11","華南永昌-中正",52,0,52
"7700","8112至上","110/08/11","美林",21,116,-95
"7701","8112至上","110/08/11","元大-仁愛",50,0,50
"7702","8112至上","110/08/11","永豐金-豐原",7,102,-95
"7703","8112至上","110/08/11","元大-北成功",101,53,48
"7704","8112至上","110/08/11","兆豐-民生",0,70,-70
"7705","8112至上","110/08/11","合庫-嘉義",45,0,45
"7706","8112至上","110/08/11","元富",2,71,-69
"7707","8112至上","110/08/11","大慶-富順",46,1,45
"7708","8112至上","110/08/11","玉山-士林",6,67,-61
"7709","8112至上","110/08/11","臺銀-金山",45,1,44
"7710","8112至上","110/08/11","凱基-埔墘",0,60,-60
"7711","1570力肯","110/08/11","國票-內壢",386,0,386
"7712","1570力肯","110/08/11","群益金鼎-大興",0,100,-100
"7713","1570力肯","110/08/11","華南永昌-桃園",104,3,101
"7714","1570力肯","110/08/11","新光",177,255,-78
"7715","1570力肯","110/08/11","摩根大通",154,84,70
"7716","1570力肯","110/08/11","富邦-台中",0,61,-61
"7717","1570力肯","110/08/11","日盛-頭份",51,0,51
"7718","1570力肯","110/08/11","群益金鼎-忠孝",1,60,-59
"7719","1570力肯","110/08/11","永豐金-中壢",51,1,50
"7720","1570力肯","110/08/11","元大-新店中正",2,61,-59
"7721","1570力肯","110/08/11","永豐金-北高雄",50,0,50
"7722","1570力肯","110/08/11","富邦-陽明",1,51,-50
"7723","1570力肯","110/08/11","凱基-天母",51,2,49
"7724","1570力肯","110/08/11","元大-太平",5,54,-49
"7725","1570力肯","110/08/11","日盛-員林",52,5,47
"7726","1570力肯","110/08/11","統一-松江",0,43,-43
"7727","1570力肯","110/08/11","元富-高雄",40,0,40
"7728","1570力肯","110/08/11","台新證券",6,44,-38
"7729","1570力肯","110/08/11","中國信託-嘉義",34,0,34
"7730","1570力肯","110/08/11","永豐金證券",1,36,-35
"7731","1570力肯","110/08/11","元大-北成功",30,1,29
"7732","1570力肯","110/08/11","瑞士信貸",0,27,-27
"7733","1570力肯","110/08/11","亞東-台中",26,0,26
"7734","1570力肯","110/08/11","元大-中壢",9,35,-26
"7735","1570力肯","110/08/11","第一金-嘉義",26,0,26
"7736","1570力肯","110/08/11","美商高盛",0,25,-25
"7737","1570力肯","110/08/11","凱基-中壢",27,3,24
"7738","1570力肯","110/08/11","國票-北高雄",128,153,-25
"7739","1570力肯","110/08/11","元大-福營",25,1,24
"7740","1570力肯","110/08/11","元富-新店",10,34,-24
"7741","2929淘帝","110/08/11","美林",25,5,20
"7742","2929淘帝","110/08/11","華南永昌",0,25,-25
"7743","2929淘帝","110/08/11","永興",20,0,20
"7744","2929淘帝","110/08/11","台新-台中",0,22,-22
"7745","2929淘帝","110/08/11","新光",17,1,16
"7746","2929淘帝","110/08/11","富邦-永和",1,21,-20
"7747","2929淘帝","110/08/11","臺銀-臺南",12,0,12
"7748","2929淘帝","110/08/11","元富-古亭",0,18,-18
"7749","2929淘帝","110/08/11","第一金-大稻埕",10,0,10
"7750","2929淘帝","110/08/11","永豐金-大園",5,23,-18
"7751","2929淘帝","110/08/11","兆豐-桃園",10,0,10
"7752","2929淘帝","110/08/11","富邦-新店",3,19,-16
"7753","2929淘帝","110/08/11","國票-九鼎",10,0,10
"7754","2929淘帝","110/08/11","新光-台中",16,31,-15
"7755","2929淘帝","110/08/11","華南永昌-長虹",10,0,10
"7756","2929淘帝","110/08/11","國泰-新莊",0,10,-10
"7757","2929淘帝","110/08/11","凱基-長庚",7,0,7
"7758","2929淘帝","110/08/11","元大-東泰",0,10,-10
"7759","2929淘帝","110/08/11","凱基-林口",7,0,7
"7760","2929淘帝","110/08/11","凱基-斗六",0,8,-8
"7761","2929淘帝","110/08/11","日盛-中壢",5,0,5
"7762","2929淘帝","110/08/11","永豐金證券",0,7,-7
"7763","2929淘帝","110/08/11","港商法國興業",5,0,5
"7764","2929淘帝","110/08/11","第一金-員林",0,5,-5
"7765","2929淘帝","110/08/11","元富-中壢",5,0,5
"7766","2929淘帝","110/08/11","元富-新竹",0,5,-5
"7767","2929淘帝","110/08/11","元富-文心",5,0,5
"7768","2929淘帝","110/08/11","凱基-東門",0,5,-5
"7769","2929淘帝","110/08/11","凱基-台中",5,0,5
"7770","2929淘帝","110/08/11","元大-桃園",0,5,-5
"7771","5410國眾","110/08/11","群益金鼎",128,0,128
"7772","5410國眾","110/08/11","國泰-敦南",12,206,-194
"7773","5410國眾","110/08/11","富邦-建國",100,0,100
"7774","5410國眾","110/08/11","凱基-竹北",2,112,-110
"7775","5410國眾","110/08/11","玉山-新莊",35,0,35
"7776","5410國眾","110/08/11","大昌-樹林",0,100,-100
"7777","5410國眾","110/08/11","合庫-桃園",30,0,30
"7778","5410國眾","110/08/11","凱基-市政",0,100,-100
"7779","5410國眾","110/08/11","高橋",30,0,30
"7780","5410國眾","110/08/11","摩根大通",20,68,-48
"7781","5410國眾","110/08/11","元大-崇德",28,0,28
"7782","5410國眾","110/08/11","凱基-台北",7,39,-32
"7783","5410國眾","110/08/11","元大-新盛",28,0,28
"7784","5410國眾","110/08/11","元大-復北",0,30,-30
"7785","5410國眾","110/08/11","凱基-三峽",21,0,21
"7786","5410國眾","110/08/11","大昌",0,26,-26
"7787","5410國眾","110/08/11","臺銀-臺中",17,0,17
"7788","5410國眾","110/08/11","第一金-豐原",0,23,-23
"7789","5410國眾","110/08/11","新光",15,0,15
"7790","5410國眾","110/08/11","元富-三重",0,22,-22
"7791","5410國眾","110/08/11","國泰-台中",20,8,12
"7792","5410國眾","110/08/11","元大-樹林",2,21,-19
"7793","5410國眾","110/08/11","新光-桃園",11,0,11
"7794","5410國眾","110/08/11","元大-成功",0,17,-17
"7795","5410國眾","110/08/11","元大-旗山",11,0,11
"7796","5410國眾","110/08/11","新光-台中",0,16,-16
"7797","5410國眾","110/08/11","大昌-新店",10,0,10
"7798","5410國眾","110/08/11","臺銀-臺南",1,14,-13
"7799","5410國眾","110/08/11","豐農",10,0,10
"7800","5410國眾","110/08/11","瑞士信貸",0,12,-12
"7801","2841台開","110/08/11","宏遠-館前",402,0,402
"7802","2841台開","110/08/11","永豐金-敦南",11,270,-259
"7803","2841台開","110/08/11","日盛-信義",129,0,129
"7804","2841台開","110/08/11","國票-天祥",0,100,-100
"7805","2841台開","110/08/11","元大-南投",80,0,80
"7806","2841台開","110/08/11","日盛證券",27,117,-90
"7807","2841台開","110/08/11","日盛-園區",72,0,72
"7808","2841台開","110/08/11","永興-水湳",0,30,-30
"7809","2841台開","110/08/11","華南永昌-鶯歌",45,0,45
"7810","2841台開","110/08/11","兆豐-寶成",0,30,-30
"7811","2841台開","110/08/11","元大-福營",20,0,20
"7812","2841台開","110/08/11","元富-四維",0,26,-26
"7813","2841台開","110/08/11","元大-左營",20,0,20
"7814","2841台開","110/08/11","統一-士林",0,25,-25
"7815","2841台開","110/08/11","永豐金-員林",15,0,15
"7816","2841台開","110/08/11","日盛-忠孝",0,20,-20
"7817","2841台開","110/08/11","日盛-內湖",11,0,11
"7818","2841台開","110/08/11","大慶-蘆洲",0,20,-20
"7819","2841台開","110/08/11","國泰-館前",10,0,10
"7820","2841台開","110/08/11","國票-中和",0,20,-20
"7821","2841台開","110/08/11","華南永昌-潮州",10,0,10
"7822","2841台開","110/08/11","元大-大灣",0,20,-20
"7823","2841台開","110/08/11","元大-大里德芳",10,0,10
"7824","2841台開","110/08/11","元大-雙和",0,20,-20
"7825","2841台開","110/08/11","元大-小港",10,0,10
"7826","2841台開","110/08/11","新光",28,47,-19
"7827","2841台開","110/08/11","新光-台南",7,0,7
"7828","2841台開","110/08/11","玉山-台中",0,13,-13
"7829","2841台開","110/08/11","國泰-台中",6,0,6
"7830","2841台開","110/08/11","富邦-建國",0,12,-12
"7831","6207雷科","110/08/11","台新-高雄",136,8,128
"7832","6207雷科","110/08/11","群益金鼎-東門",1,90,-89
"7833","6207雷科","110/08/11","凱基-台北",108,21,87
"7834","6207雷科","110/08/11","摩根大通",89,156,-67
"7835","6207雷科","110/08/11","富邦-陽明",70,0,70
"7836","6207雷科","110/08/11","元大-鳳山",22,60,-38
"7837","6207雷科","110/08/11","永豐金證券",30,0,30
"7838","6207雷科","110/08/11","凱基-三重",5,40,-35
"7839","6207雷科","110/08/11","永豐金-高雄",29,5,24
"7840","6207雷科","110/08/11","美林",5,35,-30
"7841","6207雷科","110/08/11","元大-高雄",18,0,18
"7842","6207雷科","110/08/11","港商野村",28,58,-30
"7843","6207雷科","110/08/11","元大-竹山",17,0,17
"7844","6207雷科","110/08/11","元大-路竹",3,30,-27
"7845","6207雷科","110/08/11","國泰-台南",15,2,13
"7846","6207雷科","110/08/11","元大-小港",3,30,-27
"7847","6207雷科","110/08/11","元大-東門",12,0,12
"7848","6207雷科","110/08/11","(牛牛牛)亞-網路",0,23,-23
"7849","6207雷科","110/08/11","台灣企銀-太平",10,0,10
"7850","6207雷科","110/08/11","台新證券",4,26,-22
"7851","6207雷科","110/08/11","富邦-中壢",10,0,10
"7852","6207雷科","110/08/11","新光",2,23,-21
"7853","6207雷科","110/08/11","元大-博愛",10,0,10
"7854","6207雷科","110/08/11","元大-雙和",0,19,-19
"7855","6207雷科","110/08/11","富邦-內湖",9,0,9
"7856","6207雷科","110/08/11","新加坡商瑞銀",25,41,-16
"7857","6207雷科","110/08/11","中國信託-高雄",8,0,8
"7858","6207雷科","110/08/11","玉山證券",3,19,-16
"7859","6207雷科","110/08/11","國票-九鼎",8,0,8
"7860","6207雷科","110/08/11","玉山-雙和",0,16,-16
"7861","3679新至陞","110/08/11","摩根大通",62,3,59
"7862","3679新至陞","110/08/11","港商野村",7,25,-18
"7863","3679新至陞","110/08/11","台灣摩根士丹利",38,0,38
"7864","3679新至陞","110/08/11","凱基-文心",0,9,-9
"7865","3679新至陞","110/08/11","華南永昌-台中",16,0,16
"7866","3679新至陞","110/08/11","北城證券",0,8,-8
"7867","3679新至陞","110/08/11","凱基-台北",37,23,14
"7868","3679新至陞","110/08/11","華南永昌-大安",2,10,-8
"7869","3679新至陞","110/08/11","元大-成功",13,1,12
"7870","3679新至陞","110/08/11","元大-板橋",0,8,-8
"7871","3679新至陞","110/08/11","美林",22,16,6
"7872","3679新至陞","110/08/11","致和-東門",0,7,-7
"7873","3679新至陞","110/08/11","新加坡商瑞銀",12,6,6
"7874","3679新至陞","110/08/11","凱基-長庚",0,7,-7
"7875","3679新至陞","110/08/11","國泰-館前",5,0,5
"7876","3679新至陞","110/08/11","花旗環球",0,6,-6
"7877","3679新至陞","110/08/11","瑞士信貸",9,5,4
"7878","3679新至陞","110/08/11","群益金鼎-古亭",0,6,-6
"7879","3679新至陞","110/08/11","國泰-板橋",5,1,4
"7880","3679新至陞","110/08/11","元大-大同",0,6,-6
"7881","3679新至陞","110/08/11","日進",3,0,3
"7882","3679新至陞","110/08/11","華南永昌-鶯歌",0,5,-5
"7883","3679新至陞","110/08/11","(牛牛牛)亞-網路",4,1,3
"7884","3679新至陞","110/08/11","永豐金-新竹",0,5,-5
"7885","3679新至陞","110/08/11","康和-板橋",3,0,3
"7886","3679新至陞","110/08/11","凱基-新豐",0,4,-4
"7887","3679新至陞","110/08/11","高橋-內壢",2,0,2
"7888","3679新至陞","110/08/11","臺銀-高雄",1,4,-3
"7889","3679新至陞","110/08/11","富邦-台北",7,5,2
"7890","3679新至陞","110/08/11","日盛-文化",0,3,-3
"7891","2727王品","110/08/11","美林",113,23,90
"7892","2727王品","110/08/11","台灣摩根士丹利",8,65,-57
"7893","2727王品","110/08/11","富邦-左營",72,1,71
"7894","2727王品","110/08/11","合庫-新竹",1,23,-22
"7895","2727王品","110/08/11","凱基-台北",80,42,38
"7896","2727王品","110/08/11","永豐金-忠孝",0,20,-20
"7897","2727王品","110/08/11","港商野村",96,70,26
"7898","2727王品","110/08/11","彰銀-台中",1,15,-14
"7899","2727王品","110/08/11","國泰證券",23,1,22
"7900","2727王品","110/08/11","國泰-敦南",10,24,-14
"7901","2727王品","110/08/11","統一",28,8,20
"7902","2727王品","110/08/11","凱基-南崁",0,11,-11
"7903","2727王品","110/08/11","玉山-台南",20,1,19
"7904","2727王品","110/08/11","永豐金-三重",0,10,-10
"7905","2727王品","110/08/11","新光-台中",22,9,13
"7906","2727王品","110/08/11","富邦-中壢",3,12,-9
"7907","2727王品","110/08/11","凱基-興隆",11,0,11
"7908","2727王品","110/08/11","新光",16,24,-8
"7909","2727王品","110/08/11","元大證券",44,33,11
"7910","2727王品","110/08/11","國泰-板橋",12,20,-8
"7911","2727王品","110/08/11","日盛-樹林",12,2,10
"7912","2727王品","110/08/11","元大-彰化",0,8,-8
"7913","2727王品","110/08/11","第一金-新竹",10,0,10
"7914","2727王品","110/08/11","日盛-木柵",0,7,-7
"7915","2727王品","110/08/11","永全",10,0,10
"7916","2727王品","110/08/11","第一金-頭份",0,7,-7
"7917","2727王品","110/08/11","凱基-埔墘",10,0,10
"7918","2727王品","110/08/11","中國信託-高雄",2,9,-7
"7919","2727王品","110/08/11","摩根大通",42,33,9
"7920","2727王品","110/08/11","兆豐-公益",0,7,-7
"7921","1570力肯","110/08/11","國票-內壢",386,0,386
"7922","1570力肯","110/08/11","群益金鼎-大興",0,100,-100
"7923","1570力肯","110/08/11","華南永昌-桃園",104,3,101
"7924","1570力肯","110/08/11","新光",177,255,-78
"7925","1570力肯","110/08/11","摩根大通",154,84,70
"7926","1570力肯","110/08/11","富邦-台中",0,61,-61
"7927","1570力肯","110/08/11","日盛-頭份",51,0,51
"7928","1570力肯","110/08/11","群益金鼎-忠孝",1,60,-59
"7929","1570力肯","110/08/11","永豐金-中壢",51,1,50
"7930","1570力肯","110/08/11","元大-新店中正",2,61,-59
"7931","1570力肯","110/08/11","永豐金-北高雄",50,0,50
"7932","1570力肯","110/08/11","富邦-陽明",1,51,-50
"7933","1570力肯","110/08/11","凱基-天母",51,2,49
"7934","1570力肯","110/08/11","元大-太平",5,54,-49
"7935","1570力肯","110/08/11","日盛-員林",52,5,47
"7936","1570力肯","110/08/11","統一-松江",0,43,-43
"7937","1570力肯","110/08/11","元富-高雄",40,0,40
"7938","1570力肯","110/08/11","台新證券",6,44,-38
"7939","1570力肯","110/08/11","中國信託-嘉義",34,0,34
"7940","1570力肯","110/08/11","永豐金證券",1,36,-35
"7941","1570力肯","110/08/11","元大-北成功",30,1,29
"7942","1570力肯","110/08/11","瑞士信貸",0,27,-27
"7943","1570力肯","110/08/11","亞東-台中",26,0,26
"7944","1570力肯","110/08/11","元大-中壢",9,35,-26
"7945","1570力肯","110/08/11","第一金-嘉義",26,0,26
"7946","1570力肯","110/08/11","美商高盛",0,25,-25
"7947","1570力肯","110/08/11","凱基-中壢",27,3,24
"7948","1570力肯","110/08/11","國票-北高雄",128,153,-25
"7949","1570力肯","110/08/11","元大-福營",25,1,24
"7950","1570力肯","110/08/11","元富-新店",10,34,-24
"7951","6180橘子","110/08/11","台灣摩根士丹利",42,7,35
"7952","6180橘子","110/08/11","港商野村",5,128,-123
"7953","6180橘子","110/08/11","美商高盛",25,0,25
"7954","6180橘子","110/08/11","合庫-高雄",0,31,-31
"7955","6180橘子","110/08/11","元大-草屯",17,0,17
"7956","6180橘子","110/08/11","摩根大通",13,36,-23
"7957","6180橘子","110/08/11","日盛-文化",16,0,16
"7958","6180橘子","110/08/11","凱基-台北",37,60,-23
"7959","6180橘子","110/08/11","康和-嘉義",11,0,11
"7960","6180橘子","110/08/11","北城證券",0,19,-19
"7961","6180橘子","110/08/11","元大-左營",11,0,11
"7962","6180橘子","110/08/11","元富-潮州",24,41,-17
"7963","6180橘子","110/08/11","土銀-花蓮",10,0,10
"7964","6180橘子","110/08/11","群益金鼎-新店",0,15,-15
"7965","6180橘子","110/08/11","日盛證券",10,0,10
"7966","6180橘子","110/08/11","兆豐-竹北",0,14,-14
"7967","6180橘子","110/08/11","日盛-高雄",10,0,10
"7968","6180橘子","110/08/11","元富-成功",0,13,-13
"7969","6180橘子","110/08/11","國泰-新莊",10,0,10
"7970","6180橘子","110/08/11","新加坡商瑞銀",0,10,-10
"7971","6180橘子","110/08/11","群益金鼎-東門",10,0,10
"7972","6180橘子","110/08/11","康和-高雄",0,10,-10
"7973","6180橘子","110/08/11","凱基-中壢",10,0,10
"7974","6180橘子","110/08/11","國泰-館前",0,10,-10
"7975","6180橘子","110/08/11","元大-中壢",10,0,10
"7976","6180橘子","110/08/11","群益金鼎-嘉義",1,11,-10
"7977","6180橘子","110/08/11","元大-復北",10,0,10
"7978","6180橘子","110/08/11","華南永昌-虎尾",0,10,-10
"7979","6180橘子","110/08/11","美林",12,3,9
"7980","6180橘子","110/08/11","元富-民權",0,8,-8
"7981","2390云辰","110/08/11","臺銀-臺中",224,5,219
"7982","2390云辰","110/08/11","摩根大通",194,707,-513
"7983","2390云辰","110/08/11","兆豐-寶成",187,2,185
"7984","2390云辰","110/08/11","美商高盛",18,229,-211
"7985","2390云辰","110/08/11","元大-土城學府",143,69,74
"7986","2390云辰","110/08/11","兆豐-岡山",5,103,-98
"7987","2390云辰","110/08/11","凱基-民權",70,0,70
"7988","2390云辰","110/08/11","台新證券",13,108,-95
"7989","2390云辰","110/08/11","元大-草屯",67,2,65
"7990","2390云辰","110/08/11","美林",23,98,-75
"7991","2390云辰","110/08/11","兆豐-公益",60,0,60
"7992","2390云辰","110/08/11","永豐金-竹科",0,71,-71
"7993","2390云辰","110/08/11","國票-安和",56,0,56
"7994","2390云辰","110/08/11","元富-花蓮",0,70,-70
"7995","2390云辰","110/08/11","元富-中港",50,0,50
"7996","2390云辰","110/08/11","統一-城中",5,66,-61
"7997","2390云辰","110/08/11","元富-高雄",48,1,47
"7998","2390云辰","110/08/11","國泰-台中",50,109,-59
"7999","2390云辰","110/08/11","統一-新營",45,5,40
"8000","2390云辰","110/08/11","元大-豐原站前",10,69,-59
"8001","2390云辰","110/08/11","元大-板橋三民",39,1,38
"8002","2390云辰","110/08/11","新加坡商瑞銀",18,75,-57
"8003","2390云辰","110/08/11","元富-新店",52,17,35
"8004","2390云辰","110/08/11","台新-左楠",15,67,-52
"8005","2390云辰","110/08/11","永全-南崁",35,4,31
"8006","2390云辰","110/08/11","凱基-中壢",7,59,-52
"8007","2390云辰","110/08/11","群益金鼎-萬華",33,3,30
"8008","2390云辰","110/08/11","國票-北高雄",23,69,-46
"8009","2390云辰","110/08/11","日盛-宜蘭",25,0,25
"8010","2390云辰","110/08/11","新光-高雄",11,53,-42
"8011","2542興富發","110/08/06","瑞士信貸",747,10,737
"8012","2542興富發","110/08/06","凱基-士林",5,972,-967
"8013","2542興富發","110/08/06","摩根大通",837,107,730
"8014","2542興富發","110/08/06","統一-台中",1,376,-375
"8015","2542興富發","110/08/06","群益金鼎-敦南",681,1,680
"8016","2542興富發","110/08/06","永豐金-豐原",16,133,-117
"8017","2542興富發","110/08/06","凱基-台北",790,360,430
"8018","2542興富發","110/08/06","元富-敦南",0,111,-111
"8019","2542興富發","110/08/06","台灣摩根士丹利",259,20,239
"8020","2542興富發","110/08/06","兆豐-南京",0,108,-108
"8021","2542興富發","110/08/06","美商高盛",235,0,235
"8022","2542興富發","110/08/06","元大-金華",0,100,-100
"8023","2542興富發","110/08/06","新加坡商瑞銀",178,0,178
"8024","2542興富發","110/08/06","陽信",0,80,-80
"8025","2542興富發","110/08/06","凱基-中山",167,2,165
"8026","2542興富發","110/08/06","統一-金門",0,78,-78
"8027","2542興富發","110/08/06","凱基",121,14,107
"8028","2542興富發","110/08/06","新光-台中",7,68,-61
"8029","2542興富發","110/08/06","大慶-楊梅",101,4,97
"8030","2542興富發","110/08/06","富邦-新店",2,58,-56
"8031","2542興富發","110/08/06","美林",193,109,84
"8032","2542興富發","110/08/06","元大-新竹",0,52,-52
"8033","2542興富發","110/08/06","統一",64,5,59
"8034","2542興富發","110/08/06","凱基-永和",0,51,-51
"8035","2542興富發","110/08/06","富邦-南屯",60,1,59
"8036","2542興富發","110/08/06","統一-中壢",0,50,-50
"8037","2542興富發","110/08/06","群益金鼎",43,0,43
"8038","2542興富發","110/08/06","元富",0,50,-50
"8039","2542興富發","110/08/06","元大證券",128,85,43
"8040","2542興富發","110/08/06","法銀巴黎",0,48,-48
"8041","2867三商壽","110/08/06","摩根大通",410,157,253
"8042","2867三商壽","110/08/06","日盛-新莊",0,719,-719
"8043","2867三商壽","110/08/06","元大-北港",201,0,201
"8044","2867三商壽","110/08/06","群益金鼎-桃園",0,400,-400
"8045","2867三商壽","110/08/06","元大-斗信",200,0,200
"8046","2867三商壽","110/08/06","中國信託-文心",1,301,-300
"8047","2867三商壽","110/08/06","元大-沙鹿",199,0,199
"8048","2867三商壽","110/08/06","美林",10,169,-159
"8049","2867三商壽","110/08/06","永豐金-嘉義",130,0,130
"8050","2867三商壽","110/08/06","法銀巴黎",0,122,-122
"8051","2867三商壽","110/08/06","第一金-自由",100,0,100
"8052","2867三商壽","110/08/06","國票-中和",0,100,-100
"8053","2867三商壽","110/08/06","元大-大里德芳",100,0,100
"8054","2867三商壽","110/08/06","台灣摩根士丹利",65,164,-99
"8055","2867三商壽","110/08/06","元大-土城永寧",100,0,100
"8056","2867三商壽","110/08/06","凱基-高美館",2,64,-62
"8057","2867三商壽","110/08/06","瑞士信貸",94,0,94
"8058","2867三商壽","110/08/06","元大證券",1,62,-61
"8059","2867三商壽","110/08/06","元大-汐止",60,0,60
"8060","2867三商壽","110/08/06","華南永昌-南京",0,50,-50
"8061","2867三商壽","110/08/06","元富-大裕",52,0,52
"8062","2867三商壽","110/08/06","凱基-頭份",0,45,-45
"8063","2867三商壽","110/08/06","新光",53,1,52
"8064","2867三商壽","110/08/06","凱基",0,44,-44
"8065","2867三商壽","110/08/06","凱基-市府",51,0,51
"8066","2867三商壽","110/08/06","康和-屏東",0,43,-43
"8067","2867三商壽","110/08/06","安泰",49,0,49
"8068","2867三商壽","110/08/06","凱基-八德",0,40,-40
"8069","2867三商壽","110/08/06","富邦-桃園",50,2,48
"8070","2867三商壽","110/08/06","凱基-虎尾",0,40,-40
"8071","5521工信","110/08/06","日進",412,0,412
"8072","5521工信","110/08/06","中國信託-嘉義",0,100,-100
"8073","5521工信","110/08/06","瑞士信貸",48,0,48
"8074","5521工信","110/08/06","美林",0,69,-69
"8075","5521工信","110/08/06","日盛-雙和",34,0,34
"8076","5521工信","110/08/06","統一-新竹",0,60,-60
"8077","5521工信","110/08/06","聯邦-雙和",25,0,25
"8078","5521工信","110/08/06","第一金-桃園",0,55,-55
"8079","5521工信","110/08/06","台新證券",32,12,20
"8080","5521工信","110/08/06","凱基-台北",0,54,-54
"8081","5521工信","110/08/06","土銀-台中",17,0,17
"8082","5521工信","110/08/06","華南永昌-桃園",0,49,-49
"8083","5521工信","110/08/06","(牛牛牛)亞-鑫豐",15,0,15
"8084","5521工信","110/08/06","第一金-安和",0,40,-40
"8085","5521工信","110/08/06","元大-沙鹿",19,4,15
"8086","5521工信","110/08/06","合庫-台南",0,36,-36
"8087","5521工信","110/08/06","元富-安南",14,0,14
"8088","5521工信","110/08/06","台灣摩根士丹利",7,34,-27
"8089","5521工信","110/08/06","新加坡商瑞銀",10,0,10
"8090","5521工信","110/08/06","摩根大通",22,48,-26
"8091","5521工信","110/08/06","德信-中正",10,0,10
"8092","5521工信","110/08/06","台新-台中",0,20,-20
"8093","5521工信","110/08/06","國泰-敦南",22,12,10
"8094","5521工信","110/08/06","元大-豐原",0,20,-20
"8095","5521工信","110/08/06","群益金鼎-屏東",10,0,10
"8096","5521工信","110/08/06","元大-北成功",0,20,-20
"8097","5521工信","110/08/06","群益金鼎-東門",10,0,10
"8098","5521工信","110/08/06","永豐金-埔里",0,20,-20
"8099","5521工信","110/08/06","元大-西螺",10,0,10
"8100","5521工信","110/08/06","港商野村",0,16,-16
"8101","1471首利","110/08/06","國票-彰化",30,0,30
"8102","1471首利","110/08/06","兆豐-麻豆",0,50,-50
"8103","1471首利","110/08/06","凱基-宜蘭",27,0,27
"8104","1471首利","110/08/06","台新證券",3,30,-27
"8105","1471首利","110/08/06","玉山-桃園",22,0,22
"8106","1471首利","110/08/06","美林",15,41,-26
"8107","1471首利","110/08/06","新光-台中",17,0,17
"8108","1471首利","110/08/06","永豐金-台南",0,25,-25
"8109","1471首利","110/08/06","兆豐-埔墘",14,0,14
"8110","1471首利","110/08/06","元富-草屯",0,19,-19
"8111","1471首利","110/08/06","新光-高雄",11,0,11
"8112","1471首利","110/08/06","新光-桃園",0,17,-17
"8113","1471首利","110/08/06","合庫-鳳山",10,0,10
"8114","1471首利","110/08/06","摩根大通",13,28,-15
"8115","1471首利","110/08/06","統一-竹南",10,0,10
"8116","1471首利","110/08/06","華南永昌-淡水",1,15,-14
"8117","1471首利","110/08/06","(牛牛牛)亞-鑫豐",10,0,10
"8118","1471首利","110/08/06","台中銀",1,14,-13
"8119","1471首利","110/08/06","兆豐-岡山",10,0,10
"8120","1471首利","110/08/06","玉山-板橋",0,12,-12
"8121","1471首利","110/08/06","凱基-彰化",10,0,10
"8122","1471首利","110/08/06","富邦-基隆",10,22,-12
"8123","1471首利","110/08/06","富邦-永和",10,0,10
"8124","1471首利","110/08/06","台灣企銀",0,10,-10
"8125","1471首利","110/08/06","元大-竹山",10,0,10
"8126","1471首利","110/08/06","元富-民權",0,10,-10
"8127","1471首利","110/08/06","元大-民雄",10,0,10
"8128","1471首利","110/08/06","元大-左營",0,10,-10
"8129","1471首利","110/08/06","元大-南崁",10,1,9
"8130","1471首利","110/08/06","大昌-新店",2,11,-9
"8131","2883開發金","110/08/06","國泰證券",7766,49,7717
"8132","2883開發金","110/08/06","永豐金-板橋",2,2245,-2243
"8133","2883開發金","110/08/06","元富-城東",7094,124,6970
"8134","2883開發金","110/08/06","玉山-台南",63,2130,-2067
"8135","2883開發金","110/08/06","摩根大通",4922,1097,3825
"8136","2883開發金","110/08/06","國泰-板橋",236,1871,-1635
"8137","2883開發金","110/08/06","瑞士信貸",3230,108,3122
"8138","2883開發金","110/08/06","港商野村",1243,2562,-1319
"8139","2883開發金","110/08/06","凱基-台北",4810,2311,2499
"8140","2883開發金","110/08/06","美林",1480,2782,-1302
"8141","2883開發金","110/08/06","合庫證券",3551,2064,1487
"8142","2883開發金","110/08/06","群益金鼎-中山",7,1151,-1144
"8143","2883開發金","110/08/06","新加坡商瑞銀",3900,2689,1211
"8144","2883開發金","110/08/06","日盛-員林",17,1100,-1083
"8145","2883開發金","110/08/06","玉山證券",1332,183,1149
"8146","2883開發金","110/08/06","台灣摩根士丹利",509,1544,-1035
"8147","2883開發金","110/08/06","國票-長城",1003,0,1003
"8148","2883開發金","110/08/06","台灣企銀-民雄",0,1004,-1004
"8149","2883開發金","110/08/06","康和",720,0,720
"8150","2883開發金","110/08/06","港商法國興業",7,981,-974
"8151","2883開發金","110/08/06","福邦證券",590,15,575
"8152","2883開發金","110/08/06","新光",240,1199,-959
"8153","2883開發金","110/08/06","台灣企銀-九如",492,10,482
"8154","2883開發金","110/08/06","元大-新莊",58,1017,-959
"8155","2883開發金","110/08/06","宏遠-民生",502,54,448
"8156","2883開發金","110/08/06","富邦-彰化",5,766,-761
"8157","2883開發金","110/08/06","元大證券",803,358,445
"8158","2883開發金","110/08/06","中國信託",270,931,-661
"8159","2883開發金","110/08/06","玉山-高雄",476,80,396
"8160","2883開發金","110/08/06","永豐金-彰化",33,655,-622
"8161","6205詮欣","110/08/06","臺銀-民權",20,0,20
"8162","6205詮欣","110/08/06","元大-板橋",0,50,-50
"8163","6205詮欣","110/08/06","合庫-三重",15,0,15
"8164","6205詮欣","110/08/06","摩根大通",0,29,-29
"8165","6205詮欣","110/08/06","日盛-三重",15,4,11
"8166","6205詮欣","110/08/06","臺銀-新竹",0,3,-3
"8167","6205詮欣","110/08/06","凱基-長庚",10,0,10
"8168","6205詮欣","110/08/06","日盛-頭份",0,3,-3
"8169","6205詮欣","110/08/06","臺銀-臺中",5,0,5
"8170","6205詮欣","110/08/06","群益金鼎-潭子",0,3,-3
"8171","6205詮欣","110/08/06","兆豐-台中",4,0,4
"8172","6205詮欣","110/08/06","永豐金-敦南",0,3,-3
"8173","6205詮欣","110/08/06","凱基-台北",4,0,4
"8174","6205詮欣","110/08/06","美林",0,2,-2
"8175","6205詮欣","110/08/06","元大-龍潭",4,0,4
"8176","6205詮欣","110/08/06","新加坡商瑞銀",6,8,-2
"8177","6205詮欣","110/08/06","瑞士信貸",3,0,3
"8178","6205詮欣","110/08/06","華南永昌-淡水",0,2,-2
"8179","6205詮欣","110/08/06","國泰-板橋",3,0,3
"8180","6205詮欣","110/08/06","元大-發財",0,2,-2
"8181","6205詮欣","110/08/06","台中銀",2,0,2
"8182","6205詮欣","110/08/06","元大-屏東民生",0,2,-2
"8183","6205詮欣","110/08/06","德信-新營",2,0,2
"8184","6205詮欣","110/08/06","統一-南京",0,1,-1
"8185","6205詮欣","110/08/06","兆豐-竹北",2,0,2
"8186","6205詮欣","110/08/06","新光-台中",0,1,-1
"8187","6205詮欣","110/08/06","兆豐-景美",2,0,2
"8188","6205詮欣","110/08/06","玉山證券",0,1,-1
"8189","6205詮欣","110/08/06","台新-台中",2,0,2
"8190","6205詮欣","110/08/06","富邦-左營",0,1,-1
"8191","1540喬福","110/08/06","元富-中原",27,0,27
"8192","1540喬福","110/08/06","統一-新台中",0,25,-25
"8193","1540喬福","110/08/06","合庫-台中",24,0,24
"8194","1540喬福","110/08/06","大慶-中壢",0,24,-24
"8195","1540喬福","110/08/06","台新-台中",10,0,10
"8196","1540喬福","110/08/06","福勝",0,7,-7
"8197","1540喬福","110/08/06","富邦-竹北",7,0,7
"8198","1540喬福","110/08/06","群益金鼎-高雄",0,5,-5
"8199","1540喬福","110/08/06","華南永昌-中正",5,0,5
"8200","1540喬福","110/08/06","富邦-高雄",0,5,-5
"8201","1540喬福","110/08/06","玉山證券",4,0,4
"8202","1540喬福","110/08/06","美林",0,3,-3
"8203","1540喬福","110/08/06","兆豐-台中港",2,0,2
"8204","1540喬福","110/08/06","元大-景美",0,3,-3
"8205","1540喬福","110/08/06","國票-中正",2,0,2
"8206","1540喬福","110/08/06","元大-和平",0,3,-3
"8207","1540喬福","110/08/06","凱基-虎尾",2,0,2
"8208","1540喬福","110/08/06","日盛-台中",0,2,-2
"8209","1540喬福","110/08/06","凱基-台北",2,0,2
"8210","1540喬福","110/08/06","日盛-中和",0,2,-2
"8211","1540喬福","110/08/06","元大-府城",2,0,2
"8212","1540喬福","110/08/06","台新-台南",0,2,-2
"8213","1540喬福","110/08/06","土銀-玉里",1,0,1
"8214","1540喬福","110/08/06","玉山-高雄",0,2,-2
"8215","1540喬福","110/08/06","第一金-中壢",1,0,1
"8216","1540喬福","110/08/06","凱基-中壢",0,2,-2
"8217","1540喬福","110/08/06","國票-彰化",1,0,1
"8218","1540喬福","110/08/06","致和-南京",0,1,-1
"8219","1540喬福","110/08/06","國泰-敦南",1,0,1
"8220","1540喬福","110/08/06","摩根大通",0,1,-1
"8221","2888新光金","110/08/06","玉山-城中",3762,22,3740
"8222","2888新光金","110/08/06","美林",583,3191,-2608
"8223","2888新光金","110/08/06","瑞士信貸",1783,778,1005
"8224","2888新光金","110/08/06","元富-城東",39,1594,-1555
"8225","2888新光金","110/08/06","元大-土城永寧",1004,16,988
"8226","2888新光金","110/08/06","日盛-板橋",19,1000,-981
"8227","2888新光金","110/08/06","新加坡商瑞銀",1129,357,772
"8228","2888新光金","110/08/06","摩根大通",2207,3153,-946
"8229","2888新光金","110/08/06","中國信託",566,4,562
"8230","2888新光金","110/08/06","新光",505,1390,-885
"8231","2888新光金","110/08/06","富邦-員林",484,3,481
"8232","2888新光金","110/08/06","台灣摩根士丹利",181,1022,-841
"8233","2888新光金","110/08/06","臺銀-金山",432,3,429
"8234","2888新光金","110/08/06","元大-四維",35,750,-715
"8235","2888新光金","110/08/06","臺銀",418,2,416
"8236","2888新光金","110/08/06","美商高盛",114,811,-697
"8237","2888新光金","110/08/06","凱基-東勢",404,6,398
"8238","2888新光金","110/08/06","法銀巴黎",274,867,-593
"8239","2888新光金","110/08/06","玉山證券",416,73,343
"8240","2888新光金","110/08/06","元大-員林",18,503,-485
"8241","2888新光金","110/08/06","華南永昌-民權",305,0,305
"8242","2888新光金","110/08/06","富邦-建國",57,471,-414
"8243","2888新光金","110/08/06","永興",300,10,290
"8244","2888新光金","110/08/06","富邦-台中",15,418,-403
"8245","2888新光金","110/08/06","富邦-台北",319,48,271
"8246","2888新光金","110/08/06","華南永昌-嘉義",2,324,-322
"8247","2888新光金","110/08/06","兆豐-員林",274,28,246
"8248","2888新光金","110/08/06","凱基-台北",839,1120,-281
"8249","2888新光金","110/08/06","合庫-台中",240,10,230
"8250","2888新光金","110/08/06","國泰-館前",20,289,-269
"8251","1340勝悅","110/08/06","國泰-台中",30,0,30
"8252","1340勝悅","110/08/06","凱基-三峽",0,20,-20
"8253","1340勝悅","110/08/06","元富-彰化",10,0,10
"8254","1340勝悅","110/08/06","富邦-台東",1,14,-13
"8255","1340勝悅","110/08/06","華南永昌-忠孝",8,0,8
"8256","1340勝悅","110/08/06","華南永昌-三重",0,12,-12
"8257","1340勝悅","110/08/06","華南永昌-大安",7,0,7
"8258","1340勝悅","110/08/06","華南永昌-台中",0,10,-10
"8259","1340勝悅","110/08/06","永豐金-信義",6,0,6
"8260","1340勝悅","110/08/06","美林",0,8,-8
"8261","1340勝悅","110/08/06","臺灣企銀-埔墘",5,0,5
"8262","1340勝悅","110/08/06","第一金-豐原",0,8,-8
"8263","1340勝悅","110/08/06","元大-沙鹿",5,0,5
"8264","1340勝悅","110/08/06","凱基-城中",0,8,-8
"8265","1340勝悅","110/08/06","新光-高雄",4,0,4
"8266","1340勝悅","110/08/06","華南永昌-嘉義",0,6,-6
"8267","1340勝悅","110/08/06","群益金鼎-彰化",4,0,4
"8268","1340勝悅","110/08/06","元富",0,5,-5
"8269","1340勝悅","110/08/06","元大-仁愛",4,0,4
"8270","1340勝悅","110/08/06","光和-田中",0,5,-5
"8271","1340勝悅","110/08/06","美商高盛",3,0,3
"8272","1340勝悅","110/08/06","摩根大通",0,5,-5
"8273","1340勝悅","110/08/06","群益金鼎-館前",3,0,3
"8274","1340勝悅","110/08/06","元大-草屯",0,4,-4
"8275","1340勝悅","110/08/06","臺銀-臺中",2,0,2
"8276","1340勝悅","110/08/06","凱基-台北",1,4,-3
"8277","1340勝悅","110/08/06","永全-南崁",2,0,2
"8278","1340勝悅","110/08/06","元大-苑裡",0,3,-3
"8279","1340勝悅","110/08/06","群益金鼎-崇德",2,0,2
"8280","1340勝悅","110/08/06","日盛-員林",0,2,-2
"8281","6246臺龍","110/08/06","元大-西螺",120,1,119
"8282","6246臺龍","110/08/06","統一",0,247,-247
"8283","6246臺龍","110/08/06","富邦-敦南",111,0,111
"8284","6246臺龍","110/08/06","元大-林森",3,203,-200
"8285","6246臺龍","110/08/06","統一-台中",74,10,64
"8286","6246臺龍","110/08/06","凱基-大直",4,103,-99
"8287","6246臺龍","110/08/06","日盛證券",53,0,53
"8288","6246臺龍","110/08/06","大慶-富順",45,110,-65
"8289","6246臺龍","110/08/06","兆豐-高雄",81,38,43
"8290","6246臺龍","110/08/06","統一-南京",20,70,-50
"8291","6246臺龍","110/08/06","群益金鼎-東大",43,2,41
"8292","6246臺龍","110/08/06","港商野村",166,213,-47
"8293","6246臺龍","110/08/06","統一-永和",40,0,40
"8294","6246臺龍","110/08/06","台灣企銀",0,45,-45
"8295","6246臺龍","110/08/06","凱基-市府",48,8,40
"8296","6246臺龍","110/08/06","華南永昌-忠孝",1,45,-44
"8297","6246臺龍","110/08/06","凱基-員林",40,0,40
"8298","6246臺龍","110/08/06","永豐金-桃盛",0,35,-35
"8299","6246臺龍","110/08/06","新光-高雄",57,21,36
"8300","6246臺龍","110/08/06","康和-澎湖",0,30,-30
"8301","6246臺龍","110/08/06","國泰-敦南",104,69,35
"8302","6246臺龍","110/08/06","康和-石牌",0,30,-30
"8303","6246臺龍","110/08/06","元大-金門",39,5,34
"8304","6246臺龍","110/08/06","中國信託-永康",6,35,-29
"8305","6246臺龍","110/08/06","元大-西屯",29,2,27
"8306","6246臺龍","110/08/06","康和-內湖",2,30,-28
"8307","6246臺龍","110/08/06","永興-水湳",26,1,25
"8308","6246臺龍","110/08/06","大昌",16,43,-27
"8309","6246臺龍","110/08/06","元大-豐原站前",25,0,25
"8310","6246臺龍","110/08/06","台新證券",29,55,-26
"8311","00715L期街口布蘭特正2","110/08/06","華南永昌-長虹",810,50,760
"8312","00715L期街口布蘭特正2","110/08/06","永豐金證券",105,2122,-2017
"8313","00715L期街口布蘭特正2","110/08/06","富邦證券",557,0,557
"8314","00715L期街口布蘭特正2","110/08/06","(牛牛牛)亞-鑫豐",23,892,-869
"8315","00715L期街口布蘭特正2","110/08/06","新光",643,129,514
"8316","00715L期街口布蘭特正2","110/08/06","凱基-台北",1,789,-788
"8317","00715L期街口布蘭特正2","110/08/06","台新-新營",434,0,434
"8318","00715L期街口布蘭特正2","110/08/06","元大-永康",0,781,-781
"8319","00715L期街口布蘭特正2","110/08/06","群益金鼎-屏東",401,0,401
"8320","00715L期街口布蘭特正2","110/08/06","富邦-彰化",0,513,-513
"8321","00715L期街口布蘭特正2","110/08/06","永豐金-板盛",402,21,381
"8322","00715L期街口布蘭特正2","110/08/06","玉山-大里",0,488,-488
"8323","00715L期街口布蘭特正2","110/08/06","兆豐-員林",302,6,296
"8324","00715L期街口布蘭特正2","110/08/06","元大-中和",0,400,-400
"8325","00715L期街口布蘭特正2","110/08/06","兆豐-新莊",260,0,260
"8326","00715L期街口布蘭特正2","110/08/06","元富-安南",2,310,-308
"8327","00715L期街口布蘭特正2","110/08/06","宏遠-光隆",252,0,252
"8328","00715L期街口布蘭特正2","110/08/06","元大-羅東",5,304,-299
"8329","00715L期街口布蘭特正2","110/08/06","台中銀",207,0,207
"8330","00715L期街口布蘭特正2","110/08/06","第一金-路竹",13,273,-260
"8331","00715L期街口布蘭特正2","110/08/06","國票-北高雄",204,0,204
"8332","00715L期街口布蘭特正2","110/08/06","元大-新盛",5,247,-242
"8333","00715L期街口布蘭特正2","110/08/06","永豐金-新店",200,4,196
"8334","00715L期街口布蘭特正2","110/08/06","元大-忠孝",0,202,-202
"8335","00715L期街口布蘭特正2","110/08/06","元大-新莊",211,17,194
"8336","00715L期街口布蘭特正2","110/08/06","兆豐-嘉義",8,200,-192
"8337","00715L期街口布蘭特正2","110/08/06","聯邦-興中",185,0,185
"8338","00715L期街口布蘭特正2","110/08/06","元大-西屯",5,190,-185
"8339","00715L期街口布蘭特正2","110/08/06","元富-成功",244,62,182
"8340","00715L期街口布蘭特正2","110/08/06","元大-前金",1,181,-180
"8341","8941關中","110/08/06","第一金-台南",6,0,6
"8342","8941關中","110/08/06","富邦-員林",0,20,-20
"8343","8941關中","110/08/06","凱基-市府",6,0,6
"8344","8941關中","110/08/06","元大-金華",0,1,-1
"8345","8941關中","110/08/06","合庫-台中",5,0,5
"8346","8941關中","110/08/06","元大-淡水",0,1,-1
"8347","8941關中","110/08/06","永豐金-三重",2,0,2
"8348","8941關中","110/08/06","合庫證券",0,0,0
"8349","8941關中","110/08/06","(牛牛牛)亞-鑫豐",1,0,1
"8350","8941關中","110/08/06","元大證券",0,0,0
"8351","8941關中","110/08/06","群益金鼎-基隆",1,0,1
"8352","8941關中","110/08/06","元大-桃興",2,2,0
"8353","8941關中","110/08/06","元大-古亭",1,0,1
"8354","8941關中","110/08/06","元大-板橋",0,0,0
"8355","8941關中","110/08/06","合庫證券",0,0,0
"8356","8941關中","110/08/06","永豐金-萬盛",0,0,0
"8357","8941關中","110/08/06","元大證券",0,0,0
"8358","8941關中","110/08/06","",NA,NA,NA
"8359","8941關中","110/08/06","元大-桃興",2,2,0
"8360","8941關中","110/08/06","",NA,NA,NA
"8361","8941關中","110/08/06","元大-板橋",0,0,0
"8362","8941關中","110/08/06","",NA,NA,NA
"8363","8941關中","110/08/06","永豐金-萬盛",0,0,0
"8364","8941關中","110/08/06","",NA,NA,NA
"8365","8941關中","110/08/06","",NA,NA,NA
"8366","8941關中","110/08/06","",NA,NA,NA
"8367","8941關中","110/08/06","",NA,NA,NA
"8368","8941關中","110/08/06","",NA,NA,NA
"8369","8941關中","110/08/06","",NA,NA,NA
"8370","8941關中","110/08/06","",NA,NA,NA
"8371","8936國統","110/08/06","摩根大通",55,0,55
"8372","8936國統","110/08/06","大慶-蘆洲",1,63,-62
"8373","8936國統","110/08/06","凱基-台北",66,19,47
"8374","8936國統","110/08/06","宏遠-館前",0,50,-50
"8375","8936國統","110/08/06","國票-敦北法人",25,1,24
"8376","8936國統","110/08/06","凱基-長庚",0,46,-46
"8377","8936國統","110/08/06","元大-大里德芳",22,0,22
"8378","8936國統","110/08/06","台灣摩根士丹利",0,42,-42
"8379","8936國統","110/08/06","兆豐-新營",20,0,20
"8380","8936國統","110/08/06","永豐金-苓雅",15,48,-33
"8381","8936國統","110/08/06","新光-新竹",17,0,17
"8382","8936國統","110/08/06","元大-竹東",0,30,-30
"8383","8936國統","110/08/06","新光-台中",17,4,13
"8384","8936國統","110/08/06","新加坡商瑞銀",23,49,-26
"8385","8936國統","110/08/06","元富-新店",10,0,10
"8386","8936國統","110/08/06","國票-北高雄",0,25,-25
"8387","8936國統","110/08/06","中國信託-永康",10,0,10
"8388","8936國統","110/08/06","國泰-台南",0,20,-20
"8389","8936國統","110/08/06","台新-高雄",11,1,10
"8390","8936國統","110/08/06","國泰-敦南",7,24,-17
"8391","8936國統","110/08/06","國泰-板橋",10,0,10
"8392","8936國統","110/08/06","臺灣企銀-桃園",0,13,-13
"8393","8936國統","110/08/06","群益金鼎-東湖",10,0,10
"8394","8936國統","110/08/06","美商高盛",1,13,-12
"8395","8936國統","110/08/06","元大-北成功",10,0,10
"8396","8936國統","110/08/06","合庫-高雄",0,10,-10
"8397","8936國統","110/08/06","臺銀-高雄",9,0,9
"8398","8936國統","110/08/06","臺銀",0,10,-10
"8399","8936國統","110/08/06","日盛-和美",9,0,9
"8400","8936國統","110/08/06","元大-土城學府",0,10,-10
"8401","6226光鼎","110/08/06","國泰-敦南",183,87,96
"8402","6226光鼎","110/08/06","富邦-嘉義",286,537,-251
"8403","6226光鼎","110/08/06","台新-高雄",129,53,76
"8404","6226光鼎","110/08/06","統一-新竹",30,181,-151
"8405","6226光鼎","110/08/06","新光",81,25,56
"8406","6226光鼎","110/08/06","宏遠-台中",0,118,-118
"8407","6226光鼎","110/08/06","台新證券",112,57,55
"8408","6226光鼎","110/08/06","華南永昌-大安",2,82,-80
"8409","6226光鼎","110/08/06","台新-新營",56,4,52
"8410","6226光鼎","110/08/06","元富-西松",1,76,-75
"8411","6226光鼎","110/08/06","中國信託",48,7,41
"8412","6226光鼎","110/08/06","凱基-豐中",1,74,-73
"8413","6226光鼎","110/08/06","富邦-板橋",38,5,33
"8414","6226光鼎","110/08/06","凱基-長庚",3,64,-61
"8415","6226光鼎","110/08/06","台新-中壢",32,0,32
"8416","6226光鼎","110/08/06","元富-高雄",2,58,-56
"8417","6226光鼎","110/08/06","日盛-北高雄",32,1,31
"8418","6226光鼎","110/08/06","永豐金-萬盛",2,49,-47
"8419","6226光鼎","110/08/06","群益金鼎-桃園",31,0,31
"8420","6226光鼎","110/08/06","統一-仁愛",11,57,-46
"8421","6226光鼎","110/08/06","元大-屏東民生",31,0,31
"8422","6226光鼎","110/08/06","國票-台中",0,46,-46
"8423","6226光鼎","110/08/06","中國信託-永康",35,5,30
"8424","6226光鼎","110/08/06","群益金鼎-嘉義",11,55,-44
"8425","6226光鼎","110/08/06","國泰-台中",57,27,30
"8426","6226光鼎","110/08/06","元大-沙鹿",6,50,-44
"8427","6226光鼎","110/08/06","群益金鼎-板橋",30,0,30
"8428","6226光鼎","110/08/06","新光-高雄",17,58,-41
"8429","6226光鼎","110/08/06","寶盛",29,0,29
"8430","6226光鼎","110/08/06","元大-嘉義",3,36,-33
"8431","2363矽統","110/08/06","新加坡商瑞銀",1338,777,561
"8432","2363矽統","110/08/06","凱基-台北",4343,7347,-3004
"8433","2363矽統","110/08/06","日盛-三峽",475,86,389
"8434","2363矽統","110/08/06","摩根大通",1716,2908,-1192
"8435","2363矽統","110/08/06","中國信託-忠孝",433,44,389
"8436","2363矽統","110/08/06","美商高盛",315,1169,-854
"8437","2363矽統","110/08/06","陽信-石牌",448,73,375
"8438","2363矽統","110/08/06","永豐金證券",168,889,-721
"8439","2363矽統","110/08/06","國泰-台中",743,471,272
"8440","2363矽統","110/08/06","國票-敦北法人",29,513,-484
"8441","2363矽統","110/08/06","國泰-敦南",2177,1919,258
"8442","2363矽統","110/08/06","元富-嘉義",43,424,-381
"8443","2363矽統","110/08/06","台新-台中",565,347,218
"8444","2363矽統","110/08/06","元大-東泰",174,540,-366
"8445","2363矽統","110/08/06","元大-敦化",246,31,215
"8446","2363矽統","110/08/06","元大證券",187,522,-335
"8447","2363矽統","110/08/06","大昌-桃園",241,51,190
"8448","2363矽統","110/08/06","合庫證券",173,495,-322
"8449","2363矽統","110/08/06","華南永昌-淡水",230,48,182
"8450","2363矽統","110/08/06","元大-萬華",128,391,-263
"8451","2363矽統","110/08/06","港商野村",2381,2203,178
"8452","2363矽統","110/08/06","國票-博愛",93,350,-257
"8453","2363矽統","110/08/06","台新-高雄",529,361,168
"8454","2363矽統","110/08/06","台新-屏東",200,455,-255
"8455","2363矽統","110/08/06","元大-新竹",320,156,164
"8456","2363矽統","110/08/06","日盛-南京",74,327,-253
"8457","2363矽統","110/08/06","元大-中壢",454,292,162
"8458","2363矽統","110/08/06","兆豐-民生",16,227,-211
"8459","2363矽統","110/08/06","新光-台南",310,150,160
"8460","2363矽統","110/08/06","元大-旗山",168,364,-196
"8461","8112至上","110/08/06","新光-新竹",533,65,468
"8462","8112至上","110/08/06","摩根大通",12,2930,-2918
"8463","8112至上","110/08/06","國泰-新莊",192,0,192
"8464","8112至上","110/08/06","凱基-台北",388,1548,-1160
"8465","8112至上","110/08/06","合庫證券",195,11,184
"8466","8112至上","110/08/06","新加坡商瑞銀",17,1069,-1052
"8467","8112至上","110/08/06","元大-西門",178,2,176
"8468","8112至上","110/08/06","台灣摩根士丹利",48,955,-907
"8469","8112至上","110/08/06","(牛牛牛)亞-鑫豐",153,13,140
"8470","8112至上","110/08/06","元大-竹科",61,824,-763
"8471","8112至上","110/08/06","永豐金-中正",120,1,119
"8472","8112至上","110/08/06","美林",19,583,-564
"8473","8112至上","110/08/06","陽信",111,0,111
"8474","8112至上","110/08/06","瑞士信貸",0,547,-547
"8475","8112至上","110/08/06","康和-板橋",106,0,106
"8476","8112至上","110/08/06","康和",2,484,-482
"8477","8112至上","110/08/06","群益金鼎-延平",101,0,101
"8478","8112至上","110/08/06","永豐金-台中",17,430,-413
"8479","8112至上","110/08/06","元大-北成功",110,14,96
"8480","8112至上","110/08/06","元大-屏南",4,393,-389
"8481","8112至上","110/08/06","元富-古亭",141,46,95
"8482","8112至上","110/08/06","美商高盛",12,217,-205
"8483","8112至上","110/08/06","臺灣企銀-埔墘",92,1,91
"8484","8112至上","110/08/06","新光-桃園",42,204,-162
"8485","8112至上","110/08/06","第一金-桃園",89,0,89
"8486","8112至上","110/08/06","玉山證券",18,162,-144
"8487","8112至上","110/08/06","台新證券",105,16,89
"8488","8112至上","110/08/06","群益金鼎-基隆",7,151,-144
"8489","8112至上","110/08/06","玉山-板橋",96,10,86
"8490","8112至上","110/08/06","台新-新營",60,183,-123
"8491","1570力肯","110/08/06","國票-北高雄",246,40,206
"8492","1570力肯","110/08/06","富邦-高雄",0,47,-47
"8493","1570力肯","110/08/06","統一-松江",43,0,43
"8494","1570力肯","110/08/06","凱基-台北",55,101,-46
"8495","1570力肯","110/08/06","日茂-南投",42,2,40
"8496","1570力肯","110/08/06","台新證券",25,60,-35
"8497","1570力肯","110/08/06","群益金鼎-三重",34,2,32
"8498","1570力肯","110/08/06","元富-三重",0,32,-32
"8499","1570力肯","110/08/06","華南永昌-麻豆",32,4,28
"8500","1570力肯","110/08/06","台中銀-員林",0,32,-32
"8501","1570力肯","110/08/06","永豐金-中和",29,2,27
"8502","1570力肯","110/08/06","國泰-板橋",1,33,-32
"8503","1570力肯","110/08/06","永豐金-大園",21,0,21
"8504","1570力肯","110/08/06","摩根大通",83,112,-29
"8505","1570力肯","110/08/06","統一-三重",25,5,20
"8506","1570力肯","110/08/06","玉山-新莊",0,27,-27
"8507","1570力肯","110/08/06","元富-新店",20,0,20
"8508","1570力肯","110/08/06","永豐金-虎尾",0,27,-27
"8509","1570力肯","110/08/06","大昌-桃園",21,1,20
"8510","1570力肯","110/08/06","玉山-左營",0,25,-25
"8511","1570力肯","110/08/06","康和-高雄",18,1,17
"8512","1570力肯","110/08/06","富邦-仁愛",10,32,-22
"8513","1570力肯","110/08/06","元富-潮州",16,0,16
"8514","1570力肯","110/08/06","中國信託-忠孝",0,21,-21
"8515","1570力肯","110/08/06","元富-松德",15,0,15
"8516","1570力肯","110/08/06","臺銀-鳳山",4,24,-20
"8517","1570力肯","110/08/06","凱基-嘉義",15,0,15
"8518","1570力肯","110/08/06","台新-屏東",1,21,-20
"8519","1570力肯","110/08/06","凱基-埔墘",15,0,15
"8520","1570力肯","110/08/06","群益金鼎-西松",0,20,-20
"8521","2929淘帝","110/08/06","統一",155,0,155
"8522","2929淘帝","110/08/06","元富-敦南",0,100,-100
"8523","2929淘帝","110/08/06","港商野村",188,52,136
"8524","2929淘帝","110/08/06","兆豐-忠孝",0,60,-60
"8525","2929淘帝","110/08/06","摩根大通",72,3,69
"8526","2929淘帝","110/08/06","台新證券",9,68,-59
"8527","2929淘帝","110/08/06","新光-新竹",45,0,45
"8528","2929淘帝","110/08/06","凱基-台北",30,80,-50
"8529","2929淘帝","110/08/06","華南永昌",40,1,39
"8530","2929淘帝","110/08/06","台新-台中",0,45,-45
"8531","2929淘帝","110/08/06","美林",52,18,34
"8532","2929淘帝","110/08/06","國泰-台中",2,43,-41
"8533","2929淘帝","110/08/06","新加坡商瑞銀",48,14,34
"8534","2929淘帝","110/08/06","華南永昌-林口",0,37,-37
"8535","2929淘帝","110/08/06","日盛-頭份",32,0,32
"8536","2929淘帝","110/08/06","元大-屏南",0,30,-30
"8537","2929淘帝","110/08/06","日盛-板橋中山",30,0,30
"8538","2929淘帝","110/08/06","群益金鼎-潭子",0,26,-26
"8539","2929淘帝","110/08/06","元大-中壢",25,3,22
"8540","2929淘帝","110/08/06","元大-新莊",3,26,-23
"8541","2929淘帝","110/08/06","元大-莒光",21,0,21
"8542","2929淘帝","110/08/06","臺銀-臺南",0,22,-22
"8543","2929淘帝","110/08/06","福勝",20,0,20
"8544","2929淘帝","110/08/06","新光",2,24,-22
"8545","2929淘帝","110/08/06","元富-三重",17,0,17
"8546","2929淘帝","110/08/06","華南永昌-長虹",0,22,-22
"8547","2929淘帝","110/08/06","國票-南京",17,0,17
"8548","2929淘帝","110/08/06","富邦-高雄",0,20,-20
"8549","2929淘帝","110/08/06","合庫證券",16,0,16
"8550","2929淘帝","110/08/06","元大-竹科",0,20,-20
"8551","5410國眾","110/08/06","元大-中壢",15,1,14
"8552","5410國眾","110/08/06","凱基-台北",0,16,-16
"8553","5410國眾","110/08/06","玉山-嘉義",10,0,10
"8554","5410國眾","110/08/06","元大-松山",0,15,-15
"8555","5410國眾","110/08/06","元大-敦南",10,0,10
"8556","5410國眾","110/08/06","元大-斗信",0,10,-10
"8557","5410國眾","110/08/06","永豐金-板橋",10,0,10
"8558","5410國眾","110/08/06","臺銀-臺南",0,9,-9
"8559","5410國眾","110/08/06","華南永昌-新莊",9,0,9
"8560","5410國眾","110/08/06","新光-台中",0,9,-9
"8561","5410國眾","110/08/06","華南永昌-世貿",6,0,6
"8562","5410國眾","110/08/06","群益金鼎-中壢",0,7,-7
"8563","5410國眾","110/08/06","亞東",5,0,5
"8564","5410國眾","110/08/06","永豐金-中和",0,7,-7
"8565","5410國眾","110/08/06","大昌-新店",5,0,5
"8566","5410國眾","110/08/06","元大-北投",0,6,-6
"8567","5410國眾","110/08/06","凱基-民權",5,0,5
"8568","5410國眾","110/08/06","元大-豐原站前",0,6,-6
"8569","5410國眾","110/08/06","元大-士林",5,0,5
"8570","5410國眾","110/08/06","臺銀",0,5,-5
"8571","5410國眾","110/08/06","元大-北三重",5,0,5
"8572","5410國眾","110/08/06","台灣企銀-太平",0,5,-5
"8573","5410國眾","110/08/06","永豐金-桃園",5,0,5
"8574","5410國眾","110/08/06","元大-大益",0,5,-5
"8575","5410國眾","110/08/06","兆豐-員林",4,0,4
"8576","5410國眾","110/08/06","元大-和平",0,5,-5
"8577","5410國眾","110/08/06","台新-三民",4,0,4
"8578","5410國眾","110/08/06","元大-台南",0,5,-5
"8579","5410國眾","110/08/06","國泰-敦南",6,2,4
"8580","5410國眾","110/08/06","元大-古亭",0,5,-5
"8581","2841台開","110/08/06","宏遠-館前",520,0,520
"8582","2841台開","110/08/06","元富-台南",0,200,-200
"8583","2841台開","110/08/06","合庫證券",193,0,193
"8584","2841台開","110/08/06","元大-鹿港",0,182,-182
"8585","2841台開","110/08/06","永興-台中",100,0,100
"8586","2841台開","110/08/06","群益金鼎-桃園",0,132,-132
"8587","2841台開","110/08/06","永豐金-竹北",78,0,78
"8588","2841台開","110/08/06","中國信託-忠孝",0,130,-130
"8589","2841台開","110/08/06","元大證券",50,0,50
"8590","2841台開","110/08/06","元大-四維",3,116,-113
"8591","2841台開","110/08/06","元大-大天母",50,0,50
"8592","2841台開","110/08/06","元富-嘉義",0,50,-50
"8593","2841台開","110/08/06","永豐金-敦南",50,0,50
"8594","2841台開","110/08/06","元富-板橋",0,50,-50
"8595","2841台開","110/08/06","日盛-園區",49,0,49
"8596","2841台開","110/08/06","(牛牛牛)亞-鑫豐",0,50,-50
"8597","2841台開","110/08/06","元大-前金",38,0,38
"8598","2841台開","110/08/06","群益金鼎-新店",0,50,-50
"8599","2841台開","110/08/06","新光-台中",32,1,31
"8600","2841台開","110/08/06","統一-彰化",0,45,-45
"8601","2841台開","110/08/06","華南永昌-台中",30,0,30
"8602","2841台開","110/08/06","台中銀",12,50,-38
"8603","2841台開","110/08/06","第一金-忠孝",20,0,20
"8604","2841台開","110/08/06","國票-中和",0,30,-30
"8605","2841台開","110/08/06","富邦-台北",20,0,20
"8606","2841台開","110/08/06","富邦-竹北",0,29,-29
"8607","2841台開","110/08/06","元大-林園",20,0,20
"8608","2841台開","110/08/06","日盛-樹林",0,26,-26
"8609","2841台開","110/08/06","日盛-信義",18,0,18
"8610","2841台開","110/08/06","富邦-板橋",0,25,-25
"8611","6207雷科","110/08/06","凱基-台北",167,49,118
"8612","6207雷科","110/08/06","群益金鼎-古亭",0,80,-80
"8613","6207雷科","110/08/06","摩根大通",185,102,83
"8614","6207雷科","110/08/06","康和-台中",0,56,-56
"8615","6207雷科","110/08/06","新光-台中",65,1,64
"8616","6207雷科","110/08/06","統一-板橋",8,59,-51
"8617","6207雷科","110/08/06","元大-鳳山",77,40,37
"8618","6207雷科","110/08/06","臺銀",0,50,-50
"8619","6207雷科","110/08/06","德信",30,0,30
"8620","6207雷科","110/08/06","日盛-忠孝",0,50,-50
"8621","6207雷科","110/08/06","新加坡商瑞銀",47,19,28
"8622","6207雷科","110/08/06","永豐金-虎尾",0,29,-29
"8623","6207雷科","110/08/06","凱基-三重",30,2,28
"8624","6207雷科","110/08/06","凱基-敦北",0,23,-23
"8625","6207雷科","110/08/06","凱基-三峽",33,10,23
"8626","6207雷科","110/08/06","華南永昌-世貿",0,22,-22
"8627","6207雷科","110/08/06","玉山-台大",25,3,22
"8628","6207雷科","110/08/06","兆豐-來福",5,25,-20
"8629","6207雷科","110/08/06","元大-板橋",15,0,15
"8630","6207雷科","110/08/06","群益金鼎-中壢",1,21,-20
"8631","6207雷科","110/08/06","元大-南京",13,0,13
"8632","6207雷科","110/08/06","宏遠-台南",0,16,-16
"8633","6207雷科","110/08/06","元富-大昌",12,0,12
"8634","6207雷科","110/08/06","合庫-桃園",0,15,-15
"8635","6207雷科","110/08/06","德信-和平",11,0,11
"8636","6207雷科","110/08/06","玉山-新莊",1,16,-15
"8637","6207雷科","110/08/06","元大-承德",12,1,11
"8638","6207雷科","110/08/06","群益金鼎-敦南",0,15,-15
"8639","6207雷科","110/08/06","台新-高雄",18,8,10
"8640","6207雷科","110/08/06","台新-左楠",2,15,-13
"8641","3679新至陞","110/08/06","國票-安和",10,0,10
"8642","3679新至陞","110/08/06","摩根大通",1,32,-31
"8643","3679新至陞","110/08/06","元大-上新莊",10,0,10
"8644","3679新至陞","110/08/06","凱基-台北",2,17,-15
"8645","3679新至陞","110/08/06","富邦-台北",9,0,9
"8646","3679新至陞","110/08/06","台灣摩根士丹利",0,11,-11
"8647","3679新至陞","110/08/06","元大-板橋",9,3,6
"8648","3679新至陞","110/08/06","瑞士信貸",0,11,-11
"8649","3679新至陞","110/08/06","康和-板橋",5,0,5
"8650","3679新至陞","110/08/06","兆豐-員林",0,10,-10
"8651","3679新至陞","110/08/06","國泰-松江",5,0,5
"8652","3679新至陞","110/08/06","元大-蘆洲",0,10,-10
"8653","3679新至陞","110/08/06","凱基-三峽",5,0,5
"8654","3679新至陞","110/08/06","美林",1,8,-7
"8655","3679新至陞","110/08/06","華南永昌-大安",5,0,5
"8656","3679新至陞","110/08/06","群益金鼎-桃園",0,7,-7
"8657","3679新至陞","110/08/06","台新-屏東",4,0,4
"8658","3679新至陞","110/08/06","玉山-台大",0,5,-5
"8659","3679新至陞","110/08/06","群益金鼎-敦南",4,0,4
"8660","3679新至陞","110/08/06","日盛-新竹",0,4,-4
"8661","3679新至陞","110/08/06","元大-天母",4,0,4
"8662","3679新至陞","110/08/06","土銀-和平",2,5,-3
"8663","3679新至陞","110/08/06","臺銀-高雄",3,0,3
"8664","3679新至陞","110/08/06","元富-松德",0,3,-3
"8665","3679新至陞","110/08/06","台中銀-員林",3,0,3
"8666","3679新至陞","110/08/06","光和-田中",0,3,-3
"8667","3679新至陞","110/08/06","北城證券",3,0,3
"8668","3679新至陞","110/08/06","群益金鼎-台南",0,3,-3
"8669","3679新至陞","110/08/06","元大-景美",3,0,3
"8670","3679新至陞","110/08/06","元大證券",1,4,-3
"8671","2727王品","110/08/06","摩根大通",65,18,47
"8672","2727王品","110/08/06","美商高盛",12,258,-246
"8673","2727王品","110/08/06","華南永昌",18,0,18
"8674","2727王品","110/08/06","安泰",2,60,-58
"8675","2727王品","110/08/06","凱基-台北",41,25,16
"8676","2727王品","110/08/06","台灣摩根士丹利",10,59,-49
"8677","2727王品","110/08/06","元大-中壢",20,4,16
"8678","2727王品","110/08/06","台新證券",17,60,-43
"8679","2727王品","110/08/06","台新-高雄",27,13,14
"8680","2727王品","110/08/06","元大-桃園",0,32,-32
"8681","2727王品","110/08/06","永豐金-苓雅",14,1,13
"8682","2727王品","110/08/06","凱基-基隆",0,30,-30
"8683","2727王品","110/08/06","永豐金-中盛",14,1,13
"8684","2727王品","110/08/06","群益金鼎-台中",0,22,-22
"8685","2727王品","110/08/06","第一金-安和",12,0,12
"8686","2727王品","110/08/06","凱基-三重",1,20,-19
"8687","2727王品","110/08/06","台新-台南",12,0,12
"8688","2727王品","110/08/06","元大證券",23,42,-19
"8689","2727王品","110/08/06","元大-八德",12,0,12
"8690","2727王品","110/08/06","瑞士信貸",0,18,-18
"8691","2727王品","110/08/06","新加坡商瑞銀",14,3,11
"8692","2727王品","110/08/06","港商野村",32,50,-18
"8693","2727王品","110/08/06","美林",11,1,10
"8694","2727王品","110/08/06","元大-羅東",2,17,-15
"8695","2727王品","110/08/06","台新-中壢",10,0,10
"8696","2727王品","110/08/06","元大-彰化",3,15,-12
"8697","2727王品","110/08/06","大昌-新竹",9,0,9
"8698","2727王品","110/08/06","土銀-高雄",1,12,-11
"8699","2727王品","110/08/06","元大-文心興安",11,2,9
"8700","2727王品","110/08/06","台新-新莊",0,11,-11
"8701","1570力肯","110/08/06","國票-北高雄",246,40,206
"8702","1570力肯","110/08/06","富邦-高雄",0,47,-47
"8703","1570力肯","110/08/06","統一-松江",43,0,43
"8704","1570力肯","110/08/06","凱基-台北",55,101,-46
"8705","1570力肯","110/08/06","日茂-南投",42,2,40
"8706","1570力肯","110/08/06","台新證券",25,60,-35
"8707","1570力肯","110/08/06","群益金鼎-三重",34,2,32
"8708","1570力肯","110/08/06","元富-三重",0,32,-32
"8709","1570力肯","110/08/06","華南永昌-麻豆",32,4,28
"8710","1570力肯","110/08/06","台中銀-員林",0,32,-32
"8711","1570力肯","110/08/06","永豐金-中和",29,2,27
"8712","1570力肯","110/08/06","國泰-板橋",1,33,-32
"8713","1570力肯","110/08/06","永豐金-大園",21,0,21
"8714","1570力肯","110/08/06","摩根大通",83,112,-29
"8715","1570力肯","110/08/06","統一-三重",25,5,20
"8716","1570力肯","110/08/06","玉山-新莊",0,27,-27
"8717","1570力肯","110/08/06","元富-新店",20,0,20
"8718","1570力肯","110/08/06","永豐金-虎尾",0,27,-27
"8719","1570力肯","110/08/06","大昌-桃園",21,1,20
"8720","1570力肯","110/08/06","玉山-左營",0,25,-25
"8721","1570力肯","110/08/06","康和-高雄",18,1,17
"8722","1570力肯","110/08/06","富邦-仁愛",10,32,-22
"8723","1570力肯","110/08/06","元富-潮州",16,0,16
"8724","1570力肯","110/08/06","中國信託-忠孝",0,21,-21
"8725","1570力肯","110/08/06","元富-松德",15,0,15
"8726","1570力肯","110/08/06","臺銀-鳳山",4,24,-20
"8727","1570力肯","110/08/06","凱基-嘉義",15,0,15
"8728","1570力肯","110/08/06","台新-屏東",1,21,-20
"8729","1570力肯","110/08/06","凱基-埔墘",15,0,15
"8730","1570力肯","110/08/06","群益金鼎-西松",0,20,-20
"8731","6180橘子","110/08/06","凱基-中山",138,3,135
"8732","6180橘子","110/08/06","新光",6,37,-31
"8733","6180橘子","110/08/06","富邦-高雄",18,0,18
"8734","6180橘子","110/08/06","永豐金-板新",0,24,-24
"8735","6180橘子","110/08/06","美商高盛",14,0,14
"8736","6180橘子","110/08/06","國票-九鼎",0,20,-20
"8737","6180橘子","110/08/06","富邦-板橋",14,0,14
"8738","6180橘子","110/08/06","群益金鼎-古亭",0,20,-20
"8739","6180橘子","110/08/06","台灣摩根士丹利",18,6,12
"8740","6180橘子","110/08/06","凱基-台北",2,22,-20
"8741","6180橘子","110/08/06","聯邦-雙和",11,0,11
"8742","6180橘子","110/08/06","富邦-員林",1,20,-19
"8743","6180橘子","110/08/06","宏遠-光隆",10,0,10
"8744","6180橘子","110/08/06","富邦-基隆",0,14,-14
"8745","6180橘子","110/08/06","元富-四維",10,0,10
"8746","6180橘子","110/08/06","元富-永和",1,12,-11
"8747","6180橘子","110/08/06","摩根大通",11,1,10
"8748","6180橘子","110/08/06","玉山-台南",0,11,-11
"8749","6180橘子","110/08/06","日盛-中壢",9,0,9
"8750","6180橘子","110/08/06","元大-彰化民生",0,11,-11
"8751","6180橘子","110/08/06","中國信託",9,0,9
"8752","6180橘子","110/08/06","群益金鼎-忠孝",0,10,-10
"8753","6180橘子","110/08/06","凱基-板橋",10,1,9
"8754","6180橘子","110/08/06","元大-龍潭",0,10,-10
"8755","6180橘子","110/08/06","日盛-景美",9,2,7
"8756","6180橘子","110/08/06","元大-金華",1,11,-10
"8757","6180橘子","110/08/06","瑞士信貸",7,0,7
"8758","6180橘子","110/08/06","第一金-新興",0,8,-8
"8759","6180橘子","110/08/06","元大-高雄",5,0,5
"8760","6180橘子","110/08/06","美林",0,7,-7
"8761","2390云辰","110/08/06","元大證券",203,14,189
"8762","2390云辰","110/08/06","永豐金-豐原",0,174,-174
"8763","2390云辰","110/08/06","美商高盛",114,7,107
"8764","2390云辰","110/08/06","第一金-華江",0,83,-83
"8765","2390云辰","110/08/06","華南永昌-麻豆",103,0,103
"8766","2390云辰","110/08/06","凱基-台北",126,197,-71
"8767","2390云辰","110/08/06","國票-安和",76,11,65
"8768","2390云辰","110/08/06","摩根大通",129,187,-58
"8769","2390云辰","110/08/06","港商野村",188,138,50
"8770","2390云辰","110/08/06","臺銀-金山",0,50,-50
"8771","2390云辰","110/08/06","元大-土城學府",102,56,46
"8772","2390云辰","110/08/06","聯邦商銀",13,50,-37
"8773","2390云辰","110/08/06","元富-板橋",41,0,41
"8774","2390云辰","110/08/06","元大-上新莊",10,43,-33
"8775","2390云辰","110/08/06","新加坡商瑞銀",47,7,40
"8776","2390云辰","110/08/06","兆豐-三民",0,30,-30
"8777","2390云辰","110/08/06","元大-台南",35,0,35
"8778","2390云辰","110/08/06","富邦-桃園",0,30,-30
"8779","2390云辰","110/08/06","凱基-林口",31,0,31
"8780","2390云辰","110/08/06","國泰-敦南",33,60,-27
"8781","2390云辰","110/08/06","凱基-台中",23,0,23
"8782","2390云辰","110/08/06","元大-天母",1,28,-27
"8783","2390云辰","110/08/06","台新-左楠",22,0,22
"8784","2390云辰","110/08/06","統一-高雄",0,25,-25
"8785","2390云辰","110/08/06","元大-文心",24,2,22
"8786","2390云辰","110/08/06","元大-太平",0,22,-22
"8787","2390云辰","110/08/06","統一-三重",22,1,21
"8788","2390云辰","110/08/06","彰銀-台中",36,56,-20
"8789","2390云辰","110/08/06","台灣企銀-嘉義",20,0,20
"8790","2390云辰","110/08/06","統一-屏東",1,21,-20
"8791","2867三商壽","110/08/05","摩根大通",376,0,376
"8792","2867三商壽","110/08/05","日盛-新莊",0,253,-253
"8793","2867三商壽","110/08/05","玉山-大里",307,1,306
"8794","2867三商壽","110/08/05","宏遠-高雄",0,156,-156
"8795","2867三商壽","110/08/05","元大-土城永寧",250,0,250
"8796","2867三商壽","110/08/05","康和-台中",0,135,-135
"8797","2867三商壽","110/08/05","新加坡商瑞銀",137,0,137
"8798","2867三商壽","110/08/05","台灣摩根士丹利",17,133,-116
"8799","2867三商壽","110/08/05","大展",120,0,120
"8800","2867三商壽","110/08/05","台灣企銀-竹北",0,100,-100
"8801","2867三商壽","110/08/05","凱基-長庚",120,0,120
"8802","2867三商壽","110/08/05","群益金鼎-桃園",1,100,-99
"8803","2867三商壽","110/08/05","元大-大同",104,2,102
"8804","2867三商壽","110/08/05","永豐金-高雄",10,101,-91
"8805","2867三商壽","110/08/05","凱基-台北",98,30,68
"8806","2867三商壽","110/08/05","元富",0,70,-70
"8807","2867三商壽","110/08/05","華南永昌-朴子",60,0,60
"8808","2867三商壽","110/08/05","富邦-花蓮",0,53,-53
"8809","2867三商壽","110/08/05","永豐金-市政",50,0,50
"8810","2867三商壽","110/08/05","日盛-台南",0,43,-43
"8811","2867三商壽","110/08/05","富邦-台南",49,1,48
"8812","2867三商壽","110/08/05","宏遠-台中",6,45,-39
"8813","2867三商壽","110/08/05","永豐金-永康",30,0,30
"8814","2867三商壽","110/08/05","瑞士信貸",0,32,-32
"8815","2867三商壽","110/08/05","富邦-竹東",30,1,29
"8816","2867三商壽","110/08/05","致和-高雄",0,31,-31
"8817","2867三商壽","110/08/05","兆豐-高雄",30,10,20
"8818","2867三商壽","110/08/05","國泰-台南",1,32,-31
"8819","2867三商壽","110/08/05","群益金鼎-西松",20,0,20
"8820","2867三商壽","110/08/05","元大-松山",1,31,-30
"8821","5521工信","110/08/05","兆豐-桃園",72,0,72
"8822","5521工信","110/08/05","美林",5,100,-95
"8823","5521工信","110/08/05","(牛牛牛)亞-鑫豐",24,0,24
"8824","5521工信","110/08/05","華南永昌-桃園",0,76,-76
"8825","5521工信","110/08/05","富邦-建國",22,0,22
"8826","5521工信","110/08/05","第一金-桃園",0,43,-43
"8827","5521工信","110/08/05","日盛-雙和",16,0,16
"8828","5521工信","110/08/05","凱基-台北",0,26,-26
"8829","5521工信","110/08/05","元大-鳳山",16,0,16
"8830","5521工信","110/08/05","台灣摩根士丹利",0,22,-22
"8831","5521工信","110/08/05","元富-城東",12,0,12
"8832","5521工信","110/08/05","富邦-竹北",0,20,-20
"8833","5521工信","110/08/05","元大-東蘆",12,0,12
"8834","5521工信","110/08/05","富邦-員林",0,20,-20
"8835","5521工信","110/08/05","元大-路竹",11,0,11
"8836","5521工信","110/08/05","元大-豐原",0,20,-20
"8837","5521工信","110/08/05","元大-基隆孝二",11,0,11
"8838","5521工信","110/08/05","港商野村",0,17,-17
"8839","5521工信","110/08/05","日盛-園區",10,0,10
"8840","5521工信","110/08/05","元大-大同",0,14,-14
"8841","5521工信","110/08/05","玉山-台大",10,0,10
"8842","5521工信","110/08/05","永豐金證券",0,14,-14
"8843","5521工信","110/08/05","華南永昌-公誠",10,0,10
"8844","5521工信","110/08/05","兆豐-高雄",0,10,-10
"8845","5521工信","110/08/05","元大-斗六",10,0,10
"8846","5521工信","110/08/05","群益金鼎-永和",0,10,-10
"8847","5521工信","110/08/05","元大-屏東",10,0,10
"8848","5521工信","110/08/05","永豐金-中和",0,10,-10
"8849","5521工信","110/08/05","國泰-台中",9,0,9
"8850","5521工信","110/08/05","第一金-高雄",0,7,-7
"8851","1471首利","110/08/05","國票-北高雄",50,0,50
"8852","1471首利","110/08/05","永豐金-板盛",0,129,-129
"8853","1471首利","110/08/05","台灣摩根士丹利",49,0,49
"8854","1471首利","110/08/05","元大-三重",0,50,-50
"8855","1471首利","110/08/05","元大-太平",30,0,30
"8856","1471首利","110/08/05","瑞士信貸",0,42,-42
"8857","1471首利","110/08/05","國泰-敦南",24,0,24
"8858","1471首利","110/08/05","美林",0,37,-37
"8859","1471首利","110/08/05","玉山-桃園",21,0,21
"8860","1471首利","110/08/05","元富-草屯",0,30,-30
"8861","1471首利","110/08/05","宏遠-光隆",20,0,20
"8862","1471首利","110/08/05","元富-民權",0,25,-25
"8863","1471首利","110/08/05","富邦-嘉義",20,1,19
"8864","1471首利","110/08/05","台中銀",0,23,-23
"8865","1471首利","110/08/05","元大-博愛",30,13,17
"8866","1471首利","110/08/05","元富-新興",0,20,-20
"8867","1471首利","110/08/05","台新-高雄",16,0,16
"8868","1471首利","110/08/05","摩根大通",17,33,-16
"8869","1471首利","110/08/05","日盛-文化",15,0,15
"8870","1471首利","110/08/05","日盛-鳳山",0,15,-15
"8871","1471首利","110/08/05","群益金鼎-新莊",15,0,15
"8872","1471首利","110/08/05","高橋",0,14,-14
"8873","1471首利","110/08/05","凱基-科園",13,0,13
"8874","1471首利","110/08/05","富邦-羅東",0,13,-13
"8875","1471首利","110/08/05","元大-高雄",12,0,12
"8876","1471首利","110/08/05","德信-中正",0,12,-12
"8877","1471首利","110/08/05","第一金-桃園",11,0,11
"8878","1471首利","110/08/05","群益金鼎-中港",5,17,-12
"8879","1471首利","110/08/05","台灣企銀-太平",10,0,10
"8880","1471首利","110/08/05","第一金-台南",0,10,-10
"8881","2883開發金","110/08/05","元富",5268,0,5268
"8882","2883開發金","110/08/05","新光-高雄",309,4909,-4600
"8883","2883開發金","110/08/05","瑞士信貸",4963,0,4963
"8884","2883開發金","110/08/05","富邦-竹東",594,3509,-2915
"8885","2883開發金","110/08/05","富邦證券",3800,0,3800
"8886","2883開發金","110/08/05","永豐金-南京",2,1915,-1913
"8887","2883開發金","110/08/05","台灣摩根士丹利",3886,1250,2636
"8888","2883開發金","110/08/05","第一金-自由",2,1894,-1892
"8889","2883開發金","110/08/05","元富-城東",2119,68,2051
"8890","2883開發金","110/08/05","康和-仁愛",0,1820,-1820
"8891","2883開發金","110/08/05","港商野村",2397,395,2002
"8892","2883開發金","110/08/05","兆豐-台中港",22,1522,-1500
"8893","2883開發金","110/08/05","第一金-忠孝",2020,88,1932
"8894","2883開發金","110/08/05","元大-大同",43,1010,-967
"8895","2883開發金","110/08/05","國泰證券",1682,3,1679
"8896","2883開發金","110/08/05","國票",53,645,-592
"8897","2883開發金","110/08/05","大和國泰",1666,0,1666
"8898","2883開發金","110/08/05","富邦-新竹",86,674,-588
"8899","2883開發金","110/08/05","永豐金-板橋",1507,15,1492
"8900","2883開發金","110/08/05","富邦-建國",39,560,-521
"8901","2883開發金","110/08/05","台灣企銀-民雄",1002,0,1002
"8902","2883開發金","110/08/05","日盛-台南",7,525,-518
"8903","2883開發金","110/08/05","美林",1263,577,686
"8904","2883開發金","110/08/05","凱基-基隆",1,510,-509
"8905","2883開發金","110/08/05","康和",640,0,640
"8906","2883開發金","110/08/05","元富-民權",0,500,-500
"8907","2883開發金","110/08/05","凱基-台北",1262,679,583
"8908","2883開發金","110/08/05","永豐金-松山",9,509,-500
"8909","2883開發金","110/08/05","福邦證券",560,50,510
"8910","2883開發金","110/08/05","華南永昌-中正",25,511,-486
"8911","6205詮欣","110/08/05","富邦-高雄",27,0,27
"8912","6205詮欣","110/08/05","臺銀-鳳山",0,31,-31
"8913","6205詮欣","110/08/05","摩根大通",27,1,26
"8914","6205詮欣","110/08/05","合庫-三重",0,15,-15
"8915","6205詮欣","110/08/05","永豐金-敦南",14,0,14
"8916","6205詮欣","110/08/05","臺銀-民權",11,21,-10
"8917","6205詮欣","110/08/05","凱基-台北",14,1,13
"8918","6205詮欣","110/08/05","日盛-中壢",0,10,-10
"8919","6205詮欣","110/08/05","瑞士信貸",14,5,9
"8920","6205詮欣","110/08/05","統一-松江",0,10,-10
"8921","6205詮欣","110/08/05","凱基-湖口",9,0,9
"8922","6205詮欣","110/08/05","台新-三民",0,9,-9
"8923","6205詮欣","110/08/05","德信-新營",4,0,4
"8924","6205詮欣","110/08/05","臺銀-新竹",1,9,-8
"8925","6205詮欣","110/08/05","元大-東蘆",5,1,4
"8926","6205詮欣","110/08/05","康和",0,5,-5
"8927","6205詮欣","110/08/05","臺銀-高雄",3,0,3
"8928","6205詮欣","110/08/05","元大-館前",0,4,-4
"8929","6205詮欣","110/08/05","富邦-左營",3,0,3
"8930","6205詮欣","110/08/05","宏遠-新化",0,3,-3
"8931","6205詮欣","110/08/05","日盛-花蓮",2,0,2
"8932","6205詮欣","110/08/05","新加坡商瑞銀",4,7,-3
"8933","6205詮欣","110/08/05","元富-三重",2,0,2
"8934","6205詮欣","110/08/05","致和-高雄",0,3,-3
"8935","6205詮欣","110/08/05","北城證券",2,0,2
"8936","6205詮欣","110/08/05","國票",0,3,-3
"8937","6205詮欣","110/08/05","國票-南港",2,0,2
"8938","6205詮欣","110/08/05","富邦-嘉義",0,3,-3
"8939","6205詮欣","110/08/05","台新證券",2,0,2
"8940","6205詮欣","110/08/05","統一-士林",0,2,-2
"8941","1540喬福","110/08/05","元富-中原",24,0,24
"8942","1540喬福","110/08/05","統一-新台中",0,21,-21
"8943","1540喬福","110/08/05","台新-台南",10,0,10
"8944","1540喬福","110/08/05","國泰-敦南",0,15,-15
"8945","1540喬福","110/08/05","台新-台中",10,0,10
"8946","1540喬福","110/08/05","華南永昌-南京",0,10,-10
"8947","1540喬福","110/08/05","瑞士信貸",6,0,6
"8948","1540喬福","110/08/05","元大-台中中港",0,10,-10
"8949","1540喬福","110/08/05","台中銀-豐原",6,0,6
"8950","1540喬福","110/08/05","德信-新營",0,8,-8
"8951","1540喬福","110/08/05","凱基-台北",6,0,6
"8952","1540喬福","110/08/05","新光-台南",0,4,-4
"8953","1540喬福","110/08/05","凱基-台南",5,0,5
"8954","1540喬福","110/08/05","元大-大天母",6,10,-4
"8955","1540喬福","110/08/05","元大-士林",5,0,5
"8956","1540喬福","110/08/05","康和-新竹",0,3,-3
"8957","1540喬福","110/08/05","美林",2,0,2
"8958","1540喬福","110/08/05","元大-龍潭",0,3,-3
"8959","1540喬福","110/08/05","群益金鼎-崇德",2,0,2
"8960","1540喬福","110/08/05","第一金-員林",0,1,-1
"8961","1540喬福","110/08/05","凱基-苗栗",2,0,2
"8962","1540喬福","110/08/05","第一金-豐原",0,1,-1
"8963","1540喬福","110/08/05","凱基-中壢",2,0,2
"8964","1540喬福","110/08/05","台新-高雄",0,1,-1
"8965","1540喬福","110/08/05","土銀-士林",1,0,1
"8966","1540喬福","110/08/05","元大-崇德",0,1,-1
"8967","1540喬福","110/08/05","群益金鼎-丹鳳",1,0,1
"8968","1540喬福","110/08/05","元大-中壢",0,1,-1
"8969","1540喬福","110/08/05","元大-文心",1,0,1
"8970","1540喬福","110/08/05","元大-斗信",0,1,-1
"8971","2888新光金","110/08/05","華南永昌-南京",3753,8,3745
"8972","2888新光金","110/08/05","第一金-高雄",0,5007,-5007
"8973","2888新光金","110/08/05","玉山-城中",2004,28,1976
"8974","2888新光金","110/08/05","美商高盛",12,1719,-1707
"8975","2888新光金","110/08/05","元大-西門",906,18,888
"8976","2888新光金","110/08/05","香港上海匯豐",0,1437,-1437
"8977","2888新光金","110/08/05","日盛-和美",557,3,554
"8978","2888新光金","110/08/05","凱基-台南",46,802,-756
"8979","2888新光金","110/08/05","康和-台中",460,49,411
"8980","2888新光金","110/08/05","美林",538,1140,-602
"8981","2888新光金","110/08/05","元富-緯城",302,1,301
"8982","2888新光金","110/08/05","凱基-台北",686,1280,-594
"8983","2888新光金","110/08/05","彰銀",301,3,298
"8984","2888新光金","110/08/05","法銀巴黎",0,562,-562
"8985","2888新光金","110/08/05","花旗環球",356,84,272
"8986","2888新光金","110/08/05","瑞士信貸",1350,1798,-448
"8987","2888新光金","110/08/05","永全-南崁",240,0,240
"8988","2888新光金","110/08/05","群益金鼎-丹鳳",4,303,-299
"8989","2888新光金","110/08/05","永豐金-彰化",232,20,212
"8990","2888新光金","110/08/05","安泰-大發",10,300,-290
"8991","2888新光金","110/08/05","統一-新台中",214,7,207
"8992","2888新光金","110/08/05","摩根大通",1159,1428,-269
"8993","2888新光金","110/08/05","中國信託-永康",203,0,203
"8994","2888新光金","110/08/05","兆豐-員林",4,260,-256
"8995","2888新光金","110/08/05","日盛-景美",200,0,200
"8996","2888新光金","110/08/05","日盛-大墩",0,250,-250
"8997","2888新光金","110/08/05","元大-東泰",207,22,185
"8998","2888新光金","110/08/05","元大-大里",31,243,-212
"8999","2888新光金","110/08/05","合庫證券",181,2,179
"9000","2888新光金","110/08/05","北城證券",25,230,-205
"9001","1340勝悅","110/08/05","富邦-仁愛",20,0,20
"9002","1340勝悅","110/08/05","中國信託",0,36,-36
"9003","1340勝悅","110/08/05","華南永昌-忠孝",12,0,12
"9004","1340勝悅","110/08/05","新光-新竹",0,18,-18
"9005","1340勝悅","110/08/05","華南永昌-楠梓",10,0,10
"9006","1340勝悅","110/08/05","永豐金-嘉義",0,15,-15
"9007","1340勝悅","110/08/05","統一-城中",17,11,6
"9008","1340勝悅","110/08/05","日茂",0,10,-10
"9009","1340勝悅","110/08/05","臺灣企銀-埔墘",5,0,5
"9010","1340勝悅","110/08/05","富邦-宜蘭",0,10,-10
"9011","1340勝悅","110/08/05","國票-台東",5,0,5
"9012","1340勝悅","110/08/05","元富-花蓮",0,9,-9
"9013","1340勝悅","110/08/05","新光-高雄",5,0,5
"9014","1340勝悅","110/08/05","永豐金-南京",0,7,-7
"9015","1340勝悅","110/08/05","國泰-台中",6,1,5
"9016","1340勝悅","110/08/05","統一",0,6,-6
"9017","1340勝悅","110/08/05","富邦-陽明",5,0,5
"9018","1340勝悅","110/08/05","合庫-西台中",0,3,-3
"9019","1340勝悅","110/08/05","日盛-板橋",4,0,4
"9020","1340勝悅","110/08/05","港商野村",0,3,-3
"9021","1340勝悅","110/08/05","港商法國興業",4,0,4
"9022","1340勝悅","110/08/05","兆豐-新竹",0,3,-3
"9023","1340勝悅","110/08/05","臺銀-高雄",3,0,3
"9024","1340勝悅","110/08/05","亞東-台中",0,2,-2
"9025","1340勝悅","110/08/05","元富-新店",3,0,3
"9026","1340勝悅","110/08/05","元大-歸仁",0,2,-2
"9027","1340勝悅","110/08/05","康和-屏東",3,0,3
"9028","1340勝悅","110/08/05","日盛-斗六",0,1,-1
"9029","1340勝悅","110/08/05","群益金鼎-民權",3,0,3
"9030","1340勝悅","110/08/05","日盛-中和",0,1,-1
"9031","6246臺龍","110/08/05","元大-林森",200,0,200
"9032","6246臺龍","110/08/05","統一",0,180,-180
"9033","6246臺龍","110/08/05","元大證券",92,1,91
"9034","6246臺龍","110/08/05","大慶-富順",0,114,-114
"9035","6246臺龍","110/08/05","凱基-大直",99,19,80
"9036","6246臺龍","110/08/05","台新-三民",0,77,-77
"9037","6246臺龍","110/08/05","元大-北港",51,0,51
"9038","6246臺龍","110/08/05","永興",0,48,-48
"9039","6246臺龍","110/08/05","統一-南京",50,0,50
"9040","6246臺龍","110/08/05","華南永昌-嘉義",1,26,-25
"9041","6246臺龍","110/08/05","台灣企銀",40,0,40
"9042","6246臺龍","110/08/05","宏遠-民生",0,20,-20
"9043","6246臺龍","110/08/05","永豐金-虎尾",23,0,23
"9044","6246臺龍","110/08/05","兆豐-大同",0,20,-20
"9045","6246臺龍","110/08/05","凱基-台北",27,5,22
"9046","6246臺龍","110/08/05","華南永昌-林口",0,20,-20
"9047","6246臺龍","110/08/05","元富-新竹",20,0,20
"9048","6246臺龍","110/08/05","元大-永春",0,20,-20
"9049","6246臺龍","110/08/05","康和-石牌",20,0,20
"9050","6246臺龍","110/08/05","元大-東泰",0,19,-19
"9051","6246臺龍","110/08/05","聯邦-大業",20,0,20
"9052","6246臺龍","110/08/05","德信-新營",0,18,-18
"9053","6246臺龍","110/08/05","凱基-彰化",18,0,18
"9054","6246臺龍","110/08/05","永豐金-松山",10,28,-18
"9055","6246臺龍","110/08/05","永豐金-復興",17,1,16
"9056","6246臺龍","110/08/05","台新-台中",4,20,-16
"9057","6246臺龍","110/08/05","新光-台中",17,2,15
"9058","6246臺龍","110/08/05","兆豐-竹北",5,20,-15
"9059","6246臺龍","110/08/05","元大-路竹",15,1,14
"9060","6246臺龍","110/08/05","兆豐-南京",1,14,-13
"9061","00715L期街口布蘭特正2","110/08/05","(牛牛牛)亞-鑫豐",1195,20,1175
"9062","00715L期街口布蘭特正2","110/08/05","元大證券",1735,21716,-19981
"9063","00715L期街口布蘭特正2","110/08/05","元大-萬華",930,0,930
"9064","00715L期街口布蘭特正2","110/08/05","凱基-台北",182,11686,-11504
"9065","00715L期街口布蘭特正2","110/08/05","元大-永康",810,9,801
"9066","00715L期街口布蘭特正2","110/08/05","元富",8,6852,-6844
"9067","00715L期街口布蘭特正2","110/08/05","富邦-彰化",760,0,760
"9068","00715L期街口布蘭特正2","110/08/05","台新證券",598,4522,-3924
"9069","00715L期街口布蘭特正2","110/08/05","國泰-敦南",830,155,675
"9070","00715L期街口布蘭特正2","110/08/05","凱基",0,3168,-3168
"9071","00715L期街口布蘭特正2","110/08/05","新光-台中",698,33,665
"9072","00715L期街口布蘭特正2","110/08/05","群益金鼎",0,1742,-1742
"9073","00715L期街口布蘭特正2","110/08/05","富邦-南屯",621,5,616
"9074","00715L期街口布蘭特正2","110/08/05","國票",22,1607,-1585
"9075","00715L期街口布蘭特正2","110/08/05","群益金鼎-士林",620,40,580
"9076","00715L期街口布蘭特正2","110/08/05","永豐金證券",91,1254,-1163
"9077","00715L期街口布蘭特正2","110/08/05","兆豐-嘉義",510,0,510
"9078","00715L期街口布蘭特正2","110/08/05","富邦證券",140,1095,-955
"9079","00715L期街口布蘭特正2","110/08/05","統一-新竹",508,9,499
"9080","00715L期街口布蘭特正2","110/08/05","元大-雙和",22,850,-828
"9081","00715L期街口布蘭特正2","110/08/05","國泰-板橋",521,24,497
"9082","00715L期街口布蘭特正2","110/08/05","國票-台中",25,805,-780
"9083","00715L期街口布蘭特正2","110/08/05","元大-中和",481,3,478
"9084","00715L期街口布蘭特正2","110/08/05","華南永昌-長虹",145,820,-675
"9085","00715L期街口布蘭特正2","110/08/05","元大-羅東",470,0,470
"9086","00715L期街口布蘭特正2","110/08/05","日盛-大墩",121,455,-334
"9087","00715L期街口布蘭特正2","110/08/05","群益金鼎-嘉義",483,20,463
"9088","00715L期街口布蘭特正2","110/08/05","華南永昌-斗六",52,380,-328
"9089","00715L期街口布蘭特正2","110/08/05","群益金鼎-中壢",476,30,446
"9090","00715L期街口布蘭特正2","110/08/05","康和",0,250,-250
"9091","8941關中","110/08/05","第一金-台南",1,0,1
"9092","8941關中","110/08/05","元富-宜蘭",0,2,-2
"9093","8941關中","110/08/05","康和-嘉義",1,0,1
"9094","8941關中","110/08/05","統一-南京",0,1,-1
"9095","8941關中","110/08/05","群益金鼎-延平",1,0,1
"9096","8941關中","110/08/05","合庫證券",0,0,0
"9097","8941關中","110/08/05","合庫證券",0,0,0
"9098","8941關中","110/08/05","(牛牛牛)亞-鑫豐",0,0,0
"9099","8941關中","110/08/05","(牛牛牛)亞-鑫豐",0,0,0
"9100","8941關中","110/08/05","富邦-北港",0,0,0
"9101","8941關中","110/08/05","富邦-北港",0,0,0
"9102","8941關中","110/08/05","",NA,NA,NA
"9103","8941關中","110/08/05","",NA,NA,NA
"9104","8941關中","110/08/05","",NA,NA,NA
"9105","8941關中","110/08/05","",NA,NA,NA
"9106","8941關中","110/08/05","",NA,NA,NA
"9107","8941關中","110/08/05","",NA,NA,NA
"9108","8941關中","110/08/05","",NA,NA,NA
"9109","8941關中","110/08/05","",NA,NA,NA
"9110","8941關中","110/08/05","",NA,NA,NA
"9111","8941關中","110/08/05","",NA,NA,NA
"9112","8941關中","110/08/05","",NA,NA,NA
"9113","8941關中","110/08/05","",NA,NA,NA
"9114","8941關中","110/08/05","",NA,NA,NA
"9115","8941關中","110/08/05","",NA,NA,NA
"9116","8941關中","110/08/05","",NA,NA,NA
"9117","8941關中","110/08/05","",NA,NA,NA
"9118","8941關中","110/08/05","",NA,NA,NA
"9119","8941關中","110/08/05","",NA,NA,NA
"9120","8941關中","110/08/05","",NA,NA,NA
"9121","8936國統","110/08/05","國票-敦北法人",100,0,100
"9122","8936國統","110/08/05","摩根大通",16,240,-224
"9123","8936國統","110/08/05","第一金-光復",50,0,50
"9124","8936國統","110/08/05","台新-松江",0,205,-205
"9125","8936國統","110/08/05","元大-蘆洲",45,0,45
"9126","8936國統","110/08/05","凱基-台北",1,177,-176
"9127","8936國統","110/08/05","富邦-建國",34,0,34
"9128","8936國統","110/08/05","新加坡商瑞銀",14,119,-105
"9129","8936國統","110/08/05","富邦-高雄",33,1,32
"9130","8936國統","110/08/05","凱基-市政",0,35,-35
"9131","8936國統","110/08/05","元大-敦南",30,0,30
"9132","8936國統","110/08/05","瑞士信貸",0,31,-31
"9133","8936國統","110/08/05","元大-博愛",23,0,23
"9134","8936國統","110/08/05","合庫-高雄",22,49,-27
"9135","8936國統","110/08/05","國票-長城",20,0,20
"9136","8936國統","110/08/05","港商野村",15,41,-26
"9137","8936國統","110/08/05","凱基-岡山",20,0,20
"9138","8936國統","110/08/05","富邦-陽明",1,24,-23
"9139","8936國統","110/08/05","凱基-台南",20,0,20
"9140","8936國統","110/08/05","合庫-新竹",0,22,-22
"9141","8936國統","110/08/05","富邦-中壢",21,2,19
"9142","8936國統","110/08/05","美商高盛",0,20,-20
"9143","8936國統","110/08/05","永豐金-忠孝",17,0,17
"9144","8936國統","110/08/05","元大-雙和",0,20,-20
"9145","8936國統","110/08/05","玉山-台中",16,0,16
"9146","8936國統","110/08/05","彰銀-七賢",0,18,-18
"9147","8936國統","110/08/05","兆豐-景美",15,0,15
"9148","8936國統","110/08/05","台灣企銀-台中",0,15,-15
"9149","8936國統","110/08/05","富邦-南屯",15,0,15
"9150","8936國統","110/08/05","兆豐-大同",0,15,-15
"9151","6226光鼎","110/08/05","國泰-敦南",190,90,100
"9152","6226光鼎","110/08/05","富邦-嘉義",590,964,-374
"9153","6226光鼎","110/08/05","凱基-台中",98,2,96
"9154","6226光鼎","110/08/05","日盛-員林",9,200,-191
"9155","6226光鼎","110/08/05","華南永昌-大安",95,13,82
"9156","6226光鼎","110/08/05","華南永昌",5,157,-152
"9157","6226光鼎","110/08/05","凱基-豐中",68,2,66
"9158","6226光鼎","110/08/05","國票-敦北法人",0,106,-106
"9159","6226光鼎","110/08/05","元富-西松",76,15,61
"9160","6226光鼎","110/08/05","元大-雙和",27,118,-91
"9161","6226光鼎","110/08/05","群益金鼎-土城",61,0,61
"9162","6226光鼎","110/08/05","華南永昌-南京",48,137,-89
"9163","6226光鼎","110/08/05","新光-高雄",64,4,60
"9164","6226光鼎","110/08/05","統一-新竹",37,124,-87
"9165","6226光鼎","110/08/05","宏遠-台中",67,9,58
"9166","6226光鼎","110/08/05","大昌",3,78,-75
"9167","6226光鼎","110/08/05","元大-東港",53,0,53
"9168","6226光鼎","110/08/05","凱基-台北",1,74,-73
"9169","6226光鼎","110/08/05","群益金鼎-敦南",60,10,50
"9170","6226光鼎","110/08/05","中國信託-文心",10,65,-55
"9171","6226光鼎","110/08/05","日盛-高雄",53,7,46
"9172","6226光鼎","110/08/05","台新-新莊",1,54,-53
"9173","6226光鼎","110/08/05","台新-新營",49,4,45
"9174","6226光鼎","110/08/05","台新-台中",84,135,-51
"9175","6226光鼎","110/08/05","玉山-雙和",42,2,40
"9176","6226光鼎","110/08/05","元大-嘉義",77,128,-51
"9177","6226光鼎","110/08/05","永豐金-高雄",44,8,36
"9178","6226光鼎","110/08/05","日盛-大墩",1,43,-42
"9179","6226光鼎","110/08/05","元富-花蓮",42,7,35
"9180","6226光鼎","110/08/05","日茂-埔里",0,41,-41
"9181","2363矽統","110/08/05","瑞士信貸",3345,0,3345
"9182","2363矽統","110/08/05","新加坡商瑞銀",1909,2622,-713
"9183","2363矽統","110/08/05","台灣摩根士丹利",2917,53,2864
"9184","2363矽統","110/08/05","統一-板橋",37,650,-613
"9185","2363矽統","110/08/05","摩根大通",5124,3944,1180
"9186","2363矽統","110/08/05","美商高盛",702,1245,-543
"9187","2363矽統","110/08/05","康和-台中",911,292,619
"9188","2363矽統","110/08/05","元富-西松",367,902,-535
"9189","2363矽統","110/08/05","永豐金證券",951,339,612
"9190","2363矽統","110/08/05","華南永昌-斗六",55,584,-529
"9191","2363矽統","110/08/05","群益金鼎-三民",571,106,465
"9192","2363矽統","110/08/05","美林",2987,3501,-514
"9193","2363矽統","110/08/05","國票-敦北法人",484,51,433
"9194","2363矽統","110/08/05","群益金鼎-館前",331,802,-471
"9195","2363矽統","110/08/05","陽信-石牌",624,204,420
"9196","2363矽統","110/08/05","永豐金-三重",138,571,-433
"9197","2363矽統","110/08/05","合庫證券",520,118,402
"9198","2363矽統","110/08/05","富邦-中壢",348,774,-426
"9199","2363矽統","110/08/05","元大-承德",385,70,315
"9200","2363矽統","110/08/05","北城證券",53,459,-406
"9201","2363矽統","110/08/05","新光",2366,2079,287
"9202","2363矽統","110/08/05","凱基-興隆",370,717,-347
"9203","2363矽統","110/08/05","元大證券",601,329,272
"9204","2363矽統","110/08/05","元大-屏南",132,464,-332
"9205","2363矽統","110/08/05","國泰-敦南",4481,4216,265
"9206","2363矽統","110/08/05","日盛-中和",208,531,-323
"9207","2363矽統","110/08/05","元大-台中",562,349,213
"9208","2363矽統","110/08/05","土銀",28,340,-312
"9209","2363矽統","110/08/05","富邦-台北",584,380,204
"9210","2363矽統","110/08/05","永豐金-嘉義",97,401,-304
"9211","8112至上","110/08/05","元大-竹科",858,64,794
"9212","8112至上","110/08/05","摩根大通",461,775,-314
"9213","8112至上","110/08/05","港商野村",937,361,576
"9214","8112至上","110/08/05","台灣摩根士丹利",16,272,-256
"9215","8112至上","110/08/05","康和",484,0,484
"9216","8112至上","110/08/05","高橋",3,183,-180
"9217","8112至上","110/08/05","新加坡商瑞銀",514,58,456
"9218","8112至上","110/08/05","合庫證券",19,162,-143
"9219","8112至上","110/08/05","元大-屏南",391,4,387
"9220","8112至上","110/08/05","元大-北屯",3,145,-142
"9221","8112至上","110/08/05","國票-長城",427,142,285
"9222","8112至上","110/08/05","元大-府城",14,154,-140
"9223","8112至上","110/08/05","元大-萬華",246,12,234
"9224","8112至上","110/08/05","群益金鼎-三重",0,138,-138
"9225","8112至上","110/08/05","台灣匯立證券",210,0,210
"9226","8112至上","110/08/05","富邦-台北",25,129,-104
"9227","8112至上","110/08/05","凱基-敦北",200,4,196
"9228","8112至上","110/08/05","元富-佳里",7,100,-93
"9229","8112至上","110/08/05","元大-北成功",205,17,188
"9230","8112至上","110/08/05","元富-台南",0,86,-86
"9231","8112至上","110/08/05","元大-高雄",146,14,132
"9232","8112至上","110/08/05","臺灣企銀-桃園",0,82,-82
"9233","8112至上","110/08/05","美商高盛",161,47,114
"9234","8112至上","110/08/05","玉山-嘉義",10,88,-78
"9235","8112至上","110/08/05","花旗環球",102,0,102
"9236","8112至上","110/08/05","凱基-復興",1,67,-66
"9237","8112至上","110/08/05","統一-士林",108,8,100
"9238","8112至上","110/08/05","富邦-中壢",23,89,-66
"9239","8112至上","110/08/05","新光",244,159,85
"9240","8112至上","110/08/05","元大-上新莊",1,67,-66
"9241","1570力肯","110/08/05","國票",352,0,352
"9242","1570力肯","110/08/05","國票-和平",7,402,-395
"9243","1570力肯","110/08/05","台新證券",211,87,124
"9244","1570力肯","110/08/05","摩根大通",46,335,-289
"9245","1570力肯","110/08/05","國泰-敦南",206,125,81
"9246","1570力肯","110/08/05","國票-北高雄",79,306,-227
"9247","1570力肯","110/08/05","聯邦商銀",75,0,75
"9248","1570力肯","110/08/05","統一",3,226,-223
"9249","1570力肯","110/08/05","元大-東泰",61,4,57
"9250","1570力肯","110/08/05","凱基-台北",184,366,-182
"9251","1570力肯","110/08/05","元大-桃興",113,66,47
"9252","1570力肯","110/08/05","統一-土城",89,161,-72
"9253","1570力肯","110/08/05","國泰-板橋",96,50,46
"9254","1570力肯","110/08/05","統一-屏東",0,64,-64
"9255","1570力肯","110/08/05","合庫-桃園",92,48,44
"9256","1570力肯","110/08/05","大昌-新店",9,61,-52
"9257","1570力肯","110/08/05","華南永昌-高雄",53,12,41
"9258","1570力肯","110/08/05","群益金鼎-忠孝",11,60,-49
"9259","1570力肯","110/08/05","國泰-高雄",50,14,36
"9260","1570力肯","110/08/05","臺銀-臺南",12,52,-40
"9261","1570力肯","110/08/05","國泰-台中",60,25,35
"9262","1570力肯","110/08/05","凱基-岡山",28,68,-40
"9263","1570力肯","110/08/05","富邦-仁愛",52,17,35
"9264","1570力肯","110/08/05","元大-蘆洲",8,44,-36
"9265","1570力肯","110/08/05","中國信託-忠孝",37,3,34
"9266","1570力肯","110/08/05","統一-仁愛",25,60,-35
"9267","1570力肯","110/08/05","元大-中壢",44,10,34
"9268","1570力肯","110/08/05","富邦-高雄",8,43,-35
"9269","1570力肯","110/08/05","日盛-新竹",30,0,30
"9270","1570力肯","110/08/05","大慶-蘆洲",110,142,-32
"9271","2929淘帝","110/08/05","國泰-松江",60,0,60
"9272","2929淘帝","110/08/05","摩根大通",4,87,-83
"9273","2929淘帝","110/08/05","美林",79,30,49
"9274","2929淘帝","110/08/05","日盛-南京",0,80,-80
"9275","2929淘帝","110/08/05","港商野村",87,45,42
"9276","2929淘帝","110/08/05","華南永昌-頭份",0,80,-80
"9277","2929淘帝","110/08/05","兆豐-忠孝",40,0,40
"9278","2929淘帝","110/08/05","日盛-雙和",2,57,-55
"9279","2929淘帝","110/08/05","新光-新竹",41,2,39
"9280","2929淘帝","110/08/05","台新-台中",2,33,-31
"9281","2929淘帝","110/08/05","元大-民生",31,0,31
"9282","2929淘帝","110/08/05","群益金鼎-新竹",0,30,-30
"9283","2929淘帝","110/08/05","元富-中港",28,0,28
"9284","2929淘帝","110/08/05","元大-北成功",0,30,-30
"9285","2929淘帝","110/08/05","凱基-台北",66,41,25
"9286","2929淘帝","110/08/05","元大-天母",5,30,-25
"9287","2929淘帝","110/08/05","富邦-新店",20,0,20
"9288","2929淘帝","110/08/05","元大-北港",0,25,-25
"9289","2929淘帝","110/08/05","康和-台中",15,0,15
"9290","2929淘帝","110/08/05","兆豐-彰化",0,24,-24
"9291","2929淘帝","110/08/05","華南永昌-古亭",15,0,15
"9292","2929淘帝","110/08/05","國泰-台中",1,25,-24
"9293","2929淘帝","110/08/05","日盛-景美",11,0,11
"9294","2929淘帝","110/08/05","華南永昌-大安",0,22,-22
"9295","2929淘帝","110/08/05","台新證券",11,0,11
"9296","2929淘帝","110/08/05","國泰-館前",10,31,-21
"9297","2929淘帝","110/08/05","凱基-三重",11,0,11
"9298","2929淘帝","110/08/05","元富-安南",0,20,-20
"9299","2929淘帝","110/08/05","華南永昌-竹北",11,0,11
"9300","2929淘帝","110/08/05","元大-屏南",10,30,-20
"9301","5410國眾","110/08/05","凱基-市政",40,0,40
"9302","5410國眾","110/08/05","元富-台南",0,27,-27
"9303","5410國眾","110/08/05","安泰",16,0,16
"9304","5410國眾","110/08/05","群益金鼎-內湖",0,16,-16
"9305","5410國眾","110/08/05","元大-善化",12,0,12
"9306","5410國眾","110/08/05","中農",0,15,-15
"9307","5410國眾","110/08/05","元富-同大",10,0,10
"9308","5410國眾","110/08/05","新光-台南",0,15,-15
"9309","5410國眾","110/08/05","中國信託-新竹",10,0,10
"9310","5410國眾","110/08/05","統一-平鎮",0,13,-13
"9311","5410國眾","110/08/05","元大-敦南",10,0,10
"9312","5410國眾","110/08/05","臺銀",0,11,-11
"9313","5410國眾","110/08/05","台灣企銀-太平",8,0,8
"9314","5410國眾","110/08/05","凱基-城中",0,10,-10
"9315","5410國眾","110/08/05","瑞士信貸",7,0,7
"9316","5410國眾","110/08/05","元大-崇德",0,10,-10
"9317","5410國眾","110/08/05","元富-烏日",6,0,6
"9318","5410國眾","110/08/05","元大-和平",0,10,-10
"9319","5410國眾","110/08/05","摩根大通",7,1,6
"9320","5410國眾","110/08/05","新光-台中",1,9,-8
"9321","5410國眾","110/08/05","元富-三重",11,6,5
"9322","5410國眾","110/08/05","富邦-板橋",0,6,-6
"9323","5410國眾","110/08/05","中國信託-忠孝",5,0,5
"9324","5410國眾","110/08/05","新百王",0,5,-5
"9325","5410國眾","110/08/05","凱基-復興",5,0,5
"9326","5410國眾","110/08/05","元大-大益",0,5,-5
"9327","5410國眾","110/08/05","永豐金-台中",4,0,4
"9328","5410國眾","110/08/05","永豐金-板橋",0,5,-5
"9329","5410國眾","110/08/05","元富-板橋",3,0,3
"9330","5410國眾","110/08/05","台新-中壢",0,4,-4
"9331","2841台開","110/08/05","日盛證券",201,0,201
"9332","2841台開","110/08/05","第一金-自由",0,272,-272
"9333","2841台開","110/08/05","永豐金-敦南",202,1,201
"9334","2841台開","110/08/05","瑞士信貸",0,149,-149
"9335","2841台開","110/08/05","元大-大天母",200,0,200
"9336","2841台開","110/08/05","玉山-新竹",0,131,-131
"9337","2841台開","110/08/05","永豐金-鳳山",100,0,100
"9338","2841台開","110/08/05","元富-板橋",0,125,-125
"9339","2841台開","110/08/05","台新-三民",100,1,99
"9340","2841台開","110/08/05","元大-台中中港",0,109,-109
"9341","2841台開","110/08/05","凱基-竹科",67,0,67
"9342","2841台開","110/08/05","兆豐-東門",0,100,-100
"9343","2841台開","110/08/05","國泰-敦南",44,5,39
"9344","2841台開","110/08/05","(牛牛牛)亞-鑫豐",0,97,-97
"9345","2841台開","110/08/05","元大-中壢",35,0,35
"9346","2841台開","110/08/05","元富-嘉義",0,50,-50
"9347","2841台開","110/08/05","國泰-忠孝",33,0,33
"9348","2841台開","110/08/05","新光",20,67,-47
"9349","2841台開","110/08/05","元大-新竹經國",30,0,30
"9350","2841台開","110/08/05","永豐金-豐原",3,50,-47
"9351","2841台開","110/08/05","日盛-內湖",24,0,24
"9352","2841台開","110/08/05","統一-士林",0,31,-31
"9353","2841台開","110/08/05","新光-高雄",21,0,21
"9354","2841台開","110/08/05","元大-龍潭",0,30,-30
"9355","2841台開","110/08/05","元大-林園",20,0,20
"9356","2841台開","110/08/05","新光-台南",0,27,-27
"9357","2841台開","110/08/05","元大-仁愛",20,0,20
"9358","2841台開","110/08/05","台新-台中",0,22,-22
"9359","2841台開","110/08/05","群益金鼎-崇德",18,0,18
"9360","2841台開","110/08/05","大昌-安康",0,20,-20
"9361","6207雷科","110/08/05","摩根大通",313,64,249
"9362","6207雷科","110/08/05","日盛-忠孝",2,93,-91
"9363","6207雷科","110/08/05","新加坡商瑞銀",141,6,135
"9364","6207雷科","110/08/05","凱基-復興",0,90,-90
"9365","6207雷科","110/08/05","凱基-台北",142,20,122
"9366","6207雷科","110/08/05","群益金鼎-敦南",0,67,-67
"9367","6207雷科","110/08/05","台新-高雄",111,0,111
"9368","6207雷科","110/08/05","元大-鳳山",11,73,-62
"9369","6207雷科","110/08/05","瑞士信貸",58,0,58
"9370","6207雷科","110/08/05","群益金鼎-東門",0,56,-56
"9371","6207雷科","110/08/05","美林",45,0,45
"9372","6207雷科","110/08/05","元富-同大",1,41,-40
"9373","6207雷科","110/08/05","凱基-板橋",46,1,45
"9374","6207雷科","110/08/05","群益金鼎-屏東",1,41,-40
"9375","6207雷科","110/08/05","美商高盛",37,0,37
"9376","6207雷科","110/08/05","群益金鼎-延平",0,40,-40
"9377","6207雷科","110/08/05","凱基-三多",30,0,30
"9378","6207雷科","110/08/05","群益金鼎-瑞豐",1,33,-32
"9379","6207雷科","110/08/05","永豐金-虎尾",29,0,29
"9380","6207雷科","110/08/05","日盛證券",0,30,-30
"9381","6207雷科","110/08/05","第一金-中山",21,1,20
"9382","6207雷科","110/08/05","臺銀",1,30,-29
"9383","6207雷科","110/08/05","華南永昌-林口",20,0,20
"9384","6207雷科","110/08/05","群益金鼎-古亭",0,26,-26
"9385","6207雷科","110/08/05","兆豐-公益",18,0,18
"9386","6207雷科","110/08/05","凱基-高雄",4,30,-26
"9387","6207雷科","110/08/05","港商野村",62,46,16
"9388","6207雷科","110/08/05","富邦-竹東",0,25,-25
"9389","6207雷科","110/08/05","華南永昌-南京",16,0,16
"9390","6207雷科","110/08/05","元大-台中中港",2,25,-23
"9391","3679新至陞","110/08/05","新光",13,0,13
"9392","3679新至陞","110/08/05","凱基-台北",1,13,-12
"9393","3679新至陞","110/08/05","華南永昌-麻豆",3,0,3
"9394","3679新至陞","110/08/05","台灣摩根士丹利",0,5,-5
"9395","3679新至陞","110/08/05","臺灣企銀-埔墘",2,0,2
"9396","3679新至陞","110/08/05","元大-成功",0,5,-5
"9397","3679新至陞","110/08/05","彰銀",2,0,2
"9398","3679新至陞","110/08/05","元大證券",0,3,-3
"9399","3679新至陞","110/08/05","永全-南崁",2,0,2
"9400","3679新至陞","110/08/05","新加坡商瑞銀",0,2,-2
"9401","3679新至陞","110/08/05","群益金鼎",2,0,2
"9402","3679新至陞","110/08/05","摩根大通",0,2,-2
"9403","3679新至陞","110/08/05","富邦-三重",2,0,2
"9404","3679新至陞","110/08/05","國泰-館前",0,2,-2
"9405","3679新至陞","110/08/05","永豐金-敦北",2,0,2
"9406","3679新至陞","110/08/05","凱基-東港",0,2,-2
"9407","3679新至陞","110/08/05","臺銀-新竹",1,0,1
"9408","3679新至陞","110/08/05","元大-竹北",0,2,-2
"9409","3679新至陞","110/08/05","第一金-新興",1,0,1
"9410","3679新至陞","110/08/05","日盛-嘉義",0,1,-1
"9411","3679新至陞","110/08/05","統一-宜蘭",1,0,1
"9412","3679新至陞","110/08/05","美商高盛",1,2,-1
"9413","3679新至陞","110/08/05","元富-同大",1,0,1
"9414","3679新至陞","110/08/05","港商野村",0,1,-1
"9415","3679新至陞","110/08/05","中國信託-新竹",1,0,1
"9416","3679新至陞","110/08/05","第一金-員林",0,1,-1
"9417","3679新至陞","110/08/05","兆豐-民生",1,0,1
"9418","3679新至陞","110/08/05","統一-中壢",0,1,-1
"9419","3679新至陞","110/08/05","國泰-新莊",1,0,1
"9420","3679新至陞","110/08/05","統一-新竹",0,1,-1
"9421","2727王品","110/08/05","港商野村",68,43,25
"9422","2727王品","110/08/05","元富-宜蘭",6,96,-90
"9423","2727王品","110/08/05","花旗環球",24,0,24
"9424","2727王品","110/08/05","凱基-市政",1,89,-88
"9425","2727王品","110/08/05","新光",42,19,23
"9426","2727王品","110/08/05","群益金鼎-宜蘭",4,89,-85
"9427","2727王品","110/08/05","永豐金-忠孝",21,0,21
"9428","2727王品","110/08/05","永豐金-大園",4,66,-62
"9429","2727王品","110/08/05","凱基-埔墘",15,0,15
"9430","2727王品","110/08/05","康和-澎湖",1,60,-59
"9431","2727王品","110/08/05","新光-桃園",17,3,14
"9432","2727王品","110/08/05","日盛-八德",1,33,-32
"9433","2727王品","110/08/05","日盛-忠孝",16,3,13
"9434","2727王品","110/08/05","元大-桃園",0,29,-29
"9435","2727王品","110/08/05","統一",28,15,13
"9436","2727王品","110/08/05","凱基-竹科",4,31,-27
"9437","2727王品","110/08/05","富邦-員林",15,2,13
"9438","2727王品","110/08/05","富邦-新店",2,29,-27
"9439","2727王品","110/08/05","永豐金-桃盛",16,3,13
"9440","2727王品","110/08/05","兆豐-小港",2,26,-24
"9441","2727王品","110/08/05","元富-屏東",12,0,12
"9442","2727王品","110/08/05","華南永昌",6,25,-19
"9443","2727王品","110/08/05","凱基-台北",52,40,12
"9444","2727王品","110/08/05","台灣摩根士丹利",15,32,-17
"9445","2727王品","110/08/05","永豐金-彰化",12,0,12
"9446","2727王品","110/08/05","凱基-天母",0,15,-15
"9447","2727王品","110/08/05","美林",11,0,11
"9448","2727王品","110/08/05","富邦證券",0,15,-15
"9449","2727王品","110/08/05","群益金鼎-崇德",10,0,10
"9450","2727王品","110/08/05","永豐金證券",1,13,-12
"9451","1570力肯","110/08/05","國票",352,0,352
"9452","1570力肯","110/08/05","國票-和平",7,402,-395
"9453","1570力肯","110/08/05","台新證券",211,87,124
"9454","1570力肯","110/08/05","摩根大通",46,335,-289
"9455","1570力肯","110/08/05","國泰-敦南",206,125,81
"9456","1570力肯","110/08/05","國票-北高雄",79,306,-227
"9457","1570力肯","110/08/05","聯邦商銀",75,0,75
"9458","1570力肯","110/08/05","統一",3,226,-223
"9459","1570力肯","110/08/05","元大-東泰",61,4,57
"9460","1570力肯","110/08/05","凱基-台北",184,366,-182
"9461","1570力肯","110/08/05","元大-桃興",113,66,47
"9462","1570力肯","110/08/05","統一-土城",89,161,-72
"9463","1570力肯","110/08/05","國泰-板橋",96,50,46
"9464","1570力肯","110/08/05","統一-屏東",0,64,-64
"9465","1570力肯","110/08/05","合庫-桃園",92,48,44
"9466","1570力肯","110/08/05","大昌-新店",9,61,-52
"9467","1570力肯","110/08/05","華南永昌-高雄",53,12,41
"9468","1570力肯","110/08/05","群益金鼎-忠孝",11,60,-49
"9469","1570力肯","110/08/05","國泰-高雄",50,14,36
"9470","1570力肯","110/08/05","臺銀-臺南",12,52,-40
"9471","1570力肯","110/08/05","國泰-台中",60,25,35
"9472","1570力肯","110/08/05","凱基-岡山",28,68,-40
"9473","1570力肯","110/08/05","富邦-仁愛",52,17,35
"9474","1570力肯","110/08/05","元大-蘆洲",8,44,-36
"9475","1570力肯","110/08/05","中國信託-忠孝",37,3,34
"9476","1570力肯","110/08/05","統一-仁愛",25,60,-35
"9477","1570力肯","110/08/05","元大-中壢",44,10,34
"9478","1570力肯","110/08/05","富邦-高雄",8,43,-35
"9479","1570力肯","110/08/05","日盛-新竹",30,0,30
"9480","1570力肯","110/08/05","大慶-蘆洲",110,142,-32
"9481","6180橘子","110/08/05","永豐金-松山",51,0,51
"9482","6180橘子","110/08/05","凱基-板橋",0,80,-80
"9483","6180橘子","110/08/05","新光",40,2,38
"9484","6180橘子","110/08/05","康和-高雄",0,40,-40
"9485","6180橘子","110/08/05","兆豐證券",33,0,33
"9486","6180橘子","110/08/05","合庫-鳳山",0,32,-32
"9487","6180橘子","110/08/05","中國信託-文心",15,0,15
"9488","6180橘子","110/08/05","日盛-頭份",1,24,-23
"9489","6180橘子","110/08/05","富邦-陽明",15,0,15
"9490","6180橘子","110/08/05","兆豐-新營",0,22,-22
"9491","6180橘子","110/08/05","元大-龍潭",11,0,11
"9492","6180橘子","110/08/05","元大-福營",0,20,-20
"9493","6180橘子","110/08/05","日盛-新竹",10,0,10
"9494","6180橘子","110/08/05","新加坡商瑞銀",0,19,-19
"9495","6180橘子","110/08/05","凱基-汐止",10,0,10
"9496","6180橘子","110/08/05","永豐金-新竹",0,17,-17
"9497","6180橘子","110/08/05","元大-中壢",10,1,9
"9498","6180橘子","110/08/05","第一金-新興",1,16,-15
"9499","6180橘子","110/08/05","元富-潮州",8,0,8
"9500","6180橘子","110/08/05","凱基-中壢",0,12,-12
"9501","6180橘子","110/08/05","大慶",7,0,7
"9502","6180橘子","110/08/05","光和",0,10,-10
"9503","6180橘子","110/08/05","台新證券",7,0,7
"9504","6180橘子","110/08/05","統一-中壢",0,9,-9
"9505","6180橘子","110/08/05","聯邦-雙和",7,0,7
"9506","6180橘子","110/08/05","富邦-基隆",0,9,-9
"9507","6180橘子","110/08/05","元大證券",7,0,7
"9508","6180橘子","110/08/05","台灣摩根士丹利",0,8,-8
"9509","6180橘子","110/08/05","國泰-新莊",6,0,6
"9510","6180橘子","110/08/05","康和-仁愛",0,8,-8
"9511","2390云辰","110/08/05","日盛證券",100,0,100
"9512","2390云辰","110/08/05","摩根大通",45,525,-480
"9513","2390云辰","110/08/05","兆豐-岡山",63,0,63
"9514","2390云辰","110/08/05","統一-新台中",62,177,-115
"9515","2390云辰","110/08/05","凱基-基隆",65,10,55
"9516","2390云辰","110/08/05","富邦-中壢",0,81,-81
"9517","2390云辰","110/08/05","凱基-中壢",52,3,49
"9518","2390云辰","110/08/05","元大-大甲",3,73,-70
"9519","2390云辰","110/08/05","台新-左楠",30,0,30
"9520","2390云辰","110/08/05","元大-樹林",16,53,-37
"9521","2390云辰","110/08/05","富邦-台北",33,6,27
"9522","2390云辰","110/08/05","元富-大裕",17,46,-29
"9523","2390云辰","110/08/05","統一-中壢",27,1,26
"9524","2390云辰","110/08/05","凱基-台中",1,30,-29
"9525","2390云辰","110/08/05","元大-和平",47,22,25
"9526","2390云辰","110/08/05","大慶-蘆洲",2,30,-28
"9527","2390云辰","110/08/05","統一-士林",26,2,24
"9528","2390云辰","110/08/05","元大-大統",3,31,-28
"9529","2390云辰","110/08/05","富邦-新營",23,0,23
"9530","2390云辰","110/08/05","臺銀-金山",1,27,-26
"9531","2390云辰","110/08/05","元大-景美",22,1,21
"9532","2390云辰","110/08/05","國泰-台中",0,23,-23
"9533","2390云辰","110/08/05","合庫-嘉義",20,0,20
"9534","2390云辰","110/08/05","富邦-岡山",0,23,-23
"9535","2390云辰","110/08/05","台灣企銀-嘉義",20,0,20
"9536","2390云辰","110/08/05","元大-土城學府",24,47,-23
"9537","2390云辰","110/08/05","日盛-板橋",21,1,20
"9538","2390云辰","110/08/05","台新-台中",28,50,-22
"9539","2390云辰","110/08/05","凱基-竹科",28,8,20
"9540","2390云辰","110/08/05","群益金鼎-鳳山",0,21,-21
"9541","1471首利","110/08/04","玉山-桃園",51,0,51
"9542","1471首利","110/08/04","國票-九鼎",0,60,-60
"9543","1471首利","110/08/04","華南永昌-潮州",50,1,49
"9544","1471首利","110/08/04","日盛-士林",0,20,-20
"9545","1471首利","110/08/04","瑞士信貸",33,3,30
"9546","1471首利","110/08/04","元大-博愛",4,24,-20
"9547","1471首利","110/08/04","兆豐-板橋",20,0,20
"9548","1471首利","110/08/04","群益金鼎-台中",1,20,-19
"9549","1471首利","110/08/04","兆豐-台中港",30,13,17
"9550","1471首利","110/08/04","國泰-高雄",0,16,-16
"9551","1471首利","110/08/04","富邦-基隆",16,0,16
"9552","1471首利","110/08/04","元大-台南",1,17,-16
"9553","1471首利","110/08/04","美林",15,0,15
"9554","1471首利","110/08/04","國泰-敦南",18,32,-14
"9555","1471首利","110/08/04","永豐金-員林",12,0,12
"9556","1471首利","110/08/04","新光",21,33,-12
"9557","1471首利","110/08/04","第一金-台南",11,0,11
"9558","1471首利","110/08/04","凱基-土城",0,12,-12
"9559","1471首利","110/08/04","德信-中正",12,1,11
"9560","1471首利","110/08/04","合庫-高雄",0,10,-10
"9561","1471首利","110/08/04","合庫-台中",10,0,10
"9562","1471首利","110/08/04","元富-宜蘭",0,10,-10
"9563","1471首利","110/08/04","國泰-新莊",10,0,10
"9564","1471首利","110/08/04","國泰-板橋",0,10,-10
"9565","1471首利","110/08/04","富邦-桃園",10,0,10
"9566","1471首利","110/08/04","群益金鼎-鳳山",0,10,-10
"9567","1471首利","110/08/04","元大-苗栗",10,0,10
"9568","1471首利","110/08/04","元大-東泰",0,10,-10
"9569","1471首利","110/08/04","玉山-左營",10,1,9
"9570","1471首利","110/08/04","元大-林園",0,10,-10
"9571","2883開發金","110/08/04","國泰證券",3650,0,3650
"9572","2883開發金","110/08/04","康和-仁愛",3,1737,-1734
"9573","2883開發金","110/08/04","統一",2763,29,2734
"9574","2883開發金","110/08/04","新加坡商瑞銀",356,1472,-1116
"9575","2883開發金","110/08/04","凱基-台北",2041,429,1612
"9576","2883開發金","110/08/04","豐農",5,1025,-1020
"9577","2883開發金","110/08/04","元富-城東",1602,26,1576
"9578","2883開發金","110/08/04","富邦-建國",271,1004,-733
"9579","2883開發金","110/08/04","元富",1190,0,1190
"9580","2883開發金","110/08/04","元大-北成功",6,608,-602
"9581","2883開發金","110/08/04","美商高盛",1033,355,678
"9582","2883開發金","110/08/04","台灣摩根士丹利",573,1019,-446
"9583","2883開發金","110/08/04","康和",661,6,655
"9584","2883開發金","110/08/04","台新-中壢",2,431,-429
"9585","2883開發金","110/08/04","國票-長城",504,8,496
"9586","2883開發金","110/08/04","凱基-和平",1,400,-399
"9587","2883開發金","110/08/04","元大-大灣",734,304,430
"9588","2883開發金","110/08/04","元大-蘆洲",7,370,-363
"9589","2883開發金","110/08/04","永豐金-板橋",500,100,400
"9590","2883開發金","110/08/04","元大-民生",10,370,-360
"9591","2883開發金","110/08/04","永豐金-台南",389,11,378
"9592","2883開發金","110/08/04","中國信託-中壢",1,321,-320
"9593","2883開發金","110/08/04","日盛證券",608,255,353
"9594","2883開發金","110/08/04","港商法國興業",0,291,-291
"9595","2883開發金","110/08/04","花旗環球",343,0,343
"9596","2883開發金","110/08/04","日盛-北高雄",20,309,-289
"9597","2883開發金","110/08/04","瑞士信貸",462,121,341
"9598","2883開發金","110/08/04","日盛-花蓮",11,250,-239
"9599","2883開發金","110/08/04","凱基",320,0,320
"9600","2883開發金","110/08/04","群益金鼎-東湖",10,243,-233
"9601","6205詮欣","110/08/04","摩根大通",18,0,18
"9602","6205詮欣","110/08/04","永豐金-敦南",16,36,-20
"9603","6205詮欣","110/08/04","臺銀-民權",5,0,5
"9604","6205詮欣","110/08/04","瑞士信貸",6,10,-4
"9605","6205詮欣","110/08/04","凱基-台北",4,0,4
"9606","6205詮欣","110/08/04","致和-高雄",0,4,-4
"9607","6205詮欣","110/08/04","元富-潮州",3,0,3
"9608","6205詮欣","110/08/04","群益金鼎-台南",0,3,-3
"9609","6205詮欣","110/08/04","台中銀",3,0,3
"9610","6205詮欣","110/08/04","元大-路竹",0,3,-3
"9611","6205詮欣","110/08/04","華南永昌",3,0,3
"9612","6205詮欣","110/08/04","元大-北成功",0,3,-3
"9613","6205詮欣","110/08/04","美林",2,0,2
"9614","6205詮欣","110/08/04","凱基-東門",0,2,-2
"9615","6205詮欣","110/08/04","元富-新店",2,0,2
"9616","6205詮欣","110/08/04","凱基-基隆",0,2,-2
"9617","6205詮欣","110/08/04","元大-羅東",2,0,2
"9618","6205詮欣","110/08/04","凱基-大安",0,2,-2
"9619","6205詮欣","110/08/04","元大-館前",2,0,2
"9620","6205詮欣","110/08/04","元大-土城學府",0,2,-2
"9621","6205詮欣","110/08/04","元大-楊梅",2,0,2
"9622","6205詮欣","110/08/04","元大-民生",0,2,-2
"9623","6205詮欣","110/08/04","元大-信義",2,0,2
"9624","6205詮欣","110/08/04","日盛-八德",0,1,-1
"9625","6205詮欣","110/08/04","永豐金-埔里",2,0,2
"9626","6205詮欣","110/08/04","宏遠-高雄",0,1,-1
"9627","6205詮欣","110/08/04","日盛-板橋",1,0,1
"9628","6205詮欣","110/08/04","新加坡商瑞銀",0,1,-1
"9629","6205詮欣","110/08/04","日盛-木柵",1,0,1
"9630","6205詮欣","110/08/04","第一金-華江",0,1,-1
"9631","1540喬福","110/08/04","元富-中原",58,0,58
"9632","1540喬福","110/08/04","元大-大天母",0,60,-60
"9633","1540喬福","110/08/04","(牛牛牛)亞-鑫豐",26,0,26
"9634","1540喬福","110/08/04","統一-新台中",0,18,-18
"9635","1540喬福","110/08/04","國泰-敦南",10,0,10
"9636","1540喬福","110/08/04","群益金鼎-士林",0,7,-7
"9637","1540喬福","110/08/04","富邦-南屯",10,0,10
"9638","1540喬福","110/08/04","兆豐-北高雄",0,6,-6
"9639","1540喬福","110/08/04","兆豐-鹿港",3,0,3
"9640","1540喬福","110/08/04","凱基-市政",0,5,-5
"9641","1540喬福","110/08/04","元大-土城永寧",2,0,2
"9642","1540喬福","110/08/04","亞東-高雄",0,4,-4
"9643","1540喬福","110/08/04","第一金-桃園",1,0,1
"9644","1540喬福","110/08/04","永豐金-大園",0,4,-4
"9645","1540喬福","110/08/04","兆豐-高雄",1,0,1
"9646","1540喬福","110/08/04","永豐金-豐原",0,2,-2
"9647","1540喬福","110/08/04","元大-苑裡",1,0,1
"9648","1540喬福","110/08/04","兆豐-三重",0,1,-1
"9649","1540喬福","110/08/04","臺銀-鳳山",0,0,0
"9650","1540喬福","110/08/04","致和-南京",0,1,-1
"9651","1540喬福","110/08/04","大慶",0,0,0
"9652","1540喬福","110/08/04","國票-嘉義",0,1,-1
"9653","1540喬福","110/08/04","元富-信義",0,0,0
"9654","1540喬福","110/08/04","兆豐-嘉義",0,1,-1
"9655","1540喬福","110/08/04","德信-新營",1,1,0
"9656","1540喬福","110/08/04","華南永昌-林口",0,1,-1
"9657","1540喬福","110/08/04","國票-台中",1,1,0
"9658","1540喬福","110/08/04","華南永昌-潮州",0,1,-1
"9659","1540喬福","110/08/04","康和-板橋",0,0,0
"9660","1540喬福","110/08/04","國票-台中",1,1,0
"9661","2888新光金","110/08/04","港商麥格理",2490,0,2490
"9662","2888新光金","110/08/04","永豐金-苓雅",2,1543,-1541
"9663","2888新光金","110/08/04","凱基-八德",1000,1,999
"9664","2888新光金","110/08/04","美商高盛",196,1441,-1245
"9665","2888新光金","110/08/04","新光",1122,247,875
"9666","2888新光金","110/08/04","台灣摩根士丹利",724,1776,-1052
"9667","2888新光金","110/08/04","國票-桃園",1200,402,798
"9668","2888新光金","110/08/04","摩根大通",616,1665,-1049
"9669","2888新光金","110/08/04","華南永昌-南京",759,36,723
"9670","2888新光金","110/08/04","康和-台中",0,680,-680
"9671","2888新光金","110/08/04","港商法國興業",568,0,568
"9672","2888新光金","110/08/04","群益金鼎-高雄",0,533,-533
"9673","2888新光金","110/08/04","花旗環球",559,0,559
"9674","2888新光金","110/08/04","亞東",34,531,-497
"9675","2888新光金","110/08/04","法銀巴黎",801,242,559
"9676","2888新光金","110/08/04","群益金鼎-土城",25,464,-439
"9677","2888新光金","110/08/04","凱基-台北",889,355,534
"9678","2888新光金","110/08/04","國票-北高雄",2,425,-423
"9679","2888新光金","110/08/04","統一-松江",500,0,500
"9680","2888新光金","110/08/04","凱基-台南",0,400,-400
"9681","2888新光金","110/08/04","華南永昌-長虹",345,0,345
"9682","2888新光金","110/08/04","新加坡商瑞銀",128,486,-358
"9683","2888新光金","110/08/04","美林",884,551,333
"9684","2888新光金","110/08/04","統一-屏東",0,344,-344
"9685","2888新光金","110/08/04","群益金鼎-中壢",301,3,298
"9686","2888新光金","110/08/04","統一-宜蘭",8,326,-318
"9687","2888新光金","110/08/04","群益金鼎",278,0,278
"9688","2888新光金","110/08/04","群益金鼎-萬華",0,284,-284
"9689","2888新光金","110/08/04","元大-北投",249,5,244
"9690","2888新光金","110/08/04","富邦-仁愛",10,276,-266
"9691","1340勝悅","110/08/04","第一金-新竹",10,0,10
"9692","1340勝悅","110/08/04","中國信託",0,23,-23
"9693","1340勝悅","110/08/04","凱基-虎尾",8,0,8
"9694","1340勝悅","110/08/04","永豐金-潮州",0,19,-19
"9695","1340勝悅","110/08/04","凱基-台中",6,0,6
"9696","1340勝悅","110/08/04","元富-花蓮",0,10,-10
"9697","1340勝悅","110/08/04","臺灣企銀-埔墘",5,0,5
"9698","1340勝悅","110/08/04","中國信託-永康",0,10,-10
"9699","1340勝悅","110/08/04","第一金",5,0,5
"9700","1340勝悅","110/08/04","第一金-中壢",0,7,-7
"9701","1340勝悅","110/08/04","凱基-八德",5,0,5
"9702","1340勝悅","110/08/04","高橋-中壢",0,5,-5
"9703","1340勝悅","110/08/04","永豐金-博愛",5,0,5
"9704","1340勝悅","110/08/04","富邦-新店",0,5,-5
"9705","1340勝悅","110/08/04","摩根大通",6,2,4
"9706","1340勝悅","110/08/04","台新-高雄",0,4,-4
"9707","1340勝悅","110/08/04","凱基-三重",4,0,4
"9708","1340勝悅","110/08/04","新光",0,4,-4
"9709","1340勝悅","110/08/04","統一-城中",7,4,3
"9710","1340勝悅","110/08/04","兆豐-松德",0,2,-2
"9711","1340勝悅","110/08/04","群益金鼎-館前",3,0,3
"9712","1340勝悅","110/08/04","凱基-嘉義",0,2,-2
"9713","1340勝悅","110/08/04","元大-南京",3,0,3
"9714","1340勝悅","110/08/04","富邦-宜蘭",0,2,-2
"9715","1340勝悅","110/08/04","瑞士信貸",2,0,2
"9716","1340勝悅","110/08/04","永豐金-永康",0,2,-2
"9717","1340勝悅","110/08/04","大慶-富順",2,0,2
"9718","1340勝悅","110/08/04","永豐金-嘉義",0,2,-2
"9719","1340勝悅","110/08/04","國泰-高雄",2,0,2
"9720","1340勝悅","110/08/04","玉山證券",0,1,-1
"9721","6246臺龍","110/08/04","統一",347,0,347
"9722","6246臺龍","110/08/04","大慶-富順",0,168,-168
"9723","6246臺龍","110/08/04","元大-西螺",30,0,30
"9724","6246臺龍","110/08/04","元大-善化",1,91,-90
"9725","6246臺龍","110/08/04","華南永昌-嘉義",26,0,26
"9726","6246臺龍","110/08/04","新光-高雄",2,75,-73
"9727","6246臺龍","110/08/04","中國信託-永康",31,9,22
"9728","6246臺龍","110/08/04","元大-永春",1,40,-39
"9729","6246臺龍","110/08/04","元大-西屯",25,4,21
"9730","6246臺龍","110/08/04","元大-基隆孝二",1,35,-34
"9731","6246臺龍","110/08/04","凱基-竹科",23,3,20
"9732","6246臺龍","110/08/04","凱基-復興",10,43,-33
"9733","6246臺龍","110/08/04","凱基-大直",19,0,19
"9734","6246臺龍","110/08/04","國泰-台中",3,34,-31
"9735","6246臺龍","110/08/04","第一金-台南",18,0,18
"9736","6246臺龍","110/08/04","統一-屏東",0,26,-26
"9737","6246臺龍","110/08/04","萬泰",15,0,15
"9738","6246臺龍","110/08/04","台灣企銀-台南",1,25,-24
"9739","6246臺龍","110/08/04","華南永昌-台中",15,0,15
"9740","6246臺龍","110/08/04","宏遠-民生",0,22,-22
"9741","6246臺龍","110/08/04","凱基-板橋",13,0,13
"9742","6246臺龍","110/08/04","兆豐-來福",0,20,-20
"9743","6246臺龍","110/08/04","宏遠-高雄",12,0,12
"9744","6246臺龍","110/08/04","永豐金-市政",0,17,-17
"9745","6246臺龍","110/08/04","新光-台中",11,0,11
"9746","6246臺龍","110/08/04","台新-台中",5,21,-16
"9747","6246臺龍","110/08/04","玉山證券",13,2,11
"9748","6246臺龍","110/08/04","華南永昌-彰化",1,16,-15
"9749","6246臺龍","110/08/04","永豐金-高雄",12,1,11
"9750","6246臺龍","110/08/04","元大-博愛",13,28,-15
"9751","00715L期街口布蘭特正2","110/08/04","宏遠-高雄",1056,0,1056
"9752","00715L期街口布蘭特正2","110/08/04","元大證券",1348,7345,-5997
"9753","00715L期街口布蘭特正2","110/08/04","凱基-豐中",576,0,576
"9754","00715L期街口布蘭特正2","110/08/04","凱基-台北",37,5749,-5712
"9755","00715L期街口布蘭特正2","110/08/04","富邦-基隆",467,0,467
"9756","00715L期街口布蘭特正2","110/08/04","富邦證券",253,2075,-1822
"9757","00715L期街口布蘭特正2","110/08/04","國泰-板橋",470,30,440
"9758","00715L期街口布蘭特正2","110/08/04","第一金-頭份",11,400,-389
"9759","00715L期街口布蘭特正2","110/08/04","統一-高雄",358,3,355
"9760","00715L期街口布蘭特正2","110/08/04","富邦-永和",4,376,-372
"9761","00715L期街口布蘭特正2","110/08/04","中國信託-永康",219,1,218
"9762","00715L期街口布蘭特正2","110/08/04","永豐金-新店",0,370,-370
"9763","00715L期街口布蘭特正2","110/08/04","元大-中和",217,0,217
"9764","00715L期街口布蘭特正2","110/08/04","元富",53,412,-359
"9765","00715L期街口布蘭特正2","110/08/04","日盛-花蓮",201,1,200
"9766","00715L期街口布蘭特正2","110/08/04","臺銀-民權",15,366,-351
"9767","00715L期街口布蘭特正2","110/08/04","元大-中壢",201,12,189
"9768","00715L期街口布蘭特正2","110/08/04","兆豐-新莊",0,300,-300
"9769","00715L期街口布蘭特正2","110/08/04","宏遠-桃園",190,2,188
"9770","00715L期街口布蘭特正2","110/08/04","大昌-新店",17,300,-283
"9771","00715L期街口布蘭特正2","110/08/04","玉山-大里",182,0,182
"9772","00715L期街口布蘭特正2","110/08/04","元大-西螺",87,303,-216
"9773","00715L期街口布蘭特正2","110/08/04","新光",258,80,178
"9774","00715L期街口布蘭特正2","110/08/04","華南永昌-高雄",7,206,-199
"9775","00715L期街口布蘭特正2","110/08/04","元大-花蓮",178,0,178
"9776","00715L期街口布蘭特正2","110/08/04","國票-台中",8,200,-192
"9777","00715L期街口布蘭特正2","110/08/04","新光-台中",242,68,174
"9778","00715L期街口布蘭特正2","110/08/04","群益金鼎-鳳山",12,174,-162
"9779","00715L期街口布蘭特正2","110/08/04","(牛牛牛)亞-網路",166,0,166
"9780","00715L期街口布蘭特正2","110/08/04","國泰-台南",8,150,-142
"9781","8941關中","110/08/04","宏遠-館前",3,0,3
"9782","8941關中","110/08/04","元大-基隆",0,3,-3
"9783","8941關中","110/08/04","日盛-和美",1,0,1
"9784","8941關中","110/08/04","富邦-員林",0,2,-2
"9785","8941關中","110/08/04","元大-華山",1,0,1
"9786","8941關中","110/08/04","新光-高雄",0,0,0
"9787","8941關中","110/08/04","新光-高雄",0,0,0
"9788","8941關中","110/08/04","國泰-高雄",0,0,0
"9789","8941關中","110/08/04","國泰-高雄",0,0,0
"9790","8941關中","110/08/04","富邦-建國",0,0,0
"9791","8941關中","110/08/04","富邦-建國",0,0,0
"9792","8941關中","110/08/04","元大-西屯",0,0,0
"9793","8941關中","110/08/04","元大-西屯",0,0,0
"9794","8941關中","110/08/04","元大-花蓮",0,0,0
"9795","8941關中","110/08/04","元大-花蓮",0,0,0
"9796","8941關中","110/08/04","永豐金-萬盛",0,0,0
"9797","8941關中","110/08/04","永豐金-萬盛",0,0,0
"9798","8941關中","110/08/04","",NA,NA,NA
"9799","8941關中","110/08/04","",NA,NA,NA
"9800","8941關中","110/08/04","",NA,NA,NA
"9801","8941關中","110/08/04","",NA,NA,NA
"9802","8941關中","110/08/04","",NA,NA,NA
"9803","8941關中","110/08/04","",NA,NA,NA
"9804","8941關中","110/08/04","",NA,NA,NA
"9805","8941關中","110/08/04","",NA,NA,NA
"9806","8941關中","110/08/04","",NA,NA,NA
"9807","8941關中","110/08/04","",NA,NA,NA
"9808","8941關中","110/08/04","",NA,NA,NA
"9809","8941關中","110/08/04","",NA,NA,NA
"9810","8941關中","110/08/04","",NA,NA,NA
"9811","8936國統","110/08/04","第一金-光復",120,0,120
"9812","8936國統","110/08/04","兆豐-彰化",0,61,-61
"9813","8936國統","110/08/04","美林",99,3,96
"9814","8936國統","110/08/04","凱基-台北",4,56,-52
"9815","8936國統","110/08/04","華南永昌-楠梓",70,5,65
"9816","8936國統","110/08/04","凱基-內埔",0,50,-50
"9817","8936國統","110/08/04","永豐金-高雄",62,0,62
"9818","8936國統","110/08/04","台灣摩根士丹利",0,42,-42
"9819","8936國統","110/08/04","國票-台南",60,0,60
"9820","8936國統","110/08/04","永豐金-苓雅",1,40,-39
"9821","8936國統","110/08/04","永豐金-台中",30,0,30
"9822","8936國統","110/08/04","群益金鼎-內湖",0,30,-30
"9823","8936國統","110/08/04","第一金-豐原",20,0,20
"9824","8936國統","110/08/04","國票-北高雄",0,20,-20
"9825","8936國統","110/08/04","玉山-高雄",13,0,13
"9826","8936國統","110/08/04","宏遠-館前",0,19,-19
"9827","8936國統","110/08/04","元大-莒光",11,0,11
"9828","8936國統","110/08/04","美商高盛",3,22,-19
"9829","8936國統","110/08/04","亞東-高雄",10,0,10
"9830","8936國統","110/08/04","元大-大里德芳",4,21,-17
"9831","8936國統","110/08/04","第一金-路竹",10,0,10
"9832","8936國統","110/08/04","第一金-高雄",0,14,-14
"9833","8936國統","110/08/04","新光-台中",8,1,7
"9834","8936國統","110/08/04","日盛-竹北",0,12,-12
"9835","8936國統","110/08/04","統一-三多",5,0,5
"9836","8936國統","110/08/04","亞東",0,12,-12
"9837","8936國統","110/08/04","國票-內壢",5,0,5
"9838","8936國統","110/08/04","摩根大通",32,44,-12
"9839","8936國統","110/08/04","新光",10,5,5
"9840","8936國統","110/08/04","第一金-嘉義",0,10,-10
"9841","6226光鼎","110/08/04","富邦-嘉義",1247,573,674
"9842","6226光鼎","110/08/04","國泰-敦南",89,234,-145
"9843","6226光鼎","110/08/04","永豐金-桃盛",205,0,205
"9844","6226光鼎","110/08/04","日盛-嘉義",0,131,-131
"9845","6226光鼎","110/08/04","台新-左楠",120,1,119
"9846","6226光鼎","110/08/04","群益金鼎-東大",35,150,-115
"9847","6226光鼎","110/08/04","群益金鼎-敦南",127,8,119
"9848","6226光鼎","110/08/04","台中銀-員林",0,101,-101
"9849","6226光鼎","110/08/04","台灣摩根士丹利",135,55,80
"9850","6226光鼎","110/08/04","玉山-雙和",2,97,-95
"9851","6226光鼎","110/08/04","華南永昌-南京",89,14,75
"9852","6226光鼎","110/08/04","台新證券",76,167,-91
"9853","6226光鼎","110/08/04","台新-台中",101,32,69
"9854","6226光鼎","110/08/04","華南永昌-頭份",7,86,-79
"9855","6226光鼎","110/08/04","宏遠-台中",60,3,57
"9856","6226光鼎","110/08/04","高橋",0,70,-70
"9857","6226光鼎","110/08/04","大昌",79,26,53
"9858","6226光鼎","110/08/04","國泰-館前",18,62,-44
"9859","6226光鼎","110/08/04","台新-新莊",54,2,52
"9860","6226光鼎","110/08/04","凱基-永和",0,43,-43
"9861","6226光鼎","110/08/04","群益金鼎-三民",51,3,48
"9862","6226光鼎","110/08/04","日盛-景美",0,38,-38
"9863","6226光鼎","110/08/04","中國信託-永康",62,18,44
"9864","6226光鼎","110/08/04","華南永昌-高雄",9,47,-38
"9865","6226光鼎","110/08/04","國票-台中",45,2,43
"9866","6226光鼎","110/08/04","元大-太平",6,44,-38
"9867","6226光鼎","110/08/04","統一-士林",44,4,40
"9868","6226光鼎","110/08/04","元大-北投",0,37,-37
"9869","6226光鼎","110/08/04","統一-仁愛",51,14,37
"9870","6226光鼎","110/08/04","元大-板橋",0,37,-37
"9871","2363矽統","110/08/04","富邦-中壢",628,138,490
"9872","2363矽統","110/08/04","新加坡商瑞銀",986,2541,-1555
"9873","2363矽統","110/08/04","凱基-台北",7207,6730,477
"9874","2363矽統","110/08/04","台灣摩根士丹利",158,1373,-1215
"9875","2363矽統","110/08/04","元大-承德",449,81,368
"9876","2363矽統","110/08/04","摩根大通",2506,3701,-1195
"9877","2363矽統","110/08/04","群益金鼎-高雄",438,99,339
"9878","2363矽統","110/08/04","日盛-文化",121,1226,-1105
"9879","2363矽統","110/08/04","元富-嘉義",383,57,326
"9880","2363矽統","110/08/04","美林",2013,2637,-624
"9881","2363矽統","110/08/04","元大-旗山",446,147,299
"9882","2363矽統","110/08/04","凱基-新莊",44,445,-401
"9883","2363矽統","110/08/04","大慶-台中",304,14,290
"9884","2363矽統","110/08/04","台新-松江",60,449,-389
"9885","2363矽統","110/08/04","國票-博愛",425,150,275
"9886","2363矽統","110/08/04","統一-士林",649,1031,-382
"9887","2363矽統","110/08/04","台新-台南",494,230,264
"9888","2363矽統","110/08/04","新光",1494,1876,-382
"9889","2363矽統","110/08/04","群益金鼎-內湖",393,135,258
"9890","2363矽統","110/08/04","華南永昌",691,1068,-377
"9891","2363矽統","110/08/04","群益金鼎-桃園",295,68,227
"9892","2363矽統","110/08/04","富邦-彰化",122,486,-364
"9893","2363矽統","110/08/04","永豐金-羅東",397,182,215
"9894","2363矽統","110/08/04","凱基-永和",198,478,-280
"9895","2363矽統","110/08/04","元大-永春",347,142,205
"9896","2363矽統","110/08/04","富邦-嘉義",1358,1619,-261
"9897","2363矽統","110/08/04","台新-屏東",466,275,191
"9898","2363矽統","110/08/04","元大-前金",175,419,-244
"9899","2363矽統","110/08/04","元大-萬華",286,96,190
"9900","2363矽統","110/08/04","凱基-大直",681,912,-231
"9901","8112至上","110/08/04","台灣匯立證券",138,0,138
"9902","8112至上","110/08/04","日盛-高雄",1,355,-354
"9903","8112至上","110/08/04","元富-新興",94,8,86
"9904","8112至上","110/08/04","玉山-士林",0,150,-150
"9905","8112至上","110/08/04","合庫-西台中",55,7,48
"9906","8112至上","110/08/04","台灣摩根士丹利",20,143,-123
"9907","8112至上","110/08/04","摩根大通",145,97,48
"9908","8112至上","110/08/04","元富-大昌",0,120,-120
"9909","8112至上","110/08/04","台新證券",48,1,47
"9910","8112至上","110/08/04","華南永昌-林口",1,90,-89
"9911","8112至上","110/08/04","第一金-高雄",40,0,40
"9912","8112至上","110/08/04","元大-北屯",1,70,-69
"9913","8112至上","110/08/04","群益金鼎-大安",40,0,40
"9914","8112至上","110/08/04","凱基-台北",140,206,-66
"9915","8112至上","110/08/04","日盛-新竹",60,26,34
"9916","8112至上","110/08/04","新加坡商瑞銀",16,68,-52
"9917","8112至上","110/08/04","美林",69,38,31
"9918","8112至上","110/08/04","第一金-自由",0,50,-50
"9919","8112至上","110/08/04","凱基-虎尾",30,0,30
"9920","8112至上","110/08/04","康和-內湖",0,34,-34
"9921","8112至上","110/08/04","永豐金-台南",32,2,30
"9922","8112至上","110/08/04","聯邦商銀",0,34,-34
"9923","8112至上","110/08/04","港商野村",30,1,29
"9924","8112至上","110/08/04","臺銀-鳳山",0,28,-28
"9925","8112至上","110/08/04","國泰-館前",29,5,24
"9926","8112至上","110/08/04","兆豐-公益",0,28,-28
"9927","8112至上","110/08/04","元富-佳里",21,0,21
"9928","8112至上","110/08/04","元大-崇德",0,21,-21
"9929","8112至上","110/08/04","日進",20,0,20
"9930","8112至上","110/08/04","元大-土城永寧",0,20,-20
"9931","1570力肯","110/08/04","摩根大通",330,27,303
"9932","1570力肯","110/08/04","元大-板橋",0,86,-86
"9933","1570力肯","110/08/04","統一",224,0,224
"9934","1570力肯","110/08/04","群益金鼎-忠孝",0,80,-80
"9935","1570力肯","110/08/04","富邦-台中",84,1,83
"9936","1570力肯","110/08/04","元富-緯城",0,51,-51
"9937","1570力肯","110/08/04","統一-土城",287,222,65
"9938","1570力肯","110/08/04","國票-和平",0,51,-51
"9939","1570力肯","110/08/04","群益金鼎-中壢",60,0,60
"9940","1570力肯","110/08/04","日盛-二林",0,43,-43
"9941","1570力肯","110/08/04","富邦-高雄",69,10,59
"9942","1570力肯","110/08/04","國泰-板橋",0,43,-43
"9943","1570力肯","110/08/04","統一-屏東",61,4,57
"9944","1570力肯","110/08/04","元大-新莊",1,44,-43
"9945","1570力肯","110/08/04","凱基-岡山",53,1,52
"9946","1570力肯","110/08/04","凱基-嘉義",0,42,-42
"9947","1570力肯","110/08/04","新光-台中",43,12,31
"9948","1570力肯","110/08/04","華南永昌-鳳山",2,42,-40
"9949","1570力肯","110/08/04","台中銀-員林",30,1,29
"9950","1570力肯","110/08/04","凱基-三峽",0,37,-37
"9951","1570力肯","110/08/04","元富-三重",37,12,25
"9952","1570力肯","110/08/04","國票-中正",0,36,-36
"9953","1570力肯","110/08/04","統一-新台中",30,6,24
"9954","1570力肯","110/08/04","高橋",0,30,-30
"9955","1570力肯","110/08/04","致和-府前",25,1,24
"9956","1570力肯","110/08/04","日盛-高雄",0,29,-29
"9957","1570力肯","110/08/04","凱基-中港",22,0,22
"9958","1570力肯","110/08/04","(牛牛牛)亞-鑫豐",6,29,-23
"9959","1570力肯","110/08/04","宏遠證券",20,0,20
"9960","1570力肯","110/08/04","元富-松德",1,22,-21
"9961","2929淘帝","110/08/04","兆豐-忠孝",23,0,23
"9962","2929淘帝","110/08/04","美林",12,107,-95
"9963","2929淘帝","110/08/04","華南永昌-長虹",21,0,21
"9964","2929淘帝","110/08/04","兆豐-新莊",0,94,-94
"9965","2929淘帝","110/08/04","兆豐-桃園",20,0,20
"9966","2929淘帝","110/08/04","富邦-北港",0,30,-30
"9967","2929淘帝","110/08/04","新加坡商瑞銀",34,18,16
"9968","2929淘帝","110/08/04","永興-水湳",0,20,-20
"9969","2929淘帝","110/08/04","凱基-林口",15,0,15
"9970","2929淘帝","110/08/04","兆豐-復興",0,20,-20
"9971","2929淘帝","110/08/04","富邦-竹東",17,5,12
"9972","2929淘帝","110/08/04","國泰-高雄",1,15,-14
"9973","2929淘帝","110/08/04","台新-建北",11,0,11
"9974","2929淘帝","110/08/04","元大-上新莊",0,14,-14
"9975","2929淘帝","110/08/04","凱基-豐中",11,0,11
"9976","2929淘帝","110/08/04","凱基-敦北",0,11,-11
"9977","2929淘帝","110/08/04","統一-汐止",10,0,10
"9978","2929淘帝","110/08/04","臺銀-金山",0,10,-10
"9979","2929淘帝","110/08/04","新百王",10,0,10
"9980","2929淘帝","110/08/04","日盛-斗六",0,10,-10
"9981","2929淘帝","110/08/04","凱基-台北",16,6,10
"9982","2929淘帝","110/08/04","港商野村",16,26,-10
"9983","2929淘帝","110/08/04","華南永昌-苗栗",10,0,10
"9984","2929淘帝","110/08/04","第一金-自由",0,10,-10
"9985","2929淘帝","110/08/04","富邦-板橋",10,0,10
"9986","2929淘帝","110/08/04","玉山-台南",0,10,-10
"9987","2929淘帝","110/08/04","元大-路竹",10,0,10
"9988","2929淘帝","110/08/04","凱基-五股",0,10,-10
"9989","2929淘帝","110/08/04","元大-東蘆",10,0,10
"9990","2929淘帝","110/08/04","華南永昌-楠梓",0,10,-10
"9991","5410國眾","110/08/04","永豐金-內湖",100,1,99
"9992","5410國眾","110/08/04","群益金鼎-內湖",0,46,-46
"9993","5410國眾","110/08/04","永豐金-板新",36,0,36
"9994","5410國眾","110/08/04","新光",2,36,-34
"9995","5410國眾","110/08/04","兆豐-城中",27,0,27
"9996","5410國眾","110/08/04","元富-嘉義",0,20,-20
"9997","5410國眾","110/08/04","凱基-竹北",10,0,10
"9998","5410國眾","110/08/04","元大-博愛",0,20,-20
"9999","5410國眾","110/08/04","新光-高雄",9,0,9
"10000","5410國眾","110/08/04","永豐金-彰化",0,20,-20
"10001","5410國眾","110/08/04","兆豐-北高雄",8,0,8
"10002","5410國眾","110/08/04","元大-斗信",0,11,-11
"10003","5410國眾","110/08/04","元富-三重",9,3,6
"10004","5410國眾","110/08/04","統一-平鎮",0,10,-10
"10005","5410國眾","110/08/04","台新證券",7,1,6
"10006","5410國眾","110/08/04","元大-台北",0,10,-10
"10007","5410國眾","110/08/04","元大-中壢",10,4,6
"10008","5410國眾","110/08/04","元大-大灣",0,10,-10
"10009","5410國眾","110/08/04","北城證券",5,0,5
"10010","5410國眾","110/08/04","元大-前金",0,9,-9
"10011","5410國眾","110/08/04","國票-和平",5,0,5
"10012","5410國眾","110/08/04","致和證券",0,8,-8
"10013","5410國眾","110/08/04","元大-新盛",5,0,5
"10014","5410國眾","110/08/04","元大-崇德",0,7,-7
"10015","5410國眾","110/08/04","永豐金-中盛",5,0,5
"10016","5410國眾","110/08/04","臺銀-鳳山",0,6,-6
"10017","5410國眾","110/08/04","永豐金-桃園",5,0,5
"10018","5410國眾","110/08/04","玉山-左營",0,6,-6
"10019","5410國眾","110/08/04","凱基-台北",7,3,4
"10020","5410國眾","110/08/04","富邦-台中",0,6,-6
"10021","2841台開","110/08/04","永豐金-敦南",1166,0,1166
"10022","2841台開","110/08/04","統一-三重",0,943,-943
"10023","2841台開","110/08/04","永豐金-鳳山",206,50,156
"10024","2841台開","110/08/04","群益金鼎-東大",0,250,-250
"10025","2841台開","110/08/04","凱基-文心",136,0,136
"10026","2841台開","110/08/04","元富-城東",5,250,-245
"10027","2841台開","110/08/04","國泰-敦南",135,7,128
"10028","2841台開","110/08/04","元大-大灣",16,200,-184
"10029","2841台開","110/08/04","新光",109,4,105
"10030","2841台開","110/08/04","元大-新店中正",0,128,-128
"10031","2841台開","110/08/04","日盛-信義",102,0,102
"10032","2841台開","110/08/04","兆豐-麻豆",0,120,-120
"10033","2841台開","110/08/04","兆豐-東門",100,0,100
"10034","2841台開","110/08/04","土銀",0,100,-100
"10035","2841台開","110/08/04","台新-三民",100,0,100
"10036","2841台開","110/08/04","臺銀",0,100,-100
"10037","2841台開","110/08/04","群益金鼎-海山",100,0,100
"10038","2841台開","110/08/04","富邦-新店",4,90,-86
"10039","2841台開","110/08/04","國泰-板橋",106,13,93
"10040","2841台開","110/08/04","合庫-台中",23,104,-81
"10041","2841台開","110/08/04","永豐金-彰化",100,10,90
"10042","2841台開","110/08/04","統一-高雄",0,77,-77
"10043","2841台開","110/08/04","永豐金-萬盛",101,16,85
"10044","2841台開","110/08/04","群益金鼎-屏東",0,75,-75
"10045","2841台開","110/08/04","國票-天祥",80,0,80
"10046","2841台開","110/08/04","中國信託-高雄",2,70,-68
"10047","2841台開","110/08/04","群益金鼎-崇德",84,5,79
"10048","2841台開","110/08/04","凱基-三峽",0,61,-61
"10049","2841台開","110/08/04","群益金鼎-館前",82,3,79
"10050","2841台開","110/08/04","統一-彰化",0,60,-60
"10051","6207雷科","110/08/04","凱基-羅東",80,1,79
"10052","6207雷科","110/08/04","凱基-板橋",1,213,-212
"10053","6207雷科","110/08/04","元大-鳳山",76,2,74
"10054","6207雷科","110/08/04","摩根大通",105,209,-104
"10055","6207雷科","110/08/04","凱基-台南",37,1,36
"10056","6207雷科","110/08/04","凱基-台北",22,122,-100
"10057","6207雷科","110/08/04","富邦-竹東",35,0,35
"10058","6207雷科","110/08/04","華南永昌",12,100,-88
"10059","6207雷科","110/08/04","群益金鼎-東門",31,4,27
"10060","6207雷科","110/08/04","統一-高雄",3,74,-71
"10061","6207雷科","110/08/04","新光-高雄",30,4,26
"10062","6207雷科","110/08/04","群益金鼎-大興",0,70,-70
"10063","6207雷科","110/08/04","大慶-蘆洲",21,0,21
"10064","6207雷科","110/08/04","日盛-忠孝",0,62,-62
"10065","6207雷科","110/08/04","瑞士信貸",20,0,20
"10066","6207雷科","110/08/04","富邦-台中",0,50,-50
"10067","6207雷科","110/08/04","元大-羅東",20,0,20
"10068","6207雷科","110/08/04","永豐金-內湖",0,50,-50
"10069","6207雷科","110/08/04","群益金鼎-南京",20,2,18
"10070","6207雷科","110/08/04","美林",3,47,-44
"10071","6207雷科","110/08/04","元大-汐止",16,0,16
"10072","6207雷科","110/08/04","元富-大昌",0,40,-40
"10073","6207雷科","110/08/04","兆豐-來福",15,0,15
"10074","6207雷科","110/08/04","兆豐-景美",2,40,-38
"10075","6207雷科","110/08/04","國泰-敦南",21,6,15
"10076","6207雷科","110/08/04","新加坡商瑞銀",12,49,-37
"10077","6207雷科","110/08/04","永豐金-台中",15,0,15
"10078","6207雷科","110/08/04","群益金鼎-古亭",2,24,-22
"10079","6207雷科","110/08/04","元大-沙鹿",14,0,14
"10080","6207雷科","110/08/04","華南永昌-虎尾",0,21,-21
"10081","3679新至陞","110/08/04","凱基-台北",27,0,27
"10082","3679新至陞","110/08/04","香港上海匯豐",0,12,-12
"10083","3679新至陞","110/08/04","港商法國興業",20,0,20
"10084","3679新至陞","110/08/04","台灣摩根士丹利",0,10,-10
"10085","3679新至陞","110/08/04","新加坡商瑞銀",13,0,13
"10086","3679新至陞","110/08/04","港商野村",0,8,-8
"10087","3679新至陞","110/08/04","(牛牛牛)亞-網路",11,0,11
"10088","3679新至陞","110/08/04","玉山證券",2,9,-7
"10089","3679新至陞","110/08/04","摩根大通",9,4,5
"10090","3679新至陞","110/08/04","富邦-陽明",0,6,-6
"10091","3679新至陞","110/08/04","國泰-敦南",6,2,4
"10092","3679新至陞","110/08/04","統一",0,5,-5
"10093","3679新至陞","110/08/04","土銀-和平",3,0,3
"10094","3679新至陞","110/08/04","華南永昌-淡水",0,5,-5
"10095","3679新至陞","110/08/04","台中銀-員林",3,0,3
"10096","3679新至陞","110/08/04","元大-成功",0,5,-5
"10097","3679新至陞","110/08/04","元大-永春",3,0,3
"10098","3679新至陞","110/08/04","群益金鼎-內湖",0,4,-4
"10099","3679新至陞","110/08/04","國票-台東",2,0,2
"10100","3679新至陞","110/08/04","國泰-館前",0,3,-3
"10101","3679新至陞","110/08/04","富邦-新店",2,0,2
"10102","3679新至陞","110/08/04","凱基-板橋",0,3,-3
"10103","3679新至陞","110/08/04","富邦-三重",2,0,2
"10104","3679新至陞","110/08/04","凱基-三峽",0,3,-3
"10105","3679新至陞","110/08/04","元大-板橋三民",2,0,2
"10106","3679新至陞","110/08/04","凱基-中山",0,3,-3
"10107","3679新至陞","110/08/04","永豐金-敦南",2,0,2
"10108","3679新至陞","110/08/04","元大-承德",1,4,-3
"10109","3679新至陞","110/08/04","大昌-新店",1,0,1
"10110","3679新至陞","110/08/04","元大-大同",0,3,-3
"10111","2727王品","110/08/04","元富",46,0,46
"10112","2727王品","110/08/04","台灣摩根士丹利",20,277,-257
"10113","2727王品","110/08/04","台新證券",36,7,29
"10114","2727王品","110/08/04","群益金鼎-三民",2,104,-102
"10115","2727王品","110/08/04","國泰-敦南",42,13,29
"10116","2727王品","110/08/04","第一金",1,102,-101
"10117","2727王品","110/08/04","國泰-台中",19,2,17
"10118","2727王品","110/08/04","元大-東蘆",1,45,-44
"10119","2727王品","110/08/04","華南永昌-虎尾",13,0,13
"10120","2727王品","110/08/04","新光-台中",10,43,-33
"10121","2727王品","110/08/04","凱基-五股",11,0,11
"10122","2727王品","110/08/04","新光-桃園",9,42,-33
"10123","2727王品","110/08/04","國泰-館前",16,6,10
"10124","2727王品","110/08/04","凱基-興隆",1,21,-20
"10125","2727王品","110/08/04","凱基-基隆",10,0,10
"10126","2727王品","110/08/04","元大-龍潭",6,23,-17
"10127","2727王品","110/08/04","凱基-南崁",10,0,10
"10128","2727王品","110/08/04","日盛-士林",0,15,-15
"10129","2727王品","110/08/04","富邦-台北",12,2,10
"10130","2727王品","110/08/04","凱基-天母",0,15,-15
"10131","2727王品","110/08/04","新光",34,25,9
"10132","2727王品","110/08/04","日盛-台中",4,15,-11
"10133","2727王品","110/08/04","玉山證券",12,3,9
"10134","2727王品","110/08/04","永豐金-信義",1,12,-11
"10135","2727王品","110/08/04","國泰-高雄",10,2,8
"10136","2727王品","110/08/04","新加坡商瑞銀",2,12,-10
"10137","2727王品","110/08/04","群益金鼎-宜蘭",8,0,8
"10138","2727王品","110/08/04","元大-豐原",0,10,-10
"10139","2727王品","110/08/04","國泰-台南",7,0,7
"10140","2727王品","110/08/04","元大-樹林",1,11,-10
"10141","1570力肯","110/08/04","摩根大通",330,27,303
"10142","1570力肯","110/08/04","元大-板橋",0,86,-86
"10143","1570力肯","110/08/04","統一",224,0,224
"10144","1570力肯","110/08/04","群益金鼎-忠孝",0,80,-80
"10145","1570力肯","110/08/04","富邦-台中",84,1,83
"10146","1570力肯","110/08/04","元富-緯城",0,51,-51
"10147","1570力肯","110/08/04","統一-土城",287,222,65
"10148","1570力肯","110/08/04","國票-和平",0,51,-51
"10149","1570力肯","110/08/04","群益金鼎-中壢",60,0,60
"10150","1570力肯","110/08/04","日盛-二林",0,43,-43
"10151","1570力肯","110/08/04","富邦-高雄",69,10,59
"10152","1570力肯","110/08/04","國泰-板橋",0,43,-43
"10153","1570力肯","110/08/04","統一-屏東",61,4,57
"10154","1570力肯","110/08/04","元大-新莊",1,44,-43
"10155","1570力肯","110/08/04","凱基-岡山",53,1,52
"10156","1570力肯","110/08/04","凱基-嘉義",0,42,-42
"10157","1570力肯","110/08/04","新光-台中",43,12,31
"10158","1570力肯","110/08/04","華南永昌-鳳山",2,42,-40
"10159","1570力肯","110/08/04","台中銀-員林",30,1,29
"10160","1570力肯","110/08/04","凱基-三峽",0,37,-37
"10161","1570力肯","110/08/04","元富-三重",37,12,25
"10162","1570力肯","110/08/04","國票-中正",0,36,-36
"10163","1570力肯","110/08/04","統一-新台中",30,6,24
"10164","1570力肯","110/08/04","高橋",0,30,-30
"10165","1570力肯","110/08/04","致和-府前",25,1,24
"10166","1570力肯","110/08/04","日盛-高雄",0,29,-29
"10167","1570力肯","110/08/04","凱基-中港",22,0,22
"10168","1570力肯","110/08/04","(牛牛牛)亞-鑫豐",6,29,-23
"10169","1570力肯","110/08/04","宏遠證券",20,0,20
"10170","1570力肯","110/08/04","元富-松德",1,22,-21
"10171","6180橘子","110/08/04","新光",67,10,57
"10172","6180橘子","110/08/04","群益金鼎-桃園",0,30,-30
"10173","6180橘子","110/08/04","美林",15,0,15
"10174","6180橘子","110/08/04","華南永昌-苑裡",0,30,-30
"10175","6180橘子","110/08/04","第一金-中山",15,1,14
"10176","6180橘子","110/08/04","台灣摩根士丹利",0,19,-19
"10177","6180橘子","110/08/04","日盛-台中",10,0,10
"10178","6180橘子","110/08/04","台新-三民",0,16,-16
"10179","6180橘子","110/08/04","新光-桃園",10,0,10
"10180","6180橘子","110/08/04","群益金鼎-士林",0,13,-13
"10181","6180橘子","110/08/04","康和",9,0,9
"10182","6180橘子","110/08/04","群益金鼎-中港",0,11,-11
"10183","6180橘子","110/08/04","富邦-羅東",8,0,8
"10184","6180橘子","110/08/04","新加坡商瑞銀",0,10,-10
"10185","6180橘子","110/08/04","國票-九鼎",7,0,7
"10186","6180橘子","110/08/04","統一-彰化",0,10,-10
"10187","6180橘子","110/08/04","玉山-桃園",7,0,7
"10188","6180橘子","110/08/04","兆豐-埔墘",0,10,-10
"10189","6180橘子","110/08/04","元大-員林中山",7,0,7
"10190","6180橘子","110/08/04","摩根大通",3,13,-10
"10191","6180橘子","110/08/04","瑞士信貸",6,0,6
"10192","6180橘子","110/08/04","康和-延平",0,10,-10
"10193","6180橘子","110/08/04","富邦-新竹",7,1,6
"10194","6180橘子","110/08/04","大昌-安康",0,9,-9
"10195","6180橘子","110/08/04","富邦-宜蘭",6,0,6
"10196","6180橘子","110/08/04","富邦-仁愛",1,10,-9
"10197","6180橘子","110/08/04","統一-嘉義",5,0,5
"10198","6180橘子","110/08/04","花旗環球",0,8,-8
"10199","6180橘子","110/08/04","富邦-陽明",5,0,5
"10200","6180橘子","110/08/04","福勝",0,8,-8
"10201","2390云辰","110/08/04","元富-吉利",71,6,65
"10202","2390云辰","110/08/04","港商野村",180,422,-242
"10203","2390云辰","110/08/04","兆豐-新營",53,4,49
"10204","2390云辰","110/08/04","凱基-台北",75,264,-189
"10205","2390云辰","110/08/04","台新證券",83,37,46
"10206","2390云辰","110/08/04","美林",32,132,-100
"10207","2390云辰","110/08/04","日盛-新莊",53,12,41
"10208","2390云辰","110/08/04","華南永昌-鳳山",82,181,-99
"10209","2390云辰","110/08/04","兆豐-岡山",40,0,40
"10210","2390云辰","110/08/04","日盛-園區",1,91,-90
"10211","2390云辰","110/08/04","元大-新莊",42,6,36
"10212","2390云辰","110/08/04","統一-城中",3,82,-79
"10213","2390云辰","110/08/04","永豐金-鳳山",37,3,34
"10214","2390云辰","110/08/04","第一金-中壢",0,73,-73
"10215","2390云辰","110/08/04","德信-新營",37,4,33
"10216","2390云辰","110/08/04","元大-忠孝",8,74,-66
"10217","2390云辰","110/08/04","群益金鼎-三民",35,2,33
"10218","2390云辰","110/08/04","凱基-竹科",6,67,-61
"10219","2390云辰","110/08/04","玉山-雙和",39,7,32
"10220","2390云辰","110/08/04","統一-屏東",0,51,-51
"10221","2390云辰","110/08/04","凱基-三重",33,3,30
"10222","2390云辰","110/08/04","富邦-新店",2,50,-48
"10223","2390云辰","110/08/04","華南永昌-朴子",35,6,29
"10224","2390云辰","110/08/04","元富-大裕",21,56,-35
"10225","2390云辰","110/08/04","國票-和平",29,1,28
"10226","2390云辰","110/08/04","永豐金-三重",6,41,-35
"10227","2390云辰","110/08/04","元大-東蘆",31,3,28
"10228","2390云辰","110/08/04","臺銀",15,47,-32
"10229","2390云辰","110/08/04","日茂",59,33,26
"10230","2390云辰","110/08/04","凱基-台中",1,33,-32
"10231","1471首利","110/08/02","日盛-和美",31,0,31
"10232","1471首利","110/08/02","日盛-八德",0,63,-63
"10233","1471首利","110/08/02","宏遠-光隆",30,0,30
"10234","1471首利","110/08/02","凱基-幸福",0,49,-49
"10235","1471首利","110/08/02","元富-花蓮",25,0,25
"10236","1471首利","110/08/02","富邦-台北",0,30,-30
"10237","1471首利","110/08/02","凱基-台北",25,0,25
"10238","1471首利","110/08/02","元大-東蘆",0,30,-30
"10239","1471首利","110/08/02","日盛-木柵",20,0,20
"10240","1471首利","110/08/02","合庫-桃園",0,20,-20
"10241","1471首利","110/08/02","凱基-高美館",20,0,20
"10242","1471首利","110/08/02","康和-澎湖",0,15,-15
"10243","1471首利","110/08/02","新光-台中",24,5,19
"10244","1471首利","110/08/02","元大-斗信",0,15,-15
"10245","1471首利","110/08/02","富邦-羅東",15,0,15
"10246","1471首利","110/08/02","元富-民權",0,12,-12
"10247","1471首利","110/08/02","兆豐-鹿港",14,0,14
"10248","1471首利","110/08/02","玉山-新莊",0,12,-12
"10249","1471首利","110/08/02","美林",16,4,12
"10250","1471首利","110/08/02","宏遠-桃園",0,10,-10
"10251","1471首利","110/08/02","統一-桃園",12,0,12
"10252","1471首利","110/08/02","瑞士信貸",0,10,-10
"10253","1471首利","110/08/02","合庫-高雄",10,0,10
"10254","1471首利","110/08/02","大慶-苗栗",0,10,-10
"10255","1471首利","110/08/02","日盛-士林",10,0,10
"10256","1471首利","110/08/02","統一-新營",0,10,-10
"10257","1471首利","110/08/02","港商法國興業",10,0,10
"10258","1471首利","110/08/02","群益金鼎-三重",0,10,-10
"10259","1471首利","110/08/02","第一金-台南",10,0,10
"10260","1471首利","110/08/02","元大-基隆",0,10,-10
"10261","2883開發金","110/08/02","統一",3076,29,3047
"10262","2883開發金","110/08/02","中農",2,3126,-3124
"10263","2883開發金","110/08/02","凱基-台北",2789,192,2597
"10264","2883開發金","110/08/02","群益金鼎",11,2008,-1997
"10265","2883開發金","110/08/02","元富-城東",2139,5,2134
"10266","2883開發金","110/08/02","摩根大通",2081,3944,-1863
"10267","2883開發金","110/08/02","瑞士信貸",2184,316,1868
"10268","2883開發金","110/08/02","港商野村",949,2553,-1604
"10269","2883開發金","110/08/02","美林",1160,271,889
"10270","2883開發金","110/08/02","台灣匯立證券",198,1533,-1335
"10271","2883開發金","110/08/02","港商麥格理",855,0,855
"10272","2883開發金","110/08/02","中國信託",69,1041,-972
"10273","2883開發金","110/08/02","元大-金華",533,33,500
"10274","2883開發金","110/08/02","兆豐證券",1,863,-862
"10275","2883開發金","110/08/02","新加坡商瑞銀",1089,624,465
"10276","2883開發金","110/08/02","美商高盛",6,644,-638
"10277","2883開發金","110/08/02","法銀巴黎",441,0,441
"10278","2883開發金","110/08/02","華南永昌-中正",4,632,-628
"10279","2883開發金","110/08/02","富邦-嘉義",425,24,401
"10280","2883開發金","110/08/02","第一金-安和",156,757,-601
"10281","2883開發金","110/08/02","元富-烏日",367,3,364
"10282","2883開發金","110/08/02","國票",0,524,-524
"10283","2883開發金","110/08/02","台灣摩根士丹利",634,280,354
"10284","2883開發金","110/08/02","元富",266,770,-504
"10285","2883開發金","110/08/02","國泰-館前",516,180,336
"10286","2883開發金","110/08/02","新光",1651,1984,-333
"10287","2883開發金","110/08/02","聯邦-敦化",321,5,316
"10288","2883開發金","110/08/02","元富-安南",20,324,-304
"10289","2883開發金","110/08/02","玉山-士林",307,13,294
"10290","2883開發金","110/08/02","群益金鼎-東門",6,280,-274
"10291","6205詮欣","110/08/02","元大-館前",16,0,16
"10292","6205詮欣","110/08/02","永豐金-敦南",0,21,-21
"10293","6205詮欣","110/08/02","臺銀",11,0,11
"10294","6205詮欣","110/08/02","日盛-三重",0,17,-17
"10295","6205詮欣","110/08/02","臺銀-民權",10,0,10
"10296","6205詮欣","110/08/02","永豐金-博愛",0,10,-10
"10297","6205詮欣","110/08/02","摩根大通",11,1,10
"10298","6205詮欣","110/08/02","國票-台南",0,5,-5
"10299","6205詮欣","110/08/02","合庫-三重",5,0,5
"10300","6205詮欣","110/08/02","群益金鼎-三重",0,4,-4
"10301","6205詮欣","110/08/02","元大-東蘆",5,0,5
"10302","6205詮欣","110/08/02","元大-土城",0,4,-4
"10303","6205詮欣","110/08/02","凱基",3,0,3
"10304","6205詮欣","110/08/02","元大-草屯",0,4,-4
"10305","6205詮欣","110/08/02","日盛-雙和",2,0,2
"10306","6205詮欣","110/08/02","臺銀-新竹",1,4,-3
"10307","6205詮欣","110/08/02","兆豐-南京",2,0,2
"10308","6205詮欣","110/08/02","光和-嘉義",0,3,-3
"10309","6205詮欣","110/08/02","凱基-台北",3,1,2
"10310","6205詮欣","110/08/02","永豐金-內湖",0,3,-3
"10311","6205詮欣","110/08/02","元大-西螺",2,0,2
"10312","6205詮欣","110/08/02","第一金-華江",0,2,-2
"10313","6205詮欣","110/08/02","元大-新竹經國",2,0,2
"10314","6205詮欣","110/08/02","中國信託-高雄",0,2,-2
"10315","6205詮欣","110/08/02","元大-北成功",2,0,2
"10316","6205詮欣","110/08/02","兆豐-鹿港",0,2,-2
"10317","6205詮欣","110/08/02","臺銀-臺中",1,0,1
"10318","6205詮欣","110/08/02","統一-平鎮",0,1,-1
"10319","6205詮欣","110/08/02","德信-新營",1,0,1
"10320","6205詮欣","110/08/02","台新-台中",0,1,-1
"10321","1540喬福","110/08/02","富邦-南屯",10,0,10
"10322","1540喬福","110/08/02","永豐金-埔里",0,22,-22
"10323","1540喬福","110/08/02","元富-中原",10,2,8
"10324","1540喬福","110/08/02","統一-新台中",0,17,-17
"10325","1540喬福","110/08/02","德信-新營",6,0,6
"10326","1540喬福","110/08/02","統一-三多",0,3,-3
"10327","1540喬福","110/08/02","元大-龍潭",3,0,3
"10328","1540喬福","110/08/02","光和-高雄",0,2,-2
"10329","1540喬福","110/08/02","凱基-台北",3,0,3
"10330","1540喬福","110/08/02","兆豐-嘉義",0,2,-2
"10331","1540喬福","110/08/02","新光-桃園",3,0,3
"10332","1540喬福","110/08/02","台新-高雄",0,1,-1
"10333","1540喬福","110/08/02","永豐金-內湖",2,0,2
"10334","1540喬福","110/08/02","新光",0,1,-1
"10335","1540喬福","110/08/02","港商法國興業",2,0,2
"10336","1540喬福","110/08/02","國泰-館前",0,1,-1
"10337","1540喬福","110/08/02","統一-台南",2,0,2
"10338","1540喬福","110/08/02","群益金鼎-民權",0,1,-1
"10339","1540喬福","110/08/02","元富-桃園",2,0,2
"10340","1540喬福","110/08/02","富邦-嘉義",0,1,-1
"10341","1540喬福","110/08/02","台中銀-豐原",2,0,2
"10342","1540喬福","110/08/02","元大-新竹",0,1,-1
"10343","1540喬福","110/08/02","(牛牛牛)亞-網路",1,0,1
"10344","1540喬福","110/08/02","元大-豐原站前",0,1,-1
"10345","1540喬福","110/08/02","元富",1,0,1
"10346","1540喬福","110/08/02","臺銀-鳳山",0,0,0
"10347","1540喬福","110/08/02","第一金-桃園",1,0,1
"10348","1540喬福","110/08/02","第一金",0,0,0
"10349","1540喬福","110/08/02","瑞士信貸",1,0,1
"10350","1540喬福","110/08/02","華南永昌-南京",0,0,0
"10351","2888新光金","110/08/02","花旗環球",2291,0,2291
"10352","2888新光金","110/08/02","瑞士信貸",1405,3997,-2592
"10353","2888新光金","110/08/02","美林",2235,208,2027
"10354","2888新光金","110/08/02","新加坡商瑞銀",780,2173,-1393
"10355","2888新光金","110/08/02","群益金鼎-彰化",1014,2,1012
"10356","2888新光金","110/08/02","美商高盛",369,1356,-987
"10357","2888新光金","110/08/02","富邦-建國",823,9,814
"10358","2888新光金","110/08/02","元大-仁愛",69,795,-726
"10359","2888新光金","110/08/02","元大-華山",532,1,531
"10360","2888新光金","110/08/02","永興-台中",0,500,-500
"10361","2888新光金","110/08/02","法銀巴黎",666,166,500
"10362","2888新光金","110/08/02","凱基-站前",17,506,-489
"10363","2888新光金","110/08/02","台灣匯立證券",421,0,421
"10364","2888新光金","110/08/02","元富-城東",38,496,-458
"10365","2888新光金","110/08/02","凱基-台南",376,17,359
"10366","2888新光金","110/08/02","群益金鼎-中港",2,450,-448
"10367","2888新光金","110/08/02","永豐金-嘉義",352,0,352
"10368","2888新光金","110/08/02","華南永昌",25,461,-436
"10369","2888新光金","110/08/02","合庫-台中",339,1,338
"10370","2888新光金","110/08/02","港商野村",135,550,-415
"10371","2888新光金","110/08/02","港商麥格理",316,0,316
"10372","2888新光金","110/08/02","大慶-苗栗",1,406,-405
"10373","2888新光金","110/08/02","群益金鼎-建成",298,5,293
"10374","2888新光金","110/08/02","華南永昌-中正",34,419,-385
"10375","2888新光金","110/08/02","永豐金-板盛",221,0,221
"10376","2888新光金","110/08/02","玉山-台大",0,350,-350
"10377","2888新光金","110/08/02","台灣摩根士丹利",1700,1488,212
"10378","2888新光金","110/08/02","元大-汐止",66,363,-297
"10379","2888新光金","110/08/02","凱基-竹北",200,0,200
"10380","2888新光金","110/08/02","台新-新莊",14,265,-251
"10381","1340勝悅","110/08/02","國泰-台中",22,0,22
"10382","1340勝悅","110/08/02","中國信託",0,83,-83
"10383","1340勝悅","110/08/02","港商法國興業",14,0,14
"10384","1340勝悅","110/08/02","元大-開元",0,11,-11
"10385","1340勝悅","110/08/02","新光",18,5,13
"10386","1340勝悅","110/08/02","凱基-永康",0,10,-10
"10387","1340勝悅","110/08/02","元大-基隆孝二",11,0,11
"10388","1340勝悅","110/08/02","富邦-宜蘭",0,10,-10
"10389","1340勝悅","110/08/02","玉山-士林",10,0,10
"10390","1340勝悅","110/08/02","元大-大統",0,10,-10
"10391","1340勝悅","110/08/02","凱基",6,0,6
"10392","1340勝悅","110/08/02","富邦-板橋",0,5,-5
"10393","1340勝悅","110/08/02","摩根大通",4,0,4
"10394","1340勝悅","110/08/02","瑞士信貸",1,5,-4
"10395","1340勝悅","110/08/02","國泰-敦南",8,4,4
"10396","1340勝悅","110/08/02","華南永昌-忠孝",0,2,-2
"10397","1340勝悅","110/08/02","國泰-新莊",3,0,3
"10398","1340勝悅","110/08/02","元大-虎尾",0,2,-2
"10399","1340勝悅","110/08/02","凱基-嘉義",3,0,3
"10400","1340勝悅","110/08/02","元大-路竹",0,2,-2
"10401","1340勝悅","110/08/02","群益金鼎-館前",3,0,3
"10402","1340勝悅","110/08/02","元大-信義",0,2,-2
"10403","1340勝悅","110/08/02","國泰-館前",3,0,3
"10404","1340勝悅","110/08/02","華南永昌-高雄",0,1,-1
"10405","1340勝悅","110/08/02","臺銀-鳳山",3,0,3
"10406","1340勝悅","110/08/02","玉山-大里",0,0,0
"10407","1340勝悅","110/08/02","國泰-高雄",4,1,3
"10408","1340勝悅","110/08/02","群益金鼎-丹鳳",0,0,0
"10409","1340勝悅","110/08/02","美商高盛",3,0,3
"10410","1340勝悅","110/08/02","富邦-虎尾",0,0,0
"10411","6246臺龍","110/08/02","台新證券",19,1,18
"10412","6246臺龍","110/08/02","元大-新竹經國",0,6,-6
"10413","6246臺龍","110/08/02","凱基-台北",7,2,5
"10414","6246臺龍","110/08/02","台新-台南",0,5,-5
"10415","6246臺龍","110/08/02","國票-九鼎",3,0,3
"10416","6246臺龍","110/08/02","宏遠-新化",1,4,-3
"10417","6246臺龍","110/08/02","國票-南京",3,0,3
"10418","6246臺龍","110/08/02","元富-板橋",0,3,-3
"10419","6246臺龍","110/08/02","新光-台中",3,0,3
"10420","6246臺龍","110/08/02","國泰-敦南",0,3,-3
"10421","6246臺龍","110/08/02","元大-員林",3,0,3
"10422","6246臺龍","110/08/02","富邦-台中",0,3,-3
"10423","6246臺龍","110/08/02","元大-永和",3,0,3
"10424","6246臺龍","110/08/02","元大-大益",2,5,-3
"10425","6246臺龍","110/08/02","港商野村",2,0,2
"10426","6246臺龍","110/08/02","日盛-永康",0,2,-2
"10427","6246臺龍","110/08/02","台新-高雄",2,0,2
"10428","6246臺龍","110/08/02","日盛-宜蘭",0,2,-2
"10429","6246臺龍","110/08/02","新光-台南",2,0,2
"10430","6246臺龍","110/08/02","宏遠-台南",0,2,-2
"10431","6246臺龍","110/08/02","日盛-文化",1,0,1
"10432","6246臺龍","110/08/02","高橋-龍潭",0,2,-2
"10433","6246臺龍","110/08/02","國泰-忠孝",1,0,1
"10434","6246臺龍","110/08/02","群益金鼎-中壢",0,2,-2
"10435","6246臺龍","110/08/02","群益金鼎-崇德",3,2,1
"10436","6246臺龍","110/08/02","凱基-三多",0,2,-2
"10437","6246臺龍","110/08/02","富邦-員林",1,0,1
"10438","6246臺龍","110/08/02","統一-中壢",0,1,-1
"10439","6246臺龍","110/08/02","富邦-三重",1,0,1
"10440","6246臺龍","110/08/02","中國信託-嘉義",0,1,-1
"10441","00715L期街口布蘭特正2","110/08/02","元大證券",7296,1000,6296
"10442","00715L期街口布蘭特正2","110/08/02","富邦-基隆",0,850,-850
"10443","00715L期街口布蘭特正2","110/08/02","永豐金證券",2221,338,1883
"10444","00715L期街口布蘭特正2","110/08/02","(牛牛牛)亞-鑫豐",10,850,-840
"10445","00715L期街口布蘭特正2","110/08/02","統一",1460,100,1360
"10446","00715L期街口布蘭特正2","110/08/02","華南永昌-長虹",57,820,-763
"10447","00715L期街口布蘭特正2","110/08/02","國票-中港",1000,0,1000
"10448","00715L期街口布蘭特正2","110/08/02","富邦-彰化",0,700,-700
"10449","00715L期街口布蘭特正2","110/08/02","第一金-台中",900,13,887
"10450","00715L期街口布蘭特正2","110/08/02","第一金-路竹",0,682,-682
"10451","00715L期街口布蘭特正2","110/08/02","群益金鼎",728,0,728
"10452","00715L期街口布蘭特正2","110/08/02","台新證券",112,791,-679
"10453","00715L期街口布蘭特正2","110/08/02","群益金鼎-古亭",433,1,432
"10454","00715L期街口布蘭特正2","110/08/02","第一金-忠孝",45,483,-438
"10455","00715L期街口布蘭特正2","110/08/02","凱基-市政",525,125,400
"10456","00715L期街口布蘭特正2","110/08/02","玉山-台南",0,373,-373
"10457","00715L期街口布蘭特正2","110/08/02","元大-敦化",400,0,400
"10458","00715L期街口布蘭特正2","110/08/02","國泰-板橋",3,313,-310
"10459","00715L期街口布蘭特正2","110/08/02","元大-草屯",353,21,332
"10460","00715L期街口布蘭特正2","110/08/02","凱基",0,300,-300
"10461","00715L期街口布蘭特正2","110/08/02","元大-萬華",250,0,250
"10462","00715L期街口布蘭特正2","110/08/02","元大-嘉義",1,300,-299
"10463","00715L期街口布蘭特正2","110/08/02","統一-員林",180,0,180
"10464","00715L期街口布蘭特正2","110/08/02","元大-大灣",14,303,-289
"10465","00715L期街口布蘭特正2","110/08/02","富邦證券",282,152,130
"10466","00715L期街口布蘭特正2","110/08/02","新光-桃園",45,295,-250
"10467","00715L期街口布蘭特正2","110/08/02","元富-潮州",125,0,125
"10468","00715L期街口布蘭特正2","110/08/02","元大-新莊",76,306,-230
"10469","00715L期街口布蘭特正2","110/08/02","兆豐-台中港",106,0,106
"10470","00715L期街口布蘭特正2","110/08/02","富邦-台北",0,211,-211
"10471","8941關中","110/08/02","宏遠-館前",3,0,3
"10472","8941關中","110/08/02","富邦-台中",0,5,-5
"10473","8941關中","110/08/02","群益金鼎-彰化",2,0,2
"10474","8941關中","110/08/02","富邦-員林",0,4,-4
"10475","8941關中","110/08/02","第一金-台中",1,0,1
"10476","8941關中","110/08/02","元大-新竹經國",0,0,0
"10477","8941關中","110/08/02","台新-台中",1,0,1
"10478","8941關中","110/08/02","永豐金-萬盛",0,0,0
"10479","8941關中","110/08/02","華南永昌-南京",1,0,1
"10480","8941關中","110/08/02","",NA,NA,NA
"10481","8941關中","110/08/02","元大-桃興",2,1,1
"10482","8941關中","110/08/02","",NA,NA,NA
"10483","8941關中","110/08/02","元大-新竹經國",0,0,0
"10484","8941關中","110/08/02","",NA,NA,NA
"10485","8941關中","110/08/02","永豐金-萬盛",0,0,0
"10486","8941關中","110/08/02","",NA,NA,NA
"10487","8941關中","110/08/02","",NA,NA,NA
"10488","8941關中","110/08/02","",NA,NA,NA
"10489","8941關中","110/08/02","",NA,NA,NA
"10490","8941關中","110/08/02","",NA,NA,NA
"10491","8941關中","110/08/02","",NA,NA,NA
"10492","8941關中","110/08/02","",NA,NA,NA
"10493","8941關中","110/08/02","",NA,NA,NA
"10494","8941關中","110/08/02","",NA,NA,NA
"10495","8941關中","110/08/02","",NA,NA,NA
"10496","8941關中","110/08/02","",NA,NA,NA
"10497","8941關中","110/08/02","",NA,NA,NA
"10498","8941關中","110/08/02","",NA,NA,NA
"10499","8941關中","110/08/02","",NA,NA,NA
"10500","8941關中","110/08/02","",NA,NA,NA
"10501","8936國統","110/08/02","合庫-高雄",68,0,68
"10502","8936國統","110/08/02","凱基-台北",0,125,-125
"10503","8936國統","110/08/02","元大-蘆洲",33,0,33
"10504","8936國統","110/08/02","摩根大通",9,125,-116
"10505","8936國統","110/08/02","富邦-高雄",30,4,26
"10506","8936國統","110/08/02","永全-南崁",0,50,-50
"10507","8936國統","110/08/02","大慶-蘆洲",20,0,20
"10508","8936國統","110/08/02","新光-台中",16,55,-39
"10509","8936國統","110/08/02","兆豐-桃鶯",20,0,20
"10510","8936國統","110/08/02","凱基-市政",0,31,-31
"10511","8936國統","110/08/02","元大-東泰",20,0,20
"10512","8936國統","110/08/02","美商高盛",1,20,-19
"10513","8936國統","110/08/02","永豐金-忠孝",20,0,20
"10514","8936國統","110/08/02","元大-東港",3,20,-17
"10515","8936國統","110/08/02","元大-旗山",15,0,15
"10516","8936國統","110/08/02","台灣企銀-台中",0,15,-15
"10517","8936國統","110/08/02","中國信託-文心",12,0,12
"10518","8936國統","110/08/02","日盛-竹北",0,15,-15
"10519","8936國統","110/08/02","國泰-敦南",14,2,12
"10520","8936國統","110/08/02","瑞士信貸",0,11,-11
"10521","8936國統","110/08/02","元大-敦南",12,0,12
"10522","8936國統","110/08/02","港商野村",26,36,-10
"10523","8936國統","110/08/02","日盛-三峽",11,0,11
"10524","8936國統","110/08/02","統一-竹南",0,10,-10
"10525","8936國統","110/08/02","永豐金-苓雅",11,0,11
"10526","8936國統","110/08/02","國泰-高雄",1,11,-10
"10527","8936國統","110/08/02","宏遠-高雄",11,1,10
"10528","8936國統","110/08/02","元大-天母",0,9,-9
"10529","8936國統","110/08/02","第一金-嘉義",10,0,10
"10530","8936國統","110/08/02","元大-台中中港",0,9,-9
"10531","6226光鼎","110/08/02","新百王",283,0,283
"10532","6226光鼎","110/08/02","元富-安南",3,113,-110
"10533","6226光鼎","110/08/02","日盛-文化",219,3,216
"10534","6226光鼎","110/08/02","群益金鼎-東大",24,124,-100
"10535","6226光鼎","110/08/02","元大-嘉義",127,37,90
"10536","6226光鼎","110/08/02","富邦-南屯",3,100,-97
"10537","6226光鼎","110/08/02","統一-新竹",113,31,82
"10538","6226光鼎","110/08/02","元大-鳳中",2,99,-97
"10539","6226光鼎","110/08/02","台中銀-員林",111,47,64
"10540","6226光鼎","110/08/02","元大-忠孝鼎富",10,100,-90
"10541","6226光鼎","110/08/02","永豐金證券",66,5,61
"10542","6226光鼎","110/08/02","華南永昌-小港",0,84,-84
"10543","6226光鼎","110/08/02","日盛-員林",107,50,57
"10544","6226光鼎","110/08/02","國泰-敦南",247,324,-77
"10545","6226光鼎","110/08/02","國票-九鼎",72,24,48
"10546","6226光鼎","110/08/02","亞東",5,76,-71
"10547","6226光鼎","110/08/02","元大-士林",53,6,47
"10548","6226光鼎","110/08/02","中國信託-新竹",2,62,-60
"10549","6226光鼎","110/08/02","元大-鹿港",48,7,41
"10550","6226光鼎","110/08/02","元大-南屯",12,64,-52
"10551","6226光鼎","110/08/02","中國信託-文心",48,8,40
"10552","6226光鼎","110/08/02","元大-高雄",9,61,-52
"10553","6226光鼎","110/08/02","國泰-新莊",56,17,39
"10554","6226光鼎","110/08/02","元大-台北",2,53,-51
"10555","6226光鼎","110/08/02","元大-大同",39,0,39
"10556","6226光鼎","110/08/02","第一金-華江",8,52,-44
"10557","6226光鼎","110/08/02","富邦-建國",39,1,38
"10558","6226光鼎","110/08/02","元富-新莊",3,44,-41
"10559","6226光鼎","110/08/02","統一-三重",54,18,36
"10560","6226光鼎","110/08/02","玉山-桃園",3,40,-37
"10561","2363矽統","110/08/02","中國信託-忠孝",405,25,380
"10562","2363矽統","110/08/02","富邦證券",16,4082,-4066
"10563","2363矽統","110/08/02","群益金鼎-屏東",349,123,226
"10564","2363矽統","110/08/02","凱基-台北",2669,4466,-1797
"10565","2363矽統","110/08/02","群益金鼎-永和",233,20,213
"10566","2363矽統","110/08/02","台灣摩根士丹利",69,1749,-1680
"10567","2363矽統","110/08/02","富邦-中壢",299,91,208
"10568","2363矽統","110/08/02","新加坡商瑞銀",361,1486,-1125
"10569","2363矽統","110/08/02","永豐金-彰化",188,4,184
"10570","2363矽統","110/08/02","港商野村",619,1622,-1003
"10571","2363矽統","110/08/02","元大-承德",253,73,180
"10572","2363矽統","110/08/02","美商高盛",214,1077,-863
"10573","2363矽統","110/08/02","康和-台中",192,23,169
"10574","2363矽統","110/08/02","兆豐-復興",124,973,-849
"10575","2363矽統","110/08/02","新光",550,382,168
"10576","2363矽統","110/08/02","統一-仁愛",132,666,-534
"10577","2363矽統","110/08/02","元大-萬華",224,61,163
"10578","2363矽統","110/08/02","美林",520,1028,-508
"10579","2363矽統","110/08/02","元大-博愛",204,44,160
"10580","2363矽統","110/08/02","統一-土城",32,536,-504
"10581","2363矽統","110/08/02","兆豐-三民",171,17,154
"10582","2363矽統","110/08/02","華南永昌-斗六",33,526,-493
"10583","2363矽統","110/08/02","元大-新竹",196,44,152
"10584","2363矽統","110/08/02","統一-敦南",35,527,-492
"10585","2363矽統","110/08/02","凱基-三重",178,29,149
"10586","2363矽統","110/08/02","永豐金-員林",12,495,-483
"10587","2363矽統","110/08/02","元大-忠孝",181,38,143
"10588","2363矽統","110/08/02","統一-城中",117,589,-472
"10589","2363矽統","110/08/02","元富-世貿",142,4,138
"10590","2363矽統","110/08/02","摩根大通",1070,1471,-401
"10591","8112至上","110/08/02","合庫證券",213,0,213
"10592","8112至上","110/08/02","台灣摩根士丹利",9,287,-278
"10593","8112至上","110/08/02","凱基-台北",298,152,146
"10594","8112至上","110/08/02","凱基-三重",3,236,-233
"10595","8112至上","110/08/02","大慶",87,0,87
"10596","8112至上","110/08/02","臺銀-鳳山",11,124,-113
"10597","8112至上","110/08/02","凱基-新店",84,0,84
"10598","8112至上","110/08/02","合庫-台中",1,112,-111
"10599","8112至上","110/08/02","香港上海匯豐",76,0,76
"10600","8112至上","110/08/02","土銀-嘉義",0,105,-105
"10601","8112至上","110/08/02","群益金鼎-建成",65,1,64
"10602","8112至上","110/08/02","元大-新莊",2,106,-104
"10603","8112至上","110/08/02","玉山-板橋",63,0,63
"10604","8112至上","110/08/02","台新-建北",0,95,-95
"10605","8112至上","110/08/02","元大-前金",61,2,59
"10606","8112至上","110/08/02","華南永昌-彰化",2,64,-62
"10607","8112至上","110/08/02","台新-台中",58,5,53
"10608","8112至上","110/08/02","群益金鼎-北高雄",3,50,-47
"10609","8112至上","110/08/02","亞東",51,0,51
"10610","8112至上","110/08/02","元大-福營",1,45,-44
"10611","8112至上","110/08/02","美林",49,1,48
"10612","8112至上","110/08/02","永豐金-南京",2,38,-36
"10613","8112至上","110/08/02","摩根大通",114,67,47
"10614","8112至上","110/08/02","亞東-板橋",2,34,-32
"10615","8112至上","110/08/02","美商高盛",46,0,46
"10616","8112至上","110/08/02","元大-台南",2,33,-31
"10617","8112至上","110/08/02","凱基-松山",43,1,42
"10618","8112至上","110/08/02","統一-城中",0,30,-30
"10619","8112至上","110/08/02","群益金鼎-大安",40,0,40
"10620","8112至上","110/08/02","元富-板橋",5,35,-30
"10621","1570力肯","110/08/02","群益金鼎-高雄",11,0,11
"10622","1570力肯","110/08/02","大慶",0,5,-5
"10623","1570力肯","110/08/02","臺銀-臺南",4,0,4
"10624","1570力肯","110/08/02","元大-板橋",0,4,-4
"10625","1570力肯","110/08/02","新光-台中",4,0,4
"10626","1570力肯","110/08/02","玉山證券",0,4,-4
"10627","1570力肯","110/08/02","(牛牛牛)亞-鑫豐",3,0,3
"10628","1570力肯","110/08/02","國泰-台南",0,3,-3
"10629","1570力肯","110/08/02","土銀-白河",2,0,2
"10630","1570力肯","110/08/02","元富-新店",0,3,-3
"10631","1570力肯","110/08/02","統一-松江",2,0,2
"10632","1570力肯","110/08/02","元富-永和",0,2,-2
"10633","1570力肯","110/08/02","中國信託-永康",1,0,1
"10634","1570力肯","110/08/02","凱基-台北",0,2,-2
"10635","1570力肯","110/08/02","凱基-信義",1,0,1
"10636","1570力肯","110/08/02","統一-城中",0,2,-2
"10637","1570力肯","110/08/02","凱基-幸福",1,0,1
"10638","1570力肯","110/08/02","新光",0,1,-1
"10639","1570力肯","110/08/02","元大-歸仁",1,0,1
"10640","1570力肯","110/08/02","凱基-岡山",0,1,-1
"10641","1570力肯","110/08/02","合庫-台中",0,0,0
"10642","1570力肯","110/08/02","富邦-台南",0,1,-1
"10643","1570力肯","110/08/02","康和-板橋",0,0,0
"10644","1570力肯","110/08/02","元大-新盛",0,1,-1
"10645","1570力肯","110/08/02","群益金鼎-鳳山",0,0,0
"10646","1570力肯","110/08/02","永豐金-嘉義",0,1,-1
"10647","1570力肯","110/08/02","元大-樹林",0,0,0
"10648","1570力肯","110/08/02","康和-板橋",0,0,0
"10649","1570力肯","110/08/02","",NA,NA,NA
"10650","1570力肯","110/08/02","合庫-台中",0,0,0
"10651","2929淘帝","110/08/02","元大-民生",29,0,29
"10652","2929淘帝","110/08/02","新加坡商瑞銀",4,70,-66
"10653","2929淘帝","110/08/02","兆豐-桃園",20,0,20
"10654","2929淘帝","110/08/02","富邦-建國",0,26,-26
"10655","2929淘帝","110/08/02","新光",14,0,14
"10656","2929淘帝","110/08/02","美林",0,24,-24
"10657","2929淘帝","110/08/02","兆豐-忠孝",13,0,13
"10658","2929淘帝","110/08/02","元大-和平",0,13,-13
"10659","2929淘帝","110/08/02","兆豐-彰化",12,0,12
"10660","2929淘帝","110/08/02","元大-永和",0,10,-10
"10661","2929淘帝","110/08/02","合庫-高雄",10,0,10
"10662","2929淘帝","110/08/02","日盛-頭份",0,9,-9
"10663","2929淘帝","110/08/02","富邦-台北",10,0,10
"10664","2929淘帝","110/08/02","群益金鼎-中山",0,9,-9
"10665","2929淘帝","110/08/02","國泰-敦南",9,0,9
"10666","2929淘帝","110/08/02","華南永昌-頭份",0,7,-7
"10667","2929淘帝","110/08/02","元富-文心",10,2,8
"10668","2929淘帝","110/08/02","永豐金-敦南",0,7,-7
"10669","2929淘帝","110/08/02","台新-台中",7,0,7
"10670","2929淘帝","110/08/02","凱基-台北",5,11,-6
"10671","2929淘帝","110/08/02","元大-文心",6,0,6
"10672","2929淘帝","110/08/02","臺銀-鳳山",0,5,-5
"10673","2929淘帝","110/08/02","日盛-忠孝",5,0,5
"10674","2929淘帝","110/08/02","凱基-城中",0,5,-5
"10675","2929淘帝","110/08/02","第一金-高雄",5,0,5
"10676","2929淘帝","110/08/02","華南永昌-台中",0,5,-5
"10677","2929淘帝","110/08/02","富邦-基隆",6,1,5
"10678","2929淘帝","110/08/02","元大-博愛",0,5,-5
"10679","2929淘帝","110/08/02","富邦-新店",5,0,5
"10680","2929淘帝","110/08/02","元富-緯城",0,4,-4
"10681","5410國眾","110/08/02","新加坡商瑞銀",19,0,19
"10682","5410國眾","110/08/02","日盛-斗六",0,15,-15
"10683","5410國眾","110/08/02","兆豐-城中",18,0,18
"10684","5410國眾","110/08/02","元大-大同",0,15,-15
"10685","5410國眾","110/08/02","日盛-新莊",10,0,10
"10686","5410國眾","110/08/02","元大-博愛",0,10,-10
"10687","5410國眾","110/08/02","元富-佳里",10,0,10
"10688","5410國眾","110/08/02","凱基-台北",0,7,-7
"10689","5410國眾","110/08/02","摩根大通",9,0,9
"10690","5410國眾","110/08/02","臺銀-臺南",0,6,-6
"10691","5410國眾","110/08/02","國泰-桃園",6,0,6
"10692","5410國眾","110/08/02","元富-嘉義",0,6,-6
"10693","5410國眾","110/08/02","元富-新竹",5,0,5
"10694","5410國眾","110/08/02","第一金-中壢",0,5,-5
"10695","5410國眾","110/08/02","元大-復北",5,0,5
"10696","5410國眾","110/08/02","致和證券",0,5,-5
"10697","5410國眾","110/08/02","永豐金-桃園",5,0,5
"10698","5410國眾","110/08/02","群益金鼎-土城",0,5,-5
"10699","5410國眾","110/08/02","安泰-楠梓",4,0,4
"10700","5410國眾","110/08/02","華南永昌-中正",0,5,-5
"10701","5410國眾","110/08/02","台灣企銀-太平",3,0,3
"10702","5410國眾","110/08/02","元大-新莊",0,5,-5
"10703","5410國眾","110/08/02","新光",3,0,3
"10704","5410國眾","110/08/02","土銀-新竹",0,4,-4
"10705","5410國眾","110/08/02","富邦-內湖",3,0,3
"10706","5410國眾","110/08/02","日盛-員林",0,3,-3
"10707","5410國眾","110/08/02","中國信託-新竹",2,0,2
"10708","5410國眾","110/08/02","元大-新竹經國",0,3,-3
"10709","5410國眾","110/08/02","華南永昌-楠梓",2,0,2
"10710","5410國眾","110/08/02","元富-緯城",0,2,-2
"10711","2841台開","110/08/02","富邦-敦南",71,0,71
"10712","2841台開","110/08/02","永豐金-松山",0,91,-91
"10713","2841台開","110/08/02","國泰-館前",38,0,38
"10714","2841台開","110/08/02","元大-蘆洲",0,40,-40
"10715","2841台開","110/08/02","台中銀",19,0,19
"10716","2841台開","110/08/02","凱基-台北",2,33,-31
"10717","2841台開","110/08/02","元富-烏日",18,0,18
"10718","2841台開","110/08/02","兆豐-寶成",0,20,-20
"10719","2841台開","110/08/02","國泰-板橋",15,0,15
"10720","2841台開","110/08/02","華南永昌-民權",0,20,-20
"10721","2841台開","110/08/02","元大-台中",15,0,15
"10722","2841台開","110/08/02","國票-敦北法人",0,18,-18
"10723","2841台開","110/08/02","元大-福營",15,0,15
"10724","2841台開","110/08/02","第一金-路竹",0,17,-17
"10725","2841台開","110/08/02","日盛-花蓮",14,0,14
"10726","2841台開","110/08/02","中國信託-高雄",0,15,-15
"10727","2841台開","110/08/02","新光",12,0,12
"10728","2841台開","110/08/02","日進",0,10,-10
"10729","2841台開","110/08/02","永豐金-敦南",62,51,11
"10730","2841台開","110/08/02","統一-三多",0,10,-10
"10731","2841台開","110/08/02","日盛-台中",10,0,10
"10732","2841台開","110/08/02","元大-路竹",0,10,-10
"10733","2841台開","110/08/02","群益金鼎-崇德",10,0,10
"10734","2841台開","110/08/02","元大-中和",0,10,-10
"10735","2841台開","110/08/02","元大-南海",10,0,10
"10736","2841台開","110/08/02","宏遠-桃園",0,9,-9
"10737","2841台開","110/08/02","國泰-桃園",8,0,8
"10738","2841台開","110/08/02","大昌-新店",0,6,-6
"10739","2841台開","110/08/02","台新-台中",6,0,6
"10740","2841台開","110/08/02","國票-天祥",0,6,-6
"10741","6207雷科","110/08/02","摩根大通",173,19,154
"10742","6207雷科","110/08/02","凱基-高雄",0,50,-50
"10743","6207雷科","110/08/02","凱基-台北",150,10,140
"10744","6207雷科","110/08/02","群益金鼎-東門",0,26,-26
"10745","6207雷科","110/08/02","華南永昌-朴子",55,0,55
"10746","6207雷科","110/08/02","富邦-竹東",0,25,-25
"10747","6207雷科","110/08/02","新加坡商瑞銀",51,5,46
"10748","6207雷科","110/08/02","華南永昌-東勢",3,27,-24
"10749","6207雷科","110/08/02","元大-西門",54,12,42
"10750","6207雷科","110/08/02","富邦-岡山",1,25,-24
"10751","6207雷科","110/08/02","兆豐-景美",42,2,40
"10752","6207雷科","110/08/02","台灣摩根士丹利",0,22,-22
"10753","6207雷科","110/08/02","日盛-忠孝",35,0,35
"10754","6207雷科","110/08/02","國泰-高雄",1,23,-22
"10755","6207雷科","110/08/02","美林",25,0,25
"10756","6207雷科","110/08/02","富邦-建國",0,17,-17
"10757","6207雷科","110/08/02","日盛-北高雄",16,0,16
"10758","6207雷科","110/08/02","元大-上新莊",0,16,-16
"10759","6207雷科","110/08/02","統一-板橋",15,0,15
"10760","6207雷科","110/08/02","中國信託-高雄",0,15,-15
"10761","6207雷科","110/08/02","凱基-市政",15,0,15
"10762","6207雷科","110/08/02","宏遠證券",0,13,-13
"10763","6207雷科","110/08/02","新光-新竹",16,2,14
"10764","6207雷科","110/08/02","凱基-彰化",0,13,-13
"10765","6207雷科","110/08/02","港商野村",23,12,11
"10766","6207雷科","110/08/02","永豐金-內湖",0,13,-13
"10767","6207雷科","110/08/02","統一-南京",11,0,11
"10768","6207雷科","110/08/02","新百王",0,12,-12
"10769","6207雷科","110/08/02","元大-嘉義",11,0,11
"10770","6207雷科","110/08/02","玉山-大里",0,12,-12
"10771","3679新至陞","110/08/02","元大-成功",26,0,26
"10772","3679新至陞","110/08/02","富邦-陽明",1,34,-33
"10773","3679新至陞","110/08/02","元大-樹林",20,0,20
"10774","3679新至陞","110/08/02","富邦-中壢",0,20,-20
"10775","3679新至陞","110/08/02","(牛牛牛)亞-網路",18,0,18
"10776","3679新至陞","110/08/02","凱基-台北",34,48,-14
"10777","3679新至陞","110/08/02","凱基-中山",12,0,12
"10778","3679新至陞","110/08/02","永豐金證券",0,14,-14
"10779","3679新至陞","110/08/02","統一",21,11,10
"10780","3679新至陞","110/08/02","臺銀-臺南",2,14,-12
"10781","3679新至陞","110/08/02","玉山-台大",10,0,10
"10782","3679新至陞","110/08/02","摩根大通",20,32,-12
"10783","3679新至陞","110/08/02","台中銀",8,0,8
"10784","3679新至陞","110/08/02","富邦-嘉義",0,10,-10
"10785","3679新至陞","110/08/02","港商野村",8,2,6
"10786","3679新至陞","110/08/02","國票-北高雄",1,10,-9
"10787","3679新至陞","110/08/02","群益金鼎-丹鳳",6,0,6
"10788","3679新至陞","110/08/02","台新-台中",0,9,-9
"10789","3679新至陞","110/08/02","元大-高雄",6,0,6
"10790","3679新至陞","110/08/02","凱基-宜蘭",0,7,-7
"10791","3679新至陞","110/08/02","新加坡商瑞銀",5,0,5
"10792","3679新至陞","110/08/02","凱基-埔墘",0,7,-7
"10793","3679新至陞","110/08/02","台灣摩根士丹利",13,9,4
"10794","3679新至陞","110/08/02","永豐金-台中",0,7,-7
"10795","3679新至陞","110/08/02","第一金-華江",4,0,4
"10796","3679新至陞","110/08/02","永豐金-潮州",0,7,-7
"10797","3679新至陞","110/08/02","新光",11,7,4
"10798","3679新至陞","110/08/02","凱基-五股",0,6,-6
"10799","3679新至陞","110/08/02","國泰-館前",4,0,4
"10800","3679新至陞","110/08/02","富邦-建國",0,6,-6
"10801","2727王品","110/08/02","摩根大通",38,5,33
"10802","2727王品","110/08/02","台灣摩根士丹利",13,170,-157
"10803","2727王品","110/08/02","日盛-忠孝",33,3,30
"10804","2727王品","110/08/02","華南永昌",7,156,-149
"10805","2727王品","110/08/02","凱基-天母",30,0,30
"10806","2727王品","110/08/02","凱基-台北",37,57,-20
"10807","2727王品","110/08/02","花旗環球",17,0,17
"10808","2727王品","110/08/02","國票-北高雄",1,19,-18
"10809","2727王品","110/08/02","永豐金-竹科",20,5,15
"10810","2727王品","110/08/02","港商野村",39,54,-15
"10811","2727王品","110/08/02","彰銀-台中",16,2,14
"10812","2727王品","110/08/02","元大-四維",1,15,-14
"10813","2727王品","110/08/02","國票-內壢",14,0,14
"10814","2727王品","110/08/02","美林",12,25,-13
"10815","2727王品","110/08/02","新光-台中",17,3,14
"10816","2727王品","110/08/02","瑞士信貸",0,12,-12
"10817","2727王品","110/08/02","永豐金-南京",16,3,13
"10818","2727王品","110/08/02","元大-北成功",0,10,-10
"10819","2727王品","110/08/02","元大-樹林",13,1,12
"10820","2727王品","110/08/02","元大-崇德",0,8,-8
"10821","2727王品","110/08/02","國泰-板橋",17,7,10
"10822","2727王品","110/08/02","永豐金-內湖",3,10,-7
"10823","2727王品","110/08/02","凱基-埔墘",10,0,10
"10824","2727王品","110/08/02","大昌",5,11,-6
"10825","2727王品","110/08/02","元大-豐原",10,0,10
"10826","2727王品","110/08/02","華南永昌-斗六",2,8,-6
"10827","2727王品","110/08/02","元大-桃園",10,0,10
"10828","2727王品","110/08/02","國泰-台中",4,9,-5
"10829","2727王品","110/08/02","凱基-科園",9,0,9
"10830","2727王品","110/08/02","群益金鼎-土城",0,5,-5
"10831","1570力肯","110/08/02","群益金鼎-高雄",11,0,11
"10832","1570力肯","110/08/02","大慶",0,5,-5
"10833","1570力肯","110/08/02","臺銀-臺南",4,0,4
"10834","1570力肯","110/08/02","元大-板橋",0,4,-4
"10835","1570力肯","110/08/02","新光-台中",4,0,4
"10836","1570力肯","110/08/02","玉山證券",0,4,-4
"10837","1570力肯","110/08/02","(牛牛牛)亞-鑫豐",3,0,3
"10838","1570力肯","110/08/02","國泰-台南",0,3,-3
"10839","1570力肯","110/08/02","土銀-白河",2,0,2
"10840","1570力肯","110/08/02","元富-新店",0,3,-3
"10841","1570力肯","110/08/02","統一-松江",2,0,2
"10842","1570力肯","110/08/02","元富-永和",0,2,-2
"10843","1570力肯","110/08/02","中國信託-永康",1,0,1
"10844","1570力肯","110/08/02","凱基-台北",0,2,-2
"10845","1570力肯","110/08/02","凱基-信義",1,0,1
"10846","1570力肯","110/08/02","統一-城中",0,2,-2
"10847","1570力肯","110/08/02","凱基-幸福",1,0,1
"10848","1570力肯","110/08/02","新光",0,1,-1
"10849","1570力肯","110/08/02","元大-歸仁",1,0,1
"10850","1570力肯","110/08/02","凱基-岡山",0,1,-1
"10851","1570力肯","110/08/02","合庫-台中",0,0,0
"10852","1570力肯","110/08/02","富邦-台南",0,1,-1
"10853","1570力肯","110/08/02","康和-板橋",0,0,0
"10854","1570力肯","110/08/02","元大-新盛",0,1,-1
"10855","1570力肯","110/08/02","群益金鼎-鳳山",0,0,0
"10856","1570力肯","110/08/02","永豐金-嘉義",0,1,-1
"10857","1570力肯","110/08/02","元大-樹林",0,0,0
"10858","1570力肯","110/08/02","康和-板橋",0,0,0
"10859","1570力肯","110/08/02","",NA,NA,NA
"10860","1570力肯","110/08/02","合庫-台中",0,0,0
"10861","6180橘子","110/08/02","美商高盛",21,8,13
"10862","6180橘子","110/08/02","國票-嘉義",0,29,-29
"10863","6180橘子","110/08/02","統一-彰化",10,0,10
"10864","6180橘子","110/08/02","新加坡商瑞銀",0,21,-21
"10865","6180橘子","110/08/02","中國信託-高雄",10,0,10
"10866","6180橘子","110/08/02","凱基-台北",20,40,-20
"10867","6180橘子","110/08/02","兆豐-斗南",10,0,10
"10868","6180橘子","110/08/02","摩根大通",3,15,-12
"10869","6180橘子","110/08/02","兆豐-埔墘",10,0,10
"10870","6180橘子","110/08/02","第一金-桃園",0,10,-10
"10871","6180橘子","110/08/02","玉山證券",10,0,10
"10872","6180橘子","110/08/02","凱基-東港",0,10,-10
"10873","6180橘子","110/08/02","富邦-羅東",8,1,7
"10874","6180橘子","110/08/02","元大-桃園",0,10,-10
"10875","6180橘子","110/08/02","元大證券",7,0,7
"10876","6180橘子","110/08/02","元大-館前",0,9,-9
"10877","6180橘子","110/08/02","元大-復北",7,0,7
"10878","6180橘子","110/08/02","台灣摩根士丹利",3,10,-7
"10879","6180橘子","110/08/02","華南永昌-長虹",6,0,6
"10880","6180橘子","110/08/02","光和-花壇",0,5,-5
"10881","6180橘子","110/08/02","元富-文心",5,0,5
"10882","6180橘子","110/08/02","玉山-嘉義",0,5,-5
"10883","6180橘子","110/08/02","台新-新莊",5,0,5
"10884","6180橘子","110/08/02","凱基-松山",0,5,-5
"10885","6180橘子","110/08/02","康和-嘉義",5,0,5
"10886","6180橘子","110/08/02","永豐金-員林",0,4,-4
"10887","6180橘子","110/08/02","凱基-興隆",5,0,5
"10888","6180橘子","110/08/02","元富-大裕",0,3,-3
"10889","6180橘子","110/08/02","華南永昌-楠梓",5,0,5
"10890","6180橘子","110/08/02","富邦-板橋",0,3,-3
"10891","2390云辰","110/08/02","摩根大通",1945,913,1032
"10892","2390云辰","110/08/02","華南永昌-鳳山",154,448,-294
"10893","2390云辰","110/08/02","富邦-陽明",118,11,107
"10894","2390云辰","110/08/02","群益金鼎-三重",1,168,-167
"10895","2390云辰","110/08/02","兆豐-三民",153,62,91
"10896","2390云辰","110/08/02","統一-內湖",5,102,-97
"10897","2390云辰","110/08/02","光和-嘉義",83,4,79
"10898","2390云辰","110/08/02","台新證券",235,320,-85
"10899","2390云辰","110/08/02","華南永昌-新莊",78,4,74
"10900","2390云辰","110/08/02","統一-新台中",8,87,-79
"10901","2390云辰","110/08/02","統一-城中",182,111,71
"10902","2390云辰","110/08/02","美商高盛",10,88,-78
"10903","2390云辰","110/08/02","台灣摩根士丹利",153,85,68
"10904","2390云辰","110/08/02","元大-汐止",57,130,-73
"10905","2390云辰","110/08/02","凱基-和平",115,47,68
"10906","2390云辰","110/08/02","港商野村",580,638,-58
"10907","2390云辰","110/08/02","華南永昌-公誠",75,13,62
"10908","2390云辰","110/08/02","元富-板橋",5,61,-56
"10909","2390云辰","110/08/02","永豐金-竹科",71,9,62
"10910","2390云辰","110/08/02","新加坡商瑞銀",11,66,-55
"10911","2390云辰","110/08/02","新光",160,100,60
"10912","2390云辰","110/08/02","元大-豐原",6,56,-50
"10913","2390云辰","110/08/02","凱基-岡山",61,1,60
"10914","2390云辰","110/08/02","元大-土城",5,55,-50
"10915","2390云辰","110/08/02","美林",254,195,59
"10916","2390云辰","110/08/02","凱基-站前",1,49,-48
"10917","2390云辰","110/08/02","凱基-大里",76,22,54
"10918","2390云辰","110/08/02","元大-中壢",6,54,-48
"10919","2390云辰","110/08/02","元大-鳳中",60,8,52
"10920","2390云辰","110/08/02","日盛證券",48,95,-47
"10921","1471首利","110/07/29","宏遠-光隆",35,0,35
"10922","1471首利","110/07/29","摩根大通",24,132,-108
"10923","1471首利","110/07/29","玉山-桃園",33,3,30
"10924","1471首利","110/07/29","台灣企銀-太平",0,60,-60
"10925","1471首利","110/07/29","富邦-台南",30,0,30
"10926","1471首利","110/07/29","元大-斗六",0,40,-40
"10927","1471首利","110/07/29","臺灣企銀-桃園",25,0,25
"10928","1471首利","110/07/29","元大-歸仁",0,23,-23
"10929","1471首利","110/07/29","元富-草屯",15,0,15
"10930","1471首利","110/07/29","日盛-永康",0,20,-20
"10931","1471首利","110/07/29","新光-桃園",15,0,15
"10932","1471首利","110/07/29","台中銀-員林",0,20,-20
"10933","1471首利","110/07/29","元大-博愛",15,2,13
"10934","1471首利","110/07/29","凱基-東門",0,14,-14
"10935","1471首利","110/07/29","臺銀-鳳山",12,0,12
"10936","1471首利","110/07/29","元大-草屯",1,15,-14
"10937","1471首利","110/07/29","元富-新莊",11,0,11
"10938","1471首利","110/07/29","元大-新竹經國",0,13,-13
"10939","1471首利","110/07/29","兆豐-來福",11,0,11
"10940","1471首利","110/07/29","日盛-土城",0,10,-10
"10941","1471首利","110/07/29","統一-新營",10,0,10
"10942","1471首利","110/07/29","美林",0,10,-10
"10943","1471首利","110/07/29","光和-溪湖",10,0,10
"10944","1471首利","110/07/29","永興-水湳",0,10,-10
"10945","1471首利","110/07/29","台新-左楠",10,0,10
"10946","1471首利","110/07/29","玉山證券",0,10,-10
"10947","1471首利","110/07/29","群益金鼎-台中",10,0,10
"10948","1471首利","110/07/29","群益金鼎-海山",2,12,-10
"10949","1471首利","110/07/29","凱基-內埔",10,0,10
"10950","1471首利","110/07/29","凱基-羅東",0,10,-10
"10951","2883開發金","110/07/29","國泰證券",2782,3,2779
"10952","2883開發金","110/07/29","永豐金證券",223,3618,-3395
"10953","2883開發金","110/07/29","凱基-台北",2299,284,2015
"10954","2883開發金","110/07/29","摩根大通",411,2625,-2214
"10955","2883開發金","110/07/29","第一金",1539,7,1532
"10956","2883開發金","110/07/29","台灣企銀",5,1717,-1712
"10957","2883開發金","110/07/29","港商野村",1983,585,1398
"10958","2883開發金","110/07/29","新加坡商瑞銀",843,2324,-1481
"10959","2883開發金","110/07/29","元富",1805,427,1378
"10960","2883開發金","110/07/29","港商麥格理",0,1129,-1129
"10961","2883開發金","110/07/29","台灣摩根士丹利",1634,398,1236
"10962","2883開發金","110/07/29","元大-學甲",1,953,-952
"10963","2883開發金","110/07/29","花旗環球",932,0,932
"10964","2883開發金","110/07/29","國票-博愛",100,1025,-925
"10965","2883開發金","110/07/29","凱基-敦北",590,5,585
"10966","2883開發金","110/07/29","國泰-館前",220,944,-724
"10967","2883開發金","110/07/29","國票-長城",506,4,502
"10968","2883開發金","110/07/29","兆豐-高雄",33,650,-617
"10969","2883開發金","110/07/29","港商法國興業",506,18,488
"10970","2883開發金","110/07/29","元富-緯城",1,513,-512
"10971","2883開發金","110/07/29","台新證券",753,287,466
"10972","2883開發金","110/07/29","美林",232,698,-466
"10973","2883開發金","110/07/29","元大-鳳中",495,71,424
"10974","2883開發金","110/07/29","元富-城中",50,513,-463
"10975","2883開發金","110/07/29","日茂",374,3,371
"10976","2883開發金","110/07/29","致和-崇德",0,404,-404
"10977","2883開發金","110/07/29","大和國泰",368,0,368
"10978","2883開發金","110/07/29","永豐金-板橋",123,506,-383
"10979","2883開發金","110/07/29","新光",603,243,360
"10980","2883開發金","110/07/29","中國信託-忠孝",100,423,-323
"10981","6205詮欣","110/07/29","臺銀-鳳山",31,0,31
"10982","6205詮欣","110/07/29","永豐金-敦南",0,53,-53
"10983","6205詮欣","110/07/29","摩根大通",16,2,14
"10984","6205詮欣","110/07/29","元大-土城學府",2,16,-14
"10985","6205詮欣","110/07/29","臺銀",10,0,10
"10986","6205詮欣","110/07/29","元富-潮州",0,11,-11
"10987","6205詮欣","110/07/29","日盛證券",10,0,10
"10988","6205詮欣","110/07/29","元大-清水",0,10,-10
"10989","6205詮欣","110/07/29","兆豐-新莊",10,0,10
"10990","6205詮欣","110/07/29","日盛-三重",0,7,-7
"10991","6205詮欣","110/07/29","元大-南屯",10,0,10
"10992","6205詮欣","110/07/29","日盛-屏東",0,6,-6
"10993","6205詮欣","110/07/29","富邦-建國",4,0,4
"10994","6205詮欣","110/07/29","華南永昌-公誠",0,5,-5
"10995","6205詮欣","110/07/29","富邦-南屯",4,0,4
"10996","6205詮欣","110/07/29","元大-南京",0,5,-5
"10997","6205詮欣","110/07/29","臺銀-臺中",3,0,3
"10998","6205詮欣","110/07/29","瑞士信貸",0,4,-4
"10999","6205詮欣","110/07/29","日盛-和美",3,0,3
"11000","6205詮欣","110/07/29","凱基-大安",0,4,-4
"11001","6205詮欣","110/07/29","德信-新營",3,0,3
"11002","6205詮欣","110/07/29","元大-大里德芳",0,4,-4
"11003","6205詮欣","110/07/29","兆豐-景美",3,0,3
"11004","6205詮欣","110/07/29","合庫-基隆",0,2,-2
"11005","6205詮欣","110/07/29","國票",3,0,3
"11006","6205詮欣","110/07/29","中國信託-永康",0,2,-2
"11007","6205詮欣","110/07/29","國票-南崁",3,0,3
"11008","6205詮欣","110/07/29","兆豐-小港",0,2,-2
"11009","6205詮欣","110/07/29","元大-蘆洲",3,0,3
"11010","6205詮欣","110/07/29","康和-台中",0,2,-2
"11011","1540喬福","110/07/29","高橋-龍潭",10,0,10
"11012","1540喬福","110/07/29","統一-新台中",0,19,-19
"11013","1540喬福","110/07/29","富邦-南屯",10,0,10
"11014","1540喬福","110/07/29","元富-大昌",0,10,-10
"11015","1540喬福","110/07/29","元大-斗六",5,0,5
"11016","1540喬福","110/07/29","大昌-新店",0,6,-6
"11017","1540喬福","110/07/29","兆豐-北高雄",3,0,3
"11018","1540喬福","110/07/29","凱基-台北",0,3,-3
"11019","1540喬福","110/07/29","元大-大安",3,0,3
"11020","1540喬福","110/07/29","台新-台中",0,2,-2
"11021","1540喬福","110/07/29","永豐金-台中",3,0,3
"11022","1540喬福","110/07/29","群益金鼎-嘉義",0,2,-2
"11023","1540喬福","110/07/29","臺銀-金山",2,0,2
"11024","1540喬福","110/07/29","凱基-天母",0,2,-2
"11025","1540喬福","110/07/29","日盛-士林",2,0,2
"11026","1540喬福","110/07/29","花旗環球",0,1,-1
"11027","1540喬福","110/07/29","元大-土城學府",2,0,2
"11028","1540喬福","110/07/29","第一金-大稻埕",0,1,-1
"11029","1540喬福","110/07/29","元大-南京",2,0,2
"11030","1540喬福","110/07/29","統一-嘉義",0,1,-1
"11031","1540喬福","110/07/29","臺銀-臺南",1,0,1
"11032","1540喬福","110/07/29","元富-中港",0,1,-1
"11033","1540喬福","110/07/29","第一金-台南",1,0,1
"11034","1540喬福","110/07/29","(牛牛牛)亞-網路",0,1,-1
"11035","1540喬福","110/07/29","台中銀-豐原",1,0,1
"11036","1540喬福","110/07/29","玉山-高雄",0,1,-1
"11037","1540喬福","110/07/29","中國信託-高雄",1,0,1
"11038","1540喬福","110/07/29","群益金鼎-台南",0,1,-1
"11039","1540喬福","110/07/29","兆豐-台中港",1,0,1
"11040","1540喬福","110/07/29","凱基-鳳山",0,1,-1
"11041","2888新光金","110/07/29","美商高盛",6409,110,6299
"11042","2888新光金","110/07/29","元大-忠孝鼎富",0,6714,-6714
"11043","2888新光金","110/07/29","台灣摩根士丹利",4583,443,4140
"11044","2888新光金","110/07/29","凱基-台北",5855,11898,-6043
"11045","2888新光金","110/07/29","元富-草屯",2193,2,2191
"11046","2888新光金","110/07/29","瑞士信貸",161,6090,-5929
"11047","2888新光金","110/07/29","華南永昌-南京",2059,21,2038
"11048","2888新光金","110/07/29","永豐金-萬盛",124,3599,-3475
"11049","2888新光金","110/07/29","凱基-市政",1558,0,1558
"11050","2888新光金","110/07/29","群益金鼎-大安",2,3306,-3304
"11051","2888新光金","110/07/29","法銀巴黎",1234,0,1234
"11052","2888新光金","110/07/29","凱基-復興",15,3015,-3000
"11053","2888新光金","110/07/29","永豐金-台中",1166,49,1117
"11054","2888新光金","110/07/29","新加坡商瑞銀",1429,4265,-2836
"11055","2888新光金","110/07/29","群益金鼎-崇德",1083,10,1073
"11056","2888新光金","110/07/29","凱基-大安",10,2564,-2554
"11057","2888新光金","110/07/29","兆豐-竹北",1002,29,973
"11058","2888新光金","110/07/29","中國信託",46,2012,-1966
"11059","2888新光金","110/07/29","美林",1767,804,963
"11060","2888新光金","110/07/29","群益金鼎-台北",10,1875,-1865
"11061","2888新光金","110/07/29","元大-三重",882,0,882
"11062","2888新光金","110/07/29","元富-城東",142,1856,-1714
"11063","2888新光金","110/07/29","元大-豐原站前",983,114,869
"11064","2888新光金","110/07/29","華南永昌-忠孝",10,1600,-1590
"11065","2888新光金","110/07/29","元大-北港",868,5,863
"11066","2888新光金","110/07/29","永豐金-信義",10,1497,-1487
"11067","2888新光金","110/07/29","合庫-台中",891,54,837
"11068","2888新光金","110/07/29","富邦-建國",350,1736,-1386
"11069","2888新光金","110/07/29","統一-汐止",725,14,711
"11070","2888新光金","110/07/29","富邦-新營",60,1402,-1342
"11071","1340勝悅","110/07/29","新光-新竹",18,0,18
"11072","1340勝悅","110/07/29","瑞士信貸",0,8,-8
"11073","1340勝悅","110/07/29","華南永昌-彰化",5,0,5
"11074","1340勝悅","110/07/29","台新證券",0,7,-7
"11075","1340勝悅","110/07/29","元大-六合",5,0,5
"11076","1340勝悅","110/07/29","元富-緯城",0,5,-5
"11077","1340勝悅","110/07/29","第一金-自由",4,0,4
"11078","1340勝悅","110/07/29","兆豐-南京",0,5,-5
"11079","1340勝悅","110/07/29","新光",4,0,4
"11080","1340勝悅","110/07/29","富邦-南屯",0,5,-5
"11081","1340勝悅","110/07/29","美商高盛",3,0,3
"11082","1340勝悅","110/07/29","元富-安南",0,4,-4
"11083","1340勝悅","110/07/29","元富-彰化",3,0,3
"11084","1340勝悅","110/07/29","兆豐-三民",0,4,-4
"11085","1340勝悅","110/07/29","大昌",2,0,2
"11086","1340勝悅","110/07/29","兆豐-松德",0,4,-4
"11087","1340勝悅","110/07/29","兆豐-大安",2,0,2
"11088","1340勝悅","110/07/29","國票-台中",0,4,-4
"11089","1340勝悅","110/07/29","摩根大通",2,0,2
"11090","1340勝悅","110/07/29","第一金-路竹",0,3,-3
"11091","1340勝悅","110/07/29","新光-台中",2,0,2
"11092","1340勝悅","110/07/29","統一-城中",2,4,-2
"11093","1340勝悅","110/07/29","凱基-八德",2,0,2
"11094","1340勝悅","110/07/29","元富-同大",0,2,-2
"11095","1340勝悅","110/07/29","合庫-高雄",1,0,1
"11096","1340勝悅","110/07/29","台新-高雄",0,2,-2
"11097","1340勝悅","110/07/29","日進",1,0,1
"11098","1340勝悅","110/07/29","凱基-北門",0,2,-2
"11099","1340勝悅","110/07/29","新光-台南",1,0,1
"11100","1340勝悅","110/07/29","元大-汐止",0,2,-2
"11101","6246臺龍","110/07/29","港商野村",38,1,37
"11102","6246臺龍","110/07/29","玉山-台南",0,27,-27
"11103","6246臺龍","110/07/29","凱基-幸福",25,0,25
"11104","6246臺龍","110/07/29","國泰-忠孝",0,25,-25
"11105","6246臺龍","110/07/29","亞東-板橋",16,0,16
"11106","6246臺龍","110/07/29","光和",0,21,-21
"11107","6246臺龍","110/07/29","元大-台中",10,0,10
"11108","6246臺龍","110/07/29","第一金-安和",0,20,-20
"11109","6246臺龍","110/07/29","兆豐-松德",9,0,9
"11110","6246臺龍","110/07/29","兆豐-竹北",5,25,-20
"11111","6246臺龍","110/07/29","兆豐-公益",8,0,8
"11112","6246臺龍","110/07/29","元大-大里",0,20,-20
"11113","6246臺龍","110/07/29","華南永昌",7,0,7
"11114","6246臺龍","110/07/29","台新-台南",0,15,-15
"11115","6246臺龍","110/07/29","日盛-斗六",6,0,6
"11116","6246臺龍","110/07/29","永豐金-羅東",2,15,-13
"11117","6246臺龍","110/07/29","元富-中港",6,0,6
"11118","6246臺龍","110/07/29","元大-博愛",1,10,-9
"11119","6246臺龍","110/07/29","台新證券",8,2,6
"11120","6246臺龍","110/07/29","宏遠-台中",0,5,-5
"11121","6246臺龍","110/07/29","臺銀-臺中",5,0,5
"11122","6246臺龍","110/07/29","台新-左楠",0,5,-5
"11123","6246臺龍","110/07/29","元富-宜蘭",5,0,5
"11124","6246臺龍","110/07/29","中農",0,5,-5
"11125","6246臺龍","110/07/29","德信-新營",5,0,5
"11126","6246臺龍","110/07/29","群益金鼎-竹南",0,5,-5
"11127","6246臺龍","110/07/29","新光-新竹",5,0,5
"11128","6246臺龍","110/07/29","凱基-科園",0,5,-5
"11129","6246臺龍","110/07/29","國泰-敦南",10,5,5
"11130","6246臺龍","110/07/29","日盛-宜蘭",1,5,-4
"11131","00715L期街口布蘭特正2","110/07/29","永豐金證券",2129,2,2127
"11132","00715L期街口布蘭特正2","110/07/29","國票-博愛",55,702,-647
"11133","00715L期街口布蘭特正2","110/07/29","元大證券",1918,115,1803
"11134","00715L期街口布蘭特正2","110/07/29","富邦-彰化",0,605,-605
"11135","00715L期街口布蘭特正2","110/07/29","統一",1050,313,737
"11136","00715L期街口布蘭特正2","110/07/29","元大-前金",0,440,-440
"11137","00715L期街口布蘭特正2","110/07/29","港商野村",821,263,558
"11138","00715L期街口布蘭特正2","110/07/29","群益金鼎-崇德",0,340,-340
"11139","00715L期街口布蘭特正2","110/07/29","永豐金-內湖",500,0,500
"11140","00715L期街口布蘭特正2","110/07/29","元富-板橋",7,330,-323
"11141","00715L期街口布蘭特正2","110/07/29","元富-大裕",505,23,482
"11142","00715L期街口布蘭特正2","110/07/29","元大-三重",3,200,-197
"11143","00715L期街口布蘭特正2","110/07/29","國票-台中",276,0,276
"11144","00715L期街口布蘭特正2","110/07/29","凱基-東勢",5,194,-189
"11145","00715L期街口布蘭特正2","110/07/29","統一-高雄",300,118,182
"11146","00715L期街口布蘭特正2","110/07/29","富邦-台北",0,181,-181
"11147","00715L期街口布蘭特正2","110/07/29","群益金鼎-瑞豐",180,0,180
"11148","00715L期街口布蘭特正2","110/07/29","大慶-中和",0,174,-174
"11149","00715L期街口布蘭特正2","110/07/29","元大-南崁",128,0,128
"11150","00715L期街口布蘭特正2","110/07/29","永豐金-萬盛",0,153,-153
"11151","00715L期街口布蘭特正2","110/07/29","大慶-蘆洲",106,0,106
"11152","00715L期街口布蘭特正2","110/07/29","元大-開元",0,151,-151
"11153","00715L期街口布蘭特正2","110/07/29","統一-中壢",100,0,100
"11154","00715L期街口布蘭特正2","110/07/29","日盛-新竹",0,126,-126
"11155","00715L期街口布蘭特正2","110/07/29","第一金-自由",100,2,98
"11156","00715L期街口布蘭特正2","110/07/29","凱基-豐中",0,123,-123
"11157","00715L期街口布蘭特正2","110/07/29","華南永昌-內壢",100,2,98
"11158","00715L期街口布蘭特正2","110/07/29","元大-東泰",0,122,-122
"11159","00715L期街口布蘭特正2","110/07/29","永豐金-板橋",98,0,98
"11160","00715L期街口布蘭特正2","110/07/29","台新-高雄",0,121,-121
"11161","8941關中","110/07/29","富邦-仁愛",1,0,1
"11162","8941關中","110/07/29","富邦-員林",0,1,-1
"11163","8941關中","110/07/29","康和-板橋",0,0,0
"11164","8941關中","110/07/29","康和-板橋",0,0,0
"11165","8941關中","110/07/29","玉山證券",0,0,0
"11166","8941關中","110/07/29","玉山證券",0,0,0
"11167","8941關中","110/07/29","玉山-數位",0,0,0
"11168","8941關中","110/07/29","玉山-數位",0,0,0
"11169","8941關中","110/07/29","凱基-市府",0,0,0
"11170","8941關中","110/07/29","凱基-市府",0,0,0
"11171","8941關中","110/07/29","元大-鶯歌",0,0,0
"11172","8941關中","110/07/29","元大-鶯歌",0,0,0
"11173","8941關中","110/07/29","元大-花蓮",0,0,0
"11174","8941關中","110/07/29","元大-花蓮",0,0,0
"11175","8941關中","110/07/29","",NA,NA,NA
"11176","8941關中","110/07/29","",NA,NA,NA
"11177","8941關中","110/07/29","",NA,NA,NA
"11178","8941關中","110/07/29","",NA,NA,NA
"11179","8941關中","110/07/29","",NA,NA,NA
"11180","8941關中","110/07/29","",NA,NA,NA
"11181","8941關中","110/07/29","",NA,NA,NA
"11182","8941關中","110/07/29","",NA,NA,NA
"11183","8941關中","110/07/29","",NA,NA,NA
"11184","8941關中","110/07/29","",NA,NA,NA
"11185","8941關中","110/07/29","",NA,NA,NA
"11186","8941關中","110/07/29","",NA,NA,NA
"11187","8941關中","110/07/29","",NA,NA,NA
"11188","8941關中","110/07/29","",NA,NA,NA
"11189","8941關中","110/07/29","",NA,NA,NA
"11190","8941關中","110/07/29","",NA,NA,NA
"11191","8936國統","110/07/29","新加坡商瑞銀",89,19,70
"11192","8936國統","110/07/29","日盛-忠孝",11,135,-124
"11193","8936國統","110/07/29","瑞士信貸",55,3,52
"11194","8936國統","110/07/29","元富-敦南",0,80,-80
"11195","8936國統","110/07/29","凱基-台北",48,3,45
"11196","8936國統","110/07/29","康和",0,20,-20
"11197","8936國統","110/07/29","摩根大通",97,60,37
"11198","8936國統","110/07/29","元大-竹科",0,20,-20
"11199","8936國統","110/07/29","美林",27,2,25
"11200","8936國統","110/07/29","永豐金-桃園",0,19,-19
"11201","8936國統","110/07/29","凱基-三多",25,0,25
"11202","8936國統","110/07/29","群益金鼎-高盛",0,14,-14
"11203","8936國統","110/07/29","凱基-北門",27,2,25
"11204","8936國統","110/07/29","元富-安南",2,15,-13
"11205","8936國統","110/07/29","兆豐-桃鶯",30,10,20
"11206","8936國統","110/07/29","富邦-內湖",2,15,-13
"11207","8936國統","110/07/29","永豐金-台中",20,0,20
"11208","8936國統","110/07/29","元大-復北",0,11,-11
"11209","8936國統","110/07/29","台灣摩根士丹利",30,12,18
"11210","8936國統","110/07/29","合庫-鳳山",0,10,-10
"11211","8936國統","110/07/29","兆豐-大同",15,0,15
"11212","8936國統","110/07/29","元富-潮州",0,10,-10
"11213","8936國統","110/07/29","新光-台中",39,24,15
"11214","8936國統","110/07/29","群益金鼎-台北",0,10,-10
"11215","8936國統","110/07/29","兆豐-新營",10,0,10
"11216","8936國統","110/07/29","凱基-高雄",20,30,-10
"11217","8936國統","110/07/29","台新-高雄",10,0,10
"11218","8936國統","110/07/29","富邦-桃園",0,10,-10
"11219","8936國統","110/07/29","玉山-士林",10,0,10
"11220","8936國統","110/07/29","新光",1,10,-9
"11221","6226光鼎","110/07/29","台新-台中",396,46,350
"11222","6226光鼎","110/07/29","群益金鼎-東大",11,309,-298
"11223","6226光鼎","110/07/29","元富-永和",242,0,242
"11224","6226光鼎","110/07/29","日盛證券",2,176,-174
"11225","6226光鼎","110/07/29","永豐金-古亭",200,0,200
"11226","6226光鼎","110/07/29","國泰-敦南",90,197,-107
"11227","6226光鼎","110/07/29","華南永昌",216,46,170
"11228","6226光鼎","110/07/29","元大-雙和",16,111,-95
"11229","6226光鼎","110/07/29","國票-北高雄",188,36,152
"11230","6226光鼎","110/07/29","元大-大統",2,94,-92
"11231","6226光鼎","110/07/29","國票-台南",120,4,116
"11232","6226光鼎","110/07/29","元大-板橋",5,78,-73
"11233","6226光鼎","110/07/29","永豐金證券",101,3,98
"11234","6226光鼎","110/07/29","群益金鼎-萬華",46,111,-65
"11235","6226光鼎","110/07/29","富邦-建國",125,28,97
"11236","6226光鼎","110/07/29","華南永昌-竹北",1,60,-59
"11237","6226光鼎","110/07/29","群益金鼎-土城",94,9,85
"11238","6226光鼎","110/07/29","玉山證券",28,86,-58
"11239","6226光鼎","110/07/29","元富-四維",82,4,78
"11240","6226光鼎","110/07/29","元大-土城學府",13,68,-55
"11241","6226光鼎","110/07/29","元大-鳳中",69,15,54
"11242","6226光鼎","110/07/29","元大-豐原",5,59,-54
"11243","6226光鼎","110/07/29","台新-新莊",54,1,53
"11244","6226光鼎","110/07/29","統一",56,107,-51
"11245","6226光鼎","110/07/29","中國信託-新竹",63,13,50
"11246","6226光鼎","110/07/29","統一-內湖",0,48,-48
"11247","6226光鼎","110/07/29","群益金鼎-士林",50,0,50
"11248","6226光鼎","110/07/29","元大-東港",2,50,-48
"11249","6226光鼎","110/07/29","台新-高雄",125,80,45
"11250","6226光鼎","110/07/29","元大-太平",1,46,-45
"11251","2363矽統","110/07/29","凱基-台北",2235,1238,997
"11252","2363矽統","110/07/29","康和-台中",10,437,-427
"11253","2363矽統","110/07/29","摩根大通",1784,793,991
"11254","2363矽統","110/07/29","第一金-新興",11,310,-299
"11255","2363矽統","110/07/29","港商野村",1833,1300,533
"11256","2363矽統","110/07/29","瑞士信貸",9,190,-181
"11257","2363矽統","110/07/29","美林",652,288,364
"11258","2363矽統","110/07/29","台新證券",659,808,-149
"11259","2363矽統","110/07/29","元大-台中",376,38,338
"11260","2363矽統","110/07/29","元大-萬華",42,189,-147
"11261","2363矽統","110/07/29","新加坡商瑞銀",748,474,274
"11262","2363矽統","110/07/29","台新-左楠",26,171,-145
"11263","2363矽統","110/07/29","國泰-敦南",566,333,233
"11264","2363矽統","110/07/29","華南永昌-鳳山",116,241,-125
"11265","2363矽統","110/07/29","元大-旗山",299,66,233
"11266","2363矽統","110/07/29","永全-南崁",0,117,-117
"11267","2363矽統","110/07/29","美商高盛",600,433,167
"11268","2363矽統","110/07/29","群益金鼎-桃園",25,131,-106
"11269","2363矽統","110/07/29","元大-永和",146,12,134
"11270","2363矽統","110/07/29","宏遠-新化",3,103,-100
"11271","2363矽統","110/07/29","元大證券",137,9,128
"11272","2363矽統","110/07/29","新光",331,429,-98
"11273","2363矽統","110/07/29","永豐金-彰化",135,10,125
"11274","2363矽統","110/07/29","中國信託-忠孝",101,188,-87
"11275","2363矽統","110/07/29","北城證券",139,19,120
"11276","2363矽統","110/07/29","群益金鼎-建成",11,95,-84
"11277","2363矽統","110/07/29","富邦-高雄",153,34,119
"11278","2363矽統","110/07/29","群益金鼎-三民",23,105,-82
"11279","2363矽統","110/07/29","元大-蘆洲",120,19,101
"11280","2363矽統","110/07/29","元大-豐原",104,186,-82
"11281","8112至上","110/07/29","合庫證券",194,1,193
"11282","8112至上","110/07/29","摩根大通",4,424,-420
"11283","8112至上","110/07/29","美商高盛",154,5,149
"11284","8112至上","110/07/29","日盛-高雄",2,400,-398
"11285","8112至上","110/07/29","永豐金證券",144,0,144
"11286","8112至上","110/07/29","港商法國興業",0,374,-374
"11287","8112至上","110/07/29","新光-台中",123,12,111
"11288","8112至上","110/07/29","凱基-台北",50,312,-262
"11289","8112至上","110/07/29","新加坡商瑞銀",189,83,106
"11290","8112至上","110/07/29","美林",69,232,-163
"11291","8112至上","110/07/29","華南永昌-新莊",73,0,73
"11292","8112至上","110/07/29","兆豐-公益",0,120,-120
"11293","8112至上","110/07/29","新光",108,49,59
"11294","8112至上","110/07/29","瑞士信貸",1,109,-108
"11295","8112至上","110/07/29","元富-文心",45,3,42
"11296","8112至上","110/07/29","華南永昌-小港",4,30,-26
"11297","8112至上","110/07/29","華南永昌-林口",41,0,41
"11298","8112至上","110/07/29","富邦-中壢",1,24,-23
"11299","8112至上","110/07/29","港商野村",146,112,34
"11300","8112至上","110/07/29","元大-歸仁",2,24,-22
"11301","8112至上","110/07/29","臺銀-高雄",30,0,30
"11302","8112至上","110/07/29","華南永昌-麻豆",0,21,-21
"11303","8112至上","110/07/29","元富-佳里",30,0,30
"11304","8112至上","110/07/29","台新-松江",0,20,-20
"11305","8112至上","110/07/29","永豐金-內湖",30,1,29
"11306","8112至上","110/07/29","元大-新莊",1,20,-19
"11307","8112至上","110/07/29","台新-新營",31,3,28
"11308","8112至上","110/07/29","華南永昌-岡山",1,19,-18
"11309","8112至上","110/07/29","永豐金-彰化",27,0,27
"11310","8112至上","110/07/29","元大-崇德",3,20,-17
"11311","1570力肯","110/07/29","群益金鼎-高雄",20,0,20
"11312","1570力肯","110/07/29","聯邦-興中",0,17,-17
"11313","1570力肯","110/07/29","群益金鼎-板橋",16,0,16
"11314","1570力肯","110/07/29","富邦-建國",0,10,-10
"11315","1570力肯","110/07/29","統一-敦南",5,0,5
"11316","1570力肯","110/07/29","凱基-站前",0,5,-5
"11317","1570力肯","110/07/29","元富-松德",4,0,4
"11318","1570力肯","110/07/29","國泰-板橋",0,4,-4
"11319","1570力肯","110/07/29","元大-和平",4,0,4
"11320","1570力肯","110/07/29","統一-土城",0,3,-3
"11321","1570力肯","110/07/29","凱基-幸福",3,0,3
"11322","1570力肯","110/07/29","凱基-大里",0,3,-3
"11323","1570力肯","110/07/29","華南永昌-鳳山",3,0,3
"11324","1570力肯","110/07/29","凱基-台北",0,3,-3
"11325","1570力肯","110/07/29","元大-北港",4,2,2
"11326","1570力肯","110/07/29","元大-屏東民生",0,3,-3
"11327","1570力肯","110/07/29","美林",1,0,1
"11328","1570力肯","110/07/29","元富-緯城",0,2,-2
"11329","1570力肯","110/07/29","國泰-台南",1,0,1
"11330","1570力肯","110/07/29","台新-高雄",0,2,-2
"11331","1570力肯","110/07/29","元大-歸仁",1,0,1
"11332","1570力肯","110/07/29","華南永昌-楠梓",0,2,-2
"11333","1570力肯","110/07/29","元大-松山",1,0,1
"11334","1570力肯","110/07/29","元大-北成功",0,2,-2
"11335","1570力肯","110/07/29","元大-文心興安",1,0,1
"11336","1570力肯","110/07/29","元大-板橋",0,2,-2
"11337","1570力肯","110/07/29","元大-東蘆",1,0,1
"11338","1570力肯","110/07/29","統一-台南",0,1,-1
"11339","1570力肯","110/07/29","群益金鼎-鳳山",0,0,0
"11340","1570力肯","110/07/29","台新證券",0,1,-1
"11341","2929淘帝","110/07/29","新光-新竹",118,13,105
"11342","2929淘帝","110/07/29","元富-敦南",0,91,-91
"11343","2929淘帝","110/07/29","新加坡商瑞銀",56,0,56
"11344","2929淘帝","110/07/29","日盛-板橋中山",0,38,-38
"11345","2929淘帝","110/07/29","凱基-台北",39,4,35
"11346","2929淘帝","110/07/29","群益金鼎-士林",0,20,-20
"11347","2929淘帝","110/07/29","元大-民生",29,0,29
"11348","2929淘帝","110/07/29","華南永昌-敦南",0,20,-20
"11349","2929淘帝","110/07/29","美林",37,9,28
"11350","2929淘帝","110/07/29","高橋-龍潭",3,20,-17
"11351","2929淘帝","110/07/29","元大-承德",15,0,15
"11352","2929淘帝","110/07/29","凱基-中山",4,19,-15
"11353","2929淘帝","110/07/29","第一金-台南",10,0,10
"11354","2929淘帝","110/07/29","富邦-台北",0,15,-15
"11355","2929淘帝","110/07/29","富邦-桃園",9,0,9
"11356","2929淘帝","110/07/29","元富-台中",0,14,-14
"11357","2929淘帝","110/07/29","港商野村",17,10,7
"11358","2929淘帝","110/07/29","台新-建北",0,13,-13
"11359","2929淘帝","110/07/29","台中銀-豐原",6,0,6
"11360","2929淘帝","110/07/29","永豐金-敦南",0,12,-12
"11361","2929淘帝","110/07/29","元大-文心興安",6,0,6
"11362","2929淘帝","110/07/29","新光-台南",0,11,-11
"11363","2929淘帝","110/07/29","德信-新營",5,0,5
"11364","2929淘帝","110/07/29","宏遠-光隆",0,10,-10
"11365","2929淘帝","110/07/29","元大-博愛",5,0,5
"11366","2929淘帝","110/07/29","元大-嘉義",0,6,-6
"11367","2929淘帝","110/07/29","元大-員林",5,0,5
"11368","2929淘帝","110/07/29","日茂-南投",0,5,-5
"11369","2929淘帝","110/07/29","富邦-中壢",4,0,4
"11370","2929淘帝","110/07/29","新光",0,5,-5
"11371","5410國眾","110/07/29","兆豐-城中",32,0,32
"11372","5410國眾","110/07/29","第一金-台南",0,51,-51
"11373","5410國眾","110/07/29","新加坡商瑞銀",19,0,19
"11374","5410國眾","110/07/29","元富-大昌",0,13,-13
"11375","5410國眾","110/07/29","華南永昌-新莊",16,0,16
"11376","5410國眾","110/07/29","臺銀-臺南",0,12,-12
"11377","5410國眾","110/07/29","元大-小港",11,0,11
"11378","5410國眾","110/07/29","日盛-木柵",0,10,-10
"11379","5410國眾","110/07/29","臺銀",10,0,10
"11380","5410國眾","110/07/29","元富-安南",0,10,-10
"11381","5410國眾","110/07/29","臺銀-臺中",10,0,10
"11382","5410國眾","110/07/29","新光",4,13,-9
"11383","5410國眾","110/07/29","宏遠-館前",10,0,10
"11384","5410國眾","110/07/29","永豐金-屏東",0,5,-5
"11385","5410國眾","110/07/29","台新-中壢",10,0,10
"11386","5410國眾","110/07/29","永豐金-苓雅",0,5,-5
"11387","5410國眾","110/07/29","摩根大通",10,1,9
"11388","5410國眾","110/07/29","國票-台南",0,4,-4
"11389","5410國眾","110/07/29","元大-北投",9,0,9
"11390","5410國眾","110/07/29","永豐金-埔里",0,4,-4
"11391","5410國眾","110/07/29","台新證券",7,1,6
"11392","5410國眾","110/07/29","光和",0,3,-3
"11393","5410國眾","110/07/29","元富-新竹",5,0,5
"11394","5410國眾","110/07/29","凱基-汐止",0,3,-3
"11395","5410國眾","110/07/29","凱基-竹北",5,0,5
"11396","5410國眾","110/07/29","元大-善化",0,3,-3
"11397","5410國眾","110/07/29","永豐金-敦南",5,1,4
"11398","5410國眾","110/07/29","元大-員林",0,3,-3
"11399","5410國眾","110/07/29","美林",4,1,3
"11400","5410國眾","110/07/29","永豐金-台南",0,3,-3
"11401","2841台開","110/07/29","兆豐-台南",237,0,237
"11402","2841台開","110/07/29","元大-四維",0,184,-184
"11403","2841台開","110/07/29","永豐金-敦南",60,10,50
"11404","2841台開","110/07/29","玉山-新竹",0,145,-145
"11405","2841台開","110/07/29","永豐金-板新",50,0,50
"11406","2841台開","110/07/29","港商野村",0,124,-124
"11407","2841台開","110/07/29","華南永昌-南京",45,2,43
"11408","2841台開","110/07/29","永豐金-台南",0,32,-32
"11409","2841台開","110/07/29","群益金鼎-崇德",23,0,23
"11410","2841台開","110/07/29","華南永昌-公誠",0,23,-23
"11411","2841台開","110/07/29","日盛-園區",20,0,20
"11412","2841台開","110/07/29","元大-善化",0,22,-22
"11413","2841台開","110/07/29","台新-台中",20,0,20
"11414","2841台開","110/07/29","元大-豐原",0,20,-20
"11415","2841台開","110/07/29","華南永昌-新莊",20,0,20
"11416","2841台開","110/07/29","凱基-台北",0,15,-15
"11417","2841台開","110/07/29","富邦-仁愛",20,0,20
"11418","2841台開","110/07/29","富邦-台北",0,15,-15
"11419","2841台開","110/07/29","新光",15,0,15
"11420","2841台開","110/07/29","臺銀",0,10,-10
"11421","2841台開","110/07/29","華南永昌-台中",15,0,15
"11422","2841台開","110/07/29","元富-三重",0,10,-10
"11423","2841台開","110/07/29","凱基-彰化",13,0,13
"11424","2841台開","110/07/29","元大-林森",0,10,-10
"11425","2841台開","110/07/29","兆豐-台中",10,0,10
"11426","2841台開","110/07/29","光和-花壇",0,9,-9
"11427","2841台開","110/07/29","永豐金-松山",10,0,10
"11428","2841台開","110/07/29","國泰-桃園",1,10,-9
"11429","2841台開","110/07/29","國泰-館前",9,0,9
"11430","2841台開","110/07/29","玉山-嘉義",0,8,-8
"11431","6207雷科","110/07/29","永豐金-古亭",100,0,100
"11432","6207雷科","110/07/29","摩根大通",59,151,-92
"11433","6207雷科","110/07/29","國泰-館前",52,6,46
"11434","6207雷科","110/07/29","凱基-高雄",0,82,-82
"11435","6207雷科","110/07/29","新加坡商瑞銀",41,12,29
"11436","6207雷科","110/07/29","元大-松江",0,25,-25
"11437","6207雷科","110/07/29","大慶-蘆洲",29,6,23
"11438","6207雷科","110/07/29","元大-雙和",2,25,-23
"11439","6207雷科","110/07/29","永豐金-羅東",21,0,21
"11440","6207雷科","110/07/29","港商野村",16,36,-20
"11441","6207雷科","110/07/29","統一-南京",16,0,16
"11442","6207雷科","110/07/29","盈溢-楠梓",0,20,-20
"11443","6207雷科","110/07/29","凱基-台北",45,29,16
"11444","6207雷科","110/07/29","統一",2,20,-18
"11445","6207雷科","110/07/29","富邦-敦南",16,0,16
"11446","6207雷科","110/07/29","日盛-新竹",1,16,-15
"11447","6207雷科","110/07/29","統一-高雄",15,0,15
"11448","6207雷科","110/07/29","康和-台中",0,15,-15
"11449","6207雷科","110/07/29","台新-中壢",11,0,11
"11450","6207雷科","110/07/29","凱基-竹科",0,13,-13
"11451","6207雷科","110/07/29","台灣企銀-竹北",10,0,10
"11452","6207雷科","110/07/29","元大-鳳中",0,12,-12
"11453","6207雷科","110/07/29","宏遠證券",10,0,10
"11454","6207雷科","110/07/29","元大-土城",0,12,-12
"11455","6207雷科","110/07/29","中國信託-忠孝",10,0,10
"11456","6207雷科","110/07/29","華南永昌-高雄",0,11,-11
"11457","6207雷科","110/07/29","大昌-桃園",11,1,10
"11458","6207雷科","110/07/29","元大-木柵",0,10,-10
"11459","6207雷科","110/07/29","玉山-城中",11,1,10
"11460","6207雷科","110/07/29","日盛-板橋",1,10,-9
"11461","3679新至陞","110/07/29","華南永昌-淡水",5,0,5
"11462","3679新至陞","110/07/29","元富-板橋",0,16,-16
"11463","3679新至陞","110/07/29","富邦-新竹華信",5,0,5
"11464","3679新至陞","110/07/29","凱基-台北",0,8,-8
"11465","3679新至陞","110/07/29","永豐金-中和",5,0,5
"11466","3679新至陞","110/07/29","摩根大通",1,6,-5
"11467","3679新至陞","110/07/29","富邦-台北",4,0,4
"11468","3679新至陞","110/07/29","美林",0,4,-4
"11469","3679新至陞","110/07/29","元富-彰化",2,0,2
"11470","3679新至陞","110/07/29","瑞士信貸",0,4,-4
"11471","3679新至陞","110/07/29","兆豐-台中港",2,0,2
"11472","3679新至陞","110/07/29","元大-成功",0,3,-3
"11473","3679新至陞","110/07/29","富邦-三重",2,0,2
"11474","3679新至陞","110/07/29","統一-台南",0,2,-2
"11475","3679新至陞","110/07/29","元大-沙鹿",2,0,2
"11476","3679新至陞","110/07/29","元富-新興",0,2,-2
"11477","3679新至陞","110/07/29","元大-福營",2,0,2
"11478","3679新至陞","110/07/29","凱基-竹科",0,2,-2
"11479","3679新至陞","110/07/29","元大-花蓮",2,0,2
"11480","3679新至陞","110/07/29","元大證券",0,2,-2
"11481","3679新至陞","110/07/29","元大-板橋",2,0,2
"11482","3679新至陞","110/07/29","日盛-北高雄",0,1,-1
"11483","3679新至陞","110/07/29","永豐金-台南",2,0,2
"11484","3679新至陞","110/07/29","宏遠-高雄",0,1,-1
"11485","3679新至陞","110/07/29","合庫-彰化",1,0,1
"11486","3679新至陞","110/07/29","花旗環球",0,1,-1
"11487","3679新至陞","110/07/29","臺銀-臺南",1,0,1
"11488","3679新至陞","110/07/29","華南永昌-岡山",0,1,-1
"11489","3679新至陞","110/07/29","永興-水湳",1,0,1
"11490","3679新至陞","110/07/29","元大-佳里",0,1,-1
"11491","2727王品","110/07/29","第一金",30,0,30
"11492","2727王品","110/07/29","元大-高雄",1,93,-92
"11493","2727王品","110/07/29","港商麥格理",22,0,22
"11494","2727王品","110/07/29","新加坡商瑞銀",5,82,-77
"11495","2727王品","110/07/29","國票-北高雄",24,2,22
"11496","2727王品","110/07/29","美林",0,27,-27
"11497","2727王品","110/07/29","日盛-忠孝",21,0,21
"11498","2727王品","110/07/29","港商野村",21,48,-27
"11499","2727王品","110/07/29","新光",22,3,19
"11500","2727王品","110/07/29","凱基-台北",43,61,-18
"11501","2727王品","110/07/29","國泰-敦南",18,7,11
"11502","2727王品","110/07/29","華南永昌-麻豆",0,18,-18
"11503","2727王品","110/07/29","凱基-五股",11,0,11
"11504","2727王品","110/07/29","國泰-台中",2,17,-15
"11505","2727王品","110/07/29","兆豐-鹿港",12,2,10
"11506","2727王品","110/07/29","永豐金-桃盛",0,15,-15
"11507","2727王品","110/07/29","凱基-埔墘",10,0,10
"11508","2727王品","110/07/29","美商高盛",1,15,-14
"11509","2727王品","110/07/29","永豐金-潮州",10,0,10
"11510","2727王品","110/07/29","玉山證券",4,15,-11
"11511","2727王品","110/07/29","統一",12,4,8
"11512","2727王品","110/07/29","摩根大通",12,22,-10
"11513","2727王品","110/07/29","國泰-板橋",7,0,7
"11514","2727王品","110/07/29","元大-四維",2,12,-10
"11515","2727王品","110/07/29","彰銀-台中",7,1,6
"11516","2727王品","110/07/29","凱基-興隆",0,9,-9
"11517","2727王品","110/07/29","新光-高雄",12,6,6
"11518","2727王品","110/07/29","瑞士信貸",0,8,-8
"11519","2727王品","110/07/29","玉山-數位",6,0,6
"11520","2727王品","110/07/29","大昌-桃園",0,7,-7
"11521","1570力肯","110/07/29","群益金鼎-高雄",20,0,20
"11522","1570力肯","110/07/29","聯邦-興中",0,17,-17
"11523","1570力肯","110/07/29","群益金鼎-板橋",16,0,16
"11524","1570力肯","110/07/29","富邦-建國",0,10,-10
"11525","1570力肯","110/07/29","統一-敦南",5,0,5
"11526","1570力肯","110/07/29","凱基-站前",0,5,-5
"11527","1570力肯","110/07/29","元富-松德",4,0,4
"11528","1570力肯","110/07/29","國泰-板橋",0,4,-4
"11529","1570力肯","110/07/29","元大-和平",4,0,4
"11530","1570力肯","110/07/29","統一-土城",0,3,-3
"11531","1570力肯","110/07/29","凱基-幸福",3,0,3
"11532","1570力肯","110/07/29","凱基-大里",0,3,-3
"11533","1570力肯","110/07/29","華南永昌-鳳山",3,0,3
"11534","1570力肯","110/07/29","凱基-台北",0,3,-3
"11535","1570力肯","110/07/29","元大-北港",4,2,2
"11536","1570力肯","110/07/29","元大-屏東民生",0,3,-3
"11537","1570力肯","110/07/29","美林",1,0,1
"11538","1570力肯","110/07/29","元富-緯城",0,2,-2
"11539","1570力肯","110/07/29","國泰-台南",1,0,1
"11540","1570力肯","110/07/29","台新-高雄",0,2,-2
"11541","1570力肯","110/07/29","元大-歸仁",1,0,1
"11542","1570力肯","110/07/29","華南永昌-楠梓",0,2,-2
"11543","1570力肯","110/07/29","元大-松山",1,0,1
"11544","1570力肯","110/07/29","元大-北成功",0,2,-2
"11545","1570力肯","110/07/29","元大-文心興安",1,0,1
"11546","1570力肯","110/07/29","元大-板橋",0,2,-2
"11547","1570力肯","110/07/29","元大-東蘆",1,0,1
"11548","1570力肯","110/07/29","統一-台南",0,1,-1
"11549","1570力肯","110/07/29","群益金鼎-鳳山",0,0,0
"11550","1570力肯","110/07/29","台新證券",0,1,-1
"11551","6180橘子","110/07/29","凱基-台北",50,4,46
"11552","6180橘子","110/07/29","兆豐證券",0,95,-95
"11553","6180橘子","110/07/29","花旗環球",25,0,25
"11554","6180橘子","110/07/29","香港上海匯豐",0,74,-74
"11555","6180橘子","110/07/29","瑞士信貸",26,2,24
"11556","6180橘子","110/07/29","福勝",0,24,-24
"11557","6180橘子","110/07/29","兆豐-大同",20,0,20
"11558","6180橘子","110/07/29","第一金-安和",0,20,-20
"11559","6180橘子","110/07/29","新光-台中",17,0,17
"11560","6180橘子","110/07/29","永豐金-敦北",0,18,-18
"11561","6180橘子","110/07/29","元大-南屯",15,0,15
"11562","6180橘子","110/07/29","致和-崇德",0,10,-10
"11563","6180橘子","110/07/29","摩根大通",54,40,14
"11564","6180橘子","110/07/29","玉山-台大",0,10,-10
"11565","6180橘子","110/07/29","玉山-桃園",10,0,10
"11566","6180橘子","110/07/29","元大-四維",0,10,-10
"11567","6180橘子","110/07/29","永豐金-中正",10,0,10
"11568","6180橘子","110/07/29","元大-小港",0,8,-8
"11569","6180橘子","110/07/29","元富-三重",8,0,8
"11570","6180橘子","110/07/29","台灣摩根士丹利",7,13,-6
"11571","6180橘子","110/07/29","國泰-新莊",9,1,8
"11572","6180橘子","110/07/29","群益金鼎-丹鳳",0,6,-6
"11573","6180橘子","110/07/29","元大-木柵",8,0,8
"11574","6180橘子","110/07/29","永豐金-南京",2,8,-6
"11575","6180橘子","110/07/29","國票-敦北法人",7,0,7
"11576","6180橘子","110/07/29","日盛-頭份",5,10,-5
"11577","6180橘子","110/07/29","元大證券",7,0,7
"11578","6180橘子","110/07/29","宏遠-高雄",0,5,-5
"11579","6180橘子","110/07/29","高橋",6,0,6
"11580","6180橘子","110/07/29","第一金-中山",1,5,-4
"11581","2390云辰","110/07/29","元大-永和",561,61,500
"11582","2390云辰","110/07/29","摩根大通",152,377,-225
"11583","2390云辰","110/07/29","台灣摩根士丹利",163,1,162
"11584","2390云辰","110/07/29","元富-同大",3,139,-136
"11585","2390云辰","110/07/29","元大-善化",87,0,87
"11586","2390云辰","110/07/29","豐農",3,128,-125
"11587","2390云辰","110/07/29","元大-草屯",89,6,83
"11588","2390云辰","110/07/29","美商高盛",6,88,-82
"11589","2390云辰","110/07/29","富邦-羅東",74,10,64
"11590","2390云辰","110/07/29","美林",43,112,-69
"11591","2390云辰","110/07/29","元大-鑫永和",61,1,60
"11592","2390云辰","110/07/29","元大-發財",4,61,-57
"11593","2390云辰","110/07/29","元富-高雄",93,40,53
"11594","2390云辰","110/07/29","大慶-泰山",0,51,-51
"11595","2390云辰","110/07/29","台新-左楠",43,1,42
"11596","2390云辰","110/07/29","群益金鼎",5,49,-44
"11597","2390云辰","110/07/29","日盛-永康",35,2,33
"11598","2390云辰","110/07/29","元大-松江",0,40,-40
"11599","2390云辰","110/07/29","玉山-板橋",37,5,32
"11600","2390云辰","110/07/29","統一-新台中",123,161,-38
"11601","2390云辰","110/07/29","日盛-板橋中山",45,15,30
"11602","2390云辰","110/07/29","兆豐-員林",0,35,-35
"11603","2390云辰","110/07/29","元大-大統",30,0,30
"11604","2390云辰","110/07/29","第一金-新竹",1,35,-34
"11605","2390云辰","110/07/29","元大-竹北",30,1,29
"11606","2390云辰","110/07/29","日盛-員林",3,33,-30
"11607","2390云辰","110/07/29","元大-北屯",26,0,26
"11608","2390云辰","110/07/29","新光",40,70,-30
"11609","2390云辰","110/07/29","元大-林園",25,0,25
"11610","2390云辰","110/07/29","永豐金-松山",21,49,-28
"11611","1471首利","110/07/28","美林",138,26,112
"11612","1471首利","110/07/28","玉山-台大",0,234,-234
"11613","1471首利","110/07/28","摩根大通",164,80,84
"11614","1471首利","110/07/28","國票-九鼎",0,149,-149
"11615","1471首利","110/07/28","(牛牛牛)亞-鑫豐",65,0,65
"11616","1471首利","110/07/28","台中銀",0,69,-69
"11617","1471首利","110/07/28","大昌-新店",44,0,44
"11618","1471首利","110/07/28","元大-博愛",0,32,-32
"11619","1471首利","110/07/28","玉山-桃園",69,30,39
"11620","1471首利","110/07/28","凱基-竹北",0,30,-30
"11621","1471首利","110/07/28","兆豐-鹿港",28,0,28
"11622","1471首利","110/07/28","富邦-苗栗",0,30,-30
"11623","1471首利","110/07/28","聯邦-高雄",21,0,21
"11624","1471首利","110/07/28","港商法國興業",0,22,-22
"11625","1471首利","110/07/28","永豐金-中正",21,0,21
"11626","1471首利","110/07/28","國票-安和",0,20,-20
"11627","1471首利","110/07/28","第一金-高雄",16,0,16
"11628","1471首利","110/07/28","華南永昌-苑裡",0,15,-15
"11629","1471首利","110/07/28","統一-桃園",13,0,13
"11630","1471首利","110/07/28","日盛-中壢",0,13,-13
"11631","1471首利","110/07/28","新光-台中",19,6,13
"11632","1471首利","110/07/28","玉山-台南",0,13,-13
"11633","1471首利","110/07/28","彰銀-七賢",11,0,11
"11634","1471首利","110/07/28","凱基-桃園",0,12,-12
"11635","1471首利","110/07/28","第一金-台南",11,0,11
"11636","1471首利","110/07/28","聯邦-雙和",0,11,-11
"11637","1471首利","110/07/28","台新證券",11,0,11
"11638","1471首利","110/07/28","統一-新營",0,10,-10
"11639","1471首利","110/07/28","凱基-東勢",11,0,11
"11640","1471首利","110/07/28","凱基-城中",0,10,-10
"11641","2883開發金","110/07/28","摩根大通",5171,647,4524
"11642","2883開發金","110/07/28","台灣摩根士丹利",921,11451,-10530
"11643","2883開發金","110/07/28","瑞士信貸",4234,62,4172
"11644","2883開發金","110/07/28","美商高盛",522,3615,-3093
"11645","2883開發金","110/07/28","國泰證券",2247,28,2219
"11646","2883開發金","110/07/28","(牛牛牛)亞證券",0,3000,-3000
"11647","2883開發金","110/07/28","元大證券",2306,91,2215
"11648","2883開發金","110/07/28","康和-仁愛",17,3004,-2987
"11649","2883開發金","110/07/28","元富-城東",2203,113,2090
"11650","2883開發金","110/07/28","第一金",18,2301,-2283
"11651","2883開發金","110/07/28","新加坡商瑞銀",1840,81,1759
"11652","2883開發金","110/07/28","凱基-台北",3735,5169,-1434
"11653","2883開發金","110/07/28","永豐金-彰化",1682,27,1655
"11654","2883開發金","110/07/28","宏遠-高雄",4,1420,-1416
"11655","2883開發金","110/07/28","日盛證券",1637,9,1628
"11656","2883開發金","110/07/28","亞東-板橋",507,1722,-1215
"11657","2883開發金","110/07/28","元大-彰化",1183,11,1172
"11658","2883開發金","110/07/28","凱基-豐中",32,1127,-1095
"11659","2883開發金","110/07/28","美林",2507,1378,1129
"11660","2883開發金","110/07/28","群益金鼎-三重",65,993,-928
"11661","2883開發金","110/07/28","華南永昌",1204,239,965
"11662","2883開發金","110/07/28","元大-羅東",30,872,-842
"11663","2883開發金","110/07/28","日盛-台南",816,6,810
"11664","2883開發金","110/07/28","花旗環球",188,1004,-816
"11665","2883開發金","110/07/28","台新-松江",722,40,682
"11666","2883開發金","110/07/28","華南永昌-朴子",33,716,-683
"11667","2883開發金","110/07/28","新光-台中",858,231,627
"11668","2883開發金","110/07/28","元大-永和",31,700,-669
"11669","2883開發金","110/07/28","凱基-員林",634,25,609
"11670","2883開發金","110/07/28","玉山-台南",97,738,-641
"11671","6205詮欣","110/07/28","臺銀",30,0,30
"11672","6205詮欣","110/07/28","台灣摩根士丹利",0,59,-59
"11673","6205詮欣","110/07/28","元大-善化",30,0,30
"11674","6205詮欣","110/07/28","凱基-大安",0,50,-50
"11675","6205詮欣","110/07/28","日盛證券",16,0,16
"11676","6205詮欣","110/07/28","元大-板橋",0,20,-20
"11677","6205詮欣","110/07/28","元大-土城學府",15,3,12
"11678","6205詮欣","110/07/28","摩根大通",17,30,-13
"11679","6205詮欣","110/07/28","臺銀-民權",10,0,10
"11680","6205詮欣","110/07/28","凱基-台北",0,11,-11
"11681","6205詮欣","110/07/28","德信-新營",10,0,10
"11682","6205詮欣","110/07/28","新加坡商瑞銀",0,10,-10
"11683","6205詮欣","110/07/28","福勝",10,0,10
"11684","6205詮欣","110/07/28","第一金-新竹",0,10,-10
"11685","6205詮欣","110/07/28","元大-清水",10,0,10
"11686","6205詮欣","110/07/28","台新-高雄",0,6,-6
"11687","6205詮欣","110/07/28","新光",9,0,9
"11688","6205詮欣","110/07/28","凱基-三多",0,6,-6
"11689","6205詮欣","110/07/28","群益金鼎-屏東",7,0,7
"11690","6205詮欣","110/07/28","美林",2,7,-5
"11691","6205詮欣","110/07/28","元大-汐止",6,0,6
"11692","6205詮欣","110/07/28","瑞士信貸",0,5,-5
"11693","6205詮欣","110/07/28","統一-屏東",5,0,5
"11694","6205詮欣","110/07/28","中國信託-三重",0,5,-5
"11695","6205詮欣","110/07/28","日盛-三重",4,0,4
"11696","6205詮欣","110/07/28","日盛-雙和",0,4,-4
"11697","6205詮欣","110/07/28","亞東-板橋",4,0,4
"11698","6205詮欣","110/07/28","宏遠-光隆",0,4,-4
"11699","6205詮欣","110/07/28","台中銀",4,0,4
"11700","6205詮欣","110/07/28","兆豐-新莊",0,4,-4
"11701","1540喬福","110/07/28","兆豐-北高雄",48,0,48
"11702","1540喬福","110/07/28","合庫-台中",1,60,-59
"11703","1540喬福","110/07/28","兆豐-台中港",33,0,33
"11704","1540喬福","110/07/28","凱基-台北",0,44,-44
"11705","1540喬福","110/07/28","大慶-中壢",19,0,19
"11706","1540喬福","110/07/28","元大-學甲",0,35,-35
"11707","1540喬福","110/07/28","富邦-員林",18,0,18
"11708","1540喬福","110/07/28","統一-新台中",0,26,-26
"11709","1540喬福","110/07/28","(牛牛牛)亞-鑫豐",12,0,12
"11710","1540喬福","110/07/28","新光-新竹",0,21,-21
"11711","1540喬福","110/07/28","元富-文心",10,0,10
"11712","1540喬福","110/07/28","富邦-台北",0,20,-20
"11713","1540喬福","110/07/28","光和-和美",10,0,10
"11714","1540喬福","110/07/28","富邦-南屯",0,20,-20
"11715","1540喬福","110/07/28","永豐金-三重",9,0,9
"11716","1540喬福","110/07/28","元大-鶯歌",0,10,-10
"11717","1540喬福","110/07/28","臺銀-鳳山",8,0,8
"11718","1540喬福","110/07/28","元大-豐原",0,7,-7
"11719","1540喬福","110/07/28","元大-斗六",7,0,7
"11720","1540喬福","110/07/28","大昌-樹林",0,6,-6
"11721","1540喬福","110/07/28","台新-台中",6,0,6
"11722","1540喬福","110/07/28","新光-桃園",0,5,-5
"11723","1540喬福","110/07/28","華南永昌-中正",6,0,6
"11724","1540喬福","110/07/28","凱基-站前",0,5,-5
"11725","1540喬福","110/07/28","永豐金-台中",6,0,6
"11726","1540喬福","110/07/28","臺銀",0,4,-4
"11727","1540喬福","110/07/28","臺銀-民權",5,0,5
"11728","1540喬福","110/07/28","台新證券",0,3,-3
"11729","1540喬福","110/07/28","元富-中原",5,0,5
"11730","1540喬福","110/07/28","台新-高雄",0,3,-3
"11731","2888新光金","110/07/28","臺銀-高雄",3050,3,3047
"11732","2888新光金","110/07/28","摩根大通",2543,11316,-8773
"11733","2888新光金","110/07/28","元富-城東",2019,129,1890
"11734","2888新光金","110/07/28","香港上海匯豐",120,7576,-7456
"11735","2888新光金","110/07/28","元大證券",2106,407,1699
"11736","2888新光金","110/07/28","凱基-台北",1641,5238,-3597
"11737","2888新光金","110/07/28","凱基-台南",1068,33,1035
"11738","2888新光金","110/07/28","新加坡商瑞銀",0,3572,-3572
"11739","2888新光金","110/07/28","彰銀-台中",1098,75,1023
"11740","2888新光金","110/07/28","台灣摩根士丹利",4358,7129,-2771
"11741","2888新光金","110/07/28","元富-城中",1003,0,1003
"11742","2888新光金","110/07/28","元大-大統",103,2853,-2750
"11743","2888新光金","110/07/28","元大-大天母",1113,119,994
"11744","2888新光金","110/07/28","光和",204,2235,-2031
"11745","2888新光金","110/07/28","元大-仁愛",761,1,760
"11746","2888新光金","110/07/28","兆豐-鹿港",80,1755,-1675
"11747","2888新光金","110/07/28","日盛-雙和",927,179,748
"11748","2888新光金","110/07/28","凱基-市政",17,1447,-1430
"11749","2888新光金","110/07/28","元大-大里",648,0,648
"11750","2888新光金","110/07/28","華南永昌-敦南",66,1320,-1254
"11751","2888新光金","110/07/28","凱基-竹科",2665,2026,639
"11752","2888新光金","110/07/28","法銀巴黎",195,1423,-1228
"11753","2888新光金","110/07/28","日盛-高雄",619,11,608
"11754","2888新光金","110/07/28","臺銀",123,1343,-1220
"11755","2888新光金","110/07/28","群益金鼎-海山",710,151,559
"11756","2888新光金","110/07/28","花旗環球",0,865,-865
"11757","2888新光金","110/07/28","台新證券",855,305,550
"11758","2888新光金","110/07/28","元大-鹿港",46,848,-802
"11759","2888新光金","110/07/28","國泰-敦南",774,237,537
"11760","2888新光金","110/07/28","合庫-台中",121,800,-679
"11761","1340勝悅","110/07/28","新光-台南",50,0,50
"11762","1340勝悅","110/07/28","兆豐-南京",0,25,-25
"11763","1340勝悅","110/07/28","臺銀-臺中",6,0,6
"11764","1340勝悅","110/07/28","凱基-台北",0,22,-22
"11765","1340勝悅","110/07/28","新光",6,0,6
"11766","1340勝悅","110/07/28","美林",0,12,-12
"11767","1340勝悅","110/07/28","臺灣企銀-埔墘",5,0,5
"11768","1340勝悅","110/07/28","群益金鼎-台中",0,11,-11
"11769","1340勝悅","110/07/28","國票-敦北法人",5,0,5
"11770","1340勝悅","110/07/28","合庫-西台中",1,10,-9
"11771","1340勝悅","110/07/28","國泰-高雄",5,0,5
"11772","1340勝悅","110/07/28","元大-基隆孝二",0,8,-8
"11773","1340勝悅","110/07/28","國泰-台中",5,0,5
"11774","1340勝悅","110/07/28","統一-城中",0,7,-7
"11775","1340勝悅","110/07/28","群益金鼎-館前",5,0,5
"11776","1340勝悅","110/07/28","凱基-幸福",0,7,-7
"11777","1340勝悅","110/07/28","中國信託-文心",3,0,3
"11778","1340勝悅","110/07/28","臺銀-新竹",0,5,-5
"11779","1340勝悅","110/07/28","群益金鼎-崇德",3,0,3
"11780","1340勝悅","110/07/28","港商法國興業",0,5,-5
"11781","1340勝悅","110/07/28","元大-永春",3,0,3
"11782","1340勝悅","110/07/28","元大-新竹經國",0,5,-5
"11783","1340勝悅","110/07/28","永豐金-松山",3,0,3
"11784","1340勝悅","110/07/28","台新證券",0,4,-4
"11785","1340勝悅","110/07/28","永豐金-嘉義",3,0,3
"11786","1340勝悅","110/07/28","港商野村",0,3,-3
"11787","1340勝悅","110/07/28","日盛-木柵",2,0,2
"11788","1340勝悅","110/07/28","摩根大通",0,3,-3
"11789","1340勝悅","110/07/28","台新-台中",2,0,2
"11790","1340勝悅","110/07/28","富邦-台北",0,3,-3
"11791","6246臺龍","110/07/28","元大-基隆孝二",32,0,32
"11792","6246臺龍","110/07/28","永豐金-桃園",4,135,-131
"11793","6246臺龍","110/07/28","合庫-台中",30,0,30
"11794","6246臺龍","110/07/28","港商野村",5,93,-88
"11795","6246臺龍","110/07/28","元大-木柵",30,0,30
"11796","6246臺龍","110/07/28","凱基-台北",9,65,-56
"11797","6246臺龍","110/07/28","光和",21,0,21
"11798","6246臺龍","110/07/28","元大-西螺",0,31,-31
"11799","6246臺龍","110/07/28","宏遠-民生",20,0,20
"11800","6246臺龍","110/07/28","群益金鼎-鳳山",0,27,-27
"11801","6246臺龍","110/07/28","第一金-安和",20,0,20
"11802","6246臺龍","110/07/28","元大-西屯",0,25,-25
"11803","6246臺龍","110/07/28","兆豐-竹北",24,4,20
"11804","6246臺龍","110/07/28","永豐金-虎尾",6,27,-21
"11805","6246臺龍","110/07/28","凱基-幸福",20,0,20
"11806","6246臺龍","110/07/28","日盛-台中",1,20,-19
"11807","6246臺龍","110/07/28","德信-新營",19,0,19
"11808","6246臺龍","110/07/28","統一",0,16,-16
"11809","6246臺龍","110/07/28","台新證券",21,4,17
"11810","6246臺龍","110/07/28","群益金鼎-土城",0,16,-16
"11811","6246臺龍","110/07/28","華南永昌-公誠",17,0,17
"11812","6246臺龍","110/07/28","元大-員林",0,15,-15
"11813","6246臺龍","110/07/28","中國信託-文心",15,0,15
"11814","6246臺龍","110/07/28","華南永昌-長虹",0,11,-11
"11815","6246臺龍","110/07/28","群益金鼎-崇德",15,0,15
"11816","6246臺龍","110/07/28","日盛-中壢",0,10,-10
"11817","6246臺龍","110/07/28","兆豐-公益",12,0,12
"11818","6246臺龍","110/07/28","第一金-彰化",0,10,-10
"11819","6246臺龍","110/07/28","國票",12,0,12
"11820","6246臺龍","110/07/28","元富-中原",0,10,-10
"11821","00715L期街口布蘭特正2","110/07/28","永豐金證券",5725,30,5695
"11822","00715L期街口布蘭特正2","110/07/28","元大-四維",0,2013,-2013
"11823","00715L期街口布蘭特正2","110/07/28","元大證券",5235,705,4530
"11824","00715L期街口布蘭特正2","110/07/28","凱基-豐中",0,1536,-1536
"11825","00715L期街口布蘭特正2","110/07/28","國票",2733,11,2722
"11826","00715L期街口布蘭特正2","110/07/28","華南永昌-東昇",0,1010,-1010
"11827","00715L期街口布蘭特正2","110/07/28","富邦證券",2340,417,1923
"11828","00715L期街口布蘭特正2","110/07/28","兆豐-三民",0,1004,-1004
"11829","00715L期街口布蘭特正2","110/07/28","凱基-台北",2241,325,1916
"11830","00715L期街口布蘭特正2","110/07/28","元富-古亭",0,600,-600
"11831","00715L期街口布蘭特正2","110/07/28","統一",1635,132,1503
"11832","00715L期街口布蘭特正2","110/07/28","台新-新營",20,558,-538
"11833","00715L期街口布蘭特正2","110/07/28","國票-中港",1500,0,1500
"11834","00715L期街口布蘭特正2","110/07/28","富邦-台北",0,453,-453
"11835","00715L期街口布蘭特正2","110/07/28","兆豐-台中",525,6,519
"11836","00715L期街口布蘭特正2","110/07/28","港商野村",71,519,-448
"11837","00715L期街口布蘭特正2","110/07/28","合庫證券",1008,500,508
"11838","00715L期街口布蘭特正2","110/07/28","第一金-自由",10,405,-395
"11839","00715L期街口布蘭特正2","110/07/28","永豐金-三重",500,0,500
"11840","00715L期街口布蘭特正2","110/07/28","玉山-高雄",17,387,-370
"11841","00715L期街口布蘭特正2","110/07/28","凱基-市政",500,1,499
"11842","00715L期街口布蘭特正2","110/07/28","統一-桃園",0,331,-331
"11843","00715L期街口布蘭特正2","110/07/28","元富-大裕",500,8,492
"11844","00715L期街口布蘭特正2","110/07/28","元富-中壢",0,309,-309
"11845","00715L期街口布蘭特正2","110/07/28","永豐金-內湖",503,18,485
"11846","00715L期街口布蘭特正2","110/07/28","台新證券",21,329,-308
"11847","00715L期街口布蘭特正2","110/07/28","元富-吉利",280,0,280
"11848","00715L期街口布蘭特正2","110/07/28","國票-台中",0,275,-275
"11849","00715L期街口布蘭特正2","110/07/28","國票-博愛",200,0,200
"11850","00715L期街口布蘭特正2","110/07/28","日盛-木柵",0,268,-268
"11851","8941關中","110/07/28","第一金-台南",2,0,2
"11852","8941關中","110/07/28","聯邦-富強",0,3,-3
"11853","8941關中","110/07/28","元大-西屯",2,0,2
"11854","8941關中","110/07/28","富邦-員林",0,3,-3
"11855","8941關中","110/07/28","玉山證券",1,0,1
"11856","8941關中","110/07/28","第一金-安和",0,2,-2
"11857","8941關中","110/07/28","國泰-忠孝",1,0,1
"11858","8941關中","110/07/28","第一金-台中",0,1,-1
"11859","8941關中","110/07/28","凱基-岡山",1,0,1
"11860","8941關中","110/07/28","玉山-台中",0,0,0
"11861","8941關中","110/07/28","富邦-羅東",1,0,1
"11862","8941關中","110/07/28","元大-新竹經國",0,0,0
"11863","8941關中","110/07/28","永豐金-敦南",1,0,1
"11864","8941關中","110/07/28","元大-桃興",1,1,0
"11865","8941關中","110/07/28","玉山-台中",0,0,0
"11866","8941關中","110/07/28","",NA,NA,NA
"11867","8941關中","110/07/28","元大-新竹經國",0,0,0
"11868","8941關中","110/07/28","",NA,NA,NA
"11869","8941關中","110/07/28","元大-桃興",1,1,0
"11870","8941關中","110/07/28","",NA,NA,NA
"11871","8941關中","110/07/28","",NA,NA,NA
"11872","8941關中","110/07/28","",NA,NA,NA
"11873","8941關中","110/07/28","",NA,NA,NA
"11874","8941關中","110/07/28","",NA,NA,NA
"11875","8941關中","110/07/28","",NA,NA,NA
"11876","8941關中","110/07/28","",NA,NA,NA
"11877","8941關中","110/07/28","",NA,NA,NA
"11878","8941關中","110/07/28","",NA,NA,NA
"11879","8941關中","110/07/28","",NA,NA,NA
"11880","8941關中","110/07/28","",NA,NA,NA
"11881","8936國統","110/07/28","宏遠-高雄",141,1,140
"11882","8936國統","110/07/28","摩根大通",82,517,-435
"11883","8936國統","110/07/28","日盛-景美",100,0,100
"11884","8936國統","110/07/28","凱基-台北",5,290,-285
"11885","8936國統","110/07/28","永豐金-苓雅",67,0,67
"11886","8936國統","110/07/28","瑞士信貸",0,245,-245
"11887","8936國統","110/07/28","玉山-台南",64,0,64
"11888","8936國統","110/07/28","台灣摩根士丹利",16,176,-160
"11889","8936國統","110/07/28","國票-北高雄",61,1,60
"11890","8936國統","110/07/28","凱基-市政",11,110,-99
"11891","8936國統","110/07/28","玉山-高雄",49,0,49
"11892","8936國統","110/07/28","元大-東蘆",0,82,-82
"11893","8936國統","110/07/28","元大-小港",47,0,47
"11894","8936國統","110/07/28","新加坡商瑞銀",128,205,-77
"11895","8936國統","110/07/28","元大-台中",40,0,40
"11896","8936國統","110/07/28","元大-歸仁",30,75,-45
"11897","8936國統","110/07/28","新光-台中",41,7,34
"11898","8936國統","110/07/28","台新-台中",17,55,-38
"11899","8936國統","110/07/28","元大-豐原站前",32,0,32
"11900","8936國統","110/07/28","康和",20,58,-38
"11901","8936國統","110/07/28","玉山-台中",31,0,31
"11902","8936國統","110/07/28","第一金-新興",0,31,-31
"11903","8936國統","110/07/28","富邦-高雄",26,0,26
"11904","8936國統","110/07/28","元富-松德",0,30,-30
"11905","8936國統","110/07/28","元大-鳳中",30,5,25
"11906","8936國統","110/07/28","元大-中和",2,30,-28
"11907","8936國統","110/07/28","元富-林園",20,0,20
"11908","8936國統","110/07/28","兆豐-嘉義",0,22,-22
"11909","8936國統","110/07/28","兆豐-北高雄",20,0,20
"11910","8936國統","110/07/28","美林",11,32,-21
"11911","6226光鼎","110/07/28","群益金鼎-萬華",147,14,133
"11912","6226光鼎","110/07/28","群益金鼎-敦南",5,282,-277
"11913","6226光鼎","110/07/28","台新-台中",227,114,113
"11914","6226光鼎","110/07/28","華南永昌",19,142,-123
"11915","6226光鼎","110/07/28","摩根大通",109,0,109
"11916","6226光鼎","110/07/28","康和-台北",0,100,-100
"11917","6226光鼎","110/07/28","統一",107,0,107
"11918","6226光鼎","110/07/28","臺銀-民權",4,100,-96
"11919","6226光鼎","110/07/28","凱基-台北",103,1,102
"11920","6226光鼎","110/07/28","元大-潮州",11,102,-91
"11921","6226光鼎","110/07/28","台灣摩根士丹利",104,7,97
"11922","6226光鼎","110/07/28","華南永昌-嘉義",50,130,-80
"11923","6226光鼎","110/07/28","群益金鼎-館前",97,0,97
"11924","6226光鼎","110/07/28","台新證券",79,153,-74
"11925","6226光鼎","110/07/28","國泰-台中",97,20,77
"11926","6226光鼎","110/07/28","玉山-台南",4,74,-70
"11927","6226光鼎","110/07/28","元大-嘉義",83,16,67
"11928","6226光鼎","110/07/28","臺銀-臺中",6,65,-59
"11929","6226光鼎","110/07/28","新光-桃園",69,8,61
"11930","6226光鼎","110/07/28","富邦-仁愛",6,63,-57
"11931","6226光鼎","110/07/28","群益金鼎-三重",59,2,57
"11932","6226光鼎","110/07/28","凱基-大里",0,51,-51
"11933","6226光鼎","110/07/28","日盛-員林",63,12,51
"11934","6226光鼎","110/07/28","國泰-敦南",116,166,-50
"11935","6226光鼎","110/07/28","永豐金-松山",66,20,46
"11936","6226光鼎","110/07/28","元富-中港",2,51,-49
"11937","6226光鼎","110/07/28","統一-內湖",48,7,41
"11938","6226光鼎","110/07/28","群益金鼎-延平",0,49,-49
"11939","6226光鼎","110/07/28","凱基-高美館",51,10,41
"11940","6226光鼎","110/07/28","元大-新竹經國",5,53,-48
"11941","2363矽統","110/07/28","摩根大通",809,282,527
"11942","2363矽統","110/07/28","國泰-敦南",145,861,-716
"11943","2363矽統","110/07/28","美商高盛",532,264,268
"11944","2363矽統","110/07/28","元大-台中",18,384,-366
"11945","2363矽統","110/07/28","台新-三民",263,18,245
"11946","2363矽統","110/07/28","新光",197,525,-328
"11947","2363矽統","110/07/28","台新證券",929,703,226
"11948","2363矽統","110/07/28","群益金鼎-三民",24,266,-242
"11949","2363矽統","110/07/28","第一金-嘉義",154,0,154
"11950","2363矽統","110/07/28","凱基-斗六",0,187,-187
"11951","2363矽統","110/07/28","凱基-台北",1039,889,150
"11952","2363矽統","110/07/28","元大-上新莊",3,134,-131
"11953","2363矽統","110/07/28","永豐金-竹科",132,11,121
"11954","2363矽統","110/07/28","永豐金-彰化",5,134,-129
"11955","2363矽統","110/07/28","華南永昌-鳳山",146,34,112
"11956","2363矽統","110/07/28","日盛-二林",15,142,-127
"11957","2363矽統","110/07/28","第一金-新興",108,1,107
"11958","2363矽統","110/07/28","元大證券",18,125,-107
"11959","2363矽統","110/07/28","港商野村",673,568,105
"11960","2363矽統","110/07/28","新光-台南",25,129,-104
"11961","2363矽統","110/07/28","群益金鼎-桃園",111,11,100
"11962","2363矽統","110/07/28","統一",7,109,-102
"11963","2363矽統","110/07/28","台新-左楠",94,15,79
"11964","2363矽統","110/07/28","康和-南崁",11,108,-97
"11965","2363矽統","110/07/28","新加坡商瑞銀",789,711,78
"11966","2363矽統","110/07/28","國票",25,121,-96
"11967","2363矽統","110/07/28","國票-九鼎",99,26,73
"11968","2363矽統","110/07/28","群益金鼎-敦南",11,107,-96
"11969","2363矽統","110/07/28","兆豐-埔墘",62,0,62
"11970","2363矽統","110/07/28","兆豐-寶成",2,79,-77
"11971","8112至上","110/07/28","摩根大通",630,183,447
"11972","8112至上","110/07/28","永豐金-永康",0,242,-242
"11973","8112至上","110/07/28","合庫證券",317,21,296
"11974","8112至上","110/07/28","高橋",3,222,-219
"11975","8112至上","110/07/28","新加坡商瑞銀",417,132,285
"11976","8112至上","110/07/28","玉山證券",2,206,-204
"11977","8112至上","110/07/28","台灣摩根士丹利",253,58,195
"11978","8112至上","110/07/28","新光",50,206,-156
"11979","8112至上","110/07/28","港商野村",350,164,186
"11980","8112至上","110/07/28","永豐金-苓雅",2,102,-100
"11981","8112至上","110/07/28","美商高盛",184,7,177
"11982","8112至上","110/07/28","凱基-永和",0,80,-80
"11983","8112至上","110/07/28","美林",213,53,160
"11984","8112至上","110/07/28","華南永昌-新莊",60,134,-74
"11985","8112至上","110/07/28","花旗環球",86,16,70
"11986","8112至上","110/07/28","台新-松江",27,90,-63
"11987","8112至上","110/07/28","玉山-板橋",82,17,65
"11988","8112至上","110/07/28","宏遠證券",1,50,-49
"11989","8112至上","110/07/28","凱基-竹科",67,3,64
"11990","8112至上","110/07/28","元大-苑裡",23,72,-49
"11991","8112至上","110/07/28","元大-府城",56,0,56
"11992","8112至上","110/07/28","元大-基隆孝二",5,53,-48
"11993","8112至上","110/07/28","永豐金-內湖",37,0,37
"11994","8112至上","110/07/28","康和-仁愛",5,51,-46
"11995","8112至上","110/07/28","瑞士信貸",58,26,32
"11996","8112至上","110/07/28","台新證券",31,73,-42
"11997","8112至上","110/07/28","元大證券",60,29,31
"11998","8112至上","110/07/28","兆豐-公益",0,40,-40
"11999","8112至上","110/07/28","元富-新店",35,5,30
"12000","8112至上","110/07/28","中國信託-忠孝",1,37,-36
"12001","1570力肯","110/07/28","國泰-敦南",50,0,50
"12002","1570力肯","110/07/28","元大-高雄",0,42,-42
"12003","1570力肯","110/07/28","群益金鼎-高雄",31,0,31
"12004","1570力肯","110/07/28","國票-新莊",0,14,-14
"12005","1570力肯","110/07/28","元富-延平",15,0,15
"12006","1570力肯","110/07/28","凱基-站前",0,10,-10
"12007","1570力肯","110/07/28","(牛牛牛)亞-鑫豐",10,0,10
"12008","1570力肯","110/07/28","凱基-台北",0,10,-10
"12009","1570力肯","110/07/28","元富-緯城",6,0,6
"12010","1570力肯","110/07/28","元大-忠孝",0,10,-10
"12011","1570力肯","110/07/28","合庫-自強",5,0,5
"12012","1570力肯","110/07/28","台灣摩根士丹利",0,9,-9
"12013","1570力肯","110/07/28","臺銀-臺南",4,0,4
"12014","1570力肯","110/07/28","群益金鼎-板橋",0,8,-8
"12015","1570力肯","110/07/28","兆豐-台中港",3,0,3
"12016","1570力肯","110/07/28","永豐金-大園",0,7,-7
"12017","1570力肯","110/07/28","日盛-板橋",2,0,2
"12018","1570力肯","110/07/28","元大-台南",0,5,-5
"12019","1570力肯","110/07/28","統一-松江",2,0,2
"12020","1570力肯","110/07/28","合庫-台中",0,4,-4
"12021","1570力肯","110/07/28","台新-三民",2,0,2
"12022","1570力肯","110/07/28","富邦-板橋",0,3,-3
"12023","1570力肯","110/07/28","群益金鼎-土城",2,0,2
"12024","1570力肯","110/07/28","元大-板橋",0,3,-3
"12025","1570力肯","110/07/28","元大-和平",2,0,2
"12026","1570力肯","110/07/28","統一-桃園",0,2,-2
"12027","1570力肯","110/07/28","元大-土城永寧",2,0,2
"12028","1570力肯","110/07/28","凱基-三多",0,2,-2
"12029","1570力肯","110/07/28","大昌-樹林",1,0,1
"12030","1570力肯","110/07/28","華南永昌-高雄",0,2,-2
"12031","2929淘帝","110/07/28","日盛-八德",40,0,40
"12032","2929淘帝","110/07/28","凱基-林口",0,150,-150
"12033","2929淘帝","110/07/28","玉山-新竹",30,0,30
"12034","2929淘帝","110/07/28","日盛-台中",0,35,-35
"12035","2929淘帝","110/07/28","國泰-松江",33,3,30
"12036","2929淘帝","110/07/28","永豐金-永康",0,21,-21
"12037","2929淘帝","110/07/28","元大-民生",28,0,28
"12038","2929淘帝","110/07/28","新加坡商瑞銀",13,32,-19
"12039","2929淘帝","110/07/28","合庫-高雄",21,0,21
"12040","2929淘帝","110/07/28","國泰-敦南",2,20,-18
"12041","2929淘帝","110/07/28","華南永昌",20,0,20
"12042","2929淘帝","110/07/28","臺銀",2,17,-15
"12043","2929淘帝","110/07/28","台新證券",12,0,12
"12044","2929淘帝","110/07/28","群益金鼎-敦南",0,13,-13
"12045","2929淘帝","110/07/28","第一金-大稻埕",10,0,10
"12046","2929淘帝","110/07/28","富邦-建國",1,13,-12
"12047","2929淘帝","110/07/28","華南永昌-台中",10,0,10
"12048","2929淘帝","110/07/28","元富-城東",0,10,-10
"12049","2929淘帝","110/07/28","元大-士林",10,0,10
"12050","2929淘帝","110/07/28","兆豐-景美",0,8,-8
"12051","2929淘帝","110/07/28","元大-屏南",10,0,10
"12052","2929淘帝","110/07/28","美林",3,10,-7
"12053","2929淘帝","110/07/28","元大-員林",10,0,10
"12054","2929淘帝","110/07/28","元富-彰化",0,7,-7
"12055","2929淘帝","110/07/28","新光-桃園",9,0,9
"12056","2929淘帝","110/07/28","港商法國興業",0,6,-6
"12057","2929淘帝","110/07/28","日盛-景美",7,0,7
"12058","2929淘帝","110/07/28","新光-高雄",0,6,-6
"12059","2929淘帝","110/07/28","玉山證券",7,0,7
"12060","2929淘帝","110/07/28","港商野村",3,8,-5
"12061","5410國眾","110/07/28","兆豐-城中",38,0,38
"12062","5410國眾","110/07/28","兆豐-南門",3,80,-77
"12063","5410國眾","110/07/28","大展",20,0,20
"12064","5410國眾","110/07/28","摩根大通",12,56,-44
"12065","5410國眾","110/07/28","新光-桃園",20,0,20
"12066","5410國眾","110/07/28","凱基-台北",0,28,-28
"12067","5410國眾","110/07/28","凱基-竹北",20,0,20
"12068","5410國眾","110/07/28","亞東-板橋",0,20,-20
"12069","5410國眾","110/07/28","元大-新莊",17,0,17
"12070","5410國眾","110/07/28","統一-新台中",0,20,-20
"12071","5410國眾","110/07/28","新光",20,8,12
"12072","5410國眾","110/07/28","瑞士信貸",0,16,-16
"12073","5410國眾","110/07/28","國泰-敦南",11,0,11
"12074","5410國眾","110/07/28","新加坡商瑞銀",0,15,-15
"12075","5410國眾","110/07/28","日盛-內湖",10,0,10
"12076","5410國眾","110/07/28","統一-金門",0,15,-15
"12077","5410國眾","110/07/28","元富-新竹",10,0,10
"12078","5410國眾","110/07/28","元大-北投",0,12,-12
"12079","5410國眾","110/07/28","群益金鼎-永和",10,0,10
"12080","5410國眾","110/07/28","新百王",0,10,-10
"12081","5410國眾","110/07/28","華南永昌-中正",10,0,10
"12082","5410國眾","110/07/28","元大-館前",0,10,-10
"12083","5410國眾","110/07/28","元大-旗山",10,0,10
"12084","5410國眾","110/07/28","元富-安南",0,9,-9
"12085","5410國眾","110/07/28","元大-大天母",10,0,10
"12086","5410國眾","110/07/28","元大-龍潭",1,10,-9
"12087","5410國眾","110/07/28","大昌",9,0,9
"12088","5410國眾","110/07/28","港商野村",1,7,-6
"12089","5410國眾","110/07/28","臺銀-鳳山",8,0,8
"12090","5410國眾","110/07/28","元大-東泰",0,6,-6
"12091","2841台開","110/07/28","台新-台中",36,0,36
"12092","2841台開","110/07/28","元大-大雅",0,90,-90
"12093","2841台開","110/07/28","群益金鼎-大甲",24,0,24
"12094","2841台開","110/07/28","凱基-台北",0,73,-73
"12095","2841台開","110/07/28","永豐金-敦南",29,8,21
"12096","2841台開","110/07/28","港商野村",0,27,-27
"12097","2841台開","110/07/28","第一金-台中",20,0,20
"12098","2841台開","110/07/28","大慶-富順",0,20,-20
"12099","2841台開","110/07/28","元富-烏日",20,0,20
"12100","2841台開","110/07/28","豐農",0,17,-17
"12101","2841台開","110/07/28","元大-歸仁",20,0,20
"12102","2841台開","110/07/28","元大-大里德芳",0,15,-15
"12103","2841台開","110/07/28","永豐金-豐原",20,0,20
"12104","2841台開","110/07/28","日盛-大墩",0,10,-10
"12105","2841台開","110/07/28","日盛-花蓮",15,0,15
"12106","2841台開","110/07/28","元大-博愛",0,10,-10
"12107","2841台開","110/07/28","大昌-安康",18,3,15
"12108","2841台開","110/07/28","元大-豐原站前",0,10,-10
"12109","2841台開","110/07/28","陽信-石牌",13,0,13
"12110","2841台開","110/07/28","台新證券",6,13,-7
"12111","2841台開","110/07/28","台灣摩根士丹利",10,0,10
"12112","2841台開","110/07/28","台中銀",0,5,-5
"12113","2841台開","110/07/28","台新-高雄",10,0,10
"12114","2841台開","110/07/28","中國信託-中壢",0,5,-5
"12115","2841台開","110/07/28","國泰-忠孝",10,0,10
"12116","2841台開","110/07/28","元大-大同",0,5,-5
"12117","2841台開","110/07/28","元大-竹南",10,0,10
"12118","2841台開","110/07/28","元大-大益",0,4,-4
"12119","2841台開","110/07/28","元大-屏南",9,0,9
"12120","2841台開","110/07/28","元富-松德",0,3,-3
"12121","6207雷科","110/07/28","新加坡商瑞銀",153,44,109
"12122","6207雷科","110/07/28","康和-延平",0,48,-48
"12123","6207雷科","110/07/28","摩根大通",219,131,88
"12124","6207雷科","110/07/28","元富-大昌",0,33,-33
"12125","6207雷科","110/07/28","康和-台中",70,0,70
"12126","6207雷科","110/07/28","聯邦商銀",0,30,-30
"12127","6207雷科","110/07/28","凱基-台北",112,49,63
"12128","6207雷科","110/07/28","兆豐-三民",1,30,-29
"12129","6207雷科","110/07/28","凱基-復興",63,3,60
"12130","6207雷科","110/07/28","元大-龍潭",0,25,-25
"12131","6207雷科","110/07/28","群益金鼎-三民",59,8,51
"12132","6207雷科","110/07/28","宏遠證券",0,23,-23
"12133","6207雷科","110/07/28","永豐金-羅東",50,0,50
"12134","6207雷科","110/07/28","大昌-桃園",15,36,-21
"12135","6207雷科","110/07/28","美林",46,3,43
"12136","6207雷科","110/07/28","國泰-桃園",0,21,-21
"12137","6207雷科","110/07/28","群益金鼎-敦南",51,16,35
"12138","6207雷科","110/07/28","凱基-中壢",0,21,-21
"12139","6207雷科","110/07/28","日盛-忠孝",31,0,31
"12140","6207雷科","110/07/28","富邦-台北",4,24,-20
"12141","6207雷科","110/07/28","港商野村",32,8,24
"12142","6207雷科","110/07/28","臺銀-臺南",0,19,-19
"12143","6207雷科","110/07/28","群益金鼎-東門",22,0,22
"12144","6207雷科","110/07/28","新光",5,24,-19
"12145","6207雷科","110/07/28","統一-高雄",41,20,21
"12146","6207雷科","110/07/28","群益金鼎-大甲",1,20,-19
"12147","6207雷科","110/07/28","群益金鼎-延平",21,0,21
"12148","6207雷科","110/07/28","元大-中壢",10,28,-18
"12149","6207雷科","110/07/28","彰銀-台中",20,0,20
"12150","6207雷科","110/07/28","永豐金-北高雄",3,20,-17
"12151","3679新至陞","110/07/28","華南永昌-淡水",10,0,10
"12152","3679新至陞","110/07/28","瑞士信貸",0,25,-25
"12153","3679新至陞","110/07/28","富邦-嘉義",10,0,10
"12154","3679新至陞","110/07/28","凱基-台北",6,14,-8
"12155","3679新至陞","110/07/28","台中銀-員林",11,2,9
"12156","3679新至陞","110/07/28","美林",5,12,-7
"12157","3679新至陞","110/07/28","大昌-樹林",7,0,7
"12158","3679新至陞","110/07/28","摩根大通",5,11,-6
"12159","3679新至陞","110/07/28","康和-澎湖",5,0,5
"12160","3679新至陞","110/07/28","兆豐-新莊",0,5,-5
"12161","3679新至陞","110/07/28","富邦-台北",5,0,5
"12162","3679新至陞","110/07/28","群益金鼎-新莊",0,5,-5
"12163","3679新至陞","110/07/28","元大-成功",5,0,5
"12164","3679新至陞","110/07/28","台灣摩根士丹利",0,4,-4
"12165","3679新至陞","110/07/28","新加坡商瑞銀",3,0,3
"12166","3679新至陞","110/07/28","日盛-新竹",0,3,-3
"12167","3679新至陞","110/07/28","中國信託-新竹",3,0,3
"12168","3679新至陞","110/07/28","群益金鼎-東門",0,3,-3
"12169","3679新至陞","110/07/28","元大-新莊",3,0,3
"12170","3679新至陞","110/07/28","元大證券",0,3,-3
"12171","3679新至陞","110/07/28","宏遠-光隆",2,0,2
"12172","3679新至陞","110/07/28","元大-忠孝",0,3,-3
"12173","3679新至陞","110/07/28","大慶-蘆洲",2,0,2
"12174","3679新至陞","110/07/28","合庫-西台中",0,2,-2
"12175","3679新至陞","110/07/28","台新-左楠",2,0,2
"12176","3679新至陞","110/07/28","日盛-板橋",0,2,-2
"12177","3679新至陞","110/07/28","群益金鼎-三重",2,0,2
"12178","3679新至陞","110/07/28","國票-桃園",0,2,-2
"12179","3679新至陞","110/07/28","華南永昌-高雄",2,0,2
"12180","3679新至陞","110/07/28","台新-台南",0,2,-2
"12181","2727王品","110/07/28","凱基-台北",139,50,89
"12182","2727王品","110/07/28","新光-台中",9,68,-59
"12183","2727王品","110/07/28","美林",77,10,67
"12184","2727王品","110/07/28","瑞士信貸",16,54,-38
"12185","2727王品","110/07/28","港商野村",118,64,54
"12186","2727王品","110/07/28","華南永昌",4,41,-37
"12187","2727王品","110/07/28","國泰-敦南",51,30,21
"12188","2727王品","110/07/28","美商高盛",2,30,-28
"12189","2727王品","110/07/28","新加坡商瑞銀",58,38,20
"12190","2727王品","110/07/28","富邦-板橋",17,38,-21
"12191","2727王品","110/07/28","永豐金-中盛",24,4,20
"12192","2727王品","110/07/28","富邦-竹北",0,20,-20
"12193","2727王品","110/07/28","元大-南崁",20,2,18
"12194","2727王品","110/07/28","元大-小港",1,21,-20
"12195","2727王品","110/07/28","摩根大通",48,32,16
"12196","2727王品","110/07/28","凱基",0,18,-18
"12197","2727王品","110/07/28","臺銀-高雄",14,0,14
"12198","2727王品","110/07/28","統一",15,31,-16
"12199","2727王品","110/07/28","永豐金-桃盛",19,5,14
"12200","2727王品","110/07/28","國泰-台中",12,28,-16
"12201","2727王品","110/07/28","凱基-內湖",13,0,13
"12202","2727王品","110/07/28","元大-台中",7,22,-15
"12203","2727王品","110/07/28","永豐金-中正",15,2,13
"12204","2727王品","110/07/28","華南永昌-麻豆",0,14,-14
"12205","2727王品","110/07/28","富邦-建國",18,7,11
"12206","2727王品","110/07/28","永豐金-豐原",1,15,-14
"12207","2727王品","110/07/28","富邦-陽明",15,5,10
"12208","2727王品","110/07/28","國票-內壢",1,14,-13
"12209","2727王品","110/07/28","元大-南京",10,0,10
"12210","2727王品","110/07/28","永豐金證券",2,15,-13
"12211","1570力肯","110/07/28","國泰-敦南",50,0,50
"12212","1570力肯","110/07/28","元大-高雄",0,42,-42
"12213","1570力肯","110/07/28","群益金鼎-高雄",31,0,31
"12214","1570力肯","110/07/28","國票-新莊",0,14,-14
"12215","1570力肯","110/07/28","元富-延平",15,0,15
"12216","1570力肯","110/07/28","凱基-站前",0,10,-10
"12217","1570力肯","110/07/28","(牛牛牛)亞-鑫豐",10,0,10
"12218","1570力肯","110/07/28","凱基-台北",0,10,-10
"12219","1570力肯","110/07/28","元富-緯城",6,0,6
"12220","1570力肯","110/07/28","元大-忠孝",0,10,-10
"12221","1570力肯","110/07/28","合庫-自強",5,0,5
"12222","1570力肯","110/07/28","台灣摩根士丹利",0,9,-9
"12223","1570力肯","110/07/28","臺銀-臺南",4,0,4
"12224","1570力肯","110/07/28","群益金鼎-板橋",0,8,-8
"12225","1570力肯","110/07/28","兆豐-台中港",3,0,3
"12226","1570力肯","110/07/28","永豐金-大園",0,7,-7
"12227","1570力肯","110/07/28","日盛-板橋",2,0,2
"12228","1570力肯","110/07/28","元大-台南",0,5,-5
"12229","1570力肯","110/07/28","統一-松江",2,0,2
"12230","1570力肯","110/07/28","合庫-台中",0,4,-4
"12231","1570力肯","110/07/28","台新-三民",2,0,2
"12232","1570力肯","110/07/28","富邦-板橋",0,3,-3
"12233","1570力肯","110/07/28","群益金鼎-土城",2,0,2
"12234","1570力肯","110/07/28","元大-板橋",0,3,-3
"12235","1570力肯","110/07/28","元大-和平",2,0,2
"12236","1570力肯","110/07/28","統一-桃園",0,2,-2
"12237","1570力肯","110/07/28","元大-土城永寧",2,0,2
"12238","1570力肯","110/07/28","凱基-三多",0,2,-2
"12239","1570力肯","110/07/28","大昌-樹林",1,0,1
"12240","1570力肯","110/07/28","華南永昌-高雄",0,2,-2
"12241","6180橘子","110/07/28","凱基-台北",152,85,67
"12242","6180橘子","110/07/28","摩根大通",20,92,-72
"12243","6180橘子","110/07/28","新光",57,18,39
"12244","6180橘子","110/07/28","大慶-台中",0,33,-33
"12245","6180橘子","110/07/28","美商高盛",49,12,37
"12246","6180橘子","110/07/28","兆豐證券",0,25,-25
"12247","6180橘子","110/07/28","第一金-安和",20,0,20
"12248","6180橘子","110/07/28","元大-上新莊",0,22,-22
"12249","6180橘子","110/07/28","元富-桃園",20,0,20
"12250","6180橘子","110/07/28","新加坡商瑞銀",23,44,-21
"12251","6180橘子","110/07/28","第一金-員林",19,0,19
"12252","6180橘子","110/07/28","富邦-內湖",0,21,-21
"12253","6180橘子","110/07/28","富邦-嘉義",22,4,18
"12254","6180橘子","110/07/28","第一金-新興",0,20,-20
"12255","6180橘子","110/07/28","統一-嘉義",16,0,16
"12256","6180橘子","110/07/28","臺銀-臺南",5,22,-17
"12257","6180橘子","110/07/28","國票-九鼎",15,0,15
"12258","6180橘子","110/07/28","第一金-忠孝",0,10,-10
"12259","6180橘子","110/07/28","華南永昌-朴子",14,0,14
"12260","6180橘子","110/07/28","元富-屏東",0,10,-10
"12261","6180橘子","110/07/28","群益金鼎-台南",13,0,13
"12262","6180橘子","110/07/28","凱基-八德",1,11,-10
"12263","6180橘子","110/07/28","富邦-建國",13,1,12
"12264","6180橘子","110/07/28","元大-和平",1,11,-10
"12265","6180橘子","110/07/28","富邦-板橋",16,5,11
"12266","6180橘子","110/07/28","元大-台中中港",0,10,-10
"12267","6180橘子","110/07/28","元富-新店",10,0,10
"12268","6180橘子","110/07/28","元大-南屯",0,9,-9
"12269","6180橘子","110/07/28","元大-台南",10,0,10
"12270","6180橘子","110/07/28","永豐金-屏東",0,9,-9
"12271","2390云辰","110/07/28","摩根大通",1589,780,809
"12272","2390云辰","110/07/28","華南永昌-鳳山",34,290,-256
"12273","2390云辰","110/07/28","凱基-台北",457,300,157
"12274","2390云辰","110/07/28","凱基-基隆",0,224,-224
"12275","2390云辰","110/07/28","美林",330,206,124
"12276","2390云辰","110/07/28","元富-高雄",56,177,-121
"12277","2390云辰","110/07/28","元富-同大",159,35,124
"12278","2390云辰","110/07/28","元富-中港",1,100,-99
"12279","2390云辰","110/07/28","台灣摩根士丹利",193,71,122
"12280","2390云辰","110/07/28","兆豐-公益",4,100,-96
"12281","2390云辰","110/07/28","元大-前金",150,49,101
"12282","2390云辰","110/07/28","統一-新台中",180,274,-94
"12283","2390云辰","110/07/28","永豐金-鳳山",110,18,92
"12284","2390云辰","110/07/28","日盛-新莊",4,76,-72
"12285","2390云辰","110/07/28","元大-林園",99,11,88
"12286","2390云辰","110/07/28","永豐金-新店",0,57,-57
"12287","2390云辰","110/07/28","元大-信義",121,35,86
"12288","2390云辰","110/07/28","華南永昌-內壢",0,56,-56
"12289","2390云辰","110/07/28","美商高盛",206,123,83
"12290","2390云辰","110/07/28","第一金-豐原",9,63,-54
"12291","2390云辰","110/07/28","統一-城中",101,37,64
"12292","2390云辰","110/07/28","華南永昌-中正",13,67,-54
"12293","2390云辰","110/07/28","元大-竹山",75,20,55
"12294","2390云辰","110/07/28","元大-大益",7,59,-52
"12295","2390云辰","110/07/28","豐農",79,25,54
"12296","2390云辰","110/07/28","大慶",0,50,-50
"12297","2390云辰","110/07/28","新加坡商瑞銀",68,15,53
"12298","2390云辰","110/07/28","凱基-豐中",3,49,-46
"12299","2390云辰","110/07/28","統一-屏東",54,5,49
"12300","2390云辰","110/07/28","元大-彰化民生",7,51,-44
"12301","1471首利","110/07/27","永全-八德",50,0,50
"12302","1471首利","110/07/27","國票-九鼎",0,306,-306
"12303","1471首利","110/07/27","中國信託-松江",48,0,48
"12304","1471首利","110/07/27","兆豐-天母",1,115,-114
"12305","1471首利","110/07/27","富邦-嘉義",40,0,40
"12306","1471首利","110/07/27","美林",0,42,-42
"12307","1471首利","110/07/27","富邦-台南",33,0,33
"12308","1471首利","110/07/27","摩根大通",45,75,-30
"12309","1471首利","110/07/27","(牛牛牛)亞-鑫豐",32,0,32
"12310","1471首利","110/07/27","凱基-八德",0,30,-30
"12311","1471首利","110/07/27","台灣企銀-太平",25,0,25
"12312","1471首利","110/07/27","中國信託-高雄",0,25,-25
"12313","1471首利","110/07/27","群益金鼎-台中",23,0,23
"12314","1471首利","110/07/27","統一-新台中",0,24,-24
"12315","1471首利","110/07/27","元富-潮州",20,0,20
"12316","1471首利","110/07/27","聯邦-高雄",0,21,-21
"12317","1471首利","110/07/27","凱基-信義",20,0,20
"12318","1471首利","110/07/27","德信-中正",0,20,-20
"12319","1471首利","110/07/27","富邦-基隆",26,8,18
"12320","1471首利","110/07/27","元大-福營",3,20,-17
"12321","1471首利","110/07/27","日盛-高雄",17,0,17
"12322","1471首利","110/07/27","凱基-宜蘭",0,16,-16
"12323","1471首利","110/07/27","國泰-敦南",16,2,14
"12324","1471首利","110/07/27","凱基-天母",0,15,-15
"12325","1471首利","110/07/27","元大-大甲",13,0,13
"12326","1471首利","110/07/27","第一金-高雄",6,20,-14
"12327","1471首利","110/07/27","合庫-鳳山",12,0,12
"12328","1471首利","110/07/27","元大-中壢",0,13,-13
"12329","1471首利","110/07/27","日盛-大墩",12,0,12
"12330","1471首利","110/07/27","元富-安南",0,12,-12
"12331","2883開發金","110/07/27","元富",1762,67,1695
"12332","2883開發金","110/07/27","美林",0,11931,-11931
"12333","2883開發金","110/07/27","福邦證券",1450,0,1450
"12334","2883開發金","110/07/27","新加坡商瑞銀",1513,8370,-6857
"12335","2883開發金","110/07/27","凱基",1422,0,1422
"12336","2883開發金","110/07/27","凱基-台北",1081,5265,-4184
"12337","2883開發金","110/07/27","瑞士信貸",2044,731,1313
"12338","2883開發金","110/07/27","摩根大通",612,3392,-2780
"12339","2883開發金","110/07/27","台灣摩根士丹利",2112,921,1191
"12340","2883開發金","110/07/27","統一-仁愛",31,2002,-1971
"12341","2883開發金","110/07/27","新光",1474,461,1013
"12342","2883開發金","110/07/27","兆豐證券",192,1910,-1718
"12343","2883開發金","110/07/27","國票-長城",1003,20,983
"12344","2883開發金","110/07/27","(牛牛牛)亞-鑫豐",276,1815,-1539
"12345","2883開發金","110/07/27","台新證券",1207,362,845
"12346","2883開發金","110/07/27","永豐金-板橋",197,1610,-1413
"12347","2883開發金","110/07/27","港商野村",2209,1498,711
"12348","2883開發金","110/07/27","美商高盛",16,1337,-1321
"12349","2883開發金","110/07/27","永豐金-彰化",680,26,654
"12350","2883開發金","110/07/27","兆豐-北高雄",60,1360,-1300
"12351","2883開發金","110/07/27","台新-高雄",918,265,653
"12352","2883開發金","110/07/27","兆豐-景美",26,1070,-1044
"12353","2883開發金","110/07/27","國泰-敦南",1273,634,639
"12354","2883開發金","110/07/27","亞東-新竹",7,1001,-994
"12355","2883開發金","110/07/27","元大證券",876,246,630
"12356","2883開發金","110/07/27","富邦-羅東",201,1098,-897
"12357","2883開發金","110/07/27","致和證券",684,92,592
"12358","2883開發金","110/07/27","統一",159,811,-652
"12359","2883開發金","110/07/27","元大-民生",550,2,548
"12360","2883開發金","110/07/27","香港上海匯豐",0,584,-584
"12361","6205詮欣","110/07/27","土銀-和平",20,0,20
"12362","6205詮欣","110/07/27","摩根大通",3,22,-19
"12363","6205詮欣","110/07/27","臺銀-民權",20,6,14
"12364","6205詮欣","110/07/27","瑞士信貸",5,16,-11
"12365","6205詮欣","110/07/27","台新證券",5,0,5
"12366","6205詮欣","110/07/27","臺銀-鳳山",0,6,-6
"12367","6205詮欣","110/07/27","華南永昌-小港",5,0,5
"12368","6205詮欣","110/07/27","臺銀-新竹",0,5,-5
"12369","6205詮欣","110/07/27","日盛-新莊",4,0,4
"12370","6205詮欣","110/07/27","國票-和平",0,4,-4
"12371","6205詮欣","110/07/27","元富-三重",4,0,4
"12372","6205詮欣","110/07/27","凱基-東門",0,4,-4
"12373","6205詮欣","110/07/27","致和-佳里",4,1,3
"12374","6205詮欣","110/07/27","富邦-花蓮",0,3,-3
"12375","6205詮欣","110/07/27","華南永昌-岡山",3,0,3
"12376","6205詮欣","110/07/27","元大-北投",0,3,-3
"12377","6205詮欣","110/07/27","元大-成功",3,0,3
"12378","6205詮欣","110/07/27","元大-民生",2,5,-3
"12379","6205詮欣","110/07/27","土銀-嘉義",2,0,2
"12380","6205詮欣","110/07/27","日盛-三重",0,2,-2
"12381","6205詮欣","110/07/27","第一金-光復",2,0,2
"12382","6205詮欣","110/07/27","日盛-北高雄",0,2,-2
"12383","6205詮欣","110/07/27","統一-屏東",2,0,2
"12384","6205詮欣","110/07/27","港商野村",0,2,-2
"12385","6205詮欣","110/07/27","元富-新莊",2,0,2
"12386","6205詮欣","110/07/27","統一-彰化",0,2,-2
"12387","6205詮欣","110/07/27","兆豐-竹北",2,0,2
"12388","6205詮欣","110/07/27","永全",0,2,-2
"12389","6205詮欣","110/07/27","新光",2,0,2
"12390","6205詮欣","110/07/27","兆豐-西螺",0,2,-2
"12391","1540喬福","110/07/27","富邦-員林",10,0,10
"12392","1540喬福","110/07/27","合庫-台中",0,26,-26
"12393","1540喬福","110/07/27","元大-中壢",10,0,10
"12394","1540喬福","110/07/27","統一-新台中",0,25,-25
"12395","1540喬福","110/07/27","凱基-台中",8,0,8
"12396","1540喬福","110/07/27","元大-斗六",0,10,-10
"12397","1540喬福","110/07/27","大慶-中壢",5,0,5
"12398","1540喬福","110/07/27","凱基-中港",0,9,-9
"12399","1540喬福","110/07/27","兆豐-北高雄",5,0,5
"12400","1540喬福","110/07/27","國票-中正",0,8,-8
"12401","1540喬福","110/07/27","兆豐-三民",5,0,5
"12402","1540喬福","110/07/27","臺銀-臺中",0,5,-5
"12403","1540喬福","110/07/27","台新-台中",5,0,5
"12404","1540喬福","110/07/27","元富-中原",0,5,-5
"12405","1540喬福","110/07/27","國票-九鼎",4,0,4
"12406","1540喬福","110/07/27","新光-桃園",0,5,-5
"12407","1540喬福","110/07/27","富邦-高雄",5,1,4
"12408","1540喬福","110/07/27","大昌-新竹",0,4,-4
"12409","1540喬福","110/07/27","永豐金-羅東",4,0,4
"12410","1540喬福","110/07/27","元大-員林中山",0,4,-4
"12411","1540喬福","110/07/27","台新證券",3,0,3
"12412","1540喬福","110/07/27","群益金鼎-瑞豐",0,3,-3
"12413","1540喬福","110/07/27","華南永昌-台中",3,0,3
"12414","1540喬福","110/07/27","凱基-台北",0,3,-3
"12415","1540喬福","110/07/27","富邦-台東",3,0,3
"12416","1540喬福","110/07/27","富邦-建國",0,3,-3
"12417","1540喬福","110/07/27","元大-台中中港",3,0,3
"12418","1540喬福","110/07/27","國票-北投",0,2,-2
"12419","1540喬福","110/07/27","亞東",2,0,2
"12420","1540喬福","110/07/27","元大-鳳山",0,2,-2
"12421","2888新光金","110/07/27","台灣摩根士丹利",11737,746,10991
"12422","2888新光金","110/07/27","玉山-城中",112,6002,-5890
"12423","2888新光金","110/07/27","美林",3692,417,3275
"12424","2888新光金","110/07/27","新加坡商瑞銀",120,5935,-5815
"12425","2888新光金","110/07/27","凱基-台北",4378,2713,1665
"12426","2888新光金","110/07/27","摩根大通",1586,7187,-5601
"12427","2888新光金","110/07/27","凱基-台南",1551,3,1548
"12428","2888新光金","110/07/27","富邦-建國",298,5641,-5343
"12429","2888新光金","110/07/27","台新證券",1494,124,1370
"12430","2888新光金","110/07/27","第一金-高雄",81,5014,-4933
"12431","2888新光金","110/07/27","新光",2434,1212,1222
"12432","2888新光金","110/07/27","瑞士信貸",191,4524,-4333
"12433","2888新光金","110/07/27","元大-四維",1246,25,1221
"12434","2888新光金","110/07/27","兆豐-鹿港",45,2632,-2587
"12435","2888新光金","110/07/27","富隆-長安",1070,0,1070
"12436","2888新光金","110/07/27","國票-彰化",3,1803,-1800
"12437","2888新光金","110/07/27","永豐金-萬盛",1052,0,1052
"12438","2888新光金","110/07/27","港商野村",0,1434,-1434
"12439","2888新光金","110/07/27","法銀巴黎",1116,120,996
"12440","2888新光金","110/07/27","統一-高雄",173,1511,-1338
"12441","2888新光金","110/07/27","凱基-竹科",853,4,849
"12442","2888新光金","110/07/27","群益金鼎-古亭",40,1202,-1162
"12443","2888新光金","110/07/27","元大-斗信",874,50,824
"12444","2888新光金","110/07/27","日盛-樹林",34,1034,-1000
"12445","2888新光金","110/07/27","日盛-景美",811,119,692
"12446","2888新光金","110/07/27","統一-土城",18,1000,-982
"12447","2888新光金","110/07/27","元富-世貿",568,2,566
"12448","2888新光金","110/07/27","元大-鹿港",125,1057,-932
"12449","2888新光金","110/07/27","日盛-雙和",567,2,565
"12450","2888新光金","110/07/27","新光-桃園",91,993,-902
"12451","1340勝悅","110/07/27","亞東-台中",15,0,15
"12452","1340勝悅","110/07/27","凱基-岡山",0,25,-25
"12453","1340勝悅","110/07/27","元大-路竹",15,0,15
"12454","1340勝悅","110/07/27","合庫-嘉義",0,14,-14
"12455","1340勝悅","110/07/27","臺銀-臺中",7,0,7
"12456","1340勝悅","110/07/27","元大-北港",0,14,-14
"12457","1340勝悅","110/07/27","台新-台中",7,0,7
"12458","1340勝悅","110/07/27","凱基-台北",0,12,-12
"12459","1340勝悅","110/07/27","元大-屏南",6,0,6
"12460","1340勝悅","110/07/27","兆豐-三民",0,7,-7
"12461","1340勝悅","110/07/27","臺灣企銀-埔墘",5,0,5
"12462","1340勝悅","110/07/27","華南永昌-台中",1,7,-6
"12463","1340勝悅","110/07/27","日盛-板橋",5,0,5
"12464","1340勝悅","110/07/27","日盛-信義",0,5,-5
"12465","1340勝悅","110/07/27","日盛-新莊",5,0,5
"12466","1340勝悅","110/07/27","德信-和平",0,5,-5
"12467","1340勝悅","110/07/27","臺銀-鳳山",4,0,4
"12468","1340勝悅","110/07/27","台新證券",0,5,-5
"12469","1340勝悅","110/07/27","玉山-城中",4,0,4
"12470","1340勝悅","110/07/27","新光-高雄",0,4,-4
"12471","1340勝悅","110/07/27","美商高盛",3,0,3
"12472","1340勝悅","110/07/27","瑞士信貸",0,2,-2
"12473","1340勝悅","110/07/27","(牛牛牛)亞-鑫豐",3,0,3
"12474","1340勝悅","110/07/27","港商野村",0,2,-2
"12475","1340勝悅","110/07/27","國票-長城",2,0,2
"12476","1340勝悅","110/07/27","台新-高雄",1,3,-2
"12477","1340勝悅","110/07/27","新光",2,0,2
"12478","1340勝悅","110/07/27","玉山證券",0,2,-2
"12479","1340勝悅","110/07/27","群益金鼎-館前",2,0,2
"12480","1340勝悅","110/07/27","玉山-南京東路",0,2,-2
"12481","6246臺龍","110/07/27","永豐金-桃園",135,0,135
"12482","6246臺龍","110/07/27","元大-木柵",0,59,-59
"12483","6246臺龍","110/07/27","港商野村",111,30,81
"12484","6246臺龍","110/07/27","日盛-景美",0,52,-52
"12485","6246臺龍","110/07/27","元大-西螺",31,0,31
"12486","6246臺龍","110/07/27","華南永昌-彰化",0,46,-46
"12487","6246臺龍","110/07/27","群益金鼎-鳳山",27,0,27
"12488","6246臺龍","110/07/27","兆豐-松德",0,43,-43
"12489","6246臺龍","110/07/27","永豐金-虎尾",27,0,27
"12490","6246臺龍","110/07/27","華南永昌-公誠",5,35,-30
"12491","6246臺龍","110/07/27","玉山-台南",28,2,26
"12492","6246臺龍","110/07/27","凱基-幸福",0,28,-28
"12493","6246臺龍","110/07/27","元大-西屯",25,0,25
"12494","6246臺龍","110/07/27","元富-安南",0,22,-22
"12495","6246臺龍","110/07/27","國泰-忠孝",23,0,23
"12496","6246臺龍","110/07/27","日盛-文化",0,20,-20
"12497","6246臺龍","110/07/27","元大-大里",21,0,21
"12498","6246臺龍","110/07/27","兆豐-寶成",0,20,-20
"12499","6246臺龍","110/07/27","兆豐-竹北",20,0,20
"12500","6246臺龍","110/07/27","華南永昌-虎尾",0,20,-20
"12501","6246臺龍","110/07/27","元大-員林",20,0,20
"12502","6246臺龍","110/07/27","永豐金-埔里",0,19,-19
"12503","6246臺龍","110/07/27","永豐金-敦南",20,0,20
"12504","6246臺龍","110/07/27","兆豐-新營",2,20,-18
"12505","6246臺龍","110/07/27","永豐金-羅東",23,5,18
"12506","6246臺龍","110/07/27","新光-台中",3,20,-17
"12507","6246臺龍","110/07/27","永豐金-桃盛",18,0,18
"12508","6246臺龍","110/07/27","凱基-市政",0,17,-17
"12509","6246臺龍","110/07/27","統一",16,0,16
"12510","6246臺龍","110/07/27","元大-蘆洲",0,16,-16
"12511","00715L期街口布蘭特正2","110/07/27","元大證券",10436,28,10408
"12512","00715L期街口布蘭特正2","110/07/27","元大-萬華",0,751,-751
"12513","00715L期街口布蘭特正2","110/07/27","凱基-台北",4269,129,4140
"12514","00715L期街口布蘭特正2","110/07/27","元大-大里德芳",0,734,-734
"12515","00715L期街口布蘭特正2","110/07/27","群益金鼎",3798,0,3798
"12516","00715L期街口布蘭特正2","110/07/27","新光",380,1105,-725
"12517","00715L期街口布蘭特正2","110/07/27","永豐金證券",2610,22,2588
"12518","00715L期街口布蘭特正2","110/07/27","(牛牛牛)亞-網路",10,697,-687
"12519","00715L期街口布蘭特正2","110/07/27","國票",2605,21,2584
"12520","00715L期街口布蘭特正2","110/07/27","日盛-新莊",5,550,-545
"12521","00715L期街口布蘭特正2","110/07/27","富邦證券",1522,0,1522
"12522","00715L期街口布蘭特正2","110/07/27","玉山-高雄",7,494,-487
"12523","00715L期街口布蘭特正2","110/07/27","合庫證券",1507,239,1268
"12524","00715L期街口布蘭特正2","110/07/27","華南永昌",1,471,-470
"12525","00715L期街口布蘭特正2","110/07/27","元富",1102,0,1102
"12526","00715L期街口布蘭特正2","110/07/27","華南永昌-竹北",0,469,-469
"12527","00715L期街口布蘭特正2","110/07/27","凱基",980,0,980
"12528","00715L期街口布蘭特正2","110/07/27","兆豐-嘉義",0,420,-420
"12529","00715L期街口布蘭特正2","110/07/27","國票-博愛",702,0,702
"12530","00715L期街口布蘭特正2","110/07/27","國票-九鼎",0,409,-409
"12531","00715L期街口布蘭特正2","110/07/27","統一",796,117,679
"12532","00715L期街口布蘭特正2","110/07/27","統一-高雄",0,405,-405
"12533","00715L期街口布蘭特正2","110/07/27","華南永昌-長虹",810,185,625
"12534","00715L期街口布蘭特正2","110/07/27","富邦-彰化",0,402,-402
"12535","00715L期街口布蘭特正2","110/07/27","港商野村",1076,494,582
"12536","00715L期街口布蘭特正2","110/07/27","元大-羅東",0,400,-400
"12537","00715L期街口布蘭特正2","110/07/27","永豐金-三重",500,16,484
"12538","00715L期街口布蘭特正2","110/07/27","富邦-高雄",0,398,-398
"12539","00715L期街口布蘭特正2","110/07/27","元大-敦化",420,0,420
"12540","00715L期街口布蘭特正2","110/07/27","新光-台中",17,391,-374
"12541","8941關中","110/07/27","富邦-仁愛",4,0,4
"12542","8941關中","110/07/27","光和-溪湖",0,2,-2
"12543","8941關中","110/07/27","日盛-新莊",1,0,1
"12544","8941關中","110/07/27","富邦-園區",0,2,-2
"12545","8941關中","110/07/27","台新-高雄",1,0,1
"12546","8941關中","110/07/27","合庫-高雄",0,1,-1
"12547","8941關中","110/07/27","元大-金華",1,0,1
"12548","8941關中","110/07/27","凱基-台北",0,1,-1
"12549","8941關中","110/07/27","臺銀-鳳山",0,0,0
"12550","8941關中","110/07/27","富邦-台東",0,1,-1
"12551","8941關中","110/07/27","日盛-花蓮",0,0,0
"12552","8941關中","110/07/27","臺銀-鳳山",0,0,0
"12553","8941關中","110/07/27","康和-板橋",0,0,0
"12554","8941關中","110/07/27","日盛-花蓮",0,0,0
"12555","8941關中","110/07/27","富邦-宜蘭",0,0,0
"12556","8941關中","110/07/27","康和-板橋",0,0,0
"12557","8941關中","110/07/27","元大-新竹經國",0,0,0
"12558","8941關中","110/07/27","富邦-宜蘭",0,0,0
"12559","8941關中","110/07/27","永豐金-萬盛",0,0,0
"12560","8941關中","110/07/27","元大-新竹經國",0,0,0
"12561","8941關中","110/07/27","永豐金-桃盛",0,0,0
"12562","8941關中","110/07/27","永豐金-萬盛",0,0,0
"12563","8941關中","110/07/27","",NA,NA,NA
"12564","8941關中","110/07/27","永豐金-桃盛",0,0,0
"12565","8941關中","110/07/27","",NA,NA,NA
"12566","8941關中","110/07/27","",NA,NA,NA
"12567","8941關中","110/07/27","",NA,NA,NA
"12568","8941關中","110/07/27","",NA,NA,NA
"12569","8941關中","110/07/27","",NA,NA,NA
"12570","8941關中","110/07/27","",NA,NA,NA
"12571","8936國統","110/07/27","日盛-景美",100,0,100
"12572","8936國統","110/07/27","摩根大通",115,220,-105
"12573","8936國統","110/07/27","大慶-蘆洲",90,0,90
"12574","8936國統","110/07/27","玉山-桃園",0,75,-75
"12575","8936國統","110/07/27","台新-建北",60,0,60
"12576","8936國統","110/07/27","凱基-台北",13,77,-64
"12577","8936國統","110/07/27","日盛-忠孝",40,1,39
"12578","8936國統","110/07/27","元富-大昌",2,50,-48
"12579","8936國統","110/07/27","新加坡商瑞銀",109,71,38
"12580","8936國統","110/07/27","華南永昌-台中",4,45,-41
"12581","8936國統","110/07/27","華南永昌",30,0,30
"12582","8936國統","110/07/27","新光-台中",26,66,-40
"12583","8936國統","110/07/27","兆豐-來福",29,0,29
"12584","8936國統","110/07/27","台灣摩根士丹利",20,54,-34
"12585","8936國統","110/07/27","元大-旗山",28,0,28
"12586","8936國統","110/07/27","元大-東蘆",0,34,-34
"12587","8936國統","110/07/27","元大-松江",27,0,27
"12588","8936國統","110/07/27","富邦-仁愛",1,34,-33
"12589","8936國統","110/07/27","新光",41,19,22
"12590","8936國統","110/07/27","凱基-板橋",0,31,-31
"12591","8936國統","110/07/27","元富-林園",20,0,20
"12592","8936國統","110/07/27","凱基-信義",0,30,-30
"12593","8936國統","110/07/27","玉山-高雄",20,0,20
"12594","8936國統","110/07/27","瑞士信貸",1,30,-29
"12595","8936國統","110/07/27","凱基-桃園",23,3,20
"12596","8936國統","110/07/27","元大-花蓮",2,24,-22
"12597","8936國統","110/07/27","永豐金-永康",20,0,20
"12598","8936國統","110/07/27","元富-緯城",0,20,-20
"12599","8936國統","110/07/27","日盛-屏東",23,4,19
"12600","8936國統","110/07/27","群益金鼎-宜蘭",0,20,-20
"12601","6226光鼎","110/07/27","第一金-忠孝",405,4,401
"12602","6226光鼎","110/07/27","華南永昌-台南",5,240,-235
"12603","6226光鼎","110/07/27","台新-台中",272,75,197
"12604","6226光鼎","110/07/27","大慶-泰山",0,201,-201
"12605","6226光鼎","110/07/27","凱基-和平",155,7,148
"12606","6226光鼎","110/07/27","富邦-員林",2,151,-149
"12607","6226光鼎","110/07/27","新加坡商瑞銀",133,0,133
"12608","6226光鼎","110/07/27","群益金鼎-東大",23,165,-142
"12609","6226光鼎","110/07/27","統一-敦南",126,3,123
"12610","6226光鼎","110/07/27","元大-景美",3,132,-129
"12611","6226光鼎","110/07/27","台灣摩根士丹利",129,8,121
"12612","6226光鼎","110/07/27","台新-高雄",84,186,-102
"12613","6226光鼎","110/07/27","統一-新竹",117,1,116
"12614","6226光鼎","110/07/27","合庫證券",27,121,-94
"12615","6226光鼎","110/07/27","日盛證券",122,13,109
"12616","6226光鼎","110/07/27","致和-佳里",5,81,-76
"12617","6226光鼎","110/07/27","元大-潮州",101,1,100
"12618","6226光鼎","110/07/27","永豐金-南投",3,77,-74
"12619","6226光鼎","110/07/27","國泰-敦南",232,145,87
"12620","6226光鼎","110/07/27","台新-新莊",1,57,-56
"12621","6226光鼎","110/07/27","摩根大通",86,0,86
"12622","6226光鼎","110/07/27","日盛-中壢",11,64,-53
"12623","6226光鼎","110/07/27","元富",80,0,80
"12624","6226光鼎","110/07/27","日進",11,63,-52
"12625","6226光鼎","110/07/27","華南永昌-嘉義",80,1,79
"12626","6226光鼎","110/07/27","高橋",13,64,-51
"12627","6226光鼎","110/07/27","元大-高雄",70,3,67
"12628","6226光鼎","110/07/27","元大-土城",1,52,-51
"12629","6226光鼎","110/07/27","華南永昌",82,21,61
"12630","6226光鼎","110/07/27","華南永昌-林口",11,60,-49
"12631","2363矽統","110/07/27","國泰-敦南",541,118,423
"12632","2363矽統","110/07/27","摩根大通",317,1405,-1088
"12633","2363矽統","110/07/27","台新證券",564,333,231
"12634","2363矽統","110/07/27","美林",210,1095,-885
"12635","2363矽統","110/07/27","元大-沙鹿",196,9,187
"12636","2363矽統","110/07/27","港商野村",275,1065,-790
"12637","2363矽統","110/07/27","新光",300,151,149
"12638","2363矽統","110/07/27","凱基-台北",518,1192,-674
"12639","2363矽統","110/07/27","華南永昌-台南",108,3,105
"12640","2363矽統","110/07/27","新加坡商瑞銀",213,703,-490
"12641","2363矽統","110/07/27","華南永昌-朴子",140,43,97
"12642","2363矽統","110/07/27","富邦-南屯",6,272,-266
"12643","2363矽統","110/07/27","華南永昌-公誠",109,13,96
"12644","2363矽統","110/07/27","美商高盛",31,233,-202
"12645","2363矽統","110/07/27","元富-松德",95,1,94
"12646","2363矽統","110/07/27","元大證券",38,235,-197
"12647","2363矽統","110/07/27","中國信託-永康",102,8,94
"12648","2363矽統","110/07/27","永豐金證券",15,201,-186
"12649","2363矽統","110/07/27","台新-三民",111,21,90
"12650","2363矽統","110/07/27","亞東",46,206,-160
"12651","2363矽統","110/07/27","凱基-中港",85,3,82
"12652","2363矽統","110/07/27","群益金鼎",21,169,-148
"12653","2363矽統","110/07/27","元富-烏日",87,6,81
"12654","2363矽統","110/07/27","第一金-嘉義",0,100,-100
"12655","2363矽統","110/07/27","富邦-台北",135,56,79
"12656","2363矽統","110/07/27","凱基-彰化",9,100,-91
"12657","2363矽統","110/07/27","元大-復北",81,12,69
"12658","2363矽統","110/07/27","元富-佳里",27,97,-70
"12659","2363矽統","110/07/27","中國信託-忠孝",94,26,68
"12660","2363矽統","110/07/27","合庫-桃園",8,76,-68
"12661","8112至上","110/07/27","凱基-竹科",300,10,290
"12662","8112至上","110/07/27","凱基-三重",1,501,-500
"12663","8112至上","110/07/27","台灣摩根士丹利",271,49,222
"12664","8112至上","110/07/27","美林",21,339,-318
"12665","8112至上","110/07/27","摩根大通",488,427,61
"12666","8112至上","110/07/27","凱基-台北",423,615,-192
"12667","8112至上","110/07/27","香港上海匯豐",61,0,61
"12668","8112至上","110/07/27","港商野村",83,183,-100
"12669","8112至上","110/07/27","日盛證券",62,4,58
"12670","8112至上","110/07/27","永豐金-台南",2,79,-77
"12671","8112至上","110/07/27","元大-基隆孝二",52,0,52
"12672","8112至上","110/07/27","福邦證券",0,71,-71
"12673","8112至上","110/07/27","永豐金-中正",59,7,52
"12674","8112至上","110/07/27","兆豐-天母",0,50,-50
"12675","8112至上","110/07/27","群益金鼎-高盛",47,0,47
"12676","8112至上","110/07/27","元富-林園",3,52,-49
"12677","8112至上","110/07/27","永豐金-內湖",47,0,47
"12678","8112至上","110/07/27","永豐金-苓雅",1,50,-49
"12679","8112至上","110/07/27","富邦-台北",45,5,40
"12680","8112至上","110/07/27","元大-新莊",9,53,-44
"12681","8112至上","110/07/27","台新證券",78,39,39
"12682","8112至上","110/07/27","第一金-路竹",20,57,-37
"12683","8112至上","110/07/27","新光-台中",44,7,37
"12684","8112至上","110/07/27","新光-桃園",2,36,-34
"12685","8112至上","110/07/27","元大-羅東",38,1,37
"12686","8112至上","110/07/27","元大-東港",0,27,-27
"12687","8112至上","110/07/27","新光",101,65,36
"12688","8112至上","110/07/27","國泰-松江",2,28,-26
"12689","8112至上","110/07/27","元大-新竹",63,28,35
"12690","8112至上","110/07/27","群益金鼎-潭子",2,28,-26
"12691","1570力肯","110/07/27","國票-北高雄",7,0,7
"12692","1570力肯","110/07/27","元大-高雄",0,16,-16
"12693","1570力肯","110/07/27","富邦-陽明",5,0,5
"12694","1570力肯","110/07/27","國票-新莊",0,5,-5
"12695","1570力肯","110/07/27","元大-民雄",3,0,3
"12696","1570力肯","110/07/27","凱基-台北",0,5,-5
"12697","1570力肯","110/07/27","凱基-大里",3,0,3
"12698","1570力肯","110/07/27","美林",0,2,-2
"12699","1570力肯","110/07/27","凱基-長庚",3,0,3
"12700","1570力肯","110/07/27","富邦-南屯",0,2,-2
"12701","1570力肯","110/07/27","元大-新莊",2,0,2
"12702","1570力肯","110/07/27","元大-南崁",0,2,-2
"12703","1570力肯","110/07/27","大昌-樹林",2,0,2
"12704","1570力肯","110/07/27","元大-板橋",0,2,-2
"12705","1570力肯","110/07/27","台新-台中",2,0,2
"12706","1570力肯","110/07/27","新光",0,1,-1
"12707","1570力肯","110/07/27","新光-新竹",2,0,2
"12708","1570力肯","110/07/27","國泰-板橋",0,1,-1
"12709","1570力肯","110/07/27","富邦-左營",2,0,2
"12710","1570力肯","110/07/27","凱基-鳳山",0,1,-1
"12711","1570力肯","110/07/27","群益金鼎-土城",1,0,1
"12712","1570力肯","110/07/27","(牛牛牛)亞-鑫豐",2,2,0
"12713","1570力肯","110/07/27","凱基-竹東",1,0,1
"12714","1570力肯","110/07/27","元大-新盛",1,1,0
"12715","1570力肯","110/07/27","日盛-員林",1,0,1
"12716","1570力肯","110/07/27","",NA,NA,NA
"12717","1570力肯","110/07/27","玉山-板橋",1,0,1
"12718","1570力肯","110/07/27","",NA,NA,NA
"12719","1570力肯","110/07/27","元富-同大",1,0,1
"12720","1570力肯","110/07/27","",NA,NA,NA
"12721","2929淘帝","110/07/27","元大-民生",28,0,28
"12722","2929淘帝","110/07/27","元大-鳳山",0,20,-20
"12723","2929淘帝","110/07/27","臺銀-民權",18,0,18
"12724","2929淘帝","110/07/27","港商野村",1,18,-17
"12725","2929淘帝","110/07/27","合庫-高雄",13,0,13
"12726","2929淘帝","110/07/27","玉山-板橋",0,15,-15
"12727","2929淘帝","110/07/27","永興-水湳",10,0,10
"12728","2929淘帝","110/07/27","美林",0,10,-10
"12729","2929淘帝","110/07/27","富邦-陽明",10,0,10
"12730","2929淘帝","110/07/27","凱基-八德",0,10,-10
"12731","2929淘帝","110/07/27","元大-中和",10,0,10
"12732","2929淘帝","110/07/27","永豐金證券",0,9,-9
"12733","2929淘帝","110/07/27","國泰-館前",6,0,6
"12734","2929淘帝","110/07/27","新加坡商瑞銀",10,18,-8
"12735","2929淘帝","110/07/27","富邦-內湖",6,0,6
"12736","2929淘帝","110/07/27","富邦-台北",0,8,-8
"12737","2929淘帝","110/07/27","合庫-台南",5,0,5
"12738","2929淘帝","110/07/27","宏遠-台中",0,7,-7
"12739","2929淘帝","110/07/27","凱基-東門",5,0,5
"12740","2929淘帝","110/07/27","元富-潮州",0,7,-7
"12741","2929淘帝","110/07/27","元大-大益",5,0,5
"12742","2929淘帝","110/07/27","群益金鼎-延平",0,6,-6
"12743","2929淘帝","110/07/27","元大-屏南",5,0,5
"12744","2929淘帝","110/07/27","元大-文心",0,6,-6
"12745","2929淘帝","110/07/27","永豐金-板盛",5,0,5
"12746","2929淘帝","110/07/27","永豐金-中壢",0,6,-6
"12747","2929淘帝","110/07/27","臺銀",4,0,4
"12748","2929淘帝","110/07/27","美商高盛",0,5,-5
"12749","2929淘帝","110/07/27","永豐金-市政",4,0,4
"12750","2929淘帝","110/07/27","兆豐-南門",0,5,-5
"12751","5410國眾","110/07/27","摩根大通",47,0,47
"12752","5410國眾","110/07/27","元富-嘉義",0,48,-48
"12753","5410國眾","110/07/27","兆豐-城中",43,0,43
"12754","5410國眾","110/07/27","統一-平鎮",0,20,-20
"12755","5410國眾","110/07/27","香港上海匯豐",36,0,36
"12756","5410國眾","110/07/27","元大-大益",0,18,-18
"12757","5410國眾","110/07/27","港商麥格理",26,0,26
"12758","5410國眾","110/07/27","凱基-台北",0,16,-16
"12759","5410國眾","110/07/27","元富-大昌",21,0,21
"12760","5410國眾","110/07/27","凱基-站前",0,15,-15
"12761","5410國眾","110/07/27","元富-四維",20,0,20
"12762","5410國眾","110/07/27","元大-南勢角",0,13,-13
"12763","5410國眾","110/07/27","新光-台中",20,0,20
"12764","5410國眾","110/07/27","日盛-忠孝",0,11,-11
"12765","5410國眾","110/07/27","統一-金門",15,0,15
"12766","5410國眾","110/07/27","玉山-板橋",0,11,-11
"12767","5410國眾","110/07/27","玉山-高雄",15,0,15
"12768","5410國眾","110/07/27","元大-崇德",0,11,-11
"12769","5410國眾","110/07/27","凱基-竹北",15,0,15
"12770","5410國眾","110/07/27","元大-大天母",0,11,-11
"12771","5410國眾","110/07/27","元大-新莊",14,1,13
"12772","5410國眾","110/07/27","元富-松德",0,10,-10
"12773","5410國眾","110/07/27","華南永昌-中正",14,4,10
"12774","5410國眾","110/07/27","豐農",0,10,-10
"12775","5410國眾","110/07/27","元大-屏南",10,0,10
"12776","5410國眾","110/07/27","新光-新竹",0,10,-10
"12777","5410國眾","110/07/27","元大-中和",10,0,10
"12778","5410國眾","110/07/27","凱基-虎尾",0,10,-10
"12779","5410國眾","110/07/27","台新證券",10,1,9
"12780","5410國眾","110/07/27","元大-善化",0,10,-10
"12781","2841台開","110/07/27","日盛證券",620,0,620
"12782","2841台開","110/07/27","玉山-新竹",0,312,-312
"12783","2841台開","110/07/27","永豐金-豐原",65,0,65
"12784","2841台開","110/07/27","港商野村",0,216,-216
"12785","2841台開","110/07/27","元大-南投",50,0,50
"12786","2841台開","110/07/27","永興-水湳",0,90,-90
"12787","2841台開","110/07/27","台灣摩根士丹利",40,0,40
"12788","2841台開","110/07/27","凱基-興隆",0,64,-64
"12789","2841台開","110/07/27","玉山-高雄",29,0,29
"12790","2841台開","110/07/27","美林",0,30,-30
"12791","2841台開","110/07/27","第一金-台中",20,0,20
"12792","2841台開","110/07/27","國泰-松江",5,35,-30
"12793","2841台開","110/07/27","凱基-市政",20,0,20
"12794","2841台開","110/07/27","台新-左楠",0,25,-25
"12795","2841台開","110/07/27","群益金鼎-大甲",18,1,17
"12796","2841台開","110/07/27","大昌-樹林",0,20,-20
"12797","2841台開","110/07/27","台中銀",16,1,15
"12798","2841台開","110/07/27","富邦-仁愛",0,20,-20
"12799","2841台開","110/07/27","國泰-板橋",12,0,12
"12800","2841台開","110/07/27","致和-南京",0,16,-16
"12801","2841台開","110/07/27","群益金鼎-基隆",10,0,10
"12802","2841台開","110/07/27","凱基-台北",2,16,-14
"12803","2841台開","110/07/27","華南永昌-新莊",10,0,10
"12804","2841台開","110/07/27","日盛-台南",0,10,-10
"12805","2841台開","110/07/27","元大-福營",10,0,10
"12806","2841台開","110/07/27","國票-台東",0,10,-10
"12807","2841台開","110/07/27","元大-歸仁",10,0,10
"12808","2841台開","110/07/27","台新-台中",5,15,-10
"12809","2841台開","110/07/27","中國信託-文心",5,0,5
"12810","2841台開","110/07/27","凱基-台中",0,10,-10
"12811","6207雷科","110/07/27","摩根大通",249,119,130
"12812","6207雷科","110/07/27","永豐金-台南",2,82,-80
"12813","6207雷科","110/07/27","群益金鼎-丹鳳",70,0,70
"12814","6207雷科","110/07/27","永豐金-內湖",39,109,-70
"12815","6207雷科","110/07/27","群益金鼎-東門",42,0,42
"12816","6207雷科","110/07/27","新加坡商瑞銀",22,76,-54
"12817","6207雷科","110/07/27","永豐金-敦南",38,4,34
"12818","6207雷科","110/07/27","新光-高雄",4,57,-53
"12819","6207雷科","110/07/27","凱基-復興",30,0,30
"12820","6207雷科","110/07/27","瑞士信貸",0,40,-40
"12821","6207雷科","110/07/27","元大-東門",30,0,30
"12822","6207雷科","110/07/27","凱基-高雄",4,43,-39
"12823","6207雷科","110/07/27","大昌-桃園",33,8,25
"12824","6207雷科","110/07/27","華南永昌-高雄",4,40,-36
"12825","6207雷科","110/07/27","富邦-虎尾",24,0,24
"12826","6207雷科","110/07/27","新光",11,44,-33
"12827","6207雷科","110/07/27","凱基-羅東",24,2,22
"12828","6207雷科","110/07/27","日盛-板橋中山",0,29,-29
"12829","6207雷科","110/07/27","群益金鼎-延平",21,0,21
"12830","6207雷科","110/07/27","元大-六合",3,30,-27
"12831","6207雷科","110/07/27","群益金鼎-屏東",20,0,20
"12832","6207雷科","110/07/27","中國信託-新竹",7,33,-26
"12833","6207雷科","110/07/27","永豐金-埔里",20,0,20
"12834","6207雷科","110/07/27","元富-城中",0,23,-23
"12835","6207雷科","110/07/27","康和-延平",21,3,18
"12836","6207雷科","110/07/27","元大-大雅",2,20,-18
"12837","6207雷科","110/07/27","群益金鼎-中壢",20,2,18
"12838","6207雷科","110/07/27","永豐金-新莊",2,20,-18
"12839","6207雷科","110/07/27","宏遠證券",31,15,16
"12840","6207雷科","110/07/27","富邦-台中",5,21,-16
"12841","3679新至陞","110/07/27","凱基-市政",25,0,25
"12842","3679新至陞","110/07/27","瑞士信貸",0,13,-13
"12843","3679新至陞","110/07/27","兆豐-高雄",10,0,10
"12844","3679新至陞","110/07/27","元大-天母",0,9,-9
"12845","3679新至陞","110/07/27","光和-溪湖",8,0,8
"12846","3679新至陞","110/07/27","元大-彰化民生",0,6,-6
"12847","3679新至陞","110/07/27","臺銀-新竹",7,0,7
"12848","3679新至陞","110/07/27","康和-澎湖",2,7,-5
"12849","3679新至陞","110/07/27","新加坡商瑞銀",7,0,7
"12850","3679新至陞","110/07/27","聯邦-大業",0,5,-5
"12851","3679新至陞","110/07/27","永豐金-板橋",6,0,6
"12852","3679新至陞","110/07/27","元大-成功",0,5,-5
"12853","3679新至陞","110/07/27","宏遠-光隆",5,0,5
"12854","3679新至陞","110/07/27","康和-板橋",0,4,-4
"12855","3679新至陞","110/07/27","統一",5,0,5
"12856","3679新至陞","110/07/27","凱基-新豐",0,4,-4
"12857","3679新至陞","110/07/27","統一-新竹",5,0,5
"12858","3679新至陞","110/07/27","統一-高雄",0,3,-3
"12859","3679新至陞","110/07/27","元富-松德",5,0,5
"12860","3679新至陞","110/07/27","統一-新台中",0,3,-3
"12861","3679新至陞","110/07/27","元大-淡水",5,0,5
"12862","3679新至陞","110/07/27","元富-安南",0,3,-3
"12863","3679新至陞","110/07/27","日盛證券",4,0,4
"12864","3679新至陞","110/07/27","國票-北高雄",0,3,-3
"12865","3679新至陞","110/07/27","國泰-板橋",4,0,4
"12866","3679新至陞","110/07/27","玉山-新莊",0,3,-3
"12867","3679新至陞","110/07/27","(牛牛牛)亞-網路",3,0,3
"12868","3679新至陞","110/07/27","凱基-屏東",0,3,-3
"12869","3679新至陞","110/07/27","國票-九鼎",3,0,3
"12870","3679新至陞","110/07/27","台灣摩根士丹利",0,2,-2
"12871","2727王品","110/07/27","台灣摩根士丹利",103,12,91
"12872","2727王品","110/07/27","元大-彰化民生",11,420,-409
"12873","2727王品","110/07/27","華南永昌-麻豆",33,0,33
"12874","2727王品","110/07/27","美商高盛",0,247,-247
"12875","2727王品","110/07/27","元大-龍潭",31,1,30
"12876","2727王品","110/07/27","華南永昌",7,193,-186
"12877","2727王品","110/07/27","國泰-敦南",38,11,27
"12878","2727王品","110/07/27","花旗環球",0,86,-86
"12879","2727王品","110/07/27","群益金鼎-基隆",27,1,26
"12880","2727王品","110/07/27","凱基-台北",81,139,-58
"12881","2727王品","110/07/27","富邦-台中",26,0,26
"12882","2727王品","110/07/27","元大證券",23,64,-41
"12883","2727王品","110/07/27","元富",31,6,25
"12884","2727王品","110/07/27","瑞士信貸",0,37,-37
"12885","2727王品","110/07/27","元大-桃園",25,0,25
"12886","2727王品","110/07/27","富邦-建國",8,35,-27
"12887","2727王品","110/07/27","凱基-大直",21,1,20
"12888","2727王品","110/07/27","凱基-埔墘",6,29,-23
"12889","2727王品","110/07/27","日盛-士林",16,0,16
"12890","2727王品","110/07/27","美林",5,26,-21
"12891","2727王品","110/07/27","國票-敦北法人",17,1,16
"12892","2727王品","110/07/27","港商野村",12,30,-18
"12893","2727王品","110/07/27","群益金鼎-高雄",16,0,16
"12894","2727王品","110/07/27","華南永昌-林口",3,21,-18
"12895","2727王品","110/07/27","永豐金-忠孝",18,2,16
"12896","2727王品","110/07/27","彰銀-台中",4,20,-16
"12897","2727王品","110/07/27","臺銀-高雄",16,1,15
"12898","2727王品","110/07/27","統一",3,17,-14
"12899","2727王品","110/07/27","台新-台中",18,3,15
"12900","2727王品","110/07/27","富邦-新竹華信",2,15,-13
"12901","1570力肯","110/07/27","國票-北高雄",7,0,7
"12902","1570力肯","110/07/27","元大-高雄",0,16,-16
"12903","1570力肯","110/07/27","富邦-陽明",5,0,5
"12904","1570力肯","110/07/27","國票-新莊",0,5,-5
"12905","1570力肯","110/07/27","元大-民雄",3,0,3
"12906","1570力肯","110/07/27","凱基-台北",0,5,-5
"12907","1570力肯","110/07/27","凱基-大里",3,0,3
"12908","1570力肯","110/07/27","美林",0,2,-2
"12909","1570力肯","110/07/27","凱基-長庚",3,0,3
"12910","1570力肯","110/07/27","富邦-南屯",0,2,-2
"12911","1570力肯","110/07/27","元大-新莊",2,0,2
"12912","1570力肯","110/07/27","元大-南崁",0,2,-2
"12913","1570力肯","110/07/27","大昌-樹林",2,0,2
"12914","1570力肯","110/07/27","元大-板橋",0,2,-2
"12915","1570力肯","110/07/27","台新-台中",2,0,2
"12916","1570力肯","110/07/27","新光",0,1,-1
"12917","1570力肯","110/07/27","新光-新竹",2,0,2
"12918","1570力肯","110/07/27","國泰-板橋",0,1,-1
"12919","1570力肯","110/07/27","富邦-左營",2,0,2
"12920","1570力肯","110/07/27","凱基-鳳山",0,1,-1
"12921","1570力肯","110/07/27","群益金鼎-土城",1,0,1
"12922","1570力肯","110/07/27","(牛牛牛)亞-鑫豐",2,2,0
"12923","1570力肯","110/07/27","凱基-竹東",1,0,1
"12924","1570力肯","110/07/27","元大-新盛",1,1,0
"12925","1570力肯","110/07/27","日盛-員林",1,0,1
"12926","1570力肯","110/07/27","",NA,NA,NA
"12927","1570力肯","110/07/27","玉山-板橋",1,0,1
"12928","1570力肯","110/07/27","",NA,NA,NA
"12929","1570力肯","110/07/27","元富-同大",1,0,1
"12930","1570力肯","110/07/27","",NA,NA,NA
"12931","6180橘子","110/07/27","新加坡商瑞銀",166,24,142
"12932","6180橘子","110/07/27","花旗環球",31,87,-56
"12933","6180橘子","110/07/27","彰銀-台中",50,1,49
"12934","6180橘子","110/07/27","凱基-台北",53,108,-55
"12935","6180橘子","110/07/27","日盛-文化",48,8,40
"12936","6180橘子","110/07/27","新光",39,81,-42
"12937","6180橘子","110/07/27","美林",39,0,39
"12938","6180橘子","110/07/27","富邦-台北",1,25,-24
"12939","6180橘子","110/07/27","元大-草屯",54,17,37
"12940","6180橘子","110/07/27","第一金-員林",0,22,-22
"12941","6180橘子","110/07/27","美商高盛",35,1,34
"12942","6180橘子","110/07/27","富邦-新竹華信",7,28,-21
"12943","6180橘子","110/07/27","元大-上新莊",32,0,32
"12944","6180橘子","110/07/27","凱基-中山",5,24,-19
"12945","6180橘子","110/07/27","台灣摩根士丹利",30,0,30
"12946","6180橘子","110/07/27","國泰-敦南",22,37,-15
"12947","6180橘子","110/07/27","摩根大通",49,21,28
"12948","6180橘子","110/07/27","合庫-自強",2,16,-14
"12949","6180橘子","110/07/27","兆豐-大同",30,4,26
"12950","6180橘子","110/07/27","大昌-安康",1,14,-13
"12951","6180橘子","110/07/27","元大-羅東",21,0,21
"12952","6180橘子","110/07/27","高橋",0,11,-11
"12953","6180橘子","110/07/27","日盛-頭份",16,0,16
"12954","6180橘子","110/07/27","土銀-新竹",0,10,-10
"12955","6180橘子","110/07/27","瑞士信貸",24,8,16
"12956","6180橘子","110/07/27","兆豐-麻豆",0,10,-10
"12957","6180橘子","110/07/27","群益金鼎-士林",15,0,15
"12958","6180橘子","110/07/27","康和-永和",0,10,-10
"12959","6180橘子","110/07/27","永豐金-南京",15,1,14
"12960","6180橘子","110/07/27","永豐金-竹科",2,12,-10
"12961","2390云辰","110/07/27","凱基-基隆",207,3,204
"12962","2390云辰","110/07/27","凱基-台北",248,732,-484
"12963","2390云辰","110/07/27","摩根大通",730,560,170
"12964","2390云辰","110/07/27","美林",17,218,-201
"12965","2390云辰","110/07/27","華南永昌-中正",182,43,139
"12966","2390云辰","110/07/27","港商野村",85,277,-192
"12967","2390云辰","110/07/27","兆豐-北高雄",124,1,123
"12968","2390云辰","110/07/27","玉山-新莊",4,87,-83
"12969","2390云辰","110/07/27","元大-信義",108,5,103
"12970","2390云辰","110/07/27","新光",96,163,-67
"12971","2390云辰","110/07/27","富邦-陽明",94,22,72
"12972","2390云辰","110/07/27","新光-新竹",7,74,-67
"12973","2390云辰","110/07/27","日盛證券",140,71,69
"12974","2390云辰","110/07/27","富邦-左營",46,107,-61
"12975","2390云辰","110/07/27","第一金-豐原",56,0,56
"12976","2390云辰","110/07/27","大昌-新店",9,64,-55
"12977","2390云辰","110/07/27","統一-新台中",67,22,45
"12978","2390云辰","110/07/27","日盛-和美",28,81,-53
"12979","2390云辰","110/07/27","元大-復北",47,2,45
"12980","2390云辰","110/07/27","元大-台南",3,54,-51
"12981","2390云辰","110/07/27","富邦-建國",54,10,44
"12982","2390云辰","110/07/27","元富-世貿",10,60,-50
"12983","2390云辰","110/07/27","兆豐-桃鶯",46,5,41
"12984","2390云辰","110/07/27","華南永昌-鳳山",41,90,-49
"12985","2390云辰","110/07/27","富邦-中壢",45,4,41
"12986","2390云辰","110/07/27","聯邦商銀",6,52,-46
"12987","2390云辰","110/07/27","富邦-新竹華信",46,11,35
"12988","2390云辰","110/07/27","合庫-高雄",7,50,-43
"12989","2390云辰","110/07/27","第一金-華江",30,2,28
"12990","2390云辰","110/07/27","瑞士信貸",0,42,-42
"12991","2363矽統","110/07/26","凱基-台北",1994,468,1526
"12992","2363矽統","110/07/26","富邦-南屯",5,375,-370
"12993","2363矽統","110/07/26","新加坡商瑞銀",1537,208,1329
"12994","2363矽統","110/07/26","聯邦-興中",0,203,-203
"12995","2363矽統","110/07/26","摩根大通",2033,997,1036
"12996","2363矽統","110/07/26","台新證券",427,622,-195
"12997","2363矽統","110/07/26","瑞士信貸",930,0,930
"12998","2363矽統","110/07/26","元大-鳳中",10,203,-193
"12999","2363矽統","110/07/26","美林",985,76,909
"13000","2363矽統","110/07/26","國泰-板橋",69,209,-140
"13001","2363矽統","110/07/26","港商野村",1072,282,790
"13002","2363矽統","110/07/26","北城證券",6,132,-126
"13003","2363矽統","110/07/26","美商高盛",711,7,704
"13004","2363矽統","110/07/26","華南永昌-朴子",30,152,-122
"13005","2363矽統","110/07/26","新光",570,278,292
"13006","2363矽統","110/07/26","台新-台中",27,145,-118
"13007","2363矽統","110/07/26","台新-台南",244,39,205
"13008","2363矽統","110/07/26","群益金鼎-萬華",13,128,-115
"13009","2363矽統","110/07/26","元大證券",243,52,191
"13010","2363矽統","110/07/26","日盛-樹林",7,116,-109
"13011","2363矽統","110/07/26","永豐金證券",189,27,162
"13012","2363矽統","110/07/26","群益金鼎-屏東",200,303,-103
"13013","2363矽統","110/07/26","元大-楊梅",177,16,161
"13014","2363矽統","110/07/26","元大-潮州",6,102,-96
"13015","2363矽統","110/07/26","群益金鼎",158,21,137
"13016","2363矽統","110/07/26","新光-桃園",22,117,-95
"13017","2363矽統","110/07/26","元富-城東",107,8,99
"13018","2363矽統","110/07/26","凱基-和平",45,140,-95
"13019","2363矽統","110/07/26","日盛-雙和",109,14,95
"13020","2363矽統","110/07/26","合庫-台南",5,95,-90
"13021","8112至上","110/07/26","摩根大通",1728,41,1687
"13022","8112至上","110/07/26","玉山-左營",3,600,-597
"13023","8112至上","110/07/26","台灣摩根士丹利",408,10,398
"13024","8112至上","110/07/26","凱基-三重",1,527,-526
"13025","8112至上","110/07/26","凱基-台北",693,311,382
"13026","8112至上","110/07/26","中國信託-忠孝",0,103,-103
"13027","8112至上","110/07/26","港商法國興業",376,1,375
"13028","8112至上","110/07/26","凱基-站前",7,105,-98
"13029","8112至上","110/07/26","美商高盛",172,26,146
"13030","8112至上","110/07/26","國票-中港",0,96,-96
"13031","8112至上","110/07/26","新加坡商瑞銀",201,69,132
"13032","8112至上","110/07/26","兆豐-公益",3,84,-81
"13033","8112至上","110/07/26","美林",192,62,130
"13034","8112至上","110/07/26","玉山證券",2,65,-63
"13035","8112至上","110/07/26","港商野村",142,58,84
"13036","8112至上","110/07/26","統一-台中",1,62,-61
"13037","8112至上","110/07/26","凱基-永和",75,0,75
"13038","8112至上","110/07/26","富邦-陽明",3,60,-57
"13039","8112至上","110/07/26","凱基-竹科",65,2,63
"13040","8112至上","110/07/26","新光-新竹",86,141,-55
"13041","8112至上","110/07/26","華南永昌-敦南",63,1,62
"13042","8112至上","110/07/26","富邦-台北",2,57,-55
"13043","8112至上","110/07/26","兆豐-天母",50,0,50
"13044","8112至上","110/07/26","玉山-板橋",2,51,-49
"13045","8112至上","110/07/26","新光-桃園",57,11,46
"13046","8112至上","110/07/26","台新-新營",6,47,-41
"13047","8112至上","110/07/26","光和",35,1,34
"13048","8112至上","110/07/26","元大-虎尾",4,42,-38
"13049","8112至上","110/07/26","華南永昌-新莊",31,3,28
"13050","8112至上","110/07/26","日盛-新竹",1,38,-37
"13051","1570力肯","110/07/26","元大-民雄",10,0,10
"13052","1570力肯","110/07/26","元大-高雄",0,33,-33
"13053","1570力肯","110/07/26","新光-台中",10,1,9
"13054","1570力肯","110/07/26","日盛-宜蘭",0,8,-8
"13055","1570力肯","110/07/26","富邦-陽明",9,0,9
"13056","1570力肯","110/07/26","美林",0,5,-5
"13057","1570力肯","110/07/26","大慶-蘆洲",8,0,8
"13058","1570力肯","110/07/26","凱基-永康",0,5,-5
"13059","1570力肯","110/07/26","福勝",8,0,8
"13060","1570力肯","110/07/26","台新證券",0,4,-4
"13061","1570力肯","110/07/26","凱基-桃園",7,0,7
"13062","1570力肯","110/07/26","元大-汐止",0,4,-4
"13063","1570力肯","110/07/26","中國信託-永康",3,0,3
"13064","1570力肯","110/07/26","元大-桃興",0,3,-3
"13065","1570力肯","110/07/26","兆豐-台中港",3,0,3
"13066","1570力肯","110/07/26","元富-吉利",0,2,-2
"13067","1570力肯","110/07/26","國票-北高雄",3,0,3
"13068","1570力肯","110/07/26","國泰-板橋",0,2,-2
"13069","1570力肯","110/07/26","富邦-員林",3,0,3
"13070","1570力肯","110/07/26","元大-台中",0,2,-2
"13071","1570力肯","110/07/26","瑞士信貸",2,0,2
"13072","1570力肯","110/07/26","元大-西螺",0,2,-2
"13073","1570力肯","110/07/26","大昌-樹林",2,0,2
"13074","1570力肯","110/07/26","元大-苑裡",0,2,-2
"13075","1570力肯","110/07/26","兆豐-忠孝",2,0,2
"13076","1570力肯","110/07/26","合庫-三重",0,1,-1
"13077","1570力肯","110/07/26","新光",2,0,2
"13078","1570力肯","110/07/26","臺銀-臺南",0,1,-1
"13079","1570力肯","110/07/26","凱基-台北",2,0,2
"13080","1570力肯","110/07/26","元富-永和",0,1,-1
"13081","2929淘帝","110/07/26","合庫-高雄",47,0,47
"13082","2929淘帝","110/07/26","港商野村",11,42,-31
"13083","2929淘帝","110/07/26","元大-民生",28,0,28
"13084","2929淘帝","110/07/26","凱基-林口",0,30,-30
"13085","2929淘帝","110/07/26","臺銀-鳳山",10,0,10
"13086","2929淘帝","110/07/26","美林",1,28,-27
"13087","2929淘帝","110/07/26","華南永昌-鶯歌",10,0,10
"13088","2929淘帝","110/07/26","富邦-竹北",0,20,-20
"13089","2929淘帝","110/07/26","元大-永和",10,0,10
"13090","2929淘帝","110/07/26","凱基-台北",0,12,-12
"13091","2929淘帝","110/07/26","永豐金證券",8,0,8
"13092","2929淘帝","110/07/26","中國信託-永康",0,10,-10
"13093","2929淘帝","110/07/26","元大-太平",8,1,7
"13094","2929淘帝","110/07/26","摩根大通",0,10,-10
"13095","2929淘帝","110/07/26","德信-和平",6,0,6
"13096","2929淘帝","110/07/26","群益金鼎-高雄",0,10,-10
"13097","2929淘帝","110/07/26","兆豐-南門",6,0,6
"13098","2929淘帝","110/07/26","富邦-宜蘭",0,10,-10
"13099","2929淘帝","110/07/26","元大-新竹經國",6,0,6
"13100","2929淘帝","110/07/26","新加坡商瑞銀",4,13,-9
"13101","2929淘帝","110/07/26","合庫-台南",5,0,5
"13102","2929淘帝","110/07/26","元富-敦南",0,7,-7
"13103","2929淘帝","110/07/26","第一金-新興",5,0,5
"13104","2929淘帝","110/07/26","元大-基隆",0,6,-6
"13105","2929淘帝","110/07/26","玉山-新竹",5,0,5
"13106","2929淘帝","110/07/26","新光-台中",1,6,-5
"13107","2929淘帝","110/07/26","元大-金門",5,0,5
"13108","2929淘帝","110/07/26","華南永昌",0,5,-5
"13109","2929淘帝","110/07/26","台新-台中",4,0,4
"13110","2929淘帝","110/07/26","永豐金-中和",0,5,-5
"13111","5410國眾","110/07/26","摩根大通",71,0,71
"13112","5410國眾","110/07/26","日盛-忠孝",0,142,-142
"13113","5410國眾","110/07/26","凱基-台北",67,4,63
"13114","5410國眾","110/07/26","元富-嘉義",0,55,-55
"13115","5410國眾","110/07/26","兆豐-城中",47,0,47
"13116","5410國眾","110/07/26","國泰-敦南",2,30,-28
"13117","5410國眾","110/07/26","永豐金-內湖",45,0,45
"13118","5410國眾","110/07/26","群益金鼎-板橋",0,15,-15
"13119","5410國眾","110/07/26","元大-新莊",26,0,26
"13120","5410國眾","110/07/26","華南永昌-三重",0,11,-11
"13121","5410國眾","110/07/26","兆豐-麻豆",10,0,10
"13122","5410國眾","110/07/26","永全-南崁",0,10,-10
"13123","5410國眾","110/07/26","新光-台中",10,0,10
"13124","5410國眾","110/07/26","台新-建北",1,11,-10
"13125","5410國眾","110/07/26","元大-屏南",10,0,10
"13126","5410國眾","110/07/26","臺銀-臺南",0,8,-8
"13127","5410國眾","110/07/26","港商野村",9,0,9
"13128","5410國眾","110/07/26","群益金鼎-東大",0,7,-7
"13129","5410國眾","110/07/26","新光",13,4,9
"13130","5410國眾","110/07/26","永豐金-中正",0,7,-7
"13131","5410國眾","110/07/26","華南永昌-小港",7,0,7
"13132","5410國眾","110/07/26","永豐金-桃園",0,7,-7
"13133","5410國眾","110/07/26","玉山-左營",6,0,6
"13134","5410國眾","110/07/26","第一金-高雄",0,6,-6
"13135","5410國眾","110/07/26","土銀-台南",5,0,5
"13136","5410國眾","110/07/26","台中銀-豐原",0,6,-6
"13137","5410國眾","110/07/26","新加坡商瑞銀",5,0,5
"13138","5410國眾","110/07/26","亞東-高雄",0,5,-5
"13139","5410國眾","110/07/26","元富-三重",8,3,5
"13140","5410國眾","110/07/26","國票-北高雄",0,5,-5
"13141","2841台開","110/07/26","台新-台中",282,5,277
"13142","2841台開","110/07/26","港商野村",0,128,-128
"13143","2841台開","110/07/26","凱基-台北",41,0,41
"13144","2841台開","110/07/26","富邦-仁愛",0,70,-70
"13145","2841台開","110/07/26","台灣摩根士丹利",40,0,40
"13146","2841台開","110/07/26","元大-彰化",0,60,-60
"13147","2841台開","110/07/26","元富-緯城",40,0,40
"13148","2841台開","110/07/26","永興-水湳",0,30,-30
"13149","2841台開","110/07/26","玉山-高雄",38,0,38
"13150","2841台開","110/07/26","富邦-新竹華信",0,23,-23
"13151","2841台開","110/07/26","日盛-樹林",21,0,21
"13152","2841台開","110/07/26","宏遠-光隆",0,20,-20
"13153","2841台開","110/07/26","元大-松江",20,0,20
"13154","2841台開","110/07/26","玉山證券",0,20,-20
"13155","2841台開","110/07/26","元大-歸仁",20,0,20
"13156","2841台開","110/07/26","富邦-板橋",0,20,-20
"13157","2841台開","110/07/26","國泰-桃園",20,3,17
"13158","2841台開","110/07/26","元大-台中中港",0,19,-19
"13159","2841台開","110/07/26","新光-台中",15,0,15
"13160","2841台開","110/07/26","臺銀-臺南",0,18,-18
"13161","2841台開","110/07/26","群益金鼎-東門",11,0,11
"13162","2841台開","110/07/26","永豐金-敦南",3,19,-16
"13163","2841台開","110/07/26","華南永昌-內壢",11,0,11
"13164","2841台開","110/07/26","統一-桃園",0,13,-13
"13165","2841台開","110/07/26","元富-烏日",10,0,10
"13166","2841台開","110/07/26","國泰-台中",0,11,-11
"13167","2841台開","110/07/26","國泰-忠孝",10,2,8
"13168","2841台開","110/07/26","元大-福營",0,11,-11
"13169","2841台開","110/07/26","元大-潮州",6,0,6
"13170","2841台開","110/07/26","凱基-站前",0,10,-10
"13171","6207雷科","110/07/26","元大-向上",70,0,70
"13172","6207雷科","110/07/26","摩根大通",45,241,-196
"13173","6207雷科","110/07/26","國票-中和",67,5,62
"13174","6207雷科","110/07/26","華南永昌-台中",16,180,-164
"13175","6207雷科","110/07/26","永豐金-台南",63,2,61
"13176","6207雷科","110/07/26","瑞士信貸",4,69,-65
"13177","6207雷科","110/07/26","國泰-板橋",32,0,32
"13178","6207雷科","110/07/26","國票-天祥",11,76,-65
"13179","6207雷科","110/07/26","華南永昌-朴子",24,0,24
"13180","6207雷科","110/07/26","新加坡商瑞銀",15,78,-63
"13181","6207雷科","110/07/26","台新證券",35,12,23
"13182","6207雷科","110/07/26","凱基-台北",86,134,-48
"13183","6207雷科","110/07/26","永豐金-板盛",24,1,23
"13184","6207雷科","110/07/26","富邦-台中",58,100,-42
"13185","6207雷科","110/07/26","康和-台中",24,2,22
"13186","6207雷科","110/07/26","兆豐-大安",0,41,-41
"13187","6207雷科","110/07/26","台新-台南",22,2,20
"13188","6207雷科","110/07/26","群益金鼎-館前",0,40,-40
"13189","6207雷科","110/07/26","元大-大統",22,2,20
"13190","6207雷科","110/07/26","富邦-羅東",2,39,-37
"13191","6207雷科","110/07/26","元富-桃園",19,0,19
"13192","6207雷科","110/07/26","國票-台東",0,30,-30
"13193","6207雷科","110/07/26","高橋",17,0,17
"13194","6207雷科","110/07/26","凱基-士林",1,30,-29
"13195","6207雷科","110/07/26","元富-同大",30,13,17
"13196","6207雷科","110/07/26","元大-南京",3,31,-28
"13197","6207雷科","110/07/26","元大-內湖",17,0,17
"13198","6207雷科","110/07/26","宏遠-桃園",0,24,-24
"13199","6207雷科","110/07/26","永豐金-內湖",19,2,17
"13200","6207雷科","110/07/26","國票-和平",0,23,-23
"13201","3679新至陞","110/07/26","元富-板橋",16,0,16
"13202","3679新至陞","110/07/26","台新-台中",0,19,-19
"13203","3679新至陞","110/07/26","華南永昌-淡水",10,0,10
"13204","3679新至陞","110/07/26","元大-成功",0,10,-10
"13205","3679新至陞","110/07/26","光和-溪湖",8,0,8
"13206","3679新至陞","110/07/26","日進",0,9,-9
"13207","3679新至陞","110/07/26","宏遠-光隆",6,0,6
"13208","3679新至陞","110/07/26","臺銀-臺中",0,5,-5
"13209","3679新至陞","110/07/26","玉山-嘉義",5,0,5
"13210","3679新至陞","110/07/26","港商法國興業",0,4,-4
"13211","3679新至陞","110/07/26","元富-安南",3,0,3
"13212","3679新至陞","110/07/26","統一-新台中",0,3,-3
"13213","3679新至陞","110/07/26","摩根大通",4,1,3
"13214","3679新至陞","110/07/26","大慶-苗栗",1,3,-2
"13215","3679新至陞","110/07/26","凱基-台北",5,2,3
"13216","3679新至陞","110/07/26","元富-松德",0,2,-2
"13217","3679新至陞","110/07/26","凱基-站前",2,0,2
"13218","3679新至陞","110/07/26","富邦-仁愛",0,2,-2
"13219","3679新至陞","110/07/26","華南永昌",2,0,2
"13220","3679新至陞","110/07/26","元大-文心興安",0,2,-2
"13221","3679新至陞","110/07/26","元大-上新莊",2,0,2
"13222","3679新至陞","110/07/26","永豐金證券",0,2,-2
"13223","3679新至陞","110/07/26","美林",4,3,1
"13224","3679新至陞","110/07/26","臺銀-高雄",0,1,-1
"13225","3679新至陞","110/07/26","台灣摩根士丹利",2,1,1
"13226","3679新至陞","110/07/26","台灣企銀-屏東",0,1,-1
"13227","3679新至陞","110/07/26","美商高盛",1,0,1
"13228","3679新至陞","110/07/26","大慶-富順",0,1,-1
"13229","3679新至陞","110/07/26","富邦-台北",1,0,1
"13230","3679新至陞","110/07/26","統一-彰化",0,1,-1
"13231","2727王品","110/07/26","兆豐-南京",300,0,300
"13232","2727王品","110/07/26","元富-安南",0,62,-62
"13233","2727王品","110/07/26","凱基-台北",74,29,45
"13234","2727王品","110/07/26","瑞士信貸",0,44,-44
"13235","2727王品","110/07/26","富邦-建國",25,2,23
"13236","2727王品","110/07/26","新加坡商瑞銀",0,44,-44
"13237","2727王品","110/07/26","台灣摩根士丹利",22,0,22
"13238","2727王品","110/07/26","統一",11,54,-43
"13239","2727王品","110/07/26","永豐金-屏東",14,1,13
"13240","2727王品","110/07/26","美林",4,39,-35
"13241","2727王品","110/07/26","富邦-桃園",12,1,11
"13242","2727王品","110/07/26","第一金",0,30,-30
"13243","2727王品","110/07/26","日盛-鳳山",11,1,10
"13244","2727王品","110/07/26","康和-台中",0,30,-30
"13245","2727王品","110/07/26","元富-城中",10,0,10
"13246","2727王品","110/07/26","國泰證券",1,31,-30
"13247","2727王品","110/07/26","元大-龍潭",11,1,10
"13248","2727王品","110/07/26","元大證券",37,67,-30
"13249","2727王品","110/07/26","新光-台中",15,6,9
"13250","2727王品","110/07/26","康和",1,29,-28
"13251","2727王品","110/07/26","富邦-台中",10,1,9
"13252","2727王品","110/07/26","永豐金證券",0,27,-27
"13253","2727王品","110/07/26","元大-基隆孝二",10,1,9
"13254","2727王品","110/07/26","安泰",1,26,-25
"13255","2727王品","110/07/26","臺銀-臺中",10,2,8
"13256","2727王品","110/07/26","永豐金-古亭",2,20,-18
"13257","2727王品","110/07/26","元大-花蓮",8,0,8
"13258","2727王品","110/07/26","國票-天祥",0,16,-16
"13259","2727王品","110/07/26","元大-斗信",9,1,8
"13260","2727王品","110/07/26","摩根大通",17,33,-16
"13261","1570力肯","110/07/26","元大-民雄",10,0,10
"13262","1570力肯","110/07/26","元大-高雄",0,33,-33
"13263","1570力肯","110/07/26","新光-台中",10,1,9
"13264","1570力肯","110/07/26","日盛-宜蘭",0,8,-8
"13265","1570力肯","110/07/26","富邦-陽明",9,0,9
"13266","1570力肯","110/07/26","美林",0,5,-5
"13267","1570力肯","110/07/26","大慶-蘆洲",8,0,8
"13268","1570力肯","110/07/26","凱基-永康",0,5,-5
"13269","1570力肯","110/07/26","福勝",8,0,8
"13270","1570力肯","110/07/26","台新證券",0,4,-4
"13271","1570力肯","110/07/26","凱基-桃園",7,0,7
"13272","1570力肯","110/07/26","元大-汐止",0,4,-4
"13273","1570力肯","110/07/26","中國信託-永康",3,0,3
"13274","1570力肯","110/07/26","元大-桃興",0,3,-3
"13275","1570力肯","110/07/26","兆豐-台中港",3,0,3
"13276","1570力肯","110/07/26","元富-吉利",0,2,-2
"13277","1570力肯","110/07/26","國票-北高雄",3,0,3
"13278","1570力肯","110/07/26","國泰-板橋",0,2,-2
"13279","1570力肯","110/07/26","富邦-員林",3,0,3
"13280","1570力肯","110/07/26","元大-台中",0,2,-2
"13281","1570力肯","110/07/26","瑞士信貸",2,0,2
"13282","1570力肯","110/07/26","元大-西螺",0,2,-2
"13283","1570力肯","110/07/26","大昌-樹林",2,0,2
"13284","1570力肯","110/07/26","元大-苑裡",0,2,-2
"13285","1570力肯","110/07/26","兆豐-忠孝",2,0,2
"13286","1570力肯","110/07/26","合庫-三重",0,1,-1
"13287","1570力肯","110/07/26","新光",2,0,2
"13288","1570力肯","110/07/26","臺銀-臺南",0,1,-1
"13289","1570力肯","110/07/26","凱基-台北",2,0,2
"13290","1570力肯","110/07/26","元富-永和",0,1,-1
"13291","6180橘子","110/07/26","凱基-台北",121,1,120
"13292","6180橘子","110/07/26","元大-竹山",0,35,-35
"13293","6180橘子","110/07/26","新加坡商瑞銀",71,2,69
"13294","6180橘子","110/07/26","元大-和平",0,30,-30
"13295","6180橘子","110/07/26","摩根大通",70,4,66
"13296","6180橘子","110/07/26","元大-草屯",3,27,-24
"13297","6180橘子","110/07/26","美林",33,0,33
"13298","6180橘子","110/07/26","華南永昌-高雄",0,21,-21
"13299","6180橘子","110/07/26","台灣摩根士丹利",20,4,16
"13300","6180橘子","110/07/26","兆豐-埔墘",0,18,-18
"13301","6180橘子","110/07/26","合庫-高雄",11,0,11
"13302","6180橘子","110/07/26","元富-林園",0,17,-17
"13303","6180橘子","110/07/26","港商野村",10,0,10
"13304","6180橘子","110/07/26","元富-成功",0,16,-16
"13305","6180橘子","110/07/26","富邦-宜蘭",10,0,10
"13306","6180橘子","110/07/26","群益金鼎-台南",0,13,-13
"13307","6180橘子","110/07/26","統一-彰化",10,1,9
"13308","6180橘子","110/07/26","元大-開元",0,13,-13
"13309","6180橘子","110/07/26","兆豐-北高雄",9,1,8
"13310","6180橘子","110/07/26","富邦-台中",0,12,-12
"13311","6180橘子","110/07/26","元大-新店中正",10,2,8
"13312","6180橘子","110/07/26","(牛牛牛)亞-鑫豐",1,12,-11
"13313","6180橘子","110/07/26","國泰-敦南",10,3,7
"13314","6180橘子","110/07/26","台新-台南",0,11,-11
"13315","6180橘子","110/07/26","合庫-自強",5,0,5
"13316","6180橘子","110/07/26","聯邦-興中",0,11,-11
"13317","6180橘子","110/07/26","大慶-蘆洲",5,0,5
"13318","6180橘子","110/07/26","日盛-中和",0,10,-10
"13319","6180橘子","110/07/26","統一-中壢",5,0,5
"13320","6180橘子","110/07/26","康和-台北",0,10,-10
"13321","2390云辰","110/07/26","元大-大同",311,3,308
"13322","2390云辰","110/07/26","摩根大通",139,570,-431
"13323","2390云辰","110/07/26","華南永昌-鳳山",276,4,272
"13324","2390云辰","110/07/26","美林",103,243,-140
"13325","2390云辰","110/07/26","永豐金-竹北",201,6,195
"13326","2390云辰","110/07/26","元大-彰化民生",0,117,-117
"13327","2390云辰","110/07/26","富邦-左營",107,17,90
"13328","2390云辰","110/07/26","元富-中港",0,102,-102
"13329","2390云辰","110/07/26","元富-高雄",82,5,77
"13330","2390云辰","110/07/26","凱基-台北",161,249,-88
"13331","2390云辰","110/07/26","元大-太平",75,10,65
"13332","2390云辰","110/07/26","國票-新莊",15,78,-63
"13333","2390云辰","110/07/26","元大-大益",63,13,50
"13334","2390云辰","110/07/26","第一金-豐原",1,59,-58
"13335","2390云辰","110/07/26","元富-新竹",41,1,40
"13336","2390云辰","110/07/26","統一-竹南",5,48,-43
"13337","2390云辰","110/07/26","日盛-永康",42,4,38
"13338","2390云辰","110/07/26","第一金-台南",28,62,-34
"13339","2390云辰","110/07/26","群益金鼎-中壢",50,12,38
"13340","2390云辰","110/07/26","台灣摩根士丹利",38,70,-32
"13341","2390云辰","110/07/26","元大-鑫永和",54,18,36
"13342","2390云辰","110/07/26","群益金鼎-士林",20,52,-32
"13343","2390云辰","110/07/26","元富-同大",34,1,33
"13344","2390云辰","110/07/26","群益金鼎-延平",2,31,-29
"13345","2390云辰","110/07/26","致和-崇德",52,21,31
"13346","2390云辰","110/07/26","凱基-豐中",12,40,-28
"13347","2390云辰","110/07/26","永豐金-松山",32,2,30
"13348","2390云辰","110/07/26","富邦-中壢",19,47,-28
"13349","2390云辰","110/07/26","凱基-三重",36,8,28
"13350","2390云辰","110/07/26","統一-基隆",2,27,-25
"13351","2363矽統","110/07/20","第一金-忠孝",400,115,285
"13352","2363矽統","110/07/20","國票-長城",3,452,-449
"13353","2363矽統","110/07/20","第一金-高雄",188,0,188
"13354","2363矽統","110/07/20","美林",158,531,-373
"13355","2363矽統","110/07/20","凱基-高美館",199,14,185
"13356","2363矽統","110/07/20","台新-左楠",13,310,-297
"13357","2363矽統","110/07/20","凱基-台北",434,326,108
"13358","2363矽統","110/07/20","玉山-台大",4,228,-224
"13359","2363矽統","110/07/20","元富-松德",105,0,105
"13360","2363矽統","110/07/20","群益金鼎-大甲",11,227,-216
"13361","2363矽統","110/07/20","元大-竹科",109,7,102
"13362","2363矽統","110/07/20","群益金鼎-中港",2,111,-109
"13363","2363矽統","110/07/20","元大-成功",102,2,100
"13364","2363矽統","110/07/20","元大-大天母",0,109,-109
"13365","2363矽統","110/07/20","富邦-仁愛",116,17,99
"13366","2363矽統","110/07/20","國泰-敦南",114,218,-104
"13367","2363矽統","110/07/20","元大-上新莊",102,16,86
"13368","2363矽統","110/07/20","港商野村",250,350,-100
"13369","2363矽統","110/07/20","台新證券",286,208,78
"13370","2363矽統","110/07/20","康和-澎湖",0,90,-90
"13371","2363矽統","110/07/20","元大-新營",81,9,72
"13372","2363矽統","110/07/20","凱基-中壢",15,99,-84
"13373","2363矽統","110/07/20","華南永昌-鳳山",76,5,71
"13374","2363矽統","110/07/20","元大-學甲",0,81,-81
"13375","2363矽統","110/07/20","富邦-員林",65,2,63
"13376","2363矽統","110/07/20","凱基-三重",22,91,-69
"13377","2363矽統","110/07/20","元富-成功",67,6,61
"13378","2363矽統","110/07/20","永豐金-嘉義",24,92,-68
"13379","2363矽統","110/07/20","新光-新竹",62,1,61
"13380","2363矽統","110/07/20","大慶-蘆洲",23,89,-66
"13381","8112至上","110/07/20","摩根大通",1226,293,933
"13382","8112至上","110/07/20","凱基-三重",27,502,-475
"13383","8112至上","110/07/20","新加坡商瑞銀",358,83,275
"13384","8112至上","110/07/20","宏遠證券",0,418,-418
"13385","8112至上","110/07/20","台灣摩根士丹利",159,9,150
"13386","8112至上","110/07/20","台新-台中",11,291,-280
"13387","8112至上","110/07/20","統一-新竹",115,5,110
"13388","8112至上","110/07/20","美林",44,194,-150
"13389","8112至上","110/07/20","新光",233,126,107
"13390","8112至上","110/07/20","凱基-新莊",0,100,-100
"13391","8112至上","110/07/20","凱基-台北",367,260,107
"13392","8112至上","110/07/20","富邦-永和",14,104,-90
"13393","8112至上","110/07/20","兆豐-西螺",104,10,94
"13394","8112至上","110/07/20","國票-敦北法人",4,88,-84
"13395","8112至上","110/07/20","永豐金-中正",87,6,81
"13396","8112至上","110/07/20","凱基-市政",3,80,-77
"13397","8112至上","110/07/20","富邦-新店",102,24,78
"13398","8112至上","110/07/20","台新證券",68,142,-74
"13399","8112至上","110/07/20","元大-大同",83,5,78
"13400","8112至上","110/07/20","永豐金-中壢",11,80,-69
"13401","8112至上","110/07/20","富邦-園區",64,2,62
"13402","8112至上","110/07/20","永豐金-台南",22,91,-69
"13403","8112至上","110/07/20","新光-台南",73,14,59
"13404","8112至上","110/07/20","元大-大雅",22,87,-65
"13405","8112至上","110/07/20","統一-台中",60,2,58
"13406","8112至上","110/07/20","光和",10,67,-57
"13407","8112至上","110/07/20","元大-北成功",58,4,54
"13408","8112至上","110/07/20","元大-竹科",27,74,-47
"13409","8112至上","110/07/20","元富-林園",53,0,53
"13410","8112至上","110/07/20","兆豐-公益",1,47,-46
"13411","1570力肯","110/07/20","國票-北高雄",36,0,36
"13412","1570力肯","110/07/20","國泰-敦南",0,19,-19
"13413","1570力肯","110/07/20","群益金鼎-高雄",16,0,16
"13414","1570力肯","110/07/20","中國信託-永康",0,12,-12
"13415","1570力肯","110/07/20","臺銀-鳳山",10,0,10
"13416","1570力肯","110/07/20","第一金-路竹",0,10,-10
"13417","1570力肯","110/07/20","群益金鼎-新竹",6,0,6
"13418","1570力肯","110/07/20","福勝",0,10,-10
"13419","1570力肯","110/07/20","大昌-樹林",5,0,5
"13420","1570力肯","110/07/20","群益金鼎-板橋",0,10,-10
"13421","1570力肯","110/07/20","華南永昌-楠梓",5,0,5
"13422","1570力肯","110/07/20","日盛-鳳山",0,8,-8
"13423","1570力肯","110/07/20","元大-基隆孝二",5,0,5
"13424","1570力肯","110/07/20","永豐金-新竹",6,14,-8
"13425","1570力肯","110/07/20","元大-新竹經國",4,0,4
"13426","1570力肯","110/07/20","第一金-彰化",0,7,-7
"13427","1570力肯","110/07/20","土銀-高雄",2,0,2
"13428","1570力肯","110/07/20","元富-吉利",0,7,-7
"13429","1570力肯","110/07/20","台灣企銀-太平",2,0,2
"13430","1570力肯","110/07/20","台中銀-員林",0,7,-7
"13431","1570力肯","110/07/20","兆豐-忠孝",2,0,2
"13432","1570力肯","110/07/20","玉山證券",1,8,-7
"13433","1570力肯","110/07/20","玉山-城中",2,0,2
"13434","1570力肯","110/07/20","統一-三重",0,5,-5
"13435","1570力肯","110/07/20","國泰-板橋",2,0,2
"13436","1570力肯","110/07/20","光和-溪湖",0,3,-3
"13437","1570力肯","110/07/20","凱基-台北",2,0,2
"13438","1570力肯","110/07/20","康和-澎湖",0,3,-3
"13439","1570力肯","110/07/20","華南永昌-高雄",2,0,2
"13440","1570力肯","110/07/20","摩根大通",0,2,-2
"13441","2929淘帝","110/07/20","玉山-新竹",59,0,59
"13442","2929淘帝","110/07/20","臺銀",0,45,-45
"13443","2929淘帝","110/07/20","兆豐-新莊",50,0,50
"13444","2929淘帝","110/07/20","光和-嘉義",0,29,-29
"13445","2929淘帝","110/07/20","元大-大甲",30,0,30
"13446","2929淘帝","110/07/20","新加坡商瑞銀",27,55,-28
"13447","2929淘帝","110/07/20","元大-民生",29,0,29
"13448","2929淘帝","110/07/20","華南永昌-潮州",0,20,-20
"13449","2929淘帝","110/07/20","元大-員林",20,0,20
"13450","2929淘帝","110/07/20","玉山-高雄",0,14,-14
"13451","2929淘帝","110/07/20","元富-台南",18,0,18
"13452","2929淘帝","110/07/20","富邦-南屯",2,13,-11
"13453","2929淘帝","110/07/20","港商野村",63,50,13
"13454","2929淘帝","110/07/20","高橋-龍潭",0,10,-10
"13455","2929淘帝","110/07/20","高橋",10,0,10
"13456","2929淘帝","110/07/20","台新-建北",0,10,-10
"13457","2929淘帝","110/07/20","元富-林園",10,0,10
"13458","2929淘帝","110/07/20","群益金鼎-台中",0,10,-10
"13459","2929淘帝","110/07/20","玉山-台南",10,0,10
"13460","2929淘帝","110/07/20","華南永昌-苗栗",0,10,-10
"13461","2929淘帝","110/07/20","群益金鼎-士林",10,0,10
"13462","2929淘帝","110/07/20","群益金鼎-西松",0,9,-9
"13463","2929淘帝","110/07/20","凱基-台北",16,6,10
"13464","2929淘帝","110/07/20","台新-三民",0,8,-8
"13465","2929淘帝","110/07/20","合庫證券",9,0,9
"13466","2929淘帝","110/07/20","群益金鼎",0,8,-8
"13467","2929淘帝","110/07/20","永豐金證券",9,2,7
"13468","2929淘帝","110/07/20","富邦-永和",0,7,-7
"13469","2929淘帝","110/07/20","凱基-基隆",6,0,6
"13470","2929淘帝","110/07/20","國泰-台中",6,12,-6
"13471","5410國眾","110/07/20","日盛-內湖",27,0,27
"13472","5410國眾","110/07/20","永豐金-內湖",0,23,-23
"13473","5410國眾","110/07/20","富邦-新營",20,0,20
"13474","5410國眾","110/07/20","兆豐-台中港",0,20,-20
"13475","5410國眾","110/07/20","大昌",17,0,17
"13476","5410國眾","110/07/20","元富-嘉義",0,15,-15
"13477","5410國眾","110/07/20","永豐金-台南",17,0,17
"13478","5410國眾","110/07/20","元富-吉利",0,11,-11
"13479","5410國眾","110/07/20","凱基-站前",15,0,15
"13480","5410國眾","110/07/20","凱基-長庚",0,10,-10
"13481","5410國眾","110/07/20","凱基-竹北",11,0,11
"13482","5410國眾","110/07/20","元大-八德",0,10,-10
"13483","5410國眾","110/07/20","元富-民權",9,0,9
"13484","5410國眾","110/07/20","元大-天母",0,10,-10
"13485","5410國眾","110/07/20","群益金鼎-嘉義",6,0,6
"13486","5410國眾","110/07/20","國泰-桃園",0,9,-9
"13487","5410國眾","110/07/20","元大-土城學府",6,0,6
"13488","5410國眾","110/07/20","新光",5,12,-7
"13489","5410國眾","110/07/20","第一金-豐原",5,0,5
"13490","5410國眾","110/07/20","玉山-桃園",0,7,-7
"13491","5410國眾","110/07/20","華南永昌-林口",5,0,5
"13492","5410國眾","110/07/20","玉山-雙和",0,6,-6
"13493","5410國眾","110/07/20","元大-博愛",5,0,5
"13494","5410國眾","110/07/20","臺銀-臺南",0,5,-5
"13495","5410國眾","110/07/20","元大-竹南",5,0,5
"13496","5410國眾","110/07/20","彰銀-七賢",0,5,-5
"13497","5410國眾","110/07/20","元大-新店中正",5,0,5
"13498","5410國眾","110/07/20","宏遠證券",0,5,-5
"13499","5410國眾","110/07/20","元富-烏日",4,0,4
"13500","5410國眾","110/07/20","摩根大通",0,5,-5
"13501","2841台開","110/07/20","中國信託-忠孝",145,0,145
"13502","2841台開","110/07/20","凱基-松山",0,100,-100
"13503","2841台開","110/07/20","第一金-台中",68,0,68
"13504","2841台開","110/07/20","第一金-自由",0,33,-33
"13505","2841台開","110/07/20","美商高盛",37,0,37
"13506","2841台開","110/07/20","港商野村",0,29,-29
"13507","2841台開","110/07/20","台中銀",32,0,32
"13508","2841台開","110/07/20","國泰-敦南",11,31,-20
"13509","2841台開","110/07/20","台新-台中",20,0,20
"13510","2841台開","110/07/20","華南永昌-台中",0,20,-20
"13511","2841台開","110/07/20","凱基-東港",10,0,10
"13512","2841台開","110/07/20","元大-發財",0,15,-15
"13513","2841台開","110/07/20","大昌-安康",10,3,7
"13514","2841台開","110/07/20","元大-福營",9,23,-14
"13515","2841台開","110/07/20","豐農",7,0,7
"13516","2841台開","110/07/20","永豐金-敦南",5,18,-13
"13517","2841台開","110/07/20","元大-歸仁",7,0,7
"13518","2841台開","110/07/20","統一-城中",0,11,-11
"13519","2841台開","110/07/20","日盛-木柵",5,0,5
"13520","2841台開","110/07/20","日盛-台南",0,10,-10
"13521","2841台開","110/07/20","台新-台南",4,0,4
"13522","2841台開","110/07/20","兆豐-寶成",0,10,-10
"13523","2841台開","110/07/20","日盛證券",3,0,3
"13524","2841台開","110/07/20","國票-中港",0,10,-10
"13525","2841台開","110/07/20","台新證券",8,5,3
"13526","2841台開","110/07/20","群益金鼎",0,10,-10
"13527","2841台開","110/07/20","元大-沙鹿",3,0,3
"13528","2841台開","110/07/20","玉山證券",1,10,-9
"13529","2841台開","110/07/20","國泰-台中",2,0,2
"13530","2841台開","110/07/20","大昌-新店",0,6,-6
"13531","6207雷科","110/07/20","元大-西門",100,4,96
"13532","6207雷科","110/07/20","永豐金-內湖",0,109,-109
"13533","6207雷科","110/07/20","凱基-復興",50,0,50
"13534","6207雷科","110/07/20","國泰證券",0,90,-90
"13535","6207雷科","110/07/20","凱基-台北",47,1,46
"13536","6207雷科","110/07/20","元大-頭份",0,55,-55
"13537","6207雷科","110/07/20","玉山-城中",43,1,42
"13538","6207雷科","110/07/20","永豐金-虎尾",0,50,-50
"13539","6207雷科","110/07/20","華南永昌-長虹",44,5,39
"13540","6207雷科","110/07/20","元富-世貿",0,33,-33
"13541","6207雷科","110/07/20","凱基-板橋",38,1,37
"13542","6207雷科","110/07/20","元大-南崁",0,22,-22
"13543","6207雷科","110/07/20","元富-信義",39,3,36
"13544","6207雷科","110/07/20","永豐金-鳳山",0,21,-21
"13545","6207雷科","110/07/20","元富-彰化",35,0,35
"13546","6207雷科","110/07/20","永豐金-三重",6,27,-21
"13547","6207雷科","110/07/20","凱基-高美館",34,0,34
"13548","6207雷科","110/07/20","第一金-澎湖",0,20,-20
"13549","6207雷科","110/07/20","富邦-中壢",26,2,24
"13550","6207雷科","110/07/20","群益金鼎-東大",0,20,-20
"13551","6207雷科","110/07/20","大昌-桃園",23,0,23
"13552","6207雷科","110/07/20","兆豐-民生",0,19,-19
"13553","6207雷科","110/07/20","元大-四維",39,17,22
"13554","6207雷科","110/07/20","元大-北成功",1,20,-19
"13555","6207雷科","110/07/20","台灣摩根士丹利",18,0,18
"13556","6207雷科","110/07/20","元大-虎尾",1,18,-17
"13557","6207雷科","110/07/20","國票-中和",16,0,16
"13558","6207雷科","110/07/20","元大-文心興安",0,15,-15
"13559","6207雷科","110/07/20","永豐金-大園",16,0,16
"13560","6207雷科","110/07/20","瑞士信貸",0,14,-14
"13561","3679新至陞","110/07/20","國票-敦北法人",18,0,18
"13562","3679新至陞","110/07/20","華南永昌-台中",0,32,-32
"13563","3679新至陞","110/07/20","台中銀-員林",17,3,14
"13564","3679新至陞","110/07/20","凱基-台北",12,32,-20
"13565","3679新至陞","110/07/20","群益金鼎-高盛",13,0,13
"13566","3679新至陞","110/07/20","摩根大通",2,14,-12
"13567","3679新至陞","110/07/20","康和-澎湖",8,0,8
"13568","3679新至陞","110/07/20","國泰-桃園",0,11,-11
"13569","3679新至陞","110/07/20","台新證券",6,0,6
"13570","3679新至陞","110/07/20","群益金鼎-台南",0,10,-10
"13571","3679新至陞","110/07/20","宏遠-光隆",4,0,4
"13572","3679新至陞","110/07/20","群益金鼎-大安",0,10,-10
"13573","3679新至陞","110/07/20","玉山-大里",4,0,4
"13574","3679新至陞","110/07/20","永豐金證券",4,14,-10
"13575","3679新至陞","110/07/20","台中銀-豐原",3,0,3
"13576","3679新至陞","110/07/20","兆豐-大同",1,6,-5
"13577","3679新至陞","110/07/20","玉山-新莊",3,0,3
"13578","3679新至陞","110/07/20","群益金鼎-館前",0,4,-4
"13579","3679新至陞","110/07/20","凱基-中山",3,0,3
"13580","3679新至陞","110/07/20","富邦-南屯",0,4,-4
"13581","3679新至陞","110/07/20","富邦-台北",3,0,3
"13582","3679新至陞","110/07/20","瑞士信貸",3,6,-3
"13583","3679新至陞","110/07/20","元大-板橋",3,0,3
"13584","3679新至陞","110/07/20","國泰-板橋",0,3,-3
"13585","3679新至陞","110/07/20","日盛-八德",2,0,2
"13586","3679新至陞","110/07/20","富邦-中壢",1,4,-3
"13587","3679新至陞","110/07/20","日盛-復興",2,0,2
"13588","3679新至陞","110/07/20","台灣企銀",0,2,-2
"13589","3679新至陞","110/07/20","康和-板橋",2,0,2
"13590","3679新至陞","110/07/20","日盛-大墩",0,2,-2
"13591","2727王品","110/07/20","兆豐-南京",200,0,200
"13592","2727王品","110/07/20","凱基-市政",1,75,-74
"13593","2727王品","110/07/20","富邦證券",88,0,88
"13594","2727王品","110/07/20","美商高盛",6,38,-32
"13595","2727王品","110/07/20","台新證券",142,55,87
"13596","2727王品","110/07/20","富邦-陽明",7,38,-31
"13597","2727王品","110/07/20","瑞士信貸",50,0,50
"13598","2727王品","110/07/20","永豐金-中正",3,34,-31
"13599","2727王品","110/07/20","港商野村",106,57,49
"13600","2727王品","110/07/20","永豐金-潮州",0,31,-31
"13601","2727王品","110/07/20","凱基-台北",67,27,40
"13602","2727王品","110/07/20","兆豐-大安",0,30,-30
"13603","2727王品","110/07/20","永豐金-大園",29,2,27
"13604","2727王品","110/07/20","摩根大通",50,73,-23
"13605","2727王品","110/07/20","康和-高雄",20,0,20
"13606","2727王品","110/07/20","日盛證券",4,24,-20
"13607","2727王品","110/07/20","第一金-高雄",20,3,17
"13608","2727王品","110/07/20","凱基-大里",0,20,-20
"13609","2727王品","110/07/20","富邦-板橋",21,4,17
"13610","2727王品","110/07/20","群益金鼎-大甲",0,18,-18
"13611","2727王品","110/07/20","永豐金-桃盛",15,0,15
"13612","2727王品","110/07/20","統一",18,29,-11
"13613","2727王品","110/07/20","凱基",13,0,13
"13614","2727王品","110/07/20","國泰-台中",12,23,-11
"13615","2727王品","110/07/20","新加坡商瑞銀",23,11,12
"13616","2727王品","110/07/20","元大-彰化",0,11,-11
"13617","2727王品","110/07/20","亞東",10,0,10
"13618","2727王品","110/07/20","國泰-館前",4,14,-10
"13619","2727王品","110/07/20","康和-台中",13,4,9
"13620","2727王品","110/07/20","元大-學甲",0,10,-10
"13621","1570力肯","110/07/20","國票-北高雄",36,0,36
"13622","1570力肯","110/07/20","國泰-敦南",0,19,-19
"13623","1570力肯","110/07/20","群益金鼎-高雄",16,0,16
"13624","1570力肯","110/07/20","中國信託-永康",0,12,-12
"13625","1570力肯","110/07/20","臺銀-鳳山",10,0,10
"13626","1570力肯","110/07/20","第一金-路竹",0,10,-10
"13627","1570力肯","110/07/20","群益金鼎-新竹",6,0,6
"13628","1570力肯","110/07/20","福勝",0,10,-10
"13629","1570力肯","110/07/20","大昌-樹林",5,0,5
"13630","1570力肯","110/07/20","群益金鼎-板橋",0,10,-10
"13631","1570力肯","110/07/20","華南永昌-楠梓",5,0,5
"13632","1570力肯","110/07/20","日盛-鳳山",0,8,-8
"13633","1570力肯","110/07/20","元大-基隆孝二",5,0,5
"13634","1570力肯","110/07/20","永豐金-新竹",6,14,-8
"13635","1570力肯","110/07/20","元大-新竹經國",4,0,4
"13636","1570力肯","110/07/20","第一金-彰化",0,7,-7
"13637","1570力肯","110/07/20","土銀-高雄",2,0,2
"13638","1570力肯","110/07/20","元富-吉利",0,7,-7
"13639","1570力肯","110/07/20","台灣企銀-太平",2,0,2
"13640","1570力肯","110/07/20","台中銀-員林",0,7,-7
"13641","1570力肯","110/07/20","兆豐-忠孝",2,0,2
"13642","1570力肯","110/07/20","玉山證券",1,8,-7
"13643","1570力肯","110/07/20","玉山-城中",2,0,2
"13644","1570力肯","110/07/20","統一-三重",0,5,-5
"13645","1570力肯","110/07/20","國泰-板橋",2,0,2
"13646","1570力肯","110/07/20","光和-溪湖",0,3,-3
"13647","1570力肯","110/07/20","凱基-台北",2,0,2
"13648","1570力肯","110/07/20","康和-澎湖",0,3,-3
"13649","1570力肯","110/07/20","華南永昌-高雄",2,0,2
"13650","1570力肯","110/07/20","摩根大通",0,2,-2
"13651","6180橘子","110/07/20","摩根大通",89,31,58
"13652","6180橘子","110/07/20","群益金鼎-中山",0,80,-80
"13653","6180橘子","110/07/20","美商高盛",27,0,27
"13654","6180橘子","110/07/20","台中銀-台北",0,30,-30
"13655","6180橘子","110/07/20","新加坡商瑞銀",28,1,27
"13656","6180橘子","110/07/20","日盛-新莊",1,22,-21
"13657","6180橘子","110/07/20","新光",41,16,25
"13658","6180橘子","110/07/20","元富-緯城",2,20,-18
"13659","6180橘子","110/07/20","日盛-文化",21,0,21
"13660","6180橘子","110/07/20","日盛-新竹",2,15,-13
"13661","6180橘子","110/07/20","元富-潮州",20,0,20
"13662","6180橘子","110/07/20","元大-汐止",0,12,-12
"13663","6180橘子","110/07/20","凱基-台北",31,11,20
"13664","6180橘子","110/07/20","元大-豐原站前",0,12,-12
"13665","6180橘子","110/07/20","元大-草屯",18,0,18
"13666","6180橘子","110/07/20","德信-中正",0,10,-10
"13667","6180橘子","110/07/20","花旗環球",13,0,13
"13668","6180橘子","110/07/20","新光-台南",0,10,-10
"13669","6180橘子","110/07/20","元大-桃園",12,0,12
"13670","6180橘子","110/07/20","玉山-雙和",0,10,-10
"13671","6180橘子","110/07/20","群益金鼎",10,0,10
"13672","6180橘子","110/07/20","元大-四維",0,10,-10
"13673","6180橘子","110/07/20","元大-高雄",10,0,10
"13674","6180橘子","110/07/20","元大-永春",2,12,-10
"13675","6180橘子","110/07/20","群益金鼎-嘉義",9,0,9
"13676","6180橘子","110/07/20","凱基-高美館",0,8,-8
"13677","6180橘子","110/07/20","富邦-嘉義",9,0,9
"13678","6180橘子","110/07/20","華南永昌",2,10,-8
"13679","6180橘子","110/07/20","元富-草屯",10,2,8
"13680","6180橘子","110/07/20","富邦-台北",0,8,-8
"13681","2390云辰","110/07/20","元大證券",6043,11,6032
"13682","2390云辰","110/07/20","華南永昌-鳳山",2,312,-310
"13683","2390云辰","110/07/20","兆豐-復興",998,0,998
"13684","2390云辰","110/07/20","台灣摩根士丹利",0,247,-247
"13685","2390云辰","110/07/20","富邦-嘉義",775,7,768
"13686","2390云辰","110/07/20","元大-復北",4,239,-235
"13687","2390云辰","110/07/20","統一-台中",350,6,344
"13688","2390云辰","110/07/20","富邦-建國",25,236,-211
"13689","2390云辰","110/07/20","兆豐-城中",240,0,240
"13690","2390云辰","110/07/20","元富-中港",0,202,-202
"13691","2390云辰","110/07/20","群益金鼎-館前",204,2,202
"13692","2390云辰","110/07/20","國泰-敦南",20,194,-174
"13693","2390云辰","110/07/20","凱基-大直",187,0,187
"13694","2390云辰","110/07/20","元大-土城學府",10,156,-146
"13695","2390云辰","110/07/20","永豐金證券",160,10,150
"13696","2390云辰","110/07/20","中國信託-松江",0,130,-130
"13697","2390云辰","110/07/20","日盛-高雄",104,2,102
"13698","2390云辰","110/07/20","凱基-基隆",0,130,-130
"13699","2390云辰","110/07/20","凱基-中山",100,3,97
"13700","2390云辰","110/07/20","永豐金-中正",1,117,-116
"13701","2390云辰","110/07/20","元大-基隆",85,7,78
"13702","2390云辰","110/07/20","富邦-陽明",1,94,-93
"13703","2390云辰","110/07/20","群益金鼎-東大",64,2,62
"13704","2390云辰","110/07/20","元大-潮州",20,112,-92
"13705","2390云辰","110/07/20","元大-前金",60,1,59
"13706","2390云辰","110/07/20","宏遠證券",0,89,-89
"13707","2390云辰","110/07/20","國票-北高雄",63,14,49
"13708","2390云辰","110/07/20","兆豐-台中",0,75,-75
"13709","2390云辰","110/07/20","群益金鼎-三重",40,6,34
"13710","2390云辰","110/07/20","新光",8,82,-74
"13711","2363矽統","110/07/19","第一金-忠孝",210,0,210
"13712","2363矽統","110/07/19","富邦-仁愛",32,575,-543
"13713","2363矽統","110/07/19","中國信託-文心",191,9,182
"13714","2363矽統","110/07/19","新加坡商瑞銀",53,486,-433
"13715","2363矽統","110/07/19","華南永昌-鳳山",116,1,115
"13716","2363矽統","110/07/19","摩根大通",42,320,-278
"13717","2363矽統","110/07/19","元大-新竹",113,12,101
"13718","2363矽統","110/07/19","元大-竹科",3,201,-198
"13719","2363矽統","110/07/19","凱基-中山",89,1,88
"13720","2363矽統","110/07/19","元大-成功",7,183,-176
"13721","2363矽統","110/07/19","永豐金-嘉義",82,7,75
"13722","2363矽統","110/07/19","凱基-大里",0,150,-150
"13723","2363矽統","110/07/19","凱基-台南",72,4,68
"13724","2363矽統","110/07/19","瑞士信貸",80,215,-135
"13725","2363矽統","110/07/19","元富-城東",84,17,67
"13726","2363矽統","110/07/19","日盛-新莊",4,135,-131
"13727","2363矽統","110/07/19","群益金鼎-東湖",61,0,61
"13728","2363矽統","110/07/19","宏遠-桃園",20,150,-130
"13729","2363矽統","110/07/19","兆豐-中壢",55,0,55
"13730","2363矽統","110/07/19","凱基-三重",7,107,-100
"13731","2363矽統","110/07/19","康和-內湖",55,1,54
"13732","2363矽統","110/07/19","凱基-台北",384,476,-92
"13733","2363矽統","110/07/19","群益金鼎-桃園",55,2,53
"13734","2363矽統","110/07/19","合庫-台中",3,84,-81
"13735","2363矽統","110/07/19","群益金鼎-大興",50,0,50
"13736","2363矽統","110/07/19","致和-金華",1,80,-79
"13737","2363矽統","110/07/19","台新-台中",81,32,49
"13738","2363矽統","110/07/19","凱基-員林",5,77,-72
"13739","2363矽統","110/07/19","北城證券",58,10,48
"13740","2363矽統","110/07/19","華南永昌-合泰",2,70,-68
"13741","8112至上","110/07/19","摩根大通",1413,144,1269
"13742","8112至上","110/07/19","凱基-三重",3,600,-597
"13743","8112至上","110/07/19","凱基-台北",1053,266,787
"13744","8112至上","110/07/19","元大-府城",0,165,-165
"13745","8112至上","110/07/19","新加坡商瑞銀",523,2,521
"13746","8112至上","110/07/19","台灣企銀-台中",0,150,-150
"13747","8112至上","110/07/19","台灣摩根士丹利",487,8,479
"13748","8112至上","110/07/19","(牛牛牛)亞-鑫豐",26,119,-93
"13749","8112至上","110/07/19","美林",529,93,436
"13750","8112至上","110/07/19","永豐金-台南",15,95,-80
"13751","8112至上","110/07/19","港商野村",358,36,322
"13752","8112至上","110/07/19","亞東-板橋",2,81,-79
"13753","8112至上","110/07/19","美商高盛",276,3,273
"13754","8112至上","110/07/19","陽信",0,70,-70
"13755","8112至上","110/07/19","兆豐-公益",180,7,173
"13756","8112至上","110/07/19","元富-佳里",0,69,-69
"13757","8112至上","110/07/19","國泰-板橋",116,15,101
"13758","8112至上","110/07/19","臺銀-鳳山",7,72,-65
"13759","8112至上","110/07/19","凱基-新莊",100,1,99
"13760","8112至上","110/07/19","兆豐-竹北",4,65,-61
"13761","8112至上","110/07/19","凱基-市政",89,0,89
"13762","8112至上","110/07/19","國泰-新莊",2,62,-60
"13763","8112至上","110/07/19","玉山證券",73,7,66
"13764","8112至上","110/07/19","元富-大裕",2,60,-58
"13765","8112至上","110/07/19","花旗環球",64,0,64
"13766","8112至上","110/07/19","臺灣企銀-桃園",0,55,-55
"13767","8112至上","110/07/19","合庫-台中",55,3,52
"13768","8112至上","110/07/19","康和-台南",4,59,-55
"13769","8112至上","110/07/19","永豐金-中壢",50,1,49
"13770","8112至上","110/07/19","第一金-華江",3,55,-52
"13771","1570力肯","110/07/19","國票-北高雄",34,0,34
"13772","1570力肯","110/07/19","合庫-三重",0,8,-8
"13773","1570力肯","110/07/19","新光",30,3,27
"13774","1570力肯","110/07/19","元大-高雄",0,8,-8
"13775","1570力肯","110/07/19","凱基-台北",24,1,23
"13776","1570力肯","110/07/19","合庫-台中",0,7,-7
"13777","1570力肯","110/07/19","台灣摩根士丹利",7,0,7
"13778","1570力肯","110/07/19","臺銀-臺中",0,6,-6
"13779","1570力肯","110/07/19","元大-林森",5,0,5
"13780","1570力肯","110/07/19","摩根大通",6,11,-5
"13781","1570力肯","110/07/19","元大-士林",4,0,4
"13782","1570力肯","110/07/19","元富-緯城",0,4,-4
"13783","1570力肯","110/07/19","玉山證券",8,5,3
"13784","1570力肯","110/07/19","玉山-台大",0,4,-4
"13785","1570力肯","110/07/19","統一-城中",2,0,2
"13786","1570力肯","110/07/19","群益金鼎-三重",0,4,-4
"13787","1570力肯","110/07/19","元大-基隆孝二",2,0,2
"13788","1570力肯","110/07/19","凱基-鳳山",1,5,-4
"13789","1570力肯","110/07/19","土銀-建國",1,0,1
"13790","1570力肯","110/07/19","元大-板橋",0,4,-4
"13791","1570力肯","110/07/19","日盛-復興",1,0,1
"13792","1570力肯","110/07/19","日盛-和美",0,3,-3
"13793","1570力肯","110/07/19","瑞士信貸",1,0,1
"13794","1570力肯","110/07/19","元富-新店",2,5,-3
"13795","1570力肯","110/07/19","元富-四維",1,0,1
"13796","1570力肯","110/07/19","元大-新莊",0,3,-3
"13797","1570力肯","110/07/19","群益金鼎-北高雄",1,0,1
"13798","1570力肯","110/07/19","永豐金-敦南",0,3,-3
"13799","1570力肯","110/07/19","凱基-高美館",1,0,1
"13800","1570力肯","110/07/19","永豐金-台中",0,3,-3
"13801","2929淘帝","110/07/19","元大-民生",28,0,28
"13802","2929淘帝","110/07/19","元大-六合",0,40,-40
"13803","2929淘帝","110/07/19","宏遠-光隆",25,0,25
"13804","2929淘帝","110/07/19","新光-新竹",0,35,-35
"13805","2929淘帝","110/07/19","華南永昌-苗栗",20,0,20
"13806","2929淘帝","110/07/19","新加坡商瑞銀",1,30,-29
"13807","2929淘帝","110/07/19","元大-員林",20,0,20
"13808","2929淘帝","110/07/19","永豐金-永康",0,27,-27
"13809","2929淘帝","110/07/19","合庫-高雄",18,0,18
"13810","2929淘帝","110/07/19","凱基-復興",0,24,-24
"13811","2929淘帝","110/07/19","臺銀-鳳山",18,0,18
"13812","2929淘帝","110/07/19","日盛-豐原",0,22,-22
"13813","2929淘帝","110/07/19","日盛-雙和",17,0,17
"13814","2929淘帝","110/07/19","富邦-南屯",1,22,-21
"13815","2929淘帝","110/07/19","華南永昌-林口",15,0,15
"13816","2929淘帝","110/07/19","新光",1,21,-20
"13817","2929淘帝","110/07/19","元大-屏南",15,0,15
"13818","2929淘帝","110/07/19","華南永昌",0,20,-20
"13819","2929淘帝","110/07/19","台新-中壢",12,0,12
"13820","2929淘帝","110/07/19","富邦-竹東",2,22,-20
"13821","2929淘帝","110/07/19","新光-台中",11,0,11
"13822","2929淘帝","110/07/19","凱基-士林",0,16,-16
"13823","2929淘帝","110/07/19","凱基-台北",20,9,11
"13824","2929淘帝","110/07/19","福勝",0,15,-15
"13825","2929淘帝","110/07/19","富邦-台北",11,0,11
"13826","2929淘帝","110/07/19","港商野村",25,37,-12
"13827","2929淘帝","110/07/19","合庫-自強",10,0,10
"13828","2929淘帝","110/07/19","群益金鼎-建成",0,11,-11
"13829","2929淘帝","110/07/19","凱基-豐中",10,0,10
"13830","2929淘帝","110/07/19","華南永昌-朴子",0,11,-11
"13831","5410國眾","110/07/19","香港上海匯豐",28,0,28
"13832","5410國眾","110/07/19","群益金鼎-內湖",0,80,-80
"13833","5410國眾","110/07/19","大昌",26,0,26
"13834","5410國眾","110/07/19","永豐金-屏東",0,14,-14
"13835","5410國眾","110/07/19","兆豐-公益",20,0,20
"13836","5410國眾","110/07/19","永豐金-南京",0,10,-10
"13837","5410國眾","110/07/19","合庫-嘉義",10,0,10
"13838","5410國眾","110/07/19","元大-內湖",0,9,-9
"13839","5410國眾","110/07/19","台新-左楠",20,10,10
"13840","5410國眾","110/07/19","富邦-永和",0,8,-8
"13841","5410國眾","110/07/19","摩根大通",15,6,9
"13842","5410國眾","110/07/19","日盛-景美",0,6,-6
"13843","5410國眾","110/07/19","台灣企銀-民雄",8,0,8
"13844","5410國眾","110/07/19","光和",1,7,-6
"13845","5410國眾","110/07/19","元大-竹科",8,0,8
"13846","5410國眾","110/07/19","元大-士林",0,6,-6
"13847","5410國眾","110/07/19","凱基-台北",9,3,6
"13848","5410國眾","110/07/19","新光-台中",0,5,-5
"13849","5410國眾","110/07/19","元大-博愛",6,0,6
"13850","5410國眾","110/07/19","元大-景美",0,5,-5
"13851","5410國眾","110/07/19","台新-三民",5,0,5
"13852","5410國眾","110/07/19","大慶-蘆洲",0,4,-4
"13853","5410國眾","110/07/19","群益金鼎-中壢",5,0,5
"13854","5410國眾","110/07/19","中國信託-新竹",0,4,-4
"13855","5410國眾","110/07/19","群益金鼎-嘉義",5,0,5
"13856","5410國眾","110/07/19","新光",6,10,-4
"13857","5410國眾","110/07/19","日盛證券",4,0,4
"13858","5410國眾","110/07/19","元大-基隆孝二",0,4,-4
"13859","5410國眾","110/07/19","群益金鼎-新店",4,0,4
"13860","5410國眾","110/07/19","土銀-台中",0,3,-3
"13861","2841台開","110/07/19","元富-城東",150,0,150
"13862","2841台開","110/07/19","日進",0,80,-80
"13863","2841台開","110/07/19","中國信託-忠孝",80,0,80
"13864","2841台開","110/07/19","港商野村",0,77,-77
"13865","2841台開","110/07/19","凱基-台北",52,0,52
"13866","2841台開","110/07/19","摩根大通",0,41,-41
"13867","2841台開","110/07/19","美商高盛",48,0,48
"13868","2841台開","110/07/19","元大-三重",1,38,-37
"13869","2841台開","110/07/19","台中銀",43,0,43
"13870","2841台開","110/07/19","元大-福營",0,30,-30
"13871","2841台開","110/07/19","永豐金-豐原",32,0,32
"13872","2841台開","110/07/19","新光",4,28,-24
"13873","2841台開","110/07/19","豐農",20,0,20
"13874","2841台開","110/07/19","元大-竹科",0,22,-22
"13875","2841台開","110/07/19","台新-台中",30,10,20
"13876","2841台開","110/07/19","永豐金-敦南",33,55,-22
"13877","2841台開","110/07/19","華南永昌-新莊",20,0,20
"13878","2841台開","110/07/19","日盛-二林",0,15,-15
"13879","2841台開","110/07/19","第一金-台中",12,0,12
"13880","2841台開","110/07/19","元富-虎尾",0,15,-15
"13881","2841台開","110/07/19","國泰-台中",12,0,12
"13882","2841台開","110/07/19","華南永昌-世貿",0,15,-15
"13883","2841台開","110/07/19","日茂",10,0,10
"13884","2841台開","110/07/19","統一-三多",0,12,-12
"13885","2841台開","110/07/19","凱基-埔墘",10,0,10
"13886","2841台開","110/07/19","台中銀-豐原",0,10,-10
"13887","2841台開","110/07/19","永豐金-內湖",8,0,8
"13888","2841台開","110/07/19","元大-頭份",0,10,-10
"13889","2841台開","110/07/19","合庫-台中",7,0,7
"13890","2841台開","110/07/19","合庫-台南",0,8,-8
"13891","6207雷科","110/07/19","元富-信義",92,0,92
"13892","6207雷科","110/07/19","新加坡商瑞銀",5,104,-99
"13893","6207雷科","110/07/19","國泰證券",90,0,90
"13894","6207雷科","110/07/19","富邦-彰化",2,97,-95
"13895","6207雷科","110/07/19","元富-城中",80,4,76
"13896","6207雷科","110/07/19","永豐金-內湖",6,85,-79
"13897","6207雷科","110/07/19","元大-福營",71,5,66
"13898","6207雷科","110/07/19","摩根大通",102,164,-62
"13899","6207雷科","110/07/19","凱基-復興",60,0,60
"13900","6207雷科","110/07/19","瑞士信貸",0,51,-51
"13901","6207雷科","110/07/19","凱基-台北",91,46,45
"13902","6207雷科","110/07/19","凱基-板橋",10,55,-45
"13903","6207雷科","110/07/19","玉山-城中",42,0,42
"13904","6207雷科","110/07/19","華南永昌-大安",0,40,-40
"13905","6207雷科","110/07/19","華南永昌-長虹",40,0,40
"13906","6207雷科","110/07/19","群益金鼎-東大",1,40,-39
"13907","6207雷科","110/07/19","永豐金-羅東",38,0,38
"13908","6207雷科","110/07/19","台新-高雄",15,47,-32
"13909","6207雷科","110/07/19","日盛-忠孝",36,2,34
"13910","6207雷科","110/07/19","玉山-嘉義",1,32,-31
"13911","6207雷科","110/07/19","凱基-羅東",37,3,34
"13912","6207雷科","110/07/19","凱基-中港",0,30,-30
"13913","6207雷科","110/07/19","第一金-新竹",30,0,30
"13914","6207雷科","110/07/19","元大-六合",7,36,-29
"13915","6207雷科","110/07/19","玉山-數位",27,1,26
"13916","6207雷科","110/07/19","元富-花蓮",0,28,-28
"13917","6207雷科","110/07/19","凱基-長庚",22,0,22
"13918","6207雷科","110/07/19","群益金鼎-瑞豐",6,34,-28
"13919","6207雷科","110/07/19","台灣企銀-北高雄",20,0,20
"13920","6207雷科","110/07/19","新百王",0,26,-26
"13921","3679新至陞","110/07/19","元大-成功",7,0,7
"13922","3679新至陞","110/07/19","群益金鼎-大安",0,15,-15
"13923","3679新至陞","110/07/19","美商高盛",6,0,6
"13924","3679新至陞","110/07/19","凱基-民權",0,10,-10
"13925","3679新至陞","110/07/19","台新-高雄",5,0,5
"13926","3679新至陞","110/07/19","元大-西門",0,10,-10
"13927","3679新至陞","110/07/19","凱基-松山",5,0,5
"13928","3679新至陞","110/07/19","瑞士信貸",0,6,-6
"13929","3679新至陞","110/07/19","日盛-員林",4,0,4
"13930","3679新至陞","110/07/19","兆豐-高雄",0,6,-6
"13931","3679新至陞","110/07/19","台中銀-員林",4,0,4
"13932","3679新至陞","110/07/19","群益金鼎",0,5,-5
"13933","3679新至陞","110/07/19","(牛牛牛)亞-網路",3,0,3
"13934","3679新至陞","110/07/19","元大-永春",0,4,-4
"13935","3679新至陞","110/07/19","大昌-新店",3,0,3
"13936","3679新至陞","110/07/19","凱基-台北",2,5,-3
"13937","3679新至陞","110/07/19","凱基-埔墘",3,0,3
"13938","3679新至陞","110/07/19","港商法國興業",0,2,-2
"13939","3679新至陞","110/07/19","元大-板橋",3,0,3
"13940","3679新至陞","110/07/19","摩根大通",2,4,-2
"13941","3679新至陞","110/07/19","臺銀-金山",2,0,2
"13942","3679新至陞","110/07/19","元大-金門",0,2,-2
"13943","3679新至陞","110/07/19","日盛-樹林",2,0,2
"13944","3679新至陞","110/07/19","元大-土城",0,2,-2
"13945","3679新至陞","110/07/19","致和-東門",2,0,2
"13946","3679新至陞","110/07/19","日盛-鳳山",0,1,-1
"13947","3679新至陞","110/07/19","國票-敦北法人",2,0,2
"13948","3679新至陞","110/07/19","美林",1,2,-1
"13949","3679新至陞","110/07/19","台新證券",2,0,2
"13950","3679新至陞","110/07/19","第一金",0,1,-1
"13951","2727王品","110/07/19","台新證券",374,33,341
"13952","2727王品","110/07/19","台灣摩根士丹利",25,188,-163
"13953","2727王品","110/07/19","瑞士信貸",217,1,216
"13954","2727王品","110/07/19","港商野村",74,198,-124
"13955","2727王品","110/07/19","兆豐-南京",200,0,200
"13956","2727王品","110/07/19","統一",6,80,-74
"13957","2727王品","110/07/19","第一金",70,1,69
"13958","2727王品","110/07/19","合庫-台中",8,79,-71
"13959","2727王品","110/07/19","元大-小港",59,1,58
"13960","2727王品","110/07/19","凱基-台北",178,231,-53
"13961","2727王品","110/07/19","玉山-桃園",42,6,36
"13962","2727王品","110/07/19","富邦-中壢",3,52,-49
"13963","2727王品","110/07/19","永豐金-大園",31,0,31
"13964","2727王品","110/07/19","凱基-永華",0,43,-43
"13965","2727王品","110/07/19","兆豐-大安",30,0,30
"13966","2727王品","110/07/19","土銀-台中",0,36,-36
"13967","2727王品","110/07/19","美商高盛",38,15,23
"13968","2727王品","110/07/19","美林",8,41,-33
"13969","2727王品","110/07/19","康和-澎湖",23,1,22
"13970","2727王品","110/07/19","中國信託-忠孝",1,33,-32
"13971","2727王品","110/07/19","第一金-高雄",21,0,21
"13972","2727王品","110/07/19","新光",31,61,-30
"13973","2727王品","110/07/19","國票-內壢",21,0,21
"13974","2727王品","110/07/19","第一金-豐原",0,26,-26
"13975","2727王品","110/07/19","元大-桃興",19,3,16
"13976","2727王品","110/07/19","富邦-彰化",0,26,-26
"13977","2727王品","110/07/19","凱基-三重",16,1,15
"13978","2727王品","110/07/19","摩根大通",78,97,-19
"13979","2727王品","110/07/19","永豐金-南投",16,1,15
"13980","2727王品","110/07/19","國泰證券",2,21,-19
"13981","1570力肯","110/07/19","國票-北高雄",34,0,34
"13982","1570力肯","110/07/19","合庫-三重",0,8,-8
"13983","1570力肯","110/07/19","新光",30,3,27
"13984","1570力肯","110/07/19","元大-高雄",0,8,-8
"13985","1570力肯","110/07/19","凱基-台北",24,1,23
"13986","1570力肯","110/07/19","合庫-台中",0,7,-7
"13987","1570力肯","110/07/19","台灣摩根士丹利",7,0,7
"13988","1570力肯","110/07/19","臺銀-臺中",0,6,-6
"13989","1570力肯","110/07/19","元大-林森",5,0,5
"13990","1570力肯","110/07/19","摩根大通",6,11,-5
"13991","1570力肯","110/07/19","元大-士林",4,0,4
"13992","1570力肯","110/07/19","元富-緯城",0,4,-4
"13993","1570力肯","110/07/19","玉山證券",8,5,3
"13994","1570力肯","110/07/19","玉山-台大",0,4,-4
"13995","1570力肯","110/07/19","統一-城中",2,0,2
"13996","1570力肯","110/07/19","群益金鼎-三重",0,4,-4
"13997","1570力肯","110/07/19","元大-基隆孝二",2,0,2
"13998","1570力肯","110/07/19","凱基-鳳山",1,5,-4
"13999","1570力肯","110/07/19","土銀-建國",1,0,1
"14000","1570力肯","110/07/19","元大-板橋",0,4,-4
"14001","1570力肯","110/07/19","日盛-復興",1,0,1
"14002","1570力肯","110/07/19","日盛-和美",0,3,-3
"14003","1570力肯","110/07/19","瑞士信貸",1,0,1
"14004","1570力肯","110/07/19","元富-新店",2,5,-3
"14005","1570力肯","110/07/19","元富-四維",1,0,1
"14006","1570力肯","110/07/19","元大-新莊",0,3,-3
"14007","1570力肯","110/07/19","群益金鼎-北高雄",1,0,1
"14008","1570力肯","110/07/19","永豐金-敦南",0,3,-3
"14009","1570力肯","110/07/19","凱基-高美館",1,0,1
"14010","1570力肯","110/07/19","永豐金-台中",0,3,-3
"14011","6180橘子","110/07/19","兆豐證券",55,0,55
"14012","6180橘子","110/07/19","石橋證券",0,80,-80
"14013","6180橘子","110/07/19","凱基-台北",89,35,54
"14014","6180橘子","110/07/19","永豐金-大園",2,50,-48
"14015","6180橘子","110/07/19","合庫-自強",36,0,36
"14016","6180橘子","110/07/19","群益金鼎-屏東",0,40,-40
"14017","6180橘子","110/07/19","新光",50,25,25
"14018","6180橘子","110/07/19","國泰-敦南",0,19,-19
"14019","6180橘子","110/07/19","日盛-龍潭",20,0,20
"14020","6180橘子","110/07/19","日盛-新竹",2,20,-18
"14021","6180橘子","110/07/19","元大-斗信",16,1,15
"14022","6180橘子","110/07/19","摩根大通",17,35,-18
"14023","6180橘子","110/07/19","康和-台中",12,0,12
"14024","6180橘子","110/07/19","富邦-陽明",0,17,-17
"14025","6180橘子","110/07/19","國泰-台中",14,2,12
"14026","6180橘子","110/07/19","美商高盛",11,27,-16
"14027","6180橘子","110/07/19","富邦-嘉義",12,0,12
"14028","6180橘子","110/07/19","統一-宜蘭",0,14,-14
"14029","6180橘子","110/07/19","元大-草屯",12,0,12
"14030","6180橘子","110/07/19","凱基-興隆",0,12,-12
"14031","6180橘子","110/07/19","元富-桃園",11,0,11
"14032","6180橘子","110/07/19","台中銀-豐原",1,11,-10
"14033","6180橘子","110/07/19","兆豐-城中",10,0,10
"14034","6180橘子","110/07/19","永豐金-豐原",0,10,-10
"14035","6180橘子","110/07/19","元大-旗山",10,0,10
"14036","6180橘子","110/07/19","永豐金-竹科",0,10,-10
"14037","6180橘子","110/07/19","元大-大安",10,0,10
"14038","6180橘子","110/07/19","臺銀-鳳山",1,10,-9
"14039","6180橘子","110/07/19","大昌-新店",9,0,9
"14040","6180橘子","110/07/19","群益金鼎-台南",0,9,-9
"14041","2390云辰","110/07/19","摩根大通",1135,266,869
"14042","2390云辰","110/07/19","元富-成功",15,119,-104
"14043","2390云辰","110/07/19","台灣摩根士丹利",232,40,192
"14044","2390云辰","110/07/19","元富-中港",5,101,-96
"14045","2390云辰","110/07/19","凱基-台北",669,504,165
"14046","2390云辰","110/07/19","元富-嘉義",5,85,-80
"14047","2390云辰","110/07/19","美林",290,159,131
"14048","2390云辰","110/07/19","美商高盛",11,62,-51
"14049","2390云辰","110/07/19","統一",111,8,103
"14050","2390云辰","110/07/19","群益金鼎-西松",4,54,-50
"14051","2390云辰","110/07/19","元富-埔里",102,0,102
"14052","2390云辰","110/07/19","聯邦商銀",0,48,-48
"14053","2390云辰","110/07/19","華南永昌-台中",126,26,100
"14054","2390云辰","110/07/19","元大-萬華",15,57,-42
"14055","2390云辰","110/07/19","永豐金-豐原",100,32,68
"14056","2390云辰","110/07/19","群益金鼎-高雄",2,42,-40
"14057","2390云辰","110/07/19","台新-台南",87,25,62
"14058","2390云辰","110/07/19","國泰-敦南",117,154,-37
"14059","2390云辰","110/07/19","台新-左楠",67,11,56
"14060","2390云辰","110/07/19","中國信託-文心",5,40,-35
"14061","2390云辰","110/07/19","國泰-忠孝",52,0,52
"14062","2390云辰","110/07/19","凱基-城中",16,51,-35
"14063","2390云辰","110/07/19","台新證券",105,54,51
"14064","2390云辰","110/07/19","瑞士信貸",0,31,-31
"14065","2390云辰","110/07/19","華南永昌-頭份",53,3,50
"14066","2390云辰","110/07/19","中國信託-永康",1,32,-31
"14067","2390云辰","110/07/19","新光-台南",44,0,44
"14068","2390云辰","110/07/19","統一-彰化",2,32,-30
"14069","2390云辰","110/07/19","合庫-西台中",50,8,42
"14070","2390云辰","110/07/19","元大-館前",7,37,-30
"14071","2363矽統","110/07/16","國票-長城",461,21,440
"14072","2363矽統","110/07/16","新加坡商瑞銀",155,482,-327
"14073","2363矽統","110/07/16","凱基-豐中",201,3,198
"14074","2363矽統","110/07/16","港商野村",253,546,-293
"14075","2363矽統","110/07/16","凱基-土城",132,9,123
"14076","2363矽統","110/07/16","摩根大通",116,401,-285
"14077","2363矽統","110/07/16","台新證券",199,78,121
"14078","2363矽統","110/07/16","瑞士信貸",291,533,-242
"14079","2363矽統","110/07/16","日盛-中和",74,0,74
"14080","2363矽統","110/07/16","日盛-竹北",19,248,-229
"14081","2363矽統","110/07/16","日盛-員林",66,3,63
"14082","2363矽統","110/07/16","臺銀-金山",4,211,-207
"14083","2363矽統","110/07/16","國票-中和",60,3,57
"14084","2363矽統","110/07/16","元大-大統",13,138,-125
"14085","2363矽統","110/07/16","新光",240,184,56
"14086","2363矽統","110/07/16","永豐金證券",11,125,-114
"14087","2363矽統","110/07/16","富邦-竹東",65,9,56
"14088","2363矽統","110/07/16","兆豐-民生",2,101,-99
"14089","2363矽統","110/07/16","華南永昌-鳳山",56,1,55
"14090","2363矽統","110/07/16","群益金鼎-松山",2,100,-98
"14091","2363矽統","110/07/16","凱基-台北",520,466,54
"14092","2363矽統","110/07/16","元大-花蓮",8,99,-91
"14093","2363矽統","110/07/16","元富-城東",63,12,51
"14094","2363矽統","110/07/16","華南永昌-虎尾",68,154,-86
"14095","2363矽統","110/07/16","群益金鼎-桃園",56,5,51
"14096","2363矽統","110/07/16","富邦-新竹華信",7,89,-82
"14097","2363矽統","110/07/16","北城證券",60,10,50
"14098","2363矽統","110/07/16","元大-佳里",3,81,-78
"14099","2363矽統","110/07/16","國票-九鼎",57,7,50
"14100","2363矽統","110/07/16","玉山-南京東路",0,73,-73
"14101","8112至上","110/07/16","宏遠證券",551,6,545
"14102","8112至上","110/07/16","玉山-桃園",42,318,-276
"14103","8112至上","110/07/16","台灣摩根士丹利",317,11,306
"14104","8112至上","110/07/16","美林",64,305,-241
"14105","8112至上","110/07/16","新加坡商瑞銀",378,73,305
"14106","8112至上","110/07/16","宏遠-館前",16,212,-196
"14107","8112至上","110/07/16","凱基-台北",758,553,205
"14108","8112至上","110/07/16","玉山-嘉義",19,95,-76
"14109","8112至上","110/07/16","富邦證券",127,0,127
"14110","8112至上","110/07/16","群益金鼎-三民",7,82,-75
"14111","8112至上","110/07/16","台新證券",129,30,99
"14112","8112至上","110/07/16","日盛-二林",1,73,-72
"14113","8112至上","110/07/16","花旗環球",97,0,97
"14114","8112至上","110/07/16","玉山-台大",8,76,-68
"14115","8112至上","110/07/16","永豐金-台南",97,8,89
"14116","8112至上","110/07/16","元富-台南",1,68,-67
"14117","8112至上","110/07/16","元大-大天母",93,15,78
"14118","8112至上","110/07/16","玉山-板橋",4,71,-67
"14119","8112至上","110/07/16","亞東-板橋",72,2,70
"14120","8112至上","110/07/16","臺灣企銀-埔墘",0,60,-60
"14121","8112至上","110/07/16","永豐金-中正",64,9,55
"14122","8112至上","110/07/16","華南永昌-鶯歌",11,64,-53
"14123","8112至上","110/07/16","大昌-樹林",53,2,51
"14124","8112至上","110/07/16","元大-士林",7,59,-52
"14125","8112至上","110/07/16","凱基-永和",56,5,51
"14126","8112至上","110/07/16","元富-新店",8,57,-49
"14127","8112至上","110/07/16","兆豐-竹北",53,3,50
"14128","8112至上","110/07/16","富邦-陽明",9,58,-49
"14129","8112至上","110/07/16","日盛-豐原",48,0,48
"14130","8112至上","110/07/16","元大-發財",0,49,-49
"14131","1570力肯","110/07/16","新光",71,6,65
"14132","1570力肯","110/07/16","元大-高雄",0,23,-23
"14133","1570力肯","110/07/16","國票-北高雄",21,0,21
"14134","1570力肯","110/07/16","合庫-台南",0,20,-20
"14135","1570力肯","110/07/16","凱基-台北",17,1,16
"14136","1570力肯","110/07/16","元富-新店",0,15,-15
"14137","1570力肯","110/07/16","群益金鼎-高雄",15,0,15
"14138","1570力肯","110/07/16","元大-東港",0,10,-10
"14139","1570力肯","110/07/16","富邦-建國",10,0,10
"14140","1570力肯","110/07/16","中國信託",0,7,-7
"14141","1570力肯","110/07/16","元大-士林",5,0,5
"14142","1570力肯","110/07/16","台新證券",0,6,-6
"14143","1570力肯","110/07/16","瑞士信貸",3,0,3
"14144","1570力肯","110/07/16","日盛-信義",0,5,-5
"14145","1570力肯","110/07/16","臺銀-高雄",2,0,2
"14146","1570力肯","110/07/16","宏遠-館前",0,5,-5
"14147","1570力肯","110/07/16","華南永昌",2,0,2
"14148","1570力肯","110/07/16","國泰-館前",0,5,-5
"14149","1570力肯","110/07/16","元富-同大",1,0,1
"14150","1570力肯","110/07/16","富邦-園區",0,5,-5
"14151","1570力肯","110/07/16","兆豐-麻豆",1,0,1
"14152","1570力肯","110/07/16","永豐金-中正",0,5,-5
"14153","1570力肯","110/07/16","國泰-板橋",1,0,1
"14154","1570力肯","110/07/16","(牛牛牛)亞-鑫豐",0,4,-4
"14155","1570力肯","110/07/16","群益金鼎-東湖",1,0,1
"14156","1570力肯","110/07/16","台中銀-員林",0,3,-3
"14157","1570力肯","110/07/16","元大-東泰",1,0,1
"14158","1570力肯","110/07/16","玉山-新莊",0,3,-3
"14159","1570力肯","110/07/16","元大-南勢角",1,0,1
"14160","1570力肯","110/07/16","凱基-長庚",0,3,-3
"14161","2929淘帝","110/07/16","元大-民生",28,0,28
"14162","2929淘帝","110/07/16","玉山-新竹",0,30,-30
"14163","2929淘帝","110/07/16","元大-員林",20,0,20
"14164","2929淘帝","110/07/16","合庫證券",0,20,-20
"14165","2929淘帝","110/07/16","兆豐-桃鶯",12,0,12
"14166","2929淘帝","110/07/16","元大-六合",0,20,-20
"14167","2929淘帝","110/07/16","元大-大統",10,0,10
"14168","2929淘帝","110/07/16","摩根大通",0,12,-12
"14169","2929淘帝","110/07/16","新加坡商瑞銀",9,0,9
"14170","2929淘帝","110/07/16","永興",0,6,-6
"14171","2929淘帝","110/07/16","凱基-基隆",6,0,6
"14172","2929淘帝","110/07/16","凱基-長庚",0,5,-5
"14173","2929淘帝","110/07/16","合庫-高雄",5,0,5
"14174","2929淘帝","110/07/16","群益金鼎-潭子",0,4,-4
"14175","2929淘帝","110/07/16","台新-台中",6,1,5
"14176","2929淘帝","110/07/16","華南永昌-小港",2,6,-4
"14177","2929淘帝","110/07/16","元大-承德",5,0,5
"14178","2929淘帝","110/07/16","華南永昌-虎尾",0,4,-4
"14179","2929淘帝","110/07/16","元大-沙鹿",5,0,5
"14180","2929淘帝","110/07/16","日盛-和美",0,3,-3
"14181","2929淘帝","110/07/16","大慶-苗栗",5,1,4
"14182","2929淘帝","110/07/16","彰銀",0,3,-3
"14183","2929淘帝","110/07/16","台新-新營",4,0,4
"14184","2929淘帝","110/07/16","港商野村",7,10,-3
"14185","2929淘帝","110/07/16","凱基-台北",6,2,4
"14186","2929淘帝","110/07/16","群益金鼎-中山",1,4,-3
"14187","2929淘帝","110/07/16","兆豐-台中港",3,0,3
"14188","2929淘帝","110/07/16","凱基-嘉義",0,3,-3
"14189","2929淘帝","110/07/16","國票-北高雄",3,0,3
"14190","2929淘帝","110/07/16","元大-斗信",0,3,-3
"14191","5410國眾","110/07/16","盈溢-籬子內",49,0,49
"14192","5410國眾","110/07/16","元大-博愛",0,41,-41
"14193","5410國眾","110/07/16","香港上海匯豐",31,0,31
"14194","5410國眾","110/07/16","元富-嘉義",0,20,-20
"14195","5410國眾","110/07/16","元大-東泰",30,0,30
"14196","5410國眾","110/07/16","國泰-桃園",0,18,-18
"14197","5410國眾","110/07/16","兆豐-台中港",20,0,20
"14198","5410國眾","110/07/16","元富",0,17,-17
"14199","5410國眾","110/07/16","臺銀-臺南",11,0,11
"14200","5410國眾","110/07/16","元大-新竹",0,14,-14
"14201","5410國眾","110/07/16","富邦-新竹華信",11,0,11
"14202","5410國眾","110/07/16","安泰-大發",0,11,-11
"14203","5410國眾","110/07/16","臺銀",10,0,10
"14204","5410國眾","110/07/16","大昌-樹林",0,10,-10
"14205","5410國眾","110/07/16","凱基-台北",8,1,7
"14206","5410國眾","110/07/16","群益金鼎-內湖",0,10,-10
"14207","5410國眾","110/07/16","日盛-士林",5,0,5
"14208","5410國眾","110/07/16","元大-樹林",0,10,-10
"14209","5410國眾","110/07/16","新光-桃園",5,0,5
"14210","5410國眾","110/07/16","元大-內湖",0,9,-9
"14211","5410國眾","110/07/16","國泰-台南",5,0,5
"14212","5410國眾","110/07/16","群益金鼎-永和",0,5,-5
"14213","5410國眾","110/07/16","群益金鼎-嘉義",5,0,5
"14214","5410國眾","110/07/16","凱基-屏東",0,5,-5
"14215","5410國眾","110/07/16","元大-屏南",5,0,5
"14216","5410國眾","110/07/16","統一-員林",0,4,-4
"14217","5410國眾","110/07/16","日盛-員林",3,0,3
"14218","5410國眾","110/07/16","國泰-松江",0,4,-4
"14219","5410國眾","110/07/16","瑞士信貸",3,0,3
"14220","5410國眾","110/07/16","凱基-台南",0,4,-4
"14221","2841台開","110/07/16","日盛證券",250,0,250
"14222","2841台開","110/07/16","元大-歸仁",0,590,-590
"14223","2841台開","110/07/16","凱基-文心",204,0,204
"14224","2841台開","110/07/16","摩根大通",0,245,-245
"14225","2841台開","110/07/16","國泰-館前",114,0,114
"14226","2841台開","110/07/16","日盛-信義",0,145,-145
"14227","2841台開","110/07/16","永豐金-豐原",75,0,75
"14228","2841台開","110/07/16","港商野村",0,103,-103
"14229","2841台開","110/07/16","台新-台中",76,10,66
"14230","2841台開","110/07/16","玉山-嘉義",5,54,-49
"14231","2841台開","110/07/16","中國信託-文心",51,5,46
"14232","2841台開","110/07/16","台新證券",22,63,-41
"14233","2841台開","110/07/16","華南永昌-新莊",41,10,31
"14234","2841台開","110/07/16","美商高盛",0,39,-39
"14235","2841台開","110/07/16","富邦-嘉義",30,0,30
"14236","2841台開","110/07/16","亞東-板橋",0,30,-30
"14237","2841台開","110/07/16","新光",26,0,26
"14238","2841台開","110/07/16","永豐金-北高雄",0,30,-30
"14239","2841台開","110/07/16","富邦-板橋",25,0,25
"14240","2841台開","110/07/16","日盛-忠孝",0,20,-20
"14241","2841台開","110/07/16","新光-台中",22,0,22
"14242","2841台開","110/07/16","元富-草屯",0,15,-15
"14243","2841台開","110/07/16","元大-承德",22,0,22
"14244","2841台開","110/07/16","永豐金-板新",0,12,-12
"14245","2841台開","110/07/16","日盛-三重",20,0,20
"14246","2841台開","110/07/16","第一金-華江",0,10,-10
"14247","2841台開","110/07/16","日盛-新莊",20,0,20
"14248","2841台開","110/07/16","兆豐-南京",0,10,-10
"14249","2841台開","110/07/16","凱基-台南",20,0,20
"14250","2841台開","110/07/16","國票-中港",0,10,-10
"14251","6207雷科","110/07/16","統一-平鎮",215,4,211
"14252","6207雷科","110/07/16","凱基-台北",344,628,-284
"14253","6207雷科","110/07/16","凱基-復興",166,6,160
"14254","6207雷科","110/07/16","新加坡商瑞銀",104,370,-266
"14255","6207雷科","110/07/16","永豐金-南京",141,3,138
"14256","6207雷科","110/07/16","摩根大通",193,430,-237
"14257","6207雷科","110/07/16","永豐金-內湖",117,1,116
"14258","6207雷科","110/07/16","富邦證券",0,150,-150
"14259","6207雷科","110/07/16","日盛證券",104,2,102
"14260","6207雷科","110/07/16","華南永昌-中正",26,169,-143
"14261","6207雷科","110/07/16","群益金鼎-古亭",74,2,72
"14262","6207雷科","110/07/16","凱基-敦北",1,142,-141
"14263","6207雷科","110/07/16","群益金鼎-東門",76,12,64
"14264","6207雷科","110/07/16","凱基-板橋",0,120,-120
"14265","6207雷科","110/07/16","日盛-板橋",78,25,53
"14266","6207雷科","110/07/16","元富-大昌",30,136,-106
"14267","6207雷科","110/07/16","元大-斗六",57,6,51
"14268","6207雷科","110/07/16","元大-北成功",26,97,-71
"14269","6207雷科","110/07/16","元大-頭份",53,3,50
"14270","6207雷科","110/07/16","新光-桃園",29,93,-64
"14271","6207雷科","110/07/16","群益金鼎-東大",56,11,45
"14272","6207雷科","110/07/16","新百王",27,90,-63
"14273","6207雷科","110/07/16","永豐金-虎尾",50,8,42
"14274","6207雷科","110/07/16","玉山-左營",16,72,-56
"14275","6207雷科","110/07/16","元大-西門",39,1,38
"14276","6207雷科","110/07/16","群益金鼎-中壢",3,54,-51
"14277","6207雷科","110/07/16","凱基-竹科",38,1,37
"14278","6207雷科","110/07/16","元富-中原",21,67,-46
"14279","6207雷科","110/07/16","元富-世貿",50,15,35
"14280","6207雷科","110/07/16","大昌-桃園",26,70,-44
"14281","3679新至陞","110/07/16","元大-成功",17,1,16
"14282","3679新至陞","110/07/16","國票-桃園",0,11,-11
"14283","3679新至陞","110/07/16","玉山-台大",5,0,5
"14284","3679新至陞","110/07/16","富邦-台北",0,10,-10
"14285","3679新至陞","110/07/16","日盛-員林",4,0,4
"14286","3679新至陞","110/07/16","富邦-苗栗",0,10,-10
"14287","3679新至陞","110/07/16","凱基-台北",6,2,4
"14288","3679新至陞","110/07/16","元大-永春",0,6,-6
"14289","3679新至陞","110/07/16","台灣摩根士丹利",3,0,3
"14290","3679新至陞","110/07/16","美林",0,5,-5
"14291","3679新至陞","110/07/16","凱基-中山",3,0,3
"14292","3679新至陞","110/07/16","瑞士信貸",3,7,-4
"14293","3679新至陞","110/07/16","元大-承德",3,0,3
"14294","3679新至陞","110/07/16","宏遠-館前",0,3,-3
"14295","3679新至陞","110/07/16","元大-汐止",4,1,3
"14296","3679新至陞","110/07/16","元大-東港",0,3,-3
"14297","3679新至陞","110/07/16","日盛-大墩",2,0,2
"14298","3679新至陞","110/07/16","元大證券",0,2,-2
"14299","3679新至陞","110/07/16","玉山-城中",2,0,2
"14300","3679新至陞","110/07/16","永豐金-板新",0,2,-2
"14301","3679新至陞","110/07/16","華南永昌-內壢",2,0,2
"14302","3679新至陞","110/07/16","臺銀-民權",0,1,-1
"14303","3679新至陞","110/07/16","元大-台南",2,0,2
"14304","3679新至陞","110/07/16","日盛-台中",0,1,-1
"14305","3679新至陞","110/07/16","元大-大同",2,0,2
"14306","3679新至陞","110/07/16","日盛-鳳山",0,1,-1
"14307","3679新至陞","110/07/16","臺銀-高雄",1,0,1
"14308","3679新至陞","110/07/16","元富-古亭",0,1,-1
"14309","3679新至陞","110/07/16","日盛-樹林",1,0,1
"14310","3679新至陞","110/07/16","元富-新興",0,1,-1
"14311","2727王品","110/07/16","富邦證券",570,0,570
"14312","2727王品","110/07/16","台新證券",27,77,-50
"14313","2727王品","110/07/16","兆豐-南京",200,0,200
"14314","2727王品","110/07/16","台灣摩根士丹利",4,47,-43
"14315","2727王品","110/07/16","瑞士信貸",133,2,131
"14316","2727王品","110/07/16","永豐金-大園",0,33,-33
"14317","2727王品","110/07/16","美林",121,26,95
"14318","2727王品","110/07/16","元大-北屯",0,32,-32
"14319","2727王品","110/07/16","統一",103,43,60
"14320","2727王品","110/07/16","富邦-南屯",1,30,-29
"14321","2727王品","110/07/16","中國信託-忠孝",36,2,34
"14322","2727王品","110/07/16","元大-基隆孝二",0,29,-29
"14323","2727王品","110/07/16","元大證券",68,45,23
"14324","2727王品","110/07/16","日盛-忠孝",4,30,-26
"14325","2727王品","110/07/16","合庫-彰化",22,1,21
"14326","2727王品","110/07/16","新光-新竹",1,21,-20
"14327","2727王品","110/07/16","港商野村",126,105,21
"14328","2727王品","110/07/16","凱基-台北",94,113,-19
"14329","2727王品","110/07/16","元富-板橋",22,1,21
"14330","2727王品","110/07/16","富邦-虎尾",1,19,-18
"14331","2727王品","110/07/16","新加坡商瑞銀",36,18,18
"14332","2727王品","110/07/16","元大-南京",0,17,-17
"14333","2727王品","110/07/16","國泰證券",20,5,15
"14334","2727王品","110/07/16","日盛-鳳山",2,18,-16
"14335","2727王品","110/07/16","日盛-桃園",13,1,12
"14336","2727王品","110/07/16","新光",34,50,-16
"14337","2727王品","110/07/16","凱基-市政",12,1,11
"14338","2727王品","110/07/16","富邦-台北",2,18,-16
"14339","2727王品","110/07/16","元大-嘉義",14,3,11
"14340","2727王品","110/07/16","國票-內壢",1,15,-14
"14341","1570力肯","110/07/16","新光",71,6,65
"14342","1570力肯","110/07/16","元大-高雄",0,23,-23
"14343","1570力肯","110/07/16","國票-北高雄",21,0,21
"14344","1570力肯","110/07/16","合庫-台南",0,20,-20
"14345","1570力肯","110/07/16","凱基-台北",17,1,16
"14346","1570力肯","110/07/16","元富-新店",0,15,-15
"14347","1570力肯","110/07/16","群益金鼎-高雄",15,0,15
"14348","1570力肯","110/07/16","元大-東港",0,10,-10
"14349","1570力肯","110/07/16","富邦-建國",10,0,10
"14350","1570力肯","110/07/16","中國信託",0,7,-7
"14351","1570力肯","110/07/16","元大-士林",5,0,5
"14352","1570力肯","110/07/16","台新證券",0,6,-6
"14353","1570力肯","110/07/16","瑞士信貸",3,0,3
"14354","1570力肯","110/07/16","日盛-信義",0,5,-5
"14355","1570力肯","110/07/16","臺銀-高雄",2,0,2
"14356","1570力肯","110/07/16","宏遠-館前",0,5,-5
"14357","1570力肯","110/07/16","華南永昌",2,0,2
"14358","1570力肯","110/07/16","國泰-館前",0,5,-5
"14359","1570力肯","110/07/16","元富-同大",1,0,1
"14360","1570力肯","110/07/16","富邦-園區",0,5,-5
"14361","1570力肯","110/07/16","兆豐-麻豆",1,0,1
"14362","1570力肯","110/07/16","永豐金-中正",0,5,-5
"14363","1570力肯","110/07/16","國泰-板橋",1,0,1
"14364","1570力肯","110/07/16","(牛牛牛)亞-鑫豐",0,4,-4
"14365","1570力肯","110/07/16","群益金鼎-東湖",1,0,1
"14366","1570力肯","110/07/16","台中銀-員林",0,3,-3
"14367","1570力肯","110/07/16","元大-東泰",1,0,1
"14368","1570力肯","110/07/16","玉山-新莊",0,3,-3
"14369","1570力肯","110/07/16","元大-南勢角",1,0,1
"14370","1570力肯","110/07/16","凱基-長庚",0,3,-3
"14371","6180橘子","110/07/16","日盛-文化",71,5,66
"14372","6180橘子","110/07/16","凱基-台北",110,238,-128
"14373","6180橘子","110/07/16","新加坡商瑞銀",75,19,56
"14374","6180橘子","110/07/16","摩根大通",77,161,-84
"14375","6180橘子","110/07/16","瑞士信貸",51,0,51
"14376","6180橘子","110/07/16","元富-高雄",0,62,-62
"14377","6180橘子","110/07/16","台灣企銀-屏東",50,0,50
"14378","6180橘子","110/07/16","美商高盛",0,40,-40
"14379","6180橘子","110/07/16","元大-桃園",52,2,50
"14380","6180橘子","110/07/16","合庫-自強",0,37,-37
"14381","6180橘子","110/07/16","康和-台北",51,10,41
"14382","6180橘子","110/07/16","美林",15,48,-33
"14383","6180橘子","110/07/16","群益金鼎-屏東",61,20,41
"14384","6180橘子","110/07/16","元富-四維",0,32,-32
"14385","6180橘子","110/07/16","元大-彰化",33,2,31
"14386","6180橘子","110/07/16","新光",63,92,-29
"14387","6180橘子","110/07/16","台中銀-台北",30,0,30
"14388","6180橘子","110/07/16","新光-台南",6,28,-22
"14389","6180橘子","110/07/16","福勝",29,3,26
"14390","6180橘子","110/07/16","港商野村",28,49,-21
"14391","6180橘子","110/07/16","兆豐證券",21,0,21
"14392","6180橘子","110/07/16","統一",2,23,-21
"14393","6180橘子","110/07/16","華南永昌-頭份",20,0,20
"14394","6180橘子","110/07/16","元大-豐原站前",3,21,-18
"14395","6180橘子","110/07/16","富邦-台北",25,5,20
"14396","6180橘子","110/07/16","豐農",3,20,-17
"14397","6180橘子","110/07/16","富邦-員林",23,4,19
"14398","6180橘子","110/07/16","安泰-大發",0,17,-17
"14399","6180橘子","110/07/16","台新-新莊",20,2,18
"14400","6180橘子","110/07/16","群益金鼎",2,19,-17
"14401","2390云辰","110/07/16","兆豐-天母",642,7,635
"14402","2390云辰","110/07/16","凱基",0,5007,-5007
"14403","2390云辰","110/07/16","華南永昌-鳳山",339,35,304
"14404","2390云辰","110/07/16","凱基-台北",1224,2306,-1082
"14405","2390云辰","110/07/16","第一金-大稻埕",269,13,256
"14406","2390云辰","110/07/16","元大證券",206,1177,-971
"14407","2390云辰","110/07/16","國泰-敦南",665,427,238
"14408","2390云辰","110/07/16","摩根大通",1073,1967,-894
"14409","2390云辰","110/07/16","富邦-建國",272,50,222
"14410","2390云辰","110/07/16","台灣摩根士丹利",232,671,-439
"14411","2390云辰","110/07/16","元大-信義",180,15,165
"14412","2390云辰","110/07/16","美林",187,496,-309
"14413","2390云辰","110/07/16","瑞士信貸",155,0,155
"14414","2390云辰","110/07/16","港商野村",680,950,-270
"14415","2390云辰","110/07/16","台新證券",461,317,144
"14416","2390云辰","110/07/16","永豐金-中正",18,170,-152
"14417","2390云辰","110/07/16","兆豐-公益",148,11,137
"14418","2390云辰","110/07/16","元富-板橋",30,169,-139
"14419","2390云辰","110/07/16","元大-土城學府",197,61,136
"14420","2390云辰","110/07/16","新加坡商瑞銀",61,175,-114
"14421","2390云辰","110/07/16","元大-天母",232,122,110
"14422","2390云辰","110/07/16","聯邦商銀",54,167,-113
"14423","2390云辰","110/07/16","凱基-基隆",109,2,107
"14424","2390云辰","110/07/16","群益金鼎-大甲",13,111,-98
"14425","2390云辰","110/07/16","元富-成功",110,5,105
"14426","2390云辰","110/07/16","統一-屏東",4,92,-88
"14427","2390云辰","110/07/16","統一-新營",118,14,104
"14428","2390云辰","110/07/16","凱基-大直",3,80,-77
"14429","2390云辰","110/07/16","國泰-板橋",268,170,98
"14430","2390云辰","110/07/16","元大-桃興",46,117,-71
"14431","2363矽統","110/07/15","康和-台中",626,61,565
"14432","2363矽統","110/07/15","新加坡商瑞銀",202,838,-636
"14433","2363矽統","110/07/15","摩根大通",1271,932,339
"14434","2363矽統","110/07/15","美林",185,720,-535
"14435","2363矽統","110/07/15","瑞士信貸",530,230,300
"14436","2363矽統","110/07/15","富邦-仁愛",60,583,-523
"14437","2363矽統","110/07/15","宏遠-桃園",281,0,281
"14438","2363矽統","110/07/15","元大-板橋",35,368,-333
"14439","2363矽統","110/07/15","大展",252,19,233
"14440","2363矽統","110/07/15","花旗環球",0,308,-308
"14441","2363矽統","110/07/15","凱基-台北",683,498,185
"14442","2363矽統","110/07/15","元富-成功",2,113,-111
"14443","2363矽統","110/07/15","永豐金證券",166,11,155
"14444","2363矽統","110/07/15","富邦-新營",23,132,-109
"14445","2363矽統","110/07/15","群益金鼎",157,5,152
"14446","2363矽統","110/07/15","臺銀-金山",197,304,-107
"14447","2363矽統","110/07/15","新光",333,229,104
"14448","2363矽統","110/07/15","日盛-二林",13,116,-103
"14449","2363矽統","110/07/15","永豐金-台南",130,26,104
"14450","2363矽統","110/07/15","台新-左楠",40,126,-86
"14451","2363矽統","110/07/15","國票-南京",100,0,100
"14452","2363矽統","110/07/15","康和-南崁",15,100,-85
"14453","2363矽統","110/07/15","群益金鼎-松山",150,50,100
"14454","2363矽統","110/07/15","永豐金-員林",9,91,-82
"14455","2363矽統","110/07/15","中國信託-松江",103,5,98
"14456","2363矽統","110/07/15","光和-嘉義",5,78,-73
"14457","2363矽統","110/07/15","國票-新莊",187,92,95
"14458","2363矽統","110/07/15","日盛-板橋中山",3,73,-70
"14459","2363矽統","110/07/15","北城證券",216,126,90
"14460","2363矽統","110/07/15","元大證券",10,75,-65
"14461","8112至上","110/07/15","凱基-台北",535,32,503
"14462","8112至上","110/07/15","群益金鼎-台南",0,116,-116
"14463","8112至上","110/07/15","摩根大通",362,16,346
"14464","8112至上","110/07/15","華南永昌-高雄",2,112,-110
"14465","8112至上","110/07/15","台灣摩根士丹利",254,0,254
"14466","8112至上","110/07/15","永豐金-台南",27,128,-101
"14467","8112至上","110/07/15","花旗環球",159,0,159
"14468","8112至上","110/07/15","元大-東蘆",2,73,-71
"14469","8112至上","110/07/15","新加坡商瑞銀",95,2,93
"14470","8112至上","110/07/15","美林",3,66,-63
"14471","8112至上","110/07/15","玉山-嘉義",84,0,84
"14472","8112至上","110/07/15","元大-館前",0,62,-62
"14473","8112至上","110/07/15","新光",82,6,76
"14474","8112至上","110/07/15","元富-信義",0,50,-50
"14475","8112至上","110/07/15","瑞士信貸",80,7,73
"14476","8112至上","110/07/15","台新證券",35,82,-47
"14477","8112至上","110/07/15","美商高盛",64,0,64
"14478","8112至上","110/07/15","大慶-蘆洲",7,53,-46
"14479","8112至上","110/07/15","兆豐-小港",56,0,56
"14480","8112至上","110/07/15","國票-天祥",0,45,-45
"14481","8112至上","110/07/15","永豐金-內湖",60,11,49
"14482","8112至上","110/07/15","凱基-中山",1,45,-44
"14483","8112至上","110/07/15","永豐金-南投",46,1,45
"14484","8112至上","110/07/15","元大-士林",0,43,-43
"14485","8112至上","110/07/15","凱基-三重",40,0,40
"14486","8112至上","110/07/15","玉山-城中",4,44,-40
"14487","8112至上","110/07/15","台灣企銀",29,0,29
"14488","8112至上","110/07/15","凱基-彰化",0,39,-39
"14489","8112至上","110/07/15","元大-府城",42,14,28
"14490","8112至上","110/07/15","元富-花蓮",2,40,-38
"14491","1570力肯","110/07/15","群益金鼎-高雄",40,0,40
"14492","1570力肯","110/07/15","元大-高雄",0,12,-12
"14493","1570力肯","110/07/15","新光",40,8,32
"14494","1570力肯","110/07/15","永豐金-中正",0,10,-10
"14495","1570力肯","110/07/15","凱基-台北",20,2,18
"14496","1570力肯","110/07/15","國泰-松江",0,9,-9
"14497","1570力肯","110/07/15","凱基-天母",6,0,6
"14498","1570力肯","110/07/15","台新證券",0,8,-8
"14499","1570力肯","110/07/15","元富-新店",5,0,5
"14500","1570力肯","110/07/15","玉山證券",0,7,-7
"14501","1570力肯","110/07/15","凱基-中港",5,0,5
"14502","1570力肯","110/07/15","元大-府城",0,7,-7
"14503","1570力肯","110/07/15","富邦-園區",5,0,5
"14504","1570力肯","110/07/15","元大-板橋",0,6,-6
"14505","1570力肯","110/07/15","瑞士信貸",4,0,4
"14506","1570力肯","110/07/15","日盛-信義",0,5,-5
"14507","1570力肯","110/07/15","第一金-路竹",3,0,3
"14508","1570力肯","110/07/15","國票-和平",0,5,-5
"14509","1570力肯","110/07/15","摩根大通",3,0,3
"14510","1570力肯","110/07/15","元大-民雄",0,5,-5
"14511","1570力肯","110/07/15","凱基-桃園",3,0,3
"14512","1570力肯","110/07/15","統一-台中",0,4,-4
"14513","1570力肯","110/07/15","永豐金-苓雅",3,0,3
"14514","1570力肯","110/07/15","玉山-雙和",0,4,-4
"14515","1570力肯","110/07/15","統一-員林",2,0,2
"14516","1570力肯","110/07/15","凱基-敦北",0,4,-4
"14517","1570力肯","110/07/15","元大-永春",2,0,2
"14518","1570力肯","110/07/15","富邦-新店",0,4,-4
"14519","1570力肯","110/07/15","元大-土城永寧",2,0,2
"14520","1570力肯","110/07/15","日盛-板橋",0,3,-3
"14521","2929淘帝","110/07/15","港商野村",58,4,54
"14522","2929淘帝","110/07/15","日盛-園區",0,25,-25
"14523","2929淘帝","110/07/15","元大-民生",29,0,29
"14524","2929淘帝","110/07/15","兆豐-南京",0,20,-20
"14525","2929淘帝","110/07/15","新加坡商瑞銀",22,1,21
"14526","2929淘帝","110/07/15","玉山-高雄",0,18,-18
"14527","2929淘帝","110/07/15","凱基-台北",20,2,18
"14528","2929淘帝","110/07/15","富邦-南屯",1,15,-14
"14529","2929淘帝","110/07/15","大慶-中壢",15,1,14
"14530","2929淘帝","110/07/15","富邦-員林",0,13,-13
"14531","2929淘帝","110/07/15","日盛-和美",10,0,10
"14532","2929淘帝","110/07/15","凱基-站前",0,10,-10
"14533","2929淘帝","110/07/15","元大-員林",10,0,10
"14534","2929淘帝","110/07/15","元大-台中",0,10,-10
"14535","2929淘帝","110/07/15","凱基-基隆",6,0,6
"14536","2929淘帝","110/07/15","美林",10,19,-9
"14537","2929淘帝","110/07/15","臺銀-鳳山",5,0,5
"14538","2929淘帝","110/07/15","元大-新盛",0,8,-8
"14539","2929淘帝","110/07/15","第一金-路竹",5,0,5
"14540","2929淘帝","110/07/15","台新-台南",0,7,-7
"14541","2929淘帝","110/07/15","元富-大裕",5,0,5
"14542","2929淘帝","110/07/15","元大-大天母",0,7,-7
"14543","2929淘帝","110/07/15","玉山-大里",5,0,5
"14544","2929淘帝","110/07/15","華南永昌-虎尾",0,6,-6
"14545","2929淘帝","110/07/15","元大-博愛",5,0,5
"14546","2929淘帝","110/07/15","永豐金證券",0,6,-6
"14547","2929淘帝","110/07/15","永豐金-新莊",5,0,5
"14548","2929淘帝","110/07/15","兆豐-竹北",0,5,-5
"14549","2929淘帝","110/07/15","元大-南崁",4,0,4
"14550","2929淘帝","110/07/15","元大-文心興安",0,5,-5
"14551","5410國眾","110/07/15","香港上海匯豐",18,0,18
"14552","5410國眾","110/07/15","元大-南屯",0,18,-18
"14553","5410國眾","110/07/15","摩根大通",15,0,15
"14554","5410國眾","110/07/15","亞東-新竹",0,15,-15
"14555","5410國眾","110/07/15","日盛-士林",10,0,10
"14556","5410國眾","110/07/15","兆豐-台中港",0,15,-15
"14557","5410國眾","110/07/15","群益金鼎-嘉義",10,0,10
"14558","5410國眾","110/07/15","日盛-板橋",0,12,-12
"14559","5410國眾","110/07/15","元大-高雄",10,0,10
"14560","5410國眾","110/07/15","台中銀-豐原",0,9,-9
"14561","5410國眾","110/07/15","元大-東港",10,0,10
"14562","5410國眾","110/07/15","臺銀-臺南",3,10,-7
"14563","5410國眾","110/07/15","臺銀",10,5,5
"14564","5410國眾","110/07/15","瑞士信貸",0,5,-5
"14565","5410國眾","110/07/15","台新-新營",5,0,5
"14566","5410國眾","110/07/15","統一-員林",0,5,-5
"14567","5410國眾","110/07/15","富邦-台北",5,0,5
"14568","5410國眾","110/07/15","大昌-樹林",0,5,-5
"14569","5410國眾","110/07/15","日盛-屏東",4,0,4
"14570","5410國眾","110/07/15","兆豐-來福",0,5,-5
"14571","5410國眾","110/07/15","高橋",5,1,4
"14572","5410國眾","110/07/15","豐農",0,5,-5
"14573","5410國眾","110/07/15","中國信託-新竹",4,1,3
"14574","5410國眾","110/07/15","元大-大里",0,5,-5
"14575","5410國眾","110/07/15","富邦-建國",3,0,3
"14576","5410國眾","110/07/15","港商野村",0,3,-3
"14577","5410國眾","110/07/15","永豐金-桃園",3,0,3
"14578","5410國眾","110/07/15","中農",0,3,-3
"14579","5410國眾","110/07/15","大展",2,0,2
"14580","5410國眾","110/07/15","國泰-忠孝",0,3,-3
"14581","2841台開","110/07/15","日盛證券",310,0,310
"14582","2841台開","110/07/15","港商野村",0,97,-97
"14583","2841台開","110/07/15","元富-城東",100,0,100
"14584","2841台開","110/07/15","元大-員林",0,77,-77
"14585","2841台開","110/07/15","凱基-文心",30,0,30
"14586","2841台開","110/07/15","新光",3,73,-70
"14587","2841台開","110/07/15","日盛-雙和",24,0,24
"14588","2841台開","110/07/15","永豐金-北高雄",0,30,-30
"14589","2841台開","110/07/15","第一金-台中",20,0,20
"14590","2841台開","110/07/15","華南永昌",0,25,-25
"14591","2841台開","110/07/15","豐農",20,0,20
"14592","2841台開","110/07/15","日盛-台南",0,20,-20
"14593","2841台開","110/07/15","華南永昌-新莊",19,0,19
"14594","2841台開","110/07/15","致和-佳里",0,20,-20
"14595","2841台開","110/07/15","玉山-大里",12,0,12
"14596","2841台開","110/07/15","國票-中港",0,20,-20
"14597","2841台開","110/07/15","元富-安南",10,0,10
"14598","2841台開","110/07/15","元大-歸仁",0,20,-20
"14599","2841台開","110/07/15","凱基-市政",10,0,10
"14600","2841台開","110/07/15","統一-三多",0,19,-19
"14601","2841台開","110/07/15","凱基-竹科",10,0,10
"14602","2841台開","110/07/15","凱基-城中",0,18,-18
"14603","2841台開","110/07/15","國泰-板橋",10,1,9
"14604","2841台開","110/07/15","國票-中和",0,15,-15
"14605","2841台開","110/07/15","凱基-台北",9,0,9
"14606","2841台開","110/07/15","元大-彰化",0,15,-15
"14607","2841台開","110/07/15","合庫證券",6,0,6
"14608","2841台開","110/07/15","元大-復北",0,15,-15
"14609","2841台開","110/07/15","台中銀",6,0,6
"14610","2841台開","110/07/15","土銀-花蓮",0,14,-14
"14611","6207雷科","110/07/15","凱基-板橋",210,45,165
"14612","6207雷科","110/07/15","群益金鼎-台北",20,80,-60
"14613","6207雷科","110/07/15","富邦證券",150,0,150
"14614","6207雷科","110/07/15","元大-大天母",1,56,-55
"14615","6207雷科","110/07/15","凱基-復興",140,0,140
"14616","6207雷科","110/07/15","大慶-中壢",2,50,-48
"14617","6207雷科","110/07/15","華南永昌-中正",140,0,140
"14618","6207雷科","110/07/15","元富-林園",0,47,-47
"14619","6207雷科","110/07/15","永豐金-內湖",92,10,82
"14620","6207雷科","110/07/15","元大-東門",0,40,-40
"14621","6207雷科","110/07/15","富邦-彰化",81,11,70
"14622","6207雷科","110/07/15","第一金-安和",0,37,-37
"14623","6207雷科","110/07/15","(牛牛牛)亞-網路",67,0,67
"14624","6207雷科","110/07/15","凱基-台北",61,97,-36
"14625","6207雷科","110/07/15","台新證券",60,8,52
"14626","6207雷科","110/07/15","國票-南科",0,32,-32
"14627","6207雷科","110/07/15","華南永昌",50,3,47
"14628","6207雷科","110/07/15","元大-四維",0,32,-32
"14629","6207雷科","110/07/15","新加坡商瑞銀",68,26,42
"14630","6207雷科","110/07/15","元大-板橋",0,30,-30
"14631","6207雷科","110/07/15","日盛-景美",40,0,40
"14632","6207雷科","110/07/15","元大-南崁",1,30,-29
"14633","6207雷科","110/07/15","元富-大昌",40,0,40
"14634","6207雷科","110/07/15","凱基-岡山",0,27,-27
"14635","6207雷科","110/07/15","統一-高雄",38,5,33
"14636","6207雷科","110/07/15","統一-新竹",0,26,-26
"14637","6207雷科","110/07/15","日盛證券",32,0,32
"14638","6207雷科","110/07/15","群益金鼎-三民",1,27,-26
"14639","6207雷科","110/07/15","華南永昌-頭份",31,0,31
"14640","6207雷科","110/07/15","國票-台中",0,25,-25
"14641","3679新至陞","110/07/15","群益金鼎-大安",25,0,25
"14642","3679新至陞","110/07/15","元大-成功",0,10,-10
"14643","3679新至陞","110/07/15","元大-彰化",13,0,13
"14644","3679新至陞","110/07/15","群益金鼎-東大",0,8,-8
"14645","3679新至陞","110/07/15","國票-桃園",10,0,10
"14646","3679新至陞","110/07/15","凱基-台北",4,12,-8
"14647","3679新至陞","110/07/15","群益金鼎-台南",10,0,10
"14648","3679新至陞","110/07/15","第一金-華江",0,5,-5
"14649","3679新至陞","110/07/15","華南永昌-台中",10,0,10
"14650","3679新至陞","110/07/15","兆豐-來福",0,5,-5
"14651","3679新至陞","110/07/15","港商野村",9,0,9
"14652","3679新至陞","110/07/15","元大-北三重",0,5,-5
"14653","3679新至陞","110/07/15","元大-永春",6,0,6
"14654","3679新至陞","110/07/15","瑞士信貸",0,4,-4
"14655","3679新至陞","110/07/15","(牛牛牛)亞-網路",5,0,5
"14656","3679新至陞","110/07/15","新加坡商瑞銀",0,4,-4
"14657","3679新至陞","110/07/15","凱基-高雄",5,0,5
"14658","3679新至陞","110/07/15","元大-汐止",0,4,-4
"14659","3679新至陞","110/07/15","美商高盛",6,2,4
"14660","3679新至陞","110/07/15","台中銀-員林",0,3,-3
"14661","3679新至陞","110/07/15","台新證券",3,1,2
"14662","3679新至陞","110/07/15","兆豐-忠孝",0,3,-3
"14663","3679新至陞","110/07/15","群益金鼎-大興",2,0,2
"14664","3679新至陞","110/07/15","玉山-新莊",0,3,-3
"14665","3679新至陞","110/07/15","元大-六合",2,0,2
"14666","3679新至陞","110/07/15","永豐金-屏東",0,3,-3
"14667","3679新至陞","110/07/15","彰銀",1,0,1
"14668","3679新至陞","110/07/15","永豐金-敦南",0,3,-3
"14669","3679新至陞","110/07/15","美林",2,1,1
"14670","3679新至陞","110/07/15","永豐金-萬盛",0,3,-3
"14671","2727王品","110/07/15","兆豐-南京",101,0,101
"14672","2727王品","110/07/15","富邦-左營",0,102,-102
"14673","2727王品","110/07/15","港商野村",166,73,93
"14674","2727王品","110/07/15","日盛-忠孝",2,32,-30
"14675","2727王品","110/07/15","瑞士信貸",97,8,89
"14676","2727王品","110/07/15","群益金鼎-古亭",2,24,-22
"14677","2727王品","110/07/15","玉山證券",56,12,44
"14678","2727王品","110/07/15","日盛-八德",0,21,-21
"14679","2727王品","110/07/15","第一金-高雄",43,1,42
"14680","2727王品","110/07/15","元大-新盛",2,23,-21
"14681","2727王品","110/07/15","台新證券",74,45,29
"14682","2727王品","110/07/15","摩根大通",53,72,-19
"14683","2727王品","110/07/15","康和-澎湖",27,0,27
"14684","2727王品","110/07/15","富邦-彰化",8,26,-18
"14685","2727王品","110/07/15","富邦-陽明",31,4,27
"14686","2727王品","110/07/15","富邦-台中",7,24,-17
"14687","2727王品","110/07/15","國票-北高雄",27,1,26
"14688","2727王品","110/07/15","新加坡商瑞銀",13,29,-16
"14689","2727王品","110/07/15","國泰-板橋",38,12,26
"14690","2727王品","110/07/15","國泰-敦南",35,50,-15
"14691","2727王品","110/07/15","凱基-興隆",23,0,23
"14692","2727王品","110/07/15","元大-龍潭",0,14,-14
"14693","2727王品","110/07/15","凱基-板橋",29,7,22
"14694","2727王品","110/07/15","中國信託-文心",8,21,-13
"14695","2727王品","110/07/15","合庫-彰化",21,0,21
"14696","2727王品","110/07/15","永豐金-竹科",2,15,-13
"14697","2727王品","110/07/15","土銀-南港",20,0,20
"14698","2727王品","110/07/15","臺銀-臺南",2,14,-12
"14699","2727王品","110/07/15","美林",37,18,19
"14700","2727王品","110/07/15","凱基-台北",56,68,-12
"14701","1570力肯","110/07/15","群益金鼎-高雄",40,0,40
"14702","1570力肯","110/07/15","元大-高雄",0,12,-12
"14703","1570力肯","110/07/15","新光",40,8,32
"14704","1570力肯","110/07/15","永豐金-中正",0,10,-10
"14705","1570力肯","110/07/15","凱基-台北",20,2,18
"14706","1570力肯","110/07/15","國泰-松江",0,9,-9
"14707","1570力肯","110/07/15","凱基-天母",6,0,6
"14708","1570力肯","110/07/15","台新證券",0,8,-8
"14709","1570力肯","110/07/15","元富-新店",5,0,5
"14710","1570力肯","110/07/15","玉山證券",0,7,-7
"14711","1570力肯","110/07/15","凱基-中港",5,0,5
"14712","1570力肯","110/07/15","元大-府城",0,7,-7
"14713","1570力肯","110/07/15","富邦-園區",5,0,5
"14714","1570力肯","110/07/15","元大-板橋",0,6,-6
"14715","1570力肯","110/07/15","瑞士信貸",4,0,4
"14716","1570力肯","110/07/15","日盛-信義",0,5,-5
"14717","1570力肯","110/07/15","第一金-路竹",3,0,3
"14718","1570力肯","110/07/15","國票-和平",0,5,-5
"14719","1570力肯","110/07/15","摩根大通",3,0,3
"14720","1570力肯","110/07/15","元大-民雄",0,5,-5
"14721","1570力肯","110/07/15","凱基-桃園",3,0,3
"14722","1570力肯","110/07/15","統一-台中",0,4,-4
"14723","1570力肯","110/07/15","永豐金-苓雅",3,0,3
"14724","1570力肯","110/07/15","玉山-雙和",0,4,-4
"14725","1570力肯","110/07/15","統一-員林",2,0,2
"14726","1570力肯","110/07/15","凱基-敦北",0,4,-4
"14727","1570力肯","110/07/15","元大-永春",2,0,2
"14728","1570力肯","110/07/15","富邦-新店",0,4,-4
"14729","1570力肯","110/07/15","元大-土城永寧",2,0,2
"14730","1570力肯","110/07/15","日盛-板橋",0,3,-3
"14731","6180橘子","110/07/15","兆豐證券",130,0,130
"14732","6180橘子","110/07/15","港商野村",21,137,-116
"14733","6180橘子","110/07/15","摩根大通",111,0,111
"14734","6180橘子","110/07/15","高橋",0,40,-40
"14735","6180橘子","110/07/15","石橋證券",80,0,80
"14736","6180橘子","110/07/15","臺銀",1,40,-39
"14737","6180橘子","110/07/15","凱基-台北",78,26,52
"14738","6180橘子","110/07/15","玉山-桃園",0,35,-35
"14739","6180橘子","110/07/15","新加坡商瑞銀",38,1,37
"14740","6180橘子","110/07/15","玉山-台南",2,33,-31
"14741","6180橘子","110/07/15","富邦-員林",32,0,32
"14742","6180橘子","110/07/15","統一-南京",0,30,-30
"14743","6180橘子","110/07/15","日盛-文化",23,0,23
"14744","6180橘子","110/07/15","康和-台南",0,25,-25
"14745","6180橘子","110/07/15","元富-新店",20,0,20
"14746","6180橘子","110/07/15","大昌-樹林",0,22,-22
"14747","6180橘子","110/07/15","美林",15,0,15
"14748","6180橘子","110/07/15","康和-新竹",0,20,-20
"14749","6180橘子","110/07/15","新光-新竹",17,2,15
"14750","6180橘子","110/07/15","群益金鼎-台中",0,20,-20
"14751","6180橘子","110/07/15","富邦-嘉義",12,0,12
"14752","6180橘子","110/07/15","元大-彰化民生",0,18,-18
"14753","6180橘子","110/07/15","花旗環球",11,0,11
"14754","6180橘子","110/07/15","元大-草屯",0,16,-16
"14755","6180橘子","110/07/15","第一金-新興",11,0,11
"14756","6180橘子","110/07/15","元富-潮州",0,13,-13
"14757","6180橘子","110/07/15","第一金-桃園",10,0,10
"14758","6180橘子","110/07/15","宏遠-台南",0,11,-11
"14759","6180橘子","110/07/15","永興",10,0,10
"14760","6180橘子","110/07/15","大慶-泰山",0,10,-10
"14761","2390云辰","110/07/15","凱基",5007,0,5007
"14762","2390云辰","110/07/15","凱基-台北",382,616,-234
"14763","2390云辰","110/07/15","元大證券",1006,25,981
"14764","2390云辰","110/07/15","富邦-陽明",69,265,-196
"14765","2390云辰","110/07/15","元大-天母",456,20,436
"14766","2390云辰","110/07/15","永豐金-桃園",63,255,-192
"14767","2390云辰","110/07/15","港商野村",975,675,300
"14768","2390云辰","110/07/15","富邦-仁愛",17,187,-170
"14769","2390云辰","110/07/15","摩根大通",1318,1040,278
"14770","2390云辰","110/07/15","日盛-和美",2,165,-163
"14771","2390云辰","110/07/15","國票-博愛",184,7,177
"14772","2390云辰","110/07/15","國泰-敦南",142,290,-148
"14773","2390云辰","110/07/15","群益金鼎-大甲",113,13,100
"14774","2390云辰","110/07/15","台灣摩根士丹利",51,197,-146
"14775","2390云辰","110/07/15","凱基-大直",89,2,87
"14776","2390云辰","110/07/15","國票-嘉義",4,148,-144
"14777","2390云辰","110/07/15","玉山-台中",77,8,69
"14778","2390云辰","110/07/15","台中銀",8,139,-131
"14779","2390云辰","110/07/15","聯邦商銀",70,4,66
"14780","2390云辰","110/07/15","元大-彰化民生",7,138,-131
"14781","2390云辰","110/07/15","元大-大里",88,25,63
"14782","2390云辰","110/07/15","元富-成功",2,111,-109
"14783","2390云辰","110/07/15","富邦-嘉義",542,480,62
"14784","2390云辰","110/07/15","元大-東泰",3,106,-103
"14785","2390云辰","110/07/15","新加坡商瑞銀",158,97,61
"14786","2390云辰","110/07/15","合庫-三重",1,102,-101
"14787","2390云辰","110/07/15","華南永昌-台中",86,35,51
"14788","2390云辰","110/07/15","元富-大裕",4,87,-83
"14789","2390云辰","110/07/15","群益金鼎",51,6,45
"14790","2390云辰","110/07/15","凱基-和平",17,96,-79
"14791","2363矽統","110/07/14","台灣摩根士丹利",463,0,463
"14792","2363矽統","110/07/14","新加坡商瑞銀",568,1321,-753
"14793","2363矽統","110/07/14","台新證券",750,342,408
"14794","2363矽統","110/07/14","瑞士信貸",149,864,-715
"14795","2363矽統","110/07/14","玉山-台中",363,51,312
"14796","2363矽統","110/07/14","台新-屏東",115,380,-265
"14797","2363矽統","110/07/14","元大-斗六",223,25,198
"14798","2363矽統","110/07/14","永豐金證券",16,265,-249
"14799","2363矽統","110/07/14","華南永昌-朴子",208,38,170
"14800","2363矽統","110/07/14","美林",462,701,-239
"14801","2363矽統","110/07/14","元富-西松",169,12,157
"14802","2363矽統","110/07/14","宏遠-桃園",269,500,-231
"14803","2363矽統","110/07/14","永豐金-大園",146,6,140
"14804","2363矽統","110/07/14","凱基-竹北",36,254,-218
"14805","2363矽統","110/07/14","土銀-和平",134,0,134
"14806","2363矽統","110/07/14","港商法國興業",0,214,-214
"14807","2363矽統","110/07/14","富邦-新營",130,13,117
"14808","2363矽統","110/07/14","港商野村",835,1044,-209
"14809","2363矽統","110/07/14","元富-成功",118,11,107
"14810","2363矽統","110/07/14","北城證券",212,411,-199
"14811","2363矽統","110/07/14","元富-烏日",121,18,103
"14812","2363矽統","110/07/14","(牛牛牛)亞-鑫豐",51,241,-190
"14813","2363矽統","110/07/14","日盛-二林",120,18,102
"14814","2363矽統","110/07/14","國票-博愛",24,213,-189
"14815","2363矽統","110/07/14","兆豐-忠孝",98,2,96
"14816","2363矽統","110/07/14","大慶-蘆洲",134,316,-182
"14817","2363矽統","110/07/14","大慶-楊梅",92,3,89
"14818","2363矽統","110/07/14","彰銀-台中",15,193,-178
"14819","2363矽統","110/07/14","元富-三重",120,33,87
"14820","2363矽統","110/07/14","日盛-和美",18,185,-167
"14821","8112至上","110/07/14","新加坡商瑞銀",223,17,206
"14822","8112至上","110/07/14","瑞士信貸",8,170,-162
"14823","8112至上","110/07/14","摩根大通",285,129,156
"14824","8112至上","110/07/14","美林",55,202,-147
"14825","8112至上","110/07/14","花旗環球",124,0,124
"14826","8112至上","110/07/14","凱基-台北",325,436,-111
"14827","8112至上","110/07/14","兆豐-公益",117,4,113
"14828","8112至上","110/07/14","台中銀-台北",0,98,-98
"14829","8112至上","110/07/14","香港上海匯豐",111,0,111
"14830","8112至上","110/07/14","玉山-台大",17,107,-90
"14831","8112至上","110/07/14","永豐金-內湖",117,21,96
"14832","8112至上","110/07/14","康和-內湖",1,90,-89
"14833","8112至上","110/07/14","台灣摩根士丹利",108,16,92
"14834","8112至上","110/07/14","港商野村",21,84,-63
"14835","8112至上","110/07/14","元大-東蘆",77,0,77
"14836","8112至上","110/07/14","兆豐-北高雄",1,60,-59
"14837","8112至上","110/07/14","新光",108,48,60
"14838","8112至上","110/07/14","群益金鼎-海山",1,52,-51
"14839","8112至上","110/07/14","大慶-蘆洲",59,0,59
"14840","8112至上","110/07/14","群益金鼎-大安",0,50,-50
"14841","8112至上","110/07/14","華南永昌-台中",56,3,53
"14842","8112至上","110/07/14","富邦-仁愛",2,49,-47
"14843","8112至上","110/07/14","土銀-嘉義",52,2,50
"14844","8112至上","110/07/14","元大-金華",0,42,-42
"14845","8112至上","110/07/14","美商高盛",40,0,40
"14846","8112至上","110/07/14","元大-內湖",4,43,-39
"14847","8112至上","110/07/14","臺銀",63,29,34
"14848","8112至上","110/07/14","第一金-華江",2,37,-35
"14849","8112至上","110/07/14","元富-嘉義",31,0,31
"14850","8112至上","110/07/14","永豐金-苓雅",2,34,-32
"14851","1570力肯","110/07/14","國票-北高雄",68,0,68
"14852","1570力肯","110/07/14","摩根大通",0,21,-21
"14853","1570力肯","110/07/14","日盛-八德",30,1,29
"14854","1570力肯","110/07/14","新光",1,19,-18
"14855","1570力肯","110/07/14","玉山-高雄",7,0,7
"14856","1570力肯","110/07/14","(牛牛牛)亞-鑫豐",0,17,-17
"14857","1570力肯","110/07/14","臺銀-臺南",5,0,5
"14858","1570力肯","110/07/14","日盛-士林",0,10,-10
"14859","1570力肯","110/07/14","凱基-三峽",5,0,5
"14860","1570力肯","110/07/14","統一-員林",0,10,-10
"14861","1570力肯","110/07/14","元大-和平",5,0,5
"14862","1570力肯","110/07/14","國票-新莊",0,10,-10
"14863","1570力肯","110/07/14","合庫-三重",4,0,4
"14864","1570力肯","110/07/14","凱基-高美館",0,10,-10
"14865","1570力肯","110/07/14","瑞士信貸",4,0,4
"14866","1570力肯","110/07/14","元大-屏東民生",0,5,-5
"14867","1570力肯","110/07/14","統一-三多",4,0,4
"14868","1570力肯","110/07/14","元大-古亭",0,5,-5
"14869","1570力肯","110/07/14","華南永昌-古亭",4,0,4
"14870","1570力肯","110/07/14","日盛-木柵",0,4,-4
"14871","1570力肯","110/07/14","元大-高雄",3,0,3
"14872","1570力肯","110/07/14","大昌",0,4,-4
"14873","1570力肯","110/07/14","兆豐-忠孝",2,0,2
"14874","1570力肯","110/07/14","群益金鼎-東大",0,4,-4
"14875","1570力肯","110/07/14","富邦-陽明",2,0,2
"14876","1570力肯","110/07/14","凱基-台北",0,4,-4
"14877","1570力肯","110/07/14","元大-松山",2,0,2
"14878","1570力肯","110/07/14","元大-板橋",0,4,-4
"14879","1570力肯","110/07/14","元大-忠孝",2,0,2
"14880","1570力肯","110/07/14","第一金-中山",0,3,-3
"14881","2929淘帝","110/07/14","華南永昌-林口",60,0,60
"14882","2929淘帝","110/07/14","群益金鼎",25,540,-515
"14883","2929淘帝","110/07/14","美林",87,31,56
"14884","2929淘帝","110/07/14","國泰-台南",1,30,-29
"14885","2929淘帝","110/07/14","元富-台南",40,0,40
"14886","2929淘帝","110/07/14","宏遠-桃園",0,20,-20
"14887","2929淘帝","110/07/14","元大-民生",39,0,39
"14888","2929淘帝","110/07/14","摩根大通",11,31,-20
"14889","2929淘帝","110/07/14","臺銀-鳳山",34,0,34
"14890","2929淘帝","110/07/14","台新-建北",5,20,-15
"14891","2929淘帝","110/07/14","合庫-高雄",34,1,33
"14892","2929淘帝","110/07/14","新光",1,16,-15
"14893","2929淘帝","110/07/14","華南永昌-鶯歌",28,0,28
"14894","2929淘帝","110/07/14","玉山-板橋",0,15,-15
"14895","2929淘帝","110/07/14","永興",25,0,25
"14896","2929淘帝","110/07/14","凱基-羅東",0,15,-15
"14897","2929淘帝","110/07/14","元大-新盛",25,1,24
"14898","2929淘帝","110/07/14","元大-頭份",0,15,-15
"14899","2929淘帝","110/07/14","日盛-南京",23,0,23
"14900","2929淘帝","110/07/14","第一金-台南",0,13,-13
"14901","2929淘帝","110/07/14","日茂",20,0,20
"14902","2929淘帝","110/07/14","富邦-基隆",0,12,-12
"14903","2929淘帝","110/07/14","台新-台中",20,0,20
"14904","2929淘帝","110/07/14","日茂-南投",1,12,-11
"14905","2929淘帝","110/07/14","華南永昌",20,0,20
"14906","2929淘帝","110/07/14","元大-豐原站前",0,11,-11
"14907","2929淘帝","110/07/14","福勝",15,0,15
"14908","2929淘帝","110/07/14","玉山-士林",0,10,-10
"14909","2929淘帝","110/07/14","富邦-南屯",15,0,15
"14910","2929淘帝","110/07/14","富邦-台北",0,10,-10
"14911","5410國眾","110/07/14","兆豐-城中",35,0,35
"14912","5410國眾","110/07/14","瑞士信貸",0,29,-29
"14913","5410國眾","110/07/14","新光",21,1,20
"14914","5410國眾","110/07/14","國泰-板橋",1,30,-29
"14915","5410國眾","110/07/14","國泰-敦南",21,1,20
"14916","5410國眾","110/07/14","日盛-高雄",0,20,-20
"14917","5410國眾","110/07/14","國泰-台中",20,1,19
"14918","5410國眾","110/07/14","台新-左楠",1,20,-19
"14919","5410國眾","110/07/14","元大-崇德",19,0,19
"14920","5410國眾","110/07/14","元富-大昌",1,18,-17
"14921","5410國眾","110/07/14","土銀-士林",18,0,18
"14922","5410國眾","110/07/14","富邦-建國",0,15,-15
"14923","5410國眾","110/07/14","元大-新盛",20,2,18
"14924","5410國眾","110/07/14","元富-嘉義",0,12,-12
"14925","5410國眾","110/07/14","兆豐-高雄",15,0,15
"14926","5410國眾","110/07/14","永全-南崁",0,12,-12
"14927","5410國眾","110/07/14","宏遠-中和",10,0,10
"14928","5410國眾","110/07/14","元大-員林",0,11,-11
"14929","5410國眾","110/07/14","新光-桃園",10,0,10
"14930","5410國眾","110/07/14","高橋",0,10,-10
"14931","5410國眾","110/07/14","國泰-台南",10,0,10
"14932","5410國眾","110/07/14","永興",0,10,-10
"14933","5410國眾","110/07/14","元大-復北",10,0,10
"14934","5410國眾","110/07/14","華南永昌-三重",0,10,-10
"14935","5410國眾","110/07/14","元大-竹科",8,0,8
"14936","5410國眾","110/07/14","元大-苑裡",0,7,-7
"14937","5410國眾","110/07/14","台新-新營",6,0,6
"14938","5410國眾","110/07/14","港商野村",0,6,-6
"14939","5410國眾","110/07/14","日盛-士林",5,0,5
"14940","5410國眾","110/07/14","摩根大通",5,11,-6
"14941","2841台開","110/07/14","凱基-文心",73,0,73
"14942","2841台開","110/07/14","國泰-敦南",0,50,-50
"14943","2841台開","110/07/14","元富-潮州",30,0,30
"14944","2841台開","110/07/14","凱基-中壢",0,40,-40
"14945","2841台開","110/07/14","第一金-台中",20,0,20
"14946","2841台開","110/07/14","統一-新竹",0,24,-24
"14947","2841台開","110/07/14","華南永昌-新莊",20,0,20
"14948","2841台開","110/07/14","元富-草屯",0,20,-20
"14949","2841台開","110/07/14","永豐金-豐原",20,0,20
"14950","2841台開","110/07/14","台新-台南",0,20,-20
"14951","2841台開","110/07/14","國泰-館前",15,0,15
"14952","2841台開","110/07/14","永豐金-敦南",45,63,-18
"14953","2841台開","110/07/14","群益金鼎-基隆",12,0,12
"14954","2841台開","110/07/14","國票-北高雄",0,13,-13
"14955","2841台開","110/07/14","日盛-信義",10,0,10
"14956","2841台開","110/07/14","凱基-松山",0,10,-10
"14957","2841台開","110/07/14","台新-台中",10,0,10
"14958","2841台開","110/07/14","元大證券",0,10,-10
"14959","2841台開","110/07/14","新光",10,1,9
"14960","2841台開","110/07/14","元大-中壢",0,10,-10
"14961","2841台開","110/07/14","凱基-新店",8,0,8
"14962","2841台開","110/07/14","富邦-陽明",1,10,-9
"14963","2841台開","110/07/14","元大-斗信",7,0,7
"14964","2841台開","110/07/14","富邦-建國",0,9,-9
"14965","2841台開","110/07/14","元大-三重",6,0,6
"14966","2841台開","110/07/14","富邦-台南",0,8,-8
"14967","2841台開","110/07/14","永豐金-中和",6,0,6
"14968","2841台開","110/07/14","康和-澎湖",0,7,-7
"14969","2841台開","110/07/14","元富-成功",5,0,5
"14970","2841台開","110/07/14","日盛-斗六",0,6,-6
"14971","6207雷科","110/07/14","群益金鼎-台北",60,0,60
"14972","6207雷科","110/07/14","新加坡商瑞銀",10,56,-46
"14973","6207雷科","110/07/14","台新-高雄",43,3,40
"14974","6207雷科","110/07/14","國票-中和",0,41,-41
"14975","6207雷科","110/07/14","元大-高雄",19,0,19
"14976","6207雷科","110/07/14","元大-復北",0,33,-33
"14977","6207雷科","110/07/14","福勝",15,0,15
"14978","6207雷科","110/07/14","光和-和美",0,20,-20
"14979","6207雷科","110/07/14","群益金鼎-中山",15,0,15
"14980","6207雷科","110/07/14","群益金鼎-丹鳳",0,20,-20
"14981","6207雷科","110/07/14","元大-林園",15,0,15
"14982","6207雷科","110/07/14","第一金-路竹",0,10,-10
"14983","6207雷科","110/07/14","新光",12,0,12
"14984","6207雷科","110/07/14","元大-歸仁",0,10,-10
"14985","6207雷科","110/07/14","元大-大天母",10,0,10
"14986","6207雷科","110/07/14","宏遠-館前",0,9,-9
"14987","6207雷科","110/07/14","永豐金-忠孝",9,0,9
"14988","6207雷科","110/07/14","凱基-台北",12,20,-8
"14989","6207雷科","110/07/14","永豐金-新店",7,0,7
"14990","6207雷科","110/07/14","美林",0,7,-7
"14991","6207雷科","110/07/14","玉山-嘉義",6,0,6
"14992","6207雷科","110/07/14","摩根大通",16,23,-7
"14993","6207雷科","110/07/14","元大-屏東",6,0,6
"14994","6207雷科","110/07/14","凱基-高雄",1,7,-6
"14995","6207雷科","110/07/14","凱基-大安",5,0,5
"14996","6207雷科","110/07/14","台中銀-豐原",0,5,-5
"14997","6207雷科","110/07/14","富邦-台南",5,0,5
"14998","6207雷科","110/07/14","元大-新竹經國",0,5,-5
"14999","6207雷科","110/07/14","元大-成功",5,0,5
"15000","6207雷科","110/07/14","光和-田中",0,4,-4
"15001","3679新至陞","110/07/14","凱基-台北",31,6,25
"15002","3679新至陞","110/07/14","群益金鼎-東大",0,15,-15
"15003","3679新至陞","110/07/14","華南永昌-新莊",10,0,10
"15004","3679新至陞","110/07/14","瑞士信貸",0,12,-12
"15005","3679新至陞","110/07/14","新加坡商瑞銀",11,3,8
"15006","3679新至陞","110/07/14","群益金鼎-永和",0,10,-10
"15007","3679新至陞","110/07/14","美商高盛",6,0,6
"15008","3679新至陞","110/07/14","元大-成功",5,15,-10
"15009","3679新至陞","110/07/14","第一金-中壢",6,0,6
"15010","3679新至陞","110/07/14","統一-板橋",1,10,-9
"15011","3679新至陞","110/07/14","(牛牛牛)亞-網路",4,0,4
"15012","3679新至陞","110/07/14","玉山-左營",0,5,-5
"15013","3679新至陞","110/07/14","元大-六合",3,0,3
"15014","3679新至陞","110/07/14","群益金鼎-三民",0,4,-4
"15015","3679新至陞","110/07/14","合庫-自強",2,0,2
"15016","3679新至陞","110/07/14","富邦-宜蘭",0,4,-4
"15017","3679新至陞","110/07/14","高橋-內壢",2,0,2
"15018","3679新至陞","110/07/14","永豐金-苓雅",0,3,-3
"15019","3679新至陞","110/07/14","台中銀-員林",2,0,2
"15020","3679新至陞","110/07/14","摩根大通",5,7,-2
"15021","3679新至陞","110/07/14","凱基-高美館",2,0,2
"15022","3679新至陞","110/07/14","元大-板橋三民",0,2,-2
"15023","3679新至陞","110/07/14","元大-福營",2,0,2
"15024","3679新至陞","110/07/14","宏遠-中和",0,1,-1
"15025","3679新至陞","110/07/14","永豐金-松山",2,0,2
"15026","3679新至陞","110/07/14","元富-佳里",0,1,-1
"15027","3679新至陞","110/07/14","永豐金-萬盛",2,0,2
"15028","3679新至陞","110/07/14","(牛牛牛)亞-鑫豐",0,1,-1
"15029","3679新至陞","110/07/14","元富-松德",1,0,1
"15030","3679新至陞","110/07/14","中國信託-中壢",0,1,-1
"15031","2727王品","110/07/14","富邦-左營",102,1,101
"15032","2727王品","110/07/14","統一-城中",100,234,-134
"15033","2727王品","110/07/14","國泰-板橋",105,11,94
"15034","2727王品","110/07/14","富邦-台北",1,125,-124
"15035","2727王品","110/07/14","港商野村",149,72,77
"15036","2727王品","110/07/14","台灣摩根士丹利",1,48,-47
"15037","2727王品","110/07/14","合庫-台中",66,2,64
"15038","2727王品","110/07/14","國票-新莊",0,40,-40
"15039","2727王品","110/07/14","臺銀-金山",63,8,55
"15040","2727王品","110/07/14","永豐金-忠孝",2,39,-37
"15041","2727王品","110/07/14","摩根大通",83,39,44
"15042","2727王品","110/07/14","富邦-彰化",1,34,-33
"15043","2727王品","110/07/14","凱基-台北",84,42,42
"15044","2727王品","110/07/14","康和-高雄",0,30,-30
"15045","2727王品","110/07/14","土銀-台中",35,1,34
"15046","2727王品","110/07/14","安泰",0,26,-26
"15047","2727王品","110/07/14","華南永昌-麻豆",32,1,31
"15048","2727王品","110/07/14","富邦-新竹華信",0,21,-21
"15049","2727王品","110/07/14","元大證券",85,55,30
"15050","2727王品","110/07/14","元大-南崁",1,22,-21
"15051","2727王品","110/07/14","新加坡商瑞銀",40,15,25
"15052","2727王品","110/07/14","彰銀-台中",0,18,-18
"15053","2727王品","110/07/14","日盛-八德",19,0,19
"15054","2727王品","110/07/14","元富-同大",2,20,-18
"15055","2727王品","110/07/14","統一",35,17,18
"15056","2727王品","110/07/14","玉山-嘉義",1,17,-16
"15057","2727王品","110/07/14","元富-大昌",18,1,17
"15058","2727王品","110/07/14","國泰-館前",4,20,-16
"15059","2727王品","110/07/14","玉山-板橋",15,1,14
"15060","2727王品","110/07/14","第一金-嘉義",1,13,-12
"15061","1570力肯","110/07/14","國票-北高雄",68,0,68
"15062","1570力肯","110/07/14","摩根大通",0,21,-21
"15063","1570力肯","110/07/14","日盛-八德",30,1,29
"15064","1570力肯","110/07/14","新光",1,19,-18
"15065","1570力肯","110/07/14","玉山-高雄",7,0,7
"15066","1570力肯","110/07/14","(牛牛牛)亞-鑫豐",0,17,-17
"15067","1570力肯","110/07/14","臺銀-臺南",5,0,5
"15068","1570力肯","110/07/14","日盛-士林",0,10,-10
"15069","1570力肯","110/07/14","凱基-三峽",5,0,5
"15070","1570力肯","110/07/14","統一-員林",0,10,-10
"15071","1570力肯","110/07/14","元大-和平",5,0,5
"15072","1570力肯","110/07/14","國票-新莊",0,10,-10
"15073","1570力肯","110/07/14","合庫-三重",4,0,4
"15074","1570力肯","110/07/14","凱基-高美館",0,10,-10
"15075","1570力肯","110/07/14","瑞士信貸",4,0,4
"15076","1570力肯","110/07/14","元大-屏東民生",0,5,-5
"15077","1570力肯","110/07/14","統一-三多",4,0,4
"15078","1570力肯","110/07/14","元大-古亭",0,5,-5
"15079","1570力肯","110/07/14","華南永昌-古亭",4,0,4
"15080","1570力肯","110/07/14","日盛-木柵",0,4,-4
"15081","1570力肯","110/07/14","元大-高雄",3,0,3
"15082","1570力肯","110/07/14","大昌",0,4,-4
"15083","1570力肯","110/07/14","兆豐-忠孝",2,0,2
"15084","1570力肯","110/07/14","群益金鼎-東大",0,4,-4
"15085","1570力肯","110/07/14","富邦-陽明",2,0,2
"15086","1570力肯","110/07/14","凱基-台北",0,4,-4
"15087","1570力肯","110/07/14","元大-松山",2,0,2
"15088","1570力肯","110/07/14","元大-板橋",0,4,-4
"15089","1570力肯","110/07/14","元大-忠孝",2,0,2
"15090","1570力肯","110/07/14","第一金-中山",0,3,-3
"15091","6180橘子","110/07/14","新加坡商瑞銀",84,28,56
"15092","6180橘子","110/07/14","凱基-台北",4,37,-33
"15093","6180橘子","110/07/14","日盛-信義",29,1,28
"15094","6180橘子","110/07/14","玉山-台南",1,22,-21
"15095","6180橘子","110/07/14","豐農",28,4,24
"15096","6180橘子","110/07/14","日盛-新竹",1,21,-20
"15097","6180橘子","110/07/14","新光-新竹",24,1,23
"15098","6180橘子","110/07/14","元富-潮州",0,19,-19
"15099","6180橘子","110/07/14","華南永昌-高雄",20,0,20
"15100","6180橘子","110/07/14","元大-信義",0,17,-17
"15101","6180橘子","110/07/14","元大-羅東",20,0,20
"15102","6180橘子","110/07/14","台灣企銀-台中",1,16,-15
"15103","6180橘子","110/07/14","元大-台中中港",20,0,20
"15104","6180橘子","110/07/14","元大-北港",0,15,-15
"15105","6180橘子","110/07/14","富邦-嘉義",24,5,19
"15106","6180橘子","110/07/14","富邦-高雄",0,14,-14
"15107","6180橘子","110/07/14","富邦-仁愛",15,0,15
"15108","6180橘子","110/07/14","兆豐-埔墘",0,13,-13
"15109","6180橘子","110/07/14","國票-九鼎",13,0,13
"15110","6180橘子","110/07/14","第一金-中山",0,10,-10
"15111","6180橘子","110/07/14","日盛-木柵",12,0,12
"15112","6180橘子","110/07/14","元大-彰化民生",0,10,-10
"15113","6180橘子","110/07/14","元大-成功",10,0,10
"15114","6180橘子","110/07/14","福勝",1,10,-9
"15115","6180橘子","110/07/14","港商野村",10,2,8
"15116","6180橘子","110/07/14","群益金鼎-丹鳳",1,10,-9
"15117","6180橘子","110/07/14","玉山-左營",8,0,8
"15118","6180橘子","110/07/14","群益金鼎-板橋",0,8,-8
"15119","6180橘子","110/07/14","富邦-陽明",16,8,8
"15120","6180橘子","110/07/14","合庫-鳳山",0,7,-7
"15121","2390云辰","110/07/14","摩根大通",995,198,797
"15122","2390云辰","110/07/14","新加坡商瑞銀",28,399,-371
"15123","2390云辰","110/07/14","美林",383,22,361
"15124","2390云辰","110/07/14","凱基-新豐",3,198,-195
"15125","2390云辰","110/07/14","台灣摩根士丹利",684,358,326
"15126","2390云辰","110/07/14","元大-士林",1,152,-151
"15127","2390云辰","110/07/14","凱基-台北",656,402,254
"15128","2390云辰","110/07/14","元大-竹山",80,181,-101
"15129","2390云辰","110/07/14","日盛-和美",110,5,105
"15130","2390云辰","110/07/14","群益金鼎-開元",19,95,-76
"15131","2390云辰","110/07/14","元大-天母",72,0,72
"15132","2390云辰","110/07/14","新光",77,150,-73
"15133","2390云辰","110/07/14","永豐金-松山",57,0,57
"15134","2390云辰","110/07/14","元富-高雄",0,71,-71
"15135","2390云辰","110/07/14","統一-屏東",53,0,53
"15136","2390云辰","110/07/14","元大-土城學府",130,201,-71
"15137","2390云辰","110/07/14","港商野村",486,450,36
"15138","2390云辰","110/07/14","元大-善化",12,76,-64
"15139","2390云辰","110/07/14","致和-崇德",30,0,30
"15140","2390云辰","110/07/14","華南永昌-岡山",23,81,-58
"15141","2390云辰","110/07/14","富邦-台北",40,14,26
"15142","2390云辰","110/07/14","群益金鼎-大興",82,125,-43
"15143","2390云辰","110/07/14","台新-高雄",38,13,25
"15144","2390云辰","110/07/14","大慶-中壢",0,41,-41
"15145","2390云辰","110/07/14","富邦-板橋",32,7,25
"15146","2390云辰","110/07/14","玉山-板橋",6,47,-41
"15147","2390云辰","110/07/14","陽信-石牌",24,0,24
"15148","2390云辰","110/07/14","富邦-台東",2,42,-40
"15149","2390云辰","110/07/14","凱基-屏東",32,8,24
"15150","2390云辰","110/07/14","元大-新營",3,42,-39
"15151","2363矽統","110/07/14","台灣摩根士丹利",463,0,463
"15152","2363矽統","110/07/14","新加坡商瑞銀",568,1321,-753
"15153","2363矽統","110/07/14","台新證券",750,342,408
"15154","2363矽統","110/07/14","瑞士信貸",149,864,-715
"15155","2363矽統","110/07/14","玉山-台中",363,51,312
"15156","2363矽統","110/07/14","台新-屏東",115,380,-265
"15157","2363矽統","110/07/14","元大-斗六",223,25,198
"15158","2363矽統","110/07/14","永豐金證券",16,265,-249
"15159","2363矽統","110/07/14","華南永昌-朴子",208,38,170
"15160","2363矽統","110/07/14","美林",462,701,-239
"15161","2363矽統","110/07/14","元富-西松",169,12,157
"15162","2363矽統","110/07/14","宏遠-桃園",269,500,-231
"15163","2363矽統","110/07/14","永豐金-大園",146,6,140
"15164","2363矽統","110/07/14","凱基-竹北",36,254,-218
"15165","2363矽統","110/07/14","土銀-和平",134,0,134
"15166","2363矽統","110/07/14","港商法國興業",0,214,-214
"15167","2363矽統","110/07/14","富邦-新營",130,13,117
"15168","2363矽統","110/07/14","港商野村",835,1044,-209
"15169","2363矽統","110/07/14","元富-成功",118,11,107
"15170","2363矽統","110/07/14","北城證券",212,411,-199
"15171","2363矽統","110/07/14","元富-烏日",121,18,103
"15172","2363矽統","110/07/14","(牛牛牛)亞-鑫豐",51,241,-190
"15173","2363矽統","110/07/14","日盛-二林",120,18,102
"15174","2363矽統","110/07/14","國票-博愛",24,213,-189
"15175","2363矽統","110/07/14","兆豐-忠孝",98,2,96
"15176","2363矽統","110/07/14","大慶-蘆洲",134,316,-182
"15177","2363矽統","110/07/14","大慶-楊梅",92,3,89
"15178","2363矽統","110/07/14","彰銀-台中",15,193,-178
"15179","2363矽統","110/07/14","元富-三重",120,33,87
"15180","2363矽統","110/07/14","日盛-和美",18,185,-167
"15181","8112至上","110/07/14","新加坡商瑞銀",223,17,206
"15182","8112至上","110/07/14","瑞士信貸",8,170,-162
"15183","8112至上","110/07/14","摩根大通",285,129,156
"15184","8112至上","110/07/14","美林",55,202,-147
"15185","8112至上","110/07/14","花旗環球",124,0,124
"15186","8112至上","110/07/14","凱基-台北",325,436,-111
"15187","8112至上","110/07/14","兆豐-公益",117,4,113
"15188","8112至上","110/07/14","台中銀-台北",0,98,-98
"15189","8112至上","110/07/14","香港上海匯豐",111,0,111
"15190","8112至上","110/07/14","玉山-台大",17,107,-90
"15191","8112至上","110/07/14","永豐金-內湖",117,21,96
"15192","8112至上","110/07/14","康和-內湖",1,90,-89
"15193","8112至上","110/07/14","台灣摩根士丹利",108,16,92
"15194","8112至上","110/07/14","港商野村",21,84,-63
"15195","8112至上","110/07/14","元大-東蘆",77,0,77
"15196","8112至上","110/07/14","兆豐-北高雄",1,60,-59
"15197","8112至上","110/07/14","新光",108,48,60
"15198","8112至上","110/07/14","群益金鼎-海山",1,52,-51
"15199","8112至上","110/07/14","大慶-蘆洲",59,0,59
"15200","8112至上","110/07/14","群益金鼎-大安",0,50,-50
"15201","8112至上","110/07/14","華南永昌-台中",56,3,53
"15202","8112至上","110/07/14","富邦-仁愛",2,49,-47
"15203","8112至上","110/07/14","土銀-嘉義",52,2,50
"15204","8112至上","110/07/14","元大-金華",0,42,-42
"15205","8112至上","110/07/14","美商高盛",40,0,40
"15206","8112至上","110/07/14","元大-內湖",4,43,-39
"15207","8112至上","110/07/14","臺銀",63,29,34
"15208","8112至上","110/07/14","第一金-華江",2,37,-35
"15209","8112至上","110/07/14","元富-嘉義",31,0,31
"15210","8112至上","110/07/14","永豐金-苓雅",2,34,-32
"15211","1570力肯","110/07/14","國票-北高雄",68,0,68
"15212","1570力肯","110/07/14","摩根大通",0,21,-21
"15213","1570力肯","110/07/14","日盛-八德",30,1,29
"15214","1570力肯","110/07/14","新光",1,19,-18
"15215","1570力肯","110/07/14","玉山-高雄",7,0,7
"15216","1570力肯","110/07/14","(牛牛牛)亞-鑫豐",0,17,-17
"15217","1570力肯","110/07/14","臺銀-臺南",5,0,5
"15218","1570力肯","110/07/14","日盛-士林",0,10,-10
"15219","1570力肯","110/07/14","凱基-三峽",5,0,5
"15220","1570力肯","110/07/14","統一-員林",0,10,-10
"15221","1570力肯","110/07/14","元大-和平",5,0,5
"15222","1570力肯","110/07/14","國票-新莊",0,10,-10
"15223","1570力肯","110/07/14","合庫-三重",4,0,4
"15224","1570力肯","110/07/14","凱基-高美館",0,10,-10
"15225","1570力肯","110/07/14","瑞士信貸",4,0,4
"15226","1570力肯","110/07/14","元大-屏東民生",0,5,-5
"15227","1570力肯","110/07/14","統一-三多",4,0,4
"15228","1570力肯","110/07/14","元大-古亭",0,5,-5
"15229","1570力肯","110/07/14","華南永昌-古亭",4,0,4
"15230","1570力肯","110/07/14","日盛-木柵",0,4,-4
"15231","1570力肯","110/07/14","元大-高雄",3,0,3
"15232","1570力肯","110/07/14","大昌",0,4,-4
"15233","1570力肯","110/07/14","兆豐-忠孝",2,0,2
"15234","1570力肯","110/07/14","群益金鼎-東大",0,4,-4
"15235","1570力肯","110/07/14","富邦-陽明",2,0,2
"15236","1570力肯","110/07/14","凱基-台北",0,4,-4
"15237","1570力肯","110/07/14","元大-松山",2,0,2
"15238","1570力肯","110/07/14","元大-板橋",0,4,-4
"15239","1570力肯","110/07/14","元大-忠孝",2,0,2
"15240","1570力肯","110/07/14","第一金-中山",0,3,-3
"15241","2929淘帝","110/07/14","華南永昌-林口",60,0,60
"15242","2929淘帝","110/07/14","群益金鼎",25,540,-515
"15243","2929淘帝","110/07/14","美林",87,31,56
"15244","2929淘帝","110/07/14","國泰-台南",1,30,-29
"15245","2929淘帝","110/07/14","元富-台南",40,0,40
"15246","2929淘帝","110/07/14","宏遠-桃園",0,20,-20
"15247","2929淘帝","110/07/14","元大-民生",39,0,39
"15248","2929淘帝","110/07/14","摩根大通",11,31,-20
"15249","2929淘帝","110/07/14","臺銀-鳳山",34,0,34
"15250","2929淘帝","110/07/14","台新-建北",5,20,-15
"15251","2929淘帝","110/07/14","合庫-高雄",34,1,33
"15252","2929淘帝","110/07/14","新光",1,16,-15
"15253","2929淘帝","110/07/14","華南永昌-鶯歌",28,0,28
"15254","2929淘帝","110/07/14","玉山-板橋",0,15,-15
"15255","2929淘帝","110/07/14","永興",25,0,25
"15256","2929淘帝","110/07/14","凱基-羅東",0,15,-15
"15257","2929淘帝","110/07/14","元大-新盛",25,1,24
"15258","2929淘帝","110/07/14","元大-頭份",0,15,-15
"15259","2929淘帝","110/07/14","日盛-南京",23,0,23
"15260","2929淘帝","110/07/14","第一金-台南",0,13,-13
"15261","2929淘帝","110/07/14","日茂",20,0,20
"15262","2929淘帝","110/07/14","富邦-基隆",0,12,-12
"15263","2929淘帝","110/07/14","台新-台中",20,0,20
"15264","2929淘帝","110/07/14","日茂-南投",1,12,-11
"15265","2929淘帝","110/07/14","華南永昌",20,0,20
"15266","2929淘帝","110/07/14","元大-豐原站前",0,11,-11
"15267","2929淘帝","110/07/14","福勝",15,0,15
"15268","2929淘帝","110/07/14","玉山-士林",0,10,-10
"15269","2929淘帝","110/07/14","富邦-南屯",15,0,15
"15270","2929淘帝","110/07/14","富邦-台北",0,10,-10
"15271","5410國眾","110/07/14","兆豐-城中",35,0,35
"15272","5410國眾","110/07/14","瑞士信貸",0,29,-29
"15273","5410國眾","110/07/14","新光",21,1,20
"15274","5410國眾","110/07/14","國泰-板橋",1,30,-29
"15275","5410國眾","110/07/14","國泰-敦南",21,1,20
"15276","5410國眾","110/07/14","日盛-高雄",0,20,-20
"15277","5410國眾","110/07/14","國泰-台中",20,1,19
"15278","5410國眾","110/07/14","台新-左楠",1,20,-19
"15279","5410國眾","110/07/14","元大-崇德",19,0,19
"15280","5410國眾","110/07/14","元富-大昌",1,18,-17
"15281","5410國眾","110/07/14","土銀-士林",18,0,18
"15282","5410國眾","110/07/14","富邦-建國",0,15,-15
"15283","5410國眾","110/07/14","元大-新盛",20,2,18
"15284","5410國眾","110/07/14","元富-嘉義",0,12,-12
"15285","5410國眾","110/07/14","兆豐-高雄",15,0,15
"15286","5410國眾","110/07/14","永全-南崁",0,12,-12
"15287","5410國眾","110/07/14","宏遠-中和",10,0,10
"15288","5410國眾","110/07/14","元大-員林",0,11,-11
"15289","5410國眾","110/07/14","新光-桃園",10,0,10
"15290","5410國眾","110/07/14","高橋",0,10,-10
"15291","5410國眾","110/07/14","國泰-台南",10,0,10
"15292","5410國眾","110/07/14","永興",0,10,-10
"15293","5410國眾","110/07/14","元大-復北",10,0,10
"15294","5410國眾","110/07/14","華南永昌-三重",0,10,-10
"15295","5410國眾","110/07/14","元大-竹科",8,0,8
"15296","5410國眾","110/07/14","元大-苑裡",0,7,-7
"15297","5410國眾","110/07/14","台新-新營",6,0,6
"15298","5410國眾","110/07/14","港商野村",0,6,-6
"15299","5410國眾","110/07/14","日盛-士林",5,0,5
"15300","5410國眾","110/07/14","摩根大通",5,11,-6
"15301","2841台開","110/07/14","凱基-文心",73,0,73
"15302","2841台開","110/07/14","國泰-敦南",0,50,-50
"15303","2841台開","110/07/14","元富-潮州",30,0,30
"15304","2841台開","110/07/14","凱基-中壢",0,40,-40
"15305","2841台開","110/07/14","第一金-台中",20,0,20
"15306","2841台開","110/07/14","統一-新竹",0,24,-24
"15307","2841台開","110/07/14","華南永昌-新莊",20,0,20
"15308","2841台開","110/07/14","元富-草屯",0,20,-20
"15309","2841台開","110/07/14","永豐金-豐原",20,0,20
"15310","2841台開","110/07/14","台新-台南",0,20,-20
"15311","2841台開","110/07/14","國泰-館前",15,0,15
"15312","2841台開","110/07/14","永豐金-敦南",45,63,-18
"15313","2841台開","110/07/14","群益金鼎-基隆",12,0,12
"15314","2841台開","110/07/14","國票-北高雄",0,13,-13
"15315","2841台開","110/07/14","日盛-信義",10,0,10
"15316","2841台開","110/07/14","凱基-松山",0,10,-10
"15317","2841台開","110/07/14","台新-台中",10,0,10
"15318","2841台開","110/07/14","元大證券",0,10,-10
"15319","2841台開","110/07/14","新光",10,1,9
"15320","2841台開","110/07/14","元大-中壢",0,10,-10
"15321","2841台開","110/07/14","凱基-新店",8,0,8
"15322","2841台開","110/07/14","富邦-陽明",1,10,-9
"15323","2841台開","110/07/14","元大-斗信",7,0,7
"15324","2841台開","110/07/14","富邦-建國",0,9,-9
"15325","2841台開","110/07/14","元大-三重",6,0,6
"15326","2841台開","110/07/14","富邦-台南",0,8,-8
"15327","2841台開","110/07/14","永豐金-中和",6,0,6
"15328","2841台開","110/07/14","康和-澎湖",0,7,-7
"15329","2841台開","110/07/14","元富-成功",5,0,5
"15330","2841台開","110/07/14","日盛-斗六",0,6,-6
"15331","6207雷科","110/07/14","群益金鼎-台北",60,0,60
"15332","6207雷科","110/07/14","新加坡商瑞銀",10,56,-46
"15333","6207雷科","110/07/14","台新-高雄",43,3,40
"15334","6207雷科","110/07/14","國票-中和",0,41,-41
"15335","6207雷科","110/07/14","元大-高雄",19,0,19
"15336","6207雷科","110/07/14","元大-復北",0,33,-33
"15337","6207雷科","110/07/14","福勝",15,0,15
"15338","6207雷科","110/07/14","光和-和美",0,20,-20
"15339","6207雷科","110/07/14","群益金鼎-中山",15,0,15
"15340","6207雷科","110/07/14","群益金鼎-丹鳳",0,20,-20
"15341","6207雷科","110/07/14","元大-林園",15,0,15
"15342","6207雷科","110/07/14","第一金-路竹",0,10,-10
"15343","6207雷科","110/07/14","新光",12,0,12
"15344","6207雷科","110/07/14","元大-歸仁",0,10,-10
"15345","6207雷科","110/07/14","元大-大天母",10,0,10
"15346","6207雷科","110/07/14","宏遠-館前",0,9,-9
"15347","6207雷科","110/07/14","永豐金-忠孝",9,0,9
"15348","6207雷科","110/07/14","凱基-台北",12,20,-8
"15349","6207雷科","110/07/14","永豐金-新店",7,0,7
"15350","6207雷科","110/07/14","美林",0,7,-7
"15351","6207雷科","110/07/14","玉山-嘉義",6,0,6
"15352","6207雷科","110/07/14","摩根大通",16,23,-7
"15353","6207雷科","110/07/14","元大-屏東",6,0,6
"15354","6207雷科","110/07/14","凱基-高雄",1,7,-6
"15355","6207雷科","110/07/14","凱基-大安",5,0,5
"15356","6207雷科","110/07/14","台中銀-豐原",0,5,-5
"15357","6207雷科","110/07/14","富邦-台南",5,0,5
"15358","6207雷科","110/07/14","元大-新竹經國",0,5,-5
"15359","6207雷科","110/07/14","元大-成功",5,0,5
"15360","6207雷科","110/07/14","光和-田中",0,4,-4
"15361","3679新至陞","110/07/14","凱基-台北",31,6,25
"15362","3679新至陞","110/07/14","群益金鼎-東大",0,15,-15
"15363","3679新至陞","110/07/14","華南永昌-新莊",10,0,10
"15364","3679新至陞","110/07/14","瑞士信貸",0,12,-12
"15365","3679新至陞","110/07/14","新加坡商瑞銀",11,3,8
"15366","3679新至陞","110/07/14","群益金鼎-永和",0,10,-10
"15367","3679新至陞","110/07/14","美商高盛",6,0,6
"15368","3679新至陞","110/07/14","元大-成功",5,15,-10
"15369","3679新至陞","110/07/14","第一金-中壢",6,0,6
"15370","3679新至陞","110/07/14","統一-板橋",1,10,-9
"15371","3679新至陞","110/07/14","(牛牛牛)亞-網路",4,0,4
"15372","3679新至陞","110/07/14","玉山-左營",0,5,-5
"15373","3679新至陞","110/07/14","元大-六合",3,0,3
"15374","3679新至陞","110/07/14","群益金鼎-三民",0,4,-4
"15375","3679新至陞","110/07/14","合庫-自強",2,0,2
"15376","3679新至陞","110/07/14","富邦-宜蘭",0,4,-4
"15377","3679新至陞","110/07/14","高橋-內壢",2,0,2
"15378","3679新至陞","110/07/14","永豐金-苓雅",0,3,-3
"15379","3679新至陞","110/07/14","台中銀-員林",2,0,2
"15380","3679新至陞","110/07/14","摩根大通",5,7,-2
"15381","3679新至陞","110/07/14","凱基-高美館",2,0,2
"15382","3679新至陞","110/07/14","元大-板橋三民",0,2,-2
"15383","3679新至陞","110/07/14","元大-福營",2,0,2
"15384","3679新至陞","110/07/14","宏遠-中和",0,1,-1
"15385","3679新至陞","110/07/14","永豐金-松山",2,0,2
"15386","3679新至陞","110/07/14","元富-佳里",0,1,-1
"15387","3679新至陞","110/07/14","永豐金-萬盛",2,0,2
"15388","3679新至陞","110/07/14","(牛牛牛)亞-鑫豐",0,1,-1
"15389","3679新至陞","110/07/14","元富-松德",1,0,1
"15390","3679新至陞","110/07/14","中國信託-中壢",0,1,-1
"15391","2727王品","110/07/14","富邦-左營",102,1,101
"15392","2727王品","110/07/14","統一-城中",100,234,-134
"15393","2727王品","110/07/14","國泰-板橋",105,11,94
"15394","2727王品","110/07/14","富邦-台北",1,125,-124
"15395","2727王品","110/07/14","港商野村",149,72,77
"15396","2727王品","110/07/14","台灣摩根士丹利",1,48,-47
"15397","2727王品","110/07/14","合庫-台中",66,2,64
"15398","2727王品","110/07/14","國票-新莊",0,40,-40
"15399","2727王品","110/07/14","臺銀-金山",63,8,55
"15400","2727王品","110/07/14","永豐金-忠孝",2,39,-37
"15401","2727王品","110/07/14","摩根大通",83,39,44
"15402","2727王品","110/07/14","富邦-彰化",1,34,-33
"15403","2727王品","110/07/14","凱基-台北",84,42,42
"15404","2727王品","110/07/14","康和-高雄",0,30,-30
"15405","2727王品","110/07/14","土銀-台中",35,1,34
"15406","2727王品","110/07/14","安泰",0,26,-26
"15407","2727王品","110/07/14","華南永昌-麻豆",32,1,31
"15408","2727王品","110/07/14","富邦-新竹華信",0,21,-21
"15409","2727王品","110/07/14","元大證券",85,55,30
"15410","2727王品","110/07/14","元大-南崁",1,22,-21
"15411","2727王品","110/07/14","新加坡商瑞銀",40,15,25
"15412","2727王品","110/07/14","彰銀-台中",0,18,-18
"15413","2727王品","110/07/14","日盛-八德",19,0,19
"15414","2727王品","110/07/14","元富-同大",2,20,-18
"15415","2727王品","110/07/14","統一",35,17,18
"15416","2727王品","110/07/14","玉山-嘉義",1,17,-16
"15417","2727王品","110/07/14","元富-大昌",18,1,17
"15418","2727王品","110/07/14","國泰-館前",4,20,-16
"15419","2727王品","110/07/14","玉山-板橋",15,1,14
"15420","2727王品","110/07/14","第一金-嘉義",1,13,-12
"15421","1570力肯","110/07/14","國票-北高雄",68,0,68
"15422","1570力肯","110/07/14","摩根大通",0,21,-21
"15423","1570力肯","110/07/14","日盛-八德",30,1,29
"15424","1570力肯","110/07/14","新光",1,19,-18
"15425","1570力肯","110/07/14","玉山-高雄",7,0,7
"15426","1570力肯","110/07/14","(牛牛牛)亞-鑫豐",0,17,-17
"15427","1570力肯","110/07/14","臺銀-臺南",5,0,5
"15428","1570力肯","110/07/14","日盛-士林",0,10,-10
"15429","1570力肯","110/07/14","凱基-三峽",5,0,5
"15430","1570力肯","110/07/14","統一-員林",0,10,-10
"15431","1570力肯","110/07/14","元大-和平",5,0,5
"15432","1570力肯","110/07/14","國票-新莊",0,10,-10
"15433","1570力肯","110/07/14","合庫-三重",4,0,4
"15434","1570力肯","110/07/14","凱基-高美館",0,10,-10
"15435","1570力肯","110/07/14","瑞士信貸",4,0,4
"15436","1570力肯","110/07/14","元大-屏東民生",0,5,-5
"15437","1570力肯","110/07/14","統一-三多",4,0,4
"15438","1570力肯","110/07/14","元大-古亭",0,5,-5
"15439","1570力肯","110/07/14","華南永昌-古亭",4,0,4
"15440","1570力肯","110/07/14","日盛-木柵",0,4,-4
"15441","1570力肯","110/07/14","元大-高雄",3,0,3
"15442","1570力肯","110/07/14","大昌",0,4,-4
"15443","1570力肯","110/07/14","兆豐-忠孝",2,0,2
"15444","1570力肯","110/07/14","群益金鼎-東大",0,4,-4
"15445","1570力肯","110/07/14","富邦-陽明",2,0,2
"15446","1570力肯","110/07/14","凱基-台北",0,4,-4
"15447","1570力肯","110/07/14","元大-松山",2,0,2
"15448","1570力肯","110/07/14","元大-板橋",0,4,-4
"15449","1570力肯","110/07/14","元大-忠孝",2,0,2
"15450","1570力肯","110/07/14","第一金-中山",0,3,-3
"15451","6180橘子","110/07/14","新加坡商瑞銀",84,28,56
"15452","6180橘子","110/07/14","凱基-台北",4,37,-33
"15453","6180橘子","110/07/14","日盛-信義",29,1,28
"15454","6180橘子","110/07/14","玉山-台南",1,22,-21
"15455","6180橘子","110/07/14","豐農",28,4,24
"15456","6180橘子","110/07/14","日盛-新竹",1,21,-20
"15457","6180橘子","110/07/14","新光-新竹",24,1,23
"15458","6180橘子","110/07/14","元富-潮州",0,19,-19
"15459","6180橘子","110/07/14","華南永昌-高雄",20,0,20
"15460","6180橘子","110/07/14","元大-信義",0,17,-17
"15461","6180橘子","110/07/14","元大-羅東",20,0,20
"15462","6180橘子","110/07/14","台灣企銀-台中",1,16,-15
"15463","6180橘子","110/07/14","元大-台中中港",20,0,20
"15464","6180橘子","110/07/14","元大-北港",0,15,-15
"15465","6180橘子","110/07/14","富邦-嘉義",24,5,19
"15466","6180橘子","110/07/14","富邦-高雄",0,14,-14
"15467","6180橘子","110/07/14","富邦-仁愛",15,0,15
"15468","6180橘子","110/07/14","兆豐-埔墘",0,13,-13
"15469","6180橘子","110/07/14","國票-九鼎",13,0,13
"15470","6180橘子","110/07/14","第一金-中山",0,10,-10
"15471","6180橘子","110/07/14","日盛-木柵",12,0,12
"15472","6180橘子","110/07/14","元大-彰化民生",0,10,-10
"15473","6180橘子","110/07/14","元大-成功",10,0,10
"15474","6180橘子","110/07/14","福勝",1,10,-9
"15475","6180橘子","110/07/14","港商野村",10,2,8
"15476","6180橘子","110/07/14","群益金鼎-丹鳳",1,10,-9
"15477","6180橘子","110/07/14","玉山-左營",8,0,8
"15478","6180橘子","110/07/14","群益金鼎-板橋",0,8,-8
"15479","6180橘子","110/07/14","富邦-陽明",16,8,8
"15480","6180橘子","110/07/14","合庫-鳳山",0,7,-7
"15481","2390云辰","110/07/14","摩根大通",995,198,797
"15482","2390云辰","110/07/14","新加坡商瑞銀",28,399,-371
"15483","2390云辰","110/07/14","美林",383,22,361
"15484","2390云辰","110/07/14","凱基-新豐",3,198,-195
"15485","2390云辰","110/07/14","台灣摩根士丹利",684,358,326
"15486","2390云辰","110/07/14","元大-士林",1,152,-151
"15487","2390云辰","110/07/14","凱基-台北",656,402,254
"15488","2390云辰","110/07/14","元大-竹山",80,181,-101
"15489","2390云辰","110/07/14","日盛-和美",110,5,105
"15490","2390云辰","110/07/14","群益金鼎-開元",19,95,-76
"15491","2390云辰","110/07/14","元大-天母",72,0,72
"15492","2390云辰","110/07/14","新光",77,150,-73
"15493","2390云辰","110/07/14","永豐金-松山",57,0,57
"15494","2390云辰","110/07/14","元富-高雄",0,71,-71
"15495","2390云辰","110/07/14","統一-屏東",53,0,53
"15496","2390云辰","110/07/14","元大-土城學府",130,201,-71
"15497","2390云辰","110/07/14","港商野村",486,450,36
"15498","2390云辰","110/07/14","元大-善化",12,76,-64
"15499","2390云辰","110/07/14","致和-崇德",30,0,30
"15500","2390云辰","110/07/14","華南永昌-岡山",23,81,-58
"15501","2390云辰","110/07/14","富邦-台北",40,14,26
"15502","2390云辰","110/07/14","群益金鼎-大興",82,125,-43
"15503","2390云辰","110/07/14","台新-高雄",38,13,25
"15504","2390云辰","110/07/14","大慶-中壢",0,41,-41
"15505","2390云辰","110/07/14","富邦-板橋",32,7,25
"15506","2390云辰","110/07/14","玉山-板橋",6,47,-41
"15507","2390云辰","110/07/14","陽信-石牌",24,0,24
"15508","2390云辰","110/07/14","富邦-台東",2,42,-40
"15509","2390云辰","110/07/14","凱基-屏東",32,8,24
"15510","2390云辰","110/07/14","元大-新營",3,42,-39
"15511","2363矽統","110/07/14","台灣摩根士丹利",463,0,463
"15512","2363矽統","110/07/14","新加坡商瑞銀",568,1321,-753
"15513","2363矽統","110/07/14","台新證券",750,342,408
"15514","2363矽統","110/07/14","瑞士信貸",149,864,-715
"15515","2363矽統","110/07/14","玉山-台中",363,51,312
"15516","2363矽統","110/07/14","台新-屏東",115,380,-265
"15517","2363矽統","110/07/14","元大-斗六",223,25,198
"15518","2363矽統","110/07/14","永豐金證券",16,265,-249
"15519","2363矽統","110/07/14","華南永昌-朴子",208,38,170
"15520","2363矽統","110/07/14","美林",462,701,-239
"15521","2363矽統","110/07/14","元富-西松",169,12,157
"15522","2363矽統","110/07/14","宏遠-桃園",269,500,-231
"15523","2363矽統","110/07/14","永豐金-大園",146,6,140
"15524","2363矽統","110/07/14","凱基-竹北",36,254,-218
"15525","2363矽統","110/07/14","土銀-和平",134,0,134
"15526","2363矽統","110/07/14","港商法國興業",0,214,-214
"15527","2363矽統","110/07/14","富邦-新營",130,13,117
"15528","2363矽統","110/07/14","港商野村",835,1044,-209
"15529","2363矽統","110/07/14","元富-成功",118,11,107
"15530","2363矽統","110/07/14","北城證券",212,411,-199
"15531","2363矽統","110/07/14","元富-烏日",121,18,103
"15532","2363矽統","110/07/14","(牛牛牛)亞-鑫豐",51,241,-190
"15533","2363矽統","110/07/14","日盛-二林",120,18,102
"15534","2363矽統","110/07/14","國票-博愛",24,213,-189
"15535","2363矽統","110/07/14","兆豐-忠孝",98,2,96
"15536","2363矽統","110/07/14","大慶-蘆洲",134,316,-182
"15537","2363矽統","110/07/14","大慶-楊梅",92,3,89
"15538","2363矽統","110/07/14","彰銀-台中",15,193,-178
"15539","2363矽統","110/07/14","元富-三重",120,33,87
"15540","2363矽統","110/07/14","日盛-和美",18,185,-167
"15541","8112至上","110/07/14","新加坡商瑞銀",223,17,206
"15542","8112至上","110/07/14","瑞士信貸",8,170,-162
"15543","8112至上","110/07/14","摩根大通",285,129,156
"15544","8112至上","110/07/14","美林",55,202,-147
"15545","8112至上","110/07/14","花旗環球",124,0,124
"15546","8112至上","110/07/14","凱基-台北",325,436,-111
"15547","8112至上","110/07/14","兆豐-公益",117,4,113
"15548","8112至上","110/07/14","台中銀-台北",0,98,-98
"15549","8112至上","110/07/14","香港上海匯豐",111,0,111
"15550","8112至上","110/07/14","玉山-台大",17,107,-90
"15551","8112至上","110/07/14","永豐金-內湖",117,21,96
"15552","8112至上","110/07/14","康和-內湖",1,90,-89
"15553","8112至上","110/07/14","台灣摩根士丹利",108,16,92
"15554","8112至上","110/07/14","港商野村",21,84,-63
"15555","8112至上","110/07/14","元大-東蘆",77,0,77
"15556","8112至上","110/07/14","兆豐-北高雄",1,60,-59
"15557","8112至上","110/07/14","新光",108,48,60
"15558","8112至上","110/07/14","群益金鼎-海山",1,52,-51
"15559","8112至上","110/07/14","大慶-蘆洲",59,0,59
"15560","8112至上","110/07/14","群益金鼎-大安",0,50,-50
"15561","8112至上","110/07/14","華南永昌-台中",56,3,53
"15562","8112至上","110/07/14","富邦-仁愛",2,49,-47
"15563","8112至上","110/07/14","土銀-嘉義",52,2,50
"15564","8112至上","110/07/14","元大-金華",0,42,-42
"15565","8112至上","110/07/14","美商高盛",40,0,40
"15566","8112至上","110/07/14","元大-內湖",4,43,-39
"15567","8112至上","110/07/14","臺銀",63,29,34
"15568","8112至上","110/07/14","第一金-華江",2,37,-35
"15569","8112至上","110/07/14","元富-嘉義",31,0,31
"15570","8112至上","110/07/14","永豐金-苓雅",2,34,-32
"15571","1570力肯","110/07/14","國票-北高雄",68,0,68
"15572","1570力肯","110/07/14","摩根大通",0,21,-21
"15573","1570力肯","110/07/14","日盛-八德",30,1,29
"15574","1570力肯","110/07/14","新光",1,19,-18
"15575","1570力肯","110/07/14","玉山-高雄",7,0,7
"15576","1570力肯","110/07/14","(牛牛牛)亞-鑫豐",0,17,-17
"15577","1570力肯","110/07/14","臺銀-臺南",5,0,5
"15578","1570力肯","110/07/14","日盛-士林",0,10,-10
"15579","1570力肯","110/07/14","凱基-三峽",5,0,5
"15580","1570力肯","110/07/14","統一-員林",0,10,-10
"15581","1570力肯","110/07/14","元大-和平",5,0,5
"15582","1570力肯","110/07/14","國票-新莊",0,10,-10
"15583","1570力肯","110/07/14","合庫-三重",4,0,4
"15584","1570力肯","110/07/14","凱基-高美館",0,10,-10
"15585","1570力肯","110/07/14","瑞士信貸",4,0,4
"15586","1570力肯","110/07/14","元大-屏東民生",0,5,-5
"15587","1570力肯","110/07/14","統一-三多",4,0,4
"15588","1570力肯","110/07/14","元大-古亭",0,5,-5
"15589","1570力肯","110/07/14","華南永昌-古亭",4,0,4
"15590","1570力肯","110/07/14","日盛-木柵",0,4,-4
"15591","1570力肯","110/07/14","元大-高雄",3,0,3
"15592","1570力肯","110/07/14","大昌",0,4,-4
"15593","1570力肯","110/07/14","兆豐-忠孝",2,0,2
"15594","1570力肯","110/07/14","群益金鼎-東大",0,4,-4
"15595","1570力肯","110/07/14","富邦-陽明",2,0,2
"15596","1570力肯","110/07/14","凱基-台北",0,4,-4
"15597","1570力肯","110/07/14","元大-松山",2,0,2
"15598","1570力肯","110/07/14","元大-板橋",0,4,-4
"15599","1570力肯","110/07/14","元大-忠孝",2,0,2
"15600","1570力肯","110/07/14","第一金-中山",0,3,-3
"15601","2929淘帝","110/07/14","華南永昌-林口",60,0,60
"15602","2929淘帝","110/07/14","群益金鼎",25,540,-515
"15603","2929淘帝","110/07/14","美林",87,31,56
"15604","2929淘帝","110/07/14","國泰-台南",1,30,-29
"15605","2929淘帝","110/07/14","元富-台南",40,0,40
"15606","2929淘帝","110/07/14","宏遠-桃園",0,20,-20
"15607","2929淘帝","110/07/14","元大-民生",39,0,39
"15608","2929淘帝","110/07/14","摩根大通",11,31,-20
"15609","2929淘帝","110/07/14","臺銀-鳳山",34,0,34
"15610","2929淘帝","110/07/14","台新-建北",5,20,-15
"15611","2929淘帝","110/07/14","合庫-高雄",34,1,33
"15612","2929淘帝","110/07/14","新光",1,16,-15
"15613","2929淘帝","110/07/14","華南永昌-鶯歌",28,0,28
"15614","2929淘帝","110/07/14","玉山-板橋",0,15,-15
"15615","2929淘帝","110/07/14","永興",25,0,25
"15616","2929淘帝","110/07/14","凱基-羅東",0,15,-15
"15617","2929淘帝","110/07/14","元大-新盛",25,1,24
"15618","2929淘帝","110/07/14","元大-頭份",0,15,-15
"15619","2929淘帝","110/07/14","日盛-南京",23,0,23
"15620","2929淘帝","110/07/14","第一金-台南",0,13,-13
"15621","2929淘帝","110/07/14","日茂",20,0,20
"15622","2929淘帝","110/07/14","富邦-基隆",0,12,-12
"15623","2929淘帝","110/07/14","台新-台中",20,0,20
"15624","2929淘帝","110/07/14","日茂-南投",1,12,-11
"15625","2929淘帝","110/07/14","華南永昌",20,0,20
"15626","2929淘帝","110/07/14","元大-豐原站前",0,11,-11
"15627","2929淘帝","110/07/14","福勝",15,0,15
"15628","2929淘帝","110/07/14","玉山-士林",0,10,-10
"15629","2929淘帝","110/07/14","富邦-南屯",15,0,15
"15630","2929淘帝","110/07/14","富邦-台北",0,10,-10
"15631","5410國眾","110/07/14","兆豐-城中",35,0,35
"15632","5410國眾","110/07/14","瑞士信貸",0,29,-29
"15633","5410國眾","110/07/14","新光",21,1,20
"15634","5410國眾","110/07/14","國泰-板橋",1,30,-29
"15635","5410國眾","110/07/14","國泰-敦南",21,1,20
"15636","5410國眾","110/07/14","日盛-高雄",0,20,-20
"15637","5410國眾","110/07/14","國泰-台中",20,1,19
"15638","5410國眾","110/07/14","台新-左楠",1,20,-19
"15639","5410國眾","110/07/14","元大-崇德",19,0,19
"15640","5410國眾","110/07/14","元富-大昌",1,18,-17
"15641","5410國眾","110/07/14","土銀-士林",18,0,18
"15642","5410國眾","110/07/14","富邦-建國",0,15,-15
"15643","5410國眾","110/07/14","元大-新盛",20,2,18
"15644","5410國眾","110/07/14","元富-嘉義",0,12,-12
"15645","5410國眾","110/07/14","兆豐-高雄",15,0,15
"15646","5410國眾","110/07/14","永全-南崁",0,12,-12
"15647","5410國眾","110/07/14","宏遠-中和",10,0,10
"15648","5410國眾","110/07/14","元大-員林",0,11,-11
"15649","5410國眾","110/07/14","新光-桃園",10,0,10
"15650","5410國眾","110/07/14","高橋",0,10,-10
"15651","5410國眾","110/07/14","國泰-台南",10,0,10
"15652","5410國眾","110/07/14","永興",0,10,-10
"15653","5410國眾","110/07/14","元大-復北",10,0,10
"15654","5410國眾","110/07/14","華南永昌-三重",0,10,-10
"15655","5410國眾","110/07/14","元大-竹科",8,0,8
"15656","5410國眾","110/07/14","元大-苑裡",0,7,-7
"15657","5410國眾","110/07/14","台新-新營",6,0,6
"15658","5410國眾","110/07/14","港商野村",0,6,-6
"15659","5410國眾","110/07/14","日盛-士林",5,0,5
"15660","5410國眾","110/07/14","摩根大通",5,11,-6
"15661","2841台開","110/07/14","凱基-文心",73,0,73
"15662","2841台開","110/07/14","國泰-敦南",0,50,-50
"15663","2841台開","110/07/14","元富-潮州",30,0,30
"15664","2841台開","110/07/14","凱基-中壢",0,40,-40
"15665","2841台開","110/07/14","第一金-台中",20,0,20
"15666","2841台開","110/07/14","統一-新竹",0,24,-24
"15667","2841台開","110/07/14","華南永昌-新莊",20,0,20
"15668","2841台開","110/07/14","元富-草屯",0,20,-20
"15669","2841台開","110/07/14","永豐金-豐原",20,0,20
"15670","2841台開","110/07/14","台新-台南",0,20,-20
"15671","2841台開","110/07/14","國泰-館前",15,0,15
"15672","2841台開","110/07/14","永豐金-敦南",45,63,-18
"15673","2841台開","110/07/14","群益金鼎-基隆",12,0,12
"15674","2841台開","110/07/14","國票-北高雄",0,13,-13
"15675","2841台開","110/07/14","日盛-信義",10,0,10
"15676","2841台開","110/07/14","凱基-松山",0,10,-10
"15677","2841台開","110/07/14","台新-台中",10,0,10
"15678","2841台開","110/07/14","元大證券",0,10,-10
"15679","2841台開","110/07/14","新光",10,1,9
"15680","2841台開","110/07/14","元大-中壢",0,10,-10
"15681","2841台開","110/07/14","凱基-新店",8,0,8
"15682","2841台開","110/07/14","富邦-陽明",1,10,-9
"15683","2841台開","110/07/14","元大-斗信",7,0,7
"15684","2841台開","110/07/14","富邦-建國",0,9,-9
"15685","2841台開","110/07/14","元大-三重",6,0,6
"15686","2841台開","110/07/14","富邦-台南",0,8,-8
"15687","2841台開","110/07/14","永豐金-中和",6,0,6
"15688","2841台開","110/07/14","康和-澎湖",0,7,-7
"15689","2841台開","110/07/14","元富-成功",5,0,5
"15690","2841台開","110/07/14","日盛-斗六",0,6,-6
"15691","6207雷科","110/07/14","群益金鼎-台北",60,0,60
"15692","6207雷科","110/07/14","新加坡商瑞銀",10,56,-46
"15693","6207雷科","110/07/14","台新-高雄",43,3,40
"15694","6207雷科","110/07/14","國票-中和",0,41,-41
"15695","6207雷科","110/07/14","元大-高雄",19,0,19
"15696","6207雷科","110/07/14","元大-復北",0,33,-33
"15697","6207雷科","110/07/14","福勝",15,0,15
"15698","6207雷科","110/07/14","光和-和美",0,20,-20
"15699","6207雷科","110/07/14","群益金鼎-中山",15,0,15
"15700","6207雷科","110/07/14","群益金鼎-丹鳳",0,20,-20
"15701","6207雷科","110/07/14","元大-林園",15,0,15
"15702","6207雷科","110/07/14","第一金-路竹",0,10,-10
"15703","6207雷科","110/07/14","新光",12,0,12
"15704","6207雷科","110/07/14","元大-歸仁",0,10,-10
"15705","6207雷科","110/07/14","元大-大天母",10,0,10
"15706","6207雷科","110/07/14","宏遠-館前",0,9,-9
"15707","6207雷科","110/07/14","永豐金-忠孝",9,0,9
"15708","6207雷科","110/07/14","凱基-台北",12,20,-8
"15709","6207雷科","110/07/14","永豐金-新店",7,0,7
"15710","6207雷科","110/07/14","美林",0,7,-7
"15711","6207雷科","110/07/14","玉山-嘉義",6,0,6
"15712","6207雷科","110/07/14","摩根大通",16,23,-7
"15713","6207雷科","110/07/14","元大-屏東",6,0,6
"15714","6207雷科","110/07/14","凱基-高雄",1,7,-6
"15715","6207雷科","110/07/14","凱基-大安",5,0,5
"15716","6207雷科","110/07/14","台中銀-豐原",0,5,-5
"15717","6207雷科","110/07/14","富邦-台南",5,0,5
"15718","6207雷科","110/07/14","元大-新竹經國",0,5,-5
"15719","6207雷科","110/07/14","元大-成功",5,0,5
"15720","6207雷科","110/07/14","光和-田中",0,4,-4
"15721","3679新至陞","110/07/14","凱基-台北",31,6,25
"15722","3679新至陞","110/07/14","群益金鼎-東大",0,15,-15
"15723","3679新至陞","110/07/14","華南永昌-新莊",10,0,10
"15724","3679新至陞","110/07/14","瑞士信貸",0,12,-12
"15725","3679新至陞","110/07/14","新加坡商瑞銀",11,3,8
"15726","3679新至陞","110/07/14","群益金鼎-永和",0,10,-10
"15727","3679新至陞","110/07/14","美商高盛",6,0,6
"15728","3679新至陞","110/07/14","元大-成功",5,15,-10
"15729","3679新至陞","110/07/14","第一金-中壢",6,0,6
"15730","3679新至陞","110/07/14","統一-板橋",1,10,-9
"15731","3679新至陞","110/07/14","(牛牛牛)亞-網路",4,0,4
"15732","3679新至陞","110/07/14","玉山-左營",0,5,-5
"15733","3679新至陞","110/07/14","元大-六合",3,0,3
"15734","3679新至陞","110/07/14","群益金鼎-三民",0,4,-4
"15735","3679新至陞","110/07/14","合庫-自強",2,0,2
"15736","3679新至陞","110/07/14","富邦-宜蘭",0,4,-4
"15737","3679新至陞","110/07/14","高橋-內壢",2,0,2
"15738","3679新至陞","110/07/14","永豐金-苓雅",0,3,-3
"15739","3679新至陞","110/07/14","台中銀-員林",2,0,2
"15740","3679新至陞","110/07/14","摩根大通",5,7,-2
"15741","3679新至陞","110/07/14","凱基-高美館",2,0,2
"15742","3679新至陞","110/07/14","元大-板橋三民",0,2,-2
"15743","3679新至陞","110/07/14","元大-福營",2,0,2
"15744","3679新至陞","110/07/14","宏遠-中和",0,1,-1
"15745","3679新至陞","110/07/14","永豐金-松山",2,0,2
"15746","3679新至陞","110/07/14","元富-佳里",0,1,-1
"15747","3679新至陞","110/07/14","永豐金-萬盛",2,0,2
"15748","3679新至陞","110/07/14","(牛牛牛)亞-鑫豐",0,1,-1
"15749","3679新至陞","110/07/14","元富-松德",1,0,1
"15750","3679新至陞","110/07/14","中國信託-中壢",0,1,-1
"15751","2727王品","110/07/14","富邦-左營",102,1,101
"15752","2727王品","110/07/14","統一-城中",100,234,-134
"15753","2727王品","110/07/14","國泰-板橋",105,11,94
"15754","2727王品","110/07/14","富邦-台北",1,125,-124
"15755","2727王品","110/07/14","港商野村",149,72,77
"15756","2727王品","110/07/14","台灣摩根士丹利",1,48,-47
"15757","2727王品","110/07/14","合庫-台中",66,2,64
"15758","2727王品","110/07/14","國票-新莊",0,40,-40
"15759","2727王品","110/07/14","臺銀-金山",63,8,55
"15760","2727王品","110/07/14","永豐金-忠孝",2,39,-37
"15761","2727王品","110/07/14","摩根大通",83,39,44
"15762","2727王品","110/07/14","富邦-彰化",1,34,-33
"15763","2727王品","110/07/14","凱基-台北",84,42,42
"15764","2727王品","110/07/14","康和-高雄",0,30,-30
"15765","2727王品","110/07/14","土銀-台中",35,1,34
"15766","2727王品","110/07/14","安泰",0,26,-26
"15767","2727王品","110/07/14","華南永昌-麻豆",32,1,31
"15768","2727王品","110/07/14","富邦-新竹華信",0,21,-21
"15769","2727王品","110/07/14","元大證券",85,55,30
"15770","2727王品","110/07/14","元大-南崁",1,22,-21
"15771","2727王品","110/07/14","新加坡商瑞銀",40,15,25
"15772","2727王品","110/07/14","彰銀-台中",0,18,-18
"15773","2727王品","110/07/14","日盛-八德",19,0,19
"15774","2727王品","110/07/14","元富-同大",2,20,-18
"15775","2727王品","110/07/14","統一",35,17,18
"15776","2727王品","110/07/14","玉山-嘉義",1,17,-16
"15777","2727王品","110/07/14","元富-大昌",18,1,17
"15778","2727王品","110/07/14","國泰-館前",4,20,-16
"15779","2727王品","110/07/14","玉山-板橋",15,1,14
"15780","2727王品","110/07/14","第一金-嘉義",1,13,-12
"15781","1570力肯","110/07/14","國票-北高雄",68,0,68
"15782","1570力肯","110/07/14","摩根大通",0,21,-21
"15783","1570力肯","110/07/14","日盛-八德",30,1,29
"15784","1570力肯","110/07/14","新光",1,19,-18
"15785","1570力肯","110/07/14","玉山-高雄",7,0,7
"15786","1570力肯","110/07/14","(牛牛牛)亞-鑫豐",0,17,-17
"15787","1570力肯","110/07/14","臺銀-臺南",5,0,5
"15788","1570力肯","110/07/14","日盛-士林",0,10,-10
"15789","1570力肯","110/07/14","凱基-三峽",5,0,5
"15790","1570力肯","110/07/14","統一-員林",0,10,-10
"15791","1570力肯","110/07/14","元大-和平",5,0,5
"15792","1570力肯","110/07/14","國票-新莊",0,10,-10
"15793","1570力肯","110/07/14","合庫-三重",4,0,4
"15794","1570力肯","110/07/14","凱基-高美館",0,10,-10
"15795","1570力肯","110/07/14","瑞士信貸",4,0,4
"15796","1570力肯","110/07/14","元大-屏東民生",0,5,-5
"15797","1570力肯","110/07/14","統一-三多",4,0,4
"15798","1570力肯","110/07/14","元大-古亭",0,5,-5
"15799","1570力肯","110/07/14","華南永昌-古亭",4,0,4
"15800","1570力肯","110/07/14","日盛-木柵",0,4,-4
"15801","1570力肯","110/07/14","元大-高雄",3,0,3
"15802","1570力肯","110/07/14","大昌",0,4,-4
"15803","1570力肯","110/07/14","兆豐-忠孝",2,0,2
"15804","1570力肯","110/07/14","群益金鼎-東大",0,4,-4
"15805","1570力肯","110/07/14","富邦-陽明",2,0,2
"15806","1570力肯","110/07/14","凱基-台北",0,4,-4
"15807","1570力肯","110/07/14","元大-松山",2,0,2
"15808","1570力肯","110/07/14","元大-板橋",0,4,-4
"15809","1570力肯","110/07/14","元大-忠孝",2,0,2
"15810","1570力肯","110/07/14","第一金-中山",0,3,-3
"15811","6180橘子","110/07/14","新加坡商瑞銀",84,28,56
"15812","6180橘子","110/07/14","凱基-台北",4,37,-33
"15813","6180橘子","110/07/14","日盛-信義",29,1,28
"15814","6180橘子","110/07/14","玉山-台南",1,22,-21
"15815","6180橘子","110/07/14","豐農",28,4,24
"15816","6180橘子","110/07/14","日盛-新竹",1,21,-20
"15817","6180橘子","110/07/14","新光-新竹",24,1,23
"15818","6180橘子","110/07/14","元富-潮州",0,19,-19
"15819","6180橘子","110/07/14","華南永昌-高雄",20,0,20
"15820","6180橘子","110/07/14","元大-信義",0,17,-17
"15821","6180橘子","110/07/14","元大-羅東",20,0,20
"15822","6180橘子","110/07/14","台灣企銀-台中",1,16,-15
"15823","6180橘子","110/07/14","元大-台中中港",20,0,20
"15824","6180橘子","110/07/14","元大-北港",0,15,-15
"15825","6180橘子","110/07/14","富邦-嘉義",24,5,19
"15826","6180橘子","110/07/14","富邦-高雄",0,14,-14
"15827","6180橘子","110/07/14","富邦-仁愛",15,0,15
"15828","6180橘子","110/07/14","兆豐-埔墘",0,13,-13
"15829","6180橘子","110/07/14","國票-九鼎",13,0,13
"15830","6180橘子","110/07/14","第一金-中山",0,10,-10
"15831","6180橘子","110/07/14","日盛-木柵",12,0,12
"15832","6180橘子","110/07/14","元大-彰化民生",0,10,-10
"15833","6180橘子","110/07/14","元大-成功",10,0,10
"15834","6180橘子","110/07/14","福勝",1,10,-9
"15835","6180橘子","110/07/14","港商野村",10,2,8
"15836","6180橘子","110/07/14","群益金鼎-丹鳳",1,10,-9
"15837","6180橘子","110/07/14","玉山-左營",8,0,8
"15838","6180橘子","110/07/14","群益金鼎-板橋",0,8,-8
"15839","6180橘子","110/07/14","富邦-陽明",16,8,8
"15840","6180橘子","110/07/14","合庫-鳳山",0,7,-7
"15841","2390云辰","110/07/14","摩根大通",995,198,797
"15842","2390云辰","110/07/14","新加坡商瑞銀",28,399,-371
"15843","2390云辰","110/07/14","美林",383,22,361
"15844","2390云辰","110/07/14","凱基-新豐",3,198,-195
"15845","2390云辰","110/07/14","台灣摩根士丹利",684,358,326
"15846","2390云辰","110/07/14","元大-士林",1,152,-151
"15847","2390云辰","110/07/14","凱基-台北",656,402,254
"15848","2390云辰","110/07/14","元大-竹山",80,181,-101
"15849","2390云辰","110/07/14","日盛-和美",110,5,105
"15850","2390云辰","110/07/14","群益金鼎-開元",19,95,-76
"15851","2390云辰","110/07/14","元大-天母",72,0,72
"15852","2390云辰","110/07/14","新光",77,150,-73
"15853","2390云辰","110/07/14","永豐金-松山",57,0,57
"15854","2390云辰","110/07/14","元富-高雄",0,71,-71
"15855","2390云辰","110/07/14","統一-屏東",53,0,53
"15856","2390云辰","110/07/14","元大-土城學府",130,201,-71
"15857","2390云辰","110/07/14","港商野村",486,450,36
"15858","2390云辰","110/07/14","元大-善化",12,76,-64
"15859","2390云辰","110/07/14","致和-崇德",30,0,30
"15860","2390云辰","110/07/14","華南永昌-岡山",23,81,-58
"15861","2390云辰","110/07/14","富邦-台北",40,14,26
"15862","2390云辰","110/07/14","群益金鼎-大興",82,125,-43
"15863","2390云辰","110/07/14","台新-高雄",38,13,25
"15864","2390云辰","110/07/14","大慶-中壢",0,41,-41
"15865","2390云辰","110/07/14","富邦-板橋",32,7,25
"15866","2390云辰","110/07/14","玉山-板橋",6,47,-41
"15867","2390云辰","110/07/14","陽信-石牌",24,0,24
"15868","2390云辰","110/07/14","富邦-台東",2,42,-40
"15869","2390云辰","110/07/14","凱基-屏東",32,8,24
"15870","2390云辰","110/07/14","元大-新營",3,42,-39
"15871","2363矽統","110/07/14","台灣摩根士丹利",463,0,463
"15872","2363矽統","110/07/14","新加坡商瑞銀",568,1321,-753
"15873","2363矽統","110/07/14","台新證券",750,342,408
"15874","2363矽統","110/07/14","瑞士信貸",149,864,-715
"15875","2363矽統","110/07/14","玉山-台中",363,51,312
"15876","2363矽統","110/07/14","台新-屏東",115,380,-265
"15877","2363矽統","110/07/14","元大-斗六",223,25,198
"15878","2363矽統","110/07/14","永豐金證券",16,265,-249
"15879","2363矽統","110/07/14","華南永昌-朴子",208,38,170
"15880","2363矽統","110/07/14","美林",462,701,-239
"15881","2363矽統","110/07/14","元富-西松",169,12,157
"15882","2363矽統","110/07/14","宏遠-桃園",269,500,-231
"15883","2363矽統","110/07/14","永豐金-大園",146,6,140
"15884","2363矽統","110/07/14","凱基-竹北",36,254,-218
"15885","2363矽統","110/07/14","土銀-和平",134,0,134
"15886","2363矽統","110/07/14","港商法國興業",0,214,-214
"15887","2363矽統","110/07/14","富邦-新營",130,13,117
"15888","2363矽統","110/07/14","港商野村",835,1044,-209
"15889","2363矽統","110/07/14","元富-成功",118,11,107
"15890","2363矽統","110/07/14","北城證券",212,411,-199
"15891","2363矽統","110/07/14","元富-烏日",121,18,103
"15892","2363矽統","110/07/14","(牛牛牛)亞-鑫豐",51,241,-190
"15893","2363矽統","110/07/14","日盛-二林",120,18,102
"15894","2363矽統","110/07/14","國票-博愛",24,213,-189
"15895","2363矽統","110/07/14","兆豐-忠孝",98,2,96
"15896","2363矽統","110/07/14","大慶-蘆洲",134,316,-182
"15897","2363矽統","110/07/14","大慶-楊梅",92,3,89
"15898","2363矽統","110/07/14","彰銀-台中",15,193,-178
"15899","2363矽統","110/07/14","元富-三重",120,33,87
"15900","2363矽統","110/07/14","日盛-和美",18,185,-167
"15901","8112至上","110/07/14","新加坡商瑞銀",223,17,206
"15902","8112至上","110/07/14","瑞士信貸",8,170,-162
"15903","8112至上","110/07/14","摩根大通",285,129,156
"15904","8112至上","110/07/14","美林",55,202,-147
"15905","8112至上","110/07/14","花旗環球",124,0,124
"15906","8112至上","110/07/14","凱基-台北",325,436,-111
"15907","8112至上","110/07/14","兆豐-公益",117,4,113
"15908","8112至上","110/07/14","台中銀-台北",0,98,-98
"15909","8112至上","110/07/14","香港上海匯豐",111,0,111
"15910","8112至上","110/07/14","玉山-台大",17,107,-90
"15911","8112至上","110/07/14","永豐金-內湖",117,21,96
"15912","8112至上","110/07/14","康和-內湖",1,90,-89
"15913","8112至上","110/07/14","台灣摩根士丹利",108,16,92
"15914","8112至上","110/07/14","港商野村",21,84,-63
"15915","8112至上","110/07/14","元大-東蘆",77,0,77
"15916","8112至上","110/07/14","兆豐-北高雄",1,60,-59
"15917","8112至上","110/07/14","新光",108,48,60
"15918","8112至上","110/07/14","群益金鼎-海山",1,52,-51
"15919","8112至上","110/07/14","大慶-蘆洲",59,0,59
"15920","8112至上","110/07/14","群益金鼎-大安",0,50,-50
"15921","8112至上","110/07/14","華南永昌-台中",56,3,53
"15922","8112至上","110/07/14","富邦-仁愛",2,49,-47
"15923","8112至上","110/07/14","土銀-嘉義",52,2,50
"15924","8112至上","110/07/14","元大-金華",0,42,-42
"15925","8112至上","110/07/14","美商高盛",40,0,40
"15926","8112至上","110/07/14","元大-內湖",4,43,-39
"15927","8112至上","110/07/14","臺銀",63,29,34
"15928","8112至上","110/07/14","第一金-華江",2,37,-35
"15929","8112至上","110/07/14","元富-嘉義",31,0,31
"15930","8112至上","110/07/14","永豐金-苓雅",2,34,-32
"15931","1570力肯","110/07/14","國票-北高雄",68,0,68
"15932","1570力肯","110/07/14","摩根大通",0,21,-21
"15933","1570力肯","110/07/14","日盛-八德",30,1,29
"15934","1570力肯","110/07/14","新光",1,19,-18
"15935","1570力肯","110/07/14","玉山-高雄",7,0,7
"15936","1570力肯","110/07/14","(牛牛牛)亞-鑫豐",0,17,-17
"15937","1570力肯","110/07/14","臺銀-臺南",5,0,5
"15938","1570力肯","110/07/14","日盛-士林",0,10,-10
"15939","1570力肯","110/07/14","凱基-三峽",5,0,5
"15940","1570力肯","110/07/14","統一-員林",0,10,-10
"15941","1570力肯","110/07/14","元大-和平",5,0,5
"15942","1570力肯","110/07/14","國票-新莊",0,10,-10
"15943","1570力肯","110/07/14","合庫-三重",4,0,4
"15944","1570力肯","110/07/14","凱基-高美館",0,10,-10
"15945","1570力肯","110/07/14","瑞士信貸",4,0,4
"15946","1570力肯","110/07/14","元大-屏東民生",0,5,-5
"15947","1570力肯","110/07/14","統一-三多",4,0,4
"15948","1570力肯","110/07/14","元大-古亭",0,5,-5
"15949","1570力肯","110/07/14","華南永昌-古亭",4,0,4
"15950","1570力肯","110/07/14","日盛-木柵",0,4,-4
"15951","1570力肯","110/07/14","元大-高雄",3,0,3
"15952","1570力肯","110/07/14","大昌",0,4,-4
"15953","1570力肯","110/07/14","兆豐-忠孝",2,0,2
"15954","1570力肯","110/07/14","群益金鼎-東大",0,4,-4
"15955","1570力肯","110/07/14","富邦-陽明",2,0,2
"15956","1570力肯","110/07/14","凱基-台北",0,4,-4
"15957","1570力肯","110/07/14","元大-松山",2,0,2
"15958","1570力肯","110/07/14","元大-板橋",0,4,-4
"15959","1570力肯","110/07/14","元大-忠孝",2,0,2
"15960","1570力肯","110/07/14","第一金-中山",0,3,-3
"15961","2929淘帝","110/07/14","華南永昌-林口",60,0,60
"15962","2929淘帝","110/07/14","群益金鼎",25,540,-515
"15963","2929淘帝","110/07/14","美林",87,31,56
"15964","2929淘帝","110/07/14","國泰-台南",1,30,-29
"15965","2929淘帝","110/07/14","元富-台南",40,0,40
"15966","2929淘帝","110/07/14","宏遠-桃園",0,20,-20
"15967","2929淘帝","110/07/14","元大-民生",39,0,39
"15968","2929淘帝","110/07/14","摩根大通",11,31,-20
"15969","2929淘帝","110/07/14","臺銀-鳳山",34,0,34
"15970","2929淘帝","110/07/14","台新-建北",5,20,-15
"15971","2929淘帝","110/07/14","合庫-高雄",34,1,33
"15972","2929淘帝","110/07/14","新光",1,16,-15
"15973","2929淘帝","110/07/14","華南永昌-鶯歌",28,0,28
"15974","2929淘帝","110/07/14","玉山-板橋",0,15,-15
"15975","2929淘帝","110/07/14","永興",25,0,25
"15976","2929淘帝","110/07/14","凱基-羅東",0,15,-15
"15977","2929淘帝","110/07/14","元大-新盛",25,1,24
"15978","2929淘帝","110/07/14","元大-頭份",0,15,-15
"15979","2929淘帝","110/07/14","日盛-南京",23,0,23
"15980","2929淘帝","110/07/14","第一金-台南",0,13,-13
"15981","2929淘帝","110/07/14","日茂",20,0,20
"15982","2929淘帝","110/07/14","富邦-基隆",0,12,-12
"15983","2929淘帝","110/07/14","台新-台中",20,0,20
"15984","2929淘帝","110/07/14","日茂-南投",1,12,-11
"15985","2929淘帝","110/07/14","華南永昌",20,0,20
"15986","2929淘帝","110/07/14","元大-豐原站前",0,11,-11
"15987","2929淘帝","110/07/14","福勝",15,0,15
"15988","2929淘帝","110/07/14","玉山-士林",0,10,-10
"15989","2929淘帝","110/07/14","富邦-南屯",15,0,15
"15990","2929淘帝","110/07/14","富邦-台北",0,10,-10
"15991","5410國眾","110/07/14","兆豐-城中",35,0,35
"15992","5410國眾","110/07/14","瑞士信貸",0,29,-29
"15993","5410國眾","110/07/14","新光",21,1,20
"15994","5410國眾","110/07/14","國泰-板橋",1,30,-29
"15995","5410國眾","110/07/14","國泰-敦南",21,1,20
"15996","5410國眾","110/07/14","日盛-高雄",0,20,-20
"15997","5410國眾","110/07/14","國泰-台中",20,1,19
"15998","5410國眾","110/07/14","台新-左楠",1,20,-19
"15999","5410國眾","110/07/14","元大-崇德",19,0,19
"16000","5410國眾","110/07/14","元富-大昌",1,18,-17
"16001","5410國眾","110/07/14","土銀-士林",18,0,18
"16002","5410國眾","110/07/14","富邦-建國",0,15,-15
"16003","5410國眾","110/07/14","元大-新盛",20,2,18
"16004","5410國眾","110/07/14","元富-嘉義",0,12,-12
"16005","5410國眾","110/07/14","兆豐-高雄",15,0,15
"16006","5410國眾","110/07/14","永全-南崁",0,12,-12
"16007","5410國眾","110/07/14","宏遠-中和",10,0,10
"16008","5410國眾","110/07/14","元大-員林",0,11,-11
"16009","5410國眾","110/07/14","新光-桃園",10,0,10
"16010","5410國眾","110/07/14","高橋",0,10,-10
"16011","5410國眾","110/07/14","國泰-台南",10,0,10
"16012","5410國眾","110/07/14","永興",0,10,-10
"16013","5410國眾","110/07/14","元大-復北",10,0,10
"16014","5410國眾","110/07/14","華南永昌-三重",0,10,-10
"16015","5410國眾","110/07/14","元大-竹科",8,0,8
"16016","5410國眾","110/07/14","元大-苑裡",0,7,-7
"16017","5410國眾","110/07/14","台新-新營",6,0,6
"16018","5410國眾","110/07/14","港商野村",0,6,-6
"16019","5410國眾","110/07/14","日盛-士林",5,0,5
"16020","5410國眾","110/07/14","摩根大通",5,11,-6
"16021","2841台開","110/07/14","凱基-文心",73,0,73
"16022","2841台開","110/07/14","國泰-敦南",0,50,-50
"16023","2841台開","110/07/14","元富-潮州",30,0,30
"16024","2841台開","110/07/14","凱基-中壢",0,40,-40
"16025","2841台開","110/07/14","第一金-台中",20,0,20
"16026","2841台開","110/07/14","統一-新竹",0,24,-24
"16027","2841台開","110/07/14","華南永昌-新莊",20,0,20
"16028","2841台開","110/07/14","元富-草屯",0,20,-20
"16029","2841台開","110/07/14","永豐金-豐原",20,0,20
"16030","2841台開","110/07/14","台新-台南",0,20,-20
"16031","2841台開","110/07/14","國泰-館前",15,0,15
"16032","2841台開","110/07/14","永豐金-敦南",45,63,-18
"16033","2841台開","110/07/14","群益金鼎-基隆",12,0,12
"16034","2841台開","110/07/14","國票-北高雄",0,13,-13
"16035","2841台開","110/07/14","日盛-信義",10,0,10
"16036","2841台開","110/07/14","凱基-松山",0,10,-10
"16037","2841台開","110/07/14","台新-台中",10,0,10
"16038","2841台開","110/07/14","元大證券",0,10,-10
"16039","2841台開","110/07/14","新光",10,1,9
"16040","2841台開","110/07/14","元大-中壢",0,10,-10
"16041","2841台開","110/07/14","凱基-新店",8,0,8
"16042","2841台開","110/07/14","富邦-陽明",1,10,-9
"16043","2841台開","110/07/14","元大-斗信",7,0,7
"16044","2841台開","110/07/14","富邦-建國",0,9,-9
"16045","2841台開","110/07/14","元大-三重",6,0,6
"16046","2841台開","110/07/14","富邦-台南",0,8,-8
"16047","2841台開","110/07/14","永豐金-中和",6,0,6
"16048","2841台開","110/07/14","康和-澎湖",0,7,-7
"16049","2841台開","110/07/14","元富-成功",5,0,5
"16050","2841台開","110/07/14","日盛-斗六",0,6,-6
"16051","6207雷科","110/07/14","群益金鼎-台北",60,0,60
"16052","6207雷科","110/07/14","新加坡商瑞銀",10,56,-46
"16053","6207雷科","110/07/14","台新-高雄",43,3,40
"16054","6207雷科","110/07/14","國票-中和",0,41,-41
"16055","6207雷科","110/07/14","元大-高雄",19,0,19
"16056","6207雷科","110/07/14","元大-復北",0,33,-33
"16057","6207雷科","110/07/14","福勝",15,0,15
"16058","6207雷科","110/07/14","光和-和美",0,20,-20
"16059","6207雷科","110/07/14","群益金鼎-中山",15,0,15
"16060","6207雷科","110/07/14","群益金鼎-丹鳳",0,20,-20
"16061","6207雷科","110/07/14","元大-林園",15,0,15
"16062","6207雷科","110/07/14","第一金-路竹",0,10,-10
"16063","6207雷科","110/07/14","新光",12,0,12
"16064","6207雷科","110/07/14","元大-歸仁",0,10,-10
"16065","6207雷科","110/07/14","元大-大天母",10,0,10
"16066","6207雷科","110/07/14","宏遠-館前",0,9,-9
"16067","6207雷科","110/07/14","永豐金-忠孝",9,0,9
"16068","6207雷科","110/07/14","凱基-台北",12,20,-8
"16069","6207雷科","110/07/14","永豐金-新店",7,0,7
"16070","6207雷科","110/07/14","美林",0,7,-7
"16071","6207雷科","110/07/14","玉山-嘉義",6,0,6
"16072","6207雷科","110/07/14","摩根大通",16,23,-7
"16073","6207雷科","110/07/14","元大-屏東",6,0,6
"16074","6207雷科","110/07/14","凱基-高雄",1,7,-6
"16075","6207雷科","110/07/14","凱基-大安",5,0,5
"16076","6207雷科","110/07/14","台中銀-豐原",0,5,-5
"16077","6207雷科","110/07/14","富邦-台南",5,0,5
"16078","6207雷科","110/07/14","元大-新竹經國",0,5,-5
"16079","6207雷科","110/07/14","元大-成功",5,0,5
"16080","6207雷科","110/07/14","光和-田中",0,4,-4
"16081","3679新至陞","110/07/14","凱基-台北",31,6,25
"16082","3679新至陞","110/07/14","群益金鼎-東大",0,15,-15
"16083","3679新至陞","110/07/14","華南永昌-新莊",10,0,10
"16084","3679新至陞","110/07/14","瑞士信貸",0,12,-12
"16085","3679新至陞","110/07/14","新加坡商瑞銀",11,3,8
"16086","3679新至陞","110/07/14","群益金鼎-永和",0,10,-10
"16087","3679新至陞","110/07/14","美商高盛",6,0,6
"16088","3679新至陞","110/07/14","元大-成功",5,15,-10
"16089","3679新至陞","110/07/14","第一金-中壢",6,0,6
"16090","3679新至陞","110/07/14","統一-板橋",1,10,-9
"16091","3679新至陞","110/07/14","(牛牛牛)亞-網路",4,0,4
"16092","3679新至陞","110/07/14","玉山-左營",0,5,-5
"16093","3679新至陞","110/07/14","元大-六合",3,0,3
"16094","3679新至陞","110/07/14","群益金鼎-三民",0,4,-4
"16095","3679新至陞","110/07/14","合庫-自強",2,0,2
"16096","3679新至陞","110/07/14","富邦-宜蘭",0,4,-4
"16097","3679新至陞","110/07/14","高橋-內壢",2,0,2
"16098","3679新至陞","110/07/14","永豐金-苓雅",0,3,-3
"16099","3679新至陞","110/07/14","台中銀-員林",2,0,2
"16100","3679新至陞","110/07/14","摩根大通",5,7,-2
"16101","3679新至陞","110/07/14","凱基-高美館",2,0,2
"16102","3679新至陞","110/07/14","元大-板橋三民",0,2,-2
"16103","3679新至陞","110/07/14","元大-福營",2,0,2
"16104","3679新至陞","110/07/14","宏遠-中和",0,1,-1
"16105","3679新至陞","110/07/14","永豐金-松山",2,0,2
"16106","3679新至陞","110/07/14","元富-佳里",0,1,-1
"16107","3679新至陞","110/07/14","永豐金-萬盛",2,0,2
"16108","3679新至陞","110/07/14","(牛牛牛)亞-鑫豐",0,1,-1
"16109","3679新至陞","110/07/14","元富-松德",1,0,1
"16110","3679新至陞","110/07/14","中國信託-中壢",0,1,-1
"16111","2727王品","110/07/14","富邦-左營",102,1,101
"16112","2727王品","110/07/14","統一-城中",100,234,-134
"16113","2727王品","110/07/14","國泰-板橋",105,11,94
"16114","2727王品","110/07/14","富邦-台北",1,125,-124
"16115","2727王品","110/07/14","港商野村",149,72,77
"16116","2727王品","110/07/14","台灣摩根士丹利",1,48,-47
"16117","2727王品","110/07/14","合庫-台中",66,2,64
"16118","2727王品","110/07/14","國票-新莊",0,40,-40
"16119","2727王品","110/07/14","臺銀-金山",63,8,55
"16120","2727王品","110/07/14","永豐金-忠孝",2,39,-37
"16121","2727王品","110/07/14","摩根大通",83,39,44
"16122","2727王品","110/07/14","富邦-彰化",1,34,-33
"16123","2727王品","110/07/14","凱基-台北",84,42,42
"16124","2727王品","110/07/14","康和-高雄",0,30,-30
"16125","2727王品","110/07/14","土銀-台中",35,1,34
"16126","2727王品","110/07/14","安泰",0,26,-26
"16127","2727王品","110/07/14","華南永昌-麻豆",32,1,31
"16128","2727王品","110/07/14","富邦-新竹華信",0,21,-21
"16129","2727王品","110/07/14","元大證券",85,55,30
"16130","2727王品","110/07/14","元大-南崁",1,22,-21
"16131","2727王品","110/07/14","新加坡商瑞銀",40,15,25
"16132","2727王品","110/07/14","彰銀-台中",0,18,-18
"16133","2727王品","110/07/14","日盛-八德",19,0,19
"16134","2727王品","110/07/14","元富-同大",2,20,-18
"16135","2727王品","110/07/14","統一",35,17,18
"16136","2727王品","110/07/14","玉山-嘉義",1,17,-16
"16137","2727王品","110/07/14","元富-大昌",18,1,17
"16138","2727王品","110/07/14","國泰-館前",4,20,-16
"16139","2727王品","110/07/14","玉山-板橋",15,1,14
"16140","2727王品","110/07/14","第一金-嘉義",1,13,-12
"16141","1570力肯","110/07/14","國票-北高雄",68,0,68
"16142","1570力肯","110/07/14","摩根大通",0,21,-21
"16143","1570力肯","110/07/14","日盛-八德",30,1,29
"16144","1570力肯","110/07/14","新光",1,19,-18
"16145","1570力肯","110/07/14","玉山-高雄",7,0,7
"16146","1570力肯","110/07/14","(牛牛牛)亞-鑫豐",0,17,-17
"16147","1570力肯","110/07/14","臺銀-臺南",5,0,5
"16148","1570力肯","110/07/14","日盛-士林",0,10,-10
"16149","1570力肯","110/07/14","凱基-三峽",5,0,5
"16150","1570力肯","110/07/14","統一-員林",0,10,-10
"16151","1570力肯","110/07/14","元大-和平",5,0,5
"16152","1570力肯","110/07/14","國票-新莊",0,10,-10
"16153","1570力肯","110/07/14","合庫-三重",4,0,4
"16154","1570力肯","110/07/14","凱基-高美館",0,10,-10
"16155","1570力肯","110/07/14","瑞士信貸",4,0,4
"16156","1570力肯","110/07/14","元大-屏東民生",0,5,-5
"16157","1570力肯","110/07/14","統一-三多",4,0,4
"16158","1570力肯","110/07/14","元大-古亭",0,5,-5
"16159","1570力肯","110/07/14","華南永昌-古亭",4,0,4
"16160","1570力肯","110/07/14","日盛-木柵",0,4,-4
"16161","1570力肯","110/07/14","元大-高雄",3,0,3
"16162","1570力肯","110/07/14","大昌",0,4,-4
"16163","1570力肯","110/07/14","兆豐-忠孝",2,0,2
"16164","1570力肯","110/07/14","群益金鼎-東大",0,4,-4
"16165","1570力肯","110/07/14","富邦-陽明",2,0,2
"16166","1570力肯","110/07/14","凱基-台北",0,4,-4
"16167","1570力肯","110/07/14","元大-松山",2,0,2
"16168","1570力肯","110/07/14","元大-板橋",0,4,-4
"16169","1570力肯","110/07/14","元大-忠孝",2,0,2
"16170","1570力肯","110/07/14","第一金-中山",0,3,-3
"16171","6180橘子","110/07/14","新加坡商瑞銀",84,28,56
"16172","6180橘子","110/07/14","凱基-台北",4,37,-33
"16173","6180橘子","110/07/14","日盛-信義",29,1,28
"16174","6180橘子","110/07/14","玉山-台南",1,22,-21
"16175","6180橘子","110/07/14","豐農",28,4,24
"16176","6180橘子","110/07/14","日盛-新竹",1,21,-20
"16177","6180橘子","110/07/14","新光-新竹",24,1,23
"16178","6180橘子","110/07/14","元富-潮州",0,19,-19
"16179","6180橘子","110/07/14","華南永昌-高雄",20,0,20
"16180","6180橘子","110/07/14","元大-信義",0,17,-17
"16181","6180橘子","110/07/14","元大-羅東",20,0,20
"16182","6180橘子","110/07/14","台灣企銀-台中",1,16,-15
"16183","6180橘子","110/07/14","元大-台中中港",20,0,20
"16184","6180橘子","110/07/14","元大-北港",0,15,-15
"16185","6180橘子","110/07/14","富邦-嘉義",24,5,19
"16186","6180橘子","110/07/14","富邦-高雄",0,14,-14
"16187","6180橘子","110/07/14","富邦-仁愛",15,0,15
"16188","6180橘子","110/07/14","兆豐-埔墘",0,13,-13
"16189","6180橘子","110/07/14","國票-九鼎",13,0,13
"16190","6180橘子","110/07/14","第一金-中山",0,10,-10
"16191","6180橘子","110/07/14","日盛-木柵",12,0,12
"16192","6180橘子","110/07/14","元大-彰化民生",0,10,-10
"16193","6180橘子","110/07/14","元大-成功",10,0,10
"16194","6180橘子","110/07/14","福勝",1,10,-9
"16195","6180橘子","110/07/14","港商野村",10,2,8
"16196","6180橘子","110/07/14","群益金鼎-丹鳳",1,10,-9
"16197","6180橘子","110/07/14","玉山-左營",8,0,8
"16198","6180橘子","110/07/14","群益金鼎-板橋",0,8,-8
"16199","6180橘子","110/07/14","富邦-陽明",16,8,8
"16200","6180橘子","110/07/14","合庫-鳳山",0,7,-7
"16201","2390云辰","110/07/14","摩根大通",995,198,797
"16202","2390云辰","110/07/14","新加坡商瑞銀",28,399,-371
"16203","2390云辰","110/07/14","美林",383,22,361
"16204","2390云辰","110/07/14","凱基-新豐",3,198,-195
"16205","2390云辰","110/07/14","台灣摩根士丹利",684,358,326
"16206","2390云辰","110/07/14","元大-士林",1,152,-151
"16207","2390云辰","110/07/14","凱基-台北",656,402,254
"16208","2390云辰","110/07/14","元大-竹山",80,181,-101
"16209","2390云辰","110/07/14","日盛-和美",110,5,105
"16210","2390云辰","110/07/14","群益金鼎-開元",19,95,-76
"16211","2390云辰","110/07/14","元大-天母",72,0,72
"16212","2390云辰","110/07/14","新光",77,150,-73
"16213","2390云辰","110/07/14","永豐金-松山",57,0,57
"16214","2390云辰","110/07/14","元富-高雄",0,71,-71
"16215","2390云辰","110/07/14","統一-屏東",53,0,53
"16216","2390云辰","110/07/14","元大-土城學府",130,201,-71
"16217","2390云辰","110/07/14","港商野村",486,450,36
"16218","2390云辰","110/07/14","元大-善化",12,76,-64
"16219","2390云辰","110/07/14","致和-崇德",30,0,30
"16220","2390云辰","110/07/14","華南永昌-岡山",23,81,-58
"16221","2390云辰","110/07/14","富邦-台北",40,14,26
"16222","2390云辰","110/07/14","群益金鼎-大興",82,125,-43
"16223","2390云辰","110/07/14","台新-高雄",38,13,25
"16224","2390云辰","110/07/14","大慶-中壢",0,41,-41
"16225","2390云辰","110/07/14","富邦-板橋",32,7,25
"16226","2390云辰","110/07/14","玉山-板橋",6,47,-41
"16227","2390云辰","110/07/14","陽信-石牌",24,0,24
"16228","2390云辰","110/07/14","富邦-台東",2,42,-40
"16229","2390云辰","110/07/14","凱基-屏東",32,8,24
"16230","2390云辰","110/07/14","元大-新營",3,42,-39
"16231","2363矽統","110/07/14","台灣摩根士丹利",463,0,463
"16232","2363矽統","110/07/14","新加坡商瑞銀",568,1321,-753
"16233","2363矽統","110/07/14","台新證券",750,342,408
"16234","2363矽統","110/07/14","瑞士信貸",149,864,-715
"16235","2363矽統","110/07/14","玉山-台中",363,51,312
"16236","2363矽統","110/07/14","台新-屏東",115,380,-265
"16237","2363矽統","110/07/14","元大-斗六",223,25,198
"16238","2363矽統","110/07/14","永豐金證券",16,265,-249
"16239","2363矽統","110/07/14","華南永昌-朴子",208,38,170
"16240","2363矽統","110/07/14","美林",462,701,-239
"16241","2363矽統","110/07/14","元富-西松",169,12,157
"16242","2363矽統","110/07/14","宏遠-桃園",269,500,-231
"16243","2363矽統","110/07/14","永豐金-大園",146,6,140
"16244","2363矽統","110/07/14","凱基-竹北",36,254,-218
"16245","2363矽統","110/07/14","土銀-和平",134,0,134
"16246","2363矽統","110/07/14","港商法國興業",0,214,-214
"16247","2363矽統","110/07/14","富邦-新營",130,13,117
"16248","2363矽統","110/07/14","港商野村",835,1044,-209
"16249","2363矽統","110/07/14","元富-成功",118,11,107
"16250","2363矽統","110/07/14","北城證券",212,411,-199
"16251","2363矽統","110/07/14","元富-烏日",121,18,103
"16252","2363矽統","110/07/14","(牛牛牛)亞-鑫豐",51,241,-190
"16253","2363矽統","110/07/14","日盛-二林",120,18,102
"16254","2363矽統","110/07/14","國票-博愛",24,213,-189
"16255","2363矽統","110/07/14","兆豐-忠孝",98,2,96
"16256","2363矽統","110/07/14","大慶-蘆洲",134,316,-182
"16257","2363矽統","110/07/14","大慶-楊梅",92,3,89
"16258","2363矽統","110/07/14","彰銀-台中",15,193,-178
"16259","2363矽統","110/07/14","元富-三重",120,33,87
"16260","2363矽統","110/07/14","日盛-和美",18,185,-167
"16261","8112至上","110/07/14","新加坡商瑞銀",223,17,206
"16262","8112至上","110/07/14","瑞士信貸",8,170,-162
"16263","8112至上","110/07/14","摩根大通",285,129,156
"16264","8112至上","110/07/14","美林",55,202,-147
"16265","8112至上","110/07/14","花旗環球",124,0,124
"16266","8112至上","110/07/14","凱基-台北",325,436,-111
"16267","8112至上","110/07/14","兆豐-公益",117,4,113
"16268","8112至上","110/07/14","台中銀-台北",0,98,-98
"16269","8112至上","110/07/14","香港上海匯豐",111,0,111
"16270","8112至上","110/07/14","玉山-台大",17,107,-90
"16271","8112至上","110/07/14","永豐金-內湖",117,21,96
"16272","8112至上","110/07/14","康和-內湖",1,90,-89
"16273","8112至上","110/07/14","台灣摩根士丹利",108,16,92
"16274","8112至上","110/07/14","港商野村",21,84,-63
"16275","8112至上","110/07/14","元大-東蘆",77,0,77
"16276","8112至上","110/07/14","兆豐-北高雄",1,60,-59
"16277","8112至上","110/07/14","新光",108,48,60
"16278","8112至上","110/07/14","群益金鼎-海山",1,52,-51
"16279","8112至上","110/07/14","大慶-蘆洲",59,0,59
"16280","8112至上","110/07/14","群益金鼎-大安",0,50,-50
"16281","8112至上","110/07/14","華南永昌-台中",56,3,53
"16282","8112至上","110/07/14","富邦-仁愛",2,49,-47
"16283","8112至上","110/07/14","土銀-嘉義",52,2,50
"16284","8112至上","110/07/14","元大-金華",0,42,-42
"16285","8112至上","110/07/14","美商高盛",40,0,40
"16286","8112至上","110/07/14","元大-內湖",4,43,-39
"16287","8112至上","110/07/14","臺銀",63,29,34
"16288","8112至上","110/07/14","第一金-華江",2,37,-35
"16289","8112至上","110/07/14","元富-嘉義",31,0,31
"16290","8112至上","110/07/14","永豐金-苓雅",2,34,-32
"16291","1570力肯","110/07/14","國票-北高雄",68,0,68
"16292","1570力肯","110/07/14","摩根大通",0,21,-21
"16293","1570力肯","110/07/14","日盛-八德",30,1,29
"16294","1570力肯","110/07/14","新光",1,19,-18
"16295","1570力肯","110/07/14","玉山-高雄",7,0,7
"16296","1570力肯","110/07/14","(牛牛牛)亞-鑫豐",0,17,-17
"16297","1570力肯","110/07/14","臺銀-臺南",5,0,5
"16298","1570力肯","110/07/14","日盛-士林",0,10,-10
"16299","1570力肯","110/07/14","凱基-三峽",5,0,5
"16300","1570力肯","110/07/14","統一-員林",0,10,-10
"16301","1570力肯","110/07/14","元大-和平",5,0,5
"16302","1570力肯","110/07/14","國票-新莊",0,10,-10
"16303","1570力肯","110/07/14","合庫-三重",4,0,4
"16304","1570力肯","110/07/14","凱基-高美館",0,10,-10
"16305","1570力肯","110/07/14","瑞士信貸",4,0,4
"16306","1570力肯","110/07/14","元大-屏東民生",0,5,-5
"16307","1570力肯","110/07/14","統一-三多",4,0,4
"16308","1570力肯","110/07/14","元大-古亭",0,5,-5
"16309","1570力肯","110/07/14","華南永昌-古亭",4,0,4
"16310","1570力肯","110/07/14","日盛-木柵",0,4,-4
"16311","1570力肯","110/07/14","元大-高雄",3,0,3
"16312","1570力肯","110/07/14","大昌",0,4,-4
"16313","1570力肯","110/07/14","兆豐-忠孝",2,0,2
"16314","1570力肯","110/07/14","群益金鼎-東大",0,4,-4
"16315","1570力肯","110/07/14","富邦-陽明",2,0,2
"16316","1570力肯","110/07/14","凱基-台北",0,4,-4
"16317","1570力肯","110/07/14","元大-松山",2,0,2
"16318","1570力肯","110/07/14","元大-板橋",0,4,-4
"16319","1570力肯","110/07/14","元大-忠孝",2,0,2
"16320","1570力肯","110/07/14","第一金-中山",0,3,-3
"16321","2929淘帝","110/07/14","華南永昌-林口",60,0,60
"16322","2929淘帝","110/07/14","群益金鼎",25,540,-515
"16323","2929淘帝","110/07/14","美林",87,31,56
"16324","2929淘帝","110/07/14","國泰-台南",1,30,-29
"16325","2929淘帝","110/07/14","元富-台南",40,0,40
"16326","2929淘帝","110/07/14","宏遠-桃園",0,20,-20
"16327","2929淘帝","110/07/14","元大-民生",39,0,39
"16328","2929淘帝","110/07/14","摩根大通",11,31,-20
"16329","2929淘帝","110/07/14","臺銀-鳳山",34,0,34
"16330","2929淘帝","110/07/14","台新-建北",5,20,-15
"16331","2929淘帝","110/07/14","合庫-高雄",34,1,33
"16332","2929淘帝","110/07/14","新光",1,16,-15
"16333","2929淘帝","110/07/14","華南永昌-鶯歌",28,0,28
"16334","2929淘帝","110/07/14","玉山-板橋",0,15,-15
"16335","2929淘帝","110/07/14","永興",25,0,25
"16336","2929淘帝","110/07/14","凱基-羅東",0,15,-15
"16337","2929淘帝","110/07/14","元大-新盛",25,1,24
"16338","2929淘帝","110/07/14","元大-頭份",0,15,-15
"16339","2929淘帝","110/07/14","日盛-南京",23,0,23
"16340","2929淘帝","110/07/14","第一金-台南",0,13,-13
"16341","2929淘帝","110/07/14","日茂",20,0,20
"16342","2929淘帝","110/07/14","富邦-基隆",0,12,-12
"16343","2929淘帝","110/07/14","台新-台中",20,0,20
"16344","2929淘帝","110/07/14","日茂-南投",1,12,-11
"16345","2929淘帝","110/07/14","華南永昌",20,0,20
"16346","2929淘帝","110/07/14","元大-豐原站前",0,11,-11
"16347","2929淘帝","110/07/14","福勝",15,0,15
"16348","2929淘帝","110/07/14","玉山-士林",0,10,-10
"16349","2929淘帝","110/07/14","富邦-南屯",15,0,15
"16350","2929淘帝","110/07/14","富邦-台北",0,10,-10
"16351","5410國眾","110/07/14","兆豐-城中",35,0,35
"16352","5410國眾","110/07/14","瑞士信貸",0,29,-29
"16353","5410國眾","110/07/14","新光",21,1,20
"16354","5410國眾","110/07/14","國泰-板橋",1,30,-29
"16355","5410國眾","110/07/14","國泰-敦南",21,1,20
"16356","5410國眾","110/07/14","日盛-高雄",0,20,-20
"16357","5410國眾","110/07/14","國泰-台中",20,1,19
"16358","5410國眾","110/07/14","台新-左楠",1,20,-19
"16359","5410國眾","110/07/14","元大-崇德",19,0,19
"16360","5410國眾","110/07/14","元富-大昌",1,18,-17
"16361","5410國眾","110/07/14","土銀-士林",18,0,18
"16362","5410國眾","110/07/14","富邦-建國",0,15,-15
"16363","5410國眾","110/07/14","元大-新盛",20,2,18
"16364","5410國眾","110/07/14","元富-嘉義",0,12,-12
"16365","5410國眾","110/07/14","兆豐-高雄",15,0,15
"16366","5410國眾","110/07/14","永全-南崁",0,12,-12
"16367","5410國眾","110/07/14","宏遠-中和",10,0,10
"16368","5410國眾","110/07/14","元大-員林",0,11,-11
"16369","5410國眾","110/07/14","新光-桃園",10,0,10
"16370","5410國眾","110/07/14","高橋",0,10,-10
"16371","5410國眾","110/07/14","國泰-台南",10,0,10
"16372","5410國眾","110/07/14","永興",0,10,-10
"16373","5410國眾","110/07/14","元大-復北",10,0,10
"16374","5410國眾","110/07/14","華南永昌-三重",0,10,-10
"16375","5410國眾","110/07/14","元大-竹科",8,0,8
"16376","5410國眾","110/07/14","元大-苑裡",0,7,-7
"16377","5410國眾","110/07/14","台新-新營",6,0,6
"16378","5410國眾","110/07/14","港商野村",0,6,-6
"16379","5410國眾","110/07/14","日盛-士林",5,0,5
"16380","5410國眾","110/07/14","摩根大通",5,11,-6
"16381","2841台開","110/07/14","凱基-文心",73,0,73
"16382","2841台開","110/07/14","國泰-敦南",0,50,-50
"16383","2841台開","110/07/14","元富-潮州",30,0,30
"16384","2841台開","110/07/14","凱基-中壢",0,40,-40
"16385","2841台開","110/07/14","第一金-台中",20,0,20
"16386","2841台開","110/07/14","統一-新竹",0,24,-24
"16387","2841台開","110/07/14","華南永昌-新莊",20,0,20
"16388","2841台開","110/07/14","元富-草屯",0,20,-20
"16389","2841台開","110/07/14","永豐金-豐原",20,0,20
"16390","2841台開","110/07/14","台新-台南",0,20,-20
"16391","2841台開","110/07/14","國泰-館前",15,0,15
"16392","2841台開","110/07/14","永豐金-敦南",45,63,-18
"16393","2841台開","110/07/14","群益金鼎-基隆",12,0,12
"16394","2841台開","110/07/14","國票-北高雄",0,13,-13
"16395","2841台開","110/07/14","日盛-信義",10,0,10
"16396","2841台開","110/07/14","凱基-松山",0,10,-10
"16397","2841台開","110/07/14","台新-台中",10,0,10
"16398","2841台開","110/07/14","元大證券",0,10,-10
"16399","2841台開","110/07/14","新光",10,1,9
"16400","2841台開","110/07/14","元大-中壢",0,10,-10
"16401","2841台開","110/07/14","凱基-新店",8,0,8
"16402","2841台開","110/07/14","富邦-陽明",1,10,-9
"16403","2841台開","110/07/14","元大-斗信",7,0,7
"16404","2841台開","110/07/14","富邦-建國",0,9,-9
"16405","2841台開","110/07/14","元大-三重",6,0,6
"16406","2841台開","110/07/14","富邦-台南",0,8,-8
"16407","2841台開","110/07/14","永豐金-中和",6,0,6
"16408","2841台開","110/07/14","康和-澎湖",0,7,-7
"16409","2841台開","110/07/14","元富-成功",5,0,5
"16410","2841台開","110/07/14","日盛-斗六",0,6,-6
"16411","6207雷科","110/07/14","群益金鼎-台北",60,0,60
"16412","6207雷科","110/07/14","新加坡商瑞銀",10,56,-46
"16413","6207雷科","110/07/14","台新-高雄",43,3,40
"16414","6207雷科","110/07/14","國票-中和",0,41,-41
"16415","6207雷科","110/07/14","元大-高雄",19,0,19
"16416","6207雷科","110/07/14","元大-復北",0,33,-33
"16417","6207雷科","110/07/14","福勝",15,0,15
"16418","6207雷科","110/07/14","光和-和美",0,20,-20
"16419","6207雷科","110/07/14","群益金鼎-中山",15,0,15
"16420","6207雷科","110/07/14","群益金鼎-丹鳳",0,20,-20
"16421","6207雷科","110/07/14","元大-林園",15,0,15
"16422","6207雷科","110/07/14","第一金-路竹",0,10,-10
"16423","6207雷科","110/07/14","新光",12,0,12
"16424","6207雷科","110/07/14","元大-歸仁",0,10,-10
"16425","6207雷科","110/07/14","元大-大天母",10,0,10
"16426","6207雷科","110/07/14","宏遠-館前",0,9,-9
"16427","6207雷科","110/07/14","永豐金-忠孝",9,0,9
"16428","6207雷科","110/07/14","凱基-台北",12,20,-8
"16429","6207雷科","110/07/14","永豐金-新店",7,0,7
"16430","6207雷科","110/07/14","美林",0,7,-7
"16431","6207雷科","110/07/14","玉山-嘉義",6,0,6
"16432","6207雷科","110/07/14","摩根大通",16,23,-7
"16433","6207雷科","110/07/14","元大-屏東",6,0,6
"16434","6207雷科","110/07/14","凱基-高雄",1,7,-6
"16435","6207雷科","110/07/14","凱基-大安",5,0,5
"16436","6207雷科","110/07/14","台中銀-豐原",0,5,-5
"16437","6207雷科","110/07/14","富邦-台南",5,0,5
"16438","6207雷科","110/07/14","元大-新竹經國",0,5,-5
"16439","6207雷科","110/07/14","元大-成功",5,0,5
"16440","6207雷科","110/07/14","光和-田中",0,4,-4
"16441","3679新至陞","110/07/14","凱基-台北",31,6,25
"16442","3679新至陞","110/07/14","群益金鼎-東大",0,15,-15
"16443","3679新至陞","110/07/14","華南永昌-新莊",10,0,10
"16444","3679新至陞","110/07/14","瑞士信貸",0,12,-12
"16445","3679新至陞","110/07/14","新加坡商瑞銀",11,3,8
"16446","3679新至陞","110/07/14","群益金鼎-永和",0,10,-10
"16447","3679新至陞","110/07/14","美商高盛",6,0,6
"16448","3679新至陞","110/07/14","元大-成功",5,15,-10
"16449","3679新至陞","110/07/14","第一金-中壢",6,0,6
"16450","3679新至陞","110/07/14","統一-板橋",1,10,-9
"16451","3679新至陞","110/07/14","(牛牛牛)亞-網路",4,0,4
"16452","3679新至陞","110/07/14","玉山-左營",0,5,-5
"16453","3679新至陞","110/07/14","元大-六合",3,0,3
"16454","3679新至陞","110/07/14","群益金鼎-三民",0,4,-4
"16455","3679新至陞","110/07/14","合庫-自強",2,0,2
"16456","3679新至陞","110/07/14","富邦-宜蘭",0,4,-4
"16457","3679新至陞","110/07/14","高橋-內壢",2,0,2
"16458","3679新至陞","110/07/14","永豐金-苓雅",0,3,-3
"16459","3679新至陞","110/07/14","台中銀-員林",2,0,2
"16460","3679新至陞","110/07/14","摩根大通",5,7,-2
"16461","3679新至陞","110/07/14","凱基-高美館",2,0,2
"16462","3679新至陞","110/07/14","元大-板橋三民",0,2,-2
"16463","3679新至陞","110/07/14","元大-福營",2,0,2
"16464","3679新至陞","110/07/14","宏遠-中和",0,1,-1
"16465","3679新至陞","110/07/14","永豐金-松山",2,0,2
"16466","3679新至陞","110/07/14","元富-佳里",0,1,-1
"16467","3679新至陞","110/07/14","永豐金-萬盛",2,0,2
"16468","3679新至陞","110/07/14","(牛牛牛)亞-鑫豐",0,1,-1
"16469","3679新至陞","110/07/14","元富-松德",1,0,1
"16470","3679新至陞","110/07/14","中國信託-中壢",0,1,-1
"16471","2727王品","110/07/14","富邦-左營",102,1,101
"16472","2727王品","110/07/14","統一-城中",100,234,-134
"16473","2727王品","110/07/14","國泰-板橋",105,11,94
"16474","2727王品","110/07/14","富邦-台北",1,125,-124
"16475","2727王品","110/07/14","港商野村",149,72,77
"16476","2727王品","110/07/14","台灣摩根士丹利",1,48,-47
"16477","2727王品","110/07/14","合庫-台中",66,2,64
"16478","2727王品","110/07/14","國票-新莊",0,40,-40
"16479","2727王品","110/07/14","臺銀-金山",63,8,55
"16480","2727王品","110/07/14","永豐金-忠孝",2,39,-37
"16481","2727王品","110/07/14","摩根大通",83,39,44
"16482","2727王品","110/07/14","富邦-彰化",1,34,-33
"16483","2727王品","110/07/14","凱基-台北",84,42,42
"16484","2727王品","110/07/14","康和-高雄",0,30,-30
"16485","2727王品","110/07/14","土銀-台中",35,1,34
"16486","2727王品","110/07/14","安泰",0,26,-26
"16487","2727王品","110/07/14","華南永昌-麻豆",32,1,31
"16488","2727王品","110/07/14","富邦-新竹華信",0,21,-21
"16489","2727王品","110/07/14","元大證券",85,55,30
"16490","2727王品","110/07/14","元大-南崁",1,22,-21
"16491","2727王品","110/07/14","新加坡商瑞銀",40,15,25
"16492","2727王品","110/07/14","彰銀-台中",0,18,-18
"16493","2727王品","110/07/14","日盛-八德",19,0,19
"16494","2727王品","110/07/14","元富-同大",2,20,-18
"16495","2727王品","110/07/14","統一",35,17,18
"16496","2727王品","110/07/14","玉山-嘉義",1,17,-16
"16497","2727王品","110/07/14","元富-大昌",18,1,17
"16498","2727王品","110/07/14","國泰-館前",4,20,-16
"16499","2727王品","110/07/14","玉山-板橋",15,1,14
"16500","2727王品","110/07/14","第一金-嘉義",1,13,-12
"16501","1570力肯","110/07/14","國票-北高雄",68,0,68
"16502","1570力肯","110/07/14","摩根大通",0,21,-21
"16503","1570力肯","110/07/14","日盛-八德",30,1,29
"16504","1570力肯","110/07/14","新光",1,19,-18
"16505","1570力肯","110/07/14","玉山-高雄",7,0,7
"16506","1570力肯","110/07/14","(牛牛牛)亞-鑫豐",0,17,-17
"16507","1570力肯","110/07/14","臺銀-臺南",5,0,5
"16508","1570力肯","110/07/14","日盛-士林",0,10,-10
"16509","1570力肯","110/07/14","凱基-三峽",5,0,5
"16510","1570力肯","110/07/14","統一-員林",0,10,-10
"16511","1570力肯","110/07/14","元大-和平",5,0,5
"16512","1570力肯","110/07/14","國票-新莊",0,10,-10
"16513","1570力肯","110/07/14","合庫-三重",4,0,4
"16514","1570力肯","110/07/14","凱基-高美館",0,10,-10
"16515","1570力肯","110/07/14","瑞士信貸",4,0,4
"16516","1570力肯","110/07/14","元大-屏東民生",0,5,-5
"16517","1570力肯","110/07/14","統一-三多",4,0,4
"16518","1570力肯","110/07/14","元大-古亭",0,5,-5
"16519","1570力肯","110/07/14","華南永昌-古亭",4,0,4
"16520","1570力肯","110/07/14","日盛-木柵",0,4,-4
"16521","1570力肯","110/07/14","元大-高雄",3,0,3
"16522","1570力肯","110/07/14","大昌",0,4,-4
"16523","1570力肯","110/07/14","兆豐-忠孝",2,0,2
"16524","1570力肯","110/07/14","群益金鼎-東大",0,4,-4
"16525","1570力肯","110/07/14","富邦-陽明",2,0,2
"16526","1570力肯","110/07/14","凱基-台北",0,4,-4
"16527","1570力肯","110/07/14","元大-松山",2,0,2
"16528","1570力肯","110/07/14","元大-板橋",0,4,-4
"16529","1570力肯","110/07/14","元大-忠孝",2,0,2
"16530","1570力肯","110/07/14","第一金-中山",0,3,-3
"16531","6180橘子","110/07/14","新加坡商瑞銀",84,28,56
"16532","6180橘子","110/07/14","凱基-台北",4,37,-33
"16533","6180橘子","110/07/14","日盛-信義",29,1,28
"16534","6180橘子","110/07/14","玉山-台南",1,22,-21
"16535","6180橘子","110/07/14","豐農",28,4,24
"16536","6180橘子","110/07/14","日盛-新竹",1,21,-20
"16537","6180橘子","110/07/14","新光-新竹",24,1,23
"16538","6180橘子","110/07/14","元富-潮州",0,19,-19
"16539","6180橘子","110/07/14","華南永昌-高雄",20,0,20
"16540","6180橘子","110/07/14","元大-信義",0,17,-17
"16541","6180橘子","110/07/14","元大-羅東",20,0,20
"16542","6180橘子","110/07/14","台灣企銀-台中",1,16,-15
"16543","6180橘子","110/07/14","元大-台中中港",20,0,20
"16544","6180橘子","110/07/14","元大-北港",0,15,-15
"16545","6180橘子","110/07/14","富邦-嘉義",24,5,19
"16546","6180橘子","110/07/14","富邦-高雄",0,14,-14
"16547","6180橘子","110/07/14","富邦-仁愛",15,0,15
"16548","6180橘子","110/07/14","兆豐-埔墘",0,13,-13
"16549","6180橘子","110/07/14","國票-九鼎",13,0,13
"16550","6180橘子","110/07/14","第一金-中山",0,10,-10
"16551","6180橘子","110/07/14","日盛-木柵",12,0,12
"16552","6180橘子","110/07/14","元大-彰化民生",0,10,-10
"16553","6180橘子","110/07/14","元大-成功",10,0,10
"16554","6180橘子","110/07/14","福勝",1,10,-9
"16555","6180橘子","110/07/14","港商野村",10,2,8
"16556","6180橘子","110/07/14","群益金鼎-丹鳳",1,10,-9
"16557","6180橘子","110/07/14","玉山-左營",8,0,8
"16558","6180橘子","110/07/14","群益金鼎-板橋",0,8,-8
"16559","6180橘子","110/07/14","富邦-陽明",16,8,8
"16560","6180橘子","110/07/14","合庫-鳳山",0,7,-7
"16561","2390云辰","110/07/14","摩根大通",995,198,797
"16562","2390云辰","110/07/14","新加坡商瑞銀",28,399,-371
"16563","2390云辰","110/07/14","美林",383,22,361
"16564","2390云辰","110/07/14","凱基-新豐",3,198,-195
"16565","2390云辰","110/07/14","台灣摩根士丹利",684,358,326
"16566","2390云辰","110/07/14","元大-士林",1,152,-151
"16567","2390云辰","110/07/14","凱基-台北",656,402,254
"16568","2390云辰","110/07/14","元大-竹山",80,181,-101
"16569","2390云辰","110/07/14","日盛-和美",110,5,105
"16570","2390云辰","110/07/14","群益金鼎-開元",19,95,-76
"16571","2390云辰","110/07/14","元大-天母",72,0,72
"16572","2390云辰","110/07/14","新光",77,150,-73
"16573","2390云辰","110/07/14","永豐金-松山",57,0,57
"16574","2390云辰","110/07/14","元富-高雄",0,71,-71
"16575","2390云辰","110/07/14","統一-屏東",53,0,53
"16576","2390云辰","110/07/14","元大-土城學府",130,201,-71
"16577","2390云辰","110/07/14","港商野村",486,450,36
"16578","2390云辰","110/07/14","元大-善化",12,76,-64
"16579","2390云辰","110/07/14","致和-崇德",30,0,30
"16580","2390云辰","110/07/14","華南永昌-岡山",23,81,-58
"16581","2390云辰","110/07/14","富邦-台北",40,14,26
"16582","2390云辰","110/07/14","群益金鼎-大興",82,125,-43
"16583","2390云辰","110/07/14","台新-高雄",38,13,25
"16584","2390云辰","110/07/14","大慶-中壢",0,41,-41
"16585","2390云辰","110/07/14","富邦-板橋",32,7,25
"16586","2390云辰","110/07/14","玉山-板橋",6,47,-41
"16587","2390云辰","110/07/14","陽信-石牌",24,0,24
"16588","2390云辰","110/07/14","富邦-台東",2,42,-40
"16589","2390云辰","110/07/14","凱基-屏東",32,8,24
"16590","2390云辰","110/07/14","元大-新營",3,42,-39
"16591","2363矽統","110/07/14","台灣摩根士丹利",463,0,463
"16592","2363矽統","110/07/14","新加坡商瑞銀",568,1321,-753
"16593","2363矽統","110/07/14","台新證券",750,342,408
"16594","2363矽統","110/07/14","瑞士信貸",149,864,-715
"16595","2363矽統","110/07/14","玉山-台中",363,51,312
"16596","2363矽統","110/07/14","台新-屏東",115,380,-265
"16597","2363矽統","110/07/14","元大-斗六",223,25,198
"16598","2363矽統","110/07/14","永豐金證券",16,265,-249
"16599","2363矽統","110/07/14","華南永昌-朴子",208,38,170
"16600","2363矽統","110/07/14","美林",462,701,-239
"16601","2363矽統","110/07/14","元富-西松",169,12,157
"16602","2363矽統","110/07/14","宏遠-桃園",269,500,-231
"16603","2363矽統","110/07/14","永豐金-大園",146,6,140
"16604","2363矽統","110/07/14","凱基-竹北",36,254,-218
"16605","2363矽統","110/07/14","土銀-和平",134,0,134
"16606","2363矽統","110/07/14","港商法國興業",0,214,-214
"16607","2363矽統","110/07/14","富邦-新營",130,13,117
"16608","2363矽統","110/07/14","港商野村",835,1044,-209
"16609","2363矽統","110/07/14","元富-成功",118,11,107
"16610","2363矽統","110/07/14","北城證券",212,411,-199
"16611","2363矽統","110/07/14","元富-烏日",121,18,103
"16612","2363矽統","110/07/14","(牛牛牛)亞-鑫豐",51,241,-190
"16613","2363矽統","110/07/14","日盛-二林",120,18,102
"16614","2363矽統","110/07/14","國票-博愛",24,213,-189
"16615","2363矽統","110/07/14","兆豐-忠孝",98,2,96
"16616","2363矽統","110/07/14","大慶-蘆洲",134,316,-182
"16617","2363矽統","110/07/14","大慶-楊梅",92,3,89
"16618","2363矽統","110/07/14","彰銀-台中",15,193,-178
"16619","2363矽統","110/07/14","元富-三重",120,33,87
"16620","2363矽統","110/07/14","日盛-和美",18,185,-167
"16621","8112至上","110/07/14","新加坡商瑞銀",223,17,206
"16622","8112至上","110/07/14","瑞士信貸",8,170,-162
"16623","8112至上","110/07/14","摩根大通",285,129,156
"16624","8112至上","110/07/14","美林",55,202,-147
"16625","8112至上","110/07/14","花旗環球",124,0,124
"16626","8112至上","110/07/14","凱基-台北",325,436,-111
"16627","8112至上","110/07/14","兆豐-公益",117,4,113
"16628","8112至上","110/07/14","台中銀-台北",0,98,-98
"16629","8112至上","110/07/14","香港上海匯豐",111,0,111
"16630","8112至上","110/07/14","玉山-台大",17,107,-90
"16631","8112至上","110/07/14","永豐金-內湖",117,21,96
"16632","8112至上","110/07/14","康和-內湖",1,90,-89
"16633","8112至上","110/07/14","台灣摩根士丹利",108,16,92
"16634","8112至上","110/07/14","港商野村",21,84,-63
"16635","8112至上","110/07/14","元大-東蘆",77,0,77
"16636","8112至上","110/07/14","兆豐-北高雄",1,60,-59
"16637","8112至上","110/07/14","新光",108,48,60
"16638","8112至上","110/07/14","群益金鼎-海山",1,52,-51
"16639","8112至上","110/07/14","大慶-蘆洲",59,0,59
"16640","8112至上","110/07/14","群益金鼎-大安",0,50,-50
"16641","8112至上","110/07/14","華南永昌-台中",56,3,53
"16642","8112至上","110/07/14","富邦-仁愛",2,49,-47
"16643","8112至上","110/07/14","土銀-嘉義",52,2,50
"16644","8112至上","110/07/14","元大-金華",0,42,-42
"16645","8112至上","110/07/14","美商高盛",40,0,40
"16646","8112至上","110/07/14","元大-內湖",4,43,-39
"16647","8112至上","110/07/14","臺銀",63,29,34
"16648","8112至上","110/07/14","第一金-華江",2,37,-35
"16649","8112至上","110/07/14","元富-嘉義",31,0,31
"16650","8112至上","110/07/14","永豐金-苓雅",2,34,-32
"16651","1570力肯","110/07/14","國票-北高雄",68,0,68
"16652","1570力肯","110/07/14","摩根大通",0,21,-21
"16653","1570力肯","110/07/14","日盛-八德",30,1,29
"16654","1570力肯","110/07/14","新光",1,19,-18
"16655","1570力肯","110/07/14","玉山-高雄",7,0,7
"16656","1570力肯","110/07/14","(牛牛牛)亞-鑫豐",0,17,-17
"16657","1570力肯","110/07/14","臺銀-臺南",5,0,5
"16658","1570力肯","110/07/14","日盛-士林",0,10,-10
"16659","1570力肯","110/07/14","凱基-三峽",5,0,5
"16660","1570力肯","110/07/14","統一-員林",0,10,-10
"16661","1570力肯","110/07/14","元大-和平",5,0,5
"16662","1570力肯","110/07/14","國票-新莊",0,10,-10
"16663","1570力肯","110/07/14","合庫-三重",4,0,4
"16664","1570力肯","110/07/14","凱基-高美館",0,10,-10
"16665","1570力肯","110/07/14","瑞士信貸",4,0,4
"16666","1570力肯","110/07/14","元大-屏東民生",0,5,-5
"16667","1570力肯","110/07/14","統一-三多",4,0,4
"16668","1570力肯","110/07/14","元大-古亭",0,5,-5
"16669","1570力肯","110/07/14","華南永昌-古亭",4,0,4
"16670","1570力肯","110/07/14","日盛-木柵",0,4,-4
"16671","1570力肯","110/07/14","元大-高雄",3,0,3
"16672","1570力肯","110/07/14","大昌",0,4,-4
"16673","1570力肯","110/07/14","兆豐-忠孝",2,0,2
"16674","1570力肯","110/07/14","群益金鼎-東大",0,4,-4
"16675","1570力肯","110/07/14","富邦-陽明",2,0,2
"16676","1570力肯","110/07/14","凱基-台北",0,4,-4
"16677","1570力肯","110/07/14","元大-松山",2,0,2
"16678","1570力肯","110/07/14","元大-板橋",0,4,-4
"16679","1570力肯","110/07/14","元大-忠孝",2,0,2
"16680","1570力肯","110/07/14","第一金-中山",0,3,-3
"16681","2929淘帝","110/07/14","華南永昌-林口",60,0,60
"16682","2929淘帝","110/07/14","群益金鼎",25,540,-515
"16683","2929淘帝","110/07/14","美林",87,31,56
"16684","2929淘帝","110/07/14","國泰-台南",1,30,-29
"16685","2929淘帝","110/07/14","元富-台南",40,0,40
"16686","2929淘帝","110/07/14","宏遠-桃園",0,20,-20
"16687","2929淘帝","110/07/14","元大-民生",39,0,39
"16688","2929淘帝","110/07/14","摩根大通",11,31,-20
"16689","2929淘帝","110/07/14","臺銀-鳳山",34,0,34
"16690","2929淘帝","110/07/14","台新-建北",5,20,-15
"16691","2929淘帝","110/07/14","合庫-高雄",34,1,33
"16692","2929淘帝","110/07/14","新光",1,16,-15
"16693","2929淘帝","110/07/14","華南永昌-鶯歌",28,0,28
"16694","2929淘帝","110/07/14","玉山-板橋",0,15,-15
"16695","2929淘帝","110/07/14","永興",25,0,25
"16696","2929淘帝","110/07/14","凱基-羅東",0,15,-15
"16697","2929淘帝","110/07/14","元大-新盛",25,1,24
"16698","2929淘帝","110/07/14","元大-頭份",0,15,-15
"16699","2929淘帝","110/07/14","日盛-南京",23,0,23
"16700","2929淘帝","110/07/14","第一金-台南",0,13,-13
"16701","2929淘帝","110/07/14","日茂",20,0,20
"16702","2929淘帝","110/07/14","富邦-基隆",0,12,-12
"16703","2929淘帝","110/07/14","台新-台中",20,0,20
"16704","2929淘帝","110/07/14","日茂-南投",1,12,-11
"16705","2929淘帝","110/07/14","華南永昌",20,0,20
"16706","2929淘帝","110/07/14","元大-豐原站前",0,11,-11
"16707","2929淘帝","110/07/14","福勝",15,0,15
"16708","2929淘帝","110/07/14","玉山-士林",0,10,-10
"16709","2929淘帝","110/07/14","富邦-南屯",15,0,15
"16710","2929淘帝","110/07/14","富邦-台北",0,10,-10
"16711","5410國眾","110/07/14","兆豐-城中",35,0,35
"16712","5410國眾","110/07/14","瑞士信貸",0,29,-29
"16713","5410國眾","110/07/14","新光",21,1,20
"16714","5410國眾","110/07/14","國泰-板橋",1,30,-29
"16715","5410國眾","110/07/14","國泰-敦南",21,1,20
"16716","5410國眾","110/07/14","日盛-高雄",0,20,-20
"16717","5410國眾","110/07/14","國泰-台中",20,1,19
"16718","5410國眾","110/07/14","台新-左楠",1,20,-19
"16719","5410國眾","110/07/14","元大-崇德",19,0,19
"16720","5410國眾","110/07/14","元富-大昌",1,18,-17
"16721","5410國眾","110/07/14","土銀-士林",18,0,18
"16722","5410國眾","110/07/14","富邦-建國",0,15,-15
"16723","5410國眾","110/07/14","元大-新盛",20,2,18
"16724","5410國眾","110/07/14","元富-嘉義",0,12,-12
"16725","5410國眾","110/07/14","兆豐-高雄",15,0,15
"16726","5410國眾","110/07/14","永全-南崁",0,12,-12
"16727","5410國眾","110/07/14","宏遠-中和",10,0,10
"16728","5410國眾","110/07/14","元大-員林",0,11,-11
"16729","5410國眾","110/07/14","新光-桃園",10,0,10
"16730","5410國眾","110/07/14","高橋",0,10,-10
"16731","5410國眾","110/07/14","國泰-台南",10,0,10
"16732","5410國眾","110/07/14","永興",0,10,-10
"16733","5410國眾","110/07/14","元大-復北",10,0,10
"16734","5410國眾","110/07/14","華南永昌-三重",0,10,-10
"16735","5410國眾","110/07/14","元大-竹科",8,0,8
"16736","5410國眾","110/07/14","元大-苑裡",0,7,-7
"16737","5410國眾","110/07/14","台新-新營",6,0,6
"16738","5410國眾","110/07/14","港商野村",0,6,-6
"16739","5410國眾","110/07/14","日盛-士林",5,0,5
"16740","5410國眾","110/07/14","摩根大通",5,11,-6
"16741","2841台開","110/07/14","凱基-文心",73,0,73
"16742","2841台開","110/07/14","國泰-敦南",0,50,-50
"16743","2841台開","110/07/14","元富-潮州",30,0,30
"16744","2841台開","110/07/14","凱基-中壢",0,40,-40
"16745","2841台開","110/07/14","第一金-台中",20,0,20
"16746","2841台開","110/07/14","統一-新竹",0,24,-24
"16747","2841台開","110/07/14","華南永昌-新莊",20,0,20
"16748","2841台開","110/07/14","元富-草屯",0,20,-20
"16749","2841台開","110/07/14","永豐金-豐原",20,0,20
"16750","2841台開","110/07/14","台新-台南",0,20,-20
"16751","2841台開","110/07/14","國泰-館前",15,0,15
"16752","2841台開","110/07/14","永豐金-敦南",45,63,-18
"16753","2841台開","110/07/14","群益金鼎-基隆",12,0,12
"16754","2841台開","110/07/14","國票-北高雄",0,13,-13
"16755","2841台開","110/07/14","日盛-信義",10,0,10
"16756","2841台開","110/07/14","凱基-松山",0,10,-10
"16757","2841台開","110/07/14","台新-台中",10,0,10
"16758","2841台開","110/07/14","元大證券",0,10,-10
"16759","2841台開","110/07/14","新光",10,1,9
"16760","2841台開","110/07/14","元大-中壢",0,10,-10
"16761","2841台開","110/07/14","凱基-新店",8,0,8
"16762","2841台開","110/07/14","富邦-陽明",1,10,-9
"16763","2841台開","110/07/14","元大-斗信",7,0,7
"16764","2841台開","110/07/14","富邦-建國",0,9,-9
"16765","2841台開","110/07/14","元大-三重",6,0,6
"16766","2841台開","110/07/14","富邦-台南",0,8,-8
"16767","2841台開","110/07/14","永豐金-中和",6,0,6
"16768","2841台開","110/07/14","康和-澎湖",0,7,-7
"16769","2841台開","110/07/14","元富-成功",5,0,5
"16770","2841台開","110/07/14","日盛-斗六",0,6,-6
"16771","6207雷科","110/07/14","群益金鼎-台北",60,0,60
"16772","6207雷科","110/07/14","新加坡商瑞銀",10,56,-46
"16773","6207雷科","110/07/14","台新-高雄",43,3,40
"16774","6207雷科","110/07/14","國票-中和",0,41,-41
"16775","6207雷科","110/07/14","元大-高雄",19,0,19
"16776","6207雷科","110/07/14","元大-復北",0,33,-33
"16777","6207雷科","110/07/14","福勝",15,0,15
"16778","6207雷科","110/07/14","光和-和美",0,20,-20
"16779","6207雷科","110/07/14","群益金鼎-中山",15,0,15
"16780","6207雷科","110/07/14","群益金鼎-丹鳳",0,20,-20
"16781","6207雷科","110/07/14","元大-林園",15,0,15
"16782","6207雷科","110/07/14","第一金-路竹",0,10,-10
"16783","6207雷科","110/07/14","新光",12,0,12
"16784","6207雷科","110/07/14","元大-歸仁",0,10,-10
"16785","6207雷科","110/07/14","元大-大天母",10,0,10
"16786","6207雷科","110/07/14","宏遠-館前",0,9,-9
"16787","6207雷科","110/07/14","永豐金-忠孝",9,0,9
"16788","6207雷科","110/07/14","凱基-台北",12,20,-8
"16789","6207雷科","110/07/14","永豐金-新店",7,0,7
"16790","6207雷科","110/07/14","美林",0,7,-7
"16791","6207雷科","110/07/14","玉山-嘉義",6,0,6
"16792","6207雷科","110/07/14","摩根大通",16,23,-7
"16793","6207雷科","110/07/14","元大-屏東",6,0,6
"16794","6207雷科","110/07/14","凱基-高雄",1,7,-6
"16795","6207雷科","110/07/14","凱基-大安",5,0,5
"16796","6207雷科","110/07/14","台中銀-豐原",0,5,-5
"16797","6207雷科","110/07/14","富邦-台南",5,0,5
"16798","6207雷科","110/07/14","元大-新竹經國",0,5,-5
"16799","6207雷科","110/07/14","元大-成功",5,0,5
"16800","6207雷科","110/07/14","光和-田中",0,4,-4
"16801","3679新至陞","110/07/14","凱基-台北",31,6,25
"16802","3679新至陞","110/07/14","群益金鼎-東大",0,15,-15
"16803","3679新至陞","110/07/14","華南永昌-新莊",10,0,10
"16804","3679新至陞","110/07/14","瑞士信貸",0,12,-12
"16805","3679新至陞","110/07/14","新加坡商瑞銀",11,3,8
"16806","3679新至陞","110/07/14","群益金鼎-永和",0,10,-10
"16807","3679新至陞","110/07/14","美商高盛",6,0,6
"16808","3679新至陞","110/07/14","元大-成功",5,15,-10
"16809","3679新至陞","110/07/14","第一金-中壢",6,0,6
"16810","3679新至陞","110/07/14","統一-板橋",1,10,-9
"16811","3679新至陞","110/07/14","(牛牛牛)亞-網路",4,0,4
"16812","3679新至陞","110/07/14","玉山-左營",0,5,-5
"16813","3679新至陞","110/07/14","元大-六合",3,0,3
"16814","3679新至陞","110/07/14","群益金鼎-三民",0,4,-4
"16815","3679新至陞","110/07/14","合庫-自強",2,0,2
"16816","3679新至陞","110/07/14","富邦-宜蘭",0,4,-4
"16817","3679新至陞","110/07/14","高橋-內壢",2,0,2
"16818","3679新至陞","110/07/14","永豐金-苓雅",0,3,-3
"16819","3679新至陞","110/07/14","台中銀-員林",2,0,2
"16820","3679新至陞","110/07/14","摩根大通",5,7,-2
"16821","3679新至陞","110/07/14","凱基-高美館",2,0,2
"16822","3679新至陞","110/07/14","元大-板橋三民",0,2,-2
"16823","3679新至陞","110/07/14","元大-福營",2,0,2
"16824","3679新至陞","110/07/14","宏遠-中和",0,1,-1
"16825","3679新至陞","110/07/14","永豐金-松山",2,0,2
"16826","3679新至陞","110/07/14","元富-佳里",0,1,-1
"16827","3679新至陞","110/07/14","永豐金-萬盛",2,0,2
"16828","3679新至陞","110/07/14","(牛牛牛)亞-鑫豐",0,1,-1
"16829","3679新至陞","110/07/14","元富-松德",1,0,1
"16830","3679新至陞","110/07/14","中國信託-中壢",0,1,-1
"16831","2727王品","110/07/14","富邦-左營",102,1,101
"16832","2727王品","110/07/14","統一-城中",100,234,-134
"16833","2727王品","110/07/14","國泰-板橋",105,11,94
"16834","2727王品","110/07/14","富邦-台北",1,125,-124
"16835","2727王品","110/07/14","港商野村",149,72,77
"16836","2727王品","110/07/14","台灣摩根士丹利",1,48,-47
"16837","2727王品","110/07/14","合庫-台中",66,2,64
"16838","2727王品","110/07/14","國票-新莊",0,40,-40
"16839","2727王品","110/07/14","臺銀-金山",63,8,55
"16840","2727王品","110/07/14","永豐金-忠孝",2,39,-37
"16841","2727王品","110/07/14","摩根大通",83,39,44
"16842","2727王品","110/07/14","富邦-彰化",1,34,-33
"16843","2727王品","110/07/14","凱基-台北",84,42,42
"16844","2727王品","110/07/14","康和-高雄",0,30,-30
"16845","2727王品","110/07/14","土銀-台中",35,1,34
"16846","2727王品","110/07/14","安泰",0,26,-26
"16847","2727王品","110/07/14","華南永昌-麻豆",32,1,31
"16848","2727王品","110/07/14","富邦-新竹華信",0,21,-21
"16849","2727王品","110/07/14","元大證券",85,55,30
"16850","2727王品","110/07/14","元大-南崁",1,22,-21
"16851","2727王品","110/07/14","新加坡商瑞銀",40,15,25
"16852","2727王品","110/07/14","彰銀-台中",0,18,-18
"16853","2727王品","110/07/14","日盛-八德",19,0,19
"16854","2727王品","110/07/14","元富-同大",2,20,-18
"16855","2727王品","110/07/14","統一",35,17,18
"16856","2727王品","110/07/14","玉山-嘉義",1,17,-16
"16857","2727王品","110/07/14","元富-大昌",18,1,17
"16858","2727王品","110/07/14","國泰-館前",4,20,-16
"16859","2727王品","110/07/14","玉山-板橋",15,1,14
"16860","2727王品","110/07/14","第一金-嘉義",1,13,-12
"16861","1570力肯","110/07/14","國票-北高雄",68,0,68
"16862","1570力肯","110/07/14","摩根大通",0,21,-21
"16863","1570力肯","110/07/14","日盛-八德",30,1,29
"16864","1570力肯","110/07/14","新光",1,19,-18
"16865","1570力肯","110/07/14","玉山-高雄",7,0,7
"16866","1570力肯","110/07/14","(牛牛牛)亞-鑫豐",0,17,-17
"16867","1570力肯","110/07/14","臺銀-臺南",5,0,5
"16868","1570力肯","110/07/14","日盛-士林",0,10,-10
"16869","1570力肯","110/07/14","凱基-三峽",5,0,5
"16870","1570力肯","110/07/14","統一-員林",0,10,-10
"16871","1570力肯","110/07/14","元大-和平",5,0,5
"16872","1570力肯","110/07/14","國票-新莊",0,10,-10
"16873","1570力肯","110/07/14","合庫-三重",4,0,4
"16874","1570力肯","110/07/14","凱基-高美館",0,10,-10
"16875","1570力肯","110/07/14","瑞士信貸",4,0,4
"16876","1570力肯","110/07/14","元大-屏東民生",0,5,-5
"16877","1570力肯","110/07/14","統一-三多",4,0,4
"16878","1570力肯","110/07/14","元大-古亭",0,5,-5
"16879","1570力肯","110/07/14","華南永昌-古亭",4,0,4
"16880","1570力肯","110/07/14","日盛-木柵",0,4,-4
"16881","1570力肯","110/07/14","元大-高雄",3,0,3
"16882","1570力肯","110/07/14","大昌",0,4,-4
"16883","1570力肯","110/07/14","兆豐-忠孝",2,0,2
"16884","1570力肯","110/07/14","群益金鼎-東大",0,4,-4
"16885","1570力肯","110/07/14","富邦-陽明",2,0,2
"16886","1570力肯","110/07/14","凱基-台北",0,4,-4
"16887","1570力肯","110/07/14","元大-松山",2,0,2
"16888","1570力肯","110/07/14","元大-板橋",0,4,-4
"16889","1570力肯","110/07/14","元大-忠孝",2,0,2
"16890","1570力肯","110/07/14","第一金-中山",0,3,-3
"16891","6180橘子","110/07/14","新加坡商瑞銀",84,28,56
"16892","6180橘子","110/07/14","凱基-台北",4,37,-33
"16893","6180橘子","110/07/14","日盛-信義",29,1,28
"16894","6180橘子","110/07/14","玉山-台南",1,22,-21
"16895","6180橘子","110/07/14","豐農",28,4,24
"16896","6180橘子","110/07/14","日盛-新竹",1,21,-20
"16897","6180橘子","110/07/14","新光-新竹",24,1,23
"16898","6180橘子","110/07/14","元富-潮州",0,19,-19
"16899","6180橘子","110/07/14","華南永昌-高雄",20,0,20
"16900","6180橘子","110/07/14","元大-信義",0,17,-17
"16901","6180橘子","110/07/14","元大-羅東",20,0,20
"16902","6180橘子","110/07/14","台灣企銀-台中",1,16,-15
"16903","6180橘子","110/07/14","元大-台中中港",20,0,20
"16904","6180橘子","110/07/14","元大-北港",0,15,-15
"16905","6180橘子","110/07/14","富邦-嘉義",24,5,19
"16906","6180橘子","110/07/14","富邦-高雄",0,14,-14
"16907","6180橘子","110/07/14","富邦-仁愛",15,0,15
"16908","6180橘子","110/07/14","兆豐-埔墘",0,13,-13
"16909","6180橘子","110/07/14","國票-九鼎",13,0,13
"16910","6180橘子","110/07/14","第一金-中山",0,10,-10
"16911","6180橘子","110/07/14","日盛-木柵",12,0,12
"16912","6180橘子","110/07/14","元大-彰化民生",0,10,-10
"16913","6180橘子","110/07/14","元大-成功",10,0,10
"16914","6180橘子","110/07/14","福勝",1,10,-9
"16915","6180橘子","110/07/14","港商野村",10,2,8
"16916","6180橘子","110/07/14","群益金鼎-丹鳳",1,10,-9
"16917","6180橘子","110/07/14","玉山-左營",8,0,8
"16918","6180橘子","110/07/14","群益金鼎-板橋",0,8,-8
"16919","6180橘子","110/07/14","富邦-陽明",16,8,8
"16920","6180橘子","110/07/14","合庫-鳳山",0,7,-7
"16921","2390云辰","110/07/14","摩根大通",995,198,797
"16922","2390云辰","110/07/14","新加坡商瑞銀",28,399,-371
"16923","2390云辰","110/07/14","美林",383,22,361
"16924","2390云辰","110/07/14","凱基-新豐",3,198,-195
"16925","2390云辰","110/07/14","台灣摩根士丹利",684,358,326
"16926","2390云辰","110/07/14","元大-士林",1,152,-151
"16927","2390云辰","110/07/14","凱基-台北",656,402,254
"16928","2390云辰","110/07/14","元大-竹山",80,181,-101
"16929","2390云辰","110/07/14","日盛-和美",110,5,105
"16930","2390云辰","110/07/14","群益金鼎-開元",19,95,-76
"16931","2390云辰","110/07/14","元大-天母",72,0,72
"16932","2390云辰","110/07/14","新光",77,150,-73
"16933","2390云辰","110/07/14","永豐金-松山",57,0,57
"16934","2390云辰","110/07/14","元富-高雄",0,71,-71
"16935","2390云辰","110/07/14","統一-屏東",53,0,53
"16936","2390云辰","110/07/14","元大-土城學府",130,201,-71
"16937","2390云辰","110/07/14","港商野村",486,450,36
"16938","2390云辰","110/07/14","元大-善化",12,76,-64
"16939","2390云辰","110/07/14","致和-崇德",30,0,30
"16940","2390云辰","110/07/14","華南永昌-岡山",23,81,-58
"16941","2390云辰","110/07/14","富邦-台北",40,14,26
"16942","2390云辰","110/07/14","群益金鼎-大興",82,125,-43
"16943","2390云辰","110/07/14","台新-高雄",38,13,25
"16944","2390云辰","110/07/14","大慶-中壢",0,41,-41
"16945","2390云辰","110/07/14","富邦-板橋",32,7,25
"16946","2390云辰","110/07/14","玉山-板橋",6,47,-41
"16947","2390云辰","110/07/14","陽信-石牌",24,0,24
"16948","2390云辰","110/07/14","富邦-台東",2,42,-40
"16949","2390云辰","110/07/14","凱基-屏東",32,8,24
"16950","2390云辰","110/07/14","元大-新營",3,42,-39
"16951","2363矽統","110/07/13","凱基-南崁",2133,63,2070
"16952","2363矽統","110/07/13","凱基-幸福",36,4048,-4012
"16953","2363矽統","110/07/13","國泰-敦南",2195,1617,578
"16954","2363矽統","110/07/13","統一",192,3325,-3133
"16955","2363矽統","110/07/13","中農",670,139,531
"16956","2363矽統","110/07/13","新加坡商瑞銀",1000,2747,-1747
"16957","2363矽統","110/07/13","康和-台中",638,154,484
"16958","2363矽統","110/07/13","凱基-台北",5359,6609,-1250
"16959","2363矽統","110/07/13","群益金鼎-三民",577,137,440
"16960","2363矽統","110/07/13","摩根大通",1930,2858,-928
"16961","2363矽統","110/07/13","台新-屏東",510,88,422
"16962","2363矽統","110/07/13","港商野村",960,1679,-719
"16963","2363矽統","110/07/13","德信-中正",455,67,388
"16964","2363矽統","110/07/13","兆豐-復興",25,705,-680
"16965","2363矽統","110/07/13","日盛-竹北",365,70,295
"16966","2363矽統","110/07/13","統一-仁愛",114,755,-641
"16967","2363矽統","110/07/13","元大-佳里",452,189,263
"16968","2363矽統","110/07/13","統一-敦南",29,638,-609
"16969","2363矽統","110/07/13","國票-博愛",296,38,258
"16970","2363矽統","110/07/13","統一-土城",100,704,-604
"16971","2363矽統","110/07/13","元大-萬華",340,95,245
"16972","2363矽統","110/07/13","統一-城中",116,676,-560
"16973","2363矽統","110/07/13","新光",1259,1031,228
"16974","2363矽統","110/07/13","永豐金證券",306,859,-553
"16975","2363矽統","110/07/13","元富-成功",323,96,227
"16976","2363矽統","110/07/13","元富",54,567,-513
"16977","2363矽統","110/07/13","豐農",228,23,205
"16978","2363矽統","110/07/13","瑞士信貸",202,666,-464
"16979","2363矽統","110/07/13","台灣企銀-岡山",186,4,182
"16980","2363矽統","110/07/13","永豐金-嘉義",67,468,-401
"16981","8112至上","110/07/13","摩根大通",688,296,392
"16982","8112至上","110/07/13","國票-中和",0,401,-401
"16983","8112至上","110/07/13","港商野村",344,145,199
"16984","8112至上","110/07/13","永豐金-板盛",0,205,-205
"16985","8112至上","110/07/13","兆豐-公益",195,5,190
"16986","8112至上","110/07/13","凱基-五股",43,155,-112
"16987","8112至上","110/07/13","台灣摩根士丹利",183,0,183
"16988","8112至上","110/07/13","凱基-市政",0,100,-100
"16989","8112至上","110/07/13","群益金鼎-敦南",153,2,151
"16990","8112至上","110/07/13","元大-大里德芳",1,92,-91
"16991","8112至上","110/07/13","臺銀-金山",146,26,120
"16992","8112至上","110/07/13","玉山-桃園",26,110,-84
"16993","8112至上","110/07/13","臺銀",133,19,114
"16994","8112至上","110/07/13","兆豐-天母",0,81,-81
"16995","8112至上","110/07/13","合庫-台中",115,6,109
"16996","8112至上","110/07/13","凱基-城中",3,84,-81
"16997","8112至上","110/07/13","亞東-板橋",134,26,108
"16998","8112至上","110/07/13","日盛-新莊",9,85,-76
"16999","8112至上","110/07/13","凱基-台北",414,326,88
"17000","8112至上","110/07/13","日盛-台中",2,64,-62
"17001","8112至上","110/07/13","新加坡商瑞銀",181,100,81
"17002","8112至上","110/07/13","日盛-中壢",3,64,-61
"17003","8112至上","110/07/13","國泰-敦南",108,31,77
"17004","8112至上","110/07/13","元大-台中",2,59,-57
"17005","8112至上","110/07/13","第一金-華江",77,4,73
"17006","8112至上","110/07/13","元大-雙和",7,64,-57
"17007","8112至上","110/07/13","永豐金-內湖",73,1,72
"17008","8112至上","110/07/13","元大-高雄",8,62,-54
"17009","8112至上","110/07/13","元大-永和",68,1,67
"17010","8112至上","110/07/13","元大-館前",2,55,-53
"17011","1570力肯","110/07/13","新光",115,11,104
"17012","1570力肯","110/07/13","元大-北三重",0,162,-162
"17013","1570力肯","110/07/13","群益金鼎-高雄",54,0,54
"17014","1570力肯","110/07/13","元大-大灣",0,25,-25
"17015","1570力肯","110/07/13","國票-新莊",22,0,22
"17016","1570力肯","110/07/13","永豐金-苓雅",0,22,-22
"17017","1570力肯","110/07/13","日盛-桃園",12,0,12
"17018","1570力肯","110/07/13","永豐金-永康",0,19,-19
"17019","1570力肯","110/07/13","元大-高雄",12,0,12
"17020","1570力肯","110/07/13","富邦-員林",0,15,-15
"17021","1570力肯","110/07/13","合庫-自強",11,0,11
"17022","1570力肯","110/07/13","凱基-台南",0,11,-11
"17023","1570力肯","110/07/13","摩根大通",26,15,11
"17024","1570力肯","110/07/13","日盛-竹北",0,10,-10
"17025","1570力肯","110/07/13","永豐金-中盛",11,0,11
"17026","1570力肯","110/07/13","國票-九鼎",0,10,-10
"17027","1570力肯","110/07/13","兆豐-台中港",10,0,10
"17028","1570力肯","110/07/13","凱基-桃園",0,10,-10
"17029","1570力肯","110/07/13","國泰-松江",9,0,9
"17030","1570力肯","110/07/13","凱基-新豐",0,10,-10
"17031","1570力肯","110/07/13","元大-新盛",9,0,9
"17032","1570力肯","110/07/13","元大-學甲",0,10,-10
"17033","1570力肯","110/07/13","元富-緯城",6,0,6
"17034","1570力肯","110/07/13","群益金鼎-東湖",1,10,-9
"17035","1570力肯","110/07/13","統一-三重",5,0,5
"17036","1570力肯","110/07/13","大昌",0,6,-6
"17037","1570力肯","110/07/13","元大-前金",5,0,5
"17038","1570力肯","110/07/13","元大-土城學府",0,6,-6
"17039","1570力肯","110/07/13","永豐金證券",5,0,5
"17040","1570力肯","110/07/13","統一",0,5,-5
"17041","2929淘帝","110/07/13","玉山-新竹",130,0,130
"17042","2929淘帝","110/07/13","美商高盛",0,177,-177
"17043","2929淘帝","110/07/13","臺銀-民權",60,0,60
"17044","2929淘帝","110/07/13","凱基-台北",6,80,-74
"17045","2929淘帝","110/07/13","新百王",31,0,31
"17046","2929淘帝","110/07/13","元富-大裕",0,49,-49
"17047","2929淘帝","110/07/13","日盛-園區",30,0,30
"17048","2929淘帝","110/07/13","國泰-館前",3,51,-48
"17049","2929淘帝","110/07/13","元大-南投",31,1,30
"17050","2929淘帝","110/07/13","凱基-中壢",0,41,-41
"17051","2929淘帝","110/07/13","兆豐-忠孝",28,0,28
"17052","2929淘帝","110/07/13","港商野村",21,55,-34
"17053","2929淘帝","110/07/13","元大-民生",28,0,28
"17054","2929淘帝","110/07/13","華南永昌-南京",2,34,-32
"17055","2929淘帝","110/07/13","合庫-高雄",27,0,27
"17056","2929淘帝","110/07/13","群益金鼎-土城",0,30,-30
"17057","2929淘帝","110/07/13","凱基-豐中",27,0,27
"17058","2929淘帝","110/07/13","富邦-南屯",0,22,-22
"17059","2929淘帝","110/07/13","新光",21,4,17
"17060","2929淘帝","110/07/13","第一金-豐原",0,20,-20
"17061","2929淘帝","110/07/13","元大-天母",17,0,17
"17062","2929淘帝","110/07/13","元大-屏南",6,26,-20
"17063","2929淘帝","110/07/13","永興",14,0,14
"17064","2929淘帝","110/07/13","永豐金-敦南",1,21,-20
"17065","2929淘帝","110/07/13","富邦-台北",12,0,12
"17066","2929淘帝","110/07/13","凱基-三重",2,21,-19
"17067","2929淘帝","110/07/13","元大-永和",12,0,12
"17068","2929淘帝","110/07/13","富邦-仁愛",7,25,-18
"17069","2929淘帝","110/07/13","國票-天祥",11,0,11
"17070","2929淘帝","110/07/13","元大-北投",0,16,-16
"17071","5410國眾","110/07/13","兆豐-城中",274,0,274
"17072","5410國眾","110/07/13","元富-嘉義",0,103,-103
"17073","5410國眾","110/07/13","新光",50,4,46
"17074","5410國眾","110/07/13","凱基-台北",0,50,-50
"17075","5410國眾","110/07/13","國泰-台中",26,0,26
"17076","5410國眾","110/07/13","瑞士信貸",0,31,-31
"17077","5410國眾","110/07/13","新加坡商瑞銀",22,0,22
"17078","5410國眾","110/07/13","台新-新莊",0,27,-27
"17079","5410國眾","110/07/13","光和-嘉義",20,0,20
"17080","5410國眾","110/07/13","元大-汐止",0,20,-20
"17081","5410國眾","110/07/13","凱基-竹北",17,0,17
"17082","5410國眾","110/07/13","亞東-新竹",0,17,-17
"17083","5410國眾","110/07/13","新光-桃園",15,0,15
"17084","5410國眾","110/07/13","元大-南勢角",0,13,-13
"17085","5410國眾","110/07/13","凱基-台東",14,0,14
"17086","5410國眾","110/07/13","台新-台南",0,12,-12
"17087","5410國眾","110/07/13","富邦-竹北",11,0,11
"17088","5410國眾","110/07/13","中國信託",0,11,-11
"17089","5410國眾","110/07/13","元富-同大",10,0,10
"17090","5410國眾","110/07/13","華南永昌",0,11,-11
"17091","5410國眾","110/07/13","國泰-敦南",24,15,9
"17092","5410國眾","110/07/13","臺銀-臺南",0,10,-10
"17093","5410國眾","110/07/13","日盛-內湖",7,0,7
"17094","5410國眾","110/07/13","台灣企銀-民雄",0,10,-10
"17095","5410國眾","110/07/13","台新-左楠",7,0,7
"17096","5410國眾","110/07/13","高橋",0,10,-10
"17097","5410國眾","110/07/13","元大-新盛",18,12,6
"17098","5410國眾","110/07/13","康和-嘉義",0,10,-10
"17099","5410國眾","110/07/13","統一",5,0,5
"17100","5410國眾","110/07/13","凱基-基隆",0,10,-10
"17101","2841台開","110/07/13","中國信託-高雄",251,50,201
"17102","2841台開","110/07/13","兆豐-公益",0,177,-177
"17103","2841台開","110/07/13","日盛證券",210,13,197
"17104","2841台開","110/07/13","日進",0,152,-152
"17105","2841台開","110/07/13","第一金-台中",55,0,55
"17106","2841台開","110/07/13","港商野村",0,109,-109
"17107","2841台開","110/07/13","國泰-板橋",46,0,46
"17108","2841台開","110/07/13","日盛-信義",0,103,-103
"17109","2841台開","110/07/13","國泰-館前",48,3,45
"17110","2841台開","110/07/13","國泰-敦南",11,75,-64
"17111","2841台開","110/07/13","華南永昌-新莊",45,0,45
"17112","2841台開","110/07/13","永興",0,50,-50
"17113","2841台開","110/07/13","日盛-園區",42,0,42
"17114","2841台開","110/07/13","永豐金-敦南",61,104,-43
"17115","2841台開","110/07/13","台新證券",32,0,32
"17116","2841台開","110/07/13","富邦-台南",0,42,-42
"17117","2841台開","110/07/13","台新-高雄",32,2,30
"17118","2841台開","110/07/13","國票-安和",0,30,-30
"17119","2841台開","110/07/13","豐農",23,0,23
"17120","2841台開","110/07/13","元大-桃園",0,25,-25
"17121","2841台開","110/07/13","合庫-嘉義",20,0,20
"17122","2841台開","110/07/13","新光",8,32,-24
"17123","2841台開","110/07/13","華南永昌-高雄",20,0,20
"17124","2841台開","110/07/13","元大-仁愛",0,24,-24
"17125","2841台開","110/07/13","元大-樹林",16,0,16
"17126","2841台開","110/07/13","日盛-中和",0,20,-20
"17127","2841台開","110/07/13","第一金-華江",15,2,13
"17128","2841台開","110/07/13","元富",0,20,-20
"17129","2841台開","110/07/13","美商高盛",12,0,12
"17130","2841台開","110/07/13","富邦-宜蘭",0,20,-20
"17131","6207雷科","110/07/13","元大-高雄",121,0,121
"17132","6207雷科","110/07/13","華南永昌-朴子",1,60,-59
"17133","6207雷科","110/07/13","第一金-新興",20,0,20
"17134","6207雷科","110/07/13","元大-南海",0,36,-36
"17135","6207雷科","110/07/13","元富-三重",20,0,20
"17136","6207雷科","110/07/13","凱基-土城",0,35,-35
"17137","6207雷科","110/07/13","元大-林園",15,0,15
"17138","6207雷科","110/07/13","台灣企銀",0,20,-20
"17139","6207雷科","110/07/13","元大-金華",16,1,15
"17140","6207雷科","110/07/13","群益金鼎-丹鳳",0,20,-20
"17141","6207雷科","110/07/13","日盛證券",10,0,10
"17142","6207雷科","110/07/13","元大-博愛",0,17,-17
"17143","6207雷科","110/07/13","統一-台中",10,0,10
"17144","6207雷科","110/07/13","元大-北港",0,13,-13
"17145","6207雷科","110/07/13","群益金鼎-土城",10,0,10
"17146","6207雷科","110/07/13","新加坡商瑞銀",0,12,-12
"17147","6207雷科","110/07/13","群益金鼎-桃園",10,0,10
"17148","6207雷科","110/07/13","凱基-台北",4,16,-12
"17149","6207雷科","110/07/13","永豐金-新莊",10,0,10
"17150","6207雷科","110/07/13","日茂-埔里",0,11,-11
"17151","6207雷科","110/07/13","永豐金-新店",10,0,10
"17152","6207雷科","110/07/13","元大-莒光",0,11,-11
"17153","6207雷科","110/07/13","元大證券",9,0,9
"17154","6207雷科","110/07/13","統一-新竹",0,10,-10
"17155","6207雷科","110/07/13","日盛-木柵",9,1,8
"17156","6207雷科","110/07/13","元大-西螺",0,10,-10
"17157","6207雷科","110/07/13","兆豐-來福",8,0,8
"17158","6207雷科","110/07/13","康和-台中",0,8,-8
"17159","6207雷科","110/07/13","新光",7,0,7
"17160","6207雷科","110/07/13","兆豐-高雄",0,6,-6
"17161","3679新至陞","110/07/13","永豐金證券",50,0,50
"17162","3679新至陞","110/07/13","摩根大通",2,25,-23
"17163","3679新至陞","110/07/13","國泰-桃園",22,0,22
"17164","3679新至陞","110/07/13","元大-成功",0,22,-22
"17165","3679新至陞","110/07/13","台中銀-員林",11,0,11
"17166","3679新至陞","110/07/13","富邦-板橋",1,19,-18
"17167","3679新至陞","110/07/13","元大-文心興安",8,0,8
"17168","3679新至陞","110/07/13","日盛-新莊",0,10,-10
"17169","3679新至陞","110/07/13","美商高盛",6,0,6
"17170","3679新至陞","110/07/13","台新-台中",0,10,-10
"17171","3679新至陞","110/07/13","台新-高雄",6,0,6
"17172","3679新至陞","110/07/13","永豐金-新竹",0,8,-8
"17173","3679新至陞","110/07/13","凱基-台北",18,12,6
"17174","3679新至陞","110/07/13","瑞士信貸",12,19,-7
"17175","3679新至陞","110/07/13","日盛-復興",5,0,5
"17176","3679新至陞","110/07/13","統一-南京",0,7,-7
"17177","3679新至陞","110/07/13","(牛牛牛)亞-鑫豐",4,0,4
"17178","3679新至陞","110/07/13","凱基-新莊",0,7,-7
"17179","3679新至陞","110/07/13","元富-大昌",3,0,3
"17180","3679新至陞","110/07/13","新加坡商瑞銀",0,6,-6
"17181","3679新至陞","110/07/13","富邦-台北",3,0,3
"17182","3679新至陞","110/07/13","合庫-自強",0,5,-5
"17183","3679新至陞","110/07/13","日盛-樹林",2,0,2
"17184","3679新至陞","110/07/13","富邦-桃園",0,5,-5
"17185","3679新至陞","110/07/13","宏遠-光隆",2,0,2
"17186","3679新至陞","110/07/13","永豐金-潮州",0,4,-4
"17187","3679新至陞","110/07/13","美林",3,1,2
"17188","3679新至陞","110/07/13","臺銀-臺南",0,3,-3
"17189","3679新至陞","110/07/13","第一金-中壢",2,0,2
"17190","3679新至陞","110/07/13","元大-六合",0,3,-3
"17191","2727王品","110/07/13","富邦-台北",43,3,40
"17192","2727王品","110/07/13","台灣摩根士丹利",15,97,-82
"17193","2727王品","110/07/13","元大-基隆孝二",40,0,40
"17194","2727王品","110/07/13","玉山-台南",5,57,-52
"17195","2727王品","110/07/13","國票-新莊",40,1,39
"17196","2727王品","110/07/13","新加坡商瑞銀",0,48,-48
"17197","2727王品","110/07/13","第一金-豐原",66,42,24
"17198","2727王品","110/07/13","凱基-台北",41,77,-36
"17199","2727王品","110/07/13","永豐金-大園",34,10,24
"17200","2727王品","110/07/13","永豐金-永康",0,22,-22
"17201","2727王品","110/07/13","元大-北屯",22,0,22
"17202","2727王品","110/07/13","統一-台中",2,22,-20
"17203","2727王品","110/07/13","元大-東蘆",26,7,19
"17204","2727王品","110/07/13","國泰-台中",21,39,-18
"17205","2727王品","110/07/13","永豐金-萬盛",13,1,12
"17206","2727王品","110/07/13","合庫-彰化",3,20,-17
"17207","2727王品","110/07/13","日盛-嘉義",11,0,11
"17208","2727王品","110/07/13","港商野村",13,30,-17
"17209","2727王品","110/07/13","日盛-八德",11,0,11
"17210","2727王品","110/07/13","元大-楊梅",1,16,-15
"17211","2727王品","110/07/13","統一-竹南",11,0,11
"17212","2727王品","110/07/13","凱基-高美館",2,15,-13
"17213","2727王品","110/07/13","日盛-士林",12,2,10
"17214","2727王品","110/07/13","美商高盛",2,14,-12
"17215","2727王品","110/07/13","統一-敦南",10,0,10
"17216","2727王品","110/07/13","統一-平鎮",1,13,-12
"17217","2727王品","110/07/13","中國信託",15,5,10
"17218","2727王品","110/07/13","兆豐-台中港",4,16,-12
"17219","2727王品","110/07/13","兆豐-竹北",13,3,10
"17220","2727王品","110/07/13","凱基-八德",1,13,-12
"17221","1570力肯","110/07/13","新光",115,11,104
"17222","1570力肯","110/07/13","元大-北三重",0,162,-162
"17223","1570力肯","110/07/13","群益金鼎-高雄",54,0,54
"17224","1570力肯","110/07/13","元大-大灣",0,25,-25
"17225","1570力肯","110/07/13","國票-新莊",22,0,22
"17226","1570力肯","110/07/13","永豐金-苓雅",0,22,-22
"17227","1570力肯","110/07/13","日盛-桃園",12,0,12
"17228","1570力肯","110/07/13","永豐金-永康",0,19,-19
"17229","1570力肯","110/07/13","元大-高雄",12,0,12
"17230","1570力肯","110/07/13","富邦-員林",0,15,-15
"17231","1570力肯","110/07/13","合庫-自強",11,0,11
"17232","1570力肯","110/07/13","凱基-台南",0,11,-11
"17233","1570力肯","110/07/13","摩根大通",26,15,11
"17234","1570力肯","110/07/13","日盛-竹北",0,10,-10
"17235","1570力肯","110/07/13","永豐金-中盛",11,0,11
"17236","1570力肯","110/07/13","國票-九鼎",0,10,-10
"17237","1570力肯","110/07/13","兆豐-台中港",10,0,10
"17238","1570力肯","110/07/13","凱基-桃園",0,10,-10
"17239","1570力肯","110/07/13","國泰-松江",9,0,9
"17240","1570力肯","110/07/13","凱基-新豐",0,10,-10
"17241","1570力肯","110/07/13","元大-新盛",9,0,9
"17242","1570力肯","110/07/13","元大-學甲",0,10,-10
"17243","1570力肯","110/07/13","元富-緯城",6,0,6
"17244","1570力肯","110/07/13","群益金鼎-東湖",1,10,-9
"17245","1570力肯","110/07/13","統一-三重",5,0,5
"17246","1570力肯","110/07/13","大昌",0,6,-6
"17247","1570力肯","110/07/13","元大-前金",5,0,5
"17248","1570力肯","110/07/13","元大-土城學府",0,6,-6
"17249","1570力肯","110/07/13","永豐金證券",5,0,5
"17250","1570力肯","110/07/13","統一",0,5,-5
"17251","6180橘子","110/07/13","摩根大通",119,0,119
"17252","6180橘子","110/07/13","元大-崇德",2,61,-59
"17253","6180橘子","110/07/13","美商高盛",96,0,96
"17254","6180橘子","110/07/13","康和-台中",0,51,-51
"17255","6180橘子","110/07/13","新加坡商瑞銀",86,7,79
"17256","6180橘子","110/07/13","康和-台北",0,50,-50
"17257","6180橘子","110/07/13","元大-和平",40,0,40
"17258","6180橘子","110/07/13","元富-潮州",0,40,-40
"17259","6180橘子","110/07/13","凱基-台北",83,47,36
"17260","6180橘子","110/07/13","日盛-永康",0,26,-26
"17261","6180橘子","110/07/13","美林",39,5,34
"17262","6180橘子","110/07/13","永豐金-中正",0,24,-24
"17263","6180橘子","110/07/13","富邦-新竹華信",31,2,29
"17264","6180橘子","110/07/13","國泰-板橋",2,25,-23
"17265","6180橘子","110/07/13","統一-南京",21,0,21
"17266","6180橘子","110/07/13","日盛-大墩",0,20,-20
"17267","6180橘子","110/07/13","富邦-陽明",24,3,21
"17268","6180橘子","110/07/13","元大-草屯",13,32,-19
"17269","6180橘子","110/07/13","大昌-樹林",21,1,20
"17270","6180橘子","110/07/13","元富-林園",1,18,-17
"17271","6180橘子","110/07/13","花旗環球",19,0,19
"17272","6180橘子","110/07/13","新光-新竹",1,18,-17
"17273","6180橘子","110/07/13","華南永昌-台南",19,0,19
"17274","6180橘子","110/07/13","元大-土城永寧",0,17,-17
"17275","6180橘子","110/07/13","福勝",14,0,14
"17276","6180橘子","110/07/13","國泰-新莊",3,19,-16
"17277","6180橘子","110/07/13","富邦-嘉義",12,1,11
"17278","6180橘子","110/07/13","中國信託-永康",6,21,-15
"17279","6180橘子","110/07/13","元大-板橋三民",11,0,11
"17280","6180橘子","110/07/13","凱基-東港",1,15,-14
"17281","2390云辰","110/07/13","新加坡商瑞銀",562,75,487
"17282","2390云辰","110/07/13","大展-台南",0,532,-532
"17283","2390云辰","110/07/13","台灣摩根士丹利",330,155,175
"17284","2390云辰","110/07/13","凱基-台北",668,854,-186
"17285","2390云辰","110/07/13","兆豐-公益",126,25,101
"17286","2390云辰","110/07/13","凱基-三重",12,172,-160
"17287","2390云辰","110/07/13","元富-中港",100,2,98
"17288","2390云辰","110/07/13","兆豐-忠孝",4,161,-157
"17289","2390云辰","110/07/13","統一-新台中",106,9,97
"17290","2390云辰","110/07/13","元大-士林",19,170,-151
"17291","2390云辰","110/07/13","中國信託-松江",81,11,70
"17292","2390云辰","110/07/13","臺銀-新竹",14,117,-103
"17293","2390云辰","110/07/13","日盛-板橋",72,3,69
"17294","2390云辰","110/07/13","國票-台中",4,102,-98
"17295","2390云辰","110/07/13","日盛-和美",57,0,57
"17296","2390云辰","110/07/13","新光",147,232,-85
"17297","2390云辰","110/07/13","永豐金-桃園",88,36,52
"17298","2390云辰","110/07/13","致和-崇德",2,70,-68
"17299","2390云辰","110/07/13","玉山-士林",54,4,50
"17300","2390云辰","110/07/13","群益金鼎-屏東",2,70,-68
"17301","2390云辰","110/07/13","富邦-仁愛",56,6,50
"17302","2390云辰","110/07/13","元大-大里",35,98,-63
"17303","2390云辰","110/07/13","第一金-豐原",50,1,49
"17304","2390云辰","110/07/13","元大-萬華",35,94,-59
"17305","2390云辰","110/07/13","摩根大通",502,453,49
"17306","2390云辰","110/07/13","元富-吉利",2,60,-58
"17307","2390云辰","110/07/13","凱基-松山",61,13,48
"17308","2390云辰","110/07/13","兆豐-新竹",3,53,-50
"17309","2390云辰","110/07/13","大昌",64,22,42
"17310","2390云辰","110/07/13","富邦-嘉義",65,108,-43
"17311","2363矽統","110/07/13","凱基-南崁",2133,63,2070
"17312","2363矽統","110/07/13","凱基-幸福",36,4048,-4012
"17313","2363矽統","110/07/13","國泰-敦南",2195,1617,578
"17314","2363矽統","110/07/13","統一",192,3325,-3133
"17315","2363矽統","110/07/13","中農",670,139,531
"17316","2363矽統","110/07/13","新加坡商瑞銀",1000,2747,-1747
"17317","2363矽統","110/07/13","康和-台中",638,154,484
"17318","2363矽統","110/07/13","凱基-台北",5359,6609,-1250
"17319","2363矽統","110/07/13","群益金鼎-三民",577,137,440
"17320","2363矽統","110/07/13","摩根大通",1930,2858,-928
"17321","2363矽統","110/07/13","台新-屏東",510,88,422
"17322","2363矽統","110/07/13","港商野村",960,1679,-719
"17323","2363矽統","110/07/13","德信-中正",455,67,388
"17324","2363矽統","110/07/13","兆豐-復興",25,705,-680
"17325","2363矽統","110/07/13","日盛-竹北",365,70,295
"17326","2363矽統","110/07/13","統一-仁愛",114,755,-641
"17327","2363矽統","110/07/13","元大-佳里",452,189,263
"17328","2363矽統","110/07/13","統一-敦南",29,638,-609
"17329","2363矽統","110/07/13","國票-博愛",296,38,258
"17330","2363矽統","110/07/13","統一-土城",100,704,-604
"17331","2363矽統","110/07/13","元大-萬華",340,95,245
"17332","2363矽統","110/07/13","統一-城中",116,676,-560
"17333","2363矽統","110/07/13","新光",1259,1031,228
"17334","2363矽統","110/07/13","永豐金證券",306,859,-553
"17335","2363矽統","110/07/13","元富-成功",323,96,227
"17336","2363矽統","110/07/13","元富",54,567,-513
"17337","2363矽統","110/07/13","豐農",228,23,205
"17338","2363矽統","110/07/13","瑞士信貸",202,666,-464
"17339","2363矽統","110/07/13","台灣企銀-岡山",186,4,182
"17340","2363矽統","110/07/13","永豐金-嘉義",67,468,-401
"17341","8112至上","110/07/13","摩根大通",688,296,392
"17342","8112至上","110/07/13","國票-中和",0,401,-401
"17343","8112至上","110/07/13","港商野村",344,145,199
"17344","8112至上","110/07/13","永豐金-板盛",0,205,-205
"17345","8112至上","110/07/13","兆豐-公益",195,5,190
"17346","8112至上","110/07/13","凱基-五股",43,155,-112
"17347","8112至上","110/07/13","台灣摩根士丹利",183,0,183
"17348","8112至上","110/07/13","凱基-市政",0,100,-100
"17349","8112至上","110/07/13","群益金鼎-敦南",153,2,151
"17350","8112至上","110/07/13","元大-大里德芳",1,92,-91
"17351","8112至上","110/07/13","臺銀-金山",146,26,120
"17352","8112至上","110/07/13","玉山-桃園",26,110,-84
"17353","8112至上","110/07/13","臺銀",133,19,114
"17354","8112至上","110/07/13","兆豐-天母",0,81,-81
"17355","8112至上","110/07/13","合庫-台中",115,6,109
"17356","8112至上","110/07/13","凱基-城中",3,84,-81
"17357","8112至上","110/07/13","亞東-板橋",134,26,108
"17358","8112至上","110/07/13","日盛-新莊",9,85,-76
"17359","8112至上","110/07/13","凱基-台北",414,326,88
"17360","8112至上","110/07/13","日盛-台中",2,64,-62
"17361","8112至上","110/07/13","新加坡商瑞銀",181,100,81
"17362","8112至上","110/07/13","日盛-中壢",3,64,-61
"17363","8112至上","110/07/13","國泰-敦南",108,31,77
"17364","8112至上","110/07/13","元大-台中",2,59,-57
"17365","8112至上","110/07/13","第一金-華江",77,4,73
"17366","8112至上","110/07/13","元大-雙和",7,64,-57
"17367","8112至上","110/07/13","永豐金-內湖",73,1,72
"17368","8112至上","110/07/13","元大-高雄",8,62,-54
"17369","8112至上","110/07/13","元大-永和",68,1,67
"17370","8112至上","110/07/13","元大-館前",2,55,-53
"17371","1570力肯","110/07/13","新光",115,11,104
"17372","1570力肯","110/07/13","元大-北三重",0,162,-162
"17373","1570力肯","110/07/13","群益金鼎-高雄",54,0,54
"17374","1570力肯","110/07/13","元大-大灣",0,25,-25
"17375","1570力肯","110/07/13","國票-新莊",22,0,22
"17376","1570力肯","110/07/13","永豐金-苓雅",0,22,-22
"17377","1570力肯","110/07/13","日盛-桃園",12,0,12
"17378","1570力肯","110/07/13","永豐金-永康",0,19,-19
"17379","1570力肯","110/07/13","元大-高雄",12,0,12
"17380","1570力肯","110/07/13","富邦-員林",0,15,-15
"17381","1570力肯","110/07/13","合庫-自強",11,0,11
"17382","1570力肯","110/07/13","凱基-台南",0,11,-11
"17383","1570力肯","110/07/13","摩根大通",26,15,11
"17384","1570力肯","110/07/13","日盛-竹北",0,10,-10
"17385","1570力肯","110/07/13","永豐金-中盛",11,0,11
"17386","1570力肯","110/07/13","國票-九鼎",0,10,-10
"17387","1570力肯","110/07/13","兆豐-台中港",10,0,10
"17388","1570力肯","110/07/13","凱基-桃園",0,10,-10
"17389","1570力肯","110/07/13","國泰-松江",9,0,9
"17390","1570力肯","110/07/13","凱基-新豐",0,10,-10
"17391","1570力肯","110/07/13","元大-新盛",9,0,9
"17392","1570力肯","110/07/13","元大-學甲",0,10,-10
"17393","1570力肯","110/07/13","元富-緯城",6,0,6
"17394","1570力肯","110/07/13","群益金鼎-東湖",1,10,-9
"17395","1570力肯","110/07/13","統一-三重",5,0,5
"17396","1570力肯","110/07/13","大昌",0,6,-6
"17397","1570力肯","110/07/13","元大-前金",5,0,5
"17398","1570力肯","110/07/13","元大-土城學府",0,6,-6
"17399","1570力肯","110/07/13","永豐金證券",5,0,5
"17400","1570力肯","110/07/13","統一",0,5,-5
"17401","2929淘帝","110/07/13","玉山-新竹",130,0,130
"17402","2929淘帝","110/07/13","美商高盛",0,177,-177
"17403","2929淘帝","110/07/13","臺銀-民權",60,0,60
"17404","2929淘帝","110/07/13","凱基-台北",6,80,-74
"17405","2929淘帝","110/07/13","新百王",31,0,31
"17406","2929淘帝","110/07/13","元富-大裕",0,49,-49
"17407","2929淘帝","110/07/13","日盛-園區",30,0,30
"17408","2929淘帝","110/07/13","國泰-館前",3,51,-48
"17409","2929淘帝","110/07/13","元大-南投",31,1,30
"17410","2929淘帝","110/07/13","凱基-中壢",0,41,-41
"17411","2929淘帝","110/07/13","兆豐-忠孝",28,0,28
"17412","2929淘帝","110/07/13","港商野村",21,55,-34
"17413","2929淘帝","110/07/13","元大-民生",28,0,28
"17414","2929淘帝","110/07/13","華南永昌-南京",2,34,-32
"17415","2929淘帝","110/07/13","合庫-高雄",27,0,27
"17416","2929淘帝","110/07/13","群益金鼎-土城",0,30,-30
"17417","2929淘帝","110/07/13","凱基-豐中",27,0,27
"17418","2929淘帝","110/07/13","富邦-南屯",0,22,-22
"17419","2929淘帝","110/07/13","新光",21,4,17
"17420","2929淘帝","110/07/13","第一金-豐原",0,20,-20
"17421","2929淘帝","110/07/13","元大-天母",17,0,17
"17422","2929淘帝","110/07/13","元大-屏南",6,26,-20
"17423","2929淘帝","110/07/13","永興",14,0,14
"17424","2929淘帝","110/07/13","永豐金-敦南",1,21,-20
"17425","2929淘帝","110/07/13","富邦-台北",12,0,12
"17426","2929淘帝","110/07/13","凱基-三重",2,21,-19
"17427","2929淘帝","110/07/13","元大-永和",12,0,12
"17428","2929淘帝","110/07/13","富邦-仁愛",7,25,-18
"17429","2929淘帝","110/07/13","國票-天祥",11,0,11
"17430","2929淘帝","110/07/13","元大-北投",0,16,-16
"17431","5410國眾","110/07/13","兆豐-城中",274,0,274
"17432","5410國眾","110/07/13","元富-嘉義",0,103,-103
"17433","5410國眾","110/07/13","新光",50,4,46
"17434","5410國眾","110/07/13","凱基-台北",0,50,-50
"17435","5410國眾","110/07/13","國泰-台中",26,0,26
"17436","5410國眾","110/07/13","瑞士信貸",0,31,-31
"17437","5410國眾","110/07/13","新加坡商瑞銀",22,0,22
"17438","5410國眾","110/07/13","台新-新莊",0,27,-27
"17439","5410國眾","110/07/13","光和-嘉義",20,0,20
"17440","5410國眾","110/07/13","元大-汐止",0,20,-20
"17441","5410國眾","110/07/13","凱基-竹北",17,0,17
"17442","5410國眾","110/07/13","亞東-新竹",0,17,-17
"17443","5410國眾","110/07/13","新光-桃園",15,0,15
"17444","5410國眾","110/07/13","元大-南勢角",0,13,-13
"17445","5410國眾","110/07/13","凱基-台東",14,0,14
"17446","5410國眾","110/07/13","台新-台南",0,12,-12
"17447","5410國眾","110/07/13","富邦-竹北",11,0,11
"17448","5410國眾","110/07/13","中國信託",0,11,-11
"17449","5410國眾","110/07/13","元富-同大",10,0,10
"17450","5410國眾","110/07/13","華南永昌",0,11,-11
"17451","5410國眾","110/07/13","國泰-敦南",24,15,9
"17452","5410國眾","110/07/13","臺銀-臺南",0,10,-10
"17453","5410國眾","110/07/13","日盛-內湖",7,0,7
"17454","5410國眾","110/07/13","台灣企銀-民雄",0,10,-10
"17455","5410國眾","110/07/13","台新-左楠",7,0,7
"17456","5410國眾","110/07/13","高橋",0,10,-10
"17457","5410國眾","110/07/13","元大-新盛",18,12,6
"17458","5410國眾","110/07/13","康和-嘉義",0,10,-10
"17459","5410國眾","110/07/13","統一",5,0,5
"17460","5410國眾","110/07/13","凱基-基隆",0,10,-10
"17461","2841台開","110/07/13","中國信託-高雄",251,50,201
"17462","2841台開","110/07/13","兆豐-公益",0,177,-177
"17463","2841台開","110/07/13","日盛證券",210,13,197
"17464","2841台開","110/07/13","日進",0,152,-152
"17465","2841台開","110/07/13","第一金-台中",55,0,55
"17466","2841台開","110/07/13","港商野村",0,109,-109
"17467","2841台開","110/07/13","國泰-板橋",46,0,46
"17468","2841台開","110/07/13","日盛-信義",0,103,-103
"17469","2841台開","110/07/13","國泰-館前",48,3,45
"17470","2841台開","110/07/13","國泰-敦南",11,75,-64
"17471","2841台開","110/07/13","華南永昌-新莊",45,0,45
"17472","2841台開","110/07/13","永興",0,50,-50
"17473","2841台開","110/07/13","日盛-園區",42,0,42
"17474","2841台開","110/07/13","永豐金-敦南",61,104,-43
"17475","2841台開","110/07/13","台新證券",32,0,32
"17476","2841台開","110/07/13","富邦-台南",0,42,-42
"17477","2841台開","110/07/13","台新-高雄",32,2,30
"17478","2841台開","110/07/13","國票-安和",0,30,-30
"17479","2841台開","110/07/13","豐農",23,0,23
"17480","2841台開","110/07/13","元大-桃園",0,25,-25
"17481","2841台開","110/07/13","合庫-嘉義",20,0,20
"17482","2841台開","110/07/13","新光",8,32,-24
"17483","2841台開","110/07/13","華南永昌-高雄",20,0,20
"17484","2841台開","110/07/13","元大-仁愛",0,24,-24
"17485","2841台開","110/07/13","元大-樹林",16,0,16
"17486","2841台開","110/07/13","日盛-中和",0,20,-20
"17487","2841台開","110/07/13","第一金-華江",15,2,13
"17488","2841台開","110/07/13","元富",0,20,-20
"17489","2841台開","110/07/13","美商高盛",12,0,12
"17490","2841台開","110/07/13","富邦-宜蘭",0,20,-20
"17491","6207雷科","110/07/13","元大-高雄",121,0,121
"17492","6207雷科","110/07/13","華南永昌-朴子",1,60,-59
"17493","6207雷科","110/07/13","第一金-新興",20,0,20
"17494","6207雷科","110/07/13","元大-南海",0,36,-36
"17495","6207雷科","110/07/13","元富-三重",20,0,20
"17496","6207雷科","110/07/13","凱基-土城",0,35,-35
"17497","6207雷科","110/07/13","元大-林園",15,0,15
"17498","6207雷科","110/07/13","台灣企銀",0,20,-20
"17499","6207雷科","110/07/13","元大-金華",16,1,15
"17500","6207雷科","110/07/13","群益金鼎-丹鳳",0,20,-20
"17501","6207雷科","110/07/13","日盛證券",10,0,10
"17502","6207雷科","110/07/13","元大-博愛",0,17,-17
"17503","6207雷科","110/07/13","統一-台中",10,0,10
"17504","6207雷科","110/07/13","元大-北港",0,13,-13
"17505","6207雷科","110/07/13","群益金鼎-土城",10,0,10
"17506","6207雷科","110/07/13","新加坡商瑞銀",0,12,-12
"17507","6207雷科","110/07/13","群益金鼎-桃園",10,0,10
"17508","6207雷科","110/07/13","凱基-台北",4,16,-12
"17509","6207雷科","110/07/13","永豐金-新莊",10,0,10
"17510","6207雷科","110/07/13","日茂-埔里",0,11,-11
"17511","6207雷科","110/07/13","永豐金-新店",10,0,10
"17512","6207雷科","110/07/13","元大-莒光",0,11,-11
"17513","6207雷科","110/07/13","元大證券",9,0,9
"17514","6207雷科","110/07/13","統一-新竹",0,10,-10
"17515","6207雷科","110/07/13","日盛-木柵",9,1,8
"17516","6207雷科","110/07/13","元大-西螺",0,10,-10
"17517","6207雷科","110/07/13","兆豐-來福",8,0,8
"17518","6207雷科","110/07/13","康和-台中",0,8,-8
"17519","6207雷科","110/07/13","新光",7,0,7
"17520","6207雷科","110/07/13","兆豐-高雄",0,6,-6
"17521","3679新至陞","110/07/13","永豐金證券",50,0,50
"17522","3679新至陞","110/07/13","摩根大通",2,25,-23
"17523","3679新至陞","110/07/13","國泰-桃園",22,0,22
"17524","3679新至陞","110/07/13","元大-成功",0,22,-22
"17525","3679新至陞","110/07/13","台中銀-員林",11,0,11
"17526","3679新至陞","110/07/13","富邦-板橋",1,19,-18
"17527","3679新至陞","110/07/13","元大-文心興安",8,0,8
"17528","3679新至陞","110/07/13","日盛-新莊",0,10,-10
"17529","3679新至陞","110/07/13","美商高盛",6,0,6
"17530","3679新至陞","110/07/13","台新-台中",0,10,-10
"17531","3679新至陞","110/07/13","台新-高雄",6,0,6
"17532","3679新至陞","110/07/13","永豐金-新竹",0,8,-8
"17533","3679新至陞","110/07/13","凱基-台北",18,12,6
"17534","3679新至陞","110/07/13","瑞士信貸",12,19,-7
"17535","3679新至陞","110/07/13","日盛-復興",5,0,5
"17536","3679新至陞","110/07/13","統一-南京",0,7,-7
"17537","3679新至陞","110/07/13","(牛牛牛)亞-鑫豐",4,0,4
"17538","3679新至陞","110/07/13","凱基-新莊",0,7,-7
"17539","3679新至陞","110/07/13","元富-大昌",3,0,3
"17540","3679新至陞","110/07/13","新加坡商瑞銀",0,6,-6
"17541","3679新至陞","110/07/13","富邦-台北",3,0,3
"17542","3679新至陞","110/07/13","合庫-自強",0,5,-5
"17543","3679新至陞","110/07/13","日盛-樹林",2,0,2
"17544","3679新至陞","110/07/13","富邦-桃園",0,5,-5
"17545","3679新至陞","110/07/13","宏遠-光隆",2,0,2
"17546","3679新至陞","110/07/13","永豐金-潮州",0,4,-4
"17547","3679新至陞","110/07/13","美林",3,1,2
"17548","3679新至陞","110/07/13","臺銀-臺南",0,3,-3
"17549","3679新至陞","110/07/13","第一金-中壢",2,0,2
"17550","3679新至陞","110/07/13","元大-六合",0,3,-3
"17551","2727王品","110/07/13","富邦-台北",43,3,40
"17552","2727王品","110/07/13","台灣摩根士丹利",15,97,-82
"17553","2727王品","110/07/13","元大-基隆孝二",40,0,40
"17554","2727王品","110/07/13","玉山-台南",5,57,-52
"17555","2727王品","110/07/13","國票-新莊",40,1,39
"17556","2727王品","110/07/13","新加坡商瑞銀",0,48,-48
"17557","2727王品","110/07/13","第一金-豐原",66,42,24
"17558","2727王品","110/07/13","凱基-台北",41,77,-36
"17559","2727王品","110/07/13","永豐金-大園",34,10,24
"17560","2727王品","110/07/13","永豐金-永康",0,22,-22
"17561","2727王品","110/07/13","元大-北屯",22,0,22
"17562","2727王品","110/07/13","統一-台中",2,22,-20
"17563","2727王品","110/07/13","元大-東蘆",26,7,19
"17564","2727王品","110/07/13","國泰-台中",21,39,-18
"17565","2727王品","110/07/13","永豐金-萬盛",13,1,12
"17566","2727王品","110/07/13","合庫-彰化",3,20,-17
"17567","2727王品","110/07/13","日盛-嘉義",11,0,11
"17568","2727王品","110/07/13","港商野村",13,30,-17
"17569","2727王品","110/07/13","日盛-八德",11,0,11
"17570","2727王品","110/07/13","元大-楊梅",1,16,-15
"17571","2727王品","110/07/13","統一-竹南",11,0,11
"17572","2727王品","110/07/13","凱基-高美館",2,15,-13
"17573","2727王品","110/07/13","日盛-士林",12,2,10
"17574","2727王品","110/07/13","美商高盛",2,14,-12
"17575","2727王品","110/07/13","統一-敦南",10,0,10
"17576","2727王品","110/07/13","統一-平鎮",1,13,-12
"17577","2727王品","110/07/13","中國信託",15,5,10
"17578","2727王品","110/07/13","兆豐-台中港",4,16,-12
"17579","2727王品","110/07/13","兆豐-竹北",13,3,10
"17580","2727王品","110/07/13","凱基-八德",1,13,-12
"17581","1570力肯","110/07/13","新光",115,11,104
"17582","1570力肯","110/07/13","元大-北三重",0,162,-162
"17583","1570力肯","110/07/13","群益金鼎-高雄",54,0,54
"17584","1570力肯","110/07/13","元大-大灣",0,25,-25
"17585","1570力肯","110/07/13","國票-新莊",22,0,22
"17586","1570力肯","110/07/13","永豐金-苓雅",0,22,-22
"17587","1570力肯","110/07/13","日盛-桃園",12,0,12
"17588","1570力肯","110/07/13","永豐金-永康",0,19,-19
"17589","1570力肯","110/07/13","元大-高雄",12,0,12
"17590","1570力肯","110/07/13","富邦-員林",0,15,-15
"17591","1570力肯","110/07/13","合庫-自強",11,0,11
"17592","1570力肯","110/07/13","凱基-台南",0,11,-11
"17593","1570力肯","110/07/13","摩根大通",26,15,11
"17594","1570力肯","110/07/13","日盛-竹北",0,10,-10
"17595","1570力肯","110/07/13","永豐金-中盛",11,0,11
"17596","1570力肯","110/07/13","國票-九鼎",0,10,-10
"17597","1570力肯","110/07/13","兆豐-台中港",10,0,10
"17598","1570力肯","110/07/13","凱基-桃園",0,10,-10
"17599","1570力肯","110/07/13","國泰-松江",9,0,9
"17600","1570力肯","110/07/13","凱基-新豐",0,10,-10
"17601","1570力肯","110/07/13","元大-新盛",9,0,9
"17602","1570力肯","110/07/13","元大-學甲",0,10,-10
"17603","1570力肯","110/07/13","元富-緯城",6,0,6
"17604","1570力肯","110/07/13","群益金鼎-東湖",1,10,-9
"17605","1570力肯","110/07/13","統一-三重",5,0,5
"17606","1570力肯","110/07/13","大昌",0,6,-6
"17607","1570力肯","110/07/13","元大-前金",5,0,5
"17608","1570力肯","110/07/13","元大-土城學府",0,6,-6
"17609","1570力肯","110/07/13","永豐金證券",5,0,5
"17610","1570力肯","110/07/13","統一",0,5,-5
"17611","6180橘子","110/07/13","摩根大通",119,0,119
"17612","6180橘子","110/07/13","元大-崇德",2,61,-59
"17613","6180橘子","110/07/13","美商高盛",96,0,96
"17614","6180橘子","110/07/13","康和-台中",0,51,-51
"17615","6180橘子","110/07/13","新加坡商瑞銀",86,7,79
"17616","6180橘子","110/07/13","康和-台北",0,50,-50
"17617","6180橘子","110/07/13","元大-和平",40,0,40
"17618","6180橘子","110/07/13","元富-潮州",0,40,-40
"17619","6180橘子","110/07/13","凱基-台北",83,47,36
"17620","6180橘子","110/07/13","日盛-永康",0,26,-26
"17621","6180橘子","110/07/13","美林",39,5,34
"17622","6180橘子","110/07/13","永豐金-中正",0,24,-24
"17623","6180橘子","110/07/13","富邦-新竹華信",31,2,29
"17624","6180橘子","110/07/13","國泰-板橋",2,25,-23
"17625","6180橘子","110/07/13","統一-南京",21,0,21
"17626","6180橘子","110/07/13","日盛-大墩",0,20,-20
"17627","6180橘子","110/07/13","富邦-陽明",24,3,21
"17628","6180橘子","110/07/13","元大-草屯",13,32,-19
"17629","6180橘子","110/07/13","大昌-樹林",21,1,20
"17630","6180橘子","110/07/13","元富-林園",1,18,-17
"17631","6180橘子","110/07/13","花旗環球",19,0,19
"17632","6180橘子","110/07/13","新光-新竹",1,18,-17
"17633","6180橘子","110/07/13","華南永昌-台南",19,0,19
"17634","6180橘子","110/07/13","元大-土城永寧",0,17,-17
"17635","6180橘子","110/07/13","福勝",14,0,14
"17636","6180橘子","110/07/13","國泰-新莊",3,19,-16
"17637","6180橘子","110/07/13","富邦-嘉義",12,1,11
"17638","6180橘子","110/07/13","中國信託-永康",6,21,-15
"17639","6180橘子","110/07/13","元大-板橋三民",11,0,11
"17640","6180橘子","110/07/13","凱基-東港",1,15,-14
"17641","2390云辰","110/07/13","新加坡商瑞銀",562,75,487
"17642","2390云辰","110/07/13","大展-台南",0,532,-532
"17643","2390云辰","110/07/13","台灣摩根士丹利",330,155,175
"17644","2390云辰","110/07/13","凱基-台北",668,854,-186
"17645","2390云辰","110/07/13","兆豐-公益",126,25,101
"17646","2390云辰","110/07/13","凱基-三重",12,172,-160
"17647","2390云辰","110/07/13","元富-中港",100,2,98
"17648","2390云辰","110/07/13","兆豐-忠孝",4,161,-157
"17649","2390云辰","110/07/13","統一-新台中",106,9,97
"17650","2390云辰","110/07/13","元大-士林",19,170,-151
"17651","2390云辰","110/07/13","中國信託-松江",81,11,70
"17652","2390云辰","110/07/13","臺銀-新竹",14,117,-103
"17653","2390云辰","110/07/13","日盛-板橋",72,3,69
"17654","2390云辰","110/07/13","國票-台中",4,102,-98
"17655","2390云辰","110/07/13","日盛-和美",57,0,57
"17656","2390云辰","110/07/13","新光",147,232,-85
"17657","2390云辰","110/07/13","永豐金-桃園",88,36,52
"17658","2390云辰","110/07/13","致和-崇德",2,70,-68
"17659","2390云辰","110/07/13","玉山-士林",54,4,50
"17660","2390云辰","110/07/13","群益金鼎-屏東",2,70,-68
"17661","2390云辰","110/07/13","富邦-仁愛",56,6,50
"17662","2390云辰","110/07/13","元大-大里",35,98,-63
"17663","2390云辰","110/07/13","第一金-豐原",50,1,49
"17664","2390云辰","110/07/13","元大-萬華",35,94,-59
"17665","2390云辰","110/07/13","摩根大通",502,453,49
"17666","2390云辰","110/07/13","元富-吉利",2,60,-58
"17667","2390云辰","110/07/13","凱基-松山",61,13,48
"17668","2390云辰","110/07/13","兆豐-新竹",3,53,-50
"17669","2390云辰","110/07/13","大昌",64,22,42
"17670","2390云辰","110/07/13","富邦-嘉義",65,108,-43
"17671","2363矽統","110/07/13","凱基-南崁",2133,63,2070
"17672","2363矽統","110/07/13","凱基-幸福",36,4048,-4012
"17673","2363矽統","110/07/13","國泰-敦南",2195,1617,578
"17674","2363矽統","110/07/13","統一",192,3325,-3133
"17675","2363矽統","110/07/13","中農",670,139,531
"17676","2363矽統","110/07/13","新加坡商瑞銀",1000,2747,-1747
"17677","2363矽統","110/07/13","康和-台中",638,154,484
"17678","2363矽統","110/07/13","凱基-台北",5359,6609,-1250
"17679","2363矽統","110/07/13","群益金鼎-三民",577,137,440
"17680","2363矽統","110/07/13","摩根大通",1930,2858,-928
"17681","2363矽統","110/07/13","台新-屏東",510,88,422
"17682","2363矽統","110/07/13","港商野村",960,1679,-719
"17683","2363矽統","110/07/13","德信-中正",455,67,388
"17684","2363矽統","110/07/13","兆豐-復興",25,705,-680
"17685","2363矽統","110/07/13","日盛-竹北",365,70,295
"17686","2363矽統","110/07/13","統一-仁愛",114,755,-641
"17687","2363矽統","110/07/13","元大-佳里",452,189,263
"17688","2363矽統","110/07/13","統一-敦南",29,638,-609
"17689","2363矽統","110/07/13","國票-博愛",296,38,258
"17690","2363矽統","110/07/13","統一-土城",100,704,-604
"17691","2363矽統","110/07/13","元大-萬華",340,95,245
"17692","2363矽統","110/07/13","統一-城中",116,676,-560
"17693","2363矽統","110/07/13","新光",1259,1031,228
"17694","2363矽統","110/07/13","永豐金證券",306,859,-553
"17695","2363矽統","110/07/13","元富-成功",323,96,227
"17696","2363矽統","110/07/13","元富",54,567,-513
"17697","2363矽統","110/07/13","豐農",228,23,205
"17698","2363矽統","110/07/13","瑞士信貸",202,666,-464
"17699","2363矽統","110/07/13","台灣企銀-岡山",186,4,182
"17700","2363矽統","110/07/13","永豐金-嘉義",67,468,-401
"17701","2363矽統","110/07/13","凱基-南崁",2133,63,2070
"17702","2363矽統","110/07/13","凱基-幸福",36,4048,-4012
"17703","2363矽統","110/07/13","國泰-敦南",2195,1617,578
"17704","2363矽統","110/07/13","統一",192,3325,-3133
"17705","2363矽統","110/07/13","中農",670,139,531
"17706","2363矽統","110/07/13","新加坡商瑞銀",1000,2747,-1747
"17707","2363矽統","110/07/13","康和-台中",638,154,484
"17708","2363矽統","110/07/13","凱基-台北",5359,6609,-1250
"17709","2363矽統","110/07/13","群益金鼎-三民",577,137,440
"17710","2363矽統","110/07/13","摩根大通",1930,2858,-928
"17711","2363矽統","110/07/13","台新-屏東",510,88,422
"17712","2363矽統","110/07/13","港商野村",960,1679,-719
"17713","2363矽統","110/07/13","德信-中正",455,67,388
"17714","2363矽統","110/07/13","兆豐-復興",25,705,-680
"17715","2363矽統","110/07/13","日盛-竹北",365,70,295
"17716","2363矽統","110/07/13","統一-仁愛",114,755,-641
"17717","2363矽統","110/07/13","元大-佳里",452,189,263
"17718","2363矽統","110/07/13","統一-敦南",29,638,-609
"17719","2363矽統","110/07/13","國票-博愛",296,38,258
"17720","2363矽統","110/07/13","統一-土城",100,704,-604
"17721","2363矽統","110/07/13","元大-萬華",340,95,245
"17722","2363矽統","110/07/13","統一-城中",116,676,-560
"17723","2363矽統","110/07/13","新光",1259,1031,228
"17724","2363矽統","110/07/13","永豐金證券",306,859,-553
"17725","2363矽統","110/07/13","元富-成功",323,96,227
"17726","2363矽統","110/07/13","元富",54,567,-513
"17727","2363矽統","110/07/13","豐農",228,23,205
"17728","2363矽統","110/07/13","瑞士信貸",202,666,-464
"17729","2363矽統","110/07/13","台灣企銀-岡山",186,4,182
"17730","2363矽統","110/07/13","永豐金-嘉義",67,468,-401
"17731","2363矽統","110/07/13","凱基-南崁",2133,63,2070
"17732","2363矽統","110/07/13","凱基-幸福",36,4048,-4012
"17733","2363矽統","110/07/13","國泰-敦南",2195,1617,578
"17734","2363矽統","110/07/13","統一",192,3325,-3133
"17735","2363矽統","110/07/13","中農",670,139,531
"17736","2363矽統","110/07/13","新加坡商瑞銀",1000,2747,-1747
"17737","2363矽統","110/07/13","康和-台中",638,154,484
"17738","2363矽統","110/07/13","凱基-台北",5359,6609,-1250
"17739","2363矽統","110/07/13","群益金鼎-三民",577,137,440
"17740","2363矽統","110/07/13","摩根大通",1930,2858,-928
"17741","2363矽統","110/07/13","台新-屏東",510,88,422
"17742","2363矽統","110/07/13","港商野村",960,1679,-719
"17743","2363矽統","110/07/13","德信-中正",455,67,388
"17744","2363矽統","110/07/13","兆豐-復興",25,705,-680
"17745","2363矽統","110/07/13","日盛-竹北",365,70,295
"17746","2363矽統","110/07/13","統一-仁愛",114,755,-641
"17747","2363矽統","110/07/13","元大-佳里",452,189,263
"17748","2363矽統","110/07/13","統一-敦南",29,638,-609
"17749","2363矽統","110/07/13","國票-博愛",296,38,258
"17750","2363矽統","110/07/13","統一-土城",100,704,-604
"17751","2363矽統","110/07/13","元大-萬華",340,95,245
"17752","2363矽統","110/07/13","統一-城中",116,676,-560
"17753","2363矽統","110/07/13","新光",1259,1031,228
"17754","2363矽統","110/07/13","永豐金證券",306,859,-553
"17755","2363矽統","110/07/13","元富-成功",323,96,227
"17756","2363矽統","110/07/13","元富",54,567,-513
"17757","2363矽統","110/07/13","豐農",228,23,205
"17758","2363矽統","110/07/13","瑞士信貸",202,666,-464
"17759","2363矽統","110/07/13","台灣企銀-岡山",186,4,182
"17760","2363矽統","110/07/13","永豐金-嘉義",67,468,-401
"17761","1570力肯","110/07/13","新光",115,11,104
"17762","1570力肯","110/07/13","元大-北三重",0,162,-162
"17763","1570力肯","110/07/13","群益金鼎-高雄",54,0,54
"17764","1570力肯","110/07/13","元大-大灣",0,25,-25
"17765","1570力肯","110/07/13","國票-新莊",22,0,22
"17766","1570力肯","110/07/13","永豐金-苓雅",0,22,-22
"17767","1570力肯","110/07/13","日盛-桃園",12,0,12
"17768","1570力肯","110/07/13","永豐金-永康",0,19,-19
"17769","1570力肯","110/07/13","元大-高雄",12,0,12
"17770","1570力肯","110/07/13","富邦-員林",0,15,-15
"17771","1570力肯","110/07/13","合庫-自強",11,0,11
"17772","1570力肯","110/07/13","凱基-台南",0,11,-11
"17773","1570力肯","110/07/13","摩根大通",26,15,11
"17774","1570力肯","110/07/13","日盛-竹北",0,10,-10
"17775","1570力肯","110/07/13","永豐金-中盛",11,0,11
"17776","1570力肯","110/07/13","國票-九鼎",0,10,-10
"17777","1570力肯","110/07/13","兆豐-台中港",10,0,10
"17778","1570力肯","110/07/13","凱基-桃園",0,10,-10
"17779","1570力肯","110/07/13","國泰-松江",9,0,9
"17780","1570力肯","110/07/13","凱基-新豐",0,10,-10
"17781","1570力肯","110/07/13","元大-新盛",9,0,9
"17782","1570力肯","110/07/13","元大-學甲",0,10,-10
"17783","1570力肯","110/07/13","元富-緯城",6,0,6
"17784","1570力肯","110/07/13","群益金鼎-東湖",1,10,-9
"17785","1570力肯","110/07/13","統一-三重",5,0,5
"17786","1570力肯","110/07/13","大昌",0,6,-6
"17787","1570力肯","110/07/13","元大-前金",5,0,5
"17788","1570力肯","110/07/13","元大-土城學府",0,6,-6
"17789","1570力肯","110/07/13","永豐金證券",5,0,5
"17790","1570力肯","110/07/13","統一",0,5,-5
"17791","1570力肯","110/07/13","新光",115,11,104
"17792","1570力肯","110/07/13","元大-北三重",0,162,-162
"17793","1570力肯","110/07/13","群益金鼎-高雄",54,0,54
"17794","1570力肯","110/07/13","元大-大灣",0,25,-25
"17795","1570力肯","110/07/13","國票-新莊",22,0,22
"17796","1570力肯","110/07/13","永豐金-苓雅",0,22,-22
"17797","1570力肯","110/07/13","日盛-桃園",12,0,12
"17798","1570力肯","110/07/13","永豐金-永康",0,19,-19
"17799","1570力肯","110/07/13","元大-高雄",12,0,12
"17800","1570力肯","110/07/13","富邦-員林",0,15,-15
"17801","1570力肯","110/07/13","合庫-自強",11,0,11
"17802","1570力肯","110/07/13","凱基-台南",0,11,-11
"17803","1570力肯","110/07/13","摩根大通",26,15,11
"17804","1570力肯","110/07/13","日盛-竹北",0,10,-10
"17805","1570力肯","110/07/13","永豐金-中盛",11,0,11
"17806","1570力肯","110/07/13","國票-九鼎",0,10,-10
"17807","1570力肯","110/07/13","兆豐-台中港",10,0,10
"17808","1570力肯","110/07/13","凱基-桃園",0,10,-10
"17809","1570力肯","110/07/13","國泰-松江",9,0,9
"17810","1570力肯","110/07/13","凱基-新豐",0,10,-10
"17811","1570力肯","110/07/13","元大-新盛",9,0,9
"17812","1570力肯","110/07/13","元大-學甲",0,10,-10
"17813","1570力肯","110/07/13","元富-緯城",6,0,6
"17814","1570力肯","110/07/13","群益金鼎-東湖",1,10,-9
"17815","1570力肯","110/07/13","統一-三重",5,0,5
"17816","1570力肯","110/07/13","大昌",0,6,-6
"17817","1570力肯","110/07/13","元大-前金",5,0,5
"17818","1570力肯","110/07/13","元大-土城學府",0,6,-6
"17819","1570力肯","110/07/13","永豐金證券",5,0,5
"17820","1570力肯","110/07/13","統一",0,5,-5
"17821","6180橘子","110/07/13","摩根大通",119,0,119
"17822","6180橘子","110/07/13","元大-崇德",2,61,-59
"17823","6180橘子","110/07/13","美商高盛",96,0,96
"17824","6180橘子","110/07/13","康和-台中",0,51,-51
"17825","6180橘子","110/07/13","新加坡商瑞銀",86,7,79
"17826","6180橘子","110/07/13","康和-台北",0,50,-50
"17827","6180橘子","110/07/13","元大-和平",40,0,40
"17828","6180橘子","110/07/13","元富-潮州",0,40,-40
"17829","6180橘子","110/07/13","凱基-台北",83,47,36
"17830","6180橘子","110/07/13","日盛-永康",0,26,-26
"17831","6180橘子","110/07/13","美林",39,5,34
"17832","6180橘子","110/07/13","永豐金-中正",0,24,-24
"17833","6180橘子","110/07/13","富邦-新竹華信",31,2,29
"17834","6180橘子","110/07/13","國泰-板橋",2,25,-23
"17835","6180橘子","110/07/13","統一-南京",21,0,21
"17836","6180橘子","110/07/13","日盛-大墩",0,20,-20
"17837","6180橘子","110/07/13","富邦-陽明",24,3,21
"17838","6180橘子","110/07/13","元大-草屯",13,32,-19
"17839","6180橘子","110/07/13","大昌-樹林",21,1,20
"17840","6180橘子","110/07/13","元富-林園",1,18,-17
"17841","6180橘子","110/07/13","花旗環球",19,0,19
"17842","6180橘子","110/07/13","新光-新竹",1,18,-17
"17843","6180橘子","110/07/13","華南永昌-台南",19,0,19
"17844","6180橘子","110/07/13","元大-土城永寧",0,17,-17
"17845","6180橘子","110/07/13","福勝",14,0,14
"17846","6180橘子","110/07/13","國泰-新莊",3,19,-16
"17847","6180橘子","110/07/13","富邦-嘉義",12,1,11
"17848","6180橘子","110/07/13","中國信託-永康",6,21,-15
"17849","6180橘子","110/07/13","元大-板橋三民",11,0,11
"17850","6180橘子","110/07/13","凱基-東港",1,15,-14
"17851","1570力肯","110/07/13","新光",115,11,104
"17852","1570力肯","110/07/13","元大-北三重",0,162,-162
"17853","1570力肯","110/07/13","群益金鼎-高雄",54,0,54
"17854","1570力肯","110/07/13","元大-大灣",0,25,-25
"17855","1570力肯","110/07/13","國票-新莊",22,0,22
"17856","1570力肯","110/07/13","永豐金-苓雅",0,22,-22
"17857","1570力肯","110/07/13","日盛-桃園",12,0,12
"17858","1570力肯","110/07/13","永豐金-永康",0,19,-19
"17859","1570力肯","110/07/13","元大-高雄",12,0,12
"17860","1570力肯","110/07/13","富邦-員林",0,15,-15
"17861","1570力肯","110/07/13","合庫-自強",11,0,11
"17862","1570力肯","110/07/13","凱基-台南",0,11,-11
"17863","1570力肯","110/07/13","摩根大通",26,15,11
"17864","1570力肯","110/07/13","日盛-竹北",0,10,-10
"17865","1570力肯","110/07/13","永豐金-中盛",11,0,11
"17866","1570力肯","110/07/13","國票-九鼎",0,10,-10
"17867","1570力肯","110/07/13","兆豐-台中港",10,0,10
"17868","1570力肯","110/07/13","凱基-桃園",0,10,-10
"17869","1570力肯","110/07/13","國泰-松江",9,0,9
"17870","1570力肯","110/07/13","凱基-新豐",0,10,-10
"17871","1570力肯","110/07/13","元大-新盛",9,0,9
"17872","1570力肯","110/07/13","元大-學甲",0,10,-10
"17873","1570力肯","110/07/13","元富-緯城",6,0,6
"17874","1570力肯","110/07/13","群益金鼎-東湖",1,10,-9
"17875","1570力肯","110/07/13","統一-三重",5,0,5
"17876","1570力肯","110/07/13","大昌",0,6,-6
"17877","1570力肯","110/07/13","元大-前金",5,0,5
"17878","1570力肯","110/07/13","元大-土城學府",0,6,-6
"17879","1570力肯","110/07/13","永豐金證券",5,0,5
"17880","1570力肯","110/07/13","統一",0,5,-5
"17881","6180橘子","110/07/13","摩根大通",119,0,119
"17882","6180橘子","110/07/13","元大-崇德",2,61,-59
"17883","6180橘子","110/07/13","美商高盛",96,0,96
"17884","6180橘子","110/07/13","康和-台中",0,51,-51
"17885","6180橘子","110/07/13","新加坡商瑞銀",86,7,79
"17886","6180橘子","110/07/13","康和-台北",0,50,-50
"17887","6180橘子","110/07/13","元大-和平",40,0,40
"17888","6180橘子","110/07/13","元富-潮州",0,40,-40
"17889","6180橘子","110/07/13","凱基-台北",83,47,36
"17890","6180橘子","110/07/13","日盛-永康",0,26,-26
"17891","6180橘子","110/07/13","美林",39,5,34
"17892","6180橘子","110/07/13","永豐金-中正",0,24,-24
"17893","6180橘子","110/07/13","富邦-新竹華信",31,2,29
"17894","6180橘子","110/07/13","國泰-板橋",2,25,-23
"17895","6180橘子","110/07/13","統一-南京",21,0,21
"17896","6180橘子","110/07/13","日盛-大墩",0,20,-20
"17897","6180橘子","110/07/13","富邦-陽明",24,3,21
"17898","6180橘子","110/07/13","元大-草屯",13,32,-19
"17899","6180橘子","110/07/13","大昌-樹林",21,1,20
"17900","6180橘子","110/07/13","元富-林園",1,18,-17
"17901","6180橘子","110/07/13","花旗環球",19,0,19
"17902","6180橘子","110/07/13","新光-新竹",1,18,-17
"17903","6180橘子","110/07/13","華南永昌-台南",19,0,19
"17904","6180橘子","110/07/13","元大-土城永寧",0,17,-17
"17905","6180橘子","110/07/13","福勝",14,0,14
"17906","6180橘子","110/07/13","國泰-新莊",3,19,-16
"17907","6180橘子","110/07/13","富邦-嘉義",12,1,11
"17908","6180橘子","110/07/13","中國信託-永康",6,21,-15
"17909","6180橘子","110/07/13","元大-板橋三民",11,0,11
"17910","6180橘子","110/07/13","凱基-東港",1,15,-14
"17911","2390云辰","110/07/13","新加坡商瑞銀",562,75,487
"17912","2390云辰","110/07/13","大展-台南",0,532,-532
"17913","2390云辰","110/07/13","台灣摩根士丹利",330,155,175
"17914","2390云辰","110/07/13","凱基-台北",668,854,-186
"17915","2390云辰","110/07/13","兆豐-公益",126,25,101
"17916","2390云辰","110/07/13","凱基-三重",12,172,-160
"17917","2390云辰","110/07/13","元富-中港",100,2,98
"17918","2390云辰","110/07/13","兆豐-忠孝",4,161,-157
"17919","2390云辰","110/07/13","統一-新台中",106,9,97
"17920","2390云辰","110/07/13","元大-士林",19,170,-151
"17921","2390云辰","110/07/13","中國信託-松江",81,11,70
"17922","2390云辰","110/07/13","臺銀-新竹",14,117,-103
"17923","2390云辰","110/07/13","日盛-板橋",72,3,69
"17924","2390云辰","110/07/13","國票-台中",4,102,-98
"17925","2390云辰","110/07/13","日盛-和美",57,0,57
"17926","2390云辰","110/07/13","新光",147,232,-85
"17927","2390云辰","110/07/13","永豐金-桃園",88,36,52
"17928","2390云辰","110/07/13","致和-崇德",2,70,-68
"17929","2390云辰","110/07/13","玉山-士林",54,4,50
"17930","2390云辰","110/07/13","群益金鼎-屏東",2,70,-68
"17931","2390云辰","110/07/13","富邦-仁愛",56,6,50
"17932","2390云辰","110/07/13","元大-大里",35,98,-63
"17933","2390云辰","110/07/13","第一金-豐原",50,1,49
"17934","2390云辰","110/07/13","元大-萬華",35,94,-59
"17935","2390云辰","110/07/13","摩根大通",502,453,49
"17936","2390云辰","110/07/13","元富-吉利",2,60,-58
"17937","2390云辰","110/07/13","凱基-松山",61,13,48
"17938","2390云辰","110/07/13","兆豐-新竹",3,53,-50
"17939","2390云辰","110/07/13","大昌",64,22,42
"17940","2390云辰","110/07/13","富邦-嘉義",65,108,-43
"17941","2363矽統","110/07/13","凱基-南崁",2133,63,2070
"17942","2363矽統","110/07/13","凱基-幸福",36,4048,-4012
"17943","2363矽統","110/07/13","國泰-敦南",2195,1617,578
"17944","2363矽統","110/07/13","統一",192,3325,-3133
"17945","2363矽統","110/07/13","中農",670,139,531
"17946","2363矽統","110/07/13","新加坡商瑞銀",1000,2747,-1747
"17947","2363矽統","110/07/13","康和-台中",638,154,484
"17948","2363矽統","110/07/13","凱基-台北",5359,6609,-1250
"17949","2363矽統","110/07/13","群益金鼎-三民",577,137,440
"17950","2363矽統","110/07/13","摩根大通",1930,2858,-928
"17951","2363矽統","110/07/13","台新-屏東",510,88,422
"17952","2363矽統","110/07/13","港商野村",960,1679,-719
"17953","2363矽統","110/07/13","德信-中正",455,67,388
"17954","2363矽統","110/07/13","兆豐-復興",25,705,-680
"17955","2363矽統","110/07/13","日盛-竹北",365,70,295
"17956","2363矽統","110/07/13","統一-仁愛",114,755,-641
"17957","2363矽統","110/07/13","元大-佳里",452,189,263
"17958","2363矽統","110/07/13","統一-敦南",29,638,-609
"17959","2363矽統","110/07/13","國票-博愛",296,38,258
"17960","2363矽統","110/07/13","統一-土城",100,704,-604
"17961","2363矽統","110/07/13","元大-萬華",340,95,245
"17962","2363矽統","110/07/13","統一-城中",116,676,-560
"17963","2363矽統","110/07/13","新光",1259,1031,228
"17964","2363矽統","110/07/13","永豐金證券",306,859,-553
"17965","2363矽統","110/07/13","元富-成功",323,96,227
"17966","2363矽統","110/07/13","元富",54,567,-513
"17967","2363矽統","110/07/13","豐農",228,23,205
"17968","2363矽統","110/07/13","瑞士信貸",202,666,-464
"17969","2363矽統","110/07/13","台灣企銀-岡山",186,4,182
"17970","2363矽統","110/07/13","永豐金-嘉義",67,468,-401
"17971","8112至上","110/07/13","摩根大通",688,296,392
"17972","8112至上","110/07/13","國票-中和",0,401,-401
"17973","8112至上","110/07/13","港商野村",344,145,199
"17974","8112至上","110/07/13","永豐金-板盛",0,205,-205
"17975","8112至上","110/07/13","兆豐-公益",195,5,190
"17976","8112至上","110/07/13","凱基-五股",43,155,-112
"17977","8112至上","110/07/13","台灣摩根士丹利",183,0,183
"17978","8112至上","110/07/13","凱基-市政",0,100,-100
"17979","8112至上","110/07/13","群益金鼎-敦南",153,2,151
"17980","8112至上","110/07/13","元大-大里德芳",1,92,-91
"17981","8112至上","110/07/13","臺銀-金山",146,26,120
"17982","8112至上","110/07/13","玉山-桃園",26,110,-84
"17983","8112至上","110/07/13","臺銀",133,19,114
"17984","8112至上","110/07/13","兆豐-天母",0,81,-81
"17985","8112至上","110/07/13","合庫-台中",115,6,109
"17986","8112至上","110/07/13","凱基-城中",3,84,-81
"17987","8112至上","110/07/13","亞東-板橋",134,26,108
"17988","8112至上","110/07/13","日盛-新莊",9,85,-76
"17989","8112至上","110/07/13","凱基-台北",414,326,88
"17990","8112至上","110/07/13","日盛-台中",2,64,-62
"17991","8112至上","110/07/13","新加坡商瑞銀",181,100,81
"17992","8112至上","110/07/13","日盛-中壢",3,64,-61
"17993","8112至上","110/07/13","國泰-敦南",108,31,77
"17994","8112至上","110/07/13","元大-台中",2,59,-57
"17995","8112至上","110/07/13","第一金-華江",77,4,73
"17996","8112至上","110/07/13","元大-雙和",7,64,-57
"17997","8112至上","110/07/13","永豐金-內湖",73,1,72
"17998","8112至上","110/07/13","元大-高雄",8,62,-54
"17999","8112至上","110/07/13","元大-永和",68,1,67
"18000","8112至上","110/07/13","元大-館前",2,55,-53
"18001","2929淘帝","110/07/13","玉山-新竹",130,0,130
"18002","2929淘帝","110/07/13","美商高盛",0,177,-177
"18003","2929淘帝","110/07/13","臺銀-民權",60,0,60
"18004","2929淘帝","110/07/13","凱基-台北",6,80,-74
"18005","2929淘帝","110/07/13","新百王",31,0,31
"18006","2929淘帝","110/07/13","元富-大裕",0,49,-49
"18007","2929淘帝","110/07/13","日盛-園區",30,0,30
"18008","2929淘帝","110/07/13","國泰-館前",3,51,-48
"18009","2929淘帝","110/07/13","元大-南投",31,1,30
"18010","2929淘帝","110/07/13","凱基-中壢",0,41,-41
"18011","2929淘帝","110/07/13","兆豐-忠孝",28,0,28
"18012","2929淘帝","110/07/13","港商野村",21,55,-34
"18013","2929淘帝","110/07/13","元大-民生",28,0,28
"18014","2929淘帝","110/07/13","華南永昌-南京",2,34,-32
"18015","2929淘帝","110/07/13","合庫-高雄",27,0,27
"18016","2929淘帝","110/07/13","群益金鼎-土城",0,30,-30
"18017","2929淘帝","110/07/13","凱基-豐中",27,0,27
"18018","2929淘帝","110/07/13","富邦-南屯",0,22,-22
"18019","2929淘帝","110/07/13","新光",21,4,17
"18020","2929淘帝","110/07/13","第一金-豐原",0,20,-20
"18021","2929淘帝","110/07/13","元大-天母",17,0,17
"18022","2929淘帝","110/07/13","元大-屏南",6,26,-20
"18023","2929淘帝","110/07/13","永興",14,0,14
"18024","2929淘帝","110/07/13","永豐金-敦南",1,21,-20
"18025","2929淘帝","110/07/13","富邦-台北",12,0,12
"18026","2929淘帝","110/07/13","凱基-三重",2,21,-19
"18027","2929淘帝","110/07/13","元大-永和",12,0,12
"18028","2929淘帝","110/07/13","富邦-仁愛",7,25,-18
"18029","2929淘帝","110/07/13","國票-天祥",11,0,11
"18030","2929淘帝","110/07/13","元大-北投",0,16,-16
"18031","2841台開","110/07/13","中國信託-高雄",251,50,201
"18032","2841台開","110/07/13","兆豐-公益",0,177,-177
"18033","2841台開","110/07/13","日盛證券",210,13,197
"18034","2841台開","110/07/13","日進",0,152,-152
"18035","2841台開","110/07/13","第一金-台中",55,0,55
"18036","2841台開","110/07/13","港商野村",0,109,-109
"18037","2841台開","110/07/13","國泰-板橋",46,0,46
"18038","2841台開","110/07/13","日盛-信義",0,103,-103
"18039","2841台開","110/07/13","國泰-館前",48,3,45
"18040","2841台開","110/07/13","國泰-敦南",11,75,-64
"18041","2841台開","110/07/13","華南永昌-新莊",45,0,45
"18042","2841台開","110/07/13","永興",0,50,-50
"18043","2841台開","110/07/13","日盛-園區",42,0,42
"18044","2841台開","110/07/13","永豐金-敦南",61,104,-43
"18045","2841台開","110/07/13","台新證券",32,0,32
"18046","2841台開","110/07/13","富邦-台南",0,42,-42
"18047","2841台開","110/07/13","台新-高雄",32,2,30
"18048","2841台開","110/07/13","國票-安和",0,30,-30
"18049","2841台開","110/07/13","豐農",23,0,23
"18050","2841台開","110/07/13","元大-桃園",0,25,-25
"18051","2841台開","110/07/13","合庫-嘉義",20,0,20
"18052","2841台開","110/07/13","新光",8,32,-24
"18053","2841台開","110/07/13","華南永昌-高雄",20,0,20
"18054","2841台開","110/07/13","元大-仁愛",0,24,-24
"18055","2841台開","110/07/13","元大-樹林",16,0,16
"18056","2841台開","110/07/13","日盛-中和",0,20,-20
"18057","2841台開","110/07/13","第一金-華江",15,2,13
"18058","2841台開","110/07/13","元富",0,20,-20
"18059","2841台開","110/07/13","美商高盛",12,0,12
"18060","2841台開","110/07/13","富邦-宜蘭",0,20,-20
"18061","6207雷科","110/07/13","元大-高雄",121,0,121
"18062","6207雷科","110/07/13","華南永昌-朴子",1,60,-59
"18063","6207雷科","110/07/13","第一金-新興",20,0,20
"18064","6207雷科","110/07/13","元大-南海",0,36,-36
"18065","6207雷科","110/07/13","元富-三重",20,0,20
"18066","6207雷科","110/07/13","凱基-土城",0,35,-35
"18067","6207雷科","110/07/13","元大-林園",15,0,15
"18068","6207雷科","110/07/13","台灣企銀",0,20,-20
"18069","6207雷科","110/07/13","元大-金華",16,1,15
"18070","6207雷科","110/07/13","群益金鼎-丹鳳",0,20,-20
"18071","6207雷科","110/07/13","日盛證券",10,0,10
"18072","6207雷科","110/07/13","元大-博愛",0,17,-17
"18073","6207雷科","110/07/13","統一-台中",10,0,10
"18074","6207雷科","110/07/13","元大-北港",0,13,-13
"18075","6207雷科","110/07/13","群益金鼎-土城",10,0,10
"18076","6207雷科","110/07/13","新加坡商瑞銀",0,12,-12
"18077","6207雷科","110/07/13","群益金鼎-桃園",10,0,10
"18078","6207雷科","110/07/13","凱基-台北",4,16,-12
"18079","6207雷科","110/07/13","永豐金-新莊",10,0,10
"18080","6207雷科","110/07/13","日茂-埔里",0,11,-11
"18081","6207雷科","110/07/13","永豐金-新店",10,0,10
"18082","6207雷科","110/07/13","元大-莒光",0,11,-11
"18083","6207雷科","110/07/13","元大證券",9,0,9
"18084","6207雷科","110/07/13","統一-新竹",0,10,-10
"18085","6207雷科","110/07/13","日盛-木柵",9,1,8
"18086","6207雷科","110/07/13","元大-西螺",0,10,-10
"18087","6207雷科","110/07/13","兆豐-來福",8,0,8
"18088","6207雷科","110/07/13","康和-台中",0,8,-8
"18089","6207雷科","110/07/13","新光",7,0,7
"18090","6207雷科","110/07/13","兆豐-高雄",0,6,-6
"18091","3679新至陞","110/07/13","永豐金證券",50,0,50
"18092","3679新至陞","110/07/13","摩根大通",2,25,-23
"18093","3679新至陞","110/07/13","國泰-桃園",22,0,22
"18094","3679新至陞","110/07/13","元大-成功",0,22,-22
"18095","3679新至陞","110/07/13","台中銀-員林",11,0,11
"18096","3679新至陞","110/07/13","富邦-板橋",1,19,-18
"18097","3679新至陞","110/07/13","元大-文心興安",8,0,8
"18098","3679新至陞","110/07/13","日盛-新莊",0,10,-10
"18099","3679新至陞","110/07/13","美商高盛",6,0,6
"18100","3679新至陞","110/07/13","台新-台中",0,10,-10
"18101","3679新至陞","110/07/13","台新-高雄",6,0,6
"18102","3679新至陞","110/07/13","永豐金-新竹",0,8,-8
"18103","3679新至陞","110/07/13","凱基-台北",18,12,6
"18104","3679新至陞","110/07/13","瑞士信貸",12,19,-7
"18105","3679新至陞","110/07/13","日盛-復興",5,0,5
"18106","3679新至陞","110/07/13","統一-南京",0,7,-7
"18107","3679新至陞","110/07/13","(牛牛牛)亞-鑫豐",4,0,4
"18108","3679新至陞","110/07/13","凱基-新莊",0,7,-7
"18109","3679新至陞","110/07/13","元富-大昌",3,0,3
"18110","3679新至陞","110/07/13","新加坡商瑞銀",0,6,-6
"18111","3679新至陞","110/07/13","富邦-台北",3,0,3
"18112","3679新至陞","110/07/13","合庫-自強",0,5,-5
"18113","3679新至陞","110/07/13","日盛-樹林",2,0,2
"18114","3679新至陞","110/07/13","富邦-桃園",0,5,-5
"18115","3679新至陞","110/07/13","宏遠-光隆",2,0,2
"18116","3679新至陞","110/07/13","永豐金-潮州",0,4,-4
"18117","3679新至陞","110/07/13","美林",3,1,2
"18118","3679新至陞","110/07/13","臺銀-臺南",0,3,-3
"18119","3679新至陞","110/07/13","第一金-中壢",2,0,2
"18120","3679新至陞","110/07/13","元大-六合",0,3,-3
"18121","2727王品","110/07/13","富邦-台北",43,3,40
"18122","2727王品","110/07/13","台灣摩根士丹利",15,97,-82
"18123","2727王品","110/07/13","元大-基隆孝二",40,0,40
"18124","2727王品","110/07/13","玉山-台南",5,57,-52
"18125","2727王品","110/07/13","國票-新莊",40,1,39
"18126","2727王品","110/07/13","新加坡商瑞銀",0,48,-48
"18127","2727王品","110/07/13","第一金-豐原",66,42,24
"18128","2727王品","110/07/13","凱基-台北",41,77,-36
"18129","2727王品","110/07/13","永豐金-大園",34,10,24
"18130","2727王品","110/07/13","永豐金-永康",0,22,-22
"18131","2727王品","110/07/13","元大-北屯",22,0,22
"18132","2727王品","110/07/13","統一-台中",2,22,-20
"18133","2727王品","110/07/13","元大-東蘆",26,7,19
"18134","2727王品","110/07/13","國泰-台中",21,39,-18
"18135","2727王品","110/07/13","永豐金-萬盛",13,1,12
"18136","2727王品","110/07/13","合庫-彰化",3,20,-17
"18137","2727王品","110/07/13","日盛-嘉義",11,0,11
"18138","2727王品","110/07/13","港商野村",13,30,-17
"18139","2727王品","110/07/13","日盛-八德",11,0,11
"18140","2727王品","110/07/13","元大-楊梅",1,16,-15
"18141","2727王品","110/07/13","統一-竹南",11,0,11
"18142","2727王品","110/07/13","凱基-高美館",2,15,-13
"18143","2727王品","110/07/13","日盛-士林",12,2,10
"18144","2727王品","110/07/13","美商高盛",2,14,-12
"18145","2727王品","110/07/13","統一-敦南",10,0,10
"18146","2727王品","110/07/13","統一-平鎮",1,13,-12
"18147","2727王品","110/07/13","中國信託",15,5,10
"18148","2727王品","110/07/13","兆豐-台中港",4,16,-12
"18149","2727王品","110/07/13","兆豐-竹北",13,3,10
"18150","2727王品","110/07/13","凱基-八德",1,13,-12
"18151","1570力肯","110/07/13","新光",115,11,104
"18152","1570力肯","110/07/13","元大-北三重",0,162,-162
"18153","1570力肯","110/07/13","群益金鼎-高雄",54,0,54
"18154","1570力肯","110/07/13","元大-大灣",0,25,-25
"18155","1570力肯","110/07/13","國票-新莊",22,0,22
"18156","1570力肯","110/07/13","永豐金-苓雅",0,22,-22
"18157","1570力肯","110/07/13","日盛-桃園",12,0,12
"18158","1570力肯","110/07/13","永豐金-永康",0,19,-19
"18159","1570力肯","110/07/13","元大-高雄",12,0,12
"18160","1570力肯","110/07/13","富邦-員林",0,15,-15
"18161","1570力肯","110/07/13","合庫-自強",11,0,11
"18162","1570力肯","110/07/13","凱基-台南",0,11,-11
"18163","1570力肯","110/07/13","摩根大通",26,15,11
"18164","1570力肯","110/07/13","日盛-竹北",0,10,-10
"18165","1570力肯","110/07/13","永豐金-中盛",11,0,11
"18166","1570力肯","110/07/13","國票-九鼎",0,10,-10
"18167","1570力肯","110/07/13","兆豐-台中港",10,0,10
"18168","1570力肯","110/07/13","凱基-桃園",0,10,-10
"18169","1570力肯","110/07/13","國泰-松江",9,0,9
"18170","1570力肯","110/07/13","凱基-新豐",0,10,-10
"18171","1570力肯","110/07/13","元大-新盛",9,0,9
"18172","1570力肯","110/07/13","元大-學甲",0,10,-10
"18173","1570力肯","110/07/13","元富-緯城",6,0,6
"18174","1570力肯","110/07/13","群益金鼎-東湖",1,10,-9
"18175","1570力肯","110/07/13","統一-三重",5,0,5
"18176","1570力肯","110/07/13","大昌",0,6,-6
"18177","1570力肯","110/07/13","元大-前金",5,0,5
"18178","1570力肯","110/07/13","元大-土城學府",0,6,-6
"18179","1570力肯","110/07/13","永豐金證券",5,0,5
"18180","1570力肯","110/07/13","統一",0,5,-5
"18181","6180橘子","110/07/13","摩根大通",119,0,119
"18182","6180橘子","110/07/13","元大-崇德",2,61,-59
"18183","6180橘子","110/07/13","美商高盛",96,0,96
"18184","6180橘子","110/07/13","康和-台中",0,51,-51
"18185","6180橘子","110/07/13","新加坡商瑞銀",86,7,79
"18186","6180橘子","110/07/13","康和-台北",0,50,-50
"18187","6180橘子","110/07/13","元大-和平",40,0,40
"18188","6180橘子","110/07/13","元富-潮州",0,40,-40
"18189","6180橘子","110/07/13","凱基-台北",83,47,36
"18190","6180橘子","110/07/13","日盛-永康",0,26,-26
"18191","6180橘子","110/07/13","美林",39,5,34
"18192","6180橘子","110/07/13","永豐金-中正",0,24,-24
"18193","6180橘子","110/07/13","富邦-新竹華信",31,2,29
"18194","6180橘子","110/07/13","國泰-板橋",2,25,-23
"18195","6180橘子","110/07/13","統一-南京",21,0,21
"18196","6180橘子","110/07/13","日盛-大墩",0,20,-20
"18197","6180橘子","110/07/13","富邦-陽明",24,3,21
"18198","6180橘子","110/07/13","元大-草屯",13,32,-19
"18199","6180橘子","110/07/13","大昌-樹林",21,1,20
"18200","6180橘子","110/07/13","元富-林園",1,18,-17
"18201","6180橘子","110/07/13","花旗環球",19,0,19
"18202","6180橘子","110/07/13","新光-新竹",1,18,-17
"18203","6180橘子","110/07/13","華南永昌-台南",19,0,19
"18204","6180橘子","110/07/13","元大-土城永寧",0,17,-17
"18205","6180橘子","110/07/13","福勝",14,0,14
"18206","6180橘子","110/07/13","國泰-新莊",3,19,-16
"18207","6180橘子","110/07/13","富邦-嘉義",12,1,11
"18208","6180橘子","110/07/13","中國信託-永康",6,21,-15
"18209","6180橘子","110/07/13","元大-板橋三民",11,0,11
"18210","6180橘子","110/07/13","凱基-東港",1,15,-14
"18211","2390云辰","110/07/13","新加坡商瑞銀",562,75,487
"18212","2390云辰","110/07/13","大展-台南",0,532,-532
"18213","2390云辰","110/07/13","台灣摩根士丹利",330,155,175
"18214","2390云辰","110/07/13","凱基-台北",668,854,-186
"18215","2390云辰","110/07/13","兆豐-公益",126,25,101
"18216","2390云辰","110/07/13","凱基-三重",12,172,-160
"18217","2390云辰","110/07/13","元富-中港",100,2,98
"18218","2390云辰","110/07/13","兆豐-忠孝",4,161,-157
"18219","2390云辰","110/07/13","統一-新台中",106,9,97
"18220","2390云辰","110/07/13","元大-士林",19,170,-151
"18221","2390云辰","110/07/13","中國信託-松江",81,11,70
"18222","2390云辰","110/07/13","臺銀-新竹",14,117,-103
"18223","2390云辰","110/07/13","日盛-板橋",72,3,69
"18224","2390云辰","110/07/13","國票-台中",4,102,-98
"18225","2390云辰","110/07/13","日盛-和美",57,0,57
"18226","2390云辰","110/07/13","新光",147,232,-85
"18227","2390云辰","110/07/13","永豐金-桃園",88,36,52
"18228","2390云辰","110/07/13","致和-崇德",2,70,-68
"18229","2390云辰","110/07/13","玉山-士林",54,4,50
"18230","2390云辰","110/07/13","群益金鼎-屏東",2,70,-68
"18231","2390云辰","110/07/13","富邦-仁愛",56,6,50
"18232","2390云辰","110/07/13","元大-大里",35,98,-63
"18233","2390云辰","110/07/13","第一金-豐原",50,1,49
"18234","2390云辰","110/07/13","元大-萬華",35,94,-59
"18235","2390云辰","110/07/13","摩根大通",502,453,49
"18236","2390云辰","110/07/13","元富-吉利",2,60,-58
"18237","2390云辰","110/07/13","凱基-松山",61,13,48
"18238","2390云辰","110/07/13","兆豐-新竹",3,53,-50
"18239","2390云辰","110/07/13","大昌",64,22,42
"18240","2390云辰","110/07/13","富邦-嘉義",65,108,-43
"18241","2363矽統","110/07/13","凱基-南崁",2133,63,2070
"18242","2363矽統","110/07/13","凱基-幸福",36,4048,-4012
"18243","2363矽統","110/07/13","國泰-敦南",2195,1617,578
"18244","2363矽統","110/07/13","統一",192,3325,-3133
"18245","2363矽統","110/07/13","中農",670,139,531
"18246","2363矽統","110/07/13","新加坡商瑞銀",1000,2747,-1747
"18247","2363矽統","110/07/13","康和-台中",638,154,484
"18248","2363矽統","110/07/13","凱基-台北",5359,6609,-1250
"18249","2363矽統","110/07/13","群益金鼎-三民",577,137,440
"18250","2363矽統","110/07/13","摩根大通",1930,2858,-928
"18251","2363矽統","110/07/13","台新-屏東",510,88,422
"18252","2363矽統","110/07/13","港商野村",960,1679,-719
"18253","2363矽統","110/07/13","德信-中正",455,67,388
"18254","2363矽統","110/07/13","兆豐-復興",25,705,-680
"18255","2363矽統","110/07/13","日盛-竹北",365,70,295
"18256","2363矽統","110/07/13","統一-仁愛",114,755,-641
"18257","2363矽統","110/07/13","元大-佳里",452,189,263
"18258","2363矽統","110/07/13","統一-敦南",29,638,-609
"18259","2363矽統","110/07/13","國票-博愛",296,38,258
"18260","2363矽統","110/07/13","統一-土城",100,704,-604
"18261","2363矽統","110/07/13","元大-萬華",340,95,245
"18262","2363矽統","110/07/13","統一-城中",116,676,-560
"18263","2363矽統","110/07/13","新光",1259,1031,228
"18264","2363矽統","110/07/13","永豐金證券",306,859,-553
"18265","2363矽統","110/07/13","元富-成功",323,96,227
"18266","2363矽統","110/07/13","元富",54,567,-513
"18267","2363矽統","110/07/13","豐農",228,23,205
"18268","2363矽統","110/07/13","瑞士信貸",202,666,-464
"18269","2363矽統","110/07/13","台灣企銀-岡山",186,4,182
"18270","2363矽統","110/07/13","永豐金-嘉義",67,468,-401
"18271","8112至上","110/07/13","摩根大通",688,296,392
"18272","8112至上","110/07/13","國票-中和",0,401,-401
"18273","8112至上","110/07/13","港商野村",344,145,199
"18274","8112至上","110/07/13","永豐金-板盛",0,205,-205
"18275","8112至上","110/07/13","兆豐-公益",195,5,190
"18276","8112至上","110/07/13","凱基-五股",43,155,-112
"18277","8112至上","110/07/13","台灣摩根士丹利",183,0,183
"18278","8112至上","110/07/13","凱基-市政",0,100,-100
"18279","8112至上","110/07/13","群益金鼎-敦南",153,2,151
"18280","8112至上","110/07/13","元大-大里德芳",1,92,-91
"18281","8112至上","110/07/13","臺銀-金山",146,26,120
"18282","8112至上","110/07/13","玉山-桃園",26,110,-84
"18283","8112至上","110/07/13","臺銀",133,19,114
"18284","8112至上","110/07/13","兆豐-天母",0,81,-81
"18285","8112至上","110/07/13","合庫-台中",115,6,109
"18286","8112至上","110/07/13","凱基-城中",3,84,-81
"18287","8112至上","110/07/13","亞東-板橋",134,26,108
"18288","8112至上","110/07/13","日盛-新莊",9,85,-76
"18289","8112至上","110/07/13","凱基-台北",414,326,88
"18290","8112至上","110/07/13","日盛-台中",2,64,-62
"18291","8112至上","110/07/13","新加坡商瑞銀",181,100,81
"18292","8112至上","110/07/13","日盛-中壢",3,64,-61
"18293","8112至上","110/07/13","國泰-敦南",108,31,77
"18294","8112至上","110/07/13","元大-台中",2,59,-57
"18295","8112至上","110/07/13","第一金-華江",77,4,73
"18296","8112至上","110/07/13","元大-雙和",7,64,-57
"18297","8112至上","110/07/13","永豐金-內湖",73,1,72
"18298","8112至上","110/07/13","元大-高雄",8,62,-54
"18299","8112至上","110/07/13","元大-永和",68,1,67
"18300","8112至上","110/07/13","元大-館前",2,55,-53
"18301","2929淘帝","110/07/13","玉山-新竹",130,0,130
"18302","2929淘帝","110/07/13","美商高盛",0,177,-177
"18303","2929淘帝","110/07/13","臺銀-民權",60,0,60
"18304","2929淘帝","110/07/13","凱基-台北",6,80,-74
"18305","2929淘帝","110/07/13","新百王",31,0,31
"18306","2929淘帝","110/07/13","元富-大裕",0,49,-49
"18307","2929淘帝","110/07/13","日盛-園區",30,0,30
"18308","2929淘帝","110/07/13","國泰-館前",3,51,-48
"18309","2929淘帝","110/07/13","元大-南投",31,1,30
"18310","2929淘帝","110/07/13","凱基-中壢",0,41,-41
"18311","2929淘帝","110/07/13","兆豐-忠孝",28,0,28
"18312","2929淘帝","110/07/13","港商野村",21,55,-34
"18313","2929淘帝","110/07/13","元大-民生",28,0,28
"18314","2929淘帝","110/07/13","華南永昌-南京",2,34,-32
"18315","2929淘帝","110/07/13","合庫-高雄",27,0,27
"18316","2929淘帝","110/07/13","群益金鼎-土城",0,30,-30
"18317","2929淘帝","110/07/13","凱基-豐中",27,0,27
"18318","2929淘帝","110/07/13","富邦-南屯",0,22,-22
"18319","2929淘帝","110/07/13","新光",21,4,17
"18320","2929淘帝","110/07/13","第一金-豐原",0,20,-20
"18321","2929淘帝","110/07/13","元大-天母",17,0,17
"18322","2929淘帝","110/07/13","元大-屏南",6,26,-20
"18323","2929淘帝","110/07/13","永興",14,0,14
"18324","2929淘帝","110/07/13","永豐金-敦南",1,21,-20
"18325","2929淘帝","110/07/13","富邦-台北",12,0,12
"18326","2929淘帝","110/07/13","凱基-三重",2,21,-19
"18327","2929淘帝","110/07/13","元大-永和",12,0,12
"18328","2929淘帝","110/07/13","富邦-仁愛",7,25,-18
"18329","2929淘帝","110/07/13","國票-天祥",11,0,11
"18330","2929淘帝","110/07/13","元大-北投",0,16,-16
"18331","5410國眾","110/07/13","兆豐-城中",274,0,274
"18332","5410國眾","110/07/13","元富-嘉義",0,103,-103
"18333","5410國眾","110/07/13","新光",50,4,46
"18334","5410國眾","110/07/13","凱基-台北",0,50,-50
"18335","5410國眾","110/07/13","國泰-台中",26,0,26
"18336","5410國眾","110/07/13","瑞士信貸",0,31,-31
"18337","5410國眾","110/07/13","新加坡商瑞銀",22,0,22
"18338","5410國眾","110/07/13","台新-新莊",0,27,-27
"18339","5410國眾","110/07/13","光和-嘉義",20,0,20
"18340","5410國眾","110/07/13","元大-汐止",0,20,-20
"18341","5410國眾","110/07/13","凱基-竹北",17,0,17
"18342","5410國眾","110/07/13","亞東-新竹",0,17,-17
"18343","5410國眾","110/07/13","新光-桃園",15,0,15
"18344","5410國眾","110/07/13","元大-南勢角",0,13,-13
"18345","5410國眾","110/07/13","凱基-台東",14,0,14
"18346","5410國眾","110/07/13","台新-台南",0,12,-12
"18347","5410國眾","110/07/13","富邦-竹北",11,0,11
"18348","5410國眾","110/07/13","中國信託",0,11,-11
"18349","5410國眾","110/07/13","元富-同大",10,0,10
"18350","5410國眾","110/07/13","華南永昌",0,11,-11
"18351","5410國眾","110/07/13","國泰-敦南",24,15,9
"18352","5410國眾","110/07/13","臺銀-臺南",0,10,-10
"18353","5410國眾","110/07/13","日盛-內湖",7,0,7
"18354","5410國眾","110/07/13","台灣企銀-民雄",0,10,-10
"18355","5410國眾","110/07/13","台新-左楠",7,0,7
"18356","5410國眾","110/07/13","高橋",0,10,-10
"18357","5410國眾","110/07/13","元大-新盛",18,12,6
"18358","5410國眾","110/07/13","康和-嘉義",0,10,-10
"18359","5410國眾","110/07/13","統一",5,0,5
"18360","5410國眾","110/07/13","凱基-基隆",0,10,-10
"18361","2841台開","110/07/13","中國信託-高雄",251,50,201
"18362","2841台開","110/07/13","兆豐-公益",0,177,-177
"18363","2841台開","110/07/13","日盛證券",210,13,197
"18364","2841台開","110/07/13","日進",0,152,-152
"18365","2841台開","110/07/13","第一金-台中",55,0,55
"18366","2841台開","110/07/13","港商野村",0,109,-109
"18367","2841台開","110/07/13","國泰-板橋",46,0,46
"18368","2841台開","110/07/13","日盛-信義",0,103,-103
"18369","2841台開","110/07/13","國泰-館前",48,3,45
"18370","2841台開","110/07/13","國泰-敦南",11,75,-64
"18371","2841台開","110/07/13","華南永昌-新莊",45,0,45
"18372","2841台開","110/07/13","永興",0,50,-50
"18373","2841台開","110/07/13","日盛-園區",42,0,42
"18374","2841台開","110/07/13","永豐金-敦南",61,104,-43
"18375","2841台開","110/07/13","台新證券",32,0,32
"18376","2841台開","110/07/13","富邦-台南",0,42,-42
"18377","2841台開","110/07/13","台新-高雄",32,2,30
"18378","2841台開","110/07/13","國票-安和",0,30,-30
"18379","2841台開","110/07/13","豐農",23,0,23
"18380","2841台開","110/07/13","元大-桃園",0,25,-25
"18381","2841台開","110/07/13","合庫-嘉義",20,0,20
"18382","2841台開","110/07/13","新光",8,32,-24
"18383","2841台開","110/07/13","華南永昌-高雄",20,0,20
"18384","2841台開","110/07/13","元大-仁愛",0,24,-24
"18385","2841台開","110/07/13","元大-樹林",16,0,16
"18386","2841台開","110/07/13","日盛-中和",0,20,-20
"18387","2841台開","110/07/13","第一金-華江",15,2,13
"18388","2841台開","110/07/13","元富",0,20,-20
"18389","2841台開","110/07/13","美商高盛",12,0,12
"18390","2841台開","110/07/13","富邦-宜蘭",0,20,-20
"18391","6207雷科","110/07/13","元大-高雄",121,0,121
"18392","6207雷科","110/07/13","華南永昌-朴子",1,60,-59
"18393","6207雷科","110/07/13","第一金-新興",20,0,20
"18394","6207雷科","110/07/13","元大-南海",0,36,-36
"18395","6207雷科","110/07/13","元富-三重",20,0,20
"18396","6207雷科","110/07/13","凱基-土城",0,35,-35
"18397","6207雷科","110/07/13","元大-林園",15,0,15
"18398","6207雷科","110/07/13","台灣企銀",0,20,-20
"18399","6207雷科","110/07/13","元大-金華",16,1,15
"18400","6207雷科","110/07/13","群益金鼎-丹鳳",0,20,-20
"18401","6207雷科","110/07/13","日盛證券",10,0,10
"18402","6207雷科","110/07/13","元大-博愛",0,17,-17
"18403","6207雷科","110/07/13","統一-台中",10,0,10
"18404","6207雷科","110/07/13","元大-北港",0,13,-13
"18405","6207雷科","110/07/13","群益金鼎-土城",10,0,10
"18406","6207雷科","110/07/13","新加坡商瑞銀",0,12,-12
"18407","6207雷科","110/07/13","群益金鼎-桃園",10,0,10
"18408","6207雷科","110/07/13","凱基-台北",4,16,-12
"18409","6207雷科","110/07/13","永豐金-新莊",10,0,10
"18410","6207雷科","110/07/13","日茂-埔里",0,11,-11
"18411","6207雷科","110/07/13","永豐金-新店",10,0,10
"18412","6207雷科","110/07/13","元大-莒光",0,11,-11
"18413","6207雷科","110/07/13","元大證券",9,0,9
"18414","6207雷科","110/07/13","統一-新竹",0,10,-10
"18415","6207雷科","110/07/13","日盛-木柵",9,1,8
"18416","6207雷科","110/07/13","元大-西螺",0,10,-10
"18417","6207雷科","110/07/13","兆豐-來福",8,0,8
"18418","6207雷科","110/07/13","康和-台中",0,8,-8
"18419","6207雷科","110/07/13","新光",7,0,7
"18420","6207雷科","110/07/13","兆豐-高雄",0,6,-6
"18421","3679新至陞","110/07/13","永豐金證券",50,0,50
"18422","3679新至陞","110/07/13","摩根大通",2,25,-23
"18423","3679新至陞","110/07/13","國泰-桃園",22,0,22
"18424","3679新至陞","110/07/13","元大-成功",0,22,-22
"18425","3679新至陞","110/07/13","台中銀-員林",11,0,11
"18426","3679新至陞","110/07/13","富邦-板橋",1,19,-18
"18427","3679新至陞","110/07/13","元大-文心興安",8,0,8
"18428","3679新至陞","110/07/13","日盛-新莊",0,10,-10
"18429","3679新至陞","110/07/13","美商高盛",6,0,6
"18430","3679新至陞","110/07/13","台新-台中",0,10,-10
"18431","3679新至陞","110/07/13","台新-高雄",6,0,6
"18432","3679新至陞","110/07/13","永豐金-新竹",0,8,-8
"18433","3679新至陞","110/07/13","凱基-台北",18,12,6
"18434","3679新至陞","110/07/13","瑞士信貸",12,19,-7
"18435","3679新至陞","110/07/13","日盛-復興",5,0,5
"18436","3679新至陞","110/07/13","統一-南京",0,7,-7
"18437","3679新至陞","110/07/13","(牛牛牛)亞-鑫豐",4,0,4
"18438","3679新至陞","110/07/13","凱基-新莊",0,7,-7
"18439","3679新至陞","110/07/13","元富-大昌",3,0,3
"18440","3679新至陞","110/07/13","新加坡商瑞銀",0,6,-6
"18441","3679新至陞","110/07/13","富邦-台北",3,0,3
"18442","3679新至陞","110/07/13","合庫-自強",0,5,-5
"18443","3679新至陞","110/07/13","日盛-樹林",2,0,2
"18444","3679新至陞","110/07/13","富邦-桃園",0,5,-5
"18445","3679新至陞","110/07/13","宏遠-光隆",2,0,2
"18446","3679新至陞","110/07/13","永豐金-潮州",0,4,-4
"18447","3679新至陞","110/07/13","美林",3,1,2
"18448","3679新至陞","110/07/13","臺銀-臺南",0,3,-3
"18449","3679新至陞","110/07/13","第一金-中壢",2,0,2
"18450","3679新至陞","110/07/13","元大-六合",0,3,-3
"18451","2727王品","110/07/13","富邦-台北",43,3,40
"18452","2727王品","110/07/13","台灣摩根士丹利",15,97,-82
"18453","2727王品","110/07/13","元大-基隆孝二",40,0,40
"18454","2727王品","110/07/13","玉山-台南",5,57,-52
"18455","2727王品","110/07/13","國票-新莊",40,1,39
"18456","2727王品","110/07/13","新加坡商瑞銀",0,48,-48
"18457","2727王品","110/07/13","第一金-豐原",66,42,24
"18458","2727王品","110/07/13","凱基-台北",41,77,-36
"18459","2727王品","110/07/13","永豐金-大園",34,10,24
"18460","2727王品","110/07/13","永豐金-永康",0,22,-22
"18461","2727王品","110/07/13","元大-北屯",22,0,22
"18462","2727王品","110/07/13","統一-台中",2,22,-20
"18463","2727王品","110/07/13","元大-東蘆",26,7,19
"18464","2727王品","110/07/13","國泰-台中",21,39,-18
"18465","2727王品","110/07/13","永豐金-萬盛",13,1,12
"18466","2727王品","110/07/13","合庫-彰化",3,20,-17
"18467","2727王品","110/07/13","日盛-嘉義",11,0,11
"18468","2727王品","110/07/13","港商野村",13,30,-17
"18469","2727王品","110/07/13","日盛-八德",11,0,11
"18470","2727王品","110/07/13","元大-楊梅",1,16,-15
"18471","2727王品","110/07/13","統一-竹南",11,0,11
"18472","2727王品","110/07/13","凱基-高美館",2,15,-13
"18473","2727王品","110/07/13","日盛-士林",12,2,10
"18474","2727王品","110/07/13","美商高盛",2,14,-12
"18475","2727王品","110/07/13","統一-敦南",10,0,10
"18476","2727王品","110/07/13","統一-平鎮",1,13,-12
"18477","2727王品","110/07/13","中國信託",15,5,10
"18478","2727王品","110/07/13","兆豐-台中港",4,16,-12
"18479","2727王品","110/07/13","兆豐-竹北",13,3,10
"18480","2727王品","110/07/13","凱基-八德",1,13,-12
"18481","1570力肯","110/07/13","新光",115,11,104
"18482","1570力肯","110/07/13","元大-北三重",0,162,-162
"18483","1570力肯","110/07/13","群益金鼎-高雄",54,0,54
"18484","1570力肯","110/07/13","元大-大灣",0,25,-25
"18485","1570力肯","110/07/13","國票-新莊",22,0,22
"18486","1570力肯","110/07/13","永豐金-苓雅",0,22,-22
"18487","1570力肯","110/07/13","日盛-桃園",12,0,12
"18488","1570力肯","110/07/13","永豐金-永康",0,19,-19
"18489","1570力肯","110/07/13","元大-高雄",12,0,12
"18490","1570力肯","110/07/13","富邦-員林",0,15,-15
"18491","1570力肯","110/07/13","合庫-自強",11,0,11
"18492","1570力肯","110/07/13","凱基-台南",0,11,-11
"18493","1570力肯","110/07/13","摩根大通",26,15,11
"18494","1570力肯","110/07/13","日盛-竹北",0,10,-10
"18495","1570力肯","110/07/13","永豐金-中盛",11,0,11
"18496","1570力肯","110/07/13","國票-九鼎",0,10,-10
"18497","1570力肯","110/07/13","兆豐-台中港",10,0,10
"18498","1570力肯","110/07/13","凱基-桃園",0,10,-10
"18499","1570力肯","110/07/13","國泰-松江",9,0,9
"18500","1570力肯","110/07/13","凱基-新豐",0,10,-10
"18501","1570力肯","110/07/13","元大-新盛",9,0,9
"18502","1570力肯","110/07/13","元大-學甲",0,10,-10
"18503","1570力肯","110/07/13","元富-緯城",6,0,6
"18504","1570力肯","110/07/13","群益金鼎-東湖",1,10,-9
"18505","1570力肯","110/07/13","統一-三重",5,0,5
"18506","1570力肯","110/07/13","大昌",0,6,-6
"18507","1570力肯","110/07/13","元大-前金",5,0,5
"18508","1570力肯","110/07/13","元大-土城學府",0,6,-6
"18509","1570力肯","110/07/13","永豐金證券",5,0,5
"18510","1570力肯","110/07/13","統一",0,5,-5
"18511","6180橘子","110/07/13","摩根大通",119,0,119
"18512","6180橘子","110/07/13","元大-崇德",2,61,-59
"18513","6180橘子","110/07/13","美商高盛",96,0,96
"18514","6180橘子","110/07/13","康和-台中",0,51,-51
"18515","6180橘子","110/07/13","新加坡商瑞銀",86,7,79
"18516","6180橘子","110/07/13","康和-台北",0,50,-50
"18517","6180橘子","110/07/13","元大-和平",40,0,40
"18518","6180橘子","110/07/13","元富-潮州",0,40,-40
"18519","6180橘子","110/07/13","凱基-台北",83,47,36
"18520","6180橘子","110/07/13","日盛-永康",0,26,-26
"18521","6180橘子","110/07/13","美林",39,5,34
"18522","6180橘子","110/07/13","永豐金-中正",0,24,-24
"18523","6180橘子","110/07/13","富邦-新竹華信",31,2,29
"18524","6180橘子","110/07/13","國泰-板橋",2,25,-23
"18525","6180橘子","110/07/13","統一-南京",21,0,21
"18526","6180橘子","110/07/13","日盛-大墩",0,20,-20
"18527","6180橘子","110/07/13","富邦-陽明",24,3,21
"18528","6180橘子","110/07/13","元大-草屯",13,32,-19
"18529","6180橘子","110/07/13","大昌-樹林",21,1,20
"18530","6180橘子","110/07/13","元富-林園",1,18,-17
"18531","6180橘子","110/07/13","花旗環球",19,0,19
"18532","6180橘子","110/07/13","新光-新竹",1,18,-17
"18533","6180橘子","110/07/13","華南永昌-台南",19,0,19
"18534","6180橘子","110/07/13","元大-土城永寧",0,17,-17
"18535","6180橘子","110/07/13","福勝",14,0,14
"18536","6180橘子","110/07/13","國泰-新莊",3,19,-16
"18537","6180橘子","110/07/13","富邦-嘉義",12,1,11
"18538","6180橘子","110/07/13","中國信託-永康",6,21,-15
"18539","6180橘子","110/07/13","元大-板橋三民",11,0,11
"18540","6180橘子","110/07/13","凱基-東港",1,15,-14
"18541","2390云辰","110/07/13","新加坡商瑞銀",562,75,487
"18542","2390云辰","110/07/13","大展-台南",0,532,-532
"18543","2390云辰","110/07/13","台灣摩根士丹利",330,155,175
"18544","2390云辰","110/07/13","凱基-台北",668,854,-186
"18545","2390云辰","110/07/13","兆豐-公益",126,25,101
"18546","2390云辰","110/07/13","凱基-三重",12,172,-160
"18547","2390云辰","110/07/13","元富-中港",100,2,98
"18548","2390云辰","110/07/13","兆豐-忠孝",4,161,-157
"18549","2390云辰","110/07/13","統一-新台中",106,9,97
"18550","2390云辰","110/07/13","元大-士林",19,170,-151
"18551","2390云辰","110/07/13","中國信託-松江",81,11,70
"18552","2390云辰","110/07/13","臺銀-新竹",14,117,-103
"18553","2390云辰","110/07/13","日盛-板橋",72,3,69
"18554","2390云辰","110/07/13","國票-台中",4,102,-98
"18555","2390云辰","110/07/13","日盛-和美",57,0,57
"18556","2390云辰","110/07/13","新光",147,232,-85
"18557","2390云辰","110/07/13","永豐金-桃園",88,36,52
"18558","2390云辰","110/07/13","致和-崇德",2,70,-68
"18559","2390云辰","110/07/13","玉山-士林",54,4,50
"18560","2390云辰","110/07/13","群益金鼎-屏東",2,70,-68
"18561","2390云辰","110/07/13","富邦-仁愛",56,6,50
"18562","2390云辰","110/07/13","元大-大里",35,98,-63
"18563","2390云辰","110/07/13","第一金-豐原",50,1,49
"18564","2390云辰","110/07/13","元大-萬華",35,94,-59
"18565","2390云辰","110/07/13","摩根大通",502,453,49
"18566","2390云辰","110/07/13","元富-吉利",2,60,-58
"18567","2390云辰","110/07/13","凱基-松山",61,13,48
"18568","2390云辰","110/07/13","兆豐-新竹",3,53,-50
"18569","2390云辰","110/07/13","大昌",64,22,42
"18570","2390云辰","110/07/13","富邦-嘉義",65,108,-43
"18571","2363矽統","110/07/13","凱基-南崁",2133,63,2070
"18572","2363矽統","110/07/13","凱基-幸福",36,4048,-4012
"18573","2363矽統","110/07/13","國泰-敦南",2195,1617,578
"18574","2363矽統","110/07/13","統一",192,3325,-3133
"18575","2363矽統","110/07/13","中農",670,139,531
"18576","2363矽統","110/07/13","新加坡商瑞銀",1000,2747,-1747
"18577","2363矽統","110/07/13","康和-台中",638,154,484
"18578","2363矽統","110/07/13","凱基-台北",5359,6609,-1250
"18579","2363矽統","110/07/13","群益金鼎-三民",577,137,440
"18580","2363矽統","110/07/13","摩根大通",1930,2858,-928
"18581","2363矽統","110/07/13","台新-屏東",510,88,422
"18582","2363矽統","110/07/13","港商野村",960,1679,-719
"18583","2363矽統","110/07/13","德信-中正",455,67,388
"18584","2363矽統","110/07/13","兆豐-復興",25,705,-680
"18585","2363矽統","110/07/13","日盛-竹北",365,70,295
"18586","2363矽統","110/07/13","統一-仁愛",114,755,-641
"18587","2363矽統","110/07/13","元大-佳里",452,189,263
"18588","2363矽統","110/07/13","統一-敦南",29,638,-609
"18589","2363矽統","110/07/13","國票-博愛",296,38,258
"18590","2363矽統","110/07/13","統一-土城",100,704,-604
"18591","2363矽統","110/07/13","元大-萬華",340,95,245
"18592","2363矽統","110/07/13","統一-城中",116,676,-560
"18593","2363矽統","110/07/13","新光",1259,1031,228
"18594","2363矽統","110/07/13","永豐金證券",306,859,-553
"18595","2363矽統","110/07/13","元富-成功",323,96,227
"18596","2363矽統","110/07/13","元富",54,567,-513
"18597","2363矽統","110/07/13","豐農",228,23,205
"18598","2363矽統","110/07/13","瑞士信貸",202,666,-464
"18599","2363矽統","110/07/13","台灣企銀-岡山",186,4,182
"18600","2363矽統","110/07/13","永豐金-嘉義",67,468,-401
"18601","8112至上","110/07/13","摩根大通",688,296,392
"18602","8112至上","110/07/13","國票-中和",0,401,-401
"18603","8112至上","110/07/13","港商野村",344,145,199
"18604","8112至上","110/07/13","永豐金-板盛",0,205,-205
"18605","8112至上","110/07/13","兆豐-公益",195,5,190
"18606","8112至上","110/07/13","凱基-五股",43,155,-112
"18607","8112至上","110/07/13","台灣摩根士丹利",183,0,183
"18608","8112至上","110/07/13","凱基-市政",0,100,-100
"18609","8112至上","110/07/13","群益金鼎-敦南",153,2,151
"18610","8112至上","110/07/13","元大-大里德芳",1,92,-91
"18611","8112至上","110/07/13","臺銀-金山",146,26,120
"18612","8112至上","110/07/13","玉山-桃園",26,110,-84
"18613","8112至上","110/07/13","臺銀",133,19,114
"18614","8112至上","110/07/13","兆豐-天母",0,81,-81
"18615","8112至上","110/07/13","合庫-台中",115,6,109
"18616","8112至上","110/07/13","凱基-城中",3,84,-81
"18617","8112至上","110/07/13","亞東-板橋",134,26,108
"18618","8112至上","110/07/13","日盛-新莊",9,85,-76
"18619","8112至上","110/07/13","凱基-台北",414,326,88
"18620","8112至上","110/07/13","日盛-台中",2,64,-62
"18621","8112至上","110/07/13","新加坡商瑞銀",181,100,81
"18622","8112至上","110/07/13","日盛-中壢",3,64,-61
"18623","8112至上","110/07/13","國泰-敦南",108,31,77
"18624","8112至上","110/07/13","元大-台中",2,59,-57
"18625","8112至上","110/07/13","第一金-華江",77,4,73
"18626","8112至上","110/07/13","元大-雙和",7,64,-57
"18627","8112至上","110/07/13","永豐金-內湖",73,1,72
"18628","8112至上","110/07/13","元大-高雄",8,62,-54
"18629","8112至上","110/07/13","元大-永和",68,1,67
"18630","8112至上","110/07/13","元大-館前",2,55,-53
"18631","2929淘帝","110/07/13","玉山-新竹",130,0,130
"18632","2929淘帝","110/07/13","美商高盛",0,177,-177
"18633","2929淘帝","110/07/13","臺銀-民權",60,0,60
"18634","2929淘帝","110/07/13","凱基-台北",6,80,-74
"18635","2929淘帝","110/07/13","新百王",31,0,31
"18636","2929淘帝","110/07/13","元富-大裕",0,49,-49
"18637","2929淘帝","110/07/13","日盛-園區",30,0,30
"18638","2929淘帝","110/07/13","國泰-館前",3,51,-48
"18639","2929淘帝","110/07/13","元大-南投",31,1,30
"18640","2929淘帝","110/07/13","凱基-中壢",0,41,-41
"18641","2929淘帝","110/07/13","兆豐-忠孝",28,0,28
"18642","2929淘帝","110/07/13","港商野村",21,55,-34
"18643","2929淘帝","110/07/13","元大-民生",28,0,28
"18644","2929淘帝","110/07/13","華南永昌-南京",2,34,-32
"18645","2929淘帝","110/07/13","合庫-高雄",27,0,27
"18646","2929淘帝","110/07/13","群益金鼎-土城",0,30,-30
"18647","2929淘帝","110/07/13","凱基-豐中",27,0,27
"18648","2929淘帝","110/07/13","富邦-南屯",0,22,-22
"18649","2929淘帝","110/07/13","新光",21,4,17
"18650","2929淘帝","110/07/13","第一金-豐原",0,20,-20
"18651","2929淘帝","110/07/13","元大-天母",17,0,17
"18652","2929淘帝","110/07/13","元大-屏南",6,26,-20
"18653","2929淘帝","110/07/13","永興",14,0,14
"18654","2929淘帝","110/07/13","永豐金-敦南",1,21,-20
"18655","2929淘帝","110/07/13","富邦-台北",12,0,12
"18656","2929淘帝","110/07/13","凱基-三重",2,21,-19
"18657","2929淘帝","110/07/13","元大-永和",12,0,12
"18658","2929淘帝","110/07/13","富邦-仁愛",7,25,-18
"18659","2929淘帝","110/07/13","國票-天祥",11,0,11
"18660","2929淘帝","110/07/13","元大-北投",0,16,-16
"18661","5410國眾","110/07/13","兆豐-城中",274,0,274
"18662","5410國眾","110/07/13","元富-嘉義",0,103,-103
"18663","5410國眾","110/07/13","新光",50,4,46
"18664","5410國眾","110/07/13","凱基-台北",0,50,-50
"18665","5410國眾","110/07/13","國泰-台中",26,0,26
"18666","5410國眾","110/07/13","瑞士信貸",0,31,-31
"18667","5410國眾","110/07/13","新加坡商瑞銀",22,0,22
"18668","5410國眾","110/07/13","台新-新莊",0,27,-27
"18669","5410國眾","110/07/13","光和-嘉義",20,0,20
"18670","5410國眾","110/07/13","元大-汐止",0,20,-20
"18671","5410國眾","110/07/13","凱基-竹北",17,0,17
"18672","5410國眾","110/07/13","亞東-新竹",0,17,-17
"18673","5410國眾","110/07/13","新光-桃園",15,0,15
"18674","5410國眾","110/07/13","元大-南勢角",0,13,-13
"18675","5410國眾","110/07/13","凱基-台東",14,0,14
"18676","5410國眾","110/07/13","台新-台南",0,12,-12
"18677","5410國眾","110/07/13","富邦-竹北",11,0,11
"18678","5410國眾","110/07/13","中國信託",0,11,-11
"18679","5410國眾","110/07/13","元富-同大",10,0,10
"18680","5410國眾","110/07/13","華南永昌",0,11,-11
"18681","5410國眾","110/07/13","國泰-敦南",24,15,9
"18682","5410國眾","110/07/13","臺銀-臺南",0,10,-10
"18683","5410國眾","110/07/13","日盛-內湖",7,0,7
"18684","5410國眾","110/07/13","台灣企銀-民雄",0,10,-10
"18685","5410國眾","110/07/13","台新-左楠",7,0,7
"18686","5410國眾","110/07/13","高橋",0,10,-10
"18687","5410國眾","110/07/13","元大-新盛",18,12,6
"18688","5410國眾","110/07/13","康和-嘉義",0,10,-10
"18689","5410國眾","110/07/13","統一",5,0,5
"18690","5410國眾","110/07/13","凱基-基隆",0,10,-10
"18691","2841台開","110/07/13","中國信託-高雄",251,50,201
"18692","2841台開","110/07/13","兆豐-公益",0,177,-177
"18693","2841台開","110/07/13","日盛證券",210,13,197
"18694","2841台開","110/07/13","日進",0,152,-152
"18695","2841台開","110/07/13","第一金-台中",55,0,55
"18696","2841台開","110/07/13","港商野村",0,109,-109
"18697","2841台開","110/07/13","國泰-板橋",46,0,46
"18698","2841台開","110/07/13","日盛-信義",0,103,-103
"18699","2841台開","110/07/13","國泰-館前",48,3,45
"18700","2841台開","110/07/13","國泰-敦南",11,75,-64
"18701","2841台開","110/07/13","華南永昌-新莊",45,0,45
"18702","2841台開","110/07/13","永興",0,50,-50
"18703","2841台開","110/07/13","日盛-園區",42,0,42
"18704","2841台開","110/07/13","永豐金-敦南",61,104,-43
"18705","2841台開","110/07/13","台新證券",32,0,32
"18706","2841台開","110/07/13","富邦-台南",0,42,-42
"18707","2841台開","110/07/13","台新-高雄",32,2,30
"18708","2841台開","110/07/13","國票-安和",0,30,-30
"18709","2841台開","110/07/13","豐農",23,0,23
"18710","2841台開","110/07/13","元大-桃園",0,25,-25
"18711","2841台開","110/07/13","合庫-嘉義",20,0,20
"18712","2841台開","110/07/13","新光",8,32,-24
"18713","2841台開","110/07/13","華南永昌-高雄",20,0,20
"18714","2841台開","110/07/13","元大-仁愛",0,24,-24
"18715","2841台開","110/07/13","元大-樹林",16,0,16
"18716","2841台開","110/07/13","日盛-中和",0,20,-20
"18717","2841台開","110/07/13","第一金-華江",15,2,13
"18718","2841台開","110/07/13","元富",0,20,-20
"18719","2841台開","110/07/13","美商高盛",12,0,12
"18720","2841台開","110/07/13","富邦-宜蘭",0,20,-20
"18721","6207雷科","110/07/13","元大-高雄",121,0,121
"18722","6207雷科","110/07/13","華南永昌-朴子",1,60,-59
"18723","6207雷科","110/07/13","第一金-新興",20,0,20
"18724","6207雷科","110/07/13","元大-南海",0,36,-36
"18725","6207雷科","110/07/13","元富-三重",20,0,20
"18726","6207雷科","110/07/13","凱基-土城",0,35,-35
"18727","6207雷科","110/07/13","元大-林園",15,0,15
"18728","6207雷科","110/07/13","台灣企銀",0,20,-20
"18729","6207雷科","110/07/13","元大-金華",16,1,15
"18730","6207雷科","110/07/13","群益金鼎-丹鳳",0,20,-20
"18731","6207雷科","110/07/13","日盛證券",10,0,10
"18732","6207雷科","110/07/13","元大-博愛",0,17,-17
"18733","6207雷科","110/07/13","統一-台中",10,0,10
"18734","6207雷科","110/07/13","元大-北港",0,13,-13
"18735","6207雷科","110/07/13","群益金鼎-土城",10,0,10
"18736","6207雷科","110/07/13","新加坡商瑞銀",0,12,-12
"18737","6207雷科","110/07/13","群益金鼎-桃園",10,0,10
"18738","6207雷科","110/07/13","凱基-台北",4,16,-12
"18739","6207雷科","110/07/13","永豐金-新莊",10,0,10
"18740","6207雷科","110/07/13","日茂-埔里",0,11,-11
"18741","6207雷科","110/07/13","永豐金-新店",10,0,10
"18742","6207雷科","110/07/13","元大-莒光",0,11,-11
"18743","6207雷科","110/07/13","元大證券",9,0,9
"18744","6207雷科","110/07/13","統一-新竹",0,10,-10
"18745","6207雷科","110/07/13","日盛-木柵",9,1,8
"18746","6207雷科","110/07/13","元大-西螺",0,10,-10
"18747","6207雷科","110/07/13","兆豐-來福",8,0,8
"18748","6207雷科","110/07/13","康和-台中",0,8,-8
"18749","6207雷科","110/07/13","新光",7,0,7
"18750","6207雷科","110/07/13","兆豐-高雄",0,6,-6
"18751","3679新至陞","110/07/13","永豐金證券",50,0,50
"18752","3679新至陞","110/07/13","摩根大通",2,25,-23
"18753","3679新至陞","110/07/13","國泰-桃園",22,0,22
"18754","3679新至陞","110/07/13","元大-成功",0,22,-22
"18755","3679新至陞","110/07/13","台中銀-員林",11,0,11
"18756","3679新至陞","110/07/13","富邦-板橋",1,19,-18
"18757","3679新至陞","110/07/13","元大-文心興安",8,0,8
"18758","3679新至陞","110/07/13","日盛-新莊",0,10,-10
"18759","3679新至陞","110/07/13","美商高盛",6,0,6
"18760","3679新至陞","110/07/13","台新-台中",0,10,-10
"18761","3679新至陞","110/07/13","台新-高雄",6,0,6
"18762","3679新至陞","110/07/13","永豐金-新竹",0,8,-8
"18763","3679新至陞","110/07/13","凱基-台北",18,12,6
"18764","3679新至陞","110/07/13","瑞士信貸",12,19,-7
"18765","3679新至陞","110/07/13","日盛-復興",5,0,5
"18766","3679新至陞","110/07/13","統一-南京",0,7,-7
"18767","3679新至陞","110/07/13","(牛牛牛)亞-鑫豐",4,0,4
"18768","3679新至陞","110/07/13","凱基-新莊",0,7,-7
"18769","3679新至陞","110/07/13","元富-大昌",3,0,3
"18770","3679新至陞","110/07/13","新加坡商瑞銀",0,6,-6
"18771","3679新至陞","110/07/13","富邦-台北",3,0,3
"18772","3679新至陞","110/07/13","合庫-自強",0,5,-5
"18773","3679新至陞","110/07/13","日盛-樹林",2,0,2
"18774","3679新至陞","110/07/13","富邦-桃園",0,5,-5
"18775","3679新至陞","110/07/13","宏遠-光隆",2,0,2
"18776","3679新至陞","110/07/13","永豐金-潮州",0,4,-4
"18777","3679新至陞","110/07/13","美林",3,1,2
"18778","3679新至陞","110/07/13","臺銀-臺南",0,3,-3
"18779","3679新至陞","110/07/13","第一金-中壢",2,0,2
"18780","3679新至陞","110/07/13","元大-六合",0,3,-3
"18781","2727王品","110/07/13","富邦-台北",43,3,40
"18782","2727王品","110/07/13","台灣摩根士丹利",15,97,-82
"18783","2727王品","110/07/13","元大-基隆孝二",40,0,40
"18784","2727王品","110/07/13","玉山-台南",5,57,-52
"18785","2727王品","110/07/13","國票-新莊",40,1,39
"18786","2727王品","110/07/13","新加坡商瑞銀",0,48,-48
"18787","2727王品","110/07/13","第一金-豐原",66,42,24
"18788","2727王品","110/07/13","凱基-台北",41,77,-36
"18789","2727王品","110/07/13","永豐金-大園",34,10,24
"18790","2727王品","110/07/13","永豐金-永康",0,22,-22
"18791","2727王品","110/07/13","元大-北屯",22,0,22
"18792","2727王品","110/07/13","統一-台中",2,22,-20
"18793","2727王品","110/07/13","元大-東蘆",26,7,19
"18794","2727王品","110/07/13","國泰-台中",21,39,-18
"18795","2727王品","110/07/13","永豐金-萬盛",13,1,12
"18796","2727王品","110/07/13","合庫-彰化",3,20,-17
"18797","2727王品","110/07/13","日盛-嘉義",11,0,11
"18798","2727王品","110/07/13","港商野村",13,30,-17
"18799","2727王品","110/07/13","日盛-八德",11,0,11
"18800","2727王品","110/07/13","元大-楊梅",1,16,-15
"18801","2727王品","110/07/13","統一-竹南",11,0,11
"18802","2727王品","110/07/13","凱基-高美館",2,15,-13
"18803","2727王品","110/07/13","日盛-士林",12,2,10
"18804","2727王品","110/07/13","美商高盛",2,14,-12
"18805","2727王品","110/07/13","統一-敦南",10,0,10
"18806","2727王品","110/07/13","統一-平鎮",1,13,-12
"18807","2727王品","110/07/13","中國信託",15,5,10
"18808","2727王品","110/07/13","兆豐-台中港",4,16,-12
"18809","2727王品","110/07/13","兆豐-竹北",13,3,10
"18810","2727王品","110/07/13","凱基-八德",1,13,-12
"18811","1570力肯","110/07/13","新光",115,11,104
"18812","1570力肯","110/07/13","元大-北三重",0,162,-162
"18813","1570力肯","110/07/13","群益金鼎-高雄",54,0,54
"18814","1570力肯","110/07/13","元大-大灣",0,25,-25
"18815","1570力肯","110/07/13","國票-新莊",22,0,22
"18816","1570力肯","110/07/13","永豐金-苓雅",0,22,-22
"18817","1570力肯","110/07/13","日盛-桃園",12,0,12
"18818","1570力肯","110/07/13","永豐金-永康",0,19,-19
"18819","1570力肯","110/07/13","元大-高雄",12,0,12
"18820","1570力肯","110/07/13","富邦-員林",0,15,-15
"18821","1570力肯","110/07/13","合庫-自強",11,0,11
"18822","1570力肯","110/07/13","凱基-台南",0,11,-11
"18823","1570力肯","110/07/13","摩根大通",26,15,11
"18824","1570力肯","110/07/13","日盛-竹北",0,10,-10
"18825","1570力肯","110/07/13","永豐金-中盛",11,0,11
"18826","1570力肯","110/07/13","國票-九鼎",0,10,-10
"18827","1570力肯","110/07/13","兆豐-台中港",10,0,10
"18828","1570力肯","110/07/13","凱基-桃園",0,10,-10
"18829","1570力肯","110/07/13","國泰-松江",9,0,9
"18830","1570力肯","110/07/13","凱基-新豐",0,10,-10
"18831","1570力肯","110/07/13","元大-新盛",9,0,9
"18832","1570力肯","110/07/13","元大-學甲",0,10,-10
"18833","1570力肯","110/07/13","元富-緯城",6,0,6
"18834","1570力肯","110/07/13","群益金鼎-東湖",1,10,-9
"18835","1570力肯","110/07/13","統一-三重",5,0,5
"18836","1570力肯","110/07/13","大昌",0,6,-6
"18837","1570力肯","110/07/13","元大-前金",5,0,5
"18838","1570力肯","110/07/13","元大-土城學府",0,6,-6
"18839","1570力肯","110/07/13","永豐金證券",5,0,5
"18840","1570力肯","110/07/13","統一",0,5,-5
"18841","6180橘子","110/07/13","摩根大通",119,0,119
"18842","6180橘子","110/07/13","元大-崇德",2,61,-59
"18843","6180橘子","110/07/13","美商高盛",96,0,96
"18844","6180橘子","110/07/13","康和-台中",0,51,-51
"18845","6180橘子","110/07/13","新加坡商瑞銀",86,7,79
"18846","6180橘子","110/07/13","康和-台北",0,50,-50
"18847","6180橘子","110/07/13","元大-和平",40,0,40
"18848","6180橘子","110/07/13","元富-潮州",0,40,-40
"18849","6180橘子","110/07/13","凱基-台北",83,47,36
"18850","6180橘子","110/07/13","日盛-永康",0,26,-26
"18851","6180橘子","110/07/13","美林",39,5,34
"18852","6180橘子","110/07/13","永豐金-中正",0,24,-24
"18853","6180橘子","110/07/13","富邦-新竹華信",31,2,29
"18854","6180橘子","110/07/13","國泰-板橋",2,25,-23
"18855","6180橘子","110/07/13","統一-南京",21,0,21
"18856","6180橘子","110/07/13","日盛-大墩",0,20,-20
"18857","6180橘子","110/07/13","富邦-陽明",24,3,21
"18858","6180橘子","110/07/13","元大-草屯",13,32,-19
"18859","6180橘子","110/07/13","大昌-樹林",21,1,20
"18860","6180橘子","110/07/13","元富-林園",1,18,-17
"18861","6180橘子","110/07/13","花旗環球",19,0,19
"18862","6180橘子","110/07/13","新光-新竹",1,18,-17
"18863","6180橘子","110/07/13","華南永昌-台南",19,0,19
"18864","6180橘子","110/07/13","元大-土城永寧",0,17,-17
"18865","6180橘子","110/07/13","福勝",14,0,14
"18866","6180橘子","110/07/13","國泰-新莊",3,19,-16
"18867","6180橘子","110/07/13","富邦-嘉義",12,1,11
"18868","6180橘子","110/07/13","中國信託-永康",6,21,-15
"18869","6180橘子","110/07/13","元大-板橋三民",11,0,11
"18870","6180橘子","110/07/13","凱基-東港",1,15,-14
"18871","2390云辰","110/07/13","新加坡商瑞銀",562,75,487
"18872","2390云辰","110/07/13","大展-台南",0,532,-532
"18873","2390云辰","110/07/13","台灣摩根士丹利",330,155,175
"18874","2390云辰","110/07/13","凱基-台北",668,854,-186
"18875","2390云辰","110/07/13","兆豐-公益",126,25,101
"18876","2390云辰","110/07/13","凱基-三重",12,172,-160
"18877","2390云辰","110/07/13","元富-中港",100,2,98
"18878","2390云辰","110/07/13","兆豐-忠孝",4,161,-157
"18879","2390云辰","110/07/13","統一-新台中",106,9,97
"18880","2390云辰","110/07/13","元大-士林",19,170,-151
"18881","2390云辰","110/07/13","中國信託-松江",81,11,70
"18882","2390云辰","110/07/13","臺銀-新竹",14,117,-103
"18883","2390云辰","110/07/13","日盛-板橋",72,3,69
"18884","2390云辰","110/07/13","國票-台中",4,102,-98
"18885","2390云辰","110/07/13","日盛-和美",57,0,57
"18886","2390云辰","110/07/13","新光",147,232,-85
"18887","2390云辰","110/07/13","永豐金-桃園",88,36,52
"18888","2390云辰","110/07/13","致和-崇德",2,70,-68
"18889","2390云辰","110/07/13","玉山-士林",54,4,50
"18890","2390云辰","110/07/13","群益金鼎-屏東",2,70,-68
"18891","2390云辰","110/07/13","富邦-仁愛",56,6,50
"18892","2390云辰","110/07/13","元大-大里",35,98,-63
"18893","2390云辰","110/07/13","第一金-豐原",50,1,49
"18894","2390云辰","110/07/13","元大-萬華",35,94,-59
"18895","2390云辰","110/07/13","摩根大通",502,453,49
"18896","2390云辰","110/07/13","元富-吉利",2,60,-58
"18897","2390云辰","110/07/13","凱基-松山",61,13,48
"18898","2390云辰","110/07/13","兆豐-新竹",3,53,-50
"18899","2390云辰","110/07/13","大昌",64,22,42
"18900","2390云辰","110/07/13","富邦-嘉義",65,108,-43
"18901","2363矽統","110/07/13","凱基-南崁",2133,63,2070
"18902","2363矽統","110/07/13","凱基-幸福",36,4048,-4012
"18903","2363矽統","110/07/13","國泰-敦南",2195,1617,578
"18904","2363矽統","110/07/13","統一",192,3325,-3133
"18905","2363矽統","110/07/13","中農",670,139,531
"18906","2363矽統","110/07/13","新加坡商瑞銀",1000,2747,-1747
"18907","2363矽統","110/07/13","康和-台中",638,154,484
"18908","2363矽統","110/07/13","凱基-台北",5359,6609,-1250
"18909","2363矽統","110/07/13","群益金鼎-三民",577,137,440
"18910","2363矽統","110/07/13","摩根大通",1930,2858,-928
"18911","2363矽統","110/07/13","台新-屏東",510,88,422
"18912","2363矽統","110/07/13","港商野村",960,1679,-719
"18913","2363矽統","110/07/13","德信-中正",455,67,388
"18914","2363矽統","110/07/13","兆豐-復興",25,705,-680
"18915","2363矽統","110/07/13","日盛-竹北",365,70,295
"18916","2363矽統","110/07/13","統一-仁愛",114,755,-641
"18917","2363矽統","110/07/13","元大-佳里",452,189,263
"18918","2363矽統","110/07/13","統一-敦南",29,638,-609
"18919","2363矽統","110/07/13","國票-博愛",296,38,258
"18920","2363矽統","110/07/13","統一-土城",100,704,-604
"18921","2363矽統","110/07/13","元大-萬華",340,95,245
"18922","2363矽統","110/07/13","統一-城中",116,676,-560
"18923","2363矽統","110/07/13","新光",1259,1031,228
"18924","2363矽統","110/07/13","永豐金證券",306,859,-553
"18925","2363矽統","110/07/13","元富-成功",323,96,227
"18926","2363矽統","110/07/13","元富",54,567,-513
"18927","2363矽統","110/07/13","豐農",228,23,205
"18928","2363矽統","110/07/13","瑞士信貸",202,666,-464
"18929","2363矽統","110/07/13","台灣企銀-岡山",186,4,182
"18930","2363矽統","110/07/13","永豐金-嘉義",67,468,-401
"18931","8112至上","110/07/13","摩根大通",688,296,392
"18932","8112至上","110/07/13","國票-中和",0,401,-401
"18933","8112至上","110/07/13","港商野村",344,145,199
"18934","8112至上","110/07/13","永豐金-板盛",0,205,-205
"18935","8112至上","110/07/13","兆豐-公益",195,5,190
"18936","8112至上","110/07/13","凱基-五股",43,155,-112
"18937","8112至上","110/07/13","台灣摩根士丹利",183,0,183
"18938","8112至上","110/07/13","凱基-市政",0,100,-100
"18939","8112至上","110/07/13","群益金鼎-敦南",153,2,151
"18940","8112至上","110/07/13","元大-大里德芳",1,92,-91
"18941","8112至上","110/07/13","臺銀-金山",146,26,120
"18942","8112至上","110/07/13","玉山-桃園",26,110,-84
"18943","8112至上","110/07/13","臺銀",133,19,114
"18944","8112至上","110/07/13","兆豐-天母",0,81,-81
"18945","8112至上","110/07/13","合庫-台中",115,6,109
"18946","8112至上","110/07/13","凱基-城中",3,84,-81
"18947","8112至上","110/07/13","亞東-板橋",134,26,108
"18948","8112至上","110/07/13","日盛-新莊",9,85,-76
"18949","8112至上","110/07/13","凱基-台北",414,326,88
"18950","8112至上","110/07/13","日盛-台中",2,64,-62
"18951","8112至上","110/07/13","新加坡商瑞銀",181,100,81
"18952","8112至上","110/07/13","日盛-中壢",3,64,-61
"18953","8112至上","110/07/13","國泰-敦南",108,31,77
"18954","8112至上","110/07/13","元大-台中",2,59,-57
"18955","8112至上","110/07/13","第一金-華江",77,4,73
"18956","8112至上","110/07/13","元大-雙和",7,64,-57
"18957","8112至上","110/07/13","永豐金-內湖",73,1,72
"18958","8112至上","110/07/13","元大-高雄",8,62,-54
"18959","8112至上","110/07/13","元大-永和",68,1,67
"18960","8112至上","110/07/13","元大-館前",2,55,-53
"18961","4903聯光通","110/07/13","台灣企銀-太平",56,0,56
"18962","4903聯光通","110/07/13","土銀",0,32,-32
"18963","4903聯光通","110/07/13","元富-新興",23,0,23
"18964","4903聯光通","110/07/13","元大-樹林",0,19,-19
"18965","4903聯光通","110/07/13","日盛-樹林",22,0,22
"18966","4903聯光通","110/07/13","凱基-士林",0,17,-17
"18967","4903聯光通","110/07/13","兆豐-天母",20,0,20
"18968","4903聯光通","110/07/13","國票-博愛",0,14,-14
"18969","4903聯光通","110/07/13","華南永昌-桃園",20,0,20
"18970","4903聯光通","110/07/13","元富",0,10,-10
"18971","4903聯光通","110/07/13","富邦-新店",10,0,10
"18972","4903聯光通","110/07/13","新光",0,10,-10
"18973","4903聯光通","110/07/13","新光-台中",5,0,5
"18974","4903聯光通","110/07/13","玉山-南京東路",0,10,-10
"18975","4903聯光通","110/07/13","華南永昌-台中",5,0,5
"18976","4903聯光通","110/07/13","富邦-陽明",0,10,-10
"18977","4903聯光通","110/07/13","元大-崇德",5,0,5
"18978","4903聯光通","110/07/13","元大-大甲",0,8,-8
"18979","4903聯光通","110/07/13","元大-草屯",5,0,5
"18980","4903聯光通","110/07/13","富邦-台中",0,7,-7
"18981","4903聯光通","110/07/13","元富-草屯",4,0,4
"18982","4903聯光通","110/07/13","凱基-中壢",0,6,-6
"18983","4903聯光通","110/07/13","元大-清水",4,0,4
"18984","4903聯光通","110/07/13","臺銀-民權",0,5,-5
"18985","4903聯光通","110/07/13","元大-東泰",4,0,4
"18986","4903聯光通","110/07/13","日盛-板橋",0,5,-5
"18987","4903聯光通","110/07/13","元大-佳里",2,0,2
"18988","4903聯光通","110/07/13","中國信託-忠孝",0,5,-5
"18989","4903聯光通","110/07/13","永豐金-板橋",2,0,2
"18990","4903聯光通","110/07/13","永豐金-鳳山",0,5,-5
"18991","2929淘帝","110/07/13","玉山-新竹",130,0,130
"18992","2929淘帝","110/07/13","美商高盛",0,177,-177
"18993","2929淘帝","110/07/13","臺銀-民權",60,0,60
"18994","2929淘帝","110/07/13","凱基-台北",6,80,-74
"18995","2929淘帝","110/07/13","新百王",31,0,31
"18996","2929淘帝","110/07/13","元富-大裕",0,49,-49
"18997","2929淘帝","110/07/13","日盛-園區",30,0,30
"18998","2929淘帝","110/07/13","國泰-館前",3,51,-48
"18999","2929淘帝","110/07/13","元大-南投",31,1,30
"19000","2929淘帝","110/07/13","凱基-中壢",0,41,-41
"19001","2929淘帝","110/07/13","兆豐-忠孝",28,0,28
"19002","2929淘帝","110/07/13","港商野村",21,55,-34
"19003","2929淘帝","110/07/13","元大-民生",28,0,28
"19004","2929淘帝","110/07/13","華南永昌-南京",2,34,-32
"19005","2929淘帝","110/07/13","合庫-高雄",27,0,27
"19006","2929淘帝","110/07/13","群益金鼎-土城",0,30,-30
"19007","2929淘帝","110/07/13","凱基-豐中",27,0,27
"19008","2929淘帝","110/07/13","富邦-南屯",0,22,-22
"19009","2929淘帝","110/07/13","新光",21,4,17
"19010","2929淘帝","110/07/13","第一金-豐原",0,20,-20
"19011","2929淘帝","110/07/13","元大-天母",17,0,17
"19012","2929淘帝","110/07/13","元大-屏南",6,26,-20
"19013","2929淘帝","110/07/13","永興",14,0,14
"19014","2929淘帝","110/07/13","永豐金-敦南",1,21,-20
"19015","2929淘帝","110/07/13","富邦-台北",12,0,12
"19016","2929淘帝","110/07/13","凱基-三重",2,21,-19
"19017","2929淘帝","110/07/13","元大-永和",12,0,12
"19018","2929淘帝","110/07/13","富邦-仁愛",7,25,-18
"19019","2929淘帝","110/07/13","國票-天祥",11,0,11
"19020","2929淘帝","110/07/13","元大-北投",0,16,-16
"19021","5410國眾","110/07/13","兆豐-城中",274,0,274
"19022","5410國眾","110/07/13","元富-嘉義",0,103,-103
"19023","5410國眾","110/07/13","新光",50,4,46
"19024","5410國眾","110/07/13","凱基-台北",0,50,-50
"19025","5410國眾","110/07/13","國泰-台中",26,0,26
"19026","5410國眾","110/07/13","瑞士信貸",0,31,-31
"19027","5410國眾","110/07/13","新加坡商瑞銀",22,0,22
"19028","5410國眾","110/07/13","台新-新莊",0,27,-27
"19029","5410國眾","110/07/13","光和-嘉義",20,0,20
"19030","5410國眾","110/07/13","元大-汐止",0,20,-20
"19031","5410國眾","110/07/13","凱基-竹北",17,0,17
"19032","5410國眾","110/07/13","亞東-新竹",0,17,-17
"19033","5410國眾","110/07/13","新光-桃園",15,0,15
"19034","5410國眾","110/07/13","元大-南勢角",0,13,-13
"19035","5410國眾","110/07/13","凱基-台東",14,0,14
"19036","5410國眾","110/07/13","台新-台南",0,12,-12
"19037","5410國眾","110/07/13","富邦-竹北",11,0,11
"19038","5410國眾","110/07/13","中國信託",0,11,-11
"19039","5410國眾","110/07/13","元富-同大",10,0,10
"19040","5410國眾","110/07/13","華南永昌",0,11,-11
"19041","5410國眾","110/07/13","國泰-敦南",24,15,9
"19042","5410國眾","110/07/13","臺銀-臺南",0,10,-10
"19043","5410國眾","110/07/13","日盛-內湖",7,0,7
"19044","5410國眾","110/07/13","台灣企銀-民雄",0,10,-10
"19045","5410國眾","110/07/13","台新-左楠",7,0,7
"19046","5410國眾","110/07/13","高橋",0,10,-10
"19047","5410國眾","110/07/13","元大-新盛",18,12,6
"19048","5410國眾","110/07/13","康和-嘉義",0,10,-10
"19049","5410國眾","110/07/13","統一",5,0,5
"19050","5410國眾","110/07/13","凱基-基隆",0,10,-10
"19051","2841台開","110/07/13","中國信託-高雄",251,50,201
"19052","2841台開","110/07/13","兆豐-公益",0,177,-177
"19053","2841台開","110/07/13","日盛證券",210,13,197
"19054","2841台開","110/07/13","日進",0,152,-152
"19055","2841台開","110/07/13","第一金-台中",55,0,55
"19056","2841台開","110/07/13","港商野村",0,109,-109
"19057","2841台開","110/07/13","國泰-板橋",46,0,46
"19058","2841台開","110/07/13","日盛-信義",0,103,-103
"19059","2841台開","110/07/13","國泰-館前",48,3,45
"19060","2841台開","110/07/13","國泰-敦南",11,75,-64
"19061","2841台開","110/07/13","華南永昌-新莊",45,0,45
"19062","2841台開","110/07/13","永興",0,50,-50
"19063","2841台開","110/07/13","日盛-園區",42,0,42
"19064","2841台開","110/07/13","永豐金-敦南",61,104,-43
"19065","2841台開","110/07/13","台新證券",32,0,32
"19066","2841台開","110/07/13","富邦-台南",0,42,-42
"19067","2841台開","110/07/13","台新-高雄",32,2,30
"19068","2841台開","110/07/13","國票-安和",0,30,-30
"19069","2841台開","110/07/13","豐農",23,0,23
"19070","2841台開","110/07/13","元大-桃園",0,25,-25
"19071","2841台開","110/07/13","合庫-嘉義",20,0,20
"19072","2841台開","110/07/13","新光",8,32,-24
"19073","2841台開","110/07/13","華南永昌-高雄",20,0,20
"19074","2841台開","110/07/13","元大-仁愛",0,24,-24
"19075","2841台開","110/07/13","元大-樹林",16,0,16
"19076","2841台開","110/07/13","日盛-中和",0,20,-20
"19077","2841台開","110/07/13","第一金-華江",15,2,13
"19078","2841台開","110/07/13","元富",0,20,-20
"19079","2841台開","110/07/13","美商高盛",12,0,12
"19080","2841台開","110/07/13","富邦-宜蘭",0,20,-20
"19081","6207雷科","110/07/13","元大-高雄",121,0,121
"19082","6207雷科","110/07/13","華南永昌-朴子",1,60,-59
"19083","6207雷科","110/07/13","第一金-新興",20,0,20
"19084","6207雷科","110/07/13","元大-南海",0,36,-36
"19085","6207雷科","110/07/13","元富-三重",20,0,20
"19086","6207雷科","110/07/13","凱基-土城",0,35,-35
"19087","6207雷科","110/07/13","元大-林園",15,0,15
"19088","6207雷科","110/07/13","台灣企銀",0,20,-20
"19089","6207雷科","110/07/13","元大-金華",16,1,15
"19090","6207雷科","110/07/13","群益金鼎-丹鳳",0,20,-20
"19091","6207雷科","110/07/13","日盛證券",10,0,10
"19092","6207雷科","110/07/13","元大-博愛",0,17,-17
"19093","6207雷科","110/07/13","統一-台中",10,0,10
"19094","6207雷科","110/07/13","元大-北港",0,13,-13
"19095","6207雷科","110/07/13","群益金鼎-土城",10,0,10
"19096","6207雷科","110/07/13","新加坡商瑞銀",0,12,-12
"19097","6207雷科","110/07/13","群益金鼎-桃園",10,0,10
"19098","6207雷科","110/07/13","凱基-台北",4,16,-12
"19099","6207雷科","110/07/13","永豐金-新莊",10,0,10
"19100","6207雷科","110/07/13","日茂-埔里",0,11,-11
"19101","6207雷科","110/07/13","永豐金-新店",10,0,10
"19102","6207雷科","110/07/13","元大-莒光",0,11,-11
"19103","6207雷科","110/07/13","元大證券",9,0,9
"19104","6207雷科","110/07/13","統一-新竹",0,10,-10
"19105","6207雷科","110/07/13","日盛-木柵",9,1,8
"19106","6207雷科","110/07/13","元大-西螺",0,10,-10
"19107","6207雷科","110/07/13","兆豐-來福",8,0,8
"19108","6207雷科","110/07/13","康和-台中",0,8,-8
"19109","6207雷科","110/07/13","新光",7,0,7
"19110","6207雷科","110/07/13","兆豐-高雄",0,6,-6
"19111","3679新至陞","110/07/13","永豐金證券",50,0,50
"19112","3679新至陞","110/07/13","摩根大通",2,25,-23
"19113","3679新至陞","110/07/13","國泰-桃園",22,0,22
"19114","3679新至陞","110/07/13","元大-成功",0,22,-22
"19115","3679新至陞","110/07/13","台中銀-員林",11,0,11
"19116","3679新至陞","110/07/13","富邦-板橋",1,19,-18
"19117","3679新至陞","110/07/13","元大-文心興安",8,0,8
"19118","3679新至陞","110/07/13","日盛-新莊",0,10,-10
"19119","3679新至陞","110/07/13","美商高盛",6,0,6
"19120","3679新至陞","110/07/13","台新-台中",0,10,-10
"19121","3679新至陞","110/07/13","台新-高雄",6,0,6
"19122","3679新至陞","110/07/13","永豐金-新竹",0,8,-8
"19123","3679新至陞","110/07/13","凱基-台北",18,12,6
"19124","3679新至陞","110/07/13","瑞士信貸",12,19,-7
"19125","3679新至陞","110/07/13","日盛-復興",5,0,5
"19126","3679新至陞","110/07/13","統一-南京",0,7,-7
"19127","3679新至陞","110/07/13","(牛牛牛)亞-鑫豐",4,0,4
"19128","3679新至陞","110/07/13","凱基-新莊",0,7,-7
"19129","3679新至陞","110/07/13","元富-大昌",3,0,3
"19130","3679新至陞","110/07/13","新加坡商瑞銀",0,6,-6
"19131","3679新至陞","110/07/13","富邦-台北",3,0,3
"19132","3679新至陞","110/07/13","合庫-自強",0,5,-5
"19133","3679新至陞","110/07/13","日盛-樹林",2,0,2
"19134","3679新至陞","110/07/13","富邦-桃園",0,5,-5
"19135","3679新至陞","110/07/13","宏遠-光隆",2,0,2
"19136","3679新至陞","110/07/13","永豐金-潮州",0,4,-4
"19137","3679新至陞","110/07/13","美林",3,1,2
"19138","3679新至陞","110/07/13","臺銀-臺南",0,3,-3
"19139","3679新至陞","110/07/13","第一金-中壢",2,0,2
"19140","3679新至陞","110/07/13","元大-六合",0,3,-3
"19141","2727王品","110/07/13","富邦-台北",43,3,40
"19142","2727王品","110/07/13","台灣摩根士丹利",15,97,-82
"19143","2727王品","110/07/13","元大-基隆孝二",40,0,40
"19144","2727王品","110/07/13","玉山-台南",5,57,-52
"19145","2727王品","110/07/13","國票-新莊",40,1,39
"19146","2727王品","110/07/13","新加坡商瑞銀",0,48,-48
"19147","2727王品","110/07/13","第一金-豐原",66,42,24
"19148","2727王品","110/07/13","凱基-台北",41,77,-36
"19149","2727王品","110/07/13","永豐金-大園",34,10,24
"19150","2727王品","110/07/13","永豐金-永康",0,22,-22
"19151","2727王品","110/07/13","元大-北屯",22,0,22
"19152","2727王品","110/07/13","統一-台中",2,22,-20
"19153","2727王品","110/07/13","元大-東蘆",26,7,19
"19154","2727王品","110/07/13","國泰-台中",21,39,-18
"19155","2727王品","110/07/13","永豐金-萬盛",13,1,12
"19156","2727王品","110/07/13","合庫-彰化",3,20,-17
"19157","2727王品","110/07/13","日盛-嘉義",11,0,11
"19158","2727王品","110/07/13","港商野村",13,30,-17
"19159","2727王品","110/07/13","日盛-八德",11,0,11
"19160","2727王品","110/07/13","元大-楊梅",1,16,-15
"19161","2727王品","110/07/13","統一-竹南",11,0,11
"19162","2727王品","110/07/13","凱基-高美館",2,15,-13
"19163","2727王品","110/07/13","日盛-士林",12,2,10
"19164","2727王品","110/07/13","美商高盛",2,14,-12
"19165","2727王品","110/07/13","統一-敦南",10,0,10
"19166","2727王品","110/07/13","統一-平鎮",1,13,-12
"19167","2727王品","110/07/13","中國信託",15,5,10
"19168","2727王品","110/07/13","兆豐-台中港",4,16,-12
"19169","2727王品","110/07/13","兆豐-竹北",13,3,10
"19170","2727王品","110/07/13","凱基-八德",1,13,-12
"19171","1570力肯","110/07/13","新光",115,11,104
"19172","1570力肯","110/07/13","元大-北三重",0,162,-162
"19173","1570力肯","110/07/13","群益金鼎-高雄",54,0,54
"19174","1570力肯","110/07/13","元大-大灣",0,25,-25
"19175","1570力肯","110/07/13","國票-新莊",22,0,22
"19176","1570力肯","110/07/13","永豐金-苓雅",0,22,-22
"19177","1570力肯","110/07/13","日盛-桃園",12,0,12
"19178","1570力肯","110/07/13","永豐金-永康",0,19,-19
"19179","1570力肯","110/07/13","元大-高雄",12,0,12
"19180","1570力肯","110/07/13","富邦-員林",0,15,-15
"19181","1570力肯","110/07/13","合庫-自強",11,0,11
"19182","1570力肯","110/07/13","凱基-台南",0,11,-11
"19183","1570力肯","110/07/13","摩根大通",26,15,11
"19184","1570力肯","110/07/13","日盛-竹北",0,10,-10
"19185","1570力肯","110/07/13","永豐金-中盛",11,0,11
"19186","1570力肯","110/07/13","國票-九鼎",0,10,-10
"19187","1570力肯","110/07/13","兆豐-台中港",10,0,10
"19188","1570力肯","110/07/13","凱基-桃園",0,10,-10
"19189","1570力肯","110/07/13","國泰-松江",9,0,9
"19190","1570力肯","110/07/13","凱基-新豐",0,10,-10
"19191","1570力肯","110/07/13","元大-新盛",9,0,9
"19192","1570力肯","110/07/13","元大-學甲",0,10,-10
"19193","1570力肯","110/07/13","元富-緯城",6,0,6
"19194","1570力肯","110/07/13","群益金鼎-東湖",1,10,-9
"19195","1570力肯","110/07/13","統一-三重",5,0,5
"19196","1570力肯","110/07/13","大昌",0,6,-6
"19197","1570力肯","110/07/13","元大-前金",5,0,5
"19198","1570力肯","110/07/13","元大-土城學府",0,6,-6
"19199","1570力肯","110/07/13","永豐金證券",5,0,5
"19200","1570力肯","110/07/13","統一",0,5,-5
"19201","6180橘子","110/07/13","摩根大通",119,0,119
"19202","6180橘子","110/07/13","元大-崇德",2,61,-59
"19203","6180橘子","110/07/13","美商高盛",96,0,96
"19204","6180橘子","110/07/13","康和-台中",0,51,-51
"19205","6180橘子","110/07/13","新加坡商瑞銀",86,7,79
"19206","6180橘子","110/07/13","康和-台北",0,50,-50
"19207","6180橘子","110/07/13","元大-和平",40,0,40
"19208","6180橘子","110/07/13","元富-潮州",0,40,-40
"19209","6180橘子","110/07/13","凱基-台北",83,47,36
"19210","6180橘子","110/07/13","日盛-永康",0,26,-26
"19211","6180橘子","110/07/13","美林",39,5,34
"19212","6180橘子","110/07/13","永豐金-中正",0,24,-24
"19213","6180橘子","110/07/13","富邦-新竹華信",31,2,29
"19214","6180橘子","110/07/13","國泰-板橋",2,25,-23
"19215","6180橘子","110/07/13","統一-南京",21,0,21
"19216","6180橘子","110/07/13","日盛-大墩",0,20,-20
"19217","6180橘子","110/07/13","富邦-陽明",24,3,21
"19218","6180橘子","110/07/13","元大-草屯",13,32,-19
"19219","6180橘子","110/07/13","大昌-樹林",21,1,20
"19220","6180橘子","110/07/13","元富-林園",1,18,-17
"19221","6180橘子","110/07/13","花旗環球",19,0,19
"19222","6180橘子","110/07/13","新光-新竹",1,18,-17
"19223","6180橘子","110/07/13","華南永昌-台南",19,0,19
"19224","6180橘子","110/07/13","元大-土城永寧",0,17,-17
"19225","6180橘子","110/07/13","福勝",14,0,14
"19226","6180橘子","110/07/13","國泰-新莊",3,19,-16
"19227","6180橘子","110/07/13","富邦-嘉義",12,1,11
"19228","6180橘子","110/07/13","中國信託-永康",6,21,-15
"19229","6180橘子","110/07/13","元大-板橋三民",11,0,11
"19230","6180橘子","110/07/13","凱基-東港",1,15,-14
"19231","2390云辰","110/07/13","新加坡商瑞銀",562,75,487
"19232","2390云辰","110/07/13","大展-台南",0,532,-532
"19233","2390云辰","110/07/13","台灣摩根士丹利",330,155,175
"19234","2390云辰","110/07/13","凱基-台北",668,854,-186
"19235","2390云辰","110/07/13","兆豐-公益",126,25,101
"19236","2390云辰","110/07/13","凱基-三重",12,172,-160
"19237","2390云辰","110/07/13","元富-中港",100,2,98
"19238","2390云辰","110/07/13","兆豐-忠孝",4,161,-157
"19239","2390云辰","110/07/13","統一-新台中",106,9,97
"19240","2390云辰","110/07/13","元大-士林",19,170,-151
"19241","2390云辰","110/07/13","中國信託-松江",81,11,70
"19242","2390云辰","110/07/13","臺銀-新竹",14,117,-103
"19243","2390云辰","110/07/13","日盛-板橋",72,3,69
"19244","2390云辰","110/07/13","國票-台中",4,102,-98
"19245","2390云辰","110/07/13","日盛-和美",57,0,57
"19246","2390云辰","110/07/13","新光",147,232,-85
"19247","2390云辰","110/07/13","永豐金-桃園",88,36,52
"19248","2390云辰","110/07/13","致和-崇德",2,70,-68
"19249","2390云辰","110/07/13","玉山-士林",54,4,50
"19250","2390云辰","110/07/13","群益金鼎-屏東",2,70,-68
"19251","2390云辰","110/07/13","富邦-仁愛",56,6,50
"19252","2390云辰","110/07/13","元大-大里",35,98,-63
"19253","2390云辰","110/07/13","第一金-豐原",50,1,49
"19254","2390云辰","110/07/13","元大-萬華",35,94,-59
"19255","2390云辰","110/07/13","摩根大通",502,453,49
"19256","2390云辰","110/07/13","元富-吉利",2,60,-58
"19257","2390云辰","110/07/13","凱基-松山",61,13,48
"19258","2390云辰","110/07/13","兆豐-新竹",3,53,-50
"19259","2390云辰","110/07/13","大昌",64,22,42
"19260","2390云辰","110/07/13","富邦-嘉義",65,108,-43
"19261","2363矽統","110/07/13","凱基-南崁",2133,63,2070
"19262","2363矽統","110/07/13","凱基-幸福",36,4048,-4012
"19263","2363矽統","110/07/13","國泰-敦南",2195,1617,578
"19264","2363矽統","110/07/13","統一",192,3325,-3133
"19265","2363矽統","110/07/13","中農",670,139,531
"19266","2363矽統","110/07/13","新加坡商瑞銀",1000,2747,-1747
"19267","2363矽統","110/07/13","康和-台中",638,154,484
"19268","2363矽統","110/07/13","凱基-台北",5359,6609,-1250
"19269","2363矽統","110/07/13","群益金鼎-三民",577,137,440
"19270","2363矽統","110/07/13","摩根大通",1930,2858,-928
"19271","2363矽統","110/07/13","台新-屏東",510,88,422
"19272","2363矽統","110/07/13","港商野村",960,1679,-719
"19273","2363矽統","110/07/13","德信-中正",455,67,388
"19274","2363矽統","110/07/13","兆豐-復興",25,705,-680
"19275","2363矽統","110/07/13","日盛-竹北",365,70,295
"19276","2363矽統","110/07/13","統一-仁愛",114,755,-641
"19277","2363矽統","110/07/13","元大-佳里",452,189,263
"19278","2363矽統","110/07/13","統一-敦南",29,638,-609
"19279","2363矽統","110/07/13","國票-博愛",296,38,258
"19280","2363矽統","110/07/13","統一-土城",100,704,-604
"19281","2363矽統","110/07/13","元大-萬華",340,95,245
"19282","2363矽統","110/07/13","統一-城中",116,676,-560
"19283","2363矽統","110/07/13","新光",1259,1031,228
"19284","2363矽統","110/07/13","永豐金證券",306,859,-553
"19285","2363矽統","110/07/13","元富-成功",323,96,227
"19286","2363矽統","110/07/13","元富",54,567,-513
"19287","2363矽統","110/07/13","豐農",228,23,205
"19288","2363矽統","110/07/13","瑞士信貸",202,666,-464
"19289","2363矽統","110/07/13","台灣企銀-岡山",186,4,182
"19290","2363矽統","110/07/13","永豐金-嘉義",67,468,-401
"19291","8112至上","110/07/13","摩根大通",688,296,392
"19292","8112至上","110/07/13","國票-中和",0,401,-401
"19293","8112至上","110/07/13","港商野村",344,145,199
"19294","8112至上","110/07/13","永豐金-板盛",0,205,-205
"19295","8112至上","110/07/13","兆豐-公益",195,5,190
"19296","8112至上","110/07/13","凱基-五股",43,155,-112
"19297","8112至上","110/07/13","台灣摩根士丹利",183,0,183
"19298","8112至上","110/07/13","凱基-市政",0,100,-100
"19299","8112至上","110/07/13","群益金鼎-敦南",153,2,151
"19300","8112至上","110/07/13","元大-大里德芳",1,92,-91
"19301","8112至上","110/07/13","臺銀-金山",146,26,120
"19302","8112至上","110/07/13","玉山-桃園",26,110,-84
"19303","8112至上","110/07/13","臺銀",133,19,114
"19304","8112至上","110/07/13","兆豐-天母",0,81,-81
"19305","8112至上","110/07/13","合庫-台中",115,6,109
"19306","8112至上","110/07/13","凱基-城中",3,84,-81
"19307","8112至上","110/07/13","亞東-板橋",134,26,108
"19308","8112至上","110/07/13","日盛-新莊",9,85,-76
"19309","8112至上","110/07/13","凱基-台北",414,326,88
"19310","8112至上","110/07/13","日盛-台中",2,64,-62
"19311","8112至上","110/07/13","新加坡商瑞銀",181,100,81
"19312","8112至上","110/07/13","日盛-中壢",3,64,-61
"19313","8112至上","110/07/13","國泰-敦南",108,31,77
"19314","8112至上","110/07/13","元大-台中",2,59,-57
"19315","8112至上","110/07/13","第一金-華江",77,4,73
"19316","8112至上","110/07/13","元大-雙和",7,64,-57
"19317","8112至上","110/07/13","永豐金-內湖",73,1,72
"19318","8112至上","110/07/13","元大-高雄",8,62,-54
"19319","8112至上","110/07/13","元大-永和",68,1,67
"19320","8112至上","110/07/13","元大-館前",2,55,-53
"19321","4903聯光通","110/07/13","台灣企銀-太平",56,0,56
"19322","4903聯光通","110/07/13","土銀",0,32,-32
"19323","4903聯光通","110/07/13","元富-新興",23,0,23
"19324","4903聯光通","110/07/13","元大-樹林",0,19,-19
"19325","4903聯光通","110/07/13","日盛-樹林",22,0,22
"19326","4903聯光通","110/07/13","凱基-士林",0,17,-17
"19327","4903聯光通","110/07/13","兆豐-天母",20,0,20
"19328","4903聯光通","110/07/13","國票-博愛",0,14,-14
"19329","4903聯光通","110/07/13","華南永昌-桃園",20,0,20
"19330","4903聯光通","110/07/13","元富",0,10,-10
"19331","4903聯光通","110/07/13","富邦-新店",10,0,10
"19332","4903聯光通","110/07/13","新光",0,10,-10
"19333","4903聯光通","110/07/13","新光-台中",5,0,5
"19334","4903聯光通","110/07/13","玉山-南京東路",0,10,-10
"19335","4903聯光通","110/07/13","華南永昌-台中",5,0,5
"19336","4903聯光通","110/07/13","富邦-陽明",0,10,-10
"19337","4903聯光通","110/07/13","元大-崇德",5,0,5
"19338","4903聯光通","110/07/13","元大-大甲",0,8,-8
"19339","4903聯光通","110/07/13","元大-草屯",5,0,5
"19340","4903聯光通","110/07/13","富邦-台中",0,7,-7
"19341","4903聯光通","110/07/13","元富-草屯",4,0,4
"19342","4903聯光通","110/07/13","凱基-中壢",0,6,-6
"19343","4903聯光通","110/07/13","元大-清水",4,0,4
"19344","4903聯光通","110/07/13","臺銀-民權",0,5,-5
"19345","4903聯光通","110/07/13","元大-東泰",4,0,4
"19346","4903聯光通","110/07/13","日盛-板橋",0,5,-5
"19347","4903聯光通","110/07/13","元大-佳里",2,0,2
"19348","4903聯光通","110/07/13","中國信託-忠孝",0,5,-5
"19349","4903聯光通","110/07/13","永豐金-板橋",2,0,2
"19350","4903聯光通","110/07/13","永豐金-鳳山",0,5,-5
"19351","2929淘帝","110/07/13","玉山-新竹",130,0,130
"19352","2929淘帝","110/07/13","美商高盛",0,177,-177
"19353","2929淘帝","110/07/13","臺銀-民權",60,0,60
"19354","2929淘帝","110/07/13","凱基-台北",6,80,-74
"19355","2929淘帝","110/07/13","新百王",31,0,31
"19356","2929淘帝","110/07/13","元富-大裕",0,49,-49
"19357","2929淘帝","110/07/13","日盛-園區",30,0,30
"19358","2929淘帝","110/07/13","國泰-館前",3,51,-48
"19359","2929淘帝","110/07/13","元大-南投",31,1,30
"19360","2929淘帝","110/07/13","凱基-中壢",0,41,-41
"19361","2929淘帝","110/07/13","兆豐-忠孝",28,0,28
"19362","2929淘帝","110/07/13","港商野村",21,55,-34
"19363","2929淘帝","110/07/13","元大-民生",28,0,28
"19364","2929淘帝","110/07/13","華南永昌-南京",2,34,-32
"19365","2929淘帝","110/07/13","合庫-高雄",27,0,27
"19366","2929淘帝","110/07/13","群益金鼎-土城",0,30,-30
"19367","2929淘帝","110/07/13","凱基-豐中",27,0,27
"19368","2929淘帝","110/07/13","富邦-南屯",0,22,-22
"19369","2929淘帝","110/07/13","新光",21,4,17
"19370","2929淘帝","110/07/13","第一金-豐原",0,20,-20
"19371","2929淘帝","110/07/13","元大-天母",17,0,17
"19372","2929淘帝","110/07/13","元大-屏南",6,26,-20
"19373","2929淘帝","110/07/13","永興",14,0,14
"19374","2929淘帝","110/07/13","永豐金-敦南",1,21,-20
"19375","2929淘帝","110/07/13","富邦-台北",12,0,12
"19376","2929淘帝","110/07/13","凱基-三重",2,21,-19
"19377","2929淘帝","110/07/13","元大-永和",12,0,12
"19378","2929淘帝","110/07/13","富邦-仁愛",7,25,-18
"19379","2929淘帝","110/07/13","國票-天祥",11,0,11
"19380","2929淘帝","110/07/13","元大-北投",0,16,-16
"19381","5410國眾","110/07/13","兆豐-城中",274,0,274
"19382","5410國眾","110/07/13","元富-嘉義",0,103,-103
"19383","5410國眾","110/07/13","新光",50,4,46
"19384","5410國眾","110/07/13","凱基-台北",0,50,-50
"19385","5410國眾","110/07/13","國泰-台中",26,0,26
"19386","5410國眾","110/07/13","瑞士信貸",0,31,-31
"19387","5410國眾","110/07/13","新加坡商瑞銀",22,0,22
"19388","5410國眾","110/07/13","台新-新莊",0,27,-27
"19389","5410國眾","110/07/13","光和-嘉義",20,0,20
"19390","5410國眾","110/07/13","元大-汐止",0,20,-20
"19391","5410國眾","110/07/13","凱基-竹北",17,0,17
"19392","5410國眾","110/07/13","亞東-新竹",0,17,-17
"19393","5410國眾","110/07/13","新光-桃園",15,0,15
"19394","5410國眾","110/07/13","元大-南勢角",0,13,-13
"19395","5410國眾","110/07/13","凱基-台東",14,0,14
"19396","5410國眾","110/07/13","台新-台南",0,12,-12
"19397","5410國眾","110/07/13","富邦-竹北",11,0,11
"19398","5410國眾","110/07/13","中國信託",0,11,-11
"19399","5410國眾","110/07/13","元富-同大",10,0,10
"19400","5410國眾","110/07/13","華南永昌",0,11,-11
"19401","5410國眾","110/07/13","國泰-敦南",24,15,9
"19402","5410國眾","110/07/13","臺銀-臺南",0,10,-10
"19403","5410國眾","110/07/13","日盛-內湖",7,0,7
"19404","5410國眾","110/07/13","台灣企銀-民雄",0,10,-10
"19405","5410國眾","110/07/13","台新-左楠",7,0,7
"19406","5410國眾","110/07/13","高橋",0,10,-10
"19407","5410國眾","110/07/13","元大-新盛",18,12,6
"19408","5410國眾","110/07/13","康和-嘉義",0,10,-10
"19409","5410國眾","110/07/13","統一",5,0,5
"19410","5410國眾","110/07/13","凱基-基隆",0,10,-10
"19411","2841台開","110/07/13","中國信託-高雄",251,50,201
"19412","2841台開","110/07/13","兆豐-公益",0,177,-177
"19413","2841台開","110/07/13","日盛證券",210,13,197
"19414","2841台開","110/07/13","日進",0,152,-152
"19415","2841台開","110/07/13","第一金-台中",55,0,55
"19416","2841台開","110/07/13","港商野村",0,109,-109
"19417","2841台開","110/07/13","國泰-板橋",46,0,46
"19418","2841台開","110/07/13","日盛-信義",0,103,-103
"19419","2841台開","110/07/13","國泰-館前",48,3,45
"19420","2841台開","110/07/13","國泰-敦南",11,75,-64
"19421","2841台開","110/07/13","華南永昌-新莊",45,0,45
"19422","2841台開","110/07/13","永興",0,50,-50
"19423","2841台開","110/07/13","日盛-園區",42,0,42
"19424","2841台開","110/07/13","永豐金-敦南",61,104,-43
"19425","2841台開","110/07/13","台新證券",32,0,32
"19426","2841台開","110/07/13","富邦-台南",0,42,-42
"19427","2841台開","110/07/13","台新-高雄",32,2,30
"19428","2841台開","110/07/13","國票-安和",0,30,-30
"19429","2841台開","110/07/13","豐農",23,0,23
"19430","2841台開","110/07/13","元大-桃園",0,25,-25
"19431","2841台開","110/07/13","合庫-嘉義",20,0,20
"19432","2841台開","110/07/13","新光",8,32,-24
"19433","2841台開","110/07/13","華南永昌-高雄",20,0,20
"19434","2841台開","110/07/13","元大-仁愛",0,24,-24
"19435","2841台開","110/07/13","元大-樹林",16,0,16
"19436","2841台開","110/07/13","日盛-中和",0,20,-20
"19437","2841台開","110/07/13","第一金-華江",15,2,13
"19438","2841台開","110/07/13","元富",0,20,-20
"19439","2841台開","110/07/13","美商高盛",12,0,12
"19440","2841台開","110/07/13","富邦-宜蘭",0,20,-20
"19441","6207雷科","110/07/13","元大-高雄",121,0,121
"19442","6207雷科","110/07/13","華南永昌-朴子",1,60,-59
"19443","6207雷科","110/07/13","第一金-新興",20,0,20
"19444","6207雷科","110/07/13","元大-南海",0,36,-36
"19445","6207雷科","110/07/13","元富-三重",20,0,20
"19446","6207雷科","110/07/13","凱基-土城",0,35,-35
"19447","6207雷科","110/07/13","元大-林園",15,0,15
"19448","6207雷科","110/07/13","台灣企銀",0,20,-20
"19449","6207雷科","110/07/13","元大-金華",16,1,15
"19450","6207雷科","110/07/13","群益金鼎-丹鳳",0,20,-20
"19451","6207雷科","110/07/13","日盛證券",10,0,10
"19452","6207雷科","110/07/13","元大-博愛",0,17,-17
"19453","6207雷科","110/07/13","統一-台中",10,0,10
"19454","6207雷科","110/07/13","元大-北港",0,13,-13
"19455","6207雷科","110/07/13","群益金鼎-土城",10,0,10
"19456","6207雷科","110/07/13","新加坡商瑞銀",0,12,-12
"19457","6207雷科","110/07/13","群益金鼎-桃園",10,0,10
"19458","6207雷科","110/07/13","凱基-台北",4,16,-12
"19459","6207雷科","110/07/13","永豐金-新莊",10,0,10
"19460","6207雷科","110/07/13","日茂-埔里",0,11,-11
"19461","6207雷科","110/07/13","永豐金-新店",10,0,10
"19462","6207雷科","110/07/13","元大-莒光",0,11,-11
"19463","6207雷科","110/07/13","元大證券",9,0,9
"19464","6207雷科","110/07/13","統一-新竹",0,10,-10
"19465","6207雷科","110/07/13","日盛-木柵",9,1,8
"19466","6207雷科","110/07/13","元大-西螺",0,10,-10
"19467","6207雷科","110/07/13","兆豐-來福",8,0,8
"19468","6207雷科","110/07/13","康和-台中",0,8,-8
"19469","6207雷科","110/07/13","新光",7,0,7
"19470","6207雷科","110/07/13","兆豐-高雄",0,6,-6
"19471","3679新至陞","110/07/13","永豐金證券",50,0,50
"19472","3679新至陞","110/07/13","摩根大通",2,25,-23
"19473","3679新至陞","110/07/13","國泰-桃園",22,0,22
"19474","3679新至陞","110/07/13","元大-成功",0,22,-22
"19475","3679新至陞","110/07/13","台中銀-員林",11,0,11
"19476","3679新至陞","110/07/13","富邦-板橋",1,19,-18
"19477","3679新至陞","110/07/13","元大-文心興安",8,0,8
"19478","3679新至陞","110/07/13","日盛-新莊",0,10,-10
"19479","3679新至陞","110/07/13","美商高盛",6,0,6
"19480","3679新至陞","110/07/13","台新-台中",0,10,-10
"19481","3679新至陞","110/07/13","台新-高雄",6,0,6
"19482","3679新至陞","110/07/13","永豐金-新竹",0,8,-8
"19483","3679新至陞","110/07/13","凱基-台北",18,12,6
"19484","3679新至陞","110/07/13","瑞士信貸",12,19,-7
"19485","3679新至陞","110/07/13","日盛-復興",5,0,5
"19486","3679新至陞","110/07/13","統一-南京",0,7,-7
"19487","3679新至陞","110/07/13","(牛牛牛)亞-鑫豐",4,0,4
"19488","3679新至陞","110/07/13","凱基-新莊",0,7,-7
"19489","3679新至陞","110/07/13","元富-大昌",3,0,3
"19490","3679新至陞","110/07/13","新加坡商瑞銀",0,6,-6
"19491","3679新至陞","110/07/13","富邦-台北",3,0,3
"19492","3679新至陞","110/07/13","合庫-自強",0,5,-5
"19493","3679新至陞","110/07/13","日盛-樹林",2,0,2
"19494","3679新至陞","110/07/13","富邦-桃園",0,5,-5
"19495","3679新至陞","110/07/13","宏遠-光隆",2,0,2
"19496","3679新至陞","110/07/13","永豐金-潮州",0,4,-4
"19497","3679新至陞","110/07/13","美林",3,1,2
"19498","3679新至陞","110/07/13","臺銀-臺南",0,3,-3
"19499","3679新至陞","110/07/13","第一金-中壢",2,0,2
"19500","3679新至陞","110/07/13","元大-六合",0,3,-3
"19501","2727王品","110/07/13","富邦-台北",43,3,40
"19502","2727王品","110/07/13","台灣摩根士丹利",15,97,-82
"19503","2727王品","110/07/13","元大-基隆孝二",40,0,40
"19504","2727王品","110/07/13","玉山-台南",5,57,-52
"19505","2727王品","110/07/13","國票-新莊",40,1,39
"19506","2727王品","110/07/13","新加坡商瑞銀",0,48,-48
"19507","2727王品","110/07/13","第一金-豐原",66,42,24
"19508","2727王品","110/07/13","凱基-台北",41,77,-36
"19509","2727王品","110/07/13","永豐金-大園",34,10,24
"19510","2727王品","110/07/13","永豐金-永康",0,22,-22
"19511","2727王品","110/07/13","元大-北屯",22,0,22
"19512","2727王品","110/07/13","統一-台中",2,22,-20
"19513","2727王品","110/07/13","元大-東蘆",26,7,19
"19514","2727王品","110/07/13","國泰-台中",21,39,-18
"19515","2727王品","110/07/13","永豐金-萬盛",13,1,12
"19516","2727王品","110/07/13","合庫-彰化",3,20,-17
"19517","2727王品","110/07/13","日盛-嘉義",11,0,11
"19518","2727王品","110/07/13","港商野村",13,30,-17
"19519","2727王品","110/07/13","日盛-八德",11,0,11
"19520","2727王品","110/07/13","元大-楊梅",1,16,-15
"19521","2727王品","110/07/13","統一-竹南",11,0,11
"19522","2727王品","110/07/13","凱基-高美館",2,15,-13
"19523","2727王品","110/07/13","日盛-士林",12,2,10
"19524","2727王品","110/07/13","美商高盛",2,14,-12
"19525","2727王品","110/07/13","統一-敦南",10,0,10
"19526","2727王品","110/07/13","統一-平鎮",1,13,-12
"19527","2727王品","110/07/13","中國信託",15,5,10
"19528","2727王品","110/07/13","兆豐-台中港",4,16,-12
"19529","2727王品","110/07/13","兆豐-竹北",13,3,10
"19530","2727王品","110/07/13","凱基-八德",1,13,-12
"19531","1570力肯","110/07/13","新光",115,11,104
"19532","1570力肯","110/07/13","元大-北三重",0,162,-162
"19533","1570力肯","110/07/13","群益金鼎-高雄",54,0,54
"19534","1570力肯","110/07/13","元大-大灣",0,25,-25
"19535","1570力肯","110/07/13","國票-新莊",22,0,22
"19536","1570力肯","110/07/13","永豐金-苓雅",0,22,-22
"19537","1570力肯","110/07/13","日盛-桃園",12,0,12
"19538","1570力肯","110/07/13","永豐金-永康",0,19,-19
"19539","1570力肯","110/07/13","元大-高雄",12,0,12
"19540","1570力肯","110/07/13","富邦-員林",0,15,-15
"19541","1570力肯","110/07/13","合庫-自強",11,0,11
"19542","1570力肯","110/07/13","凱基-台南",0,11,-11
"19543","1570力肯","110/07/13","摩根大通",26,15,11
"19544","1570力肯","110/07/13","日盛-竹北",0,10,-10
"19545","1570力肯","110/07/13","永豐金-中盛",11,0,11
"19546","1570力肯","110/07/13","國票-九鼎",0,10,-10
"19547","1570力肯","110/07/13","兆豐-台中港",10,0,10
"19548","1570力肯","110/07/13","凱基-桃園",0,10,-10
"19549","1570力肯","110/07/13","國泰-松江",9,0,9
"19550","1570力肯","110/07/13","凱基-新豐",0,10,-10
"19551","1570力肯","110/07/13","元大-新盛",9,0,9
"19552","1570力肯","110/07/13","元大-學甲",0,10,-10
"19553","1570力肯","110/07/13","元富-緯城",6,0,6
"19554","1570力肯","110/07/13","群益金鼎-東湖",1,10,-9
"19555","1570力肯","110/07/13","統一-三重",5,0,5
"19556","1570力肯","110/07/13","大昌",0,6,-6
"19557","1570力肯","110/07/13","元大-前金",5,0,5
"19558","1570力肯","110/07/13","元大-土城學府",0,6,-6
"19559","1570力肯","110/07/13","永豐金證券",5,0,5
"19560","1570力肯","110/07/13","統一",0,5,-5
"19561","6180橘子","110/07/13","摩根大通",119,0,119
"19562","6180橘子","110/07/13","元大-崇德",2,61,-59
"19563","6180橘子","110/07/13","美商高盛",96,0,96
"19564","6180橘子","110/07/13","康和-台中",0,51,-51
"19565","6180橘子","110/07/13","新加坡商瑞銀",86,7,79
"19566","6180橘子","110/07/13","康和-台北",0,50,-50
"19567","6180橘子","110/07/13","元大-和平",40,0,40
"19568","6180橘子","110/07/13","元富-潮州",0,40,-40
"19569","6180橘子","110/07/13","凱基-台北",83,47,36
"19570","6180橘子","110/07/13","日盛-永康",0,26,-26
"19571","6180橘子","110/07/13","美林",39,5,34
"19572","6180橘子","110/07/13","永豐金-中正",0,24,-24
"19573","6180橘子","110/07/13","富邦-新竹華信",31,2,29
"19574","6180橘子","110/07/13","國泰-板橋",2,25,-23
"19575","6180橘子","110/07/13","統一-南京",21,0,21
"19576","6180橘子","110/07/13","日盛-大墩",0,20,-20
"19577","6180橘子","110/07/13","富邦-陽明",24,3,21
"19578","6180橘子","110/07/13","元大-草屯",13,32,-19
"19579","6180橘子","110/07/13","大昌-樹林",21,1,20
"19580","6180橘子","110/07/13","元富-林園",1,18,-17
"19581","6180橘子","110/07/13","花旗環球",19,0,19
"19582","6180橘子","110/07/13","新光-新竹",1,18,-17
"19583","6180橘子","110/07/13","華南永昌-台南",19,0,19
"19584","6180橘子","110/07/13","元大-土城永寧",0,17,-17
"19585","6180橘子","110/07/13","福勝",14,0,14
"19586","6180橘子","110/07/13","國泰-新莊",3,19,-16
"19587","6180橘子","110/07/13","富邦-嘉義",12,1,11
"19588","6180橘子","110/07/13","中國信託-永康",6,21,-15
"19589","6180橘子","110/07/13","元大-板橋三民",11,0,11
"19590","6180橘子","110/07/13","凱基-東港",1,15,-14
"19591","2390云辰","110/07/13","新加坡商瑞銀",562,75,487
"19592","2390云辰","110/07/13","大展-台南",0,532,-532
"19593","2390云辰","110/07/13","台灣摩根士丹利",330,155,175
"19594","2390云辰","110/07/13","凱基-台北",668,854,-186
"19595","2390云辰","110/07/13","兆豐-公益",126,25,101
"19596","2390云辰","110/07/13","凱基-三重",12,172,-160
"19597","2390云辰","110/07/13","元富-中港",100,2,98
"19598","2390云辰","110/07/13","兆豐-忠孝",4,161,-157
"19599","2390云辰","110/07/13","統一-新台中",106,9,97
"19600","2390云辰","110/07/13","元大-士林",19,170,-151
"19601","2390云辰","110/07/13","中國信託-松江",81,11,70
"19602","2390云辰","110/07/13","臺銀-新竹",14,117,-103
"19603","2390云辰","110/07/13","日盛-板橋",72,3,69
"19604","2390云辰","110/07/13","國票-台中",4,102,-98
"19605","2390云辰","110/07/13","日盛-和美",57,0,57
"19606","2390云辰","110/07/13","新光",147,232,-85
"19607","2390云辰","110/07/13","永豐金-桃園",88,36,52
"19608","2390云辰","110/07/13","致和-崇德",2,70,-68
"19609","2390云辰","110/07/13","玉山-士林",54,4,50
"19610","2390云辰","110/07/13","群益金鼎-屏東",2,70,-68
"19611","2390云辰","110/07/13","富邦-仁愛",56,6,50
"19612","2390云辰","110/07/13","元大-大里",35,98,-63
"19613","2390云辰","110/07/13","第一金-豐原",50,1,49
"19614","2390云辰","110/07/13","元大-萬華",35,94,-59
"19615","2390云辰","110/07/13","摩根大通",502,453,49
"19616","2390云辰","110/07/13","元富-吉利",2,60,-58
"19617","2390云辰","110/07/13","凱基-松山",61,13,48
"19618","2390云辰","110/07/13","兆豐-新竹",3,53,-50
"19619","2390云辰","110/07/13","大昌",64,22,42
"19620","2390云辰","110/07/13","富邦-嘉義",65,108,-43
"19621","2363矽統","110/07/13","凱基-南崁",2133,63,2070
"19622","2363矽統","110/07/13","凱基-幸福",36,4048,-4012
"19623","2363矽統","110/07/13","國泰-敦南",2195,1617,578
"19624","2363矽統","110/07/13","統一",192,3325,-3133
"19625","2363矽統","110/07/13","中農",670,139,531
"19626","2363矽統","110/07/13","新加坡商瑞銀",1000,2747,-1747
"19627","2363矽統","110/07/13","康和-台中",638,154,484
"19628","2363矽統","110/07/13","凱基-台北",5359,6609,-1250
"19629","2363矽統","110/07/13","群益金鼎-三民",577,137,440
"19630","2363矽統","110/07/13","摩根大通",1930,2858,-928
"19631","2363矽統","110/07/13","台新-屏東",510,88,422
"19632","2363矽統","110/07/13","港商野村",960,1679,-719
"19633","2363矽統","110/07/13","德信-中正",455,67,388
"19634","2363矽統","110/07/13","兆豐-復興",25,705,-680
"19635","2363矽統","110/07/13","日盛-竹北",365,70,295
"19636","2363矽統","110/07/13","統一-仁愛",114,755,-641
"19637","2363矽統","110/07/13","元大-佳里",452,189,263
"19638","2363矽統","110/07/13","統一-敦南",29,638,-609
"19639","2363矽統","110/07/13","國票-博愛",296,38,258
"19640","2363矽統","110/07/13","統一-土城",100,704,-604
"19641","2363矽統","110/07/13","元大-萬華",340,95,245
"19642","2363矽統","110/07/13","統一-城中",116,676,-560
"19643","2363矽統","110/07/13","新光",1259,1031,228
"19644","2363矽統","110/07/13","永豐金證券",306,859,-553
"19645","2363矽統","110/07/13","元富-成功",323,96,227
"19646","2363矽統","110/07/13","元富",54,567,-513
"19647","2363矽統","110/07/13","豐農",228,23,205
"19648","2363矽統","110/07/13","瑞士信貸",202,666,-464
"19649","2363矽統","110/07/13","台灣企銀-岡山",186,4,182
"19650","2363矽統","110/07/13","永豐金-嘉義",67,468,-401
"19651","8112至上","110/07/13","摩根大通",688,296,392
"19652","8112至上","110/07/13","國票-中和",0,401,-401
"19653","8112至上","110/07/13","港商野村",344,145,199
"19654","8112至上","110/07/13","永豐金-板盛",0,205,-205
"19655","8112至上","110/07/13","兆豐-公益",195,5,190
"19656","8112至上","110/07/13","凱基-五股",43,155,-112
"19657","8112至上","110/07/13","台灣摩根士丹利",183,0,183
"19658","8112至上","110/07/13","凱基-市政",0,100,-100
"19659","8112至上","110/07/13","群益金鼎-敦南",153,2,151
"19660","8112至上","110/07/13","元大-大里德芳",1,92,-91
"19661","8112至上","110/07/13","臺銀-金山",146,26,120
"19662","8112至上","110/07/13","玉山-桃園",26,110,-84
"19663","8112至上","110/07/13","臺銀",133,19,114
"19664","8112至上","110/07/13","兆豐-天母",0,81,-81
"19665","8112至上","110/07/13","合庫-台中",115,6,109
"19666","8112至上","110/07/13","凱基-城中",3,84,-81
"19667","8112至上","110/07/13","亞東-板橋",134,26,108
"19668","8112至上","110/07/13","日盛-新莊",9,85,-76
"19669","8112至上","110/07/13","凱基-台北",414,326,88
"19670","8112至上","110/07/13","日盛-台中",2,64,-62
"19671","8112至上","110/07/13","新加坡商瑞銀",181,100,81
"19672","8112至上","110/07/13","日盛-中壢",3,64,-61
"19673","8112至上","110/07/13","國泰-敦南",108,31,77
"19674","8112至上","110/07/13","元大-台中",2,59,-57
"19675","8112至上","110/07/13","第一金-華江",77,4,73
"19676","8112至上","110/07/13","元大-雙和",7,64,-57
"19677","8112至上","110/07/13","永豐金-內湖",73,1,72
"19678","8112至上","110/07/13","元大-高雄",8,62,-54
"19679","8112至上","110/07/13","元大-永和",68,1,67
"19680","8112至上","110/07/13","元大-館前",2,55,-53
"19681","4903聯光通","110/07/13","台灣企銀-太平",56,0,56
"19682","4903聯光通","110/07/13","土銀",0,32,-32
"19683","4903聯光通","110/07/13","元富-新興",23,0,23
"19684","4903聯光通","110/07/13","元大-樹林",0,19,-19
"19685","4903聯光通","110/07/13","日盛-樹林",22,0,22
"19686","4903聯光通","110/07/13","凱基-士林",0,17,-17
"19687","4903聯光通","110/07/13","兆豐-天母",20,0,20
"19688","4903聯光通","110/07/13","國票-博愛",0,14,-14
"19689","4903聯光通","110/07/13","華南永昌-桃園",20,0,20
"19690","4903聯光通","110/07/13","元富",0,10,-10
"19691","4903聯光通","110/07/13","富邦-新店",10,0,10
"19692","4903聯光通","110/07/13","新光",0,10,-10
"19693","4903聯光通","110/07/13","新光-台中",5,0,5
"19694","4903聯光通","110/07/13","玉山-南京東路",0,10,-10
"19695","4903聯光通","110/07/13","華南永昌-台中",5,0,5
"19696","4903聯光通","110/07/13","富邦-陽明",0,10,-10
"19697","4903聯光通","110/07/13","元大-崇德",5,0,5
"19698","4903聯光通","110/07/13","元大-大甲",0,8,-8
"19699","4903聯光通","110/07/13","元大-草屯",5,0,5
"19700","4903聯光通","110/07/13","富邦-台中",0,7,-7
"19701","4903聯光通","110/07/13","元富-草屯",4,0,4
"19702","4903聯光通","110/07/13","凱基-中壢",0,6,-6
"19703","4903聯光通","110/07/13","元大-清水",4,0,4
"19704","4903聯光通","110/07/13","臺銀-民權",0,5,-5
"19705","4903聯光通","110/07/13","元大-東泰",4,0,4
"19706","4903聯光通","110/07/13","日盛-板橋",0,5,-5
"19707","4903聯光通","110/07/13","元大-佳里",2,0,2
"19708","4903聯光通","110/07/13","中國信託-忠孝",0,5,-5
"19709","4903聯光通","110/07/13","永豐金-板橋",2,0,2
"19710","4903聯光通","110/07/13","永豐金-鳳山",0,5,-5
"19711","2929淘帝","110/07/13","玉山-新竹",130,0,130
"19712","2929淘帝","110/07/13","美商高盛",0,177,-177
"19713","2929淘帝","110/07/13","臺銀-民權",60,0,60
"19714","2929淘帝","110/07/13","凱基-台北",6,80,-74
"19715","2929淘帝","110/07/13","新百王",31,0,31
"19716","2929淘帝","110/07/13","元富-大裕",0,49,-49
"19717","2929淘帝","110/07/13","日盛-園區",30,0,30
"19718","2929淘帝","110/07/13","國泰-館前",3,51,-48
"19719","2929淘帝","110/07/13","元大-南投",31,1,30
"19720","2929淘帝","110/07/13","凱基-中壢",0,41,-41
"19721","2929淘帝","110/07/13","兆豐-忠孝",28,0,28
"19722","2929淘帝","110/07/13","港商野村",21,55,-34
"19723","2929淘帝","110/07/13","元大-民生",28,0,28
"19724","2929淘帝","110/07/13","華南永昌-南京",2,34,-32
"19725","2929淘帝","110/07/13","合庫-高雄",27,0,27
"19726","2929淘帝","110/07/13","群益金鼎-土城",0,30,-30
"19727","2929淘帝","110/07/13","凱基-豐中",27,0,27
"19728","2929淘帝","110/07/13","富邦-南屯",0,22,-22
"19729","2929淘帝","110/07/13","新光",21,4,17
"19730","2929淘帝","110/07/13","第一金-豐原",0,20,-20
"19731","2929淘帝","110/07/13","元大-天母",17,0,17
"19732","2929淘帝","110/07/13","元大-屏南",6,26,-20
"19733","2929淘帝","110/07/13","永興",14,0,14
"19734","2929淘帝","110/07/13","永豐金-敦南",1,21,-20
"19735","2929淘帝","110/07/13","富邦-台北",12,0,12
"19736","2929淘帝","110/07/13","凱基-三重",2,21,-19
"19737","2929淘帝","110/07/13","元大-永和",12,0,12
"19738","2929淘帝","110/07/13","富邦-仁愛",7,25,-18
"19739","2929淘帝","110/07/13","國票-天祥",11,0,11
"19740","2929淘帝","110/07/13","元大-北投",0,16,-16
"19741","5410國眾","110/07/13","兆豐-城中",274,0,274
"19742","5410國眾","110/07/13","元富-嘉義",0,103,-103
"19743","5410國眾","110/07/13","新光",50,4,46
"19744","5410國眾","110/07/13","凱基-台北",0,50,-50
"19745","5410國眾","110/07/13","國泰-台中",26,0,26
"19746","5410國眾","110/07/13","瑞士信貸",0,31,-31
"19747","5410國眾","110/07/13","新加坡商瑞銀",22,0,22
"19748","5410國眾","110/07/13","台新-新莊",0,27,-27
"19749","5410國眾","110/07/13","光和-嘉義",20,0,20
"19750","5410國眾","110/07/13","元大-汐止",0,20,-20
"19751","5410國眾","110/07/13","凱基-竹北",17,0,17
"19752","5410國眾","110/07/13","亞東-新竹",0,17,-17
"19753","5410國眾","110/07/13","新光-桃園",15,0,15
"19754","5410國眾","110/07/13","元大-南勢角",0,13,-13
"19755","5410國眾","110/07/13","凱基-台東",14,0,14
"19756","5410國眾","110/07/13","台新-台南",0,12,-12
"19757","5410國眾","110/07/13","富邦-竹北",11,0,11
"19758","5410國眾","110/07/13","中國信託",0,11,-11
"19759","5410國眾","110/07/13","元富-同大",10,0,10
"19760","5410國眾","110/07/13","華南永昌",0,11,-11
"19761","5410國眾","110/07/13","國泰-敦南",24,15,9
"19762","5410國眾","110/07/13","臺銀-臺南",0,10,-10
"19763","5410國眾","110/07/13","日盛-內湖",7,0,7
"19764","5410國眾","110/07/13","台灣企銀-民雄",0,10,-10
"19765","5410國眾","110/07/13","台新-左楠",7,0,7
"19766","5410國眾","110/07/13","高橋",0,10,-10
"19767","5410國眾","110/07/13","元大-新盛",18,12,6
"19768","5410國眾","110/07/13","康和-嘉義",0,10,-10
"19769","5410國眾","110/07/13","統一",5,0,5
"19770","5410國眾","110/07/13","凱基-基隆",0,10,-10
"19771","2841台開","110/07/13","中國信託-高雄",251,50,201
"19772","2841台開","110/07/13","兆豐-公益",0,177,-177
"19773","2841台開","110/07/13","日盛證券",210,13,197
"19774","2841台開","110/07/13","日進",0,152,-152
"19775","2841台開","110/07/13","第一金-台中",55,0,55
"19776","2841台開","110/07/13","港商野村",0,109,-109
"19777","2841台開","110/07/13","國泰-板橋",46,0,46
"19778","2841台開","110/07/13","日盛-信義",0,103,-103
"19779","2841台開","110/07/13","國泰-館前",48,3,45
"19780","2841台開","110/07/13","國泰-敦南",11,75,-64
"19781","2841台開","110/07/13","華南永昌-新莊",45,0,45
"19782","2841台開","110/07/13","永興",0,50,-50
"19783","2841台開","110/07/13","日盛-園區",42,0,42
"19784","2841台開","110/07/13","永豐金-敦南",61,104,-43
"19785","2841台開","110/07/13","台新證券",32,0,32
"19786","2841台開","110/07/13","富邦-台南",0,42,-42
"19787","2841台開","110/07/13","台新-高雄",32,2,30
"19788","2841台開","110/07/13","國票-安和",0,30,-30
"19789","2841台開","110/07/13","豐農",23,0,23
"19790","2841台開","110/07/13","元大-桃園",0,25,-25
"19791","2841台開","110/07/13","合庫-嘉義",20,0,20
"19792","2841台開","110/07/13","新光",8,32,-24
"19793","2841台開","110/07/13","華南永昌-高雄",20,0,20
"19794","2841台開","110/07/13","元大-仁愛",0,24,-24
"19795","2841台開","110/07/13","元大-樹林",16,0,16
"19796","2841台開","110/07/13","日盛-中和",0,20,-20
"19797","2841台開","110/07/13","第一金-華江",15,2,13
"19798","2841台開","110/07/13","元富",0,20,-20
"19799","2841台開","110/07/13","美商高盛",12,0,12
"19800","2841台開","110/07/13","富邦-宜蘭",0,20,-20
"19801","6207雷科","110/07/13","元大-高雄",121,0,121
"19802","6207雷科","110/07/13","華南永昌-朴子",1,60,-59
"19803","6207雷科","110/07/13","第一金-新興",20,0,20
"19804","6207雷科","110/07/13","元大-南海",0,36,-36
"19805","6207雷科","110/07/13","元富-三重",20,0,20
"19806","6207雷科","110/07/13","凱基-土城",0,35,-35
"19807","6207雷科","110/07/13","元大-林園",15,0,15
"19808","6207雷科","110/07/13","台灣企銀",0,20,-20
"19809","6207雷科","110/07/13","元大-金華",16,1,15
"19810","6207雷科","110/07/13","群益金鼎-丹鳳",0,20,-20
"19811","6207雷科","110/07/13","日盛證券",10,0,10
"19812","6207雷科","110/07/13","元大-博愛",0,17,-17
"19813","6207雷科","110/07/13","統一-台中",10,0,10
"19814","6207雷科","110/07/13","元大-北港",0,13,-13
"19815","6207雷科","110/07/13","群益金鼎-土城",10,0,10
"19816","6207雷科","110/07/13","新加坡商瑞銀",0,12,-12
"19817","6207雷科","110/07/13","群益金鼎-桃園",10,0,10
"19818","6207雷科","110/07/13","凱基-台北",4,16,-12
"19819","6207雷科","110/07/13","永豐金-新莊",10,0,10
"19820","6207雷科","110/07/13","日茂-埔里",0,11,-11
"19821","6207雷科","110/07/13","永豐金-新店",10,0,10
"19822","6207雷科","110/07/13","元大-莒光",0,11,-11
"19823","6207雷科","110/07/13","元大證券",9,0,9
"19824","6207雷科","110/07/13","統一-新竹",0,10,-10
"19825","6207雷科","110/07/13","日盛-木柵",9,1,8
"19826","6207雷科","110/07/13","元大-西螺",0,10,-10
"19827","6207雷科","110/07/13","兆豐-來福",8,0,8
"19828","6207雷科","110/07/13","康和-台中",0,8,-8
"19829","6207雷科","110/07/13","新光",7,0,7
"19830","6207雷科","110/07/13","兆豐-高雄",0,6,-6
"19831","3679新至陞","110/07/13","永豐金證券",50,0,50
"19832","3679新至陞","110/07/13","摩根大通",2,25,-23
"19833","3679新至陞","110/07/13","國泰-桃園",22,0,22
"19834","3679新至陞","110/07/13","元大-成功",0,22,-22
"19835","3679新至陞","110/07/13","台中銀-員林",11,0,11
"19836","3679新至陞","110/07/13","富邦-板橋",1,19,-18
"19837","3679新至陞","110/07/13","元大-文心興安",8,0,8
"19838","3679新至陞","110/07/13","日盛-新莊",0,10,-10
"19839","3679新至陞","110/07/13","美商高盛",6,0,6
"19840","3679新至陞","110/07/13","台新-台中",0,10,-10
"19841","3679新至陞","110/07/13","台新-高雄",6,0,6
"19842","3679新至陞","110/07/13","永豐金-新竹",0,8,-8
"19843","3679新至陞","110/07/13","凱基-台北",18,12,6
"19844","3679新至陞","110/07/13","瑞士信貸",12,19,-7
"19845","3679新至陞","110/07/13","日盛-復興",5,0,5
"19846","3679新至陞","110/07/13","統一-南京",0,7,-7
"19847","3679新至陞","110/07/13","(牛牛牛)亞-鑫豐",4,0,4
"19848","3679新至陞","110/07/13","凱基-新莊",0,7,-7
"19849","3679新至陞","110/07/13","元富-大昌",3,0,3
"19850","3679新至陞","110/07/13","新加坡商瑞銀",0,6,-6
"19851","3679新至陞","110/07/13","富邦-台北",3,0,3
"19852","3679新至陞","110/07/13","合庫-自強",0,5,-5
"19853","3679新至陞","110/07/13","日盛-樹林",2,0,2
"19854","3679新至陞","110/07/13","富邦-桃園",0,5,-5
"19855","3679新至陞","110/07/13","宏遠-光隆",2,0,2
"19856","3679新至陞","110/07/13","永豐金-潮州",0,4,-4
"19857","3679新至陞","110/07/13","美林",3,1,2
"19858","3679新至陞","110/07/13","臺銀-臺南",0,3,-3
"19859","3679新至陞","110/07/13","第一金-中壢",2,0,2
"19860","3679新至陞","110/07/13","元大-六合",0,3,-3
"19861","2727王品","110/07/13","富邦-台北",43,3,40
"19862","2727王品","110/07/13","台灣摩根士丹利",15,97,-82
"19863","2727王品","110/07/13","元大-基隆孝二",40,0,40
"19864","2727王品","110/07/13","玉山-台南",5,57,-52
"19865","2727王品","110/07/13","國票-新莊",40,1,39
"19866","2727王品","110/07/13","新加坡商瑞銀",0,48,-48
"19867","2727王品","110/07/13","第一金-豐原",66,42,24
"19868","2727王品","110/07/13","凱基-台北",41,77,-36
"19869","2727王品","110/07/13","永豐金-大園",34,10,24
"19870","2727王品","110/07/13","永豐金-永康",0,22,-22
"19871","2727王品","110/07/13","元大-北屯",22,0,22
"19872","2727王品","110/07/13","統一-台中",2,22,-20
"19873","2727王品","110/07/13","元大-東蘆",26,7,19
"19874","2727王品","110/07/13","國泰-台中",21,39,-18
"19875","2727王品","110/07/13","永豐金-萬盛",13,1,12
"19876","2727王品","110/07/13","合庫-彰化",3,20,-17
"19877","2727王品","110/07/13","日盛-嘉義",11,0,11
"19878","2727王品","110/07/13","港商野村",13,30,-17
"19879","2727王品","110/07/13","日盛-八德",11,0,11
"19880","2727王品","110/07/13","元大-楊梅",1,16,-15
"19881","2727王品","110/07/13","統一-竹南",11,0,11
"19882","2727王品","110/07/13","凱基-高美館",2,15,-13
"19883","2727王品","110/07/13","日盛-士林",12,2,10
"19884","2727王品","110/07/13","美商高盛",2,14,-12
"19885","2727王品","110/07/13","統一-敦南",10,0,10
"19886","2727王品","110/07/13","統一-平鎮",1,13,-12
"19887","2727王品","110/07/13","中國信託",15,5,10
"19888","2727王品","110/07/13","兆豐-台中港",4,16,-12
"19889","2727王品","110/07/13","兆豐-竹北",13,3,10
"19890","2727王品","110/07/13","凱基-八德",1,13,-12
"19891","1570力肯","110/07/13","新光",115,11,104
"19892","1570力肯","110/07/13","元大-北三重",0,162,-162
"19893","1570力肯","110/07/13","群益金鼎-高雄",54,0,54
"19894","1570力肯","110/07/13","元大-大灣",0,25,-25
"19895","1570力肯","110/07/13","國票-新莊",22,0,22
"19896","1570力肯","110/07/13","永豐金-苓雅",0,22,-22
"19897","1570力肯","110/07/13","日盛-桃園",12,0,12
"19898","1570力肯","110/07/13","永豐金-永康",0,19,-19
"19899","1570力肯","110/07/13","元大-高雄",12,0,12
"19900","1570力肯","110/07/13","富邦-員林",0,15,-15
"19901","1570力肯","110/07/13","合庫-自強",11,0,11
"19902","1570力肯","110/07/13","凱基-台南",0,11,-11
"19903","1570力肯","110/07/13","摩根大通",26,15,11
"19904","1570力肯","110/07/13","日盛-竹北",0,10,-10
"19905","1570力肯","110/07/13","永豐金-中盛",11,0,11
"19906","1570力肯","110/07/13","國票-九鼎",0,10,-10
"19907","1570力肯","110/07/13","兆豐-台中港",10,0,10
"19908","1570力肯","110/07/13","凱基-桃園",0,10,-10
"19909","1570力肯","110/07/13","國泰-松江",9,0,9
"19910","1570力肯","110/07/13","凱基-新豐",0,10,-10
"19911","1570力肯","110/07/13","元大-新盛",9,0,9
"19912","1570力肯","110/07/13","元大-學甲",0,10,-10
"19913","1570力肯","110/07/13","元富-緯城",6,0,6
"19914","1570力肯","110/07/13","群益金鼎-東湖",1,10,-9
"19915","1570力肯","110/07/13","統一-三重",5,0,5
"19916","1570力肯","110/07/13","大昌",0,6,-6
"19917","1570力肯","110/07/13","元大-前金",5,0,5
"19918","1570力肯","110/07/13","元大-土城學府",0,6,-6
"19919","1570力肯","110/07/13","永豐金證券",5,0,5
"19920","1570力肯","110/07/13","統一",0,5,-5
"19921","6180橘子","110/07/13","摩根大通",119,0,119
"19922","6180橘子","110/07/13","元大-崇德",2,61,-59
"19923","6180橘子","110/07/13","美商高盛",96,0,96
"19924","6180橘子","110/07/13","康和-台中",0,51,-51
"19925","6180橘子","110/07/13","新加坡商瑞銀",86,7,79
"19926","6180橘子","110/07/13","康和-台北",0,50,-50
"19927","6180橘子","110/07/13","元大-和平",40,0,40
"19928","6180橘子","110/07/13","元富-潮州",0,40,-40
"19929","6180橘子","110/07/13","凱基-台北",83,47,36
"19930","6180橘子","110/07/13","日盛-永康",0,26,-26
"19931","6180橘子","110/07/13","美林",39,5,34
"19932","6180橘子","110/07/13","永豐金-中正",0,24,-24
"19933","6180橘子","110/07/13","富邦-新竹華信",31,2,29
"19934","6180橘子","110/07/13","國泰-板橋",2,25,-23
"19935","6180橘子","110/07/13","統一-南京",21,0,21
"19936","6180橘子","110/07/13","日盛-大墩",0,20,-20
"19937","6180橘子","110/07/13","富邦-陽明",24,3,21
"19938","6180橘子","110/07/13","元大-草屯",13,32,-19
"19939","6180橘子","110/07/13","大昌-樹林",21,1,20
"19940","6180橘子","110/07/13","元富-林園",1,18,-17
"19941","6180橘子","110/07/13","花旗環球",19,0,19
"19942","6180橘子","110/07/13","新光-新竹",1,18,-17
"19943","6180橘子","110/07/13","華南永昌-台南",19,0,19
"19944","6180橘子","110/07/13","元大-土城永寧",0,17,-17
"19945","6180橘子","110/07/13","福勝",14,0,14
"19946","6180橘子","110/07/13","國泰-新莊",3,19,-16
"19947","6180橘子","110/07/13","富邦-嘉義",12,1,11
"19948","6180橘子","110/07/13","中國信託-永康",6,21,-15
"19949","6180橘子","110/07/13","元大-板橋三民",11,0,11
"19950","6180橘子","110/07/13","凱基-東港",1,15,-14
"19951","2390云辰","110/07/13","新加坡商瑞銀",562,75,487
"19952","2390云辰","110/07/13","大展-台南",0,532,-532
"19953","2390云辰","110/07/13","台灣摩根士丹利",330,155,175
"19954","2390云辰","110/07/13","凱基-台北",668,854,-186
"19955","2390云辰","110/07/13","兆豐-公益",126,25,101
"19956","2390云辰","110/07/13","凱基-三重",12,172,-160
"19957","2390云辰","110/07/13","元富-中港",100,2,98
"19958","2390云辰","110/07/13","兆豐-忠孝",4,161,-157
"19959","2390云辰","110/07/13","統一-新台中",106,9,97
"19960","2390云辰","110/07/13","元大-士林",19,170,-151
"19961","2390云辰","110/07/13","中國信託-松江",81,11,70
"19962","2390云辰","110/07/13","臺銀-新竹",14,117,-103
"19963","2390云辰","110/07/13","日盛-板橋",72,3,69
"19964","2390云辰","110/07/13","國票-台中",4,102,-98
"19965","2390云辰","110/07/13","日盛-和美",57,0,57
"19966","2390云辰","110/07/13","新光",147,232,-85
"19967","2390云辰","110/07/13","永豐金-桃園",88,36,52
"19968","2390云辰","110/07/13","致和-崇德",2,70,-68
"19969","2390云辰","110/07/13","玉山-士林",54,4,50
"19970","2390云辰","110/07/13","群益金鼎-屏東",2,70,-68
"19971","2390云辰","110/07/13","富邦-仁愛",56,6,50
"19972","2390云辰","110/07/13","元大-大里",35,98,-63
"19973","2390云辰","110/07/13","第一金-豐原",50,1,49
"19974","2390云辰","110/07/13","元大-萬華",35,94,-59
"19975","2390云辰","110/07/13","摩根大通",502,453,49
"19976","2390云辰","110/07/13","元富-吉利",2,60,-58
"19977","2390云辰","110/07/13","凱基-松山",61,13,48
"19978","2390云辰","110/07/13","兆豐-新竹",3,53,-50
"19979","2390云辰","110/07/13","大昌",64,22,42
"19980","2390云辰","110/07/13","富邦-嘉義",65,108,-43
"19981","2363矽統","110/07/13","凱基-南崁",2133,63,2070
"19982","2363矽統","110/07/13","凱基-幸福",36,4048,-4012
"19983","2363矽統","110/07/13","國泰-敦南",2195,1617,578
"19984","2363矽統","110/07/13","統一",192,3325,-3133
"19985","2363矽統","110/07/13","中農",670,139,531
"19986","2363矽統","110/07/13","新加坡商瑞銀",1000,2747,-1747
"19987","2363矽統","110/07/13","康和-台中",638,154,484
"19988","2363矽統","110/07/13","凱基-台北",5359,6609,-1250
"19989","2363矽統","110/07/13","群益金鼎-三民",577,137,440
"19990","2363矽統","110/07/13","摩根大通",1930,2858,-928
"19991","2363矽統","110/07/13","台新-屏東",510,88,422
"19992","2363矽統","110/07/13","港商野村",960,1679,-719
"19993","2363矽統","110/07/13","德信-中正",455,67,388
"19994","2363矽統","110/07/13","兆豐-復興",25,705,-680
"19995","2363矽統","110/07/13","日盛-竹北",365,70,295
"19996","2363矽統","110/07/13","統一-仁愛",114,755,-641
"19997","2363矽統","110/07/13","元大-佳里",452,189,263
"19998","2363矽統","110/07/13","統一-敦南",29,638,-609
"19999","2363矽統","110/07/13","國票-博愛",296,38,258
"20000","2363矽統","110/07/13","統一-土城",100,704,-604
"20001","2363矽統","110/07/13","元大-萬華",340,95,245
"20002","2363矽統","110/07/13","統一-城中",116,676,-560
"20003","2363矽統","110/07/13","新光",1259,1031,228
"20004","2363矽統","110/07/13","永豐金證券",306,859,-553
"20005","2363矽統","110/07/13","元富-成功",323,96,227
"20006","2363矽統","110/07/13","元富",54,567,-513
"20007","2363矽統","110/07/13","豐農",228,23,205
"20008","2363矽統","110/07/13","瑞士信貸",202,666,-464
"20009","2363矽統","110/07/13","台灣企銀-岡山",186,4,182
"20010","2363矽統","110/07/13","永豐金-嘉義",67,468,-401
"20011","8112至上","110/07/13","摩根大通",688,296,392
"20012","8112至上","110/07/13","國票-中和",0,401,-401
"20013","8112至上","110/07/13","港商野村",344,145,199
"20014","8112至上","110/07/13","永豐金-板盛",0,205,-205
"20015","8112至上","110/07/13","兆豐-公益",195,5,190
"20016","8112至上","110/07/13","凱基-五股",43,155,-112
"20017","8112至上","110/07/13","台灣摩根士丹利",183,0,183
"20018","8112至上","110/07/13","凱基-市政",0,100,-100
"20019","8112至上","110/07/13","群益金鼎-敦南",153,2,151
"20020","8112至上","110/07/13","元大-大里德芳",1,92,-91
"20021","8112至上","110/07/13","臺銀-金山",146,26,120
"20022","8112至上","110/07/13","玉山-桃園",26,110,-84
"20023","8112至上","110/07/13","臺銀",133,19,114
"20024","8112至上","110/07/13","兆豐-天母",0,81,-81
"20025","8112至上","110/07/13","合庫-台中",115,6,109
"20026","8112至上","110/07/13","凱基-城中",3,84,-81
"20027","8112至上","110/07/13","亞東-板橋",134,26,108
"20028","8112至上","110/07/13","日盛-新莊",9,85,-76
"20029","8112至上","110/07/13","凱基-台北",414,326,88
"20030","8112至上","110/07/13","日盛-台中",2,64,-62
"20031","8112至上","110/07/13","新加坡商瑞銀",181,100,81
"20032","8112至上","110/07/13","日盛-中壢",3,64,-61
"20033","8112至上","110/07/13","國泰-敦南",108,31,77
"20034","8112至上","110/07/13","元大-台中",2,59,-57
"20035","8112至上","110/07/13","第一金-華江",77,4,73
"20036","8112至上","110/07/13","元大-雙和",7,64,-57
"20037","8112至上","110/07/13","永豐金-內湖",73,1,72
"20038","8112至上","110/07/13","元大-高雄",8,62,-54
"20039","8112至上","110/07/13","元大-永和",68,1,67
"20040","8112至上","110/07/13","元大-館前",2,55,-53
"20041","4903聯光通","110/07/13","台灣企銀-太平",56,0,56
"20042","4903聯光通","110/07/13","土銀",0,32,-32
"20043","4903聯光通","110/07/13","元富-新興",23,0,23
"20044","4903聯光通","110/07/13","元大-樹林",0,19,-19
"20045","4903聯光通","110/07/13","日盛-樹林",22,0,22
"20046","4903聯光通","110/07/13","凱基-士林",0,17,-17
"20047","4903聯光通","110/07/13","兆豐-天母",20,0,20
"20048","4903聯光通","110/07/13","國票-博愛",0,14,-14
"20049","4903聯光通","110/07/13","華南永昌-桃園",20,0,20
"20050","4903聯光通","110/07/13","元富",0,10,-10
"20051","4903聯光通","110/07/13","富邦-新店",10,0,10
"20052","4903聯光通","110/07/13","新光",0,10,-10
"20053","4903聯光通","110/07/13","新光-台中",5,0,5
"20054","4903聯光通","110/07/13","玉山-南京東路",0,10,-10
"20055","4903聯光通","110/07/13","華南永昌-台中",5,0,5
"20056","4903聯光通","110/07/13","富邦-陽明",0,10,-10
"20057","4903聯光通","110/07/13","元大-崇德",5,0,5
"20058","4903聯光通","110/07/13","元大-大甲",0,8,-8
"20059","4903聯光通","110/07/13","元大-草屯",5,0,5
"20060","4903聯光通","110/07/13","富邦-台中",0,7,-7
"20061","4903聯光通","110/07/13","元富-草屯",4,0,4
"20062","4903聯光通","110/07/13","凱基-中壢",0,6,-6
"20063","4903聯光通","110/07/13","元大-清水",4,0,4
"20064","4903聯光通","110/07/13","臺銀-民權",0,5,-5
"20065","4903聯光通","110/07/13","元大-東泰",4,0,4
"20066","4903聯光通","110/07/13","日盛-板橋",0,5,-5
"20067","4903聯光通","110/07/13","元大-佳里",2,0,2
"20068","4903聯光通","110/07/13","中國信託-忠孝",0,5,-5
"20069","4903聯光通","110/07/13","永豐金-板橋",2,0,2
"20070","4903聯光通","110/07/13","永豐金-鳳山",0,5,-5
"20071","2929淘帝","110/07/13","玉山-新竹",130,0,130
"20072","2929淘帝","110/07/13","美商高盛",0,177,-177
"20073","2929淘帝","110/07/13","臺銀-民權",60,0,60
"20074","2929淘帝","110/07/13","凱基-台北",6,80,-74
"20075","2929淘帝","110/07/13","新百王",31,0,31
"20076","2929淘帝","110/07/13","元富-大裕",0,49,-49
"20077","2929淘帝","110/07/13","日盛-園區",30,0,30
"20078","2929淘帝","110/07/13","國泰-館前",3,51,-48
"20079","2929淘帝","110/07/13","元大-南投",31,1,30
"20080","2929淘帝","110/07/13","凱基-中壢",0,41,-41
"20081","2929淘帝","110/07/13","兆豐-忠孝",28,0,28
"20082","2929淘帝","110/07/13","港商野村",21,55,-34
"20083","2929淘帝","110/07/13","元大-民生",28,0,28
"20084","2929淘帝","110/07/13","華南永昌-南京",2,34,-32
"20085","2929淘帝","110/07/13","合庫-高雄",27,0,27
"20086","2929淘帝","110/07/13","群益金鼎-土城",0,30,-30
"20087","2929淘帝","110/07/13","凱基-豐中",27,0,27
"20088","2929淘帝","110/07/13","富邦-南屯",0,22,-22
"20089","2929淘帝","110/07/13","新光",21,4,17
"20090","2929淘帝","110/07/13","第一金-豐原",0,20,-20
"20091","2929淘帝","110/07/13","元大-天母",17,0,17
"20092","2929淘帝","110/07/13","元大-屏南",6,26,-20
"20093","2929淘帝","110/07/13","永興",14,0,14
"20094","2929淘帝","110/07/13","永豐金-敦南",1,21,-20
"20095","2929淘帝","110/07/13","富邦-台北",12,0,12
"20096","2929淘帝","110/07/13","凱基-三重",2,21,-19
"20097","2929淘帝","110/07/13","元大-永和",12,0,12
"20098","2929淘帝","110/07/13","富邦-仁愛",7,25,-18
"20099","2929淘帝","110/07/13","國票-天祥",11,0,11
"20100","2929淘帝","110/07/13","元大-北投",0,16,-16
"20101","5410國眾","110/07/13","兆豐-城中",274,0,274
"20102","5410國眾","110/07/13","元富-嘉義",0,103,-103
"20103","5410國眾","110/07/13","新光",50,4,46
"20104","5410國眾","110/07/13","凱基-台北",0,50,-50
"20105","5410國眾","110/07/13","國泰-台中",26,0,26
"20106","5410國眾","110/07/13","瑞士信貸",0,31,-31
"20107","5410國眾","110/07/13","新加坡商瑞銀",22,0,22
"20108","5410國眾","110/07/13","台新-新莊",0,27,-27
"20109","5410國眾","110/07/13","光和-嘉義",20,0,20
"20110","5410國眾","110/07/13","元大-汐止",0,20,-20
"20111","5410國眾","110/07/13","凱基-竹北",17,0,17
"20112","5410國眾","110/07/13","亞東-新竹",0,17,-17
"20113","5410國眾","110/07/13","新光-桃園",15,0,15
"20114","5410國眾","110/07/13","元大-南勢角",0,13,-13
"20115","5410國眾","110/07/13","凱基-台東",14,0,14
"20116","5410國眾","110/07/13","台新-台南",0,12,-12
"20117","5410國眾","110/07/13","富邦-竹北",11,0,11
"20118","5410國眾","110/07/13","中國信託",0,11,-11
"20119","5410國眾","110/07/13","元富-同大",10,0,10
"20120","5410國眾","110/07/13","華南永昌",0,11,-11
"20121","5410國眾","110/07/13","國泰-敦南",24,15,9
"20122","5410國眾","110/07/13","臺銀-臺南",0,10,-10
"20123","5410國眾","110/07/13","日盛-內湖",7,0,7
"20124","5410國眾","110/07/13","台灣企銀-民雄",0,10,-10
"20125","5410國眾","110/07/13","台新-左楠",7,0,7
"20126","5410國眾","110/07/13","高橋",0,10,-10
"20127","5410國眾","110/07/13","元大-新盛",18,12,6
"20128","5410國眾","110/07/13","康和-嘉義",0,10,-10
"20129","5410國眾","110/07/13","統一",5,0,5
"20130","5410國眾","110/07/13","凱基-基隆",0,10,-10
"20131","2841台開","110/07/13","中國信託-高雄",251,50,201
"20132","2841台開","110/07/13","兆豐-公益",0,177,-177
"20133","2841台開","110/07/13","日盛證券",210,13,197
"20134","2841台開","110/07/13","日進",0,152,-152
"20135","2841台開","110/07/13","第一金-台中",55,0,55
"20136","2841台開","110/07/13","港商野村",0,109,-109
"20137","2841台開","110/07/13","國泰-板橋",46,0,46
"20138","2841台開","110/07/13","日盛-信義",0,103,-103
"20139","2841台開","110/07/13","國泰-館前",48,3,45
"20140","2841台開","110/07/13","國泰-敦南",11,75,-64
"20141","2841台開","110/07/13","華南永昌-新莊",45,0,45
"20142","2841台開","110/07/13","永興",0,50,-50
"20143","2841台開","110/07/13","日盛-園區",42,0,42
"20144","2841台開","110/07/13","永豐金-敦南",61,104,-43
"20145","2841台開","110/07/13","台新證券",32,0,32
"20146","2841台開","110/07/13","富邦-台南",0,42,-42
"20147","2841台開","110/07/13","台新-高雄",32,2,30
"20148","2841台開","110/07/13","國票-安和",0,30,-30
"20149","2841台開","110/07/13","豐農",23,0,23
"20150","2841台開","110/07/13","元大-桃園",0,25,-25
"20151","2841台開","110/07/13","合庫-嘉義",20,0,20
"20152","2841台開","110/07/13","新光",8,32,-24
"20153","2841台開","110/07/13","華南永昌-高雄",20,0,20
"20154","2841台開","110/07/13","元大-仁愛",0,24,-24
"20155","2841台開","110/07/13","元大-樹林",16,0,16
"20156","2841台開","110/07/13","日盛-中和",0,20,-20
"20157","2841台開","110/07/13","第一金-華江",15,2,13
"20158","2841台開","110/07/13","元富",0,20,-20
"20159","2841台開","110/07/13","美商高盛",12,0,12
"20160","2841台開","110/07/13","富邦-宜蘭",0,20,-20
"20161","6207雷科","110/07/13","元大-高雄",121,0,121
"20162","6207雷科","110/07/13","華南永昌-朴子",1,60,-59
"20163","6207雷科","110/07/13","第一金-新興",20,0,20
"20164","6207雷科","110/07/13","元大-南海",0,36,-36
"20165","6207雷科","110/07/13","元富-三重",20,0,20
"20166","6207雷科","110/07/13","凱基-土城",0,35,-35
"20167","6207雷科","110/07/13","元大-林園",15,0,15
"20168","6207雷科","110/07/13","台灣企銀",0,20,-20
"20169","6207雷科","110/07/13","元大-金華",16,1,15
"20170","6207雷科","110/07/13","群益金鼎-丹鳳",0,20,-20
"20171","6207雷科","110/07/13","日盛證券",10,0,10
"20172","6207雷科","110/07/13","元大-博愛",0,17,-17
"20173","6207雷科","110/07/13","統一-台中",10,0,10
"20174","6207雷科","110/07/13","元大-北港",0,13,-13
"20175","6207雷科","110/07/13","群益金鼎-土城",10,0,10
"20176","6207雷科","110/07/13","新加坡商瑞銀",0,12,-12
"20177","6207雷科","110/07/13","群益金鼎-桃園",10,0,10
"20178","6207雷科","110/07/13","凱基-台北",4,16,-12
"20179","6207雷科","110/07/13","永豐金-新莊",10,0,10
"20180","6207雷科","110/07/13","日茂-埔里",0,11,-11
"20181","6207雷科","110/07/13","永豐金-新店",10,0,10
"20182","6207雷科","110/07/13","元大-莒光",0,11,-11
"20183","6207雷科","110/07/13","元大證券",9,0,9
"20184","6207雷科","110/07/13","統一-新竹",0,10,-10
"20185","6207雷科","110/07/13","日盛-木柵",9,1,8
"20186","6207雷科","110/07/13","元大-西螺",0,10,-10
"20187","6207雷科","110/07/13","兆豐-來福",8,0,8
"20188","6207雷科","110/07/13","康和-台中",0,8,-8
"20189","6207雷科","110/07/13","新光",7,0,7
"20190","6207雷科","110/07/13","兆豐-高雄",0,6,-6
"20191","3679新至陞","110/07/13","永豐金證券",50,0,50
"20192","3679新至陞","110/07/13","摩根大通",2,25,-23
"20193","3679新至陞","110/07/13","國泰-桃園",22,0,22
"20194","3679新至陞","110/07/13","元大-成功",0,22,-22
"20195","3679新至陞","110/07/13","台中銀-員林",11,0,11
"20196","3679新至陞","110/07/13","富邦-板橋",1,19,-18
"20197","3679新至陞","110/07/13","元大-文心興安",8,0,8
"20198","3679新至陞","110/07/13","日盛-新莊",0,10,-10
"20199","3679新至陞","110/07/13","美商高盛",6,0,6
"20200","3679新至陞","110/07/13","台新-台中",0,10,-10
"20201","3679新至陞","110/07/13","台新-高雄",6,0,6
"20202","3679新至陞","110/07/13","永豐金-新竹",0,8,-8
"20203","3679新至陞","110/07/13","凱基-台北",18,12,6
"20204","3679新至陞","110/07/13","瑞士信貸",12,19,-7
"20205","3679新至陞","110/07/13","日盛-復興",5,0,5
"20206","3679新至陞","110/07/13","統一-南京",0,7,-7
"20207","3679新至陞","110/07/13","(牛牛牛)亞-鑫豐",4,0,4
"20208","3679新至陞","110/07/13","凱基-新莊",0,7,-7
"20209","3679新至陞","110/07/13","元富-大昌",3,0,3
"20210","3679新至陞","110/07/13","新加坡商瑞銀",0,6,-6
"20211","3679新至陞","110/07/13","富邦-台北",3,0,3
"20212","3679新至陞","110/07/13","合庫-自強",0,5,-5
"20213","3679新至陞","110/07/13","日盛-樹林",2,0,2
"20214","3679新至陞","110/07/13","富邦-桃園",0,5,-5
"20215","3679新至陞","110/07/13","宏遠-光隆",2,0,2
"20216","3679新至陞","110/07/13","永豐金-潮州",0,4,-4
"20217","3679新至陞","110/07/13","美林",3,1,2
"20218","3679新至陞","110/07/13","臺銀-臺南",0,3,-3
"20219","3679新至陞","110/07/13","第一金-中壢",2,0,2
"20220","3679新至陞","110/07/13","元大-六合",0,3,-3
"20221","2727王品","110/07/13","富邦-台北",43,3,40
"20222","2727王品","110/07/13","台灣摩根士丹利",15,97,-82
"20223","2727王品","110/07/13","元大-基隆孝二",40,0,40
"20224","2727王品","110/07/13","玉山-台南",5,57,-52
"20225","2727王品","110/07/13","國票-新莊",40,1,39
"20226","2727王品","110/07/13","新加坡商瑞銀",0,48,-48
"20227","2727王品","110/07/13","第一金-豐原",66,42,24
"20228","2727王品","110/07/13","凱基-台北",41,77,-36
"20229","2727王品","110/07/13","永豐金-大園",34,10,24
"20230","2727王品","110/07/13","永豐金-永康",0,22,-22
"20231","2727王品","110/07/13","元大-北屯",22,0,22
"20232","2727王品","110/07/13","統一-台中",2,22,-20
"20233","2727王品","110/07/13","元大-東蘆",26,7,19
"20234","2727王品","110/07/13","國泰-台中",21,39,-18
"20235","2727王品","110/07/13","永豐金-萬盛",13,1,12
"20236","2727王品","110/07/13","合庫-彰化",3,20,-17
"20237","2727王品","110/07/13","日盛-嘉義",11,0,11
"20238","2727王品","110/07/13","港商野村",13,30,-17
"20239","2727王品","110/07/13","日盛-八德",11,0,11
"20240","2727王品","110/07/13","元大-楊梅",1,16,-15
"20241","2727王品","110/07/13","統一-竹南",11,0,11
"20242","2727王品","110/07/13","凱基-高美館",2,15,-13
"20243","2727王品","110/07/13","日盛-士林",12,2,10
"20244","2727王品","110/07/13","美商高盛",2,14,-12
"20245","2727王品","110/07/13","統一-敦南",10,0,10
"20246","2727王品","110/07/13","統一-平鎮",1,13,-12
"20247","2727王品","110/07/13","中國信託",15,5,10
"20248","2727王品","110/07/13","兆豐-台中港",4,16,-12
"20249","2727王品","110/07/13","兆豐-竹北",13,3,10
"20250","2727王品","110/07/13","凱基-八德",1,13,-12
"20251","1570力肯","110/07/13","新光",115,11,104
"20252","1570力肯","110/07/13","元大-北三重",0,162,-162
"20253","1570力肯","110/07/13","群益金鼎-高雄",54,0,54
"20254","1570力肯","110/07/13","元大-大灣",0,25,-25
"20255","1570力肯","110/07/13","國票-新莊",22,0,22
"20256","1570力肯","110/07/13","永豐金-苓雅",0,22,-22
"20257","1570力肯","110/07/13","日盛-桃園",12,0,12
"20258","1570力肯","110/07/13","永豐金-永康",0,19,-19
"20259","1570力肯","110/07/13","元大-高雄",12,0,12
"20260","1570力肯","110/07/13","富邦-員林",0,15,-15
"20261","1570力肯","110/07/13","合庫-自強",11,0,11
"20262","1570力肯","110/07/13","凱基-台南",0,11,-11
"20263","1570力肯","110/07/13","摩根大通",26,15,11
"20264","1570力肯","110/07/13","日盛-竹北",0,10,-10
"20265","1570力肯","110/07/13","永豐金-中盛",11,0,11
"20266","1570力肯","110/07/13","國票-九鼎",0,10,-10
"20267","1570力肯","110/07/13","兆豐-台中港",10,0,10
"20268","1570力肯","110/07/13","凱基-桃園",0,10,-10
"20269","1570力肯","110/07/13","國泰-松江",9,0,9
"20270","1570力肯","110/07/13","凱基-新豐",0,10,-10
"20271","1570力肯","110/07/13","元大-新盛",9,0,9
"20272","1570力肯","110/07/13","元大-學甲",0,10,-10
"20273","1570力肯","110/07/13","元富-緯城",6,0,6
"20274","1570力肯","110/07/13","群益金鼎-東湖",1,10,-9
"20275","1570力肯","110/07/13","統一-三重",5,0,5
"20276","1570力肯","110/07/13","大昌",0,6,-6
"20277","1570力肯","110/07/13","元大-前金",5,0,5
"20278","1570力肯","110/07/13","元大-土城學府",0,6,-6
"20279","1570力肯","110/07/13","永豐金證券",5,0,5
"20280","1570力肯","110/07/13","統一",0,5,-5
"20281","6180橘子","110/07/13","摩根大通",119,0,119
"20282","6180橘子","110/07/13","元大-崇德",2,61,-59
"20283","6180橘子","110/07/13","美商高盛",96,0,96
"20284","6180橘子","110/07/13","康和-台中",0,51,-51
"20285","6180橘子","110/07/13","新加坡商瑞銀",86,7,79
"20286","6180橘子","110/07/13","康和-台北",0,50,-50
"20287","6180橘子","110/07/13","元大-和平",40,0,40
"20288","6180橘子","110/07/13","元富-潮州",0,40,-40
"20289","6180橘子","110/07/13","凱基-台北",83,47,36
"20290","6180橘子","110/07/13","日盛-永康",0,26,-26
"20291","6180橘子","110/07/13","美林",39,5,34
"20292","6180橘子","110/07/13","永豐金-中正",0,24,-24
"20293","6180橘子","110/07/13","富邦-新竹華信",31,2,29
"20294","6180橘子","110/07/13","國泰-板橋",2,25,-23
"20295","6180橘子","110/07/13","統一-南京",21,0,21
"20296","6180橘子","110/07/13","日盛-大墩",0,20,-20
"20297","6180橘子","110/07/13","富邦-陽明",24,3,21
"20298","6180橘子","110/07/13","元大-草屯",13,32,-19
"20299","6180橘子","110/07/13","大昌-樹林",21,1,20
"20300","6180橘子","110/07/13","元富-林園",1,18,-17
"20301","6180橘子","110/07/13","花旗環球",19,0,19
"20302","6180橘子","110/07/13","新光-新竹",1,18,-17
"20303","6180橘子","110/07/13","華南永昌-台南",19,0,19
"20304","6180橘子","110/07/13","元大-土城永寧",0,17,-17
"20305","6180橘子","110/07/13","福勝",14,0,14
"20306","6180橘子","110/07/13","國泰-新莊",3,19,-16
"20307","6180橘子","110/07/13","富邦-嘉義",12,1,11
"20308","6180橘子","110/07/13","中國信託-永康",6,21,-15
"20309","6180橘子","110/07/13","元大-板橋三民",11,0,11
"20310","6180橘子","110/07/13","凱基-東港",1,15,-14
"20311","2390云辰","110/07/13","新加坡商瑞銀",562,75,487
"20312","2390云辰","110/07/13","大展-台南",0,532,-532
"20313","2390云辰","110/07/13","台灣摩根士丹利",330,155,175
"20314","2390云辰","110/07/13","凱基-台北",668,854,-186
"20315","2390云辰","110/07/13","兆豐-公益",126,25,101
"20316","2390云辰","110/07/13","凱基-三重",12,172,-160
"20317","2390云辰","110/07/13","元富-中港",100,2,98
"20318","2390云辰","110/07/13","兆豐-忠孝",4,161,-157
"20319","2390云辰","110/07/13","統一-新台中",106,9,97
"20320","2390云辰","110/07/13","元大-士林",19,170,-151
"20321","2390云辰","110/07/13","中國信託-松江",81,11,70
"20322","2390云辰","110/07/13","臺銀-新竹",14,117,-103
"20323","2390云辰","110/07/13","日盛-板橋",72,3,69
"20324","2390云辰","110/07/13","國票-台中",4,102,-98
"20325","2390云辰","110/07/13","日盛-和美",57,0,57
"20326","2390云辰","110/07/13","新光",147,232,-85
"20327","2390云辰","110/07/13","永豐金-桃園",88,36,52
"20328","2390云辰","110/07/13","致和-崇德",2,70,-68
"20329","2390云辰","110/07/13","玉山-士林",54,4,50
"20330","2390云辰","110/07/13","群益金鼎-屏東",2,70,-68
"20331","2390云辰","110/07/13","富邦-仁愛",56,6,50
"20332","2390云辰","110/07/13","元大-大里",35,98,-63
"20333","2390云辰","110/07/13","第一金-豐原",50,1,49
"20334","2390云辰","110/07/13","元大-萬華",35,94,-59
"20335","2390云辰","110/07/13","摩根大通",502,453,49
"20336","2390云辰","110/07/13","元富-吉利",2,60,-58
"20337","2390云辰","110/07/13","凱基-松山",61,13,48
"20338","2390云辰","110/07/13","兆豐-新竹",3,53,-50
"20339","2390云辰","110/07/13","大昌",64,22,42
"20340","2390云辰","110/07/13","富邦-嘉義",65,108,-43
"20341","2363矽統","110/07/13","凱基-南崁",2133,63,2070
"20342","2363矽統","110/07/13","凱基-幸福",36,4048,-4012
"20343","2363矽統","110/07/13","國泰-敦南",2195,1617,578
"20344","2363矽統","110/07/13","統一",192,3325,-3133
"20345","2363矽統","110/07/13","中農",670,139,531
"20346","2363矽統","110/07/13","新加坡商瑞銀",1000,2747,-1747
"20347","2363矽統","110/07/13","康和-台中",638,154,484
"20348","2363矽統","110/07/13","凱基-台北",5359,6609,-1250
"20349","2363矽統","110/07/13","群益金鼎-三民",577,137,440
"20350","2363矽統","110/07/13","摩根大通",1930,2858,-928
"20351","2363矽統","110/07/13","台新-屏東",510,88,422
"20352","2363矽統","110/07/13","港商野村",960,1679,-719
"20353","2363矽統","110/07/13","德信-中正",455,67,388
"20354","2363矽統","110/07/13","兆豐-復興",25,705,-680
"20355","2363矽統","110/07/13","日盛-竹北",365,70,295
"20356","2363矽統","110/07/13","統一-仁愛",114,755,-641
"20357","2363矽統","110/07/13","元大-佳里",452,189,263
"20358","2363矽統","110/07/13","統一-敦南",29,638,-609
"20359","2363矽統","110/07/13","國票-博愛",296,38,258
"20360","2363矽統","110/07/13","統一-土城",100,704,-604
"20361","2363矽統","110/07/13","元大-萬華",340,95,245
"20362","2363矽統","110/07/13","統一-城中",116,676,-560
"20363","2363矽統","110/07/13","新光",1259,1031,228
"20364","2363矽統","110/07/13","永豐金證券",306,859,-553
"20365","2363矽統","110/07/13","元富-成功",323,96,227
"20366","2363矽統","110/07/13","元富",54,567,-513
"20367","2363矽統","110/07/13","豐農",228,23,205
"20368","2363矽統","110/07/13","瑞士信貸",202,666,-464
"20369","2363矽統","110/07/13","台灣企銀-岡山",186,4,182
"20370","2363矽統","110/07/13","永豐金-嘉義",67,468,-401
"20371","8112至上","110/07/13","摩根大通",688,296,392
"20372","8112至上","110/07/13","國票-中和",0,401,-401
"20373","8112至上","110/07/13","港商野村",344,145,199
"20374","8112至上","110/07/13","永豐金-板盛",0,205,-205
"20375","8112至上","110/07/13","兆豐-公益",195,5,190
"20376","8112至上","110/07/13","凱基-五股",43,155,-112
"20377","8112至上","110/07/13","台灣摩根士丹利",183,0,183
"20378","8112至上","110/07/13","凱基-市政",0,100,-100
"20379","8112至上","110/07/13","群益金鼎-敦南",153,2,151
"20380","8112至上","110/07/13","元大-大里德芳",1,92,-91
"20381","8112至上","110/07/13","臺銀-金山",146,26,120
"20382","8112至上","110/07/13","玉山-桃園",26,110,-84
"20383","8112至上","110/07/13","臺銀",133,19,114
"20384","8112至上","110/07/13","兆豐-天母",0,81,-81
"20385","8112至上","110/07/13","合庫-台中",115,6,109
"20386","8112至上","110/07/13","凱基-城中",3,84,-81
"20387","8112至上","110/07/13","亞東-板橋",134,26,108
"20388","8112至上","110/07/13","日盛-新莊",9,85,-76
"20389","8112至上","110/07/13","凱基-台北",414,326,88
"20390","8112至上","110/07/13","日盛-台中",2,64,-62
"20391","8112至上","110/07/13","新加坡商瑞銀",181,100,81
"20392","8112至上","110/07/13","日盛-中壢",3,64,-61
"20393","8112至上","110/07/13","國泰-敦南",108,31,77
"20394","8112至上","110/07/13","元大-台中",2,59,-57
"20395","8112至上","110/07/13","第一金-華江",77,4,73
"20396","8112至上","110/07/13","元大-雙和",7,64,-57
"20397","8112至上","110/07/13","永豐金-內湖",73,1,72
"20398","8112至上","110/07/13","元大-高雄",8,62,-54
"20399","8112至上","110/07/13","元大-永和",68,1,67
"20400","8112至上","110/07/13","元大-館前",2,55,-53
"20401","4903聯光通","110/07/13","台灣企銀-太平",56,0,56
"20402","4903聯光通","110/07/13","土銀",0,32,-32
"20403","4903聯光通","110/07/13","元富-新興",23,0,23
"20404","4903聯光通","110/07/13","元大-樹林",0,19,-19
"20405","4903聯光通","110/07/13","日盛-樹林",22,0,22
"20406","4903聯光通","110/07/13","凱基-士林",0,17,-17
"20407","4903聯光通","110/07/13","兆豐-天母",20,0,20
"20408","4903聯光通","110/07/13","國票-博愛",0,14,-14
"20409","4903聯光通","110/07/13","華南永昌-桃園",20,0,20
"20410","4903聯光通","110/07/13","元富",0,10,-10
"20411","4903聯光通","110/07/13","富邦-新店",10,0,10
"20412","4903聯光通","110/07/13","新光",0,10,-10
"20413","4903聯光通","110/07/13","新光-台中",5,0,5
"20414","4903聯光通","110/07/13","玉山-南京東路",0,10,-10
"20415","4903聯光通","110/07/13","華南永昌-台中",5,0,5
"20416","4903聯光通","110/07/13","富邦-陽明",0,10,-10
"20417","4903聯光通","110/07/13","元大-崇德",5,0,5
"20418","4903聯光通","110/07/13","元大-大甲",0,8,-8
"20419","4903聯光通","110/07/13","元大-草屯",5,0,5
"20420","4903聯光通","110/07/13","富邦-台中",0,7,-7
"20421","4903聯光通","110/07/13","元富-草屯",4,0,4
"20422","4903聯光通","110/07/13","凱基-中壢",0,6,-6
"20423","4903聯光通","110/07/13","元大-清水",4,0,4
"20424","4903聯光通","110/07/13","臺銀-民權",0,5,-5
"20425","4903聯光通","110/07/13","元大-東泰",4,0,4
"20426","4903聯光通","110/07/13","日盛-板橋",0,5,-5
"20427","4903聯光通","110/07/13","元大-佳里",2,0,2
"20428","4903聯光通","110/07/13","中國信託-忠孝",0,5,-5
"20429","4903聯光通","110/07/13","永豐金-板橋",2,0,2
"20430","4903聯光通","110/07/13","永豐金-鳳山",0,5,-5
"20431","2929淘帝","110/07/13","玉山-新竹",130,0,130
"20432","2929淘帝","110/07/13","美商高盛",0,177,-177
"20433","2929淘帝","110/07/13","臺銀-民權",60,0,60
"20434","2929淘帝","110/07/13","凱基-台北",6,80,-74
"20435","2929淘帝","110/07/13","新百王",31,0,31
"20436","2929淘帝","110/07/13","元富-大裕",0,49,-49
"20437","2929淘帝","110/07/13","日盛-園區",30,0,30
"20438","2929淘帝","110/07/13","國泰-館前",3,51,-48
"20439","2929淘帝","110/07/13","元大-南投",31,1,30
"20440","2929淘帝","110/07/13","凱基-中壢",0,41,-41
"20441","2929淘帝","110/07/13","兆豐-忠孝",28,0,28
"20442","2929淘帝","110/07/13","港商野村",21,55,-34
"20443","2929淘帝","110/07/13","元大-民生",28,0,28
"20444","2929淘帝","110/07/13","華南永昌-南京",2,34,-32
"20445","2929淘帝","110/07/13","合庫-高雄",27,0,27
"20446","2929淘帝","110/07/13","群益金鼎-土城",0,30,-30
"20447","2929淘帝","110/07/13","凱基-豐中",27,0,27
"20448","2929淘帝","110/07/13","富邦-南屯",0,22,-22
"20449","2929淘帝","110/07/13","新光",21,4,17
"20450","2929淘帝","110/07/13","第一金-豐原",0,20,-20
"20451","2929淘帝","110/07/13","元大-天母",17,0,17
"20452","2929淘帝","110/07/13","元大-屏南",6,26,-20
"20453","2929淘帝","110/07/13","永興",14,0,14
"20454","2929淘帝","110/07/13","永豐金-敦南",1,21,-20
"20455","2929淘帝","110/07/13","富邦-台北",12,0,12
"20456","2929淘帝","110/07/13","凱基-三重",2,21,-19
"20457","2929淘帝","110/07/13","元大-永和",12,0,12
"20458","2929淘帝","110/07/13","富邦-仁愛",7,25,-18
"20459","2929淘帝","110/07/13","國票-天祥",11,0,11
"20460","2929淘帝","110/07/13","元大-北投",0,16,-16
"20461","5410國眾","110/07/13","兆豐-城中",274,0,274
"20462","5410國眾","110/07/13","元富-嘉義",0,103,-103
"20463","5410國眾","110/07/13","新光",50,4,46
"20464","5410國眾","110/07/13","凱基-台北",0,50,-50
"20465","5410國眾","110/07/13","國泰-台中",26,0,26
"20466","5410國眾","110/07/13","瑞士信貸",0,31,-31
"20467","5410國眾","110/07/13","新加坡商瑞銀",22,0,22
"20468","5410國眾","110/07/13","台新-新莊",0,27,-27
"20469","5410國眾","110/07/13","光和-嘉義",20,0,20
"20470","5410國眾","110/07/13","元大-汐止",0,20,-20
"20471","5410國眾","110/07/13","凱基-竹北",17,0,17
"20472","5410國眾","110/07/13","亞東-新竹",0,17,-17
"20473","5410國眾","110/07/13","新光-桃園",15,0,15
"20474","5410國眾","110/07/13","元大-南勢角",0,13,-13
"20475","5410國眾","110/07/13","凱基-台東",14,0,14
"20476","5410國眾","110/07/13","台新-台南",0,12,-12
"20477","5410國眾","110/07/13","富邦-竹北",11,0,11
"20478","5410國眾","110/07/13","中國信託",0,11,-11
"20479","5410國眾","110/07/13","元富-同大",10,0,10
"20480","5410國眾","110/07/13","華南永昌",0,11,-11
"20481","5410國眾","110/07/13","國泰-敦南",24,15,9
"20482","5410國眾","110/07/13","臺銀-臺南",0,10,-10
"20483","5410國眾","110/07/13","日盛-內湖",7,0,7
"20484","5410國眾","110/07/13","台灣企銀-民雄",0,10,-10
"20485","5410國眾","110/07/13","台新-左楠",7,0,7
"20486","5410國眾","110/07/13","高橋",0,10,-10
"20487","5410國眾","110/07/13","元大-新盛",18,12,6
"20488","5410國眾","110/07/13","康和-嘉義",0,10,-10
"20489","5410國眾","110/07/13","統一",5,0,5
"20490","5410國眾","110/07/13","凱基-基隆",0,10,-10
"20491","2841台開","110/07/13","中國信託-高雄",251,50,201
"20492","2841台開","110/07/13","兆豐-公益",0,177,-177
"20493","2841台開","110/07/13","日盛證券",210,13,197
"20494","2841台開","110/07/13","日進",0,152,-152
"20495","2841台開","110/07/13","第一金-台中",55,0,55
"20496","2841台開","110/07/13","港商野村",0,109,-109
"20497","2841台開","110/07/13","國泰-板橋",46,0,46
"20498","2841台開","110/07/13","日盛-信義",0,103,-103
"20499","2841台開","110/07/13","國泰-館前",48,3,45
"20500","2841台開","110/07/13","國泰-敦南",11,75,-64
"20501","2841台開","110/07/13","華南永昌-新莊",45,0,45
"20502","2841台開","110/07/13","永興",0,50,-50
"20503","2841台開","110/07/13","日盛-園區",42,0,42
"20504","2841台開","110/07/13","永豐金-敦南",61,104,-43
"20505","2841台開","110/07/13","台新證券",32,0,32
"20506","2841台開","110/07/13","富邦-台南",0,42,-42
"20507","2841台開","110/07/13","台新-高雄",32,2,30
"20508","2841台開","110/07/13","國票-安和",0,30,-30
"20509","2841台開","110/07/13","豐農",23,0,23
"20510","2841台開","110/07/13","元大-桃園",0,25,-25
"20511","2841台開","110/07/13","合庫-嘉義",20,0,20
"20512","2841台開","110/07/13","新光",8,32,-24
"20513","2841台開","110/07/13","華南永昌-高雄",20,0,20
"20514","2841台開","110/07/13","元大-仁愛",0,24,-24
"20515","2841台開","110/07/13","元大-樹林",16,0,16
"20516","2841台開","110/07/13","日盛-中和",0,20,-20
"20517","2841台開","110/07/13","第一金-華江",15,2,13
"20518","2841台開","110/07/13","元富",0,20,-20
"20519","2841台開","110/07/13","美商高盛",12,0,12
"20520","2841台開","110/07/13","富邦-宜蘭",0,20,-20
"20521","6207雷科","110/07/13","元大-高雄",121,0,121
"20522","6207雷科","110/07/13","華南永昌-朴子",1,60,-59
"20523","6207雷科","110/07/13","第一金-新興",20,0,20
"20524","6207雷科","110/07/13","元大-南海",0,36,-36
"20525","6207雷科","110/07/13","元富-三重",20,0,20
"20526","6207雷科","110/07/13","凱基-土城",0,35,-35
"20527","6207雷科","110/07/13","元大-林園",15,0,15
"20528","6207雷科","110/07/13","台灣企銀",0,20,-20
"20529","6207雷科","110/07/13","元大-金華",16,1,15
"20530","6207雷科","110/07/13","群益金鼎-丹鳳",0,20,-20
"20531","6207雷科","110/07/13","日盛證券",10,0,10
"20532","6207雷科","110/07/13","元大-博愛",0,17,-17
"20533","6207雷科","110/07/13","統一-台中",10,0,10
"20534","6207雷科","110/07/13","元大-北港",0,13,-13
"20535","6207雷科","110/07/13","群益金鼎-土城",10,0,10
"20536","6207雷科","110/07/13","新加坡商瑞銀",0,12,-12
"20537","6207雷科","110/07/13","群益金鼎-桃園",10,0,10
"20538","6207雷科","110/07/13","凱基-台北",4,16,-12
"20539","6207雷科","110/07/13","永豐金-新莊",10,0,10
"20540","6207雷科","110/07/13","日茂-埔里",0,11,-11
"20541","6207雷科","110/07/13","永豐金-新店",10,0,10
"20542","6207雷科","110/07/13","元大-莒光",0,11,-11
"20543","6207雷科","110/07/13","元大證券",9,0,9
"20544","6207雷科","110/07/13","統一-新竹",0,10,-10
"20545","6207雷科","110/07/13","日盛-木柵",9,1,8
"20546","6207雷科","110/07/13","元大-西螺",0,10,-10
"20547","6207雷科","110/07/13","兆豐-來福",8,0,8
"20548","6207雷科","110/07/13","康和-台中",0,8,-8
"20549","6207雷科","110/07/13","新光",7,0,7
"20550","6207雷科","110/07/13","兆豐-高雄",0,6,-6
"20551","3679新至陞","110/07/13","永豐金證券",50,0,50
"20552","3679新至陞","110/07/13","摩根大通",2,25,-23
"20553","3679新至陞","110/07/13","國泰-桃園",22,0,22
"20554","3679新至陞","110/07/13","元大-成功",0,22,-22
"20555","3679新至陞","110/07/13","台中銀-員林",11,0,11
"20556","3679新至陞","110/07/13","富邦-板橋",1,19,-18
"20557","3679新至陞","110/07/13","元大-文心興安",8,0,8
"20558","3679新至陞","110/07/13","日盛-新莊",0,10,-10
"20559","3679新至陞","110/07/13","美商高盛",6,0,6
"20560","3679新至陞","110/07/13","台新-台中",0,10,-10
"20561","3679新至陞","110/07/13","台新-高雄",6,0,6
"20562","3679新至陞","110/07/13","永豐金-新竹",0,8,-8
"20563","3679新至陞","110/07/13","凱基-台北",18,12,6
"20564","3679新至陞","110/07/13","瑞士信貸",12,19,-7
"20565","3679新至陞","110/07/13","日盛-復興",5,0,5
"20566","3679新至陞","110/07/13","統一-南京",0,7,-7
"20567","3679新至陞","110/07/13","(牛牛牛)亞-鑫豐",4,0,4
"20568","3679新至陞","110/07/13","凱基-新莊",0,7,-7
"20569","3679新至陞","110/07/13","元富-大昌",3,0,3
"20570","3679新至陞","110/07/13","新加坡商瑞銀",0,6,-6
"20571","3679新至陞","110/07/13","富邦-台北",3,0,3
"20572","3679新至陞","110/07/13","合庫-自強",0,5,-5
"20573","3679新至陞","110/07/13","日盛-樹林",2,0,2
"20574","3679新至陞","110/07/13","富邦-桃園",0,5,-5
"20575","3679新至陞","110/07/13","宏遠-光隆",2,0,2
"20576","3679新至陞","110/07/13","永豐金-潮州",0,4,-4
"20577","3679新至陞","110/07/13","美林",3,1,2
"20578","3679新至陞","110/07/13","臺銀-臺南",0,3,-3
"20579","3679新至陞","110/07/13","第一金-中壢",2,0,2
"20580","3679新至陞","110/07/13","元大-六合",0,3,-3
"20581","2727王品","110/07/13","富邦-台北",43,3,40
"20582","2727王品","110/07/13","台灣摩根士丹利",15,97,-82
"20583","2727王品","110/07/13","元大-基隆孝二",40,0,40
"20584","2727王品","110/07/13","玉山-台南",5,57,-52
"20585","2727王品","110/07/13","國票-新莊",40,1,39
"20586","2727王品","110/07/13","新加坡商瑞銀",0,48,-48
"20587","2727王品","110/07/13","第一金-豐原",66,42,24
"20588","2727王品","110/07/13","凱基-台北",41,77,-36
"20589","2727王品","110/07/13","永豐金-大園",34,10,24
"20590","2727王品","110/07/13","永豐金-永康",0,22,-22
"20591","2727王品","110/07/13","元大-北屯",22,0,22
"20592","2727王品","110/07/13","統一-台中",2,22,-20
"20593","2727王品","110/07/13","元大-東蘆",26,7,19
"20594","2727王品","110/07/13","國泰-台中",21,39,-18
"20595","2727王品","110/07/13","永豐金-萬盛",13,1,12
"20596","2727王品","110/07/13","合庫-彰化",3,20,-17
"20597","2727王品","110/07/13","日盛-嘉義",11,0,11
"20598","2727王品","110/07/13","港商野村",13,30,-17
"20599","2727王品","110/07/13","日盛-八德",11,0,11
"20600","2727王品","110/07/13","元大-楊梅",1,16,-15
"20601","2727王品","110/07/13","統一-竹南",11,0,11
"20602","2727王品","110/07/13","凱基-高美館",2,15,-13
"20603","2727王品","110/07/13","日盛-士林",12,2,10
"20604","2727王品","110/07/13","美商高盛",2,14,-12
"20605","2727王品","110/07/13","統一-敦南",10,0,10
"20606","2727王品","110/07/13","統一-平鎮",1,13,-12
"20607","2727王品","110/07/13","中國信託",15,5,10
"20608","2727王品","110/07/13","兆豐-台中港",4,16,-12
"20609","2727王品","110/07/13","兆豐-竹北",13,3,10
"20610","2727王品","110/07/13","凱基-八德",1,13,-12
"20611","1570力肯","110/07/13","新光",115,11,104
"20612","1570力肯","110/07/13","元大-北三重",0,162,-162
"20613","1570力肯","110/07/13","群益金鼎-高雄",54,0,54
"20614","1570力肯","110/07/13","元大-大灣",0,25,-25
"20615","1570力肯","110/07/13","國票-新莊",22,0,22
"20616","1570力肯","110/07/13","永豐金-苓雅",0,22,-22
"20617","1570力肯","110/07/13","日盛-桃園",12,0,12
"20618","1570力肯","110/07/13","永豐金-永康",0,19,-19
"20619","1570力肯","110/07/13","元大-高雄",12,0,12
"20620","1570力肯","110/07/13","富邦-員林",0,15,-15
"20621","1570力肯","110/07/13","合庫-自強",11,0,11
"20622","1570力肯","110/07/13","凱基-台南",0,11,-11
"20623","1570力肯","110/07/13","摩根大通",26,15,11
"20624","1570力肯","110/07/13","日盛-竹北",0,10,-10
"20625","1570力肯","110/07/13","永豐金-中盛",11,0,11
"20626","1570力肯","110/07/13","國票-九鼎",0,10,-10
"20627","1570力肯","110/07/13","兆豐-台中港",10,0,10
"20628","1570力肯","110/07/13","凱基-桃園",0,10,-10
"20629","1570力肯","110/07/13","國泰-松江",9,0,9
"20630","1570力肯","110/07/13","凱基-新豐",0,10,-10
"20631","1570力肯","110/07/13","元大-新盛",9,0,9
"20632","1570力肯","110/07/13","元大-學甲",0,10,-10
"20633","1570力肯","110/07/13","元富-緯城",6,0,6
"20634","1570力肯","110/07/13","群益金鼎-東湖",1,10,-9
"20635","1570力肯","110/07/13","統一-三重",5,0,5
"20636","1570力肯","110/07/13","大昌",0,6,-6
"20637","1570力肯","110/07/13","元大-前金",5,0,5
"20638","1570力肯","110/07/13","元大-土城學府",0,6,-6
"20639","1570力肯","110/07/13","永豐金證券",5,0,5
"20640","1570力肯","110/07/13","統一",0,5,-5
"20641","6180橘子","110/07/13","摩根大通",119,0,119
"20642","6180橘子","110/07/13","元大-崇德",2,61,-59
"20643","6180橘子","110/07/13","美商高盛",96,0,96
"20644","6180橘子","110/07/13","康和-台中",0,51,-51
"20645","6180橘子","110/07/13","新加坡商瑞銀",86,7,79
"20646","6180橘子","110/07/13","康和-台北",0,50,-50
"20647","6180橘子","110/07/13","元大-和平",40,0,40
"20648","6180橘子","110/07/13","元富-潮州",0,40,-40
"20649","6180橘子","110/07/13","凱基-台北",83,47,36
"20650","6180橘子","110/07/13","日盛-永康",0,26,-26
"20651","6180橘子","110/07/13","美林",39,5,34
"20652","6180橘子","110/07/13","永豐金-中正",0,24,-24
"20653","6180橘子","110/07/13","富邦-新竹華信",31,2,29
"20654","6180橘子","110/07/13","國泰-板橋",2,25,-23
"20655","6180橘子","110/07/13","統一-南京",21,0,21
"20656","6180橘子","110/07/13","日盛-大墩",0,20,-20
"20657","6180橘子","110/07/13","富邦-陽明",24,3,21
"20658","6180橘子","110/07/13","元大-草屯",13,32,-19
"20659","6180橘子","110/07/13","大昌-樹林",21,1,20
"20660","6180橘子","110/07/13","元富-林園",1,18,-17
"20661","6180橘子","110/07/13","花旗環球",19,0,19
"20662","6180橘子","110/07/13","新光-新竹",1,18,-17
"20663","6180橘子","110/07/13","華南永昌-台南",19,0,19
"20664","6180橘子","110/07/13","元大-土城永寧",0,17,-17
"20665","6180橘子","110/07/13","福勝",14,0,14
"20666","6180橘子","110/07/13","國泰-新莊",3,19,-16
"20667","6180橘子","110/07/13","富邦-嘉義",12,1,11
"20668","6180橘子","110/07/13","中國信託-永康",6,21,-15
"20669","6180橘子","110/07/13","元大-板橋三民",11,0,11
"20670","6180橘子","110/07/13","凱基-東港",1,15,-14
"20671","2390云辰","110/07/13","新加坡商瑞銀",562,75,487
"20672","2390云辰","110/07/13","大展-台南",0,532,-532
"20673","2390云辰","110/07/13","台灣摩根士丹利",330,155,175
"20674","2390云辰","110/07/13","凱基-台北",668,854,-186
"20675","2390云辰","110/07/13","兆豐-公益",126,25,101
"20676","2390云辰","110/07/13","凱基-三重",12,172,-160
"20677","2390云辰","110/07/13","元富-中港",100,2,98
"20678","2390云辰","110/07/13","兆豐-忠孝",4,161,-157
"20679","2390云辰","110/07/13","統一-新台中",106,9,97
"20680","2390云辰","110/07/13","元大-士林",19,170,-151
"20681","2390云辰","110/07/13","中國信託-松江",81,11,70
"20682","2390云辰","110/07/13","臺銀-新竹",14,117,-103
"20683","2390云辰","110/07/13","日盛-板橋",72,3,69
"20684","2390云辰","110/07/13","國票-台中",4,102,-98
"20685","2390云辰","110/07/13","日盛-和美",57,0,57
"20686","2390云辰","110/07/13","新光",147,232,-85
"20687","2390云辰","110/07/13","永豐金-桃園",88,36,52
"20688","2390云辰","110/07/13","致和-崇德",2,70,-68
"20689","2390云辰","110/07/13","玉山-士林",54,4,50
"20690","2390云辰","110/07/13","群益金鼎-屏東",2,70,-68
"20691","2390云辰","110/07/13","富邦-仁愛",56,6,50
"20692","2390云辰","110/07/13","元大-大里",35,98,-63
"20693","2390云辰","110/07/13","第一金-豐原",50,1,49
"20694","2390云辰","110/07/13","元大-萬華",35,94,-59
"20695","2390云辰","110/07/13","摩根大通",502,453,49
"20696","2390云辰","110/07/13","元富-吉利",2,60,-58
"20697","2390云辰","110/07/13","凱基-松山",61,13,48
"20698","2390云辰","110/07/13","兆豐-新竹",3,53,-50
"20699","2390云辰","110/07/13","大昌",64,22,42
"20700","2390云辰","110/07/13","富邦-嘉義",65,108,-43
"20701","2363矽統","110/07/12","凱基-幸福",4046,31,4015
"20702","2363矽統","110/07/12","台新證券",478,2105,-1627
"20703","2363矽統","110/07/12","統一",3504,120,3384
"20704","2363矽統","110/07/12","第一金-忠孝",4,1068,-1064
"20705","2363矽統","110/07/12","摩根大通",3006,2149,857
"20706","2363矽統","110/07/12","台新-台中",381,1003,-622
"20707","2363矽統","110/07/12","永豐金證券",1428,610,818
"20708","2363矽統","110/07/12","新光",1295,1822,-527
"20709","2363矽統","110/07/12","兆豐-復興",1936,1233,703
"20710","2363矽統","110/07/12","大昌-樹林",54,537,-483
"20711","2363矽統","110/07/12","台灣摩根士丹利",701,0,701
"20712","2363矽統","110/07/12","華南永昌-台中",90,549,-459
"20713","2363矽統","110/07/12","永豐金-南投",803,145,658
"20714","2363矽統","110/07/12","玉山-高雄",167,612,-445
"20715","2363矽統","110/07/12","統一-仁愛",1214,586,628
"20716","2363矽統","110/07/12","元富-同大",201,540,-339
"20717","2363矽統","110/07/12","統一-土城",688,75,613
"20718","2363矽統","110/07/12","華南永昌-東勢",31,367,-336
"20719","2363矽統","110/07/12","統一-城中",711,131,580
"20720","2363矽統","110/07/12","土銀-花蓮",9,333,-324
"20721","2363矽統","110/07/12","統一-敦南",632,54,578
"20722","2363矽統","110/07/12","凱基-豐中",120,434,-314
"20723","2363矽統","110/07/12","新加坡商瑞銀",1232,731,501
"20724","2363矽統","110/07/12","永豐金-竹科",54,323,-269
"20725","2363矽統","110/07/12","元富",2640,2142,498
"20726","2363矽統","110/07/12","元大-斗六",53,300,-247
"20727","2363矽統","110/07/12","凱基-永和",460,31,429
"20728","2363矽統","110/07/12","華南永昌-朴子",47,278,-231
"20729","2363矽統","110/07/12","第一金",380,22,358
"20730","2363矽統","110/07/12","永豐金-彰化",22,228,-206
"20731","8112至上","110/07/12","摩根大通",1167,290,877
"20732","8112至上","110/07/12","群益金鼎-新莊",1,156,-155
"20733","8112至上","110/07/12","凱基-台北",983,546,437
"20734","8112至上","110/07/12","國票-中港",0,131,-131
"20735","8112至上","110/07/12","新加坡商瑞銀",429,12,417
"20736","8112至上","110/07/12","元大證券",10,136,-126
"20737","8112至上","110/07/12","元大-屏南",360,2,358
"20738","8112至上","110/07/12","元大-中壢",11,135,-124
"20739","8112至上","110/07/12","美林",323,15,308
"20740","8112至上","110/07/12","合庫-基隆",0,122,-122
"20741","8112至上","110/07/12","台灣摩根士丹利",299,0,299
"20742","8112至上","110/07/12","群益金鼎-高盛",4,103,-99
"20743","8112至上","110/07/12","港商野村",267,28,239
"20744","8112至上","110/07/12","新光",110,202,-92
"20745","8112至上","110/07/12","大慶",165,3,162
"20746","8112至上","110/07/12","元大-府城",2,94,-92
"20747","8112至上","110/07/12","永豐金-台南",170,29,141
"20748","8112至上","110/07/12","富邦-板橋",5,92,-87
"20749","8112至上","110/07/12","華南永昌-長虹",128,2,126
"20750","8112至上","110/07/12","元大-土城",8,89,-81
"20751","8112至上","110/07/12","富邦-仁愛",157,51,106
"20752","8112至上","110/07/12","日盛-頭份",40,117,-77
"20753","8112至上","110/07/12","瑞士信貸",104,0,104
"20754","8112至上","110/07/12","玉山-嘉義",3,80,-77
"20755","8112至上","110/07/12","凱基-站前",100,11,89
"20756","8112至上","110/07/12","永豐金-松山",4,79,-75
"20757","8112至上","110/07/12","富邦-北港",90,3,87
"20758","8112至上","110/07/12","元大-敦南",3,75,-72
"20759","8112至上","110/07/12","元大-北港",101,20,81
"20760","8112至上","110/07/12","元富-大裕",6,77,-71
"20761","4903聯光通","110/07/12","台灣企銀-太平",19,0,19
"20762","4903聯光通","110/07/12","玉山-南京東路",0,16,-16
"20763","4903聯光通","110/07/12","統一-土城",17,0,17
"20764","4903聯光通","110/07/12","新光",0,14,-14
"20765","4903聯光通","110/07/12","國票-博愛",14,0,14
"20766","4903聯光通","110/07/12","兆豐-彰化",0,10,-10
"20767","4903聯光通","110/07/12","新光-台中",15,2,13
"20768","4903聯光通","110/07/12","國票",0,10,-10
"20769","4903聯光通","110/07/12","元大-彰化",11,0,11
"20770","4903聯光通","110/07/12","富邦-敦南",0,10,-10
"20771","4903聯光通","110/07/12","華南永昌-林口",10,0,10
"20772","4903聯光通","110/07/12","元大-前金",0,9,-9
"20773","4903聯光通","110/07/12","永豐金-南投",9,0,9
"20774","4903聯光通","110/07/12","日盛-頭份",0,8,-8
"20775","4903聯光通","110/07/12","元大-清水",8,0,8
"20776","4903聯光通","110/07/12","元大-太平",0,8,-8
"20777","4903聯光通","110/07/12","元大-博愛",8,0,8
"20778","4903聯光通","110/07/12","兆豐-埔墘",0,7,-7
"20779","4903聯光通","110/07/12","玉山-新莊",5,0,5
"20780","4903聯光通","110/07/12","臺銀-民權",0,5,-5
"20781","4903聯光通","110/07/12","凱基-士林",10,5,5
"20782","4903聯光通","110/07/12","富邦-板橋",0,5,-5
"20783","4903聯光通","110/07/12","元大-斗六",4,0,4
"20784","4903聯光通","110/07/12","元大-土城永寧",0,5,-5
"20785","4903聯光通","110/07/12","永豐金-羅東",4,0,4
"20786","4903聯光通","110/07/12","台新證券",0,4,-4
"20787","4903聯光通","110/07/12","日盛-樹林",3,0,3
"20788","4903聯光通","110/07/12","凱基-中壢",0,4,-4
"20789","4903聯光通","110/07/12","華南永昌-鶯歌",2,0,2
"20790","4903聯光通","110/07/12","元大-羅東",0,4,-4
"20791","2929淘帝","110/07/12","新光-台中",95,36,59
"20792","2929淘帝","110/07/12","華南永昌-林口",7,208,-201
"20793","2929淘帝","110/07/12","富邦-板橋",62,5,57
"20794","2929淘帝","110/07/12","富邦-台北",6,200,-194
"20795","2929淘帝","110/07/12","合庫-高雄",56,6,50
"20796","2929淘帝","110/07/12","元富-大裕",11,200,-189
"20797","2929淘帝","110/07/12","永興",41,0,41
"20798","2929淘帝","110/07/12","台中銀-台北",0,160,-160
"20799","2929淘帝","110/07/12","兆豐-忠孝",58,18,40
"20800","2929淘帝","110/07/12","日盛-園區",1,111,-110
"20801","2929淘帝","110/07/12","新光-高雄",39,3,36
"20802","2929淘帝","110/07/12","日盛-八德",0,88,-88
"20803","2929淘帝","110/07/12","凱基-豐中",36,0,36
"20804","2929淘帝","110/07/12","玉山-新竹",32,110,-78
"20805","2929淘帝","110/07/12","元大-民生",35,0,35
"20806","2929淘帝","110/07/12","元大-前金",0,72,-72
"20807","2929淘帝","110/07/12","臺銀-臺南",32,1,31
"20808","2929淘帝","110/07/12","元大-館前",12,83,-71
"20809","2929淘帝","110/07/12","台新證券",44,13,31
"20810","2929淘帝","110/07/12","華南永昌",1,57,-56
"20811","2929淘帝","110/07/12","新百王",30,0,30
"20812","2929淘帝","110/07/12","元大-南崁",4,59,-55
"20813","2929淘帝","110/07/12","群益金鼎-大興",30,0,30
"20814","2929淘帝","110/07/12","元大-嘉義",0,51,-51
"20815","2929淘帝","110/07/12","凱基-台北",32,5,27
"20816","2929淘帝","110/07/12","日茂",1,50,-49
"20817","2929淘帝","110/07/12","元富-城東",26,0,26
"20818","2929淘帝","110/07/12","新光",35,83,-48
"20819","2929淘帝","110/07/12","國泰-松江",26,0,26
"20820","2929淘帝","110/07/12","日盛-新竹",1,48,-47
"20821","5410國眾","110/07/12","群益金鼎-中壢",68,0,68
"20822","5410國眾","110/07/12","摩根大通",6,67,-61
"20823","5410國眾","110/07/12","凱基-市政",40,0,40
"20824","5410國眾","110/07/12","元富-嘉義",0,60,-60
"20825","5410國眾","110/07/12","凱基-竹北",38,0,38
"20826","5410國眾","110/07/12","凱基-台北",0,51,-51
"20827","5410國眾","110/07/12","華南永昌-三重",30,0,30
"20828","5410國眾","110/07/12","元富-大裕",0,33,-33
"20829","5410國眾","110/07/12","永興",20,0,20
"20830","5410國眾","110/07/12","日盛-木柵",0,15,-15
"20831","5410國眾","110/07/12","統一-新台中",20,0,20
"20832","5410國眾","110/07/12","群益金鼎-民權",0,15,-15
"20833","5410國眾","110/07/12","兆豐-三重",20,0,20
"20834","5410國眾","110/07/12","元富-緯城",0,14,-14
"20835","5410國眾","110/07/12","富邦-台中",20,0,20
"20836","5410國眾","110/07/12","元大-大同",0,12,-12
"20837","5410國眾","110/07/12","臺銀",15,0,15
"20838","5410國眾","110/07/12","元大-莒光",0,10,-10
"20839","5410國眾","110/07/12","新光-桃園",20,6,14
"20840","5410國眾","110/07/12","元大-博愛",0,10,-10
"20841","5410國眾","110/07/12","元大-員林",12,0,12
"20842","5410國眾","110/07/12","日盛-永康",0,8,-8
"20843","5410國眾","110/07/12","日盛-員林",10,0,10
"20844","5410國眾","110/07/12","元大-四維",5,13,-8
"20845","5410國眾","110/07/12","元大-新盛",10,0,10
"20846","5410國眾","110/07/12","新加坡商瑞銀",0,7,-7
"20847","5410國眾","110/07/12","永豐金-台南",10,0,10
"20848","5410國眾","110/07/12","致和-金華",0,7,-7
"20849","5410國眾","110/07/12","元富-新莊",8,0,8
"20850","5410國眾","110/07/12","新光-新竹",0,7,-7
"20851","2841台開","110/07/12","永豐金-敦南",139,26,113
"20852","2841台開","110/07/12","華南永昌-朴子",0,528,-528
"20853","2841台開","110/07/12","日盛-雙和",68,0,68
"20854","2841台開","110/07/12","元大-苑裡",2,50,-48
"20855","2841台開","110/07/12","台新證券",62,4,58
"20856","2841台開","110/07/12","群益金鼎-東湖",0,40,-40
"20857","2841台開","110/07/12","凱基-文心",50,0,50
"20858","2841台開","110/07/12","第一金-員林",0,30,-30
"20859","2841台開","110/07/12","第一金-台中",45,0,45
"20860","2841台開","110/07/12","德信-中正",0,20,-20
"20861","2841台開","110/07/12","富邦-嘉義",40,0,40
"20862","2841台開","110/07/12","兆豐-嘉義",0,20,-20
"20863","2841台開","110/07/12","日盛-木柵",30,0,30
"20864","2841台開","110/07/12","彰銀-七賢",0,15,-15
"20865","2841台開","110/07/12","中國信託-文心",31,3,28
"20866","2841台開","110/07/12","元大-承德",0,14,-14
"20867","2841台開","110/07/12","元大-福營",30,7,23
"20868","2841台開","110/07/12","元富",0,12,-12
"20869","2841台開","110/07/12","台中銀",20,0,20
"20870","2841台開","110/07/12","富邦-陽明",0,11,-11
"20871","2841台開","110/07/12","國泰-板橋",20,0,20
"20872","2841台開","110/07/12","元大證券",0,11,-11
"20873","2841台開","110/07/12","元大-前金",20,0,20
"20874","2841台開","110/07/12","元大-大甲",0,10,-10
"20875","2841台開","110/07/12","中國信託-高雄",16,1,15
"20876","2841台開","110/07/12","日盛-新竹",0,8,-8
"20877","2841台開","110/07/12","陽信-石牌",15,0,15
"20878","2841台開","110/07/12","元富-城東",0,8,-8
"20879","2841台開","110/07/12","永豐金-南投",15,0,15
"20880","2841台開","110/07/12","玉山-台南",2,10,-8
"20881","6207雷科","110/07/12","元大-高雄",34,0,34
"20882","6207雷科","110/07/12","永豐金-三重",1,32,-31
"20883","6207雷科","110/07/12","華南永昌-林口",16,1,15
"20884","6207雷科","110/07/12","永全-八德",0,30,-30
"20885","6207雷科","110/07/12","摩根大通",19,6,13
"20886","6207雷科","110/07/12","國泰-台中",0,14,-14
"20887","6207雷科","110/07/12","元富-埔里",10,0,10
"20888","6207雷科","110/07/12","第一金-澎湖",0,10,-10
"20889","6207雷科","110/07/12","凱基-台南",10,0,10
"20890","6207雷科","110/07/12","元富-林園",0,10,-10
"20891","6207雷科","110/07/12","新加坡商瑞銀",9,0,9
"20892","6207雷科","110/07/12","元大-東門",0,10,-10
"20893","6207雷科","110/07/12","瑞士信貸",8,0,8
"20894","6207雷科","110/07/12","兆豐-嘉義",0,4,-4
"20895","6207雷科","110/07/12","中國信託-高雄",9,1,8
"20896","6207雷科","110/07/12","新光",0,4,-4
"20897","6207雷科","110/07/12","凱基-高雄",6,0,6
"20898","6207雷科","110/07/12","新光-台中",0,4,-4
"20899","6207雷科","110/07/12","元大-六合",6,0,6
"20900","6207雷科","110/07/12","群益金鼎-開元",0,4,-4
"20901","6207雷科","110/07/12","永豐金-信義",6,0,6
"20902","6207雷科","110/07/12","凱基-桃園",0,4,-4
"20903","6207雷科","110/07/12","群益金鼎-土城",5,0,5
"20904","6207雷科","110/07/12","凱基-民權",0,4,-4
"20905","6207雷科","110/07/12","群益金鼎-竹南",5,0,5
"20906","6207雷科","110/07/12","玉山-新莊",0,3,-3
"20907","6207雷科","110/07/12","元大-大灣",5,1,4
"20908","6207雷科","110/07/12","國泰-松江",0,3,-3
"20909","6207雷科","110/07/12","永興",3,0,3
"20910","6207雷科","110/07/12","富邦-羅東",0,3,-3
"20911","3679新至陞","110/07/12","富邦-新竹華信",40,2,38
"20912","3679新至陞","110/07/12","瑞士信貸",0,45,-45
"20913","3679新至陞","110/07/12","台中銀-員林",28,2,26
"20914","3679新至陞","110/07/12","永豐金-天母",0,39,-39
"20915","3679新至陞","110/07/12","聯邦-大業",24,0,24
"20916","3679新至陞","110/07/12","摩根大通",7,35,-28
"20917","3679新至陞","110/07/12","永豐金證券",20,0,20
"20918","3679新至陞","110/07/12","凱基-台北",8,36,-28
"20919","3679新至陞","110/07/12","港商法國興業",14,0,14
"20920","3679新至陞","110/07/12","華南永昌-小港",1,23,-22
"20921","3679新至陞","110/07/12","日盛-樹林",13,1,12
"20922","3679新至陞","110/07/12","台新-台中",0,15,-15
"20923","3679新至陞","110/07/12","國泰-桃園",9,0,9
"20924","3679新至陞","110/07/12","統一-台中",0,12,-12
"20925","3679新至陞","110/07/12","宏遠-館前",8,0,8
"20926","3679新至陞","110/07/12","元大-成功",1,12,-11
"20927","3679新至陞","110/07/12","凱基",10,2,8
"20928","3679新至陞","110/07/12","康和-澎湖",0,8,-8
"20929","3679新至陞","110/07/12","(牛牛牛)亞-網路",7,0,7
"20930","3679新至陞","110/07/12","新加坡商瑞銀",0,7,-7
"20931","3679新至陞","110/07/12","兆豐-員林",7,0,7
"20932","3679新至陞","110/07/12","兆豐-來福",0,7,-7
"20933","3679新至陞","110/07/12","大慶-蘆洲",5,0,5
"20934","3679新至陞","110/07/12","元大-佳里",0,6,-6
"20935","3679新至陞","110/07/12","土銀-花蓮",4,0,4
"20936","3679新至陞","110/07/12","美商高盛",0,5,-5
"20937","3679新至陞","110/07/12","台新-高雄",5,1,4
"20938","3679新至陞","110/07/12","國票-新莊",0,5,-5
"20939","3679新至陞","110/07/12","元大-天母",4,0,4
"20940","3679新至陞","110/07/12","台新-屏東",0,5,-5
"20941","2727王品","110/07/12","凱基-台北",354,198,156
"20942","2727王品","110/07/12","台灣摩根士丹利",5,386,-381
"20943","2727王品","110/07/12","統一-城中",159,22,137
"20944","2727王品","110/07/12","元大-嘉義",4,60,-56
"20945","2727王品","110/07/12","日盛-忠孝",60,0,60
"20946","2727王品","110/07/12","元大-大同",2,44,-42
"20947","2727王品","110/07/12","永豐金-忠孝",45,5,40
"20948","2727王品","110/07/12","國泰-台中",32,73,-41
"20949","2727王品","110/07/12","合庫-新竹",31,0,31
"20950","2727王品","110/07/12","元大證券",127,163,-36
"20951","2727王品","110/07/12","富邦-台中",31,3,28
"20952","2727王品","110/07/12","凱基",1,33,-32
"20953","2727王品","110/07/12","元大-桃園",35,10,25
"20954","2727王品","110/07/12","永全-南崁",1,31,-30
"20955","2727王品","110/07/12","新加坡商瑞銀",28,4,24
"20956","2727王品","110/07/12","凱基-和平",2,32,-30
"20957","2727王品","110/07/12","群益金鼎-古亭",25,2,23
"20958","2727王品","110/07/12","永豐金-大園",8,38,-30
"20959","2727王品","110/07/12","元大-龍潭",29,7,22
"20960","2727王品","110/07/12","瑞士信貸",0,28,-28
"20961","2727王品","110/07/12","永豐金-永康",25,3,22
"20962","2727王品","110/07/12","元富",17,44,-27
"20963","2727王品","110/07/12","富邦-竹北",24,3,21
"20964","2727王品","110/07/12","元大-北屯",5,32,-27
"20965","2727王品","110/07/12","群益金鼎-松山",20,0,20
"20966","2727王品","110/07/12","華南永昌",3,28,-25
"20967","2727王品","110/07/12","元大-八德",20,0,20
"20968","2727王品","110/07/12","統一-竹南",1,23,-22
"20969","2727王品","110/07/12","元大-南京",25,6,19
"20970","2727王品","110/07/12","永豐金證券",4,26,-22
"20971","1570力肯","110/07/12","國票-北高雄",40,0,40
"20972","1570力肯","110/07/12","日盛-竹北",0,40,-40
"20973","1570力肯","110/07/12","摩根大通",16,0,16
"20974","1570力肯","110/07/12","第一金-華江",1,38,-37
"20975","1570力肯","110/07/12","新光",31,19,12
"20976","1570力肯","110/07/12","元大-永春",0,26,-26
"20977","1570力肯","110/07/12","元大-台中中港",12,0,12
"20978","1570力肯","110/07/12","元大-古亭",1,20,-19
"20979","1570力肯","110/07/12","日盛-高雄",10,0,10
"20980","1570力肯","110/07/12","國泰-松江",0,16,-16
"20981","1570力肯","110/07/12","第一金-路竹",10,0,10
"20982","1570力肯","110/07/12","台新-台南",0,15,-15
"20983","1570力肯","110/07/12","台新-新莊",10,0,10
"20984","1570力肯","110/07/12","康和-石牌",0,15,-15
"20985","1570力肯","110/07/12","元大-新盛",9,0,9
"20986","1570力肯","110/07/12","國泰-板橋",0,11,-11
"20987","1570力肯","110/07/12","凱基-台北",8,0,8
"20988","1570力肯","110/07/12","元大-高雄",0,11,-11
"20989","1570力肯","110/07/12","彰銀-七賢",6,0,6
"20990","1570力肯","110/07/12","兆豐-桃園",0,10,-10
"20991","1570力肯","110/07/12","元富-緯城",6,0,6
"20992","1570力肯","110/07/12","元大-大益",0,10,-10
"20993","1570力肯","110/07/12","華南永昌-古亭",6,0,6
"20994","1570力肯","110/07/12","中國信託-文心",0,5,-5
"20995","1570力肯","110/07/12","富邦-陽明",6,0,6
"20996","1570力肯","110/07/12","光和",0,5,-5
"20997","1570力肯","110/07/12","臺銀-臺南",5,0,5
"20998","1570力肯","110/07/12","陽信-石牌",0,5,-5
"20999","1570力肯","110/07/12","宏遠-館前",5,0,5
"21000","1570力肯","110/07/12","國泰-高雄",0,5,-5
"21001","6180橘子","110/07/12","康和-台中",32,2,30
"21002","6180橘子","110/07/12","新百王",1,40,-39
"21003","6180橘子","110/07/12","美林",32,3,29
"21004","6180橘子","110/07/12","富邦-陽明",4,42,-38
"21005","6180橘子","110/07/12","元大-羅東",21,0,21
"21006","6180橘子","110/07/12","新光",3,32,-29
"21007","6180橘子","110/07/12","兆豐-埔墘",16,0,16
"21008","6180橘子","110/07/12","日盛-文化",4,20,-16
"21009","6180橘子","110/07/12","元大-雙和",12,0,12
"21010","6180橘子","110/07/12","華南永昌-鶯歌",0,15,-15
"21011","6180橘子","110/07/12","美商高盛",18,7,11
"21012","6180橘子","110/07/12","中國信託-忠孝",7,20,-13
"21013","6180橘子","110/07/12","台新證券",14,3,11
"21014","6180橘子","110/07/12","凱基-台北",5,17,-12
"21015","6180橘子","110/07/12","元大-中壢",12,1,11
"21016","6180橘子","110/07/12","凱基-高雄",0,11,-11
"21017","6180橘子","110/07/12","統一-南京",10,0,10
"21018","6180橘子","110/07/12","凱基-大安",0,10,-10
"21019","6180橘子","110/07/12","致和-崇德",10,0,10
"21020","6180橘子","110/07/12","元大-北屯",0,10,-10
"21021","6180橘子","110/07/12","玉山-板橋",10,0,10
"21022","6180橘子","110/07/12","元大-南京",0,9,-9
"21023","6180橘子","110/07/12","富邦-仁愛",10,0,10
"21024","6180橘子","110/07/12","元大-台南",1,10,-9
"21025","6180橘子","110/07/12","摩根大通",10,1,9
"21026","6180橘子","110/07/12","康和-澎湖",0,8,-8
"21027","6180橘子","110/07/12","元富-林園",8,0,8
"21028","6180橘子","110/07/12","第一金-台中",0,7,-7
"21029","6180橘子","110/07/12","大慶-富順",7,0,7
"21030","6180橘子","110/07/12","台新-台南",1,8,-7
"21031","2390云辰","110/07/12","統一-新台中",170,0,170
"21032","2390云辰","110/07/12","元大-天母",2,450,-448
"21033","2390云辰","110/07/12","華南永昌-麻豆",137,2,135
"21034","2390云辰","110/07/12","國泰-忠孝",1,143,-142
"21035","2390云辰","110/07/12","元富-成功",103,14,89
"21036","2390云辰","110/07/12","摩根大通",377,512,-135
"21037","2390云辰","110/07/12","元大-土城學府",146,69,77
"21038","2390云辰","110/07/12","台灣摩根士丹利",0,91,-91
"21039","2390云辰","110/07/12","永豐金-永康",76,4,72
"21040","2390云辰","110/07/12","美林",84,146,-62
"21041","2390云辰","110/07/12","台中銀",73,2,71
"21042","2390云辰","110/07/12","華南永昌-嘉義",2,61,-59
"21043","2390云辰","110/07/12","大昌",63,3,60
"21044","2390云辰","110/07/12","永豐金-羅東",0,49,-49
"21045","2390云辰","110/07/12","合庫-三重",50,0,50
"21046","2390云辰","110/07/12","玉山-台中",6,53,-47
"21047","2390云辰","110/07/12","元富-高雄",93,50,43
"21048","2390云辰","110/07/12","玉山-新莊",2,48,-46
"21049","2390云辰","110/07/12","元大-館前",40,4,36
"21050","2390云辰","110/07/12","元大-大里",7,52,-45
"21051","2390云辰","110/07/12","港商野村",143,109,34
"21052","2390云辰","110/07/12","元大-內湖",3,48,-45
"21053","2390云辰","110/07/12","元大-雙和",34,0,34
"21054","2390云辰","110/07/12","永豐金-市政",1,42,-41
"21055","2390云辰","110/07/12","群益金鼎-民權",33,2,31
"21056","2390云辰","110/07/12","元大-學甲",1,41,-40
"21057","2390云辰","110/07/12","日盛-八德",40,10,30
"21058","2390云辰","110/07/12","兆豐-高雄",2,41,-39
"21059","2390云辰","110/07/12","國票-嘉義",30,0,30
"21060","2390云辰","110/07/12","新加坡商瑞銀",21,59,-38
"21061","4903聯光通","110/07/12","台灣企銀-太平",19,0,19
"21062","4903聯光通","110/07/12","玉山-南京東路",0,16,-16
"21063","4903聯光通","110/07/12","統一-土城",17,0,17
"21064","4903聯光通","110/07/12","新光",0,14,-14
"21065","4903聯光通","110/07/12","國票-博愛",14,0,14
"21066","4903聯光通","110/07/12","兆豐-彰化",0,10,-10
"21067","4903聯光通","110/07/12","新光-台中",15,2,13
"21068","4903聯光通","110/07/12","國票",0,10,-10
"21069","4903聯光通","110/07/12","元大-彰化",11,0,11
"21070","4903聯光通","110/07/12","富邦-敦南",0,10,-10
"21071","4903聯光通","110/07/12","華南永昌-林口",10,0,10
"21072","4903聯光通","110/07/12","元大-前金",0,9,-9
"21073","4903聯光通","110/07/12","永豐金-南投",9,0,9
"21074","4903聯光通","110/07/12","日盛-頭份",0,8,-8
"21075","4903聯光通","110/07/12","元大-清水",8,0,8
"21076","4903聯光通","110/07/12","元大-太平",0,8,-8
"21077","4903聯光通","110/07/12","元大-博愛",8,0,8
"21078","4903聯光通","110/07/12","兆豐-埔墘",0,7,-7
"21079","4903聯光通","110/07/12","玉山-新莊",5,0,5
"21080","4903聯光通","110/07/12","臺銀-民權",0,5,-5
"21081","4903聯光通","110/07/12","凱基-士林",10,5,5
"21082","4903聯光通","110/07/12","富邦-板橋",0,5,-5
"21083","4903聯光通","110/07/12","元大-斗六",4,0,4
"21084","4903聯光通","110/07/12","元大-土城永寧",0,5,-5
"21085","4903聯光通","110/07/12","永豐金-羅東",4,0,4
"21086","4903聯光通","110/07/12","台新證券",0,4,-4
"21087","4903聯光通","110/07/12","日盛-樹林",3,0,3
"21088","4903聯光通","110/07/12","凱基-中壢",0,4,-4
"21089","4903聯光通","110/07/12","華南永昌-鶯歌",2,0,2
"21090","4903聯光通","110/07/12","元大-羅東",0,4,-4
"21091","2929淘帝","110/07/12","新光-台中",95,36,59
"21092","2929淘帝","110/07/12","華南永昌-林口",7,208,-201
"21093","2929淘帝","110/07/12","富邦-板橋",62,5,57
"21094","2929淘帝","110/07/12","富邦-台北",6,200,-194
"21095","2929淘帝","110/07/12","合庫-高雄",56,6,50
"21096","2929淘帝","110/07/12","元富-大裕",11,200,-189
"21097","2929淘帝","110/07/12","永興",41,0,41
"21098","2929淘帝","110/07/12","台中銀-台北",0,160,-160
"21099","2929淘帝","110/07/12","兆豐-忠孝",58,18,40
"21100","2929淘帝","110/07/12","日盛-園區",1,111,-110
"21101","2929淘帝","110/07/12","新光-高雄",39,3,36
"21102","2929淘帝","110/07/12","日盛-八德",0,88,-88
"21103","2929淘帝","110/07/12","凱基-豐中",36,0,36
"21104","2929淘帝","110/07/12","玉山-新竹",32,110,-78
"21105","2929淘帝","110/07/12","元大-民生",35,0,35
"21106","2929淘帝","110/07/12","元大-前金",0,72,-72
"21107","2929淘帝","110/07/12","臺銀-臺南",32,1,31
"21108","2929淘帝","110/07/12","元大-館前",12,83,-71
"21109","2929淘帝","110/07/12","台新證券",44,13,31
"21110","2929淘帝","110/07/12","華南永昌",1,57,-56
"21111","2929淘帝","110/07/12","新百王",30,0,30
"21112","2929淘帝","110/07/12","元大-南崁",4,59,-55
"21113","2929淘帝","110/07/12","群益金鼎-大興",30,0,30
"21114","2929淘帝","110/07/12","元大-嘉義",0,51,-51
"21115","2929淘帝","110/07/12","凱基-台北",32,5,27
"21116","2929淘帝","110/07/12","日茂",1,50,-49
"21117","2929淘帝","110/07/12","元富-城東",26,0,26
"21118","2929淘帝","110/07/12","新光",35,83,-48
"21119","2929淘帝","110/07/12","國泰-松江",26,0,26
"21120","2929淘帝","110/07/12","日盛-新竹",1,48,-47
"21121","5410國眾","110/07/12","群益金鼎-中壢",68,0,68
"21122","5410國眾","110/07/12","摩根大通",6,67,-61
"21123","5410國眾","110/07/12","凱基-市政",40,0,40
"21124","5410國眾","110/07/12","元富-嘉義",0,60,-60
"21125","5410國眾","110/07/12","凱基-竹北",38,0,38
"21126","5410國眾","110/07/12","凱基-台北",0,51,-51
"21127","5410國眾","110/07/12","華南永昌-三重",30,0,30
"21128","5410國眾","110/07/12","元富-大裕",0,33,-33
"21129","5410國眾","110/07/12","永興",20,0,20
"21130","5410國眾","110/07/12","日盛-木柵",0,15,-15
"21131","5410國眾","110/07/12","統一-新台中",20,0,20
"21132","5410國眾","110/07/12","群益金鼎-民權",0,15,-15
"21133","5410國眾","110/07/12","兆豐-三重",20,0,20
"21134","5410國眾","110/07/12","元富-緯城",0,14,-14
"21135","5410國眾","110/07/12","富邦-台中",20,0,20
"21136","5410國眾","110/07/12","元大-大同",0,12,-12
"21137","5410國眾","110/07/12","臺銀",15,0,15
"21138","5410國眾","110/07/12","元大-莒光",0,10,-10
"21139","5410國眾","110/07/12","新光-桃園",20,6,14
"21140","5410國眾","110/07/12","元大-博愛",0,10,-10
"21141","5410國眾","110/07/12","元大-員林",12,0,12
"21142","5410國眾","110/07/12","日盛-永康",0,8,-8
"21143","5410國眾","110/07/12","日盛-員林",10,0,10
"21144","5410國眾","110/07/12","元大-四維",5,13,-8
"21145","5410國眾","110/07/12","元大-新盛",10,0,10
"21146","5410國眾","110/07/12","新加坡商瑞銀",0,7,-7
"21147","5410國眾","110/07/12","永豐金-台南",10,0,10
"21148","5410國眾","110/07/12","致和-金華",0,7,-7
"21149","5410國眾","110/07/12","元富-新莊",8,0,8
"21150","5410國眾","110/07/12","新光-新竹",0,7,-7
"21151","2841台開","110/07/12","永豐金-敦南",139,26,113
"21152","2841台開","110/07/12","華南永昌-朴子",0,528,-528
"21153","2841台開","110/07/12","日盛-雙和",68,0,68
"21154","2841台開","110/07/12","元大-苑裡",2,50,-48
"21155","2841台開","110/07/12","台新證券",62,4,58
"21156","2841台開","110/07/12","群益金鼎-東湖",0,40,-40
"21157","2841台開","110/07/12","凱基-文心",50,0,50
"21158","2841台開","110/07/12","第一金-員林",0,30,-30
"21159","2841台開","110/07/12","第一金-台中",45,0,45
"21160","2841台開","110/07/12","德信-中正",0,20,-20
"21161","2841台開","110/07/12","富邦-嘉義",40,0,40
"21162","2841台開","110/07/12","兆豐-嘉義",0,20,-20
"21163","2841台開","110/07/12","日盛-木柵",30,0,30
"21164","2841台開","110/07/12","彰銀-七賢",0,15,-15
"21165","2841台開","110/07/12","中國信託-文心",31,3,28
"21166","2841台開","110/07/12","元大-承德",0,14,-14
"21167","2841台開","110/07/12","元大-福營",30,7,23
"21168","2841台開","110/07/12","元富",0,12,-12
"21169","2841台開","110/07/12","台中銀",20,0,20
"21170","2841台開","110/07/12","富邦-陽明",0,11,-11
"21171","2841台開","110/07/12","國泰-板橋",20,0,20
"21172","2841台開","110/07/12","元大證券",0,11,-11
"21173","2841台開","110/07/12","元大-前金",20,0,20
"21174","2841台開","110/07/12","元大-大甲",0,10,-10
"21175","2841台開","110/07/12","中國信託-高雄",16,1,15
"21176","2841台開","110/07/12","日盛-新竹",0,8,-8
"21177","2841台開","110/07/12","陽信-石牌",15,0,15
"21178","2841台開","110/07/12","元富-城東",0,8,-8
"21179","2841台開","110/07/12","永豐金-南投",15,0,15
"21180","2841台開","110/07/12","玉山-台南",2,10,-8
"21181","6207雷科","110/07/12","元大-高雄",34,0,34
"21182","6207雷科","110/07/12","永豐金-三重",1,32,-31
"21183","6207雷科","110/07/12","華南永昌-林口",16,1,15
"21184","6207雷科","110/07/12","永全-八德",0,30,-30
"21185","6207雷科","110/07/12","摩根大通",19,6,13
"21186","6207雷科","110/07/12","國泰-台中",0,14,-14
"21187","6207雷科","110/07/12","元富-埔里",10,0,10
"21188","6207雷科","110/07/12","第一金-澎湖",0,10,-10
"21189","6207雷科","110/07/12","凱基-台南",10,0,10
"21190","6207雷科","110/07/12","元富-林園",0,10,-10
"21191","6207雷科","110/07/12","新加坡商瑞銀",9,0,9
"21192","6207雷科","110/07/12","元大-東門",0,10,-10
"21193","6207雷科","110/07/12","瑞士信貸",8,0,8
"21194","6207雷科","110/07/12","兆豐-嘉義",0,4,-4
"21195","6207雷科","110/07/12","中國信託-高雄",9,1,8
"21196","6207雷科","110/07/12","新光",0,4,-4
"21197","6207雷科","110/07/12","凱基-高雄",6,0,6
"21198","6207雷科","110/07/12","新光-台中",0,4,-4
"21199","6207雷科","110/07/12","元大-六合",6,0,6
"21200","6207雷科","110/07/12","群益金鼎-開元",0,4,-4
"21201","6207雷科","110/07/12","永豐金-信義",6,0,6
"21202","6207雷科","110/07/12","凱基-桃園",0,4,-4
"21203","6207雷科","110/07/12","群益金鼎-土城",5,0,5
"21204","6207雷科","110/07/12","凱基-民權",0,4,-4
"21205","6207雷科","110/07/12","群益金鼎-竹南",5,0,5
"21206","6207雷科","110/07/12","玉山-新莊",0,3,-3
"21207","6207雷科","110/07/12","元大-大灣",5,1,4
"21208","6207雷科","110/07/12","國泰-松江",0,3,-3
"21209","6207雷科","110/07/12","永興",3,0,3
"21210","6207雷科","110/07/12","富邦-羅東",0,3,-3
"21211","3679新至陞","110/07/12","富邦-新竹華信",40,2,38
"21212","3679新至陞","110/07/12","瑞士信貸",0,45,-45
"21213","3679新至陞","110/07/12","台中銀-員林",28,2,26
"21214","3679新至陞","110/07/12","永豐金-天母",0,39,-39
"21215","3679新至陞","110/07/12","聯邦-大業",24,0,24
"21216","3679新至陞","110/07/12","摩根大通",7,35,-28
"21217","3679新至陞","110/07/12","永豐金證券",20,0,20
"21218","3679新至陞","110/07/12","凱基-台北",8,36,-28
"21219","3679新至陞","110/07/12","港商法國興業",14,0,14
"21220","3679新至陞","110/07/12","華南永昌-小港",1,23,-22
"21221","3679新至陞","110/07/12","日盛-樹林",13,1,12
"21222","3679新至陞","110/07/12","台新-台中",0,15,-15
"21223","3679新至陞","110/07/12","國泰-桃園",9,0,9
"21224","3679新至陞","110/07/12","統一-台中",0,12,-12
"21225","3679新至陞","110/07/12","宏遠-館前",8,0,8
"21226","3679新至陞","110/07/12","元大-成功",1,12,-11
"21227","3679新至陞","110/07/12","凱基",10,2,8
"21228","3679新至陞","110/07/12","康和-澎湖",0,8,-8
"21229","3679新至陞","110/07/12","(牛牛牛)亞-網路",7,0,7
"21230","3679新至陞","110/07/12","新加坡商瑞銀",0,7,-7
"21231","3679新至陞","110/07/12","兆豐-員林",7,0,7
"21232","3679新至陞","110/07/12","兆豐-來福",0,7,-7
"21233","3679新至陞","110/07/12","大慶-蘆洲",5,0,5
"21234","3679新至陞","110/07/12","元大-佳里",0,6,-6
"21235","3679新至陞","110/07/12","土銀-花蓮",4,0,4
"21236","3679新至陞","110/07/12","美商高盛",0,5,-5
"21237","3679新至陞","110/07/12","台新-高雄",5,1,4
"21238","3679新至陞","110/07/12","國票-新莊",0,5,-5
"21239","3679新至陞","110/07/12","元大-天母",4,0,4
"21240","3679新至陞","110/07/12","台新-屏東",0,5,-5
"21241","2727王品","110/07/12","凱基-台北",354,198,156
"21242","2727王品","110/07/12","台灣摩根士丹利",5,386,-381
"21243","2727王品","110/07/12","統一-城中",159,22,137
"21244","2727王品","110/07/12","元大-嘉義",4,60,-56
"21245","2727王品","110/07/12","日盛-忠孝",60,0,60
"21246","2727王品","110/07/12","元大-大同",2,44,-42
"21247","2727王品","110/07/12","永豐金-忠孝",45,5,40
"21248","2727王品","110/07/12","國泰-台中",32,73,-41
"21249","2727王品","110/07/12","合庫-新竹",31,0,31
"21250","2727王品","110/07/12","元大證券",127,163,-36
"21251","2727王品","110/07/12","富邦-台中",31,3,28
"21252","2727王品","110/07/12","凱基",1,33,-32
"21253","2727王品","110/07/12","元大-桃園",35,10,25
"21254","2727王品","110/07/12","永全-南崁",1,31,-30
"21255","2727王品","110/07/12","新加坡商瑞銀",28,4,24
"21256","2727王品","110/07/12","凱基-和平",2,32,-30
"21257","2727王品","110/07/12","群益金鼎-古亭",25,2,23
"21258","2727王品","110/07/12","永豐金-大園",8,38,-30
"21259","2727王品","110/07/12","元大-龍潭",29,7,22
"21260","2727王品","110/07/12","瑞士信貸",0,28,-28
"21261","2727王品","110/07/12","永豐金-永康",25,3,22
"21262","2727王品","110/07/12","元富",17,44,-27
"21263","2727王品","110/07/12","富邦-竹北",24,3,21
"21264","2727王品","110/07/12","元大-北屯",5,32,-27
"21265","2727王品","110/07/12","群益金鼎-松山",20,0,20
"21266","2727王品","110/07/12","華南永昌",3,28,-25
"21267","2727王品","110/07/12","元大-八德",20,0,20
"21268","2727王品","110/07/12","統一-竹南",1,23,-22
"21269","2727王品","110/07/12","元大-南京",25,6,19
"21270","2727王品","110/07/12","永豐金證券",4,26,-22
"21271","1570力肯","110/07/12","國票-北高雄",40,0,40
"21272","1570力肯","110/07/12","日盛-竹北",0,40,-40
"21273","1570力肯","110/07/12","摩根大通",16,0,16
"21274","1570力肯","110/07/12","第一金-華江",1,38,-37
"21275","1570力肯","110/07/12","新光",31,19,12
"21276","1570力肯","110/07/12","元大-永春",0,26,-26
"21277","1570力肯","110/07/12","元大-台中中港",12,0,12
"21278","1570力肯","110/07/12","元大-古亭",1,20,-19
"21279","1570力肯","110/07/12","日盛-高雄",10,0,10
"21280","1570力肯","110/07/12","國泰-松江",0,16,-16
"21281","1570力肯","110/07/12","第一金-路竹",10,0,10
"21282","1570力肯","110/07/12","台新-台南",0,15,-15
"21283","1570力肯","110/07/12","台新-新莊",10,0,10
"21284","1570力肯","110/07/12","康和-石牌",0,15,-15
"21285","1570力肯","110/07/12","元大-新盛",9,0,9
"21286","1570力肯","110/07/12","國泰-板橋",0,11,-11
"21287","1570力肯","110/07/12","凱基-台北",8,0,8
"21288","1570力肯","110/07/12","元大-高雄",0,11,-11
"21289","1570力肯","110/07/12","彰銀-七賢",6,0,6
"21290","1570力肯","110/07/12","兆豐-桃園",0,10,-10
"21291","1570力肯","110/07/12","元富-緯城",6,0,6
"21292","1570力肯","110/07/12","元大-大益",0,10,-10
"21293","1570力肯","110/07/12","華南永昌-古亭",6,0,6
"21294","1570力肯","110/07/12","中國信託-文心",0,5,-5
"21295","1570力肯","110/07/12","富邦-陽明",6,0,6
"21296","1570力肯","110/07/12","光和",0,5,-5
"21297","1570力肯","110/07/12","臺銀-臺南",5,0,5
"21298","1570力肯","110/07/12","陽信-石牌",0,5,-5
"21299","1570力肯","110/07/12","宏遠-館前",5,0,5
"21300","1570力肯","110/07/12","國泰-高雄",0,5,-5
"21301","6180橘子","110/07/12","康和-台中",32,2,30
"21302","6180橘子","110/07/12","新百王",1,40,-39
"21303","6180橘子","110/07/12","美林",32,3,29
"21304","6180橘子","110/07/12","富邦-陽明",4,42,-38
"21305","6180橘子","110/07/12","元大-羅東",21,0,21
"21306","6180橘子","110/07/12","新光",3,32,-29
"21307","6180橘子","110/07/12","兆豐-埔墘",16,0,16
"21308","6180橘子","110/07/12","日盛-文化",4,20,-16
"21309","6180橘子","110/07/12","元大-雙和",12,0,12
"21310","6180橘子","110/07/12","華南永昌-鶯歌",0,15,-15
"21311","6180橘子","110/07/12","美商高盛",18,7,11
"21312","6180橘子","110/07/12","中國信託-忠孝",7,20,-13
"21313","6180橘子","110/07/12","台新證券",14,3,11
"21314","6180橘子","110/07/12","凱基-台北",5,17,-12
"21315","6180橘子","110/07/12","元大-中壢",12,1,11
"21316","6180橘子","110/07/12","凱基-高雄",0,11,-11
"21317","6180橘子","110/07/12","統一-南京",10,0,10
"21318","6180橘子","110/07/12","凱基-大安",0,10,-10
"21319","6180橘子","110/07/12","致和-崇德",10,0,10
"21320","6180橘子","110/07/12","元大-北屯",0,10,-10
"21321","6180橘子","110/07/12","玉山-板橋",10,0,10
"21322","6180橘子","110/07/12","元大-南京",0,9,-9
"21323","6180橘子","110/07/12","富邦-仁愛",10,0,10
"21324","6180橘子","110/07/12","元大-台南",1,10,-9
"21325","6180橘子","110/07/12","摩根大通",10,1,9
"21326","6180橘子","110/07/12","康和-澎湖",0,8,-8
"21327","6180橘子","110/07/12","元富-林園",8,0,8
"21328","6180橘子","110/07/12","第一金-台中",0,7,-7
"21329","6180橘子","110/07/12","大慶-富順",7,0,7
"21330","6180橘子","110/07/12","台新-台南",1,8,-7
"21331","2390云辰","110/07/12","統一-新台中",170,0,170
"21332","2390云辰","110/07/12","元大-天母",2,450,-448
"21333","2390云辰","110/07/12","華南永昌-麻豆",137,2,135
"21334","2390云辰","110/07/12","國泰-忠孝",1,143,-142
"21335","2390云辰","110/07/12","元富-成功",103,14,89
"21336","2390云辰","110/07/12","摩根大通",377,512,-135
"21337","2390云辰","110/07/12","元大-土城學府",146,69,77
"21338","2390云辰","110/07/12","台灣摩根士丹利",0,91,-91
"21339","2390云辰","110/07/12","永豐金-永康",76,4,72
"21340","2390云辰","110/07/12","美林",84,146,-62
"21341","2390云辰","110/07/12","台中銀",73,2,71
"21342","2390云辰","110/07/12","華南永昌-嘉義",2,61,-59
"21343","2390云辰","110/07/12","大昌",63,3,60
"21344","2390云辰","110/07/12","永豐金-羅東",0,49,-49
"21345","2390云辰","110/07/12","合庫-三重",50,0,50
"21346","2390云辰","110/07/12","玉山-台中",6,53,-47
"21347","2390云辰","110/07/12","元富-高雄",93,50,43
"21348","2390云辰","110/07/12","玉山-新莊",2,48,-46
"21349","2390云辰","110/07/12","元大-館前",40,4,36
"21350","2390云辰","110/07/12","元大-大里",7,52,-45
"21351","2390云辰","110/07/12","港商野村",143,109,34
"21352","2390云辰","110/07/12","元大-內湖",3,48,-45
"21353","2390云辰","110/07/12","元大-雙和",34,0,34
"21354","2390云辰","110/07/12","永豐金-市政",1,42,-41
"21355","2390云辰","110/07/12","群益金鼎-民權",33,2,31
"21356","2390云辰","110/07/12","元大-學甲",1,41,-40
"21357","2390云辰","110/07/12","日盛-八德",40,10,30
"21358","2390云辰","110/07/12","兆豐-高雄",2,41,-39
"21359","2390云辰","110/07/12","國票-嘉義",30,0,30
"21360","2390云辰","110/07/12","新加坡商瑞銀",21,59,-38
"21361","4903聯光通","110/07/09","元大-敦南",10,0,10
"21362","4903聯光通","110/07/09","第一金-台中",0,12,-12
"21363","4903聯光通","110/07/09","凱基-士林",5,0,5
"21364","4903聯光通","110/07/09","日盛-忠孝",0,3,-3
"21365","4903聯光通","110/07/09","元大-苗栗",5,0,5
"21366","4903聯光通","110/07/09","群益金鼎-崇德",0,3,-3
"21367","4903聯光通","110/07/09","元大-屏南",3,0,3
"21368","4903聯光通","110/07/09","國票-內壢",0,2,-2
"21369","4903聯光通","110/07/09","中國信託-永康",1,0,1
"21370","4903聯光通","110/07/09","康和-南崁",0,2,-2
"21371","4903聯光通","110/07/09","玉山證券",1,0,1
"21372","4903聯光通","110/07/09","新光-台中",0,2,-2
"21373","4903聯光通","110/07/09","元大-太平",4,3,1
"21374","4903聯光通","110/07/09","玉山-城中",0,2,-2
"21375","4903聯光通","110/07/09","永豐金-嘉義",1,0,1
"21376","4903聯光通","110/07/09","中國信託-文心",0,1,-1
"21377","4903聯光通","110/07/09","大昌",0,0,0
"21378","4903聯光通","110/07/09","大昌",0,0,0
"21379","4903聯光通","110/07/09","中農",0,0,0
"21380","4903聯光通","110/07/09","中農",0,0,0
"21381","4903聯光通","110/07/09","",NA,NA,NA
"21382","4903聯光通","110/07/09","",NA,NA,NA
"21383","4903聯光通","110/07/09","",NA,NA,NA
"21384","4903聯光通","110/07/09","",NA,NA,NA
"21385","4903聯光通","110/07/09","",NA,NA,NA
"21386","4903聯光通","110/07/09","",NA,NA,NA
"21387","4903聯光通","110/07/09","",NA,NA,NA
"21388","4903聯光通","110/07/09","",NA,NA,NA
"21389","4903聯光通","110/07/09","",NA,NA,NA
"21390","4903聯光通","110/07/09","",NA,NA,NA
"21391","2929淘帝","110/07/09","台中銀-台北",110,0,110
"21392","2929淘帝","110/07/09","新光",2,82,-80
"21393","2929淘帝","110/07/09","華南永昌-頭份",72,0,72
"21394","2929淘帝","110/07/09","摩根大通",2,63,-61
"21395","2929淘帝","110/07/09","合庫-高雄",71,0,71
"21396","2929淘帝","110/07/09","第一金-路竹",0,50,-50
"21397","2929淘帝","110/07/09","高橋-龍潭",37,0,37
"21398","2929淘帝","110/07/09","港商麥格理",0,42,-42
"21399","2929淘帝","110/07/09","新光-台中",60,26,34
"21400","2929淘帝","110/07/09","陽信-石牌",0,40,-40
"21401","2929淘帝","110/07/09","元富-大裕",22,1,21
"21402","2929淘帝","110/07/09","台新-左楠",1,39,-38
"21403","2929淘帝","110/07/09","合庫-鳳山",20,0,20
"21404","2929淘帝","110/07/09","凱基-桃園",3,29,-26
"21405","2929淘帝","110/07/09","元大-員林",22,2,20
"21406","2929淘帝","110/07/09","兆豐-內湖",0,25,-25
"21407","2929淘帝","110/07/09","台新-建北",15,0,15
"21408","2929淘帝","110/07/09","元大-北港",0,20,-20
"21409","2929淘帝","110/07/09","兆豐-桃園",13,0,13
"21410","2929淘帝","110/07/09","富邦-北港",0,19,-19
"21411","2929淘帝","110/07/09","兆豐-忠孝",10,0,10
"21412","2929淘帝","110/07/09","富邦-花蓮",0,17,-17
"21413","2929淘帝","110/07/09","國票-敦北法人",10,0,10
"21414","2929淘帝","110/07/09","國泰-台中",2,17,-15
"21415","2929淘帝","110/07/09","永豐金-博愛",10,0,10
"21416","2929淘帝","110/07/09","群益金鼎-彰化",0,15,-15
"21417","2929淘帝","110/07/09","群益金鼎-潭子",8,0,8
"21418","2929淘帝","110/07/09","元大-博愛",0,14,-14
"21419","2929淘帝","110/07/09","富邦-南屯",8,0,8
"21420","2929淘帝","110/07/09","日盛-板橋",0,13,-13
"21421","5410國眾","110/07/09","元大-新盛",14,0,14
"21422","5410國眾","110/07/09","(牛牛牛)亞-鑫豐",1,41,-40
"21423","5410國眾","110/07/09","台灣企銀-民雄",10,0,10
"21424","5410國眾","110/07/09","元富-嘉義",0,25,-25
"21425","5410國眾","110/07/09","元富-虎尾",9,0,9
"21426","5410國眾","110/07/09","凱基-高美館",0,10,-10
"21427","5410國眾","110/07/09","摩根大通",10,1,9
"21428","5410國眾","110/07/09","凱基-城中",0,10,-10
"21429","5410國眾","110/07/09","兆豐-北高雄",7,0,7
"21430","5410國眾","110/07/09","元大-頭份",0,10,-10
"21431","5410國眾","110/07/09","凱基-台北",8,1,7
"21432","5410國眾","110/07/09","群益金鼎-丹鳳",0,7,-7
"21433","5410國眾","110/07/09","華南永昌-公誠",7,0,7
"21434","5410國眾","110/07/09","凱基-復興",0,7,-7
"21435","5410國眾","110/07/09","香港上海匯豐",6,0,6
"21436","5410國眾","110/07/09","元大-員林",0,7,-7
"21437","5410國眾","110/07/09","凱基-中壢",6,0,6
"21438","5410國眾","110/07/09","富邦-竹東",0,6,-6
"21439","5410國眾","110/07/09","華南永昌-南京",6,0,6
"21440","5410國眾","110/07/09","亞東-高雄",0,5,-5
"21441","5410國眾","110/07/09","統一-三重",5,0,5
"21442","5410國眾","110/07/09","大慶-中壢",1,6,-5
"21443","5410國眾","110/07/09","富邦-宜蘭",5,0,5
"21444","5410國眾","110/07/09","群益金鼎-中港",0,5,-5
"21445","5410國眾","110/07/09","元大-崇德",5,0,5
"21446","5410國眾","110/07/09","元大-八德",0,5,-5
"21447","5410國眾","110/07/09","元大-博愛",5,0,5
"21448","5410國眾","110/07/09","富邦-基隆",0,4,-4
"21449","5410國眾","110/07/09","元大-龍潭",5,0,5
"21450","5410國眾","110/07/09","臺銀-新竹",0,3,-3
"21451","2841台開","110/07/09","日盛-雙和",102,0,102
"21452","2841台開","110/07/09","港商野村",0,129,-129
"21453","2841台開","110/07/09","元大-館前",70,0,70
"21454","2841台開","110/07/09","兆豐-永和",0,100,-100
"21455","2841台開","110/07/09","凱基-文心",50,0,50
"21456","2841台開","110/07/09","台新證券",7,28,-21
"21457","2841台開","110/07/09","富邦-嘉義",40,0,40
"21458","2841台開","110/07/09","國票-北高雄",0,20,-20
"21459","2841台開","110/07/09","美商高盛",15,0,15
"21460","2841台開","110/07/09","永豐金-敦南",29,46,-17
"21461","2841台開","110/07/09","台中銀",15,0,15
"21462","2841台開","110/07/09","合庫-基隆",0,12,-12
"21463","2841台開","110/07/09","新光",11,0,11
"21464","2841台開","110/07/09","中國信託-松江",0,12,-12
"21465","2841台開","110/07/09","華南永昌-長虹",10,0,10
"21466","2841台開","110/07/09","兆豐-城中",0,12,-12
"21467","2841台開","110/07/09","永豐金-南投",10,0,10
"21468","2841台開","110/07/09","台中銀-豐原",0,10,-10
"21469","2841台開","110/07/09","合庫-桃園",7,0,7
"21470","2841台開","110/07/09","兆豐-景美",0,10,-10
"21471","2841台開","110/07/09","群益金鼎-古亭",7,0,7
"21472","2841台開","110/07/09","群益金鼎-基隆",0,10,-10
"21473","2841台開","110/07/09","國泰-敦南",6,0,6
"21474","2841台開","110/07/09","元大-北三重",0,10,-10
"21475","2841台開","110/07/09","凱基-桃園",8,2,6
"21476","2841台開","110/07/09","(牛牛牛)亞-網路",0,9,-9
"21477","2841台開","110/07/09","日盛證券",5,0,5
"21478","2841台開","110/07/09","台新-高雄",1,10,-9
"21479","2841台開","110/07/09","元富-文心",5,0,5
"21480","2841台開","110/07/09","凱基-台北",0,7,-7
"21481","6207雷科","110/07/09","群益金鼎-新竹",47,0,47
"21482","6207雷科","110/07/09","新光",7,24,-17
"21483","6207雷科","110/07/09","永豐金-三重",31,0,31
"21484","6207雷科","110/07/09","日盛-和美",0,15,-15
"21485","6207雷科","110/07/09","新加坡商瑞銀",33,5,28
"21486","6207雷科","110/07/09","國泰-台南",0,15,-15
"21487","6207雷科","110/07/09","元大-高雄",26,0,26
"21488","6207雷科","110/07/09","華南永昌-古亭",0,14,-14
"21489","6207雷科","110/07/09","統一-員林",22,0,22
"21490","6207雷科","110/07/09","土銀-白河",0,11,-11
"21491","6207雷科","110/07/09","台新-高雄",22,0,22
"21492","6207雷科","110/07/09","日盛-台南",0,10,-10
"21493","6207雷科","110/07/09","摩根大通",34,17,17
"21494","6207雷科","110/07/09","元富-林園",0,10,-10
"21495","6207雷科","110/07/09","元大-博愛",17,1,16
"21496","6207雷科","110/07/09","富邦-園區",0,10,-10
"21497","6207雷科","110/07/09","日茂-埔里",12,0,12
"21498","6207雷科","110/07/09","元大-上新莊",0,10,-10
"21499","6207雷科","110/07/09","國泰-台中",17,6,11
"21500","6207雷科","110/07/09","永豐金-南京",0,10,-10
"21501","6207雷科","110/07/09","富邦-三重",10,0,10
"21502","6207雷科","110/07/09","兆豐-小港",0,6,-6
"21503","6207雷科","110/07/09","元大-沙鹿",10,0,10
"21504","6207雷科","110/07/09","富邦-羅東",1,7,-6
"21505","6207雷科","110/07/09","元大-八德",10,0,10
"21506","6207雷科","110/07/09","元大-土城永寧",0,6,-6
"21507","6207雷科","110/07/09","第一金-路竹",11,2,9
"21508","6207雷科","110/07/09","永豐金-板盛",0,6,-6
"21509","6207雷科","110/07/09","統一-南京",5,0,5
"21510","6207雷科","110/07/09","日盛-板橋",0,5,-5
"21511","3679新至陞","110/07/09","元大-大天母",10,0,10
"21512","3679新至陞","110/07/09","第一金-光復",0,11,-11
"21513","3679新至陞","110/07/09","日盛-樹林",9,0,9
"21514","3679新至陞","110/07/09","瑞士信貸",0,8,-8
"21515","3679新至陞","110/07/09","凱基-台北",11,2,9
"21516","3679新至陞","110/07/09","大慶-苗栗",0,5,-5
"21517","3679新至陞","110/07/09","華南永昌-小港",8,0,8
"21518","3679新至陞","110/07/09","元大-永春",0,5,-5
"21519","3679新至陞","110/07/09","兆豐-來福",7,0,7
"21520","3679新至陞","110/07/09","日盛-和美",0,4,-4
"21521","3679新至陞","110/07/09","香港上海匯豐",5,0,5
"21522","3679新至陞","110/07/09","元大-雙和",0,3,-3
"21523","3679新至陞","110/07/09","台中銀-員林",3,0,3
"21524","3679新至陞","110/07/09","永豐金-屏東",0,3,-3
"21525","3679新至陞","110/07/09","新光",3,0,3
"21526","3679新至陞","110/07/09","彰銀",0,2,-2
"21527","3679新至陞","110/07/09","土銀-花蓮",2,0,2
"21528","3679新至陞","110/07/09","宏遠-館前",0,2,-2
"21529","3679新至陞","110/07/09","第一金-澎湖",2,0,2
"21530","3679新至陞","110/07/09","港商野村",0,2,-2
"21531","3679新至陞","110/07/09","摩根大通",2,0,2
"21532","3679新至陞","110/07/09","大昌-新店",0,2,-2
"21533","3679新至陞","110/07/09","國泰-敦南",2,0,2
"21534","3679新至陞","110/07/09","元大-新莊",0,2,-2
"21535","3679新至陞","110/07/09","元大-淡水",4,2,2
"21536","3679新至陞","110/07/09","元大-板橋",0,2,-2
"21537","3679新至陞","110/07/09","日盛-士林",1,0,1
"21538","3679新至陞","110/07/09","台灣摩根士丹利",0,1,-1
"21539","3679新至陞","110/07/09","日盛-信義",1,0,1
"21540","3679新至陞","110/07/09","第一金-高雄",0,1,-1
"21541","2727王品","110/07/09","台灣匯立證券",90,0,90
"21542","2727王品","110/07/09","台灣摩根士丹利",0,267,-267
"21543","2727王品","110/07/09","國泰-敦南",166,84,82
"21544","2727王品","110/07/09","富邦-台北",35,299,-264
"21545","2727王品","110/07/09","富邦-仁愛",56,12,44
"21546","2727王品","110/07/09","凱基-台北",174,296,-122
"21547","2727王品","110/07/09","台新證券",109,66,43
"21548","2727王品","110/07/09","第一金",2,102,-100
"21549","2727王品","110/07/09","新光",117,87,30
"21550","2727王品","110/07/09","群益金鼎-大安",0,80,-80
"21551","2727王品","110/07/09","臺銀-臺中",35,6,29
"21552","2727王品","110/07/09","兆豐-大安",7,60,-53
"21553","2727王品","110/07/09","元大-桃園",32,3,29
"21554","2727王品","110/07/09","永豐金-南投",0,50,-50
"21555","2727王品","110/07/09","元富-宜蘭",34,6,28
"21556","2727王品","110/07/09","新加坡商瑞銀",6,46,-40
"21557","2727王品","110/07/09","玉山-台中",34,8,26
"21558","2727王品","110/07/09","合庫-彰化",11,50,-39
"21559","2727王品","110/07/09","群益金鼎-宜蘭",30,4,26
"21560","2727王品","110/07/09","永豐金-萬盛",13,52,-39
"21561","2727王品","110/07/09","富邦-台中",42,16,26
"21562","2727王品","110/07/09","瑞士信貸",0,34,-34
"21563","2727王品","110/07/09","第一金-豐原",25,1,24
"21564","2727王品","110/07/09","元大-和平",4,35,-31
"21565","2727王品","110/07/09","臺銀",30,8,22
"21566","2727王品","110/07/09","美林",14,44,-30
"21567","2727王品","110/07/09","兆豐-來福",23,1,22
"21568","2727王品","110/07/09","元大-員林",9,38,-29
"21569","2727王品","110/07/09","玉山-士林",22,2,20
"21570","2727王品","110/07/09","元富-西松",4,31,-27
"21571","1570力肯","110/07/09","凱基-台北",30,1,29
"21572","1570力肯","110/07/09","群益金鼎-彰化",0,20,-20
"21573","1570力肯","110/07/09","新光-台南",20,0,20
"21574","1570力肯","110/07/09","元大-土城學府",0,20,-20
"21575","1570力肯","110/07/09","元大-高雄",20,0,20
"21576","1570力肯","110/07/09","元大-大統",0,16,-16
"21577","1570力肯","110/07/09","國票-中正",12,0,12
"21578","1570力肯","110/07/09","元大-新營",0,11,-11
"21579","1570力肯","110/07/09","日盛-高雄",6,0,6
"21580","1570力肯","110/07/09","元大-和平",0,10,-10
"21581","1570力肯","110/07/09","元富-緯城",6,0,6
"21582","1570力肯","110/07/09","元大-草屯",0,10,-10
"21583","1570力肯","110/07/09","群益金鼎-台南",6,0,6
"21584","1570力肯","110/07/09","元大-鹿港",0,9,-9
"21585","1570力肯","110/07/09","華南永昌-岡山",6,0,6
"21586","1570力肯","110/07/09","合庫-基隆",0,7,-7
"21587","1570力肯","110/07/09","統一-中壢",5,0,5
"21588","1570力肯","110/07/09","摩根大通",2,8,-6
"21589","1570力肯","110/07/09","凱基-三峽",5,0,5
"21590","1570力肯","110/07/09","台灣企銀-豐原",0,4,-4
"21591","1570力肯","110/07/09","大昌-樹林",4,0,4
"21592","1570力肯","110/07/09","日盛-桃園",0,4,-4
"21593","1570力肯","110/07/09","新光",3,0,3
"21594","1570力肯","110/07/09","國泰-高雄",0,3,-3
"21595","1570力肯","110/07/09","富邦-新竹華信",3,0,3
"21596","1570力肯","110/07/09","永豐金-敦南",0,3,-3
"21597","1570力肯","110/07/09","合庫-台中",2,0,2
"21598","1570力肯","110/07/09","土銀-彰化",0,2,-2
"21599","1570力肯","110/07/09","臺銀-臺中",2,0,2
"21600","1570力肯","110/07/09","臺銀-鳳山",0,2,-2
"21601","6180橘子","110/07/09","摩根大通",63,1,62
"21602","6180橘子","110/07/09","元大-南京",1,32,-31
"21603","6180橘子","110/07/09","富邦-陽明",73,33,40
"21604","6180橘子","110/07/09","群益金鼎-台北",0,25,-25
"21605","6180橘子","110/07/09","新加坡商瑞銀",31,0,31
"21606","6180橘子","110/07/09","兆豐-復興",0,21,-21
"21607","6180橘子","110/07/09","美商高盛",25,0,25
"21608","6180橘子","110/07/09","永豐金-嘉義",0,21,-21
"21609","6180橘子","110/07/09","凱基-台北",26,10,16
"21610","6180橘子","110/07/09","凱基-中壢",8,24,-16
"21611","6180橘子","110/07/09","華南永昌-楠梓",13,0,13
"21612","6180橘子","110/07/09","致和-崇德",0,15,-15
"21613","6180橘子","110/07/09","華南永昌-朴子",11,0,11
"21614","6180橘子","110/07/09","群益金鼎-屏東",0,15,-15
"21615","6180橘子","110/07/09","元大-北港",11,0,11
"21616","6180橘子","110/07/09","群益金鼎-中山",0,15,-15
"21617","6180橘子","110/07/09","元大-成功",10,1,9
"21618","6180橘子","110/07/09","瑞士信貸",1,15,-14
"21619","6180橘子","110/07/09","新光",26,18,8
"21620","6180橘子","110/07/09","日盛-二林",0,10,-10
"21621","6180橘子","110/07/09","統一-三重",6,0,6
"21622","6180橘子","110/07/09","凱基-東門",0,10,-10
"21623","6180橘子","110/07/09","群益金鼎-嘉義",6,0,6
"21624","6180橘子","110/07/09","華南永昌-三重",0,10,-10
"21625","6180橘子","110/07/09","元大-員林中山",6,0,6
"21626","6180橘子","110/07/09","元大-彰化民生",1,11,-10
"21627","6180橘子","110/07/09","合庫-鳳山",5,0,5
"21628","6180橘子","110/07/09","永豐金-新店",1,11,-10
"21629","6180橘子","110/07/09","富邦-建國",6,1,5
"21630","6180橘子","110/07/09","群益金鼎-丹鳳",0,8,-8
"21631","2390云辰","110/07/09","摩根大通",279,56,223
"21632","2390云辰","110/07/09","元大-天母",0,127,-127
"21633","2390云辰","110/07/09","日盛-鳳山",110,2,108
"21634","2390云辰","110/07/09","中國信託-文心",5,109,-104
"21635","2390云辰","110/07/09","宏遠證券",100,0,100
"21636","2390云辰","110/07/09","永豐金-復興",0,55,-55
"21637","2390云辰","110/07/09","元大-大里",63,6,57
"21638","2390云辰","110/07/09","凱基-台北",239,286,-47
"21639","2390云辰","110/07/09","凱基-八德",59,10,49
"21640","2390云辰","110/07/09","德信",2,32,-30
"21641","2390云辰","110/07/09","合庫-新竹",40,0,40
"21642","2390云辰","110/07/09","兆豐-桃鶯",2,32,-30
"21643","2390云辰","110/07/09","國票",40,1,39
"21644","2390云辰","110/07/09","致和-南京",0,30,-30
"21645","2390云辰","110/07/09","新加坡商瑞銀",49,13,36
"21646","2390云辰","110/07/09","富邦-虎尾",1,31,-30
"21647","2390云辰","110/07/09","統一-新台中",36,2,34
"21648","2390云辰","110/07/09","元大-善化",2,31,-29
"21649","2390云辰","110/07/09","國票-嘉義",31,0,31
"21650","2390云辰","110/07/09","富邦-板橋",0,27,-27
"21651","2390云辰","110/07/09","華南永昌",35,7,28
"21652","2390云辰","110/07/09","富邦-永和",3,28,-25
"21653","2390云辰","110/07/09","玉山-台中",49,22,27
"21654","2390云辰","110/07/09","第一金-自由",20,44,-24
"21655","2390云辰","110/07/09","華南永昌-敦南",25,0,25
"21656","2390云辰","110/07/09","凱基-內湖",0,24,-24
"21657","2390云辰","110/07/09","新光-高雄",27,4,23
"21658","2390云辰","110/07/09","元大-汐止",1,24,-23
"21659","2390云辰","110/07/09","台灣摩根士丹利",85,63,22
"21660","2390云辰","110/07/09","新光-台中",12,33,-21
"21661","4903聯光通","110/07/09","元大-敦南",10,0,10
"21662","4903聯光通","110/07/09","第一金-台中",0,12,-12
"21663","4903聯光通","110/07/09","凱基-士林",5,0,5
"21664","4903聯光通","110/07/09","日盛-忠孝",0,3,-3
"21665","4903聯光通","110/07/09","元大-苗栗",5,0,5
"21666","4903聯光通","110/07/09","群益金鼎-崇德",0,3,-3
"21667","4903聯光通","110/07/09","元大-屏南",3,0,3
"21668","4903聯光通","110/07/09","國票-內壢",0,2,-2
"21669","4903聯光通","110/07/09","中國信託-永康",1,0,1
"21670","4903聯光通","110/07/09","康和-南崁",0,2,-2
"21671","4903聯光通","110/07/09","玉山證券",1,0,1
"21672","4903聯光通","110/07/09","新光-台中",0,2,-2
"21673","4903聯光通","110/07/09","元大-太平",4,3,1
"21674","4903聯光通","110/07/09","玉山-城中",0,2,-2
"21675","4903聯光通","110/07/09","永豐金-嘉義",1,0,1
"21676","4903聯光通","110/07/09","中國信託-文心",0,1,-1
"21677","4903聯光通","110/07/09","大昌",0,0,0
"21678","4903聯光通","110/07/09","大昌",0,0,0
"21679","4903聯光通","110/07/09","中農",0,0,0
"21680","4903聯光通","110/07/09","中農",0,0,0
"21681","4903聯光通","110/07/09","",NA,NA,NA
"21682","4903聯光通","110/07/09","",NA,NA,NA
"21683","4903聯光通","110/07/09","",NA,NA,NA
"21684","4903聯光通","110/07/09","",NA,NA,NA
"21685","4903聯光通","110/07/09","",NA,NA,NA
"21686","4903聯光通","110/07/09","",NA,NA,NA
"21687","4903聯光通","110/07/09","",NA,NA,NA
"21688","4903聯光通","110/07/09","",NA,NA,NA
"21689","4903聯光通","110/07/09","",NA,NA,NA
"21690","4903聯光通","110/07/09","",NA,NA,NA
"21691","2929淘帝","110/07/09","台中銀-台北",110,0,110
"21692","2929淘帝","110/07/09","新光",2,82,-80
"21693","2929淘帝","110/07/09","華南永昌-頭份",72,0,72
"21694","2929淘帝","110/07/09","摩根大通",2,63,-61
"21695","2929淘帝","110/07/09","合庫-高雄",71,0,71
"21696","2929淘帝","110/07/09","第一金-路竹",0,50,-50
"21697","2929淘帝","110/07/09","高橋-龍潭",37,0,37
"21698","2929淘帝","110/07/09","港商麥格理",0,42,-42
"21699","2929淘帝","110/07/09","新光-台中",60,26,34
"21700","2929淘帝","110/07/09","陽信-石牌",0,40,-40
"21701","2929淘帝","110/07/09","元富-大裕",22,1,21
"21702","2929淘帝","110/07/09","台新-左楠",1,39,-38
"21703","2929淘帝","110/07/09","合庫-鳳山",20,0,20
"21704","2929淘帝","110/07/09","凱基-桃園",3,29,-26
"21705","2929淘帝","110/07/09","元大-員林",22,2,20
"21706","2929淘帝","110/07/09","兆豐-內湖",0,25,-25
"21707","2929淘帝","110/07/09","台新-建北",15,0,15
"21708","2929淘帝","110/07/09","元大-北港",0,20,-20
"21709","2929淘帝","110/07/09","兆豐-桃園",13,0,13
"21710","2929淘帝","110/07/09","富邦-北港",0,19,-19
"21711","2929淘帝","110/07/09","兆豐-忠孝",10,0,10
"21712","2929淘帝","110/07/09","富邦-花蓮",0,17,-17
"21713","2929淘帝","110/07/09","國票-敦北法人",10,0,10
"21714","2929淘帝","110/07/09","國泰-台中",2,17,-15
"21715","2929淘帝","110/07/09","永豐金-博愛",10,0,10
"21716","2929淘帝","110/07/09","群益金鼎-彰化",0,15,-15
"21717","2929淘帝","110/07/09","群益金鼎-潭子",8,0,8
"21718","2929淘帝","110/07/09","元大-博愛",0,14,-14
"21719","2929淘帝","110/07/09","富邦-南屯",8,0,8
"21720","2929淘帝","110/07/09","日盛-板橋",0,13,-13
"21721","5410國眾","110/07/09","元大-新盛",14,0,14
"21722","5410國眾","110/07/09","(牛牛牛)亞-鑫豐",1,41,-40
"21723","5410國眾","110/07/09","台灣企銀-民雄",10,0,10
"21724","5410國眾","110/07/09","元富-嘉義",0,25,-25
"21725","5410國眾","110/07/09","元富-虎尾",9,0,9
"21726","5410國眾","110/07/09","凱基-高美館",0,10,-10
"21727","5410國眾","110/07/09","摩根大通",10,1,9
"21728","5410國眾","110/07/09","凱基-城中",0,10,-10
"21729","5410國眾","110/07/09","兆豐-北高雄",7,0,7
"21730","5410國眾","110/07/09","元大-頭份",0,10,-10
"21731","5410國眾","110/07/09","凱基-台北",8,1,7
"21732","5410國眾","110/07/09","群益金鼎-丹鳳",0,7,-7
"21733","5410國眾","110/07/09","華南永昌-公誠",7,0,7
"21734","5410國眾","110/07/09","凱基-復興",0,7,-7
"21735","5410國眾","110/07/09","香港上海匯豐",6,0,6
"21736","5410國眾","110/07/09","元大-員林",0,7,-7
"21737","5410國眾","110/07/09","凱基-中壢",6,0,6
"21738","5410國眾","110/07/09","富邦-竹東",0,6,-6
"21739","5410國眾","110/07/09","華南永昌-南京",6,0,6
"21740","5410國眾","110/07/09","亞東-高雄",0,5,-5
"21741","5410國眾","110/07/09","統一-三重",5,0,5
"21742","5410國眾","110/07/09","大慶-中壢",1,6,-5
"21743","5410國眾","110/07/09","富邦-宜蘭",5,0,5
"21744","5410國眾","110/07/09","群益金鼎-中港",0,5,-5
"21745","5410國眾","110/07/09","元大-崇德",5,0,5
"21746","5410國眾","110/07/09","元大-八德",0,5,-5
"21747","5410國眾","110/07/09","元大-博愛",5,0,5
"21748","5410國眾","110/07/09","富邦-基隆",0,4,-4
"21749","5410國眾","110/07/09","元大-龍潭",5,0,5
"21750","5410國眾","110/07/09","臺銀-新竹",0,3,-3
"21751","2841台開","110/07/09","日盛-雙和",102,0,102
"21752","2841台開","110/07/09","港商野村",0,129,-129
"21753","2841台開","110/07/09","元大-館前",70,0,70
"21754","2841台開","110/07/09","兆豐-永和",0,100,-100
"21755","2841台開","110/07/09","凱基-文心",50,0,50
"21756","2841台開","110/07/09","台新證券",7,28,-21
"21757","2841台開","110/07/09","富邦-嘉義",40,0,40
"21758","2841台開","110/07/09","國票-北高雄",0,20,-20
"21759","2841台開","110/07/09","美商高盛",15,0,15
"21760","2841台開","110/07/09","永豐金-敦南",29,46,-17
"21761","2841台開","110/07/09","台中銀",15,0,15
"21762","2841台開","110/07/09","合庫-基隆",0,12,-12
"21763","2841台開","110/07/09","新光",11,0,11
"21764","2841台開","110/07/09","中國信託-松江",0,12,-12
"21765","2841台開","110/07/09","華南永昌-長虹",10,0,10
"21766","2841台開","110/07/09","兆豐-城中",0,12,-12
"21767","2841台開","110/07/09","永豐金-南投",10,0,10
"21768","2841台開","110/07/09","台中銀-豐原",0,10,-10
"21769","2841台開","110/07/09","合庫-桃園",7,0,7
"21770","2841台開","110/07/09","兆豐-景美",0,10,-10
"21771","2841台開","110/07/09","群益金鼎-古亭",7,0,7
"21772","2841台開","110/07/09","群益金鼎-基隆",0,10,-10
"21773","2841台開","110/07/09","國泰-敦南",6,0,6
"21774","2841台開","110/07/09","元大-北三重",0,10,-10
"21775","2841台開","110/07/09","凱基-桃園",8,2,6
"21776","2841台開","110/07/09","(牛牛牛)亞-網路",0,9,-9
"21777","2841台開","110/07/09","日盛證券",5,0,5
"21778","2841台開","110/07/09","台新-高雄",1,10,-9
"21779","2841台開","110/07/09","元富-文心",5,0,5
"21780","2841台開","110/07/09","凱基-台北",0,7,-7
"21781","6207雷科","110/07/09","群益金鼎-新竹",47,0,47
"21782","6207雷科","110/07/09","新光",7,24,-17
"21783","6207雷科","110/07/09","永豐金-三重",31,0,31
"21784","6207雷科","110/07/09","日盛-和美",0,15,-15
"21785","6207雷科","110/07/09","新加坡商瑞銀",33,5,28
"21786","6207雷科","110/07/09","國泰-台南",0,15,-15
"21787","6207雷科","110/07/09","元大-高雄",26,0,26
"21788","6207雷科","110/07/09","華南永昌-古亭",0,14,-14
"21789","6207雷科","110/07/09","統一-員林",22,0,22
"21790","6207雷科","110/07/09","土銀-白河",0,11,-11
"21791","6207雷科","110/07/09","台新-高雄",22,0,22
"21792","6207雷科","110/07/09","日盛-台南",0,10,-10
"21793","6207雷科","110/07/09","摩根大通",34,17,17
"21794","6207雷科","110/07/09","元富-林園",0,10,-10
"21795","6207雷科","110/07/09","元大-博愛",17,1,16
"21796","6207雷科","110/07/09","富邦-園區",0,10,-10
"21797","6207雷科","110/07/09","日茂-埔里",12,0,12
"21798","6207雷科","110/07/09","元大-上新莊",0,10,-10
"21799","6207雷科","110/07/09","國泰-台中",17,6,11
"21800","6207雷科","110/07/09","永豐金-南京",0,10,-10
"21801","6207雷科","110/07/09","富邦-三重",10,0,10
"21802","6207雷科","110/07/09","兆豐-小港",0,6,-6
"21803","6207雷科","110/07/09","元大-沙鹿",10,0,10
"21804","6207雷科","110/07/09","富邦-羅東",1,7,-6
"21805","6207雷科","110/07/09","元大-八德",10,0,10
"21806","6207雷科","110/07/09","元大-土城永寧",0,6,-6
"21807","6207雷科","110/07/09","第一金-路竹",11,2,9
"21808","6207雷科","110/07/09","永豐金-板盛",0,6,-6
"21809","6207雷科","110/07/09","統一-南京",5,0,5
"21810","6207雷科","110/07/09","日盛-板橋",0,5,-5
"21811","3679新至陞","110/07/09","元大-大天母",10,0,10
"21812","3679新至陞","110/07/09","第一金-光復",0,11,-11
"21813","3679新至陞","110/07/09","日盛-樹林",9,0,9
"21814","3679新至陞","110/07/09","瑞士信貸",0,8,-8
"21815","3679新至陞","110/07/09","凱基-台北",11,2,9
"21816","3679新至陞","110/07/09","大慶-苗栗",0,5,-5
"21817","3679新至陞","110/07/09","華南永昌-小港",8,0,8
"21818","3679新至陞","110/07/09","元大-永春",0,5,-5
"21819","3679新至陞","110/07/09","兆豐-來福",7,0,7
"21820","3679新至陞","110/07/09","日盛-和美",0,4,-4
"21821","3679新至陞","110/07/09","香港上海匯豐",5,0,5
"21822","3679新至陞","110/07/09","元大-雙和",0,3,-3
"21823","3679新至陞","110/07/09","台中銀-員林",3,0,3
"21824","3679新至陞","110/07/09","永豐金-屏東",0,3,-3
"21825","3679新至陞","110/07/09","新光",3,0,3
"21826","3679新至陞","110/07/09","彰銀",0,2,-2
"21827","3679新至陞","110/07/09","土銀-花蓮",2,0,2
"21828","3679新至陞","110/07/09","宏遠-館前",0,2,-2
"21829","3679新至陞","110/07/09","第一金-澎湖",2,0,2
"21830","3679新至陞","110/07/09","港商野村",0,2,-2
"21831","3679新至陞","110/07/09","摩根大通",2,0,2
"21832","3679新至陞","110/07/09","大昌-新店",0,2,-2
"21833","3679新至陞","110/07/09","國泰-敦南",2,0,2
"21834","3679新至陞","110/07/09","元大-新莊",0,2,-2
"21835","3679新至陞","110/07/09","元大-淡水",4,2,2
"21836","3679新至陞","110/07/09","元大-板橋",0,2,-2
"21837","3679新至陞","110/07/09","日盛-士林",1,0,1
"21838","3679新至陞","110/07/09","台灣摩根士丹利",0,1,-1
"21839","3679新至陞","110/07/09","日盛-信義",1,0,1
"21840","3679新至陞","110/07/09","第一金-高雄",0,1,-1
"21841","2727王品","110/07/09","台灣匯立證券",90,0,90
"21842","2727王品","110/07/09","台灣摩根士丹利",0,267,-267
"21843","2727王品","110/07/09","國泰-敦南",166,84,82
"21844","2727王品","110/07/09","富邦-台北",35,299,-264
"21845","2727王品","110/07/09","富邦-仁愛",56,12,44
"21846","2727王品","110/07/09","凱基-台北",174,296,-122
"21847","2727王品","110/07/09","台新證券",109,66,43
"21848","2727王品","110/07/09","第一金",2,102,-100
"21849","2727王品","110/07/09","新光",117,87,30
"21850","2727王品","110/07/09","群益金鼎-大安",0,80,-80
"21851","2727王品","110/07/09","臺銀-臺中",35,6,29
"21852","2727王品","110/07/09","兆豐-大安",7,60,-53
"21853","2727王品","110/07/09","元大-桃園",32,3,29
"21854","2727王品","110/07/09","永豐金-南投",0,50,-50
"21855","2727王品","110/07/09","元富-宜蘭",34,6,28
"21856","2727王品","110/07/09","新加坡商瑞銀",6,46,-40
"21857","2727王品","110/07/09","玉山-台中",34,8,26
"21858","2727王品","110/07/09","合庫-彰化",11,50,-39
"21859","2727王品","110/07/09","群益金鼎-宜蘭",30,4,26
"21860","2727王品","110/07/09","永豐金-萬盛",13,52,-39
"21861","2727王品","110/07/09","富邦-台中",42,16,26
"21862","2727王品","110/07/09","瑞士信貸",0,34,-34
"21863","2727王品","110/07/09","第一金-豐原",25,1,24
"21864","2727王品","110/07/09","元大-和平",4,35,-31
"21865","2727王品","110/07/09","臺銀",30,8,22
"21866","2727王品","110/07/09","美林",14,44,-30
"21867","2727王品","110/07/09","兆豐-來福",23,1,22
"21868","2727王品","110/07/09","元大-員林",9,38,-29
"21869","2727王品","110/07/09","玉山-士林",22,2,20
"21870","2727王品","110/07/09","元富-西松",4,31,-27
"21871","1570力肯","110/07/09","凱基-台北",30,1,29
"21872","1570力肯","110/07/09","群益金鼎-彰化",0,20,-20
"21873","1570力肯","110/07/09","新光-台南",20,0,20
"21874","1570力肯","110/07/09","元大-土城學府",0,20,-20
"21875","1570力肯","110/07/09","元大-高雄",20,0,20
"21876","1570力肯","110/07/09","元大-大統",0,16,-16
"21877","1570力肯","110/07/09","國票-中正",12,0,12
"21878","1570力肯","110/07/09","元大-新營",0,11,-11
"21879","1570力肯","110/07/09","日盛-高雄",6,0,6
"21880","1570力肯","110/07/09","元大-和平",0,10,-10
"21881","1570力肯","110/07/09","元富-緯城",6,0,6
"21882","1570力肯","110/07/09","元大-草屯",0,10,-10
"21883","1570力肯","110/07/09","群益金鼎-台南",6,0,6
"21884","1570力肯","110/07/09","元大-鹿港",0,9,-9
"21885","1570力肯","110/07/09","華南永昌-岡山",6,0,6
"21886","1570力肯","110/07/09","合庫-基隆",0,7,-7
"21887","1570力肯","110/07/09","統一-中壢",5,0,5
"21888","1570力肯","110/07/09","摩根大通",2,8,-6
"21889","1570力肯","110/07/09","凱基-三峽",5,0,5
"21890","1570力肯","110/07/09","台灣企銀-豐原",0,4,-4
"21891","1570力肯","110/07/09","大昌-樹林",4,0,4
"21892","1570力肯","110/07/09","日盛-桃園",0,4,-4
"21893","1570力肯","110/07/09","新光",3,0,3
"21894","1570力肯","110/07/09","國泰-高雄",0,3,-3
"21895","1570力肯","110/07/09","富邦-新竹華信",3,0,3
"21896","1570力肯","110/07/09","永豐金-敦南",0,3,-3
"21897","1570力肯","110/07/09","合庫-台中",2,0,2
"21898","1570力肯","110/07/09","土銀-彰化",0,2,-2
"21899","1570力肯","110/07/09","臺銀-臺中",2,0,2
"21900","1570力肯","110/07/09","臺銀-鳳山",0,2,-2
"21901","6180橘子","110/07/09","摩根大通",63,1,62
"21902","6180橘子","110/07/09","元大-南京",1,32,-31
"21903","6180橘子","110/07/09","富邦-陽明",73,33,40
"21904","6180橘子","110/07/09","群益金鼎-台北",0,25,-25
"21905","6180橘子","110/07/09","新加坡商瑞銀",31,0,31
"21906","6180橘子","110/07/09","兆豐-復興",0,21,-21
"21907","6180橘子","110/07/09","美商高盛",25,0,25
"21908","6180橘子","110/07/09","永豐金-嘉義",0,21,-21
"21909","6180橘子","110/07/09","凱基-台北",26,10,16
"21910","6180橘子","110/07/09","凱基-中壢",8,24,-16
"21911","6180橘子","110/07/09","華南永昌-楠梓",13,0,13
"21912","6180橘子","110/07/09","致和-崇德",0,15,-15
"21913","6180橘子","110/07/09","華南永昌-朴子",11,0,11
"21914","6180橘子","110/07/09","群益金鼎-屏東",0,15,-15
"21915","6180橘子","110/07/09","元大-北港",11,0,11
"21916","6180橘子","110/07/09","群益金鼎-中山",0,15,-15
"21917","6180橘子","110/07/09","元大-成功",10,1,9
"21918","6180橘子","110/07/09","瑞士信貸",1,15,-14
"21919","6180橘子","110/07/09","新光",26,18,8
"21920","6180橘子","110/07/09","日盛-二林",0,10,-10
"21921","6180橘子","110/07/09","統一-三重",6,0,6
"21922","6180橘子","110/07/09","凱基-東門",0,10,-10
"21923","6180橘子","110/07/09","群益金鼎-嘉義",6,0,6
"21924","6180橘子","110/07/09","華南永昌-三重",0,10,-10
"21925","6180橘子","110/07/09","元大-員林中山",6,0,6
"21926","6180橘子","110/07/09","元大-彰化民生",1,11,-10
"21927","6180橘子","110/07/09","合庫-鳳山",5,0,5
"21928","6180橘子","110/07/09","永豐金-新店",1,11,-10
"21929","6180橘子","110/07/09","富邦-建國",6,1,5
"21930","6180橘子","110/07/09","群益金鼎-丹鳳",0,8,-8
"21931","2390云辰","110/07/09","摩根大通",279,56,223
"21932","2390云辰","110/07/09","元大-天母",0,127,-127
"21933","2390云辰","110/07/09","日盛-鳳山",110,2,108
"21934","2390云辰","110/07/09","中國信託-文心",5,109,-104
"21935","2390云辰","110/07/09","宏遠證券",100,0,100
"21936","2390云辰","110/07/09","永豐金-復興",0,55,-55
"21937","2390云辰","110/07/09","元大-大里",63,6,57
"21938","2390云辰","110/07/09","凱基-台北",239,286,-47
"21939","2390云辰","110/07/09","凱基-八德",59,10,49
"21940","2390云辰","110/07/09","德信",2,32,-30
"21941","2390云辰","110/07/09","合庫-新竹",40,0,40
"21942","2390云辰","110/07/09","兆豐-桃鶯",2,32,-30
"21943","2390云辰","110/07/09","國票",40,1,39
"21944","2390云辰","110/07/09","致和-南京",0,30,-30
"21945","2390云辰","110/07/09","新加坡商瑞銀",49,13,36
"21946","2390云辰","110/07/09","富邦-虎尾",1,31,-30
"21947","2390云辰","110/07/09","統一-新台中",36,2,34
"21948","2390云辰","110/07/09","元大-善化",2,31,-29
"21949","2390云辰","110/07/09","國票-嘉義",31,0,31
"21950","2390云辰","110/07/09","富邦-板橋",0,27,-27
"21951","2390云辰","110/07/09","華南永昌",35,7,28
"21952","2390云辰","110/07/09","富邦-永和",3,28,-25
"21953","2390云辰","110/07/09","玉山-台中",49,22,27
"21954","2390云辰","110/07/09","第一金-自由",20,44,-24
"21955","2390云辰","110/07/09","華南永昌-敦南",25,0,25
"21956","2390云辰","110/07/09","凱基-內湖",0,24,-24
"21957","2390云辰","110/07/09","新光-高雄",27,4,23
"21958","2390云辰","110/07/09","元大-汐止",1,24,-23
"21959","2390云辰","110/07/09","台灣摩根士丹利",85,63,22
"21960","2390云辰","110/07/09","新光-台中",12,33,-21
"21961","4903聯光通","110/07/09","元大-敦南",10,0,10
"21962","4903聯光通","110/07/09","第一金-台中",0,12,-12
"21963","4903聯光通","110/07/09","凱基-士林",5,0,5
"21964","4903聯光通","110/07/09","日盛-忠孝",0,3,-3
"21965","4903聯光通","110/07/09","元大-苗栗",5,0,5
"21966","4903聯光通","110/07/09","群益金鼎-崇德",0,3,-3
"21967","4903聯光通","110/07/09","元大-屏南",3,0,3
"21968","4903聯光通","110/07/09","國票-內壢",0,2,-2
"21969","4903聯光通","110/07/09","中國信託-永康",1,0,1
"21970","4903聯光通","110/07/09","康和-南崁",0,2,-2
"21971","4903聯光通","110/07/09","玉山證券",1,0,1
"21972","4903聯光通","110/07/09","新光-台中",0,2,-2
"21973","4903聯光通","110/07/09","元大-太平",4,3,1
"21974","4903聯光通","110/07/09","玉山-城中",0,2,-2
"21975","4903聯光通","110/07/09","永豐金-嘉義",1,0,1
"21976","4903聯光通","110/07/09","中國信託-文心",0,1,-1
"21977","4903聯光通","110/07/09","大昌",0,0,0
"21978","4903聯光通","110/07/09","大昌",0,0,0
"21979","4903聯光通","110/07/09","中農",0,0,0
"21980","4903聯光通","110/07/09","中農",0,0,0
"21981","4903聯光通","110/07/09","",NA,NA,NA
"21982","4903聯光通","110/07/09","",NA,NA,NA
"21983","4903聯光通","110/07/09","",NA,NA,NA
"21984","4903聯光通","110/07/09","",NA,NA,NA
"21985","4903聯光通","110/07/09","",NA,NA,NA
"21986","4903聯光通","110/07/09","",NA,NA,NA
"21987","4903聯光通","110/07/09","",NA,NA,NA
"21988","4903聯光通","110/07/09","",NA,NA,NA
"21989","4903聯光通","110/07/09","",NA,NA,NA
"21990","4903聯光通","110/07/09","",NA,NA,NA
"21991","2929淘帝","110/07/09","台中銀-台北",110,0,110
"21992","2929淘帝","110/07/09","新光",2,82,-80
"21993","2929淘帝","110/07/09","華南永昌-頭份",72,0,72
"21994","2929淘帝","110/07/09","摩根大通",2,63,-61
"21995","2929淘帝","110/07/09","合庫-高雄",71,0,71
"21996","2929淘帝","110/07/09","第一金-路竹",0,50,-50
"21997","2929淘帝","110/07/09","高橋-龍潭",37,0,37
"21998","2929淘帝","110/07/09","港商麥格理",0,42,-42
"21999","2929淘帝","110/07/09","新光-台中",60,26,34
"22000","2929淘帝","110/07/09","陽信-石牌",0,40,-40
"22001","2929淘帝","110/07/09","元富-大裕",22,1,21
"22002","2929淘帝","110/07/09","台新-左楠",1,39,-38
"22003","2929淘帝","110/07/09","合庫-鳳山",20,0,20
"22004","2929淘帝","110/07/09","凱基-桃園",3,29,-26
"22005","2929淘帝","110/07/09","元大-員林",22,2,20
"22006","2929淘帝","110/07/09","兆豐-內湖",0,25,-25
"22007","2929淘帝","110/07/09","台新-建北",15,0,15
"22008","2929淘帝","110/07/09","元大-北港",0,20,-20
"22009","2929淘帝","110/07/09","兆豐-桃園",13,0,13
"22010","2929淘帝","110/07/09","富邦-北港",0,19,-19
"22011","2929淘帝","110/07/09","兆豐-忠孝",10,0,10
"22012","2929淘帝","110/07/09","富邦-花蓮",0,17,-17
"22013","2929淘帝","110/07/09","國票-敦北法人",10,0,10
"22014","2929淘帝","110/07/09","國泰-台中",2,17,-15
"22015","2929淘帝","110/07/09","永豐金-博愛",10,0,10
"22016","2929淘帝","110/07/09","群益金鼎-彰化",0,15,-15
"22017","2929淘帝","110/07/09","群益金鼎-潭子",8,0,8
"22018","2929淘帝","110/07/09","元大-博愛",0,14,-14
"22019","2929淘帝","110/07/09","富邦-南屯",8,0,8
"22020","2929淘帝","110/07/09","日盛-板橋",0,13,-13
"22021","5410國眾","110/07/09","元大-新盛",14,0,14
"22022","5410國眾","110/07/09","(牛牛牛)亞-鑫豐",1,41,-40
"22023","5410國眾","110/07/09","台灣企銀-民雄",10,0,10
"22024","5410國眾","110/07/09","元富-嘉義",0,25,-25
"22025","5410國眾","110/07/09","元富-虎尾",9,0,9
"22026","5410國眾","110/07/09","凱基-高美館",0,10,-10
"22027","5410國眾","110/07/09","摩根大通",10,1,9
"22028","5410國眾","110/07/09","凱基-城中",0,10,-10
"22029","5410國眾","110/07/09","兆豐-北高雄",7,0,7
"22030","5410國眾","110/07/09","元大-頭份",0,10,-10
"22031","5410國眾","110/07/09","凱基-台北",8,1,7
"22032","5410國眾","110/07/09","群益金鼎-丹鳳",0,7,-7
"22033","5410國眾","110/07/09","華南永昌-公誠",7,0,7
"22034","5410國眾","110/07/09","凱基-復興",0,7,-7
"22035","5410國眾","110/07/09","香港上海匯豐",6,0,6
"22036","5410國眾","110/07/09","元大-員林",0,7,-7
"22037","5410國眾","110/07/09","凱基-中壢",6,0,6
"22038","5410國眾","110/07/09","富邦-竹東",0,6,-6
"22039","5410國眾","110/07/09","華南永昌-南京",6,0,6
"22040","5410國眾","110/07/09","亞東-高雄",0,5,-5
"22041","5410國眾","110/07/09","統一-三重",5,0,5
"22042","5410國眾","110/07/09","大慶-中壢",1,6,-5
"22043","5410國眾","110/07/09","富邦-宜蘭",5,0,5
"22044","5410國眾","110/07/09","群益金鼎-中港",0,5,-5
"22045","5410國眾","110/07/09","元大-崇德",5,0,5
"22046","5410國眾","110/07/09","元大-八德",0,5,-5
"22047","5410國眾","110/07/09","元大-博愛",5,0,5
"22048","5410國眾","110/07/09","富邦-基隆",0,4,-4
"22049","5410國眾","110/07/09","元大-龍潭",5,0,5
"22050","5410國眾","110/07/09","臺銀-新竹",0,3,-3
"22051","2841台開","110/07/09","日盛-雙和",102,0,102
"22052","2841台開","110/07/09","港商野村",0,129,-129
"22053","2841台開","110/07/09","元大-館前",70,0,70
"22054","2841台開","110/07/09","兆豐-永和",0,100,-100
"22055","2841台開","110/07/09","凱基-文心",50,0,50
"22056","2841台開","110/07/09","台新證券",7,28,-21
"22057","2841台開","110/07/09","富邦-嘉義",40,0,40
"22058","2841台開","110/07/09","國票-北高雄",0,20,-20
"22059","2841台開","110/07/09","美商高盛",15,0,15
"22060","2841台開","110/07/09","永豐金-敦南",29,46,-17
"22061","2841台開","110/07/09","台中銀",15,0,15
"22062","2841台開","110/07/09","合庫-基隆",0,12,-12
"22063","2841台開","110/07/09","新光",11,0,11
"22064","2841台開","110/07/09","中國信託-松江",0,12,-12
"22065","2841台開","110/07/09","華南永昌-長虹",10,0,10
"22066","2841台開","110/07/09","兆豐-城中",0,12,-12
"22067","2841台開","110/07/09","永豐金-南投",10,0,10
"22068","2841台開","110/07/09","台中銀-豐原",0,10,-10
"22069","2841台開","110/07/09","合庫-桃園",7,0,7
"22070","2841台開","110/07/09","兆豐-景美",0,10,-10
"22071","2841台開","110/07/09","群益金鼎-古亭",7,0,7
"22072","2841台開","110/07/09","群益金鼎-基隆",0,10,-10
"22073","2841台開","110/07/09","國泰-敦南",6,0,6
"22074","2841台開","110/07/09","元大-北三重",0,10,-10
"22075","2841台開","110/07/09","凱基-桃園",8,2,6
"22076","2841台開","110/07/09","(牛牛牛)亞-網路",0,9,-9
"22077","2841台開","110/07/09","日盛證券",5,0,5
"22078","2841台開","110/07/09","台新-高雄",1,10,-9
"22079","2841台開","110/07/09","元富-文心",5,0,5
"22080","2841台開","110/07/09","凱基-台北",0,7,-7
"22081","6207雷科","110/07/09","群益金鼎-新竹",47,0,47
"22082","6207雷科","110/07/09","新光",7,24,-17
"22083","6207雷科","110/07/09","永豐金-三重",31,0,31
"22084","6207雷科","110/07/09","日盛-和美",0,15,-15
"22085","6207雷科","110/07/09","新加坡商瑞銀",33,5,28
"22086","6207雷科","110/07/09","國泰-台南",0,15,-15
"22087","6207雷科","110/07/09","元大-高雄",26,0,26
"22088","6207雷科","110/07/09","華南永昌-古亭",0,14,-14
"22089","6207雷科","110/07/09","統一-員林",22,0,22
"22090","6207雷科","110/07/09","土銀-白河",0,11,-11
"22091","6207雷科","110/07/09","台新-高雄",22,0,22
"22092","6207雷科","110/07/09","日盛-台南",0,10,-10
"22093","6207雷科","110/07/09","摩根大通",34,17,17
"22094","6207雷科","110/07/09","元富-林園",0,10,-10
"22095","6207雷科","110/07/09","元大-博愛",17,1,16
"22096","6207雷科","110/07/09","富邦-園區",0,10,-10
"22097","6207雷科","110/07/09","日茂-埔里",12,0,12
"22098","6207雷科","110/07/09","元大-上新莊",0,10,-10
"22099","6207雷科","110/07/09","國泰-台中",17,6,11
"22100","6207雷科","110/07/09","永豐金-南京",0,10,-10
"22101","6207雷科","110/07/09","富邦-三重",10,0,10
"22102","6207雷科","110/07/09","兆豐-小港",0,6,-6
"22103","6207雷科","110/07/09","元大-沙鹿",10,0,10
"22104","6207雷科","110/07/09","富邦-羅東",1,7,-6
"22105","6207雷科","110/07/09","元大-八德",10,0,10
"22106","6207雷科","110/07/09","元大-土城永寧",0,6,-6
"22107","6207雷科","110/07/09","第一金-路竹",11,2,9
"22108","6207雷科","110/07/09","永豐金-板盛",0,6,-6
"22109","6207雷科","110/07/09","統一-南京",5,0,5
"22110","6207雷科","110/07/09","日盛-板橋",0,5,-5
"22111","3679新至陞","110/07/09","元大-大天母",10,0,10
"22112","3679新至陞","110/07/09","第一金-光復",0,11,-11
"22113","3679新至陞","110/07/09","日盛-樹林",9,0,9
"22114","3679新至陞","110/07/09","瑞士信貸",0,8,-8
"22115","3679新至陞","110/07/09","凱基-台北",11,2,9
"22116","3679新至陞","110/07/09","大慶-苗栗",0,5,-5
"22117","3679新至陞","110/07/09","華南永昌-小港",8,0,8
"22118","3679新至陞","110/07/09","元大-永春",0,5,-5
"22119","3679新至陞","110/07/09","兆豐-來福",7,0,7
"22120","3679新至陞","110/07/09","日盛-和美",0,4,-4
"22121","3679新至陞","110/07/09","香港上海匯豐",5,0,5
"22122","3679新至陞","110/07/09","元大-雙和",0,3,-3
"22123","3679新至陞","110/07/09","台中銀-員林",3,0,3
"22124","3679新至陞","110/07/09","永豐金-屏東",0,3,-3
"22125","3679新至陞","110/07/09","新光",3,0,3
"22126","3679新至陞","110/07/09","彰銀",0,2,-2
"22127","3679新至陞","110/07/09","土銀-花蓮",2,0,2
"22128","3679新至陞","110/07/09","宏遠-館前",0,2,-2
"22129","3679新至陞","110/07/09","第一金-澎湖",2,0,2
"22130","3679新至陞","110/07/09","港商野村",0,2,-2
"22131","3679新至陞","110/07/09","摩根大通",2,0,2
"22132","3679新至陞","110/07/09","大昌-新店",0,2,-2
"22133","3679新至陞","110/07/09","國泰-敦南",2,0,2
"22134","3679新至陞","110/07/09","元大-新莊",0,2,-2
"22135","3679新至陞","110/07/09","元大-淡水",4,2,2
"22136","3679新至陞","110/07/09","元大-板橋",0,2,-2
"22137","3679新至陞","110/07/09","日盛-士林",1,0,1
"22138","3679新至陞","110/07/09","台灣摩根士丹利",0,1,-1
"22139","3679新至陞","110/07/09","日盛-信義",1,0,1
"22140","3679新至陞","110/07/09","第一金-高雄",0,1,-1
"22141","2727王品","110/07/09","台灣匯立證券",90,0,90
"22142","2727王品","110/07/09","台灣摩根士丹利",0,267,-267
"22143","2727王品","110/07/09","國泰-敦南",166,84,82
"22144","2727王品","110/07/09","富邦-台北",35,299,-264
"22145","2727王品","110/07/09","富邦-仁愛",56,12,44
"22146","2727王品","110/07/09","凱基-台北",174,296,-122
"22147","2727王品","110/07/09","台新證券",109,66,43
"22148","2727王品","110/07/09","第一金",2,102,-100
"22149","2727王品","110/07/09","新光",117,87,30
"22150","2727王品","110/07/09","群益金鼎-大安",0,80,-80
"22151","2727王品","110/07/09","臺銀-臺中",35,6,29
"22152","2727王品","110/07/09","兆豐-大安",7,60,-53
"22153","2727王品","110/07/09","元大-桃園",32,3,29
"22154","2727王品","110/07/09","永豐金-南投",0,50,-50
"22155","2727王品","110/07/09","元富-宜蘭",34,6,28
"22156","2727王品","110/07/09","新加坡商瑞銀",6,46,-40
"22157","2727王品","110/07/09","玉山-台中",34,8,26
"22158","2727王品","110/07/09","合庫-彰化",11,50,-39
"22159","2727王品","110/07/09","群益金鼎-宜蘭",30,4,26
"22160","2727王品","110/07/09","永豐金-萬盛",13,52,-39
"22161","2727王品","110/07/09","富邦-台中",42,16,26
"22162","2727王品","110/07/09","瑞士信貸",0,34,-34
"22163","2727王品","110/07/09","第一金-豐原",25,1,24
"22164","2727王品","110/07/09","元大-和平",4,35,-31
"22165","2727王品","110/07/09","臺銀",30,8,22
"22166","2727王品","110/07/09","美林",14,44,-30
"22167","2727王品","110/07/09","兆豐-來福",23,1,22
"22168","2727王品","110/07/09","元大-員林",9,38,-29
"22169","2727王品","110/07/09","玉山-士林",22,2,20
"22170","2727王品","110/07/09","元富-西松",4,31,-27
"22171","1570力肯","110/07/09","凱基-台北",30,1,29
"22172","1570力肯","110/07/09","群益金鼎-彰化",0,20,-20
"22173","1570力肯","110/07/09","新光-台南",20,0,20
"22174","1570力肯","110/07/09","元大-土城學府",0,20,-20
"22175","1570力肯","110/07/09","元大-高雄",20,0,20
"22176","1570力肯","110/07/09","元大-大統",0,16,-16
"22177","1570力肯","110/07/09","國票-中正",12,0,12
"22178","1570力肯","110/07/09","元大-新營",0,11,-11
"22179","1570力肯","110/07/09","日盛-高雄",6,0,6
"22180","1570力肯","110/07/09","元大-和平",0,10,-10
"22181","1570力肯","110/07/09","元富-緯城",6,0,6
"22182","1570力肯","110/07/09","元大-草屯",0,10,-10
"22183","1570力肯","110/07/09","群益金鼎-台南",6,0,6
"22184","1570力肯","110/07/09","元大-鹿港",0,9,-9
"22185","1570力肯","110/07/09","華南永昌-岡山",6,0,6
"22186","1570力肯","110/07/09","合庫-基隆",0,7,-7
"22187","1570力肯","110/07/09","統一-中壢",5,0,5
"22188","1570力肯","110/07/09","摩根大通",2,8,-6
"22189","1570力肯","110/07/09","凱基-三峽",5,0,5
"22190","1570力肯","110/07/09","台灣企銀-豐原",0,4,-4
"22191","1570力肯","110/07/09","大昌-樹林",4,0,4
"22192","1570力肯","110/07/09","日盛-桃園",0,4,-4
"22193","1570力肯","110/07/09","新光",3,0,3
"22194","1570力肯","110/07/09","國泰-高雄",0,3,-3
"22195","1570力肯","110/07/09","富邦-新竹華信",3,0,3
"22196","1570力肯","110/07/09","永豐金-敦南",0,3,-3
"22197","1570力肯","110/07/09","合庫-台中",2,0,2
"22198","1570力肯","110/07/09","土銀-彰化",0,2,-2
"22199","1570力肯","110/07/09","臺銀-臺中",2,0,2
"22200","1570力肯","110/07/09","臺銀-鳳山",0,2,-2
"22201","6180橘子","110/07/09","摩根大通",63,1,62
"22202","6180橘子","110/07/09","元大-南京",1,32,-31
"22203","6180橘子","110/07/09","富邦-陽明",73,33,40
"22204","6180橘子","110/07/09","群益金鼎-台北",0,25,-25
"22205","6180橘子","110/07/09","新加坡商瑞銀",31,0,31
"22206","6180橘子","110/07/09","兆豐-復興",0,21,-21
"22207","6180橘子","110/07/09","美商高盛",25,0,25
"22208","6180橘子","110/07/09","永豐金-嘉義",0,21,-21
"22209","6180橘子","110/07/09","凱基-台北",26,10,16
"22210","6180橘子","110/07/09","凱基-中壢",8,24,-16
"22211","6180橘子","110/07/09","華南永昌-楠梓",13,0,13
"22212","6180橘子","110/07/09","致和-崇德",0,15,-15
"22213","6180橘子","110/07/09","華南永昌-朴子",11,0,11
"22214","6180橘子","110/07/09","群益金鼎-屏東",0,15,-15
"22215","6180橘子","110/07/09","元大-北港",11,0,11
"22216","6180橘子","110/07/09","群益金鼎-中山",0,15,-15
"22217","6180橘子","110/07/09","元大-成功",10,1,9
"22218","6180橘子","110/07/09","瑞士信貸",1,15,-14
"22219","6180橘子","110/07/09","新光",26,18,8
"22220","6180橘子","110/07/09","日盛-二林",0,10,-10
"22221","6180橘子","110/07/09","統一-三重",6,0,6
"22222","6180橘子","110/07/09","凱基-東門",0,10,-10
"22223","6180橘子","110/07/09","群益金鼎-嘉義",6,0,6
"22224","6180橘子","110/07/09","華南永昌-三重",0,10,-10
"22225","6180橘子","110/07/09","元大-員林中山",6,0,6
"22226","6180橘子","110/07/09","元大-彰化民生",1,11,-10
"22227","6180橘子","110/07/09","合庫-鳳山",5,0,5
"22228","6180橘子","110/07/09","永豐金-新店",1,11,-10
"22229","6180橘子","110/07/09","富邦-建國",6,1,5
"22230","6180橘子","110/07/09","群益金鼎-丹鳳",0,8,-8
"22231","2390云辰","110/07/09","摩根大通",279,56,223
"22232","2390云辰","110/07/09","元大-天母",0,127,-127
"22233","2390云辰","110/07/09","日盛-鳳山",110,2,108
"22234","2390云辰","110/07/09","中國信託-文心",5,109,-104
"22235","2390云辰","110/07/09","宏遠證券",100,0,100
"22236","2390云辰","110/07/09","永豐金-復興",0,55,-55
"22237","2390云辰","110/07/09","元大-大里",63,6,57
"22238","2390云辰","110/07/09","凱基-台北",239,286,-47
"22239","2390云辰","110/07/09","凱基-八德",59,10,49
"22240","2390云辰","110/07/09","德信",2,32,-30
"22241","2390云辰","110/07/09","合庫-新竹",40,0,40
"22242","2390云辰","110/07/09","兆豐-桃鶯",2,32,-30
"22243","2390云辰","110/07/09","國票",40,1,39
"22244","2390云辰","110/07/09","致和-南京",0,30,-30
"22245","2390云辰","110/07/09","新加坡商瑞銀",49,13,36
"22246","2390云辰","110/07/09","富邦-虎尾",1,31,-30
"22247","2390云辰","110/07/09","統一-新台中",36,2,34
"22248","2390云辰","110/07/09","元大-善化",2,31,-29
"22249","2390云辰","110/07/09","國票-嘉義",31,0,31
"22250","2390云辰","110/07/09","富邦-板橋",0,27,-27
"22251","2390云辰","110/07/09","華南永昌",35,7,28
"22252","2390云辰","110/07/09","富邦-永和",3,28,-25
"22253","2390云辰","110/07/09","玉山-台中",49,22,27
"22254","2390云辰","110/07/09","第一金-自由",20,44,-24
"22255","2390云辰","110/07/09","華南永昌-敦南",25,0,25
"22256","2390云辰","110/07/09","凱基-內湖",0,24,-24
"22257","2390云辰","110/07/09","新光-高雄",27,4,23
"22258","2390云辰","110/07/09","元大-汐止",1,24,-23
"22259","2390云辰","110/07/09","台灣摩根士丹利",85,63,22
"22260","2390云辰","110/07/09","新光-台中",12,33,-21
"22261","4903聯光通","110/07/09","元大-敦南",10,0,10
"22262","4903聯光通","110/07/09","第一金-台中",0,12,-12
"22263","4903聯光通","110/07/09","凱基-士林",5,0,5
"22264","4903聯光通","110/07/09","日盛-忠孝",0,3,-3
"22265","4903聯光通","110/07/09","元大-苗栗",5,0,5
"22266","4903聯光通","110/07/09","群益金鼎-崇德",0,3,-3
"22267","4903聯光通","110/07/09","元大-屏南",3,0,3
"22268","4903聯光通","110/07/09","國票-內壢",0,2,-2
"22269","4903聯光通","110/07/09","中國信託-永康",1,0,1
"22270","4903聯光通","110/07/09","康和-南崁",0,2,-2
"22271","4903聯光通","110/07/09","玉山證券",1,0,1
"22272","4903聯光通","110/07/09","新光-台中",0,2,-2
"22273","4903聯光通","110/07/09","元大-太平",4,3,1
"22274","4903聯光通","110/07/09","玉山-城中",0,2,-2
"22275","4903聯光通","110/07/09","永豐金-嘉義",1,0,1
"22276","4903聯光通","110/07/09","中國信託-文心",0,1,-1
"22277","4903聯光通","110/07/09","大昌",0,0,0
"22278","4903聯光通","110/07/09","大昌",0,0,0
"22279","4903聯光通","110/07/09","中農",0,0,0
"22280","4903聯光通","110/07/09","中農",0,0,0
"22281","4903聯光通","110/07/09","",NA,NA,NA
"22282","4903聯光通","110/07/09","",NA,NA,NA
"22283","4903聯光通","110/07/09","",NA,NA,NA
"22284","4903聯光通","110/07/09","",NA,NA,NA
"22285","4903聯光通","110/07/09","",NA,NA,NA
"22286","4903聯光通","110/07/09","",NA,NA,NA
"22287","4903聯光通","110/07/09","",NA,NA,NA
"22288","4903聯光通","110/07/09","",NA,NA,NA
"22289","4903聯光通","110/07/09","",NA,NA,NA
"22290","4903聯光通","110/07/09","",NA,NA,NA
"22291","2929淘帝","110/07/09","台中銀-台北",110,0,110
"22292","2929淘帝","110/07/09","新光",2,82,-80
"22293","2929淘帝","110/07/09","華南永昌-頭份",72,0,72
"22294","2929淘帝","110/07/09","摩根大通",2,63,-61
"22295","2929淘帝","110/07/09","合庫-高雄",71,0,71
"22296","2929淘帝","110/07/09","第一金-路竹",0,50,-50
"22297","2929淘帝","110/07/09","高橋-龍潭",37,0,37
"22298","2929淘帝","110/07/09","港商麥格理",0,42,-42
"22299","2929淘帝","110/07/09","新光-台中",60,26,34
"22300","2929淘帝","110/07/09","陽信-石牌",0,40,-40
"22301","2929淘帝","110/07/09","元富-大裕",22,1,21
"22302","2929淘帝","110/07/09","台新-左楠",1,39,-38
"22303","2929淘帝","110/07/09","合庫-鳳山",20,0,20
"22304","2929淘帝","110/07/09","凱基-桃園",3,29,-26
"22305","2929淘帝","110/07/09","元大-員林",22,2,20
"22306","2929淘帝","110/07/09","兆豐-內湖",0,25,-25
"22307","2929淘帝","110/07/09","台新-建北",15,0,15
"22308","2929淘帝","110/07/09","元大-北港",0,20,-20
"22309","2929淘帝","110/07/09","兆豐-桃園",13,0,13
"22310","2929淘帝","110/07/09","富邦-北港",0,19,-19
"22311","2929淘帝","110/07/09","兆豐-忠孝",10,0,10
"22312","2929淘帝","110/07/09","富邦-花蓮",0,17,-17
"22313","2929淘帝","110/07/09","國票-敦北法人",10,0,10
"22314","2929淘帝","110/07/09","國泰-台中",2,17,-15
"22315","2929淘帝","110/07/09","永豐金-博愛",10,0,10
"22316","2929淘帝","110/07/09","群益金鼎-彰化",0,15,-15
"22317","2929淘帝","110/07/09","群益金鼎-潭子",8,0,8
"22318","2929淘帝","110/07/09","元大-博愛",0,14,-14
"22319","2929淘帝","110/07/09","富邦-南屯",8,0,8
"22320","2929淘帝","110/07/09","日盛-板橋",0,13,-13
"22321","5410國眾","110/07/09","元大-新盛",14,0,14
"22322","5410國眾","110/07/09","(牛牛牛)亞-鑫豐",1,41,-40
"22323","5410國眾","110/07/09","台灣企銀-民雄",10,0,10
"22324","5410國眾","110/07/09","元富-嘉義",0,25,-25
"22325","5410國眾","110/07/09","元富-虎尾",9,0,9
"22326","5410國眾","110/07/09","凱基-高美館",0,10,-10
"22327","5410國眾","110/07/09","摩根大通",10,1,9
"22328","5410國眾","110/07/09","凱基-城中",0,10,-10
"22329","5410國眾","110/07/09","兆豐-北高雄",7,0,7
"22330","5410國眾","110/07/09","元大-頭份",0,10,-10
"22331","5410國眾","110/07/09","凱基-台北",8,1,7
"22332","5410國眾","110/07/09","群益金鼎-丹鳳",0,7,-7
"22333","5410國眾","110/07/09","華南永昌-公誠",7,0,7
"22334","5410國眾","110/07/09","凱基-復興",0,7,-7
"22335","5410國眾","110/07/09","香港上海匯豐",6,0,6
"22336","5410國眾","110/07/09","元大-員林",0,7,-7
"22337","5410國眾","110/07/09","凱基-中壢",6,0,6
"22338","5410國眾","110/07/09","富邦-竹東",0,6,-6
"22339","5410國眾","110/07/09","華南永昌-南京",6,0,6
"22340","5410國眾","110/07/09","亞東-高雄",0,5,-5
"22341","5410國眾","110/07/09","統一-三重",5,0,5
"22342","5410國眾","110/07/09","大慶-中壢",1,6,-5
"22343","5410國眾","110/07/09","富邦-宜蘭",5,0,5
"22344","5410國眾","110/07/09","群益金鼎-中港",0,5,-5
"22345","5410國眾","110/07/09","元大-崇德",5,0,5
"22346","5410國眾","110/07/09","元大-八德",0,5,-5
"22347","5410國眾","110/07/09","元大-博愛",5,0,5
"22348","5410國眾","110/07/09","富邦-基隆",0,4,-4
"22349","5410國眾","110/07/09","元大-龍潭",5,0,5
"22350","5410國眾","110/07/09","臺銀-新竹",0,3,-3
"22351","2841台開","110/07/09","日盛-雙和",102,0,102
"22352","2841台開","110/07/09","港商野村",0,129,-129
"22353","2841台開","110/07/09","元大-館前",70,0,70
"22354","2841台開","110/07/09","兆豐-永和",0,100,-100
"22355","2841台開","110/07/09","凱基-文心",50,0,50
"22356","2841台開","110/07/09","台新證券",7,28,-21
"22357","2841台開","110/07/09","富邦-嘉義",40,0,40
"22358","2841台開","110/07/09","國票-北高雄",0,20,-20
"22359","2841台開","110/07/09","美商高盛",15,0,15
"22360","2841台開","110/07/09","永豐金-敦南",29,46,-17
"22361","2841台開","110/07/09","台中銀",15,0,15
"22362","2841台開","110/07/09","合庫-基隆",0,12,-12
"22363","2841台開","110/07/09","新光",11,0,11
"22364","2841台開","110/07/09","中國信託-松江",0,12,-12
"22365","2841台開","110/07/09","華南永昌-長虹",10,0,10
"22366","2841台開","110/07/09","兆豐-城中",0,12,-12
"22367","2841台開","110/07/09","永豐金-南投",10,0,10
"22368","2841台開","110/07/09","台中銀-豐原",0,10,-10
"22369","2841台開","110/07/09","合庫-桃園",7,0,7
"22370","2841台開","110/07/09","兆豐-景美",0,10,-10
"22371","2841台開","110/07/09","群益金鼎-古亭",7,0,7
"22372","2841台開","110/07/09","群益金鼎-基隆",0,10,-10
"22373","2841台開","110/07/09","國泰-敦南",6,0,6
"22374","2841台開","110/07/09","元大-北三重",0,10,-10
"22375","2841台開","110/07/09","凱基-桃園",8,2,6
"22376","2841台開","110/07/09","(牛牛牛)亞-網路",0,9,-9
"22377","2841台開","110/07/09","日盛證券",5,0,5
"22378","2841台開","110/07/09","台新-高雄",1,10,-9
"22379","2841台開","110/07/09","元富-文心",5,0,5
"22380","2841台開","110/07/09","凱基-台北",0,7,-7
"22381","6207雷科","110/07/09","群益金鼎-新竹",47,0,47
"22382","6207雷科","110/07/09","新光",7,24,-17
"22383","6207雷科","110/07/09","永豐金-三重",31,0,31
"22384","6207雷科","110/07/09","日盛-和美",0,15,-15
"22385","6207雷科","110/07/09","新加坡商瑞銀",33,5,28
"22386","6207雷科","110/07/09","國泰-台南",0,15,-15
"22387","6207雷科","110/07/09","元大-高雄",26,0,26
"22388","6207雷科","110/07/09","華南永昌-古亭",0,14,-14
"22389","6207雷科","110/07/09","統一-員林",22,0,22
"22390","6207雷科","110/07/09","土銀-白河",0,11,-11
"22391","6207雷科","110/07/09","台新-高雄",22,0,22
"22392","6207雷科","110/07/09","日盛-台南",0,10,-10
"22393","6207雷科","110/07/09","摩根大通",34,17,17
"22394","6207雷科","110/07/09","元富-林園",0,10,-10
"22395","6207雷科","110/07/09","元大-博愛",17,1,16
"22396","6207雷科","110/07/09","富邦-園區",0,10,-10
"22397","6207雷科","110/07/09","日茂-埔里",12,0,12
"22398","6207雷科","110/07/09","元大-上新莊",0,10,-10
"22399","6207雷科","110/07/09","國泰-台中",17,6,11
"22400","6207雷科","110/07/09","永豐金-南京",0,10,-10
"22401","6207雷科","110/07/09","富邦-三重",10,0,10
"22402","6207雷科","110/07/09","兆豐-小港",0,6,-6
"22403","6207雷科","110/07/09","元大-沙鹿",10,0,10
"22404","6207雷科","110/07/09","富邦-羅東",1,7,-6
"22405","6207雷科","110/07/09","元大-八德",10,0,10
"22406","6207雷科","110/07/09","元大-土城永寧",0,6,-6
"22407","6207雷科","110/07/09","第一金-路竹",11,2,9
"22408","6207雷科","110/07/09","永豐金-板盛",0,6,-6
"22409","6207雷科","110/07/09","統一-南京",5,0,5
"22410","6207雷科","110/07/09","日盛-板橋",0,5,-5
"22411","3679新至陞","110/07/09","元大-大天母",10,0,10
"22412","3679新至陞","110/07/09","第一金-光復",0,11,-11
"22413","3679新至陞","110/07/09","日盛-樹林",9,0,9
"22414","3679新至陞","110/07/09","瑞士信貸",0,8,-8
"22415","3679新至陞","110/07/09","凱基-台北",11,2,9
"22416","3679新至陞","110/07/09","大慶-苗栗",0,5,-5
"22417","3679新至陞","110/07/09","華南永昌-小港",8,0,8
"22418","3679新至陞","110/07/09","元大-永春",0,5,-5
"22419","3679新至陞","110/07/09","兆豐-來福",7,0,7
"22420","3679新至陞","110/07/09","日盛-和美",0,4,-4
"22421","3679新至陞","110/07/09","香港上海匯豐",5,0,5
"22422","3679新至陞","110/07/09","元大-雙和",0,3,-3
"22423","3679新至陞","110/07/09","台中銀-員林",3,0,3
"22424","3679新至陞","110/07/09","永豐金-屏東",0,3,-3
"22425","3679新至陞","110/07/09","新光",3,0,3
"22426","3679新至陞","110/07/09","彰銀",0,2,-2
"22427","3679新至陞","110/07/09","土銀-花蓮",2,0,2
"22428","3679新至陞","110/07/09","宏遠-館前",0,2,-2
"22429","3679新至陞","110/07/09","第一金-澎湖",2,0,2
"22430","3679新至陞","110/07/09","港商野村",0,2,-2
"22431","3679新至陞","110/07/09","摩根大通",2,0,2
"22432","3679新至陞","110/07/09","大昌-新店",0,2,-2
"22433","3679新至陞","110/07/09","國泰-敦南",2,0,2
"22434","3679新至陞","110/07/09","元大-新莊",0,2,-2
"22435","3679新至陞","110/07/09","元大-淡水",4,2,2
"22436","3679新至陞","110/07/09","元大-板橋",0,2,-2
"22437","3679新至陞","110/07/09","日盛-士林",1,0,1
"22438","3679新至陞","110/07/09","台灣摩根士丹利",0,1,-1
"22439","3679新至陞","110/07/09","日盛-信義",1,0,1
"22440","3679新至陞","110/07/09","第一金-高雄",0,1,-1
"22441","2727王品","110/07/09","台灣匯立證券",90,0,90
"22442","2727王品","110/07/09","台灣摩根士丹利",0,267,-267
"22443","2727王品","110/07/09","國泰-敦南",166,84,82
"22444","2727王品","110/07/09","富邦-台北",35,299,-264
"22445","2727王品","110/07/09","富邦-仁愛",56,12,44
"22446","2727王品","110/07/09","凱基-台北",174,296,-122
"22447","2727王品","110/07/09","台新證券",109,66,43
"22448","2727王品","110/07/09","第一金",2,102,-100
"22449","2727王品","110/07/09","新光",117,87,30
"22450","2727王品","110/07/09","群益金鼎-大安",0,80,-80
"22451","2727王品","110/07/09","臺銀-臺中",35,6,29
"22452","2727王品","110/07/09","兆豐-大安",7,60,-53
"22453","2727王品","110/07/09","元大-桃園",32,3,29
"22454","2727王品","110/07/09","永豐金-南投",0,50,-50
"22455","2727王品","110/07/09","元富-宜蘭",34,6,28
"22456","2727王品","110/07/09","新加坡商瑞銀",6,46,-40
"22457","2727王品","110/07/09","玉山-台中",34,8,26
"22458","2727王品","110/07/09","合庫-彰化",11,50,-39
"22459","2727王品","110/07/09","群益金鼎-宜蘭",30,4,26
"22460","2727王品","110/07/09","永豐金-萬盛",13,52,-39
"22461","2727王品","110/07/09","富邦-台中",42,16,26
"22462","2727王品","110/07/09","瑞士信貸",0,34,-34
"22463","2727王品","110/07/09","第一金-豐原",25,1,24
"22464","2727王品","110/07/09","元大-和平",4,35,-31
"22465","2727王品","110/07/09","臺銀",30,8,22
"22466","2727王品","110/07/09","美林",14,44,-30
"22467","2727王品","110/07/09","兆豐-來福",23,1,22
"22468","2727王品","110/07/09","元大-員林",9,38,-29
"22469","2727王品","110/07/09","玉山-士林",22,2,20
"22470","2727王品","110/07/09","元富-西松",4,31,-27
"22471","1570力肯","110/07/09","凱基-台北",30,1,29
"22472","1570力肯","110/07/09","群益金鼎-彰化",0,20,-20
"22473","1570力肯","110/07/09","新光-台南",20,0,20
"22474","1570力肯","110/07/09","元大-土城學府",0,20,-20
"22475","1570力肯","110/07/09","元大-高雄",20,0,20
"22476","1570力肯","110/07/09","元大-大統",0,16,-16
"22477","1570力肯","110/07/09","國票-中正",12,0,12
"22478","1570力肯","110/07/09","元大-新營",0,11,-11
"22479","1570力肯","110/07/09","日盛-高雄",6,0,6
"22480","1570力肯","110/07/09","元大-和平",0,10,-10
"22481","1570力肯","110/07/09","元富-緯城",6,0,6
"22482","1570力肯","110/07/09","元大-草屯",0,10,-10
"22483","1570力肯","110/07/09","群益金鼎-台南",6,0,6
"22484","1570力肯","110/07/09","元大-鹿港",0,9,-9
"22485","1570力肯","110/07/09","華南永昌-岡山",6,0,6
"22486","1570力肯","110/07/09","合庫-基隆",0,7,-7
"22487","1570力肯","110/07/09","統一-中壢",5,0,5
"22488","1570力肯","110/07/09","摩根大通",2,8,-6
"22489","1570力肯","110/07/09","凱基-三峽",5,0,5
"22490","1570力肯","110/07/09","台灣企銀-豐原",0,4,-4
"22491","1570力肯","110/07/09","大昌-樹林",4,0,4
"22492","1570力肯","110/07/09","日盛-桃園",0,4,-4
"22493","1570力肯","110/07/09","新光",3,0,3
"22494","1570力肯","110/07/09","國泰-高雄",0,3,-3
"22495","1570力肯","110/07/09","富邦-新竹華信",3,0,3
"22496","1570力肯","110/07/09","永豐金-敦南",0,3,-3
"22497","1570力肯","110/07/09","合庫-台中",2,0,2
"22498","1570力肯","110/07/09","土銀-彰化",0,2,-2
"22499","1570力肯","110/07/09","臺銀-臺中",2,0,2
"22500","1570力肯","110/07/09","臺銀-鳳山",0,2,-2
"22501","6180橘子","110/07/09","摩根大通",63,1,62
"22502","6180橘子","110/07/09","元大-南京",1,32,-31
"22503","6180橘子","110/07/09","富邦-陽明",73,33,40
"22504","6180橘子","110/07/09","群益金鼎-台北",0,25,-25
"22505","6180橘子","110/07/09","新加坡商瑞銀",31,0,31
"22506","6180橘子","110/07/09","兆豐-復興",0,21,-21
"22507","6180橘子","110/07/09","美商高盛",25,0,25
"22508","6180橘子","110/07/09","永豐金-嘉義",0,21,-21
"22509","6180橘子","110/07/09","凱基-台北",26,10,16
"22510","6180橘子","110/07/09","凱基-中壢",8,24,-16
"22511","6180橘子","110/07/09","華南永昌-楠梓",13,0,13
"22512","6180橘子","110/07/09","致和-崇德",0,15,-15
"22513","6180橘子","110/07/09","華南永昌-朴子",11,0,11
"22514","6180橘子","110/07/09","群益金鼎-屏東",0,15,-15
"22515","6180橘子","110/07/09","元大-北港",11,0,11
"22516","6180橘子","110/07/09","群益金鼎-中山",0,15,-15
"22517","6180橘子","110/07/09","元大-成功",10,1,9
"22518","6180橘子","110/07/09","瑞士信貸",1,15,-14
"22519","6180橘子","110/07/09","新光",26,18,8
"22520","6180橘子","110/07/09","日盛-二林",0,10,-10
"22521","6180橘子","110/07/09","統一-三重",6,0,6
"22522","6180橘子","110/07/09","凱基-東門",0,10,-10
"22523","6180橘子","110/07/09","群益金鼎-嘉義",6,0,6
"22524","6180橘子","110/07/09","華南永昌-三重",0,10,-10
"22525","6180橘子","110/07/09","元大-員林中山",6,0,6
"22526","6180橘子","110/07/09","元大-彰化民生",1,11,-10
"22527","6180橘子","110/07/09","合庫-鳳山",5,0,5
"22528","6180橘子","110/07/09","永豐金-新店",1,11,-10
"22529","6180橘子","110/07/09","富邦-建國",6,1,5
"22530","6180橘子","110/07/09","群益金鼎-丹鳳",0,8,-8
"22531","2390云辰","110/07/09","摩根大通",279,56,223
"22532","2390云辰","110/07/09","元大-天母",0,127,-127
"22533","2390云辰","110/07/09","日盛-鳳山",110,2,108
"22534","2390云辰","110/07/09","中國信託-文心",5,109,-104
"22535","2390云辰","110/07/09","宏遠證券",100,0,100
"22536","2390云辰","110/07/09","永豐金-復興",0,55,-55
"22537","2390云辰","110/07/09","元大-大里",63,6,57
"22538","2390云辰","110/07/09","凱基-台北",239,286,-47
"22539","2390云辰","110/07/09","凱基-八德",59,10,49
"22540","2390云辰","110/07/09","德信",2,32,-30
"22541","2390云辰","110/07/09","合庫-新竹",40,0,40
"22542","2390云辰","110/07/09","兆豐-桃鶯",2,32,-30
"22543","2390云辰","110/07/09","國票",40,1,39
"22544","2390云辰","110/07/09","致和-南京",0,30,-30
"22545","2390云辰","110/07/09","新加坡商瑞銀",49,13,36
"22546","2390云辰","110/07/09","富邦-虎尾",1,31,-30
"22547","2390云辰","110/07/09","統一-新台中",36,2,34
"22548","2390云辰","110/07/09","元大-善化",2,31,-29
"22549","2390云辰","110/07/09","國票-嘉義",31,0,31
"22550","2390云辰","110/07/09","富邦-板橋",0,27,-27
"22551","2390云辰","110/07/09","華南永昌",35,7,28
"22552","2390云辰","110/07/09","富邦-永和",3,28,-25
"22553","2390云辰","110/07/09","玉山-台中",49,22,27
"22554","2390云辰","110/07/09","第一金-自由",20,44,-24
"22555","2390云辰","110/07/09","華南永昌-敦南",25,0,25
"22556","2390云辰","110/07/09","凱基-內湖",0,24,-24
"22557","2390云辰","110/07/09","新光-高雄",27,4,23
"22558","2390云辰","110/07/09","元大-汐止",1,24,-23
"22559","2390云辰","110/07/09","台灣摩根士丹利",85,63,22
"22560","2390云辰","110/07/09","新光-台中",12,33,-21
"22561","4903聯光通","110/07/09","元大-敦南",10,0,10
"22562","4903聯光通","110/07/09","第一金-台中",0,12,-12
"22563","4903聯光通","110/07/09","凱基-士林",5,0,5
"22564","4903聯光通","110/07/09","日盛-忠孝",0,3,-3
"22565","4903聯光通","110/07/09","元大-苗栗",5,0,5
"22566","4903聯光通","110/07/09","群益金鼎-崇德",0,3,-3
"22567","4903聯光通","110/07/09","元大-屏南",3,0,3
"22568","4903聯光通","110/07/09","國票-內壢",0,2,-2
"22569","4903聯光通","110/07/09","中國信託-永康",1,0,1
"22570","4903聯光通","110/07/09","康和-南崁",0,2,-2
"22571","4903聯光通","110/07/09","玉山證券",1,0,1
"22572","4903聯光通","110/07/09","新光-台中",0,2,-2
"22573","4903聯光通","110/07/09","元大-太平",4,3,1
"22574","4903聯光通","110/07/09","玉山-城中",0,2,-2
"22575","4903聯光通","110/07/09","永豐金-嘉義",1,0,1
"22576","4903聯光通","110/07/09","中國信託-文心",0,1,-1
"22577","4903聯光通","110/07/09","大昌",0,0,0
"22578","4903聯光通","110/07/09","大昌",0,0,0
"22579","4903聯光通","110/07/09","中農",0,0,0
"22580","4903聯光通","110/07/09","中農",0,0,0
"22581","4903聯光通","110/07/09","",NA,NA,NA
"22582","4903聯光通","110/07/09","",NA,NA,NA
"22583","4903聯光通","110/07/09","",NA,NA,NA
"22584","4903聯光通","110/07/09","",NA,NA,NA
"22585","4903聯光通","110/07/09","",NA,NA,NA
"22586","4903聯光通","110/07/09","",NA,NA,NA
"22587","4903聯光通","110/07/09","",NA,NA,NA
"22588","4903聯光通","110/07/09","",NA,NA,NA
"22589","4903聯光通","110/07/09","",NA,NA,NA
"22590","4903聯光通","110/07/09","",NA,NA,NA
"22591","2929淘帝","110/07/09","台中銀-台北",110,0,110
"22592","2929淘帝","110/07/09","新光",2,82,-80
"22593","2929淘帝","110/07/09","華南永昌-頭份",72,0,72
"22594","2929淘帝","110/07/09","摩根大通",2,63,-61
"22595","2929淘帝","110/07/09","合庫-高雄",71,0,71
"22596","2929淘帝","110/07/09","第一金-路竹",0,50,-50
"22597","2929淘帝","110/07/09","高橋-龍潭",37,0,37
"22598","2929淘帝","110/07/09","港商麥格理",0,42,-42
"22599","2929淘帝","110/07/09","新光-台中",60,26,34
"22600","2929淘帝","110/07/09","陽信-石牌",0,40,-40
"22601","2929淘帝","110/07/09","元富-大裕",22,1,21
"22602","2929淘帝","110/07/09","台新-左楠",1,39,-38
"22603","2929淘帝","110/07/09","合庫-鳳山",20,0,20
"22604","2929淘帝","110/07/09","凱基-桃園",3,29,-26
"22605","2929淘帝","110/07/09","元大-員林",22,2,20
"22606","2929淘帝","110/07/09","兆豐-內湖",0,25,-25
"22607","2929淘帝","110/07/09","台新-建北",15,0,15
"22608","2929淘帝","110/07/09","元大-北港",0,20,-20
"22609","2929淘帝","110/07/09","兆豐-桃園",13,0,13
"22610","2929淘帝","110/07/09","富邦-北港",0,19,-19
"22611","2929淘帝","110/07/09","兆豐-忠孝",10,0,10
"22612","2929淘帝","110/07/09","富邦-花蓮",0,17,-17
"22613","2929淘帝","110/07/09","國票-敦北法人",10,0,10
"22614","2929淘帝","110/07/09","國泰-台中",2,17,-15
"22615","2929淘帝","110/07/09","永豐金-博愛",10,0,10
"22616","2929淘帝","110/07/09","群益金鼎-彰化",0,15,-15
"22617","2929淘帝","110/07/09","群益金鼎-潭子",8,0,8
"22618","2929淘帝","110/07/09","元大-博愛",0,14,-14
"22619","2929淘帝","110/07/09","富邦-南屯",8,0,8
"22620","2929淘帝","110/07/09","日盛-板橋",0,13,-13
"22621","5410國眾","110/07/09","元大-新盛",14,0,14
"22622","5410國眾","110/07/09","(牛牛牛)亞-鑫豐",1,41,-40
"22623","5410國眾","110/07/09","台灣企銀-民雄",10,0,10
"22624","5410國眾","110/07/09","元富-嘉義",0,25,-25
"22625","5410國眾","110/07/09","元富-虎尾",9,0,9
"22626","5410國眾","110/07/09","凱基-高美館",0,10,-10
"22627","5410國眾","110/07/09","摩根大通",10,1,9
"22628","5410國眾","110/07/09","凱基-城中",0,10,-10
"22629","5410國眾","110/07/09","兆豐-北高雄",7,0,7
"22630","5410國眾","110/07/09","元大-頭份",0,10,-10
"22631","5410國眾","110/07/09","凱基-台北",8,1,7
"22632","5410國眾","110/07/09","群益金鼎-丹鳳",0,7,-7
"22633","5410國眾","110/07/09","華南永昌-公誠",7,0,7
"22634","5410國眾","110/07/09","凱基-復興",0,7,-7
"22635","5410國眾","110/07/09","香港上海匯豐",6,0,6
"22636","5410國眾","110/07/09","元大-員林",0,7,-7
"22637","5410國眾","110/07/09","凱基-中壢",6,0,6
"22638","5410國眾","110/07/09","富邦-竹東",0,6,-6
"22639","5410國眾","110/07/09","華南永昌-南京",6,0,6
"22640","5410國眾","110/07/09","亞東-高雄",0,5,-5
"22641","5410國眾","110/07/09","統一-三重",5,0,5
"22642","5410國眾","110/07/09","大慶-中壢",1,6,-5
"22643","5410國眾","110/07/09","富邦-宜蘭",5,0,5
"22644","5410國眾","110/07/09","群益金鼎-中港",0,5,-5
"22645","5410國眾","110/07/09","元大-崇德",5,0,5
"22646","5410國眾","110/07/09","元大-八德",0,5,-5
"22647","5410國眾","110/07/09","元大-博愛",5,0,5
"22648","5410國眾","110/07/09","富邦-基隆",0,4,-4
"22649","5410國眾","110/07/09","元大-龍潭",5,0,5
"22650","5410國眾","110/07/09","臺銀-新竹",0,3,-3
"22651","2841台開","110/07/09","日盛-雙和",102,0,102
"22652","2841台開","110/07/09","港商野村",0,129,-129
"22653","2841台開","110/07/09","元大-館前",70,0,70
"22654","2841台開","110/07/09","兆豐-永和",0,100,-100
"22655","2841台開","110/07/09","凱基-文心",50,0,50
"22656","2841台開","110/07/09","台新證券",7,28,-21
"22657","2841台開","110/07/09","富邦-嘉義",40,0,40
"22658","2841台開","110/07/09","國票-北高雄",0,20,-20
"22659","2841台開","110/07/09","美商高盛",15,0,15
"22660","2841台開","110/07/09","永豐金-敦南",29,46,-17
"22661","2841台開","110/07/09","台中銀",15,0,15
"22662","2841台開","110/07/09","合庫-基隆",0,12,-12
"22663","2841台開","110/07/09","新光",11,0,11
"22664","2841台開","110/07/09","中國信託-松江",0,12,-12
"22665","2841台開","110/07/09","華南永昌-長虹",10,0,10
"22666","2841台開","110/07/09","兆豐-城中",0,12,-12
"22667","2841台開","110/07/09","永豐金-南投",10,0,10
"22668","2841台開","110/07/09","台中銀-豐原",0,10,-10
"22669","2841台開","110/07/09","合庫-桃園",7,0,7
"22670","2841台開","110/07/09","兆豐-景美",0,10,-10
"22671","2841台開","110/07/09","群益金鼎-古亭",7,0,7
"22672","2841台開","110/07/09","群益金鼎-基隆",0,10,-10
"22673","2841台開","110/07/09","國泰-敦南",6,0,6
"22674","2841台開","110/07/09","元大-北三重",0,10,-10
"22675","2841台開","110/07/09","凱基-桃園",8,2,6
"22676","2841台開","110/07/09","(牛牛牛)亞-網路",0,9,-9
"22677","2841台開","110/07/09","日盛證券",5,0,5
"22678","2841台開","110/07/09","台新-高雄",1,10,-9
"22679","2841台開","110/07/09","元富-文心",5,0,5
"22680","2841台開","110/07/09","凱基-台北",0,7,-7
"22681","6207雷科","110/07/09","群益金鼎-新竹",47,0,47
"22682","6207雷科","110/07/09","新光",7,24,-17
"22683","6207雷科","110/07/09","永豐金-三重",31,0,31
"22684","6207雷科","110/07/09","日盛-和美",0,15,-15
"22685","6207雷科","110/07/09","新加坡商瑞銀",33,5,28
"22686","6207雷科","110/07/09","國泰-台南",0,15,-15
"22687","6207雷科","110/07/09","元大-高雄",26,0,26
"22688","6207雷科","110/07/09","華南永昌-古亭",0,14,-14
"22689","6207雷科","110/07/09","統一-員林",22,0,22
"22690","6207雷科","110/07/09","土銀-白河",0,11,-11
"22691","6207雷科","110/07/09","台新-高雄",22,0,22
"22692","6207雷科","110/07/09","日盛-台南",0,10,-10
"22693","6207雷科","110/07/09","摩根大通",34,17,17
"22694","6207雷科","110/07/09","元富-林園",0,10,-10
"22695","6207雷科","110/07/09","元大-博愛",17,1,16
"22696","6207雷科","110/07/09","富邦-園區",0,10,-10
"22697","6207雷科","110/07/09","日茂-埔里",12,0,12
"22698","6207雷科","110/07/09","元大-上新莊",0,10,-10
"22699","6207雷科","110/07/09","國泰-台中",17,6,11
"22700","6207雷科","110/07/09","永豐金-南京",0,10,-10
"22701","6207雷科","110/07/09","富邦-三重",10,0,10
"22702","6207雷科","110/07/09","兆豐-小港",0,6,-6
"22703","6207雷科","110/07/09","元大-沙鹿",10,0,10
"22704","6207雷科","110/07/09","富邦-羅東",1,7,-6
"22705","6207雷科","110/07/09","元大-八德",10,0,10
"22706","6207雷科","110/07/09","元大-土城永寧",0,6,-6
"22707","6207雷科","110/07/09","第一金-路竹",11,2,9
"22708","6207雷科","110/07/09","永豐金-板盛",0,6,-6
"22709","6207雷科","110/07/09","統一-南京",5,0,5
"22710","6207雷科","110/07/09","日盛-板橋",0,5,-5
"22711","3679新至陞","110/07/09","元大-大天母",10,0,10
"22712","3679新至陞","110/07/09","第一金-光復",0,11,-11
"22713","3679新至陞","110/07/09","日盛-樹林",9,0,9
"22714","3679新至陞","110/07/09","瑞士信貸",0,8,-8
"22715","3679新至陞","110/07/09","凱基-台北",11,2,9
"22716","3679新至陞","110/07/09","大慶-苗栗",0,5,-5
"22717","3679新至陞","110/07/09","華南永昌-小港",8,0,8
"22718","3679新至陞","110/07/09","元大-永春",0,5,-5
"22719","3679新至陞","110/07/09","兆豐-來福",7,0,7
"22720","3679新至陞","110/07/09","日盛-和美",0,4,-4
"22721","3679新至陞","110/07/09","香港上海匯豐",5,0,5
"22722","3679新至陞","110/07/09","元大-雙和",0,3,-3
"22723","3679新至陞","110/07/09","台中銀-員林",3,0,3
"22724","3679新至陞","110/07/09","永豐金-屏東",0,3,-3
"22725","3679新至陞","110/07/09","新光",3,0,3
"22726","3679新至陞","110/07/09","彰銀",0,2,-2
"22727","3679新至陞","110/07/09","土銀-花蓮",2,0,2
"22728","3679新至陞","110/07/09","宏遠-館前",0,2,-2
"22729","3679新至陞","110/07/09","第一金-澎湖",2,0,2
"22730","3679新至陞","110/07/09","港商野村",0,2,-2
"22731","3679新至陞","110/07/09","摩根大通",2,0,2
"22732","3679新至陞","110/07/09","大昌-新店",0,2,-2
"22733","3679新至陞","110/07/09","國泰-敦南",2,0,2
"22734","3679新至陞","110/07/09","元大-新莊",0,2,-2
"22735","3679新至陞","110/07/09","元大-淡水",4,2,2
"22736","3679新至陞","110/07/09","元大-板橋",0,2,-2
"22737","3679新至陞","110/07/09","日盛-士林",1,0,1
"22738","3679新至陞","110/07/09","台灣摩根士丹利",0,1,-1
"22739","3679新至陞","110/07/09","日盛-信義",1,0,1
"22740","3679新至陞","110/07/09","第一金-高雄",0,1,-1
"22741","2727王品","110/07/09","台灣匯立證券",90,0,90
"22742","2727王品","110/07/09","台灣摩根士丹利",0,267,-267
"22743","2727王品","110/07/09","國泰-敦南",166,84,82
"22744","2727王品","110/07/09","富邦-台北",35,299,-264
"22745","2727王品","110/07/09","富邦-仁愛",56,12,44
"22746","2727王品","110/07/09","凱基-台北",174,296,-122
"22747","2727王品","110/07/09","台新證券",109,66,43
"22748","2727王品","110/07/09","第一金",2,102,-100
"22749","2727王品","110/07/09","新光",117,87,30
"22750","2727王品","110/07/09","群益金鼎-大安",0,80,-80
"22751","2727王品","110/07/09","臺銀-臺中",35,6,29
"22752","2727王品","110/07/09","兆豐-大安",7,60,-53
"22753","2727王品","110/07/09","元大-桃園",32,3,29
"22754","2727王品","110/07/09","永豐金-南投",0,50,-50
"22755","2727王品","110/07/09","元富-宜蘭",34,6,28
"22756","2727王品","110/07/09","新加坡商瑞銀",6,46,-40
"22757","2727王品","110/07/09","玉山-台中",34,8,26
"22758","2727王品","110/07/09","合庫-彰化",11,50,-39
"22759","2727王品","110/07/09","群益金鼎-宜蘭",30,4,26
"22760","2727王品","110/07/09","永豐金-萬盛",13,52,-39
"22761","2727王品","110/07/09","富邦-台中",42,16,26
"22762","2727王品","110/07/09","瑞士信貸",0,34,-34
"22763","2727王品","110/07/09","第一金-豐原",25,1,24
"22764","2727王品","110/07/09","元大-和平",4,35,-31
"22765","2727王品","110/07/09","臺銀",30,8,22
"22766","2727王品","110/07/09","美林",14,44,-30
"22767","2727王品","110/07/09","兆豐-來福",23,1,22
"22768","2727王品","110/07/09","元大-員林",9,38,-29
"22769","2727王品","110/07/09","玉山-士林",22,2,20
"22770","2727王品","110/07/09","元富-西松",4,31,-27
"22771","1570力肯","110/07/09","凱基-台北",30,1,29
"22772","1570力肯","110/07/09","群益金鼎-彰化",0,20,-20
"22773","1570力肯","110/07/09","新光-台南",20,0,20
"22774","1570力肯","110/07/09","元大-土城學府",0,20,-20
"22775","1570力肯","110/07/09","元大-高雄",20,0,20
"22776","1570力肯","110/07/09","元大-大統",0,16,-16
"22777","1570力肯","110/07/09","國票-中正",12,0,12
"22778","1570力肯","110/07/09","元大-新營",0,11,-11
"22779","1570力肯","110/07/09","日盛-高雄",6,0,6
"22780","1570力肯","110/07/09","元大-和平",0,10,-10
"22781","1570力肯","110/07/09","元富-緯城",6,0,6
"22782","1570力肯","110/07/09","元大-草屯",0,10,-10
"22783","1570力肯","110/07/09","群益金鼎-台南",6,0,6
"22784","1570力肯","110/07/09","元大-鹿港",0,9,-9
"22785","1570力肯","110/07/09","華南永昌-岡山",6,0,6
"22786","1570力肯","110/07/09","合庫-基隆",0,7,-7
"22787","1570力肯","110/07/09","統一-中壢",5,0,5
"22788","1570力肯","110/07/09","摩根大通",2,8,-6
"22789","1570力肯","110/07/09","凱基-三峽",5,0,5
"22790","1570力肯","110/07/09","台灣企銀-豐原",0,4,-4
"22791","1570力肯","110/07/09","大昌-樹林",4,0,4
"22792","1570力肯","110/07/09","日盛-桃園",0,4,-4
"22793","1570力肯","110/07/09","新光",3,0,3
"22794","1570力肯","110/07/09","國泰-高雄",0,3,-3
"22795","1570力肯","110/07/09","富邦-新竹華信",3,0,3
"22796","1570力肯","110/07/09","永豐金-敦南",0,3,-3
"22797","1570力肯","110/07/09","合庫-台中",2,0,2
"22798","1570力肯","110/07/09","土銀-彰化",0,2,-2
"22799","1570力肯","110/07/09","臺銀-臺中",2,0,2
"22800","1570力肯","110/07/09","臺銀-鳳山",0,2,-2
"22801","6180橘子","110/07/09","摩根大通",63,1,62
"22802","6180橘子","110/07/09","元大-南京",1,32,-31
"22803","6180橘子","110/07/09","富邦-陽明",73,33,40
"22804","6180橘子","110/07/09","群益金鼎-台北",0,25,-25
"22805","6180橘子","110/07/09","新加坡商瑞銀",31,0,31
"22806","6180橘子","110/07/09","兆豐-復興",0,21,-21
"22807","6180橘子","110/07/09","美商高盛",25,0,25
"22808","6180橘子","110/07/09","永豐金-嘉義",0,21,-21
"22809","6180橘子","110/07/09","凱基-台北",26,10,16
"22810","6180橘子","110/07/09","凱基-中壢",8,24,-16
"22811","6180橘子","110/07/09","華南永昌-楠梓",13,0,13
"22812","6180橘子","110/07/09","致和-崇德",0,15,-15
"22813","6180橘子","110/07/09","華南永昌-朴子",11,0,11
"22814","6180橘子","110/07/09","群益金鼎-屏東",0,15,-15
"22815","6180橘子","110/07/09","元大-北港",11,0,11
"22816","6180橘子","110/07/09","群益金鼎-中山",0,15,-15
"22817","6180橘子","110/07/09","元大-成功",10,1,9
"22818","6180橘子","110/07/09","瑞士信貸",1,15,-14
"22819","6180橘子","110/07/09","新光",26,18,8
"22820","6180橘子","110/07/09","日盛-二林",0,10,-10
"22821","6180橘子","110/07/09","統一-三重",6,0,6
"22822","6180橘子","110/07/09","凱基-東門",0,10,-10
"22823","6180橘子","110/07/09","群益金鼎-嘉義",6,0,6
"22824","6180橘子","110/07/09","華南永昌-三重",0,10,-10
"22825","6180橘子","110/07/09","元大-員林中山",6,0,6
"22826","6180橘子","110/07/09","元大-彰化民生",1,11,-10
"22827","6180橘子","110/07/09","合庫-鳳山",5,0,5
"22828","6180橘子","110/07/09","永豐金-新店",1,11,-10
"22829","6180橘子","110/07/09","富邦-建國",6,1,5
"22830","6180橘子","110/07/09","群益金鼎-丹鳳",0,8,-8
"22831","2390云辰","110/07/09","摩根大通",279,56,223
"22832","2390云辰","110/07/09","元大-天母",0,127,-127
"22833","2390云辰","110/07/09","日盛-鳳山",110,2,108
"22834","2390云辰","110/07/09","中國信託-文心",5,109,-104
"22835","2390云辰","110/07/09","宏遠證券",100,0,100
"22836","2390云辰","110/07/09","永豐金-復興",0,55,-55
"22837","2390云辰","110/07/09","元大-大里",63,6,57
"22838","2390云辰","110/07/09","凱基-台北",239,286,-47
"22839","2390云辰","110/07/09","凱基-八德",59,10,49
"22840","2390云辰","110/07/09","德信",2,32,-30
"22841","2390云辰","110/07/09","合庫-新竹",40,0,40
"22842","2390云辰","110/07/09","兆豐-桃鶯",2,32,-30
"22843","2390云辰","110/07/09","國票",40,1,39
"22844","2390云辰","110/07/09","致和-南京",0,30,-30
"22845","2390云辰","110/07/09","新加坡商瑞銀",49,13,36
"22846","2390云辰","110/07/09","富邦-虎尾",1,31,-30
"22847","2390云辰","110/07/09","統一-新台中",36,2,34
"22848","2390云辰","110/07/09","元大-善化",2,31,-29
"22849","2390云辰","110/07/09","國票-嘉義",31,0,31
"22850","2390云辰","110/07/09","富邦-板橋",0,27,-27
"22851","2390云辰","110/07/09","華南永昌",35,7,28
"22852","2390云辰","110/07/09","富邦-永和",3,28,-25
"22853","2390云辰","110/07/09","玉山-台中",49,22,27
"22854","2390云辰","110/07/09","第一金-自由",20,44,-24
"22855","2390云辰","110/07/09","華南永昌-敦南",25,0,25
"22856","2390云辰","110/07/09","凱基-內湖",0,24,-24
"22857","2390云辰","110/07/09","新光-高雄",27,4,23
"22858","2390云辰","110/07/09","元大-汐止",1,24,-23
"22859","2390云辰","110/07/09","台灣摩根士丹利",85,63,22
"22860","2390云辰","110/07/09","新光-台中",12,33,-21
"22861","4903聯光通","110/07/09","元大-敦南",10,0,10
"22862","4903聯光通","110/07/09","第一金-台中",0,12,-12
"22863","4903聯光通","110/07/09","凱基-士林",5,0,5
"22864","4903聯光通","110/07/09","日盛-忠孝",0,3,-3
"22865","4903聯光通","110/07/09","元大-苗栗",5,0,5
"22866","4903聯光通","110/07/09","群益金鼎-崇德",0,3,-3
"22867","4903聯光通","110/07/09","元大-屏南",3,0,3
"22868","4903聯光通","110/07/09","國票-內壢",0,2,-2
"22869","4903聯光通","110/07/09","中國信託-永康",1,0,1
"22870","4903聯光通","110/07/09","康和-南崁",0,2,-2
"22871","4903聯光通","110/07/09","玉山證券",1,0,1
"22872","4903聯光通","110/07/09","新光-台中",0,2,-2
"22873","4903聯光通","110/07/09","元大-太平",4,3,1
"22874","4903聯光通","110/07/09","玉山-城中",0,2,-2
"22875","4903聯光通","110/07/09","永豐金-嘉義",1,0,1
"22876","4903聯光通","110/07/09","中國信託-文心",0,1,-1
"22877","4903聯光通","110/07/09","大昌",0,0,0
"22878","4903聯光通","110/07/09","大昌",0,0,0
"22879","4903聯光通","110/07/09","中農",0,0,0
"22880","4903聯光通","110/07/09","中農",0,0,0
"22881","4903聯光通","110/07/09","",NA,NA,NA
"22882","4903聯光通","110/07/09","",NA,NA,NA
"22883","4903聯光通","110/07/09","",NA,NA,NA
"22884","4903聯光通","110/07/09","",NA,NA,NA
"22885","4903聯光通","110/07/09","",NA,NA,NA
"22886","4903聯光通","110/07/09","",NA,NA,NA
"22887","4903聯光通","110/07/09","",NA,NA,NA
"22888","4903聯光通","110/07/09","",NA,NA,NA
"22889","4903聯光通","110/07/09","",NA,NA,NA
"22890","4903聯光通","110/07/09","",NA,NA,NA
"22891","2929淘帝","110/07/09","台中銀-台北",110,0,110
"22892","2929淘帝","110/07/09","新光",2,82,-80
"22893","2929淘帝","110/07/09","華南永昌-頭份",72,0,72
"22894","2929淘帝","110/07/09","摩根大通",2,63,-61
"22895","2929淘帝","110/07/09","合庫-高雄",71,0,71
"22896","2929淘帝","110/07/09","第一金-路竹",0,50,-50
"22897","2929淘帝","110/07/09","高橋-龍潭",37,0,37
"22898","2929淘帝","110/07/09","港商麥格理",0,42,-42
"22899","2929淘帝","110/07/09","新光-台中",60,26,34
"22900","2929淘帝","110/07/09","陽信-石牌",0,40,-40
"22901","2929淘帝","110/07/09","元富-大裕",22,1,21
"22902","2929淘帝","110/07/09","台新-左楠",1,39,-38
"22903","2929淘帝","110/07/09","合庫-鳳山",20,0,20
"22904","2929淘帝","110/07/09","凱基-桃園",3,29,-26
"22905","2929淘帝","110/07/09","元大-員林",22,2,20
"22906","2929淘帝","110/07/09","兆豐-內湖",0,25,-25
"22907","2929淘帝","110/07/09","台新-建北",15,0,15
"22908","2929淘帝","110/07/09","元大-北港",0,20,-20
"22909","2929淘帝","110/07/09","兆豐-桃園",13,0,13
"22910","2929淘帝","110/07/09","富邦-北港",0,19,-19
"22911","2929淘帝","110/07/09","兆豐-忠孝",10,0,10
"22912","2929淘帝","110/07/09","富邦-花蓮",0,17,-17
"22913","2929淘帝","110/07/09","國票-敦北法人",10,0,10
"22914","2929淘帝","110/07/09","國泰-台中",2,17,-15
"22915","2929淘帝","110/07/09","永豐金-博愛",10,0,10
"22916","2929淘帝","110/07/09","群益金鼎-彰化",0,15,-15
"22917","2929淘帝","110/07/09","群益金鼎-潭子",8,0,8
"22918","2929淘帝","110/07/09","元大-博愛",0,14,-14
"22919","2929淘帝","110/07/09","富邦-南屯",8,0,8
"22920","2929淘帝","110/07/09","日盛-板橋",0,13,-13
"22921","5410國眾","110/07/09","元大-新盛",14,0,14
"22922","5410國眾","110/07/09","(牛牛牛)亞-鑫豐",1,41,-40
"22923","5410國眾","110/07/09","台灣企銀-民雄",10,0,10
"22924","5410國眾","110/07/09","元富-嘉義",0,25,-25
"22925","5410國眾","110/07/09","元富-虎尾",9,0,9
"22926","5410國眾","110/07/09","凱基-高美館",0,10,-10
"22927","5410國眾","110/07/09","摩根大通",10,1,9
"22928","5410國眾","110/07/09","凱基-城中",0,10,-10
"22929","5410國眾","110/07/09","兆豐-北高雄",7,0,7
"22930","5410國眾","110/07/09","元大-頭份",0,10,-10
"22931","5410國眾","110/07/09","凱基-台北",8,1,7
"22932","5410國眾","110/07/09","群益金鼎-丹鳳",0,7,-7
"22933","5410國眾","110/07/09","華南永昌-公誠",7,0,7
"22934","5410國眾","110/07/09","凱基-復興",0,7,-7
"22935","5410國眾","110/07/09","香港上海匯豐",6,0,6
"22936","5410國眾","110/07/09","元大-員林",0,7,-7
"22937","5410國眾","110/07/09","凱基-中壢",6,0,6
"22938","5410國眾","110/07/09","富邦-竹東",0,6,-6
"22939","5410國眾","110/07/09","華南永昌-南京",6,0,6
"22940","5410國眾","110/07/09","亞東-高雄",0,5,-5
"22941","5410國眾","110/07/09","統一-三重",5,0,5
"22942","5410國眾","110/07/09","大慶-中壢",1,6,-5
"22943","5410國眾","110/07/09","富邦-宜蘭",5,0,5
"22944","5410國眾","110/07/09","群益金鼎-中港",0,5,-5
"22945","5410國眾","110/07/09","元大-崇德",5,0,5
"22946","5410國眾","110/07/09","元大-八德",0,5,-5
"22947","5410國眾","110/07/09","元大-博愛",5,0,5
"22948","5410國眾","110/07/09","富邦-基隆",0,4,-4
"22949","5410國眾","110/07/09","元大-龍潭",5,0,5
"22950","5410國眾","110/07/09","臺銀-新竹",0,3,-3
"22951","2841台開","110/07/09","日盛-雙和",102,0,102
"22952","2841台開","110/07/09","港商野村",0,129,-129
"22953","2841台開","110/07/09","元大-館前",70,0,70
"22954","2841台開","110/07/09","兆豐-永和",0,100,-100
"22955","2841台開","110/07/09","凱基-文心",50,0,50
"22956","2841台開","110/07/09","台新證券",7,28,-21
"22957","2841台開","110/07/09","富邦-嘉義",40,0,40
"22958","2841台開","110/07/09","國票-北高雄",0,20,-20
"22959","2841台開","110/07/09","美商高盛",15,0,15
"22960","2841台開","110/07/09","永豐金-敦南",29,46,-17
"22961","2841台開","110/07/09","台中銀",15,0,15
"22962","2841台開","110/07/09","合庫-基隆",0,12,-12
"22963","2841台開","110/07/09","新光",11,0,11
"22964","2841台開","110/07/09","中國信託-松江",0,12,-12
"22965","2841台開","110/07/09","華南永昌-長虹",10,0,10
"22966","2841台開","110/07/09","兆豐-城中",0,12,-12
"22967","2841台開","110/07/09","永豐金-南投",10,0,10
"22968","2841台開","110/07/09","台中銀-豐原",0,10,-10
"22969","2841台開","110/07/09","合庫-桃園",7,0,7
"22970","2841台開","110/07/09","兆豐-景美",0,10,-10
"22971","2841台開","110/07/09","群益金鼎-古亭",7,0,7
"22972","2841台開","110/07/09","群益金鼎-基隆",0,10,-10
"22973","2841台開","110/07/09","國泰-敦南",6,0,6
"22974","2841台開","110/07/09","元大-北三重",0,10,-10
"22975","2841台開","110/07/09","凱基-桃園",8,2,6
"22976","2841台開","110/07/09","(牛牛牛)亞-網路",0,9,-9
"22977","2841台開","110/07/09","日盛證券",5,0,5
"22978","2841台開","110/07/09","台新-高雄",1,10,-9
"22979","2841台開","110/07/09","元富-文心",5,0,5
"22980","2841台開","110/07/09","凱基-台北",0,7,-7
"22981","6207雷科","110/07/09","群益金鼎-新竹",47,0,47
"22982","6207雷科","110/07/09","新光",7,24,-17
"22983","6207雷科","110/07/09","永豐金-三重",31,0,31
"22984","6207雷科","110/07/09","日盛-和美",0,15,-15
"22985","6207雷科","110/07/09","新加坡商瑞銀",33,5,28
"22986","6207雷科","110/07/09","國泰-台南",0,15,-15
"22987","6207雷科","110/07/09","元大-高雄",26,0,26
"22988","6207雷科","110/07/09","華南永昌-古亭",0,14,-14
"22989","6207雷科","110/07/09","統一-員林",22,0,22
"22990","6207雷科","110/07/09","土銀-白河",0,11,-11
"22991","6207雷科","110/07/09","台新-高雄",22,0,22
"22992","6207雷科","110/07/09","日盛-台南",0,10,-10
"22993","6207雷科","110/07/09","摩根大通",34,17,17
"22994","6207雷科","110/07/09","元富-林園",0,10,-10
"22995","6207雷科","110/07/09","元大-博愛",17,1,16
"22996","6207雷科","110/07/09","富邦-園區",0,10,-10
"22997","6207雷科","110/07/09","日茂-埔里",12,0,12
"22998","6207雷科","110/07/09","元大-上新莊",0,10,-10
"22999","6207雷科","110/07/09","國泰-台中",17,6,11
"23000","6207雷科","110/07/09","永豐金-南京",0,10,-10
"23001","6207雷科","110/07/09","富邦-三重",10,0,10
"23002","6207雷科","110/07/09","兆豐-小港",0,6,-6
"23003","6207雷科","110/07/09","元大-沙鹿",10,0,10
"23004","6207雷科","110/07/09","富邦-羅東",1,7,-6
"23005","6207雷科","110/07/09","元大-八德",10,0,10
"23006","6207雷科","110/07/09","元大-土城永寧",0,6,-6
"23007","6207雷科","110/07/09","第一金-路竹",11,2,9
"23008","6207雷科","110/07/09","永豐金-板盛",0,6,-6
"23009","6207雷科","110/07/09","統一-南京",5,0,5
"23010","6207雷科","110/07/09","日盛-板橋",0,5,-5
"23011","3679新至陞","110/07/09","元大-大天母",10,0,10
"23012","3679新至陞","110/07/09","第一金-光復",0,11,-11
"23013","3679新至陞","110/07/09","日盛-樹林",9,0,9
"23014","3679新至陞","110/07/09","瑞士信貸",0,8,-8
"23015","3679新至陞","110/07/09","凱基-台北",11,2,9
"23016","3679新至陞","110/07/09","大慶-苗栗",0,5,-5
"23017","3679新至陞","110/07/09","華南永昌-小港",8,0,8
"23018","3679新至陞","110/07/09","元大-永春",0,5,-5
"23019","3679新至陞","110/07/09","兆豐-來福",7,0,7
"23020","3679新至陞","110/07/09","日盛-和美",0,4,-4
"23021","3679新至陞","110/07/09","香港上海匯豐",5,0,5
"23022","3679新至陞","110/07/09","元大-雙和",0,3,-3
"23023","3679新至陞","110/07/09","台中銀-員林",3,0,3
"23024","3679新至陞","110/07/09","永豐金-屏東",0,3,-3
"23025","3679新至陞","110/07/09","新光",3,0,3
"23026","3679新至陞","110/07/09","彰銀",0,2,-2
"23027","3679新至陞","110/07/09","土銀-花蓮",2,0,2
"23028","3679新至陞","110/07/09","宏遠-館前",0,2,-2
"23029","3679新至陞","110/07/09","第一金-澎湖",2,0,2
"23030","3679新至陞","110/07/09","港商野村",0,2,-2
"23031","3679新至陞","110/07/09","摩根大通",2,0,2
"23032","3679新至陞","110/07/09","大昌-新店",0,2,-2
"23033","3679新至陞","110/07/09","國泰-敦南",2,0,2
"23034","3679新至陞","110/07/09","元大-新莊",0,2,-2
"23035","3679新至陞","110/07/09","元大-淡水",4,2,2
"23036","3679新至陞","110/07/09","元大-板橋",0,2,-2
"23037","3679新至陞","110/07/09","日盛-士林",1,0,1
"23038","3679新至陞","110/07/09","台灣摩根士丹利",0,1,-1
"23039","3679新至陞","110/07/09","日盛-信義",1,0,1
"23040","3679新至陞","110/07/09","第一金-高雄",0,1,-1
"23041","2727王品","110/07/09","台灣匯立證券",90,0,90
"23042","2727王品","110/07/09","台灣摩根士丹利",0,267,-267
"23043","2727王品","110/07/09","國泰-敦南",166,84,82
"23044","2727王品","110/07/09","富邦-台北",35,299,-264
"23045","2727王品","110/07/09","富邦-仁愛",56,12,44
"23046","2727王品","110/07/09","凱基-台北",174,296,-122
"23047","2727王品","110/07/09","台新證券",109,66,43
"23048","2727王品","110/07/09","第一金",2,102,-100
"23049","2727王品","110/07/09","新光",117,87,30
"23050","2727王品","110/07/09","群益金鼎-大安",0,80,-80
"23051","2727王品","110/07/09","臺銀-臺中",35,6,29
"23052","2727王品","110/07/09","兆豐-大安",7,60,-53
"23053","2727王品","110/07/09","元大-桃園",32,3,29
"23054","2727王品","110/07/09","永豐金-南投",0,50,-50
"23055","2727王品","110/07/09","元富-宜蘭",34,6,28
"23056","2727王品","110/07/09","新加坡商瑞銀",6,46,-40
"23057","2727王品","110/07/09","玉山-台中",34,8,26
"23058","2727王品","110/07/09","合庫-彰化",11,50,-39
"23059","2727王品","110/07/09","群益金鼎-宜蘭",30,4,26
"23060","2727王品","110/07/09","永豐金-萬盛",13,52,-39
"23061","2727王品","110/07/09","富邦-台中",42,16,26
"23062","2727王品","110/07/09","瑞士信貸",0,34,-34
"23063","2727王品","110/07/09","第一金-豐原",25,1,24
"23064","2727王品","110/07/09","元大-和平",4,35,-31
"23065","2727王品","110/07/09","臺銀",30,8,22
"23066","2727王品","110/07/09","美林",14,44,-30
"23067","2727王品","110/07/09","兆豐-來福",23,1,22
"23068","2727王品","110/07/09","元大-員林",9,38,-29
"23069","2727王品","110/07/09","玉山-士林",22,2,20
"23070","2727王品","110/07/09","元富-西松",4,31,-27
"23071","1570力肯","110/07/09","凱基-台北",30,1,29
"23072","1570力肯","110/07/09","群益金鼎-彰化",0,20,-20
"23073","1570力肯","110/07/09","新光-台南",20,0,20
"23074","1570力肯","110/07/09","元大-土城學府",0,20,-20
"23075","1570力肯","110/07/09","元大-高雄",20,0,20
"23076","1570力肯","110/07/09","元大-大統",0,16,-16
"23077","1570力肯","110/07/09","國票-中正",12,0,12
"23078","1570力肯","110/07/09","元大-新營",0,11,-11
"23079","1570力肯","110/07/09","日盛-高雄",6,0,6
"23080","1570力肯","110/07/09","元大-和平",0,10,-10
"23081","1570力肯","110/07/09","元富-緯城",6,0,6
"23082","1570力肯","110/07/09","元大-草屯",0,10,-10
"23083","1570力肯","110/07/09","群益金鼎-台南",6,0,6
"23084","1570力肯","110/07/09","元大-鹿港",0,9,-9
"23085","1570力肯","110/07/09","華南永昌-岡山",6,0,6
"23086","1570力肯","110/07/09","合庫-基隆",0,7,-7
"23087","1570力肯","110/07/09","統一-中壢",5,0,5
"23088","1570力肯","110/07/09","摩根大通",2,8,-6
"23089","1570力肯","110/07/09","凱基-三峽",5,0,5
"23090","1570力肯","110/07/09","台灣企銀-豐原",0,4,-4
"23091","1570力肯","110/07/09","大昌-樹林",4,0,4
"23092","1570力肯","110/07/09","日盛-桃園",0,4,-4
"23093","1570力肯","110/07/09","新光",3,0,3
"23094","1570力肯","110/07/09","國泰-高雄",0,3,-3
"23095","1570力肯","110/07/09","富邦-新竹華信",3,0,3
"23096","1570力肯","110/07/09","永豐金-敦南",0,3,-3
"23097","1570力肯","110/07/09","合庫-台中",2,0,2
"23098","1570力肯","110/07/09","土銀-彰化",0,2,-2
"23099","1570力肯","110/07/09","臺銀-臺中",2,0,2
"23100","1570力肯","110/07/09","臺銀-鳳山",0,2,-2
"23101","6180橘子","110/07/09","摩根大通",63,1,62
"23102","6180橘子","110/07/09","元大-南京",1,32,-31
"23103","6180橘子","110/07/09","富邦-陽明",73,33,40
"23104","6180橘子","110/07/09","群益金鼎-台北",0,25,-25
"23105","6180橘子","110/07/09","新加坡商瑞銀",31,0,31
"23106","6180橘子","110/07/09","兆豐-復興",0,21,-21
"23107","6180橘子","110/07/09","美商高盛",25,0,25
"23108","6180橘子","110/07/09","永豐金-嘉義",0,21,-21
"23109","6180橘子","110/07/09","凱基-台北",26,10,16
"23110","6180橘子","110/07/09","凱基-中壢",8,24,-16
"23111","6180橘子","110/07/09","華南永昌-楠梓",13,0,13
"23112","6180橘子","110/07/09","致和-崇德",0,15,-15
"23113","6180橘子","110/07/09","華南永昌-朴子",11,0,11
"23114","6180橘子","110/07/09","群益金鼎-屏東",0,15,-15
"23115","6180橘子","110/07/09","元大-北港",11,0,11
"23116","6180橘子","110/07/09","群益金鼎-中山",0,15,-15
"23117","6180橘子","110/07/09","元大-成功",10,1,9
"23118","6180橘子","110/07/09","瑞士信貸",1,15,-14
"23119","6180橘子","110/07/09","新光",26,18,8
"23120","6180橘子","110/07/09","日盛-二林",0,10,-10
"23121","6180橘子","110/07/09","統一-三重",6,0,6
"23122","6180橘子","110/07/09","凱基-東門",0,10,-10
"23123","6180橘子","110/07/09","群益金鼎-嘉義",6,0,6
"23124","6180橘子","110/07/09","華南永昌-三重",0,10,-10
"23125","6180橘子","110/07/09","元大-員林中山",6,0,6
"23126","6180橘子","110/07/09","元大-彰化民生",1,11,-10
"23127","6180橘子","110/07/09","合庫-鳳山",5,0,5
"23128","6180橘子","110/07/09","永豐金-新店",1,11,-10
"23129","6180橘子","110/07/09","富邦-建國",6,1,5
"23130","6180橘子","110/07/09","群益金鼎-丹鳳",0,8,-8
"23131","2390云辰","110/07/09","摩根大通",279,56,223
"23132","2390云辰","110/07/09","元大-天母",0,127,-127
"23133","2390云辰","110/07/09","日盛-鳳山",110,2,108
"23134","2390云辰","110/07/09","中國信託-文心",5,109,-104
"23135","2390云辰","110/07/09","宏遠證券",100,0,100
"23136","2390云辰","110/07/09","永豐金-復興",0,55,-55
"23137","2390云辰","110/07/09","元大-大里",63,6,57
"23138","2390云辰","110/07/09","凱基-台北",239,286,-47
"23139","2390云辰","110/07/09","凱基-八德",59,10,49
"23140","2390云辰","110/07/09","德信",2,32,-30
"23141","2390云辰","110/07/09","合庫-新竹",40,0,40
"23142","2390云辰","110/07/09","兆豐-桃鶯",2,32,-30
"23143","2390云辰","110/07/09","國票",40,1,39
"23144","2390云辰","110/07/09","致和-南京",0,30,-30
"23145","2390云辰","110/07/09","新加坡商瑞銀",49,13,36
"23146","2390云辰","110/07/09","富邦-虎尾",1,31,-30
"23147","2390云辰","110/07/09","統一-新台中",36,2,34
"23148","2390云辰","110/07/09","元大-善化",2,31,-29
"23149","2390云辰","110/07/09","國票-嘉義",31,0,31
"23150","2390云辰","110/07/09","富邦-板橋",0,27,-27
"23151","2390云辰","110/07/09","華南永昌",35,7,28
"23152","2390云辰","110/07/09","富邦-永和",3,28,-25
"23153","2390云辰","110/07/09","玉山-台中",49,22,27
"23154","2390云辰","110/07/09","第一金-自由",20,44,-24
"23155","2390云辰","110/07/09","華南永昌-敦南",25,0,25
"23156","2390云辰","110/07/09","凱基-內湖",0,24,-24
"23157","2390云辰","110/07/09","新光-高雄",27,4,23
"23158","2390云辰","110/07/09","元大-汐止",1,24,-23
"23159","2390云辰","110/07/09","台灣摩根士丹利",85,63,22
"23160","2390云辰","110/07/09","新光-台中",12,33,-21
"23161","4903聯光通","110/07/09","元大-敦南",10,0,10
"23162","4903聯光通","110/07/09","第一金-台中",0,12,-12
"23163","4903聯光通","110/07/09","凱基-士林",5,0,5
"23164","4903聯光通","110/07/09","日盛-忠孝",0,3,-3
"23165","4903聯光通","110/07/09","元大-苗栗",5,0,5
"23166","4903聯光通","110/07/09","群益金鼎-崇德",0,3,-3
"23167","4903聯光通","110/07/09","元大-屏南",3,0,3
"23168","4903聯光通","110/07/09","國票-內壢",0,2,-2
"23169","4903聯光通","110/07/09","中國信託-永康",1,0,1
"23170","4903聯光通","110/07/09","康和-南崁",0,2,-2
"23171","4903聯光通","110/07/09","玉山證券",1,0,1
"23172","4903聯光通","110/07/09","新光-台中",0,2,-2
"23173","4903聯光通","110/07/09","元大-太平",4,3,1
"23174","4903聯光通","110/07/09","玉山-城中",0,2,-2
"23175","4903聯光通","110/07/09","永豐金-嘉義",1,0,1
"23176","4903聯光通","110/07/09","中國信託-文心",0,1,-1
"23177","4903聯光通","110/07/09","大昌",0,0,0
"23178","4903聯光通","110/07/09","大昌",0,0,0
"23179","4903聯光通","110/07/09","中農",0,0,0
"23180","4903聯光通","110/07/09","中農",0,0,0
"23181","4903聯光通","110/07/09","",NA,NA,NA
"23182","4903聯光通","110/07/09","",NA,NA,NA
"23183","4903聯光通","110/07/09","",NA,NA,NA
"23184","4903聯光通","110/07/09","",NA,NA,NA
"23185","4903聯光通","110/07/09","",NA,NA,NA
"23186","4903聯光通","110/07/09","",NA,NA,NA
"23187","4903聯光通","110/07/09","",NA,NA,NA
"23188","4903聯光通","110/07/09","",NA,NA,NA
"23189","4903聯光通","110/07/09","",NA,NA,NA
"23190","4903聯光通","110/07/09","",NA,NA,NA
"23191","2929淘帝","110/07/09","台中銀-台北",110,0,110
"23192","2929淘帝","110/07/09","新光",2,82,-80
"23193","2929淘帝","110/07/09","華南永昌-頭份",72,0,72
"23194","2929淘帝","110/07/09","摩根大通",2,63,-61
"23195","2929淘帝","110/07/09","合庫-高雄",71,0,71
"23196","2929淘帝","110/07/09","第一金-路竹",0,50,-50
"23197","2929淘帝","110/07/09","高橋-龍潭",37,0,37
"23198","2929淘帝","110/07/09","港商麥格理",0,42,-42
"23199","2929淘帝","110/07/09","新光-台中",60,26,34
"23200","2929淘帝","110/07/09","陽信-石牌",0,40,-40
"23201","2929淘帝","110/07/09","元富-大裕",22,1,21
"23202","2929淘帝","110/07/09","台新-左楠",1,39,-38
"23203","2929淘帝","110/07/09","合庫-鳳山",20,0,20
"23204","2929淘帝","110/07/09","凱基-桃園",3,29,-26
"23205","2929淘帝","110/07/09","元大-員林",22,2,20
"23206","2929淘帝","110/07/09","兆豐-內湖",0,25,-25
"23207","2929淘帝","110/07/09","台新-建北",15,0,15
"23208","2929淘帝","110/07/09","元大-北港",0,20,-20
"23209","2929淘帝","110/07/09","兆豐-桃園",13,0,13
"23210","2929淘帝","110/07/09","富邦-北港",0,19,-19
"23211","2929淘帝","110/07/09","兆豐-忠孝",10,0,10
"23212","2929淘帝","110/07/09","富邦-花蓮",0,17,-17
"23213","2929淘帝","110/07/09","國票-敦北法人",10,0,10
"23214","2929淘帝","110/07/09","國泰-台中",2,17,-15
"23215","2929淘帝","110/07/09","永豐金-博愛",10,0,10
"23216","2929淘帝","110/07/09","群益金鼎-彰化",0,15,-15
"23217","2929淘帝","110/07/09","群益金鼎-潭子",8,0,8
"23218","2929淘帝","110/07/09","元大-博愛",0,14,-14
"23219","2929淘帝","110/07/09","富邦-南屯",8,0,8
"23220","2929淘帝","110/07/09","日盛-板橋",0,13,-13
"23221","5410國眾","110/07/09","元大-新盛",14,0,14
"23222","5410國眾","110/07/09","(牛牛牛)亞-鑫豐",1,41,-40
"23223","5410國眾","110/07/09","台灣企銀-民雄",10,0,10
"23224","5410國眾","110/07/09","元富-嘉義",0,25,-25
"23225","5410國眾","110/07/09","元富-虎尾",9,0,9
"23226","5410國眾","110/07/09","凱基-高美館",0,10,-10
"23227","5410國眾","110/07/09","摩根大通",10,1,9
"23228","5410國眾","110/07/09","凱基-城中",0,10,-10
"23229","5410國眾","110/07/09","兆豐-北高雄",7,0,7
"23230","5410國眾","110/07/09","元大-頭份",0,10,-10
"23231","5410國眾","110/07/09","凱基-台北",8,1,7
"23232","5410國眾","110/07/09","群益金鼎-丹鳳",0,7,-7
"23233","5410國眾","110/07/09","華南永昌-公誠",7,0,7
"23234","5410國眾","110/07/09","凱基-復興",0,7,-7
"23235","5410國眾","110/07/09","香港上海匯豐",6,0,6
"23236","5410國眾","110/07/09","元大-員林",0,7,-7
"23237","5410國眾","110/07/09","凱基-中壢",6,0,6
"23238","5410國眾","110/07/09","富邦-竹東",0,6,-6
"23239","5410國眾","110/07/09","華南永昌-南京",6,0,6
"23240","5410國眾","110/07/09","亞東-高雄",0,5,-5
"23241","5410國眾","110/07/09","統一-三重",5,0,5
"23242","5410國眾","110/07/09","大慶-中壢",1,6,-5
"23243","5410國眾","110/07/09","富邦-宜蘭",5,0,5
"23244","5410國眾","110/07/09","群益金鼎-中港",0,5,-5
"23245","5410國眾","110/07/09","元大-崇德",5,0,5
"23246","5410國眾","110/07/09","元大-八德",0,5,-5
"23247","5410國眾","110/07/09","元大-博愛",5,0,5
"23248","5410國眾","110/07/09","富邦-基隆",0,4,-4
"23249","5410國眾","110/07/09","元大-龍潭",5,0,5
"23250","5410國眾","110/07/09","臺銀-新竹",0,3,-3
"23251","2841台開","110/07/09","日盛-雙和",102,0,102
"23252","2841台開","110/07/09","港商野村",0,129,-129
"23253","2841台開","110/07/09","元大-館前",70,0,70
"23254","2841台開","110/07/09","兆豐-永和",0,100,-100
"23255","2841台開","110/07/09","凱基-文心",50,0,50
"23256","2841台開","110/07/09","台新證券",7,28,-21
"23257","2841台開","110/07/09","富邦-嘉義",40,0,40
"23258","2841台開","110/07/09","國票-北高雄",0,20,-20
"23259","2841台開","110/07/09","美商高盛",15,0,15
"23260","2841台開","110/07/09","永豐金-敦南",29,46,-17
"23261","2841台開","110/07/09","台中銀",15,0,15
"23262","2841台開","110/07/09","合庫-基隆",0,12,-12
"23263","2841台開","110/07/09","新光",11,0,11
"23264","2841台開","110/07/09","中國信託-松江",0,12,-12
"23265","2841台開","110/07/09","華南永昌-長虹",10,0,10
"23266","2841台開","110/07/09","兆豐-城中",0,12,-12
"23267","2841台開","110/07/09","永豐金-南投",10,0,10
"23268","2841台開","110/07/09","台中銀-豐原",0,10,-10
"23269","2841台開","110/07/09","合庫-桃園",7,0,7
"23270","2841台開","110/07/09","兆豐-景美",0,10,-10
"23271","2841台開","110/07/09","群益金鼎-古亭",7,0,7
"23272","2841台開","110/07/09","群益金鼎-基隆",0,10,-10
"23273","2841台開","110/07/09","國泰-敦南",6,0,6
"23274","2841台開","110/07/09","元大-北三重",0,10,-10
"23275","2841台開","110/07/09","凱基-桃園",8,2,6
"23276","2841台開","110/07/09","(牛牛牛)亞-網路",0,9,-9
"23277","2841台開","110/07/09","日盛證券",5,0,5
"23278","2841台開","110/07/09","台新-高雄",1,10,-9
"23279","2841台開","110/07/09","元富-文心",5,0,5
"23280","2841台開","110/07/09","凱基-台北",0,7,-7
"23281","6207雷科","110/07/09","群益金鼎-新竹",47,0,47
"23282","6207雷科","110/07/09","新光",7,24,-17
"23283","6207雷科","110/07/09","永豐金-三重",31,0,31
"23284","6207雷科","110/07/09","日盛-和美",0,15,-15
"23285","6207雷科","110/07/09","新加坡商瑞銀",33,5,28
"23286","6207雷科","110/07/09","國泰-台南",0,15,-15
"23287","6207雷科","110/07/09","元大-高雄",26,0,26
"23288","6207雷科","110/07/09","華南永昌-古亭",0,14,-14
"23289","6207雷科","110/07/09","統一-員林",22,0,22
"23290","6207雷科","110/07/09","土銀-白河",0,11,-11
"23291","6207雷科","110/07/09","台新-高雄",22,0,22
"23292","6207雷科","110/07/09","日盛-台南",0,10,-10
"23293","6207雷科","110/07/09","摩根大通",34,17,17
"23294","6207雷科","110/07/09","元富-林園",0,10,-10
"23295","6207雷科","110/07/09","元大-博愛",17,1,16
"23296","6207雷科","110/07/09","富邦-園區",0,10,-10
"23297","6207雷科","110/07/09","日茂-埔里",12,0,12
"23298","6207雷科","110/07/09","元大-上新莊",0,10,-10
"23299","6207雷科","110/07/09","國泰-台中",17,6,11
"23300","6207雷科","110/07/09","永豐金-南京",0,10,-10
"23301","6207雷科","110/07/09","富邦-三重",10,0,10
"23302","6207雷科","110/07/09","兆豐-小港",0,6,-6
"23303","6207雷科","110/07/09","元大-沙鹿",10,0,10
"23304","6207雷科","110/07/09","富邦-羅東",1,7,-6
"23305","6207雷科","110/07/09","元大-八德",10,0,10
"23306","6207雷科","110/07/09","元大-土城永寧",0,6,-6
"23307","6207雷科","110/07/09","第一金-路竹",11,2,9
"23308","6207雷科","110/07/09","永豐金-板盛",0,6,-6
"23309","6207雷科","110/07/09","統一-南京",5,0,5
"23310","6207雷科","110/07/09","日盛-板橋",0,5,-5
"23311","3679新至陞","110/07/09","元大-大天母",10,0,10
"23312","3679新至陞","110/07/09","第一金-光復",0,11,-11
"23313","3679新至陞","110/07/09","日盛-樹林",9,0,9
"23314","3679新至陞","110/07/09","瑞士信貸",0,8,-8
"23315","3679新至陞","110/07/09","凱基-台北",11,2,9
"23316","3679新至陞","110/07/09","大慶-苗栗",0,5,-5
"23317","3679新至陞","110/07/09","華南永昌-小港",8,0,8
"23318","3679新至陞","110/07/09","元大-永春",0,5,-5
"23319","3679新至陞","110/07/09","兆豐-來福",7,0,7
"23320","3679新至陞","110/07/09","日盛-和美",0,4,-4
"23321","3679新至陞","110/07/09","香港上海匯豐",5,0,5
"23322","3679新至陞","110/07/09","元大-雙和",0,3,-3
"23323","3679新至陞","110/07/09","台中銀-員林",3,0,3
"23324","3679新至陞","110/07/09","永豐金-屏東",0,3,-3
"23325","3679新至陞","110/07/09","新光",3,0,3
"23326","3679新至陞","110/07/09","彰銀",0,2,-2
"23327","3679新至陞","110/07/09","土銀-花蓮",2,0,2
"23328","3679新至陞","110/07/09","宏遠-館前",0,2,-2
"23329","3679新至陞","110/07/09","第一金-澎湖",2,0,2
"23330","3679新至陞","110/07/09","港商野村",0,2,-2
"23331","3679新至陞","110/07/09","摩根大通",2,0,2
"23332","3679新至陞","110/07/09","大昌-新店",0,2,-2
"23333","3679新至陞","110/07/09","國泰-敦南",2,0,2
"23334","3679新至陞","110/07/09","元大-新莊",0,2,-2
"23335","3679新至陞","110/07/09","元大-淡水",4,2,2
"23336","3679新至陞","110/07/09","元大-板橋",0,2,-2
"23337","3679新至陞","110/07/09","日盛-士林",1,0,1
"23338","3679新至陞","110/07/09","台灣摩根士丹利",0,1,-1
"23339","3679新至陞","110/07/09","日盛-信義",1,0,1
"23340","3679新至陞","110/07/09","第一金-高雄",0,1,-1
"23341","2727王品","110/07/09","台灣匯立證券",90,0,90
"23342","2727王品","110/07/09","台灣摩根士丹利",0,267,-267
"23343","2727王品","110/07/09","國泰-敦南",166,84,82
"23344","2727王品","110/07/09","富邦-台北",35,299,-264
"23345","2727王品","110/07/09","富邦-仁愛",56,12,44
"23346","2727王品","110/07/09","凱基-台北",174,296,-122
"23347","2727王品","110/07/09","台新證券",109,66,43
"23348","2727王品","110/07/09","第一金",2,102,-100
"23349","2727王品","110/07/09","新光",117,87,30
"23350","2727王品","110/07/09","群益金鼎-大安",0,80,-80
"23351","2727王品","110/07/09","臺銀-臺中",35,6,29
"23352","2727王品","110/07/09","兆豐-大安",7,60,-53
"23353","2727王品","110/07/09","元大-桃園",32,3,29
"23354","2727王品","110/07/09","永豐金-南投",0,50,-50
"23355","2727王品","110/07/09","元富-宜蘭",34,6,28
"23356","2727王品","110/07/09","新加坡商瑞銀",6,46,-40
"23357","2727王品","110/07/09","玉山-台中",34,8,26
"23358","2727王品","110/07/09","合庫-彰化",11,50,-39
"23359","2727王品","110/07/09","群益金鼎-宜蘭",30,4,26
"23360","2727王品","110/07/09","永豐金-萬盛",13,52,-39
"23361","2727王品","110/07/09","富邦-台中",42,16,26
"23362","2727王品","110/07/09","瑞士信貸",0,34,-34
"23363","2727王品","110/07/09","第一金-豐原",25,1,24
"23364","2727王品","110/07/09","元大-和平",4,35,-31
"23365","2727王品","110/07/09","臺銀",30,8,22
"23366","2727王品","110/07/09","美林",14,44,-30
"23367","2727王品","110/07/09","兆豐-來福",23,1,22
"23368","2727王品","110/07/09","元大-員林",9,38,-29
"23369","2727王品","110/07/09","玉山-士林",22,2,20
"23370","2727王品","110/07/09","元富-西松",4,31,-27
"23371","1570力肯","110/07/09","凱基-台北",30,1,29
"23372","1570力肯","110/07/09","群益金鼎-彰化",0,20,-20
"23373","1570力肯","110/07/09","新光-台南",20,0,20
"23374","1570力肯","110/07/09","元大-土城學府",0,20,-20
"23375","1570力肯","110/07/09","元大-高雄",20,0,20
"23376","1570力肯","110/07/09","元大-大統",0,16,-16
"23377","1570力肯","110/07/09","國票-中正",12,0,12
"23378","1570力肯","110/07/09","元大-新營",0,11,-11
"23379","1570力肯","110/07/09","日盛-高雄",6,0,6
"23380","1570力肯","110/07/09","元大-和平",0,10,-10
"23381","1570力肯","110/07/09","元富-緯城",6,0,6
"23382","1570力肯","110/07/09","元大-草屯",0,10,-10
"23383","1570力肯","110/07/09","群益金鼎-台南",6,0,6
"23384","1570力肯","110/07/09","元大-鹿港",0,9,-9
"23385","1570力肯","110/07/09","華南永昌-岡山",6,0,6
"23386","1570力肯","110/07/09","合庫-基隆",0,7,-7
"23387","1570力肯","110/07/09","統一-中壢",5,0,5
"23388","1570力肯","110/07/09","摩根大通",2,8,-6
"23389","1570力肯","110/07/09","凱基-三峽",5,0,5
"23390","1570力肯","110/07/09","台灣企銀-豐原",0,4,-4
"23391","1570力肯","110/07/09","大昌-樹林",4,0,4
"23392","1570力肯","110/07/09","日盛-桃園",0,4,-4
"23393","1570力肯","110/07/09","新光",3,0,3
"23394","1570力肯","110/07/09","國泰-高雄",0,3,-3
"23395","1570力肯","110/07/09","富邦-新竹華信",3,0,3
"23396","1570力肯","110/07/09","永豐金-敦南",0,3,-3
"23397","1570力肯","110/07/09","合庫-台中",2,0,2
"23398","1570力肯","110/07/09","土銀-彰化",0,2,-2
"23399","1570力肯","110/07/09","臺銀-臺中",2,0,2
"23400","1570力肯","110/07/09","臺銀-鳳山",0,2,-2
"23401","6180橘子","110/07/09","摩根大通",63,1,62
"23402","6180橘子","110/07/09","元大-南京",1,32,-31
"23403","6180橘子","110/07/09","富邦-陽明",73,33,40
"23404","6180橘子","110/07/09","群益金鼎-台北",0,25,-25
"23405","6180橘子","110/07/09","新加坡商瑞銀",31,0,31
"23406","6180橘子","110/07/09","兆豐-復興",0,21,-21
"23407","6180橘子","110/07/09","美商高盛",25,0,25
"23408","6180橘子","110/07/09","永豐金-嘉義",0,21,-21
"23409","6180橘子","110/07/09","凱基-台北",26,10,16
"23410","6180橘子","110/07/09","凱基-中壢",8,24,-16
"23411","6180橘子","110/07/09","華南永昌-楠梓",13,0,13
"23412","6180橘子","110/07/09","致和-崇德",0,15,-15
"23413","6180橘子","110/07/09","華南永昌-朴子",11,0,11
"23414","6180橘子","110/07/09","群益金鼎-屏東",0,15,-15
"23415","6180橘子","110/07/09","元大-北港",11,0,11
"23416","6180橘子","110/07/09","群益金鼎-中山",0,15,-15
"23417","6180橘子","110/07/09","元大-成功",10,1,9
"23418","6180橘子","110/07/09","瑞士信貸",1,15,-14
"23419","6180橘子","110/07/09","新光",26,18,8
"23420","6180橘子","110/07/09","日盛-二林",0,10,-10
"23421","6180橘子","110/07/09","統一-三重",6,0,6
"23422","6180橘子","110/07/09","凱基-東門",0,10,-10
"23423","6180橘子","110/07/09","群益金鼎-嘉義",6,0,6
"23424","6180橘子","110/07/09","華南永昌-三重",0,10,-10
"23425","6180橘子","110/07/09","元大-員林中山",6,0,6
"23426","6180橘子","110/07/09","元大-彰化民生",1,11,-10
"23427","6180橘子","110/07/09","合庫-鳳山",5,0,5
"23428","6180橘子","110/07/09","永豐金-新店",1,11,-10
"23429","6180橘子","110/07/09","富邦-建國",6,1,5
"23430","6180橘子","110/07/09","群益金鼎-丹鳳",0,8,-8
"23431","2390云辰","110/07/09","摩根大通",279,56,223
"23432","2390云辰","110/07/09","元大-天母",0,127,-127
"23433","2390云辰","110/07/09","日盛-鳳山",110,2,108
"23434","2390云辰","110/07/09","中國信託-文心",5,109,-104
"23435","2390云辰","110/07/09","宏遠證券",100,0,100
"23436","2390云辰","110/07/09","永豐金-復興",0,55,-55
"23437","2390云辰","110/07/09","元大-大里",63,6,57
"23438","2390云辰","110/07/09","凱基-台北",239,286,-47
"23439","2390云辰","110/07/09","凱基-八德",59,10,49
"23440","2390云辰","110/07/09","德信",2,32,-30
"23441","2390云辰","110/07/09","合庫-新竹",40,0,40
"23442","2390云辰","110/07/09","兆豐-桃鶯",2,32,-30
"23443","2390云辰","110/07/09","國票",40,1,39
"23444","2390云辰","110/07/09","致和-南京",0,30,-30
"23445","2390云辰","110/07/09","新加坡商瑞銀",49,13,36
"23446","2390云辰","110/07/09","富邦-虎尾",1,31,-30
"23447","2390云辰","110/07/09","統一-新台中",36,2,34
"23448","2390云辰","110/07/09","元大-善化",2,31,-29
"23449","2390云辰","110/07/09","國票-嘉義",31,0,31
"23450","2390云辰","110/07/09","富邦-板橋",0,27,-27
"23451","2390云辰","110/07/09","華南永昌",35,7,28
"23452","2390云辰","110/07/09","富邦-永和",3,28,-25
"23453","2390云辰","110/07/09","玉山-台中",49,22,27
"23454","2390云辰","110/07/09","第一金-自由",20,44,-24
"23455","2390云辰","110/07/09","華南永昌-敦南",25,0,25
"23456","2390云辰","110/07/09","凱基-內湖",0,24,-24
"23457","2390云辰","110/07/09","新光-高雄",27,4,23
"23458","2390云辰","110/07/09","元大-汐止",1,24,-23
"23459","2390云辰","110/07/09","台灣摩根士丹利",85,63,22
"23460","2390云辰","110/07/09","新光-台中",12,33,-21
"23461","4903聯光通","110/07/09","元大-敦南",10,0,10
"23462","4903聯光通","110/07/09","第一金-台中",0,12,-12
"23463","4903聯光通","110/07/09","凱基-士林",5,0,5
"23464","4903聯光通","110/07/09","日盛-忠孝",0,3,-3
"23465","4903聯光通","110/07/09","元大-苗栗",5,0,5
"23466","4903聯光通","110/07/09","群益金鼎-崇德",0,3,-3
"23467","4903聯光通","110/07/09","元大-屏南",3,0,3
"23468","4903聯光通","110/07/09","國票-內壢",0,2,-2
"23469","4903聯光通","110/07/09","中國信託-永康",1,0,1
"23470","4903聯光通","110/07/09","康和-南崁",0,2,-2
"23471","4903聯光通","110/07/09","玉山證券",1,0,1
"23472","4903聯光通","110/07/09","新光-台中",0,2,-2
"23473","4903聯光通","110/07/09","元大-太平",4,3,1
"23474","4903聯光通","110/07/09","玉山-城中",0,2,-2
"23475","4903聯光通","110/07/09","永豐金-嘉義",1,0,1
"23476","4903聯光通","110/07/09","中國信託-文心",0,1,-1
"23477","4903聯光通","110/07/09","大昌",0,0,0
"23478","4903聯光通","110/07/09","大昌",0,0,0
"23479","4903聯光通","110/07/09","中農",0,0,0
"23480","4903聯光通","110/07/09","中農",0,0,0
"23481","4903聯光通","110/07/09","",NA,NA,NA
"23482","4903聯光通","110/07/09","",NA,NA,NA
"23483","4903聯光通","110/07/09","",NA,NA,NA
"23484","4903聯光通","110/07/09","",NA,NA,NA
"23485","4903聯光通","110/07/09","",NA,NA,NA
"23486","4903聯光通","110/07/09","",NA,NA,NA
"23487","4903聯光通","110/07/09","",NA,NA,NA
"23488","4903聯光通","110/07/09","",NA,NA,NA
"23489","4903聯光通","110/07/09","",NA,NA,NA
"23490","4903聯光通","110/07/09","",NA,NA,NA
"23491","2929淘帝","110/07/09","台中銀-台北",110,0,110
"23492","2929淘帝","110/07/09","新光",2,82,-80
"23493","2929淘帝","110/07/09","華南永昌-頭份",72,0,72
"23494","2929淘帝","110/07/09","摩根大通",2,63,-61
"23495","2929淘帝","110/07/09","合庫-高雄",71,0,71
"23496","2929淘帝","110/07/09","第一金-路竹",0,50,-50
"23497","2929淘帝","110/07/09","高橋-龍潭",37,0,37
"23498","2929淘帝","110/07/09","港商麥格理",0,42,-42
"23499","2929淘帝","110/07/09","新光-台中",60,26,34
"23500","2929淘帝","110/07/09","陽信-石牌",0,40,-40
"23501","2929淘帝","110/07/09","元富-大裕",22,1,21
"23502","2929淘帝","110/07/09","台新-左楠",1,39,-38
"23503","2929淘帝","110/07/09","合庫-鳳山",20,0,20
"23504","2929淘帝","110/07/09","凱基-桃園",3,29,-26
"23505","2929淘帝","110/07/09","元大-員林",22,2,20
"23506","2929淘帝","110/07/09","兆豐-內湖",0,25,-25
"23507","2929淘帝","110/07/09","台新-建北",15,0,15
"23508","2929淘帝","110/07/09","元大-北港",0,20,-20
"23509","2929淘帝","110/07/09","兆豐-桃園",13,0,13
"23510","2929淘帝","110/07/09","富邦-北港",0,19,-19
"23511","2929淘帝","110/07/09","兆豐-忠孝",10,0,10
"23512","2929淘帝","110/07/09","富邦-花蓮",0,17,-17
"23513","2929淘帝","110/07/09","國票-敦北法人",10,0,10
"23514","2929淘帝","110/07/09","國泰-台中",2,17,-15
"23515","2929淘帝","110/07/09","永豐金-博愛",10,0,10
"23516","2929淘帝","110/07/09","群益金鼎-彰化",0,15,-15
"23517","2929淘帝","110/07/09","群益金鼎-潭子",8,0,8
"23518","2929淘帝","110/07/09","元大-博愛",0,14,-14
"23519","2929淘帝","110/07/09","富邦-南屯",8,0,8
"23520","2929淘帝","110/07/09","日盛-板橋",0,13,-13
"23521","5410國眾","110/07/09","元大-新盛",14,0,14
"23522","5410國眾","110/07/09","(牛牛牛)亞-鑫豐",1,41,-40
"23523","5410國眾","110/07/09","台灣企銀-民雄",10,0,10
"23524","5410國眾","110/07/09","元富-嘉義",0,25,-25
"23525","5410國眾","110/07/09","元富-虎尾",9,0,9
"23526","5410國眾","110/07/09","凱基-高美館",0,10,-10
"23527","5410國眾","110/07/09","摩根大通",10,1,9
"23528","5410國眾","110/07/09","凱基-城中",0,10,-10
"23529","5410國眾","110/07/09","兆豐-北高雄",7,0,7
"23530","5410國眾","110/07/09","元大-頭份",0,10,-10
"23531","5410國眾","110/07/09","凱基-台北",8,1,7
"23532","5410國眾","110/07/09","群益金鼎-丹鳳",0,7,-7
"23533","5410國眾","110/07/09","華南永昌-公誠",7,0,7
"23534","5410國眾","110/07/09","凱基-復興",0,7,-7
"23535","5410國眾","110/07/09","香港上海匯豐",6,0,6
"23536","5410國眾","110/07/09","元大-員林",0,7,-7
"23537","5410國眾","110/07/09","凱基-中壢",6,0,6
"23538","5410國眾","110/07/09","富邦-竹東",0,6,-6
"23539","5410國眾","110/07/09","華南永昌-南京",6,0,6
"23540","5410國眾","110/07/09","亞東-高雄",0,5,-5
"23541","5410國眾","110/07/09","統一-三重",5,0,5
"23542","5410國眾","110/07/09","大慶-中壢",1,6,-5
"23543","5410國眾","110/07/09","富邦-宜蘭",5,0,5
"23544","5410國眾","110/07/09","群益金鼎-中港",0,5,-5
"23545","5410國眾","110/07/09","元大-崇德",5,0,5
"23546","5410國眾","110/07/09","元大-八德",0,5,-5
"23547","5410國眾","110/07/09","元大-博愛",5,0,5
"23548","5410國眾","110/07/09","富邦-基隆",0,4,-4
"23549","5410國眾","110/07/09","元大-龍潭",5,0,5
"23550","5410國眾","110/07/09","臺銀-新竹",0,3,-3
"23551","2841台開","110/07/09","日盛-雙和",102,0,102
"23552","2841台開","110/07/09","港商野村",0,129,-129
"23553","2841台開","110/07/09","元大-館前",70,0,70
"23554","2841台開","110/07/09","兆豐-永和",0,100,-100
"23555","2841台開","110/07/09","凱基-文心",50,0,50
"23556","2841台開","110/07/09","台新證券",7,28,-21
"23557","2841台開","110/07/09","富邦-嘉義",40,0,40
"23558","2841台開","110/07/09","國票-北高雄",0,20,-20
"23559","2841台開","110/07/09","美商高盛",15,0,15
"23560","2841台開","110/07/09","永豐金-敦南",29,46,-17
"23561","2841台開","110/07/09","台中銀",15,0,15
"23562","2841台開","110/07/09","合庫-基隆",0,12,-12
"23563","2841台開","110/07/09","新光",11,0,11
"23564","2841台開","110/07/09","中國信託-松江",0,12,-12
"23565","2841台開","110/07/09","華南永昌-長虹",10,0,10
"23566","2841台開","110/07/09","兆豐-城中",0,12,-12
"23567","2841台開","110/07/09","永豐金-南投",10,0,10
"23568","2841台開","110/07/09","台中銀-豐原",0,10,-10
"23569","2841台開","110/07/09","合庫-桃園",7,0,7
"23570","2841台開","110/07/09","兆豐-景美",0,10,-10
"23571","2841台開","110/07/09","群益金鼎-古亭",7,0,7
"23572","2841台開","110/07/09","群益金鼎-基隆",0,10,-10
"23573","2841台開","110/07/09","國泰-敦南",6,0,6
"23574","2841台開","110/07/09","元大-北三重",0,10,-10
"23575","2841台開","110/07/09","凱基-桃園",8,2,6
"23576","2841台開","110/07/09","(牛牛牛)亞-網路",0,9,-9
"23577","2841台開","110/07/09","日盛證券",5,0,5
"23578","2841台開","110/07/09","台新-高雄",1,10,-9
"23579","2841台開","110/07/09","元富-文心",5,0,5
"23580","2841台開","110/07/09","凱基-台北",0,7,-7
"23581","6207雷科","110/07/09","群益金鼎-新竹",47,0,47
"23582","6207雷科","110/07/09","新光",7,24,-17
"23583","6207雷科","110/07/09","永豐金-三重",31,0,31
"23584","6207雷科","110/07/09","日盛-和美",0,15,-15
"23585","6207雷科","110/07/09","新加坡商瑞銀",33,5,28
"23586","6207雷科","110/07/09","國泰-台南",0,15,-15
"23587","6207雷科","110/07/09","元大-高雄",26,0,26
"23588","6207雷科","110/07/09","華南永昌-古亭",0,14,-14
"23589","6207雷科","110/07/09","統一-員林",22,0,22
"23590","6207雷科","110/07/09","土銀-白河",0,11,-11
"23591","6207雷科","110/07/09","台新-高雄",22,0,22
"23592","6207雷科","110/07/09","日盛-台南",0,10,-10
"23593","6207雷科","110/07/09","摩根大通",34,17,17
"23594","6207雷科","110/07/09","元富-林園",0,10,-10
"23595","6207雷科","110/07/09","元大-博愛",17,1,16
"23596","6207雷科","110/07/09","富邦-園區",0,10,-10
"23597","6207雷科","110/07/09","日茂-埔里",12,0,12
"23598","6207雷科","110/07/09","元大-上新莊",0,10,-10
"23599","6207雷科","110/07/09","國泰-台中",17,6,11
"23600","6207雷科","110/07/09","永豐金-南京",0,10,-10
"23601","6207雷科","110/07/09","富邦-三重",10,0,10
"23602","6207雷科","110/07/09","兆豐-小港",0,6,-6
"23603","6207雷科","110/07/09","元大-沙鹿",10,0,10
"23604","6207雷科","110/07/09","富邦-羅東",1,7,-6
"23605","6207雷科","110/07/09","元大-八德",10,0,10
"23606","6207雷科","110/07/09","元大-土城永寧",0,6,-6
"23607","6207雷科","110/07/09","第一金-路竹",11,2,9
"23608","6207雷科","110/07/09","永豐金-板盛",0,6,-6
"23609","6207雷科","110/07/09","統一-南京",5,0,5
"23610","6207雷科","110/07/09","日盛-板橋",0,5,-5
"23611","3679新至陞","110/07/09","元大-大天母",10,0,10
"23612","3679新至陞","110/07/09","第一金-光復",0,11,-11
"23613","3679新至陞","110/07/09","日盛-樹林",9,0,9
"23614","3679新至陞","110/07/09","瑞士信貸",0,8,-8
"23615","3679新至陞","110/07/09","凱基-台北",11,2,9
"23616","3679新至陞","110/07/09","大慶-苗栗",0,5,-5
"23617","3679新至陞","110/07/09","華南永昌-小港",8,0,8
"23618","3679新至陞","110/07/09","元大-永春",0,5,-5
"23619","3679新至陞","110/07/09","兆豐-來福",7,0,7
"23620","3679新至陞","110/07/09","日盛-和美",0,4,-4
"23621","3679新至陞","110/07/09","香港上海匯豐",5,0,5
"23622","3679新至陞","110/07/09","元大-雙和",0,3,-3
"23623","3679新至陞","110/07/09","台中銀-員林",3,0,3
"23624","3679新至陞","110/07/09","永豐金-屏東",0,3,-3
"23625","3679新至陞","110/07/09","新光",3,0,3
"23626","3679新至陞","110/07/09","彰銀",0,2,-2
"23627","3679新至陞","110/07/09","土銀-花蓮",2,0,2
"23628","3679新至陞","110/07/09","宏遠-館前",0,2,-2
"23629","3679新至陞","110/07/09","第一金-澎湖",2,0,2
"23630","3679新至陞","110/07/09","港商野村",0,2,-2
"23631","3679新至陞","110/07/09","摩根大通",2,0,2
"23632","3679新至陞","110/07/09","大昌-新店",0,2,-2
"23633","3679新至陞","110/07/09","國泰-敦南",2,0,2
"23634","3679新至陞","110/07/09","元大-新莊",0,2,-2
"23635","3679新至陞","110/07/09","元大-淡水",4,2,2
"23636","3679新至陞","110/07/09","元大-板橋",0,2,-2
"23637","3679新至陞","110/07/09","日盛-士林",1,0,1
"23638","3679新至陞","110/07/09","台灣摩根士丹利",0,1,-1
"23639","3679新至陞","110/07/09","日盛-信義",1,0,1
"23640","3679新至陞","110/07/09","第一金-高雄",0,1,-1
"23641","2727王品","110/07/09","台灣匯立證券",90,0,90
"23642","2727王品","110/07/09","台灣摩根士丹利",0,267,-267
"23643","2727王品","110/07/09","國泰-敦南",166,84,82
"23644","2727王品","110/07/09","富邦-台北",35,299,-264
"23645","2727王品","110/07/09","富邦-仁愛",56,12,44
"23646","2727王品","110/07/09","凱基-台北",174,296,-122
"23647","2727王品","110/07/09","台新證券",109,66,43
"23648","2727王品","110/07/09","第一金",2,102,-100
"23649","2727王品","110/07/09","新光",117,87,30
"23650","2727王品","110/07/09","群益金鼎-大安",0,80,-80
"23651","2727王品","110/07/09","臺銀-臺中",35,6,29
"23652","2727王品","110/07/09","兆豐-大安",7,60,-53
"23653","2727王品","110/07/09","元大-桃園",32,3,29
"23654","2727王品","110/07/09","永豐金-南投",0,50,-50
"23655","2727王品","110/07/09","元富-宜蘭",34,6,28
"23656","2727王品","110/07/09","新加坡商瑞銀",6,46,-40
"23657","2727王品","110/07/09","玉山-台中",34,8,26
"23658","2727王品","110/07/09","合庫-彰化",11,50,-39
"23659","2727王品","110/07/09","群益金鼎-宜蘭",30,4,26
"23660","2727王品","110/07/09","永豐金-萬盛",13,52,-39
"23661","2727王品","110/07/09","富邦-台中",42,16,26
"23662","2727王品","110/07/09","瑞士信貸",0,34,-34
"23663","2727王品","110/07/09","第一金-豐原",25,1,24
"23664","2727王品","110/07/09","元大-和平",4,35,-31
"23665","2727王品","110/07/09","臺銀",30,8,22
"23666","2727王品","110/07/09","美林",14,44,-30
"23667","2727王品","110/07/09","兆豐-來福",23,1,22
"23668","2727王品","110/07/09","元大-員林",9,38,-29
"23669","2727王品","110/07/09","玉山-士林",22,2,20
"23670","2727王品","110/07/09","元富-西松",4,31,-27
"23671","1570力肯","110/07/09","凱基-台北",30,1,29
"23672","1570力肯","110/07/09","群益金鼎-彰化",0,20,-20
"23673","1570力肯","110/07/09","新光-台南",20,0,20
"23674","1570力肯","110/07/09","元大-土城學府",0,20,-20
"23675","1570力肯","110/07/09","元大-高雄",20,0,20
"23676","1570力肯","110/07/09","元大-大統",0,16,-16
"23677","1570力肯","110/07/09","國票-中正",12,0,12
"23678","1570力肯","110/07/09","元大-新營",0,11,-11
"23679","1570力肯","110/07/09","日盛-高雄",6,0,6
"23680","1570力肯","110/07/09","元大-和平",0,10,-10
"23681","1570力肯","110/07/09","元富-緯城",6,0,6
"23682","1570力肯","110/07/09","元大-草屯",0,10,-10
"23683","1570力肯","110/07/09","群益金鼎-台南",6,0,6
"23684","1570力肯","110/07/09","元大-鹿港",0,9,-9
"23685","1570力肯","110/07/09","華南永昌-岡山",6,0,6
"23686","1570力肯","110/07/09","合庫-基隆",0,7,-7
"23687","1570力肯","110/07/09","統一-中壢",5,0,5
"23688","1570力肯","110/07/09","摩根大通",2,8,-6
"23689","1570力肯","110/07/09","凱基-三峽",5,0,5
"23690","1570力肯","110/07/09","台灣企銀-豐原",0,4,-4
"23691","1570力肯","110/07/09","大昌-樹林",4,0,4
"23692","1570力肯","110/07/09","日盛-桃園",0,4,-4
"23693","1570力肯","110/07/09","新光",3,0,3
"23694","1570力肯","110/07/09","國泰-高雄",0,3,-3
"23695","1570力肯","110/07/09","富邦-新竹華信",3,0,3
"23696","1570力肯","110/07/09","永豐金-敦南",0,3,-3
"23697","1570力肯","110/07/09","合庫-台中",2,0,2
"23698","1570力肯","110/07/09","土銀-彰化",0,2,-2
"23699","1570力肯","110/07/09","臺銀-臺中",2,0,2
"23700","1570力肯","110/07/09","臺銀-鳳山",0,2,-2
"23701","6180橘子","110/07/09","摩根大通",63,1,62
"23702","6180橘子","110/07/09","元大-南京",1,32,-31
"23703","6180橘子","110/07/09","富邦-陽明",73,33,40
"23704","6180橘子","110/07/09","群益金鼎-台北",0,25,-25
"23705","6180橘子","110/07/09","新加坡商瑞銀",31,0,31
"23706","6180橘子","110/07/09","兆豐-復興",0,21,-21
"23707","6180橘子","110/07/09","美商高盛",25,0,25
"23708","6180橘子","110/07/09","永豐金-嘉義",0,21,-21
"23709","6180橘子","110/07/09","凱基-台北",26,10,16
"23710","6180橘子","110/07/09","凱基-中壢",8,24,-16
"23711","6180橘子","110/07/09","華南永昌-楠梓",13,0,13
"23712","6180橘子","110/07/09","致和-崇德",0,15,-15
"23713","6180橘子","110/07/09","華南永昌-朴子",11,0,11
"23714","6180橘子","110/07/09","群益金鼎-屏東",0,15,-15
"23715","6180橘子","110/07/09","元大-北港",11,0,11
"23716","6180橘子","110/07/09","群益金鼎-中山",0,15,-15
"23717","6180橘子","110/07/09","元大-成功",10,1,9
"23718","6180橘子","110/07/09","瑞士信貸",1,15,-14
"23719","6180橘子","110/07/09","新光",26,18,8
"23720","6180橘子","110/07/09","日盛-二林",0,10,-10
"23721","6180橘子","110/07/09","統一-三重",6,0,6
"23722","6180橘子","110/07/09","凱基-東門",0,10,-10
"23723","6180橘子","110/07/09","群益金鼎-嘉義",6,0,6
"23724","6180橘子","110/07/09","華南永昌-三重",0,10,-10
"23725","6180橘子","110/07/09","元大-員林中山",6,0,6
"23726","6180橘子","110/07/09","元大-彰化民生",1,11,-10
"23727","6180橘子","110/07/09","合庫-鳳山",5,0,5
"23728","6180橘子","110/07/09","永豐金-新店",1,11,-10
"23729","6180橘子","110/07/09","富邦-建國",6,1,5
"23730","6180橘子","110/07/09","群益金鼎-丹鳳",0,8,-8
"23731","2390云辰","110/07/09","摩根大通",279,56,223
"23732","2390云辰","110/07/09","元大-天母",0,127,-127
"23733","2390云辰","110/07/09","日盛-鳳山",110,2,108
"23734","2390云辰","110/07/09","中國信託-文心",5,109,-104
"23735","2390云辰","110/07/09","宏遠證券",100,0,100
"23736","2390云辰","110/07/09","永豐金-復興",0,55,-55
"23737","2390云辰","110/07/09","元大-大里",63,6,57
"23738","2390云辰","110/07/09","凱基-台北",239,286,-47
"23739","2390云辰","110/07/09","凱基-八德",59,10,49
"23740","2390云辰","110/07/09","德信",2,32,-30
"23741","2390云辰","110/07/09","合庫-新竹",40,0,40
"23742","2390云辰","110/07/09","兆豐-桃鶯",2,32,-30
"23743","2390云辰","110/07/09","國票",40,1,39
"23744","2390云辰","110/07/09","致和-南京",0,30,-30
"23745","2390云辰","110/07/09","新加坡商瑞銀",49,13,36
"23746","2390云辰","110/07/09","富邦-虎尾",1,31,-30
"23747","2390云辰","110/07/09","統一-新台中",36,2,34
"23748","2390云辰","110/07/09","元大-善化",2,31,-29
"23749","2390云辰","110/07/09","國票-嘉義",31,0,31
"23750","2390云辰","110/07/09","富邦-板橋",0,27,-27
"23751","2390云辰","110/07/09","華南永昌",35,7,28
"23752","2390云辰","110/07/09","富邦-永和",3,28,-25
"23753","2390云辰","110/07/09","玉山-台中",49,22,27
"23754","2390云辰","110/07/09","第一金-自由",20,44,-24
"23755","2390云辰","110/07/09","華南永昌-敦南",25,0,25
"23756","2390云辰","110/07/09","凱基-內湖",0,24,-24
"23757","2390云辰","110/07/09","新光-高雄",27,4,23
"23758","2390云辰","110/07/09","元大-汐止",1,24,-23
"23759","2390云辰","110/07/09","台灣摩根士丹利",85,63,22
"23760","2390云辰","110/07/09","新光-台中",12,33,-21
"23761","4903聯光通","110/07/09","元大-敦南",10,0,10
"23762","4903聯光通","110/07/09","第一金-台中",0,12,-12
"23763","4903聯光通","110/07/09","凱基-士林",5,0,5
"23764","4903聯光通","110/07/09","日盛-忠孝",0,3,-3
"23765","4903聯光通","110/07/09","元大-苗栗",5,0,5
"23766","4903聯光通","110/07/09","群益金鼎-崇德",0,3,-3
"23767","4903聯光通","110/07/09","元大-屏南",3,0,3
"23768","4903聯光通","110/07/09","國票-內壢",0,2,-2
"23769","4903聯光通","110/07/09","中國信託-永康",1,0,1
"23770","4903聯光通","110/07/09","康和-南崁",0,2,-2
"23771","4903聯光通","110/07/09","玉山證券",1,0,1
"23772","4903聯光通","110/07/09","新光-台中",0,2,-2
"23773","4903聯光通","110/07/09","元大-太平",4,3,1
"23774","4903聯光通","110/07/09","玉山-城中",0,2,-2
"23775","4903聯光通","110/07/09","永豐金-嘉義",1,0,1
"23776","4903聯光通","110/07/09","中國信託-文心",0,1,-1
"23777","4903聯光通","110/07/09","大昌",0,0,0
"23778","4903聯光通","110/07/09","大昌",0,0,0
"23779","4903聯光通","110/07/09","中農",0,0,0
"23780","4903聯光通","110/07/09","中農",0,0,0
"23781","2929淘帝","110/07/09","台中銀-台北",110,0,110
"23782","2929淘帝","110/07/09","新光",2,82,-80
"23783","2929淘帝","110/07/09","華南永昌-頭份",72,0,72
"23784","2929淘帝","110/07/09","摩根大通",2,63,-61
"23785","2929淘帝","110/07/09","合庫-高雄",71,0,71
"23786","2929淘帝","110/07/09","第一金-路竹",0,50,-50
"23787","2929淘帝","110/07/09","高橋-龍潭",37,0,37
"23788","2929淘帝","110/07/09","港商麥格理",0,42,-42
"23789","2929淘帝","110/07/09","新光-台中",60,26,34
"23790","2929淘帝","110/07/09","陽信-石牌",0,40,-40
"23791","2929淘帝","110/07/09","元富-大裕",22,1,21
"23792","2929淘帝","110/07/09","台新-左楠",1,39,-38
"23793","2929淘帝","110/07/09","合庫-鳳山",20,0,20
"23794","2929淘帝","110/07/09","凱基-桃園",3,29,-26
"23795","2929淘帝","110/07/09","元大-員林",22,2,20
"23796","2929淘帝","110/07/09","兆豐-內湖",0,25,-25
"23797","2929淘帝","110/07/09","台新-建北",15,0,15
"23798","2929淘帝","110/07/09","元大-北港",0,20,-20
"23799","2929淘帝","110/07/09","兆豐-桃園",13,0,13
"23800","2929淘帝","110/07/09","富邦-北港",0,19,-19
"23801","2929淘帝","110/07/09","兆豐-忠孝",10,0,10
"23802","2929淘帝","110/07/09","富邦-花蓮",0,17,-17
"23803","2929淘帝","110/07/09","國票-敦北法人",10,0,10
"23804","2929淘帝","110/07/09","國泰-台中",2,17,-15
"23805","2929淘帝","110/07/09","永豐金-博愛",10,0,10
"23806","2929淘帝","110/07/09","群益金鼎-彰化",0,15,-15
"23807","2929淘帝","110/07/09","群益金鼎-潭子",8,0,8
"23808","2929淘帝","110/07/09","元大-博愛",0,14,-14
"23809","2929淘帝","110/07/09","富邦-南屯",8,0,8
"23810","2929淘帝","110/07/09","日盛-板橋",0,13,-13
"23811","5410國眾","110/07/09","元大-新盛",14,0,14
"23812","5410國眾","110/07/09","(牛牛牛)亞-鑫豐",1,41,-40
"23813","5410國眾","110/07/09","台灣企銀-民雄",10,0,10
"23814","5410國眾","110/07/09","元富-嘉義",0,25,-25
"23815","5410國眾","110/07/09","元富-虎尾",9,0,9
"23816","5410國眾","110/07/09","凱基-高美館",0,10,-10
"23817","5410國眾","110/07/09","摩根大通",10,1,9
"23818","5410國眾","110/07/09","凱基-城中",0,10,-10
"23819","5410國眾","110/07/09","兆豐-北高雄",7,0,7
"23820","5410國眾","110/07/09","元大-頭份",0,10,-10
"23821","5410國眾","110/07/09","凱基-台北",8,1,7
"23822","5410國眾","110/07/09","群益金鼎-丹鳳",0,7,-7
"23823","5410國眾","110/07/09","華南永昌-公誠",7,0,7
"23824","5410國眾","110/07/09","凱基-復興",0,7,-7
"23825","5410國眾","110/07/09","香港上海匯豐",6,0,6
"23826","5410國眾","110/07/09","元大-員林",0,7,-7
"23827","5410國眾","110/07/09","凱基-中壢",6,0,6
"23828","5410國眾","110/07/09","富邦-竹東",0,6,-6
"23829","5410國眾","110/07/09","華南永昌-南京",6,0,6
"23830","5410國眾","110/07/09","亞東-高雄",0,5,-5
"23831","5410國眾","110/07/09","統一-三重",5,0,5
"23832","5410國眾","110/07/09","大慶-中壢",1,6,-5
"23833","5410國眾","110/07/09","富邦-宜蘭",5,0,5
"23834","5410國眾","110/07/09","群益金鼎-中港",0,5,-5
"23835","5410國眾","110/07/09","元大-崇德",5,0,5
"23836","5410國眾","110/07/09","元大-八德",0,5,-5
"23837","5410國眾","110/07/09","元大-博愛",5,0,5
"23838","5410國眾","110/07/09","富邦-基隆",0,4,-4
"23839","5410國眾","110/07/09","元大-龍潭",5,0,5
"23840","5410國眾","110/07/09","臺銀-新竹",0,3,-3
"23841","2841台開","110/07/09","日盛-雙和",102,0,102
"23842","2841台開","110/07/09","港商野村",0,129,-129
"23843","2841台開","110/07/09","元大-館前",70,0,70
"23844","2841台開","110/07/09","兆豐-永和",0,100,-100
"23845","2841台開","110/07/09","凱基-文心",50,0,50
"23846","2841台開","110/07/09","台新證券",7,28,-21
"23847","2841台開","110/07/09","富邦-嘉義",40,0,40
"23848","2841台開","110/07/09","國票-北高雄",0,20,-20
"23849","2841台開","110/07/09","美商高盛",15,0,15
"23850","2841台開","110/07/09","永豐金-敦南",29,46,-17
"23851","2841台開","110/07/09","台中銀",15,0,15
"23852","2841台開","110/07/09","合庫-基隆",0,12,-12
"23853","2841台開","110/07/09","新光",11,0,11
"23854","2841台開","110/07/09","中國信託-松江",0,12,-12
"23855","2841台開","110/07/09","華南永昌-長虹",10,0,10
"23856","2841台開","110/07/09","兆豐-城中",0,12,-12
"23857","2841台開","110/07/09","永豐金-南投",10,0,10
"23858","2841台開","110/07/09","台中銀-豐原",0,10,-10
"23859","2841台開","110/07/09","合庫-桃園",7,0,7
"23860","2841台開","110/07/09","兆豐-景美",0,10,-10
"23861","2841台開","110/07/09","群益金鼎-古亭",7,0,7
"23862","2841台開","110/07/09","群益金鼎-基隆",0,10,-10
"23863","2841台開","110/07/09","國泰-敦南",6,0,6
"23864","2841台開","110/07/09","元大-北三重",0,10,-10
"23865","2841台開","110/07/09","凱基-桃園",8,2,6
"23866","2841台開","110/07/09","(牛牛牛)亞-網路",0,9,-9
"23867","2841台開","110/07/09","日盛證券",5,0,5
"23868","2841台開","110/07/09","台新-高雄",1,10,-9
"23869","2841台開","110/07/09","元富-文心",5,0,5
"23870","2841台開","110/07/09","凱基-台北",0,7,-7
"23871","6207雷科","110/07/09","群益金鼎-新竹",47,0,47
"23872","6207雷科","110/07/09","新光",7,24,-17
"23873","6207雷科","110/07/09","永豐金-三重",31,0,31
"23874","6207雷科","110/07/09","日盛-和美",0,15,-15
"23875","6207雷科","110/07/09","新加坡商瑞銀",33,5,28
"23876","6207雷科","110/07/09","國泰-台南",0,15,-15
"23877","6207雷科","110/07/09","元大-高雄",26,0,26
"23878","6207雷科","110/07/09","華南永昌-古亭",0,14,-14
"23879","6207雷科","110/07/09","統一-員林",22,0,22
"23880","6207雷科","110/07/09","土銀-白河",0,11,-11
"23881","6207雷科","110/07/09","台新-高雄",22,0,22
"23882","6207雷科","110/07/09","日盛-台南",0,10,-10
"23883","6207雷科","110/07/09","摩根大通",34,17,17
"23884","6207雷科","110/07/09","元富-林園",0,10,-10
"23885","6207雷科","110/07/09","元大-博愛",17,1,16
"23886","6207雷科","110/07/09","富邦-園區",0,10,-10
"23887","6207雷科","110/07/09","日茂-埔里",12,0,12
"23888","6207雷科","110/07/09","元大-上新莊",0,10,-10
"23889","6207雷科","110/07/09","國泰-台中",17,6,11
"23890","6207雷科","110/07/09","永豐金-南京",0,10,-10
"23891","6207雷科","110/07/09","富邦-三重",10,0,10
"23892","6207雷科","110/07/09","兆豐-小港",0,6,-6
"23893","6207雷科","110/07/09","元大-沙鹿",10,0,10
"23894","6207雷科","110/07/09","富邦-羅東",1,7,-6
"23895","6207雷科","110/07/09","元大-八德",10,0,10
"23896","6207雷科","110/07/09","元大-土城永寧",0,6,-6
"23897","6207雷科","110/07/09","第一金-路竹",11,2,9
"23898","6207雷科","110/07/09","永豐金-板盛",0,6,-6
"23899","6207雷科","110/07/09","統一-南京",5,0,5
"23900","6207雷科","110/07/09","日盛-板橋",0,5,-5
"23901","3679新至陞","110/07/09","元大-大天母",10,0,10
"23902","3679新至陞","110/07/09","第一金-光復",0,11,-11
"23903","3679新至陞","110/07/09","日盛-樹林",9,0,9
"23904","3679新至陞","110/07/09","瑞士信貸",0,8,-8
"23905","3679新至陞","110/07/09","凱基-台北",11,2,9
"23906","3679新至陞","110/07/09","大慶-苗栗",0,5,-5
"23907","3679新至陞","110/07/09","華南永昌-小港",8,0,8
"23908","3679新至陞","110/07/09","元大-永春",0,5,-5
"23909","3679新至陞","110/07/09","兆豐-來福",7,0,7
"23910","3679新至陞","110/07/09","日盛-和美",0,4,-4
"23911","3679新至陞","110/07/09","香港上海匯豐",5,0,5
"23912","3679新至陞","110/07/09","元大-雙和",0,3,-3
"23913","3679新至陞","110/07/09","台中銀-員林",3,0,3
"23914","3679新至陞","110/07/09","永豐金-屏東",0,3,-3
"23915","3679新至陞","110/07/09","新光",3,0,3
"23916","3679新至陞","110/07/09","彰銀",0,2,-2
"23917","3679新至陞","110/07/09","土銀-花蓮",2,0,2
"23918","3679新至陞","110/07/09","宏遠-館前",0,2,-2
"23919","3679新至陞","110/07/09","第一金-澎湖",2,0,2
"23920","3679新至陞","110/07/09","港商野村",0,2,-2
"23921","3679新至陞","110/07/09","摩根大通",2,0,2
"23922","3679新至陞","110/07/09","大昌-新店",0,2,-2
"23923","3679新至陞","110/07/09","國泰-敦南",2,0,2
"23924","3679新至陞","110/07/09","元大-新莊",0,2,-2
"23925","3679新至陞","110/07/09","元大-淡水",4,2,2
"23926","3679新至陞","110/07/09","元大-板橋",0,2,-2
"23927","3679新至陞","110/07/09","日盛-士林",1,0,1
"23928","3679新至陞","110/07/09","台灣摩根士丹利",0,1,-1
"23929","3679新至陞","110/07/09","日盛-信義",1,0,1
"23930","3679新至陞","110/07/09","第一金-高雄",0,1,-1
"23931","2727王品","110/07/09","台灣匯立證券",90,0,90
"23932","2727王品","110/07/09","台灣摩根士丹利",0,267,-267
"23933","2727王品","110/07/09","國泰-敦南",166,84,82
"23934","2727王品","110/07/09","富邦-台北",35,299,-264
"23935","2727王品","110/07/09","富邦-仁愛",56,12,44
"23936","2727王品","110/07/09","凱基-台北",174,296,-122
"23937","2727王品","110/07/09","台新證券",109,66,43
"23938","2727王品","110/07/09","第一金",2,102,-100
"23939","2727王品","110/07/09","新光",117,87,30
"23940","2727王品","110/07/09","群益金鼎-大安",0,80,-80
"23941","2727王品","110/07/09","臺銀-臺中",35,6,29
"23942","2727王品","110/07/09","兆豐-大安",7,60,-53
"23943","2727王品","110/07/09","元大-桃園",32,3,29
"23944","2727王品","110/07/09","永豐金-南投",0,50,-50
"23945","2727王品","110/07/09","元富-宜蘭",34,6,28
"23946","2727王品","110/07/09","新加坡商瑞銀",6,46,-40
"23947","2727王品","110/07/09","玉山-台中",34,8,26
"23948","2727王品","110/07/09","合庫-彰化",11,50,-39
"23949","2727王品","110/07/09","群益金鼎-宜蘭",30,4,26
"23950","2727王品","110/07/09","永豐金-萬盛",13,52,-39
"23951","2727王品","110/07/09","富邦-台中",42,16,26
"23952","2727王品","110/07/09","瑞士信貸",0,34,-34
"23953","2727王品","110/07/09","第一金-豐原",25,1,24
"23954","2727王品","110/07/09","元大-和平",4,35,-31
"23955","2727王品","110/07/09","臺銀",30,8,22
"23956","2727王品","110/07/09","美林",14,44,-30
"23957","2727王品","110/07/09","兆豐-來福",23,1,22
"23958","2727王品","110/07/09","元大-員林",9,38,-29
"23959","2727王品","110/07/09","玉山-士林",22,2,20
"23960","2727王品","110/07/09","元富-西松",4,31,-27
"23961","1570力肯","110/07/09","凱基-台北",30,1,29
"23962","1570力肯","110/07/09","群益金鼎-彰化",0,20,-20
"23963","1570力肯","110/07/09","新光-台南",20,0,20
"23964","1570力肯","110/07/09","元大-土城學府",0,20,-20
"23965","1570力肯","110/07/09","元大-高雄",20,0,20
"23966","1570力肯","110/07/09","元大-大統",0,16,-16
"23967","1570力肯","110/07/09","國票-中正",12,0,12
"23968","1570力肯","110/07/09","元大-新營",0,11,-11
"23969","1570力肯","110/07/09","日盛-高雄",6,0,6
"23970","1570力肯","110/07/09","元大-和平",0,10,-10
"23971","1570力肯","110/07/09","元富-緯城",6,0,6
"23972","1570力肯","110/07/09","元大-草屯",0,10,-10
"23973","1570力肯","110/07/09","群益金鼎-台南",6,0,6
"23974","1570力肯","110/07/09","元大-鹿港",0,9,-9
"23975","1570力肯","110/07/09","華南永昌-岡山",6,0,6
"23976","1570力肯","110/07/09","合庫-基隆",0,7,-7
"23977","1570力肯","110/07/09","統一-中壢",5,0,5
"23978","1570力肯","110/07/09","摩根大通",2,8,-6
"23979","1570力肯","110/07/09","凱基-三峽",5,0,5
"23980","1570力肯","110/07/09","台灣企銀-豐原",0,4,-4
"23981","1570力肯","110/07/09","大昌-樹林",4,0,4
"23982","1570力肯","110/07/09","日盛-桃園",0,4,-4
"23983","1570力肯","110/07/09","新光",3,0,3
"23984","1570力肯","110/07/09","國泰-高雄",0,3,-3
"23985","1570力肯","110/07/09","富邦-新竹華信",3,0,3
"23986","1570力肯","110/07/09","永豐金-敦南",0,3,-3
"23987","1570力肯","110/07/09","合庫-台中",2,0,2
"23988","1570力肯","110/07/09","土銀-彰化",0,2,-2
"23989","1570力肯","110/07/09","臺銀-臺中",2,0,2
"23990","1570力肯","110/07/09","臺銀-鳳山",0,2,-2
"23991","6180橘子","110/07/09","摩根大通",63,1,62
"23992","6180橘子","110/07/09","元大-南京",1,32,-31
"23993","6180橘子","110/07/09","富邦-陽明",73,33,40
"23994","6180橘子","110/07/09","群益金鼎-台北",0,25,-25
"23995","6180橘子","110/07/09","新加坡商瑞銀",31,0,31
"23996","6180橘子","110/07/09","兆豐-復興",0,21,-21
"23997","6180橘子","110/07/09","美商高盛",25,0,25
"23998","6180橘子","110/07/09","永豐金-嘉義",0,21,-21
"23999","6180橘子","110/07/09","凱基-台北",26,10,16
"24000","6180橘子","110/07/09","凱基-中壢",8,24,-16
"24001","6180橘子","110/07/09","華南永昌-楠梓",13,0,13
"24002","6180橘子","110/07/09","致和-崇德",0,15,-15
"24003","6180橘子","110/07/09","華南永昌-朴子",11,0,11
"24004","6180橘子","110/07/09","群益金鼎-屏東",0,15,-15
"24005","6180橘子","110/07/09","元大-北港",11,0,11
"24006","6180橘子","110/07/09","群益金鼎-中山",0,15,-15
"24007","6180橘子","110/07/09","元大-成功",10,1,9
"24008","6180橘子","110/07/09","瑞士信貸",1,15,-14
"24009","6180橘子","110/07/09","新光",26,18,8
"24010","6180橘子","110/07/09","日盛-二林",0,10,-10
"24011","6180橘子","110/07/09","統一-三重",6,0,6
"24012","6180橘子","110/07/09","凱基-東門",0,10,-10
"24013","6180橘子","110/07/09","群益金鼎-嘉義",6,0,6
"24014","6180橘子","110/07/09","華南永昌-三重",0,10,-10
"24015","6180橘子","110/07/09","元大-員林中山",6,0,6
"24016","6180橘子","110/07/09","元大-彰化民生",1,11,-10
"24017","6180橘子","110/07/09","合庫-鳳山",5,0,5
"24018","6180橘子","110/07/09","永豐金-新店",1,11,-10
"24019","6180橘子","110/07/09","富邦-建國",6,1,5
"24020","6180橘子","110/07/09","群益金鼎-丹鳳",0,8,-8
"24021","2390云辰","110/07/09","摩根大通",279,56,223
"24022","2390云辰","110/07/09","元大-天母",0,127,-127
"24023","2390云辰","110/07/09","日盛-鳳山",110,2,108
"24024","2390云辰","110/07/09","中國信託-文心",5,109,-104
"24025","2390云辰","110/07/09","宏遠證券",100,0,100
"24026","2390云辰","110/07/09","永豐金-復興",0,55,-55
"24027","2390云辰","110/07/09","元大-大里",63,6,57
"24028","2390云辰","110/07/09","凱基-台北",239,286,-47
"24029","2390云辰","110/07/09","凱基-八德",59,10,49
"24030","2390云辰","110/07/09","德信",2,32,-30
"24031","2390云辰","110/07/09","合庫-新竹",40,0,40
"24032","2390云辰","110/07/09","兆豐-桃鶯",2,32,-30
"24033","2390云辰","110/07/09","國票",40,1,39
"24034","2390云辰","110/07/09","致和-南京",0,30,-30
"24035","2390云辰","110/07/09","新加坡商瑞銀",49,13,36
"24036","2390云辰","110/07/09","富邦-虎尾",1,31,-30
"24037","2390云辰","110/07/09","統一-新台中",36,2,34
"24038","2390云辰","110/07/09","元大-善化",2,31,-29
"24039","2390云辰","110/07/09","國票-嘉義",31,0,31
"24040","2390云辰","110/07/09","富邦-板橋",0,27,-27
"24041","2390云辰","110/07/09","華南永昌",35,7,28
"24042","2390云辰","110/07/09","富邦-永和",3,28,-25
"24043","2390云辰","110/07/09","玉山-台中",49,22,27
"24044","2390云辰","110/07/09","第一金-自由",20,44,-24
"24045","2390云辰","110/07/09","華南永昌-敦南",25,0,25
"24046","2390云辰","110/07/09","凱基-內湖",0,24,-24
"24047","2390云辰","110/07/09","新光-高雄",27,4,23
"24048","2390云辰","110/07/09","元大-汐止",1,24,-23
"24049","2390云辰","110/07/09","台灣摩根士丹利",85,63,22
"24050","2390云辰","110/07/09","新光-台中",12,33,-21
"24051","4903聯光通","110/07/08","元富-新興",18,0,18
"24052","4903聯光通","110/07/08","中國信託-中壢",0,14,-14
"24053","4903聯光通","110/07/08","元大-苗栗",9,0,9
"24054","4903聯光通","110/07/08","彰銀",0,7,-7
"24055","4903聯光通","110/07/08","兆豐-鹿港",3,0,3
"24056","4903聯光通","110/07/08","中國信託-松江",0,5,-5
"24057","4903聯光通","110/07/08","群益金鼎-萬華",2,0,2
"24058","4903聯光通","110/07/08","光和",0,2,-2
"24059","4903聯光通","110/07/08","元大-屏南",1,0,1
"24060","4903聯光通","110/07/08","元大-鶯歌",0,2,-2
"24061","4903聯光通","110/07/08","華南永昌-新莊",0,0,0
"24062","4903聯光通","110/07/08","群益金鼎-館前",0,1,-1
"24063","4903聯光通","110/07/08","元大-羅東",0,0,0
"24064","4903聯光通","110/07/08","華南永昌",0,1,-1
"24065","4903聯光通","110/07/08","元大-太平",2,3,-1
"24066","4903聯光通","110/07/08","華南永昌-新莊",0,0,0
"24067","4903聯光通","110/07/08","元大-羅東",0,0,0
"24068","2929淘帝","110/07/08","日盛-園區",90,6,84
"24069","2929淘帝","110/07/08","元大-太平",1,111,-110
"24070","2929淘帝","110/07/08","華南永昌-頭份",54,0,54
"24071","2929淘帝","110/07/08","港商野村",31,106,-75
"24072","2929淘帝","110/07/08","美商高盛",50,0,50
"24073","2929淘帝","110/07/08","凱基-板橋",62,111,-49
"24074","2929淘帝","110/07/08","台中銀-台北",50,0,50
"24075","2929淘帝","110/07/08","新光-台中",30,78,-48
"24076","2929淘帝","110/07/08","臺銀-臺南",30,0,30
"24077","2929淘帝","110/07/08","元富-永和",1,41,-40
"24078","2929淘帝","110/07/08","永豐金-大園",42,12,30
"24079","2929淘帝","110/07/08","永豐金-鳳山",0,28,-28
"24080","2929淘帝","110/07/08","元富-三重",30,1,29
"24081","2929淘帝","110/07/08","元大-南崁",0,26,-26
"24082","2929淘帝","110/07/08","兆豐-桃鶯",29,0,29
"24083","2929淘帝","110/07/08","元大-花蓮",2,27,-25
"24084","2929淘帝","110/07/08","元大-承德",20,3,17
"24085","2929淘帝","110/07/08","元大-府城",0,24,-24
"24086","2929淘帝","110/07/08","新光-新竹",13,0,13
"24087","2929淘帝","110/07/08","新光",21,43,-22
"24088","2929淘帝","110/07/08","富邦-內湖",13,0,13
"24089","2929淘帝","110/07/08","臺銀-民權",0,20,-20
"24090","2929淘帝","110/07/08","國泰-板橋",13,1,12
"24091","2929淘帝","110/07/08","摩根大通",66,84,-18
"24092","2929淘帝","110/07/08","第一金-大稻埕",10,0,10
"24093","2929淘帝","110/07/08","凱基-台北",0,17,-17
"24094","2929淘帝","110/07/08","統一-汐止",10,0,10
"24095","2929淘帝","110/07/08","元大-博愛",6,23,-17
"24096","2929淘帝","110/07/08","元富-大裕",10,0,10
"24097","2929淘帝","110/07/08","永豐金-桃盛",0,16,-16
"24098","5410國眾","110/07/08","元大-新盛",15,0,15
"24099","5410國眾","110/07/08","元大-旗山",0,50,-50
"24100","5410國眾","110/07/08","元大-屏南",10,0,10
"24101","5410國眾","110/07/08","元大-頭份",0,14,-14
"24102","5410國眾","110/07/08","元大-成功",10,0,10
"24103","5410國眾","110/07/08","國泰-高雄",0,8,-8
"24104","5410國眾","110/07/08","元大-東泰",7,0,7
"24105","5410國眾","110/07/08","元大-小港",0,7,-7
"24106","5410國眾","110/07/08","富邦-陽明",6,0,6
"24107","5410國眾","110/07/08","統一-嘉義",0,5,-5
"24108","5410國眾","110/07/08","臺銀-金山",5,0,5
"24109","5410國眾","110/07/08","兆豐-台中港",0,5,-5
"24110","5410國眾","110/07/08","日盛-員林",5,0,5
"24111","5410國眾","110/07/08","凱基-屏東",0,5,-5
"24112","5410國眾","110/07/08","摩根大通",5,0,5
"24113","5410國眾","110/07/08","元大-八德",0,5,-5
"24114","5410國眾","110/07/08","富邦-桃園",5,0,5
"24115","5410國眾","110/07/08","元富-嘉義",0,4,-4
"24116","5410國眾","110/07/08","元富-大昌",4,0,4
"24117","5410國眾","110/07/08","玉山-雙和",0,4,-4
"24118","5410國眾","110/07/08","台新-台中",4,0,4
"24119","5410國眾","110/07/08","凱基-高美館",1,5,-4
"24120","5410國眾","110/07/08","華南永昌-小港",5,1,4
"24121","5410國眾","110/07/08","統一-員林",0,3,-3
"24122","5410國眾","110/07/08","元大-新竹",5,1,4
"24123","5410國眾","110/07/08","臺銀-鳳山",0,2,-2
"24124","5410國眾","110/07/08","元大-土城學府",4,0,4
"24125","5410國眾","110/07/08","亞東",0,2,-2
"24126","5410國眾","110/07/08","元大-新莊",4,0,4
"24127","5410國眾","110/07/08","新光",0,2,-2
"24128","2841台開","110/07/08","元大-樹林",653,0,653
"24129","2841台開","110/07/08","港商野村",0,868,-868
"24130","2841台開","110/07/08","台新證券",115,0,115
"24131","2841台開","110/07/08","群益金鼎-忠孝",0,100,-100
"24132","2841台開","110/07/08","永豐金-豐原",105,0,105
"24133","2841台開","110/07/08","宏遠-高雄",0,56,-56
"24134","2841台開","110/07/08","元富-新興",100,0,100
"24135","2841台開","110/07/08","新光",3,38,-35
"24136","2841台開","110/07/08","凱基-文心",50,0,50
"24137","2841台開","110/07/08","花旗環球",0,29,-29
"24138","2841台開","110/07/08","元大-八德",40,0,40
"24139","2841台開","110/07/08","富邦-仁愛",2,30,-28
"24140","2841台開","110/07/08","日盛-雙和",30,0,30
"24141","2841台開","110/07/08","元富-潮州",0,24,-24
"24142","2841台開","110/07/08","統一-竹南",30,0,30
"24143","2841台開","110/07/08","元大-沙鹿",0,20,-20
"24144","2841台開","110/07/08","凱基-台南",30,0,30
"24145","2841台開","110/07/08","元大-汐止",0,20,-20
"24146","2841台開","110/07/08","元大-福營",30,0,30
"24147","2841台開","110/07/08","合庫-嘉義",2,20,-18
"24148","2841台開","110/07/08","合庫-台中",22,0,22
"24149","2841台開","110/07/08","國泰-敦南",3,21,-18
"24150","2841台開","110/07/08","大昌-安康",28,10,18
"24151","2841台開","110/07/08","日盛-竹北",0,15,-15
"24152","2841台開","110/07/08","元大-斗信",15,0,15
"24153","2841台開","110/07/08","元大-三重",0,15,-15
"24154","2841台開","110/07/08","富邦-台北",13,0,13
"24155","2841台開","110/07/08","永豐金-敦南",45,60,-15
"24156","2841台開","110/07/08","合庫-桃園",10,0,10
"24157","2841台開","110/07/08","(牛牛牛)亞-網路",0,12,-12
"24158","6207雷科","110/07/08","台新-高雄",54,2,52
"24159","6207雷科","110/07/08","群益金鼎-丹鳳",0,60,-60
"24160","6207雷科","110/07/08","新光-台中",18,0,18
"24161","6207雷科","110/07/08","元大-頭份",1,56,-55
"24162","6207雷科","110/07/08","日盛-嘉義",16,0,16
"24163","6207雷科","110/07/08","國票-中和",0,30,-30
"24164","6207雷科","110/07/08","合庫-鳳山",15,0,15
"24165","6207雷科","110/07/08","凱基-台北",1,29,-28
"24166","6207雷科","110/07/08","臺銀-臺中",12,0,12
"24167","6207雷科","110/07/08","兆豐-板橋",0,25,-25
"24168","6207雷科","110/07/08","群益金鼎-土城",12,0,12
"24169","6207雷科","110/07/08","凱基-城中",4,25,-21
"24170","6207雷科","110/07/08","新光",25,14,11
"24171","6207雷科","110/07/08","日進",0,20,-20
"24172","6207雷科","110/07/08","凱基-中壢",11,0,11
"24173","6207雷科","110/07/08","台新證券",3,20,-17
"24174","6207雷科","110/07/08","台灣企銀",10,0,10
"24175","6207雷科","110/07/08","群益金鼎-中山",0,16,-16
"24176","6207雷科","110/07/08","第一金-新興",11,1,10
"24177","6207雷科","110/07/08","元大-東門",0,16,-16
"24178","6207雷科","110/07/08","元富-吉利",10,0,10
"24179","6207雷科","110/07/08","群益金鼎-大甲",0,13,-13
"24180","6207雷科","110/07/08","光和-和美",10,0,10
"24181","6207雷科","110/07/08","日盛-板橋",0,10,-10
"24182","6207雷科","110/07/08","永豐金-南京",10,0,10
"24183","6207雷科","110/07/08","日盛-中壢",0,10,-10
"24184","6207雷科","110/07/08","土銀",8,0,8
"24185","6207雷科","110/07/08","摩根大通",125,135,-10
"24186","6207雷科","110/07/08","中國信託-高雄",8,0,8
"24187","6207雷科","110/07/08","凱基-五股",0,10,-10
"24188","3679新至陞","110/07/08","華南永昌-台中",17,0,17
"24189","3679新至陞","110/07/08","大慶-蘆洲",0,10,-10
"24190","3679新至陞","110/07/08","國泰-桃園",6,0,6
"24191","3679新至陞","110/07/08","華南永昌-小港",0,7,-7
"24192","3679新至陞","110/07/08","元大-永春",6,0,6
"24193","3679新至陞","110/07/08","國泰-館前",0,3,-3
"24194","3679新至陞","110/07/08","香港上海匯豐",4,0,4
"24195","3679新至陞","110/07/08","元大-板橋",0,3,-3
"24196","3679新至陞","110/07/08","中國信託-新竹",3,0,3
"24197","3679新至陞","110/07/08","港商法國興業",0,2,-2
"24198","3679新至陞","110/07/08","國票-敦北法人",3,0,3
"24199","3679新至陞","110/07/08","第一金-忠孝",0,2,-2
"24200","3679新至陞","110/07/08","群益金鼎-台南",2,0,2
"24201","3679新至陞","110/07/08","元富-古亭",0,2,-2
"24202","3679新至陞","110/07/08","凱基",2,0,2
"24203","3679新至陞","110/07/08","摩根大通",1,3,-2
"24204","3679新至陞","110/07/08","凱基-台北",6,4,2
"24205","3679新至陞","110/07/08","富邦-板橋",0,2,-2
"24206","3679新至陞","110/07/08","日盛-信義",1,0,1
"24207","3679新至陞","110/07/08","元大-文心興安",0,2,-2
"24208","3679新至陞","110/07/08","日盛-新莊",1,0,1
"24209","3679新至陞","110/07/08","臺銀-高雄",0,1,-1
"24210","3679新至陞","110/07/08","大慶",1,0,1
"24211","3679新至陞","110/07/08","日盛-高雄",0,1,-1
"24212","3679新至陞","110/07/08","兆豐-三重",1,0,1
"24213","3679新至陞","110/07/08","日盛-文化",0,1,-1
"24214","3679新至陞","110/07/08","致和-東門",1,0,1
"24215","3679新至陞","110/07/08","美商高盛",0,1,-1
"24216","3679新至陞","110/07/08","台新證券",1,0,1
"24217","3679新至陞","110/07/08","瑞士信貸",0,1,-1
"24218","2727王品","110/07/08","群益金鼎-大安",80,0,80
"24219","2727王品","110/07/08","台灣摩根士丹利",1,300,-299
"24220","2727王品","110/07/08","富邦-台北",237,165,72
"24221","2727王品","110/07/08","元大證券",173,439,-266
"24222","2727王品","110/07/08","永豐金-萬盛",55,5,50
"24223","2727王品","110/07/08","統一",33,200,-167
"24224","2727王品","110/07/08","永豐金-南投",53,10,43
"24225","2727王品","110/07/08","凱基-台北",476,615,-139
"24226","2727王品","110/07/08","國泰-敦南",190,148,42
"24227","2727王品","110/07/08","永豐金-松山",8,138,-130
"24228","2727王品","110/07/08","台新-高雄",71,36,35
"24229","2727王品","110/07/08","新加坡商瑞銀",38,138,-100
"24230","2727王品","110/07/08","富邦-建國",62,27,35
"24231","2727王品","110/07/08","富邦-嘉義",84,182,-98
"24232","2727王品","110/07/08","永豐金證券",50,15,35
"24233","2727王品","110/07/08","元富-台南",4,99,-95
"24234","2727王品","110/07/08","港商野村",185,152,33
"24235","2727王品","110/07/08","凱基-永華",4,92,-88
"24236","2727王品","110/07/08","元大-嘉義",35,3,32
"24237","2727王品","110/07/08","凱基-大直",2,73,-71
"24238","2727王品","110/07/08","台新-三民",35,4,31
"24239","2727王品","110/07/08","美林",105,164,-59
"24240","2727王品","110/07/08","凱基-桃園",35,4,31
"24241","2727王品","110/07/08","第一金-台南",11,63,-52
"24242","2727王品","110/07/08","元大-和平",41,10,31
"24243","2727王品","110/07/08","摩根大通",216,259,-43
"24244","2727王品","110/07/08","兆豐-大安",33,5,28
"24245","2727王品","110/07/08","元大-員林",9,50,-41
"24246","2727王品","110/07/08","元大-新盛",33,6,27
"24247","2727王品","110/07/08","兆豐-虎尾",1,41,-40
"24248","1570力肯","110/07/08","群益金鼎-三重",20,0,20
"24249","1570力肯","110/07/08","中國信託-永康",0,26,-26
"24250","1570力肯","110/07/08","凱基-中壢",20,0,20
"24251","1570力肯","110/07/08","統一-敦南",0,12,-12
"24252","1570力肯","110/07/08","群益金鼎-台南",14,0,14
"24253","1570力肯","110/07/08","國票-博愛",0,10,-10
"24254","1570力肯","110/07/08","元富-緯城",10,0,10
"24255","1570力肯","110/07/08","元大-西門",0,10,-10
"24256","1570力肯","110/07/08","瑞士信貸",7,0,7
"24257","1570力肯","110/07/08","新光",0,9,-9
"24258","1570力肯","110/07/08","摩根大通",6,0,6
"24259","1570力肯","110/07/08","永豐金-大園",0,9,-9
"24260","1570力肯","110/07/08","土銀-白河",5,0,5
"24261","1570力肯","110/07/08","日盛-大墩",0,6,-6
"24262","1570力肯","110/07/08","台灣摩根士丹利",4,0,4
"24263","1570力肯","110/07/08","台新證券",0,6,-6
"24264","1570力肯","110/07/08","元大-新莊",3,0,3
"24265","1570力肯","110/07/08","永全",0,5,-5
"24266","1570力肯","110/07/08","永豐金-苓雅",3,0,3
"24267","1570力肯","110/07/08","元大-天母",0,5,-5
"24268","1570力肯","110/07/08","合庫-三重",2,0,2
"24269","1570力肯","110/07/08","元富-吉利",0,3,-3
"24270","1570力肯","110/07/08","(牛牛牛)亞-鑫豐",2,0,2
"24271","1570力肯","110/07/08","國泰-高雄",0,3,-3
"24272","1570力肯","110/07/08","玉山-大里",2,0,2
"24273","1570力肯","110/07/08","群益金鼎-北高雄",0,3,-3
"24274","1570力肯","110/07/08","國泰-敦南",2,0,2
"24275","1570力肯","110/07/08","群益金鼎-東門",0,2,-2
"24276","1570力肯","110/07/08","華南永昌-岡山",2,0,2
"24277","1570力肯","110/07/08","日盛-高雄",5,6,-1
"24278","6180橘子","110/07/08","新光",30,4,26
"24279","6180橘子","110/07/08","元大-土城學府",0,89,-89
"24280","6180橘子","110/07/08","康和-台南",22,0,22
"24281","6180橘子","110/07/08","凱基-東勢",1,66,-65
"24282","6180橘子","110/07/08","國泰-板橋",22,0,22
"24283","6180橘子","110/07/08","光和",0,64,-64
"24284","6180橘子","110/07/08","日盛-文化",21,0,21
"24285","6180橘子","110/07/08","中國信託-忠孝",0,50,-50
"24286","6180橘子","110/07/08","中國信託-文心",20,2,18
"24287","6180橘子","110/07/08","元富-大裕",0,25,-25
"24288","6180橘子","110/07/08","凱基-台北",39,24,15
"24289","6180橘子","110/07/08","統一-基隆",1,25,-24
"24290","6180橘子","110/07/08","元富-新店",14,0,14
"24291","6180橘子","110/07/08","美商高盛",1,21,-20
"24292","6180橘子","110/07/08","元大-土城永寧",11,0,11
"24293","6180橘子","110/07/08","元大證券",1,19,-18
"24294","6180橘子","110/07/08","永豐金-南京",11,0,11
"24295","6180橘子","110/07/08","元大-太平",2,20,-18
"24296","6180橘子","110/07/08","宏遠-館前",10,0,10
"24297","6180橘子","110/07/08","合庫證券",2,18,-16
"24298","6180橘子","110/07/08","國泰-新莊",10,0,10
"24299","6180橘子","110/07/08","台灣摩根士丹利",1,12,-11
"24300","6180橘子","110/07/08","群益金鼎",10,0,10
"24301","6180橘子","110/07/08","瑞士信貸",0,11,-11
"24302","6180橘子","110/07/08","凱基-高雄",10,0,10
"24303","6180橘子","110/07/08","元富-嘉義",0,11,-11
"24304","6180橘子","110/07/08","凱基-大安",10,0,10
"24305","6180橘子","110/07/08","新光-高雄",0,11,-11
"24306","6180橘子","110/07/08","富邦-仁愛",10,0,10
"24307","6180橘子","110/07/08","大慶-苗栗",0,10,-10
"24308","2390云辰","110/07/08","統一-新台中",126,1,125
"24309","2390云辰","110/07/08","摩根大通",62,661,-599
"24310","2390云辰","110/07/08","元大-員林",111,0,111
"24311","2390云辰","110/07/08","新加坡商瑞銀",0,173,-173
"24312","2390云辰","110/07/08","合庫-高雄",105,0,105
"24313","2390云辰","110/07/08","元大-天母",7,150,-143
"24314","2390云辰","110/07/08","凱基-台北",255,177,78
"24315","2390云辰","110/07/08","台灣摩根士丹利",0,134,-134
"24316","2390云辰","110/07/08","新光",71,17,54
"24317","2390云辰","110/07/08","玉山-台中",17,120,-103
"24318","2390云辰","110/07/08","國票-嘉義",53,0,53
"24319","2390云辰","110/07/08","美商高盛",0,78,-78
"24320","2390云辰","110/07/08","富邦-仁愛",53,4,49
"24321","2390云辰","110/07/08","美林",11,82,-71
"24322","2390云辰","110/07/08","兆豐-城中",48,0,48
"24323","2390云辰","110/07/08","群益金鼎-大興",35,106,-71
"24324","2390云辰","110/07/08","元大-新營",47,0,47
"24325","2390云辰","110/07/08","光和",11,71,-60
"24326","2390云辰","110/07/08","國泰-敦南",89,55,34
"24327","2390云辰","110/07/08","國泰-台中",28,70,-42
"24328","2390云辰","110/07/08","兆豐-台中",40,7,33
"24329","2390云辰","110/07/08","玉山-新莊",6,46,-40
"24330","2390云辰","110/07/08","永豐金-中正",36,6,30
"24331","2390云辰","110/07/08","富邦-台北",21,57,-36
"24332","2390云辰","110/07/08","中國信託-三重",29,0,29
"24333","2390云辰","110/07/08","土銀-台中",0,30,-30
"24334","2390云辰","110/07/08","富邦-陽明",33,5,28
"24335","2390云辰","110/07/08","兆豐-埔墘",1,31,-30
"24336","2390云辰","110/07/08","元富-桃園",27,0,27
"24337","2390云辰","110/07/08","玉山-南京東路",3,33,-30
"24338","4903聯光通","110/07/07","元大-太平",47,4,43
"24339","4903聯光通","110/07/07","日盛-板橋",0,15,-15
"24340","4903聯光通","110/07/07","華南永昌-桃園",10,0,10
"24341","4903聯光通","110/07/07","元大-八德",0,9,-9
"24342","4903聯光通","110/07/07","元大-南投",9,0,9
"24343","4903聯光通","110/07/07","宏遠證券",0,7,-7
"24344","4903聯光通","110/07/07","新光-台中",3,0,3
"24345","4903聯光通","110/07/07","大慶",0,7,-7
"24346","4903聯光通","110/07/07","國泰-敦南",1,0,1
"24347","4903聯光通","110/07/07","群益金鼎-館前",0,6,-6
"24348","4903聯光通","110/07/07","國票-中正",0,0,0
"24349","4903聯光通","110/07/07","元大-羅東",0,5,-5
"24350","4903聯光通","110/07/07","康和-內湖",0,0,0
"24351","4903聯光通","110/07/07","新光",8,12,-4
"24352","4903聯光通","110/07/07","凱基-站前",0,0,0
"24353","4903聯光通","110/07/07","國泰-高雄",0,3,-3
"24354","4903聯光通","110/07/07","華南永昌",1,1,0
"24355","4903聯光通","110/07/07","第一金-台中",0,3,-3
"24356","4903聯光通","110/07/07","華南永昌-新莊",0,0,0
"24357","4903聯光通","110/07/07","中農",0,1,-1
"24358","4903聯光通","110/07/07","臺灣企銀-桃園",0,1,-1
"24359","4903聯光通","110/07/07","台新-新營",0,1,-1
"24360","4903聯光通","110/07/07","元大-鶯歌",2,3,-1
"24361","4903聯光通","110/07/07","元大-永和",0,1,-1
"24362","4903聯光通","110/07/07","元大-苑裡",0,1,-1
"24363","2929淘帝","110/07/07","統一",163,0,163
"24364","2929淘帝","110/07/07","新光-台中",57,142,-85
"24365","2929淘帝","110/07/07","港商野村",323,181,142
"24366","2929淘帝","110/07/07","兆豐-忠孝",0,76,-76
"24367","2929淘帝","110/07/07","日盛-中壢",132,10,122
"24368","2929淘帝","110/07/07","台新-建北",0,53,-53
"24369","2929淘帝","110/07/07","新加坡商瑞銀",140,19,121
"24370","2929淘帝","110/07/07","臺銀-鳳山",0,44,-44
"24371","2929淘帝","110/07/07","日盛-嘉義",101,0,101
"24372","2929淘帝","110/07/07","元大-新盛",0,42,-42
"24373","2929淘帝","110/07/07","摩根大通",101,16,85
"24374","2929淘帝","110/07/07","富邦-建國",6,47,-41
"24375","2929淘帝","110/07/07","元大-太平",55,2,53
"24376","2929淘帝","110/07/07","日盛-園區",0,40,-40
"24377","2929淘帝","110/07/07","元富-松德",50,1,49
"24378","2929淘帝","110/07/07","新光-高雄",1,38,-37
"24379","2929淘帝","110/07/07","凱基-板橋",53,5,48
"24380","2929淘帝","110/07/07","永豐金-三重",1,34,-33
"24381","2929淘帝","110/07/07","美林",80,34,46
"24382","2929淘帝","110/07/07","元大-彰化",0,31,-31
"24383","2929淘帝","110/07/07","元富-台南",41,0,41
"24384","2929淘帝","110/07/07","第一金-大稻埕",0,30,-30
"24385","2929淘帝","110/07/07","兆豐-竹北",39,0,39
"24386","2929淘帝","110/07/07","國泰-敦南",3,33,-30
"24387","2929淘帝","110/07/07","元大-西門",36,0,36
"24388","2929淘帝","110/07/07","富邦-員林",0,30,-30
"24389","2929淘帝","110/07/07","華南永昌",39,4,35
"24390","2929淘帝","110/07/07","元大-蘆洲",1,30,-29
"24391","2929淘帝","110/07/07","日盛-板橋中山",30,0,30
"24392","2929淘帝","110/07/07","台新-台南",4,32,-28
"24393","5410國眾","110/07/07","兆豐-城中",66,0,66
"24394","5410國眾","110/07/07","富邦-仁愛",0,115,-115
"24395","5410國眾","110/07/07","摩根大通",21,0,21
"24396","5410國眾","110/07/07","亞東-板橋",0,38,-38
"24397","5410國眾","110/07/07","元大-北投",21,0,21
"24398","5410國眾","110/07/07","凱基-台北",2,24,-22
"24399","5410國眾","110/07/07","亞東-新竹",15,0,15
"24400","5410國眾","110/07/07","彰銀-七賢",0,10,-10
"24401","5410國眾","110/07/07","元大-福營",12,0,12
"24402","5410國眾","110/07/07","凱基-基隆",0,10,-10
"24403","5410國眾","110/07/07","新光-高雄",11,0,11
"24404","5410國眾","110/07/07","凱基-屏東",0,10,-10
"24405","5410國眾","110/07/07","華南永昌-小港",10,0,10
"24406","5410國眾","110/07/07","凱基-鳳山",0,10,-10
"24407","5410國眾","110/07/07","元大-大灣",10,0,10
"24408","5410國眾","110/07/07","永豐金-忠孝",0,10,-10
"24409","5410國眾","110/07/07","元大-莒光",10,0,10
"24410","5410國眾","110/07/07","日盛-板橋中山",0,9,-9
"24411","5410國眾","110/07/07","台中銀-豐原",9,0,9
"24412","5410國眾","110/07/07","統一-高雄",0,5,-5
"24413","5410國眾","110/07/07","元大-南屯",9,0,9
"24414","5410國眾","110/07/07","元大-斗六",0,5,-5
"24415","5410國眾","110/07/07","日盛-新莊",7,0,7
"24416","5410國眾","110/07/07","元大-大益",0,5,-5
"24417","5410國眾","110/07/07","元富-大昌",6,0,6
"24418","5410國眾","110/07/07","元大-南投",0,5,-5
"24419","5410國眾","110/07/07","新光-新竹",6,0,6
"24420","5410國眾","110/07/07","永豐金-員林",0,5,-5
"24421","5410國眾","110/07/07","臺銀-金山",5,0,5
"24422","5410國眾","110/07/07","華南永昌-楠梓",0,4,-4
"24423","2841台開","110/07/07","永豐金-豐原",268,0,268
"24424","2841台開","110/07/07","凱基-市政",0,200,-200
"24425","2841台開","110/07/07","永豐金-南投",200,0,200
"24426","2841台開","110/07/07","永豐金-彰化",0,100,-100
"24427","2841台開","110/07/07","新光",139,9,130
"24428","2841台開","110/07/07","元大-開元",1,93,-92
"24429","2841台開","110/07/07","中國信託-高雄",50,1,49
"24430","2841台開","110/07/07","港商野村",0,80,-80
"24431","2841台開","110/07/07","元大-歸仁",40,0,40
"24432","2841台開","110/07/07","凱基-台南",25,85,-60
"24433","2841台開","110/07/07","台中銀",35,0,35
"24434","2841台開","110/07/07","美商高盛",1,58,-57
"24435","2841台開","110/07/07","台新-新營",30,0,30
"24436","2841台開","110/07/07","統一-三重",0,55,-55
"24437","2841台開","110/07/07","富邦-台南",30,0,30
"24438","2841台開","110/07/07","台新證券",12,50,-38
"24439","2841台開","110/07/07","國泰-板橋",30,1,29
"24440","2841台開","110/07/07","陽信-石牌",0,31,-31
"24441","2841台開","110/07/07","凱基-文心",28,0,28
"24442","2841台開","110/07/07","元大-福營",0,31,-31
"24443","2841台開","110/07/07","凱基-站前",27,0,27
"24444","2841台開","110/07/07","第一金-澎湖",0,30,-30
"24445","2841台開","110/07/07","大昌-安康",38,16,22
"24446","2841台開","110/07/07","元大-新莊",0,30,-30
"24447","2841台開","110/07/07","合庫-台中",20,0,20
"24448","2841台開","110/07/07","國泰-館前",0,28,-28
"24449","2841台開","110/07/07","日盛-台南",20,0,20
"24450","2841台開","110/07/07","元大-竹科",0,25,-25
"24451","2841台開","110/07/07","台中銀-員林",20,0,20
"24452","2841台開","110/07/07","富邦-仁愛",1,22,-21
"24453","6207雷科","110/07/07","元大-大天母",21,0,21
"24454","6207雷科","110/07/07","元大-高雄",0,105,-105
"24455","6207雷科","110/07/07","元大-頭份",18,0,18
"24456","6207雷科","110/07/07","永豐金-中正",0,35,-35
"24457","6207雷科","110/07/07","第一金-新興",16,0,16
"24458","6207雷科","110/07/07","摩根大通",8,39,-31
"24459","6207雷科","110/07/07","富邦-虎尾",12,0,12
"24460","6207雷科","110/07/07","元大-林園",0,30,-30
"24461","6207雷科","110/07/07","兆豐-板橋",10,0,10
"24462","6207雷科","110/07/07","凱基-台北",0,19,-19
"24463","6207雷科","110/07/07","玉山-台大",10,0,10
"24464","6207雷科","110/07/07","國票-中和",13,25,-12
"24465","6207雷科","110/07/07","元大-四維",10,0,10
"24466","6207雷科","110/07/07","新加坡商瑞銀",0,9,-9
"24467","6207雷科","110/07/07","元大-鹿港",10,0,10
"24468","6207雷科","110/07/07","玉山-高雄",0,8,-8
"24469","6207雷科","110/07/07","元大-信義",10,0,10
"24470","6207雷科","110/07/07","玉山-台南",0,8,-8
"24471","6207雷科","110/07/07","台新-三民",8,0,8
"24472","6207雷科","110/07/07","宏遠-高雄",0,5,-5
"24473","6207雷科","110/07/07","元大-上新莊",8,0,8
"24474","6207雷科","110/07/07","元大-南海",0,5,-5
"24475","6207雷科","110/07/07","大昌-桃園",7,0,7
"24476","6207雷科","110/07/07","元大-莒光",0,4,-4
"24477","6207雷科","110/07/07","新光-台中",10,4,6
"24478","6207雷科","110/07/07","港商野村",0,3,-3
"24479","6207雷科","110/07/07","日盛-頭份",5,0,5
"24480","6207雷科","110/07/07","大慶-台南",0,3,-3
"24481","6207雷科","110/07/07","日茂-埔里",5,0,5
"24482","6207雷科","110/07/07","凱基-站前",0,3,-3
"24483","3679新至陞","110/07/07","永豐金證券",18,0,18
"24484","3679新至陞","110/07/07","美林",0,13,-13
"24485","3679新至陞","110/07/07","元大-文心興安",6,0,6
"24486","3679新至陞","110/07/07","兆豐-大安",0,10,-10
"24487","3679新至陞","110/07/07","中農",5,0,5
"24488","3679新至陞","110/07/07","國泰-桃園",0,4,-4
"24489","3679新至陞","110/07/07","台新證券",4,0,4
"24490","3679新至陞","110/07/07","永豐金-虎尾",0,4,-4
"24491","3679新至陞","110/07/07","華南永昌-小港",4,0,4
"24492","3679新至陞","110/07/07","台灣摩根士丹利",0,3,-3
"24493","3679新至陞","110/07/07","元大-天母",4,0,4
"24494","3679新至陞","110/07/07","瑞士信貸",0,3,-3
"24495","3679新至陞","110/07/07","台中銀-員林",4,1,3
"24496","3679新至陞","110/07/07","統一-新竹",0,3,-3
"24497","3679新至陞","110/07/07","摩根大通",4,1,3
"24498","3679新至陞","110/07/07","統一-三重",0,3,-3
"24499","3679新至陞","110/07/07","凱基-台北",7,4,3
"24500","3679新至陞","110/07/07","凱基-竹北",0,3,-3
"24501","3679新至陞","110/07/07","華南永昌-高雄",3,0,3
"24502","3679新至陞","110/07/07","元富-世貿",0,2,-2
"24503","3679新至陞","110/07/07","永豐金-潮州",2,0,2
"24504","3679新至陞","110/07/07","兆豐-鹿港",0,2,-2
"24505","3679新至陞","110/07/07","合庫-新竹",1,0,1
"24506","3679新至陞","110/07/07","玉山-台大",0,2,-2
"24507","3679新至陞","110/07/07","土銀-高雄",1,0,1
"24508","3679新至陞","110/07/07","國泰-館前",0,2,-2
"24509","3679新至陞","110/07/07","元富-新興",1,0,1
"24510","3679新至陞","110/07/07","群益金鼎-新莊",0,2,-2
"24511","3679新至陞","110/07/07","富邦-中壢",1,0,1
"24512","3679新至陞","110/07/07","元大-桃園",0,2,-2
"24513","2727王品","110/07/07","第一金",62,0,62
"24514","2727王品","110/07/07","台灣摩根士丹利",1,177,-176
"24515","2727王品","110/07/07","凱基-埔墘",40,0,40
"24516","2727王品","110/07/07","凱基-台北",49,151,-102
"24517","2727王品","110/07/07","中國信託-忠孝",40,1,39
"24518","2727王品","110/07/07","摩根大通",19,107,-88
"24519","2727王品","110/07/07","玉山-板橋",40,6,34
"24520","2727王品","110/07/07","美商高盛",2,86,-84
"24521","2727王品","110/07/07","亞東-新竹",31,1,30
"24522","2727王品","110/07/07","元大-北屯",1,52,-51
"24523","2727王品","110/07/07","群益金鼎-宜蘭",25,1,24
"24524","2727王品","110/07/07","國泰證券",1,47,-46
"24525","2727王品","110/07/07","富邦-竹北",23,0,23
"24526","2727王品","110/07/07","統一",3,33,-30
"24527","2727王品","110/07/07","元大-旗山",23,0,23
"24528","2727王品","110/07/07","第一金-台中",1,30,-29
"24529","2727王品","110/07/07","元富-宜蘭",21,0,21
"24530","2727王品","110/07/07","華南永昌-中正",4,29,-25
"24531","2727王品","110/07/07","國票-長城",20,0,20
"24532","2727王品","110/07/07","美林",0,23,-23
"24533","2727王品","110/07/07","台新證券",47,28,19
"24534","2727王品","110/07/07","群益金鼎-館前",0,20,-20
"24535","2727王品","110/07/07","富邦-新竹華信",18,1,17
"24536","2727王品","110/07/07","國票-內壢",0,16,-16
"24537","2727王品","110/07/07","永豐金-中正",18,1,17
"24538","2727王品","110/07/07","兆豐-新莊",0,15,-15
"24539","2727王品","110/07/07","華南永昌-麻豆",17,1,16
"24540","2727王品","110/07/07","港商野村",15,28,-13
"24541","2727王品","110/07/07","永豐金-潮州",15,0,15
"24542","2727王品","110/07/07","元大-善化",1,13,-12
"24543","1570力肯","110/07/07","台新證券",88,0,88
"24544","1570力肯","110/07/07","新光",0,54,-54
"24545","1570力肯","110/07/07","摩根大通",49,15,34
"24546","1570力肯","110/07/07","元大-高雄",0,40,-40
"24547","1570力肯","110/07/07","合庫-桃園",20,0,20
"24548","1570力肯","110/07/07","國票-北高雄",38,50,-12
"24549","1570力肯","110/07/07","元大-土城學府",20,0,20
"24550","1570力肯","110/07/07","群益金鼎-嘉義",0,10,-10
"24551","1570力肯","110/07/07","永豐金-板盛",18,0,18
"24552","1570力肯","110/07/07","元大-草屯",0,10,-10
"24553","1570力肯","110/07/07","永豐金-永康",18,0,18
"24554","1570力肯","110/07/07","日盛-高雄",0,9,-9
"24555","1570力肯","110/07/07","統一-員林",14,0,14
"24556","1570力肯","110/07/07","第一金-路竹",0,9,-9
"24557","1570力肯","110/07/07","元大-竹山",6,0,6
"24558","1570力肯","110/07/07","元大-古亭",0,9,-9
"24559","1570力肯","110/07/07","統一-敦南",5,0,5
"24560","1570力肯","110/07/07","國票-中正",0,8,-8
"24561","1570力肯","110/07/07","元大-永和",5,0,5
"24562","1570力肯","110/07/07","群益金鼎-鳳山",0,6,-6
"24563","1570力肯","110/07/07","元富-大裕",4,0,4
"24564","1570力肯","110/07/07","元大-土城永寧",0,6,-6
"24565","1570力肯","110/07/07","華南永昌-斗六",4,0,4
"24566","1570力肯","110/07/07","中國信託",0,5,-5
"24567","1570力肯","110/07/07","永豐金-松山",6,3,3
"24568","1570力肯","110/07/07","日盛-板橋",0,4,-4
"24569","1570力肯","110/07/07","永豐金-南投",4,1,3
"24570","1570力肯","110/07/07","日盛-木柵",0,4,-4
"24571","1570力肯","110/07/07","土銀-彰化",2,0,2
"24572","1570力肯","110/07/07","玉山-桃園",0,4,-4
"24573","6180橘子","110/07/07","臺銀-金山",27,0,27
"24574","6180橘子","110/07/07","凱基-台北",6,36,-30
"24575","6180橘子","110/07/07","元富-潮州",20,0,20
"24576","6180橘子","110/07/07","元大-天母",1,26,-25
"24577","6180橘子","110/07/07","凱基-中山",20,0,20
"24578","6180橘子","110/07/07","富邦-陽明",0,22,-22
"24579","6180橘子","110/07/07","元大-太平",23,4,19
"24580","6180橘子","110/07/07","日盛-頭份",0,20,-20
"24581","6180橘子","110/07/07","摩根大通",17,0,17
"24582","6180橘子","110/07/07","富邦-仁愛",0,20,-20
"24583","6180橘子","110/07/07","元大-草屯",20,3,17
"24584","6180橘子","110/07/07","永豐金-新莊",0,20,-20
"24585","6180橘子","110/07/07","華南永昌-楠梓",15,1,14
"24586","6180橘子","110/07/07","台灣摩根士丹利",0,18,-18
"24587","6180橘子","110/07/07","中國信託-永康",12,0,12
"24588","6180橘子","110/07/07","華南永昌-長虹",1,16,-15
"24589","6180橘子","110/07/07","日盛-文化",10,0,10
"24590","6180橘子","110/07/07","新光-新竹",0,12,-12
"24591","6180橘子","110/07/07","國泰-館前",10,0,10
"24592","6180橘子","110/07/07","凱基-中壢",0,12,-12
"24593","6180橘子","110/07/07","華南永昌-鶯歌",10,0,10
"24594","6180橘子","110/07/07","第一金-忠孝",0,11,-11
"24595","6180橘子","110/07/07","元大-豐原站前",10,0,10
"24596","6180橘子","110/07/07","元大-沙鹿",0,11,-11
"24597","6180橘子","110/07/07","元大-北屯",10,0,10
"24598","6180橘子","110/07/07","永豐金-羅東",0,11,-11
"24599","6180橘子","110/07/07","兆豐-台中",10,1,9
"24600","6180橘子","110/07/07","兆豐-埔墘",0,10,-10
"24601","6180橘子","110/07/07","群益金鼎-開元",9,0,9
"24602","6180橘子","110/07/07","華南永昌-台中",0,10,-10
"24603","2390云辰","110/07/07","元大-向上",144,0,144
"24604","2390云辰","110/07/07","摩根大通",18,674,-656
"24605","2390云辰","110/07/07","元富-中港",102,0,102
"24606","2390云辰","110/07/07","凱基-台北",141,625,-484
"24607","2390云辰","110/07/07","群益金鼎-民權",104,4,100
"24608","2390云辰","110/07/07","美林",32,261,-229
"24609","2390云辰","110/07/07","兆豐-忠孝",81,0,81
"24610","2390云辰","110/07/07","新加坡商瑞銀",50,149,-99
"24611","2390云辰","110/07/07","合庫-新竹",60,0,60
"24612","2390云辰","110/07/07","台灣摩根士丹利",7,87,-80
"24613","2390云辰","110/07/07","元大-土城學府",59,1,58
"24614","2390云辰","110/07/07","元大-金華",2,68,-66
"24615","2390云辰","110/07/07","玉山-大里",58,3,55
"24616","2390云辰","110/07/07","國票-新莊",13,65,-52
"24617","2390云辰","110/07/07","元大-東蘆",54,1,53
"24618","2390云辰","110/07/07","凱基-三重",12,56,-44
"24619","2390云辰","110/07/07","元富-三重",51,0,51
"24620","2390云辰","110/07/07","新光-台中",23,65,-42
"24621","2390云辰","110/07/07","元富-埔里",50,0,50
"24622","2390云辰","110/07/07","第一金-中壢",5,45,-40
"24623","2390云辰","110/07/07","中國信託-三重",52,3,49
"24624","2390云辰","110/07/07","華南永昌-斗六",0,40,-40
"24625","2390云辰","110/07/07","元大-彰化民生",64,15,49
"24626","2390云辰","110/07/07","富邦-新竹華信",25,61,-36
"24627","2390云辰","110/07/07","元大-潮州",50,5,45
"24628","2390云辰","110/07/07","玉山-新莊",2,32,-30
"24629","2390云辰","110/07/07","元富-高雄",57,14,43
"24630","2390云辰","110/07/07","凱基-新豐",17,47,-30
"24631","2390云辰","110/07/07","凱基-和平",40,0,40
"24632","2390云辰","110/07/07","統一-汐止",1,29,-28
"24633","4903聯光通","110/07/06","元大-苗栗",10,0,10
"24634","4903聯光通","110/07/06","宏遠證券",0,13,-13
"24635","4903聯光通","110/07/06","彰銀",5,0,5
"24636","4903聯光通","110/07/06","富邦-新營",0,4,-4
"24637","4903聯光通","110/07/06","元大-松山",5,0,5
"24638","4903聯光通","110/07/06","元富-草屯",0,3,-3
"24639","4903聯光通","110/07/06","新光",3,0,3
"24640","4903聯光通","110/07/06","元大-羅東",0,3,-3
"24641","4903聯光通","110/07/06","群益金鼎-館前",1,0,1
"24642","4903聯光通","110/07/06","元大-北三重",0,2,-2
"24643","4903聯光通","110/07/06","華南永昌-鶯歌",1,0,1
"24644","4903聯光通","110/07/06","國泰-敦南",0,1,-1
"24645","4903聯光通","110/07/06","永豐金-市政",1,0,1
"24646","4903聯光通","110/07/06","元富-板橋",0,0,0
"24647","4903聯光通","110/07/06","元富-板橋",0,0,0
"24648","4903聯光通","110/07/06","華南永昌",0,0,0
"24649","4903聯光通","110/07/06","華南永昌",0,0,0
"24650","4903聯光通","110/07/06","元大-太平",2,2,0
"24651","4903聯光通","110/07/06","元大-太平",2,2,0
"24652","2929淘帝","110/07/06","新光",204,85,119
"24653","2929淘帝","110/07/06","港商野村",62,282,-220
"24654","2929淘帝","110/07/06","日盛-中壢",94,0,94
"24655","2929淘帝","110/07/06","摩根大通",64,264,-200
"24656","2929淘帝","110/07/06","元富-城東",84,0,84
"24657","2929淘帝","110/07/06","統一",0,163,-163
"24658","2929淘帝","110/07/06","日盛-雙和",55,0,55
"24659","2929淘帝","110/07/06","香港上海匯豐",0,141,-141
"24660","2929淘帝","110/07/06","第一金-路竹",71,17,54
"24661","2929淘帝","110/07/06","新加坡商瑞銀",54,179,-125
"24662","2929淘帝","110/07/06","元大-花蓮",44,2,42
"24663","2929淘帝","110/07/06","合庫-高雄",3,122,-119
"24664","2929淘帝","110/07/06","永豐金-大園",73,33,40
"24665","2929淘帝","110/07/06","美林",34,118,-84
"24666","2929淘帝","110/07/06","元大-太平",44,6,38
"24667","2929淘帝","110/07/06","元大-員林",2,82,-80
"24668","2929淘帝","110/07/06","國泰-板橋",40,5,35
"24669","2929淘帝","110/07/06","元富-松德",26,75,-49
"24670","2929淘帝","110/07/06","兆豐-內湖",33,1,32
"24671","2929淘帝","110/07/06","臺銀-臺南",9,52,-43
"24672","2929淘帝","110/07/06","元大-博愛",43,11,32
"24673","2929淘帝","110/07/06","元大-北投",5,48,-43
"24674","2929淘帝","110/07/06","日盛-竹北",40,10,30
"24675","2929淘帝","110/07/06","臺銀-民權",1,41,-40
"24676","2929淘帝","110/07/06","元大-善化",52,22,30
"24677","2929淘帝","110/07/06","兆豐-忠孝",1,41,-40
"24678","2929淘帝","110/07/06","富邦-北港",29,0,29
"24679","2929淘帝","110/07/06","元大-西門",1,36,-35
"24680","2929淘帝","110/07/06","凱基-湖口",27,0,27
"24681","2929淘帝","110/07/06","玉山-嘉義",3,35,-32
"24682","5410國眾","110/07/06","兆豐-城中",28,0,28
"24683","5410國眾","110/07/06","凱基-高美館",1,18,-17
"24684","5410國眾","110/07/06","元大-小港",20,0,20
"24685","5410國眾","110/07/06","國泰-館前",0,15,-15
"24686","5410國眾","110/07/06","元大-新盛",18,0,18
"24687","5410國眾","110/07/06","國泰-板橋",2,17,-15
"24688","5410國眾","110/07/06","香港上海匯豐",15,0,15
"24689","5410國眾","110/07/06","新光",0,13,-13
"24690","5410國眾","110/07/06","華南永昌-小港",15,0,15
"24691","5410國眾","110/07/06","元富-緯城",0,10,-10
"24692","5410國眾","110/07/06","元富-大昌",13,0,13
"24693","5410國眾","110/07/06","中農",0,10,-10
"24694","5410國眾","110/07/06","臺銀-臺南",10,0,10
"24695","5410國眾","110/07/06","凱基-屏東",0,10,-10
"24696","5410國眾","110/07/06","元富-延平",8,0,8
"24697","5410國眾","110/07/06","新光-桃園",0,6,-6
"24698","5410國眾","110/07/06","元大-八德",17,9,8
"24699","5410國眾","110/07/06","高橋-龍潭",0,5,-5
"24700","5410國眾","110/07/06","摩根大通",7,0,7
"24701","5410國眾","110/07/06","元富-世貿",0,5,-5
"24702","5410國眾","110/07/06","凱基-桃園",7,0,7
"24703","5410國眾","110/07/06","群益金鼎-瑞豐",0,5,-5
"24704","5410國眾","110/07/06","永豐金-屏東",7,0,7
"24705","5410國眾","110/07/06","富邦-台中",0,5,-5
"24706","5410國眾","110/07/06","台新-左楠",5,0,5
"24707","5410國眾","110/07/06","永豐金-板橋",0,5,-5
"24708","5410國眾","110/07/06","富邦-竹東",5,0,5
"24709","5410國眾","110/07/06","富邦-台南",0,4,-4
"24710","5410國眾","110/07/06","元大-新莊",5,0,5
"24711","5410國眾","110/07/06","凱基-站前",0,3,-3
"24712","2841台開","110/07/06","群益金鼎-忠孝",100,0,100
"24713","2841台開","110/07/06","港商野村",0,295,-295
"24714","2841台開","110/07/06","台新證券",58,0,58
"24715","2841台開","110/07/06","元大-善化",0,50,-50
"24716","2841台開","110/07/06","台新-台中",58,0,58
"24717","2841台開","110/07/06","元大-四維",0,50,-50
"24718","2841台開","110/07/06","永豐金-敦南",50,0,50
"24719","2841台開","110/07/06","台新-新營",0,30,-30
"24720","2841台開","110/07/06","元大-台中",45,0,45
"24721","2841台開","110/07/06","群益金鼎-桃園",0,21,-21
"24722","2841台開","110/07/06","凱基-文心",43,0,43
"24723","2841台開","110/07/06","台中銀-員林",0,20,-20
"24724","2841台開","110/07/06","永豐金-潮州",30,0,30
"24725","2841台開","110/07/06","群益金鼎-延平",0,15,-15
"24726","2841台開","110/07/06","第一金-自由",25,0,25
"24727","2841台開","110/07/06","元大-三重",0,13,-13
"24728","2841台開","110/07/06","美商高盛",17,0,17
"24729","2841台開","110/07/06","元富-古亭",0,10,-10
"24730","2841台開","110/07/06","大昌-安康",39,22,17
"24731","2841台開","110/07/06","群益金鼎-北高雄",0,10,-10
"24732","2841台開","110/07/06","台中銀",15,0,15
"24733","2841台開","110/07/06","華南永昌-南京",0,10,-10
"24734","2841台開","110/07/06","玉山-嘉義",15,0,15
"24735","2841台開","110/07/06","富邦-花蓮",0,10,-10
"24736","2841台開","110/07/06","新光",11,0,11
"24737","2841台開","110/07/06","富邦-高雄",0,10,-10
"24738","2841台開","110/07/06","兆豐-永和",10,0,10
"24739","2841台開","110/07/06","元大-竹山",0,10,-10
"24740","2841台開","110/07/06","康和-內湖",10,0,10
"24741","2841台開","110/07/06","元大-屏東",0,10,-10
"24742","6207雷科","110/07/06","新光",45,4,41
"24743","6207雷科","110/07/06","凱基-高美館",1,104,-103
"24744","6207雷科","110/07/06","統一-基隆",30,0,30
"24745","6207雷科","110/07/06","摩根大通",11,45,-34
"24746","6207雷科","110/07/06","康和-南崁",13,0,13
"24747","6207雷科","110/07/06","群益金鼎-新竹",0,22,-22
"24748","6207雷科","110/07/06","宏遠-台南",10,0,10
"24749","6207雷科","110/07/06","港商野村",2,23,-21
"24750","6207雷科","110/07/06","國票-和平",10,0,10
"24751","6207雷科","110/07/06","凱基-台北",0,14,-14
"24752","6207雷科","110/07/06","永豐金-天母",10,0,10
"24753","6207雷科","110/07/06","台新-三民",0,12,-12
"24754","6207雷科","110/07/06","台新證券",10,1,9
"24755","6207雷科","110/07/06","群益金鼎-開元",1,11,-10
"24756","6207雷科","110/07/06","群益金鼎-士林",8,0,8
"24757","6207雷科","110/07/06","富邦-南屯",0,8,-8
"24758","6207雷科","110/07/06","群益金鼎-瑞豐",7,0,7
"24759","6207雷科","110/07/06","元大-善化",0,8,-8
"24760","6207雷科","110/07/06","元大-四維",7,0,7
"24761","6207雷科","110/07/06","日盛-頭份",0,5,-5
"24762","6207雷科","110/07/06","國票-中和",6,0,6
"24763","6207雷科","110/07/06","第一金-高雄",0,5,-5
"24764","6207雷科","110/07/06","台新-中壢",6,0,6
"24765","6207雷科","110/07/06","凱基-八德",0,5,-5
"24766","6207雷科","110/07/06","凱基-高雄",6,0,6
"24767","6207雷科","110/07/06","凱基-頭份",0,5,-5
"24768","6207雷科","110/07/06","富邦-彰化",6,0,6
"24769","6207雷科","110/07/06","合庫-新竹",0,4,-4
"24770","6207雷科","110/07/06","凱基-大安",5,0,5
"24771","6207雷科","110/07/06","新光-高雄",0,4,-4
"24772","3679新至陞","110/07/06","凱基",11,0,11
"24773","3679新至陞","110/07/06","摩根大通",0,22,-22
"24774","3679新至陞","110/07/06","台中銀-員林",11,1,10
"24775","3679新至陞","110/07/06","凱基-台北",6,21,-15
"24776","3679新至陞","110/07/06","安泰-大發",10,0,10
"24777","3679新至陞","110/07/06","瑞士信貸",0,13,-13
"24778","3679新至陞","110/07/06","香港上海匯豐",8,0,8
"24779","3679新至陞","110/07/06","富邦-苗栗",0,10,-10
"24780","3679新至陞","110/07/06","永豐金證券",8,2,6
"24781","3679新至陞","110/07/06","元大-永春",0,6,-6
"24782","3679新至陞","110/07/06","第一金-高雄",5,0,5
"24783","3679新至陞","110/07/06","凱基-興隆",0,5,-5
"24784","3679新至陞","110/07/06","群益金鼎-高盛",3,0,3
"24785","3679新至陞","110/07/06","國泰-桃園",0,3,-3
"24786","3679新至陞","110/07/06","元大-嘉義",3,0,3
"24787","3679新至陞","110/07/06","元大-萬華",2,5,-3
"24788","3679新至陞","110/07/06","臺銀-高雄",2,0,2
"24789","3679新至陞","110/07/06","美林",0,2,-2
"24790","3679新至陞","110/07/06","日盛-復興",2,0,2
"24791","3679新至陞","110/07/06","第一金-華江",0,2,-2
"24792","3679新至陞","110/07/06","日盛-樹林",4,2,2
"24793","3679新至陞","110/07/06","新光-台中",0,2,-2
"24794","3679新至陞","110/07/06","宏遠-館前",2,0,2
"24795","3679新至陞","110/07/06","華南永昌-民權",0,2,-2
"24796","3679新至陞","110/07/06","台新證券",2,0,2
"24797","3679新至陞","110/07/06","元大-板橋",0,2,-2
"24798","3679新至陞","110/07/06","康和-板橋",2,0,2
"24799","3679新至陞","110/07/06","日盛-板橋中山",0,1,-1
"24800","3679新至陞","110/07/06","群益金鼎-台南",2,0,2
"24801","3679新至陞","110/07/06","宏遠證券",0,1,-1
"24802","2727王品","110/07/06","元大證券",1033,729,304
"24803","2727王品","110/07/06","台灣摩根士丹利",35,184,-149
"24804","2727王品","110/07/06","富邦-台北",332,46,286
"24805","2727王品","110/07/06","元大-北屯",11,79,-68
"24806","2727王品","110/07/06","統一",252,43,209
"24807","2727王品","110/07/06","元富-敦南",4,70,-66
"24808","2727王品","110/07/06","永豐金-松山",147,14,133
"24809","2727王品","110/07/06","元大-基隆孝二",11,75,-64
"24810","2727王品","110/07/06","富邦-嘉義",301,198,103
"24811","2727王品","110/07/06","臺銀-臺南",9,69,-60
"24812","2727王品","110/07/06","新加坡商瑞銀",128,34,94
"24813","2727王品","110/07/06","中國信託-忠孝",5,48,-43
"24814","2727王品","110/07/06","元富-台南",97,6,91
"24815","2727王品","110/07/06","永豐金-市政",5,46,-41
"24816","2727王品","110/07/06","台新證券",169,105,64
"24817","2727王品","110/07/06","彰銀-台中",19,56,-37
"24818","2727王品","110/07/06","美林",115,58,57
"24819","2727王品","110/07/06","玉山證券",30,67,-37
"24820","2727王品","110/07/06","華南永昌",75,23,52
"24821","2727王品","110/07/06","凱基-埔墘",4,41,-37
"24822","2727王品","110/07/06","凱基-台北",445,398,47
"24823","2727王品","110/07/06","永豐金-大園",3,40,-37
"24824","2727王品","110/07/06","凱基-大直",48,7,41
"24825","2727王品","110/07/06","元富",2,37,-35
"24826","2727王品","110/07/06","凱基-林口",45,4,41
"24827","2727王品","110/07/06","富邦-仁愛",32,64,-32
"24828","2727王品","110/07/06","德信",40,1,39
"24829","2727王品","110/07/06","玉山-板橋",52,82,-30
"24830","2727王品","110/07/06","第一金",42,5,37
"24831","2727王品","110/07/06","中國信託-文心",10,39,-29
"24832","1570力肯","110/07/06","香港上海匯豐",47,0,47
"24833","1570力肯","110/07/06","新光",2,107,-105
"24834","1570力肯","110/07/06","元大-高雄",55,16,39
"24835","1570力肯","110/07/06","摩根大通",11,58,-47
"24836","1570力肯","110/07/06","元富-緯城",37,0,37
"24837","1570力肯","110/07/06","高橋",4,50,-46
"24838","1570力肯","110/07/06","台新-台南",16,0,16
"24839","1570力肯","110/07/06","合庫-桃園",0,20,-20
"24840","1570力肯","110/07/06","元大-新竹經國",14,0,14
"24841","1570力肯","110/07/06","永豐金-板盛",0,18,-18
"24842","1570力肯","110/07/06","富邦-左營",12,0,12
"24843","1570力肯","110/07/06","華南永昌-公誠",0,9,-9
"24844","1570力肯","110/07/06","國票-中正",12,2,10
"24845","1570力肯","110/07/06","凱基-台北",1,9,-8
"24846","1570力肯","110/07/06","國票-博愛",10,0,10
"24847","1570力肯","110/07/06","臺銀-臺中",0,6,-6
"24848","1570力肯","110/07/06","統一-敦南",12,5,7
"24849","1570力肯","110/07/06","台新-三民",0,5,-5
"24850","1570力肯","110/07/06","群益金鼎-三重",7,0,7
"24851","1570力肯","110/07/06","華南永昌-麻豆",0,5,-5
"24852","1570力肯","110/07/06","臺銀-臺南",6,0,6
"24853","1570力肯","110/07/06","合庫-台南",0,4,-4
"24854","1570力肯","110/07/06","大慶-蘆洲",6,0,6
"24855","1570力肯","110/07/06","統一-員林",0,4,-4
"24856","1570力肯","110/07/06","元富-新店",6,0,6
"24857","1570力肯","110/07/06","康和-澎湖",0,4,-4
"24858","1570力肯","110/07/06","玉山-雙和",7,1,6
"24859","1570力肯","110/07/06","華南永昌-斗六",0,4,-4
"24860","1570力肯","110/07/06","永豐金-敦南",9,3,6
"24861","1570力肯","110/07/06","元大-和平",0,4,-4
"24862","6180橘子","110/07/06","凱基-台北",72,12,60
"24863","6180橘子","110/07/06","臺銀-金山",5,105,-100
"24864","6180橘子","110/07/06","美林",29,0,29
"24865","6180橘子","110/07/06","元大-台中",0,100,-100
"24866","6180橘子","110/07/06","合庫-自強",21,0,21
"24867","6180橘子","110/07/06","康和-台南",3,50,-47
"24868","6180橘子","110/07/06","凱基-三峽",17,0,17
"24869","6180橘子","110/07/06","元大-中和",0,35,-35
"24870","6180橘子","110/07/06","富邦-虎尾",15,1,14
"24871","6180橘子","110/07/06","中國信託-忠孝",0,16,-16
"24872","6180橘子","110/07/06","元富-潮州",13,0,13
"24873","6180橘子","110/07/06","玉山-高雄",0,12,-12
"24874","6180橘子","110/07/06","中國信託-永康",13,0,13
"24875","6180橘子","110/07/06","港商野村",0,11,-11
"24876","6180橘子","110/07/06","元大-草屯",18,5,13
"24877","6180橘子","110/07/06","群益金鼎-松山",0,11,-11
"24878","6180橘子","110/07/06","臺銀",11,0,11
"24879","6180橘子","110/07/06","永豐金-豐原",0,11,-11
"24880","6180橘子","110/07/06","新光",15,4,11
"24881","6180橘子","110/07/06","元富-嘉義",5,15,-10
"24882","6180橘子","110/07/06","元大-竹東",11,0,11
"24883","6180橘子","110/07/06","玉山-士林",0,10,-10
"24884","6180橘子","110/07/06","宏遠-台中",10,0,10
"24885","6180橘子","110/07/06","凱基-北門",0,10,-10
"24886","6180橘子","110/07/06","第一金-台南",10,0,10
"24887","6180橘子","110/07/06","第一金-忠孝",0,9,-9
"24888","6180橘子","110/07/06","國泰-敦南",10,0,10
"24889","6180橘子","110/07/06","統一-基隆",0,9,-9
"24890","6180橘子","110/07/06","富邦-嘉義",10,0,10
"24891","6180橘子","110/07/06","安泰-大發",1,10,-9
"24892","2390云辰","110/07/06","元大-天母",975,276,699
"24893","2390云辰","110/07/06","台灣摩根士丹利",3,265,-262
"24894","2390云辰","110/07/06","摩根大通",688,312,376
"24895","2390云辰","110/07/06","群益金鼎-海山",3,166,-163
"24896","2390云辰","110/07/06","國泰-忠孝",164,3,161
"24897","2390云辰","110/07/06","國泰-敦南",188,339,-151
"24898","2390云辰","110/07/06","富邦-北港",140,7,133
"24899","2390云辰","110/07/06","元大-土城學府",12,119,-107
"24900","2390云辰","110/07/06","聯邦商銀",151,22,129
"24901","2390云辰","110/07/06","永豐金-高雄",4,103,-99
"24902","2390云辰","110/07/06","中國信託-文心",143,17,126
"24903","2390云辰","110/07/06","土銀-士林",0,94,-94
"24904","2390云辰","110/07/06","永豐金-中正",133,7,126
"24905","2390云辰","110/07/06","元大-佳里",11,91,-80
"24906","2390云辰","110/07/06","群益金鼎-大興",178,76,102
"24907","2390云辰","110/07/06","玉山-台中",10,86,-76
"24908","2390云辰","110/07/06","元富-中港",103,3,100
"24909","2390云辰","110/07/06","新光",251,324,-73
"24910","2390云辰","110/07/06","統一-新台中",104,12,92
"24911","2390云辰","110/07/06","富邦-敦南",29,101,-72
"24912","2390云辰","110/07/06","新加坡商瑞銀",211,120,91
"24913","2390云辰","110/07/06","兆豐-台中",0,58,-58
"24914","2390云辰","110/07/06","兆豐-忠孝",100,11,89
"24915","2390云辰","110/07/06","日盛證券",16,73,-57
"24916","2390云辰","110/07/06","凱基-林口",87,9,78
"24917","2390云辰","110/07/06","元大-東泰",5,61,-56
"24918","2390云辰","110/07/06","元富-西松",72,4,68
"24919","2390云辰","110/07/06","台新證券",136,190,-54
"24920","2390云辰","110/07/06","台新-左楠",66,9,57
"24921","2390云辰","110/07/06","元大-六合",10,63,-53
