"","stake","date","name","buy","sell","total"
"1","2834臺企銀","110/09/07","國票-敦北法人",10123,14,10109
"2","2834臺企銀","110/09/07","凱基-台北",8942,16307,-7365
"3","2834臺企銀","110/09/07","瑞士信貸",7521,1120,6401
"4","2834臺企銀","110/09/07","台灣摩根士丹利",114,5259,-5145
"5","2834臺企銀","110/09/07","日盛-三峽",2978,40,2938
"6","2834臺企銀","110/09/07","美商高盛",265,2876,-2611
"7","2834臺企銀","110/09/07","摩根大通",2105,171,1934
"8","2834臺企銀","110/09/07","永豐金-中和",6,2006,-2000
"9","2834臺企銀","110/09/07","國票-南港",1040,0,1040
"10","2834臺企銀","110/09/07","華南永昌",74,2029,-1955
"11","2834臺企銀","110/09/07","新光",1207,187,1020
"12","2834臺企銀","110/09/07","聯邦-富強",0,1900,-1900
"13","2834臺企銀","110/09/07","美林",2413,1412,1001
"14","2834臺企銀","110/09/07","富邦-南屯",30,1322,-1292
"15","2834臺企銀","110/09/07","華南永昌-彰化",717,5,712
"16","2834臺企銀","110/09/07","凱基-基隆",14,1199,-1185
"17","2834臺企銀","110/09/07","港商法國興業",709,7,702
"18","2834臺企銀","110/09/07","統一-板橋",2,1065,-1063
"19","2834臺企銀","110/09/07","日盛-二林",645,10,635
"20","2834臺企銀","110/09/07","國票-長城",0,1000,-1000
"21","2834臺企銀","110/09/07","元大-桃園",511,11,500
"22","2834臺企銀","110/09/07","法銀巴黎",0,932,-932
"23","2834臺企銀","110/09/07","台灣企銀-太平",477,12,465
"24","2834臺企銀","110/09/07","凱基-八德",3,602,-599
"25","2834臺企銀","110/09/07","凱基-湖口",414,31,383
"26","2834臺企銀","110/09/07","永豐金-博愛",4,506,-502
"27","2834臺企銀","110/09/07","玉山-台中",389,27,362
"28","2834臺企銀","110/09/07","台新-三民",64,558,-494
"29","2834臺企銀","110/09/07","永豐金-埔里",350,30,320
"30","2834臺企銀","110/09/07","元大-彰化",1,482,-481
"31","5511德昌","110/09/07","瑞士信貸",5,0,5
"32","5511德昌","110/09/07","康和-內湖",0,4,-4
"33","5511德昌","110/09/07","國泰-高雄",2,0,2
"34","5511德昌","110/09/07","凱基-台南",0,3,-3
"35","5511德昌","110/09/07","富邦-高雄",2,0,2
"36","5511德昌","110/09/07","新光",0,2,-2
"37","5511德昌","110/09/07","臺銀-臺南",1,0,1
"38","5511德昌","110/09/07","日盛-新竹",0,1,-1
"39","5511德昌","110/09/07","元富-安南",1,0,1
"40","5511德昌","110/09/07","玉山-板橋",0,1,-1
"41","5511德昌","110/09/07","新光-高雄",1,0,1
"42","5511德昌","110/09/07","玉山-左營",0,1,-1
"43","5511德昌","110/09/07","富邦-台北",1,0,1
"44","5511德昌","110/09/07","凱基-市府",0,1,-1
"45","5511德昌","110/09/07","國票-南崁",0,0,0
"46","5511德昌","110/09/07","國票-南崁",0,0,0
"47","5511德昌","110/09/07","元大-太平",0,0,0
"48","5511德昌","110/09/07","元大-太平",0,0,0
"49","5511德昌","110/09/07","",NA,NA,NA
"50","5511德昌","110/09/07","",NA,NA,NA
"51","5511德昌","110/09/07","",NA,NA,NA
"52","5511德昌","110/09/07","",NA,NA,NA
"53","5511德昌","110/09/07","",NA,NA,NA
"54","5511德昌","110/09/07","",NA,NA,NA
"55","5511德昌","110/09/07","",NA,NA,NA
"56","5511德昌","110/09/07","",NA,NA,NA
"57","5511德昌","110/09/07","",NA,NA,NA
"58","5511德昌","110/09/07","",NA,NA,NA
"59","5511德昌","110/09/07","",NA,NA,NA
"60","5511德昌","110/09/07","",NA,NA,NA
"61","2489瑞軒","110/09/07","凱基-台北",642,132,510
"62","2489瑞軒","110/09/07","第一金-澎湖",5,330,-325
"63","2489瑞軒","110/09/07","瑞士信貸",441,5,436
"64","2489瑞軒","110/09/07","第一金-新興",0,196,-196
"65","2489瑞軒","110/09/07","港商野村",433,78,355
"66","2489瑞軒","110/09/07","凱基-竹北",1,110,-109
"67","2489瑞軒","110/09/07","美林",434,175,259
"68","2489瑞軒","110/09/07","康和-台中",5,106,-101
"69","2489瑞軒","110/09/07","美商高盛",292,84,208
"70","2489瑞軒","110/09/07","元富-文心",0,100,-100
"71","2489瑞軒","110/09/07","元大-豐原",201,0,201
"72","2489瑞軒","110/09/07","凱基-桃園",0,83,-83
"73","2489瑞軒","110/09/07","摩根大通",291,155,136
"74","2489瑞軒","110/09/07","群益金鼎-中壢",0,67,-67
"75","2489瑞軒","110/09/07","台灣摩根士丹利",127,24,103
"76","2489瑞軒","110/09/07","元大-清水",31,95,-64
"77","2489瑞軒","110/09/07","永豐金-板盛",100,0,100
"78","2489瑞軒","110/09/07","新光",10,71,-61
"79","2489瑞軒","110/09/07","元大-大同",75,13,62
"80","2489瑞軒","110/09/07","國票-台中",0,58,-58
"81","2489瑞軒","110/09/07","土銀-新竹",54,1,53
"82","2489瑞軒","110/09/07","統一-桃園",0,50,-50
"83","2489瑞軒","110/09/07","兆豐-台南",50,0,50
"84","2489瑞軒","110/09/07","合庫-桃園",4,53,-49
"85","2489瑞軒","110/09/07","新加坡商瑞銀",157,108,49
"86","2489瑞軒","110/09/07","華南永昌-虎尾",139,187,-48
"87","2489瑞軒","110/09/07","元富-台中",50,2,48
"88","2489瑞軒","110/09/07","凱基-中山",0,43,-43
"89","2489瑞軒","110/09/07","日盛-三峽",50,5,45
"90","2489瑞軒","110/09/07","合庫-台中",7,48,-41
"91","2428興勤","110/09/07","台灣摩根士丹利",12,1,11
"92","2428興勤","110/09/07","統一",0,10,-10
"93","2428興勤","110/09/07","日盛-新竹",10,0,10
"94","2428興勤","110/09/07","元富-新竹",0,10,-10
"95","2428興勤","110/09/07","美商高盛",12,2,10
"96","2428興勤","110/09/07","玉山證券",0,8,-8
"97","2428興勤","110/09/07","美林",11,4,7
"98","2428興勤","110/09/07","港商野村",0,6,-6
"99","2428興勤","110/09/07","瑞士信貸",6,0,6
"100","2428興勤","110/09/07","國票-敦北法人",1,6,-5
"101","2428興勤","110/09/07","中國信託",5,0,5
"102","2428興勤","110/09/07","新光",1,6,-5
"103","2428興勤","110/09/07","國泰-高雄",5,0,5
"104","2428興勤","110/09/07","中國信託-新竹",0,4,-4
"105","2428興勤","110/09/07","國泰-板橋",5,0,5
"106","2428興勤","110/09/07","國票",0,4,-4
"107","2428興勤","110/09/07","新加坡商瑞銀",8,4,4
"108","2428興勤","110/09/07","元大-新盛",1,5,-4
"109","2428興勤","110/09/07","康和-台中",4,0,4
"110","2428興勤","110/09/07","日盛-花蓮",0,3,-3
"111","2428興勤","110/09/07","元富-城東",3,0,3
"112","2428興勤","110/09/07","第一金-豐原",0,3,-3
"113","2428興勤","110/09/07","群益金鼎-土城",3,0,3
"114","2428興勤","110/09/07","摩根大通",30,33,-3
"115","2428興勤","110/09/07","凱基-永康",3,0,3
"116","2428興勤","110/09/07","凱基-三重",4,7,-3
"117","2428興勤","110/09/07","合庫-高雄",2,0,2
"118","2428興勤","110/09/07","凱基-高雄",0,3,-3
"119","2428興勤","110/09/07","日盛-忠孝",2,0,2
"120","2428興勤","110/09/07","凱基-松山",4,7,-3
"121","3176基亞","110/09/07","新加坡商瑞銀",44,4,40
"122","3176基亞","110/09/07","日盛-忠孝",1,24,-23
"123","3176基亞","110/09/07","日盛-板橋中山",32,0,32
"124","3176基亞","110/09/07","富邦-員林",2,14,-12
"125","3176基亞","110/09/07","美商高盛",18,2,16
"126","3176基亞","110/09/07","凱基-高美館",0,11,-11
"127","3176基亞","110/09/07","凱基-屏東",15,0,15
"128","3176基亞","110/09/07","致和證券",0,10,-10
"129","3176基亞","110/09/07","摩根大通",19,5,14
"130","3176基亞","110/09/07","國票-中正",0,10,-10
"131","3176基亞","110/09/07","富邦-新店",12,0,12
"132","3176基亞","110/09/07","國票-北投",0,9,-9
"133","3176基亞","110/09/07","凱基-東門",10,0,10
"134","3176基亞","110/09/07","新光",1,10,-9
"135","3176基亞","110/09/07","元大-大雅",10,0,10
"136","3176基亞","110/09/07","元大-中壢",0,9,-9
"137","3176基亞","110/09/07","玉山-嘉義",9,0,9
"138","3176基亞","110/09/07","富邦-高雄",0,8,-8
"139","3176基亞","110/09/07","元大-新竹經國",9,0,9
"140","3176基亞","110/09/07","合庫-基隆",0,7,-7
"141","3176基亞","110/09/07","元大-和平",10,1,9
"142","3176基亞","110/09/07","國泰-板橋",1,8,-7
"143","3176基亞","110/09/07","國泰-敦南",8,1,7
"144","3176基亞","110/09/07","凱基-站前",0,7,-7
"145","3176基亞","110/09/07","華南永昌-嘉義",6,0,6
"146","3176基亞","110/09/07","日盛-和美",2,8,-6
"147","3176基亞","110/09/07","富邦-新竹",6,0,6
"148","3176基亞","110/09/07","國泰-台中",0,6,-6
"149","3176基亞","110/09/07","元大-草屯",6,0,6
"150","3176基亞","110/09/07","合庫-鳳山",0,5,-5
"151","2409友達","110/09/07","台灣摩根士丹利",31020,10876,20144
"152","2409友達","110/09/07","瑞士信貸",3123,26453,-23330
"153","2409友達","110/09/07","永豐金證券",11577,62,11515
"154","2409友達","110/09/07","華南永昌-南京",72,8467,-8395
"155","2409友達","110/09/07","元大證券",9263,2104,7159
"156","2409友達","110/09/07","美商高盛",586,4838,-4252
"157","2409友達","110/09/07","大昌-桃園",4059,47,4012
"158","2409友達","110/09/07","美林",6133,8509,-2376
"159","2409友達","110/09/07","花旗環球",2996,56,2940
"160","2409友達","110/09/07","港商野村",3918,6196,-2278
"161","2409友達","110/09/07","國泰證券",2706,449,2257
"162","2409友達","110/09/07","玉山-高雄",118,1047,-929
"163","2409友達","110/09/07","摩根大通",5858,4102,1756
"164","2409友達","110/09/07","元大-館前",53,862,-809
"165","2409友達","110/09/07","富邦證券",1311,47,1264
"166","2409友達","110/09/07","港商法國興業",115,765,-650
"167","2409友達","110/09/07","新加坡商瑞銀",6869,6047,822
"168","2409友達","110/09/07","玉山證券",198,806,-608
"169","2409友達","110/09/07","永豐金-台南",849,160,689
"170","2409友達","110/09/07","元富",2,526,-524
"171","2409友達","110/09/07","元富-安南",686,102,584
"172","2409友達","110/09/07","(牛牛牛)亞-鑫豐",170,690,-520
"173","2409友達","110/09/07","永豐金-中壢",637,53,584
"174","2409友達","110/09/07","日盛證券",225,683,-458
"175","2409友達","110/09/07","元大-南屯",725,154,571
"176","2409友達","110/09/07","元富-城東",51,468,-417
"177","2409友達","110/09/07","富邦-南屯",570,90,480
"178","2409友達","110/09/07","台新證券",969,1353,-384
"179","2409友達","110/09/07","台新-台南",661,200,461
"180","2409友達","110/09/07","兆豐-忠孝",46,424,-378
"181","1315達新","110/09/07","日盛-大墩",2,0,2
"182","1315達新","110/09/07","港商法國興業",0,4,-4
"183","1315達新","110/09/07","台灣摩根士丹利",3,1,2
"184","1315達新","110/09/07","元大-文心興安",1,3,-2
"185","1315達新","110/09/07","元大-花蓮",2,0,2
"186","1315達新","110/09/07","群益金鼎-古亭",0,2,-2
"187","1315達新","110/09/07","玉山-新莊",2,0,2
"188","1315達新","110/09/07","永豐金-台南",0,1,-1
"189","1315達新","110/09/07","永豐金-南投",1,0,1
"190","1315達新","110/09/07","元大-新竹經國",0,1,-1
"191","1315達新","110/09/07","臺銀",1,0,1
"192","1315達新","110/09/07","元大-景美",0,1,-1
"193","1315達新","110/09/07","元大-福營",1,0,1
"194","1315達新","110/09/07","富邦-左營",0,1,-1
"195","1315達新","110/09/07","富邦-台中",1,0,1
"196","1315達新","110/09/07","華南永昌",0,1,-1
"197","1315達新","110/09/07","聯邦-富強",1,0,1
"198","1315達新","110/09/07","凱基-台北",0,1,-1
"199","1315達新","110/09/07","新光",1,0,1
"200","1315達新","110/09/07","元富-世貿",0,1,-1
"201","1315達新","110/09/07","台新-台中",1,0,1
"202","1315達新","110/09/07","美林",0,1,-1
"203","1315達新","110/09/07","新加坡商瑞銀",1,0,1
"204","1315達新","110/09/07","群益金鼎-台南",0,0,0
"205","1315達新","110/09/07","國泰-敦南",0,0,0
"206","1315達新","110/09/07","群益金鼎-士林",0,0,0
"207","1315達新","110/09/07","群益金鼎-士林",0,0,0
"208","1315達新","110/09/07","國泰-敦南",0,0,0
"209","1315達新","110/09/07","群益金鼎-台南",0,0,0
"210","1315達新","110/09/07","元富-城中",0,0,0
"211","2609陽明","110/09/07","康和",7261,45,7216
"212","2609陽明","110/09/07","瑞士信貸",2100,5289,-3189
"213","2609陽明","110/09/07","凱基-台北",6900,1220,5680
"214","2609陽明","110/09/07","富邦證券",4313,6250,-1937
"215","2609陽明","110/09/07","新加坡商瑞銀",3022,307,2715
"216","2609陽明","110/09/07","華南永昌-竹北",34,688,-654
"217","2609陽明","110/09/07","永豐金-信義",2164,37,2127
"218","2609陽明","110/09/07","元大-士林",5347,5967,-620
"219","2609陽明","110/09/07","福邦-新竹",828,9,819
"220","2609陽明","110/09/07","玉山證券",636,1209,-573
"221","2609陽明","110/09/07","元大證券",2539,1912,627
"222","2609陽明","110/09/07","元大-土城永寧",152,677,-525
"223","2609陽明","110/09/07","統一-仁愛",1929,1334,595
"224","2609陽明","110/09/07","兆豐-板橋",446,910,-464
"225","2609陽明","110/09/07","凱基-竹北",757,192,565
"226","2609陽明","110/09/07","富邦-仁愛",471,922,-451
"227","2609陽明","110/09/07","日盛-文化",578,139,439
"228","2609陽明","110/09/07","台新證券",1959,2389,-430
"229","2609陽明","110/09/07","凱基-復興",677,255,422
"230","2609陽明","110/09/07","統一-彰化",119,522,-403
"231","2609陽明","110/09/07","國票-安和",913,503,410
"232","2609陽明","110/09/07","元大-北屯",432,833,-401
"233","2609陽明","110/09/07","永豐金-市政",536,129,407
"234","2609陽明","110/09/07","永豐金證券",69,449,-380
"235","2609陽明","110/09/07","兆豐-虎尾",9131,8725,406
"236","2609陽明","110/09/07","國泰-館前",600,940,-340
"237","2609陽明","110/09/07","凱基-板橋",431,107,324
"238","2609陽明","110/09/07","宏遠-高雄",210,526,-316
"239","2609陽明","110/09/07","摩根大通",6328,6053,275
"240","2609陽明","110/09/07","新光",2364,2650,-286
"241","2636台驊投控","110/09/07","統一",532,304,228
"242","2636台驊投控","110/09/07","瑞士信貸",100,599,-499
"243","2636台驊投控","110/09/07","凱基-信義",176,4,172
"244","2636台驊投控","110/09/07","日盛-台中",160,410,-250
"245","2636台驊投控","110/09/07","元富-嘉義",114,12,102
"246","2636台驊投控","110/09/07","美林",438,672,-234
"247","2636台驊投控","110/09/07","兆豐證券",100,0,100
"248","2636台驊投控","110/09/07","華南永昌-竹北",54,274,-220
"249","2636台驊投控","110/09/07","兆豐-中壢",98,14,84
"250","2636台驊投控","110/09/07","摩根大通",875,1090,-215
"251","2636台驊投控","110/09/07","統一-基隆",147,68,79
"252","2636台驊投控","110/09/07","台灣摩根士丹利",182,360,-178
"253","2636台驊投控","110/09/07","日盛-景美",122,60,62
"254","2636台驊投控","110/09/07","玉山證券",62,190,-128
"255","2636台驊投控","110/09/07","群益金鼎-竹南",65,4,61
"256","2636台驊投控","110/09/07","新加坡商瑞銀",78,180,-102
"257","2636台驊投控","110/09/07","富邦-仁愛",175,122,53
"258","2636台驊投控","110/09/07","新光",382,451,-69
"259","2636台驊投控","110/09/07","統一-南京",125,76,49
"260","2636台驊投控","110/09/07","華南永昌-潮州",1,62,-61
"261","2636台驊投控","110/09/07","兆豐-南京",61,19,42
"262","2636台驊投控","110/09/07","日盛證券",96,153,-57
"263","2636台驊投控","110/09/07","兆豐-三民",61,20,41
"264","2636台驊投控","110/09/07","凱基-台北",900,956,-56
"265","2636台驊投控","110/09/07","富邦-虎尾",45,4,41
"266","2636台驊投控","110/09/07","兆豐-新莊",39,84,-45
"267","2636台驊投控","110/09/07","元大-南屯",68,27,41
"268","2636台驊投控","110/09/07","美商高盛",184,228,-44
"269","2636台驊投控","110/09/07","富邦-台北",90,50,40
"270","2636台驊投控","110/09/07","統一-新台中",3,38,-35
"271","2867三商壽","110/09/07","瑞士信貸",329,0,329
"272","2867三商壽","110/09/07","國泰-台中",5,177,-172
"273","2867三商壽","110/09/07","美林",187,10,177
"274","2867三商壽","110/09/07","凱基-中壢",0,140,-140
"275","2867三商壽","110/09/07","玉山-城中",100,0,100
"276","2867三商壽","110/09/07","凱基-市府",0,100,-100
"277","2867三商壽","110/09/07","凱基-台北",70,18,52
"278","2867三商壽","110/09/07","亞東",0,63,-63
"279","2867三商壽","110/09/07","聯邦-嘉義",50,0,50
"280","2867三商壽","110/09/07","摩根大通",17,77,-60
"281","2867三商壽","110/09/07","華南永昌-台南",50,0,50
"282","2867三商壽","110/09/07","宏遠-台中",0,55,-55
"283","2867三商壽","110/09/07","華南永昌-淡水",50,0,50
"284","2867三商壽","110/09/07","元大-崇德",0,53,-53
"285","2867三商壽","110/09/07","台灣摩根士丹利",46,7,39
"286","2867三商壽","110/09/07","統一-台南",0,50,-50
"287","2867三商壽","110/09/07","臺銀-高雄",31,0,31
"288","2867三商壽","110/09/07","統一-新竹",0,40,-40
"289","2867三商壽","110/09/07","日盛-嘉義",30,0,30
"290","2867三商壽","110/09/07","元富-基隆",0,40,-40
"291","2867三商壽","110/09/07","富邦-新營",30,0,30
"292","2867三商壽","110/09/07","統一-屏東",0,30,-30
"293","2867三商壽","110/09/07","永豐金-北高雄",30,0,30
"294","2867三商壽","110/09/07","宏遠-中和",0,28,-28
"295","2867三商壽","110/09/07","國票-九鼎",35,6,29
"296","2867三商壽","110/09/07","兆豐-桃園",0,26,-26
"297","2867三商壽","110/09/07","新加坡商瑞銀",26,0,26
"298","2867三商壽","110/09/07","元大-永春",0,25,-25
"299","2867三商壽","110/09/07","凱基-興隆",25,0,25
"300","2867三商壽","110/09/07","元富-古亭",0,22,-22
"301","5521工信","110/09/07","凱基-台北",1776,1363,413
"302","5521工信","110/09/07","富邦-台北",3,1100,-1097
"303","5521工信","110/09/07","台新證券",251,4,247
"304","5521工信","110/09/07","元富",5,887,-882
"305","5521工信","110/09/07","國泰-敦南",202,7,195
"306","5521工信","110/09/07","國票-敦北法人",4,818,-814
"307","5521工信","110/09/07","玉山-左營",114,0,114
"308","5521工信","110/09/07","摩根大通",67,535,-468
"309","5521工信","110/09/07","富邦-敦南",82,0,82
"310","5521工信","110/09/07","台灣摩根士丹利",5,141,-136
"311","5521工信","110/09/07","元大-南屯",63,0,63
"312","5521工信","110/09/07","美商高盛",0,92,-92
"313","5521工信","110/09/07","元大-淡水",60,8,52
"314","5521工信","110/09/07","兆豐-北高雄",14,102,-88
"315","5521工信","110/09/07","台新-新莊",51,0,51
"316","5521工信","110/09/07","元大-中壢",5,90,-85
"317","5521工信","110/09/07","合庫-基隆",50,0,50
"318","5521工信","110/09/07","港商野村",0,72,-72
"319","5521工信","110/09/07","元富-花蓮",50,0,50
"320","5521工信","110/09/07","(牛牛牛)亞-鑫豐",24,83,-59
"321","5521工信","110/09/07","國票-安和",50,0,50
"322","5521工信","110/09/07","元大-西門",3,62,-59
"323","5521工信","110/09/07","福勝",49,0,49
"324","5521工信","110/09/07","國票-中港",0,50,-50
"325","5521工信","110/09/07","中國信託-三重",48,0,48
"326","5521工信","110/09/07","元大-崇德",0,44,-44
"327","5521工信","110/09/07","永豐金-松山",51,3,48
"328","5521工信","110/09/07","台新-新營",0,30,-30
"329","5521工信","110/09/07","國泰-台中",55,8,47
"330","5521工信","110/09/07","凱基-大里",1,31,-30
"331","1471首利","110/09/07","兆豐-桃園",30,0,30
"332","1471首利","110/09/07","元大-民雄",0,50,-50
"333","1471首利","110/09/07","光和-溪湖",21,0,21
"334","1471首利","110/09/07","凱基-台北",0,30,-30
"335","1471首利","110/09/07","群益金鼎-海山",29,8,21
"336","1471首利","110/09/07","永豐金證券",0,30,-30
"337","1471首利","110/09/07","群益金鼎-土城",20,0,20
"338","1471首利","110/09/07","元大-西門",0,18,-18
"339","1471首利","110/09/07","群益金鼎-東門",20,0,20
"340","1471首利","110/09/07","凱基-科園",0,13,-13
"341","1471首利","110/09/07","日盛-高雄",18,0,18
"342","1471首利","110/09/07","元大-台南",0,13,-13
"343","1471首利","110/09/07","瑞士信貸",18,2,16
"344","1471首利","110/09/07","元大-基隆孝二",0,11,-11
"345","1471首利","110/09/07","元大-福營",12,0,12
"346","1471首利","110/09/07","永豐金-竹科",0,11,-11
"347","1471首利","110/09/07","元大-竹山",12,0,12
"348","1471首利","110/09/07","宏遠-館前",0,10,-10
"349","1471首利","110/09/07","光和",11,0,11
"350","1471首利","110/09/07","兆豐-西螺",0,10,-10
"351","1471首利","110/09/07","玉山-左營",11,0,11
"352","1471首利","110/09/07","富邦-彰化",0,10,-10
"353","1471首利","110/09/07","摩根大通",40,30,10
"354","1471首利","110/09/07","元富-同大",2,10,-8
"355","1471首利","110/09/07","華南永昌-台南",10,0,10
"356","1471首利","110/09/07","台新-新莊",0,8,-8
"357","1471首利","110/09/07","富邦-桃園",10,0,10
"358","1471首利","110/09/07","新光",1,9,-8
"359","1471首利","110/09/07","元大-文心興安",7,0,7
"360","1471首利","110/09/07","永豐金-天母",0,8,-8
"361","2883開發金","110/09/07","瑞士信貸",4415,0,4415
"362","2883開發金","110/09/07","花旗環球",0,10298,-10298
"363","2883開發金","110/09/07","新加坡商瑞銀",3882,173,3709
"364","2883開發金","110/09/07","亞東-新竹",125,1505,-1380
"365","2883開發金","110/09/07","凱基-台北",2794,633,2161
"366","2883開發金","110/09/07","國泰證券",2,1001,-999
"367","2883開發金","110/09/07","台新證券",1137,95,1042
"368","2883開發金","110/09/07","中國信託-文心",33,444,-411
"369","2883開發金","110/09/07","國票-長城",1000,0,1000
"370","2883開發金","110/09/07","新光-桃園",27,426,-399
"371","2883開發金","110/09/07","臺銀-鳳山",724,106,618
"372","2883開發金","110/09/07","元富-同大",15,364,-349
"373","2883開發金","110/09/07","美林",1016,437,579
"374","2883開發金","110/09/07","華南永昌-林口",20,300,-280
"375","2883開發金","110/09/07","港商野村",1836,1354,482
"376","2883開發金","110/09/07","國泰-板橋",144,419,-275
"377","2883開發金","110/09/07","元大-竹北",323,11,312
"378","2883開發金","110/09/07","富邦-嘉義",19,275,-256
"379","2883開發金","110/09/07","群益金鼎-桃園",308,20,288
"380","2883開發金","110/09/07","永豐金-三重",23,260,-237
"381","2883開發金","110/09/07","元大-蘆洲",307,23,284
"382","2883開發金","110/09/07","台灣摩根士丹利",257,476,-219
"383","2883開發金","110/09/07","統一-彰化",274,20,254
"384","2883開發金","110/09/07","國票",7,216,-209
"385","2883開發金","110/09/07","元大-花蓮",278,33,245
"386","2883開發金","110/09/07","光和",4,212,-208
"387","2883開發金","110/09/07","富邦-中壢",269,26,243
"388","2883開發金","110/09/07","(牛牛牛)亞-鑫豐",27,218,-191
"389","2883開發金","110/09/07","永豐金-苓雅",242,28,214
"390","2883開發金","110/09/07","元大-民生",5,195,-190
"391","6205詮欣","110/09/07","玉山-城中",7,0,7
"392","6205詮欣","110/09/07","德信-新營",0,10,-10
"393","6205詮欣","110/09/07","臺銀",5,0,5
"394","6205詮欣","110/09/07","瑞士信貸",0,4,-4
"395","6205詮欣","110/09/07","臺銀-民權",5,0,5
"396","6205詮欣","110/09/07","日盛-新莊",0,2,-2
"397","6205詮欣","110/09/07","日盛-三重",3,0,3
"398","6205詮欣","110/09/07","富邦-永和",0,2,-2
"399","6205詮欣","110/09/07","元大-汐止",3,0,3
"400","6205詮欣","110/09/07","元大-竹北",0,2,-2
"401","6205詮欣","110/09/07","新加坡商瑞銀",2,0,2
"402","6205詮欣","110/09/07","元大-忠孝",0,2,-2
"403","6205詮欣","110/09/07","玉山-新莊",2,0,2
"404","6205詮欣","110/09/07","日盛-中壢",0,1,-1
"405","6205詮欣","110/09/07","元富-基隆",1,0,1
"406","6205詮欣","110/09/07","美林",1,2,-1
"407","6205詮欣","110/09/07","群益金鼎-士林",1,0,1
"408","6205詮欣","110/09/07","大慶-蘆洲",0,1,-1
"409","6205詮欣","110/09/07","凱基-東門",1,0,1
"410","6205詮欣","110/09/07","元富-潮州",0,1,-1
"411","6205詮欣","110/09/07","華南永昌-古亭",1,0,1
"412","6205詮欣","110/09/07","大昌-樹林",0,1,-1
"413","6205詮欣","110/09/07","元大-南崁",1,0,1
"414","6205詮欣","110/09/07","致和-崇德",0,1,-1
"415","6205詮欣","110/09/07","兆豐-景美",1,1,0
"416","6205詮欣","110/09/07","群益金鼎-館前",0,1,-1
"417","6205詮欣","110/09/07","",NA,NA,NA
"418","6205詮欣","110/09/07","凱基-台北",0,1,-1
"419","6205詮欣","110/09/07","",NA,NA,NA
"420","6205詮欣","110/09/07","華南永昌-苑裡",0,1,-1
"421","1540喬福","110/09/07","元富-佳里",9,0,9
"422","1540喬福","110/09/07","日盛-文化",0,32,-32
"423","1540喬福","110/09/07","元富-板橋",7,0,7
"424","1540喬福","110/09/07","日盛-台南",0,7,-7
"425","1540喬福","110/09/07","日盛-鳳山",6,0,6
"426","1540喬福","110/09/07","日盛-花蓮",0,3,-3
"427","1540喬福","110/09/07","日盛-士林",3,0,3
"428","1540喬福","110/09/07","凱基-台北",0,3,-3
"429","1540喬福","110/09/07","元大-清水",2,0,2
"430","1540喬福","110/09/07","日盛-中壢",0,1,-1
"431","1540喬福","110/09/07","台灣企銀-嘉義",2,0,2
"432","1540喬福","110/09/07","台新-台中",0,1,-1
"433","1540喬福","110/09/07","群益金鼎-三民",2,0,2
"434","1540喬福","110/09/07","富邦-左營",0,1,-1
"435","1540喬福","110/09/07","台中銀-豐原",2,0,2
"436","1540喬福","110/09/07","元富",1,1,0
"437","1540喬福","110/09/07","元富-緯城",2,0,2
"438","1540喬福","110/09/07","玉山-嘉義",0,0,0
"439","1540喬福","110/09/07","統一-土城",2,0,2
"440","1540喬福","110/09/07","群益金鼎-古亭",0,0,0
"441","1540喬福","110/09/07","兆豐-北高雄",1,0,1
"442","1540喬福","110/09/07","凱基-竹北",0,0,0
"443","1540喬福","110/09/07","兆豐-高雄",1,0,1
"444","1540喬福","110/09/07","凱基-興隆",0,0,0
"445","1540喬福","110/09/07","台新證券",1,0,1
"446","1540喬福","110/09/07","華南永昌-高雄",0,0,0
"447","1540喬福","110/09/07","新光",1,0,1
"448","1540喬福","110/09/07","",NA,NA,NA
"449","1540喬福","110/09/07","群益金鼎-館前",1,0,1
"450","1540喬福","110/09/07","",NA,NA,NA
"451","2888新光金","110/09/07","瑞士信貸",3114,598,2516
"452","2888新光金","110/09/07","永豐金證券",27,1084,-1057
"453","2888新光金","110/09/07","新加坡商瑞銀",850,2,848
"454","2888新光金","110/09/07","群益金鼎-嘉義",20,897,-877
"455","2888新光金","110/09/07","日盛-樹林",703,0,703
"456","2888新光金","110/09/07","永豐金-松山",0,838,-838
"457","2888新光金","110/09/07","國票-長城",1500,800,700
"458","2888新光金","110/09/07","永豐金-羅東",0,650,-650
"459","2888新光金","110/09/07","統一-板橋",866,303,563
"460","2888新光金","110/09/07","台灣摩根士丹利",194,694,-500
"461","2888新光金","110/09/07","摩根大通",1147,744,403
"462","2888新光金","110/09/07","群益金鼎-館前",18,500,-482
"463","2888新光金","110/09/07","富邦-陽明",475,138,337
"464","2888新光金","110/09/07","國泰-忠孝",7,486,-479
"465","2888新光金","110/09/07","美林",515,234,281
"466","2888新光金","110/09/07","群益金鼎-彰化",50,440,-390
"467","2888新光金","110/09/07","元大-大雅",275,3,272
"468","2888新光金","110/09/07","凱基-湖口",0,285,-285
"469","2888新光金","110/09/07","元大-發財",257,0,257
"470","2888新光金","110/09/07","日盛-雙和",6,262,-256
"471","2888新光金","110/09/07","元大-新竹經國",256,2,254
"472","2888新光金","110/09/07","元富-台中",3,255,-252
"473","2888新光金","110/09/07","台新-台南",213,1,212
"474","2888新光金","110/09/07","華南永昌-台中",3,223,-220
"475","2888新光金","110/09/07","康和-台中",200,0,200
"476","2888新光金","110/09/07","元富-城東",22,221,-199
"477","2888新光金","110/09/07","永豐金-彰化",205,10,195
"478","2888新光金","110/09/07","凱基-高雄",46,244,-198
"479","2888新光金","110/09/07","凱基-基隆",205,11,194
"480","2888新光金","110/09/07","凱基-幸福",4,202,-198
"481","1340勝悅","110/09/07","元大-前金",24,0,24
"482","1340勝悅","110/09/07","群益金鼎-三重",0,15,-15
"483","1340勝悅","110/09/07","元富-彰化",6,0,6
"484","1340勝悅","110/09/07","摩根大通",0,14,-14
"485","1340勝悅","110/09/07","凱基-台中",6,0,6
"486","1340勝悅","110/09/07","凱基-台北",0,12,-12
"487","1340勝悅","110/09/07","美商高盛",3,0,3
"488","1340勝悅","110/09/07","新光-台中",0,7,-7
"489","1340勝悅","110/09/07","華南永昌-忠孝",3,0,3
"490","1340勝悅","110/09/07","日盛-員林",0,5,-5
"491","1340勝悅","110/09/07","元大-屏南",3,0,3
"492","1340勝悅","110/09/07","永豐金-苓雅",0,5,-5
"493","1340勝悅","110/09/07","統一-城中",2,0,2
"494","1340勝悅","110/09/07","美林",0,3,-3
"495","1340勝悅","110/09/07","兆豐-新竹",2,0,2
"496","1340勝悅","110/09/07","群益金鼎-館前",0,3,-3
"497","1340勝悅","110/09/07","國泰-桃園",2,0,2
"498","1340勝悅","110/09/07","臺銀-鳳山",0,2,-2
"499","1340勝悅","110/09/07","富邦-北港",2,0,2
"500","1340勝悅","110/09/07","富邦-羅東",0,2,-2
"501","1340勝悅","110/09/07","元大-天母",2,0,2
"502","1340勝悅","110/09/07","富邦-嘉義",0,2,-2
"503","1340勝悅","110/09/07","元大-基隆孝二",2,0,2
"504","1340勝悅","110/09/07","元大-土城永寧",0,2,-2
"505","1340勝悅","110/09/07","元大-小港",2,0,2
"506","1340勝悅","110/09/07","元大-豐原站前",0,2,-2
"507","1340勝悅","110/09/07","永豐金-天母",2,0,2
"508","1340勝悅","110/09/07","日盛-斗六",0,1,-1
"509","1340勝悅","110/09/07","國泰-台中",1,0,1
"510","1340勝悅","110/09/07","元大-金門",0,1,-1
"511","6246臺龍","110/09/07","台新證券",10,0,10
"512","6246臺龍","110/09/07","統一-台南",2,18,-16
"513","6246臺龍","110/09/07","宏遠-館前",8,0,8
"514","6246臺龍","110/09/07","日盛-木柵",0,10,-10
"515","6246臺龍","110/09/07","元富-屏東",8,0,8
"516","6246臺龍","110/09/07","港商野村",0,9,-9
"517","6246臺龍","110/09/07","日盛-大墩",5,0,5
"518","6246臺龍","110/09/07","凱基-永和",0,5,-5
"519","6246臺龍","110/09/07","元富-中港",5,0,5
"520","6246臺龍","110/09/07","群益金鼎-古亭",0,4,-4
"521","6246臺龍","110/09/07","凱基-內湖",4,0,4
"522","6246臺龍","110/09/07","元大-內湖",0,4,-4
"523","6246臺龍","110/09/07","日盛-八德",3,0,3
"524","6246臺龍","110/09/07","台新-台南",0,3,-3
"525","6246臺龍","110/09/07","富邦-新竹",3,0,3
"526","6246臺龍","110/09/07","日盛-台中",0,2,-2
"527","6246臺龍","110/09/07","元富-吉利",2,0,2
"528","6246臺龍","110/09/07","兆豐-桃園",0,2,-2
"529","6246臺龍","110/09/07","國票-內壢",2,0,2
"530","6246臺龍","110/09/07","臺銀",0,1,-1
"531","6246臺龍","110/09/07","國泰-敦南",3,1,2
"532","6246臺龍","110/09/07","日盛-宜蘭",0,1,-1
"533","6246臺龍","110/09/07","凱基-高美館",2,0,2
"534","6246臺龍","110/09/07","元富-新店",0,1,-1
"535","6246臺龍","110/09/07","元大-發財",2,0,2
"536","6246臺龍","110/09/07","兆豐-岡山",0,1,-1
"537","6246臺龍","110/09/07","台中銀-員林",1,0,1
"538","6246臺龍","110/09/07","新光-高雄",0,1,-1
"539","6246臺龍","110/09/07","玉山-嘉義",1,0,1
"540","6246臺龍","110/09/07","玉山-桃園",0,1,-1
"541","00715L期街口布蘭特正2","110/09/07","永豐金證券",2384,0,2384
"542","00715L期街口布蘭特正2","110/09/07","新光",0,709,-709
"543","00715L期街口布蘭特正2","110/09/07","元大證券",2302,0,2302
"544","00715L期街口布蘭特正2","110/09/07","元大-花蓮",0,601,-601
"545","00715L期街口布蘭特正2","110/09/07","台新證券",1146,63,1083
"546","00715L期街口布蘭特正2","110/09/07","永豐金-北高雄",0,550,-550
"547","00715L期街口布蘭特正2","110/09/07","富邦證券",1095,142,953
"548","00715L期街口布蘭特正2","110/09/07","元大-萬華",0,360,-360
"549","00715L期街口布蘭特正2","110/09/07","康和",821,10,811
"550","00715L期街口布蘭特正2","110/09/07","大昌-樹林",0,345,-345
"551","00715L期街口布蘭特正2","110/09/07","港商野村",1183,373,810
"552","00715L期街口布蘭特正2","110/09/07","日盛-和美",0,300,-300
"553","00715L期街口布蘭特正2","110/09/07","合庫證券",838,118,720
"554","00715L期街口布蘭特正2","110/09/07","新光-台南",0,238,-238
"555","00715L期街口布蘭特正2","110/09/07","兆豐-台中",500,0,500
"556","00715L期街口布蘭特正2","110/09/07","元大-台南",1,218,-217
"557","00715L期街口布蘭特正2","110/09/07","永豐金-內湖",500,0,500
"558","00715L期街口布蘭特正2","110/09/07","國泰-敦南",8,223,-215
"559","00715L期街口布蘭特正2","110/09/07","元大-前金",580,106,474
"560","00715L期街口布蘭特正2","110/09/07","台新-高雄",34,247,-213
"561","00715L期街口布蘭特正2","110/09/07","群益金鼎",377,2,375
"562","00715L期街口布蘭特正2","110/09/07","凱基-桃園",5,206,-201
"563","00715L期街口布蘭特正2","110/09/07","台新-台中",502,235,267
"564","00715L期街口布蘭特正2","110/09/07","群益金鼎-土城",0,200,-200
"565","00715L期街口布蘭特正2","110/09/07","凱基-台北",341,97,244
"566","00715L期街口布蘭特正2","110/09/07","第一金-台南",0,155,-155
"567","00715L期街口布蘭特正2","110/09/07","統一",229,0,229
"568","00715L期街口布蘭特正2","110/09/07","富邦-羅東",1,150,-149
"569","00715L期街口布蘭特正2","110/09/07","日盛-永康",330,102,228
"570","00715L期街口布蘭特正2","110/09/07","永豐金-台中",0,140,-140
"571","8941關中","110/09/07","凱基-市府",2,0,2
"572","8941關中","110/09/07","彰銀-台中",0,1,-1
"573","8941關中","110/09/07","臺銀-臺中",1,0,1
"574","8941關中","110/09/07","統一-台中",0,1,-1
"575","8941關中","110/09/07","元大-華山",1,0,1
"576","8941關中","110/09/07","德信-中正",0,1,-1
"577","8941關中","110/09/07","元大-金華",1,0,1
"578","8941關中","110/09/07","富邦-仁愛",0,1,-1
"579","8941關中","110/09/07","",NA,NA,NA
"580","8941關中","110/09/07","永豐金-中盛",0,1,-1
"581","8941關中","110/09/07","",NA,NA,NA
"582","8941關中","110/09/07","",NA,NA,NA
"583","8941關中","110/09/07","",NA,NA,NA
"584","8941關中","110/09/07","",NA,NA,NA
"585","8941關中","110/09/07","",NA,NA,NA
"586","8941關中","110/09/07","",NA,NA,NA
"587","8941關中","110/09/07","",NA,NA,NA
"588","8941關中","110/09/07","",NA,NA,NA
"589","8941關中","110/09/07","",NA,NA,NA
"590","8941關中","110/09/07","",NA,NA,NA
"591","8941關中","110/09/07","",NA,NA,NA
"592","8941關中","110/09/07","",NA,NA,NA
"593","8941關中","110/09/07","",NA,NA,NA
"594","8941關中","110/09/07","",NA,NA,NA
"595","8941關中","110/09/07","",NA,NA,NA
"596","8941關中","110/09/07","",NA,NA,NA
"597","8941關中","110/09/07","",NA,NA,NA
"598","8941關中","110/09/07","",NA,NA,NA
"599","8941關中","110/09/07","",NA,NA,NA
"600","8941關中","110/09/07","",NA,NA,NA
"601","8936國統","110/09/07","永豐金-忠孝",40,0,40
"602","8936國統","110/09/07","永豐金-高雄",0,100,-100
"603","8936國統","110/09/07","富邦-岡山",38,0,38
"604","8936國統","110/09/07","元富-林園",5,63,-58
"605","8936國統","110/09/07","凱基-台北",91,55,36
"606","8936國統","110/09/07","新加坡商瑞銀",3,48,-45
"607","8936國統","110/09/07","中國信託-高雄",43,14,29
"608","8936國統","110/09/07","華南永昌-高雄",48,90,-42
"609","8936國統","110/09/07","日盛-三重",16,0,16
"610","8936國統","110/09/07","瑞士信貸",0,41,-41
"611","8936國統","110/09/07","元大-敦南",16,0,16
"612","8936國統","110/09/07","台灣摩根士丹利",0,36,-36
"613","8936國統","110/09/07","元大-員林",14,0,14
"614","8936國統","110/09/07","美商高盛",3,33,-30
"615","8936國統","110/09/07","富邦-台北",16,3,13
"616","8936國統","110/09/07","玉山-桃園",0,30,-30
"617","8936國統","110/09/07","永豐金-彰化",13,0,13
"618","8936國統","110/09/07","摩根大通",43,72,-29
"619","8936國統","110/09/07","日盛-和美",21,9,12
"620","8936國統","110/09/07","港商野村",3,31,-28
"621","8936國統","110/09/07","新光-台中",23,11,12
"622","8936國統","110/09/07","元富-三重",0,28,-28
"623","8936國統","110/09/07","第一金-安和",11,1,10
"624","8936國統","110/09/07","統一",0,20,-20
"625","8936國統","110/09/07","元富-敦南",10,0,10
"626","8936國統","110/09/07","元富-中原",0,20,-20
"627","8936國統","110/09/07","台新證券",12,2,10
"628","8936國統","110/09/07","兆豐-新竹",0,20,-20
"629","8936國統","110/09/07","元大-土城學府",10,0,10
"630","8936國統","110/09/07","永豐金-竹科",0,20,-20
"631","6226光鼎","110/09/07","美商高盛",463,26,437
"632","6226光鼎","110/09/07","(牛牛牛)亞-鑫豐",4,109,-105
"633","6226光鼎","110/09/07","瑞士信貸",252,0,252
"634","6226光鼎","110/09/07","玉山-桃園",6,99,-93
"635","6226光鼎","110/09/07","美林",376,166,210
"636","6226光鼎","110/09/07","新光",16,77,-61
"637","6226光鼎","110/09/07","凱基-台北",232,77,155
"638","6226光鼎","110/09/07","臺銀-臺南",1,61,-60
"639","6226光鼎","110/09/07","摩根大通",146,69,77
"640","6226光鼎","110/09/07","元富-城中",1,60,-59
"641","6226光鼎","110/09/07","群益金鼎-開元",51,1,50
"642","6226光鼎","110/09/07","合庫-鳳山",1,57,-56
"643","6226光鼎","110/09/07","新加坡商瑞銀",77,31,46
"644","6226光鼎","110/09/07","凱基-內湖",1,56,-55
"645","6226光鼎","110/09/07","元大-小港",48,3,45
"646","6226光鼎","110/09/07","元大-新營",9,63,-54
"647","6226光鼎","110/09/07","港商野村",215,179,36
"648","6226光鼎","110/09/07","永豐金-苓雅",14,65,-51
"649","6226光鼎","110/09/07","華南永昌-小港",33,0,33
"650","6226光鼎","110/09/07","元大-松山",0,50,-50
"651","6226光鼎","110/09/07","群益金鼎-竹南",41,9,32
"652","6226光鼎","110/09/07","凱基-站前",0,47,-47
"653","6226光鼎","110/09/07","華南永昌-大安",50,20,30
"654","6226光鼎","110/09/07","中國信託-永康",1,45,-44
"655","6226光鼎","110/09/07","永豐金-大園",40,11,29
"656","6226光鼎","110/09/07","華南永昌-台中",5,48,-43
"657","6226光鼎","110/09/07","國票-台南",27,0,27
"658","6226光鼎","110/09/07","台灣企銀",0,40,-40
"659","6226光鼎","110/09/07","富邦-桃園",25,0,25
"660","6226光鼎","110/09/07","玉山-大里",1,41,-40
"661","2363矽統","110/09/07","第一金-桃園",822,65,757
"662","2363矽統","110/09/07","美林",1897,4225,-2328
"663","2363矽統","110/09/07","統一-敦南",581,41,540
"664","2363矽統","110/09/07","凱基-台北",2281,3707,-1426
"665","2363矽統","110/09/07","新光",1339,821,518
"666","2363矽統","110/09/07","美商高盛",576,1921,-1345
"667","2363矽統","110/09/07","國泰-敦南",1624,1311,313
"668","2363矽統","110/09/07","新加坡商瑞銀",512,1442,-930
"669","2363矽統","110/09/07","富邦-仁愛",405,181,224
"670","2363矽統","110/09/07","日盛-南京",37,904,-867
"671","2363矽統","110/09/07","永豐金-中壢",230,13,217
"672","2363矽統","110/09/07","台灣摩根士丹利",16,873,-857
"673","2363矽統","110/09/07","富隆-長安",204,1,203
"674","2363矽統","110/09/07","富邦-北港",58,849,-791
"675","2363矽統","110/09/07","元大-汐止",303,106,197
"676","2363矽統","110/09/07","統一",165,954,-789
"677","2363矽統","110/09/07","元大-佳里",240,44,196
"678","2363矽統","110/09/07","永豐金證券",132,879,-747
"679","2363矽統","110/09/07","玉山-台中",257,63,194
"680","2363矽統","110/09/07","港商野村",493,972,-479
"681","2363矽統","110/09/07","兆豐-三民",230,41,189
"682","2363矽統","110/09/07","元大證券",824,1298,-474
"683","2363矽統","110/09/07","凱基-虎尾",192,15,177
"684","2363矽統","110/09/07","統一-士林",244,699,-455
"685","2363矽統","110/09/07","統一-南京",221,57,164
"686","2363矽統","110/09/07","陽信-石牌",367,764,-397
"687","2363矽統","110/09/07","台新-台中",549,390,159
"688","2363矽統","110/09/07","群益金鼎-敦南",32,316,-284
"689","2363矽統","110/09/07","永豐金-南投",208,49,159
"690","2363矽統","110/09/07","凱基-信義",11,289,-278
"691","8112至上","110/09/07","瑞士信貸",501,0,501
"692","8112至上","110/09/07","台灣摩根士丹利",34,322,-288
"693","8112至上","110/09/07","華南永昌-虎尾",100,0,100
"694","8112至上","110/09/07","元大-信義",0,285,-285
"695","8112至上","110/09/07","國票-南京",85,0,85
"696","8112至上","110/09/07","凱基-長庚",0,112,-112
"697","8112至上","110/09/07","凱基-市政",85,0,85
"698","8112至上","110/09/07","新光-新竹",23,130,-107
"699","8112至上","110/09/07","元大-北成功",71,1,70
"700","8112至上","110/09/07","新光-台中",6,89,-83
"701","8112至上","110/09/07","統一-中壢",60,2,58
"702","8112至上","110/09/07","兆豐-來福",0,70,-70
"703","8112至上","110/09/07","台新-新營",57,0,57
"704","8112至上","110/09/07","(牛牛牛)亞-鑫豐",5,55,-50
"705","8112至上","110/09/07","元大-士林",57,0,57
"706","8112至上","110/09/07","群益金鼎-內湖",0,50,-50
"707","8112至上","110/09/07","凱基-高雄",51,0,51
"708","8112至上","110/09/07","華南永昌-淡水",0,41,-41
"709","8112至上","110/09/07","元大-員林中山",51,0,51
"710","8112至上","110/09/07","亞東",0,40,-40
"711","8112至上","110/09/07","兆豐-桃園",49,0,49
"712","8112至上","110/09/07","元大-淡水",1,41,-40
"713","8112至上","110/09/07","富邦-仁愛",48,1,47
"714","8112至上","110/09/07","新光-台南",13,52,-39
"715","8112至上","110/09/07","永豐金-高雄",50,5,45
"716","8112至上","110/09/07","凱基-台北",159,198,-39
"717","8112至上","110/09/07","大展-台南",40,0,40
"718","8112至上","110/09/07","港商野村",3,40,-37
"719","8112至上","110/09/07","新光",51,20,31
"720","8112至上","110/09/07","美林",52,88,-36
"721","1570力肯","110/09/07","國票-和平",114,0,114
"722","1570力肯","110/09/07","群益金鼎-中壢",10,52,-42
"723","1570力肯","110/09/07","群益金鼎-東湖",17,0,17
"724","1570力肯","110/09/07","凱基-市政",0,30,-30
"725","1570力肯","110/09/07","元大-草屯",10,0,10
"726","1570力肯","110/09/07","台新證券",0,22,-22
"727","1570力肯","110/09/07","元大-北三重",10,0,10
"728","1570力肯","110/09/07","凱基-高美館",0,20,-20
"729","1570力肯","110/09/07","兆豐-天母",5,0,5
"730","1570力肯","110/09/07","凱基-台北",0,9,-9
"731","1570力肯","110/09/07","兆豐-員林",5,0,5
"732","1570力肯","110/09/07","摩根大通",4,12,-8
"733","1570力肯","110/09/07","群益金鼎-民權",5,0,5
"734","1570力肯","110/09/07","元富-民權",0,6,-6
"735","1570力肯","110/09/07","元大-福營",3,0,3
"736","1570力肯","110/09/07","元大-館前",0,5,-5
"737","1570力肯","110/09/07","日盛-八德",2,0,2
"738","1570力肯","110/09/07","新光",1,5,-4
"739","1570力肯","110/09/07","永豐金-苓雅",2,0,2
"740","1570力肯","110/09/07","元大-龍潭",0,4,-4
"741","1570力肯","110/09/07","合庫證券",1,0,1
"742","1570力肯","110/09/07","元富-西松",0,3,-3
"743","1570力肯","110/09/07","美林",1,0,1
"744","1570力肯","110/09/07","國泰-館前",0,3,-3
"745","1570力肯","110/09/07","元富-新店",1,0,1
"746","1570力肯","110/09/07","元大-竹北",0,3,-3
"747","1570力肯","110/09/07","中國信託",1,0,1
"748","1570力肯","110/09/07","元大-新盛",0,3,-3
"749","1570力肯","110/09/07","福邦證券",1,0,1
"750","1570力肯","110/09/07","兆豐-台中港",0,2,-2
"751","2929淘帝","110/09/07","元富-板橋",30,0,30
"752","2929淘帝","110/09/07","統一-員林",0,20,-20
"753","2929淘帝","110/09/07","摩根大通",13,3,10
"754","2929淘帝","110/09/07","凱基-長庚",0,13,-13
"755","2929淘帝","110/09/07","新光-台中",14,5,9
"756","2929淘帝","110/09/07","陽信-石牌",0,11,-11
"757","2929淘帝","110/09/07","臺銀-民權",5,0,5
"758","2929淘帝","110/09/07","元大-前金",0,10,-10
"759","2929淘帝","110/09/07","群益金鼎-基隆",5,0,5
"760","2929淘帝","110/09/07","元大-林森",0,10,-10
"761","2929淘帝","110/09/07","新光-新竹",4,0,4
"762","2929淘帝","110/09/07","永豐金-敦南",0,8,-8
"763","2929淘帝","110/09/07","玉山-嘉義",4,0,4
"764","2929淘帝","110/09/07","美林",2,9,-7
"765","2929淘帝","110/09/07","合庫-高雄",3,0,3
"766","2929淘帝","110/09/07","兆豐-大同",3,10,-7
"767","2929淘帝","110/09/07","元富-大裕",3,0,3
"768","2929淘帝","110/09/07","華南永昌-古亭",0,7,-7
"769","2929淘帝","110/09/07","元富-世貿",3,0,3
"770","2929淘帝","110/09/07","元大-竹科",0,6,-6
"771","2929淘帝","110/09/07","(牛牛牛)亞-鑫豐",3,0,3
"772","2929淘帝","110/09/07","港商野村",1,6,-5
"773","2929淘帝","110/09/07","凱基-豐中",3,0,3
"774","2929淘帝","110/09/07","兆豐-桃鶯",2,5,-3
"775","2929淘帝","110/09/07","富邦-建國",3,0,3
"776","2929淘帝","110/09/07","群益金鼎-敦南",0,3,-3
"777","2929淘帝","110/09/07","富邦-嘉義",3,0,3
"778","2929淘帝","110/09/07","元大-復北",0,3,-3
"779","2929淘帝","110/09/07","元大-太平",3,0,3
"780","2929淘帝","110/09/07","元大-蘆洲",0,3,-3
"781","5410國眾","110/09/07","華南永昌-高雄",30,0,30
"782","5410國眾","110/09/07","元大-學甲",0,19,-19
"783","5410國眾","110/09/07","元大-中壢",17,0,17
"784","5410國眾","110/09/07","新光-台中",1,16,-15
"785","5410國眾","110/09/07","元大-東泰",10,0,10
"786","5410國眾","110/09/07","日盛-屏東",0,10,-10
"787","5410國眾","110/09/07","國泰-松江",6,0,6
"788","5410國眾","110/09/07","永豐金-中盛",0,10,-10
"789","5410國眾","110/09/07","新光",5,0,5
"790","5410國眾","110/09/07","永豐金-復興",0,6,-6
"791","5410國眾","110/09/07","國泰-台中",3,0,3
"792","5410國眾","110/09/07","國泰-館前",0,5,-5
"793","5410國眾","110/09/07","元大-崇德",3,0,3
"794","5410國眾","110/09/07","元富-嘉義",0,4,-4
"795","5410國眾","110/09/07","元大-左營",3,0,3
"796","5410國眾","110/09/07","光和-高雄",0,3,-3
"797","5410國眾","110/09/07","大昌-安康",2,0,2
"798","5410國眾","110/09/07","凱基-彰化",0,3,-3
"799","5410國眾","110/09/07","凱基-南崁",2,0,2
"800","5410國眾","110/09/07","華南永昌-淡水",0,3,-3
"801","5410國眾","110/09/07","富邦-永和",2,0,2
"802","5410國眾","110/09/07","臺銀-臺中",0,2,-2
"803","5410國眾","110/09/07","永豐金-員林",2,0,2
"804","5410國眾","110/09/07","元富-板橋",0,2,-2
"805","5410國眾","110/09/07","永豐金-竹北",2,0,2
"806","5410國眾","110/09/07","摩根大通",0,2,-2
"807","5410國眾","110/09/07","日盛-和美",1,0,1
"808","5410國眾","110/09/07","元大-汐止",0,2,-2
"809","5410國眾","110/09/07","永豐金-敦南",1,0,1
"810","5410國眾","110/09/07","永豐金-板橋",0,2,-2
"811","2841台開","110/09/07","群益金鼎-彰化",50,0,50
"812","2841台開","110/09/07","港商野村",0,61,-61
"813","2841台開","110/09/07","富邦-中壢",40,0,40
"814","2841台開","110/09/07","大慶-蘆洲",0,50,-50
"815","2841台開","110/09/07","台中銀",32,8,24
"816","2841台開","110/09/07","兆豐-寶成",0,30,-30
"817","2841台開","110/09/07","宏遠-館前",20,0,20
"818","2841台開","110/09/07","光和-高雄",0,21,-21
"819","2841台開","110/09/07","日盛證券",17,0,17
"820","2841台開","110/09/07","新加坡商瑞銀",0,14,-14
"821","2841台開","110/09/07","元大-台中",17,0,17
"822","2841台開","110/09/07","永豐金-敦南",8,22,-14
"823","2841台開","110/09/07","元富-中原",16,0,16
"824","2841台開","110/09/07","北城證券",0,10,-10
"825","2841台開","110/09/07","元大-南投",16,0,16
"826","2841台開","110/09/07","群益金鼎-永和",0,10,-10
"827","2841台開","110/09/07","台灣摩根士丹利",15,0,15
"828","2841台開","110/09/07","元大-永春",0,10,-10
"829","2841台開","110/09/07","大昌-安康",15,0,15
"830","2841台開","110/09/07","永豐金-松山",0,10,-10
"831","2841台開","110/09/07","日盛-新竹",10,0,10
"832","2841台開","110/09/07","永豐金-台南",0,10,-10
"833","2841台開","110/09/07","富邦-南屯",10,0,10
"834","2841台開","110/09/07","康和-台南",0,9,-9
"835","2841台開","110/09/07","元大-天母",10,0,10
"836","2841台開","110/09/07","統一-平鎮",0,7,-7
"837","2841台開","110/09/07","康和-台北",9,0,9
"838","2841台開","110/09/07","凱基-宜蘭",0,5,-5
"839","2841台開","110/09/07","國泰-敦南",6,0,6
"840","2841台開","110/09/07","元大-府城",0,5,-5
"841","6207雷科","110/09/07","台新-高雄",101,0,101
"842","6207雷科","110/09/07","新加坡商瑞銀",6,32,-26
"843","6207雷科","110/09/07","永全-八德",18,0,18
"844","6207雷科","110/09/07","合庫-嘉義",0,24,-24
"845","6207雷科","110/09/07","中國信託-高雄",17,0,17
"846","6207雷科","110/09/07","群益金鼎-中山",0,20,-20
"847","6207雷科","110/09/07","群益金鼎-延平",13,0,13
"848","6207雷科","110/09/07","凱基-台北",22,41,-19
"849","6207雷科","110/09/07","統一-宜蘭",10,0,10
"850","6207雷科","110/09/07","國泰-敦南",4,18,-14
"851","6207雷科","110/09/07","元大-南海",10,0,10
"852","6207雷科","110/09/07","美商高盛",4,17,-13
"853","6207雷科","110/09/07","永豐金-敦南",10,0,10
"854","6207雷科","110/09/07","國票-九鼎",2,14,-12
"855","6207雷科","110/09/07","統一",9,0,9
"856","6207雷科","110/09/07","摩根大通",2,13,-11
"857","6207雷科","110/09/07","元大-高雄",8,0,8
"858","6207雷科","110/09/07","元大-淡水",1,10,-9
"859","6207雷科","110/09/07","凱基-中山",7,0,7
"860","6207雷科","110/09/07","日盛-台中",0,8,-8
"861","6207雷科","110/09/07","第一金-華江",5,0,5
"862","6207雷科","110/09/07","港商野村",0,8,-8
"863","6207雷科","110/09/07","國泰-台中",5,0,5
"864","6207雷科","110/09/07","元富-潮州",0,8,-8
"865","6207雷科","110/09/07","群益金鼎-高盛",5,0,5
"866","6207雷科","110/09/07","富邦-台北",1,9,-8
"867","6207雷科","110/09/07","日盛-士林",4,0,4
"868","6207雷科","110/09/07","日盛-三重",0,6,-6
"869","6207雷科","110/09/07","玉山-大里",4,0,4
"870","6207雷科","110/09/07","永興",0,6,-6
"871","3679新至陞","110/09/07","元大-成功",10,0,10
"872","3679新至陞","110/09/07","摩根大通",0,15,-15
"873","3679新至陞","110/09/07","凱基-台北",9,0,9
"874","3679新至陞","110/09/07","美林",0,6,-6
"875","3679新至陞","110/09/07","華南永昌-古亭",3,0,3
"876","3679新至陞","110/09/07","元大-北三重",0,5,-5
"877","3679新至陞","110/09/07","土銀-和平",4,2,2
"878","3679新至陞","110/09/07","康和-高雄",0,4,-4
"879","3679新至陞","110/09/07","第一金-忠孝",2,0,2
"880","3679新至陞","110/09/07","美商高盛",0,3,-3
"881","3679新至陞","110/09/07","元富-緯城",2,0,2
"882","3679新至陞","110/09/07","港商野村",0,3,-3
"883","3679新至陞","110/09/07","台中銀-員林",2,0,2
"884","3679新至陞","110/09/07","台新證券",0,3,-3
"885","3679新至陞","110/09/07","國票-台東",2,0,2
"886","3679新至陞","110/09/07","玉山-台大",0,3,-3
"887","3679新至陞","110/09/07","玉山-台中",2,0,2
"888","3679新至陞","110/09/07","彰銀",0,2,-2
"889","3679新至陞","110/09/07","玉山-新竹",2,0,2
"890","3679新至陞","110/09/07","宏遠-中和",0,2,-2
"891","3679新至陞","110/09/07","凱基-市政",2,0,2
"892","3679新至陞","110/09/07","新加坡商瑞銀",0,2,-2
"893","3679新至陞","110/09/07","元大-土城",2,0,2
"894","3679新至陞","110/09/07","統一-士林",0,2,-2
"895","3679新至陞","110/09/07","元大-淡水",2,0,2
"896","3679新至陞","110/09/07","兆豐-鹿港",0,2,-2
"897","3679新至陞","110/09/07","元大-板橋",2,0,2
"898","3679新至陞","110/09/07","群益金鼎-三重",0,2,-2
"899","3679新至陞","110/09/07","元大-景美",1,0,1
"900","3679新至陞","110/09/07","華南永昌-麻豆",0,2,-2
"901","2727王品","110/09/07","兆豐-新莊",60,0,60
"902","2727王品","110/09/07","港商法國興業",0,45,-45
"903","2727王品","110/09/07","摩根大通",84,27,57
"904","2727王品","110/09/07","港商野村",15,51,-36
"905","2727王品","110/09/07","台灣摩根士丹利",44,2,42
"906","2727王品","110/09/07","華南永昌-鳳山",3,32,-29
"907","2727王品","110/09/07","華南永昌-長虹",30,0,30
"908","2727王品","110/09/07","美商高盛",24,49,-25
"909","2727王品","110/09/07","瑞士信貸",29,0,29
"910","2727王品","110/09/07","凱基-五股",0,24,-24
"911","2727王品","110/09/07","日盛-南京",20,0,20
"912","2727王品","110/09/07","群益金鼎-新店",0,21,-21
"913","2727王品","110/09/07","元大-北屯",20,1,19
"914","2727王品","110/09/07","新光-新竹",2,19,-17
"915","2727王品","110/09/07","永豐金-中盛",16,0,16
"916","2727王品","110/09/07","彰銀-台中",3,19,-16
"917","2727王品","110/09/07","國泰-台中",18,3,15
"918","2727王品","110/09/07","大慶-苗栗",0,13,-13
"919","2727王品","110/09/07","元大-台中中港",15,1,14
"920","2727王品","110/09/07","國泰-板橋",1,14,-13
"921","2727王品","110/09/07","新加坡商瑞銀",11,0,11
"922","2727王品","110/09/07","元大證券",45,58,-13
"923","2727王品","110/09/07","德信",10,0,10
"924","2727王品","110/09/07","富邦-板橋",1,13,-12
"925","2727王品","110/09/07","台新證券",12,2,10
"926","2727王品","110/09/07","日盛-大墩",0,11,-11
"927","2727王品","110/09/07","凱基-中山",9,0,9
"928","2727王品","110/09/07","統一",3,14,-11
"929","2727王品","110/09/07","富邦-仁愛",8,2,6
"930","2727王品","110/09/07","凱基-板橋",4,15,-11
"931","1570力肯","110/09/07","國票-和平",114,0,114
"932","1570力肯","110/09/07","群益金鼎-中壢",10,52,-42
"933","1570力肯","110/09/07","群益金鼎-東湖",17,0,17
"934","1570力肯","110/09/07","凱基-市政",0,30,-30
"935","1570力肯","110/09/07","元大-草屯",10,0,10
"936","1570力肯","110/09/07","台新證券",0,22,-22
"937","1570力肯","110/09/07","元大-北三重",10,0,10
"938","1570力肯","110/09/07","凱基-高美館",0,20,-20
"939","1570力肯","110/09/07","兆豐-天母",5,0,5
"940","1570力肯","110/09/07","凱基-台北",0,9,-9
"941","1570力肯","110/09/07","兆豐-員林",5,0,5
"942","1570力肯","110/09/07","摩根大通",4,12,-8
"943","1570力肯","110/09/07","群益金鼎-民權",5,0,5
"944","1570力肯","110/09/07","元富-民權",0,6,-6
"945","1570力肯","110/09/07","元大-福營",3,0,3
"946","1570力肯","110/09/07","元大-館前",0,5,-5
"947","1570力肯","110/09/07","日盛-八德",2,0,2
"948","1570力肯","110/09/07","新光",1,5,-4
"949","1570力肯","110/09/07","永豐金-苓雅",2,0,2
"950","1570力肯","110/09/07","元大-龍潭",0,4,-4
"951","1570力肯","110/09/07","合庫證券",1,0,1
"952","1570力肯","110/09/07","元富-西松",0,3,-3
"953","1570力肯","110/09/07","美林",1,0,1
"954","1570力肯","110/09/07","國泰-館前",0,3,-3
"955","1570力肯","110/09/07","元富-新店",1,0,1
"956","1570力肯","110/09/07","元大-竹北",0,3,-3
"957","1570力肯","110/09/07","中國信託",1,0,1
"958","1570力肯","110/09/07","元大-新盛",0,3,-3
"959","1570力肯","110/09/07","福邦證券",1,0,1
"960","1570力肯","110/09/07","兆豐-台中港",0,2,-2
"961","6180橘子","110/09/07","永豐金-中盛",24,0,24
"962","6180橘子","110/09/07","兆豐-北高雄",0,100,-100
"963","6180橘子","110/09/07","美商高盛",20,1,19
"964","6180橘子","110/09/07","元大-旗山",0,29,-29
"965","6180橘子","110/09/07","摩根大通",16,5,11
"966","6180橘子","110/09/07","統一-高雄",0,15,-15
"967","6180橘子","110/09/07","第一金-中山",10,0,10
"968","6180橘子","110/09/07","高橋",0,11,-11
"969","6180橘子","110/09/07","元富-大裕",10,0,10
"970","6180橘子","110/09/07","台中銀-員林",0,10,-10
"971","6180橘子","110/09/07","亞東-新竹",9,0,9
"972","6180橘子","110/09/07","群益金鼎-彰化",1,11,-10
"973","6180橘子","110/09/07","美林",7,0,7
"974","6180橘子","110/09/07","凱基-永康",0,10,-10
"975","6180橘子","110/09/07","港商野村",9,2,7
"976","6180橘子","110/09/07","元大-中和",0,10,-10
"977","6180橘子","110/09/07","凱基-嘉義",7,0,7
"978","6180橘子","110/09/07","台新-新營",0,7,-7
"979","6180橘子","110/09/07","凱基-台北",20,13,7
"980","6180橘子","110/09/07","國泰-板橋",0,7,-7
"981","6180橘子","110/09/07","華南永昌-古亭",8,1,7
"982","6180橘子","110/09/07","凱基-中港",0,6,-6
"983","6180橘子","110/09/07","台新-左楠",6,0,6
"984","6180橘子","110/09/07","日盛-樹林",0,5,-5
"985","6180橘子","110/09/07","新光",10,4,6
"986","6180橘子","110/09/07","大慶-楊梅",0,5,-5
"987","6180橘子","110/09/07","富邦-陽明",6,0,6
"988","6180橘子","110/09/07","新光-高雄",0,5,-5
"989","6180橘子","110/09/07","國泰-敦南",7,2,5
"990","6180橘子","110/09/07","元大-清水",1,6,-5
"991","2390云辰","110/09/07","摩根大通",794,259,535
"992","2390云辰","110/09/07","統一-新台中",6,205,-199
"993","2390云辰","110/09/07","美林",275,113,162
"994","2390云辰","110/09/07","新加坡商瑞銀",26,193,-167
"995","2390云辰","110/09/07","元富-安南",113,10,103
"996","2390云辰","110/09/07","元大證券",2,142,-140
"997","2390云辰","110/09/07","國票-中和",86,6,80
"998","2390云辰","110/09/07","元大-土城學府",83,208,-125
"999","2390云辰","110/09/07","台灣摩根士丹利",157,86,71
"1000","2390云辰","110/09/07","新光-台中",30,152,-122
"1001","2390云辰","110/09/07","富邦-竹北",68,0,68
"1002","2390云辰","110/09/07","凱基-長庚",3,110,-107
"1003","2390云辰","110/09/07","國泰-板橋",87,21,66
"1004","2390云辰","110/09/07","元大-松山",8,108,-100
"1005","2390云辰","110/09/07","凱基-台北",179,125,54
"1006","2390云辰","110/09/07","日盛-新莊",6,104,-98
"1007","2390云辰","110/09/07","國泰-館前",46,10,36
"1008","2390云辰","110/09/07","新光",58,125,-67
"1009","2390云辰","110/09/07","富邦-仁愛",40,5,35
"1010","2390云辰","110/09/07","群益金鼎-民權",1,52,-51
"1011","2390云辰","110/09/07","永豐金-南投",63,28,35
"1012","2390云辰","110/09/07","富邦-宜蘭",8,56,-48
"1013","2390云辰","110/09/07","統一-彰化",34,2,32
"1014","2390云辰","110/09/07","元大-頭份",6,52,-46
"1015","2390云辰","110/09/07","國票-博愛",157,126,31
"1016","2390云辰","110/09/07","玉山-左營",3,46,-43
"1017","2390云辰","110/09/07","台新-台中",62,32,30
"1018","2390云辰","110/09/07","兆豐-寶成",2,43,-41
"1019","2390云辰","110/09/07","元大-松江",34,4,30
"1020","2390云辰","110/09/07","新光-桃園",16,57,-41
