"","stake","date","name","buy","sell","total"
"1","2867三商壽","110/08/06","摩根大通",410,157,253
"2","2867三商壽","110/08/06","日盛-新莊",0,719,-719
"3","2867三商壽","110/08/06","元大-北港",201,0,201
"4","2867三商壽","110/08/06","群益金鼎-桃園",0,400,-400
"5","2867三商壽","110/08/06","元大-斗信",200,0,200
"6","2867三商壽","110/08/06","中國信託-文心",1,301,-300
"7","2867三商壽","110/08/06","元大-沙鹿",199,0,199
"8","2867三商壽","110/08/06","美林",10,169,-159
"9","2867三商壽","110/08/06","永豐金-嘉義",130,0,130
"10","2867三商壽","110/08/06","法銀巴黎",0,122,-122
"11","2867三商壽","110/08/06","第一金-自由",100,0,100
"12","2867三商壽","110/08/06","國票-中和",0,100,-100
"13","2867三商壽","110/08/06","元大-大里德芳",100,0,100
"14","2867三商壽","110/08/06","台灣摩根士丹利",65,164,-99
"15","2867三商壽","110/08/06","元大-土城永寧",100,0,100
"16","2867三商壽","110/08/06","凱基-高美館",2,64,-62
"17","2867三商壽","110/08/06","瑞士信貸",94,0,94
"18","2867三商壽","110/08/06","元大證券",1,62,-61
"19","2867三商壽","110/08/06","元大-汐止",60,0,60
"20","2867三商壽","110/08/06","華南永昌-南京",0,50,-50
"21","2867三商壽","110/08/06","元富-大裕",52,0,52
"22","2867三商壽","110/08/06","凱基-頭份",0,45,-45
"23","2867三商壽","110/08/06","新光",53,1,52
"24","2867三商壽","110/08/06","凱基",0,44,-44
"25","2867三商壽","110/08/06","凱基-市府",51,0,51
"26","2867三商壽","110/08/06","康和-屏東",0,43,-43
"27","2867三商壽","110/08/06","安泰",49,0,49
"28","2867三商壽","110/08/06","凱基-八德",0,40,-40
"29","2867三商壽","110/08/06","富邦-桃園",50,2,48
"30","2867三商壽","110/08/06","凱基-虎尾",0,40,-40
"31","5521工信","110/08/06","日進",412,0,412
"32","5521工信","110/08/06","中國信託-嘉義",0,100,-100
"33","5521工信","110/08/06","瑞士信貸",48,0,48
"34","5521工信","110/08/06","美林",0,69,-69
"35","5521工信","110/08/06","日盛-雙和",34,0,34
"36","5521工信","110/08/06","統一-新竹",0,60,-60
"37","5521工信","110/08/06","聯邦-雙和",25,0,25
"38","5521工信","110/08/06","第一金-桃園",0,55,-55
"39","5521工信","110/08/06","台新證券",32,12,20
"40","5521工信","110/08/06","凱基-台北",0,54,-54
"41","5521工信","110/08/06","土銀-台中",17,0,17
"42","5521工信","110/08/06","華南永昌-桃園",0,49,-49
"43","5521工信","110/08/06","(牛牛牛)亞-鑫豐",15,0,15
"44","5521工信","110/08/06","第一金-安和",0,40,-40
"45","5521工信","110/08/06","元大-沙鹿",19,4,15
"46","5521工信","110/08/06","合庫-台南",0,36,-36
"47","5521工信","110/08/06","元富-安南",14,0,14
"48","5521工信","110/08/06","台灣摩根士丹利",7,34,-27
"49","5521工信","110/08/06","新加坡商瑞銀",10,0,10
"50","5521工信","110/08/06","摩根大通",22,48,-26
"51","5521工信","110/08/06","德信-中正",10,0,10
"52","5521工信","110/08/06","台新-台中",0,20,-20
"53","5521工信","110/08/06","國泰-敦南",22,12,10
"54","5521工信","110/08/06","元大-豐原",0,20,-20
"55","5521工信","110/08/06","群益金鼎-屏東",10,0,10
"56","5521工信","110/08/06","元大-北成功",0,20,-20
"57","5521工信","110/08/06","群益金鼎-東門",10,0,10
"58","5521工信","110/08/06","永豐金-埔里",0,20,-20
"59","5521工信","110/08/06","元大-西螺",10,0,10
"60","5521工信","110/08/06","港商野村",0,16,-16
"61","1471首利","110/08/06","國票-彰化",30,0,30
"62","1471首利","110/08/06","兆豐-麻豆",0,50,-50
"63","1471首利","110/08/06","凱基-宜蘭",27,0,27
"64","1471首利","110/08/06","台新證券",3,30,-27
"65","1471首利","110/08/06","玉山-桃園",22,0,22
"66","1471首利","110/08/06","美林",15,41,-26
"67","1471首利","110/08/06","新光-台中",17,0,17
"68","1471首利","110/08/06","永豐金-台南",0,25,-25
"69","1471首利","110/08/06","兆豐-埔墘",14,0,14
"70","1471首利","110/08/06","元富-草屯",0,19,-19
"71","1471首利","110/08/06","新光-高雄",11,0,11
"72","1471首利","110/08/06","新光-桃園",0,17,-17
"73","1471首利","110/08/06","合庫-鳳山",10,0,10
"74","1471首利","110/08/06","摩根大通",13,28,-15
"75","1471首利","110/08/06","統一-竹南",10,0,10
"76","1471首利","110/08/06","華南永昌-淡水",1,15,-14
"77","1471首利","110/08/06","(牛牛牛)亞-鑫豐",10,0,10
"78","1471首利","110/08/06","台中銀",1,14,-13
"79","1471首利","110/08/06","兆豐-岡山",10,0,10
"80","1471首利","110/08/06","玉山-板橋",0,12,-12
"81","1471首利","110/08/06","凱基-彰化",10,0,10
"82","1471首利","110/08/06","富邦-基隆",10,22,-12
"83","1471首利","110/08/06","富邦-永和",10,0,10
"84","1471首利","110/08/06","台灣企銀",0,10,-10
"85","1471首利","110/08/06","元大-竹山",10,0,10
"86","1471首利","110/08/06","元富-民權",0,10,-10
"87","1471首利","110/08/06","元大-民雄",10,0,10
"88","1471首利","110/08/06","元大-左營",0,10,-10
"89","1471首利","110/08/06","元大-南崁",10,1,9
"90","1471首利","110/08/06","大昌-新店",2,11,-9
"91","2883開發金","110/08/06","國泰證券",7766,49,7717
"92","2883開發金","110/08/06","永豐金-板橋",2,2245,-2243
"93","2883開發金","110/08/06","元富-城東",7094,124,6970
"94","2883開發金","110/08/06","玉山-台南",63,2130,-2067
"95","2883開發金","110/08/06","摩根大通",4922,1097,3825
"96","2883開發金","110/08/06","國泰-板橋",236,1871,-1635
"97","2883開發金","110/08/06","瑞士信貸",3230,108,3122
"98","2883開發金","110/08/06","港商野村",1243,2562,-1319
"99","2883開發金","110/08/06","凱基-台北",4810,2311,2499
"100","2883開發金","110/08/06","美林",1480,2782,-1302
"101","2883開發金","110/08/06","合庫證券",3551,2064,1487
"102","2883開發金","110/08/06","群益金鼎-中山",7,1151,-1144
"103","2883開發金","110/08/06","新加坡商瑞銀",3900,2689,1211
"104","2883開發金","110/08/06","日盛-員林",17,1100,-1083
"105","2883開發金","110/08/06","玉山證券",1332,183,1149
"106","2883開發金","110/08/06","台灣摩根士丹利",509,1544,-1035
"107","2883開發金","110/08/06","國票-長城",1003,0,1003
"108","2883開發金","110/08/06","台灣企銀-民雄",0,1004,-1004
"109","2883開發金","110/08/06","康和",720,0,720
"110","2883開發金","110/08/06","港商法國興業",7,981,-974
"111","2883開發金","110/08/06","福邦證券",590,15,575
"112","2883開發金","110/08/06","新光",240,1199,-959
"113","2883開發金","110/08/06","台灣企銀-九如",492,10,482
"114","2883開發金","110/08/06","元大-新莊",58,1017,-959
"115","2883開發金","110/08/06","宏遠-民生",502,54,448
"116","2883開發金","110/08/06","富邦-彰化",5,766,-761
"117","2883開發金","110/08/06","元大證券",803,358,445
"118","2883開發金","110/08/06","中國信託",270,931,-661
"119","2883開發金","110/08/06","玉山-高雄",476,80,396
"120","2883開發金","110/08/06","永豐金-彰化",33,655,-622
"121","6205詮欣","110/08/06","臺銀-民權",20,0,20
"122","6205詮欣","110/08/06","元大-板橋",0,50,-50
"123","6205詮欣","110/08/06","合庫-三重",15,0,15
"124","6205詮欣","110/08/06","摩根大通",0,29,-29
"125","6205詮欣","110/08/06","日盛-三重",15,4,11
"126","6205詮欣","110/08/06","臺銀-新竹",0,3,-3
"127","6205詮欣","110/08/06","凱基-長庚",10,0,10
"128","6205詮欣","110/08/06","日盛-頭份",0,3,-3
"129","6205詮欣","110/08/06","臺銀-臺中",5,0,5
"130","6205詮欣","110/08/06","群益金鼎-潭子",0,3,-3
"131","6205詮欣","110/08/06","兆豐-台中",4,0,4
"132","6205詮欣","110/08/06","永豐金-敦南",0,3,-3
"133","6205詮欣","110/08/06","凱基-台北",4,0,4
"134","6205詮欣","110/08/06","美林",0,2,-2
"135","6205詮欣","110/08/06","元大-龍潭",4,0,4
"136","6205詮欣","110/08/06","新加坡商瑞銀",6,8,-2
"137","6205詮欣","110/08/06","瑞士信貸",3,0,3
"138","6205詮欣","110/08/06","華南永昌-淡水",0,2,-2
"139","6205詮欣","110/08/06","國泰-板橋",3,0,3
"140","6205詮欣","110/08/06","元大-發財",0,2,-2
"141","6205詮欣","110/08/06","台中銀",2,0,2
"142","6205詮欣","110/08/06","元大-屏東民生",0,2,-2
"143","6205詮欣","110/08/06","德信-新營",2,0,2
"144","6205詮欣","110/08/06","統一-南京",0,1,-1
"145","6205詮欣","110/08/06","兆豐-竹北",2,0,2
"146","6205詮欣","110/08/06","新光-台中",0,1,-1
"147","6205詮欣","110/08/06","兆豐-景美",2,0,2
"148","6205詮欣","110/08/06","玉山證券",0,1,-1
"149","6205詮欣","110/08/06","台新-台中",2,0,2
"150","6205詮欣","110/08/06","富邦-左營",0,1,-1
"151","1540喬福","110/08/06","元富-中原",27,0,27
"152","1540喬福","110/08/06","統一-新台中",0,25,-25
"153","1540喬福","110/08/06","合庫-台中",24,0,24
"154","1540喬福","110/08/06","大慶-中壢",0,24,-24
"155","1540喬福","110/08/06","台新-台中",10,0,10
"156","1540喬福","110/08/06","福勝",0,7,-7
"157","1540喬福","110/08/06","富邦-竹北",7,0,7
"158","1540喬福","110/08/06","群益金鼎-高雄",0,5,-5
"159","1540喬福","110/08/06","華南永昌-中正",5,0,5
"160","1540喬福","110/08/06","富邦-高雄",0,5,-5
"161","1540喬福","110/08/06","玉山證券",4,0,4
"162","1540喬福","110/08/06","美林",0,3,-3
"163","1540喬福","110/08/06","兆豐-台中港",2,0,2
"164","1540喬福","110/08/06","元大-景美",0,3,-3
"165","1540喬福","110/08/06","國票-中正",2,0,2
"166","1540喬福","110/08/06","元大-和平",0,3,-3
"167","1540喬福","110/08/06","凱基-虎尾",2,0,2
"168","1540喬福","110/08/06","日盛-台中",0,2,-2
"169","1540喬福","110/08/06","凱基-台北",2,0,2
"170","1540喬福","110/08/06","日盛-中和",0,2,-2
"171","1540喬福","110/08/06","元大-府城",2,0,2
"172","1540喬福","110/08/06","台新-台南",0,2,-2
"173","1540喬福","110/08/06","土銀-玉里",1,0,1
"174","1540喬福","110/08/06","玉山-高雄",0,2,-2
"175","1540喬福","110/08/06","第一金-中壢",1,0,1
"176","1540喬福","110/08/06","凱基-中壢",0,2,-2
"177","1540喬福","110/08/06","國票-彰化",1,0,1
"178","1540喬福","110/08/06","致和-南京",0,1,-1
"179","1540喬福","110/08/06","國泰-敦南",1,0,1
"180","1540喬福","110/08/06","摩根大通",0,1,-1
"181","2888新光金","110/08/06","玉山-城中",3762,22,3740
"182","2888新光金","110/08/06","美林",583,3191,-2608
"183","2888新光金","110/08/06","瑞士信貸",1783,778,1005
"184","2888新光金","110/08/06","元富-城東",39,1594,-1555
"185","2888新光金","110/08/06","元大-土城永寧",1004,16,988
"186","2888新光金","110/08/06","日盛-板橋",19,1000,-981
"187","2888新光金","110/08/06","新加坡商瑞銀",1129,357,772
"188","2888新光金","110/08/06","摩根大通",2207,3153,-946
"189","2888新光金","110/08/06","中國信託",566,4,562
"190","2888新光金","110/08/06","新光",505,1390,-885
"191","2888新光金","110/08/06","富邦-員林",484,3,481
"192","2888新光金","110/08/06","台灣摩根士丹利",181,1022,-841
"193","2888新光金","110/08/06","臺銀-金山",432,3,429
"194","2888新光金","110/08/06","元大-四維",35,750,-715
"195","2888新光金","110/08/06","臺銀",418,2,416
"196","2888新光金","110/08/06","美商高盛",114,811,-697
"197","2888新光金","110/08/06","凱基-東勢",404,6,398
"198","2888新光金","110/08/06","法銀巴黎",274,867,-593
"199","2888新光金","110/08/06","玉山證券",416,73,343
"200","2888新光金","110/08/06","元大-員林",18,503,-485
"201","2888新光金","110/08/06","華南永昌-民權",305,0,305
"202","2888新光金","110/08/06","富邦-建國",57,471,-414
"203","2888新光金","110/08/06","永興",300,10,290
"204","2888新光金","110/08/06","富邦-台中",15,418,-403
"205","2888新光金","110/08/06","富邦-台北",319,48,271
"206","2888新光金","110/08/06","華南永昌-嘉義",2,324,-322
"207","2888新光金","110/08/06","兆豐-員林",274,28,246
"208","2888新光金","110/08/06","凱基-台北",839,1120,-281
"209","2888新光金","110/08/06","合庫-台中",240,10,230
"210","2888新光金","110/08/06","國泰-館前",20,289,-269
"211","1340勝悅","110/08/06","國泰-台中",30,0,30
"212","1340勝悅","110/08/06","凱基-三峽",0,20,-20
"213","1340勝悅","110/08/06","元富-彰化",10,0,10
"214","1340勝悅","110/08/06","富邦-台東",1,14,-13
"215","1340勝悅","110/08/06","華南永昌-忠孝",8,0,8
"216","1340勝悅","110/08/06","華南永昌-三重",0,12,-12
"217","1340勝悅","110/08/06","華南永昌-大安",7,0,7
"218","1340勝悅","110/08/06","華南永昌-台中",0,10,-10
"219","1340勝悅","110/08/06","永豐金-信義",6,0,6
"220","1340勝悅","110/08/06","美林",0,8,-8
"221","1340勝悅","110/08/06","臺灣企銀-埔墘",5,0,5
"222","1340勝悅","110/08/06","第一金-豐原",0,8,-8
"223","1340勝悅","110/08/06","元大-沙鹿",5,0,5
"224","1340勝悅","110/08/06","凱基-城中",0,8,-8
"225","1340勝悅","110/08/06","新光-高雄",4,0,4
"226","1340勝悅","110/08/06","華南永昌-嘉義",0,6,-6
"227","1340勝悅","110/08/06","群益金鼎-彰化",4,0,4
"228","1340勝悅","110/08/06","元富",0,5,-5
"229","1340勝悅","110/08/06","元大-仁愛",4,0,4
"230","1340勝悅","110/08/06","光和-田中",0,5,-5
"231","1340勝悅","110/08/06","美商高盛",3,0,3
"232","1340勝悅","110/08/06","摩根大通",0,5,-5
"233","1340勝悅","110/08/06","群益金鼎-館前",3,0,3
"234","1340勝悅","110/08/06","元大-草屯",0,4,-4
"235","1340勝悅","110/08/06","臺銀-臺中",2,0,2
"236","1340勝悅","110/08/06","凱基-台北",1,4,-3
"237","1340勝悅","110/08/06","永全-南崁",2,0,2
"238","1340勝悅","110/08/06","元大-苑裡",0,3,-3
"239","1340勝悅","110/08/06","群益金鼎-崇德",2,0,2
"240","1340勝悅","110/08/06","日盛-員林",0,2,-2
"241","6246臺龍","110/08/06","元大-西螺",120,1,119
"242","6246臺龍","110/08/06","統一",0,247,-247
"243","6246臺龍","110/08/06","富邦-敦南",111,0,111
"244","6246臺龍","110/08/06","元大-林森",3,203,-200
"245","6246臺龍","110/08/06","統一-台中",74,10,64
"246","6246臺龍","110/08/06","凱基-大直",4,103,-99
"247","6246臺龍","110/08/06","日盛證券",53,0,53
"248","6246臺龍","110/08/06","大慶-富順",45,110,-65
"249","6246臺龍","110/08/06","兆豐-高雄",81,38,43
"250","6246臺龍","110/08/06","統一-南京",20,70,-50
"251","6246臺龍","110/08/06","群益金鼎-東大",43,2,41
"252","6246臺龍","110/08/06","港商野村",166,213,-47
"253","6246臺龍","110/08/06","統一-永和",40,0,40
"254","6246臺龍","110/08/06","台灣企銀",0,45,-45
"255","6246臺龍","110/08/06","凱基-市府",48,8,40
"256","6246臺龍","110/08/06","華南永昌-忠孝",1,45,-44
"257","6246臺龍","110/08/06","凱基-員林",40,0,40
"258","6246臺龍","110/08/06","永豐金-桃盛",0,35,-35
"259","6246臺龍","110/08/06","新光-高雄",57,21,36
"260","6246臺龍","110/08/06","康和-澎湖",0,30,-30
"261","6246臺龍","110/08/06","國泰-敦南",104,69,35
"262","6246臺龍","110/08/06","康和-石牌",0,30,-30
"263","6246臺龍","110/08/06","元大-金門",39,5,34
"264","6246臺龍","110/08/06","中國信託-永康",6,35,-29
"265","6246臺龍","110/08/06","元大-西屯",29,2,27
"266","6246臺龍","110/08/06","康和-內湖",2,30,-28
"267","6246臺龍","110/08/06","永興-水湳",26,1,25
"268","6246臺龍","110/08/06","大昌",16,43,-27
"269","6246臺龍","110/08/06","元大-豐原站前",25,0,25
"270","6246臺龍","110/08/06","台新證券",29,55,-26
"271","00715L期街口布蘭特正2","110/08/06","華南永昌-長虹",810,50,760
"272","00715L期街口布蘭特正2","110/08/06","永豐金證券",105,2122,-2017
"273","00715L期街口布蘭特正2","110/08/06","富邦證券",557,0,557
"274","00715L期街口布蘭特正2","110/08/06","(牛牛牛)亞-鑫豐",23,892,-869
"275","00715L期街口布蘭特正2","110/08/06","新光",643,129,514
"276","00715L期街口布蘭特正2","110/08/06","凱基-台北",1,789,-788
"277","00715L期街口布蘭特正2","110/08/06","台新-新營",434,0,434
"278","00715L期街口布蘭特正2","110/08/06","元大-永康",0,781,-781
"279","00715L期街口布蘭特正2","110/08/06","群益金鼎-屏東",401,0,401
"280","00715L期街口布蘭特正2","110/08/06","富邦-彰化",0,513,-513
"281","00715L期街口布蘭特正2","110/08/06","永豐金-板盛",402,21,381
"282","00715L期街口布蘭特正2","110/08/06","玉山-大里",0,488,-488
"283","00715L期街口布蘭特正2","110/08/06","兆豐-員林",302,6,296
"284","00715L期街口布蘭特正2","110/08/06","元大-中和",0,400,-400
"285","00715L期街口布蘭特正2","110/08/06","兆豐-新莊",260,0,260
"286","00715L期街口布蘭特正2","110/08/06","元富-安南",2,310,-308
"287","00715L期街口布蘭特正2","110/08/06","宏遠-光隆",252,0,252
"288","00715L期街口布蘭特正2","110/08/06","元大-羅東",5,304,-299
"289","00715L期街口布蘭特正2","110/08/06","台中銀",207,0,207
"290","00715L期街口布蘭特正2","110/08/06","第一金-路竹",13,273,-260
"291","00715L期街口布蘭特正2","110/08/06","國票-北高雄",204,0,204
"292","00715L期街口布蘭特正2","110/08/06","元大-新盛",5,247,-242
"293","00715L期街口布蘭特正2","110/08/06","永豐金-新店",200,4,196
"294","00715L期街口布蘭特正2","110/08/06","元大-忠孝",0,202,-202
"295","00715L期街口布蘭特正2","110/08/06","元大-新莊",211,17,194
"296","00715L期街口布蘭特正2","110/08/06","兆豐-嘉義",8,200,-192
"297","00715L期街口布蘭特正2","110/08/06","聯邦-興中",185,0,185
"298","00715L期街口布蘭特正2","110/08/06","元大-西屯",5,190,-185
"299","00715L期街口布蘭特正2","110/08/06","元富-成功",244,62,182
"300","00715L期街口布蘭特正2","110/08/06","元大-前金",1,181,-180
"301","8941關中","110/08/06","第一金-台南",6,0,6
"302","8941關中","110/08/06","富邦-員林",0,20,-20
"303","8941關中","110/08/06","凱基-市府",6,0,6
"304","8941關中","110/08/06","元大-金華",0,1,-1
"305","8941關中","110/08/06","合庫-台中",5,0,5
"306","8941關中","110/08/06","元大-淡水",0,1,-1
"307","8941關中","110/08/06","永豐金-三重",2,0,2
"308","8941關中","110/08/06","合庫證券",0,0,0
"309","8941關中","110/08/06","(牛牛牛)亞-鑫豐",1,0,1
"310","8941關中","110/08/06","元大證券",0,0,0
"311","8941關中","110/08/06","群益金鼎-基隆",1,0,1
"312","8941關中","110/08/06","元大-桃興",2,2,0
"313","8941關中","110/08/06","元大-古亭",1,0,1
"314","8941關中","110/08/06","元大-板橋",0,0,0
"315","8941關中","110/08/06","合庫證券",0,0,0
"316","8941關中","110/08/06","永豐金-萬盛",0,0,0
"317","8941關中","110/08/06","元大證券",0,0,0
"318","8941關中","110/08/06","",NA,NA,NA
"319","8941關中","110/08/06","元大-桃興",2,2,0
"320","8941關中","110/08/06","",NA,NA,NA
"321","8941關中","110/08/06","元大-板橋",0,0,0
"322","8941關中","110/08/06","",NA,NA,NA
"323","8941關中","110/08/06","永豐金-萬盛",0,0,0
"324","8941關中","110/08/06","",NA,NA,NA
"325","8941關中","110/08/06","",NA,NA,NA
"326","8941關中","110/08/06","",NA,NA,NA
"327","8941關中","110/08/06","",NA,NA,NA
"328","8941關中","110/08/06","",NA,NA,NA
"329","8941關中","110/08/06","",NA,NA,NA
"330","8941關中","110/08/06","",NA,NA,NA
"331","8936國統","110/08/06","摩根大通",55,0,55
"332","8936國統","110/08/06","大慶-蘆洲",1,63,-62
"333","8936國統","110/08/06","凱基-台北",66,19,47
"334","8936國統","110/08/06","宏遠-館前",0,50,-50
"335","8936國統","110/08/06","國票-敦北法人",25,1,24
"336","8936國統","110/08/06","凱基-長庚",0,46,-46
"337","8936國統","110/08/06","元大-大里德芳",22,0,22
"338","8936國統","110/08/06","台灣摩根士丹利",0,42,-42
"339","8936國統","110/08/06","兆豐-新營",20,0,20
"340","8936國統","110/08/06","永豐金-苓雅",15,48,-33
"341","8936國統","110/08/06","新光-新竹",17,0,17
"342","8936國統","110/08/06","元大-竹東",0,30,-30
"343","8936國統","110/08/06","新光-台中",17,4,13
"344","8936國統","110/08/06","新加坡商瑞銀",23,49,-26
"345","8936國統","110/08/06","元富-新店",10,0,10
"346","8936國統","110/08/06","國票-北高雄",0,25,-25
"347","8936國統","110/08/06","中國信託-永康",10,0,10
"348","8936國統","110/08/06","國泰-台南",0,20,-20
"349","8936國統","110/08/06","台新-高雄",11,1,10
"350","8936國統","110/08/06","國泰-敦南",7,24,-17
"351","8936國統","110/08/06","國泰-板橋",10,0,10
"352","8936國統","110/08/06","臺灣企銀-桃園",0,13,-13
"353","8936國統","110/08/06","群益金鼎-東湖",10,0,10
"354","8936國統","110/08/06","美商高盛",1,13,-12
"355","8936國統","110/08/06","元大-北成功",10,0,10
"356","8936國統","110/08/06","合庫-高雄",0,10,-10
"357","8936國統","110/08/06","臺銀-高雄",9,0,9
"358","8936國統","110/08/06","臺銀",0,10,-10
"359","8936國統","110/08/06","日盛-和美",9,0,9
"360","8936國統","110/08/06","元大-土城學府",0,10,-10
"361","6226光鼎","110/08/06","國泰-敦南",183,87,96
"362","6226光鼎","110/08/06","富邦-嘉義",286,537,-251
"363","6226光鼎","110/08/06","台新-高雄",129,53,76
"364","6226光鼎","110/08/06","統一-新竹",30,181,-151
"365","6226光鼎","110/08/06","新光",81,25,56
"366","6226光鼎","110/08/06","宏遠-台中",0,118,-118
"367","6226光鼎","110/08/06","台新證券",112,57,55
"368","6226光鼎","110/08/06","華南永昌-大安",2,82,-80
"369","6226光鼎","110/08/06","台新-新營",56,4,52
"370","6226光鼎","110/08/06","元富-西松",1,76,-75
"371","6226光鼎","110/08/06","中國信託",48,7,41
"372","6226光鼎","110/08/06","凱基-豐中",1,74,-73
"373","6226光鼎","110/08/06","富邦-板橋",38,5,33
"374","6226光鼎","110/08/06","凱基-長庚",3,64,-61
"375","6226光鼎","110/08/06","台新-中壢",32,0,32
"376","6226光鼎","110/08/06","元富-高雄",2,58,-56
"377","6226光鼎","110/08/06","日盛-北高雄",32,1,31
"378","6226光鼎","110/08/06","永豐金-萬盛",2,49,-47
"379","6226光鼎","110/08/06","群益金鼎-桃園",31,0,31
"380","6226光鼎","110/08/06","統一-仁愛",11,57,-46
"381","6226光鼎","110/08/06","元大-屏東民生",31,0,31
"382","6226光鼎","110/08/06","國票-台中",0,46,-46
"383","6226光鼎","110/08/06","中國信託-永康",35,5,30
"384","6226光鼎","110/08/06","群益金鼎-嘉義",11,55,-44
"385","6226光鼎","110/08/06","國泰-台中",57,27,30
"386","6226光鼎","110/08/06","元大-沙鹿",6,50,-44
"387","6226光鼎","110/08/06","群益金鼎-板橋",30,0,30
"388","6226光鼎","110/08/06","新光-高雄",17,58,-41
"389","6226光鼎","110/08/06","寶盛",29,0,29
"390","6226光鼎","110/08/06","元大-嘉義",3,36,-33
"391","2363矽統","110/08/06","新加坡商瑞銀",1338,777,561
"392","2363矽統","110/08/06","凱基-台北",4343,7347,-3004
"393","2363矽統","110/08/06","日盛-三峽",475,86,389
"394","2363矽統","110/08/06","摩根大通",1716,2908,-1192
"395","2363矽統","110/08/06","中國信託-忠孝",433,44,389
"396","2363矽統","110/08/06","美商高盛",315,1169,-854
"397","2363矽統","110/08/06","陽信-石牌",448,73,375
"398","2363矽統","110/08/06","永豐金證券",168,889,-721
"399","2363矽統","110/08/06","國泰-台中",743,471,272
"400","2363矽統","110/08/06","國票-敦北法人",29,513,-484
"401","2363矽統","110/08/06","國泰-敦南",2177,1919,258
"402","2363矽統","110/08/06","元富-嘉義",43,424,-381
"403","2363矽統","110/08/06","台新-台中",565,347,218
"404","2363矽統","110/08/06","元大-東泰",174,540,-366
"405","2363矽統","110/08/06","元大-敦化",246,31,215
"406","2363矽統","110/08/06","元大證券",187,522,-335
"407","2363矽統","110/08/06","大昌-桃園",241,51,190
"408","2363矽統","110/08/06","合庫證券",173,495,-322
"409","2363矽統","110/08/06","華南永昌-淡水",230,48,182
"410","2363矽統","110/08/06","元大-萬華",128,391,-263
"411","2363矽統","110/08/06","港商野村",2381,2203,178
"412","2363矽統","110/08/06","國票-博愛",93,350,-257
"413","2363矽統","110/08/06","台新-高雄",529,361,168
"414","2363矽統","110/08/06","台新-屏東",200,455,-255
"415","2363矽統","110/08/06","元大-新竹",320,156,164
"416","2363矽統","110/08/06","日盛-南京",74,327,-253
"417","2363矽統","110/08/06","元大-中壢",454,292,162
"418","2363矽統","110/08/06","兆豐-民生",16,227,-211
"419","2363矽統","110/08/06","新光-台南",310,150,160
"420","2363矽統","110/08/06","元大-旗山",168,364,-196
"421","8112至上","110/08/06","新光-新竹",533,65,468
"422","8112至上","110/08/06","摩根大通",12,2930,-2918
"423","8112至上","110/08/06","國泰-新莊",192,0,192
"424","8112至上","110/08/06","凱基-台北",388,1548,-1160
"425","8112至上","110/08/06","合庫證券",195,11,184
"426","8112至上","110/08/06","新加坡商瑞銀",17,1069,-1052
"427","8112至上","110/08/06","元大-西門",178,2,176
"428","8112至上","110/08/06","台灣摩根士丹利",48,955,-907
"429","8112至上","110/08/06","(牛牛牛)亞-鑫豐",153,13,140
"430","8112至上","110/08/06","元大-竹科",61,824,-763
"431","8112至上","110/08/06","永豐金-中正",120,1,119
"432","8112至上","110/08/06","美林",19,583,-564
"433","8112至上","110/08/06","陽信",111,0,111
"434","8112至上","110/08/06","瑞士信貸",0,547,-547
"435","8112至上","110/08/06","康和-板橋",106,0,106
"436","8112至上","110/08/06","康和",2,484,-482
"437","8112至上","110/08/06","群益金鼎-延平",101,0,101
"438","8112至上","110/08/06","永豐金-台中",17,430,-413
"439","8112至上","110/08/06","元大-北成功",110,14,96
"440","8112至上","110/08/06","元大-屏南",4,393,-389
"441","8112至上","110/08/06","元富-古亭",141,46,95
"442","8112至上","110/08/06","美商高盛",12,217,-205
"443","8112至上","110/08/06","臺灣企銀-埔墘",92,1,91
"444","8112至上","110/08/06","新光-桃園",42,204,-162
"445","8112至上","110/08/06","第一金-桃園",89,0,89
"446","8112至上","110/08/06","玉山證券",18,162,-144
"447","8112至上","110/08/06","台新證券",105,16,89
"448","8112至上","110/08/06","群益金鼎-基隆",7,151,-144
"449","8112至上","110/08/06","玉山-板橋",96,10,86
"450","8112至上","110/08/06","台新-新營",60,183,-123
"451","1570力肯","110/08/06","國票-北高雄",246,40,206
"452","1570力肯","110/08/06","富邦-高雄",0,47,-47
"453","1570力肯","110/08/06","統一-松江",43,0,43
"454","1570力肯","110/08/06","凱基-台北",55,101,-46
"455","1570力肯","110/08/06","日茂-南投",42,2,40
"456","1570力肯","110/08/06","台新證券",25,60,-35
"457","1570力肯","110/08/06","群益金鼎-三重",34,2,32
"458","1570力肯","110/08/06","元富-三重",0,32,-32
"459","1570力肯","110/08/06","華南永昌-麻豆",32,4,28
"460","1570力肯","110/08/06","台中銀-員林",0,32,-32
"461","1570力肯","110/08/06","永豐金-中和",29,2,27
"462","1570力肯","110/08/06","國泰-板橋",1,33,-32
"463","1570力肯","110/08/06","永豐金-大園",21,0,21
"464","1570力肯","110/08/06","摩根大通",83,112,-29
"465","1570力肯","110/08/06","統一-三重",25,5,20
"466","1570力肯","110/08/06","玉山-新莊",0,27,-27
"467","1570力肯","110/08/06","元富-新店",20,0,20
"468","1570力肯","110/08/06","永豐金-虎尾",0,27,-27
"469","1570力肯","110/08/06","大昌-桃園",21,1,20
"470","1570力肯","110/08/06","玉山-左營",0,25,-25
"471","1570力肯","110/08/06","康和-高雄",18,1,17
"472","1570力肯","110/08/06","富邦-仁愛",10,32,-22
"473","1570力肯","110/08/06","元富-潮州",16,0,16
"474","1570力肯","110/08/06","中國信託-忠孝",0,21,-21
"475","1570力肯","110/08/06","元富-松德",15,0,15
"476","1570力肯","110/08/06","臺銀-鳳山",4,24,-20
"477","1570力肯","110/08/06","凱基-嘉義",15,0,15
"478","1570力肯","110/08/06","台新-屏東",1,21,-20
"479","1570力肯","110/08/06","凱基-埔墘",15,0,15
"480","1570力肯","110/08/06","群益金鼎-西松",0,20,-20
"481","2929淘帝","110/08/06","統一",155,0,155
"482","2929淘帝","110/08/06","元富-敦南",0,100,-100
"483","2929淘帝","110/08/06","港商野村",188,52,136
"484","2929淘帝","110/08/06","兆豐-忠孝",0,60,-60
"485","2929淘帝","110/08/06","摩根大通",72,3,69
"486","2929淘帝","110/08/06","台新證券",9,68,-59
"487","2929淘帝","110/08/06","新光-新竹",45,0,45
"488","2929淘帝","110/08/06","凱基-台北",30,80,-50
"489","2929淘帝","110/08/06","華南永昌",40,1,39
"490","2929淘帝","110/08/06","台新-台中",0,45,-45
"491","2929淘帝","110/08/06","美林",52,18,34
"492","2929淘帝","110/08/06","國泰-台中",2,43,-41
"493","2929淘帝","110/08/06","新加坡商瑞銀",48,14,34
"494","2929淘帝","110/08/06","華南永昌-林口",0,37,-37
"495","2929淘帝","110/08/06","日盛-頭份",32,0,32
"496","2929淘帝","110/08/06","元大-屏南",0,30,-30
"497","2929淘帝","110/08/06","日盛-板橋中山",30,0,30
"498","2929淘帝","110/08/06","群益金鼎-潭子",0,26,-26
"499","2929淘帝","110/08/06","元大-中壢",25,3,22
"500","2929淘帝","110/08/06","元大-新莊",3,26,-23
"501","2929淘帝","110/08/06","元大-莒光",21,0,21
"502","2929淘帝","110/08/06","臺銀-臺南",0,22,-22
"503","2929淘帝","110/08/06","福勝",20,0,20
"504","2929淘帝","110/08/06","新光",2,24,-22
"505","2929淘帝","110/08/06","元富-三重",17,0,17
"506","2929淘帝","110/08/06","華南永昌-長虹",0,22,-22
"507","2929淘帝","110/08/06","國票-南京",17,0,17
"508","2929淘帝","110/08/06","富邦-高雄",0,20,-20
"509","2929淘帝","110/08/06","合庫證券",16,0,16
"510","2929淘帝","110/08/06","元大-竹科",0,20,-20
"511","5410國眾","110/08/06","元大-中壢",15,1,14
"512","5410國眾","110/08/06","凱基-台北",0,16,-16
"513","5410國眾","110/08/06","玉山-嘉義",10,0,10
"514","5410國眾","110/08/06","元大-松山",0,15,-15
"515","5410國眾","110/08/06","元大-敦南",10,0,10
"516","5410國眾","110/08/06","元大-斗信",0,10,-10
"517","5410國眾","110/08/06","永豐金-板橋",10,0,10
"518","5410國眾","110/08/06","臺銀-臺南",0,9,-9
"519","5410國眾","110/08/06","華南永昌-新莊",9,0,9
"520","5410國眾","110/08/06","新光-台中",0,9,-9
"521","5410國眾","110/08/06","華南永昌-世貿",6,0,6
"522","5410國眾","110/08/06","群益金鼎-中壢",0,7,-7
"523","5410國眾","110/08/06","亞東",5,0,5
"524","5410國眾","110/08/06","永豐金-中和",0,7,-7
"525","5410國眾","110/08/06","大昌-新店",5,0,5
"526","5410國眾","110/08/06","元大-北投",0,6,-6
"527","5410國眾","110/08/06","凱基-民權",5,0,5
"528","5410國眾","110/08/06","元大-豐原站前",0,6,-6
"529","5410國眾","110/08/06","元大-士林",5,0,5
"530","5410國眾","110/08/06","臺銀",0,5,-5
"531","5410國眾","110/08/06","元大-北三重",5,0,5
"532","5410國眾","110/08/06","台灣企銀-太平",0,5,-5
"533","5410國眾","110/08/06","永豐金-桃園",5,0,5
"534","5410國眾","110/08/06","元大-大益",0,5,-5
"535","5410國眾","110/08/06","兆豐-員林",4,0,4
"536","5410國眾","110/08/06","元大-和平",0,5,-5
"537","5410國眾","110/08/06","台新-三民",4,0,4
"538","5410國眾","110/08/06","元大-台南",0,5,-5
"539","5410國眾","110/08/06","國泰-敦南",6,2,4
"540","5410國眾","110/08/06","元大-古亭",0,5,-5
"541","2841台開","110/08/06","宏遠-館前",520,0,520
"542","2841台開","110/08/06","元富-台南",0,200,-200
"543","2841台開","110/08/06","合庫證券",193,0,193
"544","2841台開","110/08/06","元大-鹿港",0,182,-182
"545","2841台開","110/08/06","永興-台中",100,0,100
"546","2841台開","110/08/06","群益金鼎-桃園",0,132,-132
"547","2841台開","110/08/06","永豐金-竹北",78,0,78
"548","2841台開","110/08/06","中國信託-忠孝",0,130,-130
"549","2841台開","110/08/06","元大證券",50,0,50
"550","2841台開","110/08/06","元大-四維",3,116,-113
"551","2841台開","110/08/06","元大-大天母",50,0,50
"552","2841台開","110/08/06","元富-嘉義",0,50,-50
"553","2841台開","110/08/06","永豐金-敦南",50,0,50
"554","2841台開","110/08/06","元富-板橋",0,50,-50
"555","2841台開","110/08/06","日盛-園區",49,0,49
"556","2841台開","110/08/06","(牛牛牛)亞-鑫豐",0,50,-50
"557","2841台開","110/08/06","元大-前金",38,0,38
"558","2841台開","110/08/06","群益金鼎-新店",0,50,-50
"559","2841台開","110/08/06","新光-台中",32,1,31
"560","2841台開","110/08/06","統一-彰化",0,45,-45
"561","2841台開","110/08/06","華南永昌-台中",30,0,30
"562","2841台開","110/08/06","台中銀",12,50,-38
"563","2841台開","110/08/06","第一金-忠孝",20,0,20
"564","2841台開","110/08/06","國票-中和",0,30,-30
"565","2841台開","110/08/06","富邦-台北",20,0,20
"566","2841台開","110/08/06","富邦-竹北",0,29,-29
"567","2841台開","110/08/06","元大-林園",20,0,20
"568","2841台開","110/08/06","日盛-樹林",0,26,-26
"569","2841台開","110/08/06","日盛-信義",18,0,18
"570","2841台開","110/08/06","富邦-板橋",0,25,-25
"571","6207雷科","110/08/06","凱基-台北",167,49,118
"572","6207雷科","110/08/06","群益金鼎-古亭",0,80,-80
"573","6207雷科","110/08/06","摩根大通",185,102,83
"574","6207雷科","110/08/06","康和-台中",0,56,-56
"575","6207雷科","110/08/06","新光-台中",65,1,64
"576","6207雷科","110/08/06","統一-板橋",8,59,-51
"577","6207雷科","110/08/06","元大-鳳山",77,40,37
"578","6207雷科","110/08/06","臺銀",0,50,-50
"579","6207雷科","110/08/06","德信",30,0,30
"580","6207雷科","110/08/06","日盛-忠孝",0,50,-50
"581","6207雷科","110/08/06","新加坡商瑞銀",47,19,28
"582","6207雷科","110/08/06","永豐金-虎尾",0,29,-29
"583","6207雷科","110/08/06","凱基-三重",30,2,28
"584","6207雷科","110/08/06","凱基-敦北",0,23,-23
"585","6207雷科","110/08/06","凱基-三峽",33,10,23
"586","6207雷科","110/08/06","華南永昌-世貿",0,22,-22
"587","6207雷科","110/08/06","玉山-台大",25,3,22
"588","6207雷科","110/08/06","兆豐-來福",5,25,-20
"589","6207雷科","110/08/06","元大-板橋",15,0,15
"590","6207雷科","110/08/06","群益金鼎-中壢",1,21,-20
"591","6207雷科","110/08/06","元大-南京",13,0,13
"592","6207雷科","110/08/06","宏遠-台南",0,16,-16
"593","6207雷科","110/08/06","元富-大昌",12,0,12
"594","6207雷科","110/08/06","合庫-桃園",0,15,-15
"595","6207雷科","110/08/06","德信-和平",11,0,11
"596","6207雷科","110/08/06","玉山-新莊",1,16,-15
"597","6207雷科","110/08/06","元大-承德",12,1,11
"598","6207雷科","110/08/06","群益金鼎-敦南",0,15,-15
"599","6207雷科","110/08/06","台新-高雄",18,8,10
"600","6207雷科","110/08/06","台新-左楠",2,15,-13
"601","3679新至陞","110/08/06","國票-安和",10,0,10
"602","3679新至陞","110/08/06","摩根大通",1,32,-31
"603","3679新至陞","110/08/06","元大-上新莊",10,0,10
"604","3679新至陞","110/08/06","凱基-台北",2,17,-15
"605","3679新至陞","110/08/06","富邦-台北",9,0,9
"606","3679新至陞","110/08/06","台灣摩根士丹利",0,11,-11
"607","3679新至陞","110/08/06","元大-板橋",9,3,6
"608","3679新至陞","110/08/06","瑞士信貸",0,11,-11
"609","3679新至陞","110/08/06","康和-板橋",5,0,5
"610","3679新至陞","110/08/06","兆豐-員林",0,10,-10
"611","3679新至陞","110/08/06","國泰-松江",5,0,5
"612","3679新至陞","110/08/06","元大-蘆洲",0,10,-10
"613","3679新至陞","110/08/06","凱基-三峽",5,0,5
"614","3679新至陞","110/08/06","美林",1,8,-7
"615","3679新至陞","110/08/06","華南永昌-大安",5,0,5
"616","3679新至陞","110/08/06","群益金鼎-桃園",0,7,-7
"617","3679新至陞","110/08/06","台新-屏東",4,0,4
"618","3679新至陞","110/08/06","玉山-台大",0,5,-5
"619","3679新至陞","110/08/06","群益金鼎-敦南",4,0,4
"620","3679新至陞","110/08/06","日盛-新竹",0,4,-4
"621","3679新至陞","110/08/06","元大-天母",4,0,4
"622","3679新至陞","110/08/06","土銀-和平",2,5,-3
"623","3679新至陞","110/08/06","臺銀-高雄",3,0,3
"624","3679新至陞","110/08/06","元富-松德",0,3,-3
"625","3679新至陞","110/08/06","台中銀-員林",3,0,3
"626","3679新至陞","110/08/06","光和-田中",0,3,-3
"627","3679新至陞","110/08/06","北城證券",3,0,3
"628","3679新至陞","110/08/06","群益金鼎-台南",0,3,-3
"629","3679新至陞","110/08/06","元大-景美",3,0,3
"630","3679新至陞","110/08/06","元大證券",1,4,-3
"631","2727王品","110/08/06","摩根大通",65,18,47
"632","2727王品","110/08/06","美商高盛",12,258,-246
"633","2727王品","110/08/06","華南永昌",18,0,18
"634","2727王品","110/08/06","安泰",2,60,-58
"635","2727王品","110/08/06","凱基-台北",41,25,16
"636","2727王品","110/08/06","台灣摩根士丹利",10,59,-49
"637","2727王品","110/08/06","元大-中壢",20,4,16
"638","2727王品","110/08/06","台新證券",17,60,-43
"639","2727王品","110/08/06","台新-高雄",27,13,14
"640","2727王品","110/08/06","元大-桃園",0,32,-32
"641","2727王品","110/08/06","永豐金-苓雅",14,1,13
"642","2727王品","110/08/06","凱基-基隆",0,30,-30
"643","2727王品","110/08/06","永豐金-中盛",14,1,13
"644","2727王品","110/08/06","群益金鼎-台中",0,22,-22
"645","2727王品","110/08/06","第一金-安和",12,0,12
"646","2727王品","110/08/06","凱基-三重",1,20,-19
"647","2727王品","110/08/06","台新-台南",12,0,12
"648","2727王品","110/08/06","元大證券",23,42,-19
"649","2727王品","110/08/06","元大-八德",12,0,12
"650","2727王品","110/08/06","瑞士信貸",0,18,-18
"651","2727王品","110/08/06","新加坡商瑞銀",14,3,11
"652","2727王品","110/08/06","港商野村",32,50,-18
"653","2727王品","110/08/06","美林",11,1,10
"654","2727王品","110/08/06","元大-羅東",2,17,-15
"655","2727王品","110/08/06","台新-中壢",10,0,10
"656","2727王品","110/08/06","元大-彰化",3,15,-12
"657","2727王品","110/08/06","大昌-新竹",9,0,9
"658","2727王品","110/08/06","土銀-高雄",1,12,-11
"659","2727王品","110/08/06","元大-文心興安",11,2,9
"660","2727王品","110/08/06","台新-新莊",0,11,-11
"661","1570力肯","110/08/06","國票-北高雄",246,40,206
"662","1570力肯","110/08/06","富邦-高雄",0,47,-47
"663","1570力肯","110/08/06","統一-松江",43,0,43
"664","1570力肯","110/08/06","凱基-台北",55,101,-46
"665","1570力肯","110/08/06","日茂-南投",42,2,40
"666","1570力肯","110/08/06","台新證券",25,60,-35
"667","1570力肯","110/08/06","群益金鼎-三重",34,2,32
"668","1570力肯","110/08/06","元富-三重",0,32,-32
"669","1570力肯","110/08/06","華南永昌-麻豆",32,4,28
"670","1570力肯","110/08/06","台中銀-員林",0,32,-32
"671","1570力肯","110/08/06","永豐金-中和",29,2,27
"672","1570力肯","110/08/06","國泰-板橋",1,33,-32
"673","1570力肯","110/08/06","永豐金-大園",21,0,21
"674","1570力肯","110/08/06","摩根大通",83,112,-29
"675","1570力肯","110/08/06","統一-三重",25,5,20
"676","1570力肯","110/08/06","玉山-新莊",0,27,-27
"677","1570力肯","110/08/06","元富-新店",20,0,20
"678","1570力肯","110/08/06","永豐金-虎尾",0,27,-27
"679","1570力肯","110/08/06","大昌-桃園",21,1,20
"680","1570力肯","110/08/06","玉山-左營",0,25,-25
"681","1570力肯","110/08/06","康和-高雄",18,1,17
"682","1570力肯","110/08/06","富邦-仁愛",10,32,-22
"683","1570力肯","110/08/06","元富-潮州",16,0,16
"684","1570力肯","110/08/06","中國信託-忠孝",0,21,-21
"685","1570力肯","110/08/06","元富-松德",15,0,15
"686","1570力肯","110/08/06","臺銀-鳳山",4,24,-20
"687","1570力肯","110/08/06","凱基-嘉義",15,0,15
"688","1570力肯","110/08/06","台新-屏東",1,21,-20
"689","1570力肯","110/08/06","凱基-埔墘",15,0,15
"690","1570力肯","110/08/06","群益金鼎-西松",0,20,-20
"691","6180橘子","110/08/06","凱基-中山",138,3,135
"692","6180橘子","110/08/06","新光",6,37,-31
"693","6180橘子","110/08/06","富邦-高雄",18,0,18
"694","6180橘子","110/08/06","永豐金-板新",0,24,-24
"695","6180橘子","110/08/06","美商高盛",14,0,14
"696","6180橘子","110/08/06","國票-九鼎",0,20,-20
"697","6180橘子","110/08/06","富邦-板橋",14,0,14
"698","6180橘子","110/08/06","群益金鼎-古亭",0,20,-20
"699","6180橘子","110/08/06","台灣摩根士丹利",18,6,12
"700","6180橘子","110/08/06","凱基-台北",2,22,-20
"701","6180橘子","110/08/06","聯邦-雙和",11,0,11
"702","6180橘子","110/08/06","富邦-員林",1,20,-19
"703","6180橘子","110/08/06","宏遠-光隆",10,0,10
"704","6180橘子","110/08/06","富邦-基隆",0,14,-14
"705","6180橘子","110/08/06","元富-四維",10,0,10
"706","6180橘子","110/08/06","元富-永和",1,12,-11
"707","6180橘子","110/08/06","摩根大通",11,1,10
"708","6180橘子","110/08/06","玉山-台南",0,11,-11
"709","6180橘子","110/08/06","日盛-中壢",9,0,9
"710","6180橘子","110/08/06","元大-彰化民生",0,11,-11
"711","6180橘子","110/08/06","中國信託",9,0,9
"712","6180橘子","110/08/06","群益金鼎-忠孝",0,10,-10
"713","6180橘子","110/08/06","凱基-板橋",10,1,9
"714","6180橘子","110/08/06","元大-龍潭",0,10,-10
"715","6180橘子","110/08/06","日盛-景美",9,2,7
"716","6180橘子","110/08/06","元大-金華",1,11,-10
"717","6180橘子","110/08/06","瑞士信貸",7,0,7
"718","6180橘子","110/08/06","第一金-新興",0,8,-8
"719","6180橘子","110/08/06","元大-高雄",5,0,5
"720","6180橘子","110/08/06","美林",0,7,-7
"721","2390云辰","110/08/06","元大證券",203,14,189
"722","2390云辰","110/08/06","永豐金-豐原",0,174,-174
"723","2390云辰","110/08/06","美商高盛",114,7,107
"724","2390云辰","110/08/06","第一金-華江",0,83,-83
"725","2390云辰","110/08/06","華南永昌-麻豆",103,0,103
"726","2390云辰","110/08/06","凱基-台北",126,197,-71
"727","2390云辰","110/08/06","國票-安和",76,11,65
"728","2390云辰","110/08/06","摩根大通",129,187,-58
"729","2390云辰","110/08/06","港商野村",188,138,50
"730","2390云辰","110/08/06","臺銀-金山",0,50,-50
"731","2390云辰","110/08/06","元大-土城學府",102,56,46
"732","2390云辰","110/08/06","聯邦商銀",13,50,-37
"733","2390云辰","110/08/06","元富-板橋",41,0,41
"734","2390云辰","110/08/06","元大-上新莊",10,43,-33
"735","2390云辰","110/08/06","新加坡商瑞銀",47,7,40
"736","2390云辰","110/08/06","兆豐-三民",0,30,-30
"737","2390云辰","110/08/06","元大-台南",35,0,35
"738","2390云辰","110/08/06","富邦-桃園",0,30,-30
"739","2390云辰","110/08/06","凱基-林口",31,0,31
"740","2390云辰","110/08/06","國泰-敦南",33,60,-27
"741","2390云辰","110/08/06","凱基-台中",23,0,23
"742","2390云辰","110/08/06","元大-天母",1,28,-27
"743","2390云辰","110/08/06","台新-左楠",22,0,22
"744","2390云辰","110/08/06","統一-高雄",0,25,-25
"745","2390云辰","110/08/06","元大-文心",24,2,22
"746","2390云辰","110/08/06","元大-太平",0,22,-22
"747","2390云辰","110/08/06","統一-三重",22,1,21
"748","2390云辰","110/08/06","彰銀-台中",36,56,-20
"749","2390云辰","110/08/06","台灣企銀-嘉義",20,0,20
"750","2390云辰","110/08/06","統一-屏東",1,21,-20
