"","stake","date","name","buy","sell","total"
"1","2867三商壽","110/08/12","新光",292,1,291
"2","2867三商壽","110/08/12","摩根大通",53,266,-213
"3","2867三商壽","110/08/12","元大-土城永寧",200,0,200
"4","2867三商壽","110/08/12","元大-崇德",3,201,-198
"5","2867三商壽","110/08/12","合庫證券",100,0,100
"6","2867三商壽","110/08/12","美商高盛",31,159,-128
"7","2867三商壽","110/08/12","土銀",100,0,100
"8","2867三商壽","110/08/12","富邦證券",0,120,-120
"9","2867三商壽","110/08/12","臺銀-臺南",100,0,100
"10","2867三商壽","110/08/12","凱基-信義",0,117,-117
"11","2867三商壽","110/08/12","元富-古亭",100,0,100
"12","2867三商壽","110/08/12","凱基-台北",2,113,-111
"13","2867三商壽","110/08/12","元大-新莊",100,0,100
"14","2867三商壽","110/08/12","凱基-虎尾",0,100,-100
"15","2867三商壽","110/08/12","凱基",97,0,97
"16","2867三商壽","110/08/12","元大-南投",0,92,-92
"17","2867三商壽","110/08/12","元大-桃園",60,0,60
"18","2867三商壽","110/08/12","台灣摩根士丹利",0,70,-70
"19","2867三商壽","110/08/12","合庫-西台中",51,0,51
"20","2867三商壽","110/08/12","美林",8,72,-64
"21","2867三商壽","110/08/12","華南永昌-鳳山",51,1,50
"22","2867三商壽","110/08/12","新加坡商瑞銀",0,61,-61
"23","2867三商壽","110/08/12","元大-沙鹿",39,0,39
"24","2867三商壽","110/08/12","群益金鼎-台北",0,60,-60
"25","2867三商壽","110/08/12","光和",30,0,30
"26","2867三商壽","110/08/12","富邦-宜蘭",0,50,-50
"27","2867三商壽","110/08/12","元大-龍潭",30,0,30
"28","2867三商壽","110/08/12","元大-旗山",0,50,-50
"29","2867三商壽","110/08/12","永豐金-員林",30,0,30
"30","2867三商壽","110/08/12","元富-吉利",0,27,-27
"31","5521工信","110/08/12","日進",900,0,900
"32","5521工信","110/08/12","永豐金證券",14,200,-186
"33","5521工信","110/08/12","摩根大通",678,57,621
"34","5521工信","110/08/12","富邦-中壢",2,112,-110
"35","5521工信","110/08/12","國票-安和",254,20,234
"36","5521工信","110/08/12","中國信託-嘉義",0,100,-100
"37","5521工信","110/08/12","凱基-台北",194,46,148
"38","5521工信","110/08/12","元大-南屯",0,58,-58
"39","5521工信","110/08/12","日盛-中和",103,10,93
"40","5521工信","110/08/12","凱基-中壢",0,55,-55
"41","5521工信","110/08/12","新光-新竹",80,5,75
"42","5521工信","110/08/12","(牛牛牛)亞-鑫豐",1,52,-51
"43","5521工信","110/08/12","美林",69,10,59
"44","5521工信","110/08/12","台新證券",1,51,-50
"45","5521工信","110/08/12","富邦-台北",69,20,49
"46","5521工信","110/08/12","群益金鼎-崇德",0,48,-48
"47","5521工信","110/08/12","新光-台南",37,0,37
"48","5521工信","110/08/12","康和-內湖",0,46,-46
"49","5521工信","110/08/12","永豐金-鳳山",32,0,32
"50","5521工信","110/08/12","日盛-新莊",0,45,-45
"51","5521工信","110/08/12","第一金-台南",67,42,25
"52","5521工信","110/08/12","元大-旗山",1,46,-45
"53","5521工信","110/08/12","台灣企銀-台中",20,0,20
"54","5521工信","110/08/12","元大-內湖",0,45,-45
"55","5521工信","110/08/12","康和-澎湖",20,0,20
"56","5521工信","110/08/12","日盛-高雄",0,42,-42
"57","5521工信","110/08/12","凱基-三多",20,0,20
"58","5521工信","110/08/12","元大-大同",0,42,-42
"59","5521工信","110/08/12","元大-仁愛",20,0,20
"60","5521工信","110/08/12","第一金-新竹",0,40,-40
"61","1471首利","110/08/12","摩根大通",190,21,169
"62","1471首利","110/08/12","光和-溪湖",0,75,-75
"63","1471首利","110/08/12","元大-敦化",100,0,100
"64","1471首利","110/08/12","富邦-基隆",2,41,-39
"65","1471首利","110/08/12","瑞士信貸",86,0,86
"66","1471首利","110/08/12","凱基-台南",0,30,-30
"67","1471首利","110/08/12","美商高盛",51,0,51
"68","1471首利","110/08/12","元富-民權",0,29,-29
"69","1471首利","110/08/12","美林",49,0,49
"70","1471首利","110/08/12","凱基-東門",0,24,-24
"71","1471首利","110/08/12","國票-北高雄",20,0,20
"72","1471首利","110/08/12","永興-大墩",0,20,-20
"73","1471首利","110/08/12","凱基-五股",20,0,20
"74","1471首利","110/08/12","元大-土城",1,21,-20
"75","1471首利","110/08/12","永豐金-中壢",20,0,20
"76","1471首利","110/08/12","凱基-內埔",1,20,-19
"77","1471首利","110/08/12","凱基-台北",16,0,16
"78","1471首利","110/08/12","中國信託",0,17,-17
"79","1471首利","110/08/12","台新證券",16,3,13
"80","1471首利","110/08/12","華南永昌-中正",2,19,-17
"81","1471首利","110/08/12","兆豐-員林",15,3,12
"82","1471首利","110/08/12","中國信託-文心",0,16,-16
"83","1471首利","110/08/12","中國信託-永康",10,0,10
"84","1471首利","110/08/12","兆豐-台南",1,17,-16
"85","1471首利","110/08/12","華南永昌-麻豆",11,1,10
"86","1471首利","110/08/12","凱基-新豐",0,15,-15
"87","1471首利","110/08/12","元大-新營",10,0,10
"88","1471首利","110/08/12","永豐金-新莊",0,15,-15
"89","1471首利","110/08/12","新加坡商瑞銀",6,0,6
"90","1471首利","110/08/12","凱基-彰化",6,20,-14
"91","2883開發金","110/08/12","美林",2636,759,1877
"92","2883開發金","110/08/12","摩根大通",28,5087,-5059
"93","2883開發金","110/08/12","華南永昌",889,3,886
"94","2883開發金","110/08/12","新加坡商瑞銀",111,2619,-2508
"95","2883開發金","110/08/12","美商高盛",1037,275,762
"96","2883開發金","110/08/12","富邦-彰化",7,809,-802
"97","2883開發金","110/08/12","凱基-員林",600,0,600
"98","2883開發金","110/08/12","瑞士信貸",773,1528,-755
"99","2883開發金","110/08/12","日盛-中壢",532,9,523
"100","2883開發金","110/08/12","港商野村",2,600,-598
"101","2883開發金","110/08/12","元大證券",631,169,462
"102","2883開發金","110/08/12","宏遠-民生",0,500,-500
"103","2883開發金","110/08/12","玉山-高雄",457,5,452
"104","2883開發金","110/08/12","元大-桃園",19,504,-485
"105","2883開發金","110/08/12","元大-員林",435,0,435
"106","2883開發金","110/08/12","台灣摩根士丹利",1506,1983,-477
"107","2883開發金","110/08/12","永豐金-高雄",343,20,323
"108","2883開發金","110/08/12","永豐金-台南",29,495,-466
"109","2883開發金","110/08/12","日盛-大墩",321,0,321
"110","2883開發金","110/08/12","元大-斗六",4,457,-453
"111","2883開發金","110/08/12","台新-三民",338,19,319
"112","2883開發金","110/08/12","群益金鼎-桃園",36,314,-278
"113","2883開發金","110/08/12","國泰-敦南",468,170,298
"114","2883開發金","110/08/12","群益金鼎-開元",15,221,-206
"115","2883開發金","110/08/12","兆豐-北高雄",258,6,252
"116","2883開發金","110/08/12","土銀-台中",1,202,-201
"117","2883開發金","110/08/12","安泰",272,53,219
"118","2883開發金","110/08/12","凱基-台中",12,204,-192
"119","2883開發金","110/08/12","群益金鼎-彰化",218,4,214
"120","2883開發金","110/08/12","永豐金-中盛",55,246,-191
"121","6205詮欣","110/08/12","元大-新竹經國",12,0,12
"122","6205詮欣","110/08/12","元大-善化",0,20,-20
"123","6205詮欣","110/08/12","臺銀-民權",8,0,8
"124","6205詮欣","110/08/12","瑞士信貸",0,4,-4
"125","6205詮欣","110/08/12","聯邦-嘉義",5,0,5
"126","6205詮欣","110/08/12","群益金鼎-板橋",0,4,-4
"127","6205詮欣","110/08/12","中國信託-三重",3,0,3
"128","6205詮欣","110/08/12","元大-屏東民生",0,4,-4
"129","6205詮欣","110/08/12","德信-新營",3,0,3
"130","6205詮欣","110/08/12","臺銀-高雄",0,3,-3
"131","6205詮欣","110/08/12","合庫-彰化",2,0,2
"132","6205詮欣","110/08/12","凱基-南崁",0,3,-3
"133","6205詮欣","110/08/12","新光-台南",2,0,2
"134","6205詮欣","110/08/12","元大-華山",0,3,-3
"135","6205詮欣","110/08/12","玉山-雙和",2,0,2
"136","6205詮欣","110/08/12","摩根大通",0,2,-2
"137","6205詮欣","110/08/12","元大-南投",2,0,2
"138","6205詮欣","110/08/12","兆豐-新營",0,1,-1
"139","6205詮欣","110/08/12","統一-三重",1,0,1
"140","6205詮欣","110/08/12","兆豐-中壢",0,1,-1
"141","6205詮欣","110/08/12","元富-安南",1,0,1
"142","6205詮欣","110/08/12","凱基-台北",0,1,-1
"143","6205詮欣","110/08/12","豐農",1,0,1
"144","6205詮欣","110/08/12","凱基-竹科",0,1,-1
"145","6205詮欣","110/08/12","北城證券",1,0,1
"146","6205詮欣","110/08/12","富邦-高雄",0,1,-1
"147","6205詮欣","110/08/12","玉山-嘉義",1,0,1
"148","6205詮欣","110/08/12","元大-路竹",0,1,-1
"149","6205詮欣","110/08/12","凱基-五股",1,0,1
"150","6205詮欣","110/08/12","元大-屏南",0,1,-1
"151","1540喬福","110/08/12","元富-中原",20,0,20
"152","1540喬福","110/08/12","永豐金-豐原",0,64,-64
"153","1540喬福","110/08/12","台中銀",17,0,17
"154","1540喬福","110/08/12","統一-新台中",0,19,-19
"155","1540喬福","110/08/12","凱基-中壢",11,0,11
"156","1540喬福","110/08/12","凱基-興隆",0,7,-7
"157","1540喬福","110/08/12","凱基-台中",8,0,8
"158","1540喬福","110/08/12","玉山-城中",0,6,-6
"159","1540喬福","110/08/12","亞東",5,0,5
"160","1540喬福","110/08/12","富邦-台北",1,5,-4
"161","1540喬福","110/08/12","群益金鼎-古亭",5,0,5
"162","1540喬福","110/08/12","元大-左營",0,2,-2
"163","1540喬福","110/08/12","美林",4,0,4
"164","1540喬福","110/08/12","國泰-敦南",0,1,-1
"165","1540喬福","110/08/12","兆豐-鹿港",4,0,4
"166","1540喬福","110/08/12","凱基-基隆",0,1,-1
"167","1540喬福","110/08/12","港商法國興業",3,0,3
"168","1540喬福","110/08/12","凱基-大里",0,1,-1
"169","1540喬福","110/08/12","凱基-苗栗",3,0,3
"170","1540喬福","110/08/12","元富-中壢",0,0,0
"171","1540喬福","110/08/12","國票-台中",2,0,2
"172","1540喬福","110/08/12","凱基-竹北",0,0,0
"173","1540喬福","110/08/12","兆豐-高雄",2,0,2
"174","1540喬福","110/08/12","凱基-台北",1,1,0
"175","1540喬福","110/08/12","元富-緯城",2,0,2
"176","1540喬福","110/08/12","華南永昌-南京",0,0,0
"177","1540喬福","110/08/12","華南永昌-台中",2,0,2
"178","1540喬福","110/08/12","富邦-高雄",0,0,0
"179","1540喬福","110/08/12","富邦-中壢",2,0,2
"180","1540喬福","110/08/12","富邦-三重",0,0,0
"181","2888新光金","110/08/12","群益金鼎-崇德",2118,3,2115
"182","2888新光金","110/08/12","國票-台東",12,1903,-1891
"183","2888新光金","110/08/12","國票-九鼎",2175,141,2034
"184","2888新光金","110/08/12","永豐金-竹科",0,1186,-1186
"185","2888新光金","110/08/12","元大-忠孝鼎富",986,4,982
"186","2888新光金","110/08/12","群益金鼎-民權",1,1049,-1048
"187","2888新光金","110/08/12","台灣摩根士丹利",992,319,673
"188","2888新光金","110/08/12","凱基-台北",1172,2195,-1023
"189","2888新光金","110/08/12","港商法國興業",670,0,670
"190","2888新光金","110/08/12","摩根大通",829,1704,-875
"191","2888新光金","110/08/12","富邦-內湖",605,0,605
"192","2888新光金","110/08/12","美林",248,668,-420
"193","2888新光金","110/08/12","華南永昌-台中",600,3,597
"194","2888新光金","110/08/12","群益金鼎-鳳山",2,404,-402
"195","2888新光金","110/08/12","元大-豐原站前",556,38,518
"196","2888新光金","110/08/12","新加坡商瑞銀",470,857,-387
"197","2888新光金","110/08/12","瑞士信貸",643,139,504
"198","2888新光金","110/08/12","香港上海匯豐",22,270,-248
"199","2888新光金","110/08/12","元大-永和",505,8,497
"200","2888新光金","110/08/12","合庫證券",2,232,-230
"201","2888新光金","110/08/12","法銀巴黎",498,9,489
"202","2888新光金","110/08/12","元大-大同",0,214,-214
"203","2888新光金","110/08/12","福邦-新竹",430,0,430
"204","2888新光金","110/08/12","元富-文心",2,210,-208
"205","2888新光金","110/08/12","凱基-鳳山",379,3,376
"206","2888新光金","110/08/12","新光",154,346,-192
"207","2888新光金","110/08/12","康和-內湖",306,7,299
"208","2888新光金","110/08/12","元富-城東",28,215,-187
"209","2888新光金","110/08/12","元大-樹林",300,10,290
"210","2888新光金","110/08/12","富邦-彰化",23,201,-178
"211","1340勝悅","110/08/12","國泰-台中",11,0,11
"212","1340勝悅","110/08/12","中國信託",0,76,-76
"213","1340勝悅","110/08/12","元大-博愛",10,0,10
"214","1340勝悅","110/08/12","日盛-八德",0,14,-14
"215","1340勝悅","110/08/12","凱基-台北",8,1,7
"216","1340勝悅","110/08/12","摩根大通",3,13,-10
"217","1340勝悅","110/08/12","臺灣企銀-埔墘",5,0,5
"218","1340勝悅","110/08/12","日盛-木柵",0,7,-7
"219","1340勝悅","110/08/12","第一金-新竹",5,0,5
"220","1340勝悅","110/08/12","元大-路竹",0,7,-7
"221","1340勝悅","110/08/12","元富-新興",5,0,5
"222","1340勝悅","110/08/12","群益金鼎-內湖",0,4,-4
"223","1340勝悅","110/08/12","兆豐-台南",5,0,5
"224","1340勝悅","110/08/12","凱基-彰化",0,4,-4
"225","1340勝悅","110/08/12","玉山-士林",5,0,5
"226","1340勝悅","110/08/12","元大-大天母",0,3,-3
"227","1340勝悅","110/08/12","華南永昌-新莊",5,0,5
"228","1340勝悅","110/08/12","統一-城中",4,6,-2
"229","1340勝悅","110/08/12","美商高盛",4,0,4
"230","1340勝悅","110/08/12","兆豐-新竹",0,2,-2
"231","1340勝悅","110/08/12","港商法國興業",3,0,3
"232","1340勝悅","110/08/12","台新證券",0,2,-2
"233","1340勝悅","110/08/12","台新-台中",3,0,3
"234","1340勝悅","110/08/12","富邦-台南",0,2,-2
"235","1340勝悅","110/08/12","玉山-台大",3,0,3
"236","1340勝悅","110/08/12","元大-新營",0,2,-2
"237","1340勝悅","110/08/12","國泰-高雄",3,0,3
"238","1340勝悅","110/08/12","瑞士信貸",2,3,-1
"239","1340勝悅","110/08/12","元大-竹南",3,0,3
"240","1340勝悅","110/08/12","永豐金-中正",0,1,-1
"241","6246臺龍","110/08/12","元大-南投",75,0,75
"242","6246臺龍","110/08/12","統一-台中",0,58,-58
"243","6246臺龍","110/08/12","元大-台北",32,0,32
"244","6246臺龍","110/08/12","合庫-台中",1,41,-40
"245","6246臺龍","110/08/12","元富-世貿",30,2,28
"246","6246臺龍","110/08/12","凱基-市府",0,40,-40
"247","6246臺龍","110/08/12","凱基-永和",25,0,25
"248","6246臺龍","110/08/12","日盛-木柵",4,33,-29
"249","6246臺龍","110/08/12","元富-新店",18,3,15
"250","6246臺龍","110/08/12","凱基-台北",1,29,-28
"251","6246臺龍","110/08/12","華南永昌-忠孝",12,0,12
"252","6246臺龍","110/08/12","永豐金-內湖",2,30,-28
"253","6246臺龍","110/08/12","永豐金-復興",12,0,12
"254","6246臺龍","110/08/12","元大-中壢",23,44,-21
"255","6246臺龍","110/08/12","富邦-敦南",11,0,11
"256","6246臺龍","110/08/12","永全-南崁",0,20,-20
"257","6246臺龍","110/08/12","元大證券",13,2,11
"258","6246臺龍","110/08/12","國泰-敦南",7,27,-20
"259","6246臺龍","110/08/12","大慶-蘆洲",10,0,10
"260","6246臺龍","110/08/12","大昌",0,18,-18
"261","6246臺龍","110/08/12","元大-新莊",10,0,10
"262","6246臺龍","110/08/12","新光-台中",3,17,-14
"263","6246臺龍","110/08/12","元大-林園",10,1,9
"264","6246臺龍","110/08/12","元大-金門",3,16,-13
"265","6246臺龍","110/08/12","元大-西屯",10,2,8
"266","6246臺龍","110/08/12","永全",0,10,-10
"267","6246臺龍","110/08/12","兆豐-公益",7,0,7
"268","6246臺龍","110/08/12","元大-新店中正",0,10,-10
"269","6246臺龍","110/08/12","群益金鼎-開元",7,0,7
"270","6246臺龍","110/08/12","日盛-八德",0,8,-8
"271","00715L期街口布蘭特正2","110/08/12","元大證券",13644,167,13477
"272","00715L期街口布蘭特正2","110/08/12","元大-林森",0,780,-780
"273","00715L期街口布蘭特正2","110/08/12","永豐金證券",2789,2,2787
"274","00715L期街口布蘭特正2","110/08/12","台新-新營",12,600,-588
"275","00715L期街口布蘭特正2","110/08/12","統一",2972,199,2773
"276","00715L期街口布蘭特正2","110/08/12","台中銀",10,592,-582
"277","00715L期街口布蘭特正2","110/08/12","元富",1524,5,1519
"278","00715L期街口布蘭特正2","110/08/12","群益金鼎-屏東",0,575,-575
"279","00715L期街口布蘭特正2","110/08/12","統一-嘉義",466,26,440
"280","00715L期街口布蘭特正2","110/08/12","元大-北港",10,505,-495
"281","00715L期街口布蘭特正2","110/08/12","群益金鼎-延平",300,4,296
"282","00715L期街口布蘭特正2","110/08/12","兆豐-台中",0,476,-476
"283","00715L期街口布蘭特正2","110/08/12","台新-三民",300,24,276
"284","00715L期街口布蘭特正2","110/08/12","宏遠-桃園",0,438,-438
"285","00715L期街口布蘭特正2","110/08/12","群益金鼎-瑞豐",210,14,196
"286","00715L期街口布蘭特正2","110/08/12","台新-台中",65,474,-409
"287","00715L期街口布蘭特正2","110/08/12","港商野村",320,140,180
"288","00715L期街口布蘭特正2","110/08/12","元大-西螺",3,382,-379
"289","00715L期街口布蘭特正2","110/08/12","台新-松江",200,35,165
"290","00715L期街口布蘭特正2","110/08/12","凱基-城中",0,370,-370
"291","00715L期街口布蘭特正2","110/08/12","合庫證券",121,0,121
"292","00715L期街口布蘭特正2","110/08/12","元大-歸仁",20,384,-364
"293","00715L期街口布蘭特正2","110/08/12","元大-旗山",120,1,119
"294","00715L期街口布蘭特正2","110/08/12","群益金鼎-古亭",13,367,-354
"295","00715L期街口布蘭特正2","110/08/12","富邦-員林",362,251,111
"296","00715L期街口布蘭特正2","110/08/12","元大-竹科",6,327,-321
"297","00715L期街口布蘭特正2","110/08/12","日盛-木柵",130,22,108
"298","00715L期街口布蘭特正2","110/08/12","臺銀-新竹",0,320,-320
"299","00715L期街口布蘭特正2","110/08/12","大慶-苗栗",107,2,105
"300","00715L期街口布蘭特正2","110/08/12","統一-台中",7,325,-318
"301","8941關中","110/08/12","元大-金華",1,0,1
"302","8941關中","110/08/12","凱基-士林",0,2,-2
"303","8941關中","110/08/12","元大-桃興",1,0,1
"304","8941關中","110/08/12","(牛牛牛)亞-鑫豐",0,0,0
"305","8941關中","110/08/12","(牛牛牛)亞-鑫豐",0,0,0
"306","8941關中","110/08/12","台新-三民",0,0,0
"307","8941關中","110/08/12","台新-三民",0,0,0
"308","8941關中","110/08/12","國泰-忠孝",1,1,0
"309","8941關中","110/08/12","國泰-忠孝",1,1,0
"310","8941關中","110/08/12","凱基-市府",1,1,0
"311","8941關中","110/08/12","凱基-市府",1,1,0
"312","8941關中","110/08/12","",NA,NA,NA
"313","8941關中","110/08/12","",NA,NA,NA
"314","8941關中","110/08/12","",NA,NA,NA
"315","8941關中","110/08/12","",NA,NA,NA
"316","8941關中","110/08/12","",NA,NA,NA
"317","8941關中","110/08/12","",NA,NA,NA
"318","8941關中","110/08/12","",NA,NA,NA
"319","8941關中","110/08/12","",NA,NA,NA
"320","8941關中","110/08/12","",NA,NA,NA
"321","8941關中","110/08/12","",NA,NA,NA
"322","8941關中","110/08/12","",NA,NA,NA
"323","8941關中","110/08/12","",NA,NA,NA
"324","8941關中","110/08/12","",NA,NA,NA
"325","8941關中","110/08/12","",NA,NA,NA
"326","8941關中","110/08/12","",NA,NA,NA
"327","8941關中","110/08/12","",NA,NA,NA
"328","8941關中","110/08/12","",NA,NA,NA
"329","8941關中","110/08/12","",NA,NA,NA
"330","8941關中","110/08/12","",NA,NA,NA
"331","8936國統","110/08/12","台新-高雄",410,32,378
"332","8936國統","110/08/12","日盛-景美",0,70,-70
"333","8936國統","110/08/12","元富-林園",65,0,65
"334","8936國統","110/08/12","臺銀-金山",0,55,-55
"335","8936國統","110/08/12","摩根大通",64,12,52
"336","8936國統","110/08/12","元大-敦南",0,32,-32
"337","8936國統","110/08/12","新加坡商瑞銀",53,31,22
"338","8936國統","110/08/12","華南永昌-南京",0,30,-30
"339","8936國統","110/08/12","元大-莒光",19,0,19
"340","8936國統","110/08/12","玉山-台南",0,23,-23
"341","8936國統","110/08/12","第一金-高雄",10,0,10
"342","8936國統","110/08/12","兆豐-岡山",1,21,-20
"343","8936國統","110/08/12","統一-高雄",10,0,10
"344","8936國統","110/08/12","統一-新竹",0,14,-14
"345","8936國統","110/08/12","元富-桃園",10,0,10
"346","8936國統","110/08/12","國泰-敦南",1,14,-13
"347","8936國統","110/08/12","台新-台南",10,0,10
"348","8936國統","110/08/12","台灣摩根士丹利",2,14,-12
"349","8936國統","110/08/12","元大-竹山",9,0,9
"350","8936國統","110/08/12","凱基-台南",3,14,-11
"351","8936國統","110/08/12","港商野村",15,8,7
"352","8936國統","110/08/12","凱基-高美館",0,11,-11
"353","8936國統","110/08/12","華南永昌-高雄",6,0,6
"354","8936國統","110/08/12","元大-博愛",0,10,-10
"355","8936國統","110/08/12","土銀-高雄",5,0,5
"356","8936國統","110/08/12","第一金-新興",0,9,-9
"357","8936國統","110/08/12","大昌-安康",5,0,5
"358","8936國統","110/08/12","元大-沙鹿",0,9,-9
"359","8936國統","110/08/12","兆豐-斗南",5,0,5
"360","8936國統","110/08/12","元大-左營",3,12,-9
"361","6226光鼎","110/08/12","摩根大通",1930,830,1100
"362","6226光鼎","110/08/12","凱基-台北",224,675,-451
"363","6226光鼎","110/08/12","第一金-大稻埕",418,0,418
"364","6226光鼎","110/08/12","統一-高雄",1,353,-352
"365","6226光鼎","110/08/12","台新-中壢",239,3,236
"366","6226光鼎","110/08/12","美林",153,291,-138
"367","6226光鼎","110/08/12","元大-文心興安",223,27,196
"368","6226光鼎","110/08/12","大昌",88,225,-137
"369","6226光鼎","110/08/12","富邦-陽明",112,9,103
"370","6226光鼎","110/08/12","元大-土城永寧",3,126,-123
"371","6226光鼎","110/08/12","華南永昌-高雄",96,13,83
"372","6226光鼎","110/08/12","元大-北屯",16,107,-91
"373","6226光鼎","110/08/12","永豐金-南投",95,13,82
"374","6226光鼎","110/08/12","統一-板橋",0,88,-88
"375","6226光鼎","110/08/12","永豐金-中盛",102,26,76
"376","6226光鼎","110/08/12","群益金鼎-東大",5,91,-86
"377","6226光鼎","110/08/12","元大證券",90,15,75
"378","6226光鼎","110/08/12","富邦-南屯",40,111,-71
"379","6226光鼎","110/08/12","元大-屏東民生",85,15,70
"380","6226光鼎","110/08/12","新光",240,309,-69
"381","6226光鼎","110/08/12","台灣摩根士丹利",93,32,61
"382","6226光鼎","110/08/12","台新-高雄",75,143,-68
"383","6226光鼎","110/08/12","富邦-高雄",121,66,55
"384","6226光鼎","110/08/12","日盛證券",10,76,-66
"385","6226光鼎","110/08/12","臺銀",106,54,52
"386","6226光鼎","110/08/12","國泰-敦南",391,457,-66
"387","6226光鼎","110/08/12","台灣企銀-三民",58,8,50
"388","6226光鼎","110/08/12","富邦-台北",31,97,-66
"389","6226光鼎","110/08/12","元大-新竹",250,200,50
"390","6226光鼎","110/08/12","凱基-永和",30,91,-61
"391","2363矽統","110/08/12","元大-佳里",810,33,777
"392","2363矽統","110/08/12","凱基-台北",1783,3582,-1799
"393","2363矽統","110/08/12","元大-大同",455,30,425
"394","2363矽統","110/08/12","台灣摩根士丹利",0,959,-959
"395","2363矽統","110/08/12","富邦-建國",503,100,403
"396","2363矽統","110/08/12","華南永昌-斗六",90,1037,-947
"397","2363矽統","110/08/12","北城證券",434,34,400
"398","2363矽統","110/08/12","群益金鼎-敦南",27,331,-304
"399","2363矽統","110/08/12","元大-開元",321,33,288
"400","2363矽統","110/08/12","美商高盛",57,327,-270
"401","2363矽統","110/08/12","台新-三民",287,84,203
"402","2363矽統","110/08/12","大慶-蘆洲",26,233,-207
"403","2363矽統","110/08/12","台中銀",157,23,134
"404","2363矽統","110/08/12","新光-台南",130,324,-194
"405","2363矽統","110/08/12","元大-新竹經國",152,21,131
"406","2363矽統","110/08/12","美林",927,1076,-149
"407","2363矽統","110/08/12","台新-高雄",449,322,127
"408","2363矽統","110/08/12","華南永昌-頭份",187,328,-141
"409","2363矽統","110/08/12","華南永昌",254,163,91
"410","2363矽統","110/08/12","陽信-石牌",157,276,-119
"411","2363矽統","110/08/12","凱基-城中",98,13,85
"412","2363矽統","110/08/12","兆豐證券",0,104,-104
"413","2363矽統","110/08/12","台中銀-台北",85,4,81
"414","2363矽統","110/08/12","元大-忠孝鼎富",32,132,-100
"415","2363矽統","110/08/12","元大-新莊",140,60,80
"416","2363矽統","110/08/12","元大-鳳中",85,185,-100
"417","2363矽統","110/08/12","玉山-台中",116,41,75
"418","2363矽統","110/08/12","永豐金-桃盛",24,119,-95
"419","2363矽統","110/08/12","元富-彰化",88,23,65
"420","2363矽統","110/08/12","元大證券",51,145,-94
"421","8112至上","110/08/12","摩根大通",1492,130,1362
"422","8112至上","110/08/12","永豐金-台中",0,274,-274
"423","8112至上","110/08/12","美林",712,13,699
"424","8112至上","110/08/12","永豐金證券",8,272,-264
"425","8112至上","110/08/12","台灣摩根士丹利",696,41,655
"426","8112至上","110/08/12","群益金鼎-基隆",0,249,-249
"427","8112至上","110/08/12","凱基-台北",582,82,500
"428","8112至上","110/08/12","國票-長城",2,228,-226
"429","8112至上","110/08/12","新加坡商瑞銀",359,18,341
"430","8112至上","110/08/12","新光-新竹",19,208,-189
"431","8112至上","110/08/12","花旗環球",266,0,266
"432","8112至上","110/08/12","玉山-嘉義",20,168,-148
"433","8112至上","110/08/12","富邦-仁愛",231,25,206
"434","8112至上","110/08/12","元大-高雄",0,131,-131
"435","8112至上","110/08/12","美商高盛",190,3,187
"436","8112至上","110/08/12","臺灣企銀-桃園",128,251,-123
"437","8112至上","110/08/12","凱基-三重",121,6,115
"438","8112至上","110/08/12","元大-府城",0,115,-115
"439","8112至上","110/08/12","港商野村",198,88,110
"440","8112至上","110/08/12","台新證券",100,203,-103
"441","8112至上","110/08/12","國票-中港",101,0,101
"442","8112至上","110/08/12","康和-板橋",5,106,-101
"443","8112至上","110/08/12","日盛-新竹",80,3,77
"444","8112至上","110/08/12","元大-北成功",0,101,-101
"445","8112至上","110/08/12","兆豐-斗南",71,8,63
"446","8112至上","110/08/12","元大-永和",5,88,-83
"447","8112至上","110/08/12","大慶",63,1,62
"448","8112至上","110/08/12","群益金鼎-內湖",0,80,-80
"449","8112至上","110/08/12","群益金鼎-竹南",57,1,56
"450","8112至上","110/08/12","元大-南勢角",0,80,-80
"451","1570力肯","110/08/12","台新證券",91,15,76
"452","1570力肯","110/08/12","國票-北高雄",2,361,-359
"453","1570力肯","110/08/12","元大-南投",81,5,76
"454","1570力肯","110/08/12","新光",95,222,-127
"455","1570力肯","110/08/12","永全-南崁",94,20,74
"456","1570力肯","110/08/12","(牛牛牛)亞-鑫豐",28,120,-92
"457","1570力肯","110/08/12","日盛-忠孝",57,0,57
"458","1570力肯","110/08/12","華南永昌-高雄",0,52,-52
"459","1570力肯","110/08/12","永豐金-北高雄",55,0,55
"460","1570力肯","110/08/12","群益金鼎-三重",0,42,-42
"461","1570力肯","110/08/12","中國信託-高雄",72,22,50
"462","1570力肯","110/08/12","日盛-八德",2,39,-37
"463","1570力肯","110/08/12","凱基-天母",49,0,49
"464","1570力肯","110/08/12","新光-台中",130,167,-37
"465","1570力肯","110/08/12","新光-台南",56,18,38
"466","1570力肯","110/08/12","日盛-樹林",1,31,-30
"467","1570力肯","110/08/12","兆豐-嘉義",35,0,35
"468","1570力肯","110/08/12","元大-竹北",0,30,-30
"469","1570力肯","110/08/12","國票-天祥",32,1,31
"470","1570力肯","110/08/12","元大-楊梅",6,35,-29
"471","1570力肯","110/08/12","國泰-松江",81,51,30
"472","1570力肯","110/08/12","元大-桃興",4,32,-28
"473","1570力肯","110/08/12","元大-新店中正",33,3,30
"474","1570力肯","110/08/12","亞東-台中",0,26,-26
"475","1570力肯","110/08/12","統一",48,21,27
"476","1570力肯","110/08/12","永豐金-屏東",5,30,-25
"477","1570力肯","110/08/12","國票-內壢",26,0,26
"478","1570力肯","110/08/12","國泰-館前",0,24,-24
"479","1570力肯","110/08/12","元大-大益",27,1,26
"480","1570力肯","110/08/12","摩根大通",173,193,-20
"481","2929淘帝","110/08/12","摩根大通",47,0,47
"482","2929淘帝","110/08/12","華南永昌-彰化",0,30,-30
"483","2929淘帝","110/08/12","宏遠-館前",40,0,40
"484","2929淘帝","110/08/12","第一金-大稻埕",0,10,-10
"485","2929淘帝","110/08/12","富邦-高雄",16,0,16
"486","2929淘帝","110/08/12","統一-敦南",0,10,-10
"487","2929淘帝","110/08/12","兆豐-內湖",15,0,15
"488","2929淘帝","110/08/12","玉山-台南",0,10,-10
"489","2929淘帝","110/08/12","港商野村",29,15,14
"490","2929淘帝","110/08/12","元大-花蓮",0,10,-10
"491","2929淘帝","110/08/12","元富-台南",10,0,10
"492","2929淘帝","110/08/12","凱基-台中",0,9,-9
"493","2929淘帝","110/08/12","豐農",10,0,10
"494","2929淘帝","110/08/12","群益金鼎-潭子",0,8,-8
"495","2929淘帝","110/08/12","群益金鼎-三重",10,0,10
"496","2929淘帝","110/08/12","新加坡商瑞銀",10,17,-7
"497","2929淘帝","110/08/12","永豐金證券",10,0,10
"498","2929淘帝","110/08/12","新光-高雄",0,7,-7
"499","2929淘帝","110/08/12","永豐金-敦南",10,0,10
"500","2929淘帝","110/08/12","亞東-板橋",0,6,-6
"501","2929淘帝","110/08/12","凱基-八德",6,0,6
"502","2929淘帝","110/08/12","元富-中港",0,6,-6
"503","2929淘帝","110/08/12","台新-新莊",5,0,5
"504","2929淘帝","110/08/12","國泰-敦南",1,7,-6
"505","2929淘帝","110/08/12","群益金鼎-中山",5,0,5
"506","2929淘帝","110/08/12","永豐金-市政",0,6,-6
"507","2929淘帝","110/08/12","凱基-幸福",5,0,5
"508","2929淘帝","110/08/12","永豐金-中盛",10,16,-6
"509","2929淘帝","110/08/12","元富-新竹",4,0,4
"510","2929淘帝","110/08/12","台新-三民",0,5,-5
"511","5410國眾","110/08/12","凱基-八德",23,0,23
"512","5410國眾","110/08/12","國泰-敦南",1,101,-100
"513","5410國眾","110/08/12","元大-大灣",11,0,11
"514","5410國眾","110/08/12","第一金-華江",0,27,-27
"515","5410國眾","110/08/12","合庫-新竹",10,0,10
"516","5410國眾","110/08/12","元大-竹科",0,17,-17
"517","5410國眾","110/08/12","凱基-虎尾",10,0,10
"518","5410國眾","110/08/12","元大-歸仁",1,15,-14
"519","5410國眾","110/08/12","富邦-竹北",10,0,10
"520","5410國眾","110/08/12","日盛-八德",0,10,-10
"521","5410國眾","110/08/12","玉山-新莊",9,0,9
"522","5410國眾","110/08/12","華南永昌-潮州",0,10,-10
"523","5410國眾","110/08/12","玉山-台大",8,0,8
"524","5410國眾","110/08/12","富邦-板橋",0,7,-7
"525","5410國眾","110/08/12","凱基-桃園",8,0,8
"526","5410國眾","110/08/12","凱基-高雄",0,6,-6
"527","5410國眾","110/08/12","日盛-永康",7,0,7
"528","5410國眾","110/08/12","元大-忠孝",0,6,-6
"529","5410國眾","110/08/12","玉山-雙和",7,0,7
"530","5410國眾","110/08/12","凱基-汐止",0,5,-5
"531","5410國眾","110/08/12","元大-彰化",7,0,7
"532","5410國眾","110/08/12","凱基-台北",0,5,-5
"533","5410國眾","110/08/12","元大-崇德",7,0,7
"534","5410國眾","110/08/12","元富-花蓮",0,4,-4
"535","5410國眾","110/08/12","國泰-館前",6,0,6
"536","5410國眾","110/08/12","凱基-岡山",0,4,-4
"537","5410國眾","110/08/12","國泰-板橋",8,2,6
"538","5410國眾","110/08/12","瑞士信貸",0,3,-3
"539","5410國眾","110/08/12","元富-桃園",5,0,5
"540","5410國眾","110/08/12","富邦-台中",0,3,-3
"541","2841台開","110/08/12","宏遠-館前",370,0,370
"542","2841台開","110/08/12","永豐金-敦南",4,134,-130
"543","2841台開","110/08/12","永豐金-豐原",94,0,94
"544","2841台開","110/08/12","港商野村",0,85,-85
"545","2841台開","110/08/12","富邦-北港",53,0,53
"546","2841台開","110/08/12","國泰-忠孝",1,40,-39
"547","2841台開","110/08/12","新光-台中",20,0,20
"548","2841台開","110/08/12","富邦-仁愛",0,38,-38
"549","2841台開","110/08/12","凱基-高美館",20,0,20
"550","2841台開","110/08/12","新加坡商瑞銀",0,27,-27
"551","2841台開","110/08/12","元大-左營",20,0,20
"552","2841台開","110/08/12","統一-嘉義",0,21,-21
"553","2841台開","110/08/12","元大-基隆孝二",11,0,11
"554","2841台開","110/08/12","日盛-忠孝",0,20,-20
"555","2841台開","110/08/12","元大-路竹",10,0,10
"556","2841台開","110/08/12","日盛-中壢",0,20,-20
"557","2841台開","110/08/12","華南永昌-虎尾",9,0,9
"558","2841台開","110/08/12","宏遠-桃園",0,20,-20
"559","2841台開","110/08/12","康和-台北",6,0,6
"560","2841台開","110/08/12","群益金鼎-南京",0,20,-20
"561","2841台開","110/08/12","致和-東門",5,0,5
"562","2841台開","110/08/12","合庫-基隆",0,18,-18
"563","2841台開","110/08/12","元大-虎尾",5,0,5
"564","2841台開","110/08/12","日盛證券",0,17,-17
"565","2841台開","110/08/12","元大-莒光",5,0,5
"566","2841台開","110/08/12","元大-歸仁",0,15,-15
"567","2841台開","110/08/12","永豐金-桃園",5,0,5
"568","2841台開","110/08/12","新光",10,21,-11
"569","2841台開","110/08/12","新光-台南",4,0,4
"570","2841台開","110/08/12","群益金鼎-天母",0,11,-11
"571","6207雷科","110/08/12","摩根大通",125,11,114
"572","6207雷科","110/08/12","凱基-復興",0,120,-120
"573","6207雷科","110/08/12","凱基-台北",96,1,95
"574","6207雷科","110/08/12","元大-鳳山",0,62,-62
"575","6207雷科","110/08/12","美林",38,3,35
"576","6207雷科","110/08/12","日盛證券",0,56,-56
"577","6207雷科","110/08/12","兆豐-南京",30,0,30
"578","6207雷科","110/08/12","日盛-忠孝",0,48,-48
"579","6207雷科","110/08/12","港商野村",27,1,26
"580","6207雷科","110/08/12","日盛-桃園",0,11,-11
"581","6207雷科","110/08/12","元大-南京",20,0,20
"582","6207雷科","110/08/12","中國信託-高雄",0,10,-10
"583","6207雷科","110/08/12","臺銀-臺南",12,0,12
"584","6207雷科","110/08/12","元大-土城永寧",0,10,-10
"585","6207雷科","110/08/12","瑞士信貸",11,0,11
"586","6207雷科","110/08/12","凱基-湖口",0,8,-8
"587","6207雷科","110/08/12","新加坡商瑞銀",20,11,9
"588","6207雷科","110/08/12","富邦-敦南",0,7,-7
"589","6207雷科","110/08/12","第一金-新興",6,0,6
"590","6207雷科","110/08/12","凱基-三峽",0,6,-6
"591","6207雷科","110/08/12","群益金鼎-士林",6,0,6
"592","6207雷科","110/08/12","永豐金-高雄",0,6,-6
"593","6207雷科","110/08/12","群益金鼎-瑞豐",6,0,6
"594","6207雷科","110/08/12","宏遠證券",0,5,-5
"595","6207雷科","110/08/12","兆豐-來福",5,0,5
"596","6207雷科","110/08/12","元富-彰化",0,5,-5
"597","6207雷科","110/08/12","華南永昌-彰化",5,0,5
"598","6207雷科","110/08/12","凱基-岡山",0,5,-5
"599","6207雷科","110/08/12","富邦-中壢",5,0,5
"600","6207雷科","110/08/12","富邦-建國",0,5,-5
"601","3679新至陞","110/08/12","台灣摩根士丹利",10,0,10
"602","3679新至陞","110/08/12","元大-成功",0,10,-10
"603","3679新至陞","110/08/12","國泰-松江",8,0,8
"604","3679新至陞","110/08/12","新加坡商瑞銀",0,7,-7
"605","3679新至陞","110/08/12","元大-大同",3,0,3
"606","3679新至陞","110/08/12","摩根大通",2,6,-4
"607","3679新至陞","110/08/12","聯邦-三重",2,0,2
"608","3679新至陞","110/08/12","瑞士信貸",0,3,-3
"609","3679新至陞","110/08/12","凱基-站前",2,0,2
"610","3679新至陞","110/08/12","港商野村",0,3,-3
"611","3679新至陞","110/08/12","日盛-板橋",1,0,1
"612","3679新至陞","110/08/12","凱基-新豐",0,3,-3
"613","3679新至陞","110/08/12","日盛-龍潭",1,0,1
"614","3679新至陞","110/08/12","元大證券",0,3,-3
"615","3679新至陞","110/08/12","美商高盛",1,0,1
"616","3679新至陞","110/08/12","康和-板橋",0,2,-2
"617","3679新至陞","110/08/12","大慶-蘆洲",1,0,1
"618","3679新至陞","110/08/12","富邦-台北",0,2,-2
"619","3679新至陞","110/08/12","元富-民權",1,0,1
"620","3679新至陞","110/08/12","元大-土城永寧",0,2,-2
"621","3679新至陞","110/08/12","元富-花蓮",1,0,1
"622","3679新至陞","110/08/12","彰銀",0,1,-1
"623","3679新至陞","110/08/12","(牛牛牛)亞-網路",1,0,1
"624","3679新至陞","110/08/12","大慶-富順",0,1,-1
"625","3679新至陞","110/08/12","光和-溪湖",1,0,1
"626","3679新至陞","110/08/12","台中銀-豐原",0,1,-1
"627","3679新至陞","110/08/12","兆豐-城中",1,0,1
"628","3679新至陞","110/08/12","兆豐-東門",0,1,-1
"629","3679新至陞","110/08/12","兆豐-岡山",1,0,1
"630","3679新至陞","110/08/12","凱基-新店",0,1,-1
"631","2727王品","110/08/12","新光",25,8,17
"632","2727王品","110/08/12","美林",0,76,-76
"633","2727王品","110/08/12","彰銀-台中",14,2,12
"634","2727王品","110/08/12","新加坡商瑞銀",0,52,-52
"635","2727王品","110/08/12","康和-澎湖",10,0,10
"636","2727王品","110/08/12","凱基-台北",2,38,-36
"637","2727王品","110/08/12","富邦-建國",10,1,9
"638","2727王品","110/08/12","國泰證券",0,22,-22
"639","2727王品","110/08/12","永豐金-中正",9,0,9
"640","2727王品","110/08/12","統一",1,19,-18
"641","2727王品","110/08/12","中國信託",12,4,8
"642","2727王品","110/08/12","元大證券",5,21,-16
"643","2727王品","110/08/12","國泰-敦南",9,1,8
"644","2727王品","110/08/12","永豐金證券",0,16,-16
"645","2727王品","110/08/12","日盛-景美",8,1,7
"646","2727王品","110/08/12","港商野村",4,15,-11
"647","2727王品","110/08/12","元富-永和",7,0,7
"648","2727王品","110/08/12","元富-大昌",0,8,-8
"649","2727王品","110/08/12","富邦-新店",7,0,7
"650","2727王品","110/08/12","元大-沙鹿",0,8,-8
"651","2727王品","110/08/12","日盛-木柵",6,0,6
"652","2727王品","110/08/12","元大-板橋",5,10,-5
"653","2727王品","110/08/12","日盛-屏東",7,1,6
"654","2727王品","110/08/12","永豐金-彰化",0,5,-5
"655","2727王品","110/08/12","台新-三民",7,1,6
"656","2727王品","110/08/12","大慶-泰山",0,4,-4
"657","2727王品","110/08/12","凱基-三重",6,0,6
"658","2727王品","110/08/12","台中銀",0,4,-4
"659","2727王品","110/08/12","第一金-台南",5,0,5
"660","2727王品","110/08/12","康和",0,4,-4
"661","1570力肯","110/08/12","台新證券",91,15,76
"662","1570力肯","110/08/12","國票-北高雄",2,361,-359
"663","1570力肯","110/08/12","元大-南投",81,5,76
"664","1570力肯","110/08/12","新光",95,222,-127
"665","1570力肯","110/08/12","永全-南崁",94,20,74
"666","1570力肯","110/08/12","(牛牛牛)亞-鑫豐",28,120,-92
"667","1570力肯","110/08/12","日盛-忠孝",57,0,57
"668","1570力肯","110/08/12","華南永昌-高雄",0,52,-52
"669","1570力肯","110/08/12","永豐金-北高雄",55,0,55
"670","1570力肯","110/08/12","群益金鼎-三重",0,42,-42
"671","1570力肯","110/08/12","中國信託-高雄",72,22,50
"672","1570力肯","110/08/12","日盛-八德",2,39,-37
"673","1570力肯","110/08/12","凱基-天母",49,0,49
"674","1570力肯","110/08/12","新光-台中",130,167,-37
"675","1570力肯","110/08/12","新光-台南",56,18,38
"676","1570力肯","110/08/12","日盛-樹林",1,31,-30
"677","1570力肯","110/08/12","兆豐-嘉義",35,0,35
"678","1570力肯","110/08/12","元大-竹北",0,30,-30
"679","1570力肯","110/08/12","國票-天祥",32,1,31
"680","1570力肯","110/08/12","元大-楊梅",6,35,-29
"681","1570力肯","110/08/12","國泰-松江",81,51,30
"682","1570力肯","110/08/12","元大-桃興",4,32,-28
"683","1570力肯","110/08/12","元大-新店中正",33,3,30
"684","1570力肯","110/08/12","亞東-台中",0,26,-26
"685","1570力肯","110/08/12","統一",48,21,27
"686","1570力肯","110/08/12","永豐金-屏東",5,30,-25
"687","1570力肯","110/08/12","國票-內壢",26,0,26
"688","1570力肯","110/08/12","國泰-館前",0,24,-24
"689","1570力肯","110/08/12","元大-大益",27,1,26
"690","1570力肯","110/08/12","摩根大通",173,193,-20
"691","6180橘子","110/08/12","第一金-忠孝",54,0,54
"692","6180橘子","110/08/12","台灣企銀-屏東",0,30,-30
"693","6180橘子","110/08/12","美林",35,0,35
"694","6180橘子","110/08/12","元大-斗信",0,20,-20
"695","6180橘子","110/08/12","凱基-台北",27,0,27
"696","6180橘子","110/08/12","永豐金-信義",0,15,-15
"697","6180橘子","110/08/12","美商高盛",23,2,21
"698","6180橘子","110/08/12","玉山-桃園",0,14,-14
"699","6180橘子","110/08/12","元大-前金",20,0,20
"700","6180橘子","110/08/12","兆豐-埔墘",0,10,-10
"701","6180橘子","110/08/12","摩根大通",21,5,16
"702","6180橘子","110/08/12","富邦-高雄",0,10,-10
"703","6180橘子","110/08/12","元大-敦南",11,0,11
"704","6180橘子","110/08/12","台新-新營",1,10,-9
"705","6180橘子","110/08/12","統一-基隆",10,0,10
"706","6180橘子","110/08/12","富邦-員林",0,9,-9
"707","6180橘子","110/08/12","元大證券",6,0,6
"708","6180橘子","110/08/12","台灣摩根士丹利",4,11,-7
"709","6180橘子","110/08/12","日盛-樹林",5,0,5
"710","6180橘子","110/08/12","大慶-蘆洲",0,7,-7
"711","6180橘子","110/08/12","新光-新竹",6,1,5
"712","6180橘子","110/08/12","元大-北三重",0,7,-7
"713","6180橘子","110/08/12","元大-上新莊",5,0,5
"714","6180橘子","110/08/12","新光",1,6,-5
"715","6180橘子","110/08/12","新加坡商瑞銀",3,0,3
"716","6180橘子","110/08/12","華南永昌-虎尾",0,5,-5
"717","6180橘子","110/08/12","統一-中壢",3,0,3
"718","6180橘子","110/08/12","元大-屏南",0,5,-5
"719","6180橘子","110/08/12","元富-新店",3,0,3
"720","6180橘子","110/08/12","群益金鼎-東湖",1,5,-4
"721","2390云辰","110/08/12","美林",245,9,236
"722","2390云辰","110/08/12","臺銀-臺中",2,218,-216
"723","2390云辰","110/08/12","新加坡商瑞銀",90,20,70
"724","2390云辰","110/08/12","兆豐-寶成",0,185,-185
"725","2390云辰","110/08/12","台灣摩根士丹利",59,2,57
"726","2390云辰","110/08/12","元大-板橋三民",1,70,-69
"727","2390云辰","110/08/12","凱基-台北",127,72,55
"728","2390云辰","110/08/12","永豐金-松山",5,70,-65
"729","2390云辰","110/08/12","元大-豐原站前",51,1,50
"730","2390云辰","110/08/12","富邦-建國",11,62,-51
"731","2390云辰","110/08/12","港商野村",198,154,44
"732","2390云辰","110/08/12","元大-土城學府",36,70,-34
"733","2390云辰","110/08/12","凱基-站前",54,10,44
"734","2390云辰","110/08/12","元大-土城永寧",10,39,-29
"735","2390云辰","110/08/12","元大-北三重",34,2,32
"736","2390云辰","110/08/12","群益金鼎-中壢",3,30,-27
"737","2390云辰","110/08/12","凱基-民權",30,0,30
"738","2390云辰","110/08/12","元大-新竹",3,30,-27
"739","2390云辰","110/08/12","華南永昌-岡山",28,0,28
"740","2390云辰","110/08/12","元富-城東",2,28,-26
"741","2390云辰","110/08/12","元富-同大",34,7,27
"742","2390云辰","110/08/12","群益金鼎-三民",2,26,-24
"743","2390云辰","110/08/12","元大-路竹",45,20,25
"744","2390云辰","110/08/12","台新-左楠",28,50,-22
"745","2390云辰","110/08/12","國票-博愛",34,11,23
"746","2390云辰","110/08/12","中農",1,23,-22
"747","2390云辰","110/08/12","元大-台南",25,2,23
"748","2390云辰","110/08/12","聯邦商銀",0,22,-22
"749","2390云辰","110/08/12","群益金鼎-開元",30,8,22
"750","2390云辰","110/08/12","元富-新店",2,23,-21
"751","2867三商壽","110/08/11","摩根大通",509,31,478
"752","2867三商壽","110/08/11","港商野村",13,188,-175
"753","2867三商壽","110/08/11","美商高盛",157,17,140
"754","2867三商壽","110/08/11","宏遠-高雄",0,150,-150
"755","2867三商壽","110/08/11","凱基-台北",123,14,109
"756","2867三商壽","110/08/11","日盛-鳳山",0,73,-73
"757","2867三商壽","110/08/11","凱基-八德",101,0,101
"758","2867三商壽","110/08/11","德信-中正",0,71,-71
"759","2867三商壽","110/08/11","統一-平鎮",100,0,100
"760","2867三商壽","110/08/11","凱基-新豐",1,67,-66
"761","2867三商壽","110/08/11","元大-土城永寧",94,5,89
"762","2867三商壽","110/08/11","土銀-新竹",0,60,-60
"763","2867三商壽","110/08/11","元大-沙鹿",63,0,63
"764","2867三商壽","110/08/11","凱基-中港",0,55,-55
"765","2867三商壽","110/08/11","新加坡商瑞銀",55,1,54
"766","2867三商壽","110/08/11","中國信託-文心",11,61,-50
"767","2867三商壽","110/08/11","台灣摩根士丹利",60,10,50
"768","2867三商壽","110/08/11","國泰-新莊",2,50,-48
"769","2867三商壽","110/08/11","元富-潮州",41,0,41
"770","2867三商壽","110/08/11","群益金鼎",0,40,-40
"771","2867三商壽","110/08/11","統一-汐止",40,0,40
"772","2867三商壽","110/08/11","元大-大益",0,40,-40
"773","2867三商壽","110/08/11","新光-高雄",40,4,36
"774","2867三商壽","110/08/11","富邦-板橋",5,38,-33
"775","2867三商壽","110/08/11","玉山-板橋",31,1,30
"776","2867三商壽","110/08/11","元富-古亭",0,30,-30
"777","2867三商壽","110/08/11","美林",194,168,26
"778","2867三商壽","110/08/11","元大-金華",0,30,-30
"779","2867三商壽","110/08/11","凱基",24,0,24
"780","2867三商壽","110/08/11","元大-汐止",13,42,-29
"781","5521工信","110/08/11","摩根大通",417,16,401
"782","5521工信","110/08/11","元大-沙鹿",0,103,-103
"783","5521工信","110/08/11","凱基-台北",86,5,81
"784","5521工信","110/08/11","華南永昌",0,43,-43
"785","5521工信","110/08/11","日進",73,0,73
"786","5521工信","110/08/11","聯邦-雙和",0,42,-42
"787","5521工信","110/08/11","日盛證券",70,0,70
"788","5521工信","110/08/11","元富-基隆",0,38,-38
"789","5521工信","110/08/11","富邦-台北",65,0,65
"790","5521工信","110/08/11","第一金-路竹",0,37,-37
"791","5521工信","110/08/11","富邦-苗栗",50,0,50
"792","5521工信","110/08/11","土銀-台中",0,35,-35
"793","5521工信","110/08/11","永豐金-鳳山",40,1,39
"794","5521工信","110/08/11","玉山-高雄",0,30,-30
"795","5521工信","110/08/11","台灣企銀-北高雄",30,0,30
"796","5521工信","110/08/11","凱基-台南",0,30,-30
"797","5521工信","110/08/11","美林",71,42,29
"798","5521工信","110/08/11","凱基-復興",0,30,-30
"799","5521工信","110/08/11","台新-台中",31,6,25
"800","5521工信","110/08/11","元大-屏南",0,30,-30
"801","5521工信","110/08/11","凱基-鳳山",20,0,20
"802","5521工信","110/08/11","永豐金-天母",0,30,-30
"803","5521工信","110/08/11","元大-東蘆",20,0,20
"804","5521工信","110/08/11","華南永昌-潮州",4,32,-28
"805","5521工信","110/08/11","群益金鼎-士林",21,3,18
"806","5521工信","110/08/11","華南永昌-彰化",13,39,-26
"807","5521工信","110/08/11","永豐金證券",14,0,14
"808","5521工信","110/08/11","日盛-新莊",0,25,-25
"809","5521工信","110/08/11","瑞士信貸",13,0,13
"810","5521工信","110/08/11","群益金鼎-敦南",0,25,-25
"811","1471首利","110/08/11","瑞士信貸",162,0,162
"812","1471首利","110/08/11","日盛-和美",1,55,-54
"813","1471首利","110/08/11","永全-八德",100,0,100
"814","1471首利","110/08/11","臺銀-臺中",3,55,-52
"815","1471首利","110/08/11","摩根大通",128,46,82
"816","1471首利","110/08/11","永豐金-板盛",0,42,-42
"817","1471首利","110/08/11","台新證券",48,7,41
"818","1471首利","110/08/11","兆豐-桃園",0,40,-40
"819","1471首利","110/08/11","凱基-台南",30,0,30
"820","1471首利","110/08/11","凱基-東門",0,40,-40
"821","1471首利","110/08/11","凱基-內埔",20,0,20
"822","1471首利","110/08/11","元大-新竹經國",0,40,-40
"823","1471首利","110/08/11","元大-蘆洲",20,0,20
"824","1471首利","110/08/11","群益金鼎-中港",0,35,-35
"825","1471首利","110/08/11","台新-高雄",16,0,16
"826","1471首利","110/08/11","元大-竹山",0,30,-30
"827","1471首利","110/08/11","大慶-富順",13,0,13
"828","1471首利","110/08/11","富邦-新竹",1,30,-29
"829","1471首利","110/08/11","群益金鼎-海山",13,0,13
"830","1471首利","110/08/11","日盛-八德",0,27,-27
"831","1471首利","110/08/11","日盛-大墩",12,0,12
"832","1471首利","110/08/11","大慶-蘆洲",5,30,-25
"833","1471首利","110/08/11","凱基-三重",12,0,12
"834","1471首利","110/08/11","元富-林園",0,25,-25
"835","1471首利","110/08/11","華南永昌-林口",12,0,12
"836","1471首利","110/08/11","元富-大昌",0,25,-25
"837","1471首利","110/08/11","富邦-中壢",13,2,11
"838","1471首利","110/08/11","新光",9,34,-25
"839","1471首利","110/08/11","合庫-台中",10,0,10
"840","1471首利","110/08/11","兆豐-寶成",0,24,-24
"841","2883開發金","110/08/11","瑞士信貸",5796,0,5796
"842","2883開發金","110/08/11","元富",772,4335,-3563
"843","2883開發金","110/08/11","元大-板橋三民",4182,53,4129
"844","2883開發金","110/08/11","美林",2516,5260,-2744
"845","2883開發金","110/08/11","合庫證券",3532,28,3504
"846","2883開發金","110/08/11","永豐金-彰化",42,2447,-2405
"847","2883開發金","110/08/11","兆豐證券",2123,44,2079
"848","2883開發金","110/08/11","元大證券",1279,3467,-2188
"849","2883開發金","110/08/11","台灣摩根士丹利",2946,1744,1202
"850","2883開發金","110/08/11","國票-長城",0,2014,-2014
"851","2883開發金","110/08/11","富邦-建國",1195,92,1103
"852","2883開發金","110/08/11","港商野村",3121,4600,-1479
"853","2883開發金","110/08/11","新光-新竹",1140,38,1102
"854","2883開發金","110/08/11","元大-金華",31,1341,-1310
"855","2883開發金","110/08/11","美商高盛",1600,535,1065
"856","2883開發金","110/08/11","元大-彰化",67,1218,-1151
"857","2883開發金","110/08/11","群益金鼎-南京",1083,202,881
"858","2883開發金","110/08/11","玉山-高雄",99,986,-887
"859","2883開發金","110/08/11","凱基-台北",5046,4258,788
"860","2883開發金","110/08/11","元富-彰化",27,813,-786
"861","2883開發金","110/08/11","港商法國興業",728,0,728
"862","2883開發金","110/08/11","摩根大通",3362,4085,-723
"863","2883開發金","110/08/11","玉山證券",716,98,618
"864","2883開發金","110/08/11","國泰證券",21,658,-637
"865","2883開發金","110/08/11","凱基-豐中",634,76,558
"866","2883開發金","110/08/11","富邦-新店",61,662,-601
"867","2883開發金","110/08/11","永豐金-忠孝",1406,858,548
"868","2883開發金","110/08/11","元大-小港",71,667,-596
"869","2883開發金","110/08/11","元大-民生",532,2,530
"870","2883開發金","110/08/11","富邦-台北",213,798,-585
"871","6205詮欣","110/08/11","臺銀-民權",25,0,25
"872","6205詮欣","110/08/11","摩根大通",2,46,-44
"873","6205詮欣","110/08/11","合庫-三重",20,0,20
"874","6205詮欣","110/08/11","永豐金-敦南",0,14,-14
"875","6205詮欣","110/08/11","元富-宜蘭",20,0,20
"876","6205詮欣","110/08/11","瑞士信貸",0,11,-11
"877","6205詮欣","110/08/11","德信-新營",10,0,10
"878","6205詮欣","110/08/11","永豐金-忠孝",0,10,-10
"879","6205詮欣","110/08/11","元大-西屯",10,0,10
"880","6205詮欣","110/08/11","統一-汐止",0,6,-6
"881","6205詮欣","110/08/11","永豐金-中正",9,0,9
"882","6205詮欣","110/08/11","港商野村",0,5,-5
"883","6205詮欣","110/08/11","日盛-三重",5,0,5
"884","6205詮欣","110/08/11","新光",0,5,-5
"885","6205詮欣","110/08/11","日盛-花蓮",5,0,5
"886","6205詮欣","110/08/11","群益金鼎-開元",0,5,-5
"887","6205詮欣","110/08/11","宏遠證券",5,0,5
"888","6205詮欣","110/08/11","富邦-陽明",0,5,-5
"889","6205詮欣","110/08/11","高橋",5,0,5
"890","6205詮欣","110/08/11","元大-館前",0,5,-5
"891","6205詮欣","110/08/11","亞東-板橋",4,0,4
"892","6205詮欣","110/08/11","大慶-中壢",0,4,-4
"893","6205詮欣","110/08/11","元富-基隆",3,0,3
"894","6205詮欣","110/08/11","凱基-和平",0,4,-4
"895","6205詮欣","110/08/11","元大-台中中港",3,0,3
"896","6205詮欣","110/08/11","富邦-台北",0,4,-4
"897","6205詮欣","110/08/11","合庫-彰化",2,0,2
"898","6205詮欣","110/08/11","元大-南投",0,4,-4
"899","6205詮欣","110/08/11","元大-西門",2,0,2
"900","6205詮欣","110/08/11","元大-東蘆",0,4,-4
"901","1540喬福","110/08/11","元富-中原",30,0,30
"902","1540喬福","110/08/11","統一-新台中",0,18,-18
"903","1540喬福","110/08/11","台中銀",17,0,17
"904","1540喬福","110/08/11","凱基-台北",0,16,-16
"905","1540喬福","110/08/11","富邦-竹北",11,0,11
"906","1540喬福","110/08/11","永豐金-板新",0,15,-15
"907","1540喬福","110/08/11","國泰-敦南",8,0,8
"908","1540喬福","110/08/11","永豐金-中盛",0,11,-11
"909","1540喬福","110/08/11","凱基-中壢",6,0,6
"910","1540喬福","110/08/11","元大-中壢",0,10,-10
"911","1540喬福","110/08/11","凱基-台南",5,0,5
"912","1540喬福","110/08/11","玉山-台南",0,4,-4
"913","1540喬福","110/08/11","元大-土城永寧",3,0,3
"914","1540喬福","110/08/11","國票-南科",0,3,-3
"915","1540喬福","110/08/11","臺銀-鳳山",2,0,2
"916","1540喬福","110/08/11","元大-龍潭",0,3,-3
"917","1540喬福","110/08/11","日盛-台中",2,0,2
"918","1540喬福","110/08/11","臺銀-臺中",0,2,-2
"919","1540喬福","110/08/11","兆豐-北高雄",2,0,2
"920","1540喬福","110/08/11","(牛牛牛)亞-網路",0,2,-2
"921","1540喬福","110/08/11","兆豐-三民",2,0,2
"922","1540喬福","110/08/11","新光-台南",0,2,-2
"923","1540喬福","110/08/11","合庫-桃園",1,0,1
"924","1540喬福","110/08/11","凱基-永和",0,2,-2
"925","1540喬福","110/08/11","臺銀-民權",1,0,1
"926","1540喬福","110/08/11","元大-南崁",0,2,-2
"927","1540喬福","110/08/11","臺銀-高雄",1,0,1
"928","1540喬福","110/08/11","美林",0,1,-1
"929","1540喬福","110/08/11","日盛-永康",1,0,1
"930","1540喬福","110/08/11","美商高盛",0,1,-1
"931","2888新光金","110/08/11","摩根大通",6950,1470,5480
"932","2888新光金","110/08/11","第一金-高雄",5,5018,-5013
"933","2888新光金","110/08/11","元大-忠孝鼎富",4314,11,4303
"934","2888新光金","110/08/11","永豐金-天母",0,2241,-2241
"935","2888新光金","110/08/11","美商高盛",4420,228,4192
"936","2888新光金","110/08/11","統一-中壢",11,1720,-1709
"937","2888新光金","110/08/11","瑞士信貸",2928,166,2762
"938","2888新光金","110/08/11","美林",1510,3170,-1660
"939","2888新光金","110/08/11","群益金鼎",1859,0,1859
"940","2888新光金","110/08/11","國票-台東",21,1606,-1585
"941","2888新光金","110/08/11","凱基-台北",5335,3700,1635
"942","2888新光金","110/08/11","元富-城東",25,1082,-1057
"943","2888新光金","110/08/11","新加坡商瑞銀",1506,65,1441
"944","2888新光金","110/08/11","台灣摩根士丹利",916,1951,-1035
"945","2888新光金","110/08/11","港商法國興業",1338,0,1338
"946","2888新光金","110/08/11","中國信託",25,740,-715
"947","2888新光金","110/08/11","元富-中港",1250,9,1241
"948","2888新光金","110/08/11","新光",391,1047,-656
"949","2888新光金","110/08/11","福邦-新竹",1176,0,1176
"950","2888新光金","110/08/11","合庫-高雄",1,567,-566
"951","2888新光金","110/08/11","凱基-林口",1005,35,970
"952","2888新光金","110/08/11","康和-台中",1,463,-462
"953","2888新光金","110/08/11","港商野村",1301,434,867
"954","2888新光金","110/08/11","玉山證券",260,691,-431
"955","2888新光金","110/08/11","國票-安和",1179,519,660
"956","2888新光金","110/08/11","元大-和平",4,382,-378
"957","2888新光金","110/08/11","富邦-敦南",569,19,550
"958","2888新光金","110/08/11","日盛-新莊",0,350,-350
"959","2888新光金","110/08/11","香港上海匯豐",441,0,441
"960","2888新光金","110/08/11","群益金鼎-大興",1,341,-340
"961","1340勝悅","110/08/11","華南永昌-高雄",24,4,20
"962","1340勝悅","110/08/11","元大-大統",0,42,-42
"963","1340勝悅","110/08/11","亞東-板橋",18,0,18
"964","1340勝悅","110/08/11","(牛牛牛)亞-鑫豐",0,25,-25
"965","1340勝悅","110/08/11","永豐金-台南",12,0,12
"966","1340勝悅","110/08/11","美林",0,20,-20
"967","1340勝悅","110/08/11","永豐金-板盛",10,0,10
"968","1340勝悅","110/08/11","摩根大通",0,18,-18
"969","1340勝悅","110/08/11","永豐金-天母",9,0,9
"970","1340勝悅","110/08/11","元富-基隆",0,12,-12
"971","1340勝悅","110/08/11","國泰-敦南",15,7,8
"972","1340勝悅","110/08/11","玉山-高雄",0,12,-12
"973","1340勝悅","110/08/11","群益金鼎-館前",8,0,8
"974","1340勝悅","110/08/11","元大-桃興",0,10,-10
"975","1340勝悅","110/08/11","凱基-台中",7,0,7
"976","1340勝悅","110/08/11","永豐金-博愛",0,10,-10
"977","1340勝悅","110/08/11","統一-城中",6,0,6
"978","1340勝悅","110/08/11","瑞士信貸",0,8,-8
"979","1340勝悅","110/08/11","群益金鼎-崇德",6,0,6
"980","1340勝悅","110/08/11","日盛-台中",0,6,-6
"981","1340勝悅","110/08/11","永豐金-松山",6,0,6
"982","1340勝悅","110/08/11","元大-景美",0,6,-6
"983","1340勝悅","110/08/11","臺銀-鳳山",5,0,5
"984","1340勝悅","110/08/11","日盛-信義",0,5,-5
"985","1340勝悅","110/08/11","永全-南崁",5,0,5
"986","1340勝悅","110/08/11","台新證券",0,5,-5
"987","1340勝悅","110/08/11","玉山-士林",5,0,5
"988","1340勝悅","110/08/11","元大-忠孝鼎富",0,5,-5
"989","1340勝悅","110/08/11","國泰-台中",15,10,5
"990","1340勝悅","110/08/11","元大-中壢",0,5,-5
"991","6246臺龍","110/08/11","永興",40,3,37
"992","6246臺龍","110/08/11","港商野村",6,139,-133
"993","6246臺龍","110/08/11","永豐金-內湖",42,9,33
"994","6246臺龍","110/08/11","統一",0,97,-97
"995","6246臺龍","110/08/11","元大-豐原站前",68,41,27
"996","6246臺龍","110/08/11","兆豐-松德",0,82,-82
"997","6246臺龍","110/08/11","日盛-員林",21,1,20
"998","6246臺龍","110/08/11","元大-新盛",24,80,-56
"999","6246臺龍","110/08/11","康和-澎湖",20,0,20
"1000","6246臺龍","110/08/11","元大-北港",0,35,-35
"1001","6246臺龍","110/08/11","元大-歸仁",18,0,18
"1002","6246臺龍","110/08/11","元大-西門",0,28,-28
"1003","6246臺龍","110/08/11","元大-中壢",35,17,18
"1004","6246臺龍","110/08/11","永興-台中",0,27,-27
"1005","6246臺龍","110/08/11","玉山-大里",17,0,17
"1006","6246臺龍","110/08/11","永興-水湳",0,25,-25
"1007","6246臺龍","110/08/11","大慶-泰山",15,0,15
"1008","6246臺龍","110/08/11","元大-西螺",6,30,-24
"1009","6246臺龍","110/08/11","永豐金-松山",15,1,14
"1010","6246臺龍","110/08/11","元大-西屯",2,25,-23
"1011","6246臺龍","110/08/11","凱基-永和",13,0,13
"1012","6246臺龍","110/08/11","新光",45,67,-22
"1013","6246臺龍","110/08/11","華南永昌-嘉義",13,0,13
"1014","6246臺龍","110/08/11","第一金-台中",0,20,-20
"1015","6246臺龍","110/08/11","富邦-三重",13,0,13
"1016","6246臺龍","110/08/11","兆豐-南京",0,20,-20
"1017","6246臺龍","110/08/11","日盛-高雄",12,0,12
"1018","6246臺龍","110/08/11","日盛-頭份",2,20,-18
"1019","6246臺龍","110/08/11","群益金鼎-北高雄",12,0,12
"1020","6246臺龍","110/08/11","宏遠-桃園",0,17,-17
"1021","00715L期街口布蘭特正2","110/08/11","元大證券",11593,2378,9215
"1022","00715L期街口布蘭特正2","110/08/11","凱基-台北",313,3001,-2688
"1023","00715L期街口布蘭特正2","110/08/11","永豐金-新店",1600,4,1596
"1024","00715L期街口布蘭特正2","110/08/11","富邦-南屯",403,1908,-1505
"1025","00715L期街口布蘭特正2","110/08/11","第一金-台中",1282,31,1251
"1026","00715L期街口布蘭特正2","110/08/11","新光",152,1165,-1013
"1027","00715L期街口布蘭特正2","110/08/11","元大-敦化",1200,20,1180
"1028","00715L期街口布蘭特正2","110/08/11","第一金-台南",0,519,-519
"1029","00715L期街口布蘭特正2","110/08/11","永豐金證券",1128,53,1075
"1030","00715L期街口布蘭特正2","110/08/11","統一-新竹",13,506,-493
"1031","00715L期街口布蘭特正2","110/08/11","元大-復北",556,21,535
"1032","00715L期街口布蘭特正2","110/08/11","台新-三民",0,438,-438
"1033","00715L期街口布蘭特正2","110/08/11","日盛-永康",340,0,340
"1034","00715L期街口布蘭特正2","110/08/11","富邦-彰化",30,391,-361
"1035","00715L期街口布蘭特正2","110/08/11","群益金鼎-板橋",350,17,333
"1036","00715L期街口布蘭特正2","110/08/11","元富-中壢",5,316,-311
"1037","00715L期街口布蘭特正2","110/08/11","元富",325,2,323
"1038","00715L期街口布蘭特正2","110/08/11","凱基-豐中",0,302,-302
"1039","00715L期街口布蘭特正2","110/08/11","凱基-科園",300,0,300
"1040","00715L期街口布蘭特正2","110/08/11","康和",359,645,-286
"1041","00715L期街口布蘭特正2","110/08/11","元大-蘆洲",311,59,252
"1042","00715L期街口布蘭特正2","110/08/11","元富-成功",5,290,-285
"1043","00715L期街口布蘭特正2","110/08/11","群益金鼎-崇德",251,20,231
"1044","00715L期街口布蘭特正2","110/08/11","台新-松江",0,268,-268
"1045","00715L期街口布蘭特正2","110/08/11","富邦-建國",265,42,223
"1046","00715L期街口布蘭特正2","110/08/11","元大-前金",21,279,-258
"1047","00715L期街口布蘭特正2","110/08/11","富邦-嘉義",300,99,201
"1048","00715L期街口布蘭特正2","110/08/11","國泰-高雄",13,236,-223
"1049","00715L期街口布蘭特正2","110/08/11","元大-竹科",314,115,199
"1050","00715L期街口布蘭特正2","110/08/11","中國信託-嘉義",4,223,-219
"1051","8941關中","110/08/11","凱基-市府",1,0,1
"1052","8941關中","110/08/11","元大-古亭",0,1,-1
"1053","8941關中","110/08/11","康和-板橋",0,0,0
"1054","8941關中","110/08/11","康和-板橋",0,0,0
"1055","8941關中","110/08/11","國泰-忠孝",0,0,0
"1056","8941關中","110/08/11","國泰-忠孝",0,0,0
"1057","8941關中","110/08/11","富邦-北港",0,0,0
"1058","8941關中","110/08/11","富邦-北港",0,0,0
"1059","8941關中","110/08/11","元大證券",0,0,0
"1060","8941關中","110/08/11","元大證券",0,0,0
"1061","8941關中","110/08/11","",NA,NA,NA
"1062","8941關中","110/08/11","",NA,NA,NA
"1063","8941關中","110/08/11","",NA,NA,NA
"1064","8941關中","110/08/11","",NA,NA,NA
"1065","8941關中","110/08/11","",NA,NA,NA
"1066","8941關中","110/08/11","",NA,NA,NA
"1067","8941關中","110/08/11","",NA,NA,NA
"1068","8941關中","110/08/11","",NA,NA,NA
"1069","8941關中","110/08/11","",NA,NA,NA
"1070","8941關中","110/08/11","",NA,NA,NA
"1071","8941關中","110/08/11","",NA,NA,NA
"1072","8941關中","110/08/11","",NA,NA,NA
"1073","8941關中","110/08/11","",NA,NA,NA
"1074","8941關中","110/08/11","",NA,NA,NA
"1075","8941關中","110/08/11","",NA,NA,NA
"1076","8941關中","110/08/11","",NA,NA,NA
"1077","8941關中","110/08/11","",NA,NA,NA
"1078","8941關中","110/08/11","",NA,NA,NA
"1079","8941關中","110/08/11","",NA,NA,NA
"1080","8941關中","110/08/11","",NA,NA,NA
"1081","8936國統","110/08/11","台新-高雄",218,1,217
"1082","8936國統","110/08/11","凱基-內埔",0,70,-70
"1083","8936國統","110/08/11","新光-桃園",105,3,102
"1084","8936國統","110/08/11","元大-太平",0,60,-60
"1085","8936國統","110/08/11","新加坡商瑞銀",124,59,65
"1086","8936國統","110/08/11","永豐金-板盛",0,48,-48
"1087","8936國統","110/08/11","美林",61,0,61
"1088","8936國統","110/08/11","兆豐-高雄",0,29,-29
"1089","8936國統","110/08/11","摩根大通",71,16,55
"1090","8936國統","110/08/11","群益金鼎-屏東",0,27,-27
"1091","8936國統","110/08/11","元富-同大",41,5,36
"1092","8936國統","110/08/11","新光",0,24,-24
"1093","8936國統","110/08/11","凱基-台北",38,6,32
"1094","8936國統","110/08/11","凱基-台南",0,22,-22
"1095","8936國統","110/08/11","華南永昌-高雄",22,0,22
"1096","8936國統","110/08/11","合庫-高雄",0,20,-20
"1097","8936國統","110/08/11","日盛-三峽",21,0,21
"1098","8936國統","110/08/11","永豐金-大園",0,20,-20
"1099","8936國統","110/08/11","兆豐-大同",30,9,21
"1100","8936國統","110/08/11","永豐金-台中",0,20,-20
"1101","8936國統","110/08/11","宏遠-台南",20,0,20
"1102","8936國統","110/08/11","永豐金-竹科",0,20,-20
"1103","8936國統","110/08/11","美商高盛",17,1,16
"1104","8936國統","110/08/11","港商野村",49,67,-18
"1105","8936國統","110/08/11","日盛-斗六",15,0,15
"1106","8936國統","110/08/11","第一金-新興",0,16,-16
"1107","8936國統","110/08/11","元富-大裕",15,0,15
"1108","8936國統","110/08/11","新光-台中",14,29,-15
"1109","8936國統","110/08/11","台新-台中",15,2,13
"1110","8936國統","110/08/11","凱基-永和",0,15,-15
"1111","6226光鼎","110/08/11","美商高盛",595,148,447
"1112","6226光鼎","110/08/11","瑞士信貸",297,751,-454
"1113","6226光鼎","110/08/11","凱基-台北",506,69,437
"1114","6226光鼎","110/08/11","摩根大通",911,1317,-406
"1115","6226光鼎","110/08/11","統一-高雄",503,150,353
"1116","6226光鼎","110/08/11","凱基-站前",29,313,-284
"1117","6226光鼎","110/08/11","美林",507,312,195
"1118","6226光鼎","110/08/11","台中銀-台北",0,280,-280
"1119","6226光鼎","110/08/11","合庫-台中",143,4,139
"1120","6226光鼎","110/08/11","國泰-台中",75,176,-101
"1121","6226光鼎","110/08/11","大昌",139,0,139
"1122","6226光鼎","110/08/11","元富-潮州",10,107,-97
"1123","6226光鼎","110/08/11","台灣摩根士丹利",229,101,128
"1124","6226光鼎","110/08/11","中國信託-永康",63,159,-96
"1125","6226光鼎","110/08/11","元大-北投",123,4,119
"1126","6226光鼎","110/08/11","國泰-高雄",15,96,-81
"1127","6226光鼎","110/08/11","富邦-南屯",170,63,107
"1128","6226光鼎","110/08/11","凱基-三多",23,100,-77
"1129","6226光鼎","110/08/11","群益金鼎-西松",176,93,83
"1130","6226光鼎","110/08/11","玉山-高雄",17,90,-73
"1131","6226光鼎","110/08/11","台新證券",167,99,68
"1132","6226光鼎","110/08/11","元大-新盛",8,81,-73
"1133","6226光鼎","110/08/11","永豐金-內湖",79,22,57
"1134","6226光鼎","110/08/11","元大-府城",7,72,-65
"1135","6226光鼎","110/08/11","日盛證券",51,6,45
"1136","6226光鼎","110/08/11","統一-仁愛",13,75,-62
"1137","6226光鼎","110/08/11","臺銀-高雄",70,26,44
"1138","6226光鼎","110/08/11","高橋",4,61,-57
"1139","6226光鼎","110/08/11","富邦-陽明",84,40,44
"1140","6226光鼎","110/08/11","台新-屏東",16,71,-55
"1141","2363矽統","110/08/11","瑞士信貸",547,0,547
"1142","2363矽統","110/08/11","凱基-台北",2934,4385,-1451
"1143","2363矽統","110/08/11","台灣摩根士丹利",677,160,517
"1144","2363矽統","110/08/11","陽信-石牌",34,626,-592
"1145","2363矽統","110/08/11","玉山-台中",331,139,192
"1146","2363矽統","110/08/11","永豐金證券",103,405,-302
"1147","2363矽統","110/08/11","台新-左楠",191,33,158
"1148","2363矽統","110/08/11","元大-成功",60,289,-229
"1149","2363矽統","110/08/11","華南永昌-頭份",197,45,152
"1150","2363矽統","110/08/11","美林",747,959,-212
"1151","2363矽統","110/08/11","元大-忠孝鼎富",196,51,145
"1152","2363矽統","110/08/11","元大-員林中山",83,286,-203
"1153","2363矽統","110/08/11","元大-汐止",279,150,129
"1154","2363矽統","110/08/11","凱基-市府",42,242,-200
"1155","2363矽統","110/08/11","大慶-蘆洲",135,26,109
"1156","2363矽統","110/08/11","永豐金-埔里",4,181,-177
"1157","2363矽統","110/08/11","合庫-高雄",135,30,105
"1158","2363矽統","110/08/11","群益金鼎-內湖",41,195,-154
"1159","2363矽統","110/08/11","兆豐證券",105,1,104
"1160","2363矽統","110/08/11","元大-旗山",157,307,-150
"1161","2363矽統","110/08/11","永豐金-竹科",112,15,97
"1162","2363矽統","110/08/11","兆豐-台中港",38,178,-140
"1163","2363矽統","110/08/11","國票-彰化",95,0,95
"1164","2363矽統","110/08/11","元大-新竹",55,194,-139
"1165","2363矽統","110/08/11","元大-斗信",152,65,87
"1166","2363矽統","110/08/11","凱基-永和",32,161,-129
"1167","2363矽統","110/08/11","亞東",95,10,85
"1168","2363矽統","110/08/11","第一金-桃園",59,183,-124
"1169","2363矽統","110/08/11","美商高盛",906,822,84
"1170","2363矽統","110/08/11","台新證券",525,640,-115
"1171","8112至上","110/08/11","港商野村",188,11,177
"1172","8112至上","110/08/11","新加坡商瑞銀",35,847,-812
"1173","8112至上","110/08/11","大昌-桃園",173,0,173
"1174","8112至上","110/08/11","宏遠證券",2,536,-534
"1175","8112至上","110/08/11","合庫證券",142,3,139
"1176","8112至上","110/08/11","富邦-仁愛",67,324,-257
"1177","8112至上","110/08/11","美商高盛",145,14,131
"1178","8112至上","110/08/11","凱基-市政",0,202,-202
"1179","8112至上","110/08/11","群益金鼎-內湖",132,10,122
"1180","8112至上","110/08/11","凱基-復興",16,190,-174
"1181","8112至上","110/08/11","國票-長城",130,30,100
"1182","8112至上","110/08/11","瑞士信貸",136,306,-170
"1183","8112至上","110/08/11","玉山-板橋",84,0,84
"1184","8112至上","110/08/11","兆豐-公益",1,120,-119
"1185","8112至上","110/08/11","臺灣企銀-桃園",60,0,60
"1186","8112至上","110/08/11","元大-萬華",12,131,-119
"1187","8112至上","110/08/11","新光",103,44,59
"1188","8112至上","110/08/11","凱基-台北",211,321,-110
"1189","8112至上","110/08/11","華南永昌-中正",52,0,52
"1190","8112至上","110/08/11","美林",21,116,-95
"1191","8112至上","110/08/11","元大-仁愛",50,0,50
"1192","8112至上","110/08/11","永豐金-豐原",7,102,-95
"1193","8112至上","110/08/11","元大-北成功",101,53,48
"1194","8112至上","110/08/11","兆豐-民生",0,70,-70
"1195","8112至上","110/08/11","合庫-嘉義",45,0,45
"1196","8112至上","110/08/11","元富",2,71,-69
"1197","8112至上","110/08/11","大慶-富順",46,1,45
"1198","8112至上","110/08/11","玉山-士林",6,67,-61
"1199","8112至上","110/08/11","臺銀-金山",45,1,44
"1200","8112至上","110/08/11","凱基-埔墘",0,60,-60
"1201","1570力肯","110/08/11","國票-內壢",386,0,386
"1202","1570力肯","110/08/11","群益金鼎-大興",0,100,-100
"1203","1570力肯","110/08/11","華南永昌-桃園",104,3,101
"1204","1570力肯","110/08/11","新光",177,255,-78
"1205","1570力肯","110/08/11","摩根大通",154,84,70
"1206","1570力肯","110/08/11","富邦-台中",0,61,-61
"1207","1570力肯","110/08/11","日盛-頭份",51,0,51
"1208","1570力肯","110/08/11","群益金鼎-忠孝",1,60,-59
"1209","1570力肯","110/08/11","永豐金-中壢",51,1,50
"1210","1570力肯","110/08/11","元大-新店中正",2,61,-59
"1211","1570力肯","110/08/11","永豐金-北高雄",50,0,50
"1212","1570力肯","110/08/11","富邦-陽明",1,51,-50
"1213","1570力肯","110/08/11","凱基-天母",51,2,49
"1214","1570力肯","110/08/11","元大-太平",5,54,-49
"1215","1570力肯","110/08/11","日盛-員林",52,5,47
"1216","1570力肯","110/08/11","統一-松江",0,43,-43
"1217","1570力肯","110/08/11","元富-高雄",40,0,40
"1218","1570力肯","110/08/11","台新證券",6,44,-38
"1219","1570力肯","110/08/11","中國信託-嘉義",34,0,34
"1220","1570力肯","110/08/11","永豐金證券",1,36,-35
"1221","1570力肯","110/08/11","元大-北成功",30,1,29
"1222","1570力肯","110/08/11","瑞士信貸",0,27,-27
"1223","1570力肯","110/08/11","亞東-台中",26,0,26
"1224","1570力肯","110/08/11","元大-中壢",9,35,-26
"1225","1570力肯","110/08/11","第一金-嘉義",26,0,26
"1226","1570力肯","110/08/11","美商高盛",0,25,-25
"1227","1570力肯","110/08/11","凱基-中壢",27,3,24
"1228","1570力肯","110/08/11","國票-北高雄",128,153,-25
"1229","1570力肯","110/08/11","元大-福營",25,1,24
"1230","1570力肯","110/08/11","元富-新店",10,34,-24
"1231","2929淘帝","110/08/11","美林",25,5,20
"1232","2929淘帝","110/08/11","華南永昌",0,25,-25
"1233","2929淘帝","110/08/11","永興",20,0,20
"1234","2929淘帝","110/08/11","台新-台中",0,22,-22
"1235","2929淘帝","110/08/11","新光",17,1,16
"1236","2929淘帝","110/08/11","富邦-永和",1,21,-20
"1237","2929淘帝","110/08/11","臺銀-臺南",12,0,12
"1238","2929淘帝","110/08/11","元富-古亭",0,18,-18
"1239","2929淘帝","110/08/11","第一金-大稻埕",10,0,10
"1240","2929淘帝","110/08/11","永豐金-大園",5,23,-18
"1241","2929淘帝","110/08/11","兆豐-桃園",10,0,10
"1242","2929淘帝","110/08/11","富邦-新店",3,19,-16
"1243","2929淘帝","110/08/11","國票-九鼎",10,0,10
"1244","2929淘帝","110/08/11","新光-台中",16,31,-15
"1245","2929淘帝","110/08/11","華南永昌-長虹",10,0,10
"1246","2929淘帝","110/08/11","國泰-新莊",0,10,-10
"1247","2929淘帝","110/08/11","凱基-長庚",7,0,7
"1248","2929淘帝","110/08/11","元大-東泰",0,10,-10
"1249","2929淘帝","110/08/11","凱基-林口",7,0,7
"1250","2929淘帝","110/08/11","凱基-斗六",0,8,-8
"1251","2929淘帝","110/08/11","日盛-中壢",5,0,5
"1252","2929淘帝","110/08/11","永豐金證券",0,7,-7
"1253","2929淘帝","110/08/11","港商法國興業",5,0,5
"1254","2929淘帝","110/08/11","第一金-員林",0,5,-5
"1255","2929淘帝","110/08/11","元富-中壢",5,0,5
"1256","2929淘帝","110/08/11","元富-新竹",0,5,-5
"1257","2929淘帝","110/08/11","元富-文心",5,0,5
"1258","2929淘帝","110/08/11","凱基-東門",0,5,-5
"1259","2929淘帝","110/08/11","凱基-台中",5,0,5
"1260","2929淘帝","110/08/11","元大-桃園",0,5,-5
"1261","5410國眾","110/08/11","群益金鼎",128,0,128
"1262","5410國眾","110/08/11","國泰-敦南",12,206,-194
"1263","5410國眾","110/08/11","富邦-建國",100,0,100
"1264","5410國眾","110/08/11","凱基-竹北",2,112,-110
"1265","5410國眾","110/08/11","玉山-新莊",35,0,35
"1266","5410國眾","110/08/11","大昌-樹林",0,100,-100
"1267","5410國眾","110/08/11","合庫-桃園",30,0,30
"1268","5410國眾","110/08/11","凱基-市政",0,100,-100
"1269","5410國眾","110/08/11","高橋",30,0,30
"1270","5410國眾","110/08/11","摩根大通",20,68,-48
"1271","5410國眾","110/08/11","元大-崇德",28,0,28
"1272","5410國眾","110/08/11","凱基-台北",7,39,-32
"1273","5410國眾","110/08/11","元大-新盛",28,0,28
"1274","5410國眾","110/08/11","元大-復北",0,30,-30
"1275","5410國眾","110/08/11","凱基-三峽",21,0,21
"1276","5410國眾","110/08/11","大昌",0,26,-26
"1277","5410國眾","110/08/11","臺銀-臺中",17,0,17
"1278","5410國眾","110/08/11","第一金-豐原",0,23,-23
"1279","5410國眾","110/08/11","新光",15,0,15
"1280","5410國眾","110/08/11","元富-三重",0,22,-22
"1281","5410國眾","110/08/11","國泰-台中",20,8,12
"1282","5410國眾","110/08/11","元大-樹林",2,21,-19
"1283","5410國眾","110/08/11","新光-桃園",11,0,11
"1284","5410國眾","110/08/11","元大-成功",0,17,-17
"1285","5410國眾","110/08/11","元大-旗山",11,0,11
"1286","5410國眾","110/08/11","新光-台中",0,16,-16
"1287","5410國眾","110/08/11","大昌-新店",10,0,10
"1288","5410國眾","110/08/11","臺銀-臺南",1,14,-13
"1289","5410國眾","110/08/11","豐農",10,0,10
"1290","5410國眾","110/08/11","瑞士信貸",0,12,-12
"1291","2841台開","110/08/11","宏遠-館前",402,0,402
"1292","2841台開","110/08/11","永豐金-敦南",11,270,-259
"1293","2841台開","110/08/11","日盛-信義",129,0,129
"1294","2841台開","110/08/11","國票-天祥",0,100,-100
"1295","2841台開","110/08/11","元大-南投",80,0,80
"1296","2841台開","110/08/11","日盛證券",27,117,-90
"1297","2841台開","110/08/11","日盛-園區",72,0,72
"1298","2841台開","110/08/11","永興-水湳",0,30,-30
"1299","2841台開","110/08/11","華南永昌-鶯歌",45,0,45
"1300","2841台開","110/08/11","兆豐-寶成",0,30,-30
"1301","2841台開","110/08/11","元大-福營",20,0,20
"1302","2841台開","110/08/11","元富-四維",0,26,-26
"1303","2841台開","110/08/11","元大-左營",20,0,20
"1304","2841台開","110/08/11","統一-士林",0,25,-25
"1305","2841台開","110/08/11","永豐金-員林",15,0,15
"1306","2841台開","110/08/11","日盛-忠孝",0,20,-20
"1307","2841台開","110/08/11","日盛-內湖",11,0,11
"1308","2841台開","110/08/11","大慶-蘆洲",0,20,-20
"1309","2841台開","110/08/11","國泰-館前",10,0,10
"1310","2841台開","110/08/11","國票-中和",0,20,-20
"1311","2841台開","110/08/11","華南永昌-潮州",10,0,10
"1312","2841台開","110/08/11","元大-大灣",0,20,-20
"1313","2841台開","110/08/11","元大-大里德芳",10,0,10
"1314","2841台開","110/08/11","元大-雙和",0,20,-20
"1315","2841台開","110/08/11","元大-小港",10,0,10
"1316","2841台開","110/08/11","新光",28,47,-19
"1317","2841台開","110/08/11","新光-台南",7,0,7
"1318","2841台開","110/08/11","玉山-台中",0,13,-13
"1319","2841台開","110/08/11","國泰-台中",6,0,6
"1320","2841台開","110/08/11","富邦-建國",0,12,-12
"1321","6207雷科","110/08/11","台新-高雄",136,8,128
"1322","6207雷科","110/08/11","群益金鼎-東門",1,90,-89
"1323","6207雷科","110/08/11","凱基-台北",108,21,87
"1324","6207雷科","110/08/11","摩根大通",89,156,-67
"1325","6207雷科","110/08/11","富邦-陽明",70,0,70
"1326","6207雷科","110/08/11","元大-鳳山",22,60,-38
"1327","6207雷科","110/08/11","永豐金證券",30,0,30
"1328","6207雷科","110/08/11","凱基-三重",5,40,-35
"1329","6207雷科","110/08/11","永豐金-高雄",29,5,24
"1330","6207雷科","110/08/11","美林",5,35,-30
"1331","6207雷科","110/08/11","元大-高雄",18,0,18
"1332","6207雷科","110/08/11","港商野村",28,58,-30
"1333","6207雷科","110/08/11","元大-竹山",17,0,17
"1334","6207雷科","110/08/11","元大-路竹",3,30,-27
"1335","6207雷科","110/08/11","國泰-台南",15,2,13
"1336","6207雷科","110/08/11","元大-小港",3,30,-27
"1337","6207雷科","110/08/11","元大-東門",12,0,12
"1338","6207雷科","110/08/11","(牛牛牛)亞-網路",0,23,-23
"1339","6207雷科","110/08/11","台灣企銀-太平",10,0,10
"1340","6207雷科","110/08/11","台新證券",4,26,-22
"1341","6207雷科","110/08/11","富邦-中壢",10,0,10
"1342","6207雷科","110/08/11","新光",2,23,-21
"1343","6207雷科","110/08/11","元大-博愛",10,0,10
"1344","6207雷科","110/08/11","元大-雙和",0,19,-19
"1345","6207雷科","110/08/11","富邦-內湖",9,0,9
"1346","6207雷科","110/08/11","新加坡商瑞銀",25,41,-16
"1347","6207雷科","110/08/11","中國信託-高雄",8,0,8
"1348","6207雷科","110/08/11","玉山證券",3,19,-16
"1349","6207雷科","110/08/11","國票-九鼎",8,0,8
"1350","6207雷科","110/08/11","玉山-雙和",0,16,-16
"1351","3679新至陞","110/08/11","摩根大通",62,3,59
"1352","3679新至陞","110/08/11","港商野村",7,25,-18
"1353","3679新至陞","110/08/11","台灣摩根士丹利",38,0,38
"1354","3679新至陞","110/08/11","凱基-文心",0,9,-9
"1355","3679新至陞","110/08/11","華南永昌-台中",16,0,16
"1356","3679新至陞","110/08/11","北城證券",0,8,-8
"1357","3679新至陞","110/08/11","凱基-台北",37,23,14
"1358","3679新至陞","110/08/11","華南永昌-大安",2,10,-8
"1359","3679新至陞","110/08/11","元大-成功",13,1,12
"1360","3679新至陞","110/08/11","元大-板橋",0,8,-8
"1361","3679新至陞","110/08/11","美林",22,16,6
"1362","3679新至陞","110/08/11","致和-東門",0,7,-7
"1363","3679新至陞","110/08/11","新加坡商瑞銀",12,6,6
"1364","3679新至陞","110/08/11","凱基-長庚",0,7,-7
"1365","3679新至陞","110/08/11","國泰-館前",5,0,5
"1366","3679新至陞","110/08/11","花旗環球",0,6,-6
"1367","3679新至陞","110/08/11","瑞士信貸",9,5,4
"1368","3679新至陞","110/08/11","群益金鼎-古亭",0,6,-6
"1369","3679新至陞","110/08/11","國泰-板橋",5,1,4
"1370","3679新至陞","110/08/11","元大-大同",0,6,-6
"1371","3679新至陞","110/08/11","日進",3,0,3
"1372","3679新至陞","110/08/11","華南永昌-鶯歌",0,5,-5
"1373","3679新至陞","110/08/11","(牛牛牛)亞-網路",4,1,3
"1374","3679新至陞","110/08/11","永豐金-新竹",0,5,-5
"1375","3679新至陞","110/08/11","康和-板橋",3,0,3
"1376","3679新至陞","110/08/11","凱基-新豐",0,4,-4
"1377","3679新至陞","110/08/11","高橋-內壢",2,0,2
"1378","3679新至陞","110/08/11","臺銀-高雄",1,4,-3
"1379","3679新至陞","110/08/11","富邦-台北",7,5,2
"1380","3679新至陞","110/08/11","日盛-文化",0,3,-3
"1381","2727王品","110/08/11","美林",113,23,90
"1382","2727王品","110/08/11","台灣摩根士丹利",8,65,-57
"1383","2727王品","110/08/11","富邦-左營",72,1,71
"1384","2727王品","110/08/11","合庫-新竹",1,23,-22
"1385","2727王品","110/08/11","凱基-台北",80,42,38
"1386","2727王品","110/08/11","永豐金-忠孝",0,20,-20
"1387","2727王品","110/08/11","港商野村",96,70,26
"1388","2727王品","110/08/11","彰銀-台中",1,15,-14
"1389","2727王品","110/08/11","國泰證券",23,1,22
"1390","2727王品","110/08/11","國泰-敦南",10,24,-14
"1391","2727王品","110/08/11","統一",28,8,20
"1392","2727王品","110/08/11","凱基-南崁",0,11,-11
"1393","2727王品","110/08/11","玉山-台南",20,1,19
"1394","2727王品","110/08/11","永豐金-三重",0,10,-10
"1395","2727王品","110/08/11","新光-台中",22,9,13
"1396","2727王品","110/08/11","富邦-中壢",3,12,-9
"1397","2727王品","110/08/11","凱基-興隆",11,0,11
"1398","2727王品","110/08/11","新光",16,24,-8
"1399","2727王品","110/08/11","元大證券",44,33,11
"1400","2727王品","110/08/11","國泰-板橋",12,20,-8
"1401","2727王品","110/08/11","日盛-樹林",12,2,10
"1402","2727王品","110/08/11","元大-彰化",0,8,-8
"1403","2727王品","110/08/11","第一金-新竹",10,0,10
"1404","2727王品","110/08/11","日盛-木柵",0,7,-7
"1405","2727王品","110/08/11","永全",10,0,10
"1406","2727王品","110/08/11","第一金-頭份",0,7,-7
"1407","2727王品","110/08/11","凱基-埔墘",10,0,10
"1408","2727王品","110/08/11","中國信託-高雄",2,9,-7
"1409","2727王品","110/08/11","摩根大通",42,33,9
"1410","2727王品","110/08/11","兆豐-公益",0,7,-7
"1411","1570力肯","110/08/11","國票-內壢",386,0,386
"1412","1570力肯","110/08/11","群益金鼎-大興",0,100,-100
"1413","1570力肯","110/08/11","華南永昌-桃園",104,3,101
"1414","1570力肯","110/08/11","新光",177,255,-78
"1415","1570力肯","110/08/11","摩根大通",154,84,70
"1416","1570力肯","110/08/11","富邦-台中",0,61,-61
"1417","1570力肯","110/08/11","日盛-頭份",51,0,51
"1418","1570力肯","110/08/11","群益金鼎-忠孝",1,60,-59
"1419","1570力肯","110/08/11","永豐金-中壢",51,1,50
"1420","1570力肯","110/08/11","元大-新店中正",2,61,-59
"1421","1570力肯","110/08/11","永豐金-北高雄",50,0,50
"1422","1570力肯","110/08/11","富邦-陽明",1,51,-50
"1423","1570力肯","110/08/11","凱基-天母",51,2,49
"1424","1570力肯","110/08/11","元大-太平",5,54,-49
"1425","1570力肯","110/08/11","日盛-員林",52,5,47
"1426","1570力肯","110/08/11","統一-松江",0,43,-43
"1427","1570力肯","110/08/11","元富-高雄",40,0,40
"1428","1570力肯","110/08/11","台新證券",6,44,-38
"1429","1570力肯","110/08/11","中國信託-嘉義",34,0,34
"1430","1570力肯","110/08/11","永豐金證券",1,36,-35
"1431","1570力肯","110/08/11","元大-北成功",30,1,29
"1432","1570力肯","110/08/11","瑞士信貸",0,27,-27
"1433","1570力肯","110/08/11","亞東-台中",26,0,26
"1434","1570力肯","110/08/11","元大-中壢",9,35,-26
"1435","1570力肯","110/08/11","第一金-嘉義",26,0,26
"1436","1570力肯","110/08/11","美商高盛",0,25,-25
"1437","1570力肯","110/08/11","凱基-中壢",27,3,24
"1438","1570力肯","110/08/11","國票-北高雄",128,153,-25
"1439","1570力肯","110/08/11","元大-福營",25,1,24
"1440","1570力肯","110/08/11","元富-新店",10,34,-24
"1441","6180橘子","110/08/11","台灣摩根士丹利",42,7,35
"1442","6180橘子","110/08/11","港商野村",5,128,-123
"1443","6180橘子","110/08/11","美商高盛",25,0,25
"1444","6180橘子","110/08/11","合庫-高雄",0,31,-31
"1445","6180橘子","110/08/11","元大-草屯",17,0,17
"1446","6180橘子","110/08/11","摩根大通",13,36,-23
"1447","6180橘子","110/08/11","日盛-文化",16,0,16
"1448","6180橘子","110/08/11","凱基-台北",37,60,-23
"1449","6180橘子","110/08/11","康和-嘉義",11,0,11
"1450","6180橘子","110/08/11","北城證券",0,19,-19
"1451","6180橘子","110/08/11","元大-左營",11,0,11
"1452","6180橘子","110/08/11","元富-潮州",24,41,-17
"1453","6180橘子","110/08/11","土銀-花蓮",10,0,10
"1454","6180橘子","110/08/11","群益金鼎-新店",0,15,-15
"1455","6180橘子","110/08/11","日盛證券",10,0,10
"1456","6180橘子","110/08/11","兆豐-竹北",0,14,-14
"1457","6180橘子","110/08/11","日盛-高雄",10,0,10
"1458","6180橘子","110/08/11","元富-成功",0,13,-13
"1459","6180橘子","110/08/11","國泰-新莊",10,0,10
"1460","6180橘子","110/08/11","新加坡商瑞銀",0,10,-10
"1461","6180橘子","110/08/11","群益金鼎-東門",10,0,10
"1462","6180橘子","110/08/11","康和-高雄",0,10,-10
"1463","6180橘子","110/08/11","凱基-中壢",10,0,10
"1464","6180橘子","110/08/11","國泰-館前",0,10,-10
"1465","6180橘子","110/08/11","元大-中壢",10,0,10
"1466","6180橘子","110/08/11","群益金鼎-嘉義",1,11,-10
"1467","6180橘子","110/08/11","元大-復北",10,0,10
"1468","6180橘子","110/08/11","華南永昌-虎尾",0,10,-10
"1469","6180橘子","110/08/11","美林",12,3,9
"1470","6180橘子","110/08/11","元富-民權",0,8,-8
"1471","2390云辰","110/08/11","臺銀-臺中",224,5,219
"1472","2390云辰","110/08/11","摩根大通",194,707,-513
"1473","2390云辰","110/08/11","兆豐-寶成",187,2,185
"1474","2390云辰","110/08/11","美商高盛",18,229,-211
"1475","2390云辰","110/08/11","元大-土城學府",143,69,74
"1476","2390云辰","110/08/11","兆豐-岡山",5,103,-98
"1477","2390云辰","110/08/11","凱基-民權",70,0,70
"1478","2390云辰","110/08/11","台新證券",13,108,-95
"1479","2390云辰","110/08/11","元大-草屯",67,2,65
"1480","2390云辰","110/08/11","美林",23,98,-75
"1481","2390云辰","110/08/11","兆豐-公益",60,0,60
"1482","2390云辰","110/08/11","永豐金-竹科",0,71,-71
"1483","2390云辰","110/08/11","國票-安和",56,0,56
"1484","2390云辰","110/08/11","元富-花蓮",0,70,-70
"1485","2390云辰","110/08/11","元富-中港",50,0,50
"1486","2390云辰","110/08/11","統一-城中",5,66,-61
"1487","2390云辰","110/08/11","元富-高雄",48,1,47
"1488","2390云辰","110/08/11","國泰-台中",50,109,-59
"1489","2390云辰","110/08/11","統一-新營",45,5,40
"1490","2390云辰","110/08/11","元大-豐原站前",10,69,-59
"1491","2390云辰","110/08/11","元大-板橋三民",39,1,38
"1492","2390云辰","110/08/11","新加坡商瑞銀",18,75,-57
"1493","2390云辰","110/08/11","元富-新店",52,17,35
"1494","2390云辰","110/08/11","台新-左楠",15,67,-52
"1495","2390云辰","110/08/11","永全-南崁",35,4,31
"1496","2390云辰","110/08/11","凱基-中壢",7,59,-52
"1497","2390云辰","110/08/11","群益金鼎-萬華",33,3,30
"1498","2390云辰","110/08/11","國票-北高雄",23,69,-46
"1499","2390云辰","110/08/11","日盛-宜蘭",25,0,25
"1500","2390云辰","110/08/11","新光-高雄",11,53,-42
"1501","2542興富發","110/08/06","瑞士信貸",747,10,737
"1502","2542興富發","110/08/06","凱基-士林",5,972,-967
"1503","2542興富發","110/08/06","摩根大通",837,107,730
"1504","2542興富發","110/08/06","統一-台中",1,376,-375
"1505","2542興富發","110/08/06","群益金鼎-敦南",681,1,680
"1506","2542興富發","110/08/06","永豐金-豐原",16,133,-117
"1507","2542興富發","110/08/06","凱基-台北",790,360,430
"1508","2542興富發","110/08/06","元富-敦南",0,111,-111
"1509","2542興富發","110/08/06","台灣摩根士丹利",259,20,239
"1510","2542興富發","110/08/06","兆豐-南京",0,108,-108
"1511","2542興富發","110/08/06","美商高盛",235,0,235
"1512","2542興富發","110/08/06","元大-金華",0,100,-100
"1513","2542興富發","110/08/06","新加坡商瑞銀",178,0,178
"1514","2542興富發","110/08/06","陽信",0,80,-80
"1515","2542興富發","110/08/06","凱基-中山",167,2,165
"1516","2542興富發","110/08/06","統一-金門",0,78,-78
"1517","2542興富發","110/08/06","凱基",121,14,107
"1518","2542興富發","110/08/06","新光-台中",7,68,-61
"1519","2542興富發","110/08/06","大慶-楊梅",101,4,97
"1520","2542興富發","110/08/06","富邦-新店",2,58,-56
"1521","2542興富發","110/08/06","美林",193,109,84
"1522","2542興富發","110/08/06","元大-新竹",0,52,-52
"1523","2542興富發","110/08/06","統一",64,5,59
"1524","2542興富發","110/08/06","凱基-永和",0,51,-51
"1525","2542興富發","110/08/06","富邦-南屯",60,1,59
"1526","2542興富發","110/08/06","統一-中壢",0,50,-50
"1527","2542興富發","110/08/06","群益金鼎",43,0,43
"1528","2542興富發","110/08/06","元富",0,50,-50
"1529","2542興富發","110/08/06","元大證券",128,85,43
"1530","2542興富發","110/08/06","法銀巴黎",0,48,-48
"1531","2867三商壽","110/08/06","摩根大通",410,157,253
"1532","2867三商壽","110/08/06","日盛-新莊",0,719,-719
"1533","2867三商壽","110/08/06","元大-北港",201,0,201
"1534","2867三商壽","110/08/06","群益金鼎-桃園",0,400,-400
"1535","2867三商壽","110/08/06","元大-斗信",200,0,200
"1536","2867三商壽","110/08/06","中國信託-文心",1,301,-300
"1537","2867三商壽","110/08/06","元大-沙鹿",199,0,199
"1538","2867三商壽","110/08/06","美林",10,169,-159
"1539","2867三商壽","110/08/06","永豐金-嘉義",130,0,130
"1540","2867三商壽","110/08/06","法銀巴黎",0,122,-122
"1541","2867三商壽","110/08/06","第一金-自由",100,0,100
"1542","2867三商壽","110/08/06","國票-中和",0,100,-100
"1543","2867三商壽","110/08/06","元大-大里德芳",100,0,100
"1544","2867三商壽","110/08/06","台灣摩根士丹利",65,164,-99
"1545","2867三商壽","110/08/06","元大-土城永寧",100,0,100
"1546","2867三商壽","110/08/06","凱基-高美館",2,64,-62
"1547","2867三商壽","110/08/06","瑞士信貸",94,0,94
"1548","2867三商壽","110/08/06","元大證券",1,62,-61
"1549","2867三商壽","110/08/06","元大-汐止",60,0,60
"1550","2867三商壽","110/08/06","華南永昌-南京",0,50,-50
"1551","2867三商壽","110/08/06","元富-大裕",52,0,52
"1552","2867三商壽","110/08/06","凱基-頭份",0,45,-45
"1553","2867三商壽","110/08/06","新光",53,1,52
"1554","2867三商壽","110/08/06","凱基",0,44,-44
"1555","2867三商壽","110/08/06","凱基-市府",51,0,51
"1556","2867三商壽","110/08/06","康和-屏東",0,43,-43
"1557","2867三商壽","110/08/06","安泰",49,0,49
"1558","2867三商壽","110/08/06","凱基-八德",0,40,-40
"1559","2867三商壽","110/08/06","富邦-桃園",50,2,48
"1560","2867三商壽","110/08/06","凱基-虎尾",0,40,-40
"1561","5521工信","110/08/06","日進",412,0,412
"1562","5521工信","110/08/06","中國信託-嘉義",0,100,-100
"1563","5521工信","110/08/06","瑞士信貸",48,0,48
"1564","5521工信","110/08/06","美林",0,69,-69
"1565","5521工信","110/08/06","日盛-雙和",34,0,34
"1566","5521工信","110/08/06","統一-新竹",0,60,-60
"1567","5521工信","110/08/06","聯邦-雙和",25,0,25
"1568","5521工信","110/08/06","第一金-桃園",0,55,-55
"1569","5521工信","110/08/06","台新證券",32,12,20
"1570","5521工信","110/08/06","凱基-台北",0,54,-54
"1571","5521工信","110/08/06","土銀-台中",17,0,17
"1572","5521工信","110/08/06","華南永昌-桃園",0,49,-49
"1573","5521工信","110/08/06","(牛牛牛)亞-鑫豐",15,0,15
"1574","5521工信","110/08/06","第一金-安和",0,40,-40
"1575","5521工信","110/08/06","元大-沙鹿",19,4,15
"1576","5521工信","110/08/06","合庫-台南",0,36,-36
"1577","5521工信","110/08/06","元富-安南",14,0,14
"1578","5521工信","110/08/06","台灣摩根士丹利",7,34,-27
"1579","5521工信","110/08/06","新加坡商瑞銀",10,0,10
"1580","5521工信","110/08/06","摩根大通",22,48,-26
"1581","5521工信","110/08/06","德信-中正",10,0,10
"1582","5521工信","110/08/06","台新-台中",0,20,-20
"1583","5521工信","110/08/06","國泰-敦南",22,12,10
"1584","5521工信","110/08/06","元大-豐原",0,20,-20
"1585","5521工信","110/08/06","群益金鼎-屏東",10,0,10
"1586","5521工信","110/08/06","元大-北成功",0,20,-20
"1587","5521工信","110/08/06","群益金鼎-東門",10,0,10
"1588","5521工信","110/08/06","永豐金-埔里",0,20,-20
"1589","5521工信","110/08/06","元大-西螺",10,0,10
"1590","5521工信","110/08/06","港商野村",0,16,-16
"1591","1471首利","110/08/06","國票-彰化",30,0,30
"1592","1471首利","110/08/06","兆豐-麻豆",0,50,-50
"1593","1471首利","110/08/06","凱基-宜蘭",27,0,27
"1594","1471首利","110/08/06","台新證券",3,30,-27
"1595","1471首利","110/08/06","玉山-桃園",22,0,22
"1596","1471首利","110/08/06","美林",15,41,-26
"1597","1471首利","110/08/06","新光-台中",17,0,17
"1598","1471首利","110/08/06","永豐金-台南",0,25,-25
"1599","1471首利","110/08/06","兆豐-埔墘",14,0,14
"1600","1471首利","110/08/06","元富-草屯",0,19,-19
"1601","1471首利","110/08/06","新光-高雄",11,0,11
"1602","1471首利","110/08/06","新光-桃園",0,17,-17
"1603","1471首利","110/08/06","合庫-鳳山",10,0,10
"1604","1471首利","110/08/06","摩根大通",13,28,-15
"1605","1471首利","110/08/06","統一-竹南",10,0,10
"1606","1471首利","110/08/06","華南永昌-淡水",1,15,-14
"1607","1471首利","110/08/06","(牛牛牛)亞-鑫豐",10,0,10
"1608","1471首利","110/08/06","台中銀",1,14,-13
"1609","1471首利","110/08/06","兆豐-岡山",10,0,10
"1610","1471首利","110/08/06","玉山-板橋",0,12,-12
"1611","1471首利","110/08/06","凱基-彰化",10,0,10
"1612","1471首利","110/08/06","富邦-基隆",10,22,-12
"1613","1471首利","110/08/06","富邦-永和",10,0,10
"1614","1471首利","110/08/06","台灣企銀",0,10,-10
"1615","1471首利","110/08/06","元大-竹山",10,0,10
"1616","1471首利","110/08/06","元富-民權",0,10,-10
"1617","1471首利","110/08/06","元大-民雄",10,0,10
"1618","1471首利","110/08/06","元大-左營",0,10,-10
"1619","1471首利","110/08/06","元大-南崁",10,1,9
"1620","1471首利","110/08/06","大昌-新店",2,11,-9
"1621","2883開發金","110/08/06","國泰證券",7766,49,7717
"1622","2883開發金","110/08/06","永豐金-板橋",2,2245,-2243
"1623","2883開發金","110/08/06","元富-城東",7094,124,6970
"1624","2883開發金","110/08/06","玉山-台南",63,2130,-2067
"1625","2883開發金","110/08/06","摩根大通",4922,1097,3825
"1626","2883開發金","110/08/06","國泰-板橋",236,1871,-1635
"1627","2883開發金","110/08/06","瑞士信貸",3230,108,3122
"1628","2883開發金","110/08/06","港商野村",1243,2562,-1319
"1629","2883開發金","110/08/06","凱基-台北",4810,2311,2499
"1630","2883開發金","110/08/06","美林",1480,2782,-1302
"1631","2883開發金","110/08/06","合庫證券",3551,2064,1487
"1632","2883開發金","110/08/06","群益金鼎-中山",7,1151,-1144
"1633","2883開發金","110/08/06","新加坡商瑞銀",3900,2689,1211
"1634","2883開發金","110/08/06","日盛-員林",17,1100,-1083
"1635","2883開發金","110/08/06","玉山證券",1332,183,1149
"1636","2883開發金","110/08/06","台灣摩根士丹利",509,1544,-1035
"1637","2883開發金","110/08/06","國票-長城",1003,0,1003
"1638","2883開發金","110/08/06","台灣企銀-民雄",0,1004,-1004
"1639","2883開發金","110/08/06","康和",720,0,720
"1640","2883開發金","110/08/06","港商法國興業",7,981,-974
"1641","2883開發金","110/08/06","福邦證券",590,15,575
"1642","2883開發金","110/08/06","新光",240,1199,-959
"1643","2883開發金","110/08/06","台灣企銀-九如",492,10,482
"1644","2883開發金","110/08/06","元大-新莊",58,1017,-959
"1645","2883開發金","110/08/06","宏遠-民生",502,54,448
"1646","2883開發金","110/08/06","富邦-彰化",5,766,-761
"1647","2883開發金","110/08/06","元大證券",803,358,445
"1648","2883開發金","110/08/06","中國信託",270,931,-661
"1649","2883開發金","110/08/06","玉山-高雄",476,80,396
"1650","2883開發金","110/08/06","永豐金-彰化",33,655,-622
"1651","6205詮欣","110/08/06","臺銀-民權",20,0,20
"1652","6205詮欣","110/08/06","元大-板橋",0,50,-50
"1653","6205詮欣","110/08/06","合庫-三重",15,0,15
"1654","6205詮欣","110/08/06","摩根大通",0,29,-29
"1655","6205詮欣","110/08/06","日盛-三重",15,4,11
"1656","6205詮欣","110/08/06","臺銀-新竹",0,3,-3
"1657","6205詮欣","110/08/06","凱基-長庚",10,0,10
"1658","6205詮欣","110/08/06","日盛-頭份",0,3,-3
"1659","6205詮欣","110/08/06","臺銀-臺中",5,0,5
"1660","6205詮欣","110/08/06","群益金鼎-潭子",0,3,-3
"1661","6205詮欣","110/08/06","兆豐-台中",4,0,4
"1662","6205詮欣","110/08/06","永豐金-敦南",0,3,-3
"1663","6205詮欣","110/08/06","凱基-台北",4,0,4
"1664","6205詮欣","110/08/06","美林",0,2,-2
"1665","6205詮欣","110/08/06","元大-龍潭",4,0,4
"1666","6205詮欣","110/08/06","新加坡商瑞銀",6,8,-2
"1667","6205詮欣","110/08/06","瑞士信貸",3,0,3
"1668","6205詮欣","110/08/06","華南永昌-淡水",0,2,-2
"1669","6205詮欣","110/08/06","國泰-板橋",3,0,3
"1670","6205詮欣","110/08/06","元大-發財",0,2,-2
"1671","6205詮欣","110/08/06","台中銀",2,0,2
"1672","6205詮欣","110/08/06","元大-屏東民生",0,2,-2
"1673","6205詮欣","110/08/06","德信-新營",2,0,2
"1674","6205詮欣","110/08/06","統一-南京",0,1,-1
"1675","6205詮欣","110/08/06","兆豐-竹北",2,0,2
"1676","6205詮欣","110/08/06","新光-台中",0,1,-1
"1677","6205詮欣","110/08/06","兆豐-景美",2,0,2
"1678","6205詮欣","110/08/06","玉山證券",0,1,-1
"1679","6205詮欣","110/08/06","台新-台中",2,0,2
"1680","6205詮欣","110/08/06","富邦-左營",0,1,-1
"1681","1540喬福","110/08/06","元富-中原",27,0,27
"1682","1540喬福","110/08/06","統一-新台中",0,25,-25
"1683","1540喬福","110/08/06","合庫-台中",24,0,24
"1684","1540喬福","110/08/06","大慶-中壢",0,24,-24
"1685","1540喬福","110/08/06","台新-台中",10,0,10
"1686","1540喬福","110/08/06","福勝",0,7,-7
"1687","1540喬福","110/08/06","富邦-竹北",7,0,7
"1688","1540喬福","110/08/06","群益金鼎-高雄",0,5,-5
"1689","1540喬福","110/08/06","華南永昌-中正",5,0,5
"1690","1540喬福","110/08/06","富邦-高雄",0,5,-5
"1691","1540喬福","110/08/06","玉山證券",4,0,4
"1692","1540喬福","110/08/06","美林",0,3,-3
"1693","1540喬福","110/08/06","兆豐-台中港",2,0,2
"1694","1540喬福","110/08/06","元大-景美",0,3,-3
"1695","1540喬福","110/08/06","國票-中正",2,0,2
"1696","1540喬福","110/08/06","元大-和平",0,3,-3
"1697","1540喬福","110/08/06","凱基-虎尾",2,0,2
"1698","1540喬福","110/08/06","日盛-台中",0,2,-2
"1699","1540喬福","110/08/06","凱基-台北",2,0,2
"1700","1540喬福","110/08/06","日盛-中和",0,2,-2
"1701","1540喬福","110/08/06","元大-府城",2,0,2
"1702","1540喬福","110/08/06","台新-台南",0,2,-2
"1703","1540喬福","110/08/06","土銀-玉里",1,0,1
"1704","1540喬福","110/08/06","玉山-高雄",0,2,-2
"1705","1540喬福","110/08/06","第一金-中壢",1,0,1
"1706","1540喬福","110/08/06","凱基-中壢",0,2,-2
"1707","1540喬福","110/08/06","國票-彰化",1,0,1
"1708","1540喬福","110/08/06","致和-南京",0,1,-1
"1709","1540喬福","110/08/06","國泰-敦南",1,0,1
"1710","1540喬福","110/08/06","摩根大通",0,1,-1
"1711","2888新光金","110/08/06","玉山-城中",3762,22,3740
"1712","2888新光金","110/08/06","美林",583,3191,-2608
"1713","2888新光金","110/08/06","瑞士信貸",1783,778,1005
"1714","2888新光金","110/08/06","元富-城東",39,1594,-1555
"1715","2888新光金","110/08/06","元大-土城永寧",1004,16,988
"1716","2888新光金","110/08/06","日盛-板橋",19,1000,-981
"1717","2888新光金","110/08/06","新加坡商瑞銀",1129,357,772
"1718","2888新光金","110/08/06","摩根大通",2207,3153,-946
"1719","2888新光金","110/08/06","中國信託",566,4,562
"1720","2888新光金","110/08/06","新光",505,1390,-885
"1721","2888新光金","110/08/06","富邦-員林",484,3,481
"1722","2888新光金","110/08/06","台灣摩根士丹利",181,1022,-841
"1723","2888新光金","110/08/06","臺銀-金山",432,3,429
"1724","2888新光金","110/08/06","元大-四維",35,750,-715
"1725","2888新光金","110/08/06","臺銀",418,2,416
"1726","2888新光金","110/08/06","美商高盛",114,811,-697
"1727","2888新光金","110/08/06","凱基-東勢",404,6,398
"1728","2888新光金","110/08/06","法銀巴黎",274,867,-593
"1729","2888新光金","110/08/06","玉山證券",416,73,343
"1730","2888新光金","110/08/06","元大-員林",18,503,-485
"1731","2888新光金","110/08/06","華南永昌-民權",305,0,305
"1732","2888新光金","110/08/06","富邦-建國",57,471,-414
"1733","2888新光金","110/08/06","永興",300,10,290
"1734","2888新光金","110/08/06","富邦-台中",15,418,-403
"1735","2888新光金","110/08/06","富邦-台北",319,48,271
"1736","2888新光金","110/08/06","華南永昌-嘉義",2,324,-322
"1737","2888新光金","110/08/06","兆豐-員林",274,28,246
"1738","2888新光金","110/08/06","凱基-台北",839,1120,-281
"1739","2888新光金","110/08/06","合庫-台中",240,10,230
"1740","2888新光金","110/08/06","國泰-館前",20,289,-269
"1741","1340勝悅","110/08/06","國泰-台中",30,0,30
"1742","1340勝悅","110/08/06","凱基-三峽",0,20,-20
"1743","1340勝悅","110/08/06","元富-彰化",10,0,10
"1744","1340勝悅","110/08/06","富邦-台東",1,14,-13
"1745","1340勝悅","110/08/06","華南永昌-忠孝",8,0,8
"1746","1340勝悅","110/08/06","華南永昌-三重",0,12,-12
"1747","1340勝悅","110/08/06","華南永昌-大安",7,0,7
"1748","1340勝悅","110/08/06","華南永昌-台中",0,10,-10
"1749","1340勝悅","110/08/06","永豐金-信義",6,0,6
"1750","1340勝悅","110/08/06","美林",0,8,-8
"1751","1340勝悅","110/08/06","臺灣企銀-埔墘",5,0,5
"1752","1340勝悅","110/08/06","第一金-豐原",0,8,-8
"1753","1340勝悅","110/08/06","元大-沙鹿",5,0,5
"1754","1340勝悅","110/08/06","凱基-城中",0,8,-8
"1755","1340勝悅","110/08/06","新光-高雄",4,0,4
"1756","1340勝悅","110/08/06","華南永昌-嘉義",0,6,-6
"1757","1340勝悅","110/08/06","群益金鼎-彰化",4,0,4
"1758","1340勝悅","110/08/06","元富",0,5,-5
"1759","1340勝悅","110/08/06","元大-仁愛",4,0,4
"1760","1340勝悅","110/08/06","光和-田中",0,5,-5
"1761","1340勝悅","110/08/06","美商高盛",3,0,3
"1762","1340勝悅","110/08/06","摩根大通",0,5,-5
"1763","1340勝悅","110/08/06","群益金鼎-館前",3,0,3
"1764","1340勝悅","110/08/06","元大-草屯",0,4,-4
"1765","1340勝悅","110/08/06","臺銀-臺中",2,0,2
"1766","1340勝悅","110/08/06","凱基-台北",1,4,-3
"1767","1340勝悅","110/08/06","永全-南崁",2,0,2
"1768","1340勝悅","110/08/06","元大-苑裡",0,3,-3
"1769","1340勝悅","110/08/06","群益金鼎-崇德",2,0,2
"1770","1340勝悅","110/08/06","日盛-員林",0,2,-2
"1771","6246臺龍","110/08/06","元大-西螺",120,1,119
"1772","6246臺龍","110/08/06","統一",0,247,-247
"1773","6246臺龍","110/08/06","富邦-敦南",111,0,111
"1774","6246臺龍","110/08/06","元大-林森",3,203,-200
"1775","6246臺龍","110/08/06","統一-台中",74,10,64
"1776","6246臺龍","110/08/06","凱基-大直",4,103,-99
"1777","6246臺龍","110/08/06","日盛證券",53,0,53
"1778","6246臺龍","110/08/06","大慶-富順",45,110,-65
"1779","6246臺龍","110/08/06","兆豐-高雄",81,38,43
"1780","6246臺龍","110/08/06","統一-南京",20,70,-50
"1781","6246臺龍","110/08/06","群益金鼎-東大",43,2,41
"1782","6246臺龍","110/08/06","港商野村",166,213,-47
"1783","6246臺龍","110/08/06","統一-永和",40,0,40
"1784","6246臺龍","110/08/06","台灣企銀",0,45,-45
"1785","6246臺龍","110/08/06","凱基-市府",48,8,40
"1786","6246臺龍","110/08/06","華南永昌-忠孝",1,45,-44
"1787","6246臺龍","110/08/06","凱基-員林",40,0,40
"1788","6246臺龍","110/08/06","永豐金-桃盛",0,35,-35
"1789","6246臺龍","110/08/06","新光-高雄",57,21,36
"1790","6246臺龍","110/08/06","康和-澎湖",0,30,-30
"1791","6246臺龍","110/08/06","國泰-敦南",104,69,35
"1792","6246臺龍","110/08/06","康和-石牌",0,30,-30
"1793","6246臺龍","110/08/06","元大-金門",39,5,34
"1794","6246臺龍","110/08/06","中國信託-永康",6,35,-29
"1795","6246臺龍","110/08/06","元大-西屯",29,2,27
"1796","6246臺龍","110/08/06","康和-內湖",2,30,-28
"1797","6246臺龍","110/08/06","永興-水湳",26,1,25
"1798","6246臺龍","110/08/06","大昌",16,43,-27
"1799","6246臺龍","110/08/06","元大-豐原站前",25,0,25
"1800","6246臺龍","110/08/06","台新證券",29,55,-26
"1801","00715L期街口布蘭特正2","110/08/06","華南永昌-長虹",810,50,760
"1802","00715L期街口布蘭特正2","110/08/06","永豐金證券",105,2122,-2017
"1803","00715L期街口布蘭特正2","110/08/06","富邦證券",557,0,557
"1804","00715L期街口布蘭特正2","110/08/06","(牛牛牛)亞-鑫豐",23,892,-869
"1805","00715L期街口布蘭特正2","110/08/06","新光",643,129,514
"1806","00715L期街口布蘭特正2","110/08/06","凱基-台北",1,789,-788
"1807","00715L期街口布蘭特正2","110/08/06","台新-新營",434,0,434
"1808","00715L期街口布蘭特正2","110/08/06","元大-永康",0,781,-781
"1809","00715L期街口布蘭特正2","110/08/06","群益金鼎-屏東",401,0,401
"1810","00715L期街口布蘭特正2","110/08/06","富邦-彰化",0,513,-513
"1811","00715L期街口布蘭特正2","110/08/06","永豐金-板盛",402,21,381
"1812","00715L期街口布蘭特正2","110/08/06","玉山-大里",0,488,-488
"1813","00715L期街口布蘭特正2","110/08/06","兆豐-員林",302,6,296
"1814","00715L期街口布蘭特正2","110/08/06","元大-中和",0,400,-400
"1815","00715L期街口布蘭特正2","110/08/06","兆豐-新莊",260,0,260
"1816","00715L期街口布蘭特正2","110/08/06","元富-安南",2,310,-308
"1817","00715L期街口布蘭特正2","110/08/06","宏遠-光隆",252,0,252
"1818","00715L期街口布蘭特正2","110/08/06","元大-羅東",5,304,-299
"1819","00715L期街口布蘭特正2","110/08/06","台中銀",207,0,207
"1820","00715L期街口布蘭特正2","110/08/06","第一金-路竹",13,273,-260
"1821","00715L期街口布蘭特正2","110/08/06","國票-北高雄",204,0,204
"1822","00715L期街口布蘭特正2","110/08/06","元大-新盛",5,247,-242
"1823","00715L期街口布蘭特正2","110/08/06","永豐金-新店",200,4,196
"1824","00715L期街口布蘭特正2","110/08/06","元大-忠孝",0,202,-202
"1825","00715L期街口布蘭特正2","110/08/06","元大-新莊",211,17,194
"1826","00715L期街口布蘭特正2","110/08/06","兆豐-嘉義",8,200,-192
"1827","00715L期街口布蘭特正2","110/08/06","聯邦-興中",185,0,185
"1828","00715L期街口布蘭特正2","110/08/06","元大-西屯",5,190,-185
"1829","00715L期街口布蘭特正2","110/08/06","元富-成功",244,62,182
"1830","00715L期街口布蘭特正2","110/08/06","元大-前金",1,181,-180
"1831","8941關中","110/08/06","第一金-台南",6,0,6
"1832","8941關中","110/08/06","富邦-員林",0,20,-20
"1833","8941關中","110/08/06","凱基-市府",6,0,6
"1834","8941關中","110/08/06","元大-金華",0,1,-1
"1835","8941關中","110/08/06","合庫-台中",5,0,5
"1836","8941關中","110/08/06","元大-淡水",0,1,-1
"1837","8941關中","110/08/06","永豐金-三重",2,0,2
"1838","8941關中","110/08/06","合庫證券",0,0,0
"1839","8941關中","110/08/06","(牛牛牛)亞-鑫豐",1,0,1
"1840","8941關中","110/08/06","元大證券",0,0,0
"1841","8941關中","110/08/06","群益金鼎-基隆",1,0,1
"1842","8941關中","110/08/06","元大-桃興",2,2,0
"1843","8941關中","110/08/06","元大-古亭",1,0,1
"1844","8941關中","110/08/06","元大-板橋",0,0,0
"1845","8941關中","110/08/06","合庫證券",0,0,0
"1846","8941關中","110/08/06","永豐金-萬盛",0,0,0
"1847","8941關中","110/08/06","元大證券",0,0,0
"1848","8941關中","110/08/06","",NA,NA,NA
"1849","8941關中","110/08/06","元大-桃興",2,2,0
"1850","8941關中","110/08/06","",NA,NA,NA
"1851","8941關中","110/08/06","元大-板橋",0,0,0
"1852","8941關中","110/08/06","",NA,NA,NA
"1853","8941關中","110/08/06","永豐金-萬盛",0,0,0
"1854","8941關中","110/08/06","",NA,NA,NA
"1855","8941關中","110/08/06","",NA,NA,NA
"1856","8941關中","110/08/06","",NA,NA,NA
"1857","8941關中","110/08/06","",NA,NA,NA
"1858","8941關中","110/08/06","",NA,NA,NA
"1859","8941關中","110/08/06","",NA,NA,NA
"1860","8941關中","110/08/06","",NA,NA,NA
"1861","8936國統","110/08/06","摩根大通",55,0,55
"1862","8936國統","110/08/06","大慶-蘆洲",1,63,-62
"1863","8936國統","110/08/06","凱基-台北",66,19,47
"1864","8936國統","110/08/06","宏遠-館前",0,50,-50
"1865","8936國統","110/08/06","國票-敦北法人",25,1,24
"1866","8936國統","110/08/06","凱基-長庚",0,46,-46
"1867","8936國統","110/08/06","元大-大里德芳",22,0,22
"1868","8936國統","110/08/06","台灣摩根士丹利",0,42,-42
"1869","8936國統","110/08/06","兆豐-新營",20,0,20
"1870","8936國統","110/08/06","永豐金-苓雅",15,48,-33
"1871","8936國統","110/08/06","新光-新竹",17,0,17
"1872","8936國統","110/08/06","元大-竹東",0,30,-30
"1873","8936國統","110/08/06","新光-台中",17,4,13
"1874","8936國統","110/08/06","新加坡商瑞銀",23,49,-26
"1875","8936國統","110/08/06","元富-新店",10,0,10
"1876","8936國統","110/08/06","國票-北高雄",0,25,-25
"1877","8936國統","110/08/06","中國信託-永康",10,0,10
"1878","8936國統","110/08/06","國泰-台南",0,20,-20
"1879","8936國統","110/08/06","台新-高雄",11,1,10
"1880","8936國統","110/08/06","國泰-敦南",7,24,-17
"1881","8936國統","110/08/06","國泰-板橋",10,0,10
"1882","8936國統","110/08/06","臺灣企銀-桃園",0,13,-13
"1883","8936國統","110/08/06","群益金鼎-東湖",10,0,10
"1884","8936國統","110/08/06","美商高盛",1,13,-12
"1885","8936國統","110/08/06","元大-北成功",10,0,10
"1886","8936國統","110/08/06","合庫-高雄",0,10,-10
"1887","8936國統","110/08/06","臺銀-高雄",9,0,9
"1888","8936國統","110/08/06","臺銀",0,10,-10
"1889","8936國統","110/08/06","日盛-和美",9,0,9
"1890","8936國統","110/08/06","元大-土城學府",0,10,-10
"1891","6226光鼎","110/08/06","國泰-敦南",183,87,96
"1892","6226光鼎","110/08/06","富邦-嘉義",286,537,-251
"1893","6226光鼎","110/08/06","台新-高雄",129,53,76
"1894","6226光鼎","110/08/06","統一-新竹",30,181,-151
"1895","6226光鼎","110/08/06","新光",81,25,56
"1896","6226光鼎","110/08/06","宏遠-台中",0,118,-118
"1897","6226光鼎","110/08/06","台新證券",112,57,55
"1898","6226光鼎","110/08/06","華南永昌-大安",2,82,-80
"1899","6226光鼎","110/08/06","台新-新營",56,4,52
"1900","6226光鼎","110/08/06","元富-西松",1,76,-75
"1901","6226光鼎","110/08/06","中國信託",48,7,41
"1902","6226光鼎","110/08/06","凱基-豐中",1,74,-73
"1903","6226光鼎","110/08/06","富邦-板橋",38,5,33
"1904","6226光鼎","110/08/06","凱基-長庚",3,64,-61
"1905","6226光鼎","110/08/06","台新-中壢",32,0,32
"1906","6226光鼎","110/08/06","元富-高雄",2,58,-56
"1907","6226光鼎","110/08/06","日盛-北高雄",32,1,31
"1908","6226光鼎","110/08/06","永豐金-萬盛",2,49,-47
"1909","6226光鼎","110/08/06","群益金鼎-桃園",31,0,31
"1910","6226光鼎","110/08/06","統一-仁愛",11,57,-46
"1911","6226光鼎","110/08/06","元大-屏東民生",31,0,31
"1912","6226光鼎","110/08/06","國票-台中",0,46,-46
"1913","6226光鼎","110/08/06","中國信託-永康",35,5,30
"1914","6226光鼎","110/08/06","群益金鼎-嘉義",11,55,-44
"1915","6226光鼎","110/08/06","國泰-台中",57,27,30
"1916","6226光鼎","110/08/06","元大-沙鹿",6,50,-44
"1917","6226光鼎","110/08/06","群益金鼎-板橋",30,0,30
"1918","6226光鼎","110/08/06","新光-高雄",17,58,-41
"1919","6226光鼎","110/08/06","寶盛",29,0,29
"1920","6226光鼎","110/08/06","元大-嘉義",3,36,-33
"1921","2363矽統","110/08/06","新加坡商瑞銀",1338,777,561
"1922","2363矽統","110/08/06","凱基-台北",4343,7347,-3004
"1923","2363矽統","110/08/06","日盛-三峽",475,86,389
"1924","2363矽統","110/08/06","摩根大通",1716,2908,-1192
"1925","2363矽統","110/08/06","中國信託-忠孝",433,44,389
"1926","2363矽統","110/08/06","美商高盛",315,1169,-854
"1927","2363矽統","110/08/06","陽信-石牌",448,73,375
"1928","2363矽統","110/08/06","永豐金證券",168,889,-721
"1929","2363矽統","110/08/06","國泰-台中",743,471,272
"1930","2363矽統","110/08/06","國票-敦北法人",29,513,-484
"1931","2363矽統","110/08/06","國泰-敦南",2177,1919,258
"1932","2363矽統","110/08/06","元富-嘉義",43,424,-381
"1933","2363矽統","110/08/06","台新-台中",565,347,218
"1934","2363矽統","110/08/06","元大-東泰",174,540,-366
"1935","2363矽統","110/08/06","元大-敦化",246,31,215
"1936","2363矽統","110/08/06","元大證券",187,522,-335
"1937","2363矽統","110/08/06","大昌-桃園",241,51,190
"1938","2363矽統","110/08/06","合庫證券",173,495,-322
"1939","2363矽統","110/08/06","華南永昌-淡水",230,48,182
"1940","2363矽統","110/08/06","元大-萬華",128,391,-263
"1941","2363矽統","110/08/06","港商野村",2381,2203,178
"1942","2363矽統","110/08/06","國票-博愛",93,350,-257
"1943","2363矽統","110/08/06","台新-高雄",529,361,168
"1944","2363矽統","110/08/06","台新-屏東",200,455,-255
"1945","2363矽統","110/08/06","元大-新竹",320,156,164
"1946","2363矽統","110/08/06","日盛-南京",74,327,-253
"1947","2363矽統","110/08/06","元大-中壢",454,292,162
"1948","2363矽統","110/08/06","兆豐-民生",16,227,-211
"1949","2363矽統","110/08/06","新光-台南",310,150,160
"1950","2363矽統","110/08/06","元大-旗山",168,364,-196
"1951","8112至上","110/08/06","新光-新竹",533,65,468
"1952","8112至上","110/08/06","摩根大通",12,2930,-2918
"1953","8112至上","110/08/06","國泰-新莊",192,0,192
"1954","8112至上","110/08/06","凱基-台北",388,1548,-1160
"1955","8112至上","110/08/06","合庫證券",195,11,184
"1956","8112至上","110/08/06","新加坡商瑞銀",17,1069,-1052
"1957","8112至上","110/08/06","元大-西門",178,2,176
"1958","8112至上","110/08/06","台灣摩根士丹利",48,955,-907
"1959","8112至上","110/08/06","(牛牛牛)亞-鑫豐",153,13,140
"1960","8112至上","110/08/06","元大-竹科",61,824,-763
"1961","8112至上","110/08/06","永豐金-中正",120,1,119
"1962","8112至上","110/08/06","美林",19,583,-564
"1963","8112至上","110/08/06","陽信",111,0,111
"1964","8112至上","110/08/06","瑞士信貸",0,547,-547
"1965","8112至上","110/08/06","康和-板橋",106,0,106
"1966","8112至上","110/08/06","康和",2,484,-482
"1967","8112至上","110/08/06","群益金鼎-延平",101,0,101
"1968","8112至上","110/08/06","永豐金-台中",17,430,-413
"1969","8112至上","110/08/06","元大-北成功",110,14,96
"1970","8112至上","110/08/06","元大-屏南",4,393,-389
"1971","8112至上","110/08/06","元富-古亭",141,46,95
"1972","8112至上","110/08/06","美商高盛",12,217,-205
"1973","8112至上","110/08/06","臺灣企銀-埔墘",92,1,91
"1974","8112至上","110/08/06","新光-桃園",42,204,-162
"1975","8112至上","110/08/06","第一金-桃園",89,0,89
"1976","8112至上","110/08/06","玉山證券",18,162,-144
"1977","8112至上","110/08/06","台新證券",105,16,89
"1978","8112至上","110/08/06","群益金鼎-基隆",7,151,-144
"1979","8112至上","110/08/06","玉山-板橋",96,10,86
"1980","8112至上","110/08/06","台新-新營",60,183,-123
"1981","1570力肯","110/08/06","國票-北高雄",246,40,206
"1982","1570力肯","110/08/06","富邦-高雄",0,47,-47
"1983","1570力肯","110/08/06","統一-松江",43,0,43
"1984","1570力肯","110/08/06","凱基-台北",55,101,-46
"1985","1570力肯","110/08/06","日茂-南投",42,2,40
"1986","1570力肯","110/08/06","台新證券",25,60,-35
"1987","1570力肯","110/08/06","群益金鼎-三重",34,2,32
"1988","1570力肯","110/08/06","元富-三重",0,32,-32
"1989","1570力肯","110/08/06","華南永昌-麻豆",32,4,28
"1990","1570力肯","110/08/06","台中銀-員林",0,32,-32
"1991","1570力肯","110/08/06","永豐金-中和",29,2,27
"1992","1570力肯","110/08/06","國泰-板橋",1,33,-32
"1993","1570力肯","110/08/06","永豐金-大園",21,0,21
"1994","1570力肯","110/08/06","摩根大通",83,112,-29
"1995","1570力肯","110/08/06","統一-三重",25,5,20
"1996","1570力肯","110/08/06","玉山-新莊",0,27,-27
"1997","1570力肯","110/08/06","元富-新店",20,0,20
"1998","1570力肯","110/08/06","永豐金-虎尾",0,27,-27
"1999","1570力肯","110/08/06","大昌-桃園",21,1,20
"2000","1570力肯","110/08/06","玉山-左營",0,25,-25
"2001","1570力肯","110/08/06","康和-高雄",18,1,17
"2002","1570力肯","110/08/06","富邦-仁愛",10,32,-22
"2003","1570力肯","110/08/06","元富-潮州",16,0,16
"2004","1570力肯","110/08/06","中國信託-忠孝",0,21,-21
"2005","1570力肯","110/08/06","元富-松德",15,0,15
"2006","1570力肯","110/08/06","臺銀-鳳山",4,24,-20
"2007","1570力肯","110/08/06","凱基-嘉義",15,0,15
"2008","1570力肯","110/08/06","台新-屏東",1,21,-20
"2009","1570力肯","110/08/06","凱基-埔墘",15,0,15
"2010","1570力肯","110/08/06","群益金鼎-西松",0,20,-20
"2011","2929淘帝","110/08/06","統一",155,0,155
"2012","2929淘帝","110/08/06","元富-敦南",0,100,-100
"2013","2929淘帝","110/08/06","港商野村",188,52,136
"2014","2929淘帝","110/08/06","兆豐-忠孝",0,60,-60
"2015","2929淘帝","110/08/06","摩根大通",72,3,69
"2016","2929淘帝","110/08/06","台新證券",9,68,-59
"2017","2929淘帝","110/08/06","新光-新竹",45,0,45
"2018","2929淘帝","110/08/06","凱基-台北",30,80,-50
"2019","2929淘帝","110/08/06","華南永昌",40,1,39
"2020","2929淘帝","110/08/06","台新-台中",0,45,-45
"2021","2929淘帝","110/08/06","美林",52,18,34
"2022","2929淘帝","110/08/06","國泰-台中",2,43,-41
"2023","2929淘帝","110/08/06","新加坡商瑞銀",48,14,34
"2024","2929淘帝","110/08/06","華南永昌-林口",0,37,-37
"2025","2929淘帝","110/08/06","日盛-頭份",32,0,32
"2026","2929淘帝","110/08/06","元大-屏南",0,30,-30
"2027","2929淘帝","110/08/06","日盛-板橋中山",30,0,30
"2028","2929淘帝","110/08/06","群益金鼎-潭子",0,26,-26
"2029","2929淘帝","110/08/06","元大-中壢",25,3,22
"2030","2929淘帝","110/08/06","元大-新莊",3,26,-23
"2031","2929淘帝","110/08/06","元大-莒光",21,0,21
"2032","2929淘帝","110/08/06","臺銀-臺南",0,22,-22
"2033","2929淘帝","110/08/06","福勝",20,0,20
"2034","2929淘帝","110/08/06","新光",2,24,-22
"2035","2929淘帝","110/08/06","元富-三重",17,0,17
"2036","2929淘帝","110/08/06","華南永昌-長虹",0,22,-22
"2037","2929淘帝","110/08/06","國票-南京",17,0,17
"2038","2929淘帝","110/08/06","富邦-高雄",0,20,-20
"2039","2929淘帝","110/08/06","合庫證券",16,0,16
"2040","2929淘帝","110/08/06","元大-竹科",0,20,-20
"2041","5410國眾","110/08/06","元大-中壢",15,1,14
"2042","5410國眾","110/08/06","凱基-台北",0,16,-16
"2043","5410國眾","110/08/06","玉山-嘉義",10,0,10
"2044","5410國眾","110/08/06","元大-松山",0,15,-15
"2045","5410國眾","110/08/06","元大-敦南",10,0,10
"2046","5410國眾","110/08/06","元大-斗信",0,10,-10
"2047","5410國眾","110/08/06","永豐金-板橋",10,0,10
"2048","5410國眾","110/08/06","臺銀-臺南",0,9,-9
"2049","5410國眾","110/08/06","華南永昌-新莊",9,0,9
"2050","5410國眾","110/08/06","新光-台中",0,9,-9
"2051","5410國眾","110/08/06","華南永昌-世貿",6,0,6
"2052","5410國眾","110/08/06","群益金鼎-中壢",0,7,-7
"2053","5410國眾","110/08/06","亞東",5,0,5
"2054","5410國眾","110/08/06","永豐金-中和",0,7,-7
"2055","5410國眾","110/08/06","大昌-新店",5,0,5
"2056","5410國眾","110/08/06","元大-北投",0,6,-6
"2057","5410國眾","110/08/06","凱基-民權",5,0,5
"2058","5410國眾","110/08/06","元大-豐原站前",0,6,-6
"2059","5410國眾","110/08/06","元大-士林",5,0,5
"2060","5410國眾","110/08/06","臺銀",0,5,-5
"2061","5410國眾","110/08/06","元大-北三重",5,0,5
"2062","5410國眾","110/08/06","台灣企銀-太平",0,5,-5
"2063","5410國眾","110/08/06","永豐金-桃園",5,0,5
"2064","5410國眾","110/08/06","元大-大益",0,5,-5
"2065","5410國眾","110/08/06","兆豐-員林",4,0,4
"2066","5410國眾","110/08/06","元大-和平",0,5,-5
"2067","5410國眾","110/08/06","台新-三民",4,0,4
"2068","5410國眾","110/08/06","元大-台南",0,5,-5
"2069","5410國眾","110/08/06","國泰-敦南",6,2,4
"2070","5410國眾","110/08/06","元大-古亭",0,5,-5
"2071","2841台開","110/08/06","宏遠-館前",520,0,520
"2072","2841台開","110/08/06","元富-台南",0,200,-200
"2073","2841台開","110/08/06","合庫證券",193,0,193
"2074","2841台開","110/08/06","元大-鹿港",0,182,-182
"2075","2841台開","110/08/06","永興-台中",100,0,100
"2076","2841台開","110/08/06","群益金鼎-桃園",0,132,-132
"2077","2841台開","110/08/06","永豐金-竹北",78,0,78
"2078","2841台開","110/08/06","中國信託-忠孝",0,130,-130
"2079","2841台開","110/08/06","元大證券",50,0,50
"2080","2841台開","110/08/06","元大-四維",3,116,-113
"2081","2841台開","110/08/06","元大-大天母",50,0,50
"2082","2841台開","110/08/06","元富-嘉義",0,50,-50
"2083","2841台開","110/08/06","永豐金-敦南",50,0,50
"2084","2841台開","110/08/06","元富-板橋",0,50,-50
"2085","2841台開","110/08/06","日盛-園區",49,0,49
"2086","2841台開","110/08/06","(牛牛牛)亞-鑫豐",0,50,-50
"2087","2841台開","110/08/06","元大-前金",38,0,38
"2088","2841台開","110/08/06","群益金鼎-新店",0,50,-50
"2089","2841台開","110/08/06","新光-台中",32,1,31
"2090","2841台開","110/08/06","統一-彰化",0,45,-45
"2091","2841台開","110/08/06","華南永昌-台中",30,0,30
"2092","2841台開","110/08/06","台中銀",12,50,-38
"2093","2841台開","110/08/06","第一金-忠孝",20,0,20
"2094","2841台開","110/08/06","國票-中和",0,30,-30
"2095","2841台開","110/08/06","富邦-台北",20,0,20
"2096","2841台開","110/08/06","富邦-竹北",0,29,-29
"2097","2841台開","110/08/06","元大-林園",20,0,20
"2098","2841台開","110/08/06","日盛-樹林",0,26,-26
"2099","2841台開","110/08/06","日盛-信義",18,0,18
"2100","2841台開","110/08/06","富邦-板橋",0,25,-25
"2101","6207雷科","110/08/06","凱基-台北",167,49,118
"2102","6207雷科","110/08/06","群益金鼎-古亭",0,80,-80
"2103","6207雷科","110/08/06","摩根大通",185,102,83
"2104","6207雷科","110/08/06","康和-台中",0,56,-56
"2105","6207雷科","110/08/06","新光-台中",65,1,64
"2106","6207雷科","110/08/06","統一-板橋",8,59,-51
"2107","6207雷科","110/08/06","元大-鳳山",77,40,37
"2108","6207雷科","110/08/06","臺銀",0,50,-50
"2109","6207雷科","110/08/06","德信",30,0,30
"2110","6207雷科","110/08/06","日盛-忠孝",0,50,-50
"2111","6207雷科","110/08/06","新加坡商瑞銀",47,19,28
"2112","6207雷科","110/08/06","永豐金-虎尾",0,29,-29
"2113","6207雷科","110/08/06","凱基-三重",30,2,28
"2114","6207雷科","110/08/06","凱基-敦北",0,23,-23
"2115","6207雷科","110/08/06","凱基-三峽",33,10,23
"2116","6207雷科","110/08/06","華南永昌-世貿",0,22,-22
"2117","6207雷科","110/08/06","玉山-台大",25,3,22
"2118","6207雷科","110/08/06","兆豐-來福",5,25,-20
"2119","6207雷科","110/08/06","元大-板橋",15,0,15
"2120","6207雷科","110/08/06","群益金鼎-中壢",1,21,-20
"2121","6207雷科","110/08/06","元大-南京",13,0,13
"2122","6207雷科","110/08/06","宏遠-台南",0,16,-16
"2123","6207雷科","110/08/06","元富-大昌",12,0,12
"2124","6207雷科","110/08/06","合庫-桃園",0,15,-15
"2125","6207雷科","110/08/06","德信-和平",11,0,11
"2126","6207雷科","110/08/06","玉山-新莊",1,16,-15
"2127","6207雷科","110/08/06","元大-承德",12,1,11
"2128","6207雷科","110/08/06","群益金鼎-敦南",0,15,-15
"2129","6207雷科","110/08/06","台新-高雄",18,8,10
"2130","6207雷科","110/08/06","台新-左楠",2,15,-13
"2131","3679新至陞","110/08/06","國票-安和",10,0,10
"2132","3679新至陞","110/08/06","摩根大通",1,32,-31
"2133","3679新至陞","110/08/06","元大-上新莊",10,0,10
"2134","3679新至陞","110/08/06","凱基-台北",2,17,-15
"2135","3679新至陞","110/08/06","富邦-台北",9,0,9
"2136","3679新至陞","110/08/06","台灣摩根士丹利",0,11,-11
"2137","3679新至陞","110/08/06","元大-板橋",9,3,6
"2138","3679新至陞","110/08/06","瑞士信貸",0,11,-11
"2139","3679新至陞","110/08/06","康和-板橋",5,0,5
"2140","3679新至陞","110/08/06","兆豐-員林",0,10,-10
"2141","3679新至陞","110/08/06","國泰-松江",5,0,5
"2142","3679新至陞","110/08/06","元大-蘆洲",0,10,-10
"2143","3679新至陞","110/08/06","凱基-三峽",5,0,5
"2144","3679新至陞","110/08/06","美林",1,8,-7
"2145","3679新至陞","110/08/06","華南永昌-大安",5,0,5
"2146","3679新至陞","110/08/06","群益金鼎-桃園",0,7,-7
"2147","3679新至陞","110/08/06","台新-屏東",4,0,4
"2148","3679新至陞","110/08/06","玉山-台大",0,5,-5
"2149","3679新至陞","110/08/06","群益金鼎-敦南",4,0,4
"2150","3679新至陞","110/08/06","日盛-新竹",0,4,-4
"2151","3679新至陞","110/08/06","元大-天母",4,0,4
"2152","3679新至陞","110/08/06","土銀-和平",2,5,-3
"2153","3679新至陞","110/08/06","臺銀-高雄",3,0,3
"2154","3679新至陞","110/08/06","元富-松德",0,3,-3
"2155","3679新至陞","110/08/06","台中銀-員林",3,0,3
"2156","3679新至陞","110/08/06","光和-田中",0,3,-3
"2157","3679新至陞","110/08/06","北城證券",3,0,3
"2158","3679新至陞","110/08/06","群益金鼎-台南",0,3,-3
"2159","3679新至陞","110/08/06","元大-景美",3,0,3
"2160","3679新至陞","110/08/06","元大證券",1,4,-3
"2161","2727王品","110/08/06","摩根大通",65,18,47
"2162","2727王品","110/08/06","美商高盛",12,258,-246
"2163","2727王品","110/08/06","華南永昌",18,0,18
"2164","2727王品","110/08/06","安泰",2,60,-58
"2165","2727王品","110/08/06","凱基-台北",41,25,16
"2166","2727王品","110/08/06","台灣摩根士丹利",10,59,-49
"2167","2727王品","110/08/06","元大-中壢",20,4,16
"2168","2727王品","110/08/06","台新證券",17,60,-43
"2169","2727王品","110/08/06","台新-高雄",27,13,14
"2170","2727王品","110/08/06","元大-桃園",0,32,-32
"2171","2727王品","110/08/06","永豐金-苓雅",14,1,13
"2172","2727王品","110/08/06","凱基-基隆",0,30,-30
"2173","2727王品","110/08/06","永豐金-中盛",14,1,13
"2174","2727王品","110/08/06","群益金鼎-台中",0,22,-22
"2175","2727王品","110/08/06","第一金-安和",12,0,12
"2176","2727王品","110/08/06","凱基-三重",1,20,-19
"2177","2727王品","110/08/06","台新-台南",12,0,12
"2178","2727王品","110/08/06","元大證券",23,42,-19
"2179","2727王品","110/08/06","元大-八德",12,0,12
"2180","2727王品","110/08/06","瑞士信貸",0,18,-18
"2181","2727王品","110/08/06","新加坡商瑞銀",14,3,11
"2182","2727王品","110/08/06","港商野村",32,50,-18
"2183","2727王品","110/08/06","美林",11,1,10
"2184","2727王品","110/08/06","元大-羅東",2,17,-15
"2185","2727王品","110/08/06","台新-中壢",10,0,10
"2186","2727王品","110/08/06","元大-彰化",3,15,-12
"2187","2727王品","110/08/06","大昌-新竹",9,0,9
"2188","2727王品","110/08/06","土銀-高雄",1,12,-11
"2189","2727王品","110/08/06","元大-文心興安",11,2,9
"2190","2727王品","110/08/06","台新-新莊",0,11,-11
"2191","1570力肯","110/08/06","國票-北高雄",246,40,206
"2192","1570力肯","110/08/06","富邦-高雄",0,47,-47
"2193","1570力肯","110/08/06","統一-松江",43,0,43
"2194","1570力肯","110/08/06","凱基-台北",55,101,-46
"2195","1570力肯","110/08/06","日茂-南投",42,2,40
"2196","1570力肯","110/08/06","台新證券",25,60,-35
"2197","1570力肯","110/08/06","群益金鼎-三重",34,2,32
"2198","1570力肯","110/08/06","元富-三重",0,32,-32
"2199","1570力肯","110/08/06","華南永昌-麻豆",32,4,28
"2200","1570力肯","110/08/06","台中銀-員林",0,32,-32
"2201","1570力肯","110/08/06","永豐金-中和",29,2,27
"2202","1570力肯","110/08/06","國泰-板橋",1,33,-32
"2203","1570力肯","110/08/06","永豐金-大園",21,0,21
"2204","1570力肯","110/08/06","摩根大通",83,112,-29
"2205","1570力肯","110/08/06","統一-三重",25,5,20
"2206","1570力肯","110/08/06","玉山-新莊",0,27,-27
"2207","1570力肯","110/08/06","元富-新店",20,0,20
"2208","1570力肯","110/08/06","永豐金-虎尾",0,27,-27
"2209","1570力肯","110/08/06","大昌-桃園",21,1,20
"2210","1570力肯","110/08/06","玉山-左營",0,25,-25
"2211","1570力肯","110/08/06","康和-高雄",18,1,17
"2212","1570力肯","110/08/06","富邦-仁愛",10,32,-22
"2213","1570力肯","110/08/06","元富-潮州",16,0,16
"2214","1570力肯","110/08/06","中國信託-忠孝",0,21,-21
"2215","1570力肯","110/08/06","元富-松德",15,0,15
"2216","1570力肯","110/08/06","臺銀-鳳山",4,24,-20
"2217","1570力肯","110/08/06","凱基-嘉義",15,0,15
"2218","1570力肯","110/08/06","台新-屏東",1,21,-20
"2219","1570力肯","110/08/06","凱基-埔墘",15,0,15
"2220","1570力肯","110/08/06","群益金鼎-西松",0,20,-20
"2221","6180橘子","110/08/06","凱基-中山",138,3,135
"2222","6180橘子","110/08/06","新光",6,37,-31
"2223","6180橘子","110/08/06","富邦-高雄",18,0,18
"2224","6180橘子","110/08/06","永豐金-板新",0,24,-24
"2225","6180橘子","110/08/06","美商高盛",14,0,14
"2226","6180橘子","110/08/06","國票-九鼎",0,20,-20
"2227","6180橘子","110/08/06","富邦-板橋",14,0,14
"2228","6180橘子","110/08/06","群益金鼎-古亭",0,20,-20
"2229","6180橘子","110/08/06","台灣摩根士丹利",18,6,12
"2230","6180橘子","110/08/06","凱基-台北",2,22,-20
"2231","6180橘子","110/08/06","聯邦-雙和",11,0,11
"2232","6180橘子","110/08/06","富邦-員林",1,20,-19
"2233","6180橘子","110/08/06","宏遠-光隆",10,0,10
"2234","6180橘子","110/08/06","富邦-基隆",0,14,-14
"2235","6180橘子","110/08/06","元富-四維",10,0,10
"2236","6180橘子","110/08/06","元富-永和",1,12,-11
"2237","6180橘子","110/08/06","摩根大通",11,1,10
"2238","6180橘子","110/08/06","玉山-台南",0,11,-11
"2239","6180橘子","110/08/06","日盛-中壢",9,0,9
"2240","6180橘子","110/08/06","元大-彰化民生",0,11,-11
"2241","6180橘子","110/08/06","中國信託",9,0,9
"2242","6180橘子","110/08/06","群益金鼎-忠孝",0,10,-10
"2243","6180橘子","110/08/06","凱基-板橋",10,1,9
"2244","6180橘子","110/08/06","元大-龍潭",0,10,-10
"2245","6180橘子","110/08/06","日盛-景美",9,2,7
"2246","6180橘子","110/08/06","元大-金華",1,11,-10
"2247","6180橘子","110/08/06","瑞士信貸",7,0,7
"2248","6180橘子","110/08/06","第一金-新興",0,8,-8
"2249","6180橘子","110/08/06","元大-高雄",5,0,5
"2250","6180橘子","110/08/06","美林",0,7,-7
"2251","2390云辰","110/08/06","元大證券",203,14,189
"2252","2390云辰","110/08/06","永豐金-豐原",0,174,-174
"2253","2390云辰","110/08/06","美商高盛",114,7,107
"2254","2390云辰","110/08/06","第一金-華江",0,83,-83
"2255","2390云辰","110/08/06","華南永昌-麻豆",103,0,103
"2256","2390云辰","110/08/06","凱基-台北",126,197,-71
"2257","2390云辰","110/08/06","國票-安和",76,11,65
"2258","2390云辰","110/08/06","摩根大通",129,187,-58
"2259","2390云辰","110/08/06","港商野村",188,138,50
"2260","2390云辰","110/08/06","臺銀-金山",0,50,-50
"2261","2390云辰","110/08/06","元大-土城學府",102,56,46
"2262","2390云辰","110/08/06","聯邦商銀",13,50,-37
"2263","2390云辰","110/08/06","元富-板橋",41,0,41
"2264","2390云辰","110/08/06","元大-上新莊",10,43,-33
"2265","2390云辰","110/08/06","新加坡商瑞銀",47,7,40
"2266","2390云辰","110/08/06","兆豐-三民",0,30,-30
"2267","2390云辰","110/08/06","元大-台南",35,0,35
"2268","2390云辰","110/08/06","富邦-桃園",0,30,-30
"2269","2390云辰","110/08/06","凱基-林口",31,0,31
"2270","2390云辰","110/08/06","國泰-敦南",33,60,-27
"2271","2390云辰","110/08/06","凱基-台中",23,0,23
"2272","2390云辰","110/08/06","元大-天母",1,28,-27
"2273","2390云辰","110/08/06","台新-左楠",22,0,22
"2274","2390云辰","110/08/06","統一-高雄",0,25,-25
"2275","2390云辰","110/08/06","元大-文心",24,2,22
"2276","2390云辰","110/08/06","元大-太平",0,22,-22
"2277","2390云辰","110/08/06","統一-三重",22,1,21
"2278","2390云辰","110/08/06","彰銀-台中",36,56,-20
"2279","2390云辰","110/08/06","台灣企銀-嘉義",20,0,20
"2280","2390云辰","110/08/06","統一-屏東",1,21,-20
"2281","2867三商壽","110/08/05","摩根大通",376,0,376
"2282","2867三商壽","110/08/05","日盛-新莊",0,253,-253
"2283","2867三商壽","110/08/05","玉山-大里",307,1,306
"2284","2867三商壽","110/08/05","宏遠-高雄",0,156,-156
"2285","2867三商壽","110/08/05","元大-土城永寧",250,0,250
"2286","2867三商壽","110/08/05","康和-台中",0,135,-135
"2287","2867三商壽","110/08/05","新加坡商瑞銀",137,0,137
"2288","2867三商壽","110/08/05","台灣摩根士丹利",17,133,-116
"2289","2867三商壽","110/08/05","大展",120,0,120
"2290","2867三商壽","110/08/05","台灣企銀-竹北",0,100,-100
"2291","2867三商壽","110/08/05","凱基-長庚",120,0,120
"2292","2867三商壽","110/08/05","群益金鼎-桃園",1,100,-99
"2293","2867三商壽","110/08/05","元大-大同",104,2,102
"2294","2867三商壽","110/08/05","永豐金-高雄",10,101,-91
"2295","2867三商壽","110/08/05","凱基-台北",98,30,68
"2296","2867三商壽","110/08/05","元富",0,70,-70
"2297","2867三商壽","110/08/05","華南永昌-朴子",60,0,60
"2298","2867三商壽","110/08/05","富邦-花蓮",0,53,-53
"2299","2867三商壽","110/08/05","永豐金-市政",50,0,50
"2300","2867三商壽","110/08/05","日盛-台南",0,43,-43
"2301","2867三商壽","110/08/05","富邦-台南",49,1,48
"2302","2867三商壽","110/08/05","宏遠-台中",6,45,-39
"2303","2867三商壽","110/08/05","永豐金-永康",30,0,30
"2304","2867三商壽","110/08/05","瑞士信貸",0,32,-32
"2305","2867三商壽","110/08/05","富邦-竹東",30,1,29
"2306","2867三商壽","110/08/05","致和-高雄",0,31,-31
"2307","2867三商壽","110/08/05","兆豐-高雄",30,10,20
"2308","2867三商壽","110/08/05","國泰-台南",1,32,-31
"2309","2867三商壽","110/08/05","群益金鼎-西松",20,0,20
"2310","2867三商壽","110/08/05","元大-松山",1,31,-30
"2311","5521工信","110/08/05","兆豐-桃園",72,0,72
"2312","5521工信","110/08/05","美林",5,100,-95
"2313","5521工信","110/08/05","(牛牛牛)亞-鑫豐",24,0,24
"2314","5521工信","110/08/05","華南永昌-桃園",0,76,-76
"2315","5521工信","110/08/05","富邦-建國",22,0,22
"2316","5521工信","110/08/05","第一金-桃園",0,43,-43
"2317","5521工信","110/08/05","日盛-雙和",16,0,16
"2318","5521工信","110/08/05","凱基-台北",0,26,-26
"2319","5521工信","110/08/05","元大-鳳山",16,0,16
"2320","5521工信","110/08/05","台灣摩根士丹利",0,22,-22
"2321","5521工信","110/08/05","元富-城東",12,0,12
"2322","5521工信","110/08/05","富邦-竹北",0,20,-20
"2323","5521工信","110/08/05","元大-東蘆",12,0,12
"2324","5521工信","110/08/05","富邦-員林",0,20,-20
"2325","5521工信","110/08/05","元大-路竹",11,0,11
"2326","5521工信","110/08/05","元大-豐原",0,20,-20
"2327","5521工信","110/08/05","元大-基隆孝二",11,0,11
"2328","5521工信","110/08/05","港商野村",0,17,-17
"2329","5521工信","110/08/05","日盛-園區",10,0,10
"2330","5521工信","110/08/05","元大-大同",0,14,-14
"2331","5521工信","110/08/05","玉山-台大",10,0,10
"2332","5521工信","110/08/05","永豐金證券",0,14,-14
"2333","5521工信","110/08/05","華南永昌-公誠",10,0,10
"2334","5521工信","110/08/05","兆豐-高雄",0,10,-10
"2335","5521工信","110/08/05","元大-斗六",10,0,10
"2336","5521工信","110/08/05","群益金鼎-永和",0,10,-10
"2337","5521工信","110/08/05","元大-屏東",10,0,10
"2338","5521工信","110/08/05","永豐金-中和",0,10,-10
"2339","5521工信","110/08/05","國泰-台中",9,0,9
"2340","5521工信","110/08/05","第一金-高雄",0,7,-7
"2341","1471首利","110/08/05","國票-北高雄",50,0,50
"2342","1471首利","110/08/05","永豐金-板盛",0,129,-129
"2343","1471首利","110/08/05","台灣摩根士丹利",49,0,49
"2344","1471首利","110/08/05","元大-三重",0,50,-50
"2345","1471首利","110/08/05","元大-太平",30,0,30
"2346","1471首利","110/08/05","瑞士信貸",0,42,-42
"2347","1471首利","110/08/05","國泰-敦南",24,0,24
"2348","1471首利","110/08/05","美林",0,37,-37
"2349","1471首利","110/08/05","玉山-桃園",21,0,21
"2350","1471首利","110/08/05","元富-草屯",0,30,-30
"2351","1471首利","110/08/05","宏遠-光隆",20,0,20
"2352","1471首利","110/08/05","元富-民權",0,25,-25
"2353","1471首利","110/08/05","富邦-嘉義",20,1,19
"2354","1471首利","110/08/05","台中銀",0,23,-23
"2355","1471首利","110/08/05","元大-博愛",30,13,17
"2356","1471首利","110/08/05","元富-新興",0,20,-20
"2357","1471首利","110/08/05","台新-高雄",16,0,16
"2358","1471首利","110/08/05","摩根大通",17,33,-16
"2359","1471首利","110/08/05","日盛-文化",15,0,15
"2360","1471首利","110/08/05","日盛-鳳山",0,15,-15
"2361","1471首利","110/08/05","群益金鼎-新莊",15,0,15
"2362","1471首利","110/08/05","高橋",0,14,-14
"2363","1471首利","110/08/05","凱基-科園",13,0,13
"2364","1471首利","110/08/05","富邦-羅東",0,13,-13
"2365","1471首利","110/08/05","元大-高雄",12,0,12
"2366","1471首利","110/08/05","德信-中正",0,12,-12
"2367","1471首利","110/08/05","第一金-桃園",11,0,11
"2368","1471首利","110/08/05","群益金鼎-中港",5,17,-12
"2369","1471首利","110/08/05","台灣企銀-太平",10,0,10
"2370","1471首利","110/08/05","第一金-台南",0,10,-10
"2371","2883開發金","110/08/05","元富",5268,0,5268
"2372","2883開發金","110/08/05","新光-高雄",309,4909,-4600
"2373","2883開發金","110/08/05","瑞士信貸",4963,0,4963
"2374","2883開發金","110/08/05","富邦-竹東",594,3509,-2915
"2375","2883開發金","110/08/05","富邦證券",3800,0,3800
"2376","2883開發金","110/08/05","永豐金-南京",2,1915,-1913
"2377","2883開發金","110/08/05","台灣摩根士丹利",3886,1250,2636
"2378","2883開發金","110/08/05","第一金-自由",2,1894,-1892
"2379","2883開發金","110/08/05","元富-城東",2119,68,2051
"2380","2883開發金","110/08/05","康和-仁愛",0,1820,-1820
"2381","2883開發金","110/08/05","港商野村",2397,395,2002
"2382","2883開發金","110/08/05","兆豐-台中港",22,1522,-1500
"2383","2883開發金","110/08/05","第一金-忠孝",2020,88,1932
"2384","2883開發金","110/08/05","元大-大同",43,1010,-967
"2385","2883開發金","110/08/05","國泰證券",1682,3,1679
"2386","2883開發金","110/08/05","國票",53,645,-592
"2387","2883開發金","110/08/05","大和國泰",1666,0,1666
"2388","2883開發金","110/08/05","富邦-新竹",86,674,-588
"2389","2883開發金","110/08/05","永豐金-板橋",1507,15,1492
"2390","2883開發金","110/08/05","富邦-建國",39,560,-521
"2391","2883開發金","110/08/05","台灣企銀-民雄",1002,0,1002
"2392","2883開發金","110/08/05","日盛-台南",7,525,-518
"2393","2883開發金","110/08/05","美林",1263,577,686
"2394","2883開發金","110/08/05","凱基-基隆",1,510,-509
"2395","2883開發金","110/08/05","康和",640,0,640
"2396","2883開發金","110/08/05","元富-民權",0,500,-500
"2397","2883開發金","110/08/05","凱基-台北",1262,679,583
"2398","2883開發金","110/08/05","永豐金-松山",9,509,-500
"2399","2883開發金","110/08/05","福邦證券",560,50,510
"2400","2883開發金","110/08/05","華南永昌-中正",25,511,-486
"2401","6205詮欣","110/08/05","富邦-高雄",27,0,27
"2402","6205詮欣","110/08/05","臺銀-鳳山",0,31,-31
"2403","6205詮欣","110/08/05","摩根大通",27,1,26
"2404","6205詮欣","110/08/05","合庫-三重",0,15,-15
"2405","6205詮欣","110/08/05","永豐金-敦南",14,0,14
"2406","6205詮欣","110/08/05","臺銀-民權",11,21,-10
"2407","6205詮欣","110/08/05","凱基-台北",14,1,13
"2408","6205詮欣","110/08/05","日盛-中壢",0,10,-10
"2409","6205詮欣","110/08/05","瑞士信貸",14,5,9
"2410","6205詮欣","110/08/05","統一-松江",0,10,-10
"2411","6205詮欣","110/08/05","凱基-湖口",9,0,9
"2412","6205詮欣","110/08/05","台新-三民",0,9,-9
"2413","6205詮欣","110/08/05","德信-新營",4,0,4
"2414","6205詮欣","110/08/05","臺銀-新竹",1,9,-8
"2415","6205詮欣","110/08/05","元大-東蘆",5,1,4
"2416","6205詮欣","110/08/05","康和",0,5,-5
"2417","6205詮欣","110/08/05","臺銀-高雄",3,0,3
"2418","6205詮欣","110/08/05","元大-館前",0,4,-4
"2419","6205詮欣","110/08/05","富邦-左營",3,0,3
"2420","6205詮欣","110/08/05","宏遠-新化",0,3,-3
"2421","6205詮欣","110/08/05","日盛-花蓮",2,0,2
"2422","6205詮欣","110/08/05","新加坡商瑞銀",4,7,-3
"2423","6205詮欣","110/08/05","元富-三重",2,0,2
"2424","6205詮欣","110/08/05","致和-高雄",0,3,-3
"2425","6205詮欣","110/08/05","北城證券",2,0,2
"2426","6205詮欣","110/08/05","國票",0,3,-3
"2427","6205詮欣","110/08/05","國票-南港",2,0,2
"2428","6205詮欣","110/08/05","富邦-嘉義",0,3,-3
"2429","6205詮欣","110/08/05","台新證券",2,0,2
"2430","6205詮欣","110/08/05","統一-士林",0,2,-2
"2431","1540喬福","110/08/05","元富-中原",24,0,24
"2432","1540喬福","110/08/05","統一-新台中",0,21,-21
"2433","1540喬福","110/08/05","台新-台南",10,0,10
"2434","1540喬福","110/08/05","國泰-敦南",0,15,-15
"2435","1540喬福","110/08/05","台新-台中",10,0,10
"2436","1540喬福","110/08/05","華南永昌-南京",0,10,-10
"2437","1540喬福","110/08/05","瑞士信貸",6,0,6
"2438","1540喬福","110/08/05","元大-台中中港",0,10,-10
"2439","1540喬福","110/08/05","台中銀-豐原",6,0,6
"2440","1540喬福","110/08/05","德信-新營",0,8,-8
"2441","1540喬福","110/08/05","凱基-台北",6,0,6
"2442","1540喬福","110/08/05","新光-台南",0,4,-4
"2443","1540喬福","110/08/05","凱基-台南",5,0,5
"2444","1540喬福","110/08/05","元大-大天母",6,10,-4
"2445","1540喬福","110/08/05","元大-士林",5,0,5
"2446","1540喬福","110/08/05","康和-新竹",0,3,-3
"2447","1540喬福","110/08/05","美林",2,0,2
"2448","1540喬福","110/08/05","元大-龍潭",0,3,-3
"2449","1540喬福","110/08/05","群益金鼎-崇德",2,0,2
"2450","1540喬福","110/08/05","第一金-員林",0,1,-1
"2451","1540喬福","110/08/05","凱基-苗栗",2,0,2
"2452","1540喬福","110/08/05","第一金-豐原",0,1,-1
"2453","1540喬福","110/08/05","凱基-中壢",2,0,2
"2454","1540喬福","110/08/05","台新-高雄",0,1,-1
"2455","1540喬福","110/08/05","土銀-士林",1,0,1
"2456","1540喬福","110/08/05","元大-崇德",0,1,-1
"2457","1540喬福","110/08/05","群益金鼎-丹鳳",1,0,1
"2458","1540喬福","110/08/05","元大-中壢",0,1,-1
"2459","1540喬福","110/08/05","元大-文心",1,0,1
"2460","1540喬福","110/08/05","元大-斗信",0,1,-1
"2461","2888新光金","110/08/05","華南永昌-南京",3753,8,3745
"2462","2888新光金","110/08/05","第一金-高雄",0,5007,-5007
"2463","2888新光金","110/08/05","玉山-城中",2004,28,1976
"2464","2888新光金","110/08/05","美商高盛",12,1719,-1707
"2465","2888新光金","110/08/05","元大-西門",906,18,888
"2466","2888新光金","110/08/05","香港上海匯豐",0,1437,-1437
"2467","2888新光金","110/08/05","日盛-和美",557,3,554
"2468","2888新光金","110/08/05","凱基-台南",46,802,-756
"2469","2888新光金","110/08/05","康和-台中",460,49,411
"2470","2888新光金","110/08/05","美林",538,1140,-602
"2471","2888新光金","110/08/05","元富-緯城",302,1,301
"2472","2888新光金","110/08/05","凱基-台北",686,1280,-594
"2473","2888新光金","110/08/05","彰銀",301,3,298
"2474","2888新光金","110/08/05","法銀巴黎",0,562,-562
"2475","2888新光金","110/08/05","花旗環球",356,84,272
"2476","2888新光金","110/08/05","瑞士信貸",1350,1798,-448
"2477","2888新光金","110/08/05","永全-南崁",240,0,240
"2478","2888新光金","110/08/05","群益金鼎-丹鳳",4,303,-299
"2479","2888新光金","110/08/05","永豐金-彰化",232,20,212
"2480","2888新光金","110/08/05","安泰-大發",10,300,-290
"2481","2888新光金","110/08/05","統一-新台中",214,7,207
"2482","2888新光金","110/08/05","摩根大通",1159,1428,-269
"2483","2888新光金","110/08/05","中國信託-永康",203,0,203
"2484","2888新光金","110/08/05","兆豐-員林",4,260,-256
"2485","2888新光金","110/08/05","日盛-景美",200,0,200
"2486","2888新光金","110/08/05","日盛-大墩",0,250,-250
"2487","2888新光金","110/08/05","元大-東泰",207,22,185
"2488","2888新光金","110/08/05","元大-大里",31,243,-212
"2489","2888新光金","110/08/05","合庫證券",181,2,179
"2490","2888新光金","110/08/05","北城證券",25,230,-205
"2491","1340勝悅","110/08/05","富邦-仁愛",20,0,20
"2492","1340勝悅","110/08/05","中國信託",0,36,-36
"2493","1340勝悅","110/08/05","華南永昌-忠孝",12,0,12
"2494","1340勝悅","110/08/05","新光-新竹",0,18,-18
"2495","1340勝悅","110/08/05","華南永昌-楠梓",10,0,10
"2496","1340勝悅","110/08/05","永豐金-嘉義",0,15,-15
"2497","1340勝悅","110/08/05","統一-城中",17,11,6
"2498","1340勝悅","110/08/05","日茂",0,10,-10
"2499","1340勝悅","110/08/05","臺灣企銀-埔墘",5,0,5
"2500","1340勝悅","110/08/05","富邦-宜蘭",0,10,-10
"2501","1340勝悅","110/08/05","國票-台東",5,0,5
"2502","1340勝悅","110/08/05","元富-花蓮",0,9,-9
"2503","1340勝悅","110/08/05","新光-高雄",5,0,5
"2504","1340勝悅","110/08/05","永豐金-南京",0,7,-7
"2505","1340勝悅","110/08/05","國泰-台中",6,1,5
"2506","1340勝悅","110/08/05","統一",0,6,-6
"2507","1340勝悅","110/08/05","富邦-陽明",5,0,5
"2508","1340勝悅","110/08/05","合庫-西台中",0,3,-3
"2509","1340勝悅","110/08/05","日盛-板橋",4,0,4
"2510","1340勝悅","110/08/05","港商野村",0,3,-3
"2511","1340勝悅","110/08/05","港商法國興業",4,0,4
"2512","1340勝悅","110/08/05","兆豐-新竹",0,3,-3
"2513","1340勝悅","110/08/05","臺銀-高雄",3,0,3
"2514","1340勝悅","110/08/05","亞東-台中",0,2,-2
"2515","1340勝悅","110/08/05","元富-新店",3,0,3
"2516","1340勝悅","110/08/05","元大-歸仁",0,2,-2
"2517","1340勝悅","110/08/05","康和-屏東",3,0,3
"2518","1340勝悅","110/08/05","日盛-斗六",0,1,-1
"2519","1340勝悅","110/08/05","群益金鼎-民權",3,0,3
"2520","1340勝悅","110/08/05","日盛-中和",0,1,-1
"2521","6246臺龍","110/08/05","元大-林森",200,0,200
"2522","6246臺龍","110/08/05","統一",0,180,-180
"2523","6246臺龍","110/08/05","元大證券",92,1,91
"2524","6246臺龍","110/08/05","大慶-富順",0,114,-114
"2525","6246臺龍","110/08/05","凱基-大直",99,19,80
"2526","6246臺龍","110/08/05","台新-三民",0,77,-77
"2527","6246臺龍","110/08/05","元大-北港",51,0,51
"2528","6246臺龍","110/08/05","永興",0,48,-48
"2529","6246臺龍","110/08/05","統一-南京",50,0,50
"2530","6246臺龍","110/08/05","華南永昌-嘉義",1,26,-25
"2531","6246臺龍","110/08/05","台灣企銀",40,0,40
"2532","6246臺龍","110/08/05","宏遠-民生",0,20,-20
"2533","6246臺龍","110/08/05","永豐金-虎尾",23,0,23
"2534","6246臺龍","110/08/05","兆豐-大同",0,20,-20
"2535","6246臺龍","110/08/05","凱基-台北",27,5,22
"2536","6246臺龍","110/08/05","華南永昌-林口",0,20,-20
"2537","6246臺龍","110/08/05","元富-新竹",20,0,20
"2538","6246臺龍","110/08/05","元大-永春",0,20,-20
"2539","6246臺龍","110/08/05","康和-石牌",20,0,20
"2540","6246臺龍","110/08/05","元大-東泰",0,19,-19
"2541","6246臺龍","110/08/05","聯邦-大業",20,0,20
"2542","6246臺龍","110/08/05","德信-新營",0,18,-18
"2543","6246臺龍","110/08/05","凱基-彰化",18,0,18
"2544","6246臺龍","110/08/05","永豐金-松山",10,28,-18
"2545","6246臺龍","110/08/05","永豐金-復興",17,1,16
"2546","6246臺龍","110/08/05","台新-台中",4,20,-16
"2547","6246臺龍","110/08/05","新光-台中",17,2,15
"2548","6246臺龍","110/08/05","兆豐-竹北",5,20,-15
"2549","6246臺龍","110/08/05","元大-路竹",15,1,14
"2550","6246臺龍","110/08/05","兆豐-南京",1,14,-13
"2551","00715L期街口布蘭特正2","110/08/05","(牛牛牛)亞-鑫豐",1195,20,1175
"2552","00715L期街口布蘭特正2","110/08/05","元大證券",1735,21716,-19981
"2553","00715L期街口布蘭特正2","110/08/05","元大-萬華",930,0,930
"2554","00715L期街口布蘭特正2","110/08/05","凱基-台北",182,11686,-11504
"2555","00715L期街口布蘭特正2","110/08/05","元大-永康",810,9,801
"2556","00715L期街口布蘭特正2","110/08/05","元富",8,6852,-6844
"2557","00715L期街口布蘭特正2","110/08/05","富邦-彰化",760,0,760
"2558","00715L期街口布蘭特正2","110/08/05","台新證券",598,4522,-3924
"2559","00715L期街口布蘭特正2","110/08/05","國泰-敦南",830,155,675
"2560","00715L期街口布蘭特正2","110/08/05","凱基",0,3168,-3168
"2561","00715L期街口布蘭特正2","110/08/05","新光-台中",698,33,665
"2562","00715L期街口布蘭特正2","110/08/05","群益金鼎",0,1742,-1742
"2563","00715L期街口布蘭特正2","110/08/05","富邦-南屯",621,5,616
"2564","00715L期街口布蘭特正2","110/08/05","國票",22,1607,-1585
"2565","00715L期街口布蘭特正2","110/08/05","群益金鼎-士林",620,40,580
"2566","00715L期街口布蘭特正2","110/08/05","永豐金證券",91,1254,-1163
"2567","00715L期街口布蘭特正2","110/08/05","兆豐-嘉義",510,0,510
"2568","00715L期街口布蘭特正2","110/08/05","富邦證券",140,1095,-955
"2569","00715L期街口布蘭特正2","110/08/05","統一-新竹",508,9,499
"2570","00715L期街口布蘭特正2","110/08/05","元大-雙和",22,850,-828
"2571","00715L期街口布蘭特正2","110/08/05","國泰-板橋",521,24,497
"2572","00715L期街口布蘭特正2","110/08/05","國票-台中",25,805,-780
"2573","00715L期街口布蘭特正2","110/08/05","元大-中和",481,3,478
"2574","00715L期街口布蘭特正2","110/08/05","華南永昌-長虹",145,820,-675
"2575","00715L期街口布蘭特正2","110/08/05","元大-羅東",470,0,470
"2576","00715L期街口布蘭特正2","110/08/05","日盛-大墩",121,455,-334
"2577","00715L期街口布蘭特正2","110/08/05","群益金鼎-嘉義",483,20,463
"2578","00715L期街口布蘭特正2","110/08/05","華南永昌-斗六",52,380,-328
"2579","00715L期街口布蘭特正2","110/08/05","群益金鼎-中壢",476,30,446
"2580","00715L期街口布蘭特正2","110/08/05","康和",0,250,-250
"2581","8941關中","110/08/05","第一金-台南",1,0,1
"2582","8941關中","110/08/05","元富-宜蘭",0,2,-2
"2583","8941關中","110/08/05","康和-嘉義",1,0,1
"2584","8941關中","110/08/05","統一-南京",0,1,-1
"2585","8941關中","110/08/05","群益金鼎-延平",1,0,1
"2586","8941關中","110/08/05","合庫證券",0,0,0
"2587","8941關中","110/08/05","合庫證券",0,0,0
"2588","8941關中","110/08/05","(牛牛牛)亞-鑫豐",0,0,0
"2589","8941關中","110/08/05","(牛牛牛)亞-鑫豐",0,0,0
"2590","8941關中","110/08/05","富邦-北港",0,0,0
"2591","8941關中","110/08/05","富邦-北港",0,0,0
"2592","8941關中","110/08/05","",NA,NA,NA
"2593","8941關中","110/08/05","",NA,NA,NA
"2594","8941關中","110/08/05","",NA,NA,NA
"2595","8941關中","110/08/05","",NA,NA,NA
"2596","8941關中","110/08/05","",NA,NA,NA
"2597","8941關中","110/08/05","",NA,NA,NA
"2598","8941關中","110/08/05","",NA,NA,NA
"2599","8941關中","110/08/05","",NA,NA,NA
"2600","8941關中","110/08/05","",NA,NA,NA
"2601","8941關中","110/08/05","",NA,NA,NA
"2602","8941關中","110/08/05","",NA,NA,NA
"2603","8941關中","110/08/05","",NA,NA,NA
"2604","8941關中","110/08/05","",NA,NA,NA
"2605","8941關中","110/08/05","",NA,NA,NA
"2606","8941關中","110/08/05","",NA,NA,NA
"2607","8941關中","110/08/05","",NA,NA,NA
"2608","8941關中","110/08/05","",NA,NA,NA
"2609","8941關中","110/08/05","",NA,NA,NA
"2610","8941關中","110/08/05","",NA,NA,NA
"2611","8936國統","110/08/05","國票-敦北法人",100,0,100
"2612","8936國統","110/08/05","摩根大通",16,240,-224
"2613","8936國統","110/08/05","第一金-光復",50,0,50
"2614","8936國統","110/08/05","台新-松江",0,205,-205
"2615","8936國統","110/08/05","元大-蘆洲",45,0,45
"2616","8936國統","110/08/05","凱基-台北",1,177,-176
"2617","8936國統","110/08/05","富邦-建國",34,0,34
"2618","8936國統","110/08/05","新加坡商瑞銀",14,119,-105
"2619","8936國統","110/08/05","富邦-高雄",33,1,32
"2620","8936國統","110/08/05","凱基-市政",0,35,-35
"2621","8936國統","110/08/05","元大-敦南",30,0,30
"2622","8936國統","110/08/05","瑞士信貸",0,31,-31
"2623","8936國統","110/08/05","元大-博愛",23,0,23
"2624","8936國統","110/08/05","合庫-高雄",22,49,-27
"2625","8936國統","110/08/05","國票-長城",20,0,20
"2626","8936國統","110/08/05","港商野村",15,41,-26
"2627","8936國統","110/08/05","凱基-岡山",20,0,20
"2628","8936國統","110/08/05","富邦-陽明",1,24,-23
"2629","8936國統","110/08/05","凱基-台南",20,0,20
"2630","8936國統","110/08/05","合庫-新竹",0,22,-22
"2631","8936國統","110/08/05","富邦-中壢",21,2,19
"2632","8936國統","110/08/05","美商高盛",0,20,-20
"2633","8936國統","110/08/05","永豐金-忠孝",17,0,17
"2634","8936國統","110/08/05","元大-雙和",0,20,-20
"2635","8936國統","110/08/05","玉山-台中",16,0,16
"2636","8936國統","110/08/05","彰銀-七賢",0,18,-18
"2637","8936國統","110/08/05","兆豐-景美",15,0,15
"2638","8936國統","110/08/05","台灣企銀-台中",0,15,-15
"2639","8936國統","110/08/05","富邦-南屯",15,0,15
"2640","8936國統","110/08/05","兆豐-大同",0,15,-15
"2641","6226光鼎","110/08/05","國泰-敦南",190,90,100
"2642","6226光鼎","110/08/05","富邦-嘉義",590,964,-374
"2643","6226光鼎","110/08/05","凱基-台中",98,2,96
"2644","6226光鼎","110/08/05","日盛-員林",9,200,-191
"2645","6226光鼎","110/08/05","華南永昌-大安",95,13,82
"2646","6226光鼎","110/08/05","華南永昌",5,157,-152
"2647","6226光鼎","110/08/05","凱基-豐中",68,2,66
"2648","6226光鼎","110/08/05","國票-敦北法人",0,106,-106
"2649","6226光鼎","110/08/05","元富-西松",76,15,61
"2650","6226光鼎","110/08/05","元大-雙和",27,118,-91
"2651","6226光鼎","110/08/05","群益金鼎-土城",61,0,61
"2652","6226光鼎","110/08/05","華南永昌-南京",48,137,-89
"2653","6226光鼎","110/08/05","新光-高雄",64,4,60
"2654","6226光鼎","110/08/05","統一-新竹",37,124,-87
"2655","6226光鼎","110/08/05","宏遠-台中",67,9,58
"2656","6226光鼎","110/08/05","大昌",3,78,-75
"2657","6226光鼎","110/08/05","元大-東港",53,0,53
"2658","6226光鼎","110/08/05","凱基-台北",1,74,-73
"2659","6226光鼎","110/08/05","群益金鼎-敦南",60,10,50
"2660","6226光鼎","110/08/05","中國信託-文心",10,65,-55
"2661","6226光鼎","110/08/05","日盛-高雄",53,7,46
"2662","6226光鼎","110/08/05","台新-新莊",1,54,-53
"2663","6226光鼎","110/08/05","台新-新營",49,4,45
"2664","6226光鼎","110/08/05","台新-台中",84,135,-51
"2665","6226光鼎","110/08/05","玉山-雙和",42,2,40
"2666","6226光鼎","110/08/05","元大-嘉義",77,128,-51
"2667","6226光鼎","110/08/05","永豐金-高雄",44,8,36
"2668","6226光鼎","110/08/05","日盛-大墩",1,43,-42
"2669","6226光鼎","110/08/05","元富-花蓮",42,7,35
"2670","6226光鼎","110/08/05","日茂-埔里",0,41,-41
"2671","2363矽統","110/08/05","瑞士信貸",3345,0,3345
"2672","2363矽統","110/08/05","新加坡商瑞銀",1909,2622,-713
"2673","2363矽統","110/08/05","台灣摩根士丹利",2917,53,2864
"2674","2363矽統","110/08/05","統一-板橋",37,650,-613
"2675","2363矽統","110/08/05","摩根大通",5124,3944,1180
"2676","2363矽統","110/08/05","美商高盛",702,1245,-543
"2677","2363矽統","110/08/05","康和-台中",911,292,619
"2678","2363矽統","110/08/05","元富-西松",367,902,-535
"2679","2363矽統","110/08/05","永豐金證券",951,339,612
"2680","2363矽統","110/08/05","華南永昌-斗六",55,584,-529
"2681","2363矽統","110/08/05","群益金鼎-三民",571,106,465
"2682","2363矽統","110/08/05","美林",2987,3501,-514
"2683","2363矽統","110/08/05","國票-敦北法人",484,51,433
"2684","2363矽統","110/08/05","群益金鼎-館前",331,802,-471
"2685","2363矽統","110/08/05","陽信-石牌",624,204,420
"2686","2363矽統","110/08/05","永豐金-三重",138,571,-433
"2687","2363矽統","110/08/05","合庫證券",520,118,402
"2688","2363矽統","110/08/05","富邦-中壢",348,774,-426
"2689","2363矽統","110/08/05","元大-承德",385,70,315
"2690","2363矽統","110/08/05","北城證券",53,459,-406
"2691","2363矽統","110/08/05","新光",2366,2079,287
"2692","2363矽統","110/08/05","凱基-興隆",370,717,-347
"2693","2363矽統","110/08/05","元大證券",601,329,272
"2694","2363矽統","110/08/05","元大-屏南",132,464,-332
"2695","2363矽統","110/08/05","國泰-敦南",4481,4216,265
"2696","2363矽統","110/08/05","日盛-中和",208,531,-323
"2697","2363矽統","110/08/05","元大-台中",562,349,213
"2698","2363矽統","110/08/05","土銀",28,340,-312
"2699","2363矽統","110/08/05","富邦-台北",584,380,204
"2700","2363矽統","110/08/05","永豐金-嘉義",97,401,-304
"2701","8112至上","110/08/05","元大-竹科",858,64,794
"2702","8112至上","110/08/05","摩根大通",461,775,-314
"2703","8112至上","110/08/05","港商野村",937,361,576
"2704","8112至上","110/08/05","台灣摩根士丹利",16,272,-256
"2705","8112至上","110/08/05","康和",484,0,484
"2706","8112至上","110/08/05","高橋",3,183,-180
"2707","8112至上","110/08/05","新加坡商瑞銀",514,58,456
"2708","8112至上","110/08/05","合庫證券",19,162,-143
"2709","8112至上","110/08/05","元大-屏南",391,4,387
"2710","8112至上","110/08/05","元大-北屯",3,145,-142
"2711","8112至上","110/08/05","國票-長城",427,142,285
"2712","8112至上","110/08/05","元大-府城",14,154,-140
"2713","8112至上","110/08/05","元大-萬華",246,12,234
"2714","8112至上","110/08/05","群益金鼎-三重",0,138,-138
"2715","8112至上","110/08/05","台灣匯立證券",210,0,210
"2716","8112至上","110/08/05","富邦-台北",25,129,-104
"2717","8112至上","110/08/05","凱基-敦北",200,4,196
"2718","8112至上","110/08/05","元富-佳里",7,100,-93
"2719","8112至上","110/08/05","元大-北成功",205,17,188
"2720","8112至上","110/08/05","元富-台南",0,86,-86
"2721","8112至上","110/08/05","元大-高雄",146,14,132
"2722","8112至上","110/08/05","臺灣企銀-桃園",0,82,-82
"2723","8112至上","110/08/05","美商高盛",161,47,114
"2724","8112至上","110/08/05","玉山-嘉義",10,88,-78
"2725","8112至上","110/08/05","花旗環球",102,0,102
"2726","8112至上","110/08/05","凱基-復興",1,67,-66
"2727","8112至上","110/08/05","統一-士林",108,8,100
"2728","8112至上","110/08/05","富邦-中壢",23,89,-66
"2729","8112至上","110/08/05","新光",244,159,85
"2730","8112至上","110/08/05","元大-上新莊",1,67,-66
"2731","1570力肯","110/08/05","國票",352,0,352
"2732","1570力肯","110/08/05","國票-和平",7,402,-395
"2733","1570力肯","110/08/05","台新證券",211,87,124
"2734","1570力肯","110/08/05","摩根大通",46,335,-289
"2735","1570力肯","110/08/05","國泰-敦南",206,125,81
"2736","1570力肯","110/08/05","國票-北高雄",79,306,-227
"2737","1570力肯","110/08/05","聯邦商銀",75,0,75
"2738","1570力肯","110/08/05","統一",3,226,-223
"2739","1570力肯","110/08/05","元大-東泰",61,4,57
"2740","1570力肯","110/08/05","凱基-台北",184,366,-182
"2741","1570力肯","110/08/05","元大-桃興",113,66,47
"2742","1570力肯","110/08/05","統一-土城",89,161,-72
"2743","1570力肯","110/08/05","國泰-板橋",96,50,46
"2744","1570力肯","110/08/05","統一-屏東",0,64,-64
"2745","1570力肯","110/08/05","合庫-桃園",92,48,44
"2746","1570力肯","110/08/05","大昌-新店",9,61,-52
"2747","1570力肯","110/08/05","華南永昌-高雄",53,12,41
"2748","1570力肯","110/08/05","群益金鼎-忠孝",11,60,-49
"2749","1570力肯","110/08/05","國泰-高雄",50,14,36
"2750","1570力肯","110/08/05","臺銀-臺南",12,52,-40
"2751","1570力肯","110/08/05","國泰-台中",60,25,35
"2752","1570力肯","110/08/05","凱基-岡山",28,68,-40
"2753","1570力肯","110/08/05","富邦-仁愛",52,17,35
"2754","1570力肯","110/08/05","元大-蘆洲",8,44,-36
"2755","1570力肯","110/08/05","中國信託-忠孝",37,3,34
"2756","1570力肯","110/08/05","統一-仁愛",25,60,-35
"2757","1570力肯","110/08/05","元大-中壢",44,10,34
"2758","1570力肯","110/08/05","富邦-高雄",8,43,-35
"2759","1570力肯","110/08/05","日盛-新竹",30,0,30
"2760","1570力肯","110/08/05","大慶-蘆洲",110,142,-32
"2761","2929淘帝","110/08/05","國泰-松江",60,0,60
"2762","2929淘帝","110/08/05","摩根大通",4,87,-83
"2763","2929淘帝","110/08/05","美林",79,30,49
"2764","2929淘帝","110/08/05","日盛-南京",0,80,-80
"2765","2929淘帝","110/08/05","港商野村",87,45,42
"2766","2929淘帝","110/08/05","華南永昌-頭份",0,80,-80
"2767","2929淘帝","110/08/05","兆豐-忠孝",40,0,40
"2768","2929淘帝","110/08/05","日盛-雙和",2,57,-55
"2769","2929淘帝","110/08/05","新光-新竹",41,2,39
"2770","2929淘帝","110/08/05","台新-台中",2,33,-31
"2771","2929淘帝","110/08/05","元大-民生",31,0,31
"2772","2929淘帝","110/08/05","群益金鼎-新竹",0,30,-30
"2773","2929淘帝","110/08/05","元富-中港",28,0,28
"2774","2929淘帝","110/08/05","元大-北成功",0,30,-30
"2775","2929淘帝","110/08/05","凱基-台北",66,41,25
"2776","2929淘帝","110/08/05","元大-天母",5,30,-25
"2777","2929淘帝","110/08/05","富邦-新店",20,0,20
"2778","2929淘帝","110/08/05","元大-北港",0,25,-25
"2779","2929淘帝","110/08/05","康和-台中",15,0,15
"2780","2929淘帝","110/08/05","兆豐-彰化",0,24,-24
"2781","2929淘帝","110/08/05","華南永昌-古亭",15,0,15
"2782","2929淘帝","110/08/05","國泰-台中",1,25,-24
"2783","2929淘帝","110/08/05","日盛-景美",11,0,11
"2784","2929淘帝","110/08/05","華南永昌-大安",0,22,-22
"2785","2929淘帝","110/08/05","台新證券",11,0,11
"2786","2929淘帝","110/08/05","國泰-館前",10,31,-21
"2787","2929淘帝","110/08/05","凱基-三重",11,0,11
"2788","2929淘帝","110/08/05","元富-安南",0,20,-20
"2789","2929淘帝","110/08/05","華南永昌-竹北",11,0,11
"2790","2929淘帝","110/08/05","元大-屏南",10,30,-20
"2791","5410國眾","110/08/05","凱基-市政",40,0,40
"2792","5410國眾","110/08/05","元富-台南",0,27,-27
"2793","5410國眾","110/08/05","安泰",16,0,16
"2794","5410國眾","110/08/05","群益金鼎-內湖",0,16,-16
"2795","5410國眾","110/08/05","元大-善化",12,0,12
"2796","5410國眾","110/08/05","中農",0,15,-15
"2797","5410國眾","110/08/05","元富-同大",10,0,10
"2798","5410國眾","110/08/05","新光-台南",0,15,-15
"2799","5410國眾","110/08/05","中國信託-新竹",10,0,10
"2800","5410國眾","110/08/05","統一-平鎮",0,13,-13
"2801","5410國眾","110/08/05","元大-敦南",10,0,10
"2802","5410國眾","110/08/05","臺銀",0,11,-11
"2803","5410國眾","110/08/05","台灣企銀-太平",8,0,8
"2804","5410國眾","110/08/05","凱基-城中",0,10,-10
"2805","5410國眾","110/08/05","瑞士信貸",7,0,7
"2806","5410國眾","110/08/05","元大-崇德",0,10,-10
"2807","5410國眾","110/08/05","元富-烏日",6,0,6
"2808","5410國眾","110/08/05","元大-和平",0,10,-10
"2809","5410國眾","110/08/05","摩根大通",7,1,6
"2810","5410國眾","110/08/05","新光-台中",1,9,-8
"2811","5410國眾","110/08/05","元富-三重",11,6,5
"2812","5410國眾","110/08/05","富邦-板橋",0,6,-6
"2813","5410國眾","110/08/05","中國信託-忠孝",5,0,5
"2814","5410國眾","110/08/05","新百王",0,5,-5
"2815","5410國眾","110/08/05","凱基-復興",5,0,5
"2816","5410國眾","110/08/05","元大-大益",0,5,-5
"2817","5410國眾","110/08/05","永豐金-台中",4,0,4
"2818","5410國眾","110/08/05","永豐金-板橋",0,5,-5
"2819","5410國眾","110/08/05","元富-板橋",3,0,3
"2820","5410國眾","110/08/05","台新-中壢",0,4,-4
"2821","2841台開","110/08/05","日盛證券",201,0,201
"2822","2841台開","110/08/05","第一金-自由",0,272,-272
"2823","2841台開","110/08/05","永豐金-敦南",202,1,201
"2824","2841台開","110/08/05","瑞士信貸",0,149,-149
"2825","2841台開","110/08/05","元大-大天母",200,0,200
"2826","2841台開","110/08/05","玉山-新竹",0,131,-131
"2827","2841台開","110/08/05","永豐金-鳳山",100,0,100
"2828","2841台開","110/08/05","元富-板橋",0,125,-125
"2829","2841台開","110/08/05","台新-三民",100,1,99
"2830","2841台開","110/08/05","元大-台中中港",0,109,-109
"2831","2841台開","110/08/05","凱基-竹科",67,0,67
"2832","2841台開","110/08/05","兆豐-東門",0,100,-100
"2833","2841台開","110/08/05","國泰-敦南",44,5,39
"2834","2841台開","110/08/05","(牛牛牛)亞-鑫豐",0,97,-97
"2835","2841台開","110/08/05","元大-中壢",35,0,35
"2836","2841台開","110/08/05","元富-嘉義",0,50,-50
"2837","2841台開","110/08/05","國泰-忠孝",33,0,33
"2838","2841台開","110/08/05","新光",20,67,-47
"2839","2841台開","110/08/05","元大-新竹經國",30,0,30
"2840","2841台開","110/08/05","永豐金-豐原",3,50,-47
"2841","2841台開","110/08/05","日盛-內湖",24,0,24
"2842","2841台開","110/08/05","統一-士林",0,31,-31
"2843","2841台開","110/08/05","新光-高雄",21,0,21
"2844","2841台開","110/08/05","元大-龍潭",0,30,-30
"2845","2841台開","110/08/05","元大-林園",20,0,20
"2846","2841台開","110/08/05","新光-台南",0,27,-27
"2847","2841台開","110/08/05","元大-仁愛",20,0,20
"2848","2841台開","110/08/05","台新-台中",0,22,-22
"2849","2841台開","110/08/05","群益金鼎-崇德",18,0,18
"2850","2841台開","110/08/05","大昌-安康",0,20,-20
"2851","6207雷科","110/08/05","摩根大通",313,64,249
"2852","6207雷科","110/08/05","日盛-忠孝",2,93,-91
"2853","6207雷科","110/08/05","新加坡商瑞銀",141,6,135
"2854","6207雷科","110/08/05","凱基-復興",0,90,-90
"2855","6207雷科","110/08/05","凱基-台北",142,20,122
"2856","6207雷科","110/08/05","群益金鼎-敦南",0,67,-67
"2857","6207雷科","110/08/05","台新-高雄",111,0,111
"2858","6207雷科","110/08/05","元大-鳳山",11,73,-62
"2859","6207雷科","110/08/05","瑞士信貸",58,0,58
"2860","6207雷科","110/08/05","群益金鼎-東門",0,56,-56
"2861","6207雷科","110/08/05","美林",45,0,45
"2862","6207雷科","110/08/05","元富-同大",1,41,-40
"2863","6207雷科","110/08/05","凱基-板橋",46,1,45
"2864","6207雷科","110/08/05","群益金鼎-屏東",1,41,-40
"2865","6207雷科","110/08/05","美商高盛",37,0,37
"2866","6207雷科","110/08/05","群益金鼎-延平",0,40,-40
"2867","6207雷科","110/08/05","凱基-三多",30,0,30
"2868","6207雷科","110/08/05","群益金鼎-瑞豐",1,33,-32
"2869","6207雷科","110/08/05","永豐金-虎尾",29,0,29
"2870","6207雷科","110/08/05","日盛證券",0,30,-30
"2871","6207雷科","110/08/05","第一金-中山",21,1,20
"2872","6207雷科","110/08/05","臺銀",1,30,-29
"2873","6207雷科","110/08/05","華南永昌-林口",20,0,20
"2874","6207雷科","110/08/05","群益金鼎-古亭",0,26,-26
"2875","6207雷科","110/08/05","兆豐-公益",18,0,18
"2876","6207雷科","110/08/05","凱基-高雄",4,30,-26
"2877","6207雷科","110/08/05","港商野村",62,46,16
"2878","6207雷科","110/08/05","富邦-竹東",0,25,-25
"2879","6207雷科","110/08/05","華南永昌-南京",16,0,16
"2880","6207雷科","110/08/05","元大-台中中港",2,25,-23
"2881","3679新至陞","110/08/05","新光",13,0,13
"2882","3679新至陞","110/08/05","凱基-台北",1,13,-12
"2883","3679新至陞","110/08/05","華南永昌-麻豆",3,0,3
"2884","3679新至陞","110/08/05","台灣摩根士丹利",0,5,-5
"2885","3679新至陞","110/08/05","臺灣企銀-埔墘",2,0,2
"2886","3679新至陞","110/08/05","元大-成功",0,5,-5
"2887","3679新至陞","110/08/05","彰銀",2,0,2
"2888","3679新至陞","110/08/05","元大證券",0,3,-3
"2889","3679新至陞","110/08/05","永全-南崁",2,0,2
"2890","3679新至陞","110/08/05","新加坡商瑞銀",0,2,-2
"2891","3679新至陞","110/08/05","群益金鼎",2,0,2
"2892","3679新至陞","110/08/05","摩根大通",0,2,-2
"2893","3679新至陞","110/08/05","富邦-三重",2,0,2
"2894","3679新至陞","110/08/05","國泰-館前",0,2,-2
"2895","3679新至陞","110/08/05","永豐金-敦北",2,0,2
"2896","3679新至陞","110/08/05","凱基-東港",0,2,-2
"2897","3679新至陞","110/08/05","臺銀-新竹",1,0,1
"2898","3679新至陞","110/08/05","元大-竹北",0,2,-2
"2899","3679新至陞","110/08/05","第一金-新興",1,0,1
"2900","3679新至陞","110/08/05","日盛-嘉義",0,1,-1
"2901","3679新至陞","110/08/05","統一-宜蘭",1,0,1
"2902","3679新至陞","110/08/05","美商高盛",1,2,-1
"2903","3679新至陞","110/08/05","元富-同大",1,0,1
"2904","3679新至陞","110/08/05","港商野村",0,1,-1
"2905","3679新至陞","110/08/05","中國信託-新竹",1,0,1
"2906","3679新至陞","110/08/05","第一金-員林",0,1,-1
"2907","3679新至陞","110/08/05","兆豐-民生",1,0,1
"2908","3679新至陞","110/08/05","統一-中壢",0,1,-1
"2909","3679新至陞","110/08/05","國泰-新莊",1,0,1
"2910","3679新至陞","110/08/05","統一-新竹",0,1,-1
"2911","2727王品","110/08/05","港商野村",68,43,25
"2912","2727王品","110/08/05","元富-宜蘭",6,96,-90
"2913","2727王品","110/08/05","花旗環球",24,0,24
"2914","2727王品","110/08/05","凱基-市政",1,89,-88
"2915","2727王品","110/08/05","新光",42,19,23
"2916","2727王品","110/08/05","群益金鼎-宜蘭",4,89,-85
"2917","2727王品","110/08/05","永豐金-忠孝",21,0,21
"2918","2727王品","110/08/05","永豐金-大園",4,66,-62
"2919","2727王品","110/08/05","凱基-埔墘",15,0,15
"2920","2727王品","110/08/05","康和-澎湖",1,60,-59
"2921","2727王品","110/08/05","新光-桃園",17,3,14
"2922","2727王品","110/08/05","日盛-八德",1,33,-32
"2923","2727王品","110/08/05","日盛-忠孝",16,3,13
"2924","2727王品","110/08/05","元大-桃園",0,29,-29
"2925","2727王品","110/08/05","統一",28,15,13
"2926","2727王品","110/08/05","凱基-竹科",4,31,-27
"2927","2727王品","110/08/05","富邦-員林",15,2,13
"2928","2727王品","110/08/05","富邦-新店",2,29,-27
"2929","2727王品","110/08/05","永豐金-桃盛",16,3,13
"2930","2727王品","110/08/05","兆豐-小港",2,26,-24
"2931","2727王品","110/08/05","元富-屏東",12,0,12
"2932","2727王品","110/08/05","華南永昌",6,25,-19
"2933","2727王品","110/08/05","凱基-台北",52,40,12
"2934","2727王品","110/08/05","台灣摩根士丹利",15,32,-17
"2935","2727王品","110/08/05","永豐金-彰化",12,0,12
"2936","2727王品","110/08/05","凱基-天母",0,15,-15
"2937","2727王品","110/08/05","美林",11,0,11
"2938","2727王品","110/08/05","富邦證券",0,15,-15
"2939","2727王品","110/08/05","群益金鼎-崇德",10,0,10
"2940","2727王品","110/08/05","永豐金證券",1,13,-12
"2941","1570力肯","110/08/05","國票",352,0,352
"2942","1570力肯","110/08/05","國票-和平",7,402,-395
"2943","1570力肯","110/08/05","台新證券",211,87,124
"2944","1570力肯","110/08/05","摩根大通",46,335,-289
"2945","1570力肯","110/08/05","國泰-敦南",206,125,81
"2946","1570力肯","110/08/05","國票-北高雄",79,306,-227
"2947","1570力肯","110/08/05","聯邦商銀",75,0,75
"2948","1570力肯","110/08/05","統一",3,226,-223
"2949","1570力肯","110/08/05","元大-東泰",61,4,57
"2950","1570力肯","110/08/05","凱基-台北",184,366,-182
"2951","1570力肯","110/08/05","元大-桃興",113,66,47
"2952","1570力肯","110/08/05","統一-土城",89,161,-72
"2953","1570力肯","110/08/05","國泰-板橋",96,50,46
"2954","1570力肯","110/08/05","統一-屏東",0,64,-64
"2955","1570力肯","110/08/05","合庫-桃園",92,48,44
"2956","1570力肯","110/08/05","大昌-新店",9,61,-52
"2957","1570力肯","110/08/05","華南永昌-高雄",53,12,41
"2958","1570力肯","110/08/05","群益金鼎-忠孝",11,60,-49
"2959","1570力肯","110/08/05","國泰-高雄",50,14,36
"2960","1570力肯","110/08/05","臺銀-臺南",12,52,-40
"2961","1570力肯","110/08/05","國泰-台中",60,25,35
"2962","1570力肯","110/08/05","凱基-岡山",28,68,-40
"2963","1570力肯","110/08/05","富邦-仁愛",52,17,35
"2964","1570力肯","110/08/05","元大-蘆洲",8,44,-36
"2965","1570力肯","110/08/05","中國信託-忠孝",37,3,34
"2966","1570力肯","110/08/05","統一-仁愛",25,60,-35
"2967","1570力肯","110/08/05","元大-中壢",44,10,34
"2968","1570力肯","110/08/05","富邦-高雄",8,43,-35
"2969","1570力肯","110/08/05","日盛-新竹",30,0,30
"2970","1570力肯","110/08/05","大慶-蘆洲",110,142,-32
"2971","6180橘子","110/08/05","永豐金-松山",51,0,51
"2972","6180橘子","110/08/05","凱基-板橋",0,80,-80
"2973","6180橘子","110/08/05","新光",40,2,38
"2974","6180橘子","110/08/05","康和-高雄",0,40,-40
"2975","6180橘子","110/08/05","兆豐證券",33,0,33
"2976","6180橘子","110/08/05","合庫-鳳山",0,32,-32
"2977","6180橘子","110/08/05","中國信託-文心",15,0,15
"2978","6180橘子","110/08/05","日盛-頭份",1,24,-23
"2979","6180橘子","110/08/05","富邦-陽明",15,0,15
"2980","6180橘子","110/08/05","兆豐-新營",0,22,-22
"2981","6180橘子","110/08/05","元大-龍潭",11,0,11
"2982","6180橘子","110/08/05","元大-福營",0,20,-20
"2983","6180橘子","110/08/05","日盛-新竹",10,0,10
"2984","6180橘子","110/08/05","新加坡商瑞銀",0,19,-19
"2985","6180橘子","110/08/05","凱基-汐止",10,0,10
"2986","6180橘子","110/08/05","永豐金-新竹",0,17,-17
"2987","6180橘子","110/08/05","元大-中壢",10,1,9
"2988","6180橘子","110/08/05","第一金-新興",1,16,-15
"2989","6180橘子","110/08/05","元富-潮州",8,0,8
"2990","6180橘子","110/08/05","凱基-中壢",0,12,-12
"2991","6180橘子","110/08/05","大慶",7,0,7
"2992","6180橘子","110/08/05","光和",0,10,-10
"2993","6180橘子","110/08/05","台新證券",7,0,7
"2994","6180橘子","110/08/05","統一-中壢",0,9,-9
"2995","6180橘子","110/08/05","聯邦-雙和",7,0,7
"2996","6180橘子","110/08/05","富邦-基隆",0,9,-9
"2997","6180橘子","110/08/05","元大證券",7,0,7
"2998","6180橘子","110/08/05","台灣摩根士丹利",0,8,-8
"2999","6180橘子","110/08/05","國泰-新莊",6,0,6
"3000","6180橘子","110/08/05","康和-仁愛",0,8,-8
"3001","2390云辰","110/08/05","日盛證券",100,0,100
"3002","2390云辰","110/08/05","摩根大通",45,525,-480
"3003","2390云辰","110/08/05","兆豐-岡山",63,0,63
"3004","2390云辰","110/08/05","統一-新台中",62,177,-115
"3005","2390云辰","110/08/05","凱基-基隆",65,10,55
"3006","2390云辰","110/08/05","富邦-中壢",0,81,-81
"3007","2390云辰","110/08/05","凱基-中壢",52,3,49
"3008","2390云辰","110/08/05","元大-大甲",3,73,-70
"3009","2390云辰","110/08/05","台新-左楠",30,0,30
"3010","2390云辰","110/08/05","元大-樹林",16,53,-37
"3011","2390云辰","110/08/05","富邦-台北",33,6,27
"3012","2390云辰","110/08/05","元富-大裕",17,46,-29
"3013","2390云辰","110/08/05","統一-中壢",27,1,26
"3014","2390云辰","110/08/05","凱基-台中",1,30,-29
"3015","2390云辰","110/08/05","元大-和平",47,22,25
"3016","2390云辰","110/08/05","大慶-蘆洲",2,30,-28
"3017","2390云辰","110/08/05","統一-士林",26,2,24
"3018","2390云辰","110/08/05","元大-大統",3,31,-28
"3019","2390云辰","110/08/05","富邦-新營",23,0,23
"3020","2390云辰","110/08/05","臺銀-金山",1,27,-26
"3021","2390云辰","110/08/05","元大-景美",22,1,21
"3022","2390云辰","110/08/05","國泰-台中",0,23,-23
"3023","2390云辰","110/08/05","合庫-嘉義",20,0,20
"3024","2390云辰","110/08/05","富邦-岡山",0,23,-23
"3025","2390云辰","110/08/05","台灣企銀-嘉義",20,0,20
"3026","2390云辰","110/08/05","元大-土城學府",24,47,-23
"3027","2390云辰","110/08/05","日盛-板橋",21,1,20
"3028","2390云辰","110/08/05","台新-台中",28,50,-22
"3029","2390云辰","110/08/05","凱基-竹科",28,8,20
"3030","2390云辰","110/08/05","群益金鼎-鳳山",0,21,-21
"3031","1471首利","110/08/04","玉山-桃園",51,0,51
"3032","1471首利","110/08/04","國票-九鼎",0,60,-60
"3033","1471首利","110/08/04","華南永昌-潮州",50,1,49
"3034","1471首利","110/08/04","日盛-士林",0,20,-20
"3035","1471首利","110/08/04","瑞士信貸",33,3,30
"3036","1471首利","110/08/04","元大-博愛",4,24,-20
"3037","1471首利","110/08/04","兆豐-板橋",20,0,20
"3038","1471首利","110/08/04","群益金鼎-台中",1,20,-19
"3039","1471首利","110/08/04","兆豐-台中港",30,13,17
"3040","1471首利","110/08/04","國泰-高雄",0,16,-16
"3041","1471首利","110/08/04","富邦-基隆",16,0,16
"3042","1471首利","110/08/04","元大-台南",1,17,-16
"3043","1471首利","110/08/04","美林",15,0,15
"3044","1471首利","110/08/04","國泰-敦南",18,32,-14
"3045","1471首利","110/08/04","永豐金-員林",12,0,12
"3046","1471首利","110/08/04","新光",21,33,-12
"3047","1471首利","110/08/04","第一金-台南",11,0,11
"3048","1471首利","110/08/04","凱基-土城",0,12,-12
"3049","1471首利","110/08/04","德信-中正",12,1,11
"3050","1471首利","110/08/04","合庫-高雄",0,10,-10
"3051","1471首利","110/08/04","合庫-台中",10,0,10
"3052","1471首利","110/08/04","元富-宜蘭",0,10,-10
"3053","1471首利","110/08/04","國泰-新莊",10,0,10
"3054","1471首利","110/08/04","國泰-板橋",0,10,-10
"3055","1471首利","110/08/04","富邦-桃園",10,0,10
"3056","1471首利","110/08/04","群益金鼎-鳳山",0,10,-10
"3057","1471首利","110/08/04","元大-苗栗",10,0,10
"3058","1471首利","110/08/04","元大-東泰",0,10,-10
"3059","1471首利","110/08/04","玉山-左營",10,1,9
"3060","1471首利","110/08/04","元大-林園",0,10,-10
"3061","2883開發金","110/08/04","國泰證券",3650,0,3650
"3062","2883開發金","110/08/04","康和-仁愛",3,1737,-1734
"3063","2883開發金","110/08/04","統一",2763,29,2734
"3064","2883開發金","110/08/04","新加坡商瑞銀",356,1472,-1116
"3065","2883開發金","110/08/04","凱基-台北",2041,429,1612
"3066","2883開發金","110/08/04","豐農",5,1025,-1020
"3067","2883開發金","110/08/04","元富-城東",1602,26,1576
"3068","2883開發金","110/08/04","富邦-建國",271,1004,-733
"3069","2883開發金","110/08/04","元富",1190,0,1190
"3070","2883開發金","110/08/04","元大-北成功",6,608,-602
"3071","2883開發金","110/08/04","美商高盛",1033,355,678
"3072","2883開發金","110/08/04","台灣摩根士丹利",573,1019,-446
"3073","2883開發金","110/08/04","康和",661,6,655
"3074","2883開發金","110/08/04","台新-中壢",2,431,-429
"3075","2883開發金","110/08/04","國票-長城",504,8,496
"3076","2883開發金","110/08/04","凱基-和平",1,400,-399
"3077","2883開發金","110/08/04","元大-大灣",734,304,430
"3078","2883開發金","110/08/04","元大-蘆洲",7,370,-363
"3079","2883開發金","110/08/04","永豐金-板橋",500,100,400
"3080","2883開發金","110/08/04","元大-民生",10,370,-360
"3081","2883開發金","110/08/04","永豐金-台南",389,11,378
"3082","2883開發金","110/08/04","中國信託-中壢",1,321,-320
"3083","2883開發金","110/08/04","日盛證券",608,255,353
"3084","2883開發金","110/08/04","港商法國興業",0,291,-291
"3085","2883開發金","110/08/04","花旗環球",343,0,343
"3086","2883開發金","110/08/04","日盛-北高雄",20,309,-289
"3087","2883開發金","110/08/04","瑞士信貸",462,121,341
"3088","2883開發金","110/08/04","日盛-花蓮",11,250,-239
"3089","2883開發金","110/08/04","凱基",320,0,320
"3090","2883開發金","110/08/04","群益金鼎-東湖",10,243,-233
"3091","6205詮欣","110/08/04","摩根大通",18,0,18
"3092","6205詮欣","110/08/04","永豐金-敦南",16,36,-20
"3093","6205詮欣","110/08/04","臺銀-民權",5,0,5
"3094","6205詮欣","110/08/04","瑞士信貸",6,10,-4
"3095","6205詮欣","110/08/04","凱基-台北",4,0,4
"3096","6205詮欣","110/08/04","致和-高雄",0,4,-4
"3097","6205詮欣","110/08/04","元富-潮州",3,0,3
"3098","6205詮欣","110/08/04","群益金鼎-台南",0,3,-3
"3099","6205詮欣","110/08/04","台中銀",3,0,3
"3100","6205詮欣","110/08/04","元大-路竹",0,3,-3
"3101","6205詮欣","110/08/04","華南永昌",3,0,3
"3102","6205詮欣","110/08/04","元大-北成功",0,3,-3
"3103","6205詮欣","110/08/04","美林",2,0,2
"3104","6205詮欣","110/08/04","凱基-東門",0,2,-2
"3105","6205詮欣","110/08/04","元富-新店",2,0,2
"3106","6205詮欣","110/08/04","凱基-基隆",0,2,-2
"3107","6205詮欣","110/08/04","元大-羅東",2,0,2
"3108","6205詮欣","110/08/04","凱基-大安",0,2,-2
"3109","6205詮欣","110/08/04","元大-館前",2,0,2
"3110","6205詮欣","110/08/04","元大-土城學府",0,2,-2
"3111","6205詮欣","110/08/04","元大-楊梅",2,0,2
"3112","6205詮欣","110/08/04","元大-民生",0,2,-2
"3113","6205詮欣","110/08/04","元大-信義",2,0,2
"3114","6205詮欣","110/08/04","日盛-八德",0,1,-1
"3115","6205詮欣","110/08/04","永豐金-埔里",2,0,2
"3116","6205詮欣","110/08/04","宏遠-高雄",0,1,-1
"3117","6205詮欣","110/08/04","日盛-板橋",1,0,1
"3118","6205詮欣","110/08/04","新加坡商瑞銀",0,1,-1
"3119","6205詮欣","110/08/04","日盛-木柵",1,0,1
"3120","6205詮欣","110/08/04","第一金-華江",0,1,-1
"3121","1540喬福","110/08/04","元富-中原",58,0,58
"3122","1540喬福","110/08/04","元大-大天母",0,60,-60
"3123","1540喬福","110/08/04","(牛牛牛)亞-鑫豐",26,0,26
"3124","1540喬福","110/08/04","統一-新台中",0,18,-18
"3125","1540喬福","110/08/04","國泰-敦南",10,0,10
"3126","1540喬福","110/08/04","群益金鼎-士林",0,7,-7
"3127","1540喬福","110/08/04","富邦-南屯",10,0,10
"3128","1540喬福","110/08/04","兆豐-北高雄",0,6,-6
"3129","1540喬福","110/08/04","兆豐-鹿港",3,0,3
"3130","1540喬福","110/08/04","凱基-市政",0,5,-5
"3131","1540喬福","110/08/04","元大-土城永寧",2,0,2
"3132","1540喬福","110/08/04","亞東-高雄",0,4,-4
"3133","1540喬福","110/08/04","第一金-桃園",1,0,1
"3134","1540喬福","110/08/04","永豐金-大園",0,4,-4
"3135","1540喬福","110/08/04","兆豐-高雄",1,0,1
"3136","1540喬福","110/08/04","永豐金-豐原",0,2,-2
"3137","1540喬福","110/08/04","元大-苑裡",1,0,1
"3138","1540喬福","110/08/04","兆豐-三重",0,1,-1
"3139","1540喬福","110/08/04","臺銀-鳳山",0,0,0
"3140","1540喬福","110/08/04","致和-南京",0,1,-1
"3141","1540喬福","110/08/04","大慶",0,0,0
"3142","1540喬福","110/08/04","國票-嘉義",0,1,-1
"3143","1540喬福","110/08/04","元富-信義",0,0,0
"3144","1540喬福","110/08/04","兆豐-嘉義",0,1,-1
"3145","1540喬福","110/08/04","德信-新營",1,1,0
"3146","1540喬福","110/08/04","華南永昌-林口",0,1,-1
"3147","1540喬福","110/08/04","國票-台中",1,1,0
"3148","1540喬福","110/08/04","華南永昌-潮州",0,1,-1
"3149","1540喬福","110/08/04","康和-板橋",0,0,0
"3150","1540喬福","110/08/04","國票-台中",1,1,0
"3151","2888新光金","110/08/04","港商麥格理",2490,0,2490
"3152","2888新光金","110/08/04","永豐金-苓雅",2,1543,-1541
"3153","2888新光金","110/08/04","凱基-八德",1000,1,999
"3154","2888新光金","110/08/04","美商高盛",196,1441,-1245
"3155","2888新光金","110/08/04","新光",1122,247,875
"3156","2888新光金","110/08/04","台灣摩根士丹利",724,1776,-1052
"3157","2888新光金","110/08/04","國票-桃園",1200,402,798
"3158","2888新光金","110/08/04","摩根大通",616,1665,-1049
"3159","2888新光金","110/08/04","華南永昌-南京",759,36,723
"3160","2888新光金","110/08/04","康和-台中",0,680,-680
"3161","2888新光金","110/08/04","港商法國興業",568,0,568
"3162","2888新光金","110/08/04","群益金鼎-高雄",0,533,-533
"3163","2888新光金","110/08/04","花旗環球",559,0,559
"3164","2888新光金","110/08/04","亞東",34,531,-497
"3165","2888新光金","110/08/04","法銀巴黎",801,242,559
"3166","2888新光金","110/08/04","群益金鼎-土城",25,464,-439
"3167","2888新光金","110/08/04","凱基-台北",889,355,534
"3168","2888新光金","110/08/04","國票-北高雄",2,425,-423
"3169","2888新光金","110/08/04","統一-松江",500,0,500
"3170","2888新光金","110/08/04","凱基-台南",0,400,-400
"3171","2888新光金","110/08/04","華南永昌-長虹",345,0,345
"3172","2888新光金","110/08/04","新加坡商瑞銀",128,486,-358
"3173","2888新光金","110/08/04","美林",884,551,333
"3174","2888新光金","110/08/04","統一-屏東",0,344,-344
"3175","2888新光金","110/08/04","群益金鼎-中壢",301,3,298
"3176","2888新光金","110/08/04","統一-宜蘭",8,326,-318
"3177","2888新光金","110/08/04","群益金鼎",278,0,278
"3178","2888新光金","110/08/04","群益金鼎-萬華",0,284,-284
"3179","2888新光金","110/08/04","元大-北投",249,5,244
"3180","2888新光金","110/08/04","富邦-仁愛",10,276,-266
"3181","1340勝悅","110/08/04","第一金-新竹",10,0,10
"3182","1340勝悅","110/08/04","中國信託",0,23,-23
"3183","1340勝悅","110/08/04","凱基-虎尾",8,0,8
"3184","1340勝悅","110/08/04","永豐金-潮州",0,19,-19
"3185","1340勝悅","110/08/04","凱基-台中",6,0,6
"3186","1340勝悅","110/08/04","元富-花蓮",0,10,-10
"3187","1340勝悅","110/08/04","臺灣企銀-埔墘",5,0,5
"3188","1340勝悅","110/08/04","中國信託-永康",0,10,-10
"3189","1340勝悅","110/08/04","第一金",5,0,5
"3190","1340勝悅","110/08/04","第一金-中壢",0,7,-7
"3191","1340勝悅","110/08/04","凱基-八德",5,0,5
"3192","1340勝悅","110/08/04","高橋-中壢",0,5,-5
"3193","1340勝悅","110/08/04","永豐金-博愛",5,0,5
"3194","1340勝悅","110/08/04","富邦-新店",0,5,-5
"3195","1340勝悅","110/08/04","摩根大通",6,2,4
"3196","1340勝悅","110/08/04","台新-高雄",0,4,-4
"3197","1340勝悅","110/08/04","凱基-三重",4,0,4
"3198","1340勝悅","110/08/04","新光",0,4,-4
"3199","1340勝悅","110/08/04","統一-城中",7,4,3
"3200","1340勝悅","110/08/04","兆豐-松德",0,2,-2
"3201","1340勝悅","110/08/04","群益金鼎-館前",3,0,3
"3202","1340勝悅","110/08/04","凱基-嘉義",0,2,-2
"3203","1340勝悅","110/08/04","元大-南京",3,0,3
"3204","1340勝悅","110/08/04","富邦-宜蘭",0,2,-2
"3205","1340勝悅","110/08/04","瑞士信貸",2,0,2
"3206","1340勝悅","110/08/04","永豐金-永康",0,2,-2
"3207","1340勝悅","110/08/04","大慶-富順",2,0,2
"3208","1340勝悅","110/08/04","永豐金-嘉義",0,2,-2
"3209","1340勝悅","110/08/04","國泰-高雄",2,0,2
"3210","1340勝悅","110/08/04","玉山證券",0,1,-1
"3211","6246臺龍","110/08/04","統一",347,0,347
"3212","6246臺龍","110/08/04","大慶-富順",0,168,-168
"3213","6246臺龍","110/08/04","元大-西螺",30,0,30
"3214","6246臺龍","110/08/04","元大-善化",1,91,-90
"3215","6246臺龍","110/08/04","華南永昌-嘉義",26,0,26
"3216","6246臺龍","110/08/04","新光-高雄",2,75,-73
"3217","6246臺龍","110/08/04","中國信託-永康",31,9,22
"3218","6246臺龍","110/08/04","元大-永春",1,40,-39
"3219","6246臺龍","110/08/04","元大-西屯",25,4,21
"3220","6246臺龍","110/08/04","元大-基隆孝二",1,35,-34
"3221","6246臺龍","110/08/04","凱基-竹科",23,3,20
"3222","6246臺龍","110/08/04","凱基-復興",10,43,-33
"3223","6246臺龍","110/08/04","凱基-大直",19,0,19
"3224","6246臺龍","110/08/04","國泰-台中",3,34,-31
"3225","6246臺龍","110/08/04","第一金-台南",18,0,18
"3226","6246臺龍","110/08/04","統一-屏東",0,26,-26
"3227","6246臺龍","110/08/04","萬泰",15,0,15
"3228","6246臺龍","110/08/04","台灣企銀-台南",1,25,-24
"3229","6246臺龍","110/08/04","華南永昌-台中",15,0,15
"3230","6246臺龍","110/08/04","宏遠-民生",0,22,-22
"3231","6246臺龍","110/08/04","凱基-板橋",13,0,13
"3232","6246臺龍","110/08/04","兆豐-來福",0,20,-20
"3233","6246臺龍","110/08/04","宏遠-高雄",12,0,12
"3234","6246臺龍","110/08/04","永豐金-市政",0,17,-17
"3235","6246臺龍","110/08/04","新光-台中",11,0,11
"3236","6246臺龍","110/08/04","台新-台中",5,21,-16
"3237","6246臺龍","110/08/04","玉山證券",13,2,11
"3238","6246臺龍","110/08/04","華南永昌-彰化",1,16,-15
"3239","6246臺龍","110/08/04","永豐金-高雄",12,1,11
"3240","6246臺龍","110/08/04","元大-博愛",13,28,-15
"3241","00715L期街口布蘭特正2","110/08/04","宏遠-高雄",1056,0,1056
"3242","00715L期街口布蘭特正2","110/08/04","元大證券",1348,7345,-5997
"3243","00715L期街口布蘭特正2","110/08/04","凱基-豐中",576,0,576
"3244","00715L期街口布蘭特正2","110/08/04","凱基-台北",37,5749,-5712
"3245","00715L期街口布蘭特正2","110/08/04","富邦-基隆",467,0,467
"3246","00715L期街口布蘭特正2","110/08/04","富邦證券",253,2075,-1822
"3247","00715L期街口布蘭特正2","110/08/04","國泰-板橋",470,30,440
"3248","00715L期街口布蘭特正2","110/08/04","第一金-頭份",11,400,-389
"3249","00715L期街口布蘭特正2","110/08/04","統一-高雄",358,3,355
"3250","00715L期街口布蘭特正2","110/08/04","富邦-永和",4,376,-372
"3251","00715L期街口布蘭特正2","110/08/04","中國信託-永康",219,1,218
"3252","00715L期街口布蘭特正2","110/08/04","永豐金-新店",0,370,-370
"3253","00715L期街口布蘭特正2","110/08/04","元大-中和",217,0,217
"3254","00715L期街口布蘭特正2","110/08/04","元富",53,412,-359
"3255","00715L期街口布蘭特正2","110/08/04","日盛-花蓮",201,1,200
"3256","00715L期街口布蘭特正2","110/08/04","臺銀-民權",15,366,-351
"3257","00715L期街口布蘭特正2","110/08/04","元大-中壢",201,12,189
"3258","00715L期街口布蘭特正2","110/08/04","兆豐-新莊",0,300,-300
"3259","00715L期街口布蘭特正2","110/08/04","宏遠-桃園",190,2,188
"3260","00715L期街口布蘭特正2","110/08/04","大昌-新店",17,300,-283
"3261","00715L期街口布蘭特正2","110/08/04","玉山-大里",182,0,182
"3262","00715L期街口布蘭特正2","110/08/04","元大-西螺",87,303,-216
"3263","00715L期街口布蘭特正2","110/08/04","新光",258,80,178
"3264","00715L期街口布蘭特正2","110/08/04","華南永昌-高雄",7,206,-199
"3265","00715L期街口布蘭特正2","110/08/04","元大-花蓮",178,0,178
"3266","00715L期街口布蘭特正2","110/08/04","國票-台中",8,200,-192
"3267","00715L期街口布蘭特正2","110/08/04","新光-台中",242,68,174
"3268","00715L期街口布蘭特正2","110/08/04","群益金鼎-鳳山",12,174,-162
"3269","00715L期街口布蘭特正2","110/08/04","(牛牛牛)亞-網路",166,0,166
"3270","00715L期街口布蘭特正2","110/08/04","國泰-台南",8,150,-142
"3271","8941關中","110/08/04","宏遠-館前",3,0,3
"3272","8941關中","110/08/04","元大-基隆",0,3,-3
"3273","8941關中","110/08/04","日盛-和美",1,0,1
"3274","8941關中","110/08/04","富邦-員林",0,2,-2
"3275","8941關中","110/08/04","元大-華山",1,0,1
"3276","8941關中","110/08/04","新光-高雄",0,0,0
"3277","8941關中","110/08/04","新光-高雄",0,0,0
"3278","8941關中","110/08/04","國泰-高雄",0,0,0
"3279","8941關中","110/08/04","國泰-高雄",0,0,0
"3280","8941關中","110/08/04","富邦-建國",0,0,0
"3281","8941關中","110/08/04","富邦-建國",0,0,0
"3282","8941關中","110/08/04","元大-西屯",0,0,0
"3283","8941關中","110/08/04","元大-西屯",0,0,0
"3284","8941關中","110/08/04","元大-花蓮",0,0,0
"3285","8941關中","110/08/04","元大-花蓮",0,0,0
"3286","8941關中","110/08/04","永豐金-萬盛",0,0,0
"3287","8941關中","110/08/04","永豐金-萬盛",0,0,0
"3288","8941關中","110/08/04","",NA,NA,NA
"3289","8941關中","110/08/04","",NA,NA,NA
"3290","8941關中","110/08/04","",NA,NA,NA
"3291","8941關中","110/08/04","",NA,NA,NA
"3292","8941關中","110/08/04","",NA,NA,NA
"3293","8941關中","110/08/04","",NA,NA,NA
"3294","8941關中","110/08/04","",NA,NA,NA
"3295","8941關中","110/08/04","",NA,NA,NA
"3296","8941關中","110/08/04","",NA,NA,NA
"3297","8941關中","110/08/04","",NA,NA,NA
"3298","8941關中","110/08/04","",NA,NA,NA
"3299","8941關中","110/08/04","",NA,NA,NA
"3300","8941關中","110/08/04","",NA,NA,NA
"3301","8936國統","110/08/04","第一金-光復",120,0,120
"3302","8936國統","110/08/04","兆豐-彰化",0,61,-61
"3303","8936國統","110/08/04","美林",99,3,96
"3304","8936國統","110/08/04","凱基-台北",4,56,-52
"3305","8936國統","110/08/04","華南永昌-楠梓",70,5,65
"3306","8936國統","110/08/04","凱基-內埔",0,50,-50
"3307","8936國統","110/08/04","永豐金-高雄",62,0,62
"3308","8936國統","110/08/04","台灣摩根士丹利",0,42,-42
"3309","8936國統","110/08/04","國票-台南",60,0,60
"3310","8936國統","110/08/04","永豐金-苓雅",1,40,-39
"3311","8936國統","110/08/04","永豐金-台中",30,0,30
"3312","8936國統","110/08/04","群益金鼎-內湖",0,30,-30
"3313","8936國統","110/08/04","第一金-豐原",20,0,20
"3314","8936國統","110/08/04","國票-北高雄",0,20,-20
"3315","8936國統","110/08/04","玉山-高雄",13,0,13
"3316","8936國統","110/08/04","宏遠-館前",0,19,-19
"3317","8936國統","110/08/04","元大-莒光",11,0,11
"3318","8936國統","110/08/04","美商高盛",3,22,-19
"3319","8936國統","110/08/04","亞東-高雄",10,0,10
"3320","8936國統","110/08/04","元大-大里德芳",4,21,-17
"3321","8936國統","110/08/04","第一金-路竹",10,0,10
"3322","8936國統","110/08/04","第一金-高雄",0,14,-14
"3323","8936國統","110/08/04","新光-台中",8,1,7
"3324","8936國統","110/08/04","日盛-竹北",0,12,-12
"3325","8936國統","110/08/04","統一-三多",5,0,5
"3326","8936國統","110/08/04","亞東",0,12,-12
"3327","8936國統","110/08/04","國票-內壢",5,0,5
"3328","8936國統","110/08/04","摩根大通",32,44,-12
"3329","8936國統","110/08/04","新光",10,5,5
"3330","8936國統","110/08/04","第一金-嘉義",0,10,-10
"3331","6226光鼎","110/08/04","富邦-嘉義",1247,573,674
"3332","6226光鼎","110/08/04","國泰-敦南",89,234,-145
"3333","6226光鼎","110/08/04","永豐金-桃盛",205,0,205
"3334","6226光鼎","110/08/04","日盛-嘉義",0,131,-131
"3335","6226光鼎","110/08/04","台新-左楠",120,1,119
"3336","6226光鼎","110/08/04","群益金鼎-東大",35,150,-115
"3337","6226光鼎","110/08/04","群益金鼎-敦南",127,8,119
"3338","6226光鼎","110/08/04","台中銀-員林",0,101,-101
"3339","6226光鼎","110/08/04","台灣摩根士丹利",135,55,80
"3340","6226光鼎","110/08/04","玉山-雙和",2,97,-95
"3341","6226光鼎","110/08/04","華南永昌-南京",89,14,75
"3342","6226光鼎","110/08/04","台新證券",76,167,-91
"3343","6226光鼎","110/08/04","台新-台中",101,32,69
"3344","6226光鼎","110/08/04","華南永昌-頭份",7,86,-79
"3345","6226光鼎","110/08/04","宏遠-台中",60,3,57
"3346","6226光鼎","110/08/04","高橋",0,70,-70
"3347","6226光鼎","110/08/04","大昌",79,26,53
"3348","6226光鼎","110/08/04","國泰-館前",18,62,-44
"3349","6226光鼎","110/08/04","台新-新莊",54,2,52
"3350","6226光鼎","110/08/04","凱基-永和",0,43,-43
"3351","6226光鼎","110/08/04","群益金鼎-三民",51,3,48
"3352","6226光鼎","110/08/04","日盛-景美",0,38,-38
"3353","6226光鼎","110/08/04","中國信託-永康",62,18,44
"3354","6226光鼎","110/08/04","華南永昌-高雄",9,47,-38
"3355","6226光鼎","110/08/04","國票-台中",45,2,43
"3356","6226光鼎","110/08/04","元大-太平",6,44,-38
"3357","6226光鼎","110/08/04","統一-士林",44,4,40
"3358","6226光鼎","110/08/04","元大-北投",0,37,-37
"3359","6226光鼎","110/08/04","統一-仁愛",51,14,37
"3360","6226光鼎","110/08/04","元大-板橋",0,37,-37
"3361","2363矽統","110/08/04","富邦-中壢",628,138,490
"3362","2363矽統","110/08/04","新加坡商瑞銀",986,2541,-1555
"3363","2363矽統","110/08/04","凱基-台北",7207,6730,477
"3364","2363矽統","110/08/04","台灣摩根士丹利",158,1373,-1215
"3365","2363矽統","110/08/04","元大-承德",449,81,368
"3366","2363矽統","110/08/04","摩根大通",2506,3701,-1195
"3367","2363矽統","110/08/04","群益金鼎-高雄",438,99,339
"3368","2363矽統","110/08/04","日盛-文化",121,1226,-1105
"3369","2363矽統","110/08/04","元富-嘉義",383,57,326
"3370","2363矽統","110/08/04","美林",2013,2637,-624
"3371","2363矽統","110/08/04","元大-旗山",446,147,299
"3372","2363矽統","110/08/04","凱基-新莊",44,445,-401
"3373","2363矽統","110/08/04","大慶-台中",304,14,290
"3374","2363矽統","110/08/04","台新-松江",60,449,-389
"3375","2363矽統","110/08/04","國票-博愛",425,150,275
"3376","2363矽統","110/08/04","統一-士林",649,1031,-382
"3377","2363矽統","110/08/04","台新-台南",494,230,264
"3378","2363矽統","110/08/04","新光",1494,1876,-382
"3379","2363矽統","110/08/04","群益金鼎-內湖",393,135,258
"3380","2363矽統","110/08/04","華南永昌",691,1068,-377
"3381","2363矽統","110/08/04","群益金鼎-桃園",295,68,227
"3382","2363矽統","110/08/04","富邦-彰化",122,486,-364
"3383","2363矽統","110/08/04","永豐金-羅東",397,182,215
"3384","2363矽統","110/08/04","凱基-永和",198,478,-280
"3385","2363矽統","110/08/04","元大-永春",347,142,205
"3386","2363矽統","110/08/04","富邦-嘉義",1358,1619,-261
"3387","2363矽統","110/08/04","台新-屏東",466,275,191
"3388","2363矽統","110/08/04","元大-前金",175,419,-244
"3389","2363矽統","110/08/04","元大-萬華",286,96,190
"3390","2363矽統","110/08/04","凱基-大直",681,912,-231
"3391","8112至上","110/08/04","台灣匯立證券",138,0,138
"3392","8112至上","110/08/04","日盛-高雄",1,355,-354
"3393","8112至上","110/08/04","元富-新興",94,8,86
"3394","8112至上","110/08/04","玉山-士林",0,150,-150
"3395","8112至上","110/08/04","合庫-西台中",55,7,48
"3396","8112至上","110/08/04","台灣摩根士丹利",20,143,-123
"3397","8112至上","110/08/04","摩根大通",145,97,48
"3398","8112至上","110/08/04","元富-大昌",0,120,-120
"3399","8112至上","110/08/04","台新證券",48,1,47
"3400","8112至上","110/08/04","華南永昌-林口",1,90,-89
"3401","8112至上","110/08/04","第一金-高雄",40,0,40
"3402","8112至上","110/08/04","元大-北屯",1,70,-69
"3403","8112至上","110/08/04","群益金鼎-大安",40,0,40
"3404","8112至上","110/08/04","凱基-台北",140,206,-66
"3405","8112至上","110/08/04","日盛-新竹",60,26,34
"3406","8112至上","110/08/04","新加坡商瑞銀",16,68,-52
"3407","8112至上","110/08/04","美林",69,38,31
"3408","8112至上","110/08/04","第一金-自由",0,50,-50
"3409","8112至上","110/08/04","凱基-虎尾",30,0,30
"3410","8112至上","110/08/04","康和-內湖",0,34,-34
"3411","8112至上","110/08/04","永豐金-台南",32,2,30
"3412","8112至上","110/08/04","聯邦商銀",0,34,-34
"3413","8112至上","110/08/04","港商野村",30,1,29
"3414","8112至上","110/08/04","臺銀-鳳山",0,28,-28
"3415","8112至上","110/08/04","國泰-館前",29,5,24
"3416","8112至上","110/08/04","兆豐-公益",0,28,-28
"3417","8112至上","110/08/04","元富-佳里",21,0,21
"3418","8112至上","110/08/04","元大-崇德",0,21,-21
"3419","8112至上","110/08/04","日進",20,0,20
"3420","8112至上","110/08/04","元大-土城永寧",0,20,-20
"3421","1570力肯","110/08/04","摩根大通",330,27,303
"3422","1570力肯","110/08/04","元大-板橋",0,86,-86
"3423","1570力肯","110/08/04","統一",224,0,224
"3424","1570力肯","110/08/04","群益金鼎-忠孝",0,80,-80
"3425","1570力肯","110/08/04","富邦-台中",84,1,83
"3426","1570力肯","110/08/04","元富-緯城",0,51,-51
"3427","1570力肯","110/08/04","統一-土城",287,222,65
"3428","1570力肯","110/08/04","國票-和平",0,51,-51
"3429","1570力肯","110/08/04","群益金鼎-中壢",60,0,60
"3430","1570力肯","110/08/04","日盛-二林",0,43,-43
"3431","1570力肯","110/08/04","富邦-高雄",69,10,59
"3432","1570力肯","110/08/04","國泰-板橋",0,43,-43
"3433","1570力肯","110/08/04","統一-屏東",61,4,57
"3434","1570力肯","110/08/04","元大-新莊",1,44,-43
"3435","1570力肯","110/08/04","凱基-岡山",53,1,52
"3436","1570力肯","110/08/04","凱基-嘉義",0,42,-42
"3437","1570力肯","110/08/04","新光-台中",43,12,31
"3438","1570力肯","110/08/04","華南永昌-鳳山",2,42,-40
"3439","1570力肯","110/08/04","台中銀-員林",30,1,29
"3440","1570力肯","110/08/04","凱基-三峽",0,37,-37
"3441","1570力肯","110/08/04","元富-三重",37,12,25
"3442","1570力肯","110/08/04","國票-中正",0,36,-36
"3443","1570力肯","110/08/04","統一-新台中",30,6,24
"3444","1570力肯","110/08/04","高橋",0,30,-30
"3445","1570力肯","110/08/04","致和-府前",25,1,24
"3446","1570力肯","110/08/04","日盛-高雄",0,29,-29
"3447","1570力肯","110/08/04","凱基-中港",22,0,22
"3448","1570力肯","110/08/04","(牛牛牛)亞-鑫豐",6,29,-23
"3449","1570力肯","110/08/04","宏遠證券",20,0,20
"3450","1570力肯","110/08/04","元富-松德",1,22,-21
"3451","2929淘帝","110/08/04","兆豐-忠孝",23,0,23
"3452","2929淘帝","110/08/04","美林",12,107,-95
"3453","2929淘帝","110/08/04","華南永昌-長虹",21,0,21
"3454","2929淘帝","110/08/04","兆豐-新莊",0,94,-94
"3455","2929淘帝","110/08/04","兆豐-桃園",20,0,20
"3456","2929淘帝","110/08/04","富邦-北港",0,30,-30
"3457","2929淘帝","110/08/04","新加坡商瑞銀",34,18,16
"3458","2929淘帝","110/08/04","永興-水湳",0,20,-20
"3459","2929淘帝","110/08/04","凱基-林口",15,0,15
"3460","2929淘帝","110/08/04","兆豐-復興",0,20,-20
"3461","2929淘帝","110/08/04","富邦-竹東",17,5,12
"3462","2929淘帝","110/08/04","國泰-高雄",1,15,-14
"3463","2929淘帝","110/08/04","台新-建北",11,0,11
"3464","2929淘帝","110/08/04","元大-上新莊",0,14,-14
"3465","2929淘帝","110/08/04","凱基-豐中",11,0,11
"3466","2929淘帝","110/08/04","凱基-敦北",0,11,-11
"3467","2929淘帝","110/08/04","統一-汐止",10,0,10
"3468","2929淘帝","110/08/04","臺銀-金山",0,10,-10
"3469","2929淘帝","110/08/04","新百王",10,0,10
"3470","2929淘帝","110/08/04","日盛-斗六",0,10,-10
"3471","2929淘帝","110/08/04","凱基-台北",16,6,10
"3472","2929淘帝","110/08/04","港商野村",16,26,-10
"3473","2929淘帝","110/08/04","華南永昌-苗栗",10,0,10
"3474","2929淘帝","110/08/04","第一金-自由",0,10,-10
"3475","2929淘帝","110/08/04","富邦-板橋",10,0,10
"3476","2929淘帝","110/08/04","玉山-台南",0,10,-10
"3477","2929淘帝","110/08/04","元大-路竹",10,0,10
"3478","2929淘帝","110/08/04","凱基-五股",0,10,-10
"3479","2929淘帝","110/08/04","元大-東蘆",10,0,10
"3480","2929淘帝","110/08/04","華南永昌-楠梓",0,10,-10
"3481","5410國眾","110/08/04","永豐金-內湖",100,1,99
"3482","5410國眾","110/08/04","群益金鼎-內湖",0,46,-46
"3483","5410國眾","110/08/04","永豐金-板新",36,0,36
"3484","5410國眾","110/08/04","新光",2,36,-34
"3485","5410國眾","110/08/04","兆豐-城中",27,0,27
"3486","5410國眾","110/08/04","元富-嘉義",0,20,-20
"3487","5410國眾","110/08/04","凱基-竹北",10,0,10
"3488","5410國眾","110/08/04","元大-博愛",0,20,-20
"3489","5410國眾","110/08/04","新光-高雄",9,0,9
"3490","5410國眾","110/08/04","永豐金-彰化",0,20,-20
"3491","5410國眾","110/08/04","兆豐-北高雄",8,0,8
"3492","5410國眾","110/08/04","元大-斗信",0,11,-11
"3493","5410國眾","110/08/04","元富-三重",9,3,6
"3494","5410國眾","110/08/04","統一-平鎮",0,10,-10
"3495","5410國眾","110/08/04","台新證券",7,1,6
"3496","5410國眾","110/08/04","元大-台北",0,10,-10
"3497","5410國眾","110/08/04","元大-中壢",10,4,6
"3498","5410國眾","110/08/04","元大-大灣",0,10,-10
"3499","5410國眾","110/08/04","北城證券",5,0,5
"3500","5410國眾","110/08/04","元大-前金",0,9,-9
"3501","5410國眾","110/08/04","國票-和平",5,0,5
"3502","5410國眾","110/08/04","致和證券",0,8,-8
"3503","5410國眾","110/08/04","元大-新盛",5,0,5
"3504","5410國眾","110/08/04","元大-崇德",0,7,-7
"3505","5410國眾","110/08/04","永豐金-中盛",5,0,5
"3506","5410國眾","110/08/04","臺銀-鳳山",0,6,-6
"3507","5410國眾","110/08/04","永豐金-桃園",5,0,5
"3508","5410國眾","110/08/04","玉山-左營",0,6,-6
"3509","5410國眾","110/08/04","凱基-台北",7,3,4
"3510","5410國眾","110/08/04","富邦-台中",0,6,-6
"3511","2841台開","110/08/04","永豐金-敦南",1166,0,1166
"3512","2841台開","110/08/04","統一-三重",0,943,-943
"3513","2841台開","110/08/04","永豐金-鳳山",206,50,156
"3514","2841台開","110/08/04","群益金鼎-東大",0,250,-250
"3515","2841台開","110/08/04","凱基-文心",136,0,136
"3516","2841台開","110/08/04","元富-城東",5,250,-245
"3517","2841台開","110/08/04","國泰-敦南",135,7,128
"3518","2841台開","110/08/04","元大-大灣",16,200,-184
"3519","2841台開","110/08/04","新光",109,4,105
"3520","2841台開","110/08/04","元大-新店中正",0,128,-128
"3521","2841台開","110/08/04","日盛-信義",102,0,102
"3522","2841台開","110/08/04","兆豐-麻豆",0,120,-120
"3523","2841台開","110/08/04","兆豐-東門",100,0,100
"3524","2841台開","110/08/04","土銀",0,100,-100
"3525","2841台開","110/08/04","台新-三民",100,0,100
"3526","2841台開","110/08/04","臺銀",0,100,-100
"3527","2841台開","110/08/04","群益金鼎-海山",100,0,100
"3528","2841台開","110/08/04","富邦-新店",4,90,-86
"3529","2841台開","110/08/04","國泰-板橋",106,13,93
"3530","2841台開","110/08/04","合庫-台中",23,104,-81
"3531","2841台開","110/08/04","永豐金-彰化",100,10,90
"3532","2841台開","110/08/04","統一-高雄",0,77,-77
"3533","2841台開","110/08/04","永豐金-萬盛",101,16,85
"3534","2841台開","110/08/04","群益金鼎-屏東",0,75,-75
"3535","2841台開","110/08/04","國票-天祥",80,0,80
"3536","2841台開","110/08/04","中國信託-高雄",2,70,-68
"3537","2841台開","110/08/04","群益金鼎-崇德",84,5,79
"3538","2841台開","110/08/04","凱基-三峽",0,61,-61
"3539","2841台開","110/08/04","群益金鼎-館前",82,3,79
"3540","2841台開","110/08/04","統一-彰化",0,60,-60
"3541","6207雷科","110/08/04","凱基-羅東",80,1,79
"3542","6207雷科","110/08/04","凱基-板橋",1,213,-212
"3543","6207雷科","110/08/04","元大-鳳山",76,2,74
"3544","6207雷科","110/08/04","摩根大通",105,209,-104
"3545","6207雷科","110/08/04","凱基-台南",37,1,36
"3546","6207雷科","110/08/04","凱基-台北",22,122,-100
"3547","6207雷科","110/08/04","富邦-竹東",35,0,35
"3548","6207雷科","110/08/04","華南永昌",12,100,-88
"3549","6207雷科","110/08/04","群益金鼎-東門",31,4,27
"3550","6207雷科","110/08/04","統一-高雄",3,74,-71
"3551","6207雷科","110/08/04","新光-高雄",30,4,26
"3552","6207雷科","110/08/04","群益金鼎-大興",0,70,-70
"3553","6207雷科","110/08/04","大慶-蘆洲",21,0,21
"3554","6207雷科","110/08/04","日盛-忠孝",0,62,-62
"3555","6207雷科","110/08/04","瑞士信貸",20,0,20
"3556","6207雷科","110/08/04","富邦-台中",0,50,-50
"3557","6207雷科","110/08/04","元大-羅東",20,0,20
"3558","6207雷科","110/08/04","永豐金-內湖",0,50,-50
"3559","6207雷科","110/08/04","群益金鼎-南京",20,2,18
"3560","6207雷科","110/08/04","美林",3,47,-44
"3561","6207雷科","110/08/04","元大-汐止",16,0,16
"3562","6207雷科","110/08/04","元富-大昌",0,40,-40
"3563","6207雷科","110/08/04","兆豐-來福",15,0,15
"3564","6207雷科","110/08/04","兆豐-景美",2,40,-38
"3565","6207雷科","110/08/04","國泰-敦南",21,6,15
"3566","6207雷科","110/08/04","新加坡商瑞銀",12,49,-37
"3567","6207雷科","110/08/04","永豐金-台中",15,0,15
"3568","6207雷科","110/08/04","群益金鼎-古亭",2,24,-22
"3569","6207雷科","110/08/04","元大-沙鹿",14,0,14
"3570","6207雷科","110/08/04","華南永昌-虎尾",0,21,-21
"3571","3679新至陞","110/08/04","凱基-台北",27,0,27
"3572","3679新至陞","110/08/04","香港上海匯豐",0,12,-12
"3573","3679新至陞","110/08/04","港商法國興業",20,0,20
"3574","3679新至陞","110/08/04","台灣摩根士丹利",0,10,-10
"3575","3679新至陞","110/08/04","新加坡商瑞銀",13,0,13
"3576","3679新至陞","110/08/04","港商野村",0,8,-8
"3577","3679新至陞","110/08/04","(牛牛牛)亞-網路",11,0,11
"3578","3679新至陞","110/08/04","玉山證券",2,9,-7
"3579","3679新至陞","110/08/04","摩根大通",9,4,5
"3580","3679新至陞","110/08/04","富邦-陽明",0,6,-6
"3581","3679新至陞","110/08/04","國泰-敦南",6,2,4
"3582","3679新至陞","110/08/04","統一",0,5,-5
"3583","3679新至陞","110/08/04","土銀-和平",3,0,3
"3584","3679新至陞","110/08/04","華南永昌-淡水",0,5,-5
"3585","3679新至陞","110/08/04","台中銀-員林",3,0,3
"3586","3679新至陞","110/08/04","元大-成功",0,5,-5
"3587","3679新至陞","110/08/04","元大-永春",3,0,3
"3588","3679新至陞","110/08/04","群益金鼎-內湖",0,4,-4
"3589","3679新至陞","110/08/04","國票-台東",2,0,2
"3590","3679新至陞","110/08/04","國泰-館前",0,3,-3
"3591","3679新至陞","110/08/04","富邦-新店",2,0,2
"3592","3679新至陞","110/08/04","凱基-板橋",0,3,-3
"3593","3679新至陞","110/08/04","富邦-三重",2,0,2
"3594","3679新至陞","110/08/04","凱基-三峽",0,3,-3
"3595","3679新至陞","110/08/04","元大-板橋三民",2,0,2
"3596","3679新至陞","110/08/04","凱基-中山",0,3,-3
"3597","3679新至陞","110/08/04","永豐金-敦南",2,0,2
"3598","3679新至陞","110/08/04","元大-承德",1,4,-3
"3599","3679新至陞","110/08/04","大昌-新店",1,0,1
"3600","3679新至陞","110/08/04","元大-大同",0,3,-3
"3601","2727王品","110/08/04","元富",46,0,46
"3602","2727王品","110/08/04","台灣摩根士丹利",20,277,-257
"3603","2727王品","110/08/04","台新證券",36,7,29
"3604","2727王品","110/08/04","群益金鼎-三民",2,104,-102
"3605","2727王品","110/08/04","國泰-敦南",42,13,29
"3606","2727王品","110/08/04","第一金",1,102,-101
"3607","2727王品","110/08/04","國泰-台中",19,2,17
"3608","2727王品","110/08/04","元大-東蘆",1,45,-44
"3609","2727王品","110/08/04","華南永昌-虎尾",13,0,13
"3610","2727王品","110/08/04","新光-台中",10,43,-33
"3611","2727王品","110/08/04","凱基-五股",11,0,11
"3612","2727王品","110/08/04","新光-桃園",9,42,-33
"3613","2727王品","110/08/04","國泰-館前",16,6,10
"3614","2727王品","110/08/04","凱基-興隆",1,21,-20
"3615","2727王品","110/08/04","凱基-基隆",10,0,10
"3616","2727王品","110/08/04","元大-龍潭",6,23,-17
"3617","2727王品","110/08/04","凱基-南崁",10,0,10
"3618","2727王品","110/08/04","日盛-士林",0,15,-15
"3619","2727王品","110/08/04","富邦-台北",12,2,10
"3620","2727王品","110/08/04","凱基-天母",0,15,-15
"3621","2727王品","110/08/04","新光",34,25,9
"3622","2727王品","110/08/04","日盛-台中",4,15,-11
"3623","2727王品","110/08/04","玉山證券",12,3,9
"3624","2727王品","110/08/04","永豐金-信義",1,12,-11
"3625","2727王品","110/08/04","國泰-高雄",10,2,8
"3626","2727王品","110/08/04","新加坡商瑞銀",2,12,-10
"3627","2727王品","110/08/04","群益金鼎-宜蘭",8,0,8
"3628","2727王品","110/08/04","元大-豐原",0,10,-10
"3629","2727王品","110/08/04","國泰-台南",7,0,7
"3630","2727王品","110/08/04","元大-樹林",1,11,-10
"3631","1570力肯","110/08/04","摩根大通",330,27,303
"3632","1570力肯","110/08/04","元大-板橋",0,86,-86
"3633","1570力肯","110/08/04","統一",224,0,224
"3634","1570力肯","110/08/04","群益金鼎-忠孝",0,80,-80
"3635","1570力肯","110/08/04","富邦-台中",84,1,83
"3636","1570力肯","110/08/04","元富-緯城",0,51,-51
"3637","1570力肯","110/08/04","統一-土城",287,222,65
"3638","1570力肯","110/08/04","國票-和平",0,51,-51
"3639","1570力肯","110/08/04","群益金鼎-中壢",60,0,60
"3640","1570力肯","110/08/04","日盛-二林",0,43,-43
"3641","1570力肯","110/08/04","富邦-高雄",69,10,59
"3642","1570力肯","110/08/04","國泰-板橋",0,43,-43
"3643","1570力肯","110/08/04","統一-屏東",61,4,57
"3644","1570力肯","110/08/04","元大-新莊",1,44,-43
"3645","1570力肯","110/08/04","凱基-岡山",53,1,52
"3646","1570力肯","110/08/04","凱基-嘉義",0,42,-42
"3647","1570力肯","110/08/04","新光-台中",43,12,31
"3648","1570力肯","110/08/04","華南永昌-鳳山",2,42,-40
"3649","1570力肯","110/08/04","台中銀-員林",30,1,29
"3650","1570力肯","110/08/04","凱基-三峽",0,37,-37
"3651","1570力肯","110/08/04","元富-三重",37,12,25
"3652","1570力肯","110/08/04","國票-中正",0,36,-36
"3653","1570力肯","110/08/04","統一-新台中",30,6,24
"3654","1570力肯","110/08/04","高橋",0,30,-30
"3655","1570力肯","110/08/04","致和-府前",25,1,24
"3656","1570力肯","110/08/04","日盛-高雄",0,29,-29
"3657","1570力肯","110/08/04","凱基-中港",22,0,22
"3658","1570力肯","110/08/04","(牛牛牛)亞-鑫豐",6,29,-23
"3659","1570力肯","110/08/04","宏遠證券",20,0,20
"3660","1570力肯","110/08/04","元富-松德",1,22,-21
"3661","6180橘子","110/08/04","新光",67,10,57
"3662","6180橘子","110/08/04","群益金鼎-桃園",0,30,-30
"3663","6180橘子","110/08/04","美林",15,0,15
"3664","6180橘子","110/08/04","華南永昌-苑裡",0,30,-30
"3665","6180橘子","110/08/04","第一金-中山",15,1,14
"3666","6180橘子","110/08/04","台灣摩根士丹利",0,19,-19
"3667","6180橘子","110/08/04","日盛-台中",10,0,10
"3668","6180橘子","110/08/04","台新-三民",0,16,-16
"3669","6180橘子","110/08/04","新光-桃園",10,0,10
"3670","6180橘子","110/08/04","群益金鼎-士林",0,13,-13
"3671","6180橘子","110/08/04","康和",9,0,9
"3672","6180橘子","110/08/04","群益金鼎-中港",0,11,-11
"3673","6180橘子","110/08/04","富邦-羅東",8,0,8
"3674","6180橘子","110/08/04","新加坡商瑞銀",0,10,-10
"3675","6180橘子","110/08/04","國票-九鼎",7,0,7
"3676","6180橘子","110/08/04","統一-彰化",0,10,-10
"3677","6180橘子","110/08/04","玉山-桃園",7,0,7
"3678","6180橘子","110/08/04","兆豐-埔墘",0,10,-10
"3679","6180橘子","110/08/04","元大-員林中山",7,0,7
"3680","6180橘子","110/08/04","摩根大通",3,13,-10
"3681","6180橘子","110/08/04","瑞士信貸",6,0,6
"3682","6180橘子","110/08/04","康和-延平",0,10,-10
"3683","6180橘子","110/08/04","富邦-新竹",7,1,6
"3684","6180橘子","110/08/04","大昌-安康",0,9,-9
"3685","6180橘子","110/08/04","富邦-宜蘭",6,0,6
"3686","6180橘子","110/08/04","富邦-仁愛",1,10,-9
"3687","6180橘子","110/08/04","統一-嘉義",5,0,5
"3688","6180橘子","110/08/04","花旗環球",0,8,-8
"3689","6180橘子","110/08/04","富邦-陽明",5,0,5
"3690","6180橘子","110/08/04","福勝",0,8,-8
"3691","2390云辰","110/08/04","元富-吉利",71,6,65
"3692","2390云辰","110/08/04","港商野村",180,422,-242
"3693","2390云辰","110/08/04","兆豐-新營",53,4,49
"3694","2390云辰","110/08/04","凱基-台北",75,264,-189
"3695","2390云辰","110/08/04","台新證券",83,37,46
"3696","2390云辰","110/08/04","美林",32,132,-100
"3697","2390云辰","110/08/04","日盛-新莊",53,12,41
"3698","2390云辰","110/08/04","華南永昌-鳳山",82,181,-99
"3699","2390云辰","110/08/04","兆豐-岡山",40,0,40
"3700","2390云辰","110/08/04","日盛-園區",1,91,-90
"3701","2390云辰","110/08/04","元大-新莊",42,6,36
"3702","2390云辰","110/08/04","統一-城中",3,82,-79
"3703","2390云辰","110/08/04","永豐金-鳳山",37,3,34
"3704","2390云辰","110/08/04","第一金-中壢",0,73,-73
"3705","2390云辰","110/08/04","德信-新營",37,4,33
"3706","2390云辰","110/08/04","元大-忠孝",8,74,-66
"3707","2390云辰","110/08/04","群益金鼎-三民",35,2,33
"3708","2390云辰","110/08/04","凱基-竹科",6,67,-61
"3709","2390云辰","110/08/04","玉山-雙和",39,7,32
"3710","2390云辰","110/08/04","統一-屏東",0,51,-51
"3711","2390云辰","110/08/04","凱基-三重",33,3,30
"3712","2390云辰","110/08/04","富邦-新店",2,50,-48
"3713","2390云辰","110/08/04","華南永昌-朴子",35,6,29
"3714","2390云辰","110/08/04","元富-大裕",21,56,-35
"3715","2390云辰","110/08/04","國票-和平",29,1,28
"3716","2390云辰","110/08/04","永豐金-三重",6,41,-35
"3717","2390云辰","110/08/04","元大-東蘆",31,3,28
"3718","2390云辰","110/08/04","臺銀",15,47,-32
"3719","2390云辰","110/08/04","日茂",59,33,26
"3720","2390云辰","110/08/04","凱基-台中",1,33,-32
"3721","1471首利","110/08/02","日盛-和美",31,0,31
"3722","1471首利","110/08/02","日盛-八德",0,63,-63
"3723","1471首利","110/08/02","宏遠-光隆",30,0,30
"3724","1471首利","110/08/02","凱基-幸福",0,49,-49
"3725","1471首利","110/08/02","元富-花蓮",25,0,25
"3726","1471首利","110/08/02","富邦-台北",0,30,-30
"3727","1471首利","110/08/02","凱基-台北",25,0,25
"3728","1471首利","110/08/02","元大-東蘆",0,30,-30
"3729","1471首利","110/08/02","日盛-木柵",20,0,20
"3730","1471首利","110/08/02","合庫-桃園",0,20,-20
"3731","1471首利","110/08/02","凱基-高美館",20,0,20
"3732","1471首利","110/08/02","康和-澎湖",0,15,-15
"3733","1471首利","110/08/02","新光-台中",24,5,19
"3734","1471首利","110/08/02","元大-斗信",0,15,-15
"3735","1471首利","110/08/02","富邦-羅東",15,0,15
"3736","1471首利","110/08/02","元富-民權",0,12,-12
"3737","1471首利","110/08/02","兆豐-鹿港",14,0,14
"3738","1471首利","110/08/02","玉山-新莊",0,12,-12
"3739","1471首利","110/08/02","美林",16,4,12
"3740","1471首利","110/08/02","宏遠-桃園",0,10,-10
"3741","1471首利","110/08/02","統一-桃園",12,0,12
"3742","1471首利","110/08/02","瑞士信貸",0,10,-10
"3743","1471首利","110/08/02","合庫-高雄",10,0,10
"3744","1471首利","110/08/02","大慶-苗栗",0,10,-10
"3745","1471首利","110/08/02","日盛-士林",10,0,10
"3746","1471首利","110/08/02","統一-新營",0,10,-10
"3747","1471首利","110/08/02","港商法國興業",10,0,10
"3748","1471首利","110/08/02","群益金鼎-三重",0,10,-10
"3749","1471首利","110/08/02","第一金-台南",10,0,10
"3750","1471首利","110/08/02","元大-基隆",0,10,-10
"3751","2883開發金","110/08/02","統一",3076,29,3047
"3752","2883開發金","110/08/02","中農",2,3126,-3124
"3753","2883開發金","110/08/02","凱基-台北",2789,192,2597
"3754","2883開發金","110/08/02","群益金鼎",11,2008,-1997
"3755","2883開發金","110/08/02","元富-城東",2139,5,2134
"3756","2883開發金","110/08/02","摩根大通",2081,3944,-1863
"3757","2883開發金","110/08/02","瑞士信貸",2184,316,1868
"3758","2883開發金","110/08/02","港商野村",949,2553,-1604
"3759","2883開發金","110/08/02","美林",1160,271,889
"3760","2883開發金","110/08/02","台灣匯立證券",198,1533,-1335
"3761","2883開發金","110/08/02","港商麥格理",855,0,855
"3762","2883開發金","110/08/02","中國信託",69,1041,-972
"3763","2883開發金","110/08/02","元大-金華",533,33,500
"3764","2883開發金","110/08/02","兆豐證券",1,863,-862
"3765","2883開發金","110/08/02","新加坡商瑞銀",1089,624,465
"3766","2883開發金","110/08/02","美商高盛",6,644,-638
"3767","2883開發金","110/08/02","法銀巴黎",441,0,441
"3768","2883開發金","110/08/02","華南永昌-中正",4,632,-628
"3769","2883開發金","110/08/02","富邦-嘉義",425,24,401
"3770","2883開發金","110/08/02","第一金-安和",156,757,-601
"3771","2883開發金","110/08/02","元富-烏日",367,3,364
"3772","2883開發金","110/08/02","國票",0,524,-524
"3773","2883開發金","110/08/02","台灣摩根士丹利",634,280,354
"3774","2883開發金","110/08/02","元富",266,770,-504
"3775","2883開發金","110/08/02","國泰-館前",516,180,336
"3776","2883開發金","110/08/02","新光",1651,1984,-333
"3777","2883開發金","110/08/02","聯邦-敦化",321,5,316
"3778","2883開發金","110/08/02","元富-安南",20,324,-304
"3779","2883開發金","110/08/02","玉山-士林",307,13,294
"3780","2883開發金","110/08/02","群益金鼎-東門",6,280,-274
"3781","6205詮欣","110/08/02","元大-館前",16,0,16
"3782","6205詮欣","110/08/02","永豐金-敦南",0,21,-21
"3783","6205詮欣","110/08/02","臺銀",11,0,11
"3784","6205詮欣","110/08/02","日盛-三重",0,17,-17
"3785","6205詮欣","110/08/02","臺銀-民權",10,0,10
"3786","6205詮欣","110/08/02","永豐金-博愛",0,10,-10
"3787","6205詮欣","110/08/02","摩根大通",11,1,10
"3788","6205詮欣","110/08/02","國票-台南",0,5,-5
"3789","6205詮欣","110/08/02","合庫-三重",5,0,5
"3790","6205詮欣","110/08/02","群益金鼎-三重",0,4,-4
"3791","6205詮欣","110/08/02","元大-東蘆",5,0,5
"3792","6205詮欣","110/08/02","元大-土城",0,4,-4
"3793","6205詮欣","110/08/02","凱基",3,0,3
"3794","6205詮欣","110/08/02","元大-草屯",0,4,-4
"3795","6205詮欣","110/08/02","日盛-雙和",2,0,2
"3796","6205詮欣","110/08/02","臺銀-新竹",1,4,-3
"3797","6205詮欣","110/08/02","兆豐-南京",2,0,2
"3798","6205詮欣","110/08/02","光和-嘉義",0,3,-3
"3799","6205詮欣","110/08/02","凱基-台北",3,1,2
"3800","6205詮欣","110/08/02","永豐金-內湖",0,3,-3
"3801","6205詮欣","110/08/02","元大-西螺",2,0,2
"3802","6205詮欣","110/08/02","第一金-華江",0,2,-2
"3803","6205詮欣","110/08/02","元大-新竹經國",2,0,2
"3804","6205詮欣","110/08/02","中國信託-高雄",0,2,-2
"3805","6205詮欣","110/08/02","元大-北成功",2,0,2
"3806","6205詮欣","110/08/02","兆豐-鹿港",0,2,-2
"3807","6205詮欣","110/08/02","臺銀-臺中",1,0,1
"3808","6205詮欣","110/08/02","統一-平鎮",0,1,-1
"3809","6205詮欣","110/08/02","德信-新營",1,0,1
"3810","6205詮欣","110/08/02","台新-台中",0,1,-1
"3811","1540喬福","110/08/02","富邦-南屯",10,0,10
"3812","1540喬福","110/08/02","永豐金-埔里",0,22,-22
"3813","1540喬福","110/08/02","元富-中原",10,2,8
"3814","1540喬福","110/08/02","統一-新台中",0,17,-17
"3815","1540喬福","110/08/02","德信-新營",6,0,6
"3816","1540喬福","110/08/02","統一-三多",0,3,-3
"3817","1540喬福","110/08/02","元大-龍潭",3,0,3
"3818","1540喬福","110/08/02","光和-高雄",0,2,-2
"3819","1540喬福","110/08/02","凱基-台北",3,0,3
"3820","1540喬福","110/08/02","兆豐-嘉義",0,2,-2
"3821","1540喬福","110/08/02","新光-桃園",3,0,3
"3822","1540喬福","110/08/02","台新-高雄",0,1,-1
"3823","1540喬福","110/08/02","永豐金-內湖",2,0,2
"3824","1540喬福","110/08/02","新光",0,1,-1
"3825","1540喬福","110/08/02","港商法國興業",2,0,2
"3826","1540喬福","110/08/02","國泰-館前",0,1,-1
"3827","1540喬福","110/08/02","統一-台南",2,0,2
"3828","1540喬福","110/08/02","群益金鼎-民權",0,1,-1
"3829","1540喬福","110/08/02","元富-桃園",2,0,2
"3830","1540喬福","110/08/02","富邦-嘉義",0,1,-1
"3831","1540喬福","110/08/02","台中銀-豐原",2,0,2
"3832","1540喬福","110/08/02","元大-新竹",0,1,-1
"3833","1540喬福","110/08/02","(牛牛牛)亞-網路",1,0,1
"3834","1540喬福","110/08/02","元大-豐原站前",0,1,-1
"3835","1540喬福","110/08/02","元富",1,0,1
"3836","1540喬福","110/08/02","臺銀-鳳山",0,0,0
"3837","1540喬福","110/08/02","第一金-桃園",1,0,1
"3838","1540喬福","110/08/02","第一金",0,0,0
"3839","1540喬福","110/08/02","瑞士信貸",1,0,1
"3840","1540喬福","110/08/02","華南永昌-南京",0,0,0
"3841","2888新光金","110/08/02","花旗環球",2291,0,2291
"3842","2888新光金","110/08/02","瑞士信貸",1405,3997,-2592
"3843","2888新光金","110/08/02","美林",2235,208,2027
"3844","2888新光金","110/08/02","新加坡商瑞銀",780,2173,-1393
"3845","2888新光金","110/08/02","群益金鼎-彰化",1014,2,1012
"3846","2888新光金","110/08/02","美商高盛",369,1356,-987
"3847","2888新光金","110/08/02","富邦-建國",823,9,814
"3848","2888新光金","110/08/02","元大-仁愛",69,795,-726
"3849","2888新光金","110/08/02","元大-華山",532,1,531
"3850","2888新光金","110/08/02","永興-台中",0,500,-500
"3851","2888新光金","110/08/02","法銀巴黎",666,166,500
"3852","2888新光金","110/08/02","凱基-站前",17,506,-489
"3853","2888新光金","110/08/02","台灣匯立證券",421,0,421
"3854","2888新光金","110/08/02","元富-城東",38,496,-458
"3855","2888新光金","110/08/02","凱基-台南",376,17,359
"3856","2888新光金","110/08/02","群益金鼎-中港",2,450,-448
"3857","2888新光金","110/08/02","永豐金-嘉義",352,0,352
"3858","2888新光金","110/08/02","華南永昌",25,461,-436
"3859","2888新光金","110/08/02","合庫-台中",339,1,338
"3860","2888新光金","110/08/02","港商野村",135,550,-415
"3861","2888新光金","110/08/02","港商麥格理",316,0,316
"3862","2888新光金","110/08/02","大慶-苗栗",1,406,-405
"3863","2888新光金","110/08/02","群益金鼎-建成",298,5,293
"3864","2888新光金","110/08/02","華南永昌-中正",34,419,-385
"3865","2888新光金","110/08/02","永豐金-板盛",221,0,221
"3866","2888新光金","110/08/02","玉山-台大",0,350,-350
"3867","2888新光金","110/08/02","台灣摩根士丹利",1700,1488,212
"3868","2888新光金","110/08/02","元大-汐止",66,363,-297
"3869","2888新光金","110/08/02","凱基-竹北",200,0,200
"3870","2888新光金","110/08/02","台新-新莊",14,265,-251
"3871","1340勝悅","110/08/02","國泰-台中",22,0,22
"3872","1340勝悅","110/08/02","中國信託",0,83,-83
"3873","1340勝悅","110/08/02","港商法國興業",14,0,14
"3874","1340勝悅","110/08/02","元大-開元",0,11,-11
"3875","1340勝悅","110/08/02","新光",18,5,13
"3876","1340勝悅","110/08/02","凱基-永康",0,10,-10
"3877","1340勝悅","110/08/02","元大-基隆孝二",11,0,11
"3878","1340勝悅","110/08/02","富邦-宜蘭",0,10,-10
"3879","1340勝悅","110/08/02","玉山-士林",10,0,10
"3880","1340勝悅","110/08/02","元大-大統",0,10,-10
"3881","1340勝悅","110/08/02","凱基",6,0,6
"3882","1340勝悅","110/08/02","富邦-板橋",0,5,-5
"3883","1340勝悅","110/08/02","摩根大通",4,0,4
"3884","1340勝悅","110/08/02","瑞士信貸",1,5,-4
"3885","1340勝悅","110/08/02","國泰-敦南",8,4,4
"3886","1340勝悅","110/08/02","華南永昌-忠孝",0,2,-2
"3887","1340勝悅","110/08/02","國泰-新莊",3,0,3
"3888","1340勝悅","110/08/02","元大-虎尾",0,2,-2
"3889","1340勝悅","110/08/02","凱基-嘉義",3,0,3
"3890","1340勝悅","110/08/02","元大-路竹",0,2,-2
"3891","1340勝悅","110/08/02","群益金鼎-館前",3,0,3
"3892","1340勝悅","110/08/02","元大-信義",0,2,-2
"3893","1340勝悅","110/08/02","國泰-館前",3,0,3
"3894","1340勝悅","110/08/02","華南永昌-高雄",0,1,-1
"3895","1340勝悅","110/08/02","臺銀-鳳山",3,0,3
"3896","1340勝悅","110/08/02","玉山-大里",0,0,0
"3897","1340勝悅","110/08/02","國泰-高雄",4,1,3
"3898","1340勝悅","110/08/02","群益金鼎-丹鳳",0,0,0
"3899","1340勝悅","110/08/02","美商高盛",3,0,3
"3900","1340勝悅","110/08/02","富邦-虎尾",0,0,0
"3901","6246臺龍","110/08/02","台新證券",19,1,18
"3902","6246臺龍","110/08/02","元大-新竹經國",0,6,-6
"3903","6246臺龍","110/08/02","凱基-台北",7,2,5
"3904","6246臺龍","110/08/02","台新-台南",0,5,-5
"3905","6246臺龍","110/08/02","國票-九鼎",3,0,3
"3906","6246臺龍","110/08/02","宏遠-新化",1,4,-3
"3907","6246臺龍","110/08/02","國票-南京",3,0,3
"3908","6246臺龍","110/08/02","元富-板橋",0,3,-3
"3909","6246臺龍","110/08/02","新光-台中",3,0,3
"3910","6246臺龍","110/08/02","國泰-敦南",0,3,-3
"3911","6246臺龍","110/08/02","元大-員林",3,0,3
"3912","6246臺龍","110/08/02","富邦-台中",0,3,-3
"3913","6246臺龍","110/08/02","元大-永和",3,0,3
"3914","6246臺龍","110/08/02","元大-大益",2,5,-3
"3915","6246臺龍","110/08/02","港商野村",2,0,2
"3916","6246臺龍","110/08/02","日盛-永康",0,2,-2
"3917","6246臺龍","110/08/02","台新-高雄",2,0,2
"3918","6246臺龍","110/08/02","日盛-宜蘭",0,2,-2
"3919","6246臺龍","110/08/02","新光-台南",2,0,2
"3920","6246臺龍","110/08/02","宏遠-台南",0,2,-2
"3921","6246臺龍","110/08/02","日盛-文化",1,0,1
"3922","6246臺龍","110/08/02","高橋-龍潭",0,2,-2
"3923","6246臺龍","110/08/02","國泰-忠孝",1,0,1
"3924","6246臺龍","110/08/02","群益金鼎-中壢",0,2,-2
"3925","6246臺龍","110/08/02","群益金鼎-崇德",3,2,1
"3926","6246臺龍","110/08/02","凱基-三多",0,2,-2
"3927","6246臺龍","110/08/02","富邦-員林",1,0,1
"3928","6246臺龍","110/08/02","統一-中壢",0,1,-1
"3929","6246臺龍","110/08/02","富邦-三重",1,0,1
"3930","6246臺龍","110/08/02","中國信託-嘉義",0,1,-1
"3931","00715L期街口布蘭特正2","110/08/02","元大證券",7296,1000,6296
"3932","00715L期街口布蘭特正2","110/08/02","富邦-基隆",0,850,-850
"3933","00715L期街口布蘭特正2","110/08/02","永豐金證券",2221,338,1883
"3934","00715L期街口布蘭特正2","110/08/02","(牛牛牛)亞-鑫豐",10,850,-840
"3935","00715L期街口布蘭特正2","110/08/02","統一",1460,100,1360
"3936","00715L期街口布蘭特正2","110/08/02","華南永昌-長虹",57,820,-763
"3937","00715L期街口布蘭特正2","110/08/02","國票-中港",1000,0,1000
"3938","00715L期街口布蘭特正2","110/08/02","富邦-彰化",0,700,-700
"3939","00715L期街口布蘭特正2","110/08/02","第一金-台中",900,13,887
"3940","00715L期街口布蘭特正2","110/08/02","第一金-路竹",0,682,-682
"3941","00715L期街口布蘭特正2","110/08/02","群益金鼎",728,0,728
"3942","00715L期街口布蘭特正2","110/08/02","台新證券",112,791,-679
"3943","00715L期街口布蘭特正2","110/08/02","群益金鼎-古亭",433,1,432
"3944","00715L期街口布蘭特正2","110/08/02","第一金-忠孝",45,483,-438
"3945","00715L期街口布蘭特正2","110/08/02","凱基-市政",525,125,400
"3946","00715L期街口布蘭特正2","110/08/02","玉山-台南",0,373,-373
"3947","00715L期街口布蘭特正2","110/08/02","元大-敦化",400,0,400
"3948","00715L期街口布蘭特正2","110/08/02","國泰-板橋",3,313,-310
"3949","00715L期街口布蘭特正2","110/08/02","元大-草屯",353,21,332
"3950","00715L期街口布蘭特正2","110/08/02","凱基",0,300,-300
"3951","00715L期街口布蘭特正2","110/08/02","元大-萬華",250,0,250
"3952","00715L期街口布蘭特正2","110/08/02","元大-嘉義",1,300,-299
"3953","00715L期街口布蘭特正2","110/08/02","統一-員林",180,0,180
"3954","00715L期街口布蘭特正2","110/08/02","元大-大灣",14,303,-289
"3955","00715L期街口布蘭特正2","110/08/02","富邦證券",282,152,130
"3956","00715L期街口布蘭特正2","110/08/02","新光-桃園",45,295,-250
"3957","00715L期街口布蘭特正2","110/08/02","元富-潮州",125,0,125
"3958","00715L期街口布蘭特正2","110/08/02","元大-新莊",76,306,-230
"3959","00715L期街口布蘭特正2","110/08/02","兆豐-台中港",106,0,106
"3960","00715L期街口布蘭特正2","110/08/02","富邦-台北",0,211,-211
"3961","8941關中","110/08/02","宏遠-館前",3,0,3
"3962","8941關中","110/08/02","富邦-台中",0,5,-5
"3963","8941關中","110/08/02","群益金鼎-彰化",2,0,2
"3964","8941關中","110/08/02","富邦-員林",0,4,-4
"3965","8941關中","110/08/02","第一金-台中",1,0,1
"3966","8941關中","110/08/02","元大-新竹經國",0,0,0
"3967","8941關中","110/08/02","台新-台中",1,0,1
"3968","8941關中","110/08/02","永豐金-萬盛",0,0,0
"3969","8941關中","110/08/02","華南永昌-南京",1,0,1
"3970","8941關中","110/08/02","",NA,NA,NA
"3971","8941關中","110/08/02","元大-桃興",2,1,1
"3972","8941關中","110/08/02","",NA,NA,NA
"3973","8941關中","110/08/02","元大-新竹經國",0,0,0
"3974","8941關中","110/08/02","",NA,NA,NA
"3975","8941關中","110/08/02","永豐金-萬盛",0,0,0
"3976","8941關中","110/08/02","",NA,NA,NA
"3977","8941關中","110/08/02","",NA,NA,NA
"3978","8941關中","110/08/02","",NA,NA,NA
"3979","8941關中","110/08/02","",NA,NA,NA
"3980","8941關中","110/08/02","",NA,NA,NA
"3981","8941關中","110/08/02","",NA,NA,NA
"3982","8941關中","110/08/02","",NA,NA,NA
"3983","8941關中","110/08/02","",NA,NA,NA
"3984","8941關中","110/08/02","",NA,NA,NA
"3985","8941關中","110/08/02","",NA,NA,NA
"3986","8941關中","110/08/02","",NA,NA,NA
"3987","8941關中","110/08/02","",NA,NA,NA
"3988","8941關中","110/08/02","",NA,NA,NA
"3989","8941關中","110/08/02","",NA,NA,NA
"3990","8941關中","110/08/02","",NA,NA,NA
"3991","8936國統","110/08/02","合庫-高雄",68,0,68
"3992","8936國統","110/08/02","凱基-台北",0,125,-125
"3993","8936國統","110/08/02","元大-蘆洲",33,0,33
"3994","8936國統","110/08/02","摩根大通",9,125,-116
"3995","8936國統","110/08/02","富邦-高雄",30,4,26
"3996","8936國統","110/08/02","永全-南崁",0,50,-50
"3997","8936國統","110/08/02","大慶-蘆洲",20,0,20
"3998","8936國統","110/08/02","新光-台中",16,55,-39
"3999","8936國統","110/08/02","兆豐-桃鶯",20,0,20
"4000","8936國統","110/08/02","凱基-市政",0,31,-31
"4001","8936國統","110/08/02","元大-東泰",20,0,20
"4002","8936國統","110/08/02","美商高盛",1,20,-19
"4003","8936國統","110/08/02","永豐金-忠孝",20,0,20
"4004","8936國統","110/08/02","元大-東港",3,20,-17
"4005","8936國統","110/08/02","元大-旗山",15,0,15
"4006","8936國統","110/08/02","台灣企銀-台中",0,15,-15
"4007","8936國統","110/08/02","中國信託-文心",12,0,12
"4008","8936國統","110/08/02","日盛-竹北",0,15,-15
"4009","8936國統","110/08/02","國泰-敦南",14,2,12
"4010","8936國統","110/08/02","瑞士信貸",0,11,-11
"4011","8936國統","110/08/02","元大-敦南",12,0,12
"4012","8936國統","110/08/02","港商野村",26,36,-10
"4013","8936國統","110/08/02","日盛-三峽",11,0,11
"4014","8936國統","110/08/02","統一-竹南",0,10,-10
"4015","8936國統","110/08/02","永豐金-苓雅",11,0,11
"4016","8936國統","110/08/02","國泰-高雄",1,11,-10
"4017","8936國統","110/08/02","宏遠-高雄",11,1,10
"4018","8936國統","110/08/02","元大-天母",0,9,-9
"4019","8936國統","110/08/02","第一金-嘉義",10,0,10
"4020","8936國統","110/08/02","元大-台中中港",0,9,-9
"4021","6226光鼎","110/08/02","新百王",283,0,283
"4022","6226光鼎","110/08/02","元富-安南",3,113,-110
"4023","6226光鼎","110/08/02","日盛-文化",219,3,216
"4024","6226光鼎","110/08/02","群益金鼎-東大",24,124,-100
"4025","6226光鼎","110/08/02","元大-嘉義",127,37,90
"4026","6226光鼎","110/08/02","富邦-南屯",3,100,-97
"4027","6226光鼎","110/08/02","統一-新竹",113,31,82
"4028","6226光鼎","110/08/02","元大-鳳中",2,99,-97
"4029","6226光鼎","110/08/02","台中銀-員林",111,47,64
"4030","6226光鼎","110/08/02","元大-忠孝鼎富",10,100,-90
"4031","6226光鼎","110/08/02","永豐金證券",66,5,61
"4032","6226光鼎","110/08/02","華南永昌-小港",0,84,-84
"4033","6226光鼎","110/08/02","日盛-員林",107,50,57
"4034","6226光鼎","110/08/02","國泰-敦南",247,324,-77
"4035","6226光鼎","110/08/02","國票-九鼎",72,24,48
"4036","6226光鼎","110/08/02","亞東",5,76,-71
"4037","6226光鼎","110/08/02","元大-士林",53,6,47
"4038","6226光鼎","110/08/02","中國信託-新竹",2,62,-60
"4039","6226光鼎","110/08/02","元大-鹿港",48,7,41
"4040","6226光鼎","110/08/02","元大-南屯",12,64,-52
"4041","6226光鼎","110/08/02","中國信託-文心",48,8,40
"4042","6226光鼎","110/08/02","元大-高雄",9,61,-52
"4043","6226光鼎","110/08/02","國泰-新莊",56,17,39
"4044","6226光鼎","110/08/02","元大-台北",2,53,-51
"4045","6226光鼎","110/08/02","元大-大同",39,0,39
"4046","6226光鼎","110/08/02","第一金-華江",8,52,-44
"4047","6226光鼎","110/08/02","富邦-建國",39,1,38
"4048","6226光鼎","110/08/02","元富-新莊",3,44,-41
"4049","6226光鼎","110/08/02","統一-三重",54,18,36
"4050","6226光鼎","110/08/02","玉山-桃園",3,40,-37
"4051","2363矽統","110/08/02","中國信託-忠孝",405,25,380
"4052","2363矽統","110/08/02","富邦證券",16,4082,-4066
"4053","2363矽統","110/08/02","群益金鼎-屏東",349,123,226
"4054","2363矽統","110/08/02","凱基-台北",2669,4466,-1797
"4055","2363矽統","110/08/02","群益金鼎-永和",233,20,213
"4056","2363矽統","110/08/02","台灣摩根士丹利",69,1749,-1680
"4057","2363矽統","110/08/02","富邦-中壢",299,91,208
"4058","2363矽統","110/08/02","新加坡商瑞銀",361,1486,-1125
"4059","2363矽統","110/08/02","永豐金-彰化",188,4,184
"4060","2363矽統","110/08/02","港商野村",619,1622,-1003
"4061","2363矽統","110/08/02","元大-承德",253,73,180
"4062","2363矽統","110/08/02","美商高盛",214,1077,-863
"4063","2363矽統","110/08/02","康和-台中",192,23,169
"4064","2363矽統","110/08/02","兆豐-復興",124,973,-849
"4065","2363矽統","110/08/02","新光",550,382,168
"4066","2363矽統","110/08/02","統一-仁愛",132,666,-534
"4067","2363矽統","110/08/02","元大-萬華",224,61,163
"4068","2363矽統","110/08/02","美林",520,1028,-508
"4069","2363矽統","110/08/02","元大-博愛",204,44,160
"4070","2363矽統","110/08/02","統一-土城",32,536,-504
"4071","2363矽統","110/08/02","兆豐-三民",171,17,154
"4072","2363矽統","110/08/02","華南永昌-斗六",33,526,-493
"4073","2363矽統","110/08/02","元大-新竹",196,44,152
"4074","2363矽統","110/08/02","統一-敦南",35,527,-492
"4075","2363矽統","110/08/02","凱基-三重",178,29,149
"4076","2363矽統","110/08/02","永豐金-員林",12,495,-483
"4077","2363矽統","110/08/02","元大-忠孝",181,38,143
"4078","2363矽統","110/08/02","統一-城中",117,589,-472
"4079","2363矽統","110/08/02","元富-世貿",142,4,138
"4080","2363矽統","110/08/02","摩根大通",1070,1471,-401
"4081","8112至上","110/08/02","合庫證券",213,0,213
"4082","8112至上","110/08/02","台灣摩根士丹利",9,287,-278
"4083","8112至上","110/08/02","凱基-台北",298,152,146
"4084","8112至上","110/08/02","凱基-三重",3,236,-233
"4085","8112至上","110/08/02","大慶",87,0,87
"4086","8112至上","110/08/02","臺銀-鳳山",11,124,-113
"4087","8112至上","110/08/02","凱基-新店",84,0,84
"4088","8112至上","110/08/02","合庫-台中",1,112,-111
"4089","8112至上","110/08/02","香港上海匯豐",76,0,76
"4090","8112至上","110/08/02","土銀-嘉義",0,105,-105
"4091","8112至上","110/08/02","群益金鼎-建成",65,1,64
"4092","8112至上","110/08/02","元大-新莊",2,106,-104
"4093","8112至上","110/08/02","玉山-板橋",63,0,63
"4094","8112至上","110/08/02","台新-建北",0,95,-95
"4095","8112至上","110/08/02","元大-前金",61,2,59
"4096","8112至上","110/08/02","華南永昌-彰化",2,64,-62
"4097","8112至上","110/08/02","台新-台中",58,5,53
"4098","8112至上","110/08/02","群益金鼎-北高雄",3,50,-47
"4099","8112至上","110/08/02","亞東",51,0,51
"4100","8112至上","110/08/02","元大-福營",1,45,-44
"4101","8112至上","110/08/02","美林",49,1,48
"4102","8112至上","110/08/02","永豐金-南京",2,38,-36
"4103","8112至上","110/08/02","摩根大通",114,67,47
"4104","8112至上","110/08/02","亞東-板橋",2,34,-32
"4105","8112至上","110/08/02","美商高盛",46,0,46
"4106","8112至上","110/08/02","元大-台南",2,33,-31
"4107","8112至上","110/08/02","凱基-松山",43,1,42
"4108","8112至上","110/08/02","統一-城中",0,30,-30
"4109","8112至上","110/08/02","群益金鼎-大安",40,0,40
"4110","8112至上","110/08/02","元富-板橋",5,35,-30
"4111","1570力肯","110/08/02","群益金鼎-高雄",11,0,11
"4112","1570力肯","110/08/02","大慶",0,5,-5
"4113","1570力肯","110/08/02","臺銀-臺南",4,0,4
"4114","1570力肯","110/08/02","元大-板橋",0,4,-4
"4115","1570力肯","110/08/02","新光-台中",4,0,4
"4116","1570力肯","110/08/02","玉山證券",0,4,-4
"4117","1570力肯","110/08/02","(牛牛牛)亞-鑫豐",3,0,3
"4118","1570力肯","110/08/02","國泰-台南",0,3,-3
"4119","1570力肯","110/08/02","土銀-白河",2,0,2
"4120","1570力肯","110/08/02","元富-新店",0,3,-3
"4121","1570力肯","110/08/02","統一-松江",2,0,2
"4122","1570力肯","110/08/02","元富-永和",0,2,-2
"4123","1570力肯","110/08/02","中國信託-永康",1,0,1
"4124","1570力肯","110/08/02","凱基-台北",0,2,-2
"4125","1570力肯","110/08/02","凱基-信義",1,0,1
"4126","1570力肯","110/08/02","統一-城中",0,2,-2
"4127","1570力肯","110/08/02","凱基-幸福",1,0,1
"4128","1570力肯","110/08/02","新光",0,1,-1
"4129","1570力肯","110/08/02","元大-歸仁",1,0,1
"4130","1570力肯","110/08/02","凱基-岡山",0,1,-1
"4131","1570力肯","110/08/02","合庫-台中",0,0,0
"4132","1570力肯","110/08/02","富邦-台南",0,1,-1
"4133","1570力肯","110/08/02","康和-板橋",0,0,0
"4134","1570力肯","110/08/02","元大-新盛",0,1,-1
"4135","1570力肯","110/08/02","群益金鼎-鳳山",0,0,0
"4136","1570力肯","110/08/02","永豐金-嘉義",0,1,-1
"4137","1570力肯","110/08/02","元大-樹林",0,0,0
"4138","1570力肯","110/08/02","康和-板橋",0,0,0
"4139","1570力肯","110/08/02","",NA,NA,NA
"4140","1570力肯","110/08/02","合庫-台中",0,0,0
"4141","2929淘帝","110/08/02","元大-民生",29,0,29
"4142","2929淘帝","110/08/02","新加坡商瑞銀",4,70,-66
"4143","2929淘帝","110/08/02","兆豐-桃園",20,0,20
"4144","2929淘帝","110/08/02","富邦-建國",0,26,-26
"4145","2929淘帝","110/08/02","新光",14,0,14
"4146","2929淘帝","110/08/02","美林",0,24,-24
"4147","2929淘帝","110/08/02","兆豐-忠孝",13,0,13
"4148","2929淘帝","110/08/02","元大-和平",0,13,-13
"4149","2929淘帝","110/08/02","兆豐-彰化",12,0,12
"4150","2929淘帝","110/08/02","元大-永和",0,10,-10
"4151","2929淘帝","110/08/02","合庫-高雄",10,0,10
"4152","2929淘帝","110/08/02","日盛-頭份",0,9,-9
"4153","2929淘帝","110/08/02","富邦-台北",10,0,10
"4154","2929淘帝","110/08/02","群益金鼎-中山",0,9,-9
"4155","2929淘帝","110/08/02","國泰-敦南",9,0,9
"4156","2929淘帝","110/08/02","華南永昌-頭份",0,7,-7
"4157","2929淘帝","110/08/02","元富-文心",10,2,8
"4158","2929淘帝","110/08/02","永豐金-敦南",0,7,-7
"4159","2929淘帝","110/08/02","台新-台中",7,0,7
"4160","2929淘帝","110/08/02","凱基-台北",5,11,-6
"4161","2929淘帝","110/08/02","元大-文心",6,0,6
"4162","2929淘帝","110/08/02","臺銀-鳳山",0,5,-5
"4163","2929淘帝","110/08/02","日盛-忠孝",5,0,5
"4164","2929淘帝","110/08/02","凱基-城中",0,5,-5
"4165","2929淘帝","110/08/02","第一金-高雄",5,0,5
"4166","2929淘帝","110/08/02","華南永昌-台中",0,5,-5
"4167","2929淘帝","110/08/02","富邦-基隆",6,1,5
"4168","2929淘帝","110/08/02","元大-博愛",0,5,-5
"4169","2929淘帝","110/08/02","富邦-新店",5,0,5
"4170","2929淘帝","110/08/02","元富-緯城",0,4,-4
"4171","5410國眾","110/08/02","新加坡商瑞銀",19,0,19
"4172","5410國眾","110/08/02","日盛-斗六",0,15,-15
"4173","5410國眾","110/08/02","兆豐-城中",18,0,18
"4174","5410國眾","110/08/02","元大-大同",0,15,-15
"4175","5410國眾","110/08/02","日盛-新莊",10,0,10
"4176","5410國眾","110/08/02","元大-博愛",0,10,-10
"4177","5410國眾","110/08/02","元富-佳里",10,0,10
"4178","5410國眾","110/08/02","凱基-台北",0,7,-7
"4179","5410國眾","110/08/02","摩根大通",9,0,9
"4180","5410國眾","110/08/02","臺銀-臺南",0,6,-6
"4181","5410國眾","110/08/02","國泰-桃園",6,0,6
"4182","5410國眾","110/08/02","元富-嘉義",0,6,-6
"4183","5410國眾","110/08/02","元富-新竹",5,0,5
"4184","5410國眾","110/08/02","第一金-中壢",0,5,-5
"4185","5410國眾","110/08/02","元大-復北",5,0,5
"4186","5410國眾","110/08/02","致和證券",0,5,-5
"4187","5410國眾","110/08/02","永豐金-桃園",5,0,5
"4188","5410國眾","110/08/02","群益金鼎-土城",0,5,-5
"4189","5410國眾","110/08/02","安泰-楠梓",4,0,4
"4190","5410國眾","110/08/02","華南永昌-中正",0,5,-5
"4191","5410國眾","110/08/02","台灣企銀-太平",3,0,3
"4192","5410國眾","110/08/02","元大-新莊",0,5,-5
"4193","5410國眾","110/08/02","新光",3,0,3
"4194","5410國眾","110/08/02","土銀-新竹",0,4,-4
"4195","5410國眾","110/08/02","富邦-內湖",3,0,3
"4196","5410國眾","110/08/02","日盛-員林",0,3,-3
"4197","5410國眾","110/08/02","中國信託-新竹",2,0,2
"4198","5410國眾","110/08/02","元大-新竹經國",0,3,-3
"4199","5410國眾","110/08/02","華南永昌-楠梓",2,0,2
"4200","5410國眾","110/08/02","元富-緯城",0,2,-2
"4201","2841台開","110/08/02","富邦-敦南",71,0,71
"4202","2841台開","110/08/02","永豐金-松山",0,91,-91
"4203","2841台開","110/08/02","國泰-館前",38,0,38
"4204","2841台開","110/08/02","元大-蘆洲",0,40,-40
"4205","2841台開","110/08/02","台中銀",19,0,19
"4206","2841台開","110/08/02","凱基-台北",2,33,-31
"4207","2841台開","110/08/02","元富-烏日",18,0,18
"4208","2841台開","110/08/02","兆豐-寶成",0,20,-20
"4209","2841台開","110/08/02","國泰-板橋",15,0,15
"4210","2841台開","110/08/02","華南永昌-民權",0,20,-20
"4211","2841台開","110/08/02","元大-台中",15,0,15
"4212","2841台開","110/08/02","國票-敦北法人",0,18,-18
"4213","2841台開","110/08/02","元大-福營",15,0,15
"4214","2841台開","110/08/02","第一金-路竹",0,17,-17
"4215","2841台開","110/08/02","日盛-花蓮",14,0,14
"4216","2841台開","110/08/02","中國信託-高雄",0,15,-15
"4217","2841台開","110/08/02","新光",12,0,12
"4218","2841台開","110/08/02","日進",0,10,-10
"4219","2841台開","110/08/02","永豐金-敦南",62,51,11
"4220","2841台開","110/08/02","統一-三多",0,10,-10
"4221","2841台開","110/08/02","日盛-台中",10,0,10
"4222","2841台開","110/08/02","元大-路竹",0,10,-10
"4223","2841台開","110/08/02","群益金鼎-崇德",10,0,10
"4224","2841台開","110/08/02","元大-中和",0,10,-10
"4225","2841台開","110/08/02","元大-南海",10,0,10
"4226","2841台開","110/08/02","宏遠-桃園",0,9,-9
"4227","2841台開","110/08/02","國泰-桃園",8,0,8
"4228","2841台開","110/08/02","大昌-新店",0,6,-6
"4229","2841台開","110/08/02","台新-台中",6,0,6
"4230","2841台開","110/08/02","國票-天祥",0,6,-6
"4231","6207雷科","110/08/02","摩根大通",173,19,154
"4232","6207雷科","110/08/02","凱基-高雄",0,50,-50
"4233","6207雷科","110/08/02","凱基-台北",150,10,140
"4234","6207雷科","110/08/02","群益金鼎-東門",0,26,-26
"4235","6207雷科","110/08/02","華南永昌-朴子",55,0,55
"4236","6207雷科","110/08/02","富邦-竹東",0,25,-25
"4237","6207雷科","110/08/02","新加坡商瑞銀",51,5,46
"4238","6207雷科","110/08/02","華南永昌-東勢",3,27,-24
"4239","6207雷科","110/08/02","元大-西門",54,12,42
"4240","6207雷科","110/08/02","富邦-岡山",1,25,-24
"4241","6207雷科","110/08/02","兆豐-景美",42,2,40
"4242","6207雷科","110/08/02","台灣摩根士丹利",0,22,-22
"4243","6207雷科","110/08/02","日盛-忠孝",35,0,35
"4244","6207雷科","110/08/02","國泰-高雄",1,23,-22
"4245","6207雷科","110/08/02","美林",25,0,25
"4246","6207雷科","110/08/02","富邦-建國",0,17,-17
"4247","6207雷科","110/08/02","日盛-北高雄",16,0,16
"4248","6207雷科","110/08/02","元大-上新莊",0,16,-16
"4249","6207雷科","110/08/02","統一-板橋",15,0,15
"4250","6207雷科","110/08/02","中國信託-高雄",0,15,-15
"4251","6207雷科","110/08/02","凱基-市政",15,0,15
"4252","6207雷科","110/08/02","宏遠證券",0,13,-13
"4253","6207雷科","110/08/02","新光-新竹",16,2,14
"4254","6207雷科","110/08/02","凱基-彰化",0,13,-13
"4255","6207雷科","110/08/02","港商野村",23,12,11
"4256","6207雷科","110/08/02","永豐金-內湖",0,13,-13
"4257","6207雷科","110/08/02","統一-南京",11,0,11
"4258","6207雷科","110/08/02","新百王",0,12,-12
"4259","6207雷科","110/08/02","元大-嘉義",11,0,11
"4260","6207雷科","110/08/02","玉山-大里",0,12,-12
"4261","3679新至陞","110/08/02","元大-成功",26,0,26
"4262","3679新至陞","110/08/02","富邦-陽明",1,34,-33
"4263","3679新至陞","110/08/02","元大-樹林",20,0,20
"4264","3679新至陞","110/08/02","富邦-中壢",0,20,-20
"4265","3679新至陞","110/08/02","(牛牛牛)亞-網路",18,0,18
"4266","3679新至陞","110/08/02","凱基-台北",34,48,-14
"4267","3679新至陞","110/08/02","凱基-中山",12,0,12
"4268","3679新至陞","110/08/02","永豐金證券",0,14,-14
"4269","3679新至陞","110/08/02","統一",21,11,10
"4270","3679新至陞","110/08/02","臺銀-臺南",2,14,-12
"4271","3679新至陞","110/08/02","玉山-台大",10,0,10
"4272","3679新至陞","110/08/02","摩根大通",20,32,-12
"4273","3679新至陞","110/08/02","台中銀",8,0,8
"4274","3679新至陞","110/08/02","富邦-嘉義",0,10,-10
"4275","3679新至陞","110/08/02","港商野村",8,2,6
"4276","3679新至陞","110/08/02","國票-北高雄",1,10,-9
"4277","3679新至陞","110/08/02","群益金鼎-丹鳳",6,0,6
"4278","3679新至陞","110/08/02","台新-台中",0,9,-9
"4279","3679新至陞","110/08/02","元大-高雄",6,0,6
"4280","3679新至陞","110/08/02","凱基-宜蘭",0,7,-7
"4281","3679新至陞","110/08/02","新加坡商瑞銀",5,0,5
"4282","3679新至陞","110/08/02","凱基-埔墘",0,7,-7
"4283","3679新至陞","110/08/02","台灣摩根士丹利",13,9,4
"4284","3679新至陞","110/08/02","永豐金-台中",0,7,-7
"4285","3679新至陞","110/08/02","第一金-華江",4,0,4
"4286","3679新至陞","110/08/02","永豐金-潮州",0,7,-7
"4287","3679新至陞","110/08/02","新光",11,7,4
"4288","3679新至陞","110/08/02","凱基-五股",0,6,-6
"4289","3679新至陞","110/08/02","國泰-館前",4,0,4
"4290","3679新至陞","110/08/02","富邦-建國",0,6,-6
"4291","2727王品","110/08/02","摩根大通",38,5,33
"4292","2727王品","110/08/02","台灣摩根士丹利",13,170,-157
"4293","2727王品","110/08/02","日盛-忠孝",33,3,30
"4294","2727王品","110/08/02","華南永昌",7,156,-149
"4295","2727王品","110/08/02","凱基-天母",30,0,30
"4296","2727王品","110/08/02","凱基-台北",37,57,-20
"4297","2727王品","110/08/02","花旗環球",17,0,17
"4298","2727王品","110/08/02","國票-北高雄",1,19,-18
"4299","2727王品","110/08/02","永豐金-竹科",20,5,15
"4300","2727王品","110/08/02","港商野村",39,54,-15
"4301","2727王品","110/08/02","彰銀-台中",16,2,14
"4302","2727王品","110/08/02","元大-四維",1,15,-14
"4303","2727王品","110/08/02","國票-內壢",14,0,14
"4304","2727王品","110/08/02","美林",12,25,-13
"4305","2727王品","110/08/02","新光-台中",17,3,14
"4306","2727王品","110/08/02","瑞士信貸",0,12,-12
"4307","2727王品","110/08/02","永豐金-南京",16,3,13
"4308","2727王品","110/08/02","元大-北成功",0,10,-10
"4309","2727王品","110/08/02","元大-樹林",13,1,12
"4310","2727王品","110/08/02","元大-崇德",0,8,-8
"4311","2727王品","110/08/02","國泰-板橋",17,7,10
"4312","2727王品","110/08/02","永豐金-內湖",3,10,-7
"4313","2727王品","110/08/02","凱基-埔墘",10,0,10
"4314","2727王品","110/08/02","大昌",5,11,-6
"4315","2727王品","110/08/02","元大-豐原",10,0,10
"4316","2727王品","110/08/02","華南永昌-斗六",2,8,-6
"4317","2727王品","110/08/02","元大-桃園",10,0,10
"4318","2727王品","110/08/02","國泰-台中",4,9,-5
"4319","2727王品","110/08/02","凱基-科園",9,0,9
"4320","2727王品","110/08/02","群益金鼎-土城",0,5,-5
"4321","1570力肯","110/08/02","群益金鼎-高雄",11,0,11
"4322","1570力肯","110/08/02","大慶",0,5,-5
"4323","1570力肯","110/08/02","臺銀-臺南",4,0,4
"4324","1570力肯","110/08/02","元大-板橋",0,4,-4
"4325","1570力肯","110/08/02","新光-台中",4,0,4
"4326","1570力肯","110/08/02","玉山證券",0,4,-4
"4327","1570力肯","110/08/02","(牛牛牛)亞-鑫豐",3,0,3
"4328","1570力肯","110/08/02","國泰-台南",0,3,-3
"4329","1570力肯","110/08/02","土銀-白河",2,0,2
"4330","1570力肯","110/08/02","元富-新店",0,3,-3
"4331","1570力肯","110/08/02","統一-松江",2,0,2
"4332","1570力肯","110/08/02","元富-永和",0,2,-2
"4333","1570力肯","110/08/02","中國信託-永康",1,0,1
"4334","1570力肯","110/08/02","凱基-台北",0,2,-2
"4335","1570力肯","110/08/02","凱基-信義",1,0,1
"4336","1570力肯","110/08/02","統一-城中",0,2,-2
"4337","1570力肯","110/08/02","凱基-幸福",1,0,1
"4338","1570力肯","110/08/02","新光",0,1,-1
"4339","1570力肯","110/08/02","元大-歸仁",1,0,1
"4340","1570力肯","110/08/02","凱基-岡山",0,1,-1
"4341","1570力肯","110/08/02","合庫-台中",0,0,0
"4342","1570力肯","110/08/02","富邦-台南",0,1,-1
"4343","1570力肯","110/08/02","康和-板橋",0,0,0
"4344","1570力肯","110/08/02","元大-新盛",0,1,-1
"4345","1570力肯","110/08/02","群益金鼎-鳳山",0,0,0
"4346","1570力肯","110/08/02","永豐金-嘉義",0,1,-1
"4347","1570力肯","110/08/02","元大-樹林",0,0,0
"4348","1570力肯","110/08/02","康和-板橋",0,0,0
"4349","1570力肯","110/08/02","",NA,NA,NA
"4350","1570力肯","110/08/02","合庫-台中",0,0,0
"4351","6180橘子","110/08/02","美商高盛",21,8,13
"4352","6180橘子","110/08/02","國票-嘉義",0,29,-29
"4353","6180橘子","110/08/02","統一-彰化",10,0,10
"4354","6180橘子","110/08/02","新加坡商瑞銀",0,21,-21
"4355","6180橘子","110/08/02","中國信託-高雄",10,0,10
"4356","6180橘子","110/08/02","凱基-台北",20,40,-20
"4357","6180橘子","110/08/02","兆豐-斗南",10,0,10
"4358","6180橘子","110/08/02","摩根大通",3,15,-12
"4359","6180橘子","110/08/02","兆豐-埔墘",10,0,10
"4360","6180橘子","110/08/02","第一金-桃園",0,10,-10
"4361","6180橘子","110/08/02","玉山證券",10,0,10
"4362","6180橘子","110/08/02","凱基-東港",0,10,-10
"4363","6180橘子","110/08/02","富邦-羅東",8,1,7
"4364","6180橘子","110/08/02","元大-桃園",0,10,-10
"4365","6180橘子","110/08/02","元大證券",7,0,7
"4366","6180橘子","110/08/02","元大-館前",0,9,-9
"4367","6180橘子","110/08/02","元大-復北",7,0,7
"4368","6180橘子","110/08/02","台灣摩根士丹利",3,10,-7
"4369","6180橘子","110/08/02","華南永昌-長虹",6,0,6
"4370","6180橘子","110/08/02","光和-花壇",0,5,-5
"4371","6180橘子","110/08/02","元富-文心",5,0,5
"4372","6180橘子","110/08/02","玉山-嘉義",0,5,-5
"4373","6180橘子","110/08/02","台新-新莊",5,0,5
"4374","6180橘子","110/08/02","凱基-松山",0,5,-5
"4375","6180橘子","110/08/02","康和-嘉義",5,0,5
"4376","6180橘子","110/08/02","永豐金-員林",0,4,-4
"4377","6180橘子","110/08/02","凱基-興隆",5,0,5
"4378","6180橘子","110/08/02","元富-大裕",0,3,-3
"4379","6180橘子","110/08/02","華南永昌-楠梓",5,0,5
"4380","6180橘子","110/08/02","富邦-板橋",0,3,-3
"4381","2390云辰","110/08/02","摩根大通",1945,913,1032
"4382","2390云辰","110/08/02","華南永昌-鳳山",154,448,-294
"4383","2390云辰","110/08/02","富邦-陽明",118,11,107
"4384","2390云辰","110/08/02","群益金鼎-三重",1,168,-167
"4385","2390云辰","110/08/02","兆豐-三民",153,62,91
"4386","2390云辰","110/08/02","統一-內湖",5,102,-97
"4387","2390云辰","110/08/02","光和-嘉義",83,4,79
"4388","2390云辰","110/08/02","台新證券",235,320,-85
"4389","2390云辰","110/08/02","華南永昌-新莊",78,4,74
"4390","2390云辰","110/08/02","統一-新台中",8,87,-79
"4391","2390云辰","110/08/02","統一-城中",182,111,71
"4392","2390云辰","110/08/02","美商高盛",10,88,-78
"4393","2390云辰","110/08/02","台灣摩根士丹利",153,85,68
"4394","2390云辰","110/08/02","元大-汐止",57,130,-73
"4395","2390云辰","110/08/02","凱基-和平",115,47,68
"4396","2390云辰","110/08/02","港商野村",580,638,-58
"4397","2390云辰","110/08/02","華南永昌-公誠",75,13,62
"4398","2390云辰","110/08/02","元富-板橋",5,61,-56
"4399","2390云辰","110/08/02","永豐金-竹科",71,9,62
"4400","2390云辰","110/08/02","新加坡商瑞銀",11,66,-55
"4401","2390云辰","110/08/02","新光",160,100,60
"4402","2390云辰","110/08/02","元大-豐原",6,56,-50
"4403","2390云辰","110/08/02","凱基-岡山",61,1,60
"4404","2390云辰","110/08/02","元大-土城",5,55,-50
"4405","2390云辰","110/08/02","美林",254,195,59
"4406","2390云辰","110/08/02","凱基-站前",1,49,-48
"4407","2390云辰","110/08/02","凱基-大里",76,22,54
"4408","2390云辰","110/08/02","元大-中壢",6,54,-48
"4409","2390云辰","110/08/02","元大-鳳中",60,8,52
"4410","2390云辰","110/08/02","日盛證券",48,95,-47
"4411","1471首利","110/07/29","宏遠-光隆",35,0,35
"4412","1471首利","110/07/29","摩根大通",24,132,-108
"4413","1471首利","110/07/29","玉山-桃園",33,3,30
"4414","1471首利","110/07/29","台灣企銀-太平",0,60,-60
"4415","1471首利","110/07/29","富邦-台南",30,0,30
"4416","1471首利","110/07/29","元大-斗六",0,40,-40
"4417","1471首利","110/07/29","臺灣企銀-桃園",25,0,25
"4418","1471首利","110/07/29","元大-歸仁",0,23,-23
"4419","1471首利","110/07/29","元富-草屯",15,0,15
"4420","1471首利","110/07/29","日盛-永康",0,20,-20
"4421","1471首利","110/07/29","新光-桃園",15,0,15
"4422","1471首利","110/07/29","台中銀-員林",0,20,-20
"4423","1471首利","110/07/29","元大-博愛",15,2,13
"4424","1471首利","110/07/29","凱基-東門",0,14,-14
"4425","1471首利","110/07/29","臺銀-鳳山",12,0,12
"4426","1471首利","110/07/29","元大-草屯",1,15,-14
"4427","1471首利","110/07/29","元富-新莊",11,0,11
"4428","1471首利","110/07/29","元大-新竹經國",0,13,-13
"4429","1471首利","110/07/29","兆豐-來福",11,0,11
"4430","1471首利","110/07/29","日盛-土城",0,10,-10
"4431","1471首利","110/07/29","統一-新營",10,0,10
"4432","1471首利","110/07/29","美林",0,10,-10
"4433","1471首利","110/07/29","光和-溪湖",10,0,10
"4434","1471首利","110/07/29","永興-水湳",0,10,-10
"4435","1471首利","110/07/29","台新-左楠",10,0,10
"4436","1471首利","110/07/29","玉山證券",0,10,-10
"4437","1471首利","110/07/29","群益金鼎-台中",10,0,10
"4438","1471首利","110/07/29","群益金鼎-海山",2,12,-10
"4439","1471首利","110/07/29","凱基-內埔",10,0,10
"4440","1471首利","110/07/29","凱基-羅東",0,10,-10
"4441","2883開發金","110/07/29","國泰證券",2782,3,2779
"4442","2883開發金","110/07/29","永豐金證券",223,3618,-3395
"4443","2883開發金","110/07/29","凱基-台北",2299,284,2015
"4444","2883開發金","110/07/29","摩根大通",411,2625,-2214
"4445","2883開發金","110/07/29","第一金",1539,7,1532
"4446","2883開發金","110/07/29","台灣企銀",5,1717,-1712
"4447","2883開發金","110/07/29","港商野村",1983,585,1398
"4448","2883開發金","110/07/29","新加坡商瑞銀",843,2324,-1481
"4449","2883開發金","110/07/29","元富",1805,427,1378
"4450","2883開發金","110/07/29","港商麥格理",0,1129,-1129
"4451","2883開發金","110/07/29","台灣摩根士丹利",1634,398,1236
"4452","2883開發金","110/07/29","元大-學甲",1,953,-952
"4453","2883開發金","110/07/29","花旗環球",932,0,932
"4454","2883開發金","110/07/29","國票-博愛",100,1025,-925
"4455","2883開發金","110/07/29","凱基-敦北",590,5,585
"4456","2883開發金","110/07/29","國泰-館前",220,944,-724
"4457","2883開發金","110/07/29","國票-長城",506,4,502
"4458","2883開發金","110/07/29","兆豐-高雄",33,650,-617
"4459","2883開發金","110/07/29","港商法國興業",506,18,488
"4460","2883開發金","110/07/29","元富-緯城",1,513,-512
"4461","2883開發金","110/07/29","台新證券",753,287,466
"4462","2883開發金","110/07/29","美林",232,698,-466
"4463","2883開發金","110/07/29","元大-鳳中",495,71,424
"4464","2883開發金","110/07/29","元富-城中",50,513,-463
"4465","2883開發金","110/07/29","日茂",374,3,371
"4466","2883開發金","110/07/29","致和-崇德",0,404,-404
"4467","2883開發金","110/07/29","大和國泰",368,0,368
"4468","2883開發金","110/07/29","永豐金-板橋",123,506,-383
"4469","2883開發金","110/07/29","新光",603,243,360
"4470","2883開發金","110/07/29","中國信託-忠孝",100,423,-323
"4471","6205詮欣","110/07/29","臺銀-鳳山",31,0,31
"4472","6205詮欣","110/07/29","永豐金-敦南",0,53,-53
"4473","6205詮欣","110/07/29","摩根大通",16,2,14
"4474","6205詮欣","110/07/29","元大-土城學府",2,16,-14
"4475","6205詮欣","110/07/29","臺銀",10,0,10
"4476","6205詮欣","110/07/29","元富-潮州",0,11,-11
"4477","6205詮欣","110/07/29","日盛證券",10,0,10
"4478","6205詮欣","110/07/29","元大-清水",0,10,-10
"4479","6205詮欣","110/07/29","兆豐-新莊",10,0,10
"4480","6205詮欣","110/07/29","日盛-三重",0,7,-7
"4481","6205詮欣","110/07/29","元大-南屯",10,0,10
"4482","6205詮欣","110/07/29","日盛-屏東",0,6,-6
"4483","6205詮欣","110/07/29","富邦-建國",4,0,4
"4484","6205詮欣","110/07/29","華南永昌-公誠",0,5,-5
"4485","6205詮欣","110/07/29","富邦-南屯",4,0,4
"4486","6205詮欣","110/07/29","元大-南京",0,5,-5
"4487","6205詮欣","110/07/29","臺銀-臺中",3,0,3
"4488","6205詮欣","110/07/29","瑞士信貸",0,4,-4
"4489","6205詮欣","110/07/29","日盛-和美",3,0,3
"4490","6205詮欣","110/07/29","凱基-大安",0,4,-4
"4491","6205詮欣","110/07/29","德信-新營",3,0,3
"4492","6205詮欣","110/07/29","元大-大里德芳",0,4,-4
"4493","6205詮欣","110/07/29","兆豐-景美",3,0,3
"4494","6205詮欣","110/07/29","合庫-基隆",0,2,-2
"4495","6205詮欣","110/07/29","國票",3,0,3
"4496","6205詮欣","110/07/29","中國信託-永康",0,2,-2
"4497","6205詮欣","110/07/29","國票-南崁",3,0,3
"4498","6205詮欣","110/07/29","兆豐-小港",0,2,-2
"4499","6205詮欣","110/07/29","元大-蘆洲",3,0,3
"4500","6205詮欣","110/07/29","康和-台中",0,2,-2
"4501","1540喬福","110/07/29","高橋-龍潭",10,0,10
"4502","1540喬福","110/07/29","統一-新台中",0,19,-19
"4503","1540喬福","110/07/29","富邦-南屯",10,0,10
"4504","1540喬福","110/07/29","元富-大昌",0,10,-10
"4505","1540喬福","110/07/29","元大-斗六",5,0,5
"4506","1540喬福","110/07/29","大昌-新店",0,6,-6
"4507","1540喬福","110/07/29","兆豐-北高雄",3,0,3
"4508","1540喬福","110/07/29","凱基-台北",0,3,-3
"4509","1540喬福","110/07/29","元大-大安",3,0,3
"4510","1540喬福","110/07/29","台新-台中",0,2,-2
"4511","1540喬福","110/07/29","永豐金-台中",3,0,3
"4512","1540喬福","110/07/29","群益金鼎-嘉義",0,2,-2
"4513","1540喬福","110/07/29","臺銀-金山",2,0,2
"4514","1540喬福","110/07/29","凱基-天母",0,2,-2
"4515","1540喬福","110/07/29","日盛-士林",2,0,2
"4516","1540喬福","110/07/29","花旗環球",0,1,-1
"4517","1540喬福","110/07/29","元大-土城學府",2,0,2
"4518","1540喬福","110/07/29","第一金-大稻埕",0,1,-1
"4519","1540喬福","110/07/29","元大-南京",2,0,2
"4520","1540喬福","110/07/29","統一-嘉義",0,1,-1
"4521","1540喬福","110/07/29","臺銀-臺南",1,0,1
"4522","1540喬福","110/07/29","元富-中港",0,1,-1
"4523","1540喬福","110/07/29","第一金-台南",1,0,1
"4524","1540喬福","110/07/29","(牛牛牛)亞-網路",0,1,-1
"4525","1540喬福","110/07/29","台中銀-豐原",1,0,1
"4526","1540喬福","110/07/29","玉山-高雄",0,1,-1
"4527","1540喬福","110/07/29","中國信託-高雄",1,0,1
"4528","1540喬福","110/07/29","群益金鼎-台南",0,1,-1
"4529","1540喬福","110/07/29","兆豐-台中港",1,0,1
"4530","1540喬福","110/07/29","凱基-鳳山",0,1,-1
"4531","2888新光金","110/07/29","美商高盛",6409,110,6299
"4532","2888新光金","110/07/29","元大-忠孝鼎富",0,6714,-6714
"4533","2888新光金","110/07/29","台灣摩根士丹利",4583,443,4140
"4534","2888新光金","110/07/29","凱基-台北",5855,11898,-6043
"4535","2888新光金","110/07/29","元富-草屯",2193,2,2191
"4536","2888新光金","110/07/29","瑞士信貸",161,6090,-5929
"4537","2888新光金","110/07/29","華南永昌-南京",2059,21,2038
"4538","2888新光金","110/07/29","永豐金-萬盛",124,3599,-3475
"4539","2888新光金","110/07/29","凱基-市政",1558,0,1558
"4540","2888新光金","110/07/29","群益金鼎-大安",2,3306,-3304
"4541","2888新光金","110/07/29","法銀巴黎",1234,0,1234
"4542","2888新光金","110/07/29","凱基-復興",15,3015,-3000
"4543","2888新光金","110/07/29","永豐金-台中",1166,49,1117
"4544","2888新光金","110/07/29","新加坡商瑞銀",1429,4265,-2836
"4545","2888新光金","110/07/29","群益金鼎-崇德",1083,10,1073
"4546","2888新光金","110/07/29","凱基-大安",10,2564,-2554
"4547","2888新光金","110/07/29","兆豐-竹北",1002,29,973
"4548","2888新光金","110/07/29","中國信託",46,2012,-1966
"4549","2888新光金","110/07/29","美林",1767,804,963
"4550","2888新光金","110/07/29","群益金鼎-台北",10,1875,-1865
"4551","2888新光金","110/07/29","元大-三重",882,0,882
"4552","2888新光金","110/07/29","元富-城東",142,1856,-1714
"4553","2888新光金","110/07/29","元大-豐原站前",983,114,869
"4554","2888新光金","110/07/29","華南永昌-忠孝",10,1600,-1590
"4555","2888新光金","110/07/29","元大-北港",868,5,863
"4556","2888新光金","110/07/29","永豐金-信義",10,1497,-1487
"4557","2888新光金","110/07/29","合庫-台中",891,54,837
"4558","2888新光金","110/07/29","富邦-建國",350,1736,-1386
"4559","2888新光金","110/07/29","統一-汐止",725,14,711
"4560","2888新光金","110/07/29","富邦-新營",60,1402,-1342
"4561","1340勝悅","110/07/29","新光-新竹",18,0,18
"4562","1340勝悅","110/07/29","瑞士信貸",0,8,-8
"4563","1340勝悅","110/07/29","華南永昌-彰化",5,0,5
"4564","1340勝悅","110/07/29","台新證券",0,7,-7
"4565","1340勝悅","110/07/29","元大-六合",5,0,5
"4566","1340勝悅","110/07/29","元富-緯城",0,5,-5
"4567","1340勝悅","110/07/29","第一金-自由",4,0,4
"4568","1340勝悅","110/07/29","兆豐-南京",0,5,-5
"4569","1340勝悅","110/07/29","新光",4,0,4
"4570","1340勝悅","110/07/29","富邦-南屯",0,5,-5
"4571","1340勝悅","110/07/29","美商高盛",3,0,3
"4572","1340勝悅","110/07/29","元富-安南",0,4,-4
"4573","1340勝悅","110/07/29","元富-彰化",3,0,3
"4574","1340勝悅","110/07/29","兆豐-三民",0,4,-4
"4575","1340勝悅","110/07/29","大昌",2,0,2
"4576","1340勝悅","110/07/29","兆豐-松德",0,4,-4
"4577","1340勝悅","110/07/29","兆豐-大安",2,0,2
"4578","1340勝悅","110/07/29","國票-台中",0,4,-4
"4579","1340勝悅","110/07/29","摩根大通",2,0,2
"4580","1340勝悅","110/07/29","第一金-路竹",0,3,-3
"4581","1340勝悅","110/07/29","新光-台中",2,0,2
"4582","1340勝悅","110/07/29","統一-城中",2,4,-2
"4583","1340勝悅","110/07/29","凱基-八德",2,0,2
"4584","1340勝悅","110/07/29","元富-同大",0,2,-2
"4585","1340勝悅","110/07/29","合庫-高雄",1,0,1
"4586","1340勝悅","110/07/29","台新-高雄",0,2,-2
"4587","1340勝悅","110/07/29","日進",1,0,1
"4588","1340勝悅","110/07/29","凱基-北門",0,2,-2
"4589","1340勝悅","110/07/29","新光-台南",1,0,1
"4590","1340勝悅","110/07/29","元大-汐止",0,2,-2
"4591","6246臺龍","110/07/29","港商野村",38,1,37
"4592","6246臺龍","110/07/29","玉山-台南",0,27,-27
"4593","6246臺龍","110/07/29","凱基-幸福",25,0,25
"4594","6246臺龍","110/07/29","國泰-忠孝",0,25,-25
"4595","6246臺龍","110/07/29","亞東-板橋",16,0,16
"4596","6246臺龍","110/07/29","光和",0,21,-21
"4597","6246臺龍","110/07/29","元大-台中",10,0,10
"4598","6246臺龍","110/07/29","第一金-安和",0,20,-20
"4599","6246臺龍","110/07/29","兆豐-松德",9,0,9
"4600","6246臺龍","110/07/29","兆豐-竹北",5,25,-20
"4601","6246臺龍","110/07/29","兆豐-公益",8,0,8
"4602","6246臺龍","110/07/29","元大-大里",0,20,-20
"4603","6246臺龍","110/07/29","華南永昌",7,0,7
"4604","6246臺龍","110/07/29","台新-台南",0,15,-15
"4605","6246臺龍","110/07/29","日盛-斗六",6,0,6
"4606","6246臺龍","110/07/29","永豐金-羅東",2,15,-13
"4607","6246臺龍","110/07/29","元富-中港",6,0,6
"4608","6246臺龍","110/07/29","元大-博愛",1,10,-9
"4609","6246臺龍","110/07/29","台新證券",8,2,6
"4610","6246臺龍","110/07/29","宏遠-台中",0,5,-5
"4611","6246臺龍","110/07/29","臺銀-臺中",5,0,5
"4612","6246臺龍","110/07/29","台新-左楠",0,5,-5
"4613","6246臺龍","110/07/29","元富-宜蘭",5,0,5
"4614","6246臺龍","110/07/29","中農",0,5,-5
"4615","6246臺龍","110/07/29","德信-新營",5,0,5
"4616","6246臺龍","110/07/29","群益金鼎-竹南",0,5,-5
"4617","6246臺龍","110/07/29","新光-新竹",5,0,5
"4618","6246臺龍","110/07/29","凱基-科園",0,5,-5
"4619","6246臺龍","110/07/29","國泰-敦南",10,5,5
"4620","6246臺龍","110/07/29","日盛-宜蘭",1,5,-4
"4621","00715L期街口布蘭特正2","110/07/29","永豐金證券",2129,2,2127
"4622","00715L期街口布蘭特正2","110/07/29","國票-博愛",55,702,-647
"4623","00715L期街口布蘭特正2","110/07/29","元大證券",1918,115,1803
"4624","00715L期街口布蘭特正2","110/07/29","富邦-彰化",0,605,-605
"4625","00715L期街口布蘭特正2","110/07/29","統一",1050,313,737
"4626","00715L期街口布蘭特正2","110/07/29","元大-前金",0,440,-440
"4627","00715L期街口布蘭特正2","110/07/29","港商野村",821,263,558
"4628","00715L期街口布蘭特正2","110/07/29","群益金鼎-崇德",0,340,-340
"4629","00715L期街口布蘭特正2","110/07/29","永豐金-內湖",500,0,500
"4630","00715L期街口布蘭特正2","110/07/29","元富-板橋",7,330,-323
"4631","00715L期街口布蘭特正2","110/07/29","元富-大裕",505,23,482
"4632","00715L期街口布蘭特正2","110/07/29","元大-三重",3,200,-197
"4633","00715L期街口布蘭特正2","110/07/29","國票-台中",276,0,276
"4634","00715L期街口布蘭特正2","110/07/29","凱基-東勢",5,194,-189
"4635","00715L期街口布蘭特正2","110/07/29","統一-高雄",300,118,182
"4636","00715L期街口布蘭特正2","110/07/29","富邦-台北",0,181,-181
"4637","00715L期街口布蘭特正2","110/07/29","群益金鼎-瑞豐",180,0,180
"4638","00715L期街口布蘭特正2","110/07/29","大慶-中和",0,174,-174
"4639","00715L期街口布蘭特正2","110/07/29","元大-南崁",128,0,128
"4640","00715L期街口布蘭特正2","110/07/29","永豐金-萬盛",0,153,-153
"4641","00715L期街口布蘭特正2","110/07/29","大慶-蘆洲",106,0,106
"4642","00715L期街口布蘭特正2","110/07/29","元大-開元",0,151,-151
"4643","00715L期街口布蘭特正2","110/07/29","統一-中壢",100,0,100
"4644","00715L期街口布蘭特正2","110/07/29","日盛-新竹",0,126,-126
"4645","00715L期街口布蘭特正2","110/07/29","第一金-自由",100,2,98
"4646","00715L期街口布蘭特正2","110/07/29","凱基-豐中",0,123,-123
"4647","00715L期街口布蘭特正2","110/07/29","華南永昌-內壢",100,2,98
"4648","00715L期街口布蘭特正2","110/07/29","元大-東泰",0,122,-122
"4649","00715L期街口布蘭特正2","110/07/29","永豐金-板橋",98,0,98
"4650","00715L期街口布蘭特正2","110/07/29","台新-高雄",0,121,-121
"4651","8941關中","110/07/29","富邦-仁愛",1,0,1
"4652","8941關中","110/07/29","富邦-員林",0,1,-1
"4653","8941關中","110/07/29","康和-板橋",0,0,0
"4654","8941關中","110/07/29","康和-板橋",0,0,0
"4655","8941關中","110/07/29","玉山證券",0,0,0
"4656","8941關中","110/07/29","玉山證券",0,0,0
"4657","8941關中","110/07/29","玉山-數位",0,0,0
"4658","8941關中","110/07/29","玉山-數位",0,0,0
"4659","8941關中","110/07/29","凱基-市府",0,0,0
"4660","8941關中","110/07/29","凱基-市府",0,0,0
"4661","8941關中","110/07/29","元大-鶯歌",0,0,0
"4662","8941關中","110/07/29","元大-鶯歌",0,0,0
"4663","8941關中","110/07/29","元大-花蓮",0,0,0
"4664","8941關中","110/07/29","元大-花蓮",0,0,0
"4665","8941關中","110/07/29","",NA,NA,NA
"4666","8941關中","110/07/29","",NA,NA,NA
"4667","8941關中","110/07/29","",NA,NA,NA
"4668","8941關中","110/07/29","",NA,NA,NA
"4669","8941關中","110/07/29","",NA,NA,NA
"4670","8941關中","110/07/29","",NA,NA,NA
"4671","8941關中","110/07/29","",NA,NA,NA
"4672","8941關中","110/07/29","",NA,NA,NA
"4673","8941關中","110/07/29","",NA,NA,NA
"4674","8941關中","110/07/29","",NA,NA,NA
"4675","8941關中","110/07/29","",NA,NA,NA
"4676","8941關中","110/07/29","",NA,NA,NA
"4677","8941關中","110/07/29","",NA,NA,NA
"4678","8941關中","110/07/29","",NA,NA,NA
"4679","8941關中","110/07/29","",NA,NA,NA
"4680","8941關中","110/07/29","",NA,NA,NA
"4681","8936國統","110/07/29","新加坡商瑞銀",89,19,70
"4682","8936國統","110/07/29","日盛-忠孝",11,135,-124
"4683","8936國統","110/07/29","瑞士信貸",55,3,52
"4684","8936國統","110/07/29","元富-敦南",0,80,-80
"4685","8936國統","110/07/29","凱基-台北",48,3,45
"4686","8936國統","110/07/29","康和",0,20,-20
"4687","8936國統","110/07/29","摩根大通",97,60,37
"4688","8936國統","110/07/29","元大-竹科",0,20,-20
"4689","8936國統","110/07/29","美林",27,2,25
"4690","8936國統","110/07/29","永豐金-桃園",0,19,-19
"4691","8936國統","110/07/29","凱基-三多",25,0,25
"4692","8936國統","110/07/29","群益金鼎-高盛",0,14,-14
"4693","8936國統","110/07/29","凱基-北門",27,2,25
"4694","8936國統","110/07/29","元富-安南",2,15,-13
"4695","8936國統","110/07/29","兆豐-桃鶯",30,10,20
"4696","8936國統","110/07/29","富邦-內湖",2,15,-13
"4697","8936國統","110/07/29","永豐金-台中",20,0,20
"4698","8936國統","110/07/29","元大-復北",0,11,-11
"4699","8936國統","110/07/29","台灣摩根士丹利",30,12,18
"4700","8936國統","110/07/29","合庫-鳳山",0,10,-10
"4701","8936國統","110/07/29","兆豐-大同",15,0,15
"4702","8936國統","110/07/29","元富-潮州",0,10,-10
"4703","8936國統","110/07/29","新光-台中",39,24,15
"4704","8936國統","110/07/29","群益金鼎-台北",0,10,-10
"4705","8936國統","110/07/29","兆豐-新營",10,0,10
"4706","8936國統","110/07/29","凱基-高雄",20,30,-10
"4707","8936國統","110/07/29","台新-高雄",10,0,10
"4708","8936國統","110/07/29","富邦-桃園",0,10,-10
"4709","8936國統","110/07/29","玉山-士林",10,0,10
"4710","8936國統","110/07/29","新光",1,10,-9
"4711","6226光鼎","110/07/29","台新-台中",396,46,350
"4712","6226光鼎","110/07/29","群益金鼎-東大",11,309,-298
"4713","6226光鼎","110/07/29","元富-永和",242,0,242
"4714","6226光鼎","110/07/29","日盛證券",2,176,-174
"4715","6226光鼎","110/07/29","永豐金-古亭",200,0,200
"4716","6226光鼎","110/07/29","國泰-敦南",90,197,-107
"4717","6226光鼎","110/07/29","華南永昌",216,46,170
"4718","6226光鼎","110/07/29","元大-雙和",16,111,-95
"4719","6226光鼎","110/07/29","國票-北高雄",188,36,152
"4720","6226光鼎","110/07/29","元大-大統",2,94,-92
"4721","6226光鼎","110/07/29","國票-台南",120,4,116
"4722","6226光鼎","110/07/29","元大-板橋",5,78,-73
"4723","6226光鼎","110/07/29","永豐金證券",101,3,98
"4724","6226光鼎","110/07/29","群益金鼎-萬華",46,111,-65
"4725","6226光鼎","110/07/29","富邦-建國",125,28,97
"4726","6226光鼎","110/07/29","華南永昌-竹北",1,60,-59
"4727","6226光鼎","110/07/29","群益金鼎-土城",94,9,85
"4728","6226光鼎","110/07/29","玉山證券",28,86,-58
"4729","6226光鼎","110/07/29","元富-四維",82,4,78
"4730","6226光鼎","110/07/29","元大-土城學府",13,68,-55
"4731","6226光鼎","110/07/29","元大-鳳中",69,15,54
"4732","6226光鼎","110/07/29","元大-豐原",5,59,-54
"4733","6226光鼎","110/07/29","台新-新莊",54,1,53
"4734","6226光鼎","110/07/29","統一",56,107,-51
"4735","6226光鼎","110/07/29","中國信託-新竹",63,13,50
"4736","6226光鼎","110/07/29","統一-內湖",0,48,-48
"4737","6226光鼎","110/07/29","群益金鼎-士林",50,0,50
"4738","6226光鼎","110/07/29","元大-東港",2,50,-48
"4739","6226光鼎","110/07/29","台新-高雄",125,80,45
"4740","6226光鼎","110/07/29","元大-太平",1,46,-45
"4741","2363矽統","110/07/29","凱基-台北",2235,1238,997
"4742","2363矽統","110/07/29","康和-台中",10,437,-427
"4743","2363矽統","110/07/29","摩根大通",1784,793,991
"4744","2363矽統","110/07/29","第一金-新興",11,310,-299
"4745","2363矽統","110/07/29","港商野村",1833,1300,533
"4746","2363矽統","110/07/29","瑞士信貸",9,190,-181
"4747","2363矽統","110/07/29","美林",652,288,364
"4748","2363矽統","110/07/29","台新證券",659,808,-149
"4749","2363矽統","110/07/29","元大-台中",376,38,338
"4750","2363矽統","110/07/29","元大-萬華",42,189,-147
"4751","2363矽統","110/07/29","新加坡商瑞銀",748,474,274
"4752","2363矽統","110/07/29","台新-左楠",26,171,-145
"4753","2363矽統","110/07/29","國泰-敦南",566,333,233
"4754","2363矽統","110/07/29","華南永昌-鳳山",116,241,-125
"4755","2363矽統","110/07/29","元大-旗山",299,66,233
"4756","2363矽統","110/07/29","永全-南崁",0,117,-117
"4757","2363矽統","110/07/29","美商高盛",600,433,167
"4758","2363矽統","110/07/29","群益金鼎-桃園",25,131,-106
"4759","2363矽統","110/07/29","元大-永和",146,12,134
"4760","2363矽統","110/07/29","宏遠-新化",3,103,-100
"4761","2363矽統","110/07/29","元大證券",137,9,128
"4762","2363矽統","110/07/29","新光",331,429,-98
"4763","2363矽統","110/07/29","永豐金-彰化",135,10,125
"4764","2363矽統","110/07/29","中國信託-忠孝",101,188,-87
"4765","2363矽統","110/07/29","北城證券",139,19,120
"4766","2363矽統","110/07/29","群益金鼎-建成",11,95,-84
"4767","2363矽統","110/07/29","富邦-高雄",153,34,119
"4768","2363矽統","110/07/29","群益金鼎-三民",23,105,-82
"4769","2363矽統","110/07/29","元大-蘆洲",120,19,101
"4770","2363矽統","110/07/29","元大-豐原",104,186,-82
"4771","8112至上","110/07/29","合庫證券",194,1,193
"4772","8112至上","110/07/29","摩根大通",4,424,-420
"4773","8112至上","110/07/29","美商高盛",154,5,149
"4774","8112至上","110/07/29","日盛-高雄",2,400,-398
"4775","8112至上","110/07/29","永豐金證券",144,0,144
"4776","8112至上","110/07/29","港商法國興業",0,374,-374
"4777","8112至上","110/07/29","新光-台中",123,12,111
"4778","8112至上","110/07/29","凱基-台北",50,312,-262
"4779","8112至上","110/07/29","新加坡商瑞銀",189,83,106
"4780","8112至上","110/07/29","美林",69,232,-163
"4781","8112至上","110/07/29","華南永昌-新莊",73,0,73
"4782","8112至上","110/07/29","兆豐-公益",0,120,-120
"4783","8112至上","110/07/29","新光",108,49,59
"4784","8112至上","110/07/29","瑞士信貸",1,109,-108
"4785","8112至上","110/07/29","元富-文心",45,3,42
"4786","8112至上","110/07/29","華南永昌-小港",4,30,-26
"4787","8112至上","110/07/29","華南永昌-林口",41,0,41
"4788","8112至上","110/07/29","富邦-中壢",1,24,-23
"4789","8112至上","110/07/29","港商野村",146,112,34
"4790","8112至上","110/07/29","元大-歸仁",2,24,-22
"4791","8112至上","110/07/29","臺銀-高雄",30,0,30
"4792","8112至上","110/07/29","華南永昌-麻豆",0,21,-21
"4793","8112至上","110/07/29","元富-佳里",30,0,30
"4794","8112至上","110/07/29","台新-松江",0,20,-20
"4795","8112至上","110/07/29","永豐金-內湖",30,1,29
"4796","8112至上","110/07/29","元大-新莊",1,20,-19
"4797","8112至上","110/07/29","台新-新營",31,3,28
"4798","8112至上","110/07/29","華南永昌-岡山",1,19,-18
"4799","8112至上","110/07/29","永豐金-彰化",27,0,27
"4800","8112至上","110/07/29","元大-崇德",3,20,-17
"4801","1570力肯","110/07/29","群益金鼎-高雄",20,0,20
"4802","1570力肯","110/07/29","聯邦-興中",0,17,-17
"4803","1570力肯","110/07/29","群益金鼎-板橋",16,0,16
"4804","1570力肯","110/07/29","富邦-建國",0,10,-10
"4805","1570力肯","110/07/29","統一-敦南",5,0,5
"4806","1570力肯","110/07/29","凱基-站前",0,5,-5
"4807","1570力肯","110/07/29","元富-松德",4,0,4
"4808","1570力肯","110/07/29","國泰-板橋",0,4,-4
"4809","1570力肯","110/07/29","元大-和平",4,0,4
"4810","1570力肯","110/07/29","統一-土城",0,3,-3
"4811","1570力肯","110/07/29","凱基-幸福",3,0,3
"4812","1570力肯","110/07/29","凱基-大里",0,3,-3
"4813","1570力肯","110/07/29","華南永昌-鳳山",3,0,3
"4814","1570力肯","110/07/29","凱基-台北",0,3,-3
"4815","1570力肯","110/07/29","元大-北港",4,2,2
"4816","1570力肯","110/07/29","元大-屏東民生",0,3,-3
"4817","1570力肯","110/07/29","美林",1,0,1
"4818","1570力肯","110/07/29","元富-緯城",0,2,-2
"4819","1570力肯","110/07/29","國泰-台南",1,0,1
"4820","1570力肯","110/07/29","台新-高雄",0,2,-2
"4821","1570力肯","110/07/29","元大-歸仁",1,0,1
"4822","1570力肯","110/07/29","華南永昌-楠梓",0,2,-2
"4823","1570力肯","110/07/29","元大-松山",1,0,1
"4824","1570力肯","110/07/29","元大-北成功",0,2,-2
"4825","1570力肯","110/07/29","元大-文心興安",1,0,1
"4826","1570力肯","110/07/29","元大-板橋",0,2,-2
"4827","1570力肯","110/07/29","元大-東蘆",1,0,1
"4828","1570力肯","110/07/29","統一-台南",0,1,-1
"4829","1570力肯","110/07/29","群益金鼎-鳳山",0,0,0
"4830","1570力肯","110/07/29","台新證券",0,1,-1
"4831","2929淘帝","110/07/29","新光-新竹",118,13,105
"4832","2929淘帝","110/07/29","元富-敦南",0,91,-91
"4833","2929淘帝","110/07/29","新加坡商瑞銀",56,0,56
"4834","2929淘帝","110/07/29","日盛-板橋中山",0,38,-38
"4835","2929淘帝","110/07/29","凱基-台北",39,4,35
"4836","2929淘帝","110/07/29","群益金鼎-士林",0,20,-20
"4837","2929淘帝","110/07/29","元大-民生",29,0,29
"4838","2929淘帝","110/07/29","華南永昌-敦南",0,20,-20
"4839","2929淘帝","110/07/29","美林",37,9,28
"4840","2929淘帝","110/07/29","高橋-龍潭",3,20,-17
"4841","2929淘帝","110/07/29","元大-承德",15,0,15
"4842","2929淘帝","110/07/29","凱基-中山",4,19,-15
"4843","2929淘帝","110/07/29","第一金-台南",10,0,10
"4844","2929淘帝","110/07/29","富邦-台北",0,15,-15
"4845","2929淘帝","110/07/29","富邦-桃園",9,0,9
"4846","2929淘帝","110/07/29","元富-台中",0,14,-14
"4847","2929淘帝","110/07/29","港商野村",17,10,7
"4848","2929淘帝","110/07/29","台新-建北",0,13,-13
"4849","2929淘帝","110/07/29","台中銀-豐原",6,0,6
"4850","2929淘帝","110/07/29","永豐金-敦南",0,12,-12
"4851","2929淘帝","110/07/29","元大-文心興安",6,0,6
"4852","2929淘帝","110/07/29","新光-台南",0,11,-11
"4853","2929淘帝","110/07/29","德信-新營",5,0,5
"4854","2929淘帝","110/07/29","宏遠-光隆",0,10,-10
"4855","2929淘帝","110/07/29","元大-博愛",5,0,5
"4856","2929淘帝","110/07/29","元大-嘉義",0,6,-6
"4857","2929淘帝","110/07/29","元大-員林",5,0,5
"4858","2929淘帝","110/07/29","日茂-南投",0,5,-5
"4859","2929淘帝","110/07/29","富邦-中壢",4,0,4
"4860","2929淘帝","110/07/29","新光",0,5,-5
"4861","5410國眾","110/07/29","兆豐-城中",32,0,32
"4862","5410國眾","110/07/29","第一金-台南",0,51,-51
"4863","5410國眾","110/07/29","新加坡商瑞銀",19,0,19
"4864","5410國眾","110/07/29","元富-大昌",0,13,-13
"4865","5410國眾","110/07/29","華南永昌-新莊",16,0,16
"4866","5410國眾","110/07/29","臺銀-臺南",0,12,-12
"4867","5410國眾","110/07/29","元大-小港",11,0,11
"4868","5410國眾","110/07/29","日盛-木柵",0,10,-10
"4869","5410國眾","110/07/29","臺銀",10,0,10
"4870","5410國眾","110/07/29","元富-安南",0,10,-10
"4871","5410國眾","110/07/29","臺銀-臺中",10,0,10
"4872","5410國眾","110/07/29","新光",4,13,-9
"4873","5410國眾","110/07/29","宏遠-館前",10,0,10
"4874","5410國眾","110/07/29","永豐金-屏東",0,5,-5
"4875","5410國眾","110/07/29","台新-中壢",10,0,10
"4876","5410國眾","110/07/29","永豐金-苓雅",0,5,-5
"4877","5410國眾","110/07/29","摩根大通",10,1,9
"4878","5410國眾","110/07/29","國票-台南",0,4,-4
"4879","5410國眾","110/07/29","元大-北投",9,0,9
"4880","5410國眾","110/07/29","永豐金-埔里",0,4,-4
"4881","5410國眾","110/07/29","台新證券",7,1,6
"4882","5410國眾","110/07/29","光和",0,3,-3
"4883","5410國眾","110/07/29","元富-新竹",5,0,5
"4884","5410國眾","110/07/29","凱基-汐止",0,3,-3
"4885","5410國眾","110/07/29","凱基-竹北",5,0,5
"4886","5410國眾","110/07/29","元大-善化",0,3,-3
"4887","5410國眾","110/07/29","永豐金-敦南",5,1,4
"4888","5410國眾","110/07/29","元大-員林",0,3,-3
"4889","5410國眾","110/07/29","美林",4,1,3
"4890","5410國眾","110/07/29","永豐金-台南",0,3,-3
"4891","2841台開","110/07/29","兆豐-台南",237,0,237
"4892","2841台開","110/07/29","元大-四維",0,184,-184
"4893","2841台開","110/07/29","永豐金-敦南",60,10,50
"4894","2841台開","110/07/29","玉山-新竹",0,145,-145
"4895","2841台開","110/07/29","永豐金-板新",50,0,50
"4896","2841台開","110/07/29","港商野村",0,124,-124
"4897","2841台開","110/07/29","華南永昌-南京",45,2,43
"4898","2841台開","110/07/29","永豐金-台南",0,32,-32
"4899","2841台開","110/07/29","群益金鼎-崇德",23,0,23
"4900","2841台開","110/07/29","華南永昌-公誠",0,23,-23
"4901","2841台開","110/07/29","日盛-園區",20,0,20
"4902","2841台開","110/07/29","元大-善化",0,22,-22
"4903","2841台開","110/07/29","台新-台中",20,0,20
"4904","2841台開","110/07/29","元大-豐原",0,20,-20
"4905","2841台開","110/07/29","華南永昌-新莊",20,0,20
"4906","2841台開","110/07/29","凱基-台北",0,15,-15
"4907","2841台開","110/07/29","富邦-仁愛",20,0,20
"4908","2841台開","110/07/29","富邦-台北",0,15,-15
"4909","2841台開","110/07/29","新光",15,0,15
"4910","2841台開","110/07/29","臺銀",0,10,-10
"4911","2841台開","110/07/29","華南永昌-台中",15,0,15
"4912","2841台開","110/07/29","元富-三重",0,10,-10
"4913","2841台開","110/07/29","凱基-彰化",13,0,13
"4914","2841台開","110/07/29","元大-林森",0,10,-10
"4915","2841台開","110/07/29","兆豐-台中",10,0,10
"4916","2841台開","110/07/29","光和-花壇",0,9,-9
"4917","2841台開","110/07/29","永豐金-松山",10,0,10
"4918","2841台開","110/07/29","國泰-桃園",1,10,-9
"4919","2841台開","110/07/29","國泰-館前",9,0,9
"4920","2841台開","110/07/29","玉山-嘉義",0,8,-8
"4921","6207雷科","110/07/29","永豐金-古亭",100,0,100
"4922","6207雷科","110/07/29","摩根大通",59,151,-92
"4923","6207雷科","110/07/29","國泰-館前",52,6,46
"4924","6207雷科","110/07/29","凱基-高雄",0,82,-82
"4925","6207雷科","110/07/29","新加坡商瑞銀",41,12,29
"4926","6207雷科","110/07/29","元大-松江",0,25,-25
"4927","6207雷科","110/07/29","大慶-蘆洲",29,6,23
"4928","6207雷科","110/07/29","元大-雙和",2,25,-23
"4929","6207雷科","110/07/29","永豐金-羅東",21,0,21
"4930","6207雷科","110/07/29","港商野村",16,36,-20
"4931","6207雷科","110/07/29","統一-南京",16,0,16
"4932","6207雷科","110/07/29","盈溢-楠梓",0,20,-20
"4933","6207雷科","110/07/29","凱基-台北",45,29,16
"4934","6207雷科","110/07/29","統一",2,20,-18
"4935","6207雷科","110/07/29","富邦-敦南",16,0,16
"4936","6207雷科","110/07/29","日盛-新竹",1,16,-15
"4937","6207雷科","110/07/29","統一-高雄",15,0,15
"4938","6207雷科","110/07/29","康和-台中",0,15,-15
"4939","6207雷科","110/07/29","台新-中壢",11,0,11
"4940","6207雷科","110/07/29","凱基-竹科",0,13,-13
"4941","6207雷科","110/07/29","台灣企銀-竹北",10,0,10
"4942","6207雷科","110/07/29","元大-鳳中",0,12,-12
"4943","6207雷科","110/07/29","宏遠證券",10,0,10
"4944","6207雷科","110/07/29","元大-土城",0,12,-12
"4945","6207雷科","110/07/29","中國信託-忠孝",10,0,10
"4946","6207雷科","110/07/29","華南永昌-高雄",0,11,-11
"4947","6207雷科","110/07/29","大昌-桃園",11,1,10
"4948","6207雷科","110/07/29","元大-木柵",0,10,-10
"4949","6207雷科","110/07/29","玉山-城中",11,1,10
"4950","6207雷科","110/07/29","日盛-板橋",1,10,-9
"4951","3679新至陞","110/07/29","華南永昌-淡水",5,0,5
"4952","3679新至陞","110/07/29","元富-板橋",0,16,-16
"4953","3679新至陞","110/07/29","富邦-新竹華信",5,0,5
"4954","3679新至陞","110/07/29","凱基-台北",0,8,-8
"4955","3679新至陞","110/07/29","永豐金-中和",5,0,5
"4956","3679新至陞","110/07/29","摩根大通",1,6,-5
"4957","3679新至陞","110/07/29","富邦-台北",4,0,4
"4958","3679新至陞","110/07/29","美林",0,4,-4
"4959","3679新至陞","110/07/29","元富-彰化",2,0,2
"4960","3679新至陞","110/07/29","瑞士信貸",0,4,-4
"4961","3679新至陞","110/07/29","兆豐-台中港",2,0,2
"4962","3679新至陞","110/07/29","元大-成功",0,3,-3
"4963","3679新至陞","110/07/29","富邦-三重",2,0,2
"4964","3679新至陞","110/07/29","統一-台南",0,2,-2
"4965","3679新至陞","110/07/29","元大-沙鹿",2,0,2
"4966","3679新至陞","110/07/29","元富-新興",0,2,-2
"4967","3679新至陞","110/07/29","元大-福營",2,0,2
"4968","3679新至陞","110/07/29","凱基-竹科",0,2,-2
"4969","3679新至陞","110/07/29","元大-花蓮",2,0,2
"4970","3679新至陞","110/07/29","元大證券",0,2,-2
"4971","3679新至陞","110/07/29","元大-板橋",2,0,2
"4972","3679新至陞","110/07/29","日盛-北高雄",0,1,-1
"4973","3679新至陞","110/07/29","永豐金-台南",2,0,2
"4974","3679新至陞","110/07/29","宏遠-高雄",0,1,-1
"4975","3679新至陞","110/07/29","合庫-彰化",1,0,1
"4976","3679新至陞","110/07/29","花旗環球",0,1,-1
"4977","3679新至陞","110/07/29","臺銀-臺南",1,0,1
"4978","3679新至陞","110/07/29","華南永昌-岡山",0,1,-1
"4979","3679新至陞","110/07/29","永興-水湳",1,0,1
"4980","3679新至陞","110/07/29","元大-佳里",0,1,-1
"4981","2727王品","110/07/29","第一金",30,0,30
"4982","2727王品","110/07/29","元大-高雄",1,93,-92
"4983","2727王品","110/07/29","港商麥格理",22,0,22
"4984","2727王品","110/07/29","新加坡商瑞銀",5,82,-77
"4985","2727王品","110/07/29","國票-北高雄",24,2,22
"4986","2727王品","110/07/29","美林",0,27,-27
"4987","2727王品","110/07/29","日盛-忠孝",21,0,21
"4988","2727王品","110/07/29","港商野村",21,48,-27
"4989","2727王品","110/07/29","新光",22,3,19
"4990","2727王品","110/07/29","凱基-台北",43,61,-18
"4991","2727王品","110/07/29","國泰-敦南",18,7,11
"4992","2727王品","110/07/29","華南永昌-麻豆",0,18,-18
"4993","2727王品","110/07/29","凱基-五股",11,0,11
"4994","2727王品","110/07/29","國泰-台中",2,17,-15
"4995","2727王品","110/07/29","兆豐-鹿港",12,2,10
"4996","2727王品","110/07/29","永豐金-桃盛",0,15,-15
"4997","2727王品","110/07/29","凱基-埔墘",10,0,10
"4998","2727王品","110/07/29","美商高盛",1,15,-14
"4999","2727王品","110/07/29","永豐金-潮州",10,0,10
"5000","2727王品","110/07/29","玉山證券",4,15,-11
"5001","2727王品","110/07/29","統一",12,4,8
"5002","2727王品","110/07/29","摩根大通",12,22,-10
"5003","2727王品","110/07/29","國泰-板橋",7,0,7
"5004","2727王品","110/07/29","元大-四維",2,12,-10
"5005","2727王品","110/07/29","彰銀-台中",7,1,6
"5006","2727王品","110/07/29","凱基-興隆",0,9,-9
"5007","2727王品","110/07/29","新光-高雄",12,6,6
"5008","2727王品","110/07/29","瑞士信貸",0,8,-8
"5009","2727王品","110/07/29","玉山-數位",6,0,6
"5010","2727王品","110/07/29","大昌-桃園",0,7,-7
"5011","1570力肯","110/07/29","群益金鼎-高雄",20,0,20
"5012","1570力肯","110/07/29","聯邦-興中",0,17,-17
"5013","1570力肯","110/07/29","群益金鼎-板橋",16,0,16
"5014","1570力肯","110/07/29","富邦-建國",0,10,-10
"5015","1570力肯","110/07/29","統一-敦南",5,0,5
"5016","1570力肯","110/07/29","凱基-站前",0,5,-5
"5017","1570力肯","110/07/29","元富-松德",4,0,4
"5018","1570力肯","110/07/29","國泰-板橋",0,4,-4
"5019","1570力肯","110/07/29","元大-和平",4,0,4
"5020","1570力肯","110/07/29","統一-土城",0,3,-3
"5021","1570力肯","110/07/29","凱基-幸福",3,0,3
"5022","1570力肯","110/07/29","凱基-大里",0,3,-3
"5023","1570力肯","110/07/29","華南永昌-鳳山",3,0,3
"5024","1570力肯","110/07/29","凱基-台北",0,3,-3
"5025","1570力肯","110/07/29","元大-北港",4,2,2
"5026","1570力肯","110/07/29","元大-屏東民生",0,3,-3
"5027","1570力肯","110/07/29","美林",1,0,1
"5028","1570力肯","110/07/29","元富-緯城",0,2,-2
"5029","1570力肯","110/07/29","國泰-台南",1,0,1
"5030","1570力肯","110/07/29","台新-高雄",0,2,-2
"5031","1570力肯","110/07/29","元大-歸仁",1,0,1
"5032","1570力肯","110/07/29","華南永昌-楠梓",0,2,-2
"5033","1570力肯","110/07/29","元大-松山",1,0,1
"5034","1570力肯","110/07/29","元大-北成功",0,2,-2
"5035","1570力肯","110/07/29","元大-文心興安",1,0,1
"5036","1570力肯","110/07/29","元大-板橋",0,2,-2
"5037","1570力肯","110/07/29","元大-東蘆",1,0,1
"5038","1570力肯","110/07/29","統一-台南",0,1,-1
"5039","1570力肯","110/07/29","群益金鼎-鳳山",0,0,0
"5040","1570力肯","110/07/29","台新證券",0,1,-1
"5041","6180橘子","110/07/29","凱基-台北",50,4,46
"5042","6180橘子","110/07/29","兆豐證券",0,95,-95
"5043","6180橘子","110/07/29","花旗環球",25,0,25
"5044","6180橘子","110/07/29","香港上海匯豐",0,74,-74
"5045","6180橘子","110/07/29","瑞士信貸",26,2,24
"5046","6180橘子","110/07/29","福勝",0,24,-24
"5047","6180橘子","110/07/29","兆豐-大同",20,0,20
"5048","6180橘子","110/07/29","第一金-安和",0,20,-20
"5049","6180橘子","110/07/29","新光-台中",17,0,17
"5050","6180橘子","110/07/29","永豐金-敦北",0,18,-18
"5051","6180橘子","110/07/29","元大-南屯",15,0,15
"5052","6180橘子","110/07/29","致和-崇德",0,10,-10
"5053","6180橘子","110/07/29","摩根大通",54,40,14
"5054","6180橘子","110/07/29","玉山-台大",0,10,-10
"5055","6180橘子","110/07/29","玉山-桃園",10,0,10
"5056","6180橘子","110/07/29","元大-四維",0,10,-10
"5057","6180橘子","110/07/29","永豐金-中正",10,0,10
"5058","6180橘子","110/07/29","元大-小港",0,8,-8
"5059","6180橘子","110/07/29","元富-三重",8,0,8
"5060","6180橘子","110/07/29","台灣摩根士丹利",7,13,-6
"5061","6180橘子","110/07/29","國泰-新莊",9,1,8
"5062","6180橘子","110/07/29","群益金鼎-丹鳳",0,6,-6
"5063","6180橘子","110/07/29","元大-木柵",8,0,8
"5064","6180橘子","110/07/29","永豐金-南京",2,8,-6
"5065","6180橘子","110/07/29","國票-敦北法人",7,0,7
"5066","6180橘子","110/07/29","日盛-頭份",5,10,-5
"5067","6180橘子","110/07/29","元大證券",7,0,7
"5068","6180橘子","110/07/29","宏遠-高雄",0,5,-5
"5069","6180橘子","110/07/29","高橋",6,0,6
"5070","6180橘子","110/07/29","第一金-中山",1,5,-4
"5071","2390云辰","110/07/29","元大-永和",561,61,500
"5072","2390云辰","110/07/29","摩根大通",152,377,-225
"5073","2390云辰","110/07/29","台灣摩根士丹利",163,1,162
"5074","2390云辰","110/07/29","元富-同大",3,139,-136
"5075","2390云辰","110/07/29","元大-善化",87,0,87
"5076","2390云辰","110/07/29","豐農",3,128,-125
"5077","2390云辰","110/07/29","元大-草屯",89,6,83
"5078","2390云辰","110/07/29","美商高盛",6,88,-82
"5079","2390云辰","110/07/29","富邦-羅東",74,10,64
"5080","2390云辰","110/07/29","美林",43,112,-69
"5081","2390云辰","110/07/29","元大-鑫永和",61,1,60
"5082","2390云辰","110/07/29","元大-發財",4,61,-57
"5083","2390云辰","110/07/29","元富-高雄",93,40,53
"5084","2390云辰","110/07/29","大慶-泰山",0,51,-51
"5085","2390云辰","110/07/29","台新-左楠",43,1,42
"5086","2390云辰","110/07/29","群益金鼎",5,49,-44
"5087","2390云辰","110/07/29","日盛-永康",35,2,33
"5088","2390云辰","110/07/29","元大-松江",0,40,-40
"5089","2390云辰","110/07/29","玉山-板橋",37,5,32
"5090","2390云辰","110/07/29","統一-新台中",123,161,-38
"5091","2390云辰","110/07/29","日盛-板橋中山",45,15,30
"5092","2390云辰","110/07/29","兆豐-員林",0,35,-35
"5093","2390云辰","110/07/29","元大-大統",30,0,30
"5094","2390云辰","110/07/29","第一金-新竹",1,35,-34
"5095","2390云辰","110/07/29","元大-竹北",30,1,29
"5096","2390云辰","110/07/29","日盛-員林",3,33,-30
"5097","2390云辰","110/07/29","元大-北屯",26,0,26
"5098","2390云辰","110/07/29","新光",40,70,-30
"5099","2390云辰","110/07/29","元大-林園",25,0,25
"5100","2390云辰","110/07/29","永豐金-松山",21,49,-28
"5101","1471首利","110/07/28","美林",138,26,112
"5102","1471首利","110/07/28","玉山-台大",0,234,-234
"5103","1471首利","110/07/28","摩根大通",164,80,84
"5104","1471首利","110/07/28","國票-九鼎",0,149,-149
"5105","1471首利","110/07/28","(牛牛牛)亞-鑫豐",65,0,65
"5106","1471首利","110/07/28","台中銀",0,69,-69
"5107","1471首利","110/07/28","大昌-新店",44,0,44
"5108","1471首利","110/07/28","元大-博愛",0,32,-32
"5109","1471首利","110/07/28","玉山-桃園",69,30,39
"5110","1471首利","110/07/28","凱基-竹北",0,30,-30
"5111","1471首利","110/07/28","兆豐-鹿港",28,0,28
"5112","1471首利","110/07/28","富邦-苗栗",0,30,-30
"5113","1471首利","110/07/28","聯邦-高雄",21,0,21
"5114","1471首利","110/07/28","港商法國興業",0,22,-22
"5115","1471首利","110/07/28","永豐金-中正",21,0,21
"5116","1471首利","110/07/28","國票-安和",0,20,-20
"5117","1471首利","110/07/28","第一金-高雄",16,0,16
"5118","1471首利","110/07/28","華南永昌-苑裡",0,15,-15
"5119","1471首利","110/07/28","統一-桃園",13,0,13
"5120","1471首利","110/07/28","日盛-中壢",0,13,-13
"5121","1471首利","110/07/28","新光-台中",19,6,13
"5122","1471首利","110/07/28","玉山-台南",0,13,-13
"5123","1471首利","110/07/28","彰銀-七賢",11,0,11
"5124","1471首利","110/07/28","凱基-桃園",0,12,-12
"5125","1471首利","110/07/28","第一金-台南",11,0,11
"5126","1471首利","110/07/28","聯邦-雙和",0,11,-11
"5127","1471首利","110/07/28","台新證券",11,0,11
"5128","1471首利","110/07/28","統一-新營",0,10,-10
"5129","1471首利","110/07/28","凱基-東勢",11,0,11
"5130","1471首利","110/07/28","凱基-城中",0,10,-10
"5131","2883開發金","110/07/28","摩根大通",5171,647,4524
"5132","2883開發金","110/07/28","台灣摩根士丹利",921,11451,-10530
"5133","2883開發金","110/07/28","瑞士信貸",4234,62,4172
"5134","2883開發金","110/07/28","美商高盛",522,3615,-3093
"5135","2883開發金","110/07/28","國泰證券",2247,28,2219
"5136","2883開發金","110/07/28","(牛牛牛)亞證券",0,3000,-3000
"5137","2883開發金","110/07/28","元大證券",2306,91,2215
"5138","2883開發金","110/07/28","康和-仁愛",17,3004,-2987
"5139","2883開發金","110/07/28","元富-城東",2203,113,2090
"5140","2883開發金","110/07/28","第一金",18,2301,-2283
"5141","2883開發金","110/07/28","新加坡商瑞銀",1840,81,1759
"5142","2883開發金","110/07/28","凱基-台北",3735,5169,-1434
"5143","2883開發金","110/07/28","永豐金-彰化",1682,27,1655
"5144","2883開發金","110/07/28","宏遠-高雄",4,1420,-1416
"5145","2883開發金","110/07/28","日盛證券",1637,9,1628
"5146","2883開發金","110/07/28","亞東-板橋",507,1722,-1215
"5147","2883開發金","110/07/28","元大-彰化",1183,11,1172
"5148","2883開發金","110/07/28","凱基-豐中",32,1127,-1095
"5149","2883開發金","110/07/28","美林",2507,1378,1129
"5150","2883開發金","110/07/28","群益金鼎-三重",65,993,-928
"5151","2883開發金","110/07/28","華南永昌",1204,239,965
"5152","2883開發金","110/07/28","元大-羅東",30,872,-842
"5153","2883開發金","110/07/28","日盛-台南",816,6,810
"5154","2883開發金","110/07/28","花旗環球",188,1004,-816
"5155","2883開發金","110/07/28","台新-松江",722,40,682
"5156","2883開發金","110/07/28","華南永昌-朴子",33,716,-683
"5157","2883開發金","110/07/28","新光-台中",858,231,627
"5158","2883開發金","110/07/28","元大-永和",31,700,-669
"5159","2883開發金","110/07/28","凱基-員林",634,25,609
"5160","2883開發金","110/07/28","玉山-台南",97,738,-641
"5161","6205詮欣","110/07/28","臺銀",30,0,30
"5162","6205詮欣","110/07/28","台灣摩根士丹利",0,59,-59
"5163","6205詮欣","110/07/28","元大-善化",30,0,30
"5164","6205詮欣","110/07/28","凱基-大安",0,50,-50
"5165","6205詮欣","110/07/28","日盛證券",16,0,16
"5166","6205詮欣","110/07/28","元大-板橋",0,20,-20
"5167","6205詮欣","110/07/28","元大-土城學府",15,3,12
"5168","6205詮欣","110/07/28","摩根大通",17,30,-13
"5169","6205詮欣","110/07/28","臺銀-民權",10,0,10
"5170","6205詮欣","110/07/28","凱基-台北",0,11,-11
"5171","6205詮欣","110/07/28","德信-新營",10,0,10
"5172","6205詮欣","110/07/28","新加坡商瑞銀",0,10,-10
"5173","6205詮欣","110/07/28","福勝",10,0,10
"5174","6205詮欣","110/07/28","第一金-新竹",0,10,-10
"5175","6205詮欣","110/07/28","元大-清水",10,0,10
"5176","6205詮欣","110/07/28","台新-高雄",0,6,-6
"5177","6205詮欣","110/07/28","新光",9,0,9
"5178","6205詮欣","110/07/28","凱基-三多",0,6,-6
"5179","6205詮欣","110/07/28","群益金鼎-屏東",7,0,7
"5180","6205詮欣","110/07/28","美林",2,7,-5
"5181","6205詮欣","110/07/28","元大-汐止",6,0,6
"5182","6205詮欣","110/07/28","瑞士信貸",0,5,-5
"5183","6205詮欣","110/07/28","統一-屏東",5,0,5
"5184","6205詮欣","110/07/28","中國信託-三重",0,5,-5
"5185","6205詮欣","110/07/28","日盛-三重",4,0,4
"5186","6205詮欣","110/07/28","日盛-雙和",0,4,-4
"5187","6205詮欣","110/07/28","亞東-板橋",4,0,4
"5188","6205詮欣","110/07/28","宏遠-光隆",0,4,-4
"5189","6205詮欣","110/07/28","台中銀",4,0,4
"5190","6205詮欣","110/07/28","兆豐-新莊",0,4,-4
"5191","1540喬福","110/07/28","兆豐-北高雄",48,0,48
"5192","1540喬福","110/07/28","合庫-台中",1,60,-59
"5193","1540喬福","110/07/28","兆豐-台中港",33,0,33
"5194","1540喬福","110/07/28","凱基-台北",0,44,-44
"5195","1540喬福","110/07/28","大慶-中壢",19,0,19
"5196","1540喬福","110/07/28","元大-學甲",0,35,-35
"5197","1540喬福","110/07/28","富邦-員林",18,0,18
"5198","1540喬福","110/07/28","統一-新台中",0,26,-26
"5199","1540喬福","110/07/28","(牛牛牛)亞-鑫豐",12,0,12
"5200","1540喬福","110/07/28","新光-新竹",0,21,-21
"5201","1540喬福","110/07/28","元富-文心",10,0,10
"5202","1540喬福","110/07/28","富邦-台北",0,20,-20
"5203","1540喬福","110/07/28","光和-和美",10,0,10
"5204","1540喬福","110/07/28","富邦-南屯",0,20,-20
"5205","1540喬福","110/07/28","永豐金-三重",9,0,9
"5206","1540喬福","110/07/28","元大-鶯歌",0,10,-10
"5207","1540喬福","110/07/28","臺銀-鳳山",8,0,8
"5208","1540喬福","110/07/28","元大-豐原",0,7,-7
"5209","1540喬福","110/07/28","元大-斗六",7,0,7
"5210","1540喬福","110/07/28","大昌-樹林",0,6,-6
"5211","1540喬福","110/07/28","台新-台中",6,0,6
"5212","1540喬福","110/07/28","新光-桃園",0,5,-5
"5213","1540喬福","110/07/28","華南永昌-中正",6,0,6
"5214","1540喬福","110/07/28","凱基-站前",0,5,-5
"5215","1540喬福","110/07/28","永豐金-台中",6,0,6
"5216","1540喬福","110/07/28","臺銀",0,4,-4
"5217","1540喬福","110/07/28","臺銀-民權",5,0,5
"5218","1540喬福","110/07/28","台新證券",0,3,-3
"5219","1540喬福","110/07/28","元富-中原",5,0,5
"5220","1540喬福","110/07/28","台新-高雄",0,3,-3
"5221","2888新光金","110/07/28","臺銀-高雄",3050,3,3047
"5222","2888新光金","110/07/28","摩根大通",2543,11316,-8773
"5223","2888新光金","110/07/28","元富-城東",2019,129,1890
"5224","2888新光金","110/07/28","香港上海匯豐",120,7576,-7456
"5225","2888新光金","110/07/28","元大證券",2106,407,1699
"5226","2888新光金","110/07/28","凱基-台北",1641,5238,-3597
"5227","2888新光金","110/07/28","凱基-台南",1068,33,1035
"5228","2888新光金","110/07/28","新加坡商瑞銀",0,3572,-3572
"5229","2888新光金","110/07/28","彰銀-台中",1098,75,1023
"5230","2888新光金","110/07/28","台灣摩根士丹利",4358,7129,-2771
"5231","2888新光金","110/07/28","元富-城中",1003,0,1003
"5232","2888新光金","110/07/28","元大-大統",103,2853,-2750
"5233","2888新光金","110/07/28","元大-大天母",1113,119,994
"5234","2888新光金","110/07/28","光和",204,2235,-2031
"5235","2888新光金","110/07/28","元大-仁愛",761,1,760
"5236","2888新光金","110/07/28","兆豐-鹿港",80,1755,-1675
"5237","2888新光金","110/07/28","日盛-雙和",927,179,748
"5238","2888新光金","110/07/28","凱基-市政",17,1447,-1430
"5239","2888新光金","110/07/28","元大-大里",648,0,648
"5240","2888新光金","110/07/28","華南永昌-敦南",66,1320,-1254
"5241","2888新光金","110/07/28","凱基-竹科",2665,2026,639
"5242","2888新光金","110/07/28","法銀巴黎",195,1423,-1228
"5243","2888新光金","110/07/28","日盛-高雄",619,11,608
"5244","2888新光金","110/07/28","臺銀",123,1343,-1220
"5245","2888新光金","110/07/28","群益金鼎-海山",710,151,559
"5246","2888新光金","110/07/28","花旗環球",0,865,-865
"5247","2888新光金","110/07/28","台新證券",855,305,550
"5248","2888新光金","110/07/28","元大-鹿港",46,848,-802
"5249","2888新光金","110/07/28","國泰-敦南",774,237,537
"5250","2888新光金","110/07/28","合庫-台中",121,800,-679
"5251","1340勝悅","110/07/28","新光-台南",50,0,50
"5252","1340勝悅","110/07/28","兆豐-南京",0,25,-25
"5253","1340勝悅","110/07/28","臺銀-臺中",6,0,6
"5254","1340勝悅","110/07/28","凱基-台北",0,22,-22
"5255","1340勝悅","110/07/28","新光",6,0,6
"5256","1340勝悅","110/07/28","美林",0,12,-12
"5257","1340勝悅","110/07/28","臺灣企銀-埔墘",5,0,5
"5258","1340勝悅","110/07/28","群益金鼎-台中",0,11,-11
"5259","1340勝悅","110/07/28","國票-敦北法人",5,0,5
"5260","1340勝悅","110/07/28","合庫-西台中",1,10,-9
"5261","1340勝悅","110/07/28","國泰-高雄",5,0,5
"5262","1340勝悅","110/07/28","元大-基隆孝二",0,8,-8
"5263","1340勝悅","110/07/28","國泰-台中",5,0,5
"5264","1340勝悅","110/07/28","統一-城中",0,7,-7
"5265","1340勝悅","110/07/28","群益金鼎-館前",5,0,5
"5266","1340勝悅","110/07/28","凱基-幸福",0,7,-7
"5267","1340勝悅","110/07/28","中國信託-文心",3,0,3
"5268","1340勝悅","110/07/28","臺銀-新竹",0,5,-5
"5269","1340勝悅","110/07/28","群益金鼎-崇德",3,0,3
"5270","1340勝悅","110/07/28","港商法國興業",0,5,-5
"5271","1340勝悅","110/07/28","元大-永春",3,0,3
"5272","1340勝悅","110/07/28","元大-新竹經國",0,5,-5
"5273","1340勝悅","110/07/28","永豐金-松山",3,0,3
"5274","1340勝悅","110/07/28","台新證券",0,4,-4
"5275","1340勝悅","110/07/28","永豐金-嘉義",3,0,3
"5276","1340勝悅","110/07/28","港商野村",0,3,-3
"5277","1340勝悅","110/07/28","日盛-木柵",2,0,2
"5278","1340勝悅","110/07/28","摩根大通",0,3,-3
"5279","1340勝悅","110/07/28","台新-台中",2,0,2
"5280","1340勝悅","110/07/28","富邦-台北",0,3,-3
"5281","6246臺龍","110/07/28","元大-基隆孝二",32,0,32
"5282","6246臺龍","110/07/28","永豐金-桃園",4,135,-131
"5283","6246臺龍","110/07/28","合庫-台中",30,0,30
"5284","6246臺龍","110/07/28","港商野村",5,93,-88
"5285","6246臺龍","110/07/28","元大-木柵",30,0,30
"5286","6246臺龍","110/07/28","凱基-台北",9,65,-56
"5287","6246臺龍","110/07/28","光和",21,0,21
"5288","6246臺龍","110/07/28","元大-西螺",0,31,-31
"5289","6246臺龍","110/07/28","宏遠-民生",20,0,20
"5290","6246臺龍","110/07/28","群益金鼎-鳳山",0,27,-27
"5291","6246臺龍","110/07/28","第一金-安和",20,0,20
"5292","6246臺龍","110/07/28","元大-西屯",0,25,-25
"5293","6246臺龍","110/07/28","兆豐-竹北",24,4,20
"5294","6246臺龍","110/07/28","永豐金-虎尾",6,27,-21
"5295","6246臺龍","110/07/28","凱基-幸福",20,0,20
"5296","6246臺龍","110/07/28","日盛-台中",1,20,-19
"5297","6246臺龍","110/07/28","德信-新營",19,0,19
"5298","6246臺龍","110/07/28","統一",0,16,-16
"5299","6246臺龍","110/07/28","台新證券",21,4,17
"5300","6246臺龍","110/07/28","群益金鼎-土城",0,16,-16
"5301","6246臺龍","110/07/28","華南永昌-公誠",17,0,17
"5302","6246臺龍","110/07/28","元大-員林",0,15,-15
"5303","6246臺龍","110/07/28","中國信託-文心",15,0,15
"5304","6246臺龍","110/07/28","華南永昌-長虹",0,11,-11
"5305","6246臺龍","110/07/28","群益金鼎-崇德",15,0,15
"5306","6246臺龍","110/07/28","日盛-中壢",0,10,-10
"5307","6246臺龍","110/07/28","兆豐-公益",12,0,12
"5308","6246臺龍","110/07/28","第一金-彰化",0,10,-10
"5309","6246臺龍","110/07/28","國票",12,0,12
"5310","6246臺龍","110/07/28","元富-中原",0,10,-10
"5311","00715L期街口布蘭特正2","110/07/28","永豐金證券",5725,30,5695
"5312","00715L期街口布蘭特正2","110/07/28","元大-四維",0,2013,-2013
"5313","00715L期街口布蘭特正2","110/07/28","元大證券",5235,705,4530
"5314","00715L期街口布蘭特正2","110/07/28","凱基-豐中",0,1536,-1536
"5315","00715L期街口布蘭特正2","110/07/28","國票",2733,11,2722
"5316","00715L期街口布蘭特正2","110/07/28","華南永昌-東昇",0,1010,-1010
"5317","00715L期街口布蘭特正2","110/07/28","富邦證券",2340,417,1923
"5318","00715L期街口布蘭特正2","110/07/28","兆豐-三民",0,1004,-1004
"5319","00715L期街口布蘭特正2","110/07/28","凱基-台北",2241,325,1916
"5320","00715L期街口布蘭特正2","110/07/28","元富-古亭",0,600,-600
"5321","00715L期街口布蘭特正2","110/07/28","統一",1635,132,1503
"5322","00715L期街口布蘭特正2","110/07/28","台新-新營",20,558,-538
"5323","00715L期街口布蘭特正2","110/07/28","國票-中港",1500,0,1500
"5324","00715L期街口布蘭特正2","110/07/28","富邦-台北",0,453,-453
"5325","00715L期街口布蘭特正2","110/07/28","兆豐-台中",525,6,519
"5326","00715L期街口布蘭特正2","110/07/28","港商野村",71,519,-448
"5327","00715L期街口布蘭特正2","110/07/28","合庫證券",1008,500,508
"5328","00715L期街口布蘭特正2","110/07/28","第一金-自由",10,405,-395
"5329","00715L期街口布蘭特正2","110/07/28","永豐金-三重",500,0,500
"5330","00715L期街口布蘭特正2","110/07/28","玉山-高雄",17,387,-370
"5331","00715L期街口布蘭特正2","110/07/28","凱基-市政",500,1,499
"5332","00715L期街口布蘭特正2","110/07/28","統一-桃園",0,331,-331
"5333","00715L期街口布蘭特正2","110/07/28","元富-大裕",500,8,492
"5334","00715L期街口布蘭特正2","110/07/28","元富-中壢",0,309,-309
"5335","00715L期街口布蘭特正2","110/07/28","永豐金-內湖",503,18,485
"5336","00715L期街口布蘭特正2","110/07/28","台新證券",21,329,-308
"5337","00715L期街口布蘭特正2","110/07/28","元富-吉利",280,0,280
"5338","00715L期街口布蘭特正2","110/07/28","國票-台中",0,275,-275
"5339","00715L期街口布蘭特正2","110/07/28","國票-博愛",200,0,200
"5340","00715L期街口布蘭特正2","110/07/28","日盛-木柵",0,268,-268
"5341","8941關中","110/07/28","第一金-台南",2,0,2
"5342","8941關中","110/07/28","聯邦-富強",0,3,-3
"5343","8941關中","110/07/28","元大-西屯",2,0,2
"5344","8941關中","110/07/28","富邦-員林",0,3,-3
"5345","8941關中","110/07/28","玉山證券",1,0,1
"5346","8941關中","110/07/28","第一金-安和",0,2,-2
"5347","8941關中","110/07/28","國泰-忠孝",1,0,1
"5348","8941關中","110/07/28","第一金-台中",0,1,-1
"5349","8941關中","110/07/28","凱基-岡山",1,0,1
"5350","8941關中","110/07/28","玉山-台中",0,0,0
"5351","8941關中","110/07/28","富邦-羅東",1,0,1
"5352","8941關中","110/07/28","元大-新竹經國",0,0,0
"5353","8941關中","110/07/28","永豐金-敦南",1,0,1
"5354","8941關中","110/07/28","元大-桃興",1,1,0
"5355","8941關中","110/07/28","玉山-台中",0,0,0
"5356","8941關中","110/07/28","",NA,NA,NA
"5357","8941關中","110/07/28","元大-新竹經國",0,0,0
"5358","8941關中","110/07/28","",NA,NA,NA
"5359","8941關中","110/07/28","元大-桃興",1,1,0
"5360","8941關中","110/07/28","",NA,NA,NA
"5361","8941關中","110/07/28","",NA,NA,NA
"5362","8941關中","110/07/28","",NA,NA,NA
"5363","8941關中","110/07/28","",NA,NA,NA
"5364","8941關中","110/07/28","",NA,NA,NA
"5365","8941關中","110/07/28","",NA,NA,NA
"5366","8941關中","110/07/28","",NA,NA,NA
"5367","8941關中","110/07/28","",NA,NA,NA
"5368","8941關中","110/07/28","",NA,NA,NA
"5369","8941關中","110/07/28","",NA,NA,NA
"5370","8941關中","110/07/28","",NA,NA,NA
"5371","8936國統","110/07/28","宏遠-高雄",141,1,140
"5372","8936國統","110/07/28","摩根大通",82,517,-435
"5373","8936國統","110/07/28","日盛-景美",100,0,100
"5374","8936國統","110/07/28","凱基-台北",5,290,-285
"5375","8936國統","110/07/28","永豐金-苓雅",67,0,67
"5376","8936國統","110/07/28","瑞士信貸",0,245,-245
"5377","8936國統","110/07/28","玉山-台南",64,0,64
"5378","8936國統","110/07/28","台灣摩根士丹利",16,176,-160
"5379","8936國統","110/07/28","國票-北高雄",61,1,60
"5380","8936國統","110/07/28","凱基-市政",11,110,-99
"5381","8936國統","110/07/28","玉山-高雄",49,0,49
"5382","8936國統","110/07/28","元大-東蘆",0,82,-82
"5383","8936國統","110/07/28","元大-小港",47,0,47
"5384","8936國統","110/07/28","新加坡商瑞銀",128,205,-77
"5385","8936國統","110/07/28","元大-台中",40,0,40
"5386","8936國統","110/07/28","元大-歸仁",30,75,-45
"5387","8936國統","110/07/28","新光-台中",41,7,34
"5388","8936國統","110/07/28","台新-台中",17,55,-38
"5389","8936國統","110/07/28","元大-豐原站前",32,0,32
"5390","8936國統","110/07/28","康和",20,58,-38
"5391","8936國統","110/07/28","玉山-台中",31,0,31
"5392","8936國統","110/07/28","第一金-新興",0,31,-31
"5393","8936國統","110/07/28","富邦-高雄",26,0,26
"5394","8936國統","110/07/28","元富-松德",0,30,-30
"5395","8936國統","110/07/28","元大-鳳中",30,5,25
"5396","8936國統","110/07/28","元大-中和",2,30,-28
"5397","8936國統","110/07/28","元富-林園",20,0,20
"5398","8936國統","110/07/28","兆豐-嘉義",0,22,-22
"5399","8936國統","110/07/28","兆豐-北高雄",20,0,20
"5400","8936國統","110/07/28","美林",11,32,-21
"5401","6226光鼎","110/07/28","群益金鼎-萬華",147,14,133
"5402","6226光鼎","110/07/28","群益金鼎-敦南",5,282,-277
"5403","6226光鼎","110/07/28","台新-台中",227,114,113
"5404","6226光鼎","110/07/28","華南永昌",19,142,-123
"5405","6226光鼎","110/07/28","摩根大通",109,0,109
"5406","6226光鼎","110/07/28","康和-台北",0,100,-100
"5407","6226光鼎","110/07/28","統一",107,0,107
"5408","6226光鼎","110/07/28","臺銀-民權",4,100,-96
"5409","6226光鼎","110/07/28","凱基-台北",103,1,102
"5410","6226光鼎","110/07/28","元大-潮州",11,102,-91
"5411","6226光鼎","110/07/28","台灣摩根士丹利",104,7,97
"5412","6226光鼎","110/07/28","華南永昌-嘉義",50,130,-80
"5413","6226光鼎","110/07/28","群益金鼎-館前",97,0,97
"5414","6226光鼎","110/07/28","台新證券",79,153,-74
"5415","6226光鼎","110/07/28","國泰-台中",97,20,77
"5416","6226光鼎","110/07/28","玉山-台南",4,74,-70
"5417","6226光鼎","110/07/28","元大-嘉義",83,16,67
"5418","6226光鼎","110/07/28","臺銀-臺中",6,65,-59
"5419","6226光鼎","110/07/28","新光-桃園",69,8,61
"5420","6226光鼎","110/07/28","富邦-仁愛",6,63,-57
"5421","6226光鼎","110/07/28","群益金鼎-三重",59,2,57
"5422","6226光鼎","110/07/28","凱基-大里",0,51,-51
"5423","6226光鼎","110/07/28","日盛-員林",63,12,51
"5424","6226光鼎","110/07/28","國泰-敦南",116,166,-50
"5425","6226光鼎","110/07/28","永豐金-松山",66,20,46
"5426","6226光鼎","110/07/28","元富-中港",2,51,-49
"5427","6226光鼎","110/07/28","統一-內湖",48,7,41
"5428","6226光鼎","110/07/28","群益金鼎-延平",0,49,-49
"5429","6226光鼎","110/07/28","凱基-高美館",51,10,41
"5430","6226光鼎","110/07/28","元大-新竹經國",5,53,-48
"5431","2363矽統","110/07/28","摩根大通",809,282,527
"5432","2363矽統","110/07/28","國泰-敦南",145,861,-716
"5433","2363矽統","110/07/28","美商高盛",532,264,268
"5434","2363矽統","110/07/28","元大-台中",18,384,-366
"5435","2363矽統","110/07/28","台新-三民",263,18,245
"5436","2363矽統","110/07/28","新光",197,525,-328
"5437","2363矽統","110/07/28","台新證券",929,703,226
"5438","2363矽統","110/07/28","群益金鼎-三民",24,266,-242
"5439","2363矽統","110/07/28","第一金-嘉義",154,0,154
"5440","2363矽統","110/07/28","凱基-斗六",0,187,-187
"5441","2363矽統","110/07/28","凱基-台北",1039,889,150
"5442","2363矽統","110/07/28","元大-上新莊",3,134,-131
"5443","2363矽統","110/07/28","永豐金-竹科",132,11,121
"5444","2363矽統","110/07/28","永豐金-彰化",5,134,-129
"5445","2363矽統","110/07/28","華南永昌-鳳山",146,34,112
"5446","2363矽統","110/07/28","日盛-二林",15,142,-127
"5447","2363矽統","110/07/28","第一金-新興",108,1,107
"5448","2363矽統","110/07/28","元大證券",18,125,-107
"5449","2363矽統","110/07/28","港商野村",673,568,105
"5450","2363矽統","110/07/28","新光-台南",25,129,-104
"5451","2363矽統","110/07/28","群益金鼎-桃園",111,11,100
"5452","2363矽統","110/07/28","統一",7,109,-102
"5453","2363矽統","110/07/28","台新-左楠",94,15,79
"5454","2363矽統","110/07/28","康和-南崁",11,108,-97
"5455","2363矽統","110/07/28","新加坡商瑞銀",789,711,78
"5456","2363矽統","110/07/28","國票",25,121,-96
"5457","2363矽統","110/07/28","國票-九鼎",99,26,73
"5458","2363矽統","110/07/28","群益金鼎-敦南",11,107,-96
"5459","2363矽統","110/07/28","兆豐-埔墘",62,0,62
"5460","2363矽統","110/07/28","兆豐-寶成",2,79,-77
"5461","8112至上","110/07/28","摩根大通",630,183,447
"5462","8112至上","110/07/28","永豐金-永康",0,242,-242
"5463","8112至上","110/07/28","合庫證券",317,21,296
"5464","8112至上","110/07/28","高橋",3,222,-219
"5465","8112至上","110/07/28","新加坡商瑞銀",417,132,285
"5466","8112至上","110/07/28","玉山證券",2,206,-204
"5467","8112至上","110/07/28","台灣摩根士丹利",253,58,195
"5468","8112至上","110/07/28","新光",50,206,-156
"5469","8112至上","110/07/28","港商野村",350,164,186
"5470","8112至上","110/07/28","永豐金-苓雅",2,102,-100
"5471","8112至上","110/07/28","美商高盛",184,7,177
"5472","8112至上","110/07/28","凱基-永和",0,80,-80
"5473","8112至上","110/07/28","美林",213,53,160
"5474","8112至上","110/07/28","華南永昌-新莊",60,134,-74
"5475","8112至上","110/07/28","花旗環球",86,16,70
"5476","8112至上","110/07/28","台新-松江",27,90,-63
"5477","8112至上","110/07/28","玉山-板橋",82,17,65
"5478","8112至上","110/07/28","宏遠證券",1,50,-49
"5479","8112至上","110/07/28","凱基-竹科",67,3,64
"5480","8112至上","110/07/28","元大-苑裡",23,72,-49
"5481","8112至上","110/07/28","元大-府城",56,0,56
"5482","8112至上","110/07/28","元大-基隆孝二",5,53,-48
"5483","8112至上","110/07/28","永豐金-內湖",37,0,37
"5484","8112至上","110/07/28","康和-仁愛",5,51,-46
"5485","8112至上","110/07/28","瑞士信貸",58,26,32
"5486","8112至上","110/07/28","台新證券",31,73,-42
"5487","8112至上","110/07/28","元大證券",60,29,31
"5488","8112至上","110/07/28","兆豐-公益",0,40,-40
"5489","8112至上","110/07/28","元富-新店",35,5,30
"5490","8112至上","110/07/28","中國信託-忠孝",1,37,-36
"5491","1570力肯","110/07/28","國泰-敦南",50,0,50
"5492","1570力肯","110/07/28","元大-高雄",0,42,-42
"5493","1570力肯","110/07/28","群益金鼎-高雄",31,0,31
"5494","1570力肯","110/07/28","國票-新莊",0,14,-14
"5495","1570力肯","110/07/28","元富-延平",15,0,15
"5496","1570力肯","110/07/28","凱基-站前",0,10,-10
"5497","1570力肯","110/07/28","(牛牛牛)亞-鑫豐",10,0,10
"5498","1570力肯","110/07/28","凱基-台北",0,10,-10
"5499","1570力肯","110/07/28","元富-緯城",6,0,6
"5500","1570力肯","110/07/28","元大-忠孝",0,10,-10
"5501","1570力肯","110/07/28","合庫-自強",5,0,5
"5502","1570力肯","110/07/28","台灣摩根士丹利",0,9,-9
"5503","1570力肯","110/07/28","臺銀-臺南",4,0,4
"5504","1570力肯","110/07/28","群益金鼎-板橋",0,8,-8
"5505","1570力肯","110/07/28","兆豐-台中港",3,0,3
"5506","1570力肯","110/07/28","永豐金-大園",0,7,-7
"5507","1570力肯","110/07/28","日盛-板橋",2,0,2
"5508","1570力肯","110/07/28","元大-台南",0,5,-5
"5509","1570力肯","110/07/28","統一-松江",2,0,2
"5510","1570力肯","110/07/28","合庫-台中",0,4,-4
"5511","1570力肯","110/07/28","台新-三民",2,0,2
"5512","1570力肯","110/07/28","富邦-板橋",0,3,-3
"5513","1570力肯","110/07/28","群益金鼎-土城",2,0,2
"5514","1570力肯","110/07/28","元大-板橋",0,3,-3
"5515","1570力肯","110/07/28","元大-和平",2,0,2
"5516","1570力肯","110/07/28","統一-桃園",0,2,-2
"5517","1570力肯","110/07/28","元大-土城永寧",2,0,2
"5518","1570力肯","110/07/28","凱基-三多",0,2,-2
"5519","1570力肯","110/07/28","大昌-樹林",1,0,1
"5520","1570力肯","110/07/28","華南永昌-高雄",0,2,-2
"5521","2929淘帝","110/07/28","日盛-八德",40,0,40
"5522","2929淘帝","110/07/28","凱基-林口",0,150,-150
"5523","2929淘帝","110/07/28","玉山-新竹",30,0,30
"5524","2929淘帝","110/07/28","日盛-台中",0,35,-35
"5525","2929淘帝","110/07/28","國泰-松江",33,3,30
"5526","2929淘帝","110/07/28","永豐金-永康",0,21,-21
"5527","2929淘帝","110/07/28","元大-民生",28,0,28
"5528","2929淘帝","110/07/28","新加坡商瑞銀",13,32,-19
"5529","2929淘帝","110/07/28","合庫-高雄",21,0,21
"5530","2929淘帝","110/07/28","國泰-敦南",2,20,-18
"5531","2929淘帝","110/07/28","華南永昌",20,0,20
"5532","2929淘帝","110/07/28","臺銀",2,17,-15
"5533","2929淘帝","110/07/28","台新證券",12,0,12
"5534","2929淘帝","110/07/28","群益金鼎-敦南",0,13,-13
"5535","2929淘帝","110/07/28","第一金-大稻埕",10,0,10
"5536","2929淘帝","110/07/28","富邦-建國",1,13,-12
"5537","2929淘帝","110/07/28","華南永昌-台中",10,0,10
"5538","2929淘帝","110/07/28","元富-城東",0,10,-10
"5539","2929淘帝","110/07/28","元大-士林",10,0,10
"5540","2929淘帝","110/07/28","兆豐-景美",0,8,-8
"5541","2929淘帝","110/07/28","元大-屏南",10,0,10
"5542","2929淘帝","110/07/28","美林",3,10,-7
"5543","2929淘帝","110/07/28","元大-員林",10,0,10
"5544","2929淘帝","110/07/28","元富-彰化",0,7,-7
"5545","2929淘帝","110/07/28","新光-桃園",9,0,9
"5546","2929淘帝","110/07/28","港商法國興業",0,6,-6
"5547","2929淘帝","110/07/28","日盛-景美",7,0,7
"5548","2929淘帝","110/07/28","新光-高雄",0,6,-6
"5549","2929淘帝","110/07/28","玉山證券",7,0,7
"5550","2929淘帝","110/07/28","港商野村",3,8,-5
"5551","5410國眾","110/07/28","兆豐-城中",38,0,38
"5552","5410國眾","110/07/28","兆豐-南門",3,80,-77
"5553","5410國眾","110/07/28","大展",20,0,20
"5554","5410國眾","110/07/28","摩根大通",12,56,-44
"5555","5410國眾","110/07/28","新光-桃園",20,0,20
"5556","5410國眾","110/07/28","凱基-台北",0,28,-28
"5557","5410國眾","110/07/28","凱基-竹北",20,0,20
"5558","5410國眾","110/07/28","亞東-板橋",0,20,-20
"5559","5410國眾","110/07/28","元大-新莊",17,0,17
"5560","5410國眾","110/07/28","統一-新台中",0,20,-20
"5561","5410國眾","110/07/28","新光",20,8,12
"5562","5410國眾","110/07/28","瑞士信貸",0,16,-16
"5563","5410國眾","110/07/28","國泰-敦南",11,0,11
"5564","5410國眾","110/07/28","新加坡商瑞銀",0,15,-15
"5565","5410國眾","110/07/28","日盛-內湖",10,0,10
"5566","5410國眾","110/07/28","統一-金門",0,15,-15
"5567","5410國眾","110/07/28","元富-新竹",10,0,10
"5568","5410國眾","110/07/28","元大-北投",0,12,-12
"5569","5410國眾","110/07/28","群益金鼎-永和",10,0,10
"5570","5410國眾","110/07/28","新百王",0,10,-10
"5571","5410國眾","110/07/28","華南永昌-中正",10,0,10
"5572","5410國眾","110/07/28","元大-館前",0,10,-10
"5573","5410國眾","110/07/28","元大-旗山",10,0,10
"5574","5410國眾","110/07/28","元富-安南",0,9,-9
"5575","5410國眾","110/07/28","元大-大天母",10,0,10
"5576","5410國眾","110/07/28","元大-龍潭",1,10,-9
"5577","5410國眾","110/07/28","大昌",9,0,9
"5578","5410國眾","110/07/28","港商野村",1,7,-6
"5579","5410國眾","110/07/28","臺銀-鳳山",8,0,8
"5580","5410國眾","110/07/28","元大-東泰",0,6,-6
"5581","2841台開","110/07/28","台新-台中",36,0,36
"5582","2841台開","110/07/28","元大-大雅",0,90,-90
"5583","2841台開","110/07/28","群益金鼎-大甲",24,0,24
"5584","2841台開","110/07/28","凱基-台北",0,73,-73
"5585","2841台開","110/07/28","永豐金-敦南",29,8,21
"5586","2841台開","110/07/28","港商野村",0,27,-27
"5587","2841台開","110/07/28","第一金-台中",20,0,20
"5588","2841台開","110/07/28","大慶-富順",0,20,-20
"5589","2841台開","110/07/28","元富-烏日",20,0,20
"5590","2841台開","110/07/28","豐農",0,17,-17
"5591","2841台開","110/07/28","元大-歸仁",20,0,20
"5592","2841台開","110/07/28","元大-大里德芳",0,15,-15
"5593","2841台開","110/07/28","永豐金-豐原",20,0,20
"5594","2841台開","110/07/28","日盛-大墩",0,10,-10
"5595","2841台開","110/07/28","日盛-花蓮",15,0,15
"5596","2841台開","110/07/28","元大-博愛",0,10,-10
"5597","2841台開","110/07/28","大昌-安康",18,3,15
"5598","2841台開","110/07/28","元大-豐原站前",0,10,-10
"5599","2841台開","110/07/28","陽信-石牌",13,0,13
"5600","2841台開","110/07/28","台新證券",6,13,-7
"5601","2841台開","110/07/28","台灣摩根士丹利",10,0,10
"5602","2841台開","110/07/28","台中銀",0,5,-5
"5603","2841台開","110/07/28","台新-高雄",10,0,10
"5604","2841台開","110/07/28","中國信託-中壢",0,5,-5
"5605","2841台開","110/07/28","國泰-忠孝",10,0,10
"5606","2841台開","110/07/28","元大-大同",0,5,-5
"5607","2841台開","110/07/28","元大-竹南",10,0,10
"5608","2841台開","110/07/28","元大-大益",0,4,-4
"5609","2841台開","110/07/28","元大-屏南",9,0,9
"5610","2841台開","110/07/28","元富-松德",0,3,-3
"5611","6207雷科","110/07/28","新加坡商瑞銀",153,44,109
"5612","6207雷科","110/07/28","康和-延平",0,48,-48
"5613","6207雷科","110/07/28","摩根大通",219,131,88
"5614","6207雷科","110/07/28","元富-大昌",0,33,-33
"5615","6207雷科","110/07/28","康和-台中",70,0,70
"5616","6207雷科","110/07/28","聯邦商銀",0,30,-30
"5617","6207雷科","110/07/28","凱基-台北",112,49,63
"5618","6207雷科","110/07/28","兆豐-三民",1,30,-29
"5619","6207雷科","110/07/28","凱基-復興",63,3,60
"5620","6207雷科","110/07/28","元大-龍潭",0,25,-25
"5621","6207雷科","110/07/28","群益金鼎-三民",59,8,51
"5622","6207雷科","110/07/28","宏遠證券",0,23,-23
"5623","6207雷科","110/07/28","永豐金-羅東",50,0,50
"5624","6207雷科","110/07/28","大昌-桃園",15,36,-21
"5625","6207雷科","110/07/28","美林",46,3,43
"5626","6207雷科","110/07/28","國泰-桃園",0,21,-21
"5627","6207雷科","110/07/28","群益金鼎-敦南",51,16,35
"5628","6207雷科","110/07/28","凱基-中壢",0,21,-21
"5629","6207雷科","110/07/28","日盛-忠孝",31,0,31
"5630","6207雷科","110/07/28","富邦-台北",4,24,-20
"5631","6207雷科","110/07/28","港商野村",32,8,24
"5632","6207雷科","110/07/28","臺銀-臺南",0,19,-19
"5633","6207雷科","110/07/28","群益金鼎-東門",22,0,22
"5634","6207雷科","110/07/28","新光",5,24,-19
"5635","6207雷科","110/07/28","統一-高雄",41,20,21
"5636","6207雷科","110/07/28","群益金鼎-大甲",1,20,-19
"5637","6207雷科","110/07/28","群益金鼎-延平",21,0,21
"5638","6207雷科","110/07/28","元大-中壢",10,28,-18
"5639","6207雷科","110/07/28","彰銀-台中",20,0,20
"5640","6207雷科","110/07/28","永豐金-北高雄",3,20,-17
"5641","3679新至陞","110/07/28","華南永昌-淡水",10,0,10
"5642","3679新至陞","110/07/28","瑞士信貸",0,25,-25
"5643","3679新至陞","110/07/28","富邦-嘉義",10,0,10
"5644","3679新至陞","110/07/28","凱基-台北",6,14,-8
"5645","3679新至陞","110/07/28","台中銀-員林",11,2,9
"5646","3679新至陞","110/07/28","美林",5,12,-7
"5647","3679新至陞","110/07/28","大昌-樹林",7,0,7
"5648","3679新至陞","110/07/28","摩根大通",5,11,-6
"5649","3679新至陞","110/07/28","康和-澎湖",5,0,5
"5650","3679新至陞","110/07/28","兆豐-新莊",0,5,-5
"5651","3679新至陞","110/07/28","富邦-台北",5,0,5
"5652","3679新至陞","110/07/28","群益金鼎-新莊",0,5,-5
"5653","3679新至陞","110/07/28","元大-成功",5,0,5
"5654","3679新至陞","110/07/28","台灣摩根士丹利",0,4,-4
"5655","3679新至陞","110/07/28","新加坡商瑞銀",3,0,3
"5656","3679新至陞","110/07/28","日盛-新竹",0,3,-3
"5657","3679新至陞","110/07/28","中國信託-新竹",3,0,3
"5658","3679新至陞","110/07/28","群益金鼎-東門",0,3,-3
"5659","3679新至陞","110/07/28","元大-新莊",3,0,3
"5660","3679新至陞","110/07/28","元大證券",0,3,-3
"5661","3679新至陞","110/07/28","宏遠-光隆",2,0,2
"5662","3679新至陞","110/07/28","元大-忠孝",0,3,-3
"5663","3679新至陞","110/07/28","大慶-蘆洲",2,0,2
"5664","3679新至陞","110/07/28","合庫-西台中",0,2,-2
"5665","3679新至陞","110/07/28","台新-左楠",2,0,2
"5666","3679新至陞","110/07/28","日盛-板橋",0,2,-2
"5667","3679新至陞","110/07/28","群益金鼎-三重",2,0,2
"5668","3679新至陞","110/07/28","國票-桃園",0,2,-2
"5669","3679新至陞","110/07/28","華南永昌-高雄",2,0,2
"5670","3679新至陞","110/07/28","台新-台南",0,2,-2
"5671","2727王品","110/07/28","凱基-台北",139,50,89
"5672","2727王品","110/07/28","新光-台中",9,68,-59
"5673","2727王品","110/07/28","美林",77,10,67
"5674","2727王品","110/07/28","瑞士信貸",16,54,-38
"5675","2727王品","110/07/28","港商野村",118,64,54
"5676","2727王品","110/07/28","華南永昌",4,41,-37
"5677","2727王品","110/07/28","國泰-敦南",51,30,21
"5678","2727王品","110/07/28","美商高盛",2,30,-28
"5679","2727王品","110/07/28","新加坡商瑞銀",58,38,20
"5680","2727王品","110/07/28","富邦-板橋",17,38,-21
"5681","2727王品","110/07/28","永豐金-中盛",24,4,20
"5682","2727王品","110/07/28","富邦-竹北",0,20,-20
"5683","2727王品","110/07/28","元大-南崁",20,2,18
"5684","2727王品","110/07/28","元大-小港",1,21,-20
"5685","2727王品","110/07/28","摩根大通",48,32,16
"5686","2727王品","110/07/28","凱基",0,18,-18
"5687","2727王品","110/07/28","臺銀-高雄",14,0,14
"5688","2727王品","110/07/28","統一",15,31,-16
"5689","2727王品","110/07/28","永豐金-桃盛",19,5,14
"5690","2727王品","110/07/28","國泰-台中",12,28,-16
"5691","2727王品","110/07/28","凱基-內湖",13,0,13
"5692","2727王品","110/07/28","元大-台中",7,22,-15
"5693","2727王品","110/07/28","永豐金-中正",15,2,13
"5694","2727王品","110/07/28","華南永昌-麻豆",0,14,-14
"5695","2727王品","110/07/28","富邦-建國",18,7,11
"5696","2727王品","110/07/28","永豐金-豐原",1,15,-14
"5697","2727王品","110/07/28","富邦-陽明",15,5,10
"5698","2727王品","110/07/28","國票-內壢",1,14,-13
"5699","2727王品","110/07/28","元大-南京",10,0,10
"5700","2727王品","110/07/28","永豐金證券",2,15,-13
"5701","1570力肯","110/07/28","國泰-敦南",50,0,50
"5702","1570力肯","110/07/28","元大-高雄",0,42,-42
"5703","1570力肯","110/07/28","群益金鼎-高雄",31,0,31
"5704","1570力肯","110/07/28","國票-新莊",0,14,-14
"5705","1570力肯","110/07/28","元富-延平",15,0,15
"5706","1570力肯","110/07/28","凱基-站前",0,10,-10
"5707","1570力肯","110/07/28","(牛牛牛)亞-鑫豐",10,0,10
"5708","1570力肯","110/07/28","凱基-台北",0,10,-10
"5709","1570力肯","110/07/28","元富-緯城",6,0,6
"5710","1570力肯","110/07/28","元大-忠孝",0,10,-10
"5711","1570力肯","110/07/28","合庫-自強",5,0,5
"5712","1570力肯","110/07/28","台灣摩根士丹利",0,9,-9
"5713","1570力肯","110/07/28","臺銀-臺南",4,0,4
"5714","1570力肯","110/07/28","群益金鼎-板橋",0,8,-8
"5715","1570力肯","110/07/28","兆豐-台中港",3,0,3
"5716","1570力肯","110/07/28","永豐金-大園",0,7,-7
"5717","1570力肯","110/07/28","日盛-板橋",2,0,2
"5718","1570力肯","110/07/28","元大-台南",0,5,-5
"5719","1570力肯","110/07/28","統一-松江",2,0,2
"5720","1570力肯","110/07/28","合庫-台中",0,4,-4
"5721","1570力肯","110/07/28","台新-三民",2,0,2
"5722","1570力肯","110/07/28","富邦-板橋",0,3,-3
"5723","1570力肯","110/07/28","群益金鼎-土城",2,0,2
"5724","1570力肯","110/07/28","元大-板橋",0,3,-3
"5725","1570力肯","110/07/28","元大-和平",2,0,2
"5726","1570力肯","110/07/28","統一-桃園",0,2,-2
"5727","1570力肯","110/07/28","元大-土城永寧",2,0,2
"5728","1570力肯","110/07/28","凱基-三多",0,2,-2
"5729","1570力肯","110/07/28","大昌-樹林",1,0,1
"5730","1570力肯","110/07/28","華南永昌-高雄",0,2,-2
"5731","6180橘子","110/07/28","凱基-台北",152,85,67
"5732","6180橘子","110/07/28","摩根大通",20,92,-72
"5733","6180橘子","110/07/28","新光",57,18,39
"5734","6180橘子","110/07/28","大慶-台中",0,33,-33
"5735","6180橘子","110/07/28","美商高盛",49,12,37
"5736","6180橘子","110/07/28","兆豐證券",0,25,-25
"5737","6180橘子","110/07/28","第一金-安和",20,0,20
"5738","6180橘子","110/07/28","元大-上新莊",0,22,-22
"5739","6180橘子","110/07/28","元富-桃園",20,0,20
"5740","6180橘子","110/07/28","新加坡商瑞銀",23,44,-21
"5741","6180橘子","110/07/28","第一金-員林",19,0,19
"5742","6180橘子","110/07/28","富邦-內湖",0,21,-21
"5743","6180橘子","110/07/28","富邦-嘉義",22,4,18
"5744","6180橘子","110/07/28","第一金-新興",0,20,-20
"5745","6180橘子","110/07/28","統一-嘉義",16,0,16
"5746","6180橘子","110/07/28","臺銀-臺南",5,22,-17
"5747","6180橘子","110/07/28","國票-九鼎",15,0,15
"5748","6180橘子","110/07/28","第一金-忠孝",0,10,-10
"5749","6180橘子","110/07/28","華南永昌-朴子",14,0,14
"5750","6180橘子","110/07/28","元富-屏東",0,10,-10
"5751","6180橘子","110/07/28","群益金鼎-台南",13,0,13
"5752","6180橘子","110/07/28","凱基-八德",1,11,-10
"5753","6180橘子","110/07/28","富邦-建國",13,1,12
"5754","6180橘子","110/07/28","元大-和平",1,11,-10
"5755","6180橘子","110/07/28","富邦-板橋",16,5,11
"5756","6180橘子","110/07/28","元大-台中中港",0,10,-10
"5757","6180橘子","110/07/28","元富-新店",10,0,10
"5758","6180橘子","110/07/28","元大-南屯",0,9,-9
"5759","6180橘子","110/07/28","元大-台南",10,0,10
"5760","6180橘子","110/07/28","永豐金-屏東",0,9,-9
"5761","2390云辰","110/07/28","摩根大通",1589,780,809
"5762","2390云辰","110/07/28","華南永昌-鳳山",34,290,-256
"5763","2390云辰","110/07/28","凱基-台北",457,300,157
"5764","2390云辰","110/07/28","凱基-基隆",0,224,-224
"5765","2390云辰","110/07/28","美林",330,206,124
"5766","2390云辰","110/07/28","元富-高雄",56,177,-121
"5767","2390云辰","110/07/28","元富-同大",159,35,124
"5768","2390云辰","110/07/28","元富-中港",1,100,-99
"5769","2390云辰","110/07/28","台灣摩根士丹利",193,71,122
"5770","2390云辰","110/07/28","兆豐-公益",4,100,-96
"5771","2390云辰","110/07/28","元大-前金",150,49,101
"5772","2390云辰","110/07/28","統一-新台中",180,274,-94
"5773","2390云辰","110/07/28","永豐金-鳳山",110,18,92
"5774","2390云辰","110/07/28","日盛-新莊",4,76,-72
"5775","2390云辰","110/07/28","元大-林園",99,11,88
"5776","2390云辰","110/07/28","永豐金-新店",0,57,-57
"5777","2390云辰","110/07/28","元大-信義",121,35,86
"5778","2390云辰","110/07/28","華南永昌-內壢",0,56,-56
"5779","2390云辰","110/07/28","美商高盛",206,123,83
"5780","2390云辰","110/07/28","第一金-豐原",9,63,-54
"5781","2390云辰","110/07/28","統一-城中",101,37,64
"5782","2390云辰","110/07/28","華南永昌-中正",13,67,-54
"5783","2390云辰","110/07/28","元大-竹山",75,20,55
"5784","2390云辰","110/07/28","元大-大益",7,59,-52
"5785","2390云辰","110/07/28","豐農",79,25,54
"5786","2390云辰","110/07/28","大慶",0,50,-50
"5787","2390云辰","110/07/28","新加坡商瑞銀",68,15,53
"5788","2390云辰","110/07/28","凱基-豐中",3,49,-46
"5789","2390云辰","110/07/28","統一-屏東",54,5,49
"5790","2390云辰","110/07/28","元大-彰化民生",7,51,-44
"5791","1471首利","110/07/27","永全-八德",50,0,50
"5792","1471首利","110/07/27","國票-九鼎",0,306,-306
"5793","1471首利","110/07/27","中國信託-松江",48,0,48
"5794","1471首利","110/07/27","兆豐-天母",1,115,-114
"5795","1471首利","110/07/27","富邦-嘉義",40,0,40
"5796","1471首利","110/07/27","美林",0,42,-42
"5797","1471首利","110/07/27","富邦-台南",33,0,33
"5798","1471首利","110/07/27","摩根大通",45,75,-30
"5799","1471首利","110/07/27","(牛牛牛)亞-鑫豐",32,0,32
"5800","1471首利","110/07/27","凱基-八德",0,30,-30
"5801","1471首利","110/07/27","台灣企銀-太平",25,0,25
"5802","1471首利","110/07/27","中國信託-高雄",0,25,-25
"5803","1471首利","110/07/27","群益金鼎-台中",23,0,23
"5804","1471首利","110/07/27","統一-新台中",0,24,-24
"5805","1471首利","110/07/27","元富-潮州",20,0,20
"5806","1471首利","110/07/27","聯邦-高雄",0,21,-21
"5807","1471首利","110/07/27","凱基-信義",20,0,20
"5808","1471首利","110/07/27","德信-中正",0,20,-20
"5809","1471首利","110/07/27","富邦-基隆",26,8,18
"5810","1471首利","110/07/27","元大-福營",3,20,-17
"5811","1471首利","110/07/27","日盛-高雄",17,0,17
"5812","1471首利","110/07/27","凱基-宜蘭",0,16,-16
"5813","1471首利","110/07/27","國泰-敦南",16,2,14
"5814","1471首利","110/07/27","凱基-天母",0,15,-15
"5815","1471首利","110/07/27","元大-大甲",13,0,13
"5816","1471首利","110/07/27","第一金-高雄",6,20,-14
"5817","1471首利","110/07/27","合庫-鳳山",12,0,12
"5818","1471首利","110/07/27","元大-中壢",0,13,-13
"5819","1471首利","110/07/27","日盛-大墩",12,0,12
"5820","1471首利","110/07/27","元富-安南",0,12,-12
"5821","2883開發金","110/07/27","元富",1762,67,1695
"5822","2883開發金","110/07/27","美林",0,11931,-11931
"5823","2883開發金","110/07/27","福邦證券",1450,0,1450
"5824","2883開發金","110/07/27","新加坡商瑞銀",1513,8370,-6857
"5825","2883開發金","110/07/27","凱基",1422,0,1422
"5826","2883開發金","110/07/27","凱基-台北",1081,5265,-4184
"5827","2883開發金","110/07/27","瑞士信貸",2044,731,1313
"5828","2883開發金","110/07/27","摩根大通",612,3392,-2780
"5829","2883開發金","110/07/27","台灣摩根士丹利",2112,921,1191
"5830","2883開發金","110/07/27","統一-仁愛",31,2002,-1971
"5831","2883開發金","110/07/27","新光",1474,461,1013
"5832","2883開發金","110/07/27","兆豐證券",192,1910,-1718
"5833","2883開發金","110/07/27","國票-長城",1003,20,983
"5834","2883開發金","110/07/27","(牛牛牛)亞-鑫豐",276,1815,-1539
"5835","2883開發金","110/07/27","台新證券",1207,362,845
"5836","2883開發金","110/07/27","永豐金-板橋",197,1610,-1413
"5837","2883開發金","110/07/27","港商野村",2209,1498,711
"5838","2883開發金","110/07/27","美商高盛",16,1337,-1321
"5839","2883開發金","110/07/27","永豐金-彰化",680,26,654
"5840","2883開發金","110/07/27","兆豐-北高雄",60,1360,-1300
"5841","2883開發金","110/07/27","台新-高雄",918,265,653
"5842","2883開發金","110/07/27","兆豐-景美",26,1070,-1044
"5843","2883開發金","110/07/27","國泰-敦南",1273,634,639
"5844","2883開發金","110/07/27","亞東-新竹",7,1001,-994
"5845","2883開發金","110/07/27","元大證券",876,246,630
"5846","2883開發金","110/07/27","富邦-羅東",201,1098,-897
"5847","2883開發金","110/07/27","致和證券",684,92,592
"5848","2883開發金","110/07/27","統一",159,811,-652
"5849","2883開發金","110/07/27","元大-民生",550,2,548
"5850","2883開發金","110/07/27","香港上海匯豐",0,584,-584
"5851","6205詮欣","110/07/27","土銀-和平",20,0,20
"5852","6205詮欣","110/07/27","摩根大通",3,22,-19
"5853","6205詮欣","110/07/27","臺銀-民權",20,6,14
"5854","6205詮欣","110/07/27","瑞士信貸",5,16,-11
"5855","6205詮欣","110/07/27","台新證券",5,0,5
"5856","6205詮欣","110/07/27","臺銀-鳳山",0,6,-6
"5857","6205詮欣","110/07/27","華南永昌-小港",5,0,5
"5858","6205詮欣","110/07/27","臺銀-新竹",0,5,-5
"5859","6205詮欣","110/07/27","日盛-新莊",4,0,4
"5860","6205詮欣","110/07/27","國票-和平",0,4,-4
"5861","6205詮欣","110/07/27","元富-三重",4,0,4
"5862","6205詮欣","110/07/27","凱基-東門",0,4,-4
"5863","6205詮欣","110/07/27","致和-佳里",4,1,3
"5864","6205詮欣","110/07/27","富邦-花蓮",0,3,-3
"5865","6205詮欣","110/07/27","華南永昌-岡山",3,0,3
"5866","6205詮欣","110/07/27","元大-北投",0,3,-3
"5867","6205詮欣","110/07/27","元大-成功",3,0,3
"5868","6205詮欣","110/07/27","元大-民生",2,5,-3
"5869","6205詮欣","110/07/27","土銀-嘉義",2,0,2
"5870","6205詮欣","110/07/27","日盛-三重",0,2,-2
"5871","6205詮欣","110/07/27","第一金-光復",2,0,2
"5872","6205詮欣","110/07/27","日盛-北高雄",0,2,-2
"5873","6205詮欣","110/07/27","統一-屏東",2,0,2
"5874","6205詮欣","110/07/27","港商野村",0,2,-2
"5875","6205詮欣","110/07/27","元富-新莊",2,0,2
"5876","6205詮欣","110/07/27","統一-彰化",0,2,-2
"5877","6205詮欣","110/07/27","兆豐-竹北",2,0,2
"5878","6205詮欣","110/07/27","永全",0,2,-2
"5879","6205詮欣","110/07/27","新光",2,0,2
"5880","6205詮欣","110/07/27","兆豐-西螺",0,2,-2
"5881","1540喬福","110/07/27","富邦-員林",10,0,10
"5882","1540喬福","110/07/27","合庫-台中",0,26,-26
"5883","1540喬福","110/07/27","元大-中壢",10,0,10
"5884","1540喬福","110/07/27","統一-新台中",0,25,-25
"5885","1540喬福","110/07/27","凱基-台中",8,0,8
"5886","1540喬福","110/07/27","元大-斗六",0,10,-10
"5887","1540喬福","110/07/27","大慶-中壢",5,0,5
"5888","1540喬福","110/07/27","凱基-中港",0,9,-9
"5889","1540喬福","110/07/27","兆豐-北高雄",5,0,5
"5890","1540喬福","110/07/27","國票-中正",0,8,-8
"5891","1540喬福","110/07/27","兆豐-三民",5,0,5
"5892","1540喬福","110/07/27","臺銀-臺中",0,5,-5
"5893","1540喬福","110/07/27","台新-台中",5,0,5
"5894","1540喬福","110/07/27","元富-中原",0,5,-5
"5895","1540喬福","110/07/27","國票-九鼎",4,0,4
"5896","1540喬福","110/07/27","新光-桃園",0,5,-5
"5897","1540喬福","110/07/27","富邦-高雄",5,1,4
"5898","1540喬福","110/07/27","大昌-新竹",0,4,-4
"5899","1540喬福","110/07/27","永豐金-羅東",4,0,4
"5900","1540喬福","110/07/27","元大-員林中山",0,4,-4
"5901","1540喬福","110/07/27","台新證券",3,0,3
"5902","1540喬福","110/07/27","群益金鼎-瑞豐",0,3,-3
"5903","1540喬福","110/07/27","華南永昌-台中",3,0,3
"5904","1540喬福","110/07/27","凱基-台北",0,3,-3
"5905","1540喬福","110/07/27","富邦-台東",3,0,3
"5906","1540喬福","110/07/27","富邦-建國",0,3,-3
"5907","1540喬福","110/07/27","元大-台中中港",3,0,3
"5908","1540喬福","110/07/27","國票-北投",0,2,-2
"5909","1540喬福","110/07/27","亞東",2,0,2
"5910","1540喬福","110/07/27","元大-鳳山",0,2,-2
"5911","2888新光金","110/07/27","台灣摩根士丹利",11737,746,10991
"5912","2888新光金","110/07/27","玉山-城中",112,6002,-5890
"5913","2888新光金","110/07/27","美林",3692,417,3275
"5914","2888新光金","110/07/27","新加坡商瑞銀",120,5935,-5815
"5915","2888新光金","110/07/27","凱基-台北",4378,2713,1665
"5916","2888新光金","110/07/27","摩根大通",1586,7187,-5601
"5917","2888新光金","110/07/27","凱基-台南",1551,3,1548
"5918","2888新光金","110/07/27","富邦-建國",298,5641,-5343
"5919","2888新光金","110/07/27","台新證券",1494,124,1370
"5920","2888新光金","110/07/27","第一金-高雄",81,5014,-4933
"5921","2888新光金","110/07/27","新光",2434,1212,1222
"5922","2888新光金","110/07/27","瑞士信貸",191,4524,-4333
"5923","2888新光金","110/07/27","元大-四維",1246,25,1221
"5924","2888新光金","110/07/27","兆豐-鹿港",45,2632,-2587
"5925","2888新光金","110/07/27","富隆-長安",1070,0,1070
"5926","2888新光金","110/07/27","國票-彰化",3,1803,-1800
"5927","2888新光金","110/07/27","永豐金-萬盛",1052,0,1052
"5928","2888新光金","110/07/27","港商野村",0,1434,-1434
"5929","2888新光金","110/07/27","法銀巴黎",1116,120,996
"5930","2888新光金","110/07/27","統一-高雄",173,1511,-1338
"5931","2888新光金","110/07/27","凱基-竹科",853,4,849
"5932","2888新光金","110/07/27","群益金鼎-古亭",40,1202,-1162
"5933","2888新光金","110/07/27","元大-斗信",874,50,824
"5934","2888新光金","110/07/27","日盛-樹林",34,1034,-1000
"5935","2888新光金","110/07/27","日盛-景美",811,119,692
"5936","2888新光金","110/07/27","統一-土城",18,1000,-982
"5937","2888新光金","110/07/27","元富-世貿",568,2,566
"5938","2888新光金","110/07/27","元大-鹿港",125,1057,-932
"5939","2888新光金","110/07/27","日盛-雙和",567,2,565
"5940","2888新光金","110/07/27","新光-桃園",91,993,-902
"5941","1340勝悅","110/07/27","亞東-台中",15,0,15
"5942","1340勝悅","110/07/27","凱基-岡山",0,25,-25
"5943","1340勝悅","110/07/27","元大-路竹",15,0,15
"5944","1340勝悅","110/07/27","合庫-嘉義",0,14,-14
"5945","1340勝悅","110/07/27","臺銀-臺中",7,0,7
"5946","1340勝悅","110/07/27","元大-北港",0,14,-14
"5947","1340勝悅","110/07/27","台新-台中",7,0,7
"5948","1340勝悅","110/07/27","凱基-台北",0,12,-12
"5949","1340勝悅","110/07/27","元大-屏南",6,0,6
"5950","1340勝悅","110/07/27","兆豐-三民",0,7,-7
"5951","1340勝悅","110/07/27","臺灣企銀-埔墘",5,0,5
"5952","1340勝悅","110/07/27","華南永昌-台中",1,7,-6
"5953","1340勝悅","110/07/27","日盛-板橋",5,0,5
"5954","1340勝悅","110/07/27","日盛-信義",0,5,-5
"5955","1340勝悅","110/07/27","日盛-新莊",5,0,5
"5956","1340勝悅","110/07/27","德信-和平",0,5,-5
"5957","1340勝悅","110/07/27","臺銀-鳳山",4,0,4
"5958","1340勝悅","110/07/27","台新證券",0,5,-5
"5959","1340勝悅","110/07/27","玉山-城中",4,0,4
"5960","1340勝悅","110/07/27","新光-高雄",0,4,-4
"5961","1340勝悅","110/07/27","美商高盛",3,0,3
"5962","1340勝悅","110/07/27","瑞士信貸",0,2,-2
"5963","1340勝悅","110/07/27","(牛牛牛)亞-鑫豐",3,0,3
"5964","1340勝悅","110/07/27","港商野村",0,2,-2
"5965","1340勝悅","110/07/27","國票-長城",2,0,2
"5966","1340勝悅","110/07/27","台新-高雄",1,3,-2
"5967","1340勝悅","110/07/27","新光",2,0,2
"5968","1340勝悅","110/07/27","玉山證券",0,2,-2
"5969","1340勝悅","110/07/27","群益金鼎-館前",2,0,2
"5970","1340勝悅","110/07/27","玉山-南京東路",0,2,-2
"5971","6246臺龍","110/07/27","永豐金-桃園",135,0,135
"5972","6246臺龍","110/07/27","元大-木柵",0,59,-59
"5973","6246臺龍","110/07/27","港商野村",111,30,81
"5974","6246臺龍","110/07/27","日盛-景美",0,52,-52
"5975","6246臺龍","110/07/27","元大-西螺",31,0,31
"5976","6246臺龍","110/07/27","華南永昌-彰化",0,46,-46
"5977","6246臺龍","110/07/27","群益金鼎-鳳山",27,0,27
"5978","6246臺龍","110/07/27","兆豐-松德",0,43,-43
"5979","6246臺龍","110/07/27","永豐金-虎尾",27,0,27
"5980","6246臺龍","110/07/27","華南永昌-公誠",5,35,-30
"5981","6246臺龍","110/07/27","玉山-台南",28,2,26
"5982","6246臺龍","110/07/27","凱基-幸福",0,28,-28
"5983","6246臺龍","110/07/27","元大-西屯",25,0,25
"5984","6246臺龍","110/07/27","元富-安南",0,22,-22
"5985","6246臺龍","110/07/27","國泰-忠孝",23,0,23
"5986","6246臺龍","110/07/27","日盛-文化",0,20,-20
"5987","6246臺龍","110/07/27","元大-大里",21,0,21
"5988","6246臺龍","110/07/27","兆豐-寶成",0,20,-20
"5989","6246臺龍","110/07/27","兆豐-竹北",20,0,20
"5990","6246臺龍","110/07/27","華南永昌-虎尾",0,20,-20
"5991","6246臺龍","110/07/27","元大-員林",20,0,20
"5992","6246臺龍","110/07/27","永豐金-埔里",0,19,-19
"5993","6246臺龍","110/07/27","永豐金-敦南",20,0,20
"5994","6246臺龍","110/07/27","兆豐-新營",2,20,-18
"5995","6246臺龍","110/07/27","永豐金-羅東",23,5,18
"5996","6246臺龍","110/07/27","新光-台中",3,20,-17
"5997","6246臺龍","110/07/27","永豐金-桃盛",18,0,18
"5998","6246臺龍","110/07/27","凱基-市政",0,17,-17
"5999","6246臺龍","110/07/27","統一",16,0,16
"6000","6246臺龍","110/07/27","元大-蘆洲",0,16,-16
"6001","00715L期街口布蘭特正2","110/07/27","元大證券",10436,28,10408
"6002","00715L期街口布蘭特正2","110/07/27","元大-萬華",0,751,-751
"6003","00715L期街口布蘭特正2","110/07/27","凱基-台北",4269,129,4140
"6004","00715L期街口布蘭特正2","110/07/27","元大-大里德芳",0,734,-734
"6005","00715L期街口布蘭特正2","110/07/27","群益金鼎",3798,0,3798
"6006","00715L期街口布蘭特正2","110/07/27","新光",380,1105,-725
"6007","00715L期街口布蘭特正2","110/07/27","永豐金證券",2610,22,2588
"6008","00715L期街口布蘭特正2","110/07/27","(牛牛牛)亞-網路",10,697,-687
"6009","00715L期街口布蘭特正2","110/07/27","國票",2605,21,2584
"6010","00715L期街口布蘭特正2","110/07/27","日盛-新莊",5,550,-545
"6011","00715L期街口布蘭特正2","110/07/27","富邦證券",1522,0,1522
"6012","00715L期街口布蘭特正2","110/07/27","玉山-高雄",7,494,-487
"6013","00715L期街口布蘭特正2","110/07/27","合庫證券",1507,239,1268
"6014","00715L期街口布蘭特正2","110/07/27","華南永昌",1,471,-470
"6015","00715L期街口布蘭特正2","110/07/27","元富",1102,0,1102
"6016","00715L期街口布蘭特正2","110/07/27","華南永昌-竹北",0,469,-469
"6017","00715L期街口布蘭特正2","110/07/27","凱基",980,0,980
"6018","00715L期街口布蘭特正2","110/07/27","兆豐-嘉義",0,420,-420
"6019","00715L期街口布蘭特正2","110/07/27","國票-博愛",702,0,702
"6020","00715L期街口布蘭特正2","110/07/27","國票-九鼎",0,409,-409
"6021","00715L期街口布蘭特正2","110/07/27","統一",796,117,679
"6022","00715L期街口布蘭特正2","110/07/27","統一-高雄",0,405,-405
"6023","00715L期街口布蘭特正2","110/07/27","華南永昌-長虹",810,185,625
"6024","00715L期街口布蘭特正2","110/07/27","富邦-彰化",0,402,-402
"6025","00715L期街口布蘭特正2","110/07/27","港商野村",1076,494,582
"6026","00715L期街口布蘭特正2","110/07/27","元大-羅東",0,400,-400
"6027","00715L期街口布蘭特正2","110/07/27","永豐金-三重",500,16,484
"6028","00715L期街口布蘭特正2","110/07/27","富邦-高雄",0,398,-398
"6029","00715L期街口布蘭特正2","110/07/27","元大-敦化",420,0,420
"6030","00715L期街口布蘭特正2","110/07/27","新光-台中",17,391,-374
"6031","8941關中","110/07/27","富邦-仁愛",4,0,4
"6032","8941關中","110/07/27","光和-溪湖",0,2,-2
"6033","8941關中","110/07/27","日盛-新莊",1,0,1
"6034","8941關中","110/07/27","富邦-園區",0,2,-2
"6035","8941關中","110/07/27","台新-高雄",1,0,1
"6036","8941關中","110/07/27","合庫-高雄",0,1,-1
"6037","8941關中","110/07/27","元大-金華",1,0,1
"6038","8941關中","110/07/27","凱基-台北",0,1,-1
"6039","8941關中","110/07/27","臺銀-鳳山",0,0,0
"6040","8941關中","110/07/27","富邦-台東",0,1,-1
"6041","8941關中","110/07/27","日盛-花蓮",0,0,0
"6042","8941關中","110/07/27","臺銀-鳳山",0,0,0
"6043","8941關中","110/07/27","康和-板橋",0,0,0
"6044","8941關中","110/07/27","日盛-花蓮",0,0,0
"6045","8941關中","110/07/27","富邦-宜蘭",0,0,0
"6046","8941關中","110/07/27","康和-板橋",0,0,0
"6047","8941關中","110/07/27","元大-新竹經國",0,0,0
"6048","8941關中","110/07/27","富邦-宜蘭",0,0,0
"6049","8941關中","110/07/27","永豐金-萬盛",0,0,0
"6050","8941關中","110/07/27","元大-新竹經國",0,0,0
"6051","8941關中","110/07/27","永豐金-桃盛",0,0,0
"6052","8941關中","110/07/27","永豐金-萬盛",0,0,0
"6053","8941關中","110/07/27","",NA,NA,NA
"6054","8941關中","110/07/27","永豐金-桃盛",0,0,0
"6055","8941關中","110/07/27","",NA,NA,NA
"6056","8941關中","110/07/27","",NA,NA,NA
"6057","8941關中","110/07/27","",NA,NA,NA
"6058","8941關中","110/07/27","",NA,NA,NA
"6059","8941關中","110/07/27","",NA,NA,NA
"6060","8941關中","110/07/27","",NA,NA,NA
"6061","8936國統","110/07/27","日盛-景美",100,0,100
"6062","8936國統","110/07/27","摩根大通",115,220,-105
"6063","8936國統","110/07/27","大慶-蘆洲",90,0,90
"6064","8936國統","110/07/27","玉山-桃園",0,75,-75
"6065","8936國統","110/07/27","台新-建北",60,0,60
"6066","8936國統","110/07/27","凱基-台北",13,77,-64
"6067","8936國統","110/07/27","日盛-忠孝",40,1,39
"6068","8936國統","110/07/27","元富-大昌",2,50,-48
"6069","8936國統","110/07/27","新加坡商瑞銀",109,71,38
"6070","8936國統","110/07/27","華南永昌-台中",4,45,-41
"6071","8936國統","110/07/27","華南永昌",30,0,30
"6072","8936國統","110/07/27","新光-台中",26,66,-40
"6073","8936國統","110/07/27","兆豐-來福",29,0,29
"6074","8936國統","110/07/27","台灣摩根士丹利",20,54,-34
"6075","8936國統","110/07/27","元大-旗山",28,0,28
"6076","8936國統","110/07/27","元大-東蘆",0,34,-34
"6077","8936國統","110/07/27","元大-松江",27,0,27
"6078","8936國統","110/07/27","富邦-仁愛",1,34,-33
"6079","8936國統","110/07/27","新光",41,19,22
"6080","8936國統","110/07/27","凱基-板橋",0,31,-31
"6081","8936國統","110/07/27","元富-林園",20,0,20
"6082","8936國統","110/07/27","凱基-信義",0,30,-30
"6083","8936國統","110/07/27","玉山-高雄",20,0,20
"6084","8936國統","110/07/27","瑞士信貸",1,30,-29
"6085","8936國統","110/07/27","凱基-桃園",23,3,20
"6086","8936國統","110/07/27","元大-花蓮",2,24,-22
"6087","8936國統","110/07/27","永豐金-永康",20,0,20
"6088","8936國統","110/07/27","元富-緯城",0,20,-20
"6089","8936國統","110/07/27","日盛-屏東",23,4,19
"6090","8936國統","110/07/27","群益金鼎-宜蘭",0,20,-20
"6091","6226光鼎","110/07/27","第一金-忠孝",405,4,401
"6092","6226光鼎","110/07/27","華南永昌-台南",5,240,-235
"6093","6226光鼎","110/07/27","台新-台中",272,75,197
"6094","6226光鼎","110/07/27","大慶-泰山",0,201,-201
"6095","6226光鼎","110/07/27","凱基-和平",155,7,148
"6096","6226光鼎","110/07/27","富邦-員林",2,151,-149
"6097","6226光鼎","110/07/27","新加坡商瑞銀",133,0,133
"6098","6226光鼎","110/07/27","群益金鼎-東大",23,165,-142
"6099","6226光鼎","110/07/27","統一-敦南",126,3,123
"6100","6226光鼎","110/07/27","元大-景美",3,132,-129
"6101","6226光鼎","110/07/27","台灣摩根士丹利",129,8,121
"6102","6226光鼎","110/07/27","台新-高雄",84,186,-102
"6103","6226光鼎","110/07/27","統一-新竹",117,1,116
"6104","6226光鼎","110/07/27","合庫證券",27,121,-94
"6105","6226光鼎","110/07/27","日盛證券",122,13,109
"6106","6226光鼎","110/07/27","致和-佳里",5,81,-76
"6107","6226光鼎","110/07/27","元大-潮州",101,1,100
"6108","6226光鼎","110/07/27","永豐金-南投",3,77,-74
"6109","6226光鼎","110/07/27","國泰-敦南",232,145,87
"6110","6226光鼎","110/07/27","台新-新莊",1,57,-56
"6111","6226光鼎","110/07/27","摩根大通",86,0,86
"6112","6226光鼎","110/07/27","日盛-中壢",11,64,-53
"6113","6226光鼎","110/07/27","元富",80,0,80
"6114","6226光鼎","110/07/27","日進",11,63,-52
"6115","6226光鼎","110/07/27","華南永昌-嘉義",80,1,79
"6116","6226光鼎","110/07/27","高橋",13,64,-51
"6117","6226光鼎","110/07/27","元大-高雄",70,3,67
"6118","6226光鼎","110/07/27","元大-土城",1,52,-51
"6119","6226光鼎","110/07/27","華南永昌",82,21,61
"6120","6226光鼎","110/07/27","華南永昌-林口",11,60,-49
"6121","2363矽統","110/07/27","國泰-敦南",541,118,423
"6122","2363矽統","110/07/27","摩根大通",317,1405,-1088
"6123","2363矽統","110/07/27","台新證券",564,333,231
"6124","2363矽統","110/07/27","美林",210,1095,-885
"6125","2363矽統","110/07/27","元大-沙鹿",196,9,187
"6126","2363矽統","110/07/27","港商野村",275,1065,-790
"6127","2363矽統","110/07/27","新光",300,151,149
"6128","2363矽統","110/07/27","凱基-台北",518,1192,-674
"6129","2363矽統","110/07/27","華南永昌-台南",108,3,105
"6130","2363矽統","110/07/27","新加坡商瑞銀",213,703,-490
"6131","2363矽統","110/07/27","華南永昌-朴子",140,43,97
"6132","2363矽統","110/07/27","富邦-南屯",6,272,-266
"6133","2363矽統","110/07/27","華南永昌-公誠",109,13,96
"6134","2363矽統","110/07/27","美商高盛",31,233,-202
"6135","2363矽統","110/07/27","元富-松德",95,1,94
"6136","2363矽統","110/07/27","元大證券",38,235,-197
"6137","2363矽統","110/07/27","中國信託-永康",102,8,94
"6138","2363矽統","110/07/27","永豐金證券",15,201,-186
"6139","2363矽統","110/07/27","台新-三民",111,21,90
"6140","2363矽統","110/07/27","亞東",46,206,-160
"6141","2363矽統","110/07/27","凱基-中港",85,3,82
"6142","2363矽統","110/07/27","群益金鼎",21,169,-148
"6143","2363矽統","110/07/27","元富-烏日",87,6,81
"6144","2363矽統","110/07/27","第一金-嘉義",0,100,-100
"6145","2363矽統","110/07/27","富邦-台北",135,56,79
"6146","2363矽統","110/07/27","凱基-彰化",9,100,-91
"6147","2363矽統","110/07/27","元大-復北",81,12,69
"6148","2363矽統","110/07/27","元富-佳里",27,97,-70
"6149","2363矽統","110/07/27","中國信託-忠孝",94,26,68
"6150","2363矽統","110/07/27","合庫-桃園",8,76,-68
"6151","8112至上","110/07/27","凱基-竹科",300,10,290
"6152","8112至上","110/07/27","凱基-三重",1,501,-500
"6153","8112至上","110/07/27","台灣摩根士丹利",271,49,222
"6154","8112至上","110/07/27","美林",21,339,-318
"6155","8112至上","110/07/27","摩根大通",488,427,61
"6156","8112至上","110/07/27","凱基-台北",423,615,-192
"6157","8112至上","110/07/27","香港上海匯豐",61,0,61
"6158","8112至上","110/07/27","港商野村",83,183,-100
"6159","8112至上","110/07/27","日盛證券",62,4,58
"6160","8112至上","110/07/27","永豐金-台南",2,79,-77
"6161","8112至上","110/07/27","元大-基隆孝二",52,0,52
"6162","8112至上","110/07/27","福邦證券",0,71,-71
"6163","8112至上","110/07/27","永豐金-中正",59,7,52
"6164","8112至上","110/07/27","兆豐-天母",0,50,-50
"6165","8112至上","110/07/27","群益金鼎-高盛",47,0,47
"6166","8112至上","110/07/27","元富-林園",3,52,-49
"6167","8112至上","110/07/27","永豐金-內湖",47,0,47
"6168","8112至上","110/07/27","永豐金-苓雅",1,50,-49
"6169","8112至上","110/07/27","富邦-台北",45,5,40
"6170","8112至上","110/07/27","元大-新莊",9,53,-44
"6171","8112至上","110/07/27","台新證券",78,39,39
"6172","8112至上","110/07/27","第一金-路竹",20,57,-37
"6173","8112至上","110/07/27","新光-台中",44,7,37
"6174","8112至上","110/07/27","新光-桃園",2,36,-34
"6175","8112至上","110/07/27","元大-羅東",38,1,37
"6176","8112至上","110/07/27","元大-東港",0,27,-27
"6177","8112至上","110/07/27","新光",101,65,36
"6178","8112至上","110/07/27","國泰-松江",2,28,-26
"6179","8112至上","110/07/27","元大-新竹",63,28,35
"6180","8112至上","110/07/27","群益金鼎-潭子",2,28,-26
"6181","1570力肯","110/07/27","國票-北高雄",7,0,7
"6182","1570力肯","110/07/27","元大-高雄",0,16,-16
"6183","1570力肯","110/07/27","富邦-陽明",5,0,5
"6184","1570力肯","110/07/27","國票-新莊",0,5,-5
"6185","1570力肯","110/07/27","元大-民雄",3,0,3
"6186","1570力肯","110/07/27","凱基-台北",0,5,-5
"6187","1570力肯","110/07/27","凱基-大里",3,0,3
"6188","1570力肯","110/07/27","美林",0,2,-2
"6189","1570力肯","110/07/27","凱基-長庚",3,0,3
"6190","1570力肯","110/07/27","富邦-南屯",0,2,-2
"6191","1570力肯","110/07/27","元大-新莊",2,0,2
"6192","1570力肯","110/07/27","元大-南崁",0,2,-2
"6193","1570力肯","110/07/27","大昌-樹林",2,0,2
"6194","1570力肯","110/07/27","元大-板橋",0,2,-2
"6195","1570力肯","110/07/27","台新-台中",2,0,2
"6196","1570力肯","110/07/27","新光",0,1,-1
"6197","1570力肯","110/07/27","新光-新竹",2,0,2
"6198","1570力肯","110/07/27","國泰-板橋",0,1,-1
"6199","1570力肯","110/07/27","富邦-左營",2,0,2
"6200","1570力肯","110/07/27","凱基-鳳山",0,1,-1
"6201","1570力肯","110/07/27","群益金鼎-土城",1,0,1
"6202","1570力肯","110/07/27","(牛牛牛)亞-鑫豐",2,2,0
"6203","1570力肯","110/07/27","凱基-竹東",1,0,1
"6204","1570力肯","110/07/27","元大-新盛",1,1,0
"6205","1570力肯","110/07/27","日盛-員林",1,0,1
"6206","1570力肯","110/07/27","",NA,NA,NA
"6207","1570力肯","110/07/27","玉山-板橋",1,0,1
"6208","1570力肯","110/07/27","",NA,NA,NA
"6209","1570力肯","110/07/27","元富-同大",1,0,1
"6210","1570力肯","110/07/27","",NA,NA,NA
"6211","2929淘帝","110/07/27","元大-民生",28,0,28
"6212","2929淘帝","110/07/27","元大-鳳山",0,20,-20
"6213","2929淘帝","110/07/27","臺銀-民權",18,0,18
"6214","2929淘帝","110/07/27","港商野村",1,18,-17
"6215","2929淘帝","110/07/27","合庫-高雄",13,0,13
"6216","2929淘帝","110/07/27","玉山-板橋",0,15,-15
"6217","2929淘帝","110/07/27","永興-水湳",10,0,10
"6218","2929淘帝","110/07/27","美林",0,10,-10
"6219","2929淘帝","110/07/27","富邦-陽明",10,0,10
"6220","2929淘帝","110/07/27","凱基-八德",0,10,-10
"6221","2929淘帝","110/07/27","元大-中和",10,0,10
"6222","2929淘帝","110/07/27","永豐金證券",0,9,-9
"6223","2929淘帝","110/07/27","國泰-館前",6,0,6
"6224","2929淘帝","110/07/27","新加坡商瑞銀",10,18,-8
"6225","2929淘帝","110/07/27","富邦-內湖",6,0,6
"6226","2929淘帝","110/07/27","富邦-台北",0,8,-8
"6227","2929淘帝","110/07/27","合庫-台南",5,0,5
"6228","2929淘帝","110/07/27","宏遠-台中",0,7,-7
"6229","2929淘帝","110/07/27","凱基-東門",5,0,5
"6230","2929淘帝","110/07/27","元富-潮州",0,7,-7
"6231","2929淘帝","110/07/27","元大-大益",5,0,5
"6232","2929淘帝","110/07/27","群益金鼎-延平",0,6,-6
"6233","2929淘帝","110/07/27","元大-屏南",5,0,5
"6234","2929淘帝","110/07/27","元大-文心",0,6,-6
"6235","2929淘帝","110/07/27","永豐金-板盛",5,0,5
"6236","2929淘帝","110/07/27","永豐金-中壢",0,6,-6
"6237","2929淘帝","110/07/27","臺銀",4,0,4
"6238","2929淘帝","110/07/27","美商高盛",0,5,-5
"6239","2929淘帝","110/07/27","永豐金-市政",4,0,4
"6240","2929淘帝","110/07/27","兆豐-南門",0,5,-5
"6241","5410國眾","110/07/27","摩根大通",47,0,47
"6242","5410國眾","110/07/27","元富-嘉義",0,48,-48
"6243","5410國眾","110/07/27","兆豐-城中",43,0,43
"6244","5410國眾","110/07/27","統一-平鎮",0,20,-20
"6245","5410國眾","110/07/27","香港上海匯豐",36,0,36
"6246","5410國眾","110/07/27","元大-大益",0,18,-18
"6247","5410國眾","110/07/27","港商麥格理",26,0,26
"6248","5410國眾","110/07/27","凱基-台北",0,16,-16
"6249","5410國眾","110/07/27","元富-大昌",21,0,21
"6250","5410國眾","110/07/27","凱基-站前",0,15,-15
"6251","5410國眾","110/07/27","元富-四維",20,0,20
"6252","5410國眾","110/07/27","元大-南勢角",0,13,-13
"6253","5410國眾","110/07/27","新光-台中",20,0,20
"6254","5410國眾","110/07/27","日盛-忠孝",0,11,-11
"6255","5410國眾","110/07/27","統一-金門",15,0,15
"6256","5410國眾","110/07/27","玉山-板橋",0,11,-11
"6257","5410國眾","110/07/27","玉山-高雄",15,0,15
"6258","5410國眾","110/07/27","元大-崇德",0,11,-11
"6259","5410國眾","110/07/27","凱基-竹北",15,0,15
"6260","5410國眾","110/07/27","元大-大天母",0,11,-11
"6261","5410國眾","110/07/27","元大-新莊",14,1,13
"6262","5410國眾","110/07/27","元富-松德",0,10,-10
"6263","5410國眾","110/07/27","華南永昌-中正",14,4,10
"6264","5410國眾","110/07/27","豐農",0,10,-10
"6265","5410國眾","110/07/27","元大-屏南",10,0,10
"6266","5410國眾","110/07/27","新光-新竹",0,10,-10
"6267","5410國眾","110/07/27","元大-中和",10,0,10
"6268","5410國眾","110/07/27","凱基-虎尾",0,10,-10
"6269","5410國眾","110/07/27","台新證券",10,1,9
"6270","5410國眾","110/07/27","元大-善化",0,10,-10
"6271","2841台開","110/07/27","日盛證券",620,0,620
"6272","2841台開","110/07/27","玉山-新竹",0,312,-312
"6273","2841台開","110/07/27","永豐金-豐原",65,0,65
"6274","2841台開","110/07/27","港商野村",0,216,-216
"6275","2841台開","110/07/27","元大-南投",50,0,50
"6276","2841台開","110/07/27","永興-水湳",0,90,-90
"6277","2841台開","110/07/27","台灣摩根士丹利",40,0,40
"6278","2841台開","110/07/27","凱基-興隆",0,64,-64
"6279","2841台開","110/07/27","玉山-高雄",29,0,29
"6280","2841台開","110/07/27","美林",0,30,-30
"6281","2841台開","110/07/27","第一金-台中",20,0,20
"6282","2841台開","110/07/27","國泰-松江",5,35,-30
"6283","2841台開","110/07/27","凱基-市政",20,0,20
"6284","2841台開","110/07/27","台新-左楠",0,25,-25
"6285","2841台開","110/07/27","群益金鼎-大甲",18,1,17
"6286","2841台開","110/07/27","大昌-樹林",0,20,-20
"6287","2841台開","110/07/27","台中銀",16,1,15
"6288","2841台開","110/07/27","富邦-仁愛",0,20,-20
"6289","2841台開","110/07/27","國泰-板橋",12,0,12
"6290","2841台開","110/07/27","致和-南京",0,16,-16
"6291","2841台開","110/07/27","群益金鼎-基隆",10,0,10
"6292","2841台開","110/07/27","凱基-台北",2,16,-14
"6293","2841台開","110/07/27","華南永昌-新莊",10,0,10
"6294","2841台開","110/07/27","日盛-台南",0,10,-10
"6295","2841台開","110/07/27","元大-福營",10,0,10
"6296","2841台開","110/07/27","國票-台東",0,10,-10
"6297","2841台開","110/07/27","元大-歸仁",10,0,10
"6298","2841台開","110/07/27","台新-台中",5,15,-10
"6299","2841台開","110/07/27","中國信託-文心",5,0,5
"6300","2841台開","110/07/27","凱基-台中",0,10,-10
"6301","6207雷科","110/07/27","摩根大通",249,119,130
"6302","6207雷科","110/07/27","永豐金-台南",2,82,-80
"6303","6207雷科","110/07/27","群益金鼎-丹鳳",70,0,70
"6304","6207雷科","110/07/27","永豐金-內湖",39,109,-70
"6305","6207雷科","110/07/27","群益金鼎-東門",42,0,42
"6306","6207雷科","110/07/27","新加坡商瑞銀",22,76,-54
"6307","6207雷科","110/07/27","永豐金-敦南",38,4,34
"6308","6207雷科","110/07/27","新光-高雄",4,57,-53
"6309","6207雷科","110/07/27","凱基-復興",30,0,30
"6310","6207雷科","110/07/27","瑞士信貸",0,40,-40
"6311","6207雷科","110/07/27","元大-東門",30,0,30
"6312","6207雷科","110/07/27","凱基-高雄",4,43,-39
"6313","6207雷科","110/07/27","大昌-桃園",33,8,25
"6314","6207雷科","110/07/27","華南永昌-高雄",4,40,-36
"6315","6207雷科","110/07/27","富邦-虎尾",24,0,24
"6316","6207雷科","110/07/27","新光",11,44,-33
"6317","6207雷科","110/07/27","凱基-羅東",24,2,22
"6318","6207雷科","110/07/27","日盛-板橋中山",0,29,-29
"6319","6207雷科","110/07/27","群益金鼎-延平",21,0,21
"6320","6207雷科","110/07/27","元大-六合",3,30,-27
"6321","6207雷科","110/07/27","群益金鼎-屏東",20,0,20
"6322","6207雷科","110/07/27","中國信託-新竹",7,33,-26
"6323","6207雷科","110/07/27","永豐金-埔里",20,0,20
"6324","6207雷科","110/07/27","元富-城中",0,23,-23
"6325","6207雷科","110/07/27","康和-延平",21,3,18
"6326","6207雷科","110/07/27","元大-大雅",2,20,-18
"6327","6207雷科","110/07/27","群益金鼎-中壢",20,2,18
"6328","6207雷科","110/07/27","永豐金-新莊",2,20,-18
"6329","6207雷科","110/07/27","宏遠證券",31,15,16
"6330","6207雷科","110/07/27","富邦-台中",5,21,-16
"6331","3679新至陞","110/07/27","凱基-市政",25,0,25
"6332","3679新至陞","110/07/27","瑞士信貸",0,13,-13
"6333","3679新至陞","110/07/27","兆豐-高雄",10,0,10
"6334","3679新至陞","110/07/27","元大-天母",0,9,-9
"6335","3679新至陞","110/07/27","光和-溪湖",8,0,8
"6336","3679新至陞","110/07/27","元大-彰化民生",0,6,-6
"6337","3679新至陞","110/07/27","臺銀-新竹",7,0,7
"6338","3679新至陞","110/07/27","康和-澎湖",2,7,-5
"6339","3679新至陞","110/07/27","新加坡商瑞銀",7,0,7
"6340","3679新至陞","110/07/27","聯邦-大業",0,5,-5
"6341","3679新至陞","110/07/27","永豐金-板橋",6,0,6
"6342","3679新至陞","110/07/27","元大-成功",0,5,-5
"6343","3679新至陞","110/07/27","宏遠-光隆",5,0,5
"6344","3679新至陞","110/07/27","康和-板橋",0,4,-4
"6345","3679新至陞","110/07/27","統一",5,0,5
"6346","3679新至陞","110/07/27","凱基-新豐",0,4,-4
"6347","3679新至陞","110/07/27","統一-新竹",5,0,5
"6348","3679新至陞","110/07/27","統一-高雄",0,3,-3
"6349","3679新至陞","110/07/27","元富-松德",5,0,5
"6350","3679新至陞","110/07/27","統一-新台中",0,3,-3
"6351","3679新至陞","110/07/27","元大-淡水",5,0,5
"6352","3679新至陞","110/07/27","元富-安南",0,3,-3
"6353","3679新至陞","110/07/27","日盛證券",4,0,4
"6354","3679新至陞","110/07/27","國票-北高雄",0,3,-3
"6355","3679新至陞","110/07/27","國泰-板橋",4,0,4
"6356","3679新至陞","110/07/27","玉山-新莊",0,3,-3
"6357","3679新至陞","110/07/27","(牛牛牛)亞-網路",3,0,3
"6358","3679新至陞","110/07/27","凱基-屏東",0,3,-3
"6359","3679新至陞","110/07/27","國票-九鼎",3,0,3
"6360","3679新至陞","110/07/27","台灣摩根士丹利",0,2,-2
"6361","2727王品","110/07/27","台灣摩根士丹利",103,12,91
"6362","2727王品","110/07/27","元大-彰化民生",11,420,-409
"6363","2727王品","110/07/27","華南永昌-麻豆",33,0,33
"6364","2727王品","110/07/27","美商高盛",0,247,-247
"6365","2727王品","110/07/27","元大-龍潭",31,1,30
"6366","2727王品","110/07/27","華南永昌",7,193,-186
"6367","2727王品","110/07/27","國泰-敦南",38,11,27
"6368","2727王品","110/07/27","花旗環球",0,86,-86
"6369","2727王品","110/07/27","群益金鼎-基隆",27,1,26
"6370","2727王品","110/07/27","凱基-台北",81,139,-58
"6371","2727王品","110/07/27","富邦-台中",26,0,26
"6372","2727王品","110/07/27","元大證券",23,64,-41
"6373","2727王品","110/07/27","元富",31,6,25
"6374","2727王品","110/07/27","瑞士信貸",0,37,-37
"6375","2727王品","110/07/27","元大-桃園",25,0,25
"6376","2727王品","110/07/27","富邦-建國",8,35,-27
"6377","2727王品","110/07/27","凱基-大直",21,1,20
"6378","2727王品","110/07/27","凱基-埔墘",6,29,-23
"6379","2727王品","110/07/27","日盛-士林",16,0,16
"6380","2727王品","110/07/27","美林",5,26,-21
"6381","2727王品","110/07/27","國票-敦北法人",17,1,16
"6382","2727王品","110/07/27","港商野村",12,30,-18
"6383","2727王品","110/07/27","群益金鼎-高雄",16,0,16
"6384","2727王品","110/07/27","華南永昌-林口",3,21,-18
"6385","2727王品","110/07/27","永豐金-忠孝",18,2,16
"6386","2727王品","110/07/27","彰銀-台中",4,20,-16
"6387","2727王品","110/07/27","臺銀-高雄",16,1,15
"6388","2727王品","110/07/27","統一",3,17,-14
"6389","2727王品","110/07/27","台新-台中",18,3,15
"6390","2727王品","110/07/27","富邦-新竹華信",2,15,-13
"6391","1570力肯","110/07/27","國票-北高雄",7,0,7
"6392","1570力肯","110/07/27","元大-高雄",0,16,-16
"6393","1570力肯","110/07/27","富邦-陽明",5,0,5
"6394","1570力肯","110/07/27","國票-新莊",0,5,-5
"6395","1570力肯","110/07/27","元大-民雄",3,0,3
"6396","1570力肯","110/07/27","凱基-台北",0,5,-5
"6397","1570力肯","110/07/27","凱基-大里",3,0,3
"6398","1570力肯","110/07/27","美林",0,2,-2
"6399","1570力肯","110/07/27","凱基-長庚",3,0,3
"6400","1570力肯","110/07/27","富邦-南屯",0,2,-2
"6401","1570力肯","110/07/27","元大-新莊",2,0,2
"6402","1570力肯","110/07/27","元大-南崁",0,2,-2
"6403","1570力肯","110/07/27","大昌-樹林",2,0,2
"6404","1570力肯","110/07/27","元大-板橋",0,2,-2
"6405","1570力肯","110/07/27","台新-台中",2,0,2
"6406","1570力肯","110/07/27","新光",0,1,-1
"6407","1570力肯","110/07/27","新光-新竹",2,0,2
"6408","1570力肯","110/07/27","國泰-板橋",0,1,-1
"6409","1570力肯","110/07/27","富邦-左營",2,0,2
"6410","1570力肯","110/07/27","凱基-鳳山",0,1,-1
"6411","1570力肯","110/07/27","群益金鼎-土城",1,0,1
"6412","1570力肯","110/07/27","(牛牛牛)亞-鑫豐",2,2,0
"6413","1570力肯","110/07/27","凱基-竹東",1,0,1
"6414","1570力肯","110/07/27","元大-新盛",1,1,0
"6415","1570力肯","110/07/27","日盛-員林",1,0,1
"6416","1570力肯","110/07/27","",NA,NA,NA
"6417","1570力肯","110/07/27","玉山-板橋",1,0,1
"6418","1570力肯","110/07/27","",NA,NA,NA
"6419","1570力肯","110/07/27","元富-同大",1,0,1
"6420","1570力肯","110/07/27","",NA,NA,NA
"6421","6180橘子","110/07/27","新加坡商瑞銀",166,24,142
"6422","6180橘子","110/07/27","花旗環球",31,87,-56
"6423","6180橘子","110/07/27","彰銀-台中",50,1,49
"6424","6180橘子","110/07/27","凱基-台北",53,108,-55
"6425","6180橘子","110/07/27","日盛-文化",48,8,40
"6426","6180橘子","110/07/27","新光",39,81,-42
"6427","6180橘子","110/07/27","美林",39,0,39
"6428","6180橘子","110/07/27","富邦-台北",1,25,-24
"6429","6180橘子","110/07/27","元大-草屯",54,17,37
"6430","6180橘子","110/07/27","第一金-員林",0,22,-22
"6431","6180橘子","110/07/27","美商高盛",35,1,34
"6432","6180橘子","110/07/27","富邦-新竹華信",7,28,-21
"6433","6180橘子","110/07/27","元大-上新莊",32,0,32
"6434","6180橘子","110/07/27","凱基-中山",5,24,-19
"6435","6180橘子","110/07/27","台灣摩根士丹利",30,0,30
"6436","6180橘子","110/07/27","國泰-敦南",22,37,-15
"6437","6180橘子","110/07/27","摩根大通",49,21,28
"6438","6180橘子","110/07/27","合庫-自強",2,16,-14
"6439","6180橘子","110/07/27","兆豐-大同",30,4,26
"6440","6180橘子","110/07/27","大昌-安康",1,14,-13
"6441","6180橘子","110/07/27","元大-羅東",21,0,21
"6442","6180橘子","110/07/27","高橋",0,11,-11
"6443","6180橘子","110/07/27","日盛-頭份",16,0,16
"6444","6180橘子","110/07/27","土銀-新竹",0,10,-10
"6445","6180橘子","110/07/27","瑞士信貸",24,8,16
"6446","6180橘子","110/07/27","兆豐-麻豆",0,10,-10
"6447","6180橘子","110/07/27","群益金鼎-士林",15,0,15
"6448","6180橘子","110/07/27","康和-永和",0,10,-10
"6449","6180橘子","110/07/27","永豐金-南京",15,1,14
"6450","6180橘子","110/07/27","永豐金-竹科",2,12,-10
"6451","2390云辰","110/07/27","凱基-基隆",207,3,204
"6452","2390云辰","110/07/27","凱基-台北",248,732,-484
"6453","2390云辰","110/07/27","摩根大通",730,560,170
"6454","2390云辰","110/07/27","美林",17,218,-201
"6455","2390云辰","110/07/27","華南永昌-中正",182,43,139
"6456","2390云辰","110/07/27","港商野村",85,277,-192
"6457","2390云辰","110/07/27","兆豐-北高雄",124,1,123
"6458","2390云辰","110/07/27","玉山-新莊",4,87,-83
"6459","2390云辰","110/07/27","元大-信義",108,5,103
"6460","2390云辰","110/07/27","新光",96,163,-67
"6461","2390云辰","110/07/27","富邦-陽明",94,22,72
"6462","2390云辰","110/07/27","新光-新竹",7,74,-67
"6463","2390云辰","110/07/27","日盛證券",140,71,69
"6464","2390云辰","110/07/27","富邦-左營",46,107,-61
"6465","2390云辰","110/07/27","第一金-豐原",56,0,56
"6466","2390云辰","110/07/27","大昌-新店",9,64,-55
"6467","2390云辰","110/07/27","統一-新台中",67,22,45
"6468","2390云辰","110/07/27","日盛-和美",28,81,-53
"6469","2390云辰","110/07/27","元大-復北",47,2,45
"6470","2390云辰","110/07/27","元大-台南",3,54,-51
"6471","2390云辰","110/07/27","富邦-建國",54,10,44
"6472","2390云辰","110/07/27","元富-世貿",10,60,-50
"6473","2390云辰","110/07/27","兆豐-桃鶯",46,5,41
"6474","2390云辰","110/07/27","華南永昌-鳳山",41,90,-49
"6475","2390云辰","110/07/27","富邦-中壢",45,4,41
"6476","2390云辰","110/07/27","聯邦商銀",6,52,-46
"6477","2390云辰","110/07/27","富邦-新竹華信",46,11,35
"6478","2390云辰","110/07/27","合庫-高雄",7,50,-43
"6479","2390云辰","110/07/27","第一金-華江",30,2,28
"6480","2390云辰","110/07/27","瑞士信貸",0,42,-42
"6481","2363矽統","110/07/26","凱基-台北",1994,468,1526
"6482","2363矽統","110/07/26","富邦-南屯",5,375,-370
"6483","2363矽統","110/07/26","新加坡商瑞銀",1537,208,1329
"6484","2363矽統","110/07/26","聯邦-興中",0,203,-203
"6485","2363矽統","110/07/26","摩根大通",2033,997,1036
"6486","2363矽統","110/07/26","台新證券",427,622,-195
"6487","2363矽統","110/07/26","瑞士信貸",930,0,930
"6488","2363矽統","110/07/26","元大-鳳中",10,203,-193
"6489","2363矽統","110/07/26","美林",985,76,909
"6490","2363矽統","110/07/26","國泰-板橋",69,209,-140
"6491","2363矽統","110/07/26","港商野村",1072,282,790
"6492","2363矽統","110/07/26","北城證券",6,132,-126
"6493","2363矽統","110/07/26","美商高盛",711,7,704
"6494","2363矽統","110/07/26","華南永昌-朴子",30,152,-122
"6495","2363矽統","110/07/26","新光",570,278,292
"6496","2363矽統","110/07/26","台新-台中",27,145,-118
"6497","2363矽統","110/07/26","台新-台南",244,39,205
"6498","2363矽統","110/07/26","群益金鼎-萬華",13,128,-115
"6499","2363矽統","110/07/26","元大證券",243,52,191
"6500","2363矽統","110/07/26","日盛-樹林",7,116,-109
"6501","2363矽統","110/07/26","永豐金證券",189,27,162
"6502","2363矽統","110/07/26","群益金鼎-屏東",200,303,-103
"6503","2363矽統","110/07/26","元大-楊梅",177,16,161
"6504","2363矽統","110/07/26","元大-潮州",6,102,-96
"6505","2363矽統","110/07/26","群益金鼎",158,21,137
"6506","2363矽統","110/07/26","新光-桃園",22,117,-95
"6507","2363矽統","110/07/26","元富-城東",107,8,99
"6508","2363矽統","110/07/26","凱基-和平",45,140,-95
"6509","2363矽統","110/07/26","日盛-雙和",109,14,95
"6510","2363矽統","110/07/26","合庫-台南",5,95,-90
"6511","8112至上","110/07/26","摩根大通",1728,41,1687
"6512","8112至上","110/07/26","玉山-左營",3,600,-597
"6513","8112至上","110/07/26","台灣摩根士丹利",408,10,398
"6514","8112至上","110/07/26","凱基-三重",1,527,-526
"6515","8112至上","110/07/26","凱基-台北",693,311,382
"6516","8112至上","110/07/26","中國信託-忠孝",0,103,-103
"6517","8112至上","110/07/26","港商法國興業",376,1,375
"6518","8112至上","110/07/26","凱基-站前",7,105,-98
"6519","8112至上","110/07/26","美商高盛",172,26,146
"6520","8112至上","110/07/26","國票-中港",0,96,-96
"6521","8112至上","110/07/26","新加坡商瑞銀",201,69,132
"6522","8112至上","110/07/26","兆豐-公益",3,84,-81
"6523","8112至上","110/07/26","美林",192,62,130
"6524","8112至上","110/07/26","玉山證券",2,65,-63
"6525","8112至上","110/07/26","港商野村",142,58,84
"6526","8112至上","110/07/26","統一-台中",1,62,-61
"6527","8112至上","110/07/26","凱基-永和",75,0,75
"6528","8112至上","110/07/26","富邦-陽明",3,60,-57
"6529","8112至上","110/07/26","凱基-竹科",65,2,63
"6530","8112至上","110/07/26","新光-新竹",86,141,-55
"6531","8112至上","110/07/26","華南永昌-敦南",63,1,62
"6532","8112至上","110/07/26","富邦-台北",2,57,-55
"6533","8112至上","110/07/26","兆豐-天母",50,0,50
"6534","8112至上","110/07/26","玉山-板橋",2,51,-49
"6535","8112至上","110/07/26","新光-桃園",57,11,46
"6536","8112至上","110/07/26","台新-新營",6,47,-41
"6537","8112至上","110/07/26","光和",35,1,34
"6538","8112至上","110/07/26","元大-虎尾",4,42,-38
"6539","8112至上","110/07/26","華南永昌-新莊",31,3,28
"6540","8112至上","110/07/26","日盛-新竹",1,38,-37
"6541","1570力肯","110/07/26","元大-民雄",10,0,10
"6542","1570力肯","110/07/26","元大-高雄",0,33,-33
"6543","1570力肯","110/07/26","新光-台中",10,1,9
"6544","1570力肯","110/07/26","日盛-宜蘭",0,8,-8
"6545","1570力肯","110/07/26","富邦-陽明",9,0,9
"6546","1570力肯","110/07/26","美林",0,5,-5
"6547","1570力肯","110/07/26","大慶-蘆洲",8,0,8
"6548","1570力肯","110/07/26","凱基-永康",0,5,-5
"6549","1570力肯","110/07/26","福勝",8,0,8
"6550","1570力肯","110/07/26","台新證券",0,4,-4
"6551","1570力肯","110/07/26","凱基-桃園",7,0,7
"6552","1570力肯","110/07/26","元大-汐止",0,4,-4
"6553","1570力肯","110/07/26","中國信託-永康",3,0,3
"6554","1570力肯","110/07/26","元大-桃興",0,3,-3
"6555","1570力肯","110/07/26","兆豐-台中港",3,0,3
"6556","1570力肯","110/07/26","元富-吉利",0,2,-2
"6557","1570力肯","110/07/26","國票-北高雄",3,0,3
"6558","1570力肯","110/07/26","國泰-板橋",0,2,-2
"6559","1570力肯","110/07/26","富邦-員林",3,0,3
"6560","1570力肯","110/07/26","元大-台中",0,2,-2
"6561","1570力肯","110/07/26","瑞士信貸",2,0,2
"6562","1570力肯","110/07/26","元大-西螺",0,2,-2
"6563","1570力肯","110/07/26","大昌-樹林",2,0,2
"6564","1570力肯","110/07/26","元大-苑裡",0,2,-2
"6565","1570力肯","110/07/26","兆豐-忠孝",2,0,2
"6566","1570力肯","110/07/26","合庫-三重",0,1,-1
"6567","1570力肯","110/07/26","新光",2,0,2
"6568","1570力肯","110/07/26","臺銀-臺南",0,1,-1
"6569","1570力肯","110/07/26","凱基-台北",2,0,2
"6570","1570力肯","110/07/26","元富-永和",0,1,-1
"6571","2929淘帝","110/07/26","合庫-高雄",47,0,47
"6572","2929淘帝","110/07/26","港商野村",11,42,-31
"6573","2929淘帝","110/07/26","元大-民生",28,0,28
"6574","2929淘帝","110/07/26","凱基-林口",0,30,-30
"6575","2929淘帝","110/07/26","臺銀-鳳山",10,0,10
"6576","2929淘帝","110/07/26","美林",1,28,-27
"6577","2929淘帝","110/07/26","華南永昌-鶯歌",10,0,10
"6578","2929淘帝","110/07/26","富邦-竹北",0,20,-20
"6579","2929淘帝","110/07/26","元大-永和",10,0,10
"6580","2929淘帝","110/07/26","凱基-台北",0,12,-12
"6581","2929淘帝","110/07/26","永豐金證券",8,0,8
"6582","2929淘帝","110/07/26","中國信託-永康",0,10,-10
"6583","2929淘帝","110/07/26","元大-太平",8,1,7
"6584","2929淘帝","110/07/26","摩根大通",0,10,-10
"6585","2929淘帝","110/07/26","德信-和平",6,0,6
"6586","2929淘帝","110/07/26","群益金鼎-高雄",0,10,-10
"6587","2929淘帝","110/07/26","兆豐-南門",6,0,6
"6588","2929淘帝","110/07/26","富邦-宜蘭",0,10,-10
"6589","2929淘帝","110/07/26","元大-新竹經國",6,0,6
"6590","2929淘帝","110/07/26","新加坡商瑞銀",4,13,-9
"6591","2929淘帝","110/07/26","合庫-台南",5,0,5
"6592","2929淘帝","110/07/26","元富-敦南",0,7,-7
"6593","2929淘帝","110/07/26","第一金-新興",5,0,5
"6594","2929淘帝","110/07/26","元大-基隆",0,6,-6
"6595","2929淘帝","110/07/26","玉山-新竹",5,0,5
"6596","2929淘帝","110/07/26","新光-台中",1,6,-5
"6597","2929淘帝","110/07/26","元大-金門",5,0,5
"6598","2929淘帝","110/07/26","華南永昌",0,5,-5
"6599","2929淘帝","110/07/26","台新-台中",4,0,4
"6600","2929淘帝","110/07/26","永豐金-中和",0,5,-5
"6601","5410國眾","110/07/26","摩根大通",71,0,71
"6602","5410國眾","110/07/26","日盛-忠孝",0,142,-142
"6603","5410國眾","110/07/26","凱基-台北",67,4,63
"6604","5410國眾","110/07/26","元富-嘉義",0,55,-55
"6605","5410國眾","110/07/26","兆豐-城中",47,0,47
"6606","5410國眾","110/07/26","國泰-敦南",2,30,-28
"6607","5410國眾","110/07/26","永豐金-內湖",45,0,45
"6608","5410國眾","110/07/26","群益金鼎-板橋",0,15,-15
"6609","5410國眾","110/07/26","元大-新莊",26,0,26
"6610","5410國眾","110/07/26","華南永昌-三重",0,11,-11
"6611","5410國眾","110/07/26","兆豐-麻豆",10,0,10
"6612","5410國眾","110/07/26","永全-南崁",0,10,-10
"6613","5410國眾","110/07/26","新光-台中",10,0,10
"6614","5410國眾","110/07/26","台新-建北",1,11,-10
"6615","5410國眾","110/07/26","元大-屏南",10,0,10
"6616","5410國眾","110/07/26","臺銀-臺南",0,8,-8
"6617","5410國眾","110/07/26","港商野村",9,0,9
"6618","5410國眾","110/07/26","群益金鼎-東大",0,7,-7
"6619","5410國眾","110/07/26","新光",13,4,9
"6620","5410國眾","110/07/26","永豐金-中正",0,7,-7
"6621","5410國眾","110/07/26","華南永昌-小港",7,0,7
"6622","5410國眾","110/07/26","永豐金-桃園",0,7,-7
"6623","5410國眾","110/07/26","玉山-左營",6,0,6
"6624","5410國眾","110/07/26","第一金-高雄",0,6,-6
"6625","5410國眾","110/07/26","土銀-台南",5,0,5
"6626","5410國眾","110/07/26","台中銀-豐原",0,6,-6
"6627","5410國眾","110/07/26","新加坡商瑞銀",5,0,5
"6628","5410國眾","110/07/26","亞東-高雄",0,5,-5
"6629","5410國眾","110/07/26","元富-三重",8,3,5
"6630","5410國眾","110/07/26","國票-北高雄",0,5,-5
"6631","2841台開","110/07/26","台新-台中",282,5,277
"6632","2841台開","110/07/26","港商野村",0,128,-128
"6633","2841台開","110/07/26","凱基-台北",41,0,41
"6634","2841台開","110/07/26","富邦-仁愛",0,70,-70
"6635","2841台開","110/07/26","台灣摩根士丹利",40,0,40
"6636","2841台開","110/07/26","元大-彰化",0,60,-60
"6637","2841台開","110/07/26","元富-緯城",40,0,40
"6638","2841台開","110/07/26","永興-水湳",0,30,-30
"6639","2841台開","110/07/26","玉山-高雄",38,0,38
"6640","2841台開","110/07/26","富邦-新竹華信",0,23,-23
"6641","2841台開","110/07/26","日盛-樹林",21,0,21
"6642","2841台開","110/07/26","宏遠-光隆",0,20,-20
"6643","2841台開","110/07/26","元大-松江",20,0,20
"6644","2841台開","110/07/26","玉山證券",0,20,-20
"6645","2841台開","110/07/26","元大-歸仁",20,0,20
"6646","2841台開","110/07/26","富邦-板橋",0,20,-20
"6647","2841台開","110/07/26","國泰-桃園",20,3,17
"6648","2841台開","110/07/26","元大-台中中港",0,19,-19
"6649","2841台開","110/07/26","新光-台中",15,0,15
"6650","2841台開","110/07/26","臺銀-臺南",0,18,-18
"6651","2841台開","110/07/26","群益金鼎-東門",11,0,11
"6652","2841台開","110/07/26","永豐金-敦南",3,19,-16
"6653","2841台開","110/07/26","華南永昌-內壢",11,0,11
"6654","2841台開","110/07/26","統一-桃園",0,13,-13
"6655","2841台開","110/07/26","元富-烏日",10,0,10
"6656","2841台開","110/07/26","國泰-台中",0,11,-11
"6657","2841台開","110/07/26","國泰-忠孝",10,2,8
"6658","2841台開","110/07/26","元大-福營",0,11,-11
"6659","2841台開","110/07/26","元大-潮州",6,0,6
"6660","2841台開","110/07/26","凱基-站前",0,10,-10
"6661","6207雷科","110/07/26","元大-向上",70,0,70
"6662","6207雷科","110/07/26","摩根大通",45,241,-196
"6663","6207雷科","110/07/26","國票-中和",67,5,62
"6664","6207雷科","110/07/26","華南永昌-台中",16,180,-164
"6665","6207雷科","110/07/26","永豐金-台南",63,2,61
"6666","6207雷科","110/07/26","瑞士信貸",4,69,-65
"6667","6207雷科","110/07/26","國泰-板橋",32,0,32
"6668","6207雷科","110/07/26","國票-天祥",11,76,-65
"6669","6207雷科","110/07/26","華南永昌-朴子",24,0,24
"6670","6207雷科","110/07/26","新加坡商瑞銀",15,78,-63
"6671","6207雷科","110/07/26","台新證券",35,12,23
"6672","6207雷科","110/07/26","凱基-台北",86,134,-48
"6673","6207雷科","110/07/26","永豐金-板盛",24,1,23
"6674","6207雷科","110/07/26","富邦-台中",58,100,-42
"6675","6207雷科","110/07/26","康和-台中",24,2,22
"6676","6207雷科","110/07/26","兆豐-大安",0,41,-41
"6677","6207雷科","110/07/26","台新-台南",22,2,20
"6678","6207雷科","110/07/26","群益金鼎-館前",0,40,-40
"6679","6207雷科","110/07/26","元大-大統",22,2,20
"6680","6207雷科","110/07/26","富邦-羅東",2,39,-37
"6681","6207雷科","110/07/26","元富-桃園",19,0,19
"6682","6207雷科","110/07/26","國票-台東",0,30,-30
"6683","6207雷科","110/07/26","高橋",17,0,17
"6684","6207雷科","110/07/26","凱基-士林",1,30,-29
"6685","6207雷科","110/07/26","元富-同大",30,13,17
"6686","6207雷科","110/07/26","元大-南京",3,31,-28
"6687","6207雷科","110/07/26","元大-內湖",17,0,17
"6688","6207雷科","110/07/26","宏遠-桃園",0,24,-24
"6689","6207雷科","110/07/26","永豐金-內湖",19,2,17
"6690","6207雷科","110/07/26","國票-和平",0,23,-23
"6691","3679新至陞","110/07/26","元富-板橋",16,0,16
"6692","3679新至陞","110/07/26","台新-台中",0,19,-19
"6693","3679新至陞","110/07/26","華南永昌-淡水",10,0,10
"6694","3679新至陞","110/07/26","元大-成功",0,10,-10
"6695","3679新至陞","110/07/26","光和-溪湖",8,0,8
"6696","3679新至陞","110/07/26","日進",0,9,-9
"6697","3679新至陞","110/07/26","宏遠-光隆",6,0,6
"6698","3679新至陞","110/07/26","臺銀-臺中",0,5,-5
"6699","3679新至陞","110/07/26","玉山-嘉義",5,0,5
"6700","3679新至陞","110/07/26","港商法國興業",0,4,-4
"6701","3679新至陞","110/07/26","元富-安南",3,0,3
"6702","3679新至陞","110/07/26","統一-新台中",0,3,-3
"6703","3679新至陞","110/07/26","摩根大通",4,1,3
"6704","3679新至陞","110/07/26","大慶-苗栗",1,3,-2
"6705","3679新至陞","110/07/26","凱基-台北",5,2,3
"6706","3679新至陞","110/07/26","元富-松德",0,2,-2
"6707","3679新至陞","110/07/26","凱基-站前",2,0,2
"6708","3679新至陞","110/07/26","富邦-仁愛",0,2,-2
"6709","3679新至陞","110/07/26","華南永昌",2,0,2
"6710","3679新至陞","110/07/26","元大-文心興安",0,2,-2
"6711","3679新至陞","110/07/26","元大-上新莊",2,0,2
"6712","3679新至陞","110/07/26","永豐金證券",0,2,-2
"6713","3679新至陞","110/07/26","美林",4,3,1
"6714","3679新至陞","110/07/26","臺銀-高雄",0,1,-1
"6715","3679新至陞","110/07/26","台灣摩根士丹利",2,1,1
"6716","3679新至陞","110/07/26","台灣企銀-屏東",0,1,-1
"6717","3679新至陞","110/07/26","美商高盛",1,0,1
"6718","3679新至陞","110/07/26","大慶-富順",0,1,-1
"6719","3679新至陞","110/07/26","富邦-台北",1,0,1
"6720","3679新至陞","110/07/26","統一-彰化",0,1,-1
"6721","2727王品","110/07/26","兆豐-南京",300,0,300
"6722","2727王品","110/07/26","元富-安南",0,62,-62
"6723","2727王品","110/07/26","凱基-台北",74,29,45
"6724","2727王品","110/07/26","瑞士信貸",0,44,-44
"6725","2727王品","110/07/26","富邦-建國",25,2,23
"6726","2727王品","110/07/26","新加坡商瑞銀",0,44,-44
"6727","2727王品","110/07/26","台灣摩根士丹利",22,0,22
"6728","2727王品","110/07/26","統一",11,54,-43
"6729","2727王品","110/07/26","永豐金-屏東",14,1,13
"6730","2727王品","110/07/26","美林",4,39,-35
"6731","2727王品","110/07/26","富邦-桃園",12,1,11
"6732","2727王品","110/07/26","第一金",0,30,-30
"6733","2727王品","110/07/26","日盛-鳳山",11,1,10
"6734","2727王品","110/07/26","康和-台中",0,30,-30
"6735","2727王品","110/07/26","元富-城中",10,0,10
"6736","2727王品","110/07/26","國泰證券",1,31,-30
"6737","2727王品","110/07/26","元大-龍潭",11,1,10
"6738","2727王品","110/07/26","元大證券",37,67,-30
"6739","2727王品","110/07/26","新光-台中",15,6,9
"6740","2727王品","110/07/26","康和",1,29,-28
"6741","2727王品","110/07/26","富邦-台中",10,1,9
"6742","2727王品","110/07/26","永豐金證券",0,27,-27
"6743","2727王品","110/07/26","元大-基隆孝二",10,1,9
"6744","2727王品","110/07/26","安泰",1,26,-25
"6745","2727王品","110/07/26","臺銀-臺中",10,2,8
"6746","2727王品","110/07/26","永豐金-古亭",2,20,-18
"6747","2727王品","110/07/26","元大-花蓮",8,0,8
"6748","2727王品","110/07/26","國票-天祥",0,16,-16
"6749","2727王品","110/07/26","元大-斗信",9,1,8
"6750","2727王品","110/07/26","摩根大通",17,33,-16
"6751","1570力肯","110/07/26","元大-民雄",10,0,10
"6752","1570力肯","110/07/26","元大-高雄",0,33,-33
"6753","1570力肯","110/07/26","新光-台中",10,1,9
"6754","1570力肯","110/07/26","日盛-宜蘭",0,8,-8
"6755","1570力肯","110/07/26","富邦-陽明",9,0,9
"6756","1570力肯","110/07/26","美林",0,5,-5
"6757","1570力肯","110/07/26","大慶-蘆洲",8,0,8
"6758","1570力肯","110/07/26","凱基-永康",0,5,-5
"6759","1570力肯","110/07/26","福勝",8,0,8
"6760","1570力肯","110/07/26","台新證券",0,4,-4
"6761","1570力肯","110/07/26","凱基-桃園",7,0,7
"6762","1570力肯","110/07/26","元大-汐止",0,4,-4
"6763","1570力肯","110/07/26","中國信託-永康",3,0,3
"6764","1570力肯","110/07/26","元大-桃興",0,3,-3
"6765","1570力肯","110/07/26","兆豐-台中港",3,0,3
"6766","1570力肯","110/07/26","元富-吉利",0,2,-2
"6767","1570力肯","110/07/26","國票-北高雄",3,0,3
"6768","1570力肯","110/07/26","國泰-板橋",0,2,-2
"6769","1570力肯","110/07/26","富邦-員林",3,0,3
"6770","1570力肯","110/07/26","元大-台中",0,2,-2
"6771","1570力肯","110/07/26","瑞士信貸",2,0,2
"6772","1570力肯","110/07/26","元大-西螺",0,2,-2
"6773","1570力肯","110/07/26","大昌-樹林",2,0,2
"6774","1570力肯","110/07/26","元大-苑裡",0,2,-2
"6775","1570力肯","110/07/26","兆豐-忠孝",2,0,2
"6776","1570力肯","110/07/26","合庫-三重",0,1,-1
"6777","1570力肯","110/07/26","新光",2,0,2
"6778","1570力肯","110/07/26","臺銀-臺南",0,1,-1
"6779","1570力肯","110/07/26","凱基-台北",2,0,2
"6780","1570力肯","110/07/26","元富-永和",0,1,-1
"6781","6180橘子","110/07/26","凱基-台北",121,1,120
"6782","6180橘子","110/07/26","元大-竹山",0,35,-35
"6783","6180橘子","110/07/26","新加坡商瑞銀",71,2,69
"6784","6180橘子","110/07/26","元大-和平",0,30,-30
"6785","6180橘子","110/07/26","摩根大通",70,4,66
"6786","6180橘子","110/07/26","元大-草屯",3,27,-24
"6787","6180橘子","110/07/26","美林",33,0,33
"6788","6180橘子","110/07/26","華南永昌-高雄",0,21,-21
"6789","6180橘子","110/07/26","台灣摩根士丹利",20,4,16
"6790","6180橘子","110/07/26","兆豐-埔墘",0,18,-18
"6791","6180橘子","110/07/26","合庫-高雄",11,0,11
"6792","6180橘子","110/07/26","元富-林園",0,17,-17
"6793","6180橘子","110/07/26","港商野村",10,0,10
"6794","6180橘子","110/07/26","元富-成功",0,16,-16
"6795","6180橘子","110/07/26","富邦-宜蘭",10,0,10
"6796","6180橘子","110/07/26","群益金鼎-台南",0,13,-13
"6797","6180橘子","110/07/26","統一-彰化",10,1,9
"6798","6180橘子","110/07/26","元大-開元",0,13,-13
"6799","6180橘子","110/07/26","兆豐-北高雄",9,1,8
"6800","6180橘子","110/07/26","富邦-台中",0,12,-12
"6801","6180橘子","110/07/26","元大-新店中正",10,2,8
"6802","6180橘子","110/07/26","(牛牛牛)亞-鑫豐",1,12,-11
"6803","6180橘子","110/07/26","國泰-敦南",10,3,7
"6804","6180橘子","110/07/26","台新-台南",0,11,-11
"6805","6180橘子","110/07/26","合庫-自強",5,0,5
"6806","6180橘子","110/07/26","聯邦-興中",0,11,-11
"6807","6180橘子","110/07/26","大慶-蘆洲",5,0,5
"6808","6180橘子","110/07/26","日盛-中和",0,10,-10
"6809","6180橘子","110/07/26","統一-中壢",5,0,5
"6810","6180橘子","110/07/26","康和-台北",0,10,-10
"6811","2390云辰","110/07/26","元大-大同",311,3,308
"6812","2390云辰","110/07/26","摩根大通",139,570,-431
"6813","2390云辰","110/07/26","華南永昌-鳳山",276,4,272
"6814","2390云辰","110/07/26","美林",103,243,-140
"6815","2390云辰","110/07/26","永豐金-竹北",201,6,195
"6816","2390云辰","110/07/26","元大-彰化民生",0,117,-117
"6817","2390云辰","110/07/26","富邦-左營",107,17,90
"6818","2390云辰","110/07/26","元富-中港",0,102,-102
"6819","2390云辰","110/07/26","元富-高雄",82,5,77
"6820","2390云辰","110/07/26","凱基-台北",161,249,-88
"6821","2390云辰","110/07/26","元大-太平",75,10,65
"6822","2390云辰","110/07/26","國票-新莊",15,78,-63
"6823","2390云辰","110/07/26","元大-大益",63,13,50
"6824","2390云辰","110/07/26","第一金-豐原",1,59,-58
"6825","2390云辰","110/07/26","元富-新竹",41,1,40
"6826","2390云辰","110/07/26","統一-竹南",5,48,-43
"6827","2390云辰","110/07/26","日盛-永康",42,4,38
"6828","2390云辰","110/07/26","第一金-台南",28,62,-34
"6829","2390云辰","110/07/26","群益金鼎-中壢",50,12,38
"6830","2390云辰","110/07/26","台灣摩根士丹利",38,70,-32
"6831","2390云辰","110/07/26","元大-鑫永和",54,18,36
"6832","2390云辰","110/07/26","群益金鼎-士林",20,52,-32
"6833","2390云辰","110/07/26","元富-同大",34,1,33
"6834","2390云辰","110/07/26","群益金鼎-延平",2,31,-29
"6835","2390云辰","110/07/26","致和-崇德",52,21,31
"6836","2390云辰","110/07/26","凱基-豐中",12,40,-28
"6837","2390云辰","110/07/26","永豐金-松山",32,2,30
"6838","2390云辰","110/07/26","富邦-中壢",19,47,-28
"6839","2390云辰","110/07/26","凱基-三重",36,8,28
"6840","2390云辰","110/07/26","統一-基隆",2,27,-25
"6841","2363矽統","110/07/20","第一金-忠孝",400,115,285
"6842","2363矽統","110/07/20","國票-長城",3,452,-449
"6843","2363矽統","110/07/20","第一金-高雄",188,0,188
"6844","2363矽統","110/07/20","美林",158,531,-373
"6845","2363矽統","110/07/20","凱基-高美館",199,14,185
"6846","2363矽統","110/07/20","台新-左楠",13,310,-297
"6847","2363矽統","110/07/20","凱基-台北",434,326,108
"6848","2363矽統","110/07/20","玉山-台大",4,228,-224
"6849","2363矽統","110/07/20","元富-松德",105,0,105
"6850","2363矽統","110/07/20","群益金鼎-大甲",11,227,-216
"6851","2363矽統","110/07/20","元大-竹科",109,7,102
"6852","2363矽統","110/07/20","群益金鼎-中港",2,111,-109
"6853","2363矽統","110/07/20","元大-成功",102,2,100
"6854","2363矽統","110/07/20","元大-大天母",0,109,-109
"6855","2363矽統","110/07/20","富邦-仁愛",116,17,99
"6856","2363矽統","110/07/20","國泰-敦南",114,218,-104
"6857","2363矽統","110/07/20","元大-上新莊",102,16,86
"6858","2363矽統","110/07/20","港商野村",250,350,-100
"6859","2363矽統","110/07/20","台新證券",286,208,78
"6860","2363矽統","110/07/20","康和-澎湖",0,90,-90
"6861","2363矽統","110/07/20","元大-新營",81,9,72
"6862","2363矽統","110/07/20","凱基-中壢",15,99,-84
"6863","2363矽統","110/07/20","華南永昌-鳳山",76,5,71
"6864","2363矽統","110/07/20","元大-學甲",0,81,-81
"6865","2363矽統","110/07/20","富邦-員林",65,2,63
"6866","2363矽統","110/07/20","凱基-三重",22,91,-69
"6867","2363矽統","110/07/20","元富-成功",67,6,61
"6868","2363矽統","110/07/20","永豐金-嘉義",24,92,-68
"6869","2363矽統","110/07/20","新光-新竹",62,1,61
"6870","2363矽統","110/07/20","大慶-蘆洲",23,89,-66
"6871","8112至上","110/07/20","摩根大通",1226,293,933
"6872","8112至上","110/07/20","凱基-三重",27,502,-475
"6873","8112至上","110/07/20","新加坡商瑞銀",358,83,275
"6874","8112至上","110/07/20","宏遠證券",0,418,-418
"6875","8112至上","110/07/20","台灣摩根士丹利",159,9,150
"6876","8112至上","110/07/20","台新-台中",11,291,-280
"6877","8112至上","110/07/20","統一-新竹",115,5,110
"6878","8112至上","110/07/20","美林",44,194,-150
"6879","8112至上","110/07/20","新光",233,126,107
"6880","8112至上","110/07/20","凱基-新莊",0,100,-100
"6881","8112至上","110/07/20","凱基-台北",367,260,107
"6882","8112至上","110/07/20","富邦-永和",14,104,-90
"6883","8112至上","110/07/20","兆豐-西螺",104,10,94
"6884","8112至上","110/07/20","國票-敦北法人",4,88,-84
"6885","8112至上","110/07/20","永豐金-中正",87,6,81
"6886","8112至上","110/07/20","凱基-市政",3,80,-77
"6887","8112至上","110/07/20","富邦-新店",102,24,78
"6888","8112至上","110/07/20","台新證券",68,142,-74
"6889","8112至上","110/07/20","元大-大同",83,5,78
"6890","8112至上","110/07/20","永豐金-中壢",11,80,-69
"6891","8112至上","110/07/20","富邦-園區",64,2,62
"6892","8112至上","110/07/20","永豐金-台南",22,91,-69
"6893","8112至上","110/07/20","新光-台南",73,14,59
"6894","8112至上","110/07/20","元大-大雅",22,87,-65
"6895","8112至上","110/07/20","統一-台中",60,2,58
"6896","8112至上","110/07/20","光和",10,67,-57
"6897","8112至上","110/07/20","元大-北成功",58,4,54
"6898","8112至上","110/07/20","元大-竹科",27,74,-47
"6899","8112至上","110/07/20","元富-林園",53,0,53
"6900","8112至上","110/07/20","兆豐-公益",1,47,-46
"6901","1570力肯","110/07/20","國票-北高雄",36,0,36
"6902","1570力肯","110/07/20","國泰-敦南",0,19,-19
"6903","1570力肯","110/07/20","群益金鼎-高雄",16,0,16
"6904","1570力肯","110/07/20","中國信託-永康",0,12,-12
"6905","1570力肯","110/07/20","臺銀-鳳山",10,0,10
"6906","1570力肯","110/07/20","第一金-路竹",0,10,-10
"6907","1570力肯","110/07/20","群益金鼎-新竹",6,0,6
"6908","1570力肯","110/07/20","福勝",0,10,-10
"6909","1570力肯","110/07/20","大昌-樹林",5,0,5
"6910","1570力肯","110/07/20","群益金鼎-板橋",0,10,-10
"6911","1570力肯","110/07/20","華南永昌-楠梓",5,0,5
"6912","1570力肯","110/07/20","日盛-鳳山",0,8,-8
"6913","1570力肯","110/07/20","元大-基隆孝二",5,0,5
"6914","1570力肯","110/07/20","永豐金-新竹",6,14,-8
"6915","1570力肯","110/07/20","元大-新竹經國",4,0,4
"6916","1570力肯","110/07/20","第一金-彰化",0,7,-7
"6917","1570力肯","110/07/20","土銀-高雄",2,0,2
"6918","1570力肯","110/07/20","元富-吉利",0,7,-7
"6919","1570力肯","110/07/20","台灣企銀-太平",2,0,2
"6920","1570力肯","110/07/20","台中銀-員林",0,7,-7
"6921","1570力肯","110/07/20","兆豐-忠孝",2,0,2
"6922","1570力肯","110/07/20","玉山證券",1,8,-7
"6923","1570力肯","110/07/20","玉山-城中",2,0,2
"6924","1570力肯","110/07/20","統一-三重",0,5,-5
"6925","1570力肯","110/07/20","國泰-板橋",2,0,2
"6926","1570力肯","110/07/20","光和-溪湖",0,3,-3
"6927","1570力肯","110/07/20","凱基-台北",2,0,2
"6928","1570力肯","110/07/20","康和-澎湖",0,3,-3
"6929","1570力肯","110/07/20","華南永昌-高雄",2,0,2
"6930","1570力肯","110/07/20","摩根大通",0,2,-2
"6931","2929淘帝","110/07/20","玉山-新竹",59,0,59
"6932","2929淘帝","110/07/20","臺銀",0,45,-45
"6933","2929淘帝","110/07/20","兆豐-新莊",50,0,50
"6934","2929淘帝","110/07/20","光和-嘉義",0,29,-29
"6935","2929淘帝","110/07/20","元大-大甲",30,0,30
"6936","2929淘帝","110/07/20","新加坡商瑞銀",27,55,-28
"6937","2929淘帝","110/07/20","元大-民生",29,0,29
"6938","2929淘帝","110/07/20","華南永昌-潮州",0,20,-20
"6939","2929淘帝","110/07/20","元大-員林",20,0,20
"6940","2929淘帝","110/07/20","玉山-高雄",0,14,-14
"6941","2929淘帝","110/07/20","元富-台南",18,0,18
"6942","2929淘帝","110/07/20","富邦-南屯",2,13,-11
"6943","2929淘帝","110/07/20","港商野村",63,50,13
"6944","2929淘帝","110/07/20","高橋-龍潭",0,10,-10
"6945","2929淘帝","110/07/20","高橋",10,0,10
"6946","2929淘帝","110/07/20","台新-建北",0,10,-10
"6947","2929淘帝","110/07/20","元富-林園",10,0,10
"6948","2929淘帝","110/07/20","群益金鼎-台中",0,10,-10
"6949","2929淘帝","110/07/20","玉山-台南",10,0,10
"6950","2929淘帝","110/07/20","華南永昌-苗栗",0,10,-10
"6951","2929淘帝","110/07/20","群益金鼎-士林",10,0,10
"6952","2929淘帝","110/07/20","群益金鼎-西松",0,9,-9
"6953","2929淘帝","110/07/20","凱基-台北",16,6,10
"6954","2929淘帝","110/07/20","台新-三民",0,8,-8
"6955","2929淘帝","110/07/20","合庫證券",9,0,9
"6956","2929淘帝","110/07/20","群益金鼎",0,8,-8
"6957","2929淘帝","110/07/20","永豐金證券",9,2,7
"6958","2929淘帝","110/07/20","富邦-永和",0,7,-7
"6959","2929淘帝","110/07/20","凱基-基隆",6,0,6
"6960","2929淘帝","110/07/20","國泰-台中",6,12,-6
"6961","5410國眾","110/07/20","日盛-內湖",27,0,27
"6962","5410國眾","110/07/20","永豐金-內湖",0,23,-23
"6963","5410國眾","110/07/20","富邦-新營",20,0,20
"6964","5410國眾","110/07/20","兆豐-台中港",0,20,-20
"6965","5410國眾","110/07/20","大昌",17,0,17
"6966","5410國眾","110/07/20","元富-嘉義",0,15,-15
"6967","5410國眾","110/07/20","永豐金-台南",17,0,17
"6968","5410國眾","110/07/20","元富-吉利",0,11,-11
"6969","5410國眾","110/07/20","凱基-站前",15,0,15
"6970","5410國眾","110/07/20","凱基-長庚",0,10,-10
"6971","5410國眾","110/07/20","凱基-竹北",11,0,11
"6972","5410國眾","110/07/20","元大-八德",0,10,-10
"6973","5410國眾","110/07/20","元富-民權",9,0,9
"6974","5410國眾","110/07/20","元大-天母",0,10,-10
"6975","5410國眾","110/07/20","群益金鼎-嘉義",6,0,6
"6976","5410國眾","110/07/20","國泰-桃園",0,9,-9
"6977","5410國眾","110/07/20","元大-土城學府",6,0,6
"6978","5410國眾","110/07/20","新光",5,12,-7
"6979","5410國眾","110/07/20","第一金-豐原",5,0,5
"6980","5410國眾","110/07/20","玉山-桃園",0,7,-7
"6981","5410國眾","110/07/20","華南永昌-林口",5,0,5
"6982","5410國眾","110/07/20","玉山-雙和",0,6,-6
"6983","5410國眾","110/07/20","元大-博愛",5,0,5
"6984","5410國眾","110/07/20","臺銀-臺南",0,5,-5
"6985","5410國眾","110/07/20","元大-竹南",5,0,5
"6986","5410國眾","110/07/20","彰銀-七賢",0,5,-5
"6987","5410國眾","110/07/20","元大-新店中正",5,0,5
"6988","5410國眾","110/07/20","宏遠證券",0,5,-5
"6989","5410國眾","110/07/20","元富-烏日",4,0,4
"6990","5410國眾","110/07/20","摩根大通",0,5,-5
"6991","2841台開","110/07/20","中國信託-忠孝",145,0,145
"6992","2841台開","110/07/20","凱基-松山",0,100,-100
"6993","2841台開","110/07/20","第一金-台中",68,0,68
"6994","2841台開","110/07/20","第一金-自由",0,33,-33
"6995","2841台開","110/07/20","美商高盛",37,0,37
"6996","2841台開","110/07/20","港商野村",0,29,-29
"6997","2841台開","110/07/20","台中銀",32,0,32
"6998","2841台開","110/07/20","國泰-敦南",11,31,-20
"6999","2841台開","110/07/20","台新-台中",20,0,20
"7000","2841台開","110/07/20","華南永昌-台中",0,20,-20
"7001","2841台開","110/07/20","凱基-東港",10,0,10
"7002","2841台開","110/07/20","元大-發財",0,15,-15
"7003","2841台開","110/07/20","大昌-安康",10,3,7
"7004","2841台開","110/07/20","元大-福營",9,23,-14
"7005","2841台開","110/07/20","豐農",7,0,7
"7006","2841台開","110/07/20","永豐金-敦南",5,18,-13
"7007","2841台開","110/07/20","元大-歸仁",7,0,7
"7008","2841台開","110/07/20","統一-城中",0,11,-11
"7009","2841台開","110/07/20","日盛-木柵",5,0,5
"7010","2841台開","110/07/20","日盛-台南",0,10,-10
"7011","2841台開","110/07/20","台新-台南",4,0,4
"7012","2841台開","110/07/20","兆豐-寶成",0,10,-10
"7013","2841台開","110/07/20","日盛證券",3,0,3
"7014","2841台開","110/07/20","國票-中港",0,10,-10
"7015","2841台開","110/07/20","台新證券",8,5,3
"7016","2841台開","110/07/20","群益金鼎",0,10,-10
"7017","2841台開","110/07/20","元大-沙鹿",3,0,3
"7018","2841台開","110/07/20","玉山證券",1,10,-9
"7019","2841台開","110/07/20","國泰-台中",2,0,2
"7020","2841台開","110/07/20","大昌-新店",0,6,-6
"7021","6207雷科","110/07/20","元大-西門",100,4,96
"7022","6207雷科","110/07/20","永豐金-內湖",0,109,-109
"7023","6207雷科","110/07/20","凱基-復興",50,0,50
"7024","6207雷科","110/07/20","國泰證券",0,90,-90
"7025","6207雷科","110/07/20","凱基-台北",47,1,46
"7026","6207雷科","110/07/20","元大-頭份",0,55,-55
"7027","6207雷科","110/07/20","玉山-城中",43,1,42
"7028","6207雷科","110/07/20","永豐金-虎尾",0,50,-50
"7029","6207雷科","110/07/20","華南永昌-長虹",44,5,39
"7030","6207雷科","110/07/20","元富-世貿",0,33,-33
"7031","6207雷科","110/07/20","凱基-板橋",38,1,37
"7032","6207雷科","110/07/20","元大-南崁",0,22,-22
"7033","6207雷科","110/07/20","元富-信義",39,3,36
"7034","6207雷科","110/07/20","永豐金-鳳山",0,21,-21
"7035","6207雷科","110/07/20","元富-彰化",35,0,35
"7036","6207雷科","110/07/20","永豐金-三重",6,27,-21
"7037","6207雷科","110/07/20","凱基-高美館",34,0,34
"7038","6207雷科","110/07/20","第一金-澎湖",0,20,-20
"7039","6207雷科","110/07/20","富邦-中壢",26,2,24
"7040","6207雷科","110/07/20","群益金鼎-東大",0,20,-20
"7041","6207雷科","110/07/20","大昌-桃園",23,0,23
"7042","6207雷科","110/07/20","兆豐-民生",0,19,-19
"7043","6207雷科","110/07/20","元大-四維",39,17,22
"7044","6207雷科","110/07/20","元大-北成功",1,20,-19
"7045","6207雷科","110/07/20","台灣摩根士丹利",18,0,18
"7046","6207雷科","110/07/20","元大-虎尾",1,18,-17
"7047","6207雷科","110/07/20","國票-中和",16,0,16
"7048","6207雷科","110/07/20","元大-文心興安",0,15,-15
"7049","6207雷科","110/07/20","永豐金-大園",16,0,16
"7050","6207雷科","110/07/20","瑞士信貸",0,14,-14
"7051","3679新至陞","110/07/20","國票-敦北法人",18,0,18
"7052","3679新至陞","110/07/20","華南永昌-台中",0,32,-32
"7053","3679新至陞","110/07/20","台中銀-員林",17,3,14
"7054","3679新至陞","110/07/20","凱基-台北",12,32,-20
"7055","3679新至陞","110/07/20","群益金鼎-高盛",13,0,13
"7056","3679新至陞","110/07/20","摩根大通",2,14,-12
"7057","3679新至陞","110/07/20","康和-澎湖",8,0,8
"7058","3679新至陞","110/07/20","國泰-桃園",0,11,-11
"7059","3679新至陞","110/07/20","台新證券",6,0,6
"7060","3679新至陞","110/07/20","群益金鼎-台南",0,10,-10
"7061","3679新至陞","110/07/20","宏遠-光隆",4,0,4
"7062","3679新至陞","110/07/20","群益金鼎-大安",0,10,-10
"7063","3679新至陞","110/07/20","玉山-大里",4,0,4
"7064","3679新至陞","110/07/20","永豐金證券",4,14,-10
"7065","3679新至陞","110/07/20","台中銀-豐原",3,0,3
"7066","3679新至陞","110/07/20","兆豐-大同",1,6,-5
"7067","3679新至陞","110/07/20","玉山-新莊",3,0,3
"7068","3679新至陞","110/07/20","群益金鼎-館前",0,4,-4
"7069","3679新至陞","110/07/20","凱基-中山",3,0,3
"7070","3679新至陞","110/07/20","富邦-南屯",0,4,-4
"7071","3679新至陞","110/07/20","富邦-台北",3,0,3
"7072","3679新至陞","110/07/20","瑞士信貸",3,6,-3
"7073","3679新至陞","110/07/20","元大-板橋",3,0,3
"7074","3679新至陞","110/07/20","國泰-板橋",0,3,-3
"7075","3679新至陞","110/07/20","日盛-八德",2,0,2
"7076","3679新至陞","110/07/20","富邦-中壢",1,4,-3
"7077","3679新至陞","110/07/20","日盛-復興",2,0,2
"7078","3679新至陞","110/07/20","台灣企銀",0,2,-2
"7079","3679新至陞","110/07/20","康和-板橋",2,0,2
"7080","3679新至陞","110/07/20","日盛-大墩",0,2,-2
"7081","2727王品","110/07/20","兆豐-南京",200,0,200
"7082","2727王品","110/07/20","凱基-市政",1,75,-74
"7083","2727王品","110/07/20","富邦證券",88,0,88
"7084","2727王品","110/07/20","美商高盛",6,38,-32
"7085","2727王品","110/07/20","台新證券",142,55,87
"7086","2727王品","110/07/20","富邦-陽明",7,38,-31
"7087","2727王品","110/07/20","瑞士信貸",50,0,50
"7088","2727王品","110/07/20","永豐金-中正",3,34,-31
"7089","2727王品","110/07/20","港商野村",106,57,49
"7090","2727王品","110/07/20","永豐金-潮州",0,31,-31
"7091","2727王品","110/07/20","凱基-台北",67,27,40
"7092","2727王品","110/07/20","兆豐-大安",0,30,-30
"7093","2727王品","110/07/20","永豐金-大園",29,2,27
"7094","2727王品","110/07/20","摩根大通",50,73,-23
"7095","2727王品","110/07/20","康和-高雄",20,0,20
"7096","2727王品","110/07/20","日盛證券",4,24,-20
"7097","2727王品","110/07/20","第一金-高雄",20,3,17
"7098","2727王品","110/07/20","凱基-大里",0,20,-20
"7099","2727王品","110/07/20","富邦-板橋",21,4,17
"7100","2727王品","110/07/20","群益金鼎-大甲",0,18,-18
"7101","2727王品","110/07/20","永豐金-桃盛",15,0,15
"7102","2727王品","110/07/20","統一",18,29,-11
"7103","2727王品","110/07/20","凱基",13,0,13
"7104","2727王品","110/07/20","國泰-台中",12,23,-11
"7105","2727王品","110/07/20","新加坡商瑞銀",23,11,12
"7106","2727王品","110/07/20","元大-彰化",0,11,-11
"7107","2727王品","110/07/20","亞東",10,0,10
"7108","2727王品","110/07/20","國泰-館前",4,14,-10
"7109","2727王品","110/07/20","康和-台中",13,4,9
"7110","2727王品","110/07/20","元大-學甲",0,10,-10
"7111","1570力肯","110/07/20","國票-北高雄",36,0,36
"7112","1570力肯","110/07/20","國泰-敦南",0,19,-19
"7113","1570力肯","110/07/20","群益金鼎-高雄",16,0,16
"7114","1570力肯","110/07/20","中國信託-永康",0,12,-12
"7115","1570力肯","110/07/20","臺銀-鳳山",10,0,10
"7116","1570力肯","110/07/20","第一金-路竹",0,10,-10
"7117","1570力肯","110/07/20","群益金鼎-新竹",6,0,6
"7118","1570力肯","110/07/20","福勝",0,10,-10
"7119","1570力肯","110/07/20","大昌-樹林",5,0,5
"7120","1570力肯","110/07/20","群益金鼎-板橋",0,10,-10
"7121","1570力肯","110/07/20","華南永昌-楠梓",5,0,5
"7122","1570力肯","110/07/20","日盛-鳳山",0,8,-8
"7123","1570力肯","110/07/20","元大-基隆孝二",5,0,5
"7124","1570力肯","110/07/20","永豐金-新竹",6,14,-8
"7125","1570力肯","110/07/20","元大-新竹經國",4,0,4
"7126","1570力肯","110/07/20","第一金-彰化",0,7,-7
"7127","1570力肯","110/07/20","土銀-高雄",2,0,2
"7128","1570力肯","110/07/20","元富-吉利",0,7,-7
"7129","1570力肯","110/07/20","台灣企銀-太平",2,0,2
"7130","1570力肯","110/07/20","台中銀-員林",0,7,-7
"7131","1570力肯","110/07/20","兆豐-忠孝",2,0,2
"7132","1570力肯","110/07/20","玉山證券",1,8,-7
"7133","1570力肯","110/07/20","玉山-城中",2,0,2
"7134","1570力肯","110/07/20","統一-三重",0,5,-5
"7135","1570力肯","110/07/20","國泰-板橋",2,0,2
"7136","1570力肯","110/07/20","光和-溪湖",0,3,-3
"7137","1570力肯","110/07/20","凱基-台北",2,0,2
"7138","1570力肯","110/07/20","康和-澎湖",0,3,-3
"7139","1570力肯","110/07/20","華南永昌-高雄",2,0,2
"7140","1570力肯","110/07/20","摩根大通",0,2,-2
"7141","6180橘子","110/07/20","摩根大通",89,31,58
"7142","6180橘子","110/07/20","群益金鼎-中山",0,80,-80
"7143","6180橘子","110/07/20","美商高盛",27,0,27
"7144","6180橘子","110/07/20","台中銀-台北",0,30,-30
"7145","6180橘子","110/07/20","新加坡商瑞銀",28,1,27
"7146","6180橘子","110/07/20","日盛-新莊",1,22,-21
"7147","6180橘子","110/07/20","新光",41,16,25
"7148","6180橘子","110/07/20","元富-緯城",2,20,-18
"7149","6180橘子","110/07/20","日盛-文化",21,0,21
"7150","6180橘子","110/07/20","日盛-新竹",2,15,-13
"7151","6180橘子","110/07/20","元富-潮州",20,0,20
"7152","6180橘子","110/07/20","元大-汐止",0,12,-12
"7153","6180橘子","110/07/20","凱基-台北",31,11,20
"7154","6180橘子","110/07/20","元大-豐原站前",0,12,-12
"7155","6180橘子","110/07/20","元大-草屯",18,0,18
"7156","6180橘子","110/07/20","德信-中正",0,10,-10
"7157","6180橘子","110/07/20","花旗環球",13,0,13
"7158","6180橘子","110/07/20","新光-台南",0,10,-10
"7159","6180橘子","110/07/20","元大-桃園",12,0,12
"7160","6180橘子","110/07/20","玉山-雙和",0,10,-10
"7161","6180橘子","110/07/20","群益金鼎",10,0,10
"7162","6180橘子","110/07/20","元大-四維",0,10,-10
"7163","6180橘子","110/07/20","元大-高雄",10,0,10
"7164","6180橘子","110/07/20","元大-永春",2,12,-10
"7165","6180橘子","110/07/20","群益金鼎-嘉義",9,0,9
"7166","6180橘子","110/07/20","凱基-高美館",0,8,-8
"7167","6180橘子","110/07/20","富邦-嘉義",9,0,9
"7168","6180橘子","110/07/20","華南永昌",2,10,-8
"7169","6180橘子","110/07/20","元富-草屯",10,2,8
"7170","6180橘子","110/07/20","富邦-台北",0,8,-8
"7171","2390云辰","110/07/20","元大證券",6043,11,6032
"7172","2390云辰","110/07/20","華南永昌-鳳山",2,312,-310
"7173","2390云辰","110/07/20","兆豐-復興",998,0,998
"7174","2390云辰","110/07/20","台灣摩根士丹利",0,247,-247
"7175","2390云辰","110/07/20","富邦-嘉義",775,7,768
"7176","2390云辰","110/07/20","元大-復北",4,239,-235
"7177","2390云辰","110/07/20","統一-台中",350,6,344
"7178","2390云辰","110/07/20","富邦-建國",25,236,-211
"7179","2390云辰","110/07/20","兆豐-城中",240,0,240
"7180","2390云辰","110/07/20","元富-中港",0,202,-202
"7181","2390云辰","110/07/20","群益金鼎-館前",204,2,202
"7182","2390云辰","110/07/20","國泰-敦南",20,194,-174
"7183","2390云辰","110/07/20","凱基-大直",187,0,187
"7184","2390云辰","110/07/20","元大-土城學府",10,156,-146
"7185","2390云辰","110/07/20","永豐金證券",160,10,150
"7186","2390云辰","110/07/20","中國信託-松江",0,130,-130
"7187","2390云辰","110/07/20","日盛-高雄",104,2,102
"7188","2390云辰","110/07/20","凱基-基隆",0,130,-130
"7189","2390云辰","110/07/20","凱基-中山",100,3,97
"7190","2390云辰","110/07/20","永豐金-中正",1,117,-116
"7191","2390云辰","110/07/20","元大-基隆",85,7,78
"7192","2390云辰","110/07/20","富邦-陽明",1,94,-93
"7193","2390云辰","110/07/20","群益金鼎-東大",64,2,62
"7194","2390云辰","110/07/20","元大-潮州",20,112,-92
"7195","2390云辰","110/07/20","元大-前金",60,1,59
"7196","2390云辰","110/07/20","宏遠證券",0,89,-89
"7197","2390云辰","110/07/20","國票-北高雄",63,14,49
"7198","2390云辰","110/07/20","兆豐-台中",0,75,-75
"7199","2390云辰","110/07/20","群益金鼎-三重",40,6,34
"7200","2390云辰","110/07/20","新光",8,82,-74
"7201","2363矽統","110/07/19","第一金-忠孝",210,0,210
"7202","2363矽統","110/07/19","富邦-仁愛",32,575,-543
"7203","2363矽統","110/07/19","中國信託-文心",191,9,182
"7204","2363矽統","110/07/19","新加坡商瑞銀",53,486,-433
"7205","2363矽統","110/07/19","華南永昌-鳳山",116,1,115
"7206","2363矽統","110/07/19","摩根大通",42,320,-278
"7207","2363矽統","110/07/19","元大-新竹",113,12,101
"7208","2363矽統","110/07/19","元大-竹科",3,201,-198
"7209","2363矽統","110/07/19","凱基-中山",89,1,88
"7210","2363矽統","110/07/19","元大-成功",7,183,-176
"7211","2363矽統","110/07/19","永豐金-嘉義",82,7,75
"7212","2363矽統","110/07/19","凱基-大里",0,150,-150
"7213","2363矽統","110/07/19","凱基-台南",72,4,68
"7214","2363矽統","110/07/19","瑞士信貸",80,215,-135
"7215","2363矽統","110/07/19","元富-城東",84,17,67
"7216","2363矽統","110/07/19","日盛-新莊",4,135,-131
"7217","2363矽統","110/07/19","群益金鼎-東湖",61,0,61
"7218","2363矽統","110/07/19","宏遠-桃園",20,150,-130
"7219","2363矽統","110/07/19","兆豐-中壢",55,0,55
"7220","2363矽統","110/07/19","凱基-三重",7,107,-100
"7221","2363矽統","110/07/19","康和-內湖",55,1,54
"7222","2363矽統","110/07/19","凱基-台北",384,476,-92
"7223","2363矽統","110/07/19","群益金鼎-桃園",55,2,53
"7224","2363矽統","110/07/19","合庫-台中",3,84,-81
"7225","2363矽統","110/07/19","群益金鼎-大興",50,0,50
"7226","2363矽統","110/07/19","致和-金華",1,80,-79
"7227","2363矽統","110/07/19","台新-台中",81,32,49
"7228","2363矽統","110/07/19","凱基-員林",5,77,-72
"7229","2363矽統","110/07/19","北城證券",58,10,48
"7230","2363矽統","110/07/19","華南永昌-合泰",2,70,-68
"7231","8112至上","110/07/19","摩根大通",1413,144,1269
"7232","8112至上","110/07/19","凱基-三重",3,600,-597
"7233","8112至上","110/07/19","凱基-台北",1053,266,787
"7234","8112至上","110/07/19","元大-府城",0,165,-165
"7235","8112至上","110/07/19","新加坡商瑞銀",523,2,521
"7236","8112至上","110/07/19","台灣企銀-台中",0,150,-150
"7237","8112至上","110/07/19","台灣摩根士丹利",487,8,479
"7238","8112至上","110/07/19","(牛牛牛)亞-鑫豐",26,119,-93
"7239","8112至上","110/07/19","美林",529,93,436
"7240","8112至上","110/07/19","永豐金-台南",15,95,-80
"7241","8112至上","110/07/19","港商野村",358,36,322
"7242","8112至上","110/07/19","亞東-板橋",2,81,-79
"7243","8112至上","110/07/19","美商高盛",276,3,273
"7244","8112至上","110/07/19","陽信",0,70,-70
"7245","8112至上","110/07/19","兆豐-公益",180,7,173
"7246","8112至上","110/07/19","元富-佳里",0,69,-69
"7247","8112至上","110/07/19","國泰-板橋",116,15,101
"7248","8112至上","110/07/19","臺銀-鳳山",7,72,-65
"7249","8112至上","110/07/19","凱基-新莊",100,1,99
"7250","8112至上","110/07/19","兆豐-竹北",4,65,-61
"7251","8112至上","110/07/19","凱基-市政",89,0,89
"7252","8112至上","110/07/19","國泰-新莊",2,62,-60
"7253","8112至上","110/07/19","玉山證券",73,7,66
"7254","8112至上","110/07/19","元富-大裕",2,60,-58
"7255","8112至上","110/07/19","花旗環球",64,0,64
"7256","8112至上","110/07/19","臺灣企銀-桃園",0,55,-55
"7257","8112至上","110/07/19","合庫-台中",55,3,52
"7258","8112至上","110/07/19","康和-台南",4,59,-55
"7259","8112至上","110/07/19","永豐金-中壢",50,1,49
"7260","8112至上","110/07/19","第一金-華江",3,55,-52
"7261","1570力肯","110/07/19","國票-北高雄",34,0,34
"7262","1570力肯","110/07/19","合庫-三重",0,8,-8
"7263","1570力肯","110/07/19","新光",30,3,27
"7264","1570力肯","110/07/19","元大-高雄",0,8,-8
"7265","1570力肯","110/07/19","凱基-台北",24,1,23
"7266","1570力肯","110/07/19","合庫-台中",0,7,-7
"7267","1570力肯","110/07/19","台灣摩根士丹利",7,0,7
"7268","1570力肯","110/07/19","臺銀-臺中",0,6,-6
"7269","1570力肯","110/07/19","元大-林森",5,0,5
"7270","1570力肯","110/07/19","摩根大通",6,11,-5
"7271","1570力肯","110/07/19","元大-士林",4,0,4
"7272","1570力肯","110/07/19","元富-緯城",0,4,-4
"7273","1570力肯","110/07/19","玉山證券",8,5,3
"7274","1570力肯","110/07/19","玉山-台大",0,4,-4
"7275","1570力肯","110/07/19","統一-城中",2,0,2
"7276","1570力肯","110/07/19","群益金鼎-三重",0,4,-4
"7277","1570力肯","110/07/19","元大-基隆孝二",2,0,2
"7278","1570力肯","110/07/19","凱基-鳳山",1,5,-4
"7279","1570力肯","110/07/19","土銀-建國",1,0,1
"7280","1570力肯","110/07/19","元大-板橋",0,4,-4
"7281","1570力肯","110/07/19","日盛-復興",1,0,1
"7282","1570力肯","110/07/19","日盛-和美",0,3,-3
"7283","1570力肯","110/07/19","瑞士信貸",1,0,1
"7284","1570力肯","110/07/19","元富-新店",2,5,-3
"7285","1570力肯","110/07/19","元富-四維",1,0,1
"7286","1570力肯","110/07/19","元大-新莊",0,3,-3
"7287","1570力肯","110/07/19","群益金鼎-北高雄",1,0,1
"7288","1570力肯","110/07/19","永豐金-敦南",0,3,-3
"7289","1570力肯","110/07/19","凱基-高美館",1,0,1
"7290","1570力肯","110/07/19","永豐金-台中",0,3,-3
"7291","2929淘帝","110/07/19","元大-民生",28,0,28
"7292","2929淘帝","110/07/19","元大-六合",0,40,-40
"7293","2929淘帝","110/07/19","宏遠-光隆",25,0,25
"7294","2929淘帝","110/07/19","新光-新竹",0,35,-35
"7295","2929淘帝","110/07/19","華南永昌-苗栗",20,0,20
"7296","2929淘帝","110/07/19","新加坡商瑞銀",1,30,-29
"7297","2929淘帝","110/07/19","元大-員林",20,0,20
"7298","2929淘帝","110/07/19","永豐金-永康",0,27,-27
"7299","2929淘帝","110/07/19","合庫-高雄",18,0,18
"7300","2929淘帝","110/07/19","凱基-復興",0,24,-24
"7301","2929淘帝","110/07/19","臺銀-鳳山",18,0,18
"7302","2929淘帝","110/07/19","日盛-豐原",0,22,-22
"7303","2929淘帝","110/07/19","日盛-雙和",17,0,17
"7304","2929淘帝","110/07/19","富邦-南屯",1,22,-21
"7305","2929淘帝","110/07/19","華南永昌-林口",15,0,15
"7306","2929淘帝","110/07/19","新光",1,21,-20
"7307","2929淘帝","110/07/19","元大-屏南",15,0,15
"7308","2929淘帝","110/07/19","華南永昌",0,20,-20
"7309","2929淘帝","110/07/19","台新-中壢",12,0,12
"7310","2929淘帝","110/07/19","富邦-竹東",2,22,-20
"7311","2929淘帝","110/07/19","新光-台中",11,0,11
"7312","2929淘帝","110/07/19","凱基-士林",0,16,-16
"7313","2929淘帝","110/07/19","凱基-台北",20,9,11
"7314","2929淘帝","110/07/19","福勝",0,15,-15
"7315","2929淘帝","110/07/19","富邦-台北",11,0,11
"7316","2929淘帝","110/07/19","港商野村",25,37,-12
"7317","2929淘帝","110/07/19","合庫-自強",10,0,10
"7318","2929淘帝","110/07/19","群益金鼎-建成",0,11,-11
"7319","2929淘帝","110/07/19","凱基-豐中",10,0,10
"7320","2929淘帝","110/07/19","華南永昌-朴子",0,11,-11
"7321","5410國眾","110/07/19","香港上海匯豐",28,0,28
"7322","5410國眾","110/07/19","群益金鼎-內湖",0,80,-80
"7323","5410國眾","110/07/19","大昌",26,0,26
"7324","5410國眾","110/07/19","永豐金-屏東",0,14,-14
"7325","5410國眾","110/07/19","兆豐-公益",20,0,20
"7326","5410國眾","110/07/19","永豐金-南京",0,10,-10
"7327","5410國眾","110/07/19","合庫-嘉義",10,0,10
"7328","5410國眾","110/07/19","元大-內湖",0,9,-9
"7329","5410國眾","110/07/19","台新-左楠",20,10,10
"7330","5410國眾","110/07/19","富邦-永和",0,8,-8
"7331","5410國眾","110/07/19","摩根大通",15,6,9
"7332","5410國眾","110/07/19","日盛-景美",0,6,-6
"7333","5410國眾","110/07/19","台灣企銀-民雄",8,0,8
"7334","5410國眾","110/07/19","光和",1,7,-6
"7335","5410國眾","110/07/19","元大-竹科",8,0,8
"7336","5410國眾","110/07/19","元大-士林",0,6,-6
"7337","5410國眾","110/07/19","凱基-台北",9,3,6
"7338","5410國眾","110/07/19","新光-台中",0,5,-5
"7339","5410國眾","110/07/19","元大-博愛",6,0,6
"7340","5410國眾","110/07/19","元大-景美",0,5,-5
"7341","5410國眾","110/07/19","台新-三民",5,0,5
"7342","5410國眾","110/07/19","大慶-蘆洲",0,4,-4
"7343","5410國眾","110/07/19","群益金鼎-中壢",5,0,5
"7344","5410國眾","110/07/19","中國信託-新竹",0,4,-4
"7345","5410國眾","110/07/19","群益金鼎-嘉義",5,0,5
"7346","5410國眾","110/07/19","新光",6,10,-4
"7347","5410國眾","110/07/19","日盛證券",4,0,4
"7348","5410國眾","110/07/19","元大-基隆孝二",0,4,-4
"7349","5410國眾","110/07/19","群益金鼎-新店",4,0,4
"7350","5410國眾","110/07/19","土銀-台中",0,3,-3
"7351","2841台開","110/07/19","元富-城東",150,0,150
"7352","2841台開","110/07/19","日進",0,80,-80
"7353","2841台開","110/07/19","中國信託-忠孝",80,0,80
"7354","2841台開","110/07/19","港商野村",0,77,-77
"7355","2841台開","110/07/19","凱基-台北",52,0,52
"7356","2841台開","110/07/19","摩根大通",0,41,-41
"7357","2841台開","110/07/19","美商高盛",48,0,48
"7358","2841台開","110/07/19","元大-三重",1,38,-37
"7359","2841台開","110/07/19","台中銀",43,0,43
"7360","2841台開","110/07/19","元大-福營",0,30,-30
"7361","2841台開","110/07/19","永豐金-豐原",32,0,32
"7362","2841台開","110/07/19","新光",4,28,-24
"7363","2841台開","110/07/19","豐農",20,0,20
"7364","2841台開","110/07/19","元大-竹科",0,22,-22
"7365","2841台開","110/07/19","台新-台中",30,10,20
"7366","2841台開","110/07/19","永豐金-敦南",33,55,-22
"7367","2841台開","110/07/19","華南永昌-新莊",20,0,20
"7368","2841台開","110/07/19","日盛-二林",0,15,-15
"7369","2841台開","110/07/19","第一金-台中",12,0,12
"7370","2841台開","110/07/19","元富-虎尾",0,15,-15
"7371","2841台開","110/07/19","國泰-台中",12,0,12
"7372","2841台開","110/07/19","華南永昌-世貿",0,15,-15
"7373","2841台開","110/07/19","日茂",10,0,10
"7374","2841台開","110/07/19","統一-三多",0,12,-12
"7375","2841台開","110/07/19","凱基-埔墘",10,0,10
"7376","2841台開","110/07/19","台中銀-豐原",0,10,-10
"7377","2841台開","110/07/19","永豐金-內湖",8,0,8
"7378","2841台開","110/07/19","元大-頭份",0,10,-10
"7379","2841台開","110/07/19","合庫-台中",7,0,7
"7380","2841台開","110/07/19","合庫-台南",0,8,-8
"7381","6207雷科","110/07/19","元富-信義",92,0,92
"7382","6207雷科","110/07/19","新加坡商瑞銀",5,104,-99
"7383","6207雷科","110/07/19","國泰證券",90,0,90
"7384","6207雷科","110/07/19","富邦-彰化",2,97,-95
"7385","6207雷科","110/07/19","元富-城中",80,4,76
"7386","6207雷科","110/07/19","永豐金-內湖",6,85,-79
"7387","6207雷科","110/07/19","元大-福營",71,5,66
"7388","6207雷科","110/07/19","摩根大通",102,164,-62
"7389","6207雷科","110/07/19","凱基-復興",60,0,60
"7390","6207雷科","110/07/19","瑞士信貸",0,51,-51
"7391","6207雷科","110/07/19","凱基-台北",91,46,45
"7392","6207雷科","110/07/19","凱基-板橋",10,55,-45
"7393","6207雷科","110/07/19","玉山-城中",42,0,42
"7394","6207雷科","110/07/19","華南永昌-大安",0,40,-40
"7395","6207雷科","110/07/19","華南永昌-長虹",40,0,40
"7396","6207雷科","110/07/19","群益金鼎-東大",1,40,-39
"7397","6207雷科","110/07/19","永豐金-羅東",38,0,38
"7398","6207雷科","110/07/19","台新-高雄",15,47,-32
"7399","6207雷科","110/07/19","日盛-忠孝",36,2,34
"7400","6207雷科","110/07/19","玉山-嘉義",1,32,-31
"7401","6207雷科","110/07/19","凱基-羅東",37,3,34
"7402","6207雷科","110/07/19","凱基-中港",0,30,-30
"7403","6207雷科","110/07/19","第一金-新竹",30,0,30
"7404","6207雷科","110/07/19","元大-六合",7,36,-29
"7405","6207雷科","110/07/19","玉山-數位",27,1,26
"7406","6207雷科","110/07/19","元富-花蓮",0,28,-28
"7407","6207雷科","110/07/19","凱基-長庚",22,0,22
"7408","6207雷科","110/07/19","群益金鼎-瑞豐",6,34,-28
"7409","6207雷科","110/07/19","台灣企銀-北高雄",20,0,20
"7410","6207雷科","110/07/19","新百王",0,26,-26
"7411","3679新至陞","110/07/19","元大-成功",7,0,7
"7412","3679新至陞","110/07/19","群益金鼎-大安",0,15,-15
"7413","3679新至陞","110/07/19","美商高盛",6,0,6
"7414","3679新至陞","110/07/19","凱基-民權",0,10,-10
"7415","3679新至陞","110/07/19","台新-高雄",5,0,5
"7416","3679新至陞","110/07/19","元大-西門",0,10,-10
"7417","3679新至陞","110/07/19","凱基-松山",5,0,5
"7418","3679新至陞","110/07/19","瑞士信貸",0,6,-6
"7419","3679新至陞","110/07/19","日盛-員林",4,0,4
"7420","3679新至陞","110/07/19","兆豐-高雄",0,6,-6
"7421","3679新至陞","110/07/19","台中銀-員林",4,0,4
"7422","3679新至陞","110/07/19","群益金鼎",0,5,-5
"7423","3679新至陞","110/07/19","(牛牛牛)亞-網路",3,0,3
"7424","3679新至陞","110/07/19","元大-永春",0,4,-4
"7425","3679新至陞","110/07/19","大昌-新店",3,0,3
"7426","3679新至陞","110/07/19","凱基-台北",2,5,-3
"7427","3679新至陞","110/07/19","凱基-埔墘",3,0,3
"7428","3679新至陞","110/07/19","港商法國興業",0,2,-2
"7429","3679新至陞","110/07/19","元大-板橋",3,0,3
"7430","3679新至陞","110/07/19","摩根大通",2,4,-2
"7431","3679新至陞","110/07/19","臺銀-金山",2,0,2
"7432","3679新至陞","110/07/19","元大-金門",0,2,-2
"7433","3679新至陞","110/07/19","日盛-樹林",2,0,2
"7434","3679新至陞","110/07/19","元大-土城",0,2,-2
"7435","3679新至陞","110/07/19","致和-東門",2,0,2
"7436","3679新至陞","110/07/19","日盛-鳳山",0,1,-1
"7437","3679新至陞","110/07/19","國票-敦北法人",2,0,2
"7438","3679新至陞","110/07/19","美林",1,2,-1
"7439","3679新至陞","110/07/19","台新證券",2,0,2
"7440","3679新至陞","110/07/19","第一金",0,1,-1
"7441","2727王品","110/07/19","台新證券",374,33,341
"7442","2727王品","110/07/19","台灣摩根士丹利",25,188,-163
"7443","2727王品","110/07/19","瑞士信貸",217,1,216
"7444","2727王品","110/07/19","港商野村",74,198,-124
"7445","2727王品","110/07/19","兆豐-南京",200,0,200
"7446","2727王品","110/07/19","統一",6,80,-74
"7447","2727王品","110/07/19","第一金",70,1,69
"7448","2727王品","110/07/19","合庫-台中",8,79,-71
"7449","2727王品","110/07/19","元大-小港",59,1,58
"7450","2727王品","110/07/19","凱基-台北",178,231,-53
"7451","2727王品","110/07/19","玉山-桃園",42,6,36
"7452","2727王品","110/07/19","富邦-中壢",3,52,-49
"7453","2727王品","110/07/19","永豐金-大園",31,0,31
"7454","2727王品","110/07/19","凱基-永華",0,43,-43
"7455","2727王品","110/07/19","兆豐-大安",30,0,30
"7456","2727王品","110/07/19","土銀-台中",0,36,-36
"7457","2727王品","110/07/19","美商高盛",38,15,23
"7458","2727王品","110/07/19","美林",8,41,-33
"7459","2727王品","110/07/19","康和-澎湖",23,1,22
"7460","2727王品","110/07/19","中國信託-忠孝",1,33,-32
"7461","2727王品","110/07/19","第一金-高雄",21,0,21
"7462","2727王品","110/07/19","新光",31,61,-30
"7463","2727王品","110/07/19","國票-內壢",21,0,21
"7464","2727王品","110/07/19","第一金-豐原",0,26,-26
"7465","2727王品","110/07/19","元大-桃興",19,3,16
"7466","2727王品","110/07/19","富邦-彰化",0,26,-26
"7467","2727王品","110/07/19","凱基-三重",16,1,15
"7468","2727王品","110/07/19","摩根大通",78,97,-19
"7469","2727王品","110/07/19","永豐金-南投",16,1,15
"7470","2727王品","110/07/19","國泰證券",2,21,-19
"7471","1570力肯","110/07/19","國票-北高雄",34,0,34
"7472","1570力肯","110/07/19","合庫-三重",0,8,-8
"7473","1570力肯","110/07/19","新光",30,3,27
"7474","1570力肯","110/07/19","元大-高雄",0,8,-8
"7475","1570力肯","110/07/19","凱基-台北",24,1,23
"7476","1570力肯","110/07/19","合庫-台中",0,7,-7
"7477","1570力肯","110/07/19","台灣摩根士丹利",7,0,7
"7478","1570力肯","110/07/19","臺銀-臺中",0,6,-6
"7479","1570力肯","110/07/19","元大-林森",5,0,5
"7480","1570力肯","110/07/19","摩根大通",6,11,-5
"7481","1570力肯","110/07/19","元大-士林",4,0,4
"7482","1570力肯","110/07/19","元富-緯城",0,4,-4
"7483","1570力肯","110/07/19","玉山證券",8,5,3
"7484","1570力肯","110/07/19","玉山-台大",0,4,-4
"7485","1570力肯","110/07/19","統一-城中",2,0,2
"7486","1570力肯","110/07/19","群益金鼎-三重",0,4,-4
"7487","1570力肯","110/07/19","元大-基隆孝二",2,0,2
"7488","1570力肯","110/07/19","凱基-鳳山",1,5,-4
"7489","1570力肯","110/07/19","土銀-建國",1,0,1
"7490","1570力肯","110/07/19","元大-板橋",0,4,-4
"7491","1570力肯","110/07/19","日盛-復興",1,0,1
"7492","1570力肯","110/07/19","日盛-和美",0,3,-3
"7493","1570力肯","110/07/19","瑞士信貸",1,0,1
"7494","1570力肯","110/07/19","元富-新店",2,5,-3
"7495","1570力肯","110/07/19","元富-四維",1,0,1
"7496","1570力肯","110/07/19","元大-新莊",0,3,-3
"7497","1570力肯","110/07/19","群益金鼎-北高雄",1,0,1
"7498","1570力肯","110/07/19","永豐金-敦南",0,3,-3
"7499","1570力肯","110/07/19","凱基-高美館",1,0,1
"7500","1570力肯","110/07/19","永豐金-台中",0,3,-3
"7501","6180橘子","110/07/19","兆豐證券",55,0,55
"7502","6180橘子","110/07/19","石橋證券",0,80,-80
"7503","6180橘子","110/07/19","凱基-台北",89,35,54
"7504","6180橘子","110/07/19","永豐金-大園",2,50,-48
"7505","6180橘子","110/07/19","合庫-自強",36,0,36
"7506","6180橘子","110/07/19","群益金鼎-屏東",0,40,-40
"7507","6180橘子","110/07/19","新光",50,25,25
"7508","6180橘子","110/07/19","國泰-敦南",0,19,-19
"7509","6180橘子","110/07/19","日盛-龍潭",20,0,20
"7510","6180橘子","110/07/19","日盛-新竹",2,20,-18
"7511","6180橘子","110/07/19","元大-斗信",16,1,15
"7512","6180橘子","110/07/19","摩根大通",17,35,-18
"7513","6180橘子","110/07/19","康和-台中",12,0,12
"7514","6180橘子","110/07/19","富邦-陽明",0,17,-17
"7515","6180橘子","110/07/19","國泰-台中",14,2,12
"7516","6180橘子","110/07/19","美商高盛",11,27,-16
"7517","6180橘子","110/07/19","富邦-嘉義",12,0,12
"7518","6180橘子","110/07/19","統一-宜蘭",0,14,-14
"7519","6180橘子","110/07/19","元大-草屯",12,0,12
"7520","6180橘子","110/07/19","凱基-興隆",0,12,-12
"7521","6180橘子","110/07/19","元富-桃園",11,0,11
"7522","6180橘子","110/07/19","台中銀-豐原",1,11,-10
"7523","6180橘子","110/07/19","兆豐-城中",10,0,10
"7524","6180橘子","110/07/19","永豐金-豐原",0,10,-10
"7525","6180橘子","110/07/19","元大-旗山",10,0,10
"7526","6180橘子","110/07/19","永豐金-竹科",0,10,-10
"7527","6180橘子","110/07/19","元大-大安",10,0,10
"7528","6180橘子","110/07/19","臺銀-鳳山",1,10,-9
"7529","6180橘子","110/07/19","大昌-新店",9,0,9
"7530","6180橘子","110/07/19","群益金鼎-台南",0,9,-9
"7531","2390云辰","110/07/19","摩根大通",1135,266,869
"7532","2390云辰","110/07/19","元富-成功",15,119,-104
"7533","2390云辰","110/07/19","台灣摩根士丹利",232,40,192
"7534","2390云辰","110/07/19","元富-中港",5,101,-96
"7535","2390云辰","110/07/19","凱基-台北",669,504,165
"7536","2390云辰","110/07/19","元富-嘉義",5,85,-80
"7537","2390云辰","110/07/19","美林",290,159,131
"7538","2390云辰","110/07/19","美商高盛",11,62,-51
"7539","2390云辰","110/07/19","統一",111,8,103
"7540","2390云辰","110/07/19","群益金鼎-西松",4,54,-50
"7541","2390云辰","110/07/19","元富-埔里",102,0,102
"7542","2390云辰","110/07/19","聯邦商銀",0,48,-48
"7543","2390云辰","110/07/19","華南永昌-台中",126,26,100
"7544","2390云辰","110/07/19","元大-萬華",15,57,-42
"7545","2390云辰","110/07/19","永豐金-豐原",100,32,68
"7546","2390云辰","110/07/19","群益金鼎-高雄",2,42,-40
"7547","2390云辰","110/07/19","台新-台南",87,25,62
"7548","2390云辰","110/07/19","國泰-敦南",117,154,-37
"7549","2390云辰","110/07/19","台新-左楠",67,11,56
"7550","2390云辰","110/07/19","中國信託-文心",5,40,-35
"7551","2390云辰","110/07/19","國泰-忠孝",52,0,52
"7552","2390云辰","110/07/19","凱基-城中",16,51,-35
"7553","2390云辰","110/07/19","台新證券",105,54,51
"7554","2390云辰","110/07/19","瑞士信貸",0,31,-31
"7555","2390云辰","110/07/19","華南永昌-頭份",53,3,50
"7556","2390云辰","110/07/19","中國信託-永康",1,32,-31
"7557","2390云辰","110/07/19","新光-台南",44,0,44
"7558","2390云辰","110/07/19","統一-彰化",2,32,-30
"7559","2390云辰","110/07/19","合庫-西台中",50,8,42
"7560","2390云辰","110/07/19","元大-館前",7,37,-30
"7561","2363矽統","110/07/16","國票-長城",461,21,440
"7562","2363矽統","110/07/16","新加坡商瑞銀",155,482,-327
"7563","2363矽統","110/07/16","凱基-豐中",201,3,198
"7564","2363矽統","110/07/16","港商野村",253,546,-293
"7565","2363矽統","110/07/16","凱基-土城",132,9,123
"7566","2363矽統","110/07/16","摩根大通",116,401,-285
"7567","2363矽統","110/07/16","台新證券",199,78,121
"7568","2363矽統","110/07/16","瑞士信貸",291,533,-242
"7569","2363矽統","110/07/16","日盛-中和",74,0,74
"7570","2363矽統","110/07/16","日盛-竹北",19,248,-229
"7571","2363矽統","110/07/16","日盛-員林",66,3,63
"7572","2363矽統","110/07/16","臺銀-金山",4,211,-207
"7573","2363矽統","110/07/16","國票-中和",60,3,57
"7574","2363矽統","110/07/16","元大-大統",13,138,-125
"7575","2363矽統","110/07/16","新光",240,184,56
"7576","2363矽統","110/07/16","永豐金證券",11,125,-114
"7577","2363矽統","110/07/16","富邦-竹東",65,9,56
"7578","2363矽統","110/07/16","兆豐-民生",2,101,-99
"7579","2363矽統","110/07/16","華南永昌-鳳山",56,1,55
"7580","2363矽統","110/07/16","群益金鼎-松山",2,100,-98
"7581","2363矽統","110/07/16","凱基-台北",520,466,54
"7582","2363矽統","110/07/16","元大-花蓮",8,99,-91
"7583","2363矽統","110/07/16","元富-城東",63,12,51
"7584","2363矽統","110/07/16","華南永昌-虎尾",68,154,-86
"7585","2363矽統","110/07/16","群益金鼎-桃園",56,5,51
"7586","2363矽統","110/07/16","富邦-新竹華信",7,89,-82
"7587","2363矽統","110/07/16","北城證券",60,10,50
"7588","2363矽統","110/07/16","元大-佳里",3,81,-78
"7589","2363矽統","110/07/16","國票-九鼎",57,7,50
"7590","2363矽統","110/07/16","玉山-南京東路",0,73,-73
"7591","8112至上","110/07/16","宏遠證券",551,6,545
"7592","8112至上","110/07/16","玉山-桃園",42,318,-276
"7593","8112至上","110/07/16","台灣摩根士丹利",317,11,306
"7594","8112至上","110/07/16","美林",64,305,-241
"7595","8112至上","110/07/16","新加坡商瑞銀",378,73,305
"7596","8112至上","110/07/16","宏遠-館前",16,212,-196
"7597","8112至上","110/07/16","凱基-台北",758,553,205
"7598","8112至上","110/07/16","玉山-嘉義",19,95,-76
"7599","8112至上","110/07/16","富邦證券",127,0,127
"7600","8112至上","110/07/16","群益金鼎-三民",7,82,-75
"7601","8112至上","110/07/16","台新證券",129,30,99
"7602","8112至上","110/07/16","日盛-二林",1,73,-72
"7603","8112至上","110/07/16","花旗環球",97,0,97
"7604","8112至上","110/07/16","玉山-台大",8,76,-68
"7605","8112至上","110/07/16","永豐金-台南",97,8,89
"7606","8112至上","110/07/16","元富-台南",1,68,-67
"7607","8112至上","110/07/16","元大-大天母",93,15,78
"7608","8112至上","110/07/16","玉山-板橋",4,71,-67
"7609","8112至上","110/07/16","亞東-板橋",72,2,70
"7610","8112至上","110/07/16","臺灣企銀-埔墘",0,60,-60
"7611","8112至上","110/07/16","永豐金-中正",64,9,55
"7612","8112至上","110/07/16","華南永昌-鶯歌",11,64,-53
"7613","8112至上","110/07/16","大昌-樹林",53,2,51
"7614","8112至上","110/07/16","元大-士林",7,59,-52
"7615","8112至上","110/07/16","凱基-永和",56,5,51
"7616","8112至上","110/07/16","元富-新店",8,57,-49
"7617","8112至上","110/07/16","兆豐-竹北",53,3,50
"7618","8112至上","110/07/16","富邦-陽明",9,58,-49
"7619","8112至上","110/07/16","日盛-豐原",48,0,48
"7620","8112至上","110/07/16","元大-發財",0,49,-49
"7621","1570力肯","110/07/16","新光",71,6,65
"7622","1570力肯","110/07/16","元大-高雄",0,23,-23
"7623","1570力肯","110/07/16","國票-北高雄",21,0,21
"7624","1570力肯","110/07/16","合庫-台南",0,20,-20
"7625","1570力肯","110/07/16","凱基-台北",17,1,16
"7626","1570力肯","110/07/16","元富-新店",0,15,-15
"7627","1570力肯","110/07/16","群益金鼎-高雄",15,0,15
"7628","1570力肯","110/07/16","元大-東港",0,10,-10
"7629","1570力肯","110/07/16","富邦-建國",10,0,10
"7630","1570力肯","110/07/16","中國信託",0,7,-7
"7631","1570力肯","110/07/16","元大-士林",5,0,5
"7632","1570力肯","110/07/16","台新證券",0,6,-6
"7633","1570力肯","110/07/16","瑞士信貸",3,0,3
"7634","1570力肯","110/07/16","日盛-信義",0,5,-5
"7635","1570力肯","110/07/16","臺銀-高雄",2,0,2
"7636","1570力肯","110/07/16","宏遠-館前",0,5,-5
"7637","1570力肯","110/07/16","華南永昌",2,0,2
"7638","1570力肯","110/07/16","國泰-館前",0,5,-5
"7639","1570力肯","110/07/16","元富-同大",1,0,1
"7640","1570力肯","110/07/16","富邦-園區",0,5,-5
"7641","1570力肯","110/07/16","兆豐-麻豆",1,0,1
"7642","1570力肯","110/07/16","永豐金-中正",0,5,-5
"7643","1570力肯","110/07/16","國泰-板橋",1,0,1
"7644","1570力肯","110/07/16","(牛牛牛)亞-鑫豐",0,4,-4
"7645","1570力肯","110/07/16","群益金鼎-東湖",1,0,1
"7646","1570力肯","110/07/16","台中銀-員林",0,3,-3
"7647","1570力肯","110/07/16","元大-東泰",1,0,1
"7648","1570力肯","110/07/16","玉山-新莊",0,3,-3
"7649","1570力肯","110/07/16","元大-南勢角",1,0,1
"7650","1570力肯","110/07/16","凱基-長庚",0,3,-3
"7651","2929淘帝","110/07/16","元大-民生",28,0,28
"7652","2929淘帝","110/07/16","玉山-新竹",0,30,-30
"7653","2929淘帝","110/07/16","元大-員林",20,0,20
"7654","2929淘帝","110/07/16","合庫證券",0,20,-20
"7655","2929淘帝","110/07/16","兆豐-桃鶯",12,0,12
"7656","2929淘帝","110/07/16","元大-六合",0,20,-20
"7657","2929淘帝","110/07/16","元大-大統",10,0,10
"7658","2929淘帝","110/07/16","摩根大通",0,12,-12
"7659","2929淘帝","110/07/16","新加坡商瑞銀",9,0,9
"7660","2929淘帝","110/07/16","永興",0,6,-6
"7661","2929淘帝","110/07/16","凱基-基隆",6,0,6
"7662","2929淘帝","110/07/16","凱基-長庚",0,5,-5
"7663","2929淘帝","110/07/16","合庫-高雄",5,0,5
"7664","2929淘帝","110/07/16","群益金鼎-潭子",0,4,-4
"7665","2929淘帝","110/07/16","台新-台中",6,1,5
"7666","2929淘帝","110/07/16","華南永昌-小港",2,6,-4
"7667","2929淘帝","110/07/16","元大-承德",5,0,5
"7668","2929淘帝","110/07/16","華南永昌-虎尾",0,4,-4
"7669","2929淘帝","110/07/16","元大-沙鹿",5,0,5
"7670","2929淘帝","110/07/16","日盛-和美",0,3,-3
"7671","2929淘帝","110/07/16","大慶-苗栗",5,1,4
"7672","2929淘帝","110/07/16","彰銀",0,3,-3
"7673","2929淘帝","110/07/16","台新-新營",4,0,4
"7674","2929淘帝","110/07/16","港商野村",7,10,-3
"7675","2929淘帝","110/07/16","凱基-台北",6,2,4
"7676","2929淘帝","110/07/16","群益金鼎-中山",1,4,-3
"7677","2929淘帝","110/07/16","兆豐-台中港",3,0,3
"7678","2929淘帝","110/07/16","凱基-嘉義",0,3,-3
"7679","2929淘帝","110/07/16","國票-北高雄",3,0,3
"7680","2929淘帝","110/07/16","元大-斗信",0,3,-3
"7681","5410國眾","110/07/16","盈溢-籬子內",49,0,49
"7682","5410國眾","110/07/16","元大-博愛",0,41,-41
"7683","5410國眾","110/07/16","香港上海匯豐",31,0,31
"7684","5410國眾","110/07/16","元富-嘉義",0,20,-20
"7685","5410國眾","110/07/16","元大-東泰",30,0,30
"7686","5410國眾","110/07/16","國泰-桃園",0,18,-18
"7687","5410國眾","110/07/16","兆豐-台中港",20,0,20
"7688","5410國眾","110/07/16","元富",0,17,-17
"7689","5410國眾","110/07/16","臺銀-臺南",11,0,11
"7690","5410國眾","110/07/16","元大-新竹",0,14,-14
"7691","5410國眾","110/07/16","富邦-新竹華信",11,0,11
"7692","5410國眾","110/07/16","安泰-大發",0,11,-11
"7693","5410國眾","110/07/16","臺銀",10,0,10
"7694","5410國眾","110/07/16","大昌-樹林",0,10,-10
"7695","5410國眾","110/07/16","凱基-台北",8,1,7
"7696","5410國眾","110/07/16","群益金鼎-內湖",0,10,-10
"7697","5410國眾","110/07/16","日盛-士林",5,0,5
"7698","5410國眾","110/07/16","元大-樹林",0,10,-10
"7699","5410國眾","110/07/16","新光-桃園",5,0,5
"7700","5410國眾","110/07/16","元大-內湖",0,9,-9
"7701","5410國眾","110/07/16","國泰-台南",5,0,5
"7702","5410國眾","110/07/16","群益金鼎-永和",0,5,-5
"7703","5410國眾","110/07/16","群益金鼎-嘉義",5,0,5
"7704","5410國眾","110/07/16","凱基-屏東",0,5,-5
"7705","5410國眾","110/07/16","元大-屏南",5,0,5
"7706","5410國眾","110/07/16","統一-員林",0,4,-4
"7707","5410國眾","110/07/16","日盛-員林",3,0,3
"7708","5410國眾","110/07/16","國泰-松江",0,4,-4
"7709","5410國眾","110/07/16","瑞士信貸",3,0,3
"7710","5410國眾","110/07/16","凱基-台南",0,4,-4
"7711","2841台開","110/07/16","日盛證券",250,0,250
"7712","2841台開","110/07/16","元大-歸仁",0,590,-590
"7713","2841台開","110/07/16","凱基-文心",204,0,204
"7714","2841台開","110/07/16","摩根大通",0,245,-245
"7715","2841台開","110/07/16","國泰-館前",114,0,114
"7716","2841台開","110/07/16","日盛-信義",0,145,-145
"7717","2841台開","110/07/16","永豐金-豐原",75,0,75
"7718","2841台開","110/07/16","港商野村",0,103,-103
"7719","2841台開","110/07/16","台新-台中",76,10,66
"7720","2841台開","110/07/16","玉山-嘉義",5,54,-49
"7721","2841台開","110/07/16","中國信託-文心",51,5,46
"7722","2841台開","110/07/16","台新證券",22,63,-41
"7723","2841台開","110/07/16","華南永昌-新莊",41,10,31
"7724","2841台開","110/07/16","美商高盛",0,39,-39
"7725","2841台開","110/07/16","富邦-嘉義",30,0,30
"7726","2841台開","110/07/16","亞東-板橋",0,30,-30
"7727","2841台開","110/07/16","新光",26,0,26
"7728","2841台開","110/07/16","永豐金-北高雄",0,30,-30
"7729","2841台開","110/07/16","富邦-板橋",25,0,25
"7730","2841台開","110/07/16","日盛-忠孝",0,20,-20
"7731","2841台開","110/07/16","新光-台中",22,0,22
"7732","2841台開","110/07/16","元富-草屯",0,15,-15
"7733","2841台開","110/07/16","元大-承德",22,0,22
"7734","2841台開","110/07/16","永豐金-板新",0,12,-12
"7735","2841台開","110/07/16","日盛-三重",20,0,20
"7736","2841台開","110/07/16","第一金-華江",0,10,-10
"7737","2841台開","110/07/16","日盛-新莊",20,0,20
"7738","2841台開","110/07/16","兆豐-南京",0,10,-10
"7739","2841台開","110/07/16","凱基-台南",20,0,20
"7740","2841台開","110/07/16","國票-中港",0,10,-10
"7741","6207雷科","110/07/16","統一-平鎮",215,4,211
"7742","6207雷科","110/07/16","凱基-台北",344,628,-284
"7743","6207雷科","110/07/16","凱基-復興",166,6,160
"7744","6207雷科","110/07/16","新加坡商瑞銀",104,370,-266
"7745","6207雷科","110/07/16","永豐金-南京",141,3,138
"7746","6207雷科","110/07/16","摩根大通",193,430,-237
"7747","6207雷科","110/07/16","永豐金-內湖",117,1,116
"7748","6207雷科","110/07/16","富邦證券",0,150,-150
"7749","6207雷科","110/07/16","日盛證券",104,2,102
"7750","6207雷科","110/07/16","華南永昌-中正",26,169,-143
"7751","6207雷科","110/07/16","群益金鼎-古亭",74,2,72
"7752","6207雷科","110/07/16","凱基-敦北",1,142,-141
"7753","6207雷科","110/07/16","群益金鼎-東門",76,12,64
"7754","6207雷科","110/07/16","凱基-板橋",0,120,-120
"7755","6207雷科","110/07/16","日盛-板橋",78,25,53
"7756","6207雷科","110/07/16","元富-大昌",30,136,-106
"7757","6207雷科","110/07/16","元大-斗六",57,6,51
"7758","6207雷科","110/07/16","元大-北成功",26,97,-71
"7759","6207雷科","110/07/16","元大-頭份",53,3,50
"7760","6207雷科","110/07/16","新光-桃園",29,93,-64
"7761","6207雷科","110/07/16","群益金鼎-東大",56,11,45
"7762","6207雷科","110/07/16","新百王",27,90,-63
"7763","6207雷科","110/07/16","永豐金-虎尾",50,8,42
"7764","6207雷科","110/07/16","玉山-左營",16,72,-56
"7765","6207雷科","110/07/16","元大-西門",39,1,38
"7766","6207雷科","110/07/16","群益金鼎-中壢",3,54,-51
"7767","6207雷科","110/07/16","凱基-竹科",38,1,37
"7768","6207雷科","110/07/16","元富-中原",21,67,-46
"7769","6207雷科","110/07/16","元富-世貿",50,15,35
"7770","6207雷科","110/07/16","大昌-桃園",26,70,-44
"7771","3679新至陞","110/07/16","元大-成功",17,1,16
"7772","3679新至陞","110/07/16","國票-桃園",0,11,-11
"7773","3679新至陞","110/07/16","玉山-台大",5,0,5
"7774","3679新至陞","110/07/16","富邦-台北",0,10,-10
"7775","3679新至陞","110/07/16","日盛-員林",4,0,4
"7776","3679新至陞","110/07/16","富邦-苗栗",0,10,-10
"7777","3679新至陞","110/07/16","凱基-台北",6,2,4
"7778","3679新至陞","110/07/16","元大-永春",0,6,-6
"7779","3679新至陞","110/07/16","台灣摩根士丹利",3,0,3
"7780","3679新至陞","110/07/16","美林",0,5,-5
"7781","3679新至陞","110/07/16","凱基-中山",3,0,3
"7782","3679新至陞","110/07/16","瑞士信貸",3,7,-4
"7783","3679新至陞","110/07/16","元大-承德",3,0,3
"7784","3679新至陞","110/07/16","宏遠-館前",0,3,-3
"7785","3679新至陞","110/07/16","元大-汐止",4,1,3
"7786","3679新至陞","110/07/16","元大-東港",0,3,-3
"7787","3679新至陞","110/07/16","日盛-大墩",2,0,2
"7788","3679新至陞","110/07/16","元大證券",0,2,-2
"7789","3679新至陞","110/07/16","玉山-城中",2,0,2
"7790","3679新至陞","110/07/16","永豐金-板新",0,2,-2
"7791","3679新至陞","110/07/16","華南永昌-內壢",2,0,2
"7792","3679新至陞","110/07/16","臺銀-民權",0,1,-1
"7793","3679新至陞","110/07/16","元大-台南",2,0,2
"7794","3679新至陞","110/07/16","日盛-台中",0,1,-1
"7795","3679新至陞","110/07/16","元大-大同",2,0,2
"7796","3679新至陞","110/07/16","日盛-鳳山",0,1,-1
"7797","3679新至陞","110/07/16","臺銀-高雄",1,0,1
"7798","3679新至陞","110/07/16","元富-古亭",0,1,-1
"7799","3679新至陞","110/07/16","日盛-樹林",1,0,1
"7800","3679新至陞","110/07/16","元富-新興",0,1,-1
"7801","2727王品","110/07/16","富邦證券",570,0,570
"7802","2727王品","110/07/16","台新證券",27,77,-50
"7803","2727王品","110/07/16","兆豐-南京",200,0,200
"7804","2727王品","110/07/16","台灣摩根士丹利",4,47,-43
"7805","2727王品","110/07/16","瑞士信貸",133,2,131
"7806","2727王品","110/07/16","永豐金-大園",0,33,-33
"7807","2727王品","110/07/16","美林",121,26,95
"7808","2727王品","110/07/16","元大-北屯",0,32,-32
"7809","2727王品","110/07/16","統一",103,43,60
"7810","2727王品","110/07/16","富邦-南屯",1,30,-29
"7811","2727王品","110/07/16","中國信託-忠孝",36,2,34
"7812","2727王品","110/07/16","元大-基隆孝二",0,29,-29
"7813","2727王品","110/07/16","元大證券",68,45,23
"7814","2727王品","110/07/16","日盛-忠孝",4,30,-26
"7815","2727王品","110/07/16","合庫-彰化",22,1,21
"7816","2727王品","110/07/16","新光-新竹",1,21,-20
"7817","2727王品","110/07/16","港商野村",126,105,21
"7818","2727王品","110/07/16","凱基-台北",94,113,-19
"7819","2727王品","110/07/16","元富-板橋",22,1,21
"7820","2727王品","110/07/16","富邦-虎尾",1,19,-18
"7821","2727王品","110/07/16","新加坡商瑞銀",36,18,18
"7822","2727王品","110/07/16","元大-南京",0,17,-17
"7823","2727王品","110/07/16","國泰證券",20,5,15
"7824","2727王品","110/07/16","日盛-鳳山",2,18,-16
"7825","2727王品","110/07/16","日盛-桃園",13,1,12
"7826","2727王品","110/07/16","新光",34,50,-16
"7827","2727王品","110/07/16","凱基-市政",12,1,11
"7828","2727王品","110/07/16","富邦-台北",2,18,-16
"7829","2727王品","110/07/16","元大-嘉義",14,3,11
"7830","2727王品","110/07/16","國票-內壢",1,15,-14
"7831","1570力肯","110/07/16","新光",71,6,65
"7832","1570力肯","110/07/16","元大-高雄",0,23,-23
"7833","1570力肯","110/07/16","國票-北高雄",21,0,21
"7834","1570力肯","110/07/16","合庫-台南",0,20,-20
"7835","1570力肯","110/07/16","凱基-台北",17,1,16
"7836","1570力肯","110/07/16","元富-新店",0,15,-15
"7837","1570力肯","110/07/16","群益金鼎-高雄",15,0,15
"7838","1570力肯","110/07/16","元大-東港",0,10,-10
"7839","1570力肯","110/07/16","富邦-建國",10,0,10
"7840","1570力肯","110/07/16","中國信託",0,7,-7
"7841","1570力肯","110/07/16","元大-士林",5,0,5
"7842","1570力肯","110/07/16","台新證券",0,6,-6
"7843","1570力肯","110/07/16","瑞士信貸",3,0,3
"7844","1570力肯","110/07/16","日盛-信義",0,5,-5
"7845","1570力肯","110/07/16","臺銀-高雄",2,0,2
"7846","1570力肯","110/07/16","宏遠-館前",0,5,-5
"7847","1570力肯","110/07/16","華南永昌",2,0,2
"7848","1570力肯","110/07/16","國泰-館前",0,5,-5
"7849","1570力肯","110/07/16","元富-同大",1,0,1
"7850","1570力肯","110/07/16","富邦-園區",0,5,-5
"7851","1570力肯","110/07/16","兆豐-麻豆",1,0,1
"7852","1570力肯","110/07/16","永豐金-中正",0,5,-5
"7853","1570力肯","110/07/16","國泰-板橋",1,0,1
"7854","1570力肯","110/07/16","(牛牛牛)亞-鑫豐",0,4,-4
"7855","1570力肯","110/07/16","群益金鼎-東湖",1,0,1
"7856","1570力肯","110/07/16","台中銀-員林",0,3,-3
"7857","1570力肯","110/07/16","元大-東泰",1,0,1
"7858","1570力肯","110/07/16","玉山-新莊",0,3,-3
"7859","1570力肯","110/07/16","元大-南勢角",1,0,1
"7860","1570力肯","110/07/16","凱基-長庚",0,3,-3
"7861","6180橘子","110/07/16","日盛-文化",71,5,66
"7862","6180橘子","110/07/16","凱基-台北",110,238,-128
"7863","6180橘子","110/07/16","新加坡商瑞銀",75,19,56
"7864","6180橘子","110/07/16","摩根大通",77,161,-84
"7865","6180橘子","110/07/16","瑞士信貸",51,0,51
"7866","6180橘子","110/07/16","元富-高雄",0,62,-62
"7867","6180橘子","110/07/16","台灣企銀-屏東",50,0,50
"7868","6180橘子","110/07/16","美商高盛",0,40,-40
"7869","6180橘子","110/07/16","元大-桃園",52,2,50
"7870","6180橘子","110/07/16","合庫-自強",0,37,-37
"7871","6180橘子","110/07/16","康和-台北",51,10,41
"7872","6180橘子","110/07/16","美林",15,48,-33
"7873","6180橘子","110/07/16","群益金鼎-屏東",61,20,41
"7874","6180橘子","110/07/16","元富-四維",0,32,-32
"7875","6180橘子","110/07/16","元大-彰化",33,2,31
"7876","6180橘子","110/07/16","新光",63,92,-29
"7877","6180橘子","110/07/16","台中銀-台北",30,0,30
"7878","6180橘子","110/07/16","新光-台南",6,28,-22
"7879","6180橘子","110/07/16","福勝",29,3,26
"7880","6180橘子","110/07/16","港商野村",28,49,-21
"7881","6180橘子","110/07/16","兆豐證券",21,0,21
"7882","6180橘子","110/07/16","統一",2,23,-21
"7883","6180橘子","110/07/16","華南永昌-頭份",20,0,20
"7884","6180橘子","110/07/16","元大-豐原站前",3,21,-18
"7885","6180橘子","110/07/16","富邦-台北",25,5,20
"7886","6180橘子","110/07/16","豐農",3,20,-17
"7887","6180橘子","110/07/16","富邦-員林",23,4,19
"7888","6180橘子","110/07/16","安泰-大發",0,17,-17
"7889","6180橘子","110/07/16","台新-新莊",20,2,18
"7890","6180橘子","110/07/16","群益金鼎",2,19,-17
"7891","2390云辰","110/07/16","兆豐-天母",642,7,635
"7892","2390云辰","110/07/16","凱基",0,5007,-5007
"7893","2390云辰","110/07/16","華南永昌-鳳山",339,35,304
"7894","2390云辰","110/07/16","凱基-台北",1224,2306,-1082
"7895","2390云辰","110/07/16","第一金-大稻埕",269,13,256
"7896","2390云辰","110/07/16","元大證券",206,1177,-971
"7897","2390云辰","110/07/16","國泰-敦南",665,427,238
"7898","2390云辰","110/07/16","摩根大通",1073,1967,-894
"7899","2390云辰","110/07/16","富邦-建國",272,50,222
"7900","2390云辰","110/07/16","台灣摩根士丹利",232,671,-439
"7901","2390云辰","110/07/16","元大-信義",180,15,165
"7902","2390云辰","110/07/16","美林",187,496,-309
"7903","2390云辰","110/07/16","瑞士信貸",155,0,155
"7904","2390云辰","110/07/16","港商野村",680,950,-270
"7905","2390云辰","110/07/16","台新證券",461,317,144
"7906","2390云辰","110/07/16","永豐金-中正",18,170,-152
"7907","2390云辰","110/07/16","兆豐-公益",148,11,137
"7908","2390云辰","110/07/16","元富-板橋",30,169,-139
"7909","2390云辰","110/07/16","元大-土城學府",197,61,136
"7910","2390云辰","110/07/16","新加坡商瑞銀",61,175,-114
"7911","2390云辰","110/07/16","元大-天母",232,122,110
"7912","2390云辰","110/07/16","聯邦商銀",54,167,-113
"7913","2390云辰","110/07/16","凱基-基隆",109,2,107
"7914","2390云辰","110/07/16","群益金鼎-大甲",13,111,-98
"7915","2390云辰","110/07/16","元富-成功",110,5,105
"7916","2390云辰","110/07/16","統一-屏東",4,92,-88
"7917","2390云辰","110/07/16","統一-新營",118,14,104
"7918","2390云辰","110/07/16","凱基-大直",3,80,-77
"7919","2390云辰","110/07/16","國泰-板橋",268,170,98
"7920","2390云辰","110/07/16","元大-桃興",46,117,-71
"7921","2363矽統","110/07/15","康和-台中",626,61,565
"7922","2363矽統","110/07/15","新加坡商瑞銀",202,838,-636
"7923","2363矽統","110/07/15","摩根大通",1271,932,339
"7924","2363矽統","110/07/15","美林",185,720,-535
"7925","2363矽統","110/07/15","瑞士信貸",530,230,300
"7926","2363矽統","110/07/15","富邦-仁愛",60,583,-523
"7927","2363矽統","110/07/15","宏遠-桃園",281,0,281
"7928","2363矽統","110/07/15","元大-板橋",35,368,-333
"7929","2363矽統","110/07/15","大展",252,19,233
"7930","2363矽統","110/07/15","花旗環球",0,308,-308
"7931","2363矽統","110/07/15","凱基-台北",683,498,185
"7932","2363矽統","110/07/15","元富-成功",2,113,-111
"7933","2363矽統","110/07/15","永豐金證券",166,11,155
"7934","2363矽統","110/07/15","富邦-新營",23,132,-109
"7935","2363矽統","110/07/15","群益金鼎",157,5,152
"7936","2363矽統","110/07/15","臺銀-金山",197,304,-107
"7937","2363矽統","110/07/15","新光",333,229,104
"7938","2363矽統","110/07/15","日盛-二林",13,116,-103
"7939","2363矽統","110/07/15","永豐金-台南",130,26,104
"7940","2363矽統","110/07/15","台新-左楠",40,126,-86
"7941","2363矽統","110/07/15","國票-南京",100,0,100
"7942","2363矽統","110/07/15","康和-南崁",15,100,-85
"7943","2363矽統","110/07/15","群益金鼎-松山",150,50,100
"7944","2363矽統","110/07/15","永豐金-員林",9,91,-82
"7945","2363矽統","110/07/15","中國信託-松江",103,5,98
"7946","2363矽統","110/07/15","光和-嘉義",5,78,-73
"7947","2363矽統","110/07/15","國票-新莊",187,92,95
"7948","2363矽統","110/07/15","日盛-板橋中山",3,73,-70
"7949","2363矽統","110/07/15","北城證券",216,126,90
"7950","2363矽統","110/07/15","元大證券",10,75,-65
"7951","8112至上","110/07/15","凱基-台北",535,32,503
"7952","8112至上","110/07/15","群益金鼎-台南",0,116,-116
"7953","8112至上","110/07/15","摩根大通",362,16,346
"7954","8112至上","110/07/15","華南永昌-高雄",2,112,-110
"7955","8112至上","110/07/15","台灣摩根士丹利",254,0,254
"7956","8112至上","110/07/15","永豐金-台南",27,128,-101
"7957","8112至上","110/07/15","花旗環球",159,0,159
"7958","8112至上","110/07/15","元大-東蘆",2,73,-71
"7959","8112至上","110/07/15","新加坡商瑞銀",95,2,93
"7960","8112至上","110/07/15","美林",3,66,-63
"7961","8112至上","110/07/15","玉山-嘉義",84,0,84
"7962","8112至上","110/07/15","元大-館前",0,62,-62
"7963","8112至上","110/07/15","新光",82,6,76
"7964","8112至上","110/07/15","元富-信義",0,50,-50
"7965","8112至上","110/07/15","瑞士信貸",80,7,73
"7966","8112至上","110/07/15","台新證券",35,82,-47
"7967","8112至上","110/07/15","美商高盛",64,0,64
"7968","8112至上","110/07/15","大慶-蘆洲",7,53,-46
"7969","8112至上","110/07/15","兆豐-小港",56,0,56
"7970","8112至上","110/07/15","國票-天祥",0,45,-45
"7971","8112至上","110/07/15","永豐金-內湖",60,11,49
"7972","8112至上","110/07/15","凱基-中山",1,45,-44
"7973","8112至上","110/07/15","永豐金-南投",46,1,45
"7974","8112至上","110/07/15","元大-士林",0,43,-43
"7975","8112至上","110/07/15","凱基-三重",40,0,40
"7976","8112至上","110/07/15","玉山-城中",4,44,-40
"7977","8112至上","110/07/15","台灣企銀",29,0,29
"7978","8112至上","110/07/15","凱基-彰化",0,39,-39
"7979","8112至上","110/07/15","元大-府城",42,14,28
"7980","8112至上","110/07/15","元富-花蓮",2,40,-38
"7981","1570力肯","110/07/15","群益金鼎-高雄",40,0,40
"7982","1570力肯","110/07/15","元大-高雄",0,12,-12
"7983","1570力肯","110/07/15","新光",40,8,32
"7984","1570力肯","110/07/15","永豐金-中正",0,10,-10
"7985","1570力肯","110/07/15","凱基-台北",20,2,18
"7986","1570力肯","110/07/15","國泰-松江",0,9,-9
"7987","1570力肯","110/07/15","凱基-天母",6,0,6
"7988","1570力肯","110/07/15","台新證券",0,8,-8
"7989","1570力肯","110/07/15","元富-新店",5,0,5
"7990","1570力肯","110/07/15","玉山證券",0,7,-7
"7991","1570力肯","110/07/15","凱基-中港",5,0,5
"7992","1570力肯","110/07/15","元大-府城",0,7,-7
"7993","1570力肯","110/07/15","富邦-園區",5,0,5
"7994","1570力肯","110/07/15","元大-板橋",0,6,-6
"7995","1570力肯","110/07/15","瑞士信貸",4,0,4
"7996","1570力肯","110/07/15","日盛-信義",0,5,-5
"7997","1570力肯","110/07/15","第一金-路竹",3,0,3
"7998","1570力肯","110/07/15","國票-和平",0,5,-5
"7999","1570力肯","110/07/15","摩根大通",3,0,3
"8000","1570力肯","110/07/15","元大-民雄",0,5,-5
"8001","1570力肯","110/07/15","凱基-桃園",3,0,3
"8002","1570力肯","110/07/15","統一-台中",0,4,-4
"8003","1570力肯","110/07/15","永豐金-苓雅",3,0,3
"8004","1570力肯","110/07/15","玉山-雙和",0,4,-4
"8005","1570力肯","110/07/15","統一-員林",2,0,2
"8006","1570力肯","110/07/15","凱基-敦北",0,4,-4
"8007","1570力肯","110/07/15","元大-永春",2,0,2
"8008","1570力肯","110/07/15","富邦-新店",0,4,-4
"8009","1570力肯","110/07/15","元大-土城永寧",2,0,2
"8010","1570力肯","110/07/15","日盛-板橋",0,3,-3
"8011","2929淘帝","110/07/15","港商野村",58,4,54
"8012","2929淘帝","110/07/15","日盛-園區",0,25,-25
"8013","2929淘帝","110/07/15","元大-民生",29,0,29
"8014","2929淘帝","110/07/15","兆豐-南京",0,20,-20
"8015","2929淘帝","110/07/15","新加坡商瑞銀",22,1,21
"8016","2929淘帝","110/07/15","玉山-高雄",0,18,-18
"8017","2929淘帝","110/07/15","凱基-台北",20,2,18
"8018","2929淘帝","110/07/15","富邦-南屯",1,15,-14
"8019","2929淘帝","110/07/15","大慶-中壢",15,1,14
"8020","2929淘帝","110/07/15","富邦-員林",0,13,-13
"8021","2929淘帝","110/07/15","日盛-和美",10,0,10
"8022","2929淘帝","110/07/15","凱基-站前",0,10,-10
"8023","2929淘帝","110/07/15","元大-員林",10,0,10
"8024","2929淘帝","110/07/15","元大-台中",0,10,-10
"8025","2929淘帝","110/07/15","凱基-基隆",6,0,6
"8026","2929淘帝","110/07/15","美林",10,19,-9
"8027","2929淘帝","110/07/15","臺銀-鳳山",5,0,5
"8028","2929淘帝","110/07/15","元大-新盛",0,8,-8
"8029","2929淘帝","110/07/15","第一金-路竹",5,0,5
"8030","2929淘帝","110/07/15","台新-台南",0,7,-7
"8031","2929淘帝","110/07/15","元富-大裕",5,0,5
"8032","2929淘帝","110/07/15","元大-大天母",0,7,-7
"8033","2929淘帝","110/07/15","玉山-大里",5,0,5
"8034","2929淘帝","110/07/15","華南永昌-虎尾",0,6,-6
"8035","2929淘帝","110/07/15","元大-博愛",5,0,5
"8036","2929淘帝","110/07/15","永豐金證券",0,6,-6
"8037","2929淘帝","110/07/15","永豐金-新莊",5,0,5
"8038","2929淘帝","110/07/15","兆豐-竹北",0,5,-5
"8039","2929淘帝","110/07/15","元大-南崁",4,0,4
"8040","2929淘帝","110/07/15","元大-文心興安",0,5,-5
"8041","5410國眾","110/07/15","香港上海匯豐",18,0,18
"8042","5410國眾","110/07/15","元大-南屯",0,18,-18
"8043","5410國眾","110/07/15","摩根大通",15,0,15
"8044","5410國眾","110/07/15","亞東-新竹",0,15,-15
"8045","5410國眾","110/07/15","日盛-士林",10,0,10
"8046","5410國眾","110/07/15","兆豐-台中港",0,15,-15
"8047","5410國眾","110/07/15","群益金鼎-嘉義",10,0,10
"8048","5410國眾","110/07/15","日盛-板橋",0,12,-12
"8049","5410國眾","110/07/15","元大-高雄",10,0,10
"8050","5410國眾","110/07/15","台中銀-豐原",0,9,-9
"8051","5410國眾","110/07/15","元大-東港",10,0,10
"8052","5410國眾","110/07/15","臺銀-臺南",3,10,-7
"8053","5410國眾","110/07/15","臺銀",10,5,5
"8054","5410國眾","110/07/15","瑞士信貸",0,5,-5
"8055","5410國眾","110/07/15","台新-新營",5,0,5
"8056","5410國眾","110/07/15","統一-員林",0,5,-5
"8057","5410國眾","110/07/15","富邦-台北",5,0,5
"8058","5410國眾","110/07/15","大昌-樹林",0,5,-5
"8059","5410國眾","110/07/15","日盛-屏東",4,0,4
"8060","5410國眾","110/07/15","兆豐-來福",0,5,-5
"8061","5410國眾","110/07/15","高橋",5,1,4
"8062","5410國眾","110/07/15","豐農",0,5,-5
"8063","5410國眾","110/07/15","中國信託-新竹",4,1,3
"8064","5410國眾","110/07/15","元大-大里",0,5,-5
"8065","5410國眾","110/07/15","富邦-建國",3,0,3
"8066","5410國眾","110/07/15","港商野村",0,3,-3
"8067","5410國眾","110/07/15","永豐金-桃園",3,0,3
"8068","5410國眾","110/07/15","中農",0,3,-3
"8069","5410國眾","110/07/15","大展",2,0,2
"8070","5410國眾","110/07/15","國泰-忠孝",0,3,-3
"8071","2841台開","110/07/15","日盛證券",310,0,310
"8072","2841台開","110/07/15","港商野村",0,97,-97
"8073","2841台開","110/07/15","元富-城東",100,0,100
"8074","2841台開","110/07/15","元大-員林",0,77,-77
"8075","2841台開","110/07/15","凱基-文心",30,0,30
"8076","2841台開","110/07/15","新光",3,73,-70
"8077","2841台開","110/07/15","日盛-雙和",24,0,24
"8078","2841台開","110/07/15","永豐金-北高雄",0,30,-30
"8079","2841台開","110/07/15","第一金-台中",20,0,20
"8080","2841台開","110/07/15","華南永昌",0,25,-25
"8081","2841台開","110/07/15","豐農",20,0,20
"8082","2841台開","110/07/15","日盛-台南",0,20,-20
"8083","2841台開","110/07/15","華南永昌-新莊",19,0,19
"8084","2841台開","110/07/15","致和-佳里",0,20,-20
"8085","2841台開","110/07/15","玉山-大里",12,0,12
"8086","2841台開","110/07/15","國票-中港",0,20,-20
"8087","2841台開","110/07/15","元富-安南",10,0,10
"8088","2841台開","110/07/15","元大-歸仁",0,20,-20
"8089","2841台開","110/07/15","凱基-市政",10,0,10
"8090","2841台開","110/07/15","統一-三多",0,19,-19
"8091","2841台開","110/07/15","凱基-竹科",10,0,10
"8092","2841台開","110/07/15","凱基-城中",0,18,-18
"8093","2841台開","110/07/15","國泰-板橋",10,1,9
"8094","2841台開","110/07/15","國票-中和",0,15,-15
"8095","2841台開","110/07/15","凱基-台北",9,0,9
"8096","2841台開","110/07/15","元大-彰化",0,15,-15
"8097","2841台開","110/07/15","合庫證券",6,0,6
"8098","2841台開","110/07/15","元大-復北",0,15,-15
"8099","2841台開","110/07/15","台中銀",6,0,6
"8100","2841台開","110/07/15","土銀-花蓮",0,14,-14
"8101","6207雷科","110/07/15","凱基-板橋",210,45,165
"8102","6207雷科","110/07/15","群益金鼎-台北",20,80,-60
"8103","6207雷科","110/07/15","富邦證券",150,0,150
"8104","6207雷科","110/07/15","元大-大天母",1,56,-55
"8105","6207雷科","110/07/15","凱基-復興",140,0,140
"8106","6207雷科","110/07/15","大慶-中壢",2,50,-48
"8107","6207雷科","110/07/15","華南永昌-中正",140,0,140
"8108","6207雷科","110/07/15","元富-林園",0,47,-47
"8109","6207雷科","110/07/15","永豐金-內湖",92,10,82
"8110","6207雷科","110/07/15","元大-東門",0,40,-40
"8111","6207雷科","110/07/15","富邦-彰化",81,11,70
"8112","6207雷科","110/07/15","第一金-安和",0,37,-37
"8113","6207雷科","110/07/15","(牛牛牛)亞-網路",67,0,67
"8114","6207雷科","110/07/15","凱基-台北",61,97,-36
"8115","6207雷科","110/07/15","台新證券",60,8,52
"8116","6207雷科","110/07/15","國票-南科",0,32,-32
"8117","6207雷科","110/07/15","華南永昌",50,3,47
"8118","6207雷科","110/07/15","元大-四維",0,32,-32
"8119","6207雷科","110/07/15","新加坡商瑞銀",68,26,42
"8120","6207雷科","110/07/15","元大-板橋",0,30,-30
"8121","6207雷科","110/07/15","日盛-景美",40,0,40
"8122","6207雷科","110/07/15","元大-南崁",1,30,-29
"8123","6207雷科","110/07/15","元富-大昌",40,0,40
"8124","6207雷科","110/07/15","凱基-岡山",0,27,-27
"8125","6207雷科","110/07/15","統一-高雄",38,5,33
"8126","6207雷科","110/07/15","統一-新竹",0,26,-26
"8127","6207雷科","110/07/15","日盛證券",32,0,32
"8128","6207雷科","110/07/15","群益金鼎-三民",1,27,-26
"8129","6207雷科","110/07/15","華南永昌-頭份",31,0,31
"8130","6207雷科","110/07/15","國票-台中",0,25,-25
"8131","3679新至陞","110/07/15","群益金鼎-大安",25,0,25
"8132","3679新至陞","110/07/15","元大-成功",0,10,-10
"8133","3679新至陞","110/07/15","元大-彰化",13,0,13
"8134","3679新至陞","110/07/15","群益金鼎-東大",0,8,-8
"8135","3679新至陞","110/07/15","國票-桃園",10,0,10
"8136","3679新至陞","110/07/15","凱基-台北",4,12,-8
"8137","3679新至陞","110/07/15","群益金鼎-台南",10,0,10
"8138","3679新至陞","110/07/15","第一金-華江",0,5,-5
"8139","3679新至陞","110/07/15","華南永昌-台中",10,0,10
"8140","3679新至陞","110/07/15","兆豐-來福",0,5,-5
"8141","3679新至陞","110/07/15","港商野村",9,0,9
"8142","3679新至陞","110/07/15","元大-北三重",0,5,-5
"8143","3679新至陞","110/07/15","元大-永春",6,0,6
"8144","3679新至陞","110/07/15","瑞士信貸",0,4,-4
"8145","3679新至陞","110/07/15","(牛牛牛)亞-網路",5,0,5
"8146","3679新至陞","110/07/15","新加坡商瑞銀",0,4,-4
"8147","3679新至陞","110/07/15","凱基-高雄",5,0,5
"8148","3679新至陞","110/07/15","元大-汐止",0,4,-4
"8149","3679新至陞","110/07/15","美商高盛",6,2,4
"8150","3679新至陞","110/07/15","台中銀-員林",0,3,-3
"8151","3679新至陞","110/07/15","台新證券",3,1,2
"8152","3679新至陞","110/07/15","兆豐-忠孝",0,3,-3
"8153","3679新至陞","110/07/15","群益金鼎-大興",2,0,2
"8154","3679新至陞","110/07/15","玉山-新莊",0,3,-3
"8155","3679新至陞","110/07/15","元大-六合",2,0,2
"8156","3679新至陞","110/07/15","永豐金-屏東",0,3,-3
"8157","3679新至陞","110/07/15","彰銀",1,0,1
"8158","3679新至陞","110/07/15","永豐金-敦南",0,3,-3
"8159","3679新至陞","110/07/15","美林",2,1,1
"8160","3679新至陞","110/07/15","永豐金-萬盛",0,3,-3
"8161","2727王品","110/07/15","兆豐-南京",101,0,101
"8162","2727王品","110/07/15","富邦-左營",0,102,-102
"8163","2727王品","110/07/15","港商野村",166,73,93
"8164","2727王品","110/07/15","日盛-忠孝",2,32,-30
"8165","2727王品","110/07/15","瑞士信貸",97,8,89
"8166","2727王品","110/07/15","群益金鼎-古亭",2,24,-22
"8167","2727王品","110/07/15","玉山證券",56,12,44
"8168","2727王品","110/07/15","日盛-八德",0,21,-21
"8169","2727王品","110/07/15","第一金-高雄",43,1,42
"8170","2727王品","110/07/15","元大-新盛",2,23,-21
"8171","2727王品","110/07/15","台新證券",74,45,29
"8172","2727王品","110/07/15","摩根大通",53,72,-19
"8173","2727王品","110/07/15","康和-澎湖",27,0,27
"8174","2727王品","110/07/15","富邦-彰化",8,26,-18
"8175","2727王品","110/07/15","富邦-陽明",31,4,27
"8176","2727王品","110/07/15","富邦-台中",7,24,-17
"8177","2727王品","110/07/15","國票-北高雄",27,1,26
"8178","2727王品","110/07/15","新加坡商瑞銀",13,29,-16
"8179","2727王品","110/07/15","國泰-板橋",38,12,26
"8180","2727王品","110/07/15","國泰-敦南",35,50,-15
"8181","2727王品","110/07/15","凱基-興隆",23,0,23
"8182","2727王品","110/07/15","元大-龍潭",0,14,-14
"8183","2727王品","110/07/15","凱基-板橋",29,7,22
"8184","2727王品","110/07/15","中國信託-文心",8,21,-13
"8185","2727王品","110/07/15","合庫-彰化",21,0,21
"8186","2727王品","110/07/15","永豐金-竹科",2,15,-13
"8187","2727王品","110/07/15","土銀-南港",20,0,20
"8188","2727王品","110/07/15","臺銀-臺南",2,14,-12
"8189","2727王品","110/07/15","美林",37,18,19
"8190","2727王品","110/07/15","凱基-台北",56,68,-12
"8191","1570力肯","110/07/15","群益金鼎-高雄",40,0,40
"8192","1570力肯","110/07/15","元大-高雄",0,12,-12
"8193","1570力肯","110/07/15","新光",40,8,32
"8194","1570力肯","110/07/15","永豐金-中正",0,10,-10
"8195","1570力肯","110/07/15","凱基-台北",20,2,18
"8196","1570力肯","110/07/15","國泰-松江",0,9,-9
"8197","1570力肯","110/07/15","凱基-天母",6,0,6
"8198","1570力肯","110/07/15","台新證券",0,8,-8
"8199","1570力肯","110/07/15","元富-新店",5,0,5
"8200","1570力肯","110/07/15","玉山證券",0,7,-7
"8201","1570力肯","110/07/15","凱基-中港",5,0,5
"8202","1570力肯","110/07/15","元大-府城",0,7,-7
"8203","1570力肯","110/07/15","富邦-園區",5,0,5
"8204","1570力肯","110/07/15","元大-板橋",0,6,-6
"8205","1570力肯","110/07/15","瑞士信貸",4,0,4
"8206","1570力肯","110/07/15","日盛-信義",0,5,-5
"8207","1570力肯","110/07/15","第一金-路竹",3,0,3
"8208","1570力肯","110/07/15","國票-和平",0,5,-5
"8209","1570力肯","110/07/15","摩根大通",3,0,3
"8210","1570力肯","110/07/15","元大-民雄",0,5,-5
"8211","1570力肯","110/07/15","凱基-桃園",3,0,3
"8212","1570力肯","110/07/15","統一-台中",0,4,-4
"8213","1570力肯","110/07/15","永豐金-苓雅",3,0,3
"8214","1570力肯","110/07/15","玉山-雙和",0,4,-4
"8215","1570力肯","110/07/15","統一-員林",2,0,2
"8216","1570力肯","110/07/15","凱基-敦北",0,4,-4
"8217","1570力肯","110/07/15","元大-永春",2,0,2
"8218","1570力肯","110/07/15","富邦-新店",0,4,-4
"8219","1570力肯","110/07/15","元大-土城永寧",2,0,2
"8220","1570力肯","110/07/15","日盛-板橋",0,3,-3
"8221","6180橘子","110/07/15","兆豐證券",130,0,130
"8222","6180橘子","110/07/15","港商野村",21,137,-116
"8223","6180橘子","110/07/15","摩根大通",111,0,111
"8224","6180橘子","110/07/15","高橋",0,40,-40
"8225","6180橘子","110/07/15","石橋證券",80,0,80
"8226","6180橘子","110/07/15","臺銀",1,40,-39
"8227","6180橘子","110/07/15","凱基-台北",78,26,52
"8228","6180橘子","110/07/15","玉山-桃園",0,35,-35
"8229","6180橘子","110/07/15","新加坡商瑞銀",38,1,37
"8230","6180橘子","110/07/15","玉山-台南",2,33,-31
"8231","6180橘子","110/07/15","富邦-員林",32,0,32
"8232","6180橘子","110/07/15","統一-南京",0,30,-30
"8233","6180橘子","110/07/15","日盛-文化",23,0,23
"8234","6180橘子","110/07/15","康和-台南",0,25,-25
"8235","6180橘子","110/07/15","元富-新店",20,0,20
"8236","6180橘子","110/07/15","大昌-樹林",0,22,-22
"8237","6180橘子","110/07/15","美林",15,0,15
"8238","6180橘子","110/07/15","康和-新竹",0,20,-20
"8239","6180橘子","110/07/15","新光-新竹",17,2,15
"8240","6180橘子","110/07/15","群益金鼎-台中",0,20,-20
"8241","6180橘子","110/07/15","富邦-嘉義",12,0,12
"8242","6180橘子","110/07/15","元大-彰化民生",0,18,-18
"8243","6180橘子","110/07/15","花旗環球",11,0,11
"8244","6180橘子","110/07/15","元大-草屯",0,16,-16
"8245","6180橘子","110/07/15","第一金-新興",11,0,11
"8246","6180橘子","110/07/15","元富-潮州",0,13,-13
"8247","6180橘子","110/07/15","第一金-桃園",10,0,10
"8248","6180橘子","110/07/15","宏遠-台南",0,11,-11
"8249","6180橘子","110/07/15","永興",10,0,10
"8250","6180橘子","110/07/15","大慶-泰山",0,10,-10
"8251","2390云辰","110/07/15","凱基",5007,0,5007
"8252","2390云辰","110/07/15","凱基-台北",382,616,-234
"8253","2390云辰","110/07/15","元大證券",1006,25,981
"8254","2390云辰","110/07/15","富邦-陽明",69,265,-196
"8255","2390云辰","110/07/15","元大-天母",456,20,436
"8256","2390云辰","110/07/15","永豐金-桃園",63,255,-192
"8257","2390云辰","110/07/15","港商野村",975,675,300
"8258","2390云辰","110/07/15","富邦-仁愛",17,187,-170
"8259","2390云辰","110/07/15","摩根大通",1318,1040,278
"8260","2390云辰","110/07/15","日盛-和美",2,165,-163
"8261","2390云辰","110/07/15","國票-博愛",184,7,177
"8262","2390云辰","110/07/15","國泰-敦南",142,290,-148
"8263","2390云辰","110/07/15","群益金鼎-大甲",113,13,100
"8264","2390云辰","110/07/15","台灣摩根士丹利",51,197,-146
"8265","2390云辰","110/07/15","凱基-大直",89,2,87
"8266","2390云辰","110/07/15","國票-嘉義",4,148,-144
"8267","2390云辰","110/07/15","玉山-台中",77,8,69
"8268","2390云辰","110/07/15","台中銀",8,139,-131
"8269","2390云辰","110/07/15","聯邦商銀",70,4,66
"8270","2390云辰","110/07/15","元大-彰化民生",7,138,-131
"8271","2390云辰","110/07/15","元大-大里",88,25,63
"8272","2390云辰","110/07/15","元富-成功",2,111,-109
"8273","2390云辰","110/07/15","富邦-嘉義",542,480,62
"8274","2390云辰","110/07/15","元大-東泰",3,106,-103
"8275","2390云辰","110/07/15","新加坡商瑞銀",158,97,61
"8276","2390云辰","110/07/15","合庫-三重",1,102,-101
"8277","2390云辰","110/07/15","華南永昌-台中",86,35,51
"8278","2390云辰","110/07/15","元富-大裕",4,87,-83
"8279","2390云辰","110/07/15","群益金鼎",51,6,45
"8280","2390云辰","110/07/15","凱基-和平",17,96,-79
"8281","2363矽統","110/07/14","台灣摩根士丹利",463,0,463
"8282","2363矽統","110/07/14","新加坡商瑞銀",568,1321,-753
"8283","2363矽統","110/07/14","台新證券",750,342,408
"8284","2363矽統","110/07/14","瑞士信貸",149,864,-715
"8285","2363矽統","110/07/14","玉山-台中",363,51,312
"8286","2363矽統","110/07/14","台新-屏東",115,380,-265
"8287","2363矽統","110/07/14","元大-斗六",223,25,198
"8288","2363矽統","110/07/14","永豐金證券",16,265,-249
"8289","2363矽統","110/07/14","華南永昌-朴子",208,38,170
"8290","2363矽統","110/07/14","美林",462,701,-239
"8291","2363矽統","110/07/14","元富-西松",169,12,157
"8292","2363矽統","110/07/14","宏遠-桃園",269,500,-231
"8293","2363矽統","110/07/14","永豐金-大園",146,6,140
"8294","2363矽統","110/07/14","凱基-竹北",36,254,-218
"8295","2363矽統","110/07/14","土銀-和平",134,0,134
"8296","2363矽統","110/07/14","港商法國興業",0,214,-214
"8297","2363矽統","110/07/14","富邦-新營",130,13,117
"8298","2363矽統","110/07/14","港商野村",835,1044,-209
"8299","2363矽統","110/07/14","元富-成功",118,11,107
"8300","2363矽統","110/07/14","北城證券",212,411,-199
"8301","2363矽統","110/07/14","元富-烏日",121,18,103
"8302","2363矽統","110/07/14","(牛牛牛)亞-鑫豐",51,241,-190
"8303","2363矽統","110/07/14","日盛-二林",120,18,102
"8304","2363矽統","110/07/14","國票-博愛",24,213,-189
"8305","2363矽統","110/07/14","兆豐-忠孝",98,2,96
"8306","2363矽統","110/07/14","大慶-蘆洲",134,316,-182
"8307","2363矽統","110/07/14","大慶-楊梅",92,3,89
"8308","2363矽統","110/07/14","彰銀-台中",15,193,-178
"8309","2363矽統","110/07/14","元富-三重",120,33,87
"8310","2363矽統","110/07/14","日盛-和美",18,185,-167
"8311","8112至上","110/07/14","新加坡商瑞銀",223,17,206
"8312","8112至上","110/07/14","瑞士信貸",8,170,-162
"8313","8112至上","110/07/14","摩根大通",285,129,156
"8314","8112至上","110/07/14","美林",55,202,-147
"8315","8112至上","110/07/14","花旗環球",124,0,124
"8316","8112至上","110/07/14","凱基-台北",325,436,-111
"8317","8112至上","110/07/14","兆豐-公益",117,4,113
"8318","8112至上","110/07/14","台中銀-台北",0,98,-98
"8319","8112至上","110/07/14","香港上海匯豐",111,0,111
"8320","8112至上","110/07/14","玉山-台大",17,107,-90
"8321","8112至上","110/07/14","永豐金-內湖",117,21,96
"8322","8112至上","110/07/14","康和-內湖",1,90,-89
"8323","8112至上","110/07/14","台灣摩根士丹利",108,16,92
"8324","8112至上","110/07/14","港商野村",21,84,-63
"8325","8112至上","110/07/14","元大-東蘆",77,0,77
"8326","8112至上","110/07/14","兆豐-北高雄",1,60,-59
"8327","8112至上","110/07/14","新光",108,48,60
"8328","8112至上","110/07/14","群益金鼎-海山",1,52,-51
"8329","8112至上","110/07/14","大慶-蘆洲",59,0,59
"8330","8112至上","110/07/14","群益金鼎-大安",0,50,-50
"8331","8112至上","110/07/14","華南永昌-台中",56,3,53
"8332","8112至上","110/07/14","富邦-仁愛",2,49,-47
"8333","8112至上","110/07/14","土銀-嘉義",52,2,50
"8334","8112至上","110/07/14","元大-金華",0,42,-42
"8335","8112至上","110/07/14","美商高盛",40,0,40
"8336","8112至上","110/07/14","元大-內湖",4,43,-39
"8337","8112至上","110/07/14","臺銀",63,29,34
"8338","8112至上","110/07/14","第一金-華江",2,37,-35
"8339","8112至上","110/07/14","元富-嘉義",31,0,31
"8340","8112至上","110/07/14","永豐金-苓雅",2,34,-32
"8341","1570力肯","110/07/14","國票-北高雄",68,0,68
"8342","1570力肯","110/07/14","摩根大通",0,21,-21
"8343","1570力肯","110/07/14","日盛-八德",30,1,29
"8344","1570力肯","110/07/14","新光",1,19,-18
"8345","1570力肯","110/07/14","玉山-高雄",7,0,7
"8346","1570力肯","110/07/14","(牛牛牛)亞-鑫豐",0,17,-17
"8347","1570力肯","110/07/14","臺銀-臺南",5,0,5
"8348","1570力肯","110/07/14","日盛-士林",0,10,-10
"8349","1570力肯","110/07/14","凱基-三峽",5,0,5
"8350","1570力肯","110/07/14","統一-員林",0,10,-10
"8351","1570力肯","110/07/14","元大-和平",5,0,5
"8352","1570力肯","110/07/14","國票-新莊",0,10,-10
"8353","1570力肯","110/07/14","合庫-三重",4,0,4
"8354","1570力肯","110/07/14","凱基-高美館",0,10,-10
"8355","1570力肯","110/07/14","瑞士信貸",4,0,4
"8356","1570力肯","110/07/14","元大-屏東民生",0,5,-5
"8357","1570力肯","110/07/14","統一-三多",4,0,4
"8358","1570力肯","110/07/14","元大-古亭",0,5,-5
"8359","1570力肯","110/07/14","華南永昌-古亭",4,0,4
"8360","1570力肯","110/07/14","日盛-木柵",0,4,-4
"8361","1570力肯","110/07/14","元大-高雄",3,0,3
"8362","1570力肯","110/07/14","大昌",0,4,-4
"8363","1570力肯","110/07/14","兆豐-忠孝",2,0,2
"8364","1570力肯","110/07/14","群益金鼎-東大",0,4,-4
"8365","1570力肯","110/07/14","富邦-陽明",2,0,2
"8366","1570力肯","110/07/14","凱基-台北",0,4,-4
"8367","1570力肯","110/07/14","元大-松山",2,0,2
"8368","1570力肯","110/07/14","元大-板橋",0,4,-4
"8369","1570力肯","110/07/14","元大-忠孝",2,0,2
"8370","1570力肯","110/07/14","第一金-中山",0,3,-3
"8371","2929淘帝","110/07/14","華南永昌-林口",60,0,60
"8372","2929淘帝","110/07/14","群益金鼎",25,540,-515
"8373","2929淘帝","110/07/14","美林",87,31,56
"8374","2929淘帝","110/07/14","國泰-台南",1,30,-29
"8375","2929淘帝","110/07/14","元富-台南",40,0,40
"8376","2929淘帝","110/07/14","宏遠-桃園",0,20,-20
"8377","2929淘帝","110/07/14","元大-民生",39,0,39
"8378","2929淘帝","110/07/14","摩根大通",11,31,-20
"8379","2929淘帝","110/07/14","臺銀-鳳山",34,0,34
"8380","2929淘帝","110/07/14","台新-建北",5,20,-15
"8381","2929淘帝","110/07/14","合庫-高雄",34,1,33
"8382","2929淘帝","110/07/14","新光",1,16,-15
"8383","2929淘帝","110/07/14","華南永昌-鶯歌",28,0,28
"8384","2929淘帝","110/07/14","玉山-板橋",0,15,-15
"8385","2929淘帝","110/07/14","永興",25,0,25
"8386","2929淘帝","110/07/14","凱基-羅東",0,15,-15
"8387","2929淘帝","110/07/14","元大-新盛",25,1,24
"8388","2929淘帝","110/07/14","元大-頭份",0,15,-15
"8389","2929淘帝","110/07/14","日盛-南京",23,0,23
"8390","2929淘帝","110/07/14","第一金-台南",0,13,-13
"8391","2929淘帝","110/07/14","日茂",20,0,20
"8392","2929淘帝","110/07/14","富邦-基隆",0,12,-12
"8393","2929淘帝","110/07/14","台新-台中",20,0,20
"8394","2929淘帝","110/07/14","日茂-南投",1,12,-11
"8395","2929淘帝","110/07/14","華南永昌",20,0,20
"8396","2929淘帝","110/07/14","元大-豐原站前",0,11,-11
"8397","2929淘帝","110/07/14","福勝",15,0,15
"8398","2929淘帝","110/07/14","玉山-士林",0,10,-10
"8399","2929淘帝","110/07/14","富邦-南屯",15,0,15
"8400","2929淘帝","110/07/14","富邦-台北",0,10,-10
"8401","5410國眾","110/07/14","兆豐-城中",35,0,35
"8402","5410國眾","110/07/14","瑞士信貸",0,29,-29
"8403","5410國眾","110/07/14","新光",21,1,20
"8404","5410國眾","110/07/14","國泰-板橋",1,30,-29
"8405","5410國眾","110/07/14","國泰-敦南",21,1,20
"8406","5410國眾","110/07/14","日盛-高雄",0,20,-20
"8407","5410國眾","110/07/14","國泰-台中",20,1,19
"8408","5410國眾","110/07/14","台新-左楠",1,20,-19
"8409","5410國眾","110/07/14","元大-崇德",19,0,19
"8410","5410國眾","110/07/14","元富-大昌",1,18,-17
"8411","5410國眾","110/07/14","土銀-士林",18,0,18
"8412","5410國眾","110/07/14","富邦-建國",0,15,-15
"8413","5410國眾","110/07/14","元大-新盛",20,2,18
"8414","5410國眾","110/07/14","元富-嘉義",0,12,-12
"8415","5410國眾","110/07/14","兆豐-高雄",15,0,15
"8416","5410國眾","110/07/14","永全-南崁",0,12,-12
"8417","5410國眾","110/07/14","宏遠-中和",10,0,10
"8418","5410國眾","110/07/14","元大-員林",0,11,-11
"8419","5410國眾","110/07/14","新光-桃園",10,0,10
"8420","5410國眾","110/07/14","高橋",0,10,-10
"8421","5410國眾","110/07/14","國泰-台南",10,0,10
"8422","5410國眾","110/07/14","永興",0,10,-10
"8423","5410國眾","110/07/14","元大-復北",10,0,10
"8424","5410國眾","110/07/14","華南永昌-三重",0,10,-10
"8425","5410國眾","110/07/14","元大-竹科",8,0,8
"8426","5410國眾","110/07/14","元大-苑裡",0,7,-7
"8427","5410國眾","110/07/14","台新-新營",6,0,6
"8428","5410國眾","110/07/14","港商野村",0,6,-6
"8429","5410國眾","110/07/14","日盛-士林",5,0,5
"8430","5410國眾","110/07/14","摩根大通",5,11,-6
"8431","2841台開","110/07/14","凱基-文心",73,0,73
"8432","2841台開","110/07/14","國泰-敦南",0,50,-50
"8433","2841台開","110/07/14","元富-潮州",30,0,30
"8434","2841台開","110/07/14","凱基-中壢",0,40,-40
"8435","2841台開","110/07/14","第一金-台中",20,0,20
"8436","2841台開","110/07/14","統一-新竹",0,24,-24
"8437","2841台開","110/07/14","華南永昌-新莊",20,0,20
"8438","2841台開","110/07/14","元富-草屯",0,20,-20
"8439","2841台開","110/07/14","永豐金-豐原",20,0,20
"8440","2841台開","110/07/14","台新-台南",0,20,-20
"8441","2841台開","110/07/14","國泰-館前",15,0,15
"8442","2841台開","110/07/14","永豐金-敦南",45,63,-18
"8443","2841台開","110/07/14","群益金鼎-基隆",12,0,12
"8444","2841台開","110/07/14","國票-北高雄",0,13,-13
"8445","2841台開","110/07/14","日盛-信義",10,0,10
"8446","2841台開","110/07/14","凱基-松山",0,10,-10
"8447","2841台開","110/07/14","台新-台中",10,0,10
"8448","2841台開","110/07/14","元大證券",0,10,-10
"8449","2841台開","110/07/14","新光",10,1,9
"8450","2841台開","110/07/14","元大-中壢",0,10,-10
"8451","2841台開","110/07/14","凱基-新店",8,0,8
"8452","2841台開","110/07/14","富邦-陽明",1,10,-9
"8453","2841台開","110/07/14","元大-斗信",7,0,7
"8454","2841台開","110/07/14","富邦-建國",0,9,-9
"8455","2841台開","110/07/14","元大-三重",6,0,6
"8456","2841台開","110/07/14","富邦-台南",0,8,-8
"8457","2841台開","110/07/14","永豐金-中和",6,0,6
"8458","2841台開","110/07/14","康和-澎湖",0,7,-7
"8459","2841台開","110/07/14","元富-成功",5,0,5
"8460","2841台開","110/07/14","日盛-斗六",0,6,-6
"8461","6207雷科","110/07/14","群益金鼎-台北",60,0,60
"8462","6207雷科","110/07/14","新加坡商瑞銀",10,56,-46
"8463","6207雷科","110/07/14","台新-高雄",43,3,40
"8464","6207雷科","110/07/14","國票-中和",0,41,-41
"8465","6207雷科","110/07/14","元大-高雄",19,0,19
"8466","6207雷科","110/07/14","元大-復北",0,33,-33
"8467","6207雷科","110/07/14","福勝",15,0,15
"8468","6207雷科","110/07/14","光和-和美",0,20,-20
"8469","6207雷科","110/07/14","群益金鼎-中山",15,0,15
"8470","6207雷科","110/07/14","群益金鼎-丹鳳",0,20,-20
"8471","6207雷科","110/07/14","元大-林園",15,0,15
"8472","6207雷科","110/07/14","第一金-路竹",0,10,-10
"8473","6207雷科","110/07/14","新光",12,0,12
"8474","6207雷科","110/07/14","元大-歸仁",0,10,-10
"8475","6207雷科","110/07/14","元大-大天母",10,0,10
"8476","6207雷科","110/07/14","宏遠-館前",0,9,-9
"8477","6207雷科","110/07/14","永豐金-忠孝",9,0,9
"8478","6207雷科","110/07/14","凱基-台北",12,20,-8
"8479","6207雷科","110/07/14","永豐金-新店",7,0,7
"8480","6207雷科","110/07/14","美林",0,7,-7
"8481","6207雷科","110/07/14","玉山-嘉義",6,0,6
"8482","6207雷科","110/07/14","摩根大通",16,23,-7
"8483","6207雷科","110/07/14","元大-屏東",6,0,6
"8484","6207雷科","110/07/14","凱基-高雄",1,7,-6
"8485","6207雷科","110/07/14","凱基-大安",5,0,5
"8486","6207雷科","110/07/14","台中銀-豐原",0,5,-5
"8487","6207雷科","110/07/14","富邦-台南",5,0,5
"8488","6207雷科","110/07/14","元大-新竹經國",0,5,-5
"8489","6207雷科","110/07/14","元大-成功",5,0,5
"8490","6207雷科","110/07/14","光和-田中",0,4,-4
"8491","3679新至陞","110/07/14","凱基-台北",31,6,25
"8492","3679新至陞","110/07/14","群益金鼎-東大",0,15,-15
"8493","3679新至陞","110/07/14","華南永昌-新莊",10,0,10
"8494","3679新至陞","110/07/14","瑞士信貸",0,12,-12
"8495","3679新至陞","110/07/14","新加坡商瑞銀",11,3,8
"8496","3679新至陞","110/07/14","群益金鼎-永和",0,10,-10
"8497","3679新至陞","110/07/14","美商高盛",6,0,6
"8498","3679新至陞","110/07/14","元大-成功",5,15,-10
"8499","3679新至陞","110/07/14","第一金-中壢",6,0,6
"8500","3679新至陞","110/07/14","統一-板橋",1,10,-9
"8501","3679新至陞","110/07/14","(牛牛牛)亞-網路",4,0,4
"8502","3679新至陞","110/07/14","玉山-左營",0,5,-5
"8503","3679新至陞","110/07/14","元大-六合",3,0,3
"8504","3679新至陞","110/07/14","群益金鼎-三民",0,4,-4
"8505","3679新至陞","110/07/14","合庫-自強",2,0,2
"8506","3679新至陞","110/07/14","富邦-宜蘭",0,4,-4
"8507","3679新至陞","110/07/14","高橋-內壢",2,0,2
"8508","3679新至陞","110/07/14","永豐金-苓雅",0,3,-3
"8509","3679新至陞","110/07/14","台中銀-員林",2,0,2
"8510","3679新至陞","110/07/14","摩根大通",5,7,-2
"8511","3679新至陞","110/07/14","凱基-高美館",2,0,2
"8512","3679新至陞","110/07/14","元大-板橋三民",0,2,-2
"8513","3679新至陞","110/07/14","元大-福營",2,0,2
"8514","3679新至陞","110/07/14","宏遠-中和",0,1,-1
"8515","3679新至陞","110/07/14","永豐金-松山",2,0,2
"8516","3679新至陞","110/07/14","元富-佳里",0,1,-1
"8517","3679新至陞","110/07/14","永豐金-萬盛",2,0,2
"8518","3679新至陞","110/07/14","(牛牛牛)亞-鑫豐",0,1,-1
"8519","3679新至陞","110/07/14","元富-松德",1,0,1
"8520","3679新至陞","110/07/14","中國信託-中壢",0,1,-1
"8521","2727王品","110/07/14","富邦-左營",102,1,101
"8522","2727王品","110/07/14","統一-城中",100,234,-134
"8523","2727王品","110/07/14","國泰-板橋",105,11,94
"8524","2727王品","110/07/14","富邦-台北",1,125,-124
"8525","2727王品","110/07/14","港商野村",149,72,77
"8526","2727王品","110/07/14","台灣摩根士丹利",1,48,-47
"8527","2727王品","110/07/14","合庫-台中",66,2,64
"8528","2727王品","110/07/14","國票-新莊",0,40,-40
"8529","2727王品","110/07/14","臺銀-金山",63,8,55
"8530","2727王品","110/07/14","永豐金-忠孝",2,39,-37
"8531","2727王品","110/07/14","摩根大通",83,39,44
"8532","2727王品","110/07/14","富邦-彰化",1,34,-33
"8533","2727王品","110/07/14","凱基-台北",84,42,42
"8534","2727王品","110/07/14","康和-高雄",0,30,-30
"8535","2727王品","110/07/14","土銀-台中",35,1,34
"8536","2727王品","110/07/14","安泰",0,26,-26
"8537","2727王品","110/07/14","華南永昌-麻豆",32,1,31
"8538","2727王品","110/07/14","富邦-新竹華信",0,21,-21
"8539","2727王品","110/07/14","元大證券",85,55,30
"8540","2727王品","110/07/14","元大-南崁",1,22,-21
"8541","2727王品","110/07/14","新加坡商瑞銀",40,15,25
"8542","2727王品","110/07/14","彰銀-台中",0,18,-18
"8543","2727王品","110/07/14","日盛-八德",19,0,19
"8544","2727王品","110/07/14","元富-同大",2,20,-18
"8545","2727王品","110/07/14","統一",35,17,18
"8546","2727王品","110/07/14","玉山-嘉義",1,17,-16
"8547","2727王品","110/07/14","元富-大昌",18,1,17
"8548","2727王品","110/07/14","國泰-館前",4,20,-16
"8549","2727王品","110/07/14","玉山-板橋",15,1,14
"8550","2727王品","110/07/14","第一金-嘉義",1,13,-12
"8551","1570力肯","110/07/14","國票-北高雄",68,0,68
"8552","1570力肯","110/07/14","摩根大通",0,21,-21
"8553","1570力肯","110/07/14","日盛-八德",30,1,29
"8554","1570力肯","110/07/14","新光",1,19,-18
"8555","1570力肯","110/07/14","玉山-高雄",7,0,7
"8556","1570力肯","110/07/14","(牛牛牛)亞-鑫豐",0,17,-17
"8557","1570力肯","110/07/14","臺銀-臺南",5,0,5
"8558","1570力肯","110/07/14","日盛-士林",0,10,-10
"8559","1570力肯","110/07/14","凱基-三峽",5,0,5
"8560","1570力肯","110/07/14","統一-員林",0,10,-10
"8561","1570力肯","110/07/14","元大-和平",5,0,5
"8562","1570力肯","110/07/14","國票-新莊",0,10,-10
"8563","1570力肯","110/07/14","合庫-三重",4,0,4
"8564","1570力肯","110/07/14","凱基-高美館",0,10,-10
"8565","1570力肯","110/07/14","瑞士信貸",4,0,4
"8566","1570力肯","110/07/14","元大-屏東民生",0,5,-5
"8567","1570力肯","110/07/14","統一-三多",4,0,4
"8568","1570力肯","110/07/14","元大-古亭",0,5,-5
"8569","1570力肯","110/07/14","華南永昌-古亭",4,0,4
"8570","1570力肯","110/07/14","日盛-木柵",0,4,-4
"8571","1570力肯","110/07/14","元大-高雄",3,0,3
"8572","1570力肯","110/07/14","大昌",0,4,-4
"8573","1570力肯","110/07/14","兆豐-忠孝",2,0,2
"8574","1570力肯","110/07/14","群益金鼎-東大",0,4,-4
"8575","1570力肯","110/07/14","富邦-陽明",2,0,2
"8576","1570力肯","110/07/14","凱基-台北",0,4,-4
"8577","1570力肯","110/07/14","元大-松山",2,0,2
"8578","1570力肯","110/07/14","元大-板橋",0,4,-4
"8579","1570力肯","110/07/14","元大-忠孝",2,0,2
"8580","1570力肯","110/07/14","第一金-中山",0,3,-3
"8581","6180橘子","110/07/14","新加坡商瑞銀",84,28,56
"8582","6180橘子","110/07/14","凱基-台北",4,37,-33
"8583","6180橘子","110/07/14","日盛-信義",29,1,28
"8584","6180橘子","110/07/14","玉山-台南",1,22,-21
"8585","6180橘子","110/07/14","豐農",28,4,24
"8586","6180橘子","110/07/14","日盛-新竹",1,21,-20
"8587","6180橘子","110/07/14","新光-新竹",24,1,23
"8588","6180橘子","110/07/14","元富-潮州",0,19,-19
"8589","6180橘子","110/07/14","華南永昌-高雄",20,0,20
"8590","6180橘子","110/07/14","元大-信義",0,17,-17
"8591","6180橘子","110/07/14","元大-羅東",20,0,20
"8592","6180橘子","110/07/14","台灣企銀-台中",1,16,-15
"8593","6180橘子","110/07/14","元大-台中中港",20,0,20
"8594","6180橘子","110/07/14","元大-北港",0,15,-15
"8595","6180橘子","110/07/14","富邦-嘉義",24,5,19
"8596","6180橘子","110/07/14","富邦-高雄",0,14,-14
"8597","6180橘子","110/07/14","富邦-仁愛",15,0,15
"8598","6180橘子","110/07/14","兆豐-埔墘",0,13,-13
"8599","6180橘子","110/07/14","國票-九鼎",13,0,13
"8600","6180橘子","110/07/14","第一金-中山",0,10,-10
"8601","6180橘子","110/07/14","日盛-木柵",12,0,12
"8602","6180橘子","110/07/14","元大-彰化民生",0,10,-10
"8603","6180橘子","110/07/14","元大-成功",10,0,10
"8604","6180橘子","110/07/14","福勝",1,10,-9
"8605","6180橘子","110/07/14","港商野村",10,2,8
"8606","6180橘子","110/07/14","群益金鼎-丹鳳",1,10,-9
"8607","6180橘子","110/07/14","玉山-左營",8,0,8
"8608","6180橘子","110/07/14","群益金鼎-板橋",0,8,-8
"8609","6180橘子","110/07/14","富邦-陽明",16,8,8
"8610","6180橘子","110/07/14","合庫-鳳山",0,7,-7
"8611","2390云辰","110/07/14","摩根大通",995,198,797
"8612","2390云辰","110/07/14","新加坡商瑞銀",28,399,-371
"8613","2390云辰","110/07/14","美林",383,22,361
"8614","2390云辰","110/07/14","凱基-新豐",3,198,-195
"8615","2390云辰","110/07/14","台灣摩根士丹利",684,358,326
"8616","2390云辰","110/07/14","元大-士林",1,152,-151
"8617","2390云辰","110/07/14","凱基-台北",656,402,254
"8618","2390云辰","110/07/14","元大-竹山",80,181,-101
"8619","2390云辰","110/07/14","日盛-和美",110,5,105
"8620","2390云辰","110/07/14","群益金鼎-開元",19,95,-76
"8621","2390云辰","110/07/14","元大-天母",72,0,72
"8622","2390云辰","110/07/14","新光",77,150,-73
"8623","2390云辰","110/07/14","永豐金-松山",57,0,57
"8624","2390云辰","110/07/14","元富-高雄",0,71,-71
"8625","2390云辰","110/07/14","統一-屏東",53,0,53
"8626","2390云辰","110/07/14","元大-土城學府",130,201,-71
"8627","2390云辰","110/07/14","港商野村",486,450,36
"8628","2390云辰","110/07/14","元大-善化",12,76,-64
"8629","2390云辰","110/07/14","致和-崇德",30,0,30
"8630","2390云辰","110/07/14","華南永昌-岡山",23,81,-58
"8631","2390云辰","110/07/14","富邦-台北",40,14,26
"8632","2390云辰","110/07/14","群益金鼎-大興",82,125,-43
"8633","2390云辰","110/07/14","台新-高雄",38,13,25
"8634","2390云辰","110/07/14","大慶-中壢",0,41,-41
"8635","2390云辰","110/07/14","富邦-板橋",32,7,25
"8636","2390云辰","110/07/14","玉山-板橋",6,47,-41
"8637","2390云辰","110/07/14","陽信-石牌",24,0,24
"8638","2390云辰","110/07/14","富邦-台東",2,42,-40
"8639","2390云辰","110/07/14","凱基-屏東",32,8,24
"8640","2390云辰","110/07/14","元大-新營",3,42,-39
"8641","2363矽統","110/07/14","台灣摩根士丹利",463,0,463
"8642","2363矽統","110/07/14","新加坡商瑞銀",568,1321,-753
"8643","2363矽統","110/07/14","台新證券",750,342,408
"8644","2363矽統","110/07/14","瑞士信貸",149,864,-715
"8645","2363矽統","110/07/14","玉山-台中",363,51,312
"8646","2363矽統","110/07/14","台新-屏東",115,380,-265
"8647","2363矽統","110/07/14","元大-斗六",223,25,198
"8648","2363矽統","110/07/14","永豐金證券",16,265,-249
"8649","2363矽統","110/07/14","華南永昌-朴子",208,38,170
"8650","2363矽統","110/07/14","美林",462,701,-239
"8651","2363矽統","110/07/14","元富-西松",169,12,157
"8652","2363矽統","110/07/14","宏遠-桃園",269,500,-231
"8653","2363矽統","110/07/14","永豐金-大園",146,6,140
"8654","2363矽統","110/07/14","凱基-竹北",36,254,-218
"8655","2363矽統","110/07/14","土銀-和平",134,0,134
"8656","2363矽統","110/07/14","港商法國興業",0,214,-214
"8657","2363矽統","110/07/14","富邦-新營",130,13,117
"8658","2363矽統","110/07/14","港商野村",835,1044,-209
"8659","2363矽統","110/07/14","元富-成功",118,11,107
"8660","2363矽統","110/07/14","北城證券",212,411,-199
"8661","2363矽統","110/07/14","元富-烏日",121,18,103
"8662","2363矽統","110/07/14","(牛牛牛)亞-鑫豐",51,241,-190
"8663","2363矽統","110/07/14","日盛-二林",120,18,102
"8664","2363矽統","110/07/14","國票-博愛",24,213,-189
"8665","2363矽統","110/07/14","兆豐-忠孝",98,2,96
"8666","2363矽統","110/07/14","大慶-蘆洲",134,316,-182
"8667","2363矽統","110/07/14","大慶-楊梅",92,3,89
"8668","2363矽統","110/07/14","彰銀-台中",15,193,-178
"8669","2363矽統","110/07/14","元富-三重",120,33,87
"8670","2363矽統","110/07/14","日盛-和美",18,185,-167
"8671","8112至上","110/07/14","新加坡商瑞銀",223,17,206
"8672","8112至上","110/07/14","瑞士信貸",8,170,-162
"8673","8112至上","110/07/14","摩根大通",285,129,156
"8674","8112至上","110/07/14","美林",55,202,-147
"8675","8112至上","110/07/14","花旗環球",124,0,124
"8676","8112至上","110/07/14","凱基-台北",325,436,-111
"8677","8112至上","110/07/14","兆豐-公益",117,4,113
"8678","8112至上","110/07/14","台中銀-台北",0,98,-98
"8679","8112至上","110/07/14","香港上海匯豐",111,0,111
"8680","8112至上","110/07/14","玉山-台大",17,107,-90
"8681","8112至上","110/07/14","永豐金-內湖",117,21,96
"8682","8112至上","110/07/14","康和-內湖",1,90,-89
"8683","8112至上","110/07/14","台灣摩根士丹利",108,16,92
"8684","8112至上","110/07/14","港商野村",21,84,-63
"8685","8112至上","110/07/14","元大-東蘆",77,0,77
"8686","8112至上","110/07/14","兆豐-北高雄",1,60,-59
"8687","8112至上","110/07/14","新光",108,48,60
"8688","8112至上","110/07/14","群益金鼎-海山",1,52,-51
"8689","8112至上","110/07/14","大慶-蘆洲",59,0,59
"8690","8112至上","110/07/14","群益金鼎-大安",0,50,-50
"8691","8112至上","110/07/14","華南永昌-台中",56,3,53
"8692","8112至上","110/07/14","富邦-仁愛",2,49,-47
"8693","8112至上","110/07/14","土銀-嘉義",52,2,50
"8694","8112至上","110/07/14","元大-金華",0,42,-42
"8695","8112至上","110/07/14","美商高盛",40,0,40
"8696","8112至上","110/07/14","元大-內湖",4,43,-39
"8697","8112至上","110/07/14","臺銀",63,29,34
"8698","8112至上","110/07/14","第一金-華江",2,37,-35
"8699","8112至上","110/07/14","元富-嘉義",31,0,31
"8700","8112至上","110/07/14","永豐金-苓雅",2,34,-32
"8701","1570力肯","110/07/14","國票-北高雄",68,0,68
"8702","1570力肯","110/07/14","摩根大通",0,21,-21
"8703","1570力肯","110/07/14","日盛-八德",30,1,29
"8704","1570力肯","110/07/14","新光",1,19,-18
"8705","1570力肯","110/07/14","玉山-高雄",7,0,7
"8706","1570力肯","110/07/14","(牛牛牛)亞-鑫豐",0,17,-17
"8707","1570力肯","110/07/14","臺銀-臺南",5,0,5
"8708","1570力肯","110/07/14","日盛-士林",0,10,-10
"8709","1570力肯","110/07/14","凱基-三峽",5,0,5
"8710","1570力肯","110/07/14","統一-員林",0,10,-10
"8711","1570力肯","110/07/14","元大-和平",5,0,5
"8712","1570力肯","110/07/14","國票-新莊",0,10,-10
"8713","1570力肯","110/07/14","合庫-三重",4,0,4
"8714","1570力肯","110/07/14","凱基-高美館",0,10,-10
"8715","1570力肯","110/07/14","瑞士信貸",4,0,4
"8716","1570力肯","110/07/14","元大-屏東民生",0,5,-5
"8717","1570力肯","110/07/14","統一-三多",4,0,4
"8718","1570力肯","110/07/14","元大-古亭",0,5,-5
"8719","1570力肯","110/07/14","華南永昌-古亭",4,0,4
"8720","1570力肯","110/07/14","日盛-木柵",0,4,-4
"8721","1570力肯","110/07/14","元大-高雄",3,0,3
"8722","1570力肯","110/07/14","大昌",0,4,-4
"8723","1570力肯","110/07/14","兆豐-忠孝",2,0,2
"8724","1570力肯","110/07/14","群益金鼎-東大",0,4,-4
"8725","1570力肯","110/07/14","富邦-陽明",2,0,2
"8726","1570力肯","110/07/14","凱基-台北",0,4,-4
"8727","1570力肯","110/07/14","元大-松山",2,0,2
"8728","1570力肯","110/07/14","元大-板橋",0,4,-4
"8729","1570力肯","110/07/14","元大-忠孝",2,0,2
"8730","1570力肯","110/07/14","第一金-中山",0,3,-3
"8731","2929淘帝","110/07/14","華南永昌-林口",60,0,60
"8732","2929淘帝","110/07/14","群益金鼎",25,540,-515
"8733","2929淘帝","110/07/14","美林",87,31,56
"8734","2929淘帝","110/07/14","國泰-台南",1,30,-29
"8735","2929淘帝","110/07/14","元富-台南",40,0,40
"8736","2929淘帝","110/07/14","宏遠-桃園",0,20,-20
"8737","2929淘帝","110/07/14","元大-民生",39,0,39
"8738","2929淘帝","110/07/14","摩根大通",11,31,-20
"8739","2929淘帝","110/07/14","臺銀-鳳山",34,0,34
"8740","2929淘帝","110/07/14","台新-建北",5,20,-15
"8741","2929淘帝","110/07/14","合庫-高雄",34,1,33
"8742","2929淘帝","110/07/14","新光",1,16,-15
"8743","2929淘帝","110/07/14","華南永昌-鶯歌",28,0,28
"8744","2929淘帝","110/07/14","玉山-板橋",0,15,-15
"8745","2929淘帝","110/07/14","永興",25,0,25
"8746","2929淘帝","110/07/14","凱基-羅東",0,15,-15
"8747","2929淘帝","110/07/14","元大-新盛",25,1,24
"8748","2929淘帝","110/07/14","元大-頭份",0,15,-15
"8749","2929淘帝","110/07/14","日盛-南京",23,0,23
"8750","2929淘帝","110/07/14","第一金-台南",0,13,-13
"8751","2929淘帝","110/07/14","日茂",20,0,20
"8752","2929淘帝","110/07/14","富邦-基隆",0,12,-12
"8753","2929淘帝","110/07/14","台新-台中",20,0,20
"8754","2929淘帝","110/07/14","日茂-南投",1,12,-11
"8755","2929淘帝","110/07/14","華南永昌",20,0,20
"8756","2929淘帝","110/07/14","元大-豐原站前",0,11,-11
"8757","2929淘帝","110/07/14","福勝",15,0,15
"8758","2929淘帝","110/07/14","玉山-士林",0,10,-10
"8759","2929淘帝","110/07/14","富邦-南屯",15,0,15
"8760","2929淘帝","110/07/14","富邦-台北",0,10,-10
"8761","5410國眾","110/07/14","兆豐-城中",35,0,35
"8762","5410國眾","110/07/14","瑞士信貸",0,29,-29
"8763","5410國眾","110/07/14","新光",21,1,20
"8764","5410國眾","110/07/14","國泰-板橋",1,30,-29
"8765","5410國眾","110/07/14","國泰-敦南",21,1,20
"8766","5410國眾","110/07/14","日盛-高雄",0,20,-20
"8767","5410國眾","110/07/14","國泰-台中",20,1,19
"8768","5410國眾","110/07/14","台新-左楠",1,20,-19
"8769","5410國眾","110/07/14","元大-崇德",19,0,19
"8770","5410國眾","110/07/14","元富-大昌",1,18,-17
"8771","5410國眾","110/07/14","土銀-士林",18,0,18
"8772","5410國眾","110/07/14","富邦-建國",0,15,-15
"8773","5410國眾","110/07/14","元大-新盛",20,2,18
"8774","5410國眾","110/07/14","元富-嘉義",0,12,-12
"8775","5410國眾","110/07/14","兆豐-高雄",15,0,15
"8776","5410國眾","110/07/14","永全-南崁",0,12,-12
"8777","5410國眾","110/07/14","宏遠-中和",10,0,10
"8778","5410國眾","110/07/14","元大-員林",0,11,-11
"8779","5410國眾","110/07/14","新光-桃園",10,0,10
"8780","5410國眾","110/07/14","高橋",0,10,-10
"8781","5410國眾","110/07/14","國泰-台南",10,0,10
"8782","5410國眾","110/07/14","永興",0,10,-10
"8783","5410國眾","110/07/14","元大-復北",10,0,10
"8784","5410國眾","110/07/14","華南永昌-三重",0,10,-10
"8785","5410國眾","110/07/14","元大-竹科",8,0,8
"8786","5410國眾","110/07/14","元大-苑裡",0,7,-7
"8787","5410國眾","110/07/14","台新-新營",6,0,6
"8788","5410國眾","110/07/14","港商野村",0,6,-6
"8789","5410國眾","110/07/14","日盛-士林",5,0,5
"8790","5410國眾","110/07/14","摩根大通",5,11,-6
"8791","2841台開","110/07/14","凱基-文心",73,0,73
"8792","2841台開","110/07/14","國泰-敦南",0,50,-50
"8793","2841台開","110/07/14","元富-潮州",30,0,30
"8794","2841台開","110/07/14","凱基-中壢",0,40,-40
"8795","2841台開","110/07/14","第一金-台中",20,0,20
"8796","2841台開","110/07/14","統一-新竹",0,24,-24
"8797","2841台開","110/07/14","華南永昌-新莊",20,0,20
"8798","2841台開","110/07/14","元富-草屯",0,20,-20
"8799","2841台開","110/07/14","永豐金-豐原",20,0,20
"8800","2841台開","110/07/14","台新-台南",0,20,-20
"8801","2841台開","110/07/14","國泰-館前",15,0,15
"8802","2841台開","110/07/14","永豐金-敦南",45,63,-18
"8803","2841台開","110/07/14","群益金鼎-基隆",12,0,12
"8804","2841台開","110/07/14","國票-北高雄",0,13,-13
"8805","2841台開","110/07/14","日盛-信義",10,0,10
"8806","2841台開","110/07/14","凱基-松山",0,10,-10
"8807","2841台開","110/07/14","台新-台中",10,0,10
"8808","2841台開","110/07/14","元大證券",0,10,-10
"8809","2841台開","110/07/14","新光",10,1,9
"8810","2841台開","110/07/14","元大-中壢",0,10,-10
"8811","2841台開","110/07/14","凱基-新店",8,0,8
"8812","2841台開","110/07/14","富邦-陽明",1,10,-9
"8813","2841台開","110/07/14","元大-斗信",7,0,7
"8814","2841台開","110/07/14","富邦-建國",0,9,-9
"8815","2841台開","110/07/14","元大-三重",6,0,6
"8816","2841台開","110/07/14","富邦-台南",0,8,-8
"8817","2841台開","110/07/14","永豐金-中和",6,0,6
"8818","2841台開","110/07/14","康和-澎湖",0,7,-7
"8819","2841台開","110/07/14","元富-成功",5,0,5
"8820","2841台開","110/07/14","日盛-斗六",0,6,-6
"8821","6207雷科","110/07/14","群益金鼎-台北",60,0,60
"8822","6207雷科","110/07/14","新加坡商瑞銀",10,56,-46
"8823","6207雷科","110/07/14","台新-高雄",43,3,40
"8824","6207雷科","110/07/14","國票-中和",0,41,-41
"8825","6207雷科","110/07/14","元大-高雄",19,0,19
"8826","6207雷科","110/07/14","元大-復北",0,33,-33
"8827","6207雷科","110/07/14","福勝",15,0,15
"8828","6207雷科","110/07/14","光和-和美",0,20,-20
"8829","6207雷科","110/07/14","群益金鼎-中山",15,0,15
"8830","6207雷科","110/07/14","群益金鼎-丹鳳",0,20,-20
"8831","6207雷科","110/07/14","元大-林園",15,0,15
"8832","6207雷科","110/07/14","第一金-路竹",0,10,-10
"8833","6207雷科","110/07/14","新光",12,0,12
"8834","6207雷科","110/07/14","元大-歸仁",0,10,-10
"8835","6207雷科","110/07/14","元大-大天母",10,0,10
"8836","6207雷科","110/07/14","宏遠-館前",0,9,-9
"8837","6207雷科","110/07/14","永豐金-忠孝",9,0,9
"8838","6207雷科","110/07/14","凱基-台北",12,20,-8
"8839","6207雷科","110/07/14","永豐金-新店",7,0,7
"8840","6207雷科","110/07/14","美林",0,7,-7
"8841","6207雷科","110/07/14","玉山-嘉義",6,0,6
"8842","6207雷科","110/07/14","摩根大通",16,23,-7
"8843","6207雷科","110/07/14","元大-屏東",6,0,6
"8844","6207雷科","110/07/14","凱基-高雄",1,7,-6
"8845","6207雷科","110/07/14","凱基-大安",5,0,5
"8846","6207雷科","110/07/14","台中銀-豐原",0,5,-5
"8847","6207雷科","110/07/14","富邦-台南",5,0,5
"8848","6207雷科","110/07/14","元大-新竹經國",0,5,-5
"8849","6207雷科","110/07/14","元大-成功",5,0,5
"8850","6207雷科","110/07/14","光和-田中",0,4,-4
"8851","3679新至陞","110/07/14","凱基-台北",31,6,25
"8852","3679新至陞","110/07/14","群益金鼎-東大",0,15,-15
"8853","3679新至陞","110/07/14","華南永昌-新莊",10,0,10
"8854","3679新至陞","110/07/14","瑞士信貸",0,12,-12
"8855","3679新至陞","110/07/14","新加坡商瑞銀",11,3,8
"8856","3679新至陞","110/07/14","群益金鼎-永和",0,10,-10
"8857","3679新至陞","110/07/14","美商高盛",6,0,6
"8858","3679新至陞","110/07/14","元大-成功",5,15,-10
"8859","3679新至陞","110/07/14","第一金-中壢",6,0,6
"8860","3679新至陞","110/07/14","統一-板橋",1,10,-9
"8861","3679新至陞","110/07/14","(牛牛牛)亞-網路",4,0,4
"8862","3679新至陞","110/07/14","玉山-左營",0,5,-5
"8863","3679新至陞","110/07/14","元大-六合",3,0,3
"8864","3679新至陞","110/07/14","群益金鼎-三民",0,4,-4
"8865","3679新至陞","110/07/14","合庫-自強",2,0,2
"8866","3679新至陞","110/07/14","富邦-宜蘭",0,4,-4
"8867","3679新至陞","110/07/14","高橋-內壢",2,0,2
"8868","3679新至陞","110/07/14","永豐金-苓雅",0,3,-3
"8869","3679新至陞","110/07/14","台中銀-員林",2,0,2
"8870","3679新至陞","110/07/14","摩根大通",5,7,-2
"8871","3679新至陞","110/07/14","凱基-高美館",2,0,2
"8872","3679新至陞","110/07/14","元大-板橋三民",0,2,-2
"8873","3679新至陞","110/07/14","元大-福營",2,0,2
"8874","3679新至陞","110/07/14","宏遠-中和",0,1,-1
"8875","3679新至陞","110/07/14","永豐金-松山",2,0,2
"8876","3679新至陞","110/07/14","元富-佳里",0,1,-1
"8877","3679新至陞","110/07/14","永豐金-萬盛",2,0,2
"8878","3679新至陞","110/07/14","(牛牛牛)亞-鑫豐",0,1,-1
"8879","3679新至陞","110/07/14","元富-松德",1,0,1
"8880","3679新至陞","110/07/14","中國信託-中壢",0,1,-1
"8881","2727王品","110/07/14","富邦-左營",102,1,101
"8882","2727王品","110/07/14","統一-城中",100,234,-134
"8883","2727王品","110/07/14","國泰-板橋",105,11,94
"8884","2727王品","110/07/14","富邦-台北",1,125,-124
"8885","2727王品","110/07/14","港商野村",149,72,77
"8886","2727王品","110/07/14","台灣摩根士丹利",1,48,-47
"8887","2727王品","110/07/14","合庫-台中",66,2,64
"8888","2727王品","110/07/14","國票-新莊",0,40,-40
"8889","2727王品","110/07/14","臺銀-金山",63,8,55
"8890","2727王品","110/07/14","永豐金-忠孝",2,39,-37
"8891","2727王品","110/07/14","摩根大通",83,39,44
"8892","2727王品","110/07/14","富邦-彰化",1,34,-33
"8893","2727王品","110/07/14","凱基-台北",84,42,42
"8894","2727王品","110/07/14","康和-高雄",0,30,-30
"8895","2727王品","110/07/14","土銀-台中",35,1,34
"8896","2727王品","110/07/14","安泰",0,26,-26
"8897","2727王品","110/07/14","華南永昌-麻豆",32,1,31
"8898","2727王品","110/07/14","富邦-新竹華信",0,21,-21
"8899","2727王品","110/07/14","元大證券",85,55,30
"8900","2727王品","110/07/14","元大-南崁",1,22,-21
"8901","2727王品","110/07/14","新加坡商瑞銀",40,15,25
"8902","2727王品","110/07/14","彰銀-台中",0,18,-18
"8903","2727王品","110/07/14","日盛-八德",19,0,19
"8904","2727王品","110/07/14","元富-同大",2,20,-18
"8905","2727王品","110/07/14","統一",35,17,18
"8906","2727王品","110/07/14","玉山-嘉義",1,17,-16
"8907","2727王品","110/07/14","元富-大昌",18,1,17
"8908","2727王品","110/07/14","國泰-館前",4,20,-16
"8909","2727王品","110/07/14","玉山-板橋",15,1,14
"8910","2727王品","110/07/14","第一金-嘉義",1,13,-12
"8911","1570力肯","110/07/14","國票-北高雄",68,0,68
"8912","1570力肯","110/07/14","摩根大通",0,21,-21
"8913","1570力肯","110/07/14","日盛-八德",30,1,29
"8914","1570力肯","110/07/14","新光",1,19,-18
"8915","1570力肯","110/07/14","玉山-高雄",7,0,7
"8916","1570力肯","110/07/14","(牛牛牛)亞-鑫豐",0,17,-17
"8917","1570力肯","110/07/14","臺銀-臺南",5,0,5
"8918","1570力肯","110/07/14","日盛-士林",0,10,-10
"8919","1570力肯","110/07/14","凱基-三峽",5,0,5
"8920","1570力肯","110/07/14","統一-員林",0,10,-10
"8921","1570力肯","110/07/14","元大-和平",5,0,5
"8922","1570力肯","110/07/14","國票-新莊",0,10,-10
"8923","1570力肯","110/07/14","合庫-三重",4,0,4
"8924","1570力肯","110/07/14","凱基-高美館",0,10,-10
"8925","1570力肯","110/07/14","瑞士信貸",4,0,4
"8926","1570力肯","110/07/14","元大-屏東民生",0,5,-5
"8927","1570力肯","110/07/14","統一-三多",4,0,4
"8928","1570力肯","110/07/14","元大-古亭",0,5,-5
"8929","1570力肯","110/07/14","華南永昌-古亭",4,0,4
"8930","1570力肯","110/07/14","日盛-木柵",0,4,-4
"8931","1570力肯","110/07/14","元大-高雄",3,0,3
"8932","1570力肯","110/07/14","大昌",0,4,-4
"8933","1570力肯","110/07/14","兆豐-忠孝",2,0,2
"8934","1570力肯","110/07/14","群益金鼎-東大",0,4,-4
"8935","1570力肯","110/07/14","富邦-陽明",2,0,2
"8936","1570力肯","110/07/14","凱基-台北",0,4,-4
"8937","1570力肯","110/07/14","元大-松山",2,0,2
"8938","1570力肯","110/07/14","元大-板橋",0,4,-4
"8939","1570力肯","110/07/14","元大-忠孝",2,0,2
"8940","1570力肯","110/07/14","第一金-中山",0,3,-3
"8941","6180橘子","110/07/14","新加坡商瑞銀",84,28,56
"8942","6180橘子","110/07/14","凱基-台北",4,37,-33
"8943","6180橘子","110/07/14","日盛-信義",29,1,28
"8944","6180橘子","110/07/14","玉山-台南",1,22,-21
"8945","6180橘子","110/07/14","豐農",28,4,24
"8946","6180橘子","110/07/14","日盛-新竹",1,21,-20
"8947","6180橘子","110/07/14","新光-新竹",24,1,23
"8948","6180橘子","110/07/14","元富-潮州",0,19,-19
"8949","6180橘子","110/07/14","華南永昌-高雄",20,0,20
"8950","6180橘子","110/07/14","元大-信義",0,17,-17
"8951","6180橘子","110/07/14","元大-羅東",20,0,20
"8952","6180橘子","110/07/14","台灣企銀-台中",1,16,-15
"8953","6180橘子","110/07/14","元大-台中中港",20,0,20
"8954","6180橘子","110/07/14","元大-北港",0,15,-15
"8955","6180橘子","110/07/14","富邦-嘉義",24,5,19
"8956","6180橘子","110/07/14","富邦-高雄",0,14,-14
"8957","6180橘子","110/07/14","富邦-仁愛",15,0,15
"8958","6180橘子","110/07/14","兆豐-埔墘",0,13,-13
"8959","6180橘子","110/07/14","國票-九鼎",13,0,13
"8960","6180橘子","110/07/14","第一金-中山",0,10,-10
"8961","6180橘子","110/07/14","日盛-木柵",12,0,12
"8962","6180橘子","110/07/14","元大-彰化民生",0,10,-10
"8963","6180橘子","110/07/14","元大-成功",10,0,10
"8964","6180橘子","110/07/14","福勝",1,10,-9
"8965","6180橘子","110/07/14","港商野村",10,2,8
"8966","6180橘子","110/07/14","群益金鼎-丹鳳",1,10,-9
"8967","6180橘子","110/07/14","玉山-左營",8,0,8
"8968","6180橘子","110/07/14","群益金鼎-板橋",0,8,-8
"8969","6180橘子","110/07/14","富邦-陽明",16,8,8
"8970","6180橘子","110/07/14","合庫-鳳山",0,7,-7
"8971","2390云辰","110/07/14","摩根大通",995,198,797
"8972","2390云辰","110/07/14","新加坡商瑞銀",28,399,-371
"8973","2390云辰","110/07/14","美林",383,22,361
"8974","2390云辰","110/07/14","凱基-新豐",3,198,-195
"8975","2390云辰","110/07/14","台灣摩根士丹利",684,358,326
"8976","2390云辰","110/07/14","元大-士林",1,152,-151
"8977","2390云辰","110/07/14","凱基-台北",656,402,254
"8978","2390云辰","110/07/14","元大-竹山",80,181,-101
"8979","2390云辰","110/07/14","日盛-和美",110,5,105
"8980","2390云辰","110/07/14","群益金鼎-開元",19,95,-76
"8981","2390云辰","110/07/14","元大-天母",72,0,72
"8982","2390云辰","110/07/14","新光",77,150,-73
"8983","2390云辰","110/07/14","永豐金-松山",57,0,57
"8984","2390云辰","110/07/14","元富-高雄",0,71,-71
"8985","2390云辰","110/07/14","統一-屏東",53,0,53
"8986","2390云辰","110/07/14","元大-土城學府",130,201,-71
"8987","2390云辰","110/07/14","港商野村",486,450,36
"8988","2390云辰","110/07/14","元大-善化",12,76,-64
"8989","2390云辰","110/07/14","致和-崇德",30,0,30
"8990","2390云辰","110/07/14","華南永昌-岡山",23,81,-58
"8991","2390云辰","110/07/14","富邦-台北",40,14,26
"8992","2390云辰","110/07/14","群益金鼎-大興",82,125,-43
"8993","2390云辰","110/07/14","台新-高雄",38,13,25
"8994","2390云辰","110/07/14","大慶-中壢",0,41,-41
"8995","2390云辰","110/07/14","富邦-板橋",32,7,25
"8996","2390云辰","110/07/14","玉山-板橋",6,47,-41
"8997","2390云辰","110/07/14","陽信-石牌",24,0,24
"8998","2390云辰","110/07/14","富邦-台東",2,42,-40
"8999","2390云辰","110/07/14","凱基-屏東",32,8,24
"9000","2390云辰","110/07/14","元大-新營",3,42,-39
"9001","2363矽統","110/07/14","台灣摩根士丹利",463,0,463
"9002","2363矽統","110/07/14","新加坡商瑞銀",568,1321,-753
"9003","2363矽統","110/07/14","台新證券",750,342,408
"9004","2363矽統","110/07/14","瑞士信貸",149,864,-715
"9005","2363矽統","110/07/14","玉山-台中",363,51,312
"9006","2363矽統","110/07/14","台新-屏東",115,380,-265
"9007","2363矽統","110/07/14","元大-斗六",223,25,198
"9008","2363矽統","110/07/14","永豐金證券",16,265,-249
"9009","2363矽統","110/07/14","華南永昌-朴子",208,38,170
"9010","2363矽統","110/07/14","美林",462,701,-239
"9011","2363矽統","110/07/14","元富-西松",169,12,157
"9012","2363矽統","110/07/14","宏遠-桃園",269,500,-231
"9013","2363矽統","110/07/14","永豐金-大園",146,6,140
"9014","2363矽統","110/07/14","凱基-竹北",36,254,-218
"9015","2363矽統","110/07/14","土銀-和平",134,0,134
"9016","2363矽統","110/07/14","港商法國興業",0,214,-214
"9017","2363矽統","110/07/14","富邦-新營",130,13,117
"9018","2363矽統","110/07/14","港商野村",835,1044,-209
"9019","2363矽統","110/07/14","元富-成功",118,11,107
"9020","2363矽統","110/07/14","北城證券",212,411,-199
"9021","2363矽統","110/07/14","元富-烏日",121,18,103
"9022","2363矽統","110/07/14","(牛牛牛)亞-鑫豐",51,241,-190
"9023","2363矽統","110/07/14","日盛-二林",120,18,102
"9024","2363矽統","110/07/14","國票-博愛",24,213,-189
"9025","2363矽統","110/07/14","兆豐-忠孝",98,2,96
"9026","2363矽統","110/07/14","大慶-蘆洲",134,316,-182
"9027","2363矽統","110/07/14","大慶-楊梅",92,3,89
"9028","2363矽統","110/07/14","彰銀-台中",15,193,-178
"9029","2363矽統","110/07/14","元富-三重",120,33,87
"9030","2363矽統","110/07/14","日盛-和美",18,185,-167
"9031","8112至上","110/07/14","新加坡商瑞銀",223,17,206
"9032","8112至上","110/07/14","瑞士信貸",8,170,-162
"9033","8112至上","110/07/14","摩根大通",285,129,156
"9034","8112至上","110/07/14","美林",55,202,-147
"9035","8112至上","110/07/14","花旗環球",124,0,124
"9036","8112至上","110/07/14","凱基-台北",325,436,-111
"9037","8112至上","110/07/14","兆豐-公益",117,4,113
"9038","8112至上","110/07/14","台中銀-台北",0,98,-98
"9039","8112至上","110/07/14","香港上海匯豐",111,0,111
"9040","8112至上","110/07/14","玉山-台大",17,107,-90
"9041","8112至上","110/07/14","永豐金-內湖",117,21,96
"9042","8112至上","110/07/14","康和-內湖",1,90,-89
"9043","8112至上","110/07/14","台灣摩根士丹利",108,16,92
"9044","8112至上","110/07/14","港商野村",21,84,-63
"9045","8112至上","110/07/14","元大-東蘆",77,0,77
"9046","8112至上","110/07/14","兆豐-北高雄",1,60,-59
"9047","8112至上","110/07/14","新光",108,48,60
"9048","8112至上","110/07/14","群益金鼎-海山",1,52,-51
"9049","8112至上","110/07/14","大慶-蘆洲",59,0,59
"9050","8112至上","110/07/14","群益金鼎-大安",0,50,-50
"9051","8112至上","110/07/14","華南永昌-台中",56,3,53
"9052","8112至上","110/07/14","富邦-仁愛",2,49,-47
"9053","8112至上","110/07/14","土銀-嘉義",52,2,50
"9054","8112至上","110/07/14","元大-金華",0,42,-42
"9055","8112至上","110/07/14","美商高盛",40,0,40
"9056","8112至上","110/07/14","元大-內湖",4,43,-39
"9057","8112至上","110/07/14","臺銀",63,29,34
"9058","8112至上","110/07/14","第一金-華江",2,37,-35
"9059","8112至上","110/07/14","元富-嘉義",31,0,31
"9060","8112至上","110/07/14","永豐金-苓雅",2,34,-32
"9061","1570力肯","110/07/14","國票-北高雄",68,0,68
"9062","1570力肯","110/07/14","摩根大通",0,21,-21
"9063","1570力肯","110/07/14","日盛-八德",30,1,29
"9064","1570力肯","110/07/14","新光",1,19,-18
"9065","1570力肯","110/07/14","玉山-高雄",7,0,7
"9066","1570力肯","110/07/14","(牛牛牛)亞-鑫豐",0,17,-17
"9067","1570力肯","110/07/14","臺銀-臺南",5,0,5
"9068","1570力肯","110/07/14","日盛-士林",0,10,-10
"9069","1570力肯","110/07/14","凱基-三峽",5,0,5
"9070","1570力肯","110/07/14","統一-員林",0,10,-10
"9071","1570力肯","110/07/14","元大-和平",5,0,5
"9072","1570力肯","110/07/14","國票-新莊",0,10,-10
"9073","1570力肯","110/07/14","合庫-三重",4,0,4
"9074","1570力肯","110/07/14","凱基-高美館",0,10,-10
"9075","1570力肯","110/07/14","瑞士信貸",4,0,4
"9076","1570力肯","110/07/14","元大-屏東民生",0,5,-5
"9077","1570力肯","110/07/14","統一-三多",4,0,4
"9078","1570力肯","110/07/14","元大-古亭",0,5,-5
"9079","1570力肯","110/07/14","華南永昌-古亭",4,0,4
"9080","1570力肯","110/07/14","日盛-木柵",0,4,-4
"9081","1570力肯","110/07/14","元大-高雄",3,0,3
"9082","1570力肯","110/07/14","大昌",0,4,-4
"9083","1570力肯","110/07/14","兆豐-忠孝",2,0,2
"9084","1570力肯","110/07/14","群益金鼎-東大",0,4,-4
"9085","1570力肯","110/07/14","富邦-陽明",2,0,2
"9086","1570力肯","110/07/14","凱基-台北",0,4,-4
"9087","1570力肯","110/07/14","元大-松山",2,0,2
"9088","1570力肯","110/07/14","元大-板橋",0,4,-4
"9089","1570力肯","110/07/14","元大-忠孝",2,0,2
"9090","1570力肯","110/07/14","第一金-中山",0,3,-3
"9091","2929淘帝","110/07/14","華南永昌-林口",60,0,60
"9092","2929淘帝","110/07/14","群益金鼎",25,540,-515
"9093","2929淘帝","110/07/14","美林",87,31,56
"9094","2929淘帝","110/07/14","國泰-台南",1,30,-29
"9095","2929淘帝","110/07/14","元富-台南",40,0,40
"9096","2929淘帝","110/07/14","宏遠-桃園",0,20,-20
"9097","2929淘帝","110/07/14","元大-民生",39,0,39
"9098","2929淘帝","110/07/14","摩根大通",11,31,-20
"9099","2929淘帝","110/07/14","臺銀-鳳山",34,0,34
"9100","2929淘帝","110/07/14","台新-建北",5,20,-15
"9101","2929淘帝","110/07/14","合庫-高雄",34,1,33
"9102","2929淘帝","110/07/14","新光",1,16,-15
"9103","2929淘帝","110/07/14","華南永昌-鶯歌",28,0,28
"9104","2929淘帝","110/07/14","玉山-板橋",0,15,-15
"9105","2929淘帝","110/07/14","永興",25,0,25
"9106","2929淘帝","110/07/14","凱基-羅東",0,15,-15
"9107","2929淘帝","110/07/14","元大-新盛",25,1,24
"9108","2929淘帝","110/07/14","元大-頭份",0,15,-15
"9109","2929淘帝","110/07/14","日盛-南京",23,0,23
"9110","2929淘帝","110/07/14","第一金-台南",0,13,-13
"9111","2929淘帝","110/07/14","日茂",20,0,20
"9112","2929淘帝","110/07/14","富邦-基隆",0,12,-12
"9113","2929淘帝","110/07/14","台新-台中",20,0,20
"9114","2929淘帝","110/07/14","日茂-南投",1,12,-11
"9115","2929淘帝","110/07/14","華南永昌",20,0,20
"9116","2929淘帝","110/07/14","元大-豐原站前",0,11,-11
"9117","2929淘帝","110/07/14","福勝",15,0,15
"9118","2929淘帝","110/07/14","玉山-士林",0,10,-10
"9119","2929淘帝","110/07/14","富邦-南屯",15,0,15
"9120","2929淘帝","110/07/14","富邦-台北",0,10,-10
"9121","5410國眾","110/07/14","兆豐-城中",35,0,35
"9122","5410國眾","110/07/14","瑞士信貸",0,29,-29
"9123","5410國眾","110/07/14","新光",21,1,20
"9124","5410國眾","110/07/14","國泰-板橋",1,30,-29
"9125","5410國眾","110/07/14","國泰-敦南",21,1,20
"9126","5410國眾","110/07/14","日盛-高雄",0,20,-20
"9127","5410國眾","110/07/14","國泰-台中",20,1,19
"9128","5410國眾","110/07/14","台新-左楠",1,20,-19
"9129","5410國眾","110/07/14","元大-崇德",19,0,19
"9130","5410國眾","110/07/14","元富-大昌",1,18,-17
"9131","5410國眾","110/07/14","土銀-士林",18,0,18
"9132","5410國眾","110/07/14","富邦-建國",0,15,-15
"9133","5410國眾","110/07/14","元大-新盛",20,2,18
"9134","5410國眾","110/07/14","元富-嘉義",0,12,-12
"9135","5410國眾","110/07/14","兆豐-高雄",15,0,15
"9136","5410國眾","110/07/14","永全-南崁",0,12,-12
"9137","5410國眾","110/07/14","宏遠-中和",10,0,10
"9138","5410國眾","110/07/14","元大-員林",0,11,-11
"9139","5410國眾","110/07/14","新光-桃園",10,0,10
"9140","5410國眾","110/07/14","高橋",0,10,-10
"9141","5410國眾","110/07/14","國泰-台南",10,0,10
"9142","5410國眾","110/07/14","永興",0,10,-10
"9143","5410國眾","110/07/14","元大-復北",10,0,10
"9144","5410國眾","110/07/14","華南永昌-三重",0,10,-10
"9145","5410國眾","110/07/14","元大-竹科",8,0,8
"9146","5410國眾","110/07/14","元大-苑裡",0,7,-7
"9147","5410國眾","110/07/14","台新-新營",6,0,6
"9148","5410國眾","110/07/14","港商野村",0,6,-6
"9149","5410國眾","110/07/14","日盛-士林",5,0,5
"9150","5410國眾","110/07/14","摩根大通",5,11,-6
"9151","2841台開","110/07/14","凱基-文心",73,0,73
"9152","2841台開","110/07/14","國泰-敦南",0,50,-50
"9153","2841台開","110/07/14","元富-潮州",30,0,30
"9154","2841台開","110/07/14","凱基-中壢",0,40,-40
"9155","2841台開","110/07/14","第一金-台中",20,0,20
"9156","2841台開","110/07/14","統一-新竹",0,24,-24
"9157","2841台開","110/07/14","華南永昌-新莊",20,0,20
"9158","2841台開","110/07/14","元富-草屯",0,20,-20
"9159","2841台開","110/07/14","永豐金-豐原",20,0,20
"9160","2841台開","110/07/14","台新-台南",0,20,-20
"9161","2841台開","110/07/14","國泰-館前",15,0,15
"9162","2841台開","110/07/14","永豐金-敦南",45,63,-18
"9163","2841台開","110/07/14","群益金鼎-基隆",12,0,12
"9164","2841台開","110/07/14","國票-北高雄",0,13,-13
"9165","2841台開","110/07/14","日盛-信義",10,0,10
"9166","2841台開","110/07/14","凱基-松山",0,10,-10
"9167","2841台開","110/07/14","台新-台中",10,0,10
"9168","2841台開","110/07/14","元大證券",0,10,-10
"9169","2841台開","110/07/14","新光",10,1,9
"9170","2841台開","110/07/14","元大-中壢",0,10,-10
"9171","2841台開","110/07/14","凱基-新店",8,0,8
"9172","2841台開","110/07/14","富邦-陽明",1,10,-9
"9173","2841台開","110/07/14","元大-斗信",7,0,7
"9174","2841台開","110/07/14","富邦-建國",0,9,-9
"9175","2841台開","110/07/14","元大-三重",6,0,6
"9176","2841台開","110/07/14","富邦-台南",0,8,-8
"9177","2841台開","110/07/14","永豐金-中和",6,0,6
"9178","2841台開","110/07/14","康和-澎湖",0,7,-7
"9179","2841台開","110/07/14","元富-成功",5,0,5
"9180","2841台開","110/07/14","日盛-斗六",0,6,-6
"9181","6207雷科","110/07/14","群益金鼎-台北",60,0,60
"9182","6207雷科","110/07/14","新加坡商瑞銀",10,56,-46
"9183","6207雷科","110/07/14","台新-高雄",43,3,40
"9184","6207雷科","110/07/14","國票-中和",0,41,-41
"9185","6207雷科","110/07/14","元大-高雄",19,0,19
"9186","6207雷科","110/07/14","元大-復北",0,33,-33
"9187","6207雷科","110/07/14","福勝",15,0,15
"9188","6207雷科","110/07/14","光和-和美",0,20,-20
"9189","6207雷科","110/07/14","群益金鼎-中山",15,0,15
"9190","6207雷科","110/07/14","群益金鼎-丹鳳",0,20,-20
"9191","6207雷科","110/07/14","元大-林園",15,0,15
"9192","6207雷科","110/07/14","第一金-路竹",0,10,-10
"9193","6207雷科","110/07/14","新光",12,0,12
"9194","6207雷科","110/07/14","元大-歸仁",0,10,-10
"9195","6207雷科","110/07/14","元大-大天母",10,0,10
"9196","6207雷科","110/07/14","宏遠-館前",0,9,-9
"9197","6207雷科","110/07/14","永豐金-忠孝",9,0,9
"9198","6207雷科","110/07/14","凱基-台北",12,20,-8
"9199","6207雷科","110/07/14","永豐金-新店",7,0,7
"9200","6207雷科","110/07/14","美林",0,7,-7
"9201","6207雷科","110/07/14","玉山-嘉義",6,0,6
"9202","6207雷科","110/07/14","摩根大通",16,23,-7
"9203","6207雷科","110/07/14","元大-屏東",6,0,6
"9204","6207雷科","110/07/14","凱基-高雄",1,7,-6
"9205","6207雷科","110/07/14","凱基-大安",5,0,5
"9206","6207雷科","110/07/14","台中銀-豐原",0,5,-5
"9207","6207雷科","110/07/14","富邦-台南",5,0,5
"9208","6207雷科","110/07/14","元大-新竹經國",0,5,-5
"9209","6207雷科","110/07/14","元大-成功",5,0,5
"9210","6207雷科","110/07/14","光和-田中",0,4,-4
"9211","3679新至陞","110/07/14","凱基-台北",31,6,25
"9212","3679新至陞","110/07/14","群益金鼎-東大",0,15,-15
"9213","3679新至陞","110/07/14","華南永昌-新莊",10,0,10
"9214","3679新至陞","110/07/14","瑞士信貸",0,12,-12
"9215","3679新至陞","110/07/14","新加坡商瑞銀",11,3,8
"9216","3679新至陞","110/07/14","群益金鼎-永和",0,10,-10
"9217","3679新至陞","110/07/14","美商高盛",6,0,6
"9218","3679新至陞","110/07/14","元大-成功",5,15,-10
"9219","3679新至陞","110/07/14","第一金-中壢",6,0,6
"9220","3679新至陞","110/07/14","統一-板橋",1,10,-9
"9221","3679新至陞","110/07/14","(牛牛牛)亞-網路",4,0,4
"9222","3679新至陞","110/07/14","玉山-左營",0,5,-5
"9223","3679新至陞","110/07/14","元大-六合",3,0,3
"9224","3679新至陞","110/07/14","群益金鼎-三民",0,4,-4
"9225","3679新至陞","110/07/14","合庫-自強",2,0,2
"9226","3679新至陞","110/07/14","富邦-宜蘭",0,4,-4
"9227","3679新至陞","110/07/14","高橋-內壢",2,0,2
"9228","3679新至陞","110/07/14","永豐金-苓雅",0,3,-3
"9229","3679新至陞","110/07/14","台中銀-員林",2,0,2
"9230","3679新至陞","110/07/14","摩根大通",5,7,-2
"9231","3679新至陞","110/07/14","凱基-高美館",2,0,2
"9232","3679新至陞","110/07/14","元大-板橋三民",0,2,-2
"9233","3679新至陞","110/07/14","元大-福營",2,0,2
"9234","3679新至陞","110/07/14","宏遠-中和",0,1,-1
"9235","3679新至陞","110/07/14","永豐金-松山",2,0,2
"9236","3679新至陞","110/07/14","元富-佳里",0,1,-1
"9237","3679新至陞","110/07/14","永豐金-萬盛",2,0,2
"9238","3679新至陞","110/07/14","(牛牛牛)亞-鑫豐",0,1,-1
"9239","3679新至陞","110/07/14","元富-松德",1,0,1
"9240","3679新至陞","110/07/14","中國信託-中壢",0,1,-1
"9241","2727王品","110/07/14","富邦-左營",102,1,101
"9242","2727王品","110/07/14","統一-城中",100,234,-134
"9243","2727王品","110/07/14","國泰-板橋",105,11,94
"9244","2727王品","110/07/14","富邦-台北",1,125,-124
"9245","2727王品","110/07/14","港商野村",149,72,77
"9246","2727王品","110/07/14","台灣摩根士丹利",1,48,-47
"9247","2727王品","110/07/14","合庫-台中",66,2,64
"9248","2727王品","110/07/14","國票-新莊",0,40,-40
"9249","2727王品","110/07/14","臺銀-金山",63,8,55
"9250","2727王品","110/07/14","永豐金-忠孝",2,39,-37
"9251","2727王品","110/07/14","摩根大通",83,39,44
"9252","2727王品","110/07/14","富邦-彰化",1,34,-33
"9253","2727王品","110/07/14","凱基-台北",84,42,42
"9254","2727王品","110/07/14","康和-高雄",0,30,-30
"9255","2727王品","110/07/14","土銀-台中",35,1,34
"9256","2727王品","110/07/14","安泰",0,26,-26
"9257","2727王品","110/07/14","華南永昌-麻豆",32,1,31
"9258","2727王品","110/07/14","富邦-新竹華信",0,21,-21
"9259","2727王品","110/07/14","元大證券",85,55,30
"9260","2727王品","110/07/14","元大-南崁",1,22,-21
"9261","2727王品","110/07/14","新加坡商瑞銀",40,15,25
"9262","2727王品","110/07/14","彰銀-台中",0,18,-18
"9263","2727王品","110/07/14","日盛-八德",19,0,19
"9264","2727王品","110/07/14","元富-同大",2,20,-18
"9265","2727王品","110/07/14","統一",35,17,18
"9266","2727王品","110/07/14","玉山-嘉義",1,17,-16
"9267","2727王品","110/07/14","元富-大昌",18,1,17
"9268","2727王品","110/07/14","國泰-館前",4,20,-16
"9269","2727王品","110/07/14","玉山-板橋",15,1,14
"9270","2727王品","110/07/14","第一金-嘉義",1,13,-12
"9271","1570力肯","110/07/14","國票-北高雄",68,0,68
"9272","1570力肯","110/07/14","摩根大通",0,21,-21
"9273","1570力肯","110/07/14","日盛-八德",30,1,29
"9274","1570力肯","110/07/14","新光",1,19,-18
"9275","1570力肯","110/07/14","玉山-高雄",7,0,7
"9276","1570力肯","110/07/14","(牛牛牛)亞-鑫豐",0,17,-17
"9277","1570力肯","110/07/14","臺銀-臺南",5,0,5
"9278","1570力肯","110/07/14","日盛-士林",0,10,-10
"9279","1570力肯","110/07/14","凱基-三峽",5,0,5
"9280","1570力肯","110/07/14","統一-員林",0,10,-10
"9281","1570力肯","110/07/14","元大-和平",5,0,5
"9282","1570力肯","110/07/14","國票-新莊",0,10,-10
"9283","1570力肯","110/07/14","合庫-三重",4,0,4
"9284","1570力肯","110/07/14","凱基-高美館",0,10,-10
"9285","1570力肯","110/07/14","瑞士信貸",4,0,4
"9286","1570力肯","110/07/14","元大-屏東民生",0,5,-5
"9287","1570力肯","110/07/14","統一-三多",4,0,4
"9288","1570力肯","110/07/14","元大-古亭",0,5,-5
"9289","1570力肯","110/07/14","華南永昌-古亭",4,0,4
"9290","1570力肯","110/07/14","日盛-木柵",0,4,-4
"9291","1570力肯","110/07/14","元大-高雄",3,0,3
"9292","1570力肯","110/07/14","大昌",0,4,-4
"9293","1570力肯","110/07/14","兆豐-忠孝",2,0,2
"9294","1570力肯","110/07/14","群益金鼎-東大",0,4,-4
"9295","1570力肯","110/07/14","富邦-陽明",2,0,2
"9296","1570力肯","110/07/14","凱基-台北",0,4,-4
"9297","1570力肯","110/07/14","元大-松山",2,0,2
"9298","1570力肯","110/07/14","元大-板橋",0,4,-4
"9299","1570力肯","110/07/14","元大-忠孝",2,0,2
"9300","1570力肯","110/07/14","第一金-中山",0,3,-3
"9301","6180橘子","110/07/14","新加坡商瑞銀",84,28,56
"9302","6180橘子","110/07/14","凱基-台北",4,37,-33
"9303","6180橘子","110/07/14","日盛-信義",29,1,28
"9304","6180橘子","110/07/14","玉山-台南",1,22,-21
"9305","6180橘子","110/07/14","豐農",28,4,24
"9306","6180橘子","110/07/14","日盛-新竹",1,21,-20
"9307","6180橘子","110/07/14","新光-新竹",24,1,23
"9308","6180橘子","110/07/14","元富-潮州",0,19,-19
"9309","6180橘子","110/07/14","華南永昌-高雄",20,0,20
"9310","6180橘子","110/07/14","元大-信義",0,17,-17
"9311","6180橘子","110/07/14","元大-羅東",20,0,20
"9312","6180橘子","110/07/14","台灣企銀-台中",1,16,-15
"9313","6180橘子","110/07/14","元大-台中中港",20,0,20
"9314","6180橘子","110/07/14","元大-北港",0,15,-15
"9315","6180橘子","110/07/14","富邦-嘉義",24,5,19
"9316","6180橘子","110/07/14","富邦-高雄",0,14,-14
"9317","6180橘子","110/07/14","富邦-仁愛",15,0,15
"9318","6180橘子","110/07/14","兆豐-埔墘",0,13,-13
"9319","6180橘子","110/07/14","國票-九鼎",13,0,13
"9320","6180橘子","110/07/14","第一金-中山",0,10,-10
"9321","6180橘子","110/07/14","日盛-木柵",12,0,12
"9322","6180橘子","110/07/14","元大-彰化民生",0,10,-10
"9323","6180橘子","110/07/14","元大-成功",10,0,10
"9324","6180橘子","110/07/14","福勝",1,10,-9
"9325","6180橘子","110/07/14","港商野村",10,2,8
"9326","6180橘子","110/07/14","群益金鼎-丹鳳",1,10,-9
"9327","6180橘子","110/07/14","玉山-左營",8,0,8
"9328","6180橘子","110/07/14","群益金鼎-板橋",0,8,-8
"9329","6180橘子","110/07/14","富邦-陽明",16,8,8
"9330","6180橘子","110/07/14","合庫-鳳山",0,7,-7
"9331","2390云辰","110/07/14","摩根大通",995,198,797
"9332","2390云辰","110/07/14","新加坡商瑞銀",28,399,-371
"9333","2390云辰","110/07/14","美林",383,22,361
"9334","2390云辰","110/07/14","凱基-新豐",3,198,-195
"9335","2390云辰","110/07/14","台灣摩根士丹利",684,358,326
"9336","2390云辰","110/07/14","元大-士林",1,152,-151
"9337","2390云辰","110/07/14","凱基-台北",656,402,254
"9338","2390云辰","110/07/14","元大-竹山",80,181,-101
"9339","2390云辰","110/07/14","日盛-和美",110,5,105
"9340","2390云辰","110/07/14","群益金鼎-開元",19,95,-76
"9341","2390云辰","110/07/14","元大-天母",72,0,72
"9342","2390云辰","110/07/14","新光",77,150,-73
"9343","2390云辰","110/07/14","永豐金-松山",57,0,57
"9344","2390云辰","110/07/14","元富-高雄",0,71,-71
"9345","2390云辰","110/07/14","統一-屏東",53,0,53
"9346","2390云辰","110/07/14","元大-土城學府",130,201,-71
"9347","2390云辰","110/07/14","港商野村",486,450,36
"9348","2390云辰","110/07/14","元大-善化",12,76,-64
"9349","2390云辰","110/07/14","致和-崇德",30,0,30
"9350","2390云辰","110/07/14","華南永昌-岡山",23,81,-58
"9351","2390云辰","110/07/14","富邦-台北",40,14,26
"9352","2390云辰","110/07/14","群益金鼎-大興",82,125,-43
"9353","2390云辰","110/07/14","台新-高雄",38,13,25
"9354","2390云辰","110/07/14","大慶-中壢",0,41,-41
"9355","2390云辰","110/07/14","富邦-板橋",32,7,25
"9356","2390云辰","110/07/14","玉山-板橋",6,47,-41
"9357","2390云辰","110/07/14","陽信-石牌",24,0,24
"9358","2390云辰","110/07/14","富邦-台東",2,42,-40
"9359","2390云辰","110/07/14","凱基-屏東",32,8,24
"9360","2390云辰","110/07/14","元大-新營",3,42,-39
"9361","2363矽統","110/07/14","台灣摩根士丹利",463,0,463
"9362","2363矽統","110/07/14","新加坡商瑞銀",568,1321,-753
"9363","2363矽統","110/07/14","台新證券",750,342,408
"9364","2363矽統","110/07/14","瑞士信貸",149,864,-715
"9365","2363矽統","110/07/14","玉山-台中",363,51,312
"9366","2363矽統","110/07/14","台新-屏東",115,380,-265
"9367","2363矽統","110/07/14","元大-斗六",223,25,198
"9368","2363矽統","110/07/14","永豐金證券",16,265,-249
"9369","2363矽統","110/07/14","華南永昌-朴子",208,38,170
"9370","2363矽統","110/07/14","美林",462,701,-239
"9371","2363矽統","110/07/14","元富-西松",169,12,157
"9372","2363矽統","110/07/14","宏遠-桃園",269,500,-231
"9373","2363矽統","110/07/14","永豐金-大園",146,6,140
"9374","2363矽統","110/07/14","凱基-竹北",36,254,-218
"9375","2363矽統","110/07/14","土銀-和平",134,0,134
"9376","2363矽統","110/07/14","港商法國興業",0,214,-214
"9377","2363矽統","110/07/14","富邦-新營",130,13,117
"9378","2363矽統","110/07/14","港商野村",835,1044,-209
"9379","2363矽統","110/07/14","元富-成功",118,11,107
"9380","2363矽統","110/07/14","北城證券",212,411,-199
"9381","2363矽統","110/07/14","元富-烏日",121,18,103
"9382","2363矽統","110/07/14","(牛牛牛)亞-鑫豐",51,241,-190
"9383","2363矽統","110/07/14","日盛-二林",120,18,102
"9384","2363矽統","110/07/14","國票-博愛",24,213,-189
"9385","2363矽統","110/07/14","兆豐-忠孝",98,2,96
"9386","2363矽統","110/07/14","大慶-蘆洲",134,316,-182
"9387","2363矽統","110/07/14","大慶-楊梅",92,3,89
"9388","2363矽統","110/07/14","彰銀-台中",15,193,-178
"9389","2363矽統","110/07/14","元富-三重",120,33,87
"9390","2363矽統","110/07/14","日盛-和美",18,185,-167
"9391","8112至上","110/07/14","新加坡商瑞銀",223,17,206
"9392","8112至上","110/07/14","瑞士信貸",8,170,-162
"9393","8112至上","110/07/14","摩根大通",285,129,156
"9394","8112至上","110/07/14","美林",55,202,-147
"9395","8112至上","110/07/14","花旗環球",124,0,124
"9396","8112至上","110/07/14","凱基-台北",325,436,-111
"9397","8112至上","110/07/14","兆豐-公益",117,4,113
"9398","8112至上","110/07/14","台中銀-台北",0,98,-98
"9399","8112至上","110/07/14","香港上海匯豐",111,0,111
"9400","8112至上","110/07/14","玉山-台大",17,107,-90
"9401","8112至上","110/07/14","永豐金-內湖",117,21,96
"9402","8112至上","110/07/14","康和-內湖",1,90,-89
"9403","8112至上","110/07/14","台灣摩根士丹利",108,16,92
"9404","8112至上","110/07/14","港商野村",21,84,-63
"9405","8112至上","110/07/14","元大-東蘆",77,0,77
"9406","8112至上","110/07/14","兆豐-北高雄",1,60,-59
"9407","8112至上","110/07/14","新光",108,48,60
"9408","8112至上","110/07/14","群益金鼎-海山",1,52,-51
"9409","8112至上","110/07/14","大慶-蘆洲",59,0,59
"9410","8112至上","110/07/14","群益金鼎-大安",0,50,-50
"9411","8112至上","110/07/14","華南永昌-台中",56,3,53
"9412","8112至上","110/07/14","富邦-仁愛",2,49,-47
"9413","8112至上","110/07/14","土銀-嘉義",52,2,50
"9414","8112至上","110/07/14","元大-金華",0,42,-42
"9415","8112至上","110/07/14","美商高盛",40,0,40
"9416","8112至上","110/07/14","元大-內湖",4,43,-39
"9417","8112至上","110/07/14","臺銀",63,29,34
"9418","8112至上","110/07/14","第一金-華江",2,37,-35
"9419","8112至上","110/07/14","元富-嘉義",31,0,31
"9420","8112至上","110/07/14","永豐金-苓雅",2,34,-32
"9421","1570力肯","110/07/14","國票-北高雄",68,0,68
"9422","1570力肯","110/07/14","摩根大通",0,21,-21
"9423","1570力肯","110/07/14","日盛-八德",30,1,29
"9424","1570力肯","110/07/14","新光",1,19,-18
"9425","1570力肯","110/07/14","玉山-高雄",7,0,7
"9426","1570力肯","110/07/14","(牛牛牛)亞-鑫豐",0,17,-17
"9427","1570力肯","110/07/14","臺銀-臺南",5,0,5
"9428","1570力肯","110/07/14","日盛-士林",0,10,-10
"9429","1570力肯","110/07/14","凱基-三峽",5,0,5
"9430","1570力肯","110/07/14","統一-員林",0,10,-10
"9431","1570力肯","110/07/14","元大-和平",5,0,5
"9432","1570力肯","110/07/14","國票-新莊",0,10,-10
"9433","1570力肯","110/07/14","合庫-三重",4,0,4
"9434","1570力肯","110/07/14","凱基-高美館",0,10,-10
"9435","1570力肯","110/07/14","瑞士信貸",4,0,4
"9436","1570力肯","110/07/14","元大-屏東民生",0,5,-5
"9437","1570力肯","110/07/14","統一-三多",4,0,4
"9438","1570力肯","110/07/14","元大-古亭",0,5,-5
"9439","1570力肯","110/07/14","華南永昌-古亭",4,0,4
"9440","1570力肯","110/07/14","日盛-木柵",0,4,-4
"9441","1570力肯","110/07/14","元大-高雄",3,0,3
"9442","1570力肯","110/07/14","大昌",0,4,-4
"9443","1570力肯","110/07/14","兆豐-忠孝",2,0,2
"9444","1570力肯","110/07/14","群益金鼎-東大",0,4,-4
"9445","1570力肯","110/07/14","富邦-陽明",2,0,2
"9446","1570力肯","110/07/14","凱基-台北",0,4,-4
"9447","1570力肯","110/07/14","元大-松山",2,0,2
"9448","1570力肯","110/07/14","元大-板橋",0,4,-4
"9449","1570力肯","110/07/14","元大-忠孝",2,0,2
"9450","1570力肯","110/07/14","第一金-中山",0,3,-3
"9451","2929淘帝","110/07/14","華南永昌-林口",60,0,60
"9452","2929淘帝","110/07/14","群益金鼎",25,540,-515
"9453","2929淘帝","110/07/14","美林",87,31,56
"9454","2929淘帝","110/07/14","國泰-台南",1,30,-29
"9455","2929淘帝","110/07/14","元富-台南",40,0,40
"9456","2929淘帝","110/07/14","宏遠-桃園",0,20,-20
"9457","2929淘帝","110/07/14","元大-民生",39,0,39
"9458","2929淘帝","110/07/14","摩根大通",11,31,-20
"9459","2929淘帝","110/07/14","臺銀-鳳山",34,0,34
"9460","2929淘帝","110/07/14","台新-建北",5,20,-15
"9461","2929淘帝","110/07/14","合庫-高雄",34,1,33
"9462","2929淘帝","110/07/14","新光",1,16,-15
"9463","2929淘帝","110/07/14","華南永昌-鶯歌",28,0,28
"9464","2929淘帝","110/07/14","玉山-板橋",0,15,-15
"9465","2929淘帝","110/07/14","永興",25,0,25
"9466","2929淘帝","110/07/14","凱基-羅東",0,15,-15
"9467","2929淘帝","110/07/14","元大-新盛",25,1,24
"9468","2929淘帝","110/07/14","元大-頭份",0,15,-15
"9469","2929淘帝","110/07/14","日盛-南京",23,0,23
"9470","2929淘帝","110/07/14","第一金-台南",0,13,-13
"9471","2929淘帝","110/07/14","日茂",20,0,20
"9472","2929淘帝","110/07/14","富邦-基隆",0,12,-12
"9473","2929淘帝","110/07/14","台新-台中",20,0,20
"9474","2929淘帝","110/07/14","日茂-南投",1,12,-11
"9475","2929淘帝","110/07/14","華南永昌",20,0,20
"9476","2929淘帝","110/07/14","元大-豐原站前",0,11,-11
"9477","2929淘帝","110/07/14","福勝",15,0,15
"9478","2929淘帝","110/07/14","玉山-士林",0,10,-10
"9479","2929淘帝","110/07/14","富邦-南屯",15,0,15
"9480","2929淘帝","110/07/14","富邦-台北",0,10,-10
"9481","5410國眾","110/07/14","兆豐-城中",35,0,35
"9482","5410國眾","110/07/14","瑞士信貸",0,29,-29
"9483","5410國眾","110/07/14","新光",21,1,20
"9484","5410國眾","110/07/14","國泰-板橋",1,30,-29
"9485","5410國眾","110/07/14","國泰-敦南",21,1,20
"9486","5410國眾","110/07/14","日盛-高雄",0,20,-20
"9487","5410國眾","110/07/14","國泰-台中",20,1,19
"9488","5410國眾","110/07/14","台新-左楠",1,20,-19
"9489","5410國眾","110/07/14","元大-崇德",19,0,19
"9490","5410國眾","110/07/14","元富-大昌",1,18,-17
"9491","5410國眾","110/07/14","土銀-士林",18,0,18
"9492","5410國眾","110/07/14","富邦-建國",0,15,-15
"9493","5410國眾","110/07/14","元大-新盛",20,2,18
"9494","5410國眾","110/07/14","元富-嘉義",0,12,-12
"9495","5410國眾","110/07/14","兆豐-高雄",15,0,15
"9496","5410國眾","110/07/14","永全-南崁",0,12,-12
"9497","5410國眾","110/07/14","宏遠-中和",10,0,10
"9498","5410國眾","110/07/14","元大-員林",0,11,-11
"9499","5410國眾","110/07/14","新光-桃園",10,0,10
"9500","5410國眾","110/07/14","高橋",0,10,-10
"9501","5410國眾","110/07/14","國泰-台南",10,0,10
"9502","5410國眾","110/07/14","永興",0,10,-10
"9503","5410國眾","110/07/14","元大-復北",10,0,10
"9504","5410國眾","110/07/14","華南永昌-三重",0,10,-10
"9505","5410國眾","110/07/14","元大-竹科",8,0,8
"9506","5410國眾","110/07/14","元大-苑裡",0,7,-7
"9507","5410國眾","110/07/14","台新-新營",6,0,6
"9508","5410國眾","110/07/14","港商野村",0,6,-6
"9509","5410國眾","110/07/14","日盛-士林",5,0,5
"9510","5410國眾","110/07/14","摩根大通",5,11,-6
"9511","2841台開","110/07/14","凱基-文心",73,0,73
"9512","2841台開","110/07/14","國泰-敦南",0,50,-50
"9513","2841台開","110/07/14","元富-潮州",30,0,30
"9514","2841台開","110/07/14","凱基-中壢",0,40,-40
"9515","2841台開","110/07/14","第一金-台中",20,0,20
"9516","2841台開","110/07/14","統一-新竹",0,24,-24
"9517","2841台開","110/07/14","華南永昌-新莊",20,0,20
"9518","2841台開","110/07/14","元富-草屯",0,20,-20
"9519","2841台開","110/07/14","永豐金-豐原",20,0,20
"9520","2841台開","110/07/14","台新-台南",0,20,-20
"9521","2841台開","110/07/14","國泰-館前",15,0,15
"9522","2841台開","110/07/14","永豐金-敦南",45,63,-18
"9523","2841台開","110/07/14","群益金鼎-基隆",12,0,12
"9524","2841台開","110/07/14","國票-北高雄",0,13,-13
"9525","2841台開","110/07/14","日盛-信義",10,0,10
"9526","2841台開","110/07/14","凱基-松山",0,10,-10
"9527","2841台開","110/07/14","台新-台中",10,0,10
"9528","2841台開","110/07/14","元大證券",0,10,-10
"9529","2841台開","110/07/14","新光",10,1,9
"9530","2841台開","110/07/14","元大-中壢",0,10,-10
"9531","2841台開","110/07/14","凱基-新店",8,0,8
"9532","2841台開","110/07/14","富邦-陽明",1,10,-9
"9533","2841台開","110/07/14","元大-斗信",7,0,7
"9534","2841台開","110/07/14","富邦-建國",0,9,-9
"9535","2841台開","110/07/14","元大-三重",6,0,6
"9536","2841台開","110/07/14","富邦-台南",0,8,-8
"9537","2841台開","110/07/14","永豐金-中和",6,0,6
"9538","2841台開","110/07/14","康和-澎湖",0,7,-7
"9539","2841台開","110/07/14","元富-成功",5,0,5
"9540","2841台開","110/07/14","日盛-斗六",0,6,-6
"9541","6207雷科","110/07/14","群益金鼎-台北",60,0,60
"9542","6207雷科","110/07/14","新加坡商瑞銀",10,56,-46
"9543","6207雷科","110/07/14","台新-高雄",43,3,40
"9544","6207雷科","110/07/14","國票-中和",0,41,-41
"9545","6207雷科","110/07/14","元大-高雄",19,0,19
"9546","6207雷科","110/07/14","元大-復北",0,33,-33
"9547","6207雷科","110/07/14","福勝",15,0,15
"9548","6207雷科","110/07/14","光和-和美",0,20,-20
"9549","6207雷科","110/07/14","群益金鼎-中山",15,0,15
"9550","6207雷科","110/07/14","群益金鼎-丹鳳",0,20,-20
"9551","6207雷科","110/07/14","元大-林園",15,0,15
"9552","6207雷科","110/07/14","第一金-路竹",0,10,-10
"9553","6207雷科","110/07/14","新光",12,0,12
"9554","6207雷科","110/07/14","元大-歸仁",0,10,-10
"9555","6207雷科","110/07/14","元大-大天母",10,0,10
"9556","6207雷科","110/07/14","宏遠-館前",0,9,-9
"9557","6207雷科","110/07/14","永豐金-忠孝",9,0,9
"9558","6207雷科","110/07/14","凱基-台北",12,20,-8
"9559","6207雷科","110/07/14","永豐金-新店",7,0,7
"9560","6207雷科","110/07/14","美林",0,7,-7
"9561","6207雷科","110/07/14","玉山-嘉義",6,0,6
"9562","6207雷科","110/07/14","摩根大通",16,23,-7
"9563","6207雷科","110/07/14","元大-屏東",6,0,6
"9564","6207雷科","110/07/14","凱基-高雄",1,7,-6
"9565","6207雷科","110/07/14","凱基-大安",5,0,5
"9566","6207雷科","110/07/14","台中銀-豐原",0,5,-5
"9567","6207雷科","110/07/14","富邦-台南",5,0,5
"9568","6207雷科","110/07/14","元大-新竹經國",0,5,-5
"9569","6207雷科","110/07/14","元大-成功",5,0,5
"9570","6207雷科","110/07/14","光和-田中",0,4,-4
"9571","3679新至陞","110/07/14","凱基-台北",31,6,25
"9572","3679新至陞","110/07/14","群益金鼎-東大",0,15,-15
"9573","3679新至陞","110/07/14","華南永昌-新莊",10,0,10
"9574","3679新至陞","110/07/14","瑞士信貸",0,12,-12
"9575","3679新至陞","110/07/14","新加坡商瑞銀",11,3,8
"9576","3679新至陞","110/07/14","群益金鼎-永和",0,10,-10
"9577","3679新至陞","110/07/14","美商高盛",6,0,6
"9578","3679新至陞","110/07/14","元大-成功",5,15,-10
"9579","3679新至陞","110/07/14","第一金-中壢",6,0,6
"9580","3679新至陞","110/07/14","統一-板橋",1,10,-9
"9581","3679新至陞","110/07/14","(牛牛牛)亞-網路",4,0,4
"9582","3679新至陞","110/07/14","玉山-左營",0,5,-5
"9583","3679新至陞","110/07/14","元大-六合",3,0,3
"9584","3679新至陞","110/07/14","群益金鼎-三民",0,4,-4
"9585","3679新至陞","110/07/14","合庫-自強",2,0,2
"9586","3679新至陞","110/07/14","富邦-宜蘭",0,4,-4
"9587","3679新至陞","110/07/14","高橋-內壢",2,0,2
"9588","3679新至陞","110/07/14","永豐金-苓雅",0,3,-3
"9589","3679新至陞","110/07/14","台中銀-員林",2,0,2
"9590","3679新至陞","110/07/14","摩根大通",5,7,-2
"9591","3679新至陞","110/07/14","凱基-高美館",2,0,2
"9592","3679新至陞","110/07/14","元大-板橋三民",0,2,-2
"9593","3679新至陞","110/07/14","元大-福營",2,0,2
"9594","3679新至陞","110/07/14","宏遠-中和",0,1,-1
"9595","3679新至陞","110/07/14","永豐金-松山",2,0,2
"9596","3679新至陞","110/07/14","元富-佳里",0,1,-1
"9597","3679新至陞","110/07/14","永豐金-萬盛",2,0,2
"9598","3679新至陞","110/07/14","(牛牛牛)亞-鑫豐",0,1,-1
"9599","3679新至陞","110/07/14","元富-松德",1,0,1
"9600","3679新至陞","110/07/14","中國信託-中壢",0,1,-1
"9601","2727王品","110/07/14","富邦-左營",102,1,101
"9602","2727王品","110/07/14","統一-城中",100,234,-134
"9603","2727王品","110/07/14","國泰-板橋",105,11,94
"9604","2727王品","110/07/14","富邦-台北",1,125,-124
"9605","2727王品","110/07/14","港商野村",149,72,77
"9606","2727王品","110/07/14","台灣摩根士丹利",1,48,-47
"9607","2727王品","110/07/14","合庫-台中",66,2,64
"9608","2727王品","110/07/14","國票-新莊",0,40,-40
"9609","2727王品","110/07/14","臺銀-金山",63,8,55
"9610","2727王品","110/07/14","永豐金-忠孝",2,39,-37
"9611","2727王品","110/07/14","摩根大通",83,39,44
"9612","2727王品","110/07/14","富邦-彰化",1,34,-33
"9613","2727王品","110/07/14","凱基-台北",84,42,42
"9614","2727王品","110/07/14","康和-高雄",0,30,-30
"9615","2727王品","110/07/14","土銀-台中",35,1,34
"9616","2727王品","110/07/14","安泰",0,26,-26
"9617","2727王品","110/07/14","華南永昌-麻豆",32,1,31
"9618","2727王品","110/07/14","富邦-新竹華信",0,21,-21
"9619","2727王品","110/07/14","元大證券",85,55,30
"9620","2727王品","110/07/14","元大-南崁",1,22,-21
"9621","2727王品","110/07/14","新加坡商瑞銀",40,15,25
"9622","2727王品","110/07/14","彰銀-台中",0,18,-18
"9623","2727王品","110/07/14","日盛-八德",19,0,19
"9624","2727王品","110/07/14","元富-同大",2,20,-18
"9625","2727王品","110/07/14","統一",35,17,18
"9626","2727王品","110/07/14","玉山-嘉義",1,17,-16
"9627","2727王品","110/07/14","元富-大昌",18,1,17
"9628","2727王品","110/07/14","國泰-館前",4,20,-16
"9629","2727王品","110/07/14","玉山-板橋",15,1,14
"9630","2727王品","110/07/14","第一金-嘉義",1,13,-12
"9631","1570力肯","110/07/14","國票-北高雄",68,0,68
"9632","1570力肯","110/07/14","摩根大通",0,21,-21
"9633","1570力肯","110/07/14","日盛-八德",30,1,29
"9634","1570力肯","110/07/14","新光",1,19,-18
"9635","1570力肯","110/07/14","玉山-高雄",7,0,7
"9636","1570力肯","110/07/14","(牛牛牛)亞-鑫豐",0,17,-17
"9637","1570力肯","110/07/14","臺銀-臺南",5,0,5
"9638","1570力肯","110/07/14","日盛-士林",0,10,-10
"9639","1570力肯","110/07/14","凱基-三峽",5,0,5
"9640","1570力肯","110/07/14","統一-員林",0,10,-10
"9641","1570力肯","110/07/14","元大-和平",5,0,5
"9642","1570力肯","110/07/14","國票-新莊",0,10,-10
"9643","1570力肯","110/07/14","合庫-三重",4,0,4
"9644","1570力肯","110/07/14","凱基-高美館",0,10,-10
"9645","1570力肯","110/07/14","瑞士信貸",4,0,4
"9646","1570力肯","110/07/14","元大-屏東民生",0,5,-5
"9647","1570力肯","110/07/14","統一-三多",4,0,4
"9648","1570力肯","110/07/14","元大-古亭",0,5,-5
"9649","1570力肯","110/07/14","華南永昌-古亭",4,0,4
"9650","1570力肯","110/07/14","日盛-木柵",0,4,-4
"9651","1570力肯","110/07/14","元大-高雄",3,0,3
"9652","1570力肯","110/07/14","大昌",0,4,-4
"9653","1570力肯","110/07/14","兆豐-忠孝",2,0,2
"9654","1570力肯","110/07/14","群益金鼎-東大",0,4,-4
"9655","1570力肯","110/07/14","富邦-陽明",2,0,2
"9656","1570力肯","110/07/14","凱基-台北",0,4,-4
"9657","1570力肯","110/07/14","元大-松山",2,0,2
"9658","1570力肯","110/07/14","元大-板橋",0,4,-4
"9659","1570力肯","110/07/14","元大-忠孝",2,0,2
"9660","1570力肯","110/07/14","第一金-中山",0,3,-3
"9661","6180橘子","110/07/14","新加坡商瑞銀",84,28,56
"9662","6180橘子","110/07/14","凱基-台北",4,37,-33
"9663","6180橘子","110/07/14","日盛-信義",29,1,28
"9664","6180橘子","110/07/14","玉山-台南",1,22,-21
"9665","6180橘子","110/07/14","豐農",28,4,24
"9666","6180橘子","110/07/14","日盛-新竹",1,21,-20
"9667","6180橘子","110/07/14","新光-新竹",24,1,23
"9668","6180橘子","110/07/14","元富-潮州",0,19,-19
"9669","6180橘子","110/07/14","華南永昌-高雄",20,0,20
"9670","6180橘子","110/07/14","元大-信義",0,17,-17
"9671","6180橘子","110/07/14","元大-羅東",20,0,20
"9672","6180橘子","110/07/14","台灣企銀-台中",1,16,-15
"9673","6180橘子","110/07/14","元大-台中中港",20,0,20
"9674","6180橘子","110/07/14","元大-北港",0,15,-15
"9675","6180橘子","110/07/14","富邦-嘉義",24,5,19
"9676","6180橘子","110/07/14","富邦-高雄",0,14,-14
"9677","6180橘子","110/07/14","富邦-仁愛",15,0,15
"9678","6180橘子","110/07/14","兆豐-埔墘",0,13,-13
"9679","6180橘子","110/07/14","國票-九鼎",13,0,13
"9680","6180橘子","110/07/14","第一金-中山",0,10,-10
"9681","6180橘子","110/07/14","日盛-木柵",12,0,12
"9682","6180橘子","110/07/14","元大-彰化民生",0,10,-10
"9683","6180橘子","110/07/14","元大-成功",10,0,10
"9684","6180橘子","110/07/14","福勝",1,10,-9
"9685","6180橘子","110/07/14","港商野村",10,2,8
"9686","6180橘子","110/07/14","群益金鼎-丹鳳",1,10,-9
"9687","6180橘子","110/07/14","玉山-左營",8,0,8
"9688","6180橘子","110/07/14","群益金鼎-板橋",0,8,-8
"9689","6180橘子","110/07/14","富邦-陽明",16,8,8
"9690","6180橘子","110/07/14","合庫-鳳山",0,7,-7
"9691","2390云辰","110/07/14","摩根大通",995,198,797
"9692","2390云辰","110/07/14","新加坡商瑞銀",28,399,-371
"9693","2390云辰","110/07/14","美林",383,22,361
"9694","2390云辰","110/07/14","凱基-新豐",3,198,-195
"9695","2390云辰","110/07/14","台灣摩根士丹利",684,358,326
"9696","2390云辰","110/07/14","元大-士林",1,152,-151
"9697","2390云辰","110/07/14","凱基-台北",656,402,254
"9698","2390云辰","110/07/14","元大-竹山",80,181,-101
"9699","2390云辰","110/07/14","日盛-和美",110,5,105
"9700","2390云辰","110/07/14","群益金鼎-開元",19,95,-76
"9701","2390云辰","110/07/14","元大-天母",72,0,72
"9702","2390云辰","110/07/14","新光",77,150,-73
"9703","2390云辰","110/07/14","永豐金-松山",57,0,57
"9704","2390云辰","110/07/14","元富-高雄",0,71,-71
"9705","2390云辰","110/07/14","統一-屏東",53,0,53
"9706","2390云辰","110/07/14","元大-土城學府",130,201,-71
"9707","2390云辰","110/07/14","港商野村",486,450,36
"9708","2390云辰","110/07/14","元大-善化",12,76,-64
"9709","2390云辰","110/07/14","致和-崇德",30,0,30
"9710","2390云辰","110/07/14","華南永昌-岡山",23,81,-58
"9711","2390云辰","110/07/14","富邦-台北",40,14,26
"9712","2390云辰","110/07/14","群益金鼎-大興",82,125,-43
"9713","2390云辰","110/07/14","台新-高雄",38,13,25
"9714","2390云辰","110/07/14","大慶-中壢",0,41,-41
"9715","2390云辰","110/07/14","富邦-板橋",32,7,25
"9716","2390云辰","110/07/14","玉山-板橋",6,47,-41
"9717","2390云辰","110/07/14","陽信-石牌",24,0,24
"9718","2390云辰","110/07/14","富邦-台東",2,42,-40
"9719","2390云辰","110/07/14","凱基-屏東",32,8,24
"9720","2390云辰","110/07/14","元大-新營",3,42,-39
"9721","2363矽統","110/07/14","台灣摩根士丹利",463,0,463
"9722","2363矽統","110/07/14","新加坡商瑞銀",568,1321,-753
"9723","2363矽統","110/07/14","台新證券",750,342,408
"9724","2363矽統","110/07/14","瑞士信貸",149,864,-715
"9725","2363矽統","110/07/14","玉山-台中",363,51,312
"9726","2363矽統","110/07/14","台新-屏東",115,380,-265
"9727","2363矽統","110/07/14","元大-斗六",223,25,198
"9728","2363矽統","110/07/14","永豐金證券",16,265,-249
"9729","2363矽統","110/07/14","華南永昌-朴子",208,38,170
"9730","2363矽統","110/07/14","美林",462,701,-239
"9731","2363矽統","110/07/14","元富-西松",169,12,157
"9732","2363矽統","110/07/14","宏遠-桃園",269,500,-231
"9733","2363矽統","110/07/14","永豐金-大園",146,6,140
"9734","2363矽統","110/07/14","凱基-竹北",36,254,-218
"9735","2363矽統","110/07/14","土銀-和平",134,0,134
"9736","2363矽統","110/07/14","港商法國興業",0,214,-214
"9737","2363矽統","110/07/14","富邦-新營",130,13,117
"9738","2363矽統","110/07/14","港商野村",835,1044,-209
"9739","2363矽統","110/07/14","元富-成功",118,11,107
"9740","2363矽統","110/07/14","北城證券",212,411,-199
"9741","2363矽統","110/07/14","元富-烏日",121,18,103
"9742","2363矽統","110/07/14","(牛牛牛)亞-鑫豐",51,241,-190
"9743","2363矽統","110/07/14","日盛-二林",120,18,102
"9744","2363矽統","110/07/14","國票-博愛",24,213,-189
"9745","2363矽統","110/07/14","兆豐-忠孝",98,2,96
"9746","2363矽統","110/07/14","大慶-蘆洲",134,316,-182
"9747","2363矽統","110/07/14","大慶-楊梅",92,3,89
"9748","2363矽統","110/07/14","彰銀-台中",15,193,-178
"9749","2363矽統","110/07/14","元富-三重",120,33,87
"9750","2363矽統","110/07/14","日盛-和美",18,185,-167
"9751","8112至上","110/07/14","新加坡商瑞銀",223,17,206
"9752","8112至上","110/07/14","瑞士信貸",8,170,-162
"9753","8112至上","110/07/14","摩根大通",285,129,156
"9754","8112至上","110/07/14","美林",55,202,-147
"9755","8112至上","110/07/14","花旗環球",124,0,124
"9756","8112至上","110/07/14","凱基-台北",325,436,-111
"9757","8112至上","110/07/14","兆豐-公益",117,4,113
"9758","8112至上","110/07/14","台中銀-台北",0,98,-98
"9759","8112至上","110/07/14","香港上海匯豐",111,0,111
"9760","8112至上","110/07/14","玉山-台大",17,107,-90
"9761","8112至上","110/07/14","永豐金-內湖",117,21,96
"9762","8112至上","110/07/14","康和-內湖",1,90,-89
"9763","8112至上","110/07/14","台灣摩根士丹利",108,16,92
"9764","8112至上","110/07/14","港商野村",21,84,-63
"9765","8112至上","110/07/14","元大-東蘆",77,0,77
"9766","8112至上","110/07/14","兆豐-北高雄",1,60,-59
"9767","8112至上","110/07/14","新光",108,48,60
"9768","8112至上","110/07/14","群益金鼎-海山",1,52,-51
"9769","8112至上","110/07/14","大慶-蘆洲",59,0,59
"9770","8112至上","110/07/14","群益金鼎-大安",0,50,-50
"9771","8112至上","110/07/14","華南永昌-台中",56,3,53
"9772","8112至上","110/07/14","富邦-仁愛",2,49,-47
"9773","8112至上","110/07/14","土銀-嘉義",52,2,50
"9774","8112至上","110/07/14","元大-金華",0,42,-42
"9775","8112至上","110/07/14","美商高盛",40,0,40
"9776","8112至上","110/07/14","元大-內湖",4,43,-39
"9777","8112至上","110/07/14","臺銀",63,29,34
"9778","8112至上","110/07/14","第一金-華江",2,37,-35
"9779","8112至上","110/07/14","元富-嘉義",31,0,31
"9780","8112至上","110/07/14","永豐金-苓雅",2,34,-32
"9781","1570力肯","110/07/14","國票-北高雄",68,0,68
"9782","1570力肯","110/07/14","摩根大通",0,21,-21
"9783","1570力肯","110/07/14","日盛-八德",30,1,29
"9784","1570力肯","110/07/14","新光",1,19,-18
"9785","1570力肯","110/07/14","玉山-高雄",7,0,7
"9786","1570力肯","110/07/14","(牛牛牛)亞-鑫豐",0,17,-17
"9787","1570力肯","110/07/14","臺銀-臺南",5,0,5
"9788","1570力肯","110/07/14","日盛-士林",0,10,-10
"9789","1570力肯","110/07/14","凱基-三峽",5,0,5
"9790","1570力肯","110/07/14","統一-員林",0,10,-10
"9791","1570力肯","110/07/14","元大-和平",5,0,5
"9792","1570力肯","110/07/14","國票-新莊",0,10,-10
"9793","1570力肯","110/07/14","合庫-三重",4,0,4
"9794","1570力肯","110/07/14","凱基-高美館",0,10,-10
"9795","1570力肯","110/07/14","瑞士信貸",4,0,4
"9796","1570力肯","110/07/14","元大-屏東民生",0,5,-5
"9797","1570力肯","110/07/14","統一-三多",4,0,4
"9798","1570力肯","110/07/14","元大-古亭",0,5,-5
"9799","1570力肯","110/07/14","華南永昌-古亭",4,0,4
"9800","1570力肯","110/07/14","日盛-木柵",0,4,-4
"9801","1570力肯","110/07/14","元大-高雄",3,0,3
"9802","1570力肯","110/07/14","大昌",0,4,-4
"9803","1570力肯","110/07/14","兆豐-忠孝",2,0,2
"9804","1570力肯","110/07/14","群益金鼎-東大",0,4,-4
"9805","1570力肯","110/07/14","富邦-陽明",2,0,2
"9806","1570力肯","110/07/14","凱基-台北",0,4,-4
"9807","1570力肯","110/07/14","元大-松山",2,0,2
"9808","1570力肯","110/07/14","元大-板橋",0,4,-4
"9809","1570力肯","110/07/14","元大-忠孝",2,0,2
"9810","1570力肯","110/07/14","第一金-中山",0,3,-3
"9811","2929淘帝","110/07/14","華南永昌-林口",60,0,60
"9812","2929淘帝","110/07/14","群益金鼎",25,540,-515
"9813","2929淘帝","110/07/14","美林",87,31,56
"9814","2929淘帝","110/07/14","國泰-台南",1,30,-29
"9815","2929淘帝","110/07/14","元富-台南",40,0,40
"9816","2929淘帝","110/07/14","宏遠-桃園",0,20,-20
"9817","2929淘帝","110/07/14","元大-民生",39,0,39
"9818","2929淘帝","110/07/14","摩根大通",11,31,-20
"9819","2929淘帝","110/07/14","臺銀-鳳山",34,0,34
"9820","2929淘帝","110/07/14","台新-建北",5,20,-15
"9821","2929淘帝","110/07/14","合庫-高雄",34,1,33
"9822","2929淘帝","110/07/14","新光",1,16,-15
"9823","2929淘帝","110/07/14","華南永昌-鶯歌",28,0,28
"9824","2929淘帝","110/07/14","玉山-板橋",0,15,-15
"9825","2929淘帝","110/07/14","永興",25,0,25
"9826","2929淘帝","110/07/14","凱基-羅東",0,15,-15
"9827","2929淘帝","110/07/14","元大-新盛",25,1,24
"9828","2929淘帝","110/07/14","元大-頭份",0,15,-15
"9829","2929淘帝","110/07/14","日盛-南京",23,0,23
"9830","2929淘帝","110/07/14","第一金-台南",0,13,-13
"9831","2929淘帝","110/07/14","日茂",20,0,20
"9832","2929淘帝","110/07/14","富邦-基隆",0,12,-12
"9833","2929淘帝","110/07/14","台新-台中",20,0,20
"9834","2929淘帝","110/07/14","日茂-南投",1,12,-11
"9835","2929淘帝","110/07/14","華南永昌",20,0,20
"9836","2929淘帝","110/07/14","元大-豐原站前",0,11,-11
"9837","2929淘帝","110/07/14","福勝",15,0,15
"9838","2929淘帝","110/07/14","玉山-士林",0,10,-10
"9839","2929淘帝","110/07/14","富邦-南屯",15,0,15
"9840","2929淘帝","110/07/14","富邦-台北",0,10,-10
"9841","5410國眾","110/07/14","兆豐-城中",35,0,35
"9842","5410國眾","110/07/14","瑞士信貸",0,29,-29
"9843","5410國眾","110/07/14","新光",21,1,20
"9844","5410國眾","110/07/14","國泰-板橋",1,30,-29
"9845","5410國眾","110/07/14","國泰-敦南",21,1,20
"9846","5410國眾","110/07/14","日盛-高雄",0,20,-20
"9847","5410國眾","110/07/14","國泰-台中",20,1,19
"9848","5410國眾","110/07/14","台新-左楠",1,20,-19
"9849","5410國眾","110/07/14","元大-崇德",19,0,19
"9850","5410國眾","110/07/14","元富-大昌",1,18,-17
"9851","5410國眾","110/07/14","土銀-士林",18,0,18
"9852","5410國眾","110/07/14","富邦-建國",0,15,-15
"9853","5410國眾","110/07/14","元大-新盛",20,2,18
"9854","5410國眾","110/07/14","元富-嘉義",0,12,-12
"9855","5410國眾","110/07/14","兆豐-高雄",15,0,15
"9856","5410國眾","110/07/14","永全-南崁",0,12,-12
"9857","5410國眾","110/07/14","宏遠-中和",10,0,10
"9858","5410國眾","110/07/14","元大-員林",0,11,-11
"9859","5410國眾","110/07/14","新光-桃園",10,0,10
"9860","5410國眾","110/07/14","高橋",0,10,-10
"9861","5410國眾","110/07/14","國泰-台南",10,0,10
"9862","5410國眾","110/07/14","永興",0,10,-10
"9863","5410國眾","110/07/14","元大-復北",10,0,10
"9864","5410國眾","110/07/14","華南永昌-三重",0,10,-10
"9865","5410國眾","110/07/14","元大-竹科",8,0,8
"9866","5410國眾","110/07/14","元大-苑裡",0,7,-7
"9867","5410國眾","110/07/14","台新-新營",6,0,6
"9868","5410國眾","110/07/14","港商野村",0,6,-6
"9869","5410國眾","110/07/14","日盛-士林",5,0,5
"9870","5410國眾","110/07/14","摩根大通",5,11,-6
"9871","2841台開","110/07/14","凱基-文心",73,0,73
"9872","2841台開","110/07/14","國泰-敦南",0,50,-50
"9873","2841台開","110/07/14","元富-潮州",30,0,30
"9874","2841台開","110/07/14","凱基-中壢",0,40,-40
"9875","2841台開","110/07/14","第一金-台中",20,0,20
"9876","2841台開","110/07/14","統一-新竹",0,24,-24
"9877","2841台開","110/07/14","華南永昌-新莊",20,0,20
"9878","2841台開","110/07/14","元富-草屯",0,20,-20
"9879","2841台開","110/07/14","永豐金-豐原",20,0,20
"9880","2841台開","110/07/14","台新-台南",0,20,-20
"9881","2841台開","110/07/14","國泰-館前",15,0,15
"9882","2841台開","110/07/14","永豐金-敦南",45,63,-18
"9883","2841台開","110/07/14","群益金鼎-基隆",12,0,12
"9884","2841台開","110/07/14","國票-北高雄",0,13,-13
"9885","2841台開","110/07/14","日盛-信義",10,0,10
"9886","2841台開","110/07/14","凱基-松山",0,10,-10
"9887","2841台開","110/07/14","台新-台中",10,0,10
"9888","2841台開","110/07/14","元大證券",0,10,-10
"9889","2841台開","110/07/14","新光",10,1,9
"9890","2841台開","110/07/14","元大-中壢",0,10,-10
"9891","2841台開","110/07/14","凱基-新店",8,0,8
"9892","2841台開","110/07/14","富邦-陽明",1,10,-9
"9893","2841台開","110/07/14","元大-斗信",7,0,7
"9894","2841台開","110/07/14","富邦-建國",0,9,-9
"9895","2841台開","110/07/14","元大-三重",6,0,6
"9896","2841台開","110/07/14","富邦-台南",0,8,-8
"9897","2841台開","110/07/14","永豐金-中和",6,0,6
"9898","2841台開","110/07/14","康和-澎湖",0,7,-7
"9899","2841台開","110/07/14","元富-成功",5,0,5
"9900","2841台開","110/07/14","日盛-斗六",0,6,-6
"9901","6207雷科","110/07/14","群益金鼎-台北",60,0,60
"9902","6207雷科","110/07/14","新加坡商瑞銀",10,56,-46
"9903","6207雷科","110/07/14","台新-高雄",43,3,40
"9904","6207雷科","110/07/14","國票-中和",0,41,-41
"9905","6207雷科","110/07/14","元大-高雄",19,0,19
"9906","6207雷科","110/07/14","元大-復北",0,33,-33
"9907","6207雷科","110/07/14","福勝",15,0,15
"9908","6207雷科","110/07/14","光和-和美",0,20,-20
"9909","6207雷科","110/07/14","群益金鼎-中山",15,0,15
"9910","6207雷科","110/07/14","群益金鼎-丹鳳",0,20,-20
"9911","6207雷科","110/07/14","元大-林園",15,0,15
"9912","6207雷科","110/07/14","第一金-路竹",0,10,-10
"9913","6207雷科","110/07/14","新光",12,0,12
"9914","6207雷科","110/07/14","元大-歸仁",0,10,-10
"9915","6207雷科","110/07/14","元大-大天母",10,0,10
"9916","6207雷科","110/07/14","宏遠-館前",0,9,-9
"9917","6207雷科","110/07/14","永豐金-忠孝",9,0,9
"9918","6207雷科","110/07/14","凱基-台北",12,20,-8
"9919","6207雷科","110/07/14","永豐金-新店",7,0,7
"9920","6207雷科","110/07/14","美林",0,7,-7
"9921","6207雷科","110/07/14","玉山-嘉義",6,0,6
"9922","6207雷科","110/07/14","摩根大通",16,23,-7
"9923","6207雷科","110/07/14","元大-屏東",6,0,6
"9924","6207雷科","110/07/14","凱基-高雄",1,7,-6
"9925","6207雷科","110/07/14","凱基-大安",5,0,5
"9926","6207雷科","110/07/14","台中銀-豐原",0,5,-5
"9927","6207雷科","110/07/14","富邦-台南",5,0,5
"9928","6207雷科","110/07/14","元大-新竹經國",0,5,-5
"9929","6207雷科","110/07/14","元大-成功",5,0,5
"9930","6207雷科","110/07/14","光和-田中",0,4,-4
"9931","3679新至陞","110/07/14","凱基-台北",31,6,25
"9932","3679新至陞","110/07/14","群益金鼎-東大",0,15,-15
"9933","3679新至陞","110/07/14","華南永昌-新莊",10,0,10
"9934","3679新至陞","110/07/14","瑞士信貸",0,12,-12
"9935","3679新至陞","110/07/14","新加坡商瑞銀",11,3,8
"9936","3679新至陞","110/07/14","群益金鼎-永和",0,10,-10
"9937","3679新至陞","110/07/14","美商高盛",6,0,6
"9938","3679新至陞","110/07/14","元大-成功",5,15,-10
"9939","3679新至陞","110/07/14","第一金-中壢",6,0,6
"9940","3679新至陞","110/07/14","統一-板橋",1,10,-9
"9941","3679新至陞","110/07/14","(牛牛牛)亞-網路",4,0,4
"9942","3679新至陞","110/07/14","玉山-左營",0,5,-5
"9943","3679新至陞","110/07/14","元大-六合",3,0,3
"9944","3679新至陞","110/07/14","群益金鼎-三民",0,4,-4
"9945","3679新至陞","110/07/14","合庫-自強",2,0,2
"9946","3679新至陞","110/07/14","富邦-宜蘭",0,4,-4
"9947","3679新至陞","110/07/14","高橋-內壢",2,0,2
"9948","3679新至陞","110/07/14","永豐金-苓雅",0,3,-3
"9949","3679新至陞","110/07/14","台中銀-員林",2,0,2
"9950","3679新至陞","110/07/14","摩根大通",5,7,-2
"9951","3679新至陞","110/07/14","凱基-高美館",2,0,2
"9952","3679新至陞","110/07/14","元大-板橋三民",0,2,-2
"9953","3679新至陞","110/07/14","元大-福營",2,0,2
"9954","3679新至陞","110/07/14","宏遠-中和",0,1,-1
"9955","3679新至陞","110/07/14","永豐金-松山",2,0,2
"9956","3679新至陞","110/07/14","元富-佳里",0,1,-1
"9957","3679新至陞","110/07/14","永豐金-萬盛",2,0,2
"9958","3679新至陞","110/07/14","(牛牛牛)亞-鑫豐",0,1,-1
"9959","3679新至陞","110/07/14","元富-松德",1,0,1
"9960","3679新至陞","110/07/14","中國信託-中壢",0,1,-1
"9961","2727王品","110/07/14","富邦-左營",102,1,101
"9962","2727王品","110/07/14","統一-城中",100,234,-134
"9963","2727王品","110/07/14","國泰-板橋",105,11,94
"9964","2727王品","110/07/14","富邦-台北",1,125,-124
"9965","2727王品","110/07/14","港商野村",149,72,77
"9966","2727王品","110/07/14","台灣摩根士丹利",1,48,-47
"9967","2727王品","110/07/14","合庫-台中",66,2,64
"9968","2727王品","110/07/14","國票-新莊",0,40,-40
"9969","2727王品","110/07/14","臺銀-金山",63,8,55
"9970","2727王品","110/07/14","永豐金-忠孝",2,39,-37
"9971","2727王品","110/07/14","摩根大通",83,39,44
"9972","2727王品","110/07/14","富邦-彰化",1,34,-33
"9973","2727王品","110/07/14","凱基-台北",84,42,42
"9974","2727王品","110/07/14","康和-高雄",0,30,-30
"9975","2727王品","110/07/14","土銀-台中",35,1,34
"9976","2727王品","110/07/14","安泰",0,26,-26
"9977","2727王品","110/07/14","華南永昌-麻豆",32,1,31
"9978","2727王品","110/07/14","富邦-新竹華信",0,21,-21
"9979","2727王品","110/07/14","元大證券",85,55,30
"9980","2727王品","110/07/14","元大-南崁",1,22,-21
"9981","2727王品","110/07/14","新加坡商瑞銀",40,15,25
"9982","2727王品","110/07/14","彰銀-台中",0,18,-18
"9983","2727王品","110/07/14","日盛-八德",19,0,19
"9984","2727王品","110/07/14","元富-同大",2,20,-18
"9985","2727王品","110/07/14","統一",35,17,18
"9986","2727王品","110/07/14","玉山-嘉義",1,17,-16
"9987","2727王品","110/07/14","元富-大昌",18,1,17
"9988","2727王品","110/07/14","國泰-館前",4,20,-16
"9989","2727王品","110/07/14","玉山-板橋",15,1,14
"9990","2727王品","110/07/14","第一金-嘉義",1,13,-12
"9991","1570力肯","110/07/14","國票-北高雄",68,0,68
"9992","1570力肯","110/07/14","摩根大通",0,21,-21
"9993","1570力肯","110/07/14","日盛-八德",30,1,29
"9994","1570力肯","110/07/14","新光",1,19,-18
"9995","1570力肯","110/07/14","玉山-高雄",7,0,7
"9996","1570力肯","110/07/14","(牛牛牛)亞-鑫豐",0,17,-17
"9997","1570力肯","110/07/14","臺銀-臺南",5,0,5
"9998","1570力肯","110/07/14","日盛-士林",0,10,-10
"9999","1570力肯","110/07/14","凱基-三峽",5,0,5
"10000","1570力肯","110/07/14","統一-員林",0,10,-10
"10001","1570力肯","110/07/14","元大-和平",5,0,5
"10002","1570力肯","110/07/14","國票-新莊",0,10,-10
"10003","1570力肯","110/07/14","合庫-三重",4,0,4
"10004","1570力肯","110/07/14","凱基-高美館",0,10,-10
"10005","1570力肯","110/07/14","瑞士信貸",4,0,4
"10006","1570力肯","110/07/14","元大-屏東民生",0,5,-5
"10007","1570力肯","110/07/14","統一-三多",4,0,4
"10008","1570力肯","110/07/14","元大-古亭",0,5,-5
"10009","1570力肯","110/07/14","華南永昌-古亭",4,0,4
"10010","1570力肯","110/07/14","日盛-木柵",0,4,-4
"10011","1570力肯","110/07/14","元大-高雄",3,0,3
"10012","1570力肯","110/07/14","大昌",0,4,-4
"10013","1570力肯","110/07/14","兆豐-忠孝",2,0,2
"10014","1570力肯","110/07/14","群益金鼎-東大",0,4,-4
"10015","1570力肯","110/07/14","富邦-陽明",2,0,2
"10016","1570力肯","110/07/14","凱基-台北",0,4,-4
"10017","1570力肯","110/07/14","元大-松山",2,0,2
"10018","1570力肯","110/07/14","元大-板橋",0,4,-4
"10019","1570力肯","110/07/14","元大-忠孝",2,0,2
"10020","1570力肯","110/07/14","第一金-中山",0,3,-3
"10021","6180橘子","110/07/14","新加坡商瑞銀",84,28,56
"10022","6180橘子","110/07/14","凱基-台北",4,37,-33
"10023","6180橘子","110/07/14","日盛-信義",29,1,28
"10024","6180橘子","110/07/14","玉山-台南",1,22,-21
"10025","6180橘子","110/07/14","豐農",28,4,24
"10026","6180橘子","110/07/14","日盛-新竹",1,21,-20
"10027","6180橘子","110/07/14","新光-新竹",24,1,23
"10028","6180橘子","110/07/14","元富-潮州",0,19,-19
"10029","6180橘子","110/07/14","華南永昌-高雄",20,0,20
"10030","6180橘子","110/07/14","元大-信義",0,17,-17
"10031","6180橘子","110/07/14","元大-羅東",20,0,20
"10032","6180橘子","110/07/14","台灣企銀-台中",1,16,-15
"10033","6180橘子","110/07/14","元大-台中中港",20,0,20
"10034","6180橘子","110/07/14","元大-北港",0,15,-15
"10035","6180橘子","110/07/14","富邦-嘉義",24,5,19
"10036","6180橘子","110/07/14","富邦-高雄",0,14,-14
"10037","6180橘子","110/07/14","富邦-仁愛",15,0,15
"10038","6180橘子","110/07/14","兆豐-埔墘",0,13,-13
"10039","6180橘子","110/07/14","國票-九鼎",13,0,13
"10040","6180橘子","110/07/14","第一金-中山",0,10,-10
"10041","6180橘子","110/07/14","日盛-木柵",12,0,12
"10042","6180橘子","110/07/14","元大-彰化民生",0,10,-10
"10043","6180橘子","110/07/14","元大-成功",10,0,10
"10044","6180橘子","110/07/14","福勝",1,10,-9
"10045","6180橘子","110/07/14","港商野村",10,2,8
"10046","6180橘子","110/07/14","群益金鼎-丹鳳",1,10,-9
"10047","6180橘子","110/07/14","玉山-左營",8,0,8
"10048","6180橘子","110/07/14","群益金鼎-板橋",0,8,-8
"10049","6180橘子","110/07/14","富邦-陽明",16,8,8
"10050","6180橘子","110/07/14","合庫-鳳山",0,7,-7
"10051","2390云辰","110/07/14","摩根大通",995,198,797
"10052","2390云辰","110/07/14","新加坡商瑞銀",28,399,-371
"10053","2390云辰","110/07/14","美林",383,22,361
"10054","2390云辰","110/07/14","凱基-新豐",3,198,-195
"10055","2390云辰","110/07/14","台灣摩根士丹利",684,358,326
"10056","2390云辰","110/07/14","元大-士林",1,152,-151
"10057","2390云辰","110/07/14","凱基-台北",656,402,254
"10058","2390云辰","110/07/14","元大-竹山",80,181,-101
"10059","2390云辰","110/07/14","日盛-和美",110,5,105
"10060","2390云辰","110/07/14","群益金鼎-開元",19,95,-76
"10061","2390云辰","110/07/14","元大-天母",72,0,72
"10062","2390云辰","110/07/14","新光",77,150,-73
"10063","2390云辰","110/07/14","永豐金-松山",57,0,57
"10064","2390云辰","110/07/14","元富-高雄",0,71,-71
"10065","2390云辰","110/07/14","統一-屏東",53,0,53
"10066","2390云辰","110/07/14","元大-土城學府",130,201,-71
"10067","2390云辰","110/07/14","港商野村",486,450,36
"10068","2390云辰","110/07/14","元大-善化",12,76,-64
"10069","2390云辰","110/07/14","致和-崇德",30,0,30
"10070","2390云辰","110/07/14","華南永昌-岡山",23,81,-58
"10071","2390云辰","110/07/14","富邦-台北",40,14,26
"10072","2390云辰","110/07/14","群益金鼎-大興",82,125,-43
"10073","2390云辰","110/07/14","台新-高雄",38,13,25
"10074","2390云辰","110/07/14","大慶-中壢",0,41,-41
"10075","2390云辰","110/07/14","富邦-板橋",32,7,25
"10076","2390云辰","110/07/14","玉山-板橋",6,47,-41
"10077","2390云辰","110/07/14","陽信-石牌",24,0,24
"10078","2390云辰","110/07/14","富邦-台東",2,42,-40
"10079","2390云辰","110/07/14","凱基-屏東",32,8,24
"10080","2390云辰","110/07/14","元大-新營",3,42,-39
"10081","2363矽統","110/07/14","台灣摩根士丹利",463,0,463
"10082","2363矽統","110/07/14","新加坡商瑞銀",568,1321,-753
"10083","2363矽統","110/07/14","台新證券",750,342,408
"10084","2363矽統","110/07/14","瑞士信貸",149,864,-715
"10085","2363矽統","110/07/14","玉山-台中",363,51,312
"10086","2363矽統","110/07/14","台新-屏東",115,380,-265
"10087","2363矽統","110/07/14","元大-斗六",223,25,198
"10088","2363矽統","110/07/14","永豐金證券",16,265,-249
"10089","2363矽統","110/07/14","華南永昌-朴子",208,38,170
"10090","2363矽統","110/07/14","美林",462,701,-239
"10091","2363矽統","110/07/14","元富-西松",169,12,157
"10092","2363矽統","110/07/14","宏遠-桃園",269,500,-231
"10093","2363矽統","110/07/14","永豐金-大園",146,6,140
"10094","2363矽統","110/07/14","凱基-竹北",36,254,-218
"10095","2363矽統","110/07/14","土銀-和平",134,0,134
"10096","2363矽統","110/07/14","港商法國興業",0,214,-214
"10097","2363矽統","110/07/14","富邦-新營",130,13,117
"10098","2363矽統","110/07/14","港商野村",835,1044,-209
"10099","2363矽統","110/07/14","元富-成功",118,11,107
"10100","2363矽統","110/07/14","北城證券",212,411,-199
"10101","2363矽統","110/07/14","元富-烏日",121,18,103
"10102","2363矽統","110/07/14","(牛牛牛)亞-鑫豐",51,241,-190
"10103","2363矽統","110/07/14","日盛-二林",120,18,102
"10104","2363矽統","110/07/14","國票-博愛",24,213,-189
"10105","2363矽統","110/07/14","兆豐-忠孝",98,2,96
"10106","2363矽統","110/07/14","大慶-蘆洲",134,316,-182
"10107","2363矽統","110/07/14","大慶-楊梅",92,3,89
"10108","2363矽統","110/07/14","彰銀-台中",15,193,-178
"10109","2363矽統","110/07/14","元富-三重",120,33,87
"10110","2363矽統","110/07/14","日盛-和美",18,185,-167
"10111","8112至上","110/07/14","新加坡商瑞銀",223,17,206
"10112","8112至上","110/07/14","瑞士信貸",8,170,-162
"10113","8112至上","110/07/14","摩根大通",285,129,156
"10114","8112至上","110/07/14","美林",55,202,-147
"10115","8112至上","110/07/14","花旗環球",124,0,124
"10116","8112至上","110/07/14","凱基-台北",325,436,-111
"10117","8112至上","110/07/14","兆豐-公益",117,4,113
"10118","8112至上","110/07/14","台中銀-台北",0,98,-98
"10119","8112至上","110/07/14","香港上海匯豐",111,0,111
"10120","8112至上","110/07/14","玉山-台大",17,107,-90
"10121","8112至上","110/07/14","永豐金-內湖",117,21,96
"10122","8112至上","110/07/14","康和-內湖",1,90,-89
"10123","8112至上","110/07/14","台灣摩根士丹利",108,16,92
"10124","8112至上","110/07/14","港商野村",21,84,-63
"10125","8112至上","110/07/14","元大-東蘆",77,0,77
"10126","8112至上","110/07/14","兆豐-北高雄",1,60,-59
"10127","8112至上","110/07/14","新光",108,48,60
"10128","8112至上","110/07/14","群益金鼎-海山",1,52,-51
"10129","8112至上","110/07/14","大慶-蘆洲",59,0,59
"10130","8112至上","110/07/14","群益金鼎-大安",0,50,-50
"10131","8112至上","110/07/14","華南永昌-台中",56,3,53
"10132","8112至上","110/07/14","富邦-仁愛",2,49,-47
"10133","8112至上","110/07/14","土銀-嘉義",52,2,50
"10134","8112至上","110/07/14","元大-金華",0,42,-42
"10135","8112至上","110/07/14","美商高盛",40,0,40
"10136","8112至上","110/07/14","元大-內湖",4,43,-39
"10137","8112至上","110/07/14","臺銀",63,29,34
"10138","8112至上","110/07/14","第一金-華江",2,37,-35
"10139","8112至上","110/07/14","元富-嘉義",31,0,31
"10140","8112至上","110/07/14","永豐金-苓雅",2,34,-32
"10141","1570力肯","110/07/14","國票-北高雄",68,0,68
"10142","1570力肯","110/07/14","摩根大通",0,21,-21
"10143","1570力肯","110/07/14","日盛-八德",30,1,29
"10144","1570力肯","110/07/14","新光",1,19,-18
"10145","1570力肯","110/07/14","玉山-高雄",7,0,7
"10146","1570力肯","110/07/14","(牛牛牛)亞-鑫豐",0,17,-17
"10147","1570力肯","110/07/14","臺銀-臺南",5,0,5
"10148","1570力肯","110/07/14","日盛-士林",0,10,-10
"10149","1570力肯","110/07/14","凱基-三峽",5,0,5
"10150","1570力肯","110/07/14","統一-員林",0,10,-10
"10151","1570力肯","110/07/14","元大-和平",5,0,5
"10152","1570力肯","110/07/14","國票-新莊",0,10,-10
"10153","1570力肯","110/07/14","合庫-三重",4,0,4
"10154","1570力肯","110/07/14","凱基-高美館",0,10,-10
"10155","1570力肯","110/07/14","瑞士信貸",4,0,4
"10156","1570力肯","110/07/14","元大-屏東民生",0,5,-5
"10157","1570力肯","110/07/14","統一-三多",4,0,4
"10158","1570力肯","110/07/14","元大-古亭",0,5,-5
"10159","1570力肯","110/07/14","華南永昌-古亭",4,0,4
"10160","1570力肯","110/07/14","日盛-木柵",0,4,-4
"10161","1570力肯","110/07/14","元大-高雄",3,0,3
"10162","1570力肯","110/07/14","大昌",0,4,-4
"10163","1570力肯","110/07/14","兆豐-忠孝",2,0,2
"10164","1570力肯","110/07/14","群益金鼎-東大",0,4,-4
"10165","1570力肯","110/07/14","富邦-陽明",2,0,2
"10166","1570力肯","110/07/14","凱基-台北",0,4,-4
"10167","1570力肯","110/07/14","元大-松山",2,0,2
"10168","1570力肯","110/07/14","元大-板橋",0,4,-4
"10169","1570力肯","110/07/14","元大-忠孝",2,0,2
"10170","1570力肯","110/07/14","第一金-中山",0,3,-3
"10171","2929淘帝","110/07/14","華南永昌-林口",60,0,60
"10172","2929淘帝","110/07/14","群益金鼎",25,540,-515
"10173","2929淘帝","110/07/14","美林",87,31,56
"10174","2929淘帝","110/07/14","國泰-台南",1,30,-29
"10175","2929淘帝","110/07/14","元富-台南",40,0,40
"10176","2929淘帝","110/07/14","宏遠-桃園",0,20,-20
"10177","2929淘帝","110/07/14","元大-民生",39,0,39
"10178","2929淘帝","110/07/14","摩根大通",11,31,-20
"10179","2929淘帝","110/07/14","臺銀-鳳山",34,0,34
"10180","2929淘帝","110/07/14","台新-建北",5,20,-15
"10181","2929淘帝","110/07/14","合庫-高雄",34,1,33
"10182","2929淘帝","110/07/14","新光",1,16,-15
"10183","2929淘帝","110/07/14","華南永昌-鶯歌",28,0,28
"10184","2929淘帝","110/07/14","玉山-板橋",0,15,-15
"10185","2929淘帝","110/07/14","永興",25,0,25
"10186","2929淘帝","110/07/14","凱基-羅東",0,15,-15
"10187","2929淘帝","110/07/14","元大-新盛",25,1,24
"10188","2929淘帝","110/07/14","元大-頭份",0,15,-15
"10189","2929淘帝","110/07/14","日盛-南京",23,0,23
"10190","2929淘帝","110/07/14","第一金-台南",0,13,-13
"10191","2929淘帝","110/07/14","日茂",20,0,20
"10192","2929淘帝","110/07/14","富邦-基隆",0,12,-12
"10193","2929淘帝","110/07/14","台新-台中",20,0,20
"10194","2929淘帝","110/07/14","日茂-南投",1,12,-11
"10195","2929淘帝","110/07/14","華南永昌",20,0,20
"10196","2929淘帝","110/07/14","元大-豐原站前",0,11,-11
"10197","2929淘帝","110/07/14","福勝",15,0,15
"10198","2929淘帝","110/07/14","玉山-士林",0,10,-10
"10199","2929淘帝","110/07/14","富邦-南屯",15,0,15
"10200","2929淘帝","110/07/14","富邦-台北",0,10,-10
"10201","5410國眾","110/07/14","兆豐-城中",35,0,35
"10202","5410國眾","110/07/14","瑞士信貸",0,29,-29
"10203","5410國眾","110/07/14","新光",21,1,20
"10204","5410國眾","110/07/14","國泰-板橋",1,30,-29
"10205","5410國眾","110/07/14","國泰-敦南",21,1,20
"10206","5410國眾","110/07/14","日盛-高雄",0,20,-20
"10207","5410國眾","110/07/14","國泰-台中",20,1,19
"10208","5410國眾","110/07/14","台新-左楠",1,20,-19
"10209","5410國眾","110/07/14","元大-崇德",19,0,19
"10210","5410國眾","110/07/14","元富-大昌",1,18,-17
"10211","5410國眾","110/07/14","土銀-士林",18,0,18
"10212","5410國眾","110/07/14","富邦-建國",0,15,-15
"10213","5410國眾","110/07/14","元大-新盛",20,2,18
"10214","5410國眾","110/07/14","元富-嘉義",0,12,-12
"10215","5410國眾","110/07/14","兆豐-高雄",15,0,15
"10216","5410國眾","110/07/14","永全-南崁",0,12,-12
"10217","5410國眾","110/07/14","宏遠-中和",10,0,10
"10218","5410國眾","110/07/14","元大-員林",0,11,-11
"10219","5410國眾","110/07/14","新光-桃園",10,0,10
"10220","5410國眾","110/07/14","高橋",0,10,-10
"10221","5410國眾","110/07/14","國泰-台南",10,0,10
"10222","5410國眾","110/07/14","永興",0,10,-10
"10223","5410國眾","110/07/14","元大-復北",10,0,10
"10224","5410國眾","110/07/14","華南永昌-三重",0,10,-10
"10225","5410國眾","110/07/14","元大-竹科",8,0,8
"10226","5410國眾","110/07/14","元大-苑裡",0,7,-7
"10227","5410國眾","110/07/14","台新-新營",6,0,6
"10228","5410國眾","110/07/14","港商野村",0,6,-6
"10229","5410國眾","110/07/14","日盛-士林",5,0,5
"10230","5410國眾","110/07/14","摩根大通",5,11,-6
"10231","2841台開","110/07/14","凱基-文心",73,0,73
"10232","2841台開","110/07/14","國泰-敦南",0,50,-50
"10233","2841台開","110/07/14","元富-潮州",30,0,30
"10234","2841台開","110/07/14","凱基-中壢",0,40,-40
"10235","2841台開","110/07/14","第一金-台中",20,0,20
"10236","2841台開","110/07/14","統一-新竹",0,24,-24
"10237","2841台開","110/07/14","華南永昌-新莊",20,0,20
"10238","2841台開","110/07/14","元富-草屯",0,20,-20
"10239","2841台開","110/07/14","永豐金-豐原",20,0,20
"10240","2841台開","110/07/14","台新-台南",0,20,-20
"10241","2841台開","110/07/14","國泰-館前",15,0,15
"10242","2841台開","110/07/14","永豐金-敦南",45,63,-18
"10243","2841台開","110/07/14","群益金鼎-基隆",12,0,12
"10244","2841台開","110/07/14","國票-北高雄",0,13,-13
"10245","2841台開","110/07/14","日盛-信義",10,0,10
"10246","2841台開","110/07/14","凱基-松山",0,10,-10
"10247","2841台開","110/07/14","台新-台中",10,0,10
"10248","2841台開","110/07/14","元大證券",0,10,-10
"10249","2841台開","110/07/14","新光",10,1,9
"10250","2841台開","110/07/14","元大-中壢",0,10,-10
"10251","2841台開","110/07/14","凱基-新店",8,0,8
"10252","2841台開","110/07/14","富邦-陽明",1,10,-9
"10253","2841台開","110/07/14","元大-斗信",7,0,7
"10254","2841台開","110/07/14","富邦-建國",0,9,-9
"10255","2841台開","110/07/14","元大-三重",6,0,6
"10256","2841台開","110/07/14","富邦-台南",0,8,-8
"10257","2841台開","110/07/14","永豐金-中和",6,0,6
"10258","2841台開","110/07/14","康和-澎湖",0,7,-7
"10259","2841台開","110/07/14","元富-成功",5,0,5
"10260","2841台開","110/07/14","日盛-斗六",0,6,-6
"10261","6207雷科","110/07/14","群益金鼎-台北",60,0,60
"10262","6207雷科","110/07/14","新加坡商瑞銀",10,56,-46
"10263","6207雷科","110/07/14","台新-高雄",43,3,40
"10264","6207雷科","110/07/14","國票-中和",0,41,-41
"10265","6207雷科","110/07/14","元大-高雄",19,0,19
"10266","6207雷科","110/07/14","元大-復北",0,33,-33
"10267","6207雷科","110/07/14","福勝",15,0,15
"10268","6207雷科","110/07/14","光和-和美",0,20,-20
"10269","6207雷科","110/07/14","群益金鼎-中山",15,0,15
"10270","6207雷科","110/07/14","群益金鼎-丹鳳",0,20,-20
"10271","6207雷科","110/07/14","元大-林園",15,0,15
"10272","6207雷科","110/07/14","第一金-路竹",0,10,-10
"10273","6207雷科","110/07/14","新光",12,0,12
"10274","6207雷科","110/07/14","元大-歸仁",0,10,-10
"10275","6207雷科","110/07/14","元大-大天母",10,0,10
"10276","6207雷科","110/07/14","宏遠-館前",0,9,-9
"10277","6207雷科","110/07/14","永豐金-忠孝",9,0,9
"10278","6207雷科","110/07/14","凱基-台北",12,20,-8
"10279","6207雷科","110/07/14","永豐金-新店",7,0,7
"10280","6207雷科","110/07/14","美林",0,7,-7
"10281","6207雷科","110/07/14","玉山-嘉義",6,0,6
"10282","6207雷科","110/07/14","摩根大通",16,23,-7
"10283","6207雷科","110/07/14","元大-屏東",6,0,6
"10284","6207雷科","110/07/14","凱基-高雄",1,7,-6
"10285","6207雷科","110/07/14","凱基-大安",5,0,5
"10286","6207雷科","110/07/14","台中銀-豐原",0,5,-5
"10287","6207雷科","110/07/14","富邦-台南",5,0,5
"10288","6207雷科","110/07/14","元大-新竹經國",0,5,-5
"10289","6207雷科","110/07/14","元大-成功",5,0,5
"10290","6207雷科","110/07/14","光和-田中",0,4,-4
"10291","3679新至陞","110/07/14","凱基-台北",31,6,25
"10292","3679新至陞","110/07/14","群益金鼎-東大",0,15,-15
"10293","3679新至陞","110/07/14","華南永昌-新莊",10,0,10
"10294","3679新至陞","110/07/14","瑞士信貸",0,12,-12
"10295","3679新至陞","110/07/14","新加坡商瑞銀",11,3,8
"10296","3679新至陞","110/07/14","群益金鼎-永和",0,10,-10
"10297","3679新至陞","110/07/14","美商高盛",6,0,6
"10298","3679新至陞","110/07/14","元大-成功",5,15,-10
"10299","3679新至陞","110/07/14","第一金-中壢",6,0,6
"10300","3679新至陞","110/07/14","統一-板橋",1,10,-9
"10301","3679新至陞","110/07/14","(牛牛牛)亞-網路",4,0,4
"10302","3679新至陞","110/07/14","玉山-左營",0,5,-5
"10303","3679新至陞","110/07/14","元大-六合",3,0,3
"10304","3679新至陞","110/07/14","群益金鼎-三民",0,4,-4
"10305","3679新至陞","110/07/14","合庫-自強",2,0,2
"10306","3679新至陞","110/07/14","富邦-宜蘭",0,4,-4
"10307","3679新至陞","110/07/14","高橋-內壢",2,0,2
"10308","3679新至陞","110/07/14","永豐金-苓雅",0,3,-3
"10309","3679新至陞","110/07/14","台中銀-員林",2,0,2
"10310","3679新至陞","110/07/14","摩根大通",5,7,-2
"10311","3679新至陞","110/07/14","凱基-高美館",2,0,2
"10312","3679新至陞","110/07/14","元大-板橋三民",0,2,-2
"10313","3679新至陞","110/07/14","元大-福營",2,0,2
"10314","3679新至陞","110/07/14","宏遠-中和",0,1,-1
"10315","3679新至陞","110/07/14","永豐金-松山",2,0,2
"10316","3679新至陞","110/07/14","元富-佳里",0,1,-1
"10317","3679新至陞","110/07/14","永豐金-萬盛",2,0,2
"10318","3679新至陞","110/07/14","(牛牛牛)亞-鑫豐",0,1,-1
"10319","3679新至陞","110/07/14","元富-松德",1,0,1
"10320","3679新至陞","110/07/14","中國信託-中壢",0,1,-1
"10321","2727王品","110/07/14","富邦-左營",102,1,101
"10322","2727王品","110/07/14","統一-城中",100,234,-134
"10323","2727王品","110/07/14","國泰-板橋",105,11,94
"10324","2727王品","110/07/14","富邦-台北",1,125,-124
"10325","2727王品","110/07/14","港商野村",149,72,77
"10326","2727王品","110/07/14","台灣摩根士丹利",1,48,-47
"10327","2727王品","110/07/14","合庫-台中",66,2,64
"10328","2727王品","110/07/14","國票-新莊",0,40,-40
"10329","2727王品","110/07/14","臺銀-金山",63,8,55
"10330","2727王品","110/07/14","永豐金-忠孝",2,39,-37
"10331","2727王品","110/07/14","摩根大通",83,39,44
"10332","2727王品","110/07/14","富邦-彰化",1,34,-33
"10333","2727王品","110/07/14","凱基-台北",84,42,42
"10334","2727王品","110/07/14","康和-高雄",0,30,-30
"10335","2727王品","110/07/14","土銀-台中",35,1,34
"10336","2727王品","110/07/14","安泰",0,26,-26
"10337","2727王品","110/07/14","華南永昌-麻豆",32,1,31
"10338","2727王品","110/07/14","富邦-新竹華信",0,21,-21
"10339","2727王品","110/07/14","元大證券",85,55,30
"10340","2727王品","110/07/14","元大-南崁",1,22,-21
"10341","2727王品","110/07/14","新加坡商瑞銀",40,15,25
"10342","2727王品","110/07/14","彰銀-台中",0,18,-18
"10343","2727王品","110/07/14","日盛-八德",19,0,19
"10344","2727王品","110/07/14","元富-同大",2,20,-18
"10345","2727王品","110/07/14","統一",35,17,18
"10346","2727王品","110/07/14","玉山-嘉義",1,17,-16
"10347","2727王品","110/07/14","元富-大昌",18,1,17
"10348","2727王品","110/07/14","國泰-館前",4,20,-16
"10349","2727王品","110/07/14","玉山-板橋",15,1,14
"10350","2727王品","110/07/14","第一金-嘉義",1,13,-12
"10351","1570力肯","110/07/14","國票-北高雄",68,0,68
"10352","1570力肯","110/07/14","摩根大通",0,21,-21
"10353","1570力肯","110/07/14","日盛-八德",30,1,29
"10354","1570力肯","110/07/14","新光",1,19,-18
"10355","1570力肯","110/07/14","玉山-高雄",7,0,7
"10356","1570力肯","110/07/14","(牛牛牛)亞-鑫豐",0,17,-17
"10357","1570力肯","110/07/14","臺銀-臺南",5,0,5
"10358","1570力肯","110/07/14","日盛-士林",0,10,-10
"10359","1570力肯","110/07/14","凱基-三峽",5,0,5
"10360","1570力肯","110/07/14","統一-員林",0,10,-10
"10361","1570力肯","110/07/14","元大-和平",5,0,5
"10362","1570力肯","110/07/14","國票-新莊",0,10,-10
"10363","1570力肯","110/07/14","合庫-三重",4,0,4
"10364","1570力肯","110/07/14","凱基-高美館",0,10,-10
"10365","1570力肯","110/07/14","瑞士信貸",4,0,4
"10366","1570力肯","110/07/14","元大-屏東民生",0,5,-5
"10367","1570力肯","110/07/14","統一-三多",4,0,4
"10368","1570力肯","110/07/14","元大-古亭",0,5,-5
"10369","1570力肯","110/07/14","華南永昌-古亭",4,0,4
"10370","1570力肯","110/07/14","日盛-木柵",0,4,-4
"10371","1570力肯","110/07/14","元大-高雄",3,0,3
"10372","1570力肯","110/07/14","大昌",0,4,-4
"10373","1570力肯","110/07/14","兆豐-忠孝",2,0,2
"10374","1570力肯","110/07/14","群益金鼎-東大",0,4,-4
"10375","1570力肯","110/07/14","富邦-陽明",2,0,2
"10376","1570力肯","110/07/14","凱基-台北",0,4,-4
"10377","1570力肯","110/07/14","元大-松山",2,0,2
"10378","1570力肯","110/07/14","元大-板橋",0,4,-4
"10379","1570力肯","110/07/14","元大-忠孝",2,0,2
"10380","1570力肯","110/07/14","第一金-中山",0,3,-3
"10381","6180橘子","110/07/14","新加坡商瑞銀",84,28,56
"10382","6180橘子","110/07/14","凱基-台北",4,37,-33
"10383","6180橘子","110/07/14","日盛-信義",29,1,28
"10384","6180橘子","110/07/14","玉山-台南",1,22,-21
"10385","6180橘子","110/07/14","豐農",28,4,24
"10386","6180橘子","110/07/14","日盛-新竹",1,21,-20
"10387","6180橘子","110/07/14","新光-新竹",24,1,23
"10388","6180橘子","110/07/14","元富-潮州",0,19,-19
"10389","6180橘子","110/07/14","華南永昌-高雄",20,0,20
"10390","6180橘子","110/07/14","元大-信義",0,17,-17
"10391","6180橘子","110/07/14","元大-羅東",20,0,20
"10392","6180橘子","110/07/14","台灣企銀-台中",1,16,-15
"10393","6180橘子","110/07/14","元大-台中中港",20,0,20
"10394","6180橘子","110/07/14","元大-北港",0,15,-15
"10395","6180橘子","110/07/14","富邦-嘉義",24,5,19
"10396","6180橘子","110/07/14","富邦-高雄",0,14,-14
"10397","6180橘子","110/07/14","富邦-仁愛",15,0,15
"10398","6180橘子","110/07/14","兆豐-埔墘",0,13,-13
"10399","6180橘子","110/07/14","國票-九鼎",13,0,13
"10400","6180橘子","110/07/14","第一金-中山",0,10,-10
"10401","6180橘子","110/07/14","日盛-木柵",12,0,12
"10402","6180橘子","110/07/14","元大-彰化民生",0,10,-10
"10403","6180橘子","110/07/14","元大-成功",10,0,10
"10404","6180橘子","110/07/14","福勝",1,10,-9
"10405","6180橘子","110/07/14","港商野村",10,2,8
"10406","6180橘子","110/07/14","群益金鼎-丹鳳",1,10,-9
"10407","6180橘子","110/07/14","玉山-左營",8,0,8
"10408","6180橘子","110/07/14","群益金鼎-板橋",0,8,-8
"10409","6180橘子","110/07/14","富邦-陽明",16,8,8
"10410","6180橘子","110/07/14","合庫-鳳山",0,7,-7
"10411","2390云辰","110/07/14","摩根大通",995,198,797
"10412","2390云辰","110/07/14","新加坡商瑞銀",28,399,-371
"10413","2390云辰","110/07/14","美林",383,22,361
"10414","2390云辰","110/07/14","凱基-新豐",3,198,-195
"10415","2390云辰","110/07/14","台灣摩根士丹利",684,358,326
"10416","2390云辰","110/07/14","元大-士林",1,152,-151
"10417","2390云辰","110/07/14","凱基-台北",656,402,254
"10418","2390云辰","110/07/14","元大-竹山",80,181,-101
"10419","2390云辰","110/07/14","日盛-和美",110,5,105
"10420","2390云辰","110/07/14","群益金鼎-開元",19,95,-76
"10421","2390云辰","110/07/14","元大-天母",72,0,72
"10422","2390云辰","110/07/14","新光",77,150,-73
"10423","2390云辰","110/07/14","永豐金-松山",57,0,57
"10424","2390云辰","110/07/14","元富-高雄",0,71,-71
"10425","2390云辰","110/07/14","統一-屏東",53,0,53
"10426","2390云辰","110/07/14","元大-土城學府",130,201,-71
"10427","2390云辰","110/07/14","港商野村",486,450,36
"10428","2390云辰","110/07/14","元大-善化",12,76,-64
"10429","2390云辰","110/07/14","致和-崇德",30,0,30
"10430","2390云辰","110/07/14","華南永昌-岡山",23,81,-58
"10431","2390云辰","110/07/14","富邦-台北",40,14,26
"10432","2390云辰","110/07/14","群益金鼎-大興",82,125,-43
"10433","2390云辰","110/07/14","台新-高雄",38,13,25
"10434","2390云辰","110/07/14","大慶-中壢",0,41,-41
"10435","2390云辰","110/07/14","富邦-板橋",32,7,25
"10436","2390云辰","110/07/14","玉山-板橋",6,47,-41
"10437","2390云辰","110/07/14","陽信-石牌",24,0,24
"10438","2390云辰","110/07/14","富邦-台東",2,42,-40
"10439","2390云辰","110/07/14","凱基-屏東",32,8,24
"10440","2390云辰","110/07/14","元大-新營",3,42,-39
"10441","2363矽統","110/07/13","凱基-南崁",2133,63,2070
"10442","2363矽統","110/07/13","凱基-幸福",36,4048,-4012
"10443","2363矽統","110/07/13","國泰-敦南",2195,1617,578
"10444","2363矽統","110/07/13","統一",192,3325,-3133
"10445","2363矽統","110/07/13","中農",670,139,531
"10446","2363矽統","110/07/13","新加坡商瑞銀",1000,2747,-1747
"10447","2363矽統","110/07/13","康和-台中",638,154,484
"10448","2363矽統","110/07/13","凱基-台北",5359,6609,-1250
"10449","2363矽統","110/07/13","群益金鼎-三民",577,137,440
"10450","2363矽統","110/07/13","摩根大通",1930,2858,-928
"10451","2363矽統","110/07/13","台新-屏東",510,88,422
"10452","2363矽統","110/07/13","港商野村",960,1679,-719
"10453","2363矽統","110/07/13","德信-中正",455,67,388
"10454","2363矽統","110/07/13","兆豐-復興",25,705,-680
"10455","2363矽統","110/07/13","日盛-竹北",365,70,295
"10456","2363矽統","110/07/13","統一-仁愛",114,755,-641
"10457","2363矽統","110/07/13","元大-佳里",452,189,263
"10458","2363矽統","110/07/13","統一-敦南",29,638,-609
"10459","2363矽統","110/07/13","國票-博愛",296,38,258
"10460","2363矽統","110/07/13","統一-土城",100,704,-604
"10461","2363矽統","110/07/13","元大-萬華",340,95,245
"10462","2363矽統","110/07/13","統一-城中",116,676,-560
"10463","2363矽統","110/07/13","新光",1259,1031,228
"10464","2363矽統","110/07/13","永豐金證券",306,859,-553
"10465","2363矽統","110/07/13","元富-成功",323,96,227
"10466","2363矽統","110/07/13","元富",54,567,-513
"10467","2363矽統","110/07/13","豐農",228,23,205
"10468","2363矽統","110/07/13","瑞士信貸",202,666,-464
"10469","2363矽統","110/07/13","台灣企銀-岡山",186,4,182
"10470","2363矽統","110/07/13","永豐金-嘉義",67,468,-401
"10471","8112至上","110/07/13","摩根大通",688,296,392
"10472","8112至上","110/07/13","國票-中和",0,401,-401
"10473","8112至上","110/07/13","港商野村",344,145,199
"10474","8112至上","110/07/13","永豐金-板盛",0,205,-205
"10475","8112至上","110/07/13","兆豐-公益",195,5,190
"10476","8112至上","110/07/13","凱基-五股",43,155,-112
"10477","8112至上","110/07/13","台灣摩根士丹利",183,0,183
"10478","8112至上","110/07/13","凱基-市政",0,100,-100
"10479","8112至上","110/07/13","群益金鼎-敦南",153,2,151
"10480","8112至上","110/07/13","元大-大里德芳",1,92,-91
"10481","8112至上","110/07/13","臺銀-金山",146,26,120
"10482","8112至上","110/07/13","玉山-桃園",26,110,-84
"10483","8112至上","110/07/13","臺銀",133,19,114
"10484","8112至上","110/07/13","兆豐-天母",0,81,-81
"10485","8112至上","110/07/13","合庫-台中",115,6,109
"10486","8112至上","110/07/13","凱基-城中",3,84,-81
"10487","8112至上","110/07/13","亞東-板橋",134,26,108
"10488","8112至上","110/07/13","日盛-新莊",9,85,-76
"10489","8112至上","110/07/13","凱基-台北",414,326,88
"10490","8112至上","110/07/13","日盛-台中",2,64,-62
"10491","8112至上","110/07/13","新加坡商瑞銀",181,100,81
"10492","8112至上","110/07/13","日盛-中壢",3,64,-61
"10493","8112至上","110/07/13","國泰-敦南",108,31,77
"10494","8112至上","110/07/13","元大-台中",2,59,-57
"10495","8112至上","110/07/13","第一金-華江",77,4,73
"10496","8112至上","110/07/13","元大-雙和",7,64,-57
"10497","8112至上","110/07/13","永豐金-內湖",73,1,72
"10498","8112至上","110/07/13","元大-高雄",8,62,-54
"10499","8112至上","110/07/13","元大-永和",68,1,67
"10500","8112至上","110/07/13","元大-館前",2,55,-53
"10501","1570力肯","110/07/13","新光",115,11,104
"10502","1570力肯","110/07/13","元大-北三重",0,162,-162
"10503","1570力肯","110/07/13","群益金鼎-高雄",54,0,54
"10504","1570力肯","110/07/13","元大-大灣",0,25,-25
"10505","1570力肯","110/07/13","國票-新莊",22,0,22
"10506","1570力肯","110/07/13","永豐金-苓雅",0,22,-22
"10507","1570力肯","110/07/13","日盛-桃園",12,0,12
"10508","1570力肯","110/07/13","永豐金-永康",0,19,-19
"10509","1570力肯","110/07/13","元大-高雄",12,0,12
"10510","1570力肯","110/07/13","富邦-員林",0,15,-15
"10511","1570力肯","110/07/13","合庫-自強",11,0,11
"10512","1570力肯","110/07/13","凱基-台南",0,11,-11
"10513","1570力肯","110/07/13","摩根大通",26,15,11
"10514","1570力肯","110/07/13","日盛-竹北",0,10,-10
"10515","1570力肯","110/07/13","永豐金-中盛",11,0,11
"10516","1570力肯","110/07/13","國票-九鼎",0,10,-10
"10517","1570力肯","110/07/13","兆豐-台中港",10,0,10
"10518","1570力肯","110/07/13","凱基-桃園",0,10,-10
"10519","1570力肯","110/07/13","國泰-松江",9,0,9
"10520","1570力肯","110/07/13","凱基-新豐",0,10,-10
"10521","1570力肯","110/07/13","元大-新盛",9,0,9
"10522","1570力肯","110/07/13","元大-學甲",0,10,-10
"10523","1570力肯","110/07/13","元富-緯城",6,0,6
"10524","1570力肯","110/07/13","群益金鼎-東湖",1,10,-9
"10525","1570力肯","110/07/13","統一-三重",5,0,5
"10526","1570力肯","110/07/13","大昌",0,6,-6
"10527","1570力肯","110/07/13","元大-前金",5,0,5
"10528","1570力肯","110/07/13","元大-土城學府",0,6,-6
"10529","1570力肯","110/07/13","永豐金證券",5,0,5
"10530","1570力肯","110/07/13","統一",0,5,-5
"10531","2929淘帝","110/07/13","玉山-新竹",130,0,130
"10532","2929淘帝","110/07/13","美商高盛",0,177,-177
"10533","2929淘帝","110/07/13","臺銀-民權",60,0,60
"10534","2929淘帝","110/07/13","凱基-台北",6,80,-74
"10535","2929淘帝","110/07/13","新百王",31,0,31
"10536","2929淘帝","110/07/13","元富-大裕",0,49,-49
"10537","2929淘帝","110/07/13","日盛-園區",30,0,30
"10538","2929淘帝","110/07/13","國泰-館前",3,51,-48
"10539","2929淘帝","110/07/13","元大-南投",31,1,30
"10540","2929淘帝","110/07/13","凱基-中壢",0,41,-41
"10541","2929淘帝","110/07/13","兆豐-忠孝",28,0,28
"10542","2929淘帝","110/07/13","港商野村",21,55,-34
"10543","2929淘帝","110/07/13","元大-民生",28,0,28
"10544","2929淘帝","110/07/13","華南永昌-南京",2,34,-32
"10545","2929淘帝","110/07/13","合庫-高雄",27,0,27
"10546","2929淘帝","110/07/13","群益金鼎-土城",0,30,-30
"10547","2929淘帝","110/07/13","凱基-豐中",27,0,27
"10548","2929淘帝","110/07/13","富邦-南屯",0,22,-22
"10549","2929淘帝","110/07/13","新光",21,4,17
"10550","2929淘帝","110/07/13","第一金-豐原",0,20,-20
"10551","2929淘帝","110/07/13","元大-天母",17,0,17
"10552","2929淘帝","110/07/13","元大-屏南",6,26,-20
"10553","2929淘帝","110/07/13","永興",14,0,14
"10554","2929淘帝","110/07/13","永豐金-敦南",1,21,-20
"10555","2929淘帝","110/07/13","富邦-台北",12,0,12
"10556","2929淘帝","110/07/13","凱基-三重",2,21,-19
"10557","2929淘帝","110/07/13","元大-永和",12,0,12
"10558","2929淘帝","110/07/13","富邦-仁愛",7,25,-18
"10559","2929淘帝","110/07/13","國票-天祥",11,0,11
"10560","2929淘帝","110/07/13","元大-北投",0,16,-16
"10561","5410國眾","110/07/13","兆豐-城中",274,0,274
"10562","5410國眾","110/07/13","元富-嘉義",0,103,-103
"10563","5410國眾","110/07/13","新光",50,4,46
"10564","5410國眾","110/07/13","凱基-台北",0,50,-50
"10565","5410國眾","110/07/13","國泰-台中",26,0,26
"10566","5410國眾","110/07/13","瑞士信貸",0,31,-31
"10567","5410國眾","110/07/13","新加坡商瑞銀",22,0,22
"10568","5410國眾","110/07/13","台新-新莊",0,27,-27
"10569","5410國眾","110/07/13","光和-嘉義",20,0,20
"10570","5410國眾","110/07/13","元大-汐止",0,20,-20
"10571","5410國眾","110/07/13","凱基-竹北",17,0,17
"10572","5410國眾","110/07/13","亞東-新竹",0,17,-17
"10573","5410國眾","110/07/13","新光-桃園",15,0,15
"10574","5410國眾","110/07/13","元大-南勢角",0,13,-13
"10575","5410國眾","110/07/13","凱基-台東",14,0,14
"10576","5410國眾","110/07/13","台新-台南",0,12,-12
"10577","5410國眾","110/07/13","富邦-竹北",11,0,11
"10578","5410國眾","110/07/13","中國信託",0,11,-11
"10579","5410國眾","110/07/13","元富-同大",10,0,10
"10580","5410國眾","110/07/13","華南永昌",0,11,-11
"10581","5410國眾","110/07/13","國泰-敦南",24,15,9
"10582","5410國眾","110/07/13","臺銀-臺南",0,10,-10
"10583","5410國眾","110/07/13","日盛-內湖",7,0,7
"10584","5410國眾","110/07/13","台灣企銀-民雄",0,10,-10
"10585","5410國眾","110/07/13","台新-左楠",7,0,7
"10586","5410國眾","110/07/13","高橋",0,10,-10
"10587","5410國眾","110/07/13","元大-新盛",18,12,6
"10588","5410國眾","110/07/13","康和-嘉義",0,10,-10
"10589","5410國眾","110/07/13","統一",5,0,5
"10590","5410國眾","110/07/13","凱基-基隆",0,10,-10
"10591","2841台開","110/07/13","中國信託-高雄",251,50,201
"10592","2841台開","110/07/13","兆豐-公益",0,177,-177
"10593","2841台開","110/07/13","日盛證券",210,13,197
"10594","2841台開","110/07/13","日進",0,152,-152
"10595","2841台開","110/07/13","第一金-台中",55,0,55
"10596","2841台開","110/07/13","港商野村",0,109,-109
"10597","2841台開","110/07/13","國泰-板橋",46,0,46
"10598","2841台開","110/07/13","日盛-信義",0,103,-103
"10599","2841台開","110/07/13","國泰-館前",48,3,45
"10600","2841台開","110/07/13","國泰-敦南",11,75,-64
"10601","2841台開","110/07/13","華南永昌-新莊",45,0,45
"10602","2841台開","110/07/13","永興",0,50,-50
"10603","2841台開","110/07/13","日盛-園區",42,0,42
"10604","2841台開","110/07/13","永豐金-敦南",61,104,-43
"10605","2841台開","110/07/13","台新證券",32,0,32
"10606","2841台開","110/07/13","富邦-台南",0,42,-42
"10607","2841台開","110/07/13","台新-高雄",32,2,30
"10608","2841台開","110/07/13","國票-安和",0,30,-30
"10609","2841台開","110/07/13","豐農",23,0,23
"10610","2841台開","110/07/13","元大-桃園",0,25,-25
"10611","2841台開","110/07/13","合庫-嘉義",20,0,20
"10612","2841台開","110/07/13","新光",8,32,-24
"10613","2841台開","110/07/13","華南永昌-高雄",20,0,20
"10614","2841台開","110/07/13","元大-仁愛",0,24,-24
"10615","2841台開","110/07/13","元大-樹林",16,0,16
"10616","2841台開","110/07/13","日盛-中和",0,20,-20
"10617","2841台開","110/07/13","第一金-華江",15,2,13
"10618","2841台開","110/07/13","元富",0,20,-20
"10619","2841台開","110/07/13","美商高盛",12,0,12
"10620","2841台開","110/07/13","富邦-宜蘭",0,20,-20
"10621","6207雷科","110/07/13","元大-高雄",121,0,121
"10622","6207雷科","110/07/13","華南永昌-朴子",1,60,-59
"10623","6207雷科","110/07/13","第一金-新興",20,0,20
"10624","6207雷科","110/07/13","元大-南海",0,36,-36
"10625","6207雷科","110/07/13","元富-三重",20,0,20
"10626","6207雷科","110/07/13","凱基-土城",0,35,-35
"10627","6207雷科","110/07/13","元大-林園",15,0,15
"10628","6207雷科","110/07/13","台灣企銀",0,20,-20
"10629","6207雷科","110/07/13","元大-金華",16,1,15
"10630","6207雷科","110/07/13","群益金鼎-丹鳳",0,20,-20
"10631","6207雷科","110/07/13","日盛證券",10,0,10
"10632","6207雷科","110/07/13","元大-博愛",0,17,-17
"10633","6207雷科","110/07/13","統一-台中",10,0,10
"10634","6207雷科","110/07/13","元大-北港",0,13,-13
"10635","6207雷科","110/07/13","群益金鼎-土城",10,0,10
"10636","6207雷科","110/07/13","新加坡商瑞銀",0,12,-12
"10637","6207雷科","110/07/13","群益金鼎-桃園",10,0,10
"10638","6207雷科","110/07/13","凱基-台北",4,16,-12
"10639","6207雷科","110/07/13","永豐金-新莊",10,0,10
"10640","6207雷科","110/07/13","日茂-埔里",0,11,-11
"10641","6207雷科","110/07/13","永豐金-新店",10,0,10
"10642","6207雷科","110/07/13","元大-莒光",0,11,-11
"10643","6207雷科","110/07/13","元大證券",9,0,9
"10644","6207雷科","110/07/13","統一-新竹",0,10,-10
"10645","6207雷科","110/07/13","日盛-木柵",9,1,8
"10646","6207雷科","110/07/13","元大-西螺",0,10,-10
"10647","6207雷科","110/07/13","兆豐-來福",8,0,8
"10648","6207雷科","110/07/13","康和-台中",0,8,-8
"10649","6207雷科","110/07/13","新光",7,0,7
"10650","6207雷科","110/07/13","兆豐-高雄",0,6,-6
"10651","3679新至陞","110/07/13","永豐金證券",50,0,50
"10652","3679新至陞","110/07/13","摩根大通",2,25,-23
"10653","3679新至陞","110/07/13","國泰-桃園",22,0,22
"10654","3679新至陞","110/07/13","元大-成功",0,22,-22
"10655","3679新至陞","110/07/13","台中銀-員林",11,0,11
"10656","3679新至陞","110/07/13","富邦-板橋",1,19,-18
"10657","3679新至陞","110/07/13","元大-文心興安",8,0,8
"10658","3679新至陞","110/07/13","日盛-新莊",0,10,-10
"10659","3679新至陞","110/07/13","美商高盛",6,0,6
"10660","3679新至陞","110/07/13","台新-台中",0,10,-10
"10661","3679新至陞","110/07/13","台新-高雄",6,0,6
"10662","3679新至陞","110/07/13","永豐金-新竹",0,8,-8
"10663","3679新至陞","110/07/13","凱基-台北",18,12,6
"10664","3679新至陞","110/07/13","瑞士信貸",12,19,-7
"10665","3679新至陞","110/07/13","日盛-復興",5,0,5
"10666","3679新至陞","110/07/13","統一-南京",0,7,-7
"10667","3679新至陞","110/07/13","(牛牛牛)亞-鑫豐",4,0,4
"10668","3679新至陞","110/07/13","凱基-新莊",0,7,-7
"10669","3679新至陞","110/07/13","元富-大昌",3,0,3
"10670","3679新至陞","110/07/13","新加坡商瑞銀",0,6,-6
"10671","3679新至陞","110/07/13","富邦-台北",3,0,3
"10672","3679新至陞","110/07/13","合庫-自強",0,5,-5
"10673","3679新至陞","110/07/13","日盛-樹林",2,0,2
"10674","3679新至陞","110/07/13","富邦-桃園",0,5,-5
"10675","3679新至陞","110/07/13","宏遠-光隆",2,0,2
"10676","3679新至陞","110/07/13","永豐金-潮州",0,4,-4
"10677","3679新至陞","110/07/13","美林",3,1,2
"10678","3679新至陞","110/07/13","臺銀-臺南",0,3,-3
"10679","3679新至陞","110/07/13","第一金-中壢",2,0,2
"10680","3679新至陞","110/07/13","元大-六合",0,3,-3
"10681","2727王品","110/07/13","富邦-台北",43,3,40
"10682","2727王品","110/07/13","台灣摩根士丹利",15,97,-82
"10683","2727王品","110/07/13","元大-基隆孝二",40,0,40
"10684","2727王品","110/07/13","玉山-台南",5,57,-52
"10685","2727王品","110/07/13","國票-新莊",40,1,39
"10686","2727王品","110/07/13","新加坡商瑞銀",0,48,-48
"10687","2727王品","110/07/13","第一金-豐原",66,42,24
"10688","2727王品","110/07/13","凱基-台北",41,77,-36
"10689","2727王品","110/07/13","永豐金-大園",34,10,24
"10690","2727王品","110/07/13","永豐金-永康",0,22,-22
"10691","2727王品","110/07/13","元大-北屯",22,0,22
"10692","2727王品","110/07/13","統一-台中",2,22,-20
"10693","2727王品","110/07/13","元大-東蘆",26,7,19
"10694","2727王品","110/07/13","國泰-台中",21,39,-18
"10695","2727王品","110/07/13","永豐金-萬盛",13,1,12
"10696","2727王品","110/07/13","合庫-彰化",3,20,-17
"10697","2727王品","110/07/13","日盛-嘉義",11,0,11
"10698","2727王品","110/07/13","港商野村",13,30,-17
"10699","2727王品","110/07/13","日盛-八德",11,0,11
"10700","2727王品","110/07/13","元大-楊梅",1,16,-15
"10701","2727王品","110/07/13","統一-竹南",11,0,11
"10702","2727王品","110/07/13","凱基-高美館",2,15,-13
"10703","2727王品","110/07/13","日盛-士林",12,2,10
"10704","2727王品","110/07/13","美商高盛",2,14,-12
"10705","2727王品","110/07/13","統一-敦南",10,0,10
"10706","2727王品","110/07/13","統一-平鎮",1,13,-12
"10707","2727王品","110/07/13","中國信託",15,5,10
"10708","2727王品","110/07/13","兆豐-台中港",4,16,-12
"10709","2727王品","110/07/13","兆豐-竹北",13,3,10
"10710","2727王品","110/07/13","凱基-八德",1,13,-12
"10711","1570力肯","110/07/13","新光",115,11,104
"10712","1570力肯","110/07/13","元大-北三重",0,162,-162
"10713","1570力肯","110/07/13","群益金鼎-高雄",54,0,54
"10714","1570力肯","110/07/13","元大-大灣",0,25,-25
"10715","1570力肯","110/07/13","國票-新莊",22,0,22
"10716","1570力肯","110/07/13","永豐金-苓雅",0,22,-22
"10717","1570力肯","110/07/13","日盛-桃園",12,0,12
"10718","1570力肯","110/07/13","永豐金-永康",0,19,-19
"10719","1570力肯","110/07/13","元大-高雄",12,0,12
"10720","1570力肯","110/07/13","富邦-員林",0,15,-15
"10721","1570力肯","110/07/13","合庫-自強",11,0,11
"10722","1570力肯","110/07/13","凱基-台南",0,11,-11
"10723","1570力肯","110/07/13","摩根大通",26,15,11
"10724","1570力肯","110/07/13","日盛-竹北",0,10,-10
"10725","1570力肯","110/07/13","永豐金-中盛",11,0,11
"10726","1570力肯","110/07/13","國票-九鼎",0,10,-10
"10727","1570力肯","110/07/13","兆豐-台中港",10,0,10
"10728","1570力肯","110/07/13","凱基-桃園",0,10,-10
"10729","1570力肯","110/07/13","國泰-松江",9,0,9
"10730","1570力肯","110/07/13","凱基-新豐",0,10,-10
"10731","1570力肯","110/07/13","元大-新盛",9,0,9
"10732","1570力肯","110/07/13","元大-學甲",0,10,-10
"10733","1570力肯","110/07/13","元富-緯城",6,0,6
"10734","1570力肯","110/07/13","群益金鼎-東湖",1,10,-9
"10735","1570力肯","110/07/13","統一-三重",5,0,5
"10736","1570力肯","110/07/13","大昌",0,6,-6
"10737","1570力肯","110/07/13","元大-前金",5,0,5
"10738","1570力肯","110/07/13","元大-土城學府",0,6,-6
"10739","1570力肯","110/07/13","永豐金證券",5,0,5
"10740","1570力肯","110/07/13","統一",0,5,-5
"10741","6180橘子","110/07/13","摩根大通",119,0,119
"10742","6180橘子","110/07/13","元大-崇德",2,61,-59
"10743","6180橘子","110/07/13","美商高盛",96,0,96
"10744","6180橘子","110/07/13","康和-台中",0,51,-51
"10745","6180橘子","110/07/13","新加坡商瑞銀",86,7,79
"10746","6180橘子","110/07/13","康和-台北",0,50,-50
"10747","6180橘子","110/07/13","元大-和平",40,0,40
"10748","6180橘子","110/07/13","元富-潮州",0,40,-40
"10749","6180橘子","110/07/13","凱基-台北",83,47,36
"10750","6180橘子","110/07/13","日盛-永康",0,26,-26
"10751","6180橘子","110/07/13","美林",39,5,34
"10752","6180橘子","110/07/13","永豐金-中正",0,24,-24
"10753","6180橘子","110/07/13","富邦-新竹華信",31,2,29
"10754","6180橘子","110/07/13","國泰-板橋",2,25,-23
"10755","6180橘子","110/07/13","統一-南京",21,0,21
"10756","6180橘子","110/07/13","日盛-大墩",0,20,-20
"10757","6180橘子","110/07/13","富邦-陽明",24,3,21
"10758","6180橘子","110/07/13","元大-草屯",13,32,-19
"10759","6180橘子","110/07/13","大昌-樹林",21,1,20
"10760","6180橘子","110/07/13","元富-林園",1,18,-17
"10761","6180橘子","110/07/13","花旗環球",19,0,19
"10762","6180橘子","110/07/13","新光-新竹",1,18,-17
"10763","6180橘子","110/07/13","華南永昌-台南",19,0,19
"10764","6180橘子","110/07/13","元大-土城永寧",0,17,-17
"10765","6180橘子","110/07/13","福勝",14,0,14
"10766","6180橘子","110/07/13","國泰-新莊",3,19,-16
"10767","6180橘子","110/07/13","富邦-嘉義",12,1,11
"10768","6180橘子","110/07/13","中國信託-永康",6,21,-15
"10769","6180橘子","110/07/13","元大-板橋三民",11,0,11
"10770","6180橘子","110/07/13","凱基-東港",1,15,-14
"10771","2390云辰","110/07/13","新加坡商瑞銀",562,75,487
"10772","2390云辰","110/07/13","大展-台南",0,532,-532
"10773","2390云辰","110/07/13","台灣摩根士丹利",330,155,175
"10774","2390云辰","110/07/13","凱基-台北",668,854,-186
"10775","2390云辰","110/07/13","兆豐-公益",126,25,101
"10776","2390云辰","110/07/13","凱基-三重",12,172,-160
"10777","2390云辰","110/07/13","元富-中港",100,2,98
"10778","2390云辰","110/07/13","兆豐-忠孝",4,161,-157
"10779","2390云辰","110/07/13","統一-新台中",106,9,97
"10780","2390云辰","110/07/13","元大-士林",19,170,-151
"10781","2390云辰","110/07/13","中國信託-松江",81,11,70
"10782","2390云辰","110/07/13","臺銀-新竹",14,117,-103
"10783","2390云辰","110/07/13","日盛-板橋",72,3,69
"10784","2390云辰","110/07/13","國票-台中",4,102,-98
"10785","2390云辰","110/07/13","日盛-和美",57,0,57
"10786","2390云辰","110/07/13","新光",147,232,-85
"10787","2390云辰","110/07/13","永豐金-桃園",88,36,52
"10788","2390云辰","110/07/13","致和-崇德",2,70,-68
"10789","2390云辰","110/07/13","玉山-士林",54,4,50
"10790","2390云辰","110/07/13","群益金鼎-屏東",2,70,-68
"10791","2390云辰","110/07/13","富邦-仁愛",56,6,50
"10792","2390云辰","110/07/13","元大-大里",35,98,-63
"10793","2390云辰","110/07/13","第一金-豐原",50,1,49
"10794","2390云辰","110/07/13","元大-萬華",35,94,-59
"10795","2390云辰","110/07/13","摩根大通",502,453,49
"10796","2390云辰","110/07/13","元富-吉利",2,60,-58
"10797","2390云辰","110/07/13","凱基-松山",61,13,48
"10798","2390云辰","110/07/13","兆豐-新竹",3,53,-50
"10799","2390云辰","110/07/13","大昌",64,22,42
"10800","2390云辰","110/07/13","富邦-嘉義",65,108,-43
"10801","2363矽統","110/07/13","凱基-南崁",2133,63,2070
"10802","2363矽統","110/07/13","凱基-幸福",36,4048,-4012
"10803","2363矽統","110/07/13","國泰-敦南",2195,1617,578
"10804","2363矽統","110/07/13","統一",192,3325,-3133
"10805","2363矽統","110/07/13","中農",670,139,531
"10806","2363矽統","110/07/13","新加坡商瑞銀",1000,2747,-1747
"10807","2363矽統","110/07/13","康和-台中",638,154,484
"10808","2363矽統","110/07/13","凱基-台北",5359,6609,-1250
"10809","2363矽統","110/07/13","群益金鼎-三民",577,137,440
"10810","2363矽統","110/07/13","摩根大通",1930,2858,-928
"10811","2363矽統","110/07/13","台新-屏東",510,88,422
"10812","2363矽統","110/07/13","港商野村",960,1679,-719
"10813","2363矽統","110/07/13","德信-中正",455,67,388
"10814","2363矽統","110/07/13","兆豐-復興",25,705,-680
"10815","2363矽統","110/07/13","日盛-竹北",365,70,295
"10816","2363矽統","110/07/13","統一-仁愛",114,755,-641
"10817","2363矽統","110/07/13","元大-佳里",452,189,263
"10818","2363矽統","110/07/13","統一-敦南",29,638,-609
"10819","2363矽統","110/07/13","國票-博愛",296,38,258
"10820","2363矽統","110/07/13","統一-土城",100,704,-604
"10821","2363矽統","110/07/13","元大-萬華",340,95,245
"10822","2363矽統","110/07/13","統一-城中",116,676,-560
"10823","2363矽統","110/07/13","新光",1259,1031,228
"10824","2363矽統","110/07/13","永豐金證券",306,859,-553
"10825","2363矽統","110/07/13","元富-成功",323,96,227
"10826","2363矽統","110/07/13","元富",54,567,-513
"10827","2363矽統","110/07/13","豐農",228,23,205
"10828","2363矽統","110/07/13","瑞士信貸",202,666,-464
"10829","2363矽統","110/07/13","台灣企銀-岡山",186,4,182
"10830","2363矽統","110/07/13","永豐金-嘉義",67,468,-401
"10831","8112至上","110/07/13","摩根大通",688,296,392
"10832","8112至上","110/07/13","國票-中和",0,401,-401
"10833","8112至上","110/07/13","港商野村",344,145,199
"10834","8112至上","110/07/13","永豐金-板盛",0,205,-205
"10835","8112至上","110/07/13","兆豐-公益",195,5,190
"10836","8112至上","110/07/13","凱基-五股",43,155,-112
"10837","8112至上","110/07/13","台灣摩根士丹利",183,0,183
"10838","8112至上","110/07/13","凱基-市政",0,100,-100
"10839","8112至上","110/07/13","群益金鼎-敦南",153,2,151
"10840","8112至上","110/07/13","元大-大里德芳",1,92,-91
"10841","8112至上","110/07/13","臺銀-金山",146,26,120
"10842","8112至上","110/07/13","玉山-桃園",26,110,-84
"10843","8112至上","110/07/13","臺銀",133,19,114
"10844","8112至上","110/07/13","兆豐-天母",0,81,-81
"10845","8112至上","110/07/13","合庫-台中",115,6,109
"10846","8112至上","110/07/13","凱基-城中",3,84,-81
"10847","8112至上","110/07/13","亞東-板橋",134,26,108
"10848","8112至上","110/07/13","日盛-新莊",9,85,-76
"10849","8112至上","110/07/13","凱基-台北",414,326,88
"10850","8112至上","110/07/13","日盛-台中",2,64,-62
"10851","8112至上","110/07/13","新加坡商瑞銀",181,100,81
"10852","8112至上","110/07/13","日盛-中壢",3,64,-61
"10853","8112至上","110/07/13","國泰-敦南",108,31,77
"10854","8112至上","110/07/13","元大-台中",2,59,-57
"10855","8112至上","110/07/13","第一金-華江",77,4,73
"10856","8112至上","110/07/13","元大-雙和",7,64,-57
"10857","8112至上","110/07/13","永豐金-內湖",73,1,72
"10858","8112至上","110/07/13","元大-高雄",8,62,-54
"10859","8112至上","110/07/13","元大-永和",68,1,67
"10860","8112至上","110/07/13","元大-館前",2,55,-53
"10861","1570力肯","110/07/13","新光",115,11,104
"10862","1570力肯","110/07/13","元大-北三重",0,162,-162
"10863","1570力肯","110/07/13","群益金鼎-高雄",54,0,54
"10864","1570力肯","110/07/13","元大-大灣",0,25,-25
"10865","1570力肯","110/07/13","國票-新莊",22,0,22
"10866","1570力肯","110/07/13","永豐金-苓雅",0,22,-22
"10867","1570力肯","110/07/13","日盛-桃園",12,0,12
"10868","1570力肯","110/07/13","永豐金-永康",0,19,-19
"10869","1570力肯","110/07/13","元大-高雄",12,0,12
"10870","1570力肯","110/07/13","富邦-員林",0,15,-15
"10871","1570力肯","110/07/13","合庫-自強",11,0,11
"10872","1570力肯","110/07/13","凱基-台南",0,11,-11
"10873","1570力肯","110/07/13","摩根大通",26,15,11
"10874","1570力肯","110/07/13","日盛-竹北",0,10,-10
"10875","1570力肯","110/07/13","永豐金-中盛",11,0,11
"10876","1570力肯","110/07/13","國票-九鼎",0,10,-10
"10877","1570力肯","110/07/13","兆豐-台中港",10,0,10
"10878","1570力肯","110/07/13","凱基-桃園",0,10,-10
"10879","1570力肯","110/07/13","國泰-松江",9,0,9
"10880","1570力肯","110/07/13","凱基-新豐",0,10,-10
"10881","1570力肯","110/07/13","元大-新盛",9,0,9
"10882","1570力肯","110/07/13","元大-學甲",0,10,-10
"10883","1570力肯","110/07/13","元富-緯城",6,0,6
"10884","1570力肯","110/07/13","群益金鼎-東湖",1,10,-9
"10885","1570力肯","110/07/13","統一-三重",5,0,5
"10886","1570力肯","110/07/13","大昌",0,6,-6
"10887","1570力肯","110/07/13","元大-前金",5,0,5
"10888","1570力肯","110/07/13","元大-土城學府",0,6,-6
"10889","1570力肯","110/07/13","永豐金證券",5,0,5
"10890","1570力肯","110/07/13","統一",0,5,-5
"10891","2929淘帝","110/07/13","玉山-新竹",130,0,130
"10892","2929淘帝","110/07/13","美商高盛",0,177,-177
"10893","2929淘帝","110/07/13","臺銀-民權",60,0,60
"10894","2929淘帝","110/07/13","凱基-台北",6,80,-74
"10895","2929淘帝","110/07/13","新百王",31,0,31
"10896","2929淘帝","110/07/13","元富-大裕",0,49,-49
"10897","2929淘帝","110/07/13","日盛-園區",30,0,30
"10898","2929淘帝","110/07/13","國泰-館前",3,51,-48
"10899","2929淘帝","110/07/13","元大-南投",31,1,30
"10900","2929淘帝","110/07/13","凱基-中壢",0,41,-41
"10901","2929淘帝","110/07/13","兆豐-忠孝",28,0,28
"10902","2929淘帝","110/07/13","港商野村",21,55,-34
"10903","2929淘帝","110/07/13","元大-民生",28,0,28
"10904","2929淘帝","110/07/13","華南永昌-南京",2,34,-32
"10905","2929淘帝","110/07/13","合庫-高雄",27,0,27
"10906","2929淘帝","110/07/13","群益金鼎-土城",0,30,-30
"10907","2929淘帝","110/07/13","凱基-豐中",27,0,27
"10908","2929淘帝","110/07/13","富邦-南屯",0,22,-22
"10909","2929淘帝","110/07/13","新光",21,4,17
"10910","2929淘帝","110/07/13","第一金-豐原",0,20,-20
"10911","2929淘帝","110/07/13","元大-天母",17,0,17
"10912","2929淘帝","110/07/13","元大-屏南",6,26,-20
"10913","2929淘帝","110/07/13","永興",14,0,14
"10914","2929淘帝","110/07/13","永豐金-敦南",1,21,-20
"10915","2929淘帝","110/07/13","富邦-台北",12,0,12
"10916","2929淘帝","110/07/13","凱基-三重",2,21,-19
"10917","2929淘帝","110/07/13","元大-永和",12,0,12
"10918","2929淘帝","110/07/13","富邦-仁愛",7,25,-18
"10919","2929淘帝","110/07/13","國票-天祥",11,0,11
"10920","2929淘帝","110/07/13","元大-北投",0,16,-16
"10921","5410國眾","110/07/13","兆豐-城中",274,0,274
"10922","5410國眾","110/07/13","元富-嘉義",0,103,-103
"10923","5410國眾","110/07/13","新光",50,4,46
"10924","5410國眾","110/07/13","凱基-台北",0,50,-50
"10925","5410國眾","110/07/13","國泰-台中",26,0,26
"10926","5410國眾","110/07/13","瑞士信貸",0,31,-31
"10927","5410國眾","110/07/13","新加坡商瑞銀",22,0,22
"10928","5410國眾","110/07/13","台新-新莊",0,27,-27
"10929","5410國眾","110/07/13","光和-嘉義",20,0,20
"10930","5410國眾","110/07/13","元大-汐止",0,20,-20
"10931","5410國眾","110/07/13","凱基-竹北",17,0,17
"10932","5410國眾","110/07/13","亞東-新竹",0,17,-17
"10933","5410國眾","110/07/13","新光-桃園",15,0,15
"10934","5410國眾","110/07/13","元大-南勢角",0,13,-13
"10935","5410國眾","110/07/13","凱基-台東",14,0,14
"10936","5410國眾","110/07/13","台新-台南",0,12,-12
"10937","5410國眾","110/07/13","富邦-竹北",11,0,11
"10938","5410國眾","110/07/13","中國信託",0,11,-11
"10939","5410國眾","110/07/13","元富-同大",10,0,10
"10940","5410國眾","110/07/13","華南永昌",0,11,-11
"10941","5410國眾","110/07/13","國泰-敦南",24,15,9
"10942","5410國眾","110/07/13","臺銀-臺南",0,10,-10
"10943","5410國眾","110/07/13","日盛-內湖",7,0,7
"10944","5410國眾","110/07/13","台灣企銀-民雄",0,10,-10
"10945","5410國眾","110/07/13","台新-左楠",7,0,7
"10946","5410國眾","110/07/13","高橋",0,10,-10
"10947","5410國眾","110/07/13","元大-新盛",18,12,6
"10948","5410國眾","110/07/13","康和-嘉義",0,10,-10
"10949","5410國眾","110/07/13","統一",5,0,5
"10950","5410國眾","110/07/13","凱基-基隆",0,10,-10
"10951","2841台開","110/07/13","中國信託-高雄",251,50,201
"10952","2841台開","110/07/13","兆豐-公益",0,177,-177
"10953","2841台開","110/07/13","日盛證券",210,13,197
"10954","2841台開","110/07/13","日進",0,152,-152
"10955","2841台開","110/07/13","第一金-台中",55,0,55
"10956","2841台開","110/07/13","港商野村",0,109,-109
"10957","2841台開","110/07/13","國泰-板橋",46,0,46
"10958","2841台開","110/07/13","日盛-信義",0,103,-103
"10959","2841台開","110/07/13","國泰-館前",48,3,45
"10960","2841台開","110/07/13","國泰-敦南",11,75,-64
"10961","2841台開","110/07/13","華南永昌-新莊",45,0,45
"10962","2841台開","110/07/13","永興",0,50,-50
"10963","2841台開","110/07/13","日盛-園區",42,0,42
"10964","2841台開","110/07/13","永豐金-敦南",61,104,-43
"10965","2841台開","110/07/13","台新證券",32,0,32
"10966","2841台開","110/07/13","富邦-台南",0,42,-42
"10967","2841台開","110/07/13","台新-高雄",32,2,30
"10968","2841台開","110/07/13","國票-安和",0,30,-30
"10969","2841台開","110/07/13","豐農",23,0,23
"10970","2841台開","110/07/13","元大-桃園",0,25,-25
"10971","2841台開","110/07/13","合庫-嘉義",20,0,20
"10972","2841台開","110/07/13","新光",8,32,-24
"10973","2841台開","110/07/13","華南永昌-高雄",20,0,20
"10974","2841台開","110/07/13","元大-仁愛",0,24,-24
"10975","2841台開","110/07/13","元大-樹林",16,0,16
"10976","2841台開","110/07/13","日盛-中和",0,20,-20
"10977","2841台開","110/07/13","第一金-華江",15,2,13
"10978","2841台開","110/07/13","元富",0,20,-20
"10979","2841台開","110/07/13","美商高盛",12,0,12
"10980","2841台開","110/07/13","富邦-宜蘭",0,20,-20
"10981","6207雷科","110/07/13","元大-高雄",121,0,121
"10982","6207雷科","110/07/13","華南永昌-朴子",1,60,-59
"10983","6207雷科","110/07/13","第一金-新興",20,0,20
"10984","6207雷科","110/07/13","元大-南海",0,36,-36
"10985","6207雷科","110/07/13","元富-三重",20,0,20
"10986","6207雷科","110/07/13","凱基-土城",0,35,-35
"10987","6207雷科","110/07/13","元大-林園",15,0,15
"10988","6207雷科","110/07/13","台灣企銀",0,20,-20
"10989","6207雷科","110/07/13","元大-金華",16,1,15
"10990","6207雷科","110/07/13","群益金鼎-丹鳳",0,20,-20
"10991","6207雷科","110/07/13","日盛證券",10,0,10
"10992","6207雷科","110/07/13","元大-博愛",0,17,-17
"10993","6207雷科","110/07/13","統一-台中",10,0,10
"10994","6207雷科","110/07/13","元大-北港",0,13,-13
"10995","6207雷科","110/07/13","群益金鼎-土城",10,0,10
"10996","6207雷科","110/07/13","新加坡商瑞銀",0,12,-12
"10997","6207雷科","110/07/13","群益金鼎-桃園",10,0,10
"10998","6207雷科","110/07/13","凱基-台北",4,16,-12
"10999","6207雷科","110/07/13","永豐金-新莊",10,0,10
"11000","6207雷科","110/07/13","日茂-埔里",0,11,-11
"11001","6207雷科","110/07/13","永豐金-新店",10,0,10
"11002","6207雷科","110/07/13","元大-莒光",0,11,-11
"11003","6207雷科","110/07/13","元大證券",9,0,9
"11004","6207雷科","110/07/13","統一-新竹",0,10,-10
"11005","6207雷科","110/07/13","日盛-木柵",9,1,8
"11006","6207雷科","110/07/13","元大-西螺",0,10,-10
"11007","6207雷科","110/07/13","兆豐-來福",8,0,8
"11008","6207雷科","110/07/13","康和-台中",0,8,-8
"11009","6207雷科","110/07/13","新光",7,0,7
"11010","6207雷科","110/07/13","兆豐-高雄",0,6,-6
"11011","3679新至陞","110/07/13","永豐金證券",50,0,50
"11012","3679新至陞","110/07/13","摩根大通",2,25,-23
"11013","3679新至陞","110/07/13","國泰-桃園",22,0,22
"11014","3679新至陞","110/07/13","元大-成功",0,22,-22
"11015","3679新至陞","110/07/13","台中銀-員林",11,0,11
"11016","3679新至陞","110/07/13","富邦-板橋",1,19,-18
"11017","3679新至陞","110/07/13","元大-文心興安",8,0,8
"11018","3679新至陞","110/07/13","日盛-新莊",0,10,-10
"11019","3679新至陞","110/07/13","美商高盛",6,0,6
"11020","3679新至陞","110/07/13","台新-台中",0,10,-10
"11021","3679新至陞","110/07/13","台新-高雄",6,0,6
"11022","3679新至陞","110/07/13","永豐金-新竹",0,8,-8
"11023","3679新至陞","110/07/13","凱基-台北",18,12,6
"11024","3679新至陞","110/07/13","瑞士信貸",12,19,-7
"11025","3679新至陞","110/07/13","日盛-復興",5,0,5
"11026","3679新至陞","110/07/13","統一-南京",0,7,-7
"11027","3679新至陞","110/07/13","(牛牛牛)亞-鑫豐",4,0,4
"11028","3679新至陞","110/07/13","凱基-新莊",0,7,-7
"11029","3679新至陞","110/07/13","元富-大昌",3,0,3
"11030","3679新至陞","110/07/13","新加坡商瑞銀",0,6,-6
"11031","3679新至陞","110/07/13","富邦-台北",3,0,3
"11032","3679新至陞","110/07/13","合庫-自強",0,5,-5
"11033","3679新至陞","110/07/13","日盛-樹林",2,0,2
"11034","3679新至陞","110/07/13","富邦-桃園",0,5,-5
"11035","3679新至陞","110/07/13","宏遠-光隆",2,0,2
"11036","3679新至陞","110/07/13","永豐金-潮州",0,4,-4
"11037","3679新至陞","110/07/13","美林",3,1,2
"11038","3679新至陞","110/07/13","臺銀-臺南",0,3,-3
"11039","3679新至陞","110/07/13","第一金-中壢",2,0,2
"11040","3679新至陞","110/07/13","元大-六合",0,3,-3
"11041","2727王品","110/07/13","富邦-台北",43,3,40
"11042","2727王品","110/07/13","台灣摩根士丹利",15,97,-82
"11043","2727王品","110/07/13","元大-基隆孝二",40,0,40
"11044","2727王品","110/07/13","玉山-台南",5,57,-52
"11045","2727王品","110/07/13","國票-新莊",40,1,39
"11046","2727王品","110/07/13","新加坡商瑞銀",0,48,-48
"11047","2727王品","110/07/13","第一金-豐原",66,42,24
"11048","2727王品","110/07/13","凱基-台北",41,77,-36
"11049","2727王品","110/07/13","永豐金-大園",34,10,24
"11050","2727王品","110/07/13","永豐金-永康",0,22,-22
"11051","2727王品","110/07/13","元大-北屯",22,0,22
"11052","2727王品","110/07/13","統一-台中",2,22,-20
"11053","2727王品","110/07/13","元大-東蘆",26,7,19
"11054","2727王品","110/07/13","國泰-台中",21,39,-18
"11055","2727王品","110/07/13","永豐金-萬盛",13,1,12
"11056","2727王品","110/07/13","合庫-彰化",3,20,-17
"11057","2727王品","110/07/13","日盛-嘉義",11,0,11
"11058","2727王品","110/07/13","港商野村",13,30,-17
"11059","2727王品","110/07/13","日盛-八德",11,0,11
"11060","2727王品","110/07/13","元大-楊梅",1,16,-15
"11061","2727王品","110/07/13","統一-竹南",11,0,11
"11062","2727王品","110/07/13","凱基-高美館",2,15,-13
"11063","2727王品","110/07/13","日盛-士林",12,2,10
"11064","2727王品","110/07/13","美商高盛",2,14,-12
"11065","2727王品","110/07/13","統一-敦南",10,0,10
"11066","2727王品","110/07/13","統一-平鎮",1,13,-12
"11067","2727王品","110/07/13","中國信託",15,5,10
"11068","2727王品","110/07/13","兆豐-台中港",4,16,-12
"11069","2727王品","110/07/13","兆豐-竹北",13,3,10
"11070","2727王品","110/07/13","凱基-八德",1,13,-12
"11071","1570力肯","110/07/13","新光",115,11,104
"11072","1570力肯","110/07/13","元大-北三重",0,162,-162
"11073","1570力肯","110/07/13","群益金鼎-高雄",54,0,54
"11074","1570力肯","110/07/13","元大-大灣",0,25,-25
"11075","1570力肯","110/07/13","國票-新莊",22,0,22
"11076","1570力肯","110/07/13","永豐金-苓雅",0,22,-22
"11077","1570力肯","110/07/13","日盛-桃園",12,0,12
"11078","1570力肯","110/07/13","永豐金-永康",0,19,-19
"11079","1570力肯","110/07/13","元大-高雄",12,0,12
"11080","1570力肯","110/07/13","富邦-員林",0,15,-15
"11081","1570力肯","110/07/13","合庫-自強",11,0,11
"11082","1570力肯","110/07/13","凱基-台南",0,11,-11
"11083","1570力肯","110/07/13","摩根大通",26,15,11
"11084","1570力肯","110/07/13","日盛-竹北",0,10,-10
"11085","1570力肯","110/07/13","永豐金-中盛",11,0,11
"11086","1570力肯","110/07/13","國票-九鼎",0,10,-10
"11087","1570力肯","110/07/13","兆豐-台中港",10,0,10
"11088","1570力肯","110/07/13","凱基-桃園",0,10,-10
"11089","1570力肯","110/07/13","國泰-松江",9,0,9
"11090","1570力肯","110/07/13","凱基-新豐",0,10,-10
"11091","1570力肯","110/07/13","元大-新盛",9,0,9
"11092","1570力肯","110/07/13","元大-學甲",0,10,-10
"11093","1570力肯","110/07/13","元富-緯城",6,0,6
"11094","1570力肯","110/07/13","群益金鼎-東湖",1,10,-9
"11095","1570力肯","110/07/13","統一-三重",5,0,5
"11096","1570力肯","110/07/13","大昌",0,6,-6
"11097","1570力肯","110/07/13","元大-前金",5,0,5
"11098","1570力肯","110/07/13","元大-土城學府",0,6,-6
"11099","1570力肯","110/07/13","永豐金證券",5,0,5
"11100","1570力肯","110/07/13","統一",0,5,-5
"11101","6180橘子","110/07/13","摩根大通",119,0,119
"11102","6180橘子","110/07/13","元大-崇德",2,61,-59
"11103","6180橘子","110/07/13","美商高盛",96,0,96
"11104","6180橘子","110/07/13","康和-台中",0,51,-51
"11105","6180橘子","110/07/13","新加坡商瑞銀",86,7,79
"11106","6180橘子","110/07/13","康和-台北",0,50,-50
"11107","6180橘子","110/07/13","元大-和平",40,0,40
"11108","6180橘子","110/07/13","元富-潮州",0,40,-40
"11109","6180橘子","110/07/13","凱基-台北",83,47,36
"11110","6180橘子","110/07/13","日盛-永康",0,26,-26
"11111","6180橘子","110/07/13","美林",39,5,34
"11112","6180橘子","110/07/13","永豐金-中正",0,24,-24
"11113","6180橘子","110/07/13","富邦-新竹華信",31,2,29
"11114","6180橘子","110/07/13","國泰-板橋",2,25,-23
"11115","6180橘子","110/07/13","統一-南京",21,0,21
"11116","6180橘子","110/07/13","日盛-大墩",0,20,-20
"11117","6180橘子","110/07/13","富邦-陽明",24,3,21
"11118","6180橘子","110/07/13","元大-草屯",13,32,-19
"11119","6180橘子","110/07/13","大昌-樹林",21,1,20
"11120","6180橘子","110/07/13","元富-林園",1,18,-17
"11121","6180橘子","110/07/13","花旗環球",19,0,19
"11122","6180橘子","110/07/13","新光-新竹",1,18,-17
"11123","6180橘子","110/07/13","華南永昌-台南",19,0,19
"11124","6180橘子","110/07/13","元大-土城永寧",0,17,-17
"11125","6180橘子","110/07/13","福勝",14,0,14
"11126","6180橘子","110/07/13","國泰-新莊",3,19,-16
"11127","6180橘子","110/07/13","富邦-嘉義",12,1,11
"11128","6180橘子","110/07/13","中國信託-永康",6,21,-15
"11129","6180橘子","110/07/13","元大-板橋三民",11,0,11
"11130","6180橘子","110/07/13","凱基-東港",1,15,-14
"11131","2390云辰","110/07/13","新加坡商瑞銀",562,75,487
"11132","2390云辰","110/07/13","大展-台南",0,532,-532
"11133","2390云辰","110/07/13","台灣摩根士丹利",330,155,175
"11134","2390云辰","110/07/13","凱基-台北",668,854,-186
"11135","2390云辰","110/07/13","兆豐-公益",126,25,101
"11136","2390云辰","110/07/13","凱基-三重",12,172,-160
"11137","2390云辰","110/07/13","元富-中港",100,2,98
"11138","2390云辰","110/07/13","兆豐-忠孝",4,161,-157
"11139","2390云辰","110/07/13","統一-新台中",106,9,97
"11140","2390云辰","110/07/13","元大-士林",19,170,-151
"11141","2390云辰","110/07/13","中國信託-松江",81,11,70
"11142","2390云辰","110/07/13","臺銀-新竹",14,117,-103
"11143","2390云辰","110/07/13","日盛-板橋",72,3,69
"11144","2390云辰","110/07/13","國票-台中",4,102,-98
"11145","2390云辰","110/07/13","日盛-和美",57,0,57
"11146","2390云辰","110/07/13","新光",147,232,-85
"11147","2390云辰","110/07/13","永豐金-桃園",88,36,52
"11148","2390云辰","110/07/13","致和-崇德",2,70,-68
"11149","2390云辰","110/07/13","玉山-士林",54,4,50
"11150","2390云辰","110/07/13","群益金鼎-屏東",2,70,-68
"11151","2390云辰","110/07/13","富邦-仁愛",56,6,50
"11152","2390云辰","110/07/13","元大-大里",35,98,-63
"11153","2390云辰","110/07/13","第一金-豐原",50,1,49
"11154","2390云辰","110/07/13","元大-萬華",35,94,-59
"11155","2390云辰","110/07/13","摩根大通",502,453,49
"11156","2390云辰","110/07/13","元富-吉利",2,60,-58
"11157","2390云辰","110/07/13","凱基-松山",61,13,48
"11158","2390云辰","110/07/13","兆豐-新竹",3,53,-50
"11159","2390云辰","110/07/13","大昌",64,22,42
"11160","2390云辰","110/07/13","富邦-嘉義",65,108,-43
"11161","2363矽統","110/07/13","凱基-南崁",2133,63,2070
"11162","2363矽統","110/07/13","凱基-幸福",36,4048,-4012
"11163","2363矽統","110/07/13","國泰-敦南",2195,1617,578
"11164","2363矽統","110/07/13","統一",192,3325,-3133
"11165","2363矽統","110/07/13","中農",670,139,531
"11166","2363矽統","110/07/13","新加坡商瑞銀",1000,2747,-1747
"11167","2363矽統","110/07/13","康和-台中",638,154,484
"11168","2363矽統","110/07/13","凱基-台北",5359,6609,-1250
"11169","2363矽統","110/07/13","群益金鼎-三民",577,137,440
"11170","2363矽統","110/07/13","摩根大通",1930,2858,-928
"11171","2363矽統","110/07/13","台新-屏東",510,88,422
"11172","2363矽統","110/07/13","港商野村",960,1679,-719
"11173","2363矽統","110/07/13","德信-中正",455,67,388
"11174","2363矽統","110/07/13","兆豐-復興",25,705,-680
"11175","2363矽統","110/07/13","日盛-竹北",365,70,295
"11176","2363矽統","110/07/13","統一-仁愛",114,755,-641
"11177","2363矽統","110/07/13","元大-佳里",452,189,263
"11178","2363矽統","110/07/13","統一-敦南",29,638,-609
"11179","2363矽統","110/07/13","國票-博愛",296,38,258
"11180","2363矽統","110/07/13","統一-土城",100,704,-604
"11181","2363矽統","110/07/13","元大-萬華",340,95,245
"11182","2363矽統","110/07/13","統一-城中",116,676,-560
"11183","2363矽統","110/07/13","新光",1259,1031,228
"11184","2363矽統","110/07/13","永豐金證券",306,859,-553
"11185","2363矽統","110/07/13","元富-成功",323,96,227
"11186","2363矽統","110/07/13","元富",54,567,-513
"11187","2363矽統","110/07/13","豐農",228,23,205
"11188","2363矽統","110/07/13","瑞士信貸",202,666,-464
"11189","2363矽統","110/07/13","台灣企銀-岡山",186,4,182
"11190","2363矽統","110/07/13","永豐金-嘉義",67,468,-401
"11191","2363矽統","110/07/13","凱基-南崁",2133,63,2070
"11192","2363矽統","110/07/13","凱基-幸福",36,4048,-4012
"11193","2363矽統","110/07/13","國泰-敦南",2195,1617,578
"11194","2363矽統","110/07/13","統一",192,3325,-3133
"11195","2363矽統","110/07/13","中農",670,139,531
"11196","2363矽統","110/07/13","新加坡商瑞銀",1000,2747,-1747
"11197","2363矽統","110/07/13","康和-台中",638,154,484
"11198","2363矽統","110/07/13","凱基-台北",5359,6609,-1250
"11199","2363矽統","110/07/13","群益金鼎-三民",577,137,440
"11200","2363矽統","110/07/13","摩根大通",1930,2858,-928
"11201","2363矽統","110/07/13","台新-屏東",510,88,422
"11202","2363矽統","110/07/13","港商野村",960,1679,-719
"11203","2363矽統","110/07/13","德信-中正",455,67,388
"11204","2363矽統","110/07/13","兆豐-復興",25,705,-680
"11205","2363矽統","110/07/13","日盛-竹北",365,70,295
"11206","2363矽統","110/07/13","統一-仁愛",114,755,-641
"11207","2363矽統","110/07/13","元大-佳里",452,189,263
"11208","2363矽統","110/07/13","統一-敦南",29,638,-609
"11209","2363矽統","110/07/13","國票-博愛",296,38,258
"11210","2363矽統","110/07/13","統一-土城",100,704,-604
"11211","2363矽統","110/07/13","元大-萬華",340,95,245
"11212","2363矽統","110/07/13","統一-城中",116,676,-560
"11213","2363矽統","110/07/13","新光",1259,1031,228
"11214","2363矽統","110/07/13","永豐金證券",306,859,-553
"11215","2363矽統","110/07/13","元富-成功",323,96,227
"11216","2363矽統","110/07/13","元富",54,567,-513
"11217","2363矽統","110/07/13","豐農",228,23,205
"11218","2363矽統","110/07/13","瑞士信貸",202,666,-464
"11219","2363矽統","110/07/13","台灣企銀-岡山",186,4,182
"11220","2363矽統","110/07/13","永豐金-嘉義",67,468,-401
"11221","2363矽統","110/07/13","凱基-南崁",2133,63,2070
"11222","2363矽統","110/07/13","凱基-幸福",36,4048,-4012
"11223","2363矽統","110/07/13","國泰-敦南",2195,1617,578
"11224","2363矽統","110/07/13","統一",192,3325,-3133
"11225","2363矽統","110/07/13","中農",670,139,531
"11226","2363矽統","110/07/13","新加坡商瑞銀",1000,2747,-1747
"11227","2363矽統","110/07/13","康和-台中",638,154,484
"11228","2363矽統","110/07/13","凱基-台北",5359,6609,-1250
"11229","2363矽統","110/07/13","群益金鼎-三民",577,137,440
"11230","2363矽統","110/07/13","摩根大通",1930,2858,-928
"11231","2363矽統","110/07/13","台新-屏東",510,88,422
"11232","2363矽統","110/07/13","港商野村",960,1679,-719
"11233","2363矽統","110/07/13","德信-中正",455,67,388
"11234","2363矽統","110/07/13","兆豐-復興",25,705,-680
"11235","2363矽統","110/07/13","日盛-竹北",365,70,295
"11236","2363矽統","110/07/13","統一-仁愛",114,755,-641
"11237","2363矽統","110/07/13","元大-佳里",452,189,263
"11238","2363矽統","110/07/13","統一-敦南",29,638,-609
"11239","2363矽統","110/07/13","國票-博愛",296,38,258
"11240","2363矽統","110/07/13","統一-土城",100,704,-604
"11241","2363矽統","110/07/13","元大-萬華",340,95,245
"11242","2363矽統","110/07/13","統一-城中",116,676,-560
"11243","2363矽統","110/07/13","新光",1259,1031,228
"11244","2363矽統","110/07/13","永豐金證券",306,859,-553
"11245","2363矽統","110/07/13","元富-成功",323,96,227
"11246","2363矽統","110/07/13","元富",54,567,-513
"11247","2363矽統","110/07/13","豐農",228,23,205
"11248","2363矽統","110/07/13","瑞士信貸",202,666,-464
"11249","2363矽統","110/07/13","台灣企銀-岡山",186,4,182
"11250","2363矽統","110/07/13","永豐金-嘉義",67,468,-401
"11251","1570力肯","110/07/13","新光",115,11,104
"11252","1570力肯","110/07/13","元大-北三重",0,162,-162
"11253","1570力肯","110/07/13","群益金鼎-高雄",54,0,54
"11254","1570力肯","110/07/13","元大-大灣",0,25,-25
"11255","1570力肯","110/07/13","國票-新莊",22,0,22
"11256","1570力肯","110/07/13","永豐金-苓雅",0,22,-22
"11257","1570力肯","110/07/13","日盛-桃園",12,0,12
"11258","1570力肯","110/07/13","永豐金-永康",0,19,-19
"11259","1570力肯","110/07/13","元大-高雄",12,0,12
"11260","1570力肯","110/07/13","富邦-員林",0,15,-15
"11261","1570力肯","110/07/13","合庫-自強",11,0,11
"11262","1570力肯","110/07/13","凱基-台南",0,11,-11
"11263","1570力肯","110/07/13","摩根大通",26,15,11
"11264","1570力肯","110/07/13","日盛-竹北",0,10,-10
"11265","1570力肯","110/07/13","永豐金-中盛",11,0,11
"11266","1570力肯","110/07/13","國票-九鼎",0,10,-10
"11267","1570力肯","110/07/13","兆豐-台中港",10,0,10
"11268","1570力肯","110/07/13","凱基-桃園",0,10,-10
"11269","1570力肯","110/07/13","國泰-松江",9,0,9
"11270","1570力肯","110/07/13","凱基-新豐",0,10,-10
"11271","1570力肯","110/07/13","元大-新盛",9,0,9
"11272","1570力肯","110/07/13","元大-學甲",0,10,-10
"11273","1570力肯","110/07/13","元富-緯城",6,0,6
"11274","1570力肯","110/07/13","群益金鼎-東湖",1,10,-9
"11275","1570力肯","110/07/13","統一-三重",5,0,5
"11276","1570力肯","110/07/13","大昌",0,6,-6
"11277","1570力肯","110/07/13","元大-前金",5,0,5
"11278","1570力肯","110/07/13","元大-土城學府",0,6,-6
"11279","1570力肯","110/07/13","永豐金證券",5,0,5
"11280","1570力肯","110/07/13","統一",0,5,-5
"11281","1570力肯","110/07/13","新光",115,11,104
"11282","1570力肯","110/07/13","元大-北三重",0,162,-162
"11283","1570力肯","110/07/13","群益金鼎-高雄",54,0,54
"11284","1570力肯","110/07/13","元大-大灣",0,25,-25
"11285","1570力肯","110/07/13","國票-新莊",22,0,22
"11286","1570力肯","110/07/13","永豐金-苓雅",0,22,-22
"11287","1570力肯","110/07/13","日盛-桃園",12,0,12
"11288","1570力肯","110/07/13","永豐金-永康",0,19,-19
"11289","1570力肯","110/07/13","元大-高雄",12,0,12
"11290","1570力肯","110/07/13","富邦-員林",0,15,-15
"11291","1570力肯","110/07/13","合庫-自強",11,0,11
"11292","1570力肯","110/07/13","凱基-台南",0,11,-11
"11293","1570力肯","110/07/13","摩根大通",26,15,11
"11294","1570力肯","110/07/13","日盛-竹北",0,10,-10
"11295","1570力肯","110/07/13","永豐金-中盛",11,0,11
"11296","1570力肯","110/07/13","國票-九鼎",0,10,-10
"11297","1570力肯","110/07/13","兆豐-台中港",10,0,10
"11298","1570力肯","110/07/13","凱基-桃園",0,10,-10
"11299","1570力肯","110/07/13","國泰-松江",9,0,9
"11300","1570力肯","110/07/13","凱基-新豐",0,10,-10
"11301","1570力肯","110/07/13","元大-新盛",9,0,9
"11302","1570力肯","110/07/13","元大-學甲",0,10,-10
"11303","1570力肯","110/07/13","元富-緯城",6,0,6
"11304","1570力肯","110/07/13","群益金鼎-東湖",1,10,-9
"11305","1570力肯","110/07/13","統一-三重",5,0,5
"11306","1570力肯","110/07/13","大昌",0,6,-6
"11307","1570力肯","110/07/13","元大-前金",5,0,5
"11308","1570力肯","110/07/13","元大-土城學府",0,6,-6
"11309","1570力肯","110/07/13","永豐金證券",5,0,5
"11310","1570力肯","110/07/13","統一",0,5,-5
"11311","6180橘子","110/07/13","摩根大通",119,0,119
"11312","6180橘子","110/07/13","元大-崇德",2,61,-59
"11313","6180橘子","110/07/13","美商高盛",96,0,96
"11314","6180橘子","110/07/13","康和-台中",0,51,-51
"11315","6180橘子","110/07/13","新加坡商瑞銀",86,7,79
"11316","6180橘子","110/07/13","康和-台北",0,50,-50
"11317","6180橘子","110/07/13","元大-和平",40,0,40
"11318","6180橘子","110/07/13","元富-潮州",0,40,-40
"11319","6180橘子","110/07/13","凱基-台北",83,47,36
"11320","6180橘子","110/07/13","日盛-永康",0,26,-26
"11321","6180橘子","110/07/13","美林",39,5,34
"11322","6180橘子","110/07/13","永豐金-中正",0,24,-24
"11323","6180橘子","110/07/13","富邦-新竹華信",31,2,29
"11324","6180橘子","110/07/13","國泰-板橋",2,25,-23
"11325","6180橘子","110/07/13","統一-南京",21,0,21
"11326","6180橘子","110/07/13","日盛-大墩",0,20,-20
"11327","6180橘子","110/07/13","富邦-陽明",24,3,21
"11328","6180橘子","110/07/13","元大-草屯",13,32,-19
"11329","6180橘子","110/07/13","大昌-樹林",21,1,20
"11330","6180橘子","110/07/13","元富-林園",1,18,-17
"11331","6180橘子","110/07/13","花旗環球",19,0,19
"11332","6180橘子","110/07/13","新光-新竹",1,18,-17
"11333","6180橘子","110/07/13","華南永昌-台南",19,0,19
"11334","6180橘子","110/07/13","元大-土城永寧",0,17,-17
"11335","6180橘子","110/07/13","福勝",14,0,14
"11336","6180橘子","110/07/13","國泰-新莊",3,19,-16
"11337","6180橘子","110/07/13","富邦-嘉義",12,1,11
"11338","6180橘子","110/07/13","中國信託-永康",6,21,-15
"11339","6180橘子","110/07/13","元大-板橋三民",11,0,11
"11340","6180橘子","110/07/13","凱基-東港",1,15,-14
"11341","1570力肯","110/07/13","新光",115,11,104
"11342","1570力肯","110/07/13","元大-北三重",0,162,-162
"11343","1570力肯","110/07/13","群益金鼎-高雄",54,0,54
"11344","1570力肯","110/07/13","元大-大灣",0,25,-25
"11345","1570力肯","110/07/13","國票-新莊",22,0,22
"11346","1570力肯","110/07/13","永豐金-苓雅",0,22,-22
"11347","1570力肯","110/07/13","日盛-桃園",12,0,12
"11348","1570力肯","110/07/13","永豐金-永康",0,19,-19
"11349","1570力肯","110/07/13","元大-高雄",12,0,12
"11350","1570力肯","110/07/13","富邦-員林",0,15,-15
"11351","1570力肯","110/07/13","合庫-自強",11,0,11
"11352","1570力肯","110/07/13","凱基-台南",0,11,-11
"11353","1570力肯","110/07/13","摩根大通",26,15,11
"11354","1570力肯","110/07/13","日盛-竹北",0,10,-10
"11355","1570力肯","110/07/13","永豐金-中盛",11,0,11
"11356","1570力肯","110/07/13","國票-九鼎",0,10,-10
"11357","1570力肯","110/07/13","兆豐-台中港",10,0,10
"11358","1570力肯","110/07/13","凱基-桃園",0,10,-10
"11359","1570力肯","110/07/13","國泰-松江",9,0,9
"11360","1570力肯","110/07/13","凱基-新豐",0,10,-10
"11361","1570力肯","110/07/13","元大-新盛",9,0,9
"11362","1570力肯","110/07/13","元大-學甲",0,10,-10
"11363","1570力肯","110/07/13","元富-緯城",6,0,6
"11364","1570力肯","110/07/13","群益金鼎-東湖",1,10,-9
"11365","1570力肯","110/07/13","統一-三重",5,0,5
"11366","1570力肯","110/07/13","大昌",0,6,-6
"11367","1570力肯","110/07/13","元大-前金",5,0,5
"11368","1570力肯","110/07/13","元大-土城學府",0,6,-6
"11369","1570力肯","110/07/13","永豐金證券",5,0,5
"11370","1570力肯","110/07/13","統一",0,5,-5
"11371","6180橘子","110/07/13","摩根大通",119,0,119
"11372","6180橘子","110/07/13","元大-崇德",2,61,-59
"11373","6180橘子","110/07/13","美商高盛",96,0,96
"11374","6180橘子","110/07/13","康和-台中",0,51,-51
"11375","6180橘子","110/07/13","新加坡商瑞銀",86,7,79
"11376","6180橘子","110/07/13","康和-台北",0,50,-50
"11377","6180橘子","110/07/13","元大-和平",40,0,40
"11378","6180橘子","110/07/13","元富-潮州",0,40,-40
"11379","6180橘子","110/07/13","凱基-台北",83,47,36
"11380","6180橘子","110/07/13","日盛-永康",0,26,-26
"11381","6180橘子","110/07/13","美林",39,5,34
"11382","6180橘子","110/07/13","永豐金-中正",0,24,-24
"11383","6180橘子","110/07/13","富邦-新竹華信",31,2,29
"11384","6180橘子","110/07/13","國泰-板橋",2,25,-23
"11385","6180橘子","110/07/13","統一-南京",21,0,21
"11386","6180橘子","110/07/13","日盛-大墩",0,20,-20
"11387","6180橘子","110/07/13","富邦-陽明",24,3,21
"11388","6180橘子","110/07/13","元大-草屯",13,32,-19
"11389","6180橘子","110/07/13","大昌-樹林",21,1,20
"11390","6180橘子","110/07/13","元富-林園",1,18,-17
"11391","6180橘子","110/07/13","花旗環球",19,0,19
"11392","6180橘子","110/07/13","新光-新竹",1,18,-17
"11393","6180橘子","110/07/13","華南永昌-台南",19,0,19
"11394","6180橘子","110/07/13","元大-土城永寧",0,17,-17
"11395","6180橘子","110/07/13","福勝",14,0,14
"11396","6180橘子","110/07/13","國泰-新莊",3,19,-16
"11397","6180橘子","110/07/13","富邦-嘉義",12,1,11
"11398","6180橘子","110/07/13","中國信託-永康",6,21,-15
"11399","6180橘子","110/07/13","元大-板橋三民",11,0,11
"11400","6180橘子","110/07/13","凱基-東港",1,15,-14
"11401","2390云辰","110/07/13","新加坡商瑞銀",562,75,487
"11402","2390云辰","110/07/13","大展-台南",0,532,-532
"11403","2390云辰","110/07/13","台灣摩根士丹利",330,155,175
"11404","2390云辰","110/07/13","凱基-台北",668,854,-186
"11405","2390云辰","110/07/13","兆豐-公益",126,25,101
"11406","2390云辰","110/07/13","凱基-三重",12,172,-160
"11407","2390云辰","110/07/13","元富-中港",100,2,98
"11408","2390云辰","110/07/13","兆豐-忠孝",4,161,-157
"11409","2390云辰","110/07/13","統一-新台中",106,9,97
"11410","2390云辰","110/07/13","元大-士林",19,170,-151
"11411","2390云辰","110/07/13","中國信託-松江",81,11,70
"11412","2390云辰","110/07/13","臺銀-新竹",14,117,-103
"11413","2390云辰","110/07/13","日盛-板橋",72,3,69
"11414","2390云辰","110/07/13","國票-台中",4,102,-98
"11415","2390云辰","110/07/13","日盛-和美",57,0,57
"11416","2390云辰","110/07/13","新光",147,232,-85
"11417","2390云辰","110/07/13","永豐金-桃園",88,36,52
"11418","2390云辰","110/07/13","致和-崇德",2,70,-68
"11419","2390云辰","110/07/13","玉山-士林",54,4,50
"11420","2390云辰","110/07/13","群益金鼎-屏東",2,70,-68
"11421","2390云辰","110/07/13","富邦-仁愛",56,6,50
"11422","2390云辰","110/07/13","元大-大里",35,98,-63
"11423","2390云辰","110/07/13","第一金-豐原",50,1,49
"11424","2390云辰","110/07/13","元大-萬華",35,94,-59
"11425","2390云辰","110/07/13","摩根大通",502,453,49
"11426","2390云辰","110/07/13","元富-吉利",2,60,-58
"11427","2390云辰","110/07/13","凱基-松山",61,13,48
"11428","2390云辰","110/07/13","兆豐-新竹",3,53,-50
"11429","2390云辰","110/07/13","大昌",64,22,42
"11430","2390云辰","110/07/13","富邦-嘉義",65,108,-43
"11431","2363矽統","110/07/13","凱基-南崁",2133,63,2070
"11432","2363矽統","110/07/13","凱基-幸福",36,4048,-4012
"11433","2363矽統","110/07/13","國泰-敦南",2195,1617,578
"11434","2363矽統","110/07/13","統一",192,3325,-3133
"11435","2363矽統","110/07/13","中農",670,139,531
"11436","2363矽統","110/07/13","新加坡商瑞銀",1000,2747,-1747
"11437","2363矽統","110/07/13","康和-台中",638,154,484
"11438","2363矽統","110/07/13","凱基-台北",5359,6609,-1250
"11439","2363矽統","110/07/13","群益金鼎-三民",577,137,440
"11440","2363矽統","110/07/13","摩根大通",1930,2858,-928
"11441","2363矽統","110/07/13","台新-屏東",510,88,422
"11442","2363矽統","110/07/13","港商野村",960,1679,-719
"11443","2363矽統","110/07/13","德信-中正",455,67,388
"11444","2363矽統","110/07/13","兆豐-復興",25,705,-680
"11445","2363矽統","110/07/13","日盛-竹北",365,70,295
"11446","2363矽統","110/07/13","統一-仁愛",114,755,-641
"11447","2363矽統","110/07/13","元大-佳里",452,189,263
"11448","2363矽統","110/07/13","統一-敦南",29,638,-609
"11449","2363矽統","110/07/13","國票-博愛",296,38,258
"11450","2363矽統","110/07/13","統一-土城",100,704,-604
"11451","2363矽統","110/07/13","元大-萬華",340,95,245
"11452","2363矽統","110/07/13","統一-城中",116,676,-560
"11453","2363矽統","110/07/13","新光",1259,1031,228
"11454","2363矽統","110/07/13","永豐金證券",306,859,-553
"11455","2363矽統","110/07/13","元富-成功",323,96,227
"11456","2363矽統","110/07/13","元富",54,567,-513
"11457","2363矽統","110/07/13","豐農",228,23,205
"11458","2363矽統","110/07/13","瑞士信貸",202,666,-464
"11459","2363矽統","110/07/13","台灣企銀-岡山",186,4,182
"11460","2363矽統","110/07/13","永豐金-嘉義",67,468,-401
"11461","8112至上","110/07/13","摩根大通",688,296,392
"11462","8112至上","110/07/13","國票-中和",0,401,-401
"11463","8112至上","110/07/13","港商野村",344,145,199
"11464","8112至上","110/07/13","永豐金-板盛",0,205,-205
"11465","8112至上","110/07/13","兆豐-公益",195,5,190
"11466","8112至上","110/07/13","凱基-五股",43,155,-112
"11467","8112至上","110/07/13","台灣摩根士丹利",183,0,183
"11468","8112至上","110/07/13","凱基-市政",0,100,-100
"11469","8112至上","110/07/13","群益金鼎-敦南",153,2,151
"11470","8112至上","110/07/13","元大-大里德芳",1,92,-91
"11471","8112至上","110/07/13","臺銀-金山",146,26,120
"11472","8112至上","110/07/13","玉山-桃園",26,110,-84
"11473","8112至上","110/07/13","臺銀",133,19,114
"11474","8112至上","110/07/13","兆豐-天母",0,81,-81
"11475","8112至上","110/07/13","合庫-台中",115,6,109
"11476","8112至上","110/07/13","凱基-城中",3,84,-81
"11477","8112至上","110/07/13","亞東-板橋",134,26,108
"11478","8112至上","110/07/13","日盛-新莊",9,85,-76
"11479","8112至上","110/07/13","凱基-台北",414,326,88
"11480","8112至上","110/07/13","日盛-台中",2,64,-62
"11481","8112至上","110/07/13","新加坡商瑞銀",181,100,81
"11482","8112至上","110/07/13","日盛-中壢",3,64,-61
"11483","8112至上","110/07/13","國泰-敦南",108,31,77
"11484","8112至上","110/07/13","元大-台中",2,59,-57
"11485","8112至上","110/07/13","第一金-華江",77,4,73
"11486","8112至上","110/07/13","元大-雙和",7,64,-57
"11487","8112至上","110/07/13","永豐金-內湖",73,1,72
"11488","8112至上","110/07/13","元大-高雄",8,62,-54
"11489","8112至上","110/07/13","元大-永和",68,1,67
"11490","8112至上","110/07/13","元大-館前",2,55,-53
"11491","2929淘帝","110/07/13","玉山-新竹",130,0,130
"11492","2929淘帝","110/07/13","美商高盛",0,177,-177
"11493","2929淘帝","110/07/13","臺銀-民權",60,0,60
"11494","2929淘帝","110/07/13","凱基-台北",6,80,-74
"11495","2929淘帝","110/07/13","新百王",31,0,31
"11496","2929淘帝","110/07/13","元富-大裕",0,49,-49
"11497","2929淘帝","110/07/13","日盛-園區",30,0,30
"11498","2929淘帝","110/07/13","國泰-館前",3,51,-48
"11499","2929淘帝","110/07/13","元大-南投",31,1,30
"11500","2929淘帝","110/07/13","凱基-中壢",0,41,-41
"11501","2929淘帝","110/07/13","兆豐-忠孝",28,0,28
"11502","2929淘帝","110/07/13","港商野村",21,55,-34
"11503","2929淘帝","110/07/13","元大-民生",28,0,28
"11504","2929淘帝","110/07/13","華南永昌-南京",2,34,-32
"11505","2929淘帝","110/07/13","合庫-高雄",27,0,27
"11506","2929淘帝","110/07/13","群益金鼎-土城",0,30,-30
"11507","2929淘帝","110/07/13","凱基-豐中",27,0,27
"11508","2929淘帝","110/07/13","富邦-南屯",0,22,-22
"11509","2929淘帝","110/07/13","新光",21,4,17
"11510","2929淘帝","110/07/13","第一金-豐原",0,20,-20
"11511","2929淘帝","110/07/13","元大-天母",17,0,17
"11512","2929淘帝","110/07/13","元大-屏南",6,26,-20
"11513","2929淘帝","110/07/13","永興",14,0,14
"11514","2929淘帝","110/07/13","永豐金-敦南",1,21,-20
"11515","2929淘帝","110/07/13","富邦-台北",12,0,12
"11516","2929淘帝","110/07/13","凱基-三重",2,21,-19
"11517","2929淘帝","110/07/13","元大-永和",12,0,12
"11518","2929淘帝","110/07/13","富邦-仁愛",7,25,-18
"11519","2929淘帝","110/07/13","國票-天祥",11,0,11
"11520","2929淘帝","110/07/13","元大-北投",0,16,-16
"11521","2841台開","110/07/13","中國信託-高雄",251,50,201
"11522","2841台開","110/07/13","兆豐-公益",0,177,-177
"11523","2841台開","110/07/13","日盛證券",210,13,197
"11524","2841台開","110/07/13","日進",0,152,-152
"11525","2841台開","110/07/13","第一金-台中",55,0,55
"11526","2841台開","110/07/13","港商野村",0,109,-109
"11527","2841台開","110/07/13","國泰-板橋",46,0,46
"11528","2841台開","110/07/13","日盛-信義",0,103,-103
"11529","2841台開","110/07/13","國泰-館前",48,3,45
"11530","2841台開","110/07/13","國泰-敦南",11,75,-64
"11531","2841台開","110/07/13","華南永昌-新莊",45,0,45
"11532","2841台開","110/07/13","永興",0,50,-50
"11533","2841台開","110/07/13","日盛-園區",42,0,42
"11534","2841台開","110/07/13","永豐金-敦南",61,104,-43
"11535","2841台開","110/07/13","台新證券",32,0,32
"11536","2841台開","110/07/13","富邦-台南",0,42,-42
"11537","2841台開","110/07/13","台新-高雄",32,2,30
"11538","2841台開","110/07/13","國票-安和",0,30,-30
"11539","2841台開","110/07/13","豐農",23,0,23
"11540","2841台開","110/07/13","元大-桃園",0,25,-25
"11541","2841台開","110/07/13","合庫-嘉義",20,0,20
"11542","2841台開","110/07/13","新光",8,32,-24
"11543","2841台開","110/07/13","華南永昌-高雄",20,0,20
"11544","2841台開","110/07/13","元大-仁愛",0,24,-24
"11545","2841台開","110/07/13","元大-樹林",16,0,16
"11546","2841台開","110/07/13","日盛-中和",0,20,-20
"11547","2841台開","110/07/13","第一金-華江",15,2,13
"11548","2841台開","110/07/13","元富",0,20,-20
"11549","2841台開","110/07/13","美商高盛",12,0,12
"11550","2841台開","110/07/13","富邦-宜蘭",0,20,-20
"11551","6207雷科","110/07/13","元大-高雄",121,0,121
"11552","6207雷科","110/07/13","華南永昌-朴子",1,60,-59
"11553","6207雷科","110/07/13","第一金-新興",20,0,20
"11554","6207雷科","110/07/13","元大-南海",0,36,-36
"11555","6207雷科","110/07/13","元富-三重",20,0,20
"11556","6207雷科","110/07/13","凱基-土城",0,35,-35
"11557","6207雷科","110/07/13","元大-林園",15,0,15
"11558","6207雷科","110/07/13","台灣企銀",0,20,-20
"11559","6207雷科","110/07/13","元大-金華",16,1,15
"11560","6207雷科","110/07/13","群益金鼎-丹鳳",0,20,-20
"11561","6207雷科","110/07/13","日盛證券",10,0,10
"11562","6207雷科","110/07/13","元大-博愛",0,17,-17
"11563","6207雷科","110/07/13","統一-台中",10,0,10
"11564","6207雷科","110/07/13","元大-北港",0,13,-13
"11565","6207雷科","110/07/13","群益金鼎-土城",10,0,10
"11566","6207雷科","110/07/13","新加坡商瑞銀",0,12,-12
"11567","6207雷科","110/07/13","群益金鼎-桃園",10,0,10
"11568","6207雷科","110/07/13","凱基-台北",4,16,-12
"11569","6207雷科","110/07/13","永豐金-新莊",10,0,10
"11570","6207雷科","110/07/13","日茂-埔里",0,11,-11
"11571","6207雷科","110/07/13","永豐金-新店",10,0,10
"11572","6207雷科","110/07/13","元大-莒光",0,11,-11
"11573","6207雷科","110/07/13","元大證券",9,0,9
"11574","6207雷科","110/07/13","統一-新竹",0,10,-10
"11575","6207雷科","110/07/13","日盛-木柵",9,1,8
"11576","6207雷科","110/07/13","元大-西螺",0,10,-10
"11577","6207雷科","110/07/13","兆豐-來福",8,0,8
"11578","6207雷科","110/07/13","康和-台中",0,8,-8
"11579","6207雷科","110/07/13","新光",7,0,7
"11580","6207雷科","110/07/13","兆豐-高雄",0,6,-6
"11581","3679新至陞","110/07/13","永豐金證券",50,0,50
"11582","3679新至陞","110/07/13","摩根大通",2,25,-23
"11583","3679新至陞","110/07/13","國泰-桃園",22,0,22
"11584","3679新至陞","110/07/13","元大-成功",0,22,-22
"11585","3679新至陞","110/07/13","台中銀-員林",11,0,11
"11586","3679新至陞","110/07/13","富邦-板橋",1,19,-18
"11587","3679新至陞","110/07/13","元大-文心興安",8,0,8
"11588","3679新至陞","110/07/13","日盛-新莊",0,10,-10
"11589","3679新至陞","110/07/13","美商高盛",6,0,6
"11590","3679新至陞","110/07/13","台新-台中",0,10,-10
"11591","3679新至陞","110/07/13","台新-高雄",6,0,6
"11592","3679新至陞","110/07/13","永豐金-新竹",0,8,-8
"11593","3679新至陞","110/07/13","凱基-台北",18,12,6
"11594","3679新至陞","110/07/13","瑞士信貸",12,19,-7
"11595","3679新至陞","110/07/13","日盛-復興",5,0,5
"11596","3679新至陞","110/07/13","統一-南京",0,7,-7
"11597","3679新至陞","110/07/13","(牛牛牛)亞-鑫豐",4,0,4
"11598","3679新至陞","110/07/13","凱基-新莊",0,7,-7
"11599","3679新至陞","110/07/13","元富-大昌",3,0,3
"11600","3679新至陞","110/07/13","新加坡商瑞銀",0,6,-6
"11601","3679新至陞","110/07/13","富邦-台北",3,0,3
"11602","3679新至陞","110/07/13","合庫-自強",0,5,-5
"11603","3679新至陞","110/07/13","日盛-樹林",2,0,2
"11604","3679新至陞","110/07/13","富邦-桃園",0,5,-5
"11605","3679新至陞","110/07/13","宏遠-光隆",2,0,2
"11606","3679新至陞","110/07/13","永豐金-潮州",0,4,-4
"11607","3679新至陞","110/07/13","美林",3,1,2
"11608","3679新至陞","110/07/13","臺銀-臺南",0,3,-3
"11609","3679新至陞","110/07/13","第一金-中壢",2,0,2
"11610","3679新至陞","110/07/13","元大-六合",0,3,-3
"11611","2727王品","110/07/13","富邦-台北",43,3,40
"11612","2727王品","110/07/13","台灣摩根士丹利",15,97,-82
"11613","2727王品","110/07/13","元大-基隆孝二",40,0,40
"11614","2727王品","110/07/13","玉山-台南",5,57,-52
"11615","2727王品","110/07/13","國票-新莊",40,1,39
"11616","2727王品","110/07/13","新加坡商瑞銀",0,48,-48
"11617","2727王品","110/07/13","第一金-豐原",66,42,24
"11618","2727王品","110/07/13","凱基-台北",41,77,-36
"11619","2727王品","110/07/13","永豐金-大園",34,10,24
"11620","2727王品","110/07/13","永豐金-永康",0,22,-22
"11621","2727王品","110/07/13","元大-北屯",22,0,22
"11622","2727王品","110/07/13","統一-台中",2,22,-20
"11623","2727王品","110/07/13","元大-東蘆",26,7,19
"11624","2727王品","110/07/13","國泰-台中",21,39,-18
"11625","2727王品","110/07/13","永豐金-萬盛",13,1,12
"11626","2727王品","110/07/13","合庫-彰化",3,20,-17
"11627","2727王品","110/07/13","日盛-嘉義",11,0,11
"11628","2727王品","110/07/13","港商野村",13,30,-17
"11629","2727王品","110/07/13","日盛-八德",11,0,11
"11630","2727王品","110/07/13","元大-楊梅",1,16,-15
"11631","2727王品","110/07/13","統一-竹南",11,0,11
"11632","2727王品","110/07/13","凱基-高美館",2,15,-13
"11633","2727王品","110/07/13","日盛-士林",12,2,10
"11634","2727王品","110/07/13","美商高盛",2,14,-12
"11635","2727王品","110/07/13","統一-敦南",10,0,10
"11636","2727王品","110/07/13","統一-平鎮",1,13,-12
"11637","2727王品","110/07/13","中國信託",15,5,10
"11638","2727王品","110/07/13","兆豐-台中港",4,16,-12
"11639","2727王品","110/07/13","兆豐-竹北",13,3,10
"11640","2727王品","110/07/13","凱基-八德",1,13,-12
"11641","1570力肯","110/07/13","新光",115,11,104
"11642","1570力肯","110/07/13","元大-北三重",0,162,-162
"11643","1570力肯","110/07/13","群益金鼎-高雄",54,0,54
"11644","1570力肯","110/07/13","元大-大灣",0,25,-25
"11645","1570力肯","110/07/13","國票-新莊",22,0,22
"11646","1570力肯","110/07/13","永豐金-苓雅",0,22,-22
"11647","1570力肯","110/07/13","日盛-桃園",12,0,12
"11648","1570力肯","110/07/13","永豐金-永康",0,19,-19
"11649","1570力肯","110/07/13","元大-高雄",12,0,12
"11650","1570力肯","110/07/13","富邦-員林",0,15,-15
"11651","1570力肯","110/07/13","合庫-自強",11,0,11
"11652","1570力肯","110/07/13","凱基-台南",0,11,-11
"11653","1570力肯","110/07/13","摩根大通",26,15,11
"11654","1570力肯","110/07/13","日盛-竹北",0,10,-10
"11655","1570力肯","110/07/13","永豐金-中盛",11,0,11
"11656","1570力肯","110/07/13","國票-九鼎",0,10,-10
"11657","1570力肯","110/07/13","兆豐-台中港",10,0,10
"11658","1570力肯","110/07/13","凱基-桃園",0,10,-10
"11659","1570力肯","110/07/13","國泰-松江",9,0,9
"11660","1570力肯","110/07/13","凱基-新豐",0,10,-10
"11661","1570力肯","110/07/13","元大-新盛",9,0,9
"11662","1570力肯","110/07/13","元大-學甲",0,10,-10
"11663","1570力肯","110/07/13","元富-緯城",6,0,6
"11664","1570力肯","110/07/13","群益金鼎-東湖",1,10,-9
"11665","1570力肯","110/07/13","統一-三重",5,0,5
"11666","1570力肯","110/07/13","大昌",0,6,-6
"11667","1570力肯","110/07/13","元大-前金",5,0,5
"11668","1570力肯","110/07/13","元大-土城學府",0,6,-6
"11669","1570力肯","110/07/13","永豐金證券",5,0,5
"11670","1570力肯","110/07/13","統一",0,5,-5
"11671","6180橘子","110/07/13","摩根大通",119,0,119
"11672","6180橘子","110/07/13","元大-崇德",2,61,-59
"11673","6180橘子","110/07/13","美商高盛",96,0,96
"11674","6180橘子","110/07/13","康和-台中",0,51,-51
"11675","6180橘子","110/07/13","新加坡商瑞銀",86,7,79
"11676","6180橘子","110/07/13","康和-台北",0,50,-50
"11677","6180橘子","110/07/13","元大-和平",40,0,40
"11678","6180橘子","110/07/13","元富-潮州",0,40,-40
"11679","6180橘子","110/07/13","凱基-台北",83,47,36
"11680","6180橘子","110/07/13","日盛-永康",0,26,-26
"11681","6180橘子","110/07/13","美林",39,5,34
"11682","6180橘子","110/07/13","永豐金-中正",0,24,-24
"11683","6180橘子","110/07/13","富邦-新竹華信",31,2,29
"11684","6180橘子","110/07/13","國泰-板橋",2,25,-23
"11685","6180橘子","110/07/13","統一-南京",21,0,21
"11686","6180橘子","110/07/13","日盛-大墩",0,20,-20
"11687","6180橘子","110/07/13","富邦-陽明",24,3,21
"11688","6180橘子","110/07/13","元大-草屯",13,32,-19
"11689","6180橘子","110/07/13","大昌-樹林",21,1,20
"11690","6180橘子","110/07/13","元富-林園",1,18,-17
"11691","6180橘子","110/07/13","花旗環球",19,0,19
"11692","6180橘子","110/07/13","新光-新竹",1,18,-17
"11693","6180橘子","110/07/13","華南永昌-台南",19,0,19
"11694","6180橘子","110/07/13","元大-土城永寧",0,17,-17
"11695","6180橘子","110/07/13","福勝",14,0,14
"11696","6180橘子","110/07/13","國泰-新莊",3,19,-16
"11697","6180橘子","110/07/13","富邦-嘉義",12,1,11
"11698","6180橘子","110/07/13","中國信託-永康",6,21,-15
"11699","6180橘子","110/07/13","元大-板橋三民",11,0,11
"11700","6180橘子","110/07/13","凱基-東港",1,15,-14
"11701","2390云辰","110/07/13","新加坡商瑞銀",562,75,487
"11702","2390云辰","110/07/13","大展-台南",0,532,-532
"11703","2390云辰","110/07/13","台灣摩根士丹利",330,155,175
"11704","2390云辰","110/07/13","凱基-台北",668,854,-186
"11705","2390云辰","110/07/13","兆豐-公益",126,25,101
"11706","2390云辰","110/07/13","凱基-三重",12,172,-160
"11707","2390云辰","110/07/13","元富-中港",100,2,98
"11708","2390云辰","110/07/13","兆豐-忠孝",4,161,-157
"11709","2390云辰","110/07/13","統一-新台中",106,9,97
"11710","2390云辰","110/07/13","元大-士林",19,170,-151
"11711","2390云辰","110/07/13","中國信託-松江",81,11,70
"11712","2390云辰","110/07/13","臺銀-新竹",14,117,-103
"11713","2390云辰","110/07/13","日盛-板橋",72,3,69
"11714","2390云辰","110/07/13","國票-台中",4,102,-98
"11715","2390云辰","110/07/13","日盛-和美",57,0,57
"11716","2390云辰","110/07/13","新光",147,232,-85
"11717","2390云辰","110/07/13","永豐金-桃園",88,36,52
"11718","2390云辰","110/07/13","致和-崇德",2,70,-68
"11719","2390云辰","110/07/13","玉山-士林",54,4,50
"11720","2390云辰","110/07/13","群益金鼎-屏東",2,70,-68
"11721","2390云辰","110/07/13","富邦-仁愛",56,6,50
"11722","2390云辰","110/07/13","元大-大里",35,98,-63
"11723","2390云辰","110/07/13","第一金-豐原",50,1,49
"11724","2390云辰","110/07/13","元大-萬華",35,94,-59
"11725","2390云辰","110/07/13","摩根大通",502,453,49
"11726","2390云辰","110/07/13","元富-吉利",2,60,-58
"11727","2390云辰","110/07/13","凱基-松山",61,13,48
"11728","2390云辰","110/07/13","兆豐-新竹",3,53,-50
"11729","2390云辰","110/07/13","大昌",64,22,42
"11730","2390云辰","110/07/13","富邦-嘉義",65,108,-43
"11731","2363矽統","110/07/13","凱基-南崁",2133,63,2070
"11732","2363矽統","110/07/13","凱基-幸福",36,4048,-4012
"11733","2363矽統","110/07/13","國泰-敦南",2195,1617,578
"11734","2363矽統","110/07/13","統一",192,3325,-3133
"11735","2363矽統","110/07/13","中農",670,139,531
"11736","2363矽統","110/07/13","新加坡商瑞銀",1000,2747,-1747
"11737","2363矽統","110/07/13","康和-台中",638,154,484
"11738","2363矽統","110/07/13","凱基-台北",5359,6609,-1250
"11739","2363矽統","110/07/13","群益金鼎-三民",577,137,440
"11740","2363矽統","110/07/13","摩根大通",1930,2858,-928
"11741","2363矽統","110/07/13","台新-屏東",510,88,422
"11742","2363矽統","110/07/13","港商野村",960,1679,-719
"11743","2363矽統","110/07/13","德信-中正",455,67,388
"11744","2363矽統","110/07/13","兆豐-復興",25,705,-680
"11745","2363矽統","110/07/13","日盛-竹北",365,70,295
"11746","2363矽統","110/07/13","統一-仁愛",114,755,-641
"11747","2363矽統","110/07/13","元大-佳里",452,189,263
"11748","2363矽統","110/07/13","統一-敦南",29,638,-609
"11749","2363矽統","110/07/13","國票-博愛",296,38,258
"11750","2363矽統","110/07/13","統一-土城",100,704,-604
"11751","2363矽統","110/07/13","元大-萬華",340,95,245
"11752","2363矽統","110/07/13","統一-城中",116,676,-560
"11753","2363矽統","110/07/13","新光",1259,1031,228
"11754","2363矽統","110/07/13","永豐金證券",306,859,-553
"11755","2363矽統","110/07/13","元富-成功",323,96,227
"11756","2363矽統","110/07/13","元富",54,567,-513
"11757","2363矽統","110/07/13","豐農",228,23,205
"11758","2363矽統","110/07/13","瑞士信貸",202,666,-464
"11759","2363矽統","110/07/13","台灣企銀-岡山",186,4,182
"11760","2363矽統","110/07/13","永豐金-嘉義",67,468,-401
"11761","8112至上","110/07/13","摩根大通",688,296,392
"11762","8112至上","110/07/13","國票-中和",0,401,-401
"11763","8112至上","110/07/13","港商野村",344,145,199
"11764","8112至上","110/07/13","永豐金-板盛",0,205,-205
"11765","8112至上","110/07/13","兆豐-公益",195,5,190
"11766","8112至上","110/07/13","凱基-五股",43,155,-112
"11767","8112至上","110/07/13","台灣摩根士丹利",183,0,183
"11768","8112至上","110/07/13","凱基-市政",0,100,-100
"11769","8112至上","110/07/13","群益金鼎-敦南",153,2,151
"11770","8112至上","110/07/13","元大-大里德芳",1,92,-91
"11771","8112至上","110/07/13","臺銀-金山",146,26,120
"11772","8112至上","110/07/13","玉山-桃園",26,110,-84
"11773","8112至上","110/07/13","臺銀",133,19,114
"11774","8112至上","110/07/13","兆豐-天母",0,81,-81
"11775","8112至上","110/07/13","合庫-台中",115,6,109
"11776","8112至上","110/07/13","凱基-城中",3,84,-81
"11777","8112至上","110/07/13","亞東-板橋",134,26,108
"11778","8112至上","110/07/13","日盛-新莊",9,85,-76
"11779","8112至上","110/07/13","凱基-台北",414,326,88
"11780","8112至上","110/07/13","日盛-台中",2,64,-62
"11781","8112至上","110/07/13","新加坡商瑞銀",181,100,81
"11782","8112至上","110/07/13","日盛-中壢",3,64,-61
"11783","8112至上","110/07/13","國泰-敦南",108,31,77
"11784","8112至上","110/07/13","元大-台中",2,59,-57
"11785","8112至上","110/07/13","第一金-華江",77,4,73
"11786","8112至上","110/07/13","元大-雙和",7,64,-57
"11787","8112至上","110/07/13","永豐金-內湖",73,1,72
"11788","8112至上","110/07/13","元大-高雄",8,62,-54
"11789","8112至上","110/07/13","元大-永和",68,1,67
"11790","8112至上","110/07/13","元大-館前",2,55,-53
"11791","2929淘帝","110/07/13","玉山-新竹",130,0,130
"11792","2929淘帝","110/07/13","美商高盛",0,177,-177
"11793","2929淘帝","110/07/13","臺銀-民權",60,0,60
"11794","2929淘帝","110/07/13","凱基-台北",6,80,-74
"11795","2929淘帝","110/07/13","新百王",31,0,31
"11796","2929淘帝","110/07/13","元富-大裕",0,49,-49
"11797","2929淘帝","110/07/13","日盛-園區",30,0,30
"11798","2929淘帝","110/07/13","國泰-館前",3,51,-48
"11799","2929淘帝","110/07/13","元大-南投",31,1,30
"11800","2929淘帝","110/07/13","凱基-中壢",0,41,-41
"11801","2929淘帝","110/07/13","兆豐-忠孝",28,0,28
"11802","2929淘帝","110/07/13","港商野村",21,55,-34
"11803","2929淘帝","110/07/13","元大-民生",28,0,28
"11804","2929淘帝","110/07/13","華南永昌-南京",2,34,-32
"11805","2929淘帝","110/07/13","合庫-高雄",27,0,27
"11806","2929淘帝","110/07/13","群益金鼎-土城",0,30,-30
"11807","2929淘帝","110/07/13","凱基-豐中",27,0,27
"11808","2929淘帝","110/07/13","富邦-南屯",0,22,-22
"11809","2929淘帝","110/07/13","新光",21,4,17
"11810","2929淘帝","110/07/13","第一金-豐原",0,20,-20
"11811","2929淘帝","110/07/13","元大-天母",17,0,17
"11812","2929淘帝","110/07/13","元大-屏南",6,26,-20
"11813","2929淘帝","110/07/13","永興",14,0,14
"11814","2929淘帝","110/07/13","永豐金-敦南",1,21,-20
"11815","2929淘帝","110/07/13","富邦-台北",12,0,12
"11816","2929淘帝","110/07/13","凱基-三重",2,21,-19
"11817","2929淘帝","110/07/13","元大-永和",12,0,12
"11818","2929淘帝","110/07/13","富邦-仁愛",7,25,-18
"11819","2929淘帝","110/07/13","國票-天祥",11,0,11
"11820","2929淘帝","110/07/13","元大-北投",0,16,-16
"11821","5410國眾","110/07/13","兆豐-城中",274,0,274
"11822","5410國眾","110/07/13","元富-嘉義",0,103,-103
"11823","5410國眾","110/07/13","新光",50,4,46
"11824","5410國眾","110/07/13","凱基-台北",0,50,-50
"11825","5410國眾","110/07/13","國泰-台中",26,0,26
"11826","5410國眾","110/07/13","瑞士信貸",0,31,-31
"11827","5410國眾","110/07/13","新加坡商瑞銀",22,0,22
"11828","5410國眾","110/07/13","台新-新莊",0,27,-27
"11829","5410國眾","110/07/13","光和-嘉義",20,0,20
"11830","5410國眾","110/07/13","元大-汐止",0,20,-20
"11831","5410國眾","110/07/13","凱基-竹北",17,0,17
"11832","5410國眾","110/07/13","亞東-新竹",0,17,-17
"11833","5410國眾","110/07/13","新光-桃園",15,0,15
"11834","5410國眾","110/07/13","元大-南勢角",0,13,-13
"11835","5410國眾","110/07/13","凱基-台東",14,0,14
"11836","5410國眾","110/07/13","台新-台南",0,12,-12
"11837","5410國眾","110/07/13","富邦-竹北",11,0,11
"11838","5410國眾","110/07/13","中國信託",0,11,-11
"11839","5410國眾","110/07/13","元富-同大",10,0,10
"11840","5410國眾","110/07/13","華南永昌",0,11,-11
"11841","5410國眾","110/07/13","國泰-敦南",24,15,9
"11842","5410國眾","110/07/13","臺銀-臺南",0,10,-10
"11843","5410國眾","110/07/13","日盛-內湖",7,0,7
"11844","5410國眾","110/07/13","台灣企銀-民雄",0,10,-10
"11845","5410國眾","110/07/13","台新-左楠",7,0,7
"11846","5410國眾","110/07/13","高橋",0,10,-10
"11847","5410國眾","110/07/13","元大-新盛",18,12,6
"11848","5410國眾","110/07/13","康和-嘉義",0,10,-10
"11849","5410國眾","110/07/13","統一",5,0,5
"11850","5410國眾","110/07/13","凱基-基隆",0,10,-10
"11851","2841台開","110/07/13","中國信託-高雄",251,50,201
"11852","2841台開","110/07/13","兆豐-公益",0,177,-177
"11853","2841台開","110/07/13","日盛證券",210,13,197
"11854","2841台開","110/07/13","日進",0,152,-152
"11855","2841台開","110/07/13","第一金-台中",55,0,55
"11856","2841台開","110/07/13","港商野村",0,109,-109
"11857","2841台開","110/07/13","國泰-板橋",46,0,46
"11858","2841台開","110/07/13","日盛-信義",0,103,-103
"11859","2841台開","110/07/13","國泰-館前",48,3,45
"11860","2841台開","110/07/13","國泰-敦南",11,75,-64
"11861","2841台開","110/07/13","華南永昌-新莊",45,0,45
"11862","2841台開","110/07/13","永興",0,50,-50
"11863","2841台開","110/07/13","日盛-園區",42,0,42
"11864","2841台開","110/07/13","永豐金-敦南",61,104,-43
"11865","2841台開","110/07/13","台新證券",32,0,32
"11866","2841台開","110/07/13","富邦-台南",0,42,-42
"11867","2841台開","110/07/13","台新-高雄",32,2,30
"11868","2841台開","110/07/13","國票-安和",0,30,-30
"11869","2841台開","110/07/13","豐農",23,0,23
"11870","2841台開","110/07/13","元大-桃園",0,25,-25
"11871","2841台開","110/07/13","合庫-嘉義",20,0,20
"11872","2841台開","110/07/13","新光",8,32,-24
"11873","2841台開","110/07/13","華南永昌-高雄",20,0,20
"11874","2841台開","110/07/13","元大-仁愛",0,24,-24
"11875","2841台開","110/07/13","元大-樹林",16,0,16
"11876","2841台開","110/07/13","日盛-中和",0,20,-20
"11877","2841台開","110/07/13","第一金-華江",15,2,13
"11878","2841台開","110/07/13","元富",0,20,-20
"11879","2841台開","110/07/13","美商高盛",12,0,12
"11880","2841台開","110/07/13","富邦-宜蘭",0,20,-20
"11881","6207雷科","110/07/13","元大-高雄",121,0,121
"11882","6207雷科","110/07/13","華南永昌-朴子",1,60,-59
"11883","6207雷科","110/07/13","第一金-新興",20,0,20
"11884","6207雷科","110/07/13","元大-南海",0,36,-36
"11885","6207雷科","110/07/13","元富-三重",20,0,20
"11886","6207雷科","110/07/13","凱基-土城",0,35,-35
"11887","6207雷科","110/07/13","元大-林園",15,0,15
"11888","6207雷科","110/07/13","台灣企銀",0,20,-20
"11889","6207雷科","110/07/13","元大-金華",16,1,15
"11890","6207雷科","110/07/13","群益金鼎-丹鳳",0,20,-20
"11891","6207雷科","110/07/13","日盛證券",10,0,10
"11892","6207雷科","110/07/13","元大-博愛",0,17,-17
"11893","6207雷科","110/07/13","統一-台中",10,0,10
"11894","6207雷科","110/07/13","元大-北港",0,13,-13
"11895","6207雷科","110/07/13","群益金鼎-土城",10,0,10
"11896","6207雷科","110/07/13","新加坡商瑞銀",0,12,-12
"11897","6207雷科","110/07/13","群益金鼎-桃園",10,0,10
"11898","6207雷科","110/07/13","凱基-台北",4,16,-12
"11899","6207雷科","110/07/13","永豐金-新莊",10,0,10
"11900","6207雷科","110/07/13","日茂-埔里",0,11,-11
"11901","6207雷科","110/07/13","永豐金-新店",10,0,10
"11902","6207雷科","110/07/13","元大-莒光",0,11,-11
"11903","6207雷科","110/07/13","元大證券",9,0,9
"11904","6207雷科","110/07/13","統一-新竹",0,10,-10
"11905","6207雷科","110/07/13","日盛-木柵",9,1,8
"11906","6207雷科","110/07/13","元大-西螺",0,10,-10
"11907","6207雷科","110/07/13","兆豐-來福",8,0,8
"11908","6207雷科","110/07/13","康和-台中",0,8,-8
"11909","6207雷科","110/07/13","新光",7,0,7
"11910","6207雷科","110/07/13","兆豐-高雄",0,6,-6
"11911","3679新至陞","110/07/13","永豐金證券",50,0,50
"11912","3679新至陞","110/07/13","摩根大通",2,25,-23
"11913","3679新至陞","110/07/13","國泰-桃園",22,0,22
"11914","3679新至陞","110/07/13","元大-成功",0,22,-22
"11915","3679新至陞","110/07/13","台中銀-員林",11,0,11
"11916","3679新至陞","110/07/13","富邦-板橋",1,19,-18
"11917","3679新至陞","110/07/13","元大-文心興安",8,0,8
"11918","3679新至陞","110/07/13","日盛-新莊",0,10,-10
"11919","3679新至陞","110/07/13","美商高盛",6,0,6
"11920","3679新至陞","110/07/13","台新-台中",0,10,-10
"11921","3679新至陞","110/07/13","台新-高雄",6,0,6
"11922","3679新至陞","110/07/13","永豐金-新竹",0,8,-8
"11923","3679新至陞","110/07/13","凱基-台北",18,12,6
"11924","3679新至陞","110/07/13","瑞士信貸",12,19,-7
"11925","3679新至陞","110/07/13","日盛-復興",5,0,5
"11926","3679新至陞","110/07/13","統一-南京",0,7,-7
"11927","3679新至陞","110/07/13","(牛牛牛)亞-鑫豐",4,0,4
"11928","3679新至陞","110/07/13","凱基-新莊",0,7,-7
"11929","3679新至陞","110/07/13","元富-大昌",3,0,3
"11930","3679新至陞","110/07/13","新加坡商瑞銀",0,6,-6
"11931","3679新至陞","110/07/13","富邦-台北",3,0,3
"11932","3679新至陞","110/07/13","合庫-自強",0,5,-5
"11933","3679新至陞","110/07/13","日盛-樹林",2,0,2
"11934","3679新至陞","110/07/13","富邦-桃園",0,5,-5
"11935","3679新至陞","110/07/13","宏遠-光隆",2,0,2
"11936","3679新至陞","110/07/13","永豐金-潮州",0,4,-4
"11937","3679新至陞","110/07/13","美林",3,1,2
"11938","3679新至陞","110/07/13","臺銀-臺南",0,3,-3
"11939","3679新至陞","110/07/13","第一金-中壢",2,0,2
"11940","3679新至陞","110/07/13","元大-六合",0,3,-3
"11941","2727王品","110/07/13","富邦-台北",43,3,40
"11942","2727王品","110/07/13","台灣摩根士丹利",15,97,-82
"11943","2727王品","110/07/13","元大-基隆孝二",40,0,40
"11944","2727王品","110/07/13","玉山-台南",5,57,-52
"11945","2727王品","110/07/13","國票-新莊",40,1,39
"11946","2727王品","110/07/13","新加坡商瑞銀",0,48,-48
"11947","2727王品","110/07/13","第一金-豐原",66,42,24
"11948","2727王品","110/07/13","凱基-台北",41,77,-36
"11949","2727王品","110/07/13","永豐金-大園",34,10,24
"11950","2727王品","110/07/13","永豐金-永康",0,22,-22
"11951","2727王品","110/07/13","元大-北屯",22,0,22
"11952","2727王品","110/07/13","統一-台中",2,22,-20
"11953","2727王品","110/07/13","元大-東蘆",26,7,19
"11954","2727王品","110/07/13","國泰-台中",21,39,-18
"11955","2727王品","110/07/13","永豐金-萬盛",13,1,12
"11956","2727王品","110/07/13","合庫-彰化",3,20,-17
"11957","2727王品","110/07/13","日盛-嘉義",11,0,11
"11958","2727王品","110/07/13","港商野村",13,30,-17
"11959","2727王品","110/07/13","日盛-八德",11,0,11
"11960","2727王品","110/07/13","元大-楊梅",1,16,-15
"11961","2727王品","110/07/13","統一-竹南",11,0,11
"11962","2727王品","110/07/13","凱基-高美館",2,15,-13
"11963","2727王品","110/07/13","日盛-士林",12,2,10
"11964","2727王品","110/07/13","美商高盛",2,14,-12
"11965","2727王品","110/07/13","統一-敦南",10,0,10
"11966","2727王品","110/07/13","統一-平鎮",1,13,-12
"11967","2727王品","110/07/13","中國信託",15,5,10
"11968","2727王品","110/07/13","兆豐-台中港",4,16,-12
"11969","2727王品","110/07/13","兆豐-竹北",13,3,10
"11970","2727王品","110/07/13","凱基-八德",1,13,-12
"11971","1570力肯","110/07/13","新光",115,11,104
"11972","1570力肯","110/07/13","元大-北三重",0,162,-162
"11973","1570力肯","110/07/13","群益金鼎-高雄",54,0,54
"11974","1570力肯","110/07/13","元大-大灣",0,25,-25
"11975","1570力肯","110/07/13","國票-新莊",22,0,22
"11976","1570力肯","110/07/13","永豐金-苓雅",0,22,-22
"11977","1570力肯","110/07/13","日盛-桃園",12,0,12
"11978","1570力肯","110/07/13","永豐金-永康",0,19,-19
"11979","1570力肯","110/07/13","元大-高雄",12,0,12
"11980","1570力肯","110/07/13","富邦-員林",0,15,-15
"11981","1570力肯","110/07/13","合庫-自強",11,0,11
"11982","1570力肯","110/07/13","凱基-台南",0,11,-11
"11983","1570力肯","110/07/13","摩根大通",26,15,11
"11984","1570力肯","110/07/13","日盛-竹北",0,10,-10
"11985","1570力肯","110/07/13","永豐金-中盛",11,0,11
"11986","1570力肯","110/07/13","國票-九鼎",0,10,-10
"11987","1570力肯","110/07/13","兆豐-台中港",10,0,10
"11988","1570力肯","110/07/13","凱基-桃園",0,10,-10
"11989","1570力肯","110/07/13","國泰-松江",9,0,9
"11990","1570力肯","110/07/13","凱基-新豐",0,10,-10
"11991","1570力肯","110/07/13","元大-新盛",9,0,9
"11992","1570力肯","110/07/13","元大-學甲",0,10,-10
"11993","1570力肯","110/07/13","元富-緯城",6,0,6
"11994","1570力肯","110/07/13","群益金鼎-東湖",1,10,-9
"11995","1570力肯","110/07/13","統一-三重",5,0,5
"11996","1570力肯","110/07/13","大昌",0,6,-6
"11997","1570力肯","110/07/13","元大-前金",5,0,5
"11998","1570力肯","110/07/13","元大-土城學府",0,6,-6
"11999","1570力肯","110/07/13","永豐金證券",5,0,5
"12000","1570力肯","110/07/13","統一",0,5,-5
"12001","6180橘子","110/07/13","摩根大通",119,0,119
"12002","6180橘子","110/07/13","元大-崇德",2,61,-59
"12003","6180橘子","110/07/13","美商高盛",96,0,96
"12004","6180橘子","110/07/13","康和-台中",0,51,-51
"12005","6180橘子","110/07/13","新加坡商瑞銀",86,7,79
"12006","6180橘子","110/07/13","康和-台北",0,50,-50
"12007","6180橘子","110/07/13","元大-和平",40,0,40
"12008","6180橘子","110/07/13","元富-潮州",0,40,-40
"12009","6180橘子","110/07/13","凱基-台北",83,47,36
"12010","6180橘子","110/07/13","日盛-永康",0,26,-26
"12011","6180橘子","110/07/13","美林",39,5,34
"12012","6180橘子","110/07/13","永豐金-中正",0,24,-24
"12013","6180橘子","110/07/13","富邦-新竹華信",31,2,29
"12014","6180橘子","110/07/13","國泰-板橋",2,25,-23
"12015","6180橘子","110/07/13","統一-南京",21,0,21
"12016","6180橘子","110/07/13","日盛-大墩",0,20,-20
"12017","6180橘子","110/07/13","富邦-陽明",24,3,21
"12018","6180橘子","110/07/13","元大-草屯",13,32,-19
"12019","6180橘子","110/07/13","大昌-樹林",21,1,20
"12020","6180橘子","110/07/13","元富-林園",1,18,-17
"12021","6180橘子","110/07/13","花旗環球",19,0,19
"12022","6180橘子","110/07/13","新光-新竹",1,18,-17
"12023","6180橘子","110/07/13","華南永昌-台南",19,0,19
"12024","6180橘子","110/07/13","元大-土城永寧",0,17,-17
"12025","6180橘子","110/07/13","福勝",14,0,14
"12026","6180橘子","110/07/13","國泰-新莊",3,19,-16
"12027","6180橘子","110/07/13","富邦-嘉義",12,1,11
"12028","6180橘子","110/07/13","中國信託-永康",6,21,-15
"12029","6180橘子","110/07/13","元大-板橋三民",11,0,11
"12030","6180橘子","110/07/13","凱基-東港",1,15,-14
"12031","2390云辰","110/07/13","新加坡商瑞銀",562,75,487
"12032","2390云辰","110/07/13","大展-台南",0,532,-532
"12033","2390云辰","110/07/13","台灣摩根士丹利",330,155,175
"12034","2390云辰","110/07/13","凱基-台北",668,854,-186
"12035","2390云辰","110/07/13","兆豐-公益",126,25,101
"12036","2390云辰","110/07/13","凱基-三重",12,172,-160
"12037","2390云辰","110/07/13","元富-中港",100,2,98
"12038","2390云辰","110/07/13","兆豐-忠孝",4,161,-157
"12039","2390云辰","110/07/13","統一-新台中",106,9,97
"12040","2390云辰","110/07/13","元大-士林",19,170,-151
"12041","2390云辰","110/07/13","中國信託-松江",81,11,70
"12042","2390云辰","110/07/13","臺銀-新竹",14,117,-103
"12043","2390云辰","110/07/13","日盛-板橋",72,3,69
"12044","2390云辰","110/07/13","國票-台中",4,102,-98
"12045","2390云辰","110/07/13","日盛-和美",57,0,57
"12046","2390云辰","110/07/13","新光",147,232,-85
"12047","2390云辰","110/07/13","永豐金-桃園",88,36,52
"12048","2390云辰","110/07/13","致和-崇德",2,70,-68
"12049","2390云辰","110/07/13","玉山-士林",54,4,50
"12050","2390云辰","110/07/13","群益金鼎-屏東",2,70,-68
"12051","2390云辰","110/07/13","富邦-仁愛",56,6,50
"12052","2390云辰","110/07/13","元大-大里",35,98,-63
"12053","2390云辰","110/07/13","第一金-豐原",50,1,49
"12054","2390云辰","110/07/13","元大-萬華",35,94,-59
"12055","2390云辰","110/07/13","摩根大通",502,453,49
"12056","2390云辰","110/07/13","元富-吉利",2,60,-58
"12057","2390云辰","110/07/13","凱基-松山",61,13,48
"12058","2390云辰","110/07/13","兆豐-新竹",3,53,-50
"12059","2390云辰","110/07/13","大昌",64,22,42
"12060","2390云辰","110/07/13","富邦-嘉義",65,108,-43
"12061","2363矽統","110/07/13","凱基-南崁",2133,63,2070
"12062","2363矽統","110/07/13","凱基-幸福",36,4048,-4012
"12063","2363矽統","110/07/13","國泰-敦南",2195,1617,578
"12064","2363矽統","110/07/13","統一",192,3325,-3133
"12065","2363矽統","110/07/13","中農",670,139,531
"12066","2363矽統","110/07/13","新加坡商瑞銀",1000,2747,-1747
"12067","2363矽統","110/07/13","康和-台中",638,154,484
"12068","2363矽統","110/07/13","凱基-台北",5359,6609,-1250
"12069","2363矽統","110/07/13","群益金鼎-三民",577,137,440
"12070","2363矽統","110/07/13","摩根大通",1930,2858,-928
"12071","2363矽統","110/07/13","台新-屏東",510,88,422
"12072","2363矽統","110/07/13","港商野村",960,1679,-719
"12073","2363矽統","110/07/13","德信-中正",455,67,388
"12074","2363矽統","110/07/13","兆豐-復興",25,705,-680
"12075","2363矽統","110/07/13","日盛-竹北",365,70,295
"12076","2363矽統","110/07/13","統一-仁愛",114,755,-641
"12077","2363矽統","110/07/13","元大-佳里",452,189,263
"12078","2363矽統","110/07/13","統一-敦南",29,638,-609
"12079","2363矽統","110/07/13","國票-博愛",296,38,258
"12080","2363矽統","110/07/13","統一-土城",100,704,-604
"12081","2363矽統","110/07/13","元大-萬華",340,95,245
"12082","2363矽統","110/07/13","統一-城中",116,676,-560
"12083","2363矽統","110/07/13","新光",1259,1031,228
"12084","2363矽統","110/07/13","永豐金證券",306,859,-553
"12085","2363矽統","110/07/13","元富-成功",323,96,227
"12086","2363矽統","110/07/13","元富",54,567,-513
"12087","2363矽統","110/07/13","豐農",228,23,205
"12088","2363矽統","110/07/13","瑞士信貸",202,666,-464
"12089","2363矽統","110/07/13","台灣企銀-岡山",186,4,182
"12090","2363矽統","110/07/13","永豐金-嘉義",67,468,-401
"12091","8112至上","110/07/13","摩根大通",688,296,392
"12092","8112至上","110/07/13","國票-中和",0,401,-401
"12093","8112至上","110/07/13","港商野村",344,145,199
"12094","8112至上","110/07/13","永豐金-板盛",0,205,-205
"12095","8112至上","110/07/13","兆豐-公益",195,5,190
"12096","8112至上","110/07/13","凱基-五股",43,155,-112
"12097","8112至上","110/07/13","台灣摩根士丹利",183,0,183
"12098","8112至上","110/07/13","凱基-市政",0,100,-100
"12099","8112至上","110/07/13","群益金鼎-敦南",153,2,151
"12100","8112至上","110/07/13","元大-大里德芳",1,92,-91
"12101","8112至上","110/07/13","臺銀-金山",146,26,120
"12102","8112至上","110/07/13","玉山-桃園",26,110,-84
"12103","8112至上","110/07/13","臺銀",133,19,114
"12104","8112至上","110/07/13","兆豐-天母",0,81,-81
"12105","8112至上","110/07/13","合庫-台中",115,6,109
"12106","8112至上","110/07/13","凱基-城中",3,84,-81
"12107","8112至上","110/07/13","亞東-板橋",134,26,108
"12108","8112至上","110/07/13","日盛-新莊",9,85,-76
"12109","8112至上","110/07/13","凱基-台北",414,326,88
"12110","8112至上","110/07/13","日盛-台中",2,64,-62
"12111","8112至上","110/07/13","新加坡商瑞銀",181,100,81
"12112","8112至上","110/07/13","日盛-中壢",3,64,-61
"12113","8112至上","110/07/13","國泰-敦南",108,31,77
"12114","8112至上","110/07/13","元大-台中",2,59,-57
"12115","8112至上","110/07/13","第一金-華江",77,4,73
"12116","8112至上","110/07/13","元大-雙和",7,64,-57
"12117","8112至上","110/07/13","永豐金-內湖",73,1,72
"12118","8112至上","110/07/13","元大-高雄",8,62,-54
"12119","8112至上","110/07/13","元大-永和",68,1,67
"12120","8112至上","110/07/13","元大-館前",2,55,-53
"12121","2929淘帝","110/07/13","玉山-新竹",130,0,130
"12122","2929淘帝","110/07/13","美商高盛",0,177,-177
"12123","2929淘帝","110/07/13","臺銀-民權",60,0,60
"12124","2929淘帝","110/07/13","凱基-台北",6,80,-74
"12125","2929淘帝","110/07/13","新百王",31,0,31
"12126","2929淘帝","110/07/13","元富-大裕",0,49,-49
"12127","2929淘帝","110/07/13","日盛-園區",30,0,30
"12128","2929淘帝","110/07/13","國泰-館前",3,51,-48
"12129","2929淘帝","110/07/13","元大-南投",31,1,30
"12130","2929淘帝","110/07/13","凱基-中壢",0,41,-41
"12131","2929淘帝","110/07/13","兆豐-忠孝",28,0,28
"12132","2929淘帝","110/07/13","港商野村",21,55,-34
"12133","2929淘帝","110/07/13","元大-民生",28,0,28
"12134","2929淘帝","110/07/13","華南永昌-南京",2,34,-32
"12135","2929淘帝","110/07/13","合庫-高雄",27,0,27
"12136","2929淘帝","110/07/13","群益金鼎-土城",0,30,-30
"12137","2929淘帝","110/07/13","凱基-豐中",27,0,27
"12138","2929淘帝","110/07/13","富邦-南屯",0,22,-22
"12139","2929淘帝","110/07/13","新光",21,4,17
"12140","2929淘帝","110/07/13","第一金-豐原",0,20,-20
"12141","2929淘帝","110/07/13","元大-天母",17,0,17
"12142","2929淘帝","110/07/13","元大-屏南",6,26,-20
"12143","2929淘帝","110/07/13","永興",14,0,14
"12144","2929淘帝","110/07/13","永豐金-敦南",1,21,-20
"12145","2929淘帝","110/07/13","富邦-台北",12,0,12
"12146","2929淘帝","110/07/13","凱基-三重",2,21,-19
"12147","2929淘帝","110/07/13","元大-永和",12,0,12
"12148","2929淘帝","110/07/13","富邦-仁愛",7,25,-18
"12149","2929淘帝","110/07/13","國票-天祥",11,0,11
"12150","2929淘帝","110/07/13","元大-北投",0,16,-16
"12151","5410國眾","110/07/13","兆豐-城中",274,0,274
"12152","5410國眾","110/07/13","元富-嘉義",0,103,-103
"12153","5410國眾","110/07/13","新光",50,4,46
"12154","5410國眾","110/07/13","凱基-台北",0,50,-50
"12155","5410國眾","110/07/13","國泰-台中",26,0,26
"12156","5410國眾","110/07/13","瑞士信貸",0,31,-31
"12157","5410國眾","110/07/13","新加坡商瑞銀",22,0,22
"12158","5410國眾","110/07/13","台新-新莊",0,27,-27
"12159","5410國眾","110/07/13","光和-嘉義",20,0,20
"12160","5410國眾","110/07/13","元大-汐止",0,20,-20
"12161","5410國眾","110/07/13","凱基-竹北",17,0,17
"12162","5410國眾","110/07/13","亞東-新竹",0,17,-17
"12163","5410國眾","110/07/13","新光-桃園",15,0,15
"12164","5410國眾","110/07/13","元大-南勢角",0,13,-13
"12165","5410國眾","110/07/13","凱基-台東",14,0,14
"12166","5410國眾","110/07/13","台新-台南",0,12,-12
"12167","5410國眾","110/07/13","富邦-竹北",11,0,11
"12168","5410國眾","110/07/13","中國信託",0,11,-11
"12169","5410國眾","110/07/13","元富-同大",10,0,10
"12170","5410國眾","110/07/13","華南永昌",0,11,-11
"12171","5410國眾","110/07/13","國泰-敦南",24,15,9
"12172","5410國眾","110/07/13","臺銀-臺南",0,10,-10
"12173","5410國眾","110/07/13","日盛-內湖",7,0,7
"12174","5410國眾","110/07/13","台灣企銀-民雄",0,10,-10
"12175","5410國眾","110/07/13","台新-左楠",7,0,7
"12176","5410國眾","110/07/13","高橋",0,10,-10
"12177","5410國眾","110/07/13","元大-新盛",18,12,6
"12178","5410國眾","110/07/13","康和-嘉義",0,10,-10
"12179","5410國眾","110/07/13","統一",5,0,5
"12180","5410國眾","110/07/13","凱基-基隆",0,10,-10
"12181","2841台開","110/07/13","中國信託-高雄",251,50,201
"12182","2841台開","110/07/13","兆豐-公益",0,177,-177
"12183","2841台開","110/07/13","日盛證券",210,13,197
"12184","2841台開","110/07/13","日進",0,152,-152
"12185","2841台開","110/07/13","第一金-台中",55,0,55
"12186","2841台開","110/07/13","港商野村",0,109,-109
"12187","2841台開","110/07/13","國泰-板橋",46,0,46
"12188","2841台開","110/07/13","日盛-信義",0,103,-103
"12189","2841台開","110/07/13","國泰-館前",48,3,45
"12190","2841台開","110/07/13","國泰-敦南",11,75,-64
"12191","2841台開","110/07/13","華南永昌-新莊",45,0,45
"12192","2841台開","110/07/13","永興",0,50,-50
"12193","2841台開","110/07/13","日盛-園區",42,0,42
"12194","2841台開","110/07/13","永豐金-敦南",61,104,-43
"12195","2841台開","110/07/13","台新證券",32,0,32
"12196","2841台開","110/07/13","富邦-台南",0,42,-42
"12197","2841台開","110/07/13","台新-高雄",32,2,30
"12198","2841台開","110/07/13","國票-安和",0,30,-30
"12199","2841台開","110/07/13","豐農",23,0,23
"12200","2841台開","110/07/13","元大-桃園",0,25,-25
"12201","2841台開","110/07/13","合庫-嘉義",20,0,20
"12202","2841台開","110/07/13","新光",8,32,-24
"12203","2841台開","110/07/13","華南永昌-高雄",20,0,20
"12204","2841台開","110/07/13","元大-仁愛",0,24,-24
"12205","2841台開","110/07/13","元大-樹林",16,0,16
"12206","2841台開","110/07/13","日盛-中和",0,20,-20
"12207","2841台開","110/07/13","第一金-華江",15,2,13
"12208","2841台開","110/07/13","元富",0,20,-20
"12209","2841台開","110/07/13","美商高盛",12,0,12
"12210","2841台開","110/07/13","富邦-宜蘭",0,20,-20
"12211","6207雷科","110/07/13","元大-高雄",121,0,121
"12212","6207雷科","110/07/13","華南永昌-朴子",1,60,-59
"12213","6207雷科","110/07/13","第一金-新興",20,0,20
"12214","6207雷科","110/07/13","元大-南海",0,36,-36
"12215","6207雷科","110/07/13","元富-三重",20,0,20
"12216","6207雷科","110/07/13","凱基-土城",0,35,-35
"12217","6207雷科","110/07/13","元大-林園",15,0,15
"12218","6207雷科","110/07/13","台灣企銀",0,20,-20
"12219","6207雷科","110/07/13","元大-金華",16,1,15
"12220","6207雷科","110/07/13","群益金鼎-丹鳳",0,20,-20
"12221","6207雷科","110/07/13","日盛證券",10,0,10
"12222","6207雷科","110/07/13","元大-博愛",0,17,-17
"12223","6207雷科","110/07/13","統一-台中",10,0,10
"12224","6207雷科","110/07/13","元大-北港",0,13,-13
"12225","6207雷科","110/07/13","群益金鼎-土城",10,0,10
"12226","6207雷科","110/07/13","新加坡商瑞銀",0,12,-12
"12227","6207雷科","110/07/13","群益金鼎-桃園",10,0,10
"12228","6207雷科","110/07/13","凱基-台北",4,16,-12
"12229","6207雷科","110/07/13","永豐金-新莊",10,0,10
"12230","6207雷科","110/07/13","日茂-埔里",0,11,-11
"12231","6207雷科","110/07/13","永豐金-新店",10,0,10
"12232","6207雷科","110/07/13","元大-莒光",0,11,-11
"12233","6207雷科","110/07/13","元大證券",9,0,9
"12234","6207雷科","110/07/13","統一-新竹",0,10,-10
"12235","6207雷科","110/07/13","日盛-木柵",9,1,8
"12236","6207雷科","110/07/13","元大-西螺",0,10,-10
"12237","6207雷科","110/07/13","兆豐-來福",8,0,8
"12238","6207雷科","110/07/13","康和-台中",0,8,-8
"12239","6207雷科","110/07/13","新光",7,0,7
"12240","6207雷科","110/07/13","兆豐-高雄",0,6,-6
"12241","3679新至陞","110/07/13","永豐金證券",50,0,50
"12242","3679新至陞","110/07/13","摩根大通",2,25,-23
"12243","3679新至陞","110/07/13","國泰-桃園",22,0,22
"12244","3679新至陞","110/07/13","元大-成功",0,22,-22
"12245","3679新至陞","110/07/13","台中銀-員林",11,0,11
"12246","3679新至陞","110/07/13","富邦-板橋",1,19,-18
"12247","3679新至陞","110/07/13","元大-文心興安",8,0,8
"12248","3679新至陞","110/07/13","日盛-新莊",0,10,-10
"12249","3679新至陞","110/07/13","美商高盛",6,0,6
"12250","3679新至陞","110/07/13","台新-台中",0,10,-10
"12251","3679新至陞","110/07/13","台新-高雄",6,0,6
"12252","3679新至陞","110/07/13","永豐金-新竹",0,8,-8
"12253","3679新至陞","110/07/13","凱基-台北",18,12,6
"12254","3679新至陞","110/07/13","瑞士信貸",12,19,-7
"12255","3679新至陞","110/07/13","日盛-復興",5,0,5
"12256","3679新至陞","110/07/13","統一-南京",0,7,-7
"12257","3679新至陞","110/07/13","(牛牛牛)亞-鑫豐",4,0,4
"12258","3679新至陞","110/07/13","凱基-新莊",0,7,-7
"12259","3679新至陞","110/07/13","元富-大昌",3,0,3
"12260","3679新至陞","110/07/13","新加坡商瑞銀",0,6,-6
"12261","3679新至陞","110/07/13","富邦-台北",3,0,3
"12262","3679新至陞","110/07/13","合庫-自強",0,5,-5
"12263","3679新至陞","110/07/13","日盛-樹林",2,0,2
"12264","3679新至陞","110/07/13","富邦-桃園",0,5,-5
"12265","3679新至陞","110/07/13","宏遠-光隆",2,0,2
"12266","3679新至陞","110/07/13","永豐金-潮州",0,4,-4
"12267","3679新至陞","110/07/13","美林",3,1,2
"12268","3679新至陞","110/07/13","臺銀-臺南",0,3,-3
"12269","3679新至陞","110/07/13","第一金-中壢",2,0,2
"12270","3679新至陞","110/07/13","元大-六合",0,3,-3
"12271","2727王品","110/07/13","富邦-台北",43,3,40
"12272","2727王品","110/07/13","台灣摩根士丹利",15,97,-82
"12273","2727王品","110/07/13","元大-基隆孝二",40,0,40
"12274","2727王品","110/07/13","玉山-台南",5,57,-52
"12275","2727王品","110/07/13","國票-新莊",40,1,39
"12276","2727王品","110/07/13","新加坡商瑞銀",0,48,-48
"12277","2727王品","110/07/13","第一金-豐原",66,42,24
"12278","2727王品","110/07/13","凱基-台北",41,77,-36
"12279","2727王品","110/07/13","永豐金-大園",34,10,24
"12280","2727王品","110/07/13","永豐金-永康",0,22,-22
"12281","2727王品","110/07/13","元大-北屯",22,0,22
"12282","2727王品","110/07/13","統一-台中",2,22,-20
"12283","2727王品","110/07/13","元大-東蘆",26,7,19
"12284","2727王品","110/07/13","國泰-台中",21,39,-18
"12285","2727王品","110/07/13","永豐金-萬盛",13,1,12
"12286","2727王品","110/07/13","合庫-彰化",3,20,-17
"12287","2727王品","110/07/13","日盛-嘉義",11,0,11
"12288","2727王品","110/07/13","港商野村",13,30,-17
"12289","2727王品","110/07/13","日盛-八德",11,0,11
"12290","2727王品","110/07/13","元大-楊梅",1,16,-15
"12291","2727王品","110/07/13","統一-竹南",11,0,11
"12292","2727王品","110/07/13","凱基-高美館",2,15,-13
"12293","2727王品","110/07/13","日盛-士林",12,2,10
"12294","2727王品","110/07/13","美商高盛",2,14,-12
"12295","2727王品","110/07/13","統一-敦南",10,0,10
"12296","2727王品","110/07/13","統一-平鎮",1,13,-12
"12297","2727王品","110/07/13","中國信託",15,5,10
"12298","2727王品","110/07/13","兆豐-台中港",4,16,-12
"12299","2727王品","110/07/13","兆豐-竹北",13,3,10
"12300","2727王品","110/07/13","凱基-八德",1,13,-12
"12301","1570力肯","110/07/13","新光",115,11,104
"12302","1570力肯","110/07/13","元大-北三重",0,162,-162
"12303","1570力肯","110/07/13","群益金鼎-高雄",54,0,54
"12304","1570力肯","110/07/13","元大-大灣",0,25,-25
"12305","1570力肯","110/07/13","國票-新莊",22,0,22
"12306","1570力肯","110/07/13","永豐金-苓雅",0,22,-22
"12307","1570力肯","110/07/13","日盛-桃園",12,0,12
"12308","1570力肯","110/07/13","永豐金-永康",0,19,-19
"12309","1570力肯","110/07/13","元大-高雄",12,0,12
"12310","1570力肯","110/07/13","富邦-員林",0,15,-15
"12311","1570力肯","110/07/13","合庫-自強",11,0,11
"12312","1570力肯","110/07/13","凱基-台南",0,11,-11
"12313","1570力肯","110/07/13","摩根大通",26,15,11
"12314","1570力肯","110/07/13","日盛-竹北",0,10,-10
"12315","1570力肯","110/07/13","永豐金-中盛",11,0,11
"12316","1570力肯","110/07/13","國票-九鼎",0,10,-10
"12317","1570力肯","110/07/13","兆豐-台中港",10,0,10
"12318","1570力肯","110/07/13","凱基-桃園",0,10,-10
"12319","1570力肯","110/07/13","國泰-松江",9,0,9
"12320","1570力肯","110/07/13","凱基-新豐",0,10,-10
"12321","1570力肯","110/07/13","元大-新盛",9,0,9
"12322","1570力肯","110/07/13","元大-學甲",0,10,-10
"12323","1570力肯","110/07/13","元富-緯城",6,0,6
"12324","1570力肯","110/07/13","群益金鼎-東湖",1,10,-9
"12325","1570力肯","110/07/13","統一-三重",5,0,5
"12326","1570力肯","110/07/13","大昌",0,6,-6
"12327","1570力肯","110/07/13","元大-前金",5,0,5
"12328","1570力肯","110/07/13","元大-土城學府",0,6,-6
"12329","1570力肯","110/07/13","永豐金證券",5,0,5
"12330","1570力肯","110/07/13","統一",0,5,-5
"12331","6180橘子","110/07/13","摩根大通",119,0,119
"12332","6180橘子","110/07/13","元大-崇德",2,61,-59
"12333","6180橘子","110/07/13","美商高盛",96,0,96
"12334","6180橘子","110/07/13","康和-台中",0,51,-51
"12335","6180橘子","110/07/13","新加坡商瑞銀",86,7,79
"12336","6180橘子","110/07/13","康和-台北",0,50,-50
"12337","6180橘子","110/07/13","元大-和平",40,0,40
"12338","6180橘子","110/07/13","元富-潮州",0,40,-40
"12339","6180橘子","110/07/13","凱基-台北",83,47,36
"12340","6180橘子","110/07/13","日盛-永康",0,26,-26
"12341","6180橘子","110/07/13","美林",39,5,34
"12342","6180橘子","110/07/13","永豐金-中正",0,24,-24
"12343","6180橘子","110/07/13","富邦-新竹華信",31,2,29
"12344","6180橘子","110/07/13","國泰-板橋",2,25,-23
"12345","6180橘子","110/07/13","統一-南京",21,0,21
"12346","6180橘子","110/07/13","日盛-大墩",0,20,-20
"12347","6180橘子","110/07/13","富邦-陽明",24,3,21
"12348","6180橘子","110/07/13","元大-草屯",13,32,-19
"12349","6180橘子","110/07/13","大昌-樹林",21,1,20
"12350","6180橘子","110/07/13","元富-林園",1,18,-17
"12351","6180橘子","110/07/13","花旗環球",19,0,19
"12352","6180橘子","110/07/13","新光-新竹",1,18,-17
"12353","6180橘子","110/07/13","華南永昌-台南",19,0,19
"12354","6180橘子","110/07/13","元大-土城永寧",0,17,-17
"12355","6180橘子","110/07/13","福勝",14,0,14
"12356","6180橘子","110/07/13","國泰-新莊",3,19,-16
"12357","6180橘子","110/07/13","富邦-嘉義",12,1,11
"12358","6180橘子","110/07/13","中國信託-永康",6,21,-15
"12359","6180橘子","110/07/13","元大-板橋三民",11,0,11
"12360","6180橘子","110/07/13","凱基-東港",1,15,-14
"12361","2390云辰","110/07/13","新加坡商瑞銀",562,75,487
"12362","2390云辰","110/07/13","大展-台南",0,532,-532
"12363","2390云辰","110/07/13","台灣摩根士丹利",330,155,175
"12364","2390云辰","110/07/13","凱基-台北",668,854,-186
"12365","2390云辰","110/07/13","兆豐-公益",126,25,101
"12366","2390云辰","110/07/13","凱基-三重",12,172,-160
"12367","2390云辰","110/07/13","元富-中港",100,2,98
"12368","2390云辰","110/07/13","兆豐-忠孝",4,161,-157
"12369","2390云辰","110/07/13","統一-新台中",106,9,97
"12370","2390云辰","110/07/13","元大-士林",19,170,-151
"12371","2390云辰","110/07/13","中國信託-松江",81,11,70
"12372","2390云辰","110/07/13","臺銀-新竹",14,117,-103
"12373","2390云辰","110/07/13","日盛-板橋",72,3,69
"12374","2390云辰","110/07/13","國票-台中",4,102,-98
"12375","2390云辰","110/07/13","日盛-和美",57,0,57
"12376","2390云辰","110/07/13","新光",147,232,-85
"12377","2390云辰","110/07/13","永豐金-桃園",88,36,52
"12378","2390云辰","110/07/13","致和-崇德",2,70,-68
"12379","2390云辰","110/07/13","玉山-士林",54,4,50
"12380","2390云辰","110/07/13","群益金鼎-屏東",2,70,-68
"12381","2390云辰","110/07/13","富邦-仁愛",56,6,50
"12382","2390云辰","110/07/13","元大-大里",35,98,-63
"12383","2390云辰","110/07/13","第一金-豐原",50,1,49
"12384","2390云辰","110/07/13","元大-萬華",35,94,-59
"12385","2390云辰","110/07/13","摩根大通",502,453,49
"12386","2390云辰","110/07/13","元富-吉利",2,60,-58
"12387","2390云辰","110/07/13","凱基-松山",61,13,48
"12388","2390云辰","110/07/13","兆豐-新竹",3,53,-50
"12389","2390云辰","110/07/13","大昌",64,22,42
"12390","2390云辰","110/07/13","富邦-嘉義",65,108,-43
"12391","2363矽統","110/07/13","凱基-南崁",2133,63,2070
"12392","2363矽統","110/07/13","凱基-幸福",36,4048,-4012
"12393","2363矽統","110/07/13","國泰-敦南",2195,1617,578
"12394","2363矽統","110/07/13","統一",192,3325,-3133
"12395","2363矽統","110/07/13","中農",670,139,531
"12396","2363矽統","110/07/13","新加坡商瑞銀",1000,2747,-1747
"12397","2363矽統","110/07/13","康和-台中",638,154,484
"12398","2363矽統","110/07/13","凱基-台北",5359,6609,-1250
"12399","2363矽統","110/07/13","群益金鼎-三民",577,137,440
"12400","2363矽統","110/07/13","摩根大通",1930,2858,-928
"12401","2363矽統","110/07/13","台新-屏東",510,88,422
"12402","2363矽統","110/07/13","港商野村",960,1679,-719
"12403","2363矽統","110/07/13","德信-中正",455,67,388
"12404","2363矽統","110/07/13","兆豐-復興",25,705,-680
"12405","2363矽統","110/07/13","日盛-竹北",365,70,295
"12406","2363矽統","110/07/13","統一-仁愛",114,755,-641
"12407","2363矽統","110/07/13","元大-佳里",452,189,263
"12408","2363矽統","110/07/13","統一-敦南",29,638,-609
"12409","2363矽統","110/07/13","國票-博愛",296,38,258
"12410","2363矽統","110/07/13","統一-土城",100,704,-604
"12411","2363矽統","110/07/13","元大-萬華",340,95,245
"12412","2363矽統","110/07/13","統一-城中",116,676,-560
"12413","2363矽統","110/07/13","新光",1259,1031,228
"12414","2363矽統","110/07/13","永豐金證券",306,859,-553
"12415","2363矽統","110/07/13","元富-成功",323,96,227
"12416","2363矽統","110/07/13","元富",54,567,-513
"12417","2363矽統","110/07/13","豐農",228,23,205
"12418","2363矽統","110/07/13","瑞士信貸",202,666,-464
"12419","2363矽統","110/07/13","台灣企銀-岡山",186,4,182
"12420","2363矽統","110/07/13","永豐金-嘉義",67,468,-401
"12421","8112至上","110/07/13","摩根大通",688,296,392
"12422","8112至上","110/07/13","國票-中和",0,401,-401
"12423","8112至上","110/07/13","港商野村",344,145,199
"12424","8112至上","110/07/13","永豐金-板盛",0,205,-205
"12425","8112至上","110/07/13","兆豐-公益",195,5,190
"12426","8112至上","110/07/13","凱基-五股",43,155,-112
"12427","8112至上","110/07/13","台灣摩根士丹利",183,0,183
"12428","8112至上","110/07/13","凱基-市政",0,100,-100
"12429","8112至上","110/07/13","群益金鼎-敦南",153,2,151
"12430","8112至上","110/07/13","元大-大里德芳",1,92,-91
"12431","8112至上","110/07/13","臺銀-金山",146,26,120
"12432","8112至上","110/07/13","玉山-桃園",26,110,-84
"12433","8112至上","110/07/13","臺銀",133,19,114
"12434","8112至上","110/07/13","兆豐-天母",0,81,-81
"12435","8112至上","110/07/13","合庫-台中",115,6,109
"12436","8112至上","110/07/13","凱基-城中",3,84,-81
"12437","8112至上","110/07/13","亞東-板橋",134,26,108
"12438","8112至上","110/07/13","日盛-新莊",9,85,-76
"12439","8112至上","110/07/13","凱基-台北",414,326,88
"12440","8112至上","110/07/13","日盛-台中",2,64,-62
"12441","8112至上","110/07/13","新加坡商瑞銀",181,100,81
"12442","8112至上","110/07/13","日盛-中壢",3,64,-61
"12443","8112至上","110/07/13","國泰-敦南",108,31,77
"12444","8112至上","110/07/13","元大-台中",2,59,-57
"12445","8112至上","110/07/13","第一金-華江",77,4,73
"12446","8112至上","110/07/13","元大-雙和",7,64,-57
"12447","8112至上","110/07/13","永豐金-內湖",73,1,72
"12448","8112至上","110/07/13","元大-高雄",8,62,-54
"12449","8112至上","110/07/13","元大-永和",68,1,67
"12450","8112至上","110/07/13","元大-館前",2,55,-53
"12451","4903聯光通","110/07/13","台灣企銀-太平",56,0,56
"12452","4903聯光通","110/07/13","土銀",0,32,-32
"12453","4903聯光通","110/07/13","元富-新興",23,0,23
"12454","4903聯光通","110/07/13","元大-樹林",0,19,-19
"12455","4903聯光通","110/07/13","日盛-樹林",22,0,22
"12456","4903聯光通","110/07/13","凱基-士林",0,17,-17
"12457","4903聯光通","110/07/13","兆豐-天母",20,0,20
"12458","4903聯光通","110/07/13","國票-博愛",0,14,-14
"12459","4903聯光通","110/07/13","華南永昌-桃園",20,0,20
"12460","4903聯光通","110/07/13","元富",0,10,-10
"12461","4903聯光通","110/07/13","富邦-新店",10,0,10
"12462","4903聯光通","110/07/13","新光",0,10,-10
"12463","4903聯光通","110/07/13","新光-台中",5,0,5
"12464","4903聯光通","110/07/13","玉山-南京東路",0,10,-10
"12465","4903聯光通","110/07/13","華南永昌-台中",5,0,5
"12466","4903聯光通","110/07/13","富邦-陽明",0,10,-10
"12467","4903聯光通","110/07/13","元大-崇德",5,0,5
"12468","4903聯光通","110/07/13","元大-大甲",0,8,-8
"12469","4903聯光通","110/07/13","元大-草屯",5,0,5
"12470","4903聯光通","110/07/13","富邦-台中",0,7,-7
"12471","4903聯光通","110/07/13","元富-草屯",4,0,4
"12472","4903聯光通","110/07/13","凱基-中壢",0,6,-6
"12473","4903聯光通","110/07/13","元大-清水",4,0,4
"12474","4903聯光通","110/07/13","臺銀-民權",0,5,-5
"12475","4903聯光通","110/07/13","元大-東泰",4,0,4
"12476","4903聯光通","110/07/13","日盛-板橋",0,5,-5
"12477","4903聯光通","110/07/13","元大-佳里",2,0,2
"12478","4903聯光通","110/07/13","中國信託-忠孝",0,5,-5
"12479","4903聯光通","110/07/13","永豐金-板橋",2,0,2
"12480","4903聯光通","110/07/13","永豐金-鳳山",0,5,-5
"12481","2929淘帝","110/07/13","玉山-新竹",130,0,130
"12482","2929淘帝","110/07/13","美商高盛",0,177,-177
"12483","2929淘帝","110/07/13","臺銀-民權",60,0,60
"12484","2929淘帝","110/07/13","凱基-台北",6,80,-74
"12485","2929淘帝","110/07/13","新百王",31,0,31
"12486","2929淘帝","110/07/13","元富-大裕",0,49,-49
"12487","2929淘帝","110/07/13","日盛-園區",30,0,30
"12488","2929淘帝","110/07/13","國泰-館前",3,51,-48
"12489","2929淘帝","110/07/13","元大-南投",31,1,30
"12490","2929淘帝","110/07/13","凱基-中壢",0,41,-41
"12491","2929淘帝","110/07/13","兆豐-忠孝",28,0,28
"12492","2929淘帝","110/07/13","港商野村",21,55,-34
"12493","2929淘帝","110/07/13","元大-民生",28,0,28
"12494","2929淘帝","110/07/13","華南永昌-南京",2,34,-32
"12495","2929淘帝","110/07/13","合庫-高雄",27,0,27
"12496","2929淘帝","110/07/13","群益金鼎-土城",0,30,-30
"12497","2929淘帝","110/07/13","凱基-豐中",27,0,27
"12498","2929淘帝","110/07/13","富邦-南屯",0,22,-22
"12499","2929淘帝","110/07/13","新光",21,4,17
"12500","2929淘帝","110/07/13","第一金-豐原",0,20,-20
"12501","2929淘帝","110/07/13","元大-天母",17,0,17
"12502","2929淘帝","110/07/13","元大-屏南",6,26,-20
"12503","2929淘帝","110/07/13","永興",14,0,14
"12504","2929淘帝","110/07/13","永豐金-敦南",1,21,-20
"12505","2929淘帝","110/07/13","富邦-台北",12,0,12
"12506","2929淘帝","110/07/13","凱基-三重",2,21,-19
"12507","2929淘帝","110/07/13","元大-永和",12,0,12
"12508","2929淘帝","110/07/13","富邦-仁愛",7,25,-18
"12509","2929淘帝","110/07/13","國票-天祥",11,0,11
"12510","2929淘帝","110/07/13","元大-北投",0,16,-16
"12511","5410國眾","110/07/13","兆豐-城中",274,0,274
"12512","5410國眾","110/07/13","元富-嘉義",0,103,-103
"12513","5410國眾","110/07/13","新光",50,4,46
"12514","5410國眾","110/07/13","凱基-台北",0,50,-50
"12515","5410國眾","110/07/13","國泰-台中",26,0,26
"12516","5410國眾","110/07/13","瑞士信貸",0,31,-31
"12517","5410國眾","110/07/13","新加坡商瑞銀",22,0,22
"12518","5410國眾","110/07/13","台新-新莊",0,27,-27
"12519","5410國眾","110/07/13","光和-嘉義",20,0,20
"12520","5410國眾","110/07/13","元大-汐止",0,20,-20
"12521","5410國眾","110/07/13","凱基-竹北",17,0,17
"12522","5410國眾","110/07/13","亞東-新竹",0,17,-17
"12523","5410國眾","110/07/13","新光-桃園",15,0,15
"12524","5410國眾","110/07/13","元大-南勢角",0,13,-13
"12525","5410國眾","110/07/13","凱基-台東",14,0,14
"12526","5410國眾","110/07/13","台新-台南",0,12,-12
"12527","5410國眾","110/07/13","富邦-竹北",11,0,11
"12528","5410國眾","110/07/13","中國信託",0,11,-11
"12529","5410國眾","110/07/13","元富-同大",10,0,10
"12530","5410國眾","110/07/13","華南永昌",0,11,-11
"12531","5410國眾","110/07/13","國泰-敦南",24,15,9
"12532","5410國眾","110/07/13","臺銀-臺南",0,10,-10
"12533","5410國眾","110/07/13","日盛-內湖",7,0,7
"12534","5410國眾","110/07/13","台灣企銀-民雄",0,10,-10
"12535","5410國眾","110/07/13","台新-左楠",7,0,7
"12536","5410國眾","110/07/13","高橋",0,10,-10
"12537","5410國眾","110/07/13","元大-新盛",18,12,6
"12538","5410國眾","110/07/13","康和-嘉義",0,10,-10
"12539","5410國眾","110/07/13","統一",5,0,5
"12540","5410國眾","110/07/13","凱基-基隆",0,10,-10
"12541","2841台開","110/07/13","中國信託-高雄",251,50,201
"12542","2841台開","110/07/13","兆豐-公益",0,177,-177
"12543","2841台開","110/07/13","日盛證券",210,13,197
"12544","2841台開","110/07/13","日進",0,152,-152
"12545","2841台開","110/07/13","第一金-台中",55,0,55
"12546","2841台開","110/07/13","港商野村",0,109,-109
"12547","2841台開","110/07/13","國泰-板橋",46,0,46
"12548","2841台開","110/07/13","日盛-信義",0,103,-103
"12549","2841台開","110/07/13","國泰-館前",48,3,45
"12550","2841台開","110/07/13","國泰-敦南",11,75,-64
"12551","2841台開","110/07/13","華南永昌-新莊",45,0,45
"12552","2841台開","110/07/13","永興",0,50,-50
"12553","2841台開","110/07/13","日盛-園區",42,0,42
"12554","2841台開","110/07/13","永豐金-敦南",61,104,-43
"12555","2841台開","110/07/13","台新證券",32,0,32
"12556","2841台開","110/07/13","富邦-台南",0,42,-42
"12557","2841台開","110/07/13","台新-高雄",32,2,30
"12558","2841台開","110/07/13","國票-安和",0,30,-30
"12559","2841台開","110/07/13","豐農",23,0,23
"12560","2841台開","110/07/13","元大-桃園",0,25,-25
"12561","2841台開","110/07/13","合庫-嘉義",20,0,20
"12562","2841台開","110/07/13","新光",8,32,-24
"12563","2841台開","110/07/13","華南永昌-高雄",20,0,20
"12564","2841台開","110/07/13","元大-仁愛",0,24,-24
"12565","2841台開","110/07/13","元大-樹林",16,0,16
"12566","2841台開","110/07/13","日盛-中和",0,20,-20
"12567","2841台開","110/07/13","第一金-華江",15,2,13
"12568","2841台開","110/07/13","元富",0,20,-20
"12569","2841台開","110/07/13","美商高盛",12,0,12
"12570","2841台開","110/07/13","富邦-宜蘭",0,20,-20
"12571","6207雷科","110/07/13","元大-高雄",121,0,121
"12572","6207雷科","110/07/13","華南永昌-朴子",1,60,-59
"12573","6207雷科","110/07/13","第一金-新興",20,0,20
"12574","6207雷科","110/07/13","元大-南海",0,36,-36
"12575","6207雷科","110/07/13","元富-三重",20,0,20
"12576","6207雷科","110/07/13","凱基-土城",0,35,-35
"12577","6207雷科","110/07/13","元大-林園",15,0,15
"12578","6207雷科","110/07/13","台灣企銀",0,20,-20
"12579","6207雷科","110/07/13","元大-金華",16,1,15
"12580","6207雷科","110/07/13","群益金鼎-丹鳳",0,20,-20
"12581","6207雷科","110/07/13","日盛證券",10,0,10
"12582","6207雷科","110/07/13","元大-博愛",0,17,-17
"12583","6207雷科","110/07/13","統一-台中",10,0,10
"12584","6207雷科","110/07/13","元大-北港",0,13,-13
"12585","6207雷科","110/07/13","群益金鼎-土城",10,0,10
"12586","6207雷科","110/07/13","新加坡商瑞銀",0,12,-12
"12587","6207雷科","110/07/13","群益金鼎-桃園",10,0,10
"12588","6207雷科","110/07/13","凱基-台北",4,16,-12
"12589","6207雷科","110/07/13","永豐金-新莊",10,0,10
"12590","6207雷科","110/07/13","日茂-埔里",0,11,-11
"12591","6207雷科","110/07/13","永豐金-新店",10,0,10
"12592","6207雷科","110/07/13","元大-莒光",0,11,-11
"12593","6207雷科","110/07/13","元大證券",9,0,9
"12594","6207雷科","110/07/13","統一-新竹",0,10,-10
"12595","6207雷科","110/07/13","日盛-木柵",9,1,8
"12596","6207雷科","110/07/13","元大-西螺",0,10,-10
"12597","6207雷科","110/07/13","兆豐-來福",8,0,8
"12598","6207雷科","110/07/13","康和-台中",0,8,-8
"12599","6207雷科","110/07/13","新光",7,0,7
"12600","6207雷科","110/07/13","兆豐-高雄",0,6,-6
"12601","3679新至陞","110/07/13","永豐金證券",50,0,50
"12602","3679新至陞","110/07/13","摩根大通",2,25,-23
"12603","3679新至陞","110/07/13","國泰-桃園",22,0,22
"12604","3679新至陞","110/07/13","元大-成功",0,22,-22
"12605","3679新至陞","110/07/13","台中銀-員林",11,0,11
"12606","3679新至陞","110/07/13","富邦-板橋",1,19,-18
"12607","3679新至陞","110/07/13","元大-文心興安",8,0,8
"12608","3679新至陞","110/07/13","日盛-新莊",0,10,-10
"12609","3679新至陞","110/07/13","美商高盛",6,0,6
"12610","3679新至陞","110/07/13","台新-台中",0,10,-10
"12611","3679新至陞","110/07/13","台新-高雄",6,0,6
"12612","3679新至陞","110/07/13","永豐金-新竹",0,8,-8
"12613","3679新至陞","110/07/13","凱基-台北",18,12,6
"12614","3679新至陞","110/07/13","瑞士信貸",12,19,-7
"12615","3679新至陞","110/07/13","日盛-復興",5,0,5
"12616","3679新至陞","110/07/13","統一-南京",0,7,-7
"12617","3679新至陞","110/07/13","(牛牛牛)亞-鑫豐",4,0,4
"12618","3679新至陞","110/07/13","凱基-新莊",0,7,-7
"12619","3679新至陞","110/07/13","元富-大昌",3,0,3
"12620","3679新至陞","110/07/13","新加坡商瑞銀",0,6,-6
"12621","3679新至陞","110/07/13","富邦-台北",3,0,3
"12622","3679新至陞","110/07/13","合庫-自強",0,5,-5
"12623","3679新至陞","110/07/13","日盛-樹林",2,0,2
"12624","3679新至陞","110/07/13","富邦-桃園",0,5,-5
"12625","3679新至陞","110/07/13","宏遠-光隆",2,0,2
"12626","3679新至陞","110/07/13","永豐金-潮州",0,4,-4
"12627","3679新至陞","110/07/13","美林",3,1,2
"12628","3679新至陞","110/07/13","臺銀-臺南",0,3,-3
"12629","3679新至陞","110/07/13","第一金-中壢",2,0,2
"12630","3679新至陞","110/07/13","元大-六合",0,3,-3
"12631","2727王品","110/07/13","富邦-台北",43,3,40
"12632","2727王品","110/07/13","台灣摩根士丹利",15,97,-82
"12633","2727王品","110/07/13","元大-基隆孝二",40,0,40
"12634","2727王品","110/07/13","玉山-台南",5,57,-52
"12635","2727王品","110/07/13","國票-新莊",40,1,39
"12636","2727王品","110/07/13","新加坡商瑞銀",0,48,-48
"12637","2727王品","110/07/13","第一金-豐原",66,42,24
"12638","2727王品","110/07/13","凱基-台北",41,77,-36
"12639","2727王品","110/07/13","永豐金-大園",34,10,24
"12640","2727王品","110/07/13","永豐金-永康",0,22,-22
"12641","2727王品","110/07/13","元大-北屯",22,0,22
"12642","2727王品","110/07/13","統一-台中",2,22,-20
"12643","2727王品","110/07/13","元大-東蘆",26,7,19
"12644","2727王品","110/07/13","國泰-台中",21,39,-18
"12645","2727王品","110/07/13","永豐金-萬盛",13,1,12
"12646","2727王品","110/07/13","合庫-彰化",3,20,-17
"12647","2727王品","110/07/13","日盛-嘉義",11,0,11
"12648","2727王品","110/07/13","港商野村",13,30,-17
"12649","2727王品","110/07/13","日盛-八德",11,0,11
"12650","2727王品","110/07/13","元大-楊梅",1,16,-15
"12651","2727王品","110/07/13","統一-竹南",11,0,11
"12652","2727王品","110/07/13","凱基-高美館",2,15,-13
"12653","2727王品","110/07/13","日盛-士林",12,2,10
"12654","2727王品","110/07/13","美商高盛",2,14,-12
"12655","2727王品","110/07/13","統一-敦南",10,0,10
"12656","2727王品","110/07/13","統一-平鎮",1,13,-12
"12657","2727王品","110/07/13","中國信託",15,5,10
"12658","2727王品","110/07/13","兆豐-台中港",4,16,-12
"12659","2727王品","110/07/13","兆豐-竹北",13,3,10
"12660","2727王品","110/07/13","凱基-八德",1,13,-12
"12661","1570力肯","110/07/13","新光",115,11,104
"12662","1570力肯","110/07/13","元大-北三重",0,162,-162
"12663","1570力肯","110/07/13","群益金鼎-高雄",54,0,54
"12664","1570力肯","110/07/13","元大-大灣",0,25,-25
"12665","1570力肯","110/07/13","國票-新莊",22,0,22
"12666","1570力肯","110/07/13","永豐金-苓雅",0,22,-22
"12667","1570力肯","110/07/13","日盛-桃園",12,0,12
"12668","1570力肯","110/07/13","永豐金-永康",0,19,-19
"12669","1570力肯","110/07/13","元大-高雄",12,0,12
"12670","1570力肯","110/07/13","富邦-員林",0,15,-15
"12671","1570力肯","110/07/13","合庫-自強",11,0,11
"12672","1570力肯","110/07/13","凱基-台南",0,11,-11
"12673","1570力肯","110/07/13","摩根大通",26,15,11
"12674","1570力肯","110/07/13","日盛-竹北",0,10,-10
"12675","1570力肯","110/07/13","永豐金-中盛",11,0,11
"12676","1570力肯","110/07/13","國票-九鼎",0,10,-10
"12677","1570力肯","110/07/13","兆豐-台中港",10,0,10
"12678","1570力肯","110/07/13","凱基-桃園",0,10,-10
"12679","1570力肯","110/07/13","國泰-松江",9,0,9
"12680","1570力肯","110/07/13","凱基-新豐",0,10,-10
"12681","1570力肯","110/07/13","元大-新盛",9,0,9
"12682","1570力肯","110/07/13","元大-學甲",0,10,-10
"12683","1570力肯","110/07/13","元富-緯城",6,0,6
"12684","1570力肯","110/07/13","群益金鼎-東湖",1,10,-9
"12685","1570力肯","110/07/13","統一-三重",5,0,5
"12686","1570力肯","110/07/13","大昌",0,6,-6
"12687","1570力肯","110/07/13","元大-前金",5,0,5
"12688","1570力肯","110/07/13","元大-土城學府",0,6,-6
"12689","1570力肯","110/07/13","永豐金證券",5,0,5
"12690","1570力肯","110/07/13","統一",0,5,-5
"12691","6180橘子","110/07/13","摩根大通",119,0,119
"12692","6180橘子","110/07/13","元大-崇德",2,61,-59
"12693","6180橘子","110/07/13","美商高盛",96,0,96
"12694","6180橘子","110/07/13","康和-台中",0,51,-51
"12695","6180橘子","110/07/13","新加坡商瑞銀",86,7,79
"12696","6180橘子","110/07/13","康和-台北",0,50,-50
"12697","6180橘子","110/07/13","元大-和平",40,0,40
"12698","6180橘子","110/07/13","元富-潮州",0,40,-40
"12699","6180橘子","110/07/13","凱基-台北",83,47,36
"12700","6180橘子","110/07/13","日盛-永康",0,26,-26
"12701","6180橘子","110/07/13","美林",39,5,34
"12702","6180橘子","110/07/13","永豐金-中正",0,24,-24
"12703","6180橘子","110/07/13","富邦-新竹華信",31,2,29
"12704","6180橘子","110/07/13","國泰-板橋",2,25,-23
"12705","6180橘子","110/07/13","統一-南京",21,0,21
"12706","6180橘子","110/07/13","日盛-大墩",0,20,-20
"12707","6180橘子","110/07/13","富邦-陽明",24,3,21
"12708","6180橘子","110/07/13","元大-草屯",13,32,-19
"12709","6180橘子","110/07/13","大昌-樹林",21,1,20
"12710","6180橘子","110/07/13","元富-林園",1,18,-17
"12711","6180橘子","110/07/13","花旗環球",19,0,19
"12712","6180橘子","110/07/13","新光-新竹",1,18,-17
"12713","6180橘子","110/07/13","華南永昌-台南",19,0,19
"12714","6180橘子","110/07/13","元大-土城永寧",0,17,-17
"12715","6180橘子","110/07/13","福勝",14,0,14
"12716","6180橘子","110/07/13","國泰-新莊",3,19,-16
"12717","6180橘子","110/07/13","富邦-嘉義",12,1,11
"12718","6180橘子","110/07/13","中國信託-永康",6,21,-15
"12719","6180橘子","110/07/13","元大-板橋三民",11,0,11
"12720","6180橘子","110/07/13","凱基-東港",1,15,-14
"12721","2390云辰","110/07/13","新加坡商瑞銀",562,75,487
"12722","2390云辰","110/07/13","大展-台南",0,532,-532
"12723","2390云辰","110/07/13","台灣摩根士丹利",330,155,175
"12724","2390云辰","110/07/13","凱基-台北",668,854,-186
"12725","2390云辰","110/07/13","兆豐-公益",126,25,101
"12726","2390云辰","110/07/13","凱基-三重",12,172,-160
"12727","2390云辰","110/07/13","元富-中港",100,2,98
"12728","2390云辰","110/07/13","兆豐-忠孝",4,161,-157
"12729","2390云辰","110/07/13","統一-新台中",106,9,97
"12730","2390云辰","110/07/13","元大-士林",19,170,-151
"12731","2390云辰","110/07/13","中國信託-松江",81,11,70
"12732","2390云辰","110/07/13","臺銀-新竹",14,117,-103
"12733","2390云辰","110/07/13","日盛-板橋",72,3,69
"12734","2390云辰","110/07/13","國票-台中",4,102,-98
"12735","2390云辰","110/07/13","日盛-和美",57,0,57
"12736","2390云辰","110/07/13","新光",147,232,-85
"12737","2390云辰","110/07/13","永豐金-桃園",88,36,52
"12738","2390云辰","110/07/13","致和-崇德",2,70,-68
"12739","2390云辰","110/07/13","玉山-士林",54,4,50
"12740","2390云辰","110/07/13","群益金鼎-屏東",2,70,-68
"12741","2390云辰","110/07/13","富邦-仁愛",56,6,50
"12742","2390云辰","110/07/13","元大-大里",35,98,-63
"12743","2390云辰","110/07/13","第一金-豐原",50,1,49
"12744","2390云辰","110/07/13","元大-萬華",35,94,-59
"12745","2390云辰","110/07/13","摩根大通",502,453,49
"12746","2390云辰","110/07/13","元富-吉利",2,60,-58
"12747","2390云辰","110/07/13","凱基-松山",61,13,48
"12748","2390云辰","110/07/13","兆豐-新竹",3,53,-50
"12749","2390云辰","110/07/13","大昌",64,22,42
"12750","2390云辰","110/07/13","富邦-嘉義",65,108,-43
"12751","2363矽統","110/07/13","凱基-南崁",2133,63,2070
"12752","2363矽統","110/07/13","凱基-幸福",36,4048,-4012
"12753","2363矽統","110/07/13","國泰-敦南",2195,1617,578
"12754","2363矽統","110/07/13","統一",192,3325,-3133
"12755","2363矽統","110/07/13","中農",670,139,531
"12756","2363矽統","110/07/13","新加坡商瑞銀",1000,2747,-1747
"12757","2363矽統","110/07/13","康和-台中",638,154,484
"12758","2363矽統","110/07/13","凱基-台北",5359,6609,-1250
"12759","2363矽統","110/07/13","群益金鼎-三民",577,137,440
"12760","2363矽統","110/07/13","摩根大通",1930,2858,-928
"12761","2363矽統","110/07/13","台新-屏東",510,88,422
"12762","2363矽統","110/07/13","港商野村",960,1679,-719
"12763","2363矽統","110/07/13","德信-中正",455,67,388
"12764","2363矽統","110/07/13","兆豐-復興",25,705,-680
"12765","2363矽統","110/07/13","日盛-竹北",365,70,295
"12766","2363矽統","110/07/13","統一-仁愛",114,755,-641
"12767","2363矽統","110/07/13","元大-佳里",452,189,263
"12768","2363矽統","110/07/13","統一-敦南",29,638,-609
"12769","2363矽統","110/07/13","國票-博愛",296,38,258
"12770","2363矽統","110/07/13","統一-土城",100,704,-604
"12771","2363矽統","110/07/13","元大-萬華",340,95,245
"12772","2363矽統","110/07/13","統一-城中",116,676,-560
"12773","2363矽統","110/07/13","新光",1259,1031,228
"12774","2363矽統","110/07/13","永豐金證券",306,859,-553
"12775","2363矽統","110/07/13","元富-成功",323,96,227
"12776","2363矽統","110/07/13","元富",54,567,-513
"12777","2363矽統","110/07/13","豐農",228,23,205
"12778","2363矽統","110/07/13","瑞士信貸",202,666,-464
"12779","2363矽統","110/07/13","台灣企銀-岡山",186,4,182
"12780","2363矽統","110/07/13","永豐金-嘉義",67,468,-401
"12781","8112至上","110/07/13","摩根大通",688,296,392
"12782","8112至上","110/07/13","國票-中和",0,401,-401
"12783","8112至上","110/07/13","港商野村",344,145,199
"12784","8112至上","110/07/13","永豐金-板盛",0,205,-205
"12785","8112至上","110/07/13","兆豐-公益",195,5,190
"12786","8112至上","110/07/13","凱基-五股",43,155,-112
"12787","8112至上","110/07/13","台灣摩根士丹利",183,0,183
"12788","8112至上","110/07/13","凱基-市政",0,100,-100
"12789","8112至上","110/07/13","群益金鼎-敦南",153,2,151
"12790","8112至上","110/07/13","元大-大里德芳",1,92,-91
"12791","8112至上","110/07/13","臺銀-金山",146,26,120
"12792","8112至上","110/07/13","玉山-桃園",26,110,-84
"12793","8112至上","110/07/13","臺銀",133,19,114
"12794","8112至上","110/07/13","兆豐-天母",0,81,-81
"12795","8112至上","110/07/13","合庫-台中",115,6,109
"12796","8112至上","110/07/13","凱基-城中",3,84,-81
"12797","8112至上","110/07/13","亞東-板橋",134,26,108
"12798","8112至上","110/07/13","日盛-新莊",9,85,-76
"12799","8112至上","110/07/13","凱基-台北",414,326,88
"12800","8112至上","110/07/13","日盛-台中",2,64,-62
"12801","8112至上","110/07/13","新加坡商瑞銀",181,100,81
"12802","8112至上","110/07/13","日盛-中壢",3,64,-61
"12803","8112至上","110/07/13","國泰-敦南",108,31,77
"12804","8112至上","110/07/13","元大-台中",2,59,-57
"12805","8112至上","110/07/13","第一金-華江",77,4,73
"12806","8112至上","110/07/13","元大-雙和",7,64,-57
"12807","8112至上","110/07/13","永豐金-內湖",73,1,72
"12808","8112至上","110/07/13","元大-高雄",8,62,-54
"12809","8112至上","110/07/13","元大-永和",68,1,67
"12810","8112至上","110/07/13","元大-館前",2,55,-53
"12811","4903聯光通","110/07/13","台灣企銀-太平",56,0,56
"12812","4903聯光通","110/07/13","土銀",0,32,-32
"12813","4903聯光通","110/07/13","元富-新興",23,0,23
"12814","4903聯光通","110/07/13","元大-樹林",0,19,-19
"12815","4903聯光通","110/07/13","日盛-樹林",22,0,22
"12816","4903聯光通","110/07/13","凱基-士林",0,17,-17
"12817","4903聯光通","110/07/13","兆豐-天母",20,0,20
"12818","4903聯光通","110/07/13","國票-博愛",0,14,-14
"12819","4903聯光通","110/07/13","華南永昌-桃園",20,0,20
"12820","4903聯光通","110/07/13","元富",0,10,-10
"12821","4903聯光通","110/07/13","富邦-新店",10,0,10
"12822","4903聯光通","110/07/13","新光",0,10,-10
"12823","4903聯光通","110/07/13","新光-台中",5,0,5
"12824","4903聯光通","110/07/13","玉山-南京東路",0,10,-10
"12825","4903聯光通","110/07/13","華南永昌-台中",5,0,5
"12826","4903聯光通","110/07/13","富邦-陽明",0,10,-10
"12827","4903聯光通","110/07/13","元大-崇德",5,0,5
"12828","4903聯光通","110/07/13","元大-大甲",0,8,-8
"12829","4903聯光通","110/07/13","元大-草屯",5,0,5
"12830","4903聯光通","110/07/13","富邦-台中",0,7,-7
"12831","4903聯光通","110/07/13","元富-草屯",4,0,4
"12832","4903聯光通","110/07/13","凱基-中壢",0,6,-6
"12833","4903聯光通","110/07/13","元大-清水",4,0,4
"12834","4903聯光通","110/07/13","臺銀-民權",0,5,-5
"12835","4903聯光通","110/07/13","元大-東泰",4,0,4
"12836","4903聯光通","110/07/13","日盛-板橋",0,5,-5
"12837","4903聯光通","110/07/13","元大-佳里",2,0,2
"12838","4903聯光通","110/07/13","中國信託-忠孝",0,5,-5
"12839","4903聯光通","110/07/13","永豐金-板橋",2,0,2
"12840","4903聯光通","110/07/13","永豐金-鳳山",0,5,-5
"12841","2929淘帝","110/07/13","玉山-新竹",130,0,130
"12842","2929淘帝","110/07/13","美商高盛",0,177,-177
"12843","2929淘帝","110/07/13","臺銀-民權",60,0,60
"12844","2929淘帝","110/07/13","凱基-台北",6,80,-74
"12845","2929淘帝","110/07/13","新百王",31,0,31
"12846","2929淘帝","110/07/13","元富-大裕",0,49,-49
"12847","2929淘帝","110/07/13","日盛-園區",30,0,30
"12848","2929淘帝","110/07/13","國泰-館前",3,51,-48
"12849","2929淘帝","110/07/13","元大-南投",31,1,30
"12850","2929淘帝","110/07/13","凱基-中壢",0,41,-41
"12851","2929淘帝","110/07/13","兆豐-忠孝",28,0,28
"12852","2929淘帝","110/07/13","港商野村",21,55,-34
"12853","2929淘帝","110/07/13","元大-民生",28,0,28
"12854","2929淘帝","110/07/13","華南永昌-南京",2,34,-32
"12855","2929淘帝","110/07/13","合庫-高雄",27,0,27
"12856","2929淘帝","110/07/13","群益金鼎-土城",0,30,-30
"12857","2929淘帝","110/07/13","凱基-豐中",27,0,27
"12858","2929淘帝","110/07/13","富邦-南屯",0,22,-22
"12859","2929淘帝","110/07/13","新光",21,4,17
"12860","2929淘帝","110/07/13","第一金-豐原",0,20,-20
"12861","2929淘帝","110/07/13","元大-天母",17,0,17
"12862","2929淘帝","110/07/13","元大-屏南",6,26,-20
"12863","2929淘帝","110/07/13","永興",14,0,14
"12864","2929淘帝","110/07/13","永豐金-敦南",1,21,-20
"12865","2929淘帝","110/07/13","富邦-台北",12,0,12
"12866","2929淘帝","110/07/13","凱基-三重",2,21,-19
"12867","2929淘帝","110/07/13","元大-永和",12,0,12
"12868","2929淘帝","110/07/13","富邦-仁愛",7,25,-18
"12869","2929淘帝","110/07/13","國票-天祥",11,0,11
"12870","2929淘帝","110/07/13","元大-北投",0,16,-16
"12871","5410國眾","110/07/13","兆豐-城中",274,0,274
"12872","5410國眾","110/07/13","元富-嘉義",0,103,-103
"12873","5410國眾","110/07/13","新光",50,4,46
"12874","5410國眾","110/07/13","凱基-台北",0,50,-50
"12875","5410國眾","110/07/13","國泰-台中",26,0,26
"12876","5410國眾","110/07/13","瑞士信貸",0,31,-31
"12877","5410國眾","110/07/13","新加坡商瑞銀",22,0,22
"12878","5410國眾","110/07/13","台新-新莊",0,27,-27
"12879","5410國眾","110/07/13","光和-嘉義",20,0,20
"12880","5410國眾","110/07/13","元大-汐止",0,20,-20
"12881","5410國眾","110/07/13","凱基-竹北",17,0,17
"12882","5410國眾","110/07/13","亞東-新竹",0,17,-17
"12883","5410國眾","110/07/13","新光-桃園",15,0,15
"12884","5410國眾","110/07/13","元大-南勢角",0,13,-13
"12885","5410國眾","110/07/13","凱基-台東",14,0,14
"12886","5410國眾","110/07/13","台新-台南",0,12,-12
"12887","5410國眾","110/07/13","富邦-竹北",11,0,11
"12888","5410國眾","110/07/13","中國信託",0,11,-11
"12889","5410國眾","110/07/13","元富-同大",10,0,10
"12890","5410國眾","110/07/13","華南永昌",0,11,-11
"12891","5410國眾","110/07/13","國泰-敦南",24,15,9
"12892","5410國眾","110/07/13","臺銀-臺南",0,10,-10
"12893","5410國眾","110/07/13","日盛-內湖",7,0,7
"12894","5410國眾","110/07/13","台灣企銀-民雄",0,10,-10
"12895","5410國眾","110/07/13","台新-左楠",7,0,7
"12896","5410國眾","110/07/13","高橋",0,10,-10
"12897","5410國眾","110/07/13","元大-新盛",18,12,6
"12898","5410國眾","110/07/13","康和-嘉義",0,10,-10
"12899","5410國眾","110/07/13","統一",5,0,5
"12900","5410國眾","110/07/13","凱基-基隆",0,10,-10
"12901","2841台開","110/07/13","中國信託-高雄",251,50,201
"12902","2841台開","110/07/13","兆豐-公益",0,177,-177
"12903","2841台開","110/07/13","日盛證券",210,13,197
"12904","2841台開","110/07/13","日進",0,152,-152
"12905","2841台開","110/07/13","第一金-台中",55,0,55
"12906","2841台開","110/07/13","港商野村",0,109,-109
"12907","2841台開","110/07/13","國泰-板橋",46,0,46
"12908","2841台開","110/07/13","日盛-信義",0,103,-103
"12909","2841台開","110/07/13","國泰-館前",48,3,45
"12910","2841台開","110/07/13","國泰-敦南",11,75,-64
"12911","2841台開","110/07/13","華南永昌-新莊",45,0,45
"12912","2841台開","110/07/13","永興",0,50,-50
"12913","2841台開","110/07/13","日盛-園區",42,0,42
"12914","2841台開","110/07/13","永豐金-敦南",61,104,-43
"12915","2841台開","110/07/13","台新證券",32,0,32
"12916","2841台開","110/07/13","富邦-台南",0,42,-42
"12917","2841台開","110/07/13","台新-高雄",32,2,30
"12918","2841台開","110/07/13","國票-安和",0,30,-30
"12919","2841台開","110/07/13","豐農",23,0,23
"12920","2841台開","110/07/13","元大-桃園",0,25,-25
"12921","2841台開","110/07/13","合庫-嘉義",20,0,20
"12922","2841台開","110/07/13","新光",8,32,-24
"12923","2841台開","110/07/13","華南永昌-高雄",20,0,20
"12924","2841台開","110/07/13","元大-仁愛",0,24,-24
"12925","2841台開","110/07/13","元大-樹林",16,0,16
"12926","2841台開","110/07/13","日盛-中和",0,20,-20
"12927","2841台開","110/07/13","第一金-華江",15,2,13
"12928","2841台開","110/07/13","元富",0,20,-20
"12929","2841台開","110/07/13","美商高盛",12,0,12
"12930","2841台開","110/07/13","富邦-宜蘭",0,20,-20
"12931","6207雷科","110/07/13","元大-高雄",121,0,121
"12932","6207雷科","110/07/13","華南永昌-朴子",1,60,-59
"12933","6207雷科","110/07/13","第一金-新興",20,0,20
"12934","6207雷科","110/07/13","元大-南海",0,36,-36
"12935","6207雷科","110/07/13","元富-三重",20,0,20
"12936","6207雷科","110/07/13","凱基-土城",0,35,-35
"12937","6207雷科","110/07/13","元大-林園",15,0,15
"12938","6207雷科","110/07/13","台灣企銀",0,20,-20
"12939","6207雷科","110/07/13","元大-金華",16,1,15
"12940","6207雷科","110/07/13","群益金鼎-丹鳳",0,20,-20
"12941","6207雷科","110/07/13","日盛證券",10,0,10
"12942","6207雷科","110/07/13","元大-博愛",0,17,-17
"12943","6207雷科","110/07/13","統一-台中",10,0,10
"12944","6207雷科","110/07/13","元大-北港",0,13,-13
"12945","6207雷科","110/07/13","群益金鼎-土城",10,0,10
"12946","6207雷科","110/07/13","新加坡商瑞銀",0,12,-12
"12947","6207雷科","110/07/13","群益金鼎-桃園",10,0,10
"12948","6207雷科","110/07/13","凱基-台北",4,16,-12
"12949","6207雷科","110/07/13","永豐金-新莊",10,0,10
"12950","6207雷科","110/07/13","日茂-埔里",0,11,-11
"12951","6207雷科","110/07/13","永豐金-新店",10,0,10
"12952","6207雷科","110/07/13","元大-莒光",0,11,-11
"12953","6207雷科","110/07/13","元大證券",9,0,9
"12954","6207雷科","110/07/13","統一-新竹",0,10,-10
"12955","6207雷科","110/07/13","日盛-木柵",9,1,8
"12956","6207雷科","110/07/13","元大-西螺",0,10,-10
"12957","6207雷科","110/07/13","兆豐-來福",8,0,8
"12958","6207雷科","110/07/13","康和-台中",0,8,-8
"12959","6207雷科","110/07/13","新光",7,0,7
"12960","6207雷科","110/07/13","兆豐-高雄",0,6,-6
"12961","3679新至陞","110/07/13","永豐金證券",50,0,50
"12962","3679新至陞","110/07/13","摩根大通",2,25,-23
"12963","3679新至陞","110/07/13","國泰-桃園",22,0,22
"12964","3679新至陞","110/07/13","元大-成功",0,22,-22
"12965","3679新至陞","110/07/13","台中銀-員林",11,0,11
"12966","3679新至陞","110/07/13","富邦-板橋",1,19,-18
"12967","3679新至陞","110/07/13","元大-文心興安",8,0,8
"12968","3679新至陞","110/07/13","日盛-新莊",0,10,-10
"12969","3679新至陞","110/07/13","美商高盛",6,0,6
"12970","3679新至陞","110/07/13","台新-台中",0,10,-10
"12971","3679新至陞","110/07/13","台新-高雄",6,0,6
"12972","3679新至陞","110/07/13","永豐金-新竹",0,8,-8
"12973","3679新至陞","110/07/13","凱基-台北",18,12,6
"12974","3679新至陞","110/07/13","瑞士信貸",12,19,-7
"12975","3679新至陞","110/07/13","日盛-復興",5,0,5
"12976","3679新至陞","110/07/13","統一-南京",0,7,-7
"12977","3679新至陞","110/07/13","(牛牛牛)亞-鑫豐",4,0,4
"12978","3679新至陞","110/07/13","凱基-新莊",0,7,-7
"12979","3679新至陞","110/07/13","元富-大昌",3,0,3
"12980","3679新至陞","110/07/13","新加坡商瑞銀",0,6,-6
"12981","3679新至陞","110/07/13","富邦-台北",3,0,3
"12982","3679新至陞","110/07/13","合庫-自強",0,5,-5
"12983","3679新至陞","110/07/13","日盛-樹林",2,0,2
"12984","3679新至陞","110/07/13","富邦-桃園",0,5,-5
"12985","3679新至陞","110/07/13","宏遠-光隆",2,0,2
"12986","3679新至陞","110/07/13","永豐金-潮州",0,4,-4
"12987","3679新至陞","110/07/13","美林",3,1,2
"12988","3679新至陞","110/07/13","臺銀-臺南",0,3,-3
"12989","3679新至陞","110/07/13","第一金-中壢",2,0,2
"12990","3679新至陞","110/07/13","元大-六合",0,3,-3
"12991","2727王品","110/07/13","富邦-台北",43,3,40
"12992","2727王品","110/07/13","台灣摩根士丹利",15,97,-82
"12993","2727王品","110/07/13","元大-基隆孝二",40,0,40
"12994","2727王品","110/07/13","玉山-台南",5,57,-52
"12995","2727王品","110/07/13","國票-新莊",40,1,39
"12996","2727王品","110/07/13","新加坡商瑞銀",0,48,-48
"12997","2727王品","110/07/13","第一金-豐原",66,42,24
"12998","2727王品","110/07/13","凱基-台北",41,77,-36
"12999","2727王品","110/07/13","永豐金-大園",34,10,24
"13000","2727王品","110/07/13","永豐金-永康",0,22,-22
"13001","2727王品","110/07/13","元大-北屯",22,0,22
"13002","2727王品","110/07/13","統一-台中",2,22,-20
"13003","2727王品","110/07/13","元大-東蘆",26,7,19
"13004","2727王品","110/07/13","國泰-台中",21,39,-18
"13005","2727王品","110/07/13","永豐金-萬盛",13,1,12
"13006","2727王品","110/07/13","合庫-彰化",3,20,-17
"13007","2727王品","110/07/13","日盛-嘉義",11,0,11
"13008","2727王品","110/07/13","港商野村",13,30,-17
"13009","2727王品","110/07/13","日盛-八德",11,0,11
"13010","2727王品","110/07/13","元大-楊梅",1,16,-15
"13011","2727王品","110/07/13","統一-竹南",11,0,11
"13012","2727王品","110/07/13","凱基-高美館",2,15,-13
"13013","2727王品","110/07/13","日盛-士林",12,2,10
"13014","2727王品","110/07/13","美商高盛",2,14,-12
"13015","2727王品","110/07/13","統一-敦南",10,0,10
"13016","2727王品","110/07/13","統一-平鎮",1,13,-12
"13017","2727王品","110/07/13","中國信託",15,5,10
"13018","2727王品","110/07/13","兆豐-台中港",4,16,-12
"13019","2727王品","110/07/13","兆豐-竹北",13,3,10
"13020","2727王品","110/07/13","凱基-八德",1,13,-12
"13021","1570力肯","110/07/13","新光",115,11,104
"13022","1570力肯","110/07/13","元大-北三重",0,162,-162
"13023","1570力肯","110/07/13","群益金鼎-高雄",54,0,54
"13024","1570力肯","110/07/13","元大-大灣",0,25,-25
"13025","1570力肯","110/07/13","國票-新莊",22,0,22
"13026","1570力肯","110/07/13","永豐金-苓雅",0,22,-22
"13027","1570力肯","110/07/13","日盛-桃園",12,0,12
"13028","1570力肯","110/07/13","永豐金-永康",0,19,-19
"13029","1570力肯","110/07/13","元大-高雄",12,0,12
"13030","1570力肯","110/07/13","富邦-員林",0,15,-15
"13031","1570力肯","110/07/13","合庫-自強",11,0,11
"13032","1570力肯","110/07/13","凱基-台南",0,11,-11
"13033","1570力肯","110/07/13","摩根大通",26,15,11
"13034","1570力肯","110/07/13","日盛-竹北",0,10,-10
"13035","1570力肯","110/07/13","永豐金-中盛",11,0,11
"13036","1570力肯","110/07/13","國票-九鼎",0,10,-10
"13037","1570力肯","110/07/13","兆豐-台中港",10,0,10
"13038","1570力肯","110/07/13","凱基-桃園",0,10,-10
"13039","1570力肯","110/07/13","國泰-松江",9,0,9
"13040","1570力肯","110/07/13","凱基-新豐",0,10,-10
"13041","1570力肯","110/07/13","元大-新盛",9,0,9
"13042","1570力肯","110/07/13","元大-學甲",0,10,-10
"13043","1570力肯","110/07/13","元富-緯城",6,0,6
"13044","1570力肯","110/07/13","群益金鼎-東湖",1,10,-9
"13045","1570力肯","110/07/13","統一-三重",5,0,5
"13046","1570力肯","110/07/13","大昌",0,6,-6
"13047","1570力肯","110/07/13","元大-前金",5,0,5
"13048","1570力肯","110/07/13","元大-土城學府",0,6,-6
"13049","1570力肯","110/07/13","永豐金證券",5,0,5
"13050","1570力肯","110/07/13","統一",0,5,-5
"13051","6180橘子","110/07/13","摩根大通",119,0,119
"13052","6180橘子","110/07/13","元大-崇德",2,61,-59
"13053","6180橘子","110/07/13","美商高盛",96,0,96
"13054","6180橘子","110/07/13","康和-台中",0,51,-51
"13055","6180橘子","110/07/13","新加坡商瑞銀",86,7,79
"13056","6180橘子","110/07/13","康和-台北",0,50,-50
"13057","6180橘子","110/07/13","元大-和平",40,0,40
"13058","6180橘子","110/07/13","元富-潮州",0,40,-40
"13059","6180橘子","110/07/13","凱基-台北",83,47,36
"13060","6180橘子","110/07/13","日盛-永康",0,26,-26
"13061","6180橘子","110/07/13","美林",39,5,34
"13062","6180橘子","110/07/13","永豐金-中正",0,24,-24
"13063","6180橘子","110/07/13","富邦-新竹華信",31,2,29
"13064","6180橘子","110/07/13","國泰-板橋",2,25,-23
"13065","6180橘子","110/07/13","統一-南京",21,0,21
"13066","6180橘子","110/07/13","日盛-大墩",0,20,-20
"13067","6180橘子","110/07/13","富邦-陽明",24,3,21
"13068","6180橘子","110/07/13","元大-草屯",13,32,-19
"13069","6180橘子","110/07/13","大昌-樹林",21,1,20
"13070","6180橘子","110/07/13","元富-林園",1,18,-17
"13071","6180橘子","110/07/13","花旗環球",19,0,19
"13072","6180橘子","110/07/13","新光-新竹",1,18,-17
"13073","6180橘子","110/07/13","華南永昌-台南",19,0,19
"13074","6180橘子","110/07/13","元大-土城永寧",0,17,-17
"13075","6180橘子","110/07/13","福勝",14,0,14
"13076","6180橘子","110/07/13","國泰-新莊",3,19,-16
"13077","6180橘子","110/07/13","富邦-嘉義",12,1,11
"13078","6180橘子","110/07/13","中國信託-永康",6,21,-15
"13079","6180橘子","110/07/13","元大-板橋三民",11,0,11
"13080","6180橘子","110/07/13","凱基-東港",1,15,-14
"13081","2390云辰","110/07/13","新加坡商瑞銀",562,75,487
"13082","2390云辰","110/07/13","大展-台南",0,532,-532
"13083","2390云辰","110/07/13","台灣摩根士丹利",330,155,175
"13084","2390云辰","110/07/13","凱基-台北",668,854,-186
"13085","2390云辰","110/07/13","兆豐-公益",126,25,101
"13086","2390云辰","110/07/13","凱基-三重",12,172,-160
"13087","2390云辰","110/07/13","元富-中港",100,2,98
"13088","2390云辰","110/07/13","兆豐-忠孝",4,161,-157
"13089","2390云辰","110/07/13","統一-新台中",106,9,97
"13090","2390云辰","110/07/13","元大-士林",19,170,-151
"13091","2390云辰","110/07/13","中國信託-松江",81,11,70
"13092","2390云辰","110/07/13","臺銀-新竹",14,117,-103
"13093","2390云辰","110/07/13","日盛-板橋",72,3,69
"13094","2390云辰","110/07/13","國票-台中",4,102,-98
"13095","2390云辰","110/07/13","日盛-和美",57,0,57
"13096","2390云辰","110/07/13","新光",147,232,-85
"13097","2390云辰","110/07/13","永豐金-桃園",88,36,52
"13098","2390云辰","110/07/13","致和-崇德",2,70,-68
"13099","2390云辰","110/07/13","玉山-士林",54,4,50
"13100","2390云辰","110/07/13","群益金鼎-屏東",2,70,-68
"13101","2390云辰","110/07/13","富邦-仁愛",56,6,50
"13102","2390云辰","110/07/13","元大-大里",35,98,-63
"13103","2390云辰","110/07/13","第一金-豐原",50,1,49
"13104","2390云辰","110/07/13","元大-萬華",35,94,-59
"13105","2390云辰","110/07/13","摩根大通",502,453,49
"13106","2390云辰","110/07/13","元富-吉利",2,60,-58
"13107","2390云辰","110/07/13","凱基-松山",61,13,48
"13108","2390云辰","110/07/13","兆豐-新竹",3,53,-50
"13109","2390云辰","110/07/13","大昌",64,22,42
"13110","2390云辰","110/07/13","富邦-嘉義",65,108,-43
"13111","2363矽統","110/07/13","凱基-南崁",2133,63,2070
"13112","2363矽統","110/07/13","凱基-幸福",36,4048,-4012
"13113","2363矽統","110/07/13","國泰-敦南",2195,1617,578
"13114","2363矽統","110/07/13","統一",192,3325,-3133
"13115","2363矽統","110/07/13","中農",670,139,531
"13116","2363矽統","110/07/13","新加坡商瑞銀",1000,2747,-1747
"13117","2363矽統","110/07/13","康和-台中",638,154,484
"13118","2363矽統","110/07/13","凱基-台北",5359,6609,-1250
"13119","2363矽統","110/07/13","群益金鼎-三民",577,137,440
"13120","2363矽統","110/07/13","摩根大通",1930,2858,-928
"13121","2363矽統","110/07/13","台新-屏東",510,88,422
"13122","2363矽統","110/07/13","港商野村",960,1679,-719
"13123","2363矽統","110/07/13","德信-中正",455,67,388
"13124","2363矽統","110/07/13","兆豐-復興",25,705,-680
"13125","2363矽統","110/07/13","日盛-竹北",365,70,295
"13126","2363矽統","110/07/13","統一-仁愛",114,755,-641
"13127","2363矽統","110/07/13","元大-佳里",452,189,263
"13128","2363矽統","110/07/13","統一-敦南",29,638,-609
"13129","2363矽統","110/07/13","國票-博愛",296,38,258
"13130","2363矽統","110/07/13","統一-土城",100,704,-604
"13131","2363矽統","110/07/13","元大-萬華",340,95,245
"13132","2363矽統","110/07/13","統一-城中",116,676,-560
"13133","2363矽統","110/07/13","新光",1259,1031,228
"13134","2363矽統","110/07/13","永豐金證券",306,859,-553
"13135","2363矽統","110/07/13","元富-成功",323,96,227
"13136","2363矽統","110/07/13","元富",54,567,-513
"13137","2363矽統","110/07/13","豐農",228,23,205
"13138","2363矽統","110/07/13","瑞士信貸",202,666,-464
"13139","2363矽統","110/07/13","台灣企銀-岡山",186,4,182
"13140","2363矽統","110/07/13","永豐金-嘉義",67,468,-401
"13141","8112至上","110/07/13","摩根大通",688,296,392
"13142","8112至上","110/07/13","國票-中和",0,401,-401
"13143","8112至上","110/07/13","港商野村",344,145,199
"13144","8112至上","110/07/13","永豐金-板盛",0,205,-205
"13145","8112至上","110/07/13","兆豐-公益",195,5,190
"13146","8112至上","110/07/13","凱基-五股",43,155,-112
"13147","8112至上","110/07/13","台灣摩根士丹利",183,0,183
"13148","8112至上","110/07/13","凱基-市政",0,100,-100
"13149","8112至上","110/07/13","群益金鼎-敦南",153,2,151
"13150","8112至上","110/07/13","元大-大里德芳",1,92,-91
"13151","8112至上","110/07/13","臺銀-金山",146,26,120
"13152","8112至上","110/07/13","玉山-桃園",26,110,-84
"13153","8112至上","110/07/13","臺銀",133,19,114
"13154","8112至上","110/07/13","兆豐-天母",0,81,-81
"13155","8112至上","110/07/13","合庫-台中",115,6,109
"13156","8112至上","110/07/13","凱基-城中",3,84,-81
"13157","8112至上","110/07/13","亞東-板橋",134,26,108
"13158","8112至上","110/07/13","日盛-新莊",9,85,-76
"13159","8112至上","110/07/13","凱基-台北",414,326,88
"13160","8112至上","110/07/13","日盛-台中",2,64,-62
"13161","8112至上","110/07/13","新加坡商瑞銀",181,100,81
"13162","8112至上","110/07/13","日盛-中壢",3,64,-61
"13163","8112至上","110/07/13","國泰-敦南",108,31,77
"13164","8112至上","110/07/13","元大-台中",2,59,-57
"13165","8112至上","110/07/13","第一金-華江",77,4,73
"13166","8112至上","110/07/13","元大-雙和",7,64,-57
"13167","8112至上","110/07/13","永豐金-內湖",73,1,72
"13168","8112至上","110/07/13","元大-高雄",8,62,-54
"13169","8112至上","110/07/13","元大-永和",68,1,67
"13170","8112至上","110/07/13","元大-館前",2,55,-53
"13171","4903聯光通","110/07/13","台灣企銀-太平",56,0,56
"13172","4903聯光通","110/07/13","土銀",0,32,-32
"13173","4903聯光通","110/07/13","元富-新興",23,0,23
"13174","4903聯光通","110/07/13","元大-樹林",0,19,-19
"13175","4903聯光通","110/07/13","日盛-樹林",22,0,22
"13176","4903聯光通","110/07/13","凱基-士林",0,17,-17
"13177","4903聯光通","110/07/13","兆豐-天母",20,0,20
"13178","4903聯光通","110/07/13","國票-博愛",0,14,-14
"13179","4903聯光通","110/07/13","華南永昌-桃園",20,0,20
"13180","4903聯光通","110/07/13","元富",0,10,-10
"13181","4903聯光通","110/07/13","富邦-新店",10,0,10
"13182","4903聯光通","110/07/13","新光",0,10,-10
"13183","4903聯光通","110/07/13","新光-台中",5,0,5
"13184","4903聯光通","110/07/13","玉山-南京東路",0,10,-10
"13185","4903聯光通","110/07/13","華南永昌-台中",5,0,5
"13186","4903聯光通","110/07/13","富邦-陽明",0,10,-10
"13187","4903聯光通","110/07/13","元大-崇德",5,0,5
"13188","4903聯光通","110/07/13","元大-大甲",0,8,-8
"13189","4903聯光通","110/07/13","元大-草屯",5,0,5
"13190","4903聯光通","110/07/13","富邦-台中",0,7,-7
"13191","4903聯光通","110/07/13","元富-草屯",4,0,4
"13192","4903聯光通","110/07/13","凱基-中壢",0,6,-6
"13193","4903聯光通","110/07/13","元大-清水",4,0,4
"13194","4903聯光通","110/07/13","臺銀-民權",0,5,-5
"13195","4903聯光通","110/07/13","元大-東泰",4,0,4
"13196","4903聯光通","110/07/13","日盛-板橋",0,5,-5
"13197","4903聯光通","110/07/13","元大-佳里",2,0,2
"13198","4903聯光通","110/07/13","中國信託-忠孝",0,5,-5
"13199","4903聯光通","110/07/13","永豐金-板橋",2,0,2
"13200","4903聯光通","110/07/13","永豐金-鳳山",0,5,-5
"13201","2929淘帝","110/07/13","玉山-新竹",130,0,130
"13202","2929淘帝","110/07/13","美商高盛",0,177,-177
"13203","2929淘帝","110/07/13","臺銀-民權",60,0,60
"13204","2929淘帝","110/07/13","凱基-台北",6,80,-74
"13205","2929淘帝","110/07/13","新百王",31,0,31
"13206","2929淘帝","110/07/13","元富-大裕",0,49,-49
"13207","2929淘帝","110/07/13","日盛-園區",30,0,30
"13208","2929淘帝","110/07/13","國泰-館前",3,51,-48
"13209","2929淘帝","110/07/13","元大-南投",31,1,30
"13210","2929淘帝","110/07/13","凱基-中壢",0,41,-41
"13211","2929淘帝","110/07/13","兆豐-忠孝",28,0,28
"13212","2929淘帝","110/07/13","港商野村",21,55,-34
"13213","2929淘帝","110/07/13","元大-民生",28,0,28
"13214","2929淘帝","110/07/13","華南永昌-南京",2,34,-32
"13215","2929淘帝","110/07/13","合庫-高雄",27,0,27
"13216","2929淘帝","110/07/13","群益金鼎-土城",0,30,-30
"13217","2929淘帝","110/07/13","凱基-豐中",27,0,27
"13218","2929淘帝","110/07/13","富邦-南屯",0,22,-22
"13219","2929淘帝","110/07/13","新光",21,4,17
"13220","2929淘帝","110/07/13","第一金-豐原",0,20,-20
"13221","2929淘帝","110/07/13","元大-天母",17,0,17
"13222","2929淘帝","110/07/13","元大-屏南",6,26,-20
"13223","2929淘帝","110/07/13","永興",14,0,14
"13224","2929淘帝","110/07/13","永豐金-敦南",1,21,-20
"13225","2929淘帝","110/07/13","富邦-台北",12,0,12
"13226","2929淘帝","110/07/13","凱基-三重",2,21,-19
"13227","2929淘帝","110/07/13","元大-永和",12,0,12
"13228","2929淘帝","110/07/13","富邦-仁愛",7,25,-18
"13229","2929淘帝","110/07/13","國票-天祥",11,0,11
"13230","2929淘帝","110/07/13","元大-北投",0,16,-16
"13231","5410國眾","110/07/13","兆豐-城中",274,0,274
"13232","5410國眾","110/07/13","元富-嘉義",0,103,-103
"13233","5410國眾","110/07/13","新光",50,4,46
"13234","5410國眾","110/07/13","凱基-台北",0,50,-50
"13235","5410國眾","110/07/13","國泰-台中",26,0,26
"13236","5410國眾","110/07/13","瑞士信貸",0,31,-31
"13237","5410國眾","110/07/13","新加坡商瑞銀",22,0,22
"13238","5410國眾","110/07/13","台新-新莊",0,27,-27
"13239","5410國眾","110/07/13","光和-嘉義",20,0,20
"13240","5410國眾","110/07/13","元大-汐止",0,20,-20
"13241","5410國眾","110/07/13","凱基-竹北",17,0,17
"13242","5410國眾","110/07/13","亞東-新竹",0,17,-17
"13243","5410國眾","110/07/13","新光-桃園",15,0,15
"13244","5410國眾","110/07/13","元大-南勢角",0,13,-13
"13245","5410國眾","110/07/13","凱基-台東",14,0,14
"13246","5410國眾","110/07/13","台新-台南",0,12,-12
"13247","5410國眾","110/07/13","富邦-竹北",11,0,11
"13248","5410國眾","110/07/13","中國信託",0,11,-11
"13249","5410國眾","110/07/13","元富-同大",10,0,10
"13250","5410國眾","110/07/13","華南永昌",0,11,-11
"13251","5410國眾","110/07/13","國泰-敦南",24,15,9
"13252","5410國眾","110/07/13","臺銀-臺南",0,10,-10
"13253","5410國眾","110/07/13","日盛-內湖",7,0,7
"13254","5410國眾","110/07/13","台灣企銀-民雄",0,10,-10
"13255","5410國眾","110/07/13","台新-左楠",7,0,7
"13256","5410國眾","110/07/13","高橋",0,10,-10
"13257","5410國眾","110/07/13","元大-新盛",18,12,6
"13258","5410國眾","110/07/13","康和-嘉義",0,10,-10
"13259","5410國眾","110/07/13","統一",5,0,5
"13260","5410國眾","110/07/13","凱基-基隆",0,10,-10
"13261","2841台開","110/07/13","中國信託-高雄",251,50,201
"13262","2841台開","110/07/13","兆豐-公益",0,177,-177
"13263","2841台開","110/07/13","日盛證券",210,13,197
"13264","2841台開","110/07/13","日進",0,152,-152
"13265","2841台開","110/07/13","第一金-台中",55,0,55
"13266","2841台開","110/07/13","港商野村",0,109,-109
"13267","2841台開","110/07/13","國泰-板橋",46,0,46
"13268","2841台開","110/07/13","日盛-信義",0,103,-103
"13269","2841台開","110/07/13","國泰-館前",48,3,45
"13270","2841台開","110/07/13","國泰-敦南",11,75,-64
"13271","2841台開","110/07/13","華南永昌-新莊",45,0,45
"13272","2841台開","110/07/13","永興",0,50,-50
"13273","2841台開","110/07/13","日盛-園區",42,0,42
"13274","2841台開","110/07/13","永豐金-敦南",61,104,-43
"13275","2841台開","110/07/13","台新證券",32,0,32
"13276","2841台開","110/07/13","富邦-台南",0,42,-42
"13277","2841台開","110/07/13","台新-高雄",32,2,30
"13278","2841台開","110/07/13","國票-安和",0,30,-30
"13279","2841台開","110/07/13","豐農",23,0,23
"13280","2841台開","110/07/13","元大-桃園",0,25,-25
"13281","2841台開","110/07/13","合庫-嘉義",20,0,20
"13282","2841台開","110/07/13","新光",8,32,-24
"13283","2841台開","110/07/13","華南永昌-高雄",20,0,20
"13284","2841台開","110/07/13","元大-仁愛",0,24,-24
"13285","2841台開","110/07/13","元大-樹林",16,0,16
"13286","2841台開","110/07/13","日盛-中和",0,20,-20
"13287","2841台開","110/07/13","第一金-華江",15,2,13
"13288","2841台開","110/07/13","元富",0,20,-20
"13289","2841台開","110/07/13","美商高盛",12,0,12
"13290","2841台開","110/07/13","富邦-宜蘭",0,20,-20
"13291","6207雷科","110/07/13","元大-高雄",121,0,121
"13292","6207雷科","110/07/13","華南永昌-朴子",1,60,-59
"13293","6207雷科","110/07/13","第一金-新興",20,0,20
"13294","6207雷科","110/07/13","元大-南海",0,36,-36
"13295","6207雷科","110/07/13","元富-三重",20,0,20
"13296","6207雷科","110/07/13","凱基-土城",0,35,-35
"13297","6207雷科","110/07/13","元大-林園",15,0,15
"13298","6207雷科","110/07/13","台灣企銀",0,20,-20
"13299","6207雷科","110/07/13","元大-金華",16,1,15
"13300","6207雷科","110/07/13","群益金鼎-丹鳳",0,20,-20
"13301","6207雷科","110/07/13","日盛證券",10,0,10
"13302","6207雷科","110/07/13","元大-博愛",0,17,-17
"13303","6207雷科","110/07/13","統一-台中",10,0,10
"13304","6207雷科","110/07/13","元大-北港",0,13,-13
"13305","6207雷科","110/07/13","群益金鼎-土城",10,0,10
"13306","6207雷科","110/07/13","新加坡商瑞銀",0,12,-12
"13307","6207雷科","110/07/13","群益金鼎-桃園",10,0,10
"13308","6207雷科","110/07/13","凱基-台北",4,16,-12
"13309","6207雷科","110/07/13","永豐金-新莊",10,0,10
"13310","6207雷科","110/07/13","日茂-埔里",0,11,-11
"13311","6207雷科","110/07/13","永豐金-新店",10,0,10
"13312","6207雷科","110/07/13","元大-莒光",0,11,-11
"13313","6207雷科","110/07/13","元大證券",9,0,9
"13314","6207雷科","110/07/13","統一-新竹",0,10,-10
"13315","6207雷科","110/07/13","日盛-木柵",9,1,8
"13316","6207雷科","110/07/13","元大-西螺",0,10,-10
"13317","6207雷科","110/07/13","兆豐-來福",8,0,8
"13318","6207雷科","110/07/13","康和-台中",0,8,-8
"13319","6207雷科","110/07/13","新光",7,0,7
"13320","6207雷科","110/07/13","兆豐-高雄",0,6,-6
"13321","3679新至陞","110/07/13","永豐金證券",50,0,50
"13322","3679新至陞","110/07/13","摩根大通",2,25,-23
"13323","3679新至陞","110/07/13","國泰-桃園",22,0,22
"13324","3679新至陞","110/07/13","元大-成功",0,22,-22
"13325","3679新至陞","110/07/13","台中銀-員林",11,0,11
"13326","3679新至陞","110/07/13","富邦-板橋",1,19,-18
"13327","3679新至陞","110/07/13","元大-文心興安",8,0,8
"13328","3679新至陞","110/07/13","日盛-新莊",0,10,-10
"13329","3679新至陞","110/07/13","美商高盛",6,0,6
"13330","3679新至陞","110/07/13","台新-台中",0,10,-10
"13331","3679新至陞","110/07/13","台新-高雄",6,0,6
"13332","3679新至陞","110/07/13","永豐金-新竹",0,8,-8
"13333","3679新至陞","110/07/13","凱基-台北",18,12,6
"13334","3679新至陞","110/07/13","瑞士信貸",12,19,-7
"13335","3679新至陞","110/07/13","日盛-復興",5,0,5
"13336","3679新至陞","110/07/13","統一-南京",0,7,-7
"13337","3679新至陞","110/07/13","(牛牛牛)亞-鑫豐",4,0,4
"13338","3679新至陞","110/07/13","凱基-新莊",0,7,-7
"13339","3679新至陞","110/07/13","元富-大昌",3,0,3
"13340","3679新至陞","110/07/13","新加坡商瑞銀",0,6,-6
"13341","3679新至陞","110/07/13","富邦-台北",3,0,3
"13342","3679新至陞","110/07/13","合庫-自強",0,5,-5
"13343","3679新至陞","110/07/13","日盛-樹林",2,0,2
"13344","3679新至陞","110/07/13","富邦-桃園",0,5,-5
"13345","3679新至陞","110/07/13","宏遠-光隆",2,0,2
"13346","3679新至陞","110/07/13","永豐金-潮州",0,4,-4
"13347","3679新至陞","110/07/13","美林",3,1,2
"13348","3679新至陞","110/07/13","臺銀-臺南",0,3,-3
"13349","3679新至陞","110/07/13","第一金-中壢",2,0,2
"13350","3679新至陞","110/07/13","元大-六合",0,3,-3
"13351","2727王品","110/07/13","富邦-台北",43,3,40
"13352","2727王品","110/07/13","台灣摩根士丹利",15,97,-82
"13353","2727王品","110/07/13","元大-基隆孝二",40,0,40
"13354","2727王品","110/07/13","玉山-台南",5,57,-52
"13355","2727王品","110/07/13","國票-新莊",40,1,39
"13356","2727王品","110/07/13","新加坡商瑞銀",0,48,-48
"13357","2727王品","110/07/13","第一金-豐原",66,42,24
"13358","2727王品","110/07/13","凱基-台北",41,77,-36
"13359","2727王品","110/07/13","永豐金-大園",34,10,24
"13360","2727王品","110/07/13","永豐金-永康",0,22,-22
"13361","2727王品","110/07/13","元大-北屯",22,0,22
"13362","2727王品","110/07/13","統一-台中",2,22,-20
"13363","2727王品","110/07/13","元大-東蘆",26,7,19
"13364","2727王品","110/07/13","國泰-台中",21,39,-18
"13365","2727王品","110/07/13","永豐金-萬盛",13,1,12
"13366","2727王品","110/07/13","合庫-彰化",3,20,-17
"13367","2727王品","110/07/13","日盛-嘉義",11,0,11
"13368","2727王品","110/07/13","港商野村",13,30,-17
"13369","2727王品","110/07/13","日盛-八德",11,0,11
"13370","2727王品","110/07/13","元大-楊梅",1,16,-15
"13371","2727王品","110/07/13","統一-竹南",11,0,11
"13372","2727王品","110/07/13","凱基-高美館",2,15,-13
"13373","2727王品","110/07/13","日盛-士林",12,2,10
"13374","2727王品","110/07/13","美商高盛",2,14,-12
"13375","2727王品","110/07/13","統一-敦南",10,0,10
"13376","2727王品","110/07/13","統一-平鎮",1,13,-12
"13377","2727王品","110/07/13","中國信託",15,5,10
"13378","2727王品","110/07/13","兆豐-台中港",4,16,-12
"13379","2727王品","110/07/13","兆豐-竹北",13,3,10
"13380","2727王品","110/07/13","凱基-八德",1,13,-12
"13381","1570力肯","110/07/13","新光",115,11,104
"13382","1570力肯","110/07/13","元大-北三重",0,162,-162
"13383","1570力肯","110/07/13","群益金鼎-高雄",54,0,54
"13384","1570力肯","110/07/13","元大-大灣",0,25,-25
"13385","1570力肯","110/07/13","國票-新莊",22,0,22
"13386","1570力肯","110/07/13","永豐金-苓雅",0,22,-22
"13387","1570力肯","110/07/13","日盛-桃園",12,0,12
"13388","1570力肯","110/07/13","永豐金-永康",0,19,-19
"13389","1570力肯","110/07/13","元大-高雄",12,0,12
"13390","1570力肯","110/07/13","富邦-員林",0,15,-15
"13391","1570力肯","110/07/13","合庫-自強",11,0,11
"13392","1570力肯","110/07/13","凱基-台南",0,11,-11
"13393","1570力肯","110/07/13","摩根大通",26,15,11
"13394","1570力肯","110/07/13","日盛-竹北",0,10,-10
"13395","1570力肯","110/07/13","永豐金-中盛",11,0,11
"13396","1570力肯","110/07/13","國票-九鼎",0,10,-10
"13397","1570力肯","110/07/13","兆豐-台中港",10,0,10
"13398","1570力肯","110/07/13","凱基-桃園",0,10,-10
"13399","1570力肯","110/07/13","國泰-松江",9,0,9
"13400","1570力肯","110/07/13","凱基-新豐",0,10,-10
"13401","1570力肯","110/07/13","元大-新盛",9,0,9
"13402","1570力肯","110/07/13","元大-學甲",0,10,-10
"13403","1570力肯","110/07/13","元富-緯城",6,0,6
"13404","1570力肯","110/07/13","群益金鼎-東湖",1,10,-9
"13405","1570力肯","110/07/13","統一-三重",5,0,5
"13406","1570力肯","110/07/13","大昌",0,6,-6
"13407","1570力肯","110/07/13","元大-前金",5,0,5
"13408","1570力肯","110/07/13","元大-土城學府",0,6,-6
"13409","1570力肯","110/07/13","永豐金證券",5,0,5
"13410","1570力肯","110/07/13","統一",0,5,-5
"13411","6180橘子","110/07/13","摩根大通",119,0,119
"13412","6180橘子","110/07/13","元大-崇德",2,61,-59
"13413","6180橘子","110/07/13","美商高盛",96,0,96
"13414","6180橘子","110/07/13","康和-台中",0,51,-51
"13415","6180橘子","110/07/13","新加坡商瑞銀",86,7,79
"13416","6180橘子","110/07/13","康和-台北",0,50,-50
"13417","6180橘子","110/07/13","元大-和平",40,0,40
"13418","6180橘子","110/07/13","元富-潮州",0,40,-40
"13419","6180橘子","110/07/13","凱基-台北",83,47,36
"13420","6180橘子","110/07/13","日盛-永康",0,26,-26
"13421","6180橘子","110/07/13","美林",39,5,34
"13422","6180橘子","110/07/13","永豐金-中正",0,24,-24
"13423","6180橘子","110/07/13","富邦-新竹華信",31,2,29
"13424","6180橘子","110/07/13","國泰-板橋",2,25,-23
"13425","6180橘子","110/07/13","統一-南京",21,0,21
"13426","6180橘子","110/07/13","日盛-大墩",0,20,-20
"13427","6180橘子","110/07/13","富邦-陽明",24,3,21
"13428","6180橘子","110/07/13","元大-草屯",13,32,-19
"13429","6180橘子","110/07/13","大昌-樹林",21,1,20
"13430","6180橘子","110/07/13","元富-林園",1,18,-17
"13431","6180橘子","110/07/13","花旗環球",19,0,19
"13432","6180橘子","110/07/13","新光-新竹",1,18,-17
"13433","6180橘子","110/07/13","華南永昌-台南",19,0,19
"13434","6180橘子","110/07/13","元大-土城永寧",0,17,-17
"13435","6180橘子","110/07/13","福勝",14,0,14
"13436","6180橘子","110/07/13","國泰-新莊",3,19,-16
"13437","6180橘子","110/07/13","富邦-嘉義",12,1,11
"13438","6180橘子","110/07/13","中國信託-永康",6,21,-15
"13439","6180橘子","110/07/13","元大-板橋三民",11,0,11
"13440","6180橘子","110/07/13","凱基-東港",1,15,-14
"13441","2390云辰","110/07/13","新加坡商瑞銀",562,75,487
"13442","2390云辰","110/07/13","大展-台南",0,532,-532
"13443","2390云辰","110/07/13","台灣摩根士丹利",330,155,175
"13444","2390云辰","110/07/13","凱基-台北",668,854,-186
"13445","2390云辰","110/07/13","兆豐-公益",126,25,101
"13446","2390云辰","110/07/13","凱基-三重",12,172,-160
"13447","2390云辰","110/07/13","元富-中港",100,2,98
"13448","2390云辰","110/07/13","兆豐-忠孝",4,161,-157
"13449","2390云辰","110/07/13","統一-新台中",106,9,97
"13450","2390云辰","110/07/13","元大-士林",19,170,-151
"13451","2390云辰","110/07/13","中國信託-松江",81,11,70
"13452","2390云辰","110/07/13","臺銀-新竹",14,117,-103
"13453","2390云辰","110/07/13","日盛-板橋",72,3,69
"13454","2390云辰","110/07/13","國票-台中",4,102,-98
"13455","2390云辰","110/07/13","日盛-和美",57,0,57
"13456","2390云辰","110/07/13","新光",147,232,-85
"13457","2390云辰","110/07/13","永豐金-桃園",88,36,52
"13458","2390云辰","110/07/13","致和-崇德",2,70,-68
"13459","2390云辰","110/07/13","玉山-士林",54,4,50
"13460","2390云辰","110/07/13","群益金鼎-屏東",2,70,-68
"13461","2390云辰","110/07/13","富邦-仁愛",56,6,50
"13462","2390云辰","110/07/13","元大-大里",35,98,-63
"13463","2390云辰","110/07/13","第一金-豐原",50,1,49
"13464","2390云辰","110/07/13","元大-萬華",35,94,-59
"13465","2390云辰","110/07/13","摩根大通",502,453,49
"13466","2390云辰","110/07/13","元富-吉利",2,60,-58
"13467","2390云辰","110/07/13","凱基-松山",61,13,48
"13468","2390云辰","110/07/13","兆豐-新竹",3,53,-50
"13469","2390云辰","110/07/13","大昌",64,22,42
"13470","2390云辰","110/07/13","富邦-嘉義",65,108,-43
"13471","2363矽統","110/07/13","凱基-南崁",2133,63,2070
"13472","2363矽統","110/07/13","凱基-幸福",36,4048,-4012
"13473","2363矽統","110/07/13","國泰-敦南",2195,1617,578
"13474","2363矽統","110/07/13","統一",192,3325,-3133
"13475","2363矽統","110/07/13","中農",670,139,531
"13476","2363矽統","110/07/13","新加坡商瑞銀",1000,2747,-1747
"13477","2363矽統","110/07/13","康和-台中",638,154,484
"13478","2363矽統","110/07/13","凱基-台北",5359,6609,-1250
"13479","2363矽統","110/07/13","群益金鼎-三民",577,137,440
"13480","2363矽統","110/07/13","摩根大通",1930,2858,-928
"13481","2363矽統","110/07/13","台新-屏東",510,88,422
"13482","2363矽統","110/07/13","港商野村",960,1679,-719
"13483","2363矽統","110/07/13","德信-中正",455,67,388
"13484","2363矽統","110/07/13","兆豐-復興",25,705,-680
"13485","2363矽統","110/07/13","日盛-竹北",365,70,295
"13486","2363矽統","110/07/13","統一-仁愛",114,755,-641
"13487","2363矽統","110/07/13","元大-佳里",452,189,263
"13488","2363矽統","110/07/13","統一-敦南",29,638,-609
"13489","2363矽統","110/07/13","國票-博愛",296,38,258
"13490","2363矽統","110/07/13","統一-土城",100,704,-604
"13491","2363矽統","110/07/13","元大-萬華",340,95,245
"13492","2363矽統","110/07/13","統一-城中",116,676,-560
"13493","2363矽統","110/07/13","新光",1259,1031,228
"13494","2363矽統","110/07/13","永豐金證券",306,859,-553
"13495","2363矽統","110/07/13","元富-成功",323,96,227
"13496","2363矽統","110/07/13","元富",54,567,-513
"13497","2363矽統","110/07/13","豐農",228,23,205
"13498","2363矽統","110/07/13","瑞士信貸",202,666,-464
"13499","2363矽統","110/07/13","台灣企銀-岡山",186,4,182
"13500","2363矽統","110/07/13","永豐金-嘉義",67,468,-401
"13501","8112至上","110/07/13","摩根大通",688,296,392
"13502","8112至上","110/07/13","國票-中和",0,401,-401
"13503","8112至上","110/07/13","港商野村",344,145,199
"13504","8112至上","110/07/13","永豐金-板盛",0,205,-205
"13505","8112至上","110/07/13","兆豐-公益",195,5,190
"13506","8112至上","110/07/13","凱基-五股",43,155,-112
"13507","8112至上","110/07/13","台灣摩根士丹利",183,0,183
"13508","8112至上","110/07/13","凱基-市政",0,100,-100
"13509","8112至上","110/07/13","群益金鼎-敦南",153,2,151
"13510","8112至上","110/07/13","元大-大里德芳",1,92,-91
"13511","8112至上","110/07/13","臺銀-金山",146,26,120
"13512","8112至上","110/07/13","玉山-桃園",26,110,-84
"13513","8112至上","110/07/13","臺銀",133,19,114
"13514","8112至上","110/07/13","兆豐-天母",0,81,-81
"13515","8112至上","110/07/13","合庫-台中",115,6,109
"13516","8112至上","110/07/13","凱基-城中",3,84,-81
"13517","8112至上","110/07/13","亞東-板橋",134,26,108
"13518","8112至上","110/07/13","日盛-新莊",9,85,-76
"13519","8112至上","110/07/13","凱基-台北",414,326,88
"13520","8112至上","110/07/13","日盛-台中",2,64,-62
"13521","8112至上","110/07/13","新加坡商瑞銀",181,100,81
"13522","8112至上","110/07/13","日盛-中壢",3,64,-61
"13523","8112至上","110/07/13","國泰-敦南",108,31,77
"13524","8112至上","110/07/13","元大-台中",2,59,-57
"13525","8112至上","110/07/13","第一金-華江",77,4,73
"13526","8112至上","110/07/13","元大-雙和",7,64,-57
"13527","8112至上","110/07/13","永豐金-內湖",73,1,72
"13528","8112至上","110/07/13","元大-高雄",8,62,-54
"13529","8112至上","110/07/13","元大-永和",68,1,67
"13530","8112至上","110/07/13","元大-館前",2,55,-53
"13531","4903聯光通","110/07/13","台灣企銀-太平",56,0,56
"13532","4903聯光通","110/07/13","土銀",0,32,-32
"13533","4903聯光通","110/07/13","元富-新興",23,0,23
"13534","4903聯光通","110/07/13","元大-樹林",0,19,-19
"13535","4903聯光通","110/07/13","日盛-樹林",22,0,22
"13536","4903聯光通","110/07/13","凱基-士林",0,17,-17
"13537","4903聯光通","110/07/13","兆豐-天母",20,0,20
"13538","4903聯光通","110/07/13","國票-博愛",0,14,-14
"13539","4903聯光通","110/07/13","華南永昌-桃園",20,0,20
"13540","4903聯光通","110/07/13","元富",0,10,-10
"13541","4903聯光通","110/07/13","富邦-新店",10,0,10
"13542","4903聯光通","110/07/13","新光",0,10,-10
"13543","4903聯光通","110/07/13","新光-台中",5,0,5
"13544","4903聯光通","110/07/13","玉山-南京東路",0,10,-10
"13545","4903聯光通","110/07/13","華南永昌-台中",5,0,5
"13546","4903聯光通","110/07/13","富邦-陽明",0,10,-10
"13547","4903聯光通","110/07/13","元大-崇德",5,0,5
"13548","4903聯光通","110/07/13","元大-大甲",0,8,-8
"13549","4903聯光通","110/07/13","元大-草屯",5,0,5
"13550","4903聯光通","110/07/13","富邦-台中",0,7,-7
"13551","4903聯光通","110/07/13","元富-草屯",4,0,4
"13552","4903聯光通","110/07/13","凱基-中壢",0,6,-6
"13553","4903聯光通","110/07/13","元大-清水",4,0,4
"13554","4903聯光通","110/07/13","臺銀-民權",0,5,-5
"13555","4903聯光通","110/07/13","元大-東泰",4,0,4
"13556","4903聯光通","110/07/13","日盛-板橋",0,5,-5
"13557","4903聯光通","110/07/13","元大-佳里",2,0,2
"13558","4903聯光通","110/07/13","中國信託-忠孝",0,5,-5
"13559","4903聯光通","110/07/13","永豐金-板橋",2,0,2
"13560","4903聯光通","110/07/13","永豐金-鳳山",0,5,-5
"13561","2929淘帝","110/07/13","玉山-新竹",130,0,130
"13562","2929淘帝","110/07/13","美商高盛",0,177,-177
"13563","2929淘帝","110/07/13","臺銀-民權",60,0,60
"13564","2929淘帝","110/07/13","凱基-台北",6,80,-74
"13565","2929淘帝","110/07/13","新百王",31,0,31
"13566","2929淘帝","110/07/13","元富-大裕",0,49,-49
"13567","2929淘帝","110/07/13","日盛-園區",30,0,30
"13568","2929淘帝","110/07/13","國泰-館前",3,51,-48
"13569","2929淘帝","110/07/13","元大-南投",31,1,30
"13570","2929淘帝","110/07/13","凱基-中壢",0,41,-41
"13571","2929淘帝","110/07/13","兆豐-忠孝",28,0,28
"13572","2929淘帝","110/07/13","港商野村",21,55,-34
"13573","2929淘帝","110/07/13","元大-民生",28,0,28
"13574","2929淘帝","110/07/13","華南永昌-南京",2,34,-32
"13575","2929淘帝","110/07/13","合庫-高雄",27,0,27
"13576","2929淘帝","110/07/13","群益金鼎-土城",0,30,-30
"13577","2929淘帝","110/07/13","凱基-豐中",27,0,27
"13578","2929淘帝","110/07/13","富邦-南屯",0,22,-22
"13579","2929淘帝","110/07/13","新光",21,4,17
"13580","2929淘帝","110/07/13","第一金-豐原",0,20,-20
"13581","2929淘帝","110/07/13","元大-天母",17,0,17
"13582","2929淘帝","110/07/13","元大-屏南",6,26,-20
"13583","2929淘帝","110/07/13","永興",14,0,14
"13584","2929淘帝","110/07/13","永豐金-敦南",1,21,-20
"13585","2929淘帝","110/07/13","富邦-台北",12,0,12
"13586","2929淘帝","110/07/13","凱基-三重",2,21,-19
"13587","2929淘帝","110/07/13","元大-永和",12,0,12
"13588","2929淘帝","110/07/13","富邦-仁愛",7,25,-18
"13589","2929淘帝","110/07/13","國票-天祥",11,0,11
"13590","2929淘帝","110/07/13","元大-北投",0,16,-16
"13591","5410國眾","110/07/13","兆豐-城中",274,0,274
"13592","5410國眾","110/07/13","元富-嘉義",0,103,-103
"13593","5410國眾","110/07/13","新光",50,4,46
"13594","5410國眾","110/07/13","凱基-台北",0,50,-50
"13595","5410國眾","110/07/13","國泰-台中",26,0,26
"13596","5410國眾","110/07/13","瑞士信貸",0,31,-31
"13597","5410國眾","110/07/13","新加坡商瑞銀",22,0,22
"13598","5410國眾","110/07/13","台新-新莊",0,27,-27
"13599","5410國眾","110/07/13","光和-嘉義",20,0,20
"13600","5410國眾","110/07/13","元大-汐止",0,20,-20
"13601","5410國眾","110/07/13","凱基-竹北",17,0,17
"13602","5410國眾","110/07/13","亞東-新竹",0,17,-17
"13603","5410國眾","110/07/13","新光-桃園",15,0,15
"13604","5410國眾","110/07/13","元大-南勢角",0,13,-13
"13605","5410國眾","110/07/13","凱基-台東",14,0,14
"13606","5410國眾","110/07/13","台新-台南",0,12,-12
"13607","5410國眾","110/07/13","富邦-竹北",11,0,11
"13608","5410國眾","110/07/13","中國信託",0,11,-11
"13609","5410國眾","110/07/13","元富-同大",10,0,10
"13610","5410國眾","110/07/13","華南永昌",0,11,-11
"13611","5410國眾","110/07/13","國泰-敦南",24,15,9
"13612","5410國眾","110/07/13","臺銀-臺南",0,10,-10
"13613","5410國眾","110/07/13","日盛-內湖",7,0,7
"13614","5410國眾","110/07/13","台灣企銀-民雄",0,10,-10
"13615","5410國眾","110/07/13","台新-左楠",7,0,7
"13616","5410國眾","110/07/13","高橋",0,10,-10
"13617","5410國眾","110/07/13","元大-新盛",18,12,6
"13618","5410國眾","110/07/13","康和-嘉義",0,10,-10
"13619","5410國眾","110/07/13","統一",5,0,5
"13620","5410國眾","110/07/13","凱基-基隆",0,10,-10
"13621","2841台開","110/07/13","中國信託-高雄",251,50,201
"13622","2841台開","110/07/13","兆豐-公益",0,177,-177
"13623","2841台開","110/07/13","日盛證券",210,13,197
"13624","2841台開","110/07/13","日進",0,152,-152
"13625","2841台開","110/07/13","第一金-台中",55,0,55
"13626","2841台開","110/07/13","港商野村",0,109,-109
"13627","2841台開","110/07/13","國泰-板橋",46,0,46
"13628","2841台開","110/07/13","日盛-信義",0,103,-103
"13629","2841台開","110/07/13","國泰-館前",48,3,45
"13630","2841台開","110/07/13","國泰-敦南",11,75,-64
"13631","2841台開","110/07/13","華南永昌-新莊",45,0,45
"13632","2841台開","110/07/13","永興",0,50,-50
"13633","2841台開","110/07/13","日盛-園區",42,0,42
"13634","2841台開","110/07/13","永豐金-敦南",61,104,-43
"13635","2841台開","110/07/13","台新證券",32,0,32
"13636","2841台開","110/07/13","富邦-台南",0,42,-42
"13637","2841台開","110/07/13","台新-高雄",32,2,30
"13638","2841台開","110/07/13","國票-安和",0,30,-30
"13639","2841台開","110/07/13","豐農",23,0,23
"13640","2841台開","110/07/13","元大-桃園",0,25,-25
"13641","2841台開","110/07/13","合庫-嘉義",20,0,20
"13642","2841台開","110/07/13","新光",8,32,-24
"13643","2841台開","110/07/13","華南永昌-高雄",20,0,20
"13644","2841台開","110/07/13","元大-仁愛",0,24,-24
"13645","2841台開","110/07/13","元大-樹林",16,0,16
"13646","2841台開","110/07/13","日盛-中和",0,20,-20
"13647","2841台開","110/07/13","第一金-華江",15,2,13
"13648","2841台開","110/07/13","元富",0,20,-20
"13649","2841台開","110/07/13","美商高盛",12,0,12
"13650","2841台開","110/07/13","富邦-宜蘭",0,20,-20
"13651","6207雷科","110/07/13","元大-高雄",121,0,121
"13652","6207雷科","110/07/13","華南永昌-朴子",1,60,-59
"13653","6207雷科","110/07/13","第一金-新興",20,0,20
"13654","6207雷科","110/07/13","元大-南海",0,36,-36
"13655","6207雷科","110/07/13","元富-三重",20,0,20
"13656","6207雷科","110/07/13","凱基-土城",0,35,-35
"13657","6207雷科","110/07/13","元大-林園",15,0,15
"13658","6207雷科","110/07/13","台灣企銀",0,20,-20
"13659","6207雷科","110/07/13","元大-金華",16,1,15
"13660","6207雷科","110/07/13","群益金鼎-丹鳳",0,20,-20
"13661","6207雷科","110/07/13","日盛證券",10,0,10
"13662","6207雷科","110/07/13","元大-博愛",0,17,-17
"13663","6207雷科","110/07/13","統一-台中",10,0,10
"13664","6207雷科","110/07/13","元大-北港",0,13,-13
"13665","6207雷科","110/07/13","群益金鼎-土城",10,0,10
"13666","6207雷科","110/07/13","新加坡商瑞銀",0,12,-12
"13667","6207雷科","110/07/13","群益金鼎-桃園",10,0,10
"13668","6207雷科","110/07/13","凱基-台北",4,16,-12
"13669","6207雷科","110/07/13","永豐金-新莊",10,0,10
"13670","6207雷科","110/07/13","日茂-埔里",0,11,-11
"13671","6207雷科","110/07/13","永豐金-新店",10,0,10
"13672","6207雷科","110/07/13","元大-莒光",0,11,-11
"13673","6207雷科","110/07/13","元大證券",9,0,9
"13674","6207雷科","110/07/13","統一-新竹",0,10,-10
"13675","6207雷科","110/07/13","日盛-木柵",9,1,8
"13676","6207雷科","110/07/13","元大-西螺",0,10,-10
"13677","6207雷科","110/07/13","兆豐-來福",8,0,8
"13678","6207雷科","110/07/13","康和-台中",0,8,-8
"13679","6207雷科","110/07/13","新光",7,0,7
"13680","6207雷科","110/07/13","兆豐-高雄",0,6,-6
"13681","3679新至陞","110/07/13","永豐金證券",50,0,50
"13682","3679新至陞","110/07/13","摩根大通",2,25,-23
"13683","3679新至陞","110/07/13","國泰-桃園",22,0,22
"13684","3679新至陞","110/07/13","元大-成功",0,22,-22
"13685","3679新至陞","110/07/13","台中銀-員林",11,0,11
"13686","3679新至陞","110/07/13","富邦-板橋",1,19,-18
"13687","3679新至陞","110/07/13","元大-文心興安",8,0,8
"13688","3679新至陞","110/07/13","日盛-新莊",0,10,-10
"13689","3679新至陞","110/07/13","美商高盛",6,0,6
"13690","3679新至陞","110/07/13","台新-台中",0,10,-10
"13691","3679新至陞","110/07/13","台新-高雄",6,0,6
"13692","3679新至陞","110/07/13","永豐金-新竹",0,8,-8
"13693","3679新至陞","110/07/13","凱基-台北",18,12,6
"13694","3679新至陞","110/07/13","瑞士信貸",12,19,-7
"13695","3679新至陞","110/07/13","日盛-復興",5,0,5
"13696","3679新至陞","110/07/13","統一-南京",0,7,-7
"13697","3679新至陞","110/07/13","(牛牛牛)亞-鑫豐",4,0,4
"13698","3679新至陞","110/07/13","凱基-新莊",0,7,-7
"13699","3679新至陞","110/07/13","元富-大昌",3,0,3
"13700","3679新至陞","110/07/13","新加坡商瑞銀",0,6,-6
"13701","3679新至陞","110/07/13","富邦-台北",3,0,3
"13702","3679新至陞","110/07/13","合庫-自強",0,5,-5
"13703","3679新至陞","110/07/13","日盛-樹林",2,0,2
"13704","3679新至陞","110/07/13","富邦-桃園",0,5,-5
"13705","3679新至陞","110/07/13","宏遠-光隆",2,0,2
"13706","3679新至陞","110/07/13","永豐金-潮州",0,4,-4
"13707","3679新至陞","110/07/13","美林",3,1,2
"13708","3679新至陞","110/07/13","臺銀-臺南",0,3,-3
"13709","3679新至陞","110/07/13","第一金-中壢",2,0,2
"13710","3679新至陞","110/07/13","元大-六合",0,3,-3
"13711","2727王品","110/07/13","富邦-台北",43,3,40
"13712","2727王品","110/07/13","台灣摩根士丹利",15,97,-82
"13713","2727王品","110/07/13","元大-基隆孝二",40,0,40
"13714","2727王品","110/07/13","玉山-台南",5,57,-52
"13715","2727王品","110/07/13","國票-新莊",40,1,39
"13716","2727王品","110/07/13","新加坡商瑞銀",0,48,-48
"13717","2727王品","110/07/13","第一金-豐原",66,42,24
"13718","2727王品","110/07/13","凱基-台北",41,77,-36
"13719","2727王品","110/07/13","永豐金-大園",34,10,24
"13720","2727王品","110/07/13","永豐金-永康",0,22,-22
"13721","2727王品","110/07/13","元大-北屯",22,0,22
"13722","2727王品","110/07/13","統一-台中",2,22,-20
"13723","2727王品","110/07/13","元大-東蘆",26,7,19
"13724","2727王品","110/07/13","國泰-台中",21,39,-18
"13725","2727王品","110/07/13","永豐金-萬盛",13,1,12
"13726","2727王品","110/07/13","合庫-彰化",3,20,-17
"13727","2727王品","110/07/13","日盛-嘉義",11,0,11
"13728","2727王品","110/07/13","港商野村",13,30,-17
"13729","2727王品","110/07/13","日盛-八德",11,0,11
"13730","2727王品","110/07/13","元大-楊梅",1,16,-15
"13731","2727王品","110/07/13","統一-竹南",11,0,11
"13732","2727王品","110/07/13","凱基-高美館",2,15,-13
"13733","2727王品","110/07/13","日盛-士林",12,2,10
"13734","2727王品","110/07/13","美商高盛",2,14,-12
"13735","2727王品","110/07/13","統一-敦南",10,0,10
"13736","2727王品","110/07/13","統一-平鎮",1,13,-12
"13737","2727王品","110/07/13","中國信託",15,5,10
"13738","2727王品","110/07/13","兆豐-台中港",4,16,-12
"13739","2727王品","110/07/13","兆豐-竹北",13,3,10
"13740","2727王品","110/07/13","凱基-八德",1,13,-12
"13741","1570力肯","110/07/13","新光",115,11,104
"13742","1570力肯","110/07/13","元大-北三重",0,162,-162
"13743","1570力肯","110/07/13","群益金鼎-高雄",54,0,54
"13744","1570力肯","110/07/13","元大-大灣",0,25,-25
"13745","1570力肯","110/07/13","國票-新莊",22,0,22
"13746","1570力肯","110/07/13","永豐金-苓雅",0,22,-22
"13747","1570力肯","110/07/13","日盛-桃園",12,0,12
"13748","1570力肯","110/07/13","永豐金-永康",0,19,-19
"13749","1570力肯","110/07/13","元大-高雄",12,0,12
"13750","1570力肯","110/07/13","富邦-員林",0,15,-15
"13751","1570力肯","110/07/13","合庫-自強",11,0,11
"13752","1570力肯","110/07/13","凱基-台南",0,11,-11
"13753","1570力肯","110/07/13","摩根大通",26,15,11
"13754","1570力肯","110/07/13","日盛-竹北",0,10,-10
"13755","1570力肯","110/07/13","永豐金-中盛",11,0,11
"13756","1570力肯","110/07/13","國票-九鼎",0,10,-10
"13757","1570力肯","110/07/13","兆豐-台中港",10,0,10
"13758","1570力肯","110/07/13","凱基-桃園",0,10,-10
"13759","1570力肯","110/07/13","國泰-松江",9,0,9
"13760","1570力肯","110/07/13","凱基-新豐",0,10,-10
"13761","1570力肯","110/07/13","元大-新盛",9,0,9
"13762","1570力肯","110/07/13","元大-學甲",0,10,-10
"13763","1570力肯","110/07/13","元富-緯城",6,0,6
"13764","1570力肯","110/07/13","群益金鼎-東湖",1,10,-9
"13765","1570力肯","110/07/13","統一-三重",5,0,5
"13766","1570力肯","110/07/13","大昌",0,6,-6
"13767","1570力肯","110/07/13","元大-前金",5,0,5
"13768","1570力肯","110/07/13","元大-土城學府",0,6,-6
"13769","1570力肯","110/07/13","永豐金證券",5,0,5
"13770","1570力肯","110/07/13","統一",0,5,-5
"13771","6180橘子","110/07/13","摩根大通",119,0,119
"13772","6180橘子","110/07/13","元大-崇德",2,61,-59
"13773","6180橘子","110/07/13","美商高盛",96,0,96
"13774","6180橘子","110/07/13","康和-台中",0,51,-51
"13775","6180橘子","110/07/13","新加坡商瑞銀",86,7,79
"13776","6180橘子","110/07/13","康和-台北",0,50,-50
"13777","6180橘子","110/07/13","元大-和平",40,0,40
"13778","6180橘子","110/07/13","元富-潮州",0,40,-40
"13779","6180橘子","110/07/13","凱基-台北",83,47,36
"13780","6180橘子","110/07/13","日盛-永康",0,26,-26
"13781","6180橘子","110/07/13","美林",39,5,34
"13782","6180橘子","110/07/13","永豐金-中正",0,24,-24
"13783","6180橘子","110/07/13","富邦-新竹華信",31,2,29
"13784","6180橘子","110/07/13","國泰-板橋",2,25,-23
"13785","6180橘子","110/07/13","統一-南京",21,0,21
"13786","6180橘子","110/07/13","日盛-大墩",0,20,-20
"13787","6180橘子","110/07/13","富邦-陽明",24,3,21
"13788","6180橘子","110/07/13","元大-草屯",13,32,-19
"13789","6180橘子","110/07/13","大昌-樹林",21,1,20
"13790","6180橘子","110/07/13","元富-林園",1,18,-17
"13791","6180橘子","110/07/13","花旗環球",19,0,19
"13792","6180橘子","110/07/13","新光-新竹",1,18,-17
"13793","6180橘子","110/07/13","華南永昌-台南",19,0,19
"13794","6180橘子","110/07/13","元大-土城永寧",0,17,-17
"13795","6180橘子","110/07/13","福勝",14,0,14
"13796","6180橘子","110/07/13","國泰-新莊",3,19,-16
"13797","6180橘子","110/07/13","富邦-嘉義",12,1,11
"13798","6180橘子","110/07/13","中國信託-永康",6,21,-15
"13799","6180橘子","110/07/13","元大-板橋三民",11,0,11
"13800","6180橘子","110/07/13","凱基-東港",1,15,-14
"13801","2390云辰","110/07/13","新加坡商瑞銀",562,75,487
"13802","2390云辰","110/07/13","大展-台南",0,532,-532
"13803","2390云辰","110/07/13","台灣摩根士丹利",330,155,175
"13804","2390云辰","110/07/13","凱基-台北",668,854,-186
"13805","2390云辰","110/07/13","兆豐-公益",126,25,101
"13806","2390云辰","110/07/13","凱基-三重",12,172,-160
"13807","2390云辰","110/07/13","元富-中港",100,2,98
"13808","2390云辰","110/07/13","兆豐-忠孝",4,161,-157
"13809","2390云辰","110/07/13","統一-新台中",106,9,97
"13810","2390云辰","110/07/13","元大-士林",19,170,-151
"13811","2390云辰","110/07/13","中國信託-松江",81,11,70
"13812","2390云辰","110/07/13","臺銀-新竹",14,117,-103
"13813","2390云辰","110/07/13","日盛-板橋",72,3,69
"13814","2390云辰","110/07/13","國票-台中",4,102,-98
"13815","2390云辰","110/07/13","日盛-和美",57,0,57
"13816","2390云辰","110/07/13","新光",147,232,-85
"13817","2390云辰","110/07/13","永豐金-桃園",88,36,52
"13818","2390云辰","110/07/13","致和-崇德",2,70,-68
"13819","2390云辰","110/07/13","玉山-士林",54,4,50
"13820","2390云辰","110/07/13","群益金鼎-屏東",2,70,-68
"13821","2390云辰","110/07/13","富邦-仁愛",56,6,50
"13822","2390云辰","110/07/13","元大-大里",35,98,-63
"13823","2390云辰","110/07/13","第一金-豐原",50,1,49
"13824","2390云辰","110/07/13","元大-萬華",35,94,-59
"13825","2390云辰","110/07/13","摩根大通",502,453,49
"13826","2390云辰","110/07/13","元富-吉利",2,60,-58
"13827","2390云辰","110/07/13","凱基-松山",61,13,48
"13828","2390云辰","110/07/13","兆豐-新竹",3,53,-50
"13829","2390云辰","110/07/13","大昌",64,22,42
"13830","2390云辰","110/07/13","富邦-嘉義",65,108,-43
"13831","2363矽統","110/07/13","凱基-南崁",2133,63,2070
"13832","2363矽統","110/07/13","凱基-幸福",36,4048,-4012
"13833","2363矽統","110/07/13","國泰-敦南",2195,1617,578
"13834","2363矽統","110/07/13","統一",192,3325,-3133
"13835","2363矽統","110/07/13","中農",670,139,531
"13836","2363矽統","110/07/13","新加坡商瑞銀",1000,2747,-1747
"13837","2363矽統","110/07/13","康和-台中",638,154,484
"13838","2363矽統","110/07/13","凱基-台北",5359,6609,-1250
"13839","2363矽統","110/07/13","群益金鼎-三民",577,137,440
"13840","2363矽統","110/07/13","摩根大通",1930,2858,-928
"13841","2363矽統","110/07/13","台新-屏東",510,88,422
"13842","2363矽統","110/07/13","港商野村",960,1679,-719
"13843","2363矽統","110/07/13","德信-中正",455,67,388
"13844","2363矽統","110/07/13","兆豐-復興",25,705,-680
"13845","2363矽統","110/07/13","日盛-竹北",365,70,295
"13846","2363矽統","110/07/13","統一-仁愛",114,755,-641
"13847","2363矽統","110/07/13","元大-佳里",452,189,263
"13848","2363矽統","110/07/13","統一-敦南",29,638,-609
"13849","2363矽統","110/07/13","國票-博愛",296,38,258
"13850","2363矽統","110/07/13","統一-土城",100,704,-604
"13851","2363矽統","110/07/13","元大-萬華",340,95,245
"13852","2363矽統","110/07/13","統一-城中",116,676,-560
"13853","2363矽統","110/07/13","新光",1259,1031,228
"13854","2363矽統","110/07/13","永豐金證券",306,859,-553
"13855","2363矽統","110/07/13","元富-成功",323,96,227
"13856","2363矽統","110/07/13","元富",54,567,-513
"13857","2363矽統","110/07/13","豐農",228,23,205
"13858","2363矽統","110/07/13","瑞士信貸",202,666,-464
"13859","2363矽統","110/07/13","台灣企銀-岡山",186,4,182
"13860","2363矽統","110/07/13","永豐金-嘉義",67,468,-401
"13861","8112至上","110/07/13","摩根大通",688,296,392
"13862","8112至上","110/07/13","國票-中和",0,401,-401
"13863","8112至上","110/07/13","港商野村",344,145,199
"13864","8112至上","110/07/13","永豐金-板盛",0,205,-205
"13865","8112至上","110/07/13","兆豐-公益",195,5,190
"13866","8112至上","110/07/13","凱基-五股",43,155,-112
"13867","8112至上","110/07/13","台灣摩根士丹利",183,0,183
"13868","8112至上","110/07/13","凱基-市政",0,100,-100
"13869","8112至上","110/07/13","群益金鼎-敦南",153,2,151
"13870","8112至上","110/07/13","元大-大里德芳",1,92,-91
"13871","8112至上","110/07/13","臺銀-金山",146,26,120
"13872","8112至上","110/07/13","玉山-桃園",26,110,-84
"13873","8112至上","110/07/13","臺銀",133,19,114
"13874","8112至上","110/07/13","兆豐-天母",0,81,-81
"13875","8112至上","110/07/13","合庫-台中",115,6,109
"13876","8112至上","110/07/13","凱基-城中",3,84,-81
"13877","8112至上","110/07/13","亞東-板橋",134,26,108
"13878","8112至上","110/07/13","日盛-新莊",9,85,-76
"13879","8112至上","110/07/13","凱基-台北",414,326,88
"13880","8112至上","110/07/13","日盛-台中",2,64,-62
"13881","8112至上","110/07/13","新加坡商瑞銀",181,100,81
"13882","8112至上","110/07/13","日盛-中壢",3,64,-61
"13883","8112至上","110/07/13","國泰-敦南",108,31,77
"13884","8112至上","110/07/13","元大-台中",2,59,-57
"13885","8112至上","110/07/13","第一金-華江",77,4,73
"13886","8112至上","110/07/13","元大-雙和",7,64,-57
"13887","8112至上","110/07/13","永豐金-內湖",73,1,72
"13888","8112至上","110/07/13","元大-高雄",8,62,-54
"13889","8112至上","110/07/13","元大-永和",68,1,67
"13890","8112至上","110/07/13","元大-館前",2,55,-53
"13891","4903聯光通","110/07/13","台灣企銀-太平",56,0,56
"13892","4903聯光通","110/07/13","土銀",0,32,-32
"13893","4903聯光通","110/07/13","元富-新興",23,0,23
"13894","4903聯光通","110/07/13","元大-樹林",0,19,-19
"13895","4903聯光通","110/07/13","日盛-樹林",22,0,22
"13896","4903聯光通","110/07/13","凱基-士林",0,17,-17
"13897","4903聯光通","110/07/13","兆豐-天母",20,0,20
"13898","4903聯光通","110/07/13","國票-博愛",0,14,-14
"13899","4903聯光通","110/07/13","華南永昌-桃園",20,0,20
"13900","4903聯光通","110/07/13","元富",0,10,-10
"13901","4903聯光通","110/07/13","富邦-新店",10,0,10
"13902","4903聯光通","110/07/13","新光",0,10,-10
"13903","4903聯光通","110/07/13","新光-台中",5,0,5
"13904","4903聯光通","110/07/13","玉山-南京東路",0,10,-10
"13905","4903聯光通","110/07/13","華南永昌-台中",5,0,5
"13906","4903聯光通","110/07/13","富邦-陽明",0,10,-10
"13907","4903聯光通","110/07/13","元大-崇德",5,0,5
"13908","4903聯光通","110/07/13","元大-大甲",0,8,-8
"13909","4903聯光通","110/07/13","元大-草屯",5,0,5
"13910","4903聯光通","110/07/13","富邦-台中",0,7,-7
"13911","4903聯光通","110/07/13","元富-草屯",4,0,4
"13912","4903聯光通","110/07/13","凱基-中壢",0,6,-6
"13913","4903聯光通","110/07/13","元大-清水",4,0,4
"13914","4903聯光通","110/07/13","臺銀-民權",0,5,-5
"13915","4903聯光通","110/07/13","元大-東泰",4,0,4
"13916","4903聯光通","110/07/13","日盛-板橋",0,5,-5
"13917","4903聯光通","110/07/13","元大-佳里",2,0,2
"13918","4903聯光通","110/07/13","中國信託-忠孝",0,5,-5
"13919","4903聯光通","110/07/13","永豐金-板橋",2,0,2
"13920","4903聯光通","110/07/13","永豐金-鳳山",0,5,-5
"13921","2929淘帝","110/07/13","玉山-新竹",130,0,130
"13922","2929淘帝","110/07/13","美商高盛",0,177,-177
"13923","2929淘帝","110/07/13","臺銀-民權",60,0,60
"13924","2929淘帝","110/07/13","凱基-台北",6,80,-74
"13925","2929淘帝","110/07/13","新百王",31,0,31
"13926","2929淘帝","110/07/13","元富-大裕",0,49,-49
"13927","2929淘帝","110/07/13","日盛-園區",30,0,30
"13928","2929淘帝","110/07/13","國泰-館前",3,51,-48
"13929","2929淘帝","110/07/13","元大-南投",31,1,30
"13930","2929淘帝","110/07/13","凱基-中壢",0,41,-41
"13931","2929淘帝","110/07/13","兆豐-忠孝",28,0,28
"13932","2929淘帝","110/07/13","港商野村",21,55,-34
"13933","2929淘帝","110/07/13","元大-民生",28,0,28
"13934","2929淘帝","110/07/13","華南永昌-南京",2,34,-32
"13935","2929淘帝","110/07/13","合庫-高雄",27,0,27
"13936","2929淘帝","110/07/13","群益金鼎-土城",0,30,-30
"13937","2929淘帝","110/07/13","凱基-豐中",27,0,27
"13938","2929淘帝","110/07/13","富邦-南屯",0,22,-22
"13939","2929淘帝","110/07/13","新光",21,4,17
"13940","2929淘帝","110/07/13","第一金-豐原",0,20,-20
"13941","2929淘帝","110/07/13","元大-天母",17,0,17
"13942","2929淘帝","110/07/13","元大-屏南",6,26,-20
"13943","2929淘帝","110/07/13","永興",14,0,14
"13944","2929淘帝","110/07/13","永豐金-敦南",1,21,-20
"13945","2929淘帝","110/07/13","富邦-台北",12,0,12
"13946","2929淘帝","110/07/13","凱基-三重",2,21,-19
"13947","2929淘帝","110/07/13","元大-永和",12,0,12
"13948","2929淘帝","110/07/13","富邦-仁愛",7,25,-18
"13949","2929淘帝","110/07/13","國票-天祥",11,0,11
"13950","2929淘帝","110/07/13","元大-北投",0,16,-16
"13951","5410國眾","110/07/13","兆豐-城中",274,0,274
"13952","5410國眾","110/07/13","元富-嘉義",0,103,-103
"13953","5410國眾","110/07/13","新光",50,4,46
"13954","5410國眾","110/07/13","凱基-台北",0,50,-50
"13955","5410國眾","110/07/13","國泰-台中",26,0,26
"13956","5410國眾","110/07/13","瑞士信貸",0,31,-31
"13957","5410國眾","110/07/13","新加坡商瑞銀",22,0,22
"13958","5410國眾","110/07/13","台新-新莊",0,27,-27
"13959","5410國眾","110/07/13","光和-嘉義",20,0,20
"13960","5410國眾","110/07/13","元大-汐止",0,20,-20
"13961","5410國眾","110/07/13","凱基-竹北",17,0,17
"13962","5410國眾","110/07/13","亞東-新竹",0,17,-17
"13963","5410國眾","110/07/13","新光-桃園",15,0,15
"13964","5410國眾","110/07/13","元大-南勢角",0,13,-13
"13965","5410國眾","110/07/13","凱基-台東",14,0,14
"13966","5410國眾","110/07/13","台新-台南",0,12,-12
"13967","5410國眾","110/07/13","富邦-竹北",11,0,11
"13968","5410國眾","110/07/13","中國信託",0,11,-11
"13969","5410國眾","110/07/13","元富-同大",10,0,10
"13970","5410國眾","110/07/13","華南永昌",0,11,-11
"13971","5410國眾","110/07/13","國泰-敦南",24,15,9
"13972","5410國眾","110/07/13","臺銀-臺南",0,10,-10
"13973","5410國眾","110/07/13","日盛-內湖",7,0,7
"13974","5410國眾","110/07/13","台灣企銀-民雄",0,10,-10
"13975","5410國眾","110/07/13","台新-左楠",7,0,7
"13976","5410國眾","110/07/13","高橋",0,10,-10
"13977","5410國眾","110/07/13","元大-新盛",18,12,6
"13978","5410國眾","110/07/13","康和-嘉義",0,10,-10
"13979","5410國眾","110/07/13","統一",5,0,5
"13980","5410國眾","110/07/13","凱基-基隆",0,10,-10
"13981","2841台開","110/07/13","中國信託-高雄",251,50,201
"13982","2841台開","110/07/13","兆豐-公益",0,177,-177
"13983","2841台開","110/07/13","日盛證券",210,13,197
"13984","2841台開","110/07/13","日進",0,152,-152
"13985","2841台開","110/07/13","第一金-台中",55,0,55
"13986","2841台開","110/07/13","港商野村",0,109,-109
"13987","2841台開","110/07/13","國泰-板橋",46,0,46
"13988","2841台開","110/07/13","日盛-信義",0,103,-103
"13989","2841台開","110/07/13","國泰-館前",48,3,45
"13990","2841台開","110/07/13","國泰-敦南",11,75,-64
"13991","2841台開","110/07/13","華南永昌-新莊",45,0,45
"13992","2841台開","110/07/13","永興",0,50,-50
"13993","2841台開","110/07/13","日盛-園區",42,0,42
"13994","2841台開","110/07/13","永豐金-敦南",61,104,-43
"13995","2841台開","110/07/13","台新證券",32,0,32
"13996","2841台開","110/07/13","富邦-台南",0,42,-42
"13997","2841台開","110/07/13","台新-高雄",32,2,30
"13998","2841台開","110/07/13","國票-安和",0,30,-30
"13999","2841台開","110/07/13","豐農",23,0,23
"14000","2841台開","110/07/13","元大-桃園",0,25,-25
"14001","2841台開","110/07/13","合庫-嘉義",20,0,20
"14002","2841台開","110/07/13","新光",8,32,-24
"14003","2841台開","110/07/13","華南永昌-高雄",20,0,20
"14004","2841台開","110/07/13","元大-仁愛",0,24,-24
"14005","2841台開","110/07/13","元大-樹林",16,0,16
"14006","2841台開","110/07/13","日盛-中和",0,20,-20
"14007","2841台開","110/07/13","第一金-華江",15,2,13
"14008","2841台開","110/07/13","元富",0,20,-20
"14009","2841台開","110/07/13","美商高盛",12,0,12
"14010","2841台開","110/07/13","富邦-宜蘭",0,20,-20
"14011","6207雷科","110/07/13","元大-高雄",121,0,121
"14012","6207雷科","110/07/13","華南永昌-朴子",1,60,-59
"14013","6207雷科","110/07/13","第一金-新興",20,0,20
"14014","6207雷科","110/07/13","元大-南海",0,36,-36
"14015","6207雷科","110/07/13","元富-三重",20,0,20
"14016","6207雷科","110/07/13","凱基-土城",0,35,-35
"14017","6207雷科","110/07/13","元大-林園",15,0,15
"14018","6207雷科","110/07/13","台灣企銀",0,20,-20
"14019","6207雷科","110/07/13","元大-金華",16,1,15
"14020","6207雷科","110/07/13","群益金鼎-丹鳳",0,20,-20
"14021","6207雷科","110/07/13","日盛證券",10,0,10
"14022","6207雷科","110/07/13","元大-博愛",0,17,-17
"14023","6207雷科","110/07/13","統一-台中",10,0,10
"14024","6207雷科","110/07/13","元大-北港",0,13,-13
"14025","6207雷科","110/07/13","群益金鼎-土城",10,0,10
"14026","6207雷科","110/07/13","新加坡商瑞銀",0,12,-12
"14027","6207雷科","110/07/13","群益金鼎-桃園",10,0,10
"14028","6207雷科","110/07/13","凱基-台北",4,16,-12
"14029","6207雷科","110/07/13","永豐金-新莊",10,0,10
"14030","6207雷科","110/07/13","日茂-埔里",0,11,-11
"14031","6207雷科","110/07/13","永豐金-新店",10,0,10
"14032","6207雷科","110/07/13","元大-莒光",0,11,-11
"14033","6207雷科","110/07/13","元大證券",9,0,9
"14034","6207雷科","110/07/13","統一-新竹",0,10,-10
"14035","6207雷科","110/07/13","日盛-木柵",9,1,8
"14036","6207雷科","110/07/13","元大-西螺",0,10,-10
"14037","6207雷科","110/07/13","兆豐-來福",8,0,8
"14038","6207雷科","110/07/13","康和-台中",0,8,-8
"14039","6207雷科","110/07/13","新光",7,0,7
"14040","6207雷科","110/07/13","兆豐-高雄",0,6,-6
"14041","3679新至陞","110/07/13","永豐金證券",50,0,50
"14042","3679新至陞","110/07/13","摩根大通",2,25,-23
"14043","3679新至陞","110/07/13","國泰-桃園",22,0,22
"14044","3679新至陞","110/07/13","元大-成功",0,22,-22
"14045","3679新至陞","110/07/13","台中銀-員林",11,0,11
"14046","3679新至陞","110/07/13","富邦-板橋",1,19,-18
"14047","3679新至陞","110/07/13","元大-文心興安",8,0,8
"14048","3679新至陞","110/07/13","日盛-新莊",0,10,-10
"14049","3679新至陞","110/07/13","美商高盛",6,0,6
"14050","3679新至陞","110/07/13","台新-台中",0,10,-10
"14051","3679新至陞","110/07/13","台新-高雄",6,0,6
"14052","3679新至陞","110/07/13","永豐金-新竹",0,8,-8
"14053","3679新至陞","110/07/13","凱基-台北",18,12,6
"14054","3679新至陞","110/07/13","瑞士信貸",12,19,-7
"14055","3679新至陞","110/07/13","日盛-復興",5,0,5
"14056","3679新至陞","110/07/13","統一-南京",0,7,-7
"14057","3679新至陞","110/07/13","(牛牛牛)亞-鑫豐",4,0,4
"14058","3679新至陞","110/07/13","凱基-新莊",0,7,-7
"14059","3679新至陞","110/07/13","元富-大昌",3,0,3
"14060","3679新至陞","110/07/13","新加坡商瑞銀",0,6,-6
"14061","3679新至陞","110/07/13","富邦-台北",3,0,3
"14062","3679新至陞","110/07/13","合庫-自強",0,5,-5
"14063","3679新至陞","110/07/13","日盛-樹林",2,0,2
"14064","3679新至陞","110/07/13","富邦-桃園",0,5,-5
"14065","3679新至陞","110/07/13","宏遠-光隆",2,0,2
"14066","3679新至陞","110/07/13","永豐金-潮州",0,4,-4
"14067","3679新至陞","110/07/13","美林",3,1,2
"14068","3679新至陞","110/07/13","臺銀-臺南",0,3,-3
"14069","3679新至陞","110/07/13","第一金-中壢",2,0,2
"14070","3679新至陞","110/07/13","元大-六合",0,3,-3
"14071","2727王品","110/07/13","富邦-台北",43,3,40
"14072","2727王品","110/07/13","台灣摩根士丹利",15,97,-82
"14073","2727王品","110/07/13","元大-基隆孝二",40,0,40
"14074","2727王品","110/07/13","玉山-台南",5,57,-52
"14075","2727王品","110/07/13","國票-新莊",40,1,39
"14076","2727王品","110/07/13","新加坡商瑞銀",0,48,-48
"14077","2727王品","110/07/13","第一金-豐原",66,42,24
"14078","2727王品","110/07/13","凱基-台北",41,77,-36
"14079","2727王品","110/07/13","永豐金-大園",34,10,24
"14080","2727王品","110/07/13","永豐金-永康",0,22,-22
"14081","2727王品","110/07/13","元大-北屯",22,0,22
"14082","2727王品","110/07/13","統一-台中",2,22,-20
"14083","2727王品","110/07/13","元大-東蘆",26,7,19
"14084","2727王品","110/07/13","國泰-台中",21,39,-18
"14085","2727王品","110/07/13","永豐金-萬盛",13,1,12
"14086","2727王品","110/07/13","合庫-彰化",3,20,-17
"14087","2727王品","110/07/13","日盛-嘉義",11,0,11
"14088","2727王品","110/07/13","港商野村",13,30,-17
"14089","2727王品","110/07/13","日盛-八德",11,0,11
"14090","2727王品","110/07/13","元大-楊梅",1,16,-15
"14091","2727王品","110/07/13","統一-竹南",11,0,11
"14092","2727王品","110/07/13","凱基-高美館",2,15,-13
"14093","2727王品","110/07/13","日盛-士林",12,2,10
"14094","2727王品","110/07/13","美商高盛",2,14,-12
"14095","2727王品","110/07/13","統一-敦南",10,0,10
"14096","2727王品","110/07/13","統一-平鎮",1,13,-12
"14097","2727王品","110/07/13","中國信託",15,5,10
"14098","2727王品","110/07/13","兆豐-台中港",4,16,-12
"14099","2727王品","110/07/13","兆豐-竹北",13,3,10
"14100","2727王品","110/07/13","凱基-八德",1,13,-12
"14101","1570力肯","110/07/13","新光",115,11,104
"14102","1570力肯","110/07/13","元大-北三重",0,162,-162
"14103","1570力肯","110/07/13","群益金鼎-高雄",54,0,54
"14104","1570力肯","110/07/13","元大-大灣",0,25,-25
"14105","1570力肯","110/07/13","國票-新莊",22,0,22
"14106","1570力肯","110/07/13","永豐金-苓雅",0,22,-22
"14107","1570力肯","110/07/13","日盛-桃園",12,0,12
"14108","1570力肯","110/07/13","永豐金-永康",0,19,-19
"14109","1570力肯","110/07/13","元大-高雄",12,0,12
"14110","1570力肯","110/07/13","富邦-員林",0,15,-15
"14111","1570力肯","110/07/13","合庫-自強",11,0,11
"14112","1570力肯","110/07/13","凱基-台南",0,11,-11
"14113","1570力肯","110/07/13","摩根大通",26,15,11
"14114","1570力肯","110/07/13","日盛-竹北",0,10,-10
"14115","1570力肯","110/07/13","永豐金-中盛",11,0,11
"14116","1570力肯","110/07/13","國票-九鼎",0,10,-10
"14117","1570力肯","110/07/13","兆豐-台中港",10,0,10
"14118","1570力肯","110/07/13","凱基-桃園",0,10,-10
"14119","1570力肯","110/07/13","國泰-松江",9,0,9
"14120","1570力肯","110/07/13","凱基-新豐",0,10,-10
"14121","1570力肯","110/07/13","元大-新盛",9,0,9
"14122","1570力肯","110/07/13","元大-學甲",0,10,-10
"14123","1570力肯","110/07/13","元富-緯城",6,0,6
"14124","1570力肯","110/07/13","群益金鼎-東湖",1,10,-9
"14125","1570力肯","110/07/13","統一-三重",5,0,5
"14126","1570力肯","110/07/13","大昌",0,6,-6
"14127","1570力肯","110/07/13","元大-前金",5,0,5
"14128","1570力肯","110/07/13","元大-土城學府",0,6,-6
"14129","1570力肯","110/07/13","永豐金證券",5,0,5
"14130","1570力肯","110/07/13","統一",0,5,-5
"14131","6180橘子","110/07/13","摩根大通",119,0,119
"14132","6180橘子","110/07/13","元大-崇德",2,61,-59
"14133","6180橘子","110/07/13","美商高盛",96,0,96
"14134","6180橘子","110/07/13","康和-台中",0,51,-51
"14135","6180橘子","110/07/13","新加坡商瑞銀",86,7,79
"14136","6180橘子","110/07/13","康和-台北",0,50,-50
"14137","6180橘子","110/07/13","元大-和平",40,0,40
"14138","6180橘子","110/07/13","元富-潮州",0,40,-40
"14139","6180橘子","110/07/13","凱基-台北",83,47,36
"14140","6180橘子","110/07/13","日盛-永康",0,26,-26
"14141","6180橘子","110/07/13","美林",39,5,34
"14142","6180橘子","110/07/13","永豐金-中正",0,24,-24
"14143","6180橘子","110/07/13","富邦-新竹華信",31,2,29
"14144","6180橘子","110/07/13","國泰-板橋",2,25,-23
"14145","6180橘子","110/07/13","統一-南京",21,0,21
"14146","6180橘子","110/07/13","日盛-大墩",0,20,-20
"14147","6180橘子","110/07/13","富邦-陽明",24,3,21
"14148","6180橘子","110/07/13","元大-草屯",13,32,-19
"14149","6180橘子","110/07/13","大昌-樹林",21,1,20
"14150","6180橘子","110/07/13","元富-林園",1,18,-17
"14151","6180橘子","110/07/13","花旗環球",19,0,19
"14152","6180橘子","110/07/13","新光-新竹",1,18,-17
"14153","6180橘子","110/07/13","華南永昌-台南",19,0,19
"14154","6180橘子","110/07/13","元大-土城永寧",0,17,-17
"14155","6180橘子","110/07/13","福勝",14,0,14
"14156","6180橘子","110/07/13","國泰-新莊",3,19,-16
"14157","6180橘子","110/07/13","富邦-嘉義",12,1,11
"14158","6180橘子","110/07/13","中國信託-永康",6,21,-15
"14159","6180橘子","110/07/13","元大-板橋三民",11,0,11
"14160","6180橘子","110/07/13","凱基-東港",1,15,-14
"14161","2390云辰","110/07/13","新加坡商瑞銀",562,75,487
"14162","2390云辰","110/07/13","大展-台南",0,532,-532
"14163","2390云辰","110/07/13","台灣摩根士丹利",330,155,175
"14164","2390云辰","110/07/13","凱基-台北",668,854,-186
"14165","2390云辰","110/07/13","兆豐-公益",126,25,101
"14166","2390云辰","110/07/13","凱基-三重",12,172,-160
"14167","2390云辰","110/07/13","元富-中港",100,2,98
"14168","2390云辰","110/07/13","兆豐-忠孝",4,161,-157
"14169","2390云辰","110/07/13","統一-新台中",106,9,97
"14170","2390云辰","110/07/13","元大-士林",19,170,-151
"14171","2390云辰","110/07/13","中國信託-松江",81,11,70
"14172","2390云辰","110/07/13","臺銀-新竹",14,117,-103
"14173","2390云辰","110/07/13","日盛-板橋",72,3,69
"14174","2390云辰","110/07/13","國票-台中",4,102,-98
"14175","2390云辰","110/07/13","日盛-和美",57,0,57
"14176","2390云辰","110/07/13","新光",147,232,-85
"14177","2390云辰","110/07/13","永豐金-桃園",88,36,52
"14178","2390云辰","110/07/13","致和-崇德",2,70,-68
"14179","2390云辰","110/07/13","玉山-士林",54,4,50
"14180","2390云辰","110/07/13","群益金鼎-屏東",2,70,-68
"14181","2390云辰","110/07/13","富邦-仁愛",56,6,50
"14182","2390云辰","110/07/13","元大-大里",35,98,-63
"14183","2390云辰","110/07/13","第一金-豐原",50,1,49
"14184","2390云辰","110/07/13","元大-萬華",35,94,-59
"14185","2390云辰","110/07/13","摩根大通",502,453,49
"14186","2390云辰","110/07/13","元富-吉利",2,60,-58
"14187","2390云辰","110/07/13","凱基-松山",61,13,48
"14188","2390云辰","110/07/13","兆豐-新竹",3,53,-50
"14189","2390云辰","110/07/13","大昌",64,22,42
"14190","2390云辰","110/07/13","富邦-嘉義",65,108,-43
"14191","2363矽統","110/07/12","凱基-幸福",4046,31,4015
"14192","2363矽統","110/07/12","台新證券",478,2105,-1627
"14193","2363矽統","110/07/12","統一",3504,120,3384
"14194","2363矽統","110/07/12","第一金-忠孝",4,1068,-1064
"14195","2363矽統","110/07/12","摩根大通",3006,2149,857
"14196","2363矽統","110/07/12","台新-台中",381,1003,-622
"14197","2363矽統","110/07/12","永豐金證券",1428,610,818
"14198","2363矽統","110/07/12","新光",1295,1822,-527
"14199","2363矽統","110/07/12","兆豐-復興",1936,1233,703
"14200","2363矽統","110/07/12","大昌-樹林",54,537,-483
"14201","2363矽統","110/07/12","台灣摩根士丹利",701,0,701
"14202","2363矽統","110/07/12","華南永昌-台中",90,549,-459
"14203","2363矽統","110/07/12","永豐金-南投",803,145,658
"14204","2363矽統","110/07/12","玉山-高雄",167,612,-445
"14205","2363矽統","110/07/12","統一-仁愛",1214,586,628
"14206","2363矽統","110/07/12","元富-同大",201,540,-339
"14207","2363矽統","110/07/12","統一-土城",688,75,613
"14208","2363矽統","110/07/12","華南永昌-東勢",31,367,-336
"14209","2363矽統","110/07/12","統一-城中",711,131,580
"14210","2363矽統","110/07/12","土銀-花蓮",9,333,-324
"14211","2363矽統","110/07/12","統一-敦南",632,54,578
"14212","2363矽統","110/07/12","凱基-豐中",120,434,-314
"14213","2363矽統","110/07/12","新加坡商瑞銀",1232,731,501
"14214","2363矽統","110/07/12","永豐金-竹科",54,323,-269
"14215","2363矽統","110/07/12","元富",2640,2142,498
"14216","2363矽統","110/07/12","元大-斗六",53,300,-247
"14217","2363矽統","110/07/12","凱基-永和",460,31,429
"14218","2363矽統","110/07/12","華南永昌-朴子",47,278,-231
"14219","2363矽統","110/07/12","第一金",380,22,358
"14220","2363矽統","110/07/12","永豐金-彰化",22,228,-206
"14221","8112至上","110/07/12","摩根大通",1167,290,877
"14222","8112至上","110/07/12","群益金鼎-新莊",1,156,-155
"14223","8112至上","110/07/12","凱基-台北",983,546,437
"14224","8112至上","110/07/12","國票-中港",0,131,-131
"14225","8112至上","110/07/12","新加坡商瑞銀",429,12,417
"14226","8112至上","110/07/12","元大證券",10,136,-126
"14227","8112至上","110/07/12","元大-屏南",360,2,358
"14228","8112至上","110/07/12","元大-中壢",11,135,-124
"14229","8112至上","110/07/12","美林",323,15,308
"14230","8112至上","110/07/12","合庫-基隆",0,122,-122
"14231","8112至上","110/07/12","台灣摩根士丹利",299,0,299
"14232","8112至上","110/07/12","群益金鼎-高盛",4,103,-99
"14233","8112至上","110/07/12","港商野村",267,28,239
"14234","8112至上","110/07/12","新光",110,202,-92
"14235","8112至上","110/07/12","大慶",165,3,162
"14236","8112至上","110/07/12","元大-府城",2,94,-92
"14237","8112至上","110/07/12","永豐金-台南",170,29,141
"14238","8112至上","110/07/12","富邦-板橋",5,92,-87
"14239","8112至上","110/07/12","華南永昌-長虹",128,2,126
"14240","8112至上","110/07/12","元大-土城",8,89,-81
"14241","8112至上","110/07/12","富邦-仁愛",157,51,106
"14242","8112至上","110/07/12","日盛-頭份",40,117,-77
"14243","8112至上","110/07/12","瑞士信貸",104,0,104
"14244","8112至上","110/07/12","玉山-嘉義",3,80,-77
"14245","8112至上","110/07/12","凱基-站前",100,11,89
"14246","8112至上","110/07/12","永豐金-松山",4,79,-75
"14247","8112至上","110/07/12","富邦-北港",90,3,87
"14248","8112至上","110/07/12","元大-敦南",3,75,-72
"14249","8112至上","110/07/12","元大-北港",101,20,81
"14250","8112至上","110/07/12","元富-大裕",6,77,-71
"14251","4903聯光通","110/07/12","台灣企銀-太平",19,0,19
"14252","4903聯光通","110/07/12","玉山-南京東路",0,16,-16
"14253","4903聯光通","110/07/12","統一-土城",17,0,17
"14254","4903聯光通","110/07/12","新光",0,14,-14
"14255","4903聯光通","110/07/12","國票-博愛",14,0,14
"14256","4903聯光通","110/07/12","兆豐-彰化",0,10,-10
"14257","4903聯光通","110/07/12","新光-台中",15,2,13
"14258","4903聯光通","110/07/12","國票",0,10,-10
"14259","4903聯光通","110/07/12","元大-彰化",11,0,11
"14260","4903聯光通","110/07/12","富邦-敦南",0,10,-10
"14261","4903聯光通","110/07/12","華南永昌-林口",10,0,10
"14262","4903聯光通","110/07/12","元大-前金",0,9,-9
"14263","4903聯光通","110/07/12","永豐金-南投",9,0,9
"14264","4903聯光通","110/07/12","日盛-頭份",0,8,-8
"14265","4903聯光通","110/07/12","元大-清水",8,0,8
"14266","4903聯光通","110/07/12","元大-太平",0,8,-8
"14267","4903聯光通","110/07/12","元大-博愛",8,0,8
"14268","4903聯光通","110/07/12","兆豐-埔墘",0,7,-7
"14269","4903聯光通","110/07/12","玉山-新莊",5,0,5
"14270","4903聯光通","110/07/12","臺銀-民權",0,5,-5
"14271","4903聯光通","110/07/12","凱基-士林",10,5,5
"14272","4903聯光通","110/07/12","富邦-板橋",0,5,-5
"14273","4903聯光通","110/07/12","元大-斗六",4,0,4
"14274","4903聯光通","110/07/12","元大-土城永寧",0,5,-5
"14275","4903聯光通","110/07/12","永豐金-羅東",4,0,4
"14276","4903聯光通","110/07/12","台新證券",0,4,-4
"14277","4903聯光通","110/07/12","日盛-樹林",3,0,3
"14278","4903聯光通","110/07/12","凱基-中壢",0,4,-4
"14279","4903聯光通","110/07/12","華南永昌-鶯歌",2,0,2
"14280","4903聯光通","110/07/12","元大-羅東",0,4,-4
"14281","2929淘帝","110/07/12","新光-台中",95,36,59
"14282","2929淘帝","110/07/12","華南永昌-林口",7,208,-201
"14283","2929淘帝","110/07/12","富邦-板橋",62,5,57
"14284","2929淘帝","110/07/12","富邦-台北",6,200,-194
"14285","2929淘帝","110/07/12","合庫-高雄",56,6,50
"14286","2929淘帝","110/07/12","元富-大裕",11,200,-189
"14287","2929淘帝","110/07/12","永興",41,0,41
"14288","2929淘帝","110/07/12","台中銀-台北",0,160,-160
"14289","2929淘帝","110/07/12","兆豐-忠孝",58,18,40
"14290","2929淘帝","110/07/12","日盛-園區",1,111,-110
"14291","2929淘帝","110/07/12","新光-高雄",39,3,36
"14292","2929淘帝","110/07/12","日盛-八德",0,88,-88
"14293","2929淘帝","110/07/12","凱基-豐中",36,0,36
"14294","2929淘帝","110/07/12","玉山-新竹",32,110,-78
"14295","2929淘帝","110/07/12","元大-民生",35,0,35
"14296","2929淘帝","110/07/12","元大-前金",0,72,-72
"14297","2929淘帝","110/07/12","臺銀-臺南",32,1,31
"14298","2929淘帝","110/07/12","元大-館前",12,83,-71
"14299","2929淘帝","110/07/12","台新證券",44,13,31
"14300","2929淘帝","110/07/12","華南永昌",1,57,-56
"14301","2929淘帝","110/07/12","新百王",30,0,30
"14302","2929淘帝","110/07/12","元大-南崁",4,59,-55
"14303","2929淘帝","110/07/12","群益金鼎-大興",30,0,30
"14304","2929淘帝","110/07/12","元大-嘉義",0,51,-51
"14305","2929淘帝","110/07/12","凱基-台北",32,5,27
"14306","2929淘帝","110/07/12","日茂",1,50,-49
"14307","2929淘帝","110/07/12","元富-城東",26,0,26
"14308","2929淘帝","110/07/12","新光",35,83,-48
"14309","2929淘帝","110/07/12","國泰-松江",26,0,26
"14310","2929淘帝","110/07/12","日盛-新竹",1,48,-47
"14311","5410國眾","110/07/12","群益金鼎-中壢",68,0,68
"14312","5410國眾","110/07/12","摩根大通",6,67,-61
"14313","5410國眾","110/07/12","凱基-市政",40,0,40
"14314","5410國眾","110/07/12","元富-嘉義",0,60,-60
"14315","5410國眾","110/07/12","凱基-竹北",38,0,38
"14316","5410國眾","110/07/12","凱基-台北",0,51,-51
"14317","5410國眾","110/07/12","華南永昌-三重",30,0,30
"14318","5410國眾","110/07/12","元富-大裕",0,33,-33
"14319","5410國眾","110/07/12","永興",20,0,20
"14320","5410國眾","110/07/12","日盛-木柵",0,15,-15
"14321","5410國眾","110/07/12","統一-新台中",20,0,20
"14322","5410國眾","110/07/12","群益金鼎-民權",0,15,-15
"14323","5410國眾","110/07/12","兆豐-三重",20,0,20
"14324","5410國眾","110/07/12","元富-緯城",0,14,-14
"14325","5410國眾","110/07/12","富邦-台中",20,0,20
"14326","5410國眾","110/07/12","元大-大同",0,12,-12
"14327","5410國眾","110/07/12","臺銀",15,0,15
"14328","5410國眾","110/07/12","元大-莒光",0,10,-10
"14329","5410國眾","110/07/12","新光-桃園",20,6,14
"14330","5410國眾","110/07/12","元大-博愛",0,10,-10
"14331","5410國眾","110/07/12","元大-員林",12,0,12
"14332","5410國眾","110/07/12","日盛-永康",0,8,-8
"14333","5410國眾","110/07/12","日盛-員林",10,0,10
"14334","5410國眾","110/07/12","元大-四維",5,13,-8
"14335","5410國眾","110/07/12","元大-新盛",10,0,10
"14336","5410國眾","110/07/12","新加坡商瑞銀",0,7,-7
"14337","5410國眾","110/07/12","永豐金-台南",10,0,10
"14338","5410國眾","110/07/12","致和-金華",0,7,-7
"14339","5410國眾","110/07/12","元富-新莊",8,0,8
"14340","5410國眾","110/07/12","新光-新竹",0,7,-7
"14341","2841台開","110/07/12","永豐金-敦南",139,26,113
"14342","2841台開","110/07/12","華南永昌-朴子",0,528,-528
"14343","2841台開","110/07/12","日盛-雙和",68,0,68
"14344","2841台開","110/07/12","元大-苑裡",2,50,-48
"14345","2841台開","110/07/12","台新證券",62,4,58
"14346","2841台開","110/07/12","群益金鼎-東湖",0,40,-40
"14347","2841台開","110/07/12","凱基-文心",50,0,50
"14348","2841台開","110/07/12","第一金-員林",0,30,-30
"14349","2841台開","110/07/12","第一金-台中",45,0,45
"14350","2841台開","110/07/12","德信-中正",0,20,-20
"14351","2841台開","110/07/12","富邦-嘉義",40,0,40
"14352","2841台開","110/07/12","兆豐-嘉義",0,20,-20
"14353","2841台開","110/07/12","日盛-木柵",30,0,30
"14354","2841台開","110/07/12","彰銀-七賢",0,15,-15
"14355","2841台開","110/07/12","中國信託-文心",31,3,28
"14356","2841台開","110/07/12","元大-承德",0,14,-14
"14357","2841台開","110/07/12","元大-福營",30,7,23
"14358","2841台開","110/07/12","元富",0,12,-12
"14359","2841台開","110/07/12","台中銀",20,0,20
"14360","2841台開","110/07/12","富邦-陽明",0,11,-11
"14361","2841台開","110/07/12","國泰-板橋",20,0,20
"14362","2841台開","110/07/12","元大證券",0,11,-11
"14363","2841台開","110/07/12","元大-前金",20,0,20
"14364","2841台開","110/07/12","元大-大甲",0,10,-10
"14365","2841台開","110/07/12","中國信託-高雄",16,1,15
"14366","2841台開","110/07/12","日盛-新竹",0,8,-8
"14367","2841台開","110/07/12","陽信-石牌",15,0,15
"14368","2841台開","110/07/12","元富-城東",0,8,-8
"14369","2841台開","110/07/12","永豐金-南投",15,0,15
"14370","2841台開","110/07/12","玉山-台南",2,10,-8
"14371","6207雷科","110/07/12","元大-高雄",34,0,34
"14372","6207雷科","110/07/12","永豐金-三重",1,32,-31
"14373","6207雷科","110/07/12","華南永昌-林口",16,1,15
"14374","6207雷科","110/07/12","永全-八德",0,30,-30
"14375","6207雷科","110/07/12","摩根大通",19,6,13
"14376","6207雷科","110/07/12","國泰-台中",0,14,-14
"14377","6207雷科","110/07/12","元富-埔里",10,0,10
"14378","6207雷科","110/07/12","第一金-澎湖",0,10,-10
"14379","6207雷科","110/07/12","凱基-台南",10,0,10
"14380","6207雷科","110/07/12","元富-林園",0,10,-10
"14381","6207雷科","110/07/12","新加坡商瑞銀",9,0,9
"14382","6207雷科","110/07/12","元大-東門",0,10,-10
"14383","6207雷科","110/07/12","瑞士信貸",8,0,8
"14384","6207雷科","110/07/12","兆豐-嘉義",0,4,-4
"14385","6207雷科","110/07/12","中國信託-高雄",9,1,8
"14386","6207雷科","110/07/12","新光",0,4,-4
"14387","6207雷科","110/07/12","凱基-高雄",6,0,6
"14388","6207雷科","110/07/12","新光-台中",0,4,-4
"14389","6207雷科","110/07/12","元大-六合",6,0,6
"14390","6207雷科","110/07/12","群益金鼎-開元",0,4,-4
"14391","6207雷科","110/07/12","永豐金-信義",6,0,6
"14392","6207雷科","110/07/12","凱基-桃園",0,4,-4
"14393","6207雷科","110/07/12","群益金鼎-土城",5,0,5
"14394","6207雷科","110/07/12","凱基-民權",0,4,-4
"14395","6207雷科","110/07/12","群益金鼎-竹南",5,0,5
"14396","6207雷科","110/07/12","玉山-新莊",0,3,-3
"14397","6207雷科","110/07/12","元大-大灣",5,1,4
"14398","6207雷科","110/07/12","國泰-松江",0,3,-3
"14399","6207雷科","110/07/12","永興",3,0,3
"14400","6207雷科","110/07/12","富邦-羅東",0,3,-3
"14401","3679新至陞","110/07/12","富邦-新竹華信",40,2,38
"14402","3679新至陞","110/07/12","瑞士信貸",0,45,-45
"14403","3679新至陞","110/07/12","台中銀-員林",28,2,26
"14404","3679新至陞","110/07/12","永豐金-天母",0,39,-39
"14405","3679新至陞","110/07/12","聯邦-大業",24,0,24
"14406","3679新至陞","110/07/12","摩根大通",7,35,-28
"14407","3679新至陞","110/07/12","永豐金證券",20,0,20
"14408","3679新至陞","110/07/12","凱基-台北",8,36,-28
"14409","3679新至陞","110/07/12","港商法國興業",14,0,14
"14410","3679新至陞","110/07/12","華南永昌-小港",1,23,-22
"14411","3679新至陞","110/07/12","日盛-樹林",13,1,12
"14412","3679新至陞","110/07/12","台新-台中",0,15,-15
"14413","3679新至陞","110/07/12","國泰-桃園",9,0,9
"14414","3679新至陞","110/07/12","統一-台中",0,12,-12
"14415","3679新至陞","110/07/12","宏遠-館前",8,0,8
"14416","3679新至陞","110/07/12","元大-成功",1,12,-11
"14417","3679新至陞","110/07/12","凱基",10,2,8
"14418","3679新至陞","110/07/12","康和-澎湖",0,8,-8
"14419","3679新至陞","110/07/12","(牛牛牛)亞-網路",7,0,7
"14420","3679新至陞","110/07/12","新加坡商瑞銀",0,7,-7
"14421","3679新至陞","110/07/12","兆豐-員林",7,0,7
"14422","3679新至陞","110/07/12","兆豐-來福",0,7,-7
"14423","3679新至陞","110/07/12","大慶-蘆洲",5,0,5
"14424","3679新至陞","110/07/12","元大-佳里",0,6,-6
"14425","3679新至陞","110/07/12","土銀-花蓮",4,0,4
"14426","3679新至陞","110/07/12","美商高盛",0,5,-5
"14427","3679新至陞","110/07/12","台新-高雄",5,1,4
"14428","3679新至陞","110/07/12","國票-新莊",0,5,-5
"14429","3679新至陞","110/07/12","元大-天母",4,0,4
"14430","3679新至陞","110/07/12","台新-屏東",0,5,-5
"14431","2727王品","110/07/12","凱基-台北",354,198,156
"14432","2727王品","110/07/12","台灣摩根士丹利",5,386,-381
"14433","2727王品","110/07/12","統一-城中",159,22,137
"14434","2727王品","110/07/12","元大-嘉義",4,60,-56
"14435","2727王品","110/07/12","日盛-忠孝",60,0,60
"14436","2727王品","110/07/12","元大-大同",2,44,-42
"14437","2727王品","110/07/12","永豐金-忠孝",45,5,40
"14438","2727王品","110/07/12","國泰-台中",32,73,-41
"14439","2727王品","110/07/12","合庫-新竹",31,0,31
"14440","2727王品","110/07/12","元大證券",127,163,-36
"14441","2727王品","110/07/12","富邦-台中",31,3,28
"14442","2727王品","110/07/12","凱基",1,33,-32
"14443","2727王品","110/07/12","元大-桃園",35,10,25
"14444","2727王品","110/07/12","永全-南崁",1,31,-30
"14445","2727王品","110/07/12","新加坡商瑞銀",28,4,24
"14446","2727王品","110/07/12","凱基-和平",2,32,-30
"14447","2727王品","110/07/12","群益金鼎-古亭",25,2,23
"14448","2727王品","110/07/12","永豐金-大園",8,38,-30
"14449","2727王品","110/07/12","元大-龍潭",29,7,22
"14450","2727王品","110/07/12","瑞士信貸",0,28,-28
"14451","2727王品","110/07/12","永豐金-永康",25,3,22
"14452","2727王品","110/07/12","元富",17,44,-27
"14453","2727王品","110/07/12","富邦-竹北",24,3,21
"14454","2727王品","110/07/12","元大-北屯",5,32,-27
"14455","2727王品","110/07/12","群益金鼎-松山",20,0,20
"14456","2727王品","110/07/12","華南永昌",3,28,-25
"14457","2727王品","110/07/12","元大-八德",20,0,20
"14458","2727王品","110/07/12","統一-竹南",1,23,-22
"14459","2727王品","110/07/12","元大-南京",25,6,19
"14460","2727王品","110/07/12","永豐金證券",4,26,-22
"14461","1570力肯","110/07/12","國票-北高雄",40,0,40
"14462","1570力肯","110/07/12","日盛-竹北",0,40,-40
"14463","1570力肯","110/07/12","摩根大通",16,0,16
"14464","1570力肯","110/07/12","第一金-華江",1,38,-37
"14465","1570力肯","110/07/12","新光",31,19,12
"14466","1570力肯","110/07/12","元大-永春",0,26,-26
"14467","1570力肯","110/07/12","元大-台中中港",12,0,12
"14468","1570力肯","110/07/12","元大-古亭",1,20,-19
"14469","1570力肯","110/07/12","日盛-高雄",10,0,10
"14470","1570力肯","110/07/12","國泰-松江",0,16,-16
"14471","1570力肯","110/07/12","第一金-路竹",10,0,10
"14472","1570力肯","110/07/12","台新-台南",0,15,-15
"14473","1570力肯","110/07/12","台新-新莊",10,0,10
"14474","1570力肯","110/07/12","康和-石牌",0,15,-15
"14475","1570力肯","110/07/12","元大-新盛",9,0,9
"14476","1570力肯","110/07/12","國泰-板橋",0,11,-11
"14477","1570力肯","110/07/12","凱基-台北",8,0,8
"14478","1570力肯","110/07/12","元大-高雄",0,11,-11
"14479","1570力肯","110/07/12","彰銀-七賢",6,0,6
"14480","1570力肯","110/07/12","兆豐-桃園",0,10,-10
"14481","1570力肯","110/07/12","元富-緯城",6,0,6
"14482","1570力肯","110/07/12","元大-大益",0,10,-10
"14483","1570力肯","110/07/12","華南永昌-古亭",6,0,6
"14484","1570力肯","110/07/12","中國信託-文心",0,5,-5
"14485","1570力肯","110/07/12","富邦-陽明",6,0,6
"14486","1570力肯","110/07/12","光和",0,5,-5
"14487","1570力肯","110/07/12","臺銀-臺南",5,0,5
"14488","1570力肯","110/07/12","陽信-石牌",0,5,-5
"14489","1570力肯","110/07/12","宏遠-館前",5,0,5
"14490","1570力肯","110/07/12","國泰-高雄",0,5,-5
"14491","6180橘子","110/07/12","康和-台中",32,2,30
"14492","6180橘子","110/07/12","新百王",1,40,-39
"14493","6180橘子","110/07/12","美林",32,3,29
"14494","6180橘子","110/07/12","富邦-陽明",4,42,-38
"14495","6180橘子","110/07/12","元大-羅東",21,0,21
"14496","6180橘子","110/07/12","新光",3,32,-29
"14497","6180橘子","110/07/12","兆豐-埔墘",16,0,16
"14498","6180橘子","110/07/12","日盛-文化",4,20,-16
"14499","6180橘子","110/07/12","元大-雙和",12,0,12
"14500","6180橘子","110/07/12","華南永昌-鶯歌",0,15,-15
"14501","6180橘子","110/07/12","美商高盛",18,7,11
"14502","6180橘子","110/07/12","中國信託-忠孝",7,20,-13
"14503","6180橘子","110/07/12","台新證券",14,3,11
"14504","6180橘子","110/07/12","凱基-台北",5,17,-12
"14505","6180橘子","110/07/12","元大-中壢",12,1,11
"14506","6180橘子","110/07/12","凱基-高雄",0,11,-11
"14507","6180橘子","110/07/12","統一-南京",10,0,10
"14508","6180橘子","110/07/12","凱基-大安",0,10,-10
"14509","6180橘子","110/07/12","致和-崇德",10,0,10
"14510","6180橘子","110/07/12","元大-北屯",0,10,-10
"14511","6180橘子","110/07/12","玉山-板橋",10,0,10
"14512","6180橘子","110/07/12","元大-南京",0,9,-9
"14513","6180橘子","110/07/12","富邦-仁愛",10,0,10
"14514","6180橘子","110/07/12","元大-台南",1,10,-9
"14515","6180橘子","110/07/12","摩根大通",10,1,9
"14516","6180橘子","110/07/12","康和-澎湖",0,8,-8
"14517","6180橘子","110/07/12","元富-林園",8,0,8
"14518","6180橘子","110/07/12","第一金-台中",0,7,-7
"14519","6180橘子","110/07/12","大慶-富順",7,0,7
"14520","6180橘子","110/07/12","台新-台南",1,8,-7
"14521","2390云辰","110/07/12","統一-新台中",170,0,170
"14522","2390云辰","110/07/12","元大-天母",2,450,-448
"14523","2390云辰","110/07/12","華南永昌-麻豆",137,2,135
"14524","2390云辰","110/07/12","國泰-忠孝",1,143,-142
"14525","2390云辰","110/07/12","元富-成功",103,14,89
"14526","2390云辰","110/07/12","摩根大通",377,512,-135
"14527","2390云辰","110/07/12","元大-土城學府",146,69,77
"14528","2390云辰","110/07/12","台灣摩根士丹利",0,91,-91
"14529","2390云辰","110/07/12","永豐金-永康",76,4,72
"14530","2390云辰","110/07/12","美林",84,146,-62
"14531","2390云辰","110/07/12","台中銀",73,2,71
"14532","2390云辰","110/07/12","華南永昌-嘉義",2,61,-59
"14533","2390云辰","110/07/12","大昌",63,3,60
"14534","2390云辰","110/07/12","永豐金-羅東",0,49,-49
"14535","2390云辰","110/07/12","合庫-三重",50,0,50
"14536","2390云辰","110/07/12","玉山-台中",6,53,-47
"14537","2390云辰","110/07/12","元富-高雄",93,50,43
"14538","2390云辰","110/07/12","玉山-新莊",2,48,-46
"14539","2390云辰","110/07/12","元大-館前",40,4,36
"14540","2390云辰","110/07/12","元大-大里",7,52,-45
"14541","2390云辰","110/07/12","港商野村",143,109,34
"14542","2390云辰","110/07/12","元大-內湖",3,48,-45
"14543","2390云辰","110/07/12","元大-雙和",34,0,34
"14544","2390云辰","110/07/12","永豐金-市政",1,42,-41
"14545","2390云辰","110/07/12","群益金鼎-民權",33,2,31
"14546","2390云辰","110/07/12","元大-學甲",1,41,-40
"14547","2390云辰","110/07/12","日盛-八德",40,10,30
"14548","2390云辰","110/07/12","兆豐-高雄",2,41,-39
"14549","2390云辰","110/07/12","國票-嘉義",30,0,30
"14550","2390云辰","110/07/12","新加坡商瑞銀",21,59,-38
"14551","4903聯光通","110/07/12","台灣企銀-太平",19,0,19
"14552","4903聯光通","110/07/12","玉山-南京東路",0,16,-16
"14553","4903聯光通","110/07/12","統一-土城",17,0,17
"14554","4903聯光通","110/07/12","新光",0,14,-14
"14555","4903聯光通","110/07/12","國票-博愛",14,0,14
"14556","4903聯光通","110/07/12","兆豐-彰化",0,10,-10
"14557","4903聯光通","110/07/12","新光-台中",15,2,13
"14558","4903聯光通","110/07/12","國票",0,10,-10
"14559","4903聯光通","110/07/12","元大-彰化",11,0,11
"14560","4903聯光通","110/07/12","富邦-敦南",0,10,-10
"14561","4903聯光通","110/07/12","華南永昌-林口",10,0,10
"14562","4903聯光通","110/07/12","元大-前金",0,9,-9
"14563","4903聯光通","110/07/12","永豐金-南投",9,0,9
"14564","4903聯光通","110/07/12","日盛-頭份",0,8,-8
"14565","4903聯光通","110/07/12","元大-清水",8,0,8
"14566","4903聯光通","110/07/12","元大-太平",0,8,-8
"14567","4903聯光通","110/07/12","元大-博愛",8,0,8
"14568","4903聯光通","110/07/12","兆豐-埔墘",0,7,-7
"14569","4903聯光通","110/07/12","玉山-新莊",5,0,5
"14570","4903聯光通","110/07/12","臺銀-民權",0,5,-5
"14571","4903聯光通","110/07/12","凱基-士林",10,5,5
"14572","4903聯光通","110/07/12","富邦-板橋",0,5,-5
"14573","4903聯光通","110/07/12","元大-斗六",4,0,4
"14574","4903聯光通","110/07/12","元大-土城永寧",0,5,-5
"14575","4903聯光通","110/07/12","永豐金-羅東",4,0,4
"14576","4903聯光通","110/07/12","台新證券",0,4,-4
"14577","4903聯光通","110/07/12","日盛-樹林",3,0,3
"14578","4903聯光通","110/07/12","凱基-中壢",0,4,-4
"14579","4903聯光通","110/07/12","華南永昌-鶯歌",2,0,2
"14580","4903聯光通","110/07/12","元大-羅東",0,4,-4
"14581","2929淘帝","110/07/12","新光-台中",95,36,59
"14582","2929淘帝","110/07/12","華南永昌-林口",7,208,-201
"14583","2929淘帝","110/07/12","富邦-板橋",62,5,57
"14584","2929淘帝","110/07/12","富邦-台北",6,200,-194
"14585","2929淘帝","110/07/12","合庫-高雄",56,6,50
"14586","2929淘帝","110/07/12","元富-大裕",11,200,-189
"14587","2929淘帝","110/07/12","永興",41,0,41
"14588","2929淘帝","110/07/12","台中銀-台北",0,160,-160
"14589","2929淘帝","110/07/12","兆豐-忠孝",58,18,40
"14590","2929淘帝","110/07/12","日盛-園區",1,111,-110
"14591","2929淘帝","110/07/12","新光-高雄",39,3,36
"14592","2929淘帝","110/07/12","日盛-八德",0,88,-88
"14593","2929淘帝","110/07/12","凱基-豐中",36,0,36
"14594","2929淘帝","110/07/12","玉山-新竹",32,110,-78
"14595","2929淘帝","110/07/12","元大-民生",35,0,35
"14596","2929淘帝","110/07/12","元大-前金",0,72,-72
"14597","2929淘帝","110/07/12","臺銀-臺南",32,1,31
"14598","2929淘帝","110/07/12","元大-館前",12,83,-71
"14599","2929淘帝","110/07/12","台新證券",44,13,31
"14600","2929淘帝","110/07/12","華南永昌",1,57,-56
"14601","2929淘帝","110/07/12","新百王",30,0,30
"14602","2929淘帝","110/07/12","元大-南崁",4,59,-55
"14603","2929淘帝","110/07/12","群益金鼎-大興",30,0,30
"14604","2929淘帝","110/07/12","元大-嘉義",0,51,-51
"14605","2929淘帝","110/07/12","凱基-台北",32,5,27
"14606","2929淘帝","110/07/12","日茂",1,50,-49
"14607","2929淘帝","110/07/12","元富-城東",26,0,26
"14608","2929淘帝","110/07/12","新光",35,83,-48
"14609","2929淘帝","110/07/12","國泰-松江",26,0,26
"14610","2929淘帝","110/07/12","日盛-新竹",1,48,-47
"14611","5410國眾","110/07/12","群益金鼎-中壢",68,0,68
"14612","5410國眾","110/07/12","摩根大通",6,67,-61
"14613","5410國眾","110/07/12","凱基-市政",40,0,40
"14614","5410國眾","110/07/12","元富-嘉義",0,60,-60
"14615","5410國眾","110/07/12","凱基-竹北",38,0,38
"14616","5410國眾","110/07/12","凱基-台北",0,51,-51
"14617","5410國眾","110/07/12","華南永昌-三重",30,0,30
"14618","5410國眾","110/07/12","元富-大裕",0,33,-33
"14619","5410國眾","110/07/12","永興",20,0,20
"14620","5410國眾","110/07/12","日盛-木柵",0,15,-15
"14621","5410國眾","110/07/12","統一-新台中",20,0,20
"14622","5410國眾","110/07/12","群益金鼎-民權",0,15,-15
"14623","5410國眾","110/07/12","兆豐-三重",20,0,20
"14624","5410國眾","110/07/12","元富-緯城",0,14,-14
"14625","5410國眾","110/07/12","富邦-台中",20,0,20
"14626","5410國眾","110/07/12","元大-大同",0,12,-12
"14627","5410國眾","110/07/12","臺銀",15,0,15
"14628","5410國眾","110/07/12","元大-莒光",0,10,-10
"14629","5410國眾","110/07/12","新光-桃園",20,6,14
"14630","5410國眾","110/07/12","元大-博愛",0,10,-10
"14631","5410國眾","110/07/12","元大-員林",12,0,12
"14632","5410國眾","110/07/12","日盛-永康",0,8,-8
"14633","5410國眾","110/07/12","日盛-員林",10,0,10
"14634","5410國眾","110/07/12","元大-四維",5,13,-8
"14635","5410國眾","110/07/12","元大-新盛",10,0,10
"14636","5410國眾","110/07/12","新加坡商瑞銀",0,7,-7
"14637","5410國眾","110/07/12","永豐金-台南",10,0,10
"14638","5410國眾","110/07/12","致和-金華",0,7,-7
"14639","5410國眾","110/07/12","元富-新莊",8,0,8
"14640","5410國眾","110/07/12","新光-新竹",0,7,-7
"14641","2841台開","110/07/12","永豐金-敦南",139,26,113
"14642","2841台開","110/07/12","華南永昌-朴子",0,528,-528
"14643","2841台開","110/07/12","日盛-雙和",68,0,68
"14644","2841台開","110/07/12","元大-苑裡",2,50,-48
"14645","2841台開","110/07/12","台新證券",62,4,58
"14646","2841台開","110/07/12","群益金鼎-東湖",0,40,-40
"14647","2841台開","110/07/12","凱基-文心",50,0,50
"14648","2841台開","110/07/12","第一金-員林",0,30,-30
"14649","2841台開","110/07/12","第一金-台中",45,0,45
"14650","2841台開","110/07/12","德信-中正",0,20,-20
"14651","2841台開","110/07/12","富邦-嘉義",40,0,40
"14652","2841台開","110/07/12","兆豐-嘉義",0,20,-20
"14653","2841台開","110/07/12","日盛-木柵",30,0,30
"14654","2841台開","110/07/12","彰銀-七賢",0,15,-15
"14655","2841台開","110/07/12","中國信託-文心",31,3,28
"14656","2841台開","110/07/12","元大-承德",0,14,-14
"14657","2841台開","110/07/12","元大-福營",30,7,23
"14658","2841台開","110/07/12","元富",0,12,-12
"14659","2841台開","110/07/12","台中銀",20,0,20
"14660","2841台開","110/07/12","富邦-陽明",0,11,-11
"14661","2841台開","110/07/12","國泰-板橋",20,0,20
"14662","2841台開","110/07/12","元大證券",0,11,-11
"14663","2841台開","110/07/12","元大-前金",20,0,20
"14664","2841台開","110/07/12","元大-大甲",0,10,-10
"14665","2841台開","110/07/12","中國信託-高雄",16,1,15
"14666","2841台開","110/07/12","日盛-新竹",0,8,-8
"14667","2841台開","110/07/12","陽信-石牌",15,0,15
"14668","2841台開","110/07/12","元富-城東",0,8,-8
"14669","2841台開","110/07/12","永豐金-南投",15,0,15
"14670","2841台開","110/07/12","玉山-台南",2,10,-8
"14671","6207雷科","110/07/12","元大-高雄",34,0,34
"14672","6207雷科","110/07/12","永豐金-三重",1,32,-31
"14673","6207雷科","110/07/12","華南永昌-林口",16,1,15
"14674","6207雷科","110/07/12","永全-八德",0,30,-30
"14675","6207雷科","110/07/12","摩根大通",19,6,13
"14676","6207雷科","110/07/12","國泰-台中",0,14,-14
"14677","6207雷科","110/07/12","元富-埔里",10,0,10
"14678","6207雷科","110/07/12","第一金-澎湖",0,10,-10
"14679","6207雷科","110/07/12","凱基-台南",10,0,10
"14680","6207雷科","110/07/12","元富-林園",0,10,-10
"14681","6207雷科","110/07/12","新加坡商瑞銀",9,0,9
"14682","6207雷科","110/07/12","元大-東門",0,10,-10
"14683","6207雷科","110/07/12","瑞士信貸",8,0,8
"14684","6207雷科","110/07/12","兆豐-嘉義",0,4,-4
"14685","6207雷科","110/07/12","中國信託-高雄",9,1,8
"14686","6207雷科","110/07/12","新光",0,4,-4
"14687","6207雷科","110/07/12","凱基-高雄",6,0,6
"14688","6207雷科","110/07/12","新光-台中",0,4,-4
"14689","6207雷科","110/07/12","元大-六合",6,0,6
"14690","6207雷科","110/07/12","群益金鼎-開元",0,4,-4
"14691","6207雷科","110/07/12","永豐金-信義",6,0,6
"14692","6207雷科","110/07/12","凱基-桃園",0,4,-4
"14693","6207雷科","110/07/12","群益金鼎-土城",5,0,5
"14694","6207雷科","110/07/12","凱基-民權",0,4,-4
"14695","6207雷科","110/07/12","群益金鼎-竹南",5,0,5
"14696","6207雷科","110/07/12","玉山-新莊",0,3,-3
"14697","6207雷科","110/07/12","元大-大灣",5,1,4
"14698","6207雷科","110/07/12","國泰-松江",0,3,-3
"14699","6207雷科","110/07/12","永興",3,0,3
"14700","6207雷科","110/07/12","富邦-羅東",0,3,-3
"14701","3679新至陞","110/07/12","富邦-新竹華信",40,2,38
"14702","3679新至陞","110/07/12","瑞士信貸",0,45,-45
"14703","3679新至陞","110/07/12","台中銀-員林",28,2,26
"14704","3679新至陞","110/07/12","永豐金-天母",0,39,-39
"14705","3679新至陞","110/07/12","聯邦-大業",24,0,24
"14706","3679新至陞","110/07/12","摩根大通",7,35,-28
"14707","3679新至陞","110/07/12","永豐金證券",20,0,20
"14708","3679新至陞","110/07/12","凱基-台北",8,36,-28
"14709","3679新至陞","110/07/12","港商法國興業",14,0,14
"14710","3679新至陞","110/07/12","華南永昌-小港",1,23,-22
"14711","3679新至陞","110/07/12","日盛-樹林",13,1,12
"14712","3679新至陞","110/07/12","台新-台中",0,15,-15
"14713","3679新至陞","110/07/12","國泰-桃園",9,0,9
"14714","3679新至陞","110/07/12","統一-台中",0,12,-12
"14715","3679新至陞","110/07/12","宏遠-館前",8,0,8
"14716","3679新至陞","110/07/12","元大-成功",1,12,-11
"14717","3679新至陞","110/07/12","凱基",10,2,8
"14718","3679新至陞","110/07/12","康和-澎湖",0,8,-8
"14719","3679新至陞","110/07/12","(牛牛牛)亞-網路",7,0,7
"14720","3679新至陞","110/07/12","新加坡商瑞銀",0,7,-7
"14721","3679新至陞","110/07/12","兆豐-員林",7,0,7
"14722","3679新至陞","110/07/12","兆豐-來福",0,7,-7
"14723","3679新至陞","110/07/12","大慶-蘆洲",5,0,5
"14724","3679新至陞","110/07/12","元大-佳里",0,6,-6
"14725","3679新至陞","110/07/12","土銀-花蓮",4,0,4
"14726","3679新至陞","110/07/12","美商高盛",0,5,-5
"14727","3679新至陞","110/07/12","台新-高雄",5,1,4
"14728","3679新至陞","110/07/12","國票-新莊",0,5,-5
"14729","3679新至陞","110/07/12","元大-天母",4,0,4
"14730","3679新至陞","110/07/12","台新-屏東",0,5,-5
"14731","2727王品","110/07/12","凱基-台北",354,198,156
"14732","2727王品","110/07/12","台灣摩根士丹利",5,386,-381
"14733","2727王品","110/07/12","統一-城中",159,22,137
"14734","2727王品","110/07/12","元大-嘉義",4,60,-56
"14735","2727王品","110/07/12","日盛-忠孝",60,0,60
"14736","2727王品","110/07/12","元大-大同",2,44,-42
"14737","2727王品","110/07/12","永豐金-忠孝",45,5,40
"14738","2727王品","110/07/12","國泰-台中",32,73,-41
"14739","2727王品","110/07/12","合庫-新竹",31,0,31
"14740","2727王品","110/07/12","元大證券",127,163,-36
"14741","2727王品","110/07/12","富邦-台中",31,3,28
"14742","2727王品","110/07/12","凱基",1,33,-32
"14743","2727王品","110/07/12","元大-桃園",35,10,25
"14744","2727王品","110/07/12","永全-南崁",1,31,-30
"14745","2727王品","110/07/12","新加坡商瑞銀",28,4,24
"14746","2727王品","110/07/12","凱基-和平",2,32,-30
"14747","2727王品","110/07/12","群益金鼎-古亭",25,2,23
"14748","2727王品","110/07/12","永豐金-大園",8,38,-30
"14749","2727王品","110/07/12","元大-龍潭",29,7,22
"14750","2727王品","110/07/12","瑞士信貸",0,28,-28
"14751","2727王品","110/07/12","永豐金-永康",25,3,22
"14752","2727王品","110/07/12","元富",17,44,-27
"14753","2727王品","110/07/12","富邦-竹北",24,3,21
"14754","2727王品","110/07/12","元大-北屯",5,32,-27
"14755","2727王品","110/07/12","群益金鼎-松山",20,0,20
"14756","2727王品","110/07/12","華南永昌",3,28,-25
"14757","2727王品","110/07/12","元大-八德",20,0,20
"14758","2727王品","110/07/12","統一-竹南",1,23,-22
"14759","2727王品","110/07/12","元大-南京",25,6,19
"14760","2727王品","110/07/12","永豐金證券",4,26,-22
"14761","1570力肯","110/07/12","國票-北高雄",40,0,40
"14762","1570力肯","110/07/12","日盛-竹北",0,40,-40
"14763","1570力肯","110/07/12","摩根大通",16,0,16
"14764","1570力肯","110/07/12","第一金-華江",1,38,-37
"14765","1570力肯","110/07/12","新光",31,19,12
"14766","1570力肯","110/07/12","元大-永春",0,26,-26
"14767","1570力肯","110/07/12","元大-台中中港",12,0,12
"14768","1570力肯","110/07/12","元大-古亭",1,20,-19
"14769","1570力肯","110/07/12","日盛-高雄",10,0,10
"14770","1570力肯","110/07/12","國泰-松江",0,16,-16
"14771","1570力肯","110/07/12","第一金-路竹",10,0,10
"14772","1570力肯","110/07/12","台新-台南",0,15,-15
"14773","1570力肯","110/07/12","台新-新莊",10,0,10
"14774","1570力肯","110/07/12","康和-石牌",0,15,-15
"14775","1570力肯","110/07/12","元大-新盛",9,0,9
"14776","1570力肯","110/07/12","國泰-板橋",0,11,-11
"14777","1570力肯","110/07/12","凱基-台北",8,0,8
"14778","1570力肯","110/07/12","元大-高雄",0,11,-11
"14779","1570力肯","110/07/12","彰銀-七賢",6,0,6
"14780","1570力肯","110/07/12","兆豐-桃園",0,10,-10
"14781","1570力肯","110/07/12","元富-緯城",6,0,6
"14782","1570力肯","110/07/12","元大-大益",0,10,-10
"14783","1570力肯","110/07/12","華南永昌-古亭",6,0,6
"14784","1570力肯","110/07/12","中國信託-文心",0,5,-5
"14785","1570力肯","110/07/12","富邦-陽明",6,0,6
"14786","1570力肯","110/07/12","光和",0,5,-5
"14787","1570力肯","110/07/12","臺銀-臺南",5,0,5
"14788","1570力肯","110/07/12","陽信-石牌",0,5,-5
"14789","1570力肯","110/07/12","宏遠-館前",5,0,5
"14790","1570力肯","110/07/12","國泰-高雄",0,5,-5
"14791","6180橘子","110/07/12","康和-台中",32,2,30
"14792","6180橘子","110/07/12","新百王",1,40,-39
"14793","6180橘子","110/07/12","美林",32,3,29
"14794","6180橘子","110/07/12","富邦-陽明",4,42,-38
"14795","6180橘子","110/07/12","元大-羅東",21,0,21
"14796","6180橘子","110/07/12","新光",3,32,-29
"14797","6180橘子","110/07/12","兆豐-埔墘",16,0,16
"14798","6180橘子","110/07/12","日盛-文化",4,20,-16
"14799","6180橘子","110/07/12","元大-雙和",12,0,12
"14800","6180橘子","110/07/12","華南永昌-鶯歌",0,15,-15
"14801","6180橘子","110/07/12","美商高盛",18,7,11
"14802","6180橘子","110/07/12","中國信託-忠孝",7,20,-13
"14803","6180橘子","110/07/12","台新證券",14,3,11
"14804","6180橘子","110/07/12","凱基-台北",5,17,-12
"14805","6180橘子","110/07/12","元大-中壢",12,1,11
"14806","6180橘子","110/07/12","凱基-高雄",0,11,-11
"14807","6180橘子","110/07/12","統一-南京",10,0,10
"14808","6180橘子","110/07/12","凱基-大安",0,10,-10
"14809","6180橘子","110/07/12","致和-崇德",10,0,10
"14810","6180橘子","110/07/12","元大-北屯",0,10,-10
"14811","6180橘子","110/07/12","玉山-板橋",10,0,10
"14812","6180橘子","110/07/12","元大-南京",0,9,-9
"14813","6180橘子","110/07/12","富邦-仁愛",10,0,10
"14814","6180橘子","110/07/12","元大-台南",1,10,-9
"14815","6180橘子","110/07/12","摩根大通",10,1,9
"14816","6180橘子","110/07/12","康和-澎湖",0,8,-8
"14817","6180橘子","110/07/12","元富-林園",8,0,8
"14818","6180橘子","110/07/12","第一金-台中",0,7,-7
"14819","6180橘子","110/07/12","大慶-富順",7,0,7
"14820","6180橘子","110/07/12","台新-台南",1,8,-7
"14821","2390云辰","110/07/12","統一-新台中",170,0,170
"14822","2390云辰","110/07/12","元大-天母",2,450,-448
"14823","2390云辰","110/07/12","華南永昌-麻豆",137,2,135
"14824","2390云辰","110/07/12","國泰-忠孝",1,143,-142
"14825","2390云辰","110/07/12","元富-成功",103,14,89
"14826","2390云辰","110/07/12","摩根大通",377,512,-135
"14827","2390云辰","110/07/12","元大-土城學府",146,69,77
"14828","2390云辰","110/07/12","台灣摩根士丹利",0,91,-91
"14829","2390云辰","110/07/12","永豐金-永康",76,4,72
"14830","2390云辰","110/07/12","美林",84,146,-62
"14831","2390云辰","110/07/12","台中銀",73,2,71
"14832","2390云辰","110/07/12","華南永昌-嘉義",2,61,-59
"14833","2390云辰","110/07/12","大昌",63,3,60
"14834","2390云辰","110/07/12","永豐金-羅東",0,49,-49
"14835","2390云辰","110/07/12","合庫-三重",50,0,50
"14836","2390云辰","110/07/12","玉山-台中",6,53,-47
"14837","2390云辰","110/07/12","元富-高雄",93,50,43
"14838","2390云辰","110/07/12","玉山-新莊",2,48,-46
"14839","2390云辰","110/07/12","元大-館前",40,4,36
"14840","2390云辰","110/07/12","元大-大里",7,52,-45
"14841","2390云辰","110/07/12","港商野村",143,109,34
"14842","2390云辰","110/07/12","元大-內湖",3,48,-45
"14843","2390云辰","110/07/12","元大-雙和",34,0,34
"14844","2390云辰","110/07/12","永豐金-市政",1,42,-41
"14845","2390云辰","110/07/12","群益金鼎-民權",33,2,31
"14846","2390云辰","110/07/12","元大-學甲",1,41,-40
"14847","2390云辰","110/07/12","日盛-八德",40,10,30
"14848","2390云辰","110/07/12","兆豐-高雄",2,41,-39
"14849","2390云辰","110/07/12","國票-嘉義",30,0,30
"14850","2390云辰","110/07/12","新加坡商瑞銀",21,59,-38
"14851","4903聯光通","110/07/09","元大-敦南",10,0,10
"14852","4903聯光通","110/07/09","第一金-台中",0,12,-12
"14853","4903聯光通","110/07/09","凱基-士林",5,0,5
"14854","4903聯光通","110/07/09","日盛-忠孝",0,3,-3
"14855","4903聯光通","110/07/09","元大-苗栗",5,0,5
"14856","4903聯光通","110/07/09","群益金鼎-崇德",0,3,-3
"14857","4903聯光通","110/07/09","元大-屏南",3,0,3
"14858","4903聯光通","110/07/09","國票-內壢",0,2,-2
"14859","4903聯光通","110/07/09","中國信託-永康",1,0,1
"14860","4903聯光通","110/07/09","康和-南崁",0,2,-2
"14861","4903聯光通","110/07/09","玉山證券",1,0,1
"14862","4903聯光通","110/07/09","新光-台中",0,2,-2
"14863","4903聯光通","110/07/09","元大-太平",4,3,1
"14864","4903聯光通","110/07/09","玉山-城中",0,2,-2
"14865","4903聯光通","110/07/09","永豐金-嘉義",1,0,1
"14866","4903聯光通","110/07/09","中國信託-文心",0,1,-1
"14867","4903聯光通","110/07/09","大昌",0,0,0
"14868","4903聯光通","110/07/09","大昌",0,0,0
"14869","4903聯光通","110/07/09","中農",0,0,0
"14870","4903聯光通","110/07/09","中農",0,0,0
"14871","4903聯光通","110/07/09","",NA,NA,NA
"14872","4903聯光通","110/07/09","",NA,NA,NA
"14873","4903聯光通","110/07/09","",NA,NA,NA
"14874","4903聯光通","110/07/09","",NA,NA,NA
"14875","4903聯光通","110/07/09","",NA,NA,NA
"14876","4903聯光通","110/07/09","",NA,NA,NA
"14877","4903聯光通","110/07/09","",NA,NA,NA
"14878","4903聯光通","110/07/09","",NA,NA,NA
"14879","4903聯光通","110/07/09","",NA,NA,NA
"14880","4903聯光通","110/07/09","",NA,NA,NA
"14881","2929淘帝","110/07/09","台中銀-台北",110,0,110
"14882","2929淘帝","110/07/09","新光",2,82,-80
"14883","2929淘帝","110/07/09","華南永昌-頭份",72,0,72
"14884","2929淘帝","110/07/09","摩根大通",2,63,-61
"14885","2929淘帝","110/07/09","合庫-高雄",71,0,71
"14886","2929淘帝","110/07/09","第一金-路竹",0,50,-50
"14887","2929淘帝","110/07/09","高橋-龍潭",37,0,37
"14888","2929淘帝","110/07/09","港商麥格理",0,42,-42
"14889","2929淘帝","110/07/09","新光-台中",60,26,34
"14890","2929淘帝","110/07/09","陽信-石牌",0,40,-40
"14891","2929淘帝","110/07/09","元富-大裕",22,1,21
"14892","2929淘帝","110/07/09","台新-左楠",1,39,-38
"14893","2929淘帝","110/07/09","合庫-鳳山",20,0,20
"14894","2929淘帝","110/07/09","凱基-桃園",3,29,-26
"14895","2929淘帝","110/07/09","元大-員林",22,2,20
"14896","2929淘帝","110/07/09","兆豐-內湖",0,25,-25
"14897","2929淘帝","110/07/09","台新-建北",15,0,15
"14898","2929淘帝","110/07/09","元大-北港",0,20,-20
"14899","2929淘帝","110/07/09","兆豐-桃園",13,0,13
"14900","2929淘帝","110/07/09","富邦-北港",0,19,-19
"14901","2929淘帝","110/07/09","兆豐-忠孝",10,0,10
"14902","2929淘帝","110/07/09","富邦-花蓮",0,17,-17
"14903","2929淘帝","110/07/09","國票-敦北法人",10,0,10
"14904","2929淘帝","110/07/09","國泰-台中",2,17,-15
"14905","2929淘帝","110/07/09","永豐金-博愛",10,0,10
"14906","2929淘帝","110/07/09","群益金鼎-彰化",0,15,-15
"14907","2929淘帝","110/07/09","群益金鼎-潭子",8,0,8
"14908","2929淘帝","110/07/09","元大-博愛",0,14,-14
"14909","2929淘帝","110/07/09","富邦-南屯",8,0,8
"14910","2929淘帝","110/07/09","日盛-板橋",0,13,-13
"14911","5410國眾","110/07/09","元大-新盛",14,0,14
"14912","5410國眾","110/07/09","(牛牛牛)亞-鑫豐",1,41,-40
"14913","5410國眾","110/07/09","台灣企銀-民雄",10,0,10
"14914","5410國眾","110/07/09","元富-嘉義",0,25,-25
"14915","5410國眾","110/07/09","元富-虎尾",9,0,9
"14916","5410國眾","110/07/09","凱基-高美館",0,10,-10
"14917","5410國眾","110/07/09","摩根大通",10,1,9
"14918","5410國眾","110/07/09","凱基-城中",0,10,-10
"14919","5410國眾","110/07/09","兆豐-北高雄",7,0,7
"14920","5410國眾","110/07/09","元大-頭份",0,10,-10
"14921","5410國眾","110/07/09","凱基-台北",8,1,7
"14922","5410國眾","110/07/09","群益金鼎-丹鳳",0,7,-7
"14923","5410國眾","110/07/09","華南永昌-公誠",7,0,7
"14924","5410國眾","110/07/09","凱基-復興",0,7,-7
"14925","5410國眾","110/07/09","香港上海匯豐",6,0,6
"14926","5410國眾","110/07/09","元大-員林",0,7,-7
"14927","5410國眾","110/07/09","凱基-中壢",6,0,6
"14928","5410國眾","110/07/09","富邦-竹東",0,6,-6
"14929","5410國眾","110/07/09","華南永昌-南京",6,0,6
"14930","5410國眾","110/07/09","亞東-高雄",0,5,-5
"14931","5410國眾","110/07/09","統一-三重",5,0,5
"14932","5410國眾","110/07/09","大慶-中壢",1,6,-5
"14933","5410國眾","110/07/09","富邦-宜蘭",5,0,5
"14934","5410國眾","110/07/09","群益金鼎-中港",0,5,-5
"14935","5410國眾","110/07/09","元大-崇德",5,0,5
"14936","5410國眾","110/07/09","元大-八德",0,5,-5
"14937","5410國眾","110/07/09","元大-博愛",5,0,5
"14938","5410國眾","110/07/09","富邦-基隆",0,4,-4
"14939","5410國眾","110/07/09","元大-龍潭",5,0,5
"14940","5410國眾","110/07/09","臺銀-新竹",0,3,-3
"14941","2841台開","110/07/09","日盛-雙和",102,0,102
"14942","2841台開","110/07/09","港商野村",0,129,-129
"14943","2841台開","110/07/09","元大-館前",70,0,70
"14944","2841台開","110/07/09","兆豐-永和",0,100,-100
"14945","2841台開","110/07/09","凱基-文心",50,0,50
"14946","2841台開","110/07/09","台新證券",7,28,-21
"14947","2841台開","110/07/09","富邦-嘉義",40,0,40
"14948","2841台開","110/07/09","國票-北高雄",0,20,-20
"14949","2841台開","110/07/09","美商高盛",15,0,15
"14950","2841台開","110/07/09","永豐金-敦南",29,46,-17
"14951","2841台開","110/07/09","台中銀",15,0,15
"14952","2841台開","110/07/09","合庫-基隆",0,12,-12
"14953","2841台開","110/07/09","新光",11,0,11
"14954","2841台開","110/07/09","中國信託-松江",0,12,-12
"14955","2841台開","110/07/09","華南永昌-長虹",10,0,10
"14956","2841台開","110/07/09","兆豐-城中",0,12,-12
"14957","2841台開","110/07/09","永豐金-南投",10,0,10
"14958","2841台開","110/07/09","台中銀-豐原",0,10,-10
"14959","2841台開","110/07/09","合庫-桃園",7,0,7
"14960","2841台開","110/07/09","兆豐-景美",0,10,-10
"14961","2841台開","110/07/09","群益金鼎-古亭",7,0,7
"14962","2841台開","110/07/09","群益金鼎-基隆",0,10,-10
"14963","2841台開","110/07/09","國泰-敦南",6,0,6
"14964","2841台開","110/07/09","元大-北三重",0,10,-10
"14965","2841台開","110/07/09","凱基-桃園",8,2,6
"14966","2841台開","110/07/09","(牛牛牛)亞-網路",0,9,-9
"14967","2841台開","110/07/09","日盛證券",5,0,5
"14968","2841台開","110/07/09","台新-高雄",1,10,-9
"14969","2841台開","110/07/09","元富-文心",5,0,5
"14970","2841台開","110/07/09","凱基-台北",0,7,-7
"14971","6207雷科","110/07/09","群益金鼎-新竹",47,0,47
"14972","6207雷科","110/07/09","新光",7,24,-17
"14973","6207雷科","110/07/09","永豐金-三重",31,0,31
"14974","6207雷科","110/07/09","日盛-和美",0,15,-15
"14975","6207雷科","110/07/09","新加坡商瑞銀",33,5,28
"14976","6207雷科","110/07/09","國泰-台南",0,15,-15
"14977","6207雷科","110/07/09","元大-高雄",26,0,26
"14978","6207雷科","110/07/09","華南永昌-古亭",0,14,-14
"14979","6207雷科","110/07/09","統一-員林",22,0,22
"14980","6207雷科","110/07/09","土銀-白河",0,11,-11
"14981","6207雷科","110/07/09","台新-高雄",22,0,22
"14982","6207雷科","110/07/09","日盛-台南",0,10,-10
"14983","6207雷科","110/07/09","摩根大通",34,17,17
"14984","6207雷科","110/07/09","元富-林園",0,10,-10
"14985","6207雷科","110/07/09","元大-博愛",17,1,16
"14986","6207雷科","110/07/09","富邦-園區",0,10,-10
"14987","6207雷科","110/07/09","日茂-埔里",12,0,12
"14988","6207雷科","110/07/09","元大-上新莊",0,10,-10
"14989","6207雷科","110/07/09","國泰-台中",17,6,11
"14990","6207雷科","110/07/09","永豐金-南京",0,10,-10
"14991","6207雷科","110/07/09","富邦-三重",10,0,10
"14992","6207雷科","110/07/09","兆豐-小港",0,6,-6
"14993","6207雷科","110/07/09","元大-沙鹿",10,0,10
"14994","6207雷科","110/07/09","富邦-羅東",1,7,-6
"14995","6207雷科","110/07/09","元大-八德",10,0,10
"14996","6207雷科","110/07/09","元大-土城永寧",0,6,-6
"14997","6207雷科","110/07/09","第一金-路竹",11,2,9
"14998","6207雷科","110/07/09","永豐金-板盛",0,6,-6
"14999","6207雷科","110/07/09","統一-南京",5,0,5
"15000","6207雷科","110/07/09","日盛-板橋",0,5,-5
"15001","3679新至陞","110/07/09","元大-大天母",10,0,10
"15002","3679新至陞","110/07/09","第一金-光復",0,11,-11
"15003","3679新至陞","110/07/09","日盛-樹林",9,0,9
"15004","3679新至陞","110/07/09","瑞士信貸",0,8,-8
"15005","3679新至陞","110/07/09","凱基-台北",11,2,9
"15006","3679新至陞","110/07/09","大慶-苗栗",0,5,-5
"15007","3679新至陞","110/07/09","華南永昌-小港",8,0,8
"15008","3679新至陞","110/07/09","元大-永春",0,5,-5
"15009","3679新至陞","110/07/09","兆豐-來福",7,0,7
"15010","3679新至陞","110/07/09","日盛-和美",0,4,-4
"15011","3679新至陞","110/07/09","香港上海匯豐",5,0,5
"15012","3679新至陞","110/07/09","元大-雙和",0,3,-3
"15013","3679新至陞","110/07/09","台中銀-員林",3,0,3
"15014","3679新至陞","110/07/09","永豐金-屏東",0,3,-3
"15015","3679新至陞","110/07/09","新光",3,0,3
"15016","3679新至陞","110/07/09","彰銀",0,2,-2
"15017","3679新至陞","110/07/09","土銀-花蓮",2,0,2
"15018","3679新至陞","110/07/09","宏遠-館前",0,2,-2
"15019","3679新至陞","110/07/09","第一金-澎湖",2,0,2
"15020","3679新至陞","110/07/09","港商野村",0,2,-2
"15021","3679新至陞","110/07/09","摩根大通",2,0,2
"15022","3679新至陞","110/07/09","大昌-新店",0,2,-2
"15023","3679新至陞","110/07/09","國泰-敦南",2,0,2
"15024","3679新至陞","110/07/09","元大-新莊",0,2,-2
"15025","3679新至陞","110/07/09","元大-淡水",4,2,2
"15026","3679新至陞","110/07/09","元大-板橋",0,2,-2
"15027","3679新至陞","110/07/09","日盛-士林",1,0,1
"15028","3679新至陞","110/07/09","台灣摩根士丹利",0,1,-1
"15029","3679新至陞","110/07/09","日盛-信義",1,0,1
"15030","3679新至陞","110/07/09","第一金-高雄",0,1,-1
"15031","2727王品","110/07/09","台灣匯立證券",90,0,90
"15032","2727王品","110/07/09","台灣摩根士丹利",0,267,-267
"15033","2727王品","110/07/09","國泰-敦南",166,84,82
"15034","2727王品","110/07/09","富邦-台北",35,299,-264
"15035","2727王品","110/07/09","富邦-仁愛",56,12,44
"15036","2727王品","110/07/09","凱基-台北",174,296,-122
"15037","2727王品","110/07/09","台新證券",109,66,43
"15038","2727王品","110/07/09","第一金",2,102,-100
"15039","2727王品","110/07/09","新光",117,87,30
"15040","2727王品","110/07/09","群益金鼎-大安",0,80,-80
"15041","2727王品","110/07/09","臺銀-臺中",35,6,29
"15042","2727王品","110/07/09","兆豐-大安",7,60,-53
"15043","2727王品","110/07/09","元大-桃園",32,3,29
"15044","2727王品","110/07/09","永豐金-南投",0,50,-50
"15045","2727王品","110/07/09","元富-宜蘭",34,6,28
"15046","2727王品","110/07/09","新加坡商瑞銀",6,46,-40
"15047","2727王品","110/07/09","玉山-台中",34,8,26
"15048","2727王品","110/07/09","合庫-彰化",11,50,-39
"15049","2727王品","110/07/09","群益金鼎-宜蘭",30,4,26
"15050","2727王品","110/07/09","永豐金-萬盛",13,52,-39
"15051","2727王品","110/07/09","富邦-台中",42,16,26
"15052","2727王品","110/07/09","瑞士信貸",0,34,-34
"15053","2727王品","110/07/09","第一金-豐原",25,1,24
"15054","2727王品","110/07/09","元大-和平",4,35,-31
"15055","2727王品","110/07/09","臺銀",30,8,22
"15056","2727王品","110/07/09","美林",14,44,-30
"15057","2727王品","110/07/09","兆豐-來福",23,1,22
"15058","2727王品","110/07/09","元大-員林",9,38,-29
"15059","2727王品","110/07/09","玉山-士林",22,2,20
"15060","2727王品","110/07/09","元富-西松",4,31,-27
"15061","1570力肯","110/07/09","凱基-台北",30,1,29
"15062","1570力肯","110/07/09","群益金鼎-彰化",0,20,-20
"15063","1570力肯","110/07/09","新光-台南",20,0,20
"15064","1570力肯","110/07/09","元大-土城學府",0,20,-20
"15065","1570力肯","110/07/09","元大-高雄",20,0,20
"15066","1570力肯","110/07/09","元大-大統",0,16,-16
"15067","1570力肯","110/07/09","國票-中正",12,0,12
"15068","1570力肯","110/07/09","元大-新營",0,11,-11
"15069","1570力肯","110/07/09","日盛-高雄",6,0,6
"15070","1570力肯","110/07/09","元大-和平",0,10,-10
"15071","1570力肯","110/07/09","元富-緯城",6,0,6
"15072","1570力肯","110/07/09","元大-草屯",0,10,-10
"15073","1570力肯","110/07/09","群益金鼎-台南",6,0,6
"15074","1570力肯","110/07/09","元大-鹿港",0,9,-9
"15075","1570力肯","110/07/09","華南永昌-岡山",6,0,6
"15076","1570力肯","110/07/09","合庫-基隆",0,7,-7
"15077","1570力肯","110/07/09","統一-中壢",5,0,5
"15078","1570力肯","110/07/09","摩根大通",2,8,-6
"15079","1570力肯","110/07/09","凱基-三峽",5,0,5
"15080","1570力肯","110/07/09","台灣企銀-豐原",0,4,-4
"15081","1570力肯","110/07/09","大昌-樹林",4,0,4
"15082","1570力肯","110/07/09","日盛-桃園",0,4,-4
"15083","1570力肯","110/07/09","新光",3,0,3
"15084","1570力肯","110/07/09","國泰-高雄",0,3,-3
"15085","1570力肯","110/07/09","富邦-新竹華信",3,0,3
"15086","1570力肯","110/07/09","永豐金-敦南",0,3,-3
"15087","1570力肯","110/07/09","合庫-台中",2,0,2
"15088","1570力肯","110/07/09","土銀-彰化",0,2,-2
"15089","1570力肯","110/07/09","臺銀-臺中",2,0,2
"15090","1570力肯","110/07/09","臺銀-鳳山",0,2,-2
"15091","6180橘子","110/07/09","摩根大通",63,1,62
"15092","6180橘子","110/07/09","元大-南京",1,32,-31
"15093","6180橘子","110/07/09","富邦-陽明",73,33,40
"15094","6180橘子","110/07/09","群益金鼎-台北",0,25,-25
"15095","6180橘子","110/07/09","新加坡商瑞銀",31,0,31
"15096","6180橘子","110/07/09","兆豐-復興",0,21,-21
"15097","6180橘子","110/07/09","美商高盛",25,0,25
"15098","6180橘子","110/07/09","永豐金-嘉義",0,21,-21
"15099","6180橘子","110/07/09","凱基-台北",26,10,16
"15100","6180橘子","110/07/09","凱基-中壢",8,24,-16
"15101","6180橘子","110/07/09","華南永昌-楠梓",13,0,13
"15102","6180橘子","110/07/09","致和-崇德",0,15,-15
"15103","6180橘子","110/07/09","華南永昌-朴子",11,0,11
"15104","6180橘子","110/07/09","群益金鼎-屏東",0,15,-15
"15105","6180橘子","110/07/09","元大-北港",11,0,11
"15106","6180橘子","110/07/09","群益金鼎-中山",0,15,-15
"15107","6180橘子","110/07/09","元大-成功",10,1,9
"15108","6180橘子","110/07/09","瑞士信貸",1,15,-14
"15109","6180橘子","110/07/09","新光",26,18,8
"15110","6180橘子","110/07/09","日盛-二林",0,10,-10
"15111","6180橘子","110/07/09","統一-三重",6,0,6
"15112","6180橘子","110/07/09","凱基-東門",0,10,-10
"15113","6180橘子","110/07/09","群益金鼎-嘉義",6,0,6
"15114","6180橘子","110/07/09","華南永昌-三重",0,10,-10
"15115","6180橘子","110/07/09","元大-員林中山",6,0,6
"15116","6180橘子","110/07/09","元大-彰化民生",1,11,-10
"15117","6180橘子","110/07/09","合庫-鳳山",5,0,5
"15118","6180橘子","110/07/09","永豐金-新店",1,11,-10
"15119","6180橘子","110/07/09","富邦-建國",6,1,5
"15120","6180橘子","110/07/09","群益金鼎-丹鳳",0,8,-8
"15121","2390云辰","110/07/09","摩根大通",279,56,223
"15122","2390云辰","110/07/09","元大-天母",0,127,-127
"15123","2390云辰","110/07/09","日盛-鳳山",110,2,108
"15124","2390云辰","110/07/09","中國信託-文心",5,109,-104
"15125","2390云辰","110/07/09","宏遠證券",100,0,100
"15126","2390云辰","110/07/09","永豐金-復興",0,55,-55
"15127","2390云辰","110/07/09","元大-大里",63,6,57
"15128","2390云辰","110/07/09","凱基-台北",239,286,-47
"15129","2390云辰","110/07/09","凱基-八德",59,10,49
"15130","2390云辰","110/07/09","德信",2,32,-30
"15131","2390云辰","110/07/09","合庫-新竹",40,0,40
"15132","2390云辰","110/07/09","兆豐-桃鶯",2,32,-30
"15133","2390云辰","110/07/09","國票",40,1,39
"15134","2390云辰","110/07/09","致和-南京",0,30,-30
"15135","2390云辰","110/07/09","新加坡商瑞銀",49,13,36
"15136","2390云辰","110/07/09","富邦-虎尾",1,31,-30
"15137","2390云辰","110/07/09","統一-新台中",36,2,34
"15138","2390云辰","110/07/09","元大-善化",2,31,-29
"15139","2390云辰","110/07/09","國票-嘉義",31,0,31
"15140","2390云辰","110/07/09","富邦-板橋",0,27,-27
"15141","2390云辰","110/07/09","華南永昌",35,7,28
"15142","2390云辰","110/07/09","富邦-永和",3,28,-25
"15143","2390云辰","110/07/09","玉山-台中",49,22,27
"15144","2390云辰","110/07/09","第一金-自由",20,44,-24
"15145","2390云辰","110/07/09","華南永昌-敦南",25,0,25
"15146","2390云辰","110/07/09","凱基-內湖",0,24,-24
"15147","2390云辰","110/07/09","新光-高雄",27,4,23
"15148","2390云辰","110/07/09","元大-汐止",1,24,-23
"15149","2390云辰","110/07/09","台灣摩根士丹利",85,63,22
"15150","2390云辰","110/07/09","新光-台中",12,33,-21
"15151","4903聯光通","110/07/09","元大-敦南",10,0,10
"15152","4903聯光通","110/07/09","第一金-台中",0,12,-12
"15153","4903聯光通","110/07/09","凱基-士林",5,0,5
"15154","4903聯光通","110/07/09","日盛-忠孝",0,3,-3
"15155","4903聯光通","110/07/09","元大-苗栗",5,0,5
"15156","4903聯光通","110/07/09","群益金鼎-崇德",0,3,-3
"15157","4903聯光通","110/07/09","元大-屏南",3,0,3
"15158","4903聯光通","110/07/09","國票-內壢",0,2,-2
"15159","4903聯光通","110/07/09","中國信託-永康",1,0,1
"15160","4903聯光通","110/07/09","康和-南崁",0,2,-2
"15161","4903聯光通","110/07/09","玉山證券",1,0,1
"15162","4903聯光通","110/07/09","新光-台中",0,2,-2
"15163","4903聯光通","110/07/09","元大-太平",4,3,1
"15164","4903聯光通","110/07/09","玉山-城中",0,2,-2
"15165","4903聯光通","110/07/09","永豐金-嘉義",1,0,1
"15166","4903聯光通","110/07/09","中國信託-文心",0,1,-1
"15167","4903聯光通","110/07/09","大昌",0,0,0
"15168","4903聯光通","110/07/09","大昌",0,0,0
"15169","4903聯光通","110/07/09","中農",0,0,0
"15170","4903聯光通","110/07/09","中農",0,0,0
"15171","4903聯光通","110/07/09","",NA,NA,NA
"15172","4903聯光通","110/07/09","",NA,NA,NA
"15173","4903聯光通","110/07/09","",NA,NA,NA
"15174","4903聯光通","110/07/09","",NA,NA,NA
"15175","4903聯光通","110/07/09","",NA,NA,NA
"15176","4903聯光通","110/07/09","",NA,NA,NA
"15177","4903聯光通","110/07/09","",NA,NA,NA
"15178","4903聯光通","110/07/09","",NA,NA,NA
"15179","4903聯光通","110/07/09","",NA,NA,NA
"15180","4903聯光通","110/07/09","",NA,NA,NA
"15181","2929淘帝","110/07/09","台中銀-台北",110,0,110
"15182","2929淘帝","110/07/09","新光",2,82,-80
"15183","2929淘帝","110/07/09","華南永昌-頭份",72,0,72
"15184","2929淘帝","110/07/09","摩根大通",2,63,-61
"15185","2929淘帝","110/07/09","合庫-高雄",71,0,71
"15186","2929淘帝","110/07/09","第一金-路竹",0,50,-50
"15187","2929淘帝","110/07/09","高橋-龍潭",37,0,37
"15188","2929淘帝","110/07/09","港商麥格理",0,42,-42
"15189","2929淘帝","110/07/09","新光-台中",60,26,34
"15190","2929淘帝","110/07/09","陽信-石牌",0,40,-40
"15191","2929淘帝","110/07/09","元富-大裕",22,1,21
"15192","2929淘帝","110/07/09","台新-左楠",1,39,-38
"15193","2929淘帝","110/07/09","合庫-鳳山",20,0,20
"15194","2929淘帝","110/07/09","凱基-桃園",3,29,-26
"15195","2929淘帝","110/07/09","元大-員林",22,2,20
"15196","2929淘帝","110/07/09","兆豐-內湖",0,25,-25
"15197","2929淘帝","110/07/09","台新-建北",15,0,15
"15198","2929淘帝","110/07/09","元大-北港",0,20,-20
"15199","2929淘帝","110/07/09","兆豐-桃園",13,0,13
"15200","2929淘帝","110/07/09","富邦-北港",0,19,-19
"15201","2929淘帝","110/07/09","兆豐-忠孝",10,0,10
"15202","2929淘帝","110/07/09","富邦-花蓮",0,17,-17
"15203","2929淘帝","110/07/09","國票-敦北法人",10,0,10
"15204","2929淘帝","110/07/09","國泰-台中",2,17,-15
"15205","2929淘帝","110/07/09","永豐金-博愛",10,0,10
"15206","2929淘帝","110/07/09","群益金鼎-彰化",0,15,-15
"15207","2929淘帝","110/07/09","群益金鼎-潭子",8,0,8
"15208","2929淘帝","110/07/09","元大-博愛",0,14,-14
"15209","2929淘帝","110/07/09","富邦-南屯",8,0,8
"15210","2929淘帝","110/07/09","日盛-板橋",0,13,-13
"15211","5410國眾","110/07/09","元大-新盛",14,0,14
"15212","5410國眾","110/07/09","(牛牛牛)亞-鑫豐",1,41,-40
"15213","5410國眾","110/07/09","台灣企銀-民雄",10,0,10
"15214","5410國眾","110/07/09","元富-嘉義",0,25,-25
"15215","5410國眾","110/07/09","元富-虎尾",9,0,9
"15216","5410國眾","110/07/09","凱基-高美館",0,10,-10
"15217","5410國眾","110/07/09","摩根大通",10,1,9
"15218","5410國眾","110/07/09","凱基-城中",0,10,-10
"15219","5410國眾","110/07/09","兆豐-北高雄",7,0,7
"15220","5410國眾","110/07/09","元大-頭份",0,10,-10
"15221","5410國眾","110/07/09","凱基-台北",8,1,7
"15222","5410國眾","110/07/09","群益金鼎-丹鳳",0,7,-7
"15223","5410國眾","110/07/09","華南永昌-公誠",7,0,7
"15224","5410國眾","110/07/09","凱基-復興",0,7,-7
"15225","5410國眾","110/07/09","香港上海匯豐",6,0,6
"15226","5410國眾","110/07/09","元大-員林",0,7,-7
"15227","5410國眾","110/07/09","凱基-中壢",6,0,6
"15228","5410國眾","110/07/09","富邦-竹東",0,6,-6
"15229","5410國眾","110/07/09","華南永昌-南京",6,0,6
"15230","5410國眾","110/07/09","亞東-高雄",0,5,-5
"15231","5410國眾","110/07/09","統一-三重",5,0,5
"15232","5410國眾","110/07/09","大慶-中壢",1,6,-5
"15233","5410國眾","110/07/09","富邦-宜蘭",5,0,5
"15234","5410國眾","110/07/09","群益金鼎-中港",0,5,-5
"15235","5410國眾","110/07/09","元大-崇德",5,0,5
"15236","5410國眾","110/07/09","元大-八德",0,5,-5
"15237","5410國眾","110/07/09","元大-博愛",5,0,5
"15238","5410國眾","110/07/09","富邦-基隆",0,4,-4
"15239","5410國眾","110/07/09","元大-龍潭",5,0,5
"15240","5410國眾","110/07/09","臺銀-新竹",0,3,-3
"15241","2841台開","110/07/09","日盛-雙和",102,0,102
"15242","2841台開","110/07/09","港商野村",0,129,-129
"15243","2841台開","110/07/09","元大-館前",70,0,70
"15244","2841台開","110/07/09","兆豐-永和",0,100,-100
"15245","2841台開","110/07/09","凱基-文心",50,0,50
"15246","2841台開","110/07/09","台新證券",7,28,-21
"15247","2841台開","110/07/09","富邦-嘉義",40,0,40
"15248","2841台開","110/07/09","國票-北高雄",0,20,-20
"15249","2841台開","110/07/09","美商高盛",15,0,15
"15250","2841台開","110/07/09","永豐金-敦南",29,46,-17
"15251","2841台開","110/07/09","台中銀",15,0,15
"15252","2841台開","110/07/09","合庫-基隆",0,12,-12
"15253","2841台開","110/07/09","新光",11,0,11
"15254","2841台開","110/07/09","中國信託-松江",0,12,-12
"15255","2841台開","110/07/09","華南永昌-長虹",10,0,10
"15256","2841台開","110/07/09","兆豐-城中",0,12,-12
"15257","2841台開","110/07/09","永豐金-南投",10,0,10
"15258","2841台開","110/07/09","台中銀-豐原",0,10,-10
"15259","2841台開","110/07/09","合庫-桃園",7,0,7
"15260","2841台開","110/07/09","兆豐-景美",0,10,-10
"15261","2841台開","110/07/09","群益金鼎-古亭",7,0,7
"15262","2841台開","110/07/09","群益金鼎-基隆",0,10,-10
"15263","2841台開","110/07/09","國泰-敦南",6,0,6
"15264","2841台開","110/07/09","元大-北三重",0,10,-10
"15265","2841台開","110/07/09","凱基-桃園",8,2,6
"15266","2841台開","110/07/09","(牛牛牛)亞-網路",0,9,-9
"15267","2841台開","110/07/09","日盛證券",5,0,5
"15268","2841台開","110/07/09","台新-高雄",1,10,-9
"15269","2841台開","110/07/09","元富-文心",5,0,5
"15270","2841台開","110/07/09","凱基-台北",0,7,-7
"15271","6207雷科","110/07/09","群益金鼎-新竹",47,0,47
"15272","6207雷科","110/07/09","新光",7,24,-17
"15273","6207雷科","110/07/09","永豐金-三重",31,0,31
"15274","6207雷科","110/07/09","日盛-和美",0,15,-15
"15275","6207雷科","110/07/09","新加坡商瑞銀",33,5,28
"15276","6207雷科","110/07/09","國泰-台南",0,15,-15
"15277","6207雷科","110/07/09","元大-高雄",26,0,26
"15278","6207雷科","110/07/09","華南永昌-古亭",0,14,-14
"15279","6207雷科","110/07/09","統一-員林",22,0,22
"15280","6207雷科","110/07/09","土銀-白河",0,11,-11
"15281","6207雷科","110/07/09","台新-高雄",22,0,22
"15282","6207雷科","110/07/09","日盛-台南",0,10,-10
"15283","6207雷科","110/07/09","摩根大通",34,17,17
"15284","6207雷科","110/07/09","元富-林園",0,10,-10
"15285","6207雷科","110/07/09","元大-博愛",17,1,16
"15286","6207雷科","110/07/09","富邦-園區",0,10,-10
"15287","6207雷科","110/07/09","日茂-埔里",12,0,12
"15288","6207雷科","110/07/09","元大-上新莊",0,10,-10
"15289","6207雷科","110/07/09","國泰-台中",17,6,11
"15290","6207雷科","110/07/09","永豐金-南京",0,10,-10
"15291","6207雷科","110/07/09","富邦-三重",10,0,10
"15292","6207雷科","110/07/09","兆豐-小港",0,6,-6
"15293","6207雷科","110/07/09","元大-沙鹿",10,0,10
"15294","6207雷科","110/07/09","富邦-羅東",1,7,-6
"15295","6207雷科","110/07/09","元大-八德",10,0,10
"15296","6207雷科","110/07/09","元大-土城永寧",0,6,-6
"15297","6207雷科","110/07/09","第一金-路竹",11,2,9
"15298","6207雷科","110/07/09","永豐金-板盛",0,6,-6
"15299","6207雷科","110/07/09","統一-南京",5,0,5
"15300","6207雷科","110/07/09","日盛-板橋",0,5,-5
"15301","3679新至陞","110/07/09","元大-大天母",10,0,10
"15302","3679新至陞","110/07/09","第一金-光復",0,11,-11
"15303","3679新至陞","110/07/09","日盛-樹林",9,0,9
"15304","3679新至陞","110/07/09","瑞士信貸",0,8,-8
"15305","3679新至陞","110/07/09","凱基-台北",11,2,9
"15306","3679新至陞","110/07/09","大慶-苗栗",0,5,-5
"15307","3679新至陞","110/07/09","華南永昌-小港",8,0,8
"15308","3679新至陞","110/07/09","元大-永春",0,5,-5
"15309","3679新至陞","110/07/09","兆豐-來福",7,0,7
"15310","3679新至陞","110/07/09","日盛-和美",0,4,-4
"15311","3679新至陞","110/07/09","香港上海匯豐",5,0,5
"15312","3679新至陞","110/07/09","元大-雙和",0,3,-3
"15313","3679新至陞","110/07/09","台中銀-員林",3,0,3
"15314","3679新至陞","110/07/09","永豐金-屏東",0,3,-3
"15315","3679新至陞","110/07/09","新光",3,0,3
"15316","3679新至陞","110/07/09","彰銀",0,2,-2
"15317","3679新至陞","110/07/09","土銀-花蓮",2,0,2
"15318","3679新至陞","110/07/09","宏遠-館前",0,2,-2
"15319","3679新至陞","110/07/09","第一金-澎湖",2,0,2
"15320","3679新至陞","110/07/09","港商野村",0,2,-2
"15321","3679新至陞","110/07/09","摩根大通",2,0,2
"15322","3679新至陞","110/07/09","大昌-新店",0,2,-2
"15323","3679新至陞","110/07/09","國泰-敦南",2,0,2
"15324","3679新至陞","110/07/09","元大-新莊",0,2,-2
"15325","3679新至陞","110/07/09","元大-淡水",4,2,2
"15326","3679新至陞","110/07/09","元大-板橋",0,2,-2
"15327","3679新至陞","110/07/09","日盛-士林",1,0,1
"15328","3679新至陞","110/07/09","台灣摩根士丹利",0,1,-1
"15329","3679新至陞","110/07/09","日盛-信義",1,0,1
"15330","3679新至陞","110/07/09","第一金-高雄",0,1,-1
"15331","2727王品","110/07/09","台灣匯立證券",90,0,90
"15332","2727王品","110/07/09","台灣摩根士丹利",0,267,-267
"15333","2727王品","110/07/09","國泰-敦南",166,84,82
"15334","2727王品","110/07/09","富邦-台北",35,299,-264
"15335","2727王品","110/07/09","富邦-仁愛",56,12,44
"15336","2727王品","110/07/09","凱基-台北",174,296,-122
"15337","2727王品","110/07/09","台新證券",109,66,43
"15338","2727王品","110/07/09","第一金",2,102,-100
"15339","2727王品","110/07/09","新光",117,87,30
"15340","2727王品","110/07/09","群益金鼎-大安",0,80,-80
"15341","2727王品","110/07/09","臺銀-臺中",35,6,29
"15342","2727王品","110/07/09","兆豐-大安",7,60,-53
"15343","2727王品","110/07/09","元大-桃園",32,3,29
"15344","2727王品","110/07/09","永豐金-南投",0,50,-50
"15345","2727王品","110/07/09","元富-宜蘭",34,6,28
"15346","2727王品","110/07/09","新加坡商瑞銀",6,46,-40
"15347","2727王品","110/07/09","玉山-台中",34,8,26
"15348","2727王品","110/07/09","合庫-彰化",11,50,-39
"15349","2727王品","110/07/09","群益金鼎-宜蘭",30,4,26
"15350","2727王品","110/07/09","永豐金-萬盛",13,52,-39
"15351","2727王品","110/07/09","富邦-台中",42,16,26
"15352","2727王品","110/07/09","瑞士信貸",0,34,-34
"15353","2727王品","110/07/09","第一金-豐原",25,1,24
"15354","2727王品","110/07/09","元大-和平",4,35,-31
"15355","2727王品","110/07/09","臺銀",30,8,22
"15356","2727王品","110/07/09","美林",14,44,-30
"15357","2727王品","110/07/09","兆豐-來福",23,1,22
"15358","2727王品","110/07/09","元大-員林",9,38,-29
"15359","2727王品","110/07/09","玉山-士林",22,2,20
"15360","2727王品","110/07/09","元富-西松",4,31,-27
"15361","1570力肯","110/07/09","凱基-台北",30,1,29
"15362","1570力肯","110/07/09","群益金鼎-彰化",0,20,-20
"15363","1570力肯","110/07/09","新光-台南",20,0,20
"15364","1570力肯","110/07/09","元大-土城學府",0,20,-20
"15365","1570力肯","110/07/09","元大-高雄",20,0,20
"15366","1570力肯","110/07/09","元大-大統",0,16,-16
"15367","1570力肯","110/07/09","國票-中正",12,0,12
"15368","1570力肯","110/07/09","元大-新營",0,11,-11
"15369","1570力肯","110/07/09","日盛-高雄",6,0,6
"15370","1570力肯","110/07/09","元大-和平",0,10,-10
"15371","1570力肯","110/07/09","元富-緯城",6,0,6
"15372","1570力肯","110/07/09","元大-草屯",0,10,-10
"15373","1570力肯","110/07/09","群益金鼎-台南",6,0,6
"15374","1570力肯","110/07/09","元大-鹿港",0,9,-9
"15375","1570力肯","110/07/09","華南永昌-岡山",6,0,6
"15376","1570力肯","110/07/09","合庫-基隆",0,7,-7
"15377","1570力肯","110/07/09","統一-中壢",5,0,5
"15378","1570力肯","110/07/09","摩根大通",2,8,-6
"15379","1570力肯","110/07/09","凱基-三峽",5,0,5
"15380","1570力肯","110/07/09","台灣企銀-豐原",0,4,-4
"15381","1570力肯","110/07/09","大昌-樹林",4,0,4
"15382","1570力肯","110/07/09","日盛-桃園",0,4,-4
"15383","1570力肯","110/07/09","新光",3,0,3
"15384","1570力肯","110/07/09","國泰-高雄",0,3,-3
"15385","1570力肯","110/07/09","富邦-新竹華信",3,0,3
"15386","1570力肯","110/07/09","永豐金-敦南",0,3,-3
"15387","1570力肯","110/07/09","合庫-台中",2,0,2
"15388","1570力肯","110/07/09","土銀-彰化",0,2,-2
"15389","1570力肯","110/07/09","臺銀-臺中",2,0,2
"15390","1570力肯","110/07/09","臺銀-鳳山",0,2,-2
"15391","6180橘子","110/07/09","摩根大通",63,1,62
"15392","6180橘子","110/07/09","元大-南京",1,32,-31
"15393","6180橘子","110/07/09","富邦-陽明",73,33,40
"15394","6180橘子","110/07/09","群益金鼎-台北",0,25,-25
"15395","6180橘子","110/07/09","新加坡商瑞銀",31,0,31
"15396","6180橘子","110/07/09","兆豐-復興",0,21,-21
"15397","6180橘子","110/07/09","美商高盛",25,0,25
"15398","6180橘子","110/07/09","永豐金-嘉義",0,21,-21
"15399","6180橘子","110/07/09","凱基-台北",26,10,16
"15400","6180橘子","110/07/09","凱基-中壢",8,24,-16
"15401","6180橘子","110/07/09","華南永昌-楠梓",13,0,13
"15402","6180橘子","110/07/09","致和-崇德",0,15,-15
"15403","6180橘子","110/07/09","華南永昌-朴子",11,0,11
"15404","6180橘子","110/07/09","群益金鼎-屏東",0,15,-15
"15405","6180橘子","110/07/09","元大-北港",11,0,11
"15406","6180橘子","110/07/09","群益金鼎-中山",0,15,-15
"15407","6180橘子","110/07/09","元大-成功",10,1,9
"15408","6180橘子","110/07/09","瑞士信貸",1,15,-14
"15409","6180橘子","110/07/09","新光",26,18,8
"15410","6180橘子","110/07/09","日盛-二林",0,10,-10
"15411","6180橘子","110/07/09","統一-三重",6,0,6
"15412","6180橘子","110/07/09","凱基-東門",0,10,-10
"15413","6180橘子","110/07/09","群益金鼎-嘉義",6,0,6
"15414","6180橘子","110/07/09","華南永昌-三重",0,10,-10
"15415","6180橘子","110/07/09","元大-員林中山",6,0,6
"15416","6180橘子","110/07/09","元大-彰化民生",1,11,-10
"15417","6180橘子","110/07/09","合庫-鳳山",5,0,5
"15418","6180橘子","110/07/09","永豐金-新店",1,11,-10
"15419","6180橘子","110/07/09","富邦-建國",6,1,5
"15420","6180橘子","110/07/09","群益金鼎-丹鳳",0,8,-8
"15421","2390云辰","110/07/09","摩根大通",279,56,223
"15422","2390云辰","110/07/09","元大-天母",0,127,-127
"15423","2390云辰","110/07/09","日盛-鳳山",110,2,108
"15424","2390云辰","110/07/09","中國信託-文心",5,109,-104
"15425","2390云辰","110/07/09","宏遠證券",100,0,100
"15426","2390云辰","110/07/09","永豐金-復興",0,55,-55
"15427","2390云辰","110/07/09","元大-大里",63,6,57
"15428","2390云辰","110/07/09","凱基-台北",239,286,-47
"15429","2390云辰","110/07/09","凱基-八德",59,10,49
"15430","2390云辰","110/07/09","德信",2,32,-30
"15431","2390云辰","110/07/09","合庫-新竹",40,0,40
"15432","2390云辰","110/07/09","兆豐-桃鶯",2,32,-30
"15433","2390云辰","110/07/09","國票",40,1,39
"15434","2390云辰","110/07/09","致和-南京",0,30,-30
"15435","2390云辰","110/07/09","新加坡商瑞銀",49,13,36
"15436","2390云辰","110/07/09","富邦-虎尾",1,31,-30
"15437","2390云辰","110/07/09","統一-新台中",36,2,34
"15438","2390云辰","110/07/09","元大-善化",2,31,-29
"15439","2390云辰","110/07/09","國票-嘉義",31,0,31
"15440","2390云辰","110/07/09","富邦-板橋",0,27,-27
"15441","2390云辰","110/07/09","華南永昌",35,7,28
"15442","2390云辰","110/07/09","富邦-永和",3,28,-25
"15443","2390云辰","110/07/09","玉山-台中",49,22,27
"15444","2390云辰","110/07/09","第一金-自由",20,44,-24
"15445","2390云辰","110/07/09","華南永昌-敦南",25,0,25
"15446","2390云辰","110/07/09","凱基-內湖",0,24,-24
"15447","2390云辰","110/07/09","新光-高雄",27,4,23
"15448","2390云辰","110/07/09","元大-汐止",1,24,-23
"15449","2390云辰","110/07/09","台灣摩根士丹利",85,63,22
"15450","2390云辰","110/07/09","新光-台中",12,33,-21
"15451","4903聯光通","110/07/09","元大-敦南",10,0,10
"15452","4903聯光通","110/07/09","第一金-台中",0,12,-12
"15453","4903聯光通","110/07/09","凱基-士林",5,0,5
"15454","4903聯光通","110/07/09","日盛-忠孝",0,3,-3
"15455","4903聯光通","110/07/09","元大-苗栗",5,0,5
"15456","4903聯光通","110/07/09","群益金鼎-崇德",0,3,-3
"15457","4903聯光通","110/07/09","元大-屏南",3,0,3
"15458","4903聯光通","110/07/09","國票-內壢",0,2,-2
"15459","4903聯光通","110/07/09","中國信託-永康",1,0,1
"15460","4903聯光通","110/07/09","康和-南崁",0,2,-2
"15461","4903聯光通","110/07/09","玉山證券",1,0,1
"15462","4903聯光通","110/07/09","新光-台中",0,2,-2
"15463","4903聯光通","110/07/09","元大-太平",4,3,1
"15464","4903聯光通","110/07/09","玉山-城中",0,2,-2
"15465","4903聯光通","110/07/09","永豐金-嘉義",1,0,1
"15466","4903聯光通","110/07/09","中國信託-文心",0,1,-1
"15467","4903聯光通","110/07/09","大昌",0,0,0
"15468","4903聯光通","110/07/09","大昌",0,0,0
"15469","4903聯光通","110/07/09","中農",0,0,0
"15470","4903聯光通","110/07/09","中農",0,0,0
"15471","4903聯光通","110/07/09","",NA,NA,NA
"15472","4903聯光通","110/07/09","",NA,NA,NA
"15473","4903聯光通","110/07/09","",NA,NA,NA
"15474","4903聯光通","110/07/09","",NA,NA,NA
"15475","4903聯光通","110/07/09","",NA,NA,NA
"15476","4903聯光通","110/07/09","",NA,NA,NA
"15477","4903聯光通","110/07/09","",NA,NA,NA
"15478","4903聯光通","110/07/09","",NA,NA,NA
"15479","4903聯光通","110/07/09","",NA,NA,NA
"15480","4903聯光通","110/07/09","",NA,NA,NA
"15481","2929淘帝","110/07/09","台中銀-台北",110,0,110
"15482","2929淘帝","110/07/09","新光",2,82,-80
"15483","2929淘帝","110/07/09","華南永昌-頭份",72,0,72
"15484","2929淘帝","110/07/09","摩根大通",2,63,-61
"15485","2929淘帝","110/07/09","合庫-高雄",71,0,71
"15486","2929淘帝","110/07/09","第一金-路竹",0,50,-50
"15487","2929淘帝","110/07/09","高橋-龍潭",37,0,37
"15488","2929淘帝","110/07/09","港商麥格理",0,42,-42
"15489","2929淘帝","110/07/09","新光-台中",60,26,34
"15490","2929淘帝","110/07/09","陽信-石牌",0,40,-40
"15491","2929淘帝","110/07/09","元富-大裕",22,1,21
"15492","2929淘帝","110/07/09","台新-左楠",1,39,-38
"15493","2929淘帝","110/07/09","合庫-鳳山",20,0,20
"15494","2929淘帝","110/07/09","凱基-桃園",3,29,-26
"15495","2929淘帝","110/07/09","元大-員林",22,2,20
"15496","2929淘帝","110/07/09","兆豐-內湖",0,25,-25
"15497","2929淘帝","110/07/09","台新-建北",15,0,15
"15498","2929淘帝","110/07/09","元大-北港",0,20,-20
"15499","2929淘帝","110/07/09","兆豐-桃園",13,0,13
"15500","2929淘帝","110/07/09","富邦-北港",0,19,-19
"15501","2929淘帝","110/07/09","兆豐-忠孝",10,0,10
"15502","2929淘帝","110/07/09","富邦-花蓮",0,17,-17
"15503","2929淘帝","110/07/09","國票-敦北法人",10,0,10
"15504","2929淘帝","110/07/09","國泰-台中",2,17,-15
"15505","2929淘帝","110/07/09","永豐金-博愛",10,0,10
"15506","2929淘帝","110/07/09","群益金鼎-彰化",0,15,-15
"15507","2929淘帝","110/07/09","群益金鼎-潭子",8,0,8
"15508","2929淘帝","110/07/09","元大-博愛",0,14,-14
"15509","2929淘帝","110/07/09","富邦-南屯",8,0,8
"15510","2929淘帝","110/07/09","日盛-板橋",0,13,-13
"15511","5410國眾","110/07/09","元大-新盛",14,0,14
"15512","5410國眾","110/07/09","(牛牛牛)亞-鑫豐",1,41,-40
"15513","5410國眾","110/07/09","台灣企銀-民雄",10,0,10
"15514","5410國眾","110/07/09","元富-嘉義",0,25,-25
"15515","5410國眾","110/07/09","元富-虎尾",9,0,9
"15516","5410國眾","110/07/09","凱基-高美館",0,10,-10
"15517","5410國眾","110/07/09","摩根大通",10,1,9
"15518","5410國眾","110/07/09","凱基-城中",0,10,-10
"15519","5410國眾","110/07/09","兆豐-北高雄",7,0,7
"15520","5410國眾","110/07/09","元大-頭份",0,10,-10
"15521","5410國眾","110/07/09","凱基-台北",8,1,7
"15522","5410國眾","110/07/09","群益金鼎-丹鳳",0,7,-7
"15523","5410國眾","110/07/09","華南永昌-公誠",7,0,7
"15524","5410國眾","110/07/09","凱基-復興",0,7,-7
"15525","5410國眾","110/07/09","香港上海匯豐",6,0,6
"15526","5410國眾","110/07/09","元大-員林",0,7,-7
"15527","5410國眾","110/07/09","凱基-中壢",6,0,6
"15528","5410國眾","110/07/09","富邦-竹東",0,6,-6
"15529","5410國眾","110/07/09","華南永昌-南京",6,0,6
"15530","5410國眾","110/07/09","亞東-高雄",0,5,-5
"15531","5410國眾","110/07/09","統一-三重",5,0,5
"15532","5410國眾","110/07/09","大慶-中壢",1,6,-5
"15533","5410國眾","110/07/09","富邦-宜蘭",5,0,5
"15534","5410國眾","110/07/09","群益金鼎-中港",0,5,-5
"15535","5410國眾","110/07/09","元大-崇德",5,0,5
"15536","5410國眾","110/07/09","元大-八德",0,5,-5
"15537","5410國眾","110/07/09","元大-博愛",5,0,5
"15538","5410國眾","110/07/09","富邦-基隆",0,4,-4
"15539","5410國眾","110/07/09","元大-龍潭",5,0,5
"15540","5410國眾","110/07/09","臺銀-新竹",0,3,-3
"15541","2841台開","110/07/09","日盛-雙和",102,0,102
"15542","2841台開","110/07/09","港商野村",0,129,-129
"15543","2841台開","110/07/09","元大-館前",70,0,70
"15544","2841台開","110/07/09","兆豐-永和",0,100,-100
"15545","2841台開","110/07/09","凱基-文心",50,0,50
"15546","2841台開","110/07/09","台新證券",7,28,-21
"15547","2841台開","110/07/09","富邦-嘉義",40,0,40
"15548","2841台開","110/07/09","國票-北高雄",0,20,-20
"15549","2841台開","110/07/09","美商高盛",15,0,15
"15550","2841台開","110/07/09","永豐金-敦南",29,46,-17
"15551","2841台開","110/07/09","台中銀",15,0,15
"15552","2841台開","110/07/09","合庫-基隆",0,12,-12
"15553","2841台開","110/07/09","新光",11,0,11
"15554","2841台開","110/07/09","中國信託-松江",0,12,-12
"15555","2841台開","110/07/09","華南永昌-長虹",10,0,10
"15556","2841台開","110/07/09","兆豐-城中",0,12,-12
"15557","2841台開","110/07/09","永豐金-南投",10,0,10
"15558","2841台開","110/07/09","台中銀-豐原",0,10,-10
"15559","2841台開","110/07/09","合庫-桃園",7,0,7
"15560","2841台開","110/07/09","兆豐-景美",0,10,-10
"15561","2841台開","110/07/09","群益金鼎-古亭",7,0,7
"15562","2841台開","110/07/09","群益金鼎-基隆",0,10,-10
"15563","2841台開","110/07/09","國泰-敦南",6,0,6
"15564","2841台開","110/07/09","元大-北三重",0,10,-10
"15565","2841台開","110/07/09","凱基-桃園",8,2,6
"15566","2841台開","110/07/09","(牛牛牛)亞-網路",0,9,-9
"15567","2841台開","110/07/09","日盛證券",5,0,5
"15568","2841台開","110/07/09","台新-高雄",1,10,-9
"15569","2841台開","110/07/09","元富-文心",5,0,5
"15570","2841台開","110/07/09","凱基-台北",0,7,-7
"15571","6207雷科","110/07/09","群益金鼎-新竹",47,0,47
"15572","6207雷科","110/07/09","新光",7,24,-17
"15573","6207雷科","110/07/09","永豐金-三重",31,0,31
"15574","6207雷科","110/07/09","日盛-和美",0,15,-15
"15575","6207雷科","110/07/09","新加坡商瑞銀",33,5,28
"15576","6207雷科","110/07/09","國泰-台南",0,15,-15
"15577","6207雷科","110/07/09","元大-高雄",26,0,26
"15578","6207雷科","110/07/09","華南永昌-古亭",0,14,-14
"15579","6207雷科","110/07/09","統一-員林",22,0,22
"15580","6207雷科","110/07/09","土銀-白河",0,11,-11
"15581","6207雷科","110/07/09","台新-高雄",22,0,22
"15582","6207雷科","110/07/09","日盛-台南",0,10,-10
"15583","6207雷科","110/07/09","摩根大通",34,17,17
"15584","6207雷科","110/07/09","元富-林園",0,10,-10
"15585","6207雷科","110/07/09","元大-博愛",17,1,16
"15586","6207雷科","110/07/09","富邦-園區",0,10,-10
"15587","6207雷科","110/07/09","日茂-埔里",12,0,12
"15588","6207雷科","110/07/09","元大-上新莊",0,10,-10
"15589","6207雷科","110/07/09","國泰-台中",17,6,11
"15590","6207雷科","110/07/09","永豐金-南京",0,10,-10
"15591","6207雷科","110/07/09","富邦-三重",10,0,10
"15592","6207雷科","110/07/09","兆豐-小港",0,6,-6
"15593","6207雷科","110/07/09","元大-沙鹿",10,0,10
"15594","6207雷科","110/07/09","富邦-羅東",1,7,-6
"15595","6207雷科","110/07/09","元大-八德",10,0,10
"15596","6207雷科","110/07/09","元大-土城永寧",0,6,-6
"15597","6207雷科","110/07/09","第一金-路竹",11,2,9
"15598","6207雷科","110/07/09","永豐金-板盛",0,6,-6
"15599","6207雷科","110/07/09","統一-南京",5,0,5
"15600","6207雷科","110/07/09","日盛-板橋",0,5,-5
"15601","3679新至陞","110/07/09","元大-大天母",10,0,10
"15602","3679新至陞","110/07/09","第一金-光復",0,11,-11
"15603","3679新至陞","110/07/09","日盛-樹林",9,0,9
"15604","3679新至陞","110/07/09","瑞士信貸",0,8,-8
"15605","3679新至陞","110/07/09","凱基-台北",11,2,9
"15606","3679新至陞","110/07/09","大慶-苗栗",0,5,-5
"15607","3679新至陞","110/07/09","華南永昌-小港",8,0,8
"15608","3679新至陞","110/07/09","元大-永春",0,5,-5
"15609","3679新至陞","110/07/09","兆豐-來福",7,0,7
"15610","3679新至陞","110/07/09","日盛-和美",0,4,-4
"15611","3679新至陞","110/07/09","香港上海匯豐",5,0,5
"15612","3679新至陞","110/07/09","元大-雙和",0,3,-3
"15613","3679新至陞","110/07/09","台中銀-員林",3,0,3
"15614","3679新至陞","110/07/09","永豐金-屏東",0,3,-3
"15615","3679新至陞","110/07/09","新光",3,0,3
"15616","3679新至陞","110/07/09","彰銀",0,2,-2
"15617","3679新至陞","110/07/09","土銀-花蓮",2,0,2
"15618","3679新至陞","110/07/09","宏遠-館前",0,2,-2
"15619","3679新至陞","110/07/09","第一金-澎湖",2,0,2
"15620","3679新至陞","110/07/09","港商野村",0,2,-2
"15621","3679新至陞","110/07/09","摩根大通",2,0,2
"15622","3679新至陞","110/07/09","大昌-新店",0,2,-2
"15623","3679新至陞","110/07/09","國泰-敦南",2,0,2
"15624","3679新至陞","110/07/09","元大-新莊",0,2,-2
"15625","3679新至陞","110/07/09","元大-淡水",4,2,2
"15626","3679新至陞","110/07/09","元大-板橋",0,2,-2
"15627","3679新至陞","110/07/09","日盛-士林",1,0,1
"15628","3679新至陞","110/07/09","台灣摩根士丹利",0,1,-1
"15629","3679新至陞","110/07/09","日盛-信義",1,0,1
"15630","3679新至陞","110/07/09","第一金-高雄",0,1,-1
"15631","2727王品","110/07/09","台灣匯立證券",90,0,90
"15632","2727王品","110/07/09","台灣摩根士丹利",0,267,-267
"15633","2727王品","110/07/09","國泰-敦南",166,84,82
"15634","2727王品","110/07/09","富邦-台北",35,299,-264
"15635","2727王品","110/07/09","富邦-仁愛",56,12,44
"15636","2727王品","110/07/09","凱基-台北",174,296,-122
"15637","2727王品","110/07/09","台新證券",109,66,43
"15638","2727王品","110/07/09","第一金",2,102,-100
"15639","2727王品","110/07/09","新光",117,87,30
"15640","2727王品","110/07/09","群益金鼎-大安",0,80,-80
"15641","2727王品","110/07/09","臺銀-臺中",35,6,29
"15642","2727王品","110/07/09","兆豐-大安",7,60,-53
"15643","2727王品","110/07/09","元大-桃園",32,3,29
"15644","2727王品","110/07/09","永豐金-南投",0,50,-50
"15645","2727王品","110/07/09","元富-宜蘭",34,6,28
"15646","2727王品","110/07/09","新加坡商瑞銀",6,46,-40
"15647","2727王品","110/07/09","玉山-台中",34,8,26
"15648","2727王品","110/07/09","合庫-彰化",11,50,-39
"15649","2727王品","110/07/09","群益金鼎-宜蘭",30,4,26
"15650","2727王品","110/07/09","永豐金-萬盛",13,52,-39
"15651","2727王品","110/07/09","富邦-台中",42,16,26
"15652","2727王品","110/07/09","瑞士信貸",0,34,-34
"15653","2727王品","110/07/09","第一金-豐原",25,1,24
"15654","2727王品","110/07/09","元大-和平",4,35,-31
"15655","2727王品","110/07/09","臺銀",30,8,22
"15656","2727王品","110/07/09","美林",14,44,-30
"15657","2727王品","110/07/09","兆豐-來福",23,1,22
"15658","2727王品","110/07/09","元大-員林",9,38,-29
"15659","2727王品","110/07/09","玉山-士林",22,2,20
"15660","2727王品","110/07/09","元富-西松",4,31,-27
"15661","1570力肯","110/07/09","凱基-台北",30,1,29
"15662","1570力肯","110/07/09","群益金鼎-彰化",0,20,-20
"15663","1570力肯","110/07/09","新光-台南",20,0,20
"15664","1570力肯","110/07/09","元大-土城學府",0,20,-20
"15665","1570力肯","110/07/09","元大-高雄",20,0,20
"15666","1570力肯","110/07/09","元大-大統",0,16,-16
"15667","1570力肯","110/07/09","國票-中正",12,0,12
"15668","1570力肯","110/07/09","元大-新營",0,11,-11
"15669","1570力肯","110/07/09","日盛-高雄",6,0,6
"15670","1570力肯","110/07/09","元大-和平",0,10,-10
"15671","1570力肯","110/07/09","元富-緯城",6,0,6
"15672","1570力肯","110/07/09","元大-草屯",0,10,-10
"15673","1570力肯","110/07/09","群益金鼎-台南",6,0,6
"15674","1570力肯","110/07/09","元大-鹿港",0,9,-9
"15675","1570力肯","110/07/09","華南永昌-岡山",6,0,6
"15676","1570力肯","110/07/09","合庫-基隆",0,7,-7
"15677","1570力肯","110/07/09","統一-中壢",5,0,5
"15678","1570力肯","110/07/09","摩根大通",2,8,-6
"15679","1570力肯","110/07/09","凱基-三峽",5,0,5
"15680","1570力肯","110/07/09","台灣企銀-豐原",0,4,-4
"15681","1570力肯","110/07/09","大昌-樹林",4,0,4
"15682","1570力肯","110/07/09","日盛-桃園",0,4,-4
"15683","1570力肯","110/07/09","新光",3,0,3
"15684","1570力肯","110/07/09","國泰-高雄",0,3,-3
"15685","1570力肯","110/07/09","富邦-新竹華信",3,0,3
"15686","1570力肯","110/07/09","永豐金-敦南",0,3,-3
"15687","1570力肯","110/07/09","合庫-台中",2,0,2
"15688","1570力肯","110/07/09","土銀-彰化",0,2,-2
"15689","1570力肯","110/07/09","臺銀-臺中",2,0,2
"15690","1570力肯","110/07/09","臺銀-鳳山",0,2,-2
"15691","6180橘子","110/07/09","摩根大通",63,1,62
"15692","6180橘子","110/07/09","元大-南京",1,32,-31
"15693","6180橘子","110/07/09","富邦-陽明",73,33,40
"15694","6180橘子","110/07/09","群益金鼎-台北",0,25,-25
"15695","6180橘子","110/07/09","新加坡商瑞銀",31,0,31
"15696","6180橘子","110/07/09","兆豐-復興",0,21,-21
"15697","6180橘子","110/07/09","美商高盛",25,0,25
"15698","6180橘子","110/07/09","永豐金-嘉義",0,21,-21
"15699","6180橘子","110/07/09","凱基-台北",26,10,16
"15700","6180橘子","110/07/09","凱基-中壢",8,24,-16
"15701","6180橘子","110/07/09","華南永昌-楠梓",13,0,13
"15702","6180橘子","110/07/09","致和-崇德",0,15,-15
"15703","6180橘子","110/07/09","華南永昌-朴子",11,0,11
"15704","6180橘子","110/07/09","群益金鼎-屏東",0,15,-15
"15705","6180橘子","110/07/09","元大-北港",11,0,11
"15706","6180橘子","110/07/09","群益金鼎-中山",0,15,-15
"15707","6180橘子","110/07/09","元大-成功",10,1,9
"15708","6180橘子","110/07/09","瑞士信貸",1,15,-14
"15709","6180橘子","110/07/09","新光",26,18,8
"15710","6180橘子","110/07/09","日盛-二林",0,10,-10
"15711","6180橘子","110/07/09","統一-三重",6,0,6
"15712","6180橘子","110/07/09","凱基-東門",0,10,-10
"15713","6180橘子","110/07/09","群益金鼎-嘉義",6,0,6
"15714","6180橘子","110/07/09","華南永昌-三重",0,10,-10
"15715","6180橘子","110/07/09","元大-員林中山",6,0,6
"15716","6180橘子","110/07/09","元大-彰化民生",1,11,-10
"15717","6180橘子","110/07/09","合庫-鳳山",5,0,5
"15718","6180橘子","110/07/09","永豐金-新店",1,11,-10
"15719","6180橘子","110/07/09","富邦-建國",6,1,5
"15720","6180橘子","110/07/09","群益金鼎-丹鳳",0,8,-8
"15721","2390云辰","110/07/09","摩根大通",279,56,223
"15722","2390云辰","110/07/09","元大-天母",0,127,-127
"15723","2390云辰","110/07/09","日盛-鳳山",110,2,108
"15724","2390云辰","110/07/09","中國信託-文心",5,109,-104
"15725","2390云辰","110/07/09","宏遠證券",100,0,100
"15726","2390云辰","110/07/09","永豐金-復興",0,55,-55
"15727","2390云辰","110/07/09","元大-大里",63,6,57
"15728","2390云辰","110/07/09","凱基-台北",239,286,-47
"15729","2390云辰","110/07/09","凱基-八德",59,10,49
"15730","2390云辰","110/07/09","德信",2,32,-30
"15731","2390云辰","110/07/09","合庫-新竹",40,0,40
"15732","2390云辰","110/07/09","兆豐-桃鶯",2,32,-30
"15733","2390云辰","110/07/09","國票",40,1,39
"15734","2390云辰","110/07/09","致和-南京",0,30,-30
"15735","2390云辰","110/07/09","新加坡商瑞銀",49,13,36
"15736","2390云辰","110/07/09","富邦-虎尾",1,31,-30
"15737","2390云辰","110/07/09","統一-新台中",36,2,34
"15738","2390云辰","110/07/09","元大-善化",2,31,-29
"15739","2390云辰","110/07/09","國票-嘉義",31,0,31
"15740","2390云辰","110/07/09","富邦-板橋",0,27,-27
"15741","2390云辰","110/07/09","華南永昌",35,7,28
"15742","2390云辰","110/07/09","富邦-永和",3,28,-25
"15743","2390云辰","110/07/09","玉山-台中",49,22,27
"15744","2390云辰","110/07/09","第一金-自由",20,44,-24
"15745","2390云辰","110/07/09","華南永昌-敦南",25,0,25
"15746","2390云辰","110/07/09","凱基-內湖",0,24,-24
"15747","2390云辰","110/07/09","新光-高雄",27,4,23
"15748","2390云辰","110/07/09","元大-汐止",1,24,-23
"15749","2390云辰","110/07/09","台灣摩根士丹利",85,63,22
"15750","2390云辰","110/07/09","新光-台中",12,33,-21
"15751","4903聯光通","110/07/09","元大-敦南",10,0,10
"15752","4903聯光通","110/07/09","第一金-台中",0,12,-12
"15753","4903聯光通","110/07/09","凱基-士林",5,0,5
"15754","4903聯光通","110/07/09","日盛-忠孝",0,3,-3
"15755","4903聯光通","110/07/09","元大-苗栗",5,0,5
"15756","4903聯光通","110/07/09","群益金鼎-崇德",0,3,-3
"15757","4903聯光通","110/07/09","元大-屏南",3,0,3
"15758","4903聯光通","110/07/09","國票-內壢",0,2,-2
"15759","4903聯光通","110/07/09","中國信託-永康",1,0,1
"15760","4903聯光通","110/07/09","康和-南崁",0,2,-2
"15761","4903聯光通","110/07/09","玉山證券",1,0,1
"15762","4903聯光通","110/07/09","新光-台中",0,2,-2
"15763","4903聯光通","110/07/09","元大-太平",4,3,1
"15764","4903聯光通","110/07/09","玉山-城中",0,2,-2
"15765","4903聯光通","110/07/09","永豐金-嘉義",1,0,1
"15766","4903聯光通","110/07/09","中國信託-文心",0,1,-1
"15767","4903聯光通","110/07/09","大昌",0,0,0
"15768","4903聯光通","110/07/09","大昌",0,0,0
"15769","4903聯光通","110/07/09","中農",0,0,0
"15770","4903聯光通","110/07/09","中農",0,0,0
"15771","4903聯光通","110/07/09","",NA,NA,NA
"15772","4903聯光通","110/07/09","",NA,NA,NA
"15773","4903聯光通","110/07/09","",NA,NA,NA
"15774","4903聯光通","110/07/09","",NA,NA,NA
"15775","4903聯光通","110/07/09","",NA,NA,NA
"15776","4903聯光通","110/07/09","",NA,NA,NA
"15777","4903聯光通","110/07/09","",NA,NA,NA
"15778","4903聯光通","110/07/09","",NA,NA,NA
"15779","4903聯光通","110/07/09","",NA,NA,NA
"15780","4903聯光通","110/07/09","",NA,NA,NA
"15781","2929淘帝","110/07/09","台中銀-台北",110,0,110
"15782","2929淘帝","110/07/09","新光",2,82,-80
"15783","2929淘帝","110/07/09","華南永昌-頭份",72,0,72
"15784","2929淘帝","110/07/09","摩根大通",2,63,-61
"15785","2929淘帝","110/07/09","合庫-高雄",71,0,71
"15786","2929淘帝","110/07/09","第一金-路竹",0,50,-50
"15787","2929淘帝","110/07/09","高橋-龍潭",37,0,37
"15788","2929淘帝","110/07/09","港商麥格理",0,42,-42
"15789","2929淘帝","110/07/09","新光-台中",60,26,34
"15790","2929淘帝","110/07/09","陽信-石牌",0,40,-40
"15791","2929淘帝","110/07/09","元富-大裕",22,1,21
"15792","2929淘帝","110/07/09","台新-左楠",1,39,-38
"15793","2929淘帝","110/07/09","合庫-鳳山",20,0,20
"15794","2929淘帝","110/07/09","凱基-桃園",3,29,-26
"15795","2929淘帝","110/07/09","元大-員林",22,2,20
"15796","2929淘帝","110/07/09","兆豐-內湖",0,25,-25
"15797","2929淘帝","110/07/09","台新-建北",15,0,15
"15798","2929淘帝","110/07/09","元大-北港",0,20,-20
"15799","2929淘帝","110/07/09","兆豐-桃園",13,0,13
"15800","2929淘帝","110/07/09","富邦-北港",0,19,-19
"15801","2929淘帝","110/07/09","兆豐-忠孝",10,0,10
"15802","2929淘帝","110/07/09","富邦-花蓮",0,17,-17
"15803","2929淘帝","110/07/09","國票-敦北法人",10,0,10
"15804","2929淘帝","110/07/09","國泰-台中",2,17,-15
"15805","2929淘帝","110/07/09","永豐金-博愛",10,0,10
"15806","2929淘帝","110/07/09","群益金鼎-彰化",0,15,-15
"15807","2929淘帝","110/07/09","群益金鼎-潭子",8,0,8
"15808","2929淘帝","110/07/09","元大-博愛",0,14,-14
"15809","2929淘帝","110/07/09","富邦-南屯",8,0,8
"15810","2929淘帝","110/07/09","日盛-板橋",0,13,-13
"15811","5410國眾","110/07/09","元大-新盛",14,0,14
"15812","5410國眾","110/07/09","(牛牛牛)亞-鑫豐",1,41,-40
"15813","5410國眾","110/07/09","台灣企銀-民雄",10,0,10
"15814","5410國眾","110/07/09","元富-嘉義",0,25,-25
"15815","5410國眾","110/07/09","元富-虎尾",9,0,9
"15816","5410國眾","110/07/09","凱基-高美館",0,10,-10
"15817","5410國眾","110/07/09","摩根大通",10,1,9
"15818","5410國眾","110/07/09","凱基-城中",0,10,-10
"15819","5410國眾","110/07/09","兆豐-北高雄",7,0,7
"15820","5410國眾","110/07/09","元大-頭份",0,10,-10
"15821","5410國眾","110/07/09","凱基-台北",8,1,7
"15822","5410國眾","110/07/09","群益金鼎-丹鳳",0,7,-7
"15823","5410國眾","110/07/09","華南永昌-公誠",7,0,7
"15824","5410國眾","110/07/09","凱基-復興",0,7,-7
"15825","5410國眾","110/07/09","香港上海匯豐",6,0,6
"15826","5410國眾","110/07/09","元大-員林",0,7,-7
"15827","5410國眾","110/07/09","凱基-中壢",6,0,6
"15828","5410國眾","110/07/09","富邦-竹東",0,6,-6
"15829","5410國眾","110/07/09","華南永昌-南京",6,0,6
"15830","5410國眾","110/07/09","亞東-高雄",0,5,-5
"15831","5410國眾","110/07/09","統一-三重",5,0,5
"15832","5410國眾","110/07/09","大慶-中壢",1,6,-5
"15833","5410國眾","110/07/09","富邦-宜蘭",5,0,5
"15834","5410國眾","110/07/09","群益金鼎-中港",0,5,-5
"15835","5410國眾","110/07/09","元大-崇德",5,0,5
"15836","5410國眾","110/07/09","元大-八德",0,5,-5
"15837","5410國眾","110/07/09","元大-博愛",5,0,5
"15838","5410國眾","110/07/09","富邦-基隆",0,4,-4
"15839","5410國眾","110/07/09","元大-龍潭",5,0,5
"15840","5410國眾","110/07/09","臺銀-新竹",0,3,-3
"15841","2841台開","110/07/09","日盛-雙和",102,0,102
"15842","2841台開","110/07/09","港商野村",0,129,-129
"15843","2841台開","110/07/09","元大-館前",70,0,70
"15844","2841台開","110/07/09","兆豐-永和",0,100,-100
"15845","2841台開","110/07/09","凱基-文心",50,0,50
"15846","2841台開","110/07/09","台新證券",7,28,-21
"15847","2841台開","110/07/09","富邦-嘉義",40,0,40
"15848","2841台開","110/07/09","國票-北高雄",0,20,-20
"15849","2841台開","110/07/09","美商高盛",15,0,15
"15850","2841台開","110/07/09","永豐金-敦南",29,46,-17
"15851","2841台開","110/07/09","台中銀",15,0,15
"15852","2841台開","110/07/09","合庫-基隆",0,12,-12
"15853","2841台開","110/07/09","新光",11,0,11
"15854","2841台開","110/07/09","中國信託-松江",0,12,-12
"15855","2841台開","110/07/09","華南永昌-長虹",10,0,10
"15856","2841台開","110/07/09","兆豐-城中",0,12,-12
"15857","2841台開","110/07/09","永豐金-南投",10,0,10
"15858","2841台開","110/07/09","台中銀-豐原",0,10,-10
"15859","2841台開","110/07/09","合庫-桃園",7,0,7
"15860","2841台開","110/07/09","兆豐-景美",0,10,-10
"15861","2841台開","110/07/09","群益金鼎-古亭",7,0,7
"15862","2841台開","110/07/09","群益金鼎-基隆",0,10,-10
"15863","2841台開","110/07/09","國泰-敦南",6,0,6
"15864","2841台開","110/07/09","元大-北三重",0,10,-10
"15865","2841台開","110/07/09","凱基-桃園",8,2,6
"15866","2841台開","110/07/09","(牛牛牛)亞-網路",0,9,-9
"15867","2841台開","110/07/09","日盛證券",5,0,5
"15868","2841台開","110/07/09","台新-高雄",1,10,-9
"15869","2841台開","110/07/09","元富-文心",5,0,5
"15870","2841台開","110/07/09","凱基-台北",0,7,-7
"15871","6207雷科","110/07/09","群益金鼎-新竹",47,0,47
"15872","6207雷科","110/07/09","新光",7,24,-17
"15873","6207雷科","110/07/09","永豐金-三重",31,0,31
"15874","6207雷科","110/07/09","日盛-和美",0,15,-15
"15875","6207雷科","110/07/09","新加坡商瑞銀",33,5,28
"15876","6207雷科","110/07/09","國泰-台南",0,15,-15
"15877","6207雷科","110/07/09","元大-高雄",26,0,26
"15878","6207雷科","110/07/09","華南永昌-古亭",0,14,-14
"15879","6207雷科","110/07/09","統一-員林",22,0,22
"15880","6207雷科","110/07/09","土銀-白河",0,11,-11
"15881","6207雷科","110/07/09","台新-高雄",22,0,22
"15882","6207雷科","110/07/09","日盛-台南",0,10,-10
"15883","6207雷科","110/07/09","摩根大通",34,17,17
"15884","6207雷科","110/07/09","元富-林園",0,10,-10
"15885","6207雷科","110/07/09","元大-博愛",17,1,16
"15886","6207雷科","110/07/09","富邦-園區",0,10,-10
"15887","6207雷科","110/07/09","日茂-埔里",12,0,12
"15888","6207雷科","110/07/09","元大-上新莊",0,10,-10
"15889","6207雷科","110/07/09","國泰-台中",17,6,11
"15890","6207雷科","110/07/09","永豐金-南京",0,10,-10
"15891","6207雷科","110/07/09","富邦-三重",10,0,10
"15892","6207雷科","110/07/09","兆豐-小港",0,6,-6
"15893","6207雷科","110/07/09","元大-沙鹿",10,0,10
"15894","6207雷科","110/07/09","富邦-羅東",1,7,-6
"15895","6207雷科","110/07/09","元大-八德",10,0,10
"15896","6207雷科","110/07/09","元大-土城永寧",0,6,-6
"15897","6207雷科","110/07/09","第一金-路竹",11,2,9
"15898","6207雷科","110/07/09","永豐金-板盛",0,6,-6
"15899","6207雷科","110/07/09","統一-南京",5,0,5
"15900","6207雷科","110/07/09","日盛-板橋",0,5,-5
"15901","3679新至陞","110/07/09","元大-大天母",10,0,10
"15902","3679新至陞","110/07/09","第一金-光復",0,11,-11
"15903","3679新至陞","110/07/09","日盛-樹林",9,0,9
"15904","3679新至陞","110/07/09","瑞士信貸",0,8,-8
"15905","3679新至陞","110/07/09","凱基-台北",11,2,9
"15906","3679新至陞","110/07/09","大慶-苗栗",0,5,-5
"15907","3679新至陞","110/07/09","華南永昌-小港",8,0,8
"15908","3679新至陞","110/07/09","元大-永春",0,5,-5
"15909","3679新至陞","110/07/09","兆豐-來福",7,0,7
"15910","3679新至陞","110/07/09","日盛-和美",0,4,-4
"15911","3679新至陞","110/07/09","香港上海匯豐",5,0,5
"15912","3679新至陞","110/07/09","元大-雙和",0,3,-3
"15913","3679新至陞","110/07/09","台中銀-員林",3,0,3
"15914","3679新至陞","110/07/09","永豐金-屏東",0,3,-3
"15915","3679新至陞","110/07/09","新光",3,0,3
"15916","3679新至陞","110/07/09","彰銀",0,2,-2
"15917","3679新至陞","110/07/09","土銀-花蓮",2,0,2
"15918","3679新至陞","110/07/09","宏遠-館前",0,2,-2
"15919","3679新至陞","110/07/09","第一金-澎湖",2,0,2
"15920","3679新至陞","110/07/09","港商野村",0,2,-2
"15921","3679新至陞","110/07/09","摩根大通",2,0,2
"15922","3679新至陞","110/07/09","大昌-新店",0,2,-2
"15923","3679新至陞","110/07/09","國泰-敦南",2,0,2
"15924","3679新至陞","110/07/09","元大-新莊",0,2,-2
"15925","3679新至陞","110/07/09","元大-淡水",4,2,2
"15926","3679新至陞","110/07/09","元大-板橋",0,2,-2
"15927","3679新至陞","110/07/09","日盛-士林",1,0,1
"15928","3679新至陞","110/07/09","台灣摩根士丹利",0,1,-1
"15929","3679新至陞","110/07/09","日盛-信義",1,0,1
"15930","3679新至陞","110/07/09","第一金-高雄",0,1,-1
"15931","2727王品","110/07/09","台灣匯立證券",90,0,90
"15932","2727王品","110/07/09","台灣摩根士丹利",0,267,-267
"15933","2727王品","110/07/09","國泰-敦南",166,84,82
"15934","2727王品","110/07/09","富邦-台北",35,299,-264
"15935","2727王品","110/07/09","富邦-仁愛",56,12,44
"15936","2727王品","110/07/09","凱基-台北",174,296,-122
"15937","2727王品","110/07/09","台新證券",109,66,43
"15938","2727王品","110/07/09","第一金",2,102,-100
"15939","2727王品","110/07/09","新光",117,87,30
"15940","2727王品","110/07/09","群益金鼎-大安",0,80,-80
"15941","2727王品","110/07/09","臺銀-臺中",35,6,29
"15942","2727王品","110/07/09","兆豐-大安",7,60,-53
"15943","2727王品","110/07/09","元大-桃園",32,3,29
"15944","2727王品","110/07/09","永豐金-南投",0,50,-50
"15945","2727王品","110/07/09","元富-宜蘭",34,6,28
"15946","2727王品","110/07/09","新加坡商瑞銀",6,46,-40
"15947","2727王品","110/07/09","玉山-台中",34,8,26
"15948","2727王品","110/07/09","合庫-彰化",11,50,-39
"15949","2727王品","110/07/09","群益金鼎-宜蘭",30,4,26
"15950","2727王品","110/07/09","永豐金-萬盛",13,52,-39
"15951","2727王品","110/07/09","富邦-台中",42,16,26
"15952","2727王品","110/07/09","瑞士信貸",0,34,-34
"15953","2727王品","110/07/09","第一金-豐原",25,1,24
"15954","2727王品","110/07/09","元大-和平",4,35,-31
"15955","2727王品","110/07/09","臺銀",30,8,22
"15956","2727王品","110/07/09","美林",14,44,-30
"15957","2727王品","110/07/09","兆豐-來福",23,1,22
"15958","2727王品","110/07/09","元大-員林",9,38,-29
"15959","2727王品","110/07/09","玉山-士林",22,2,20
"15960","2727王品","110/07/09","元富-西松",4,31,-27
"15961","1570力肯","110/07/09","凱基-台北",30,1,29
"15962","1570力肯","110/07/09","群益金鼎-彰化",0,20,-20
"15963","1570力肯","110/07/09","新光-台南",20,0,20
"15964","1570力肯","110/07/09","元大-土城學府",0,20,-20
"15965","1570力肯","110/07/09","元大-高雄",20,0,20
"15966","1570力肯","110/07/09","元大-大統",0,16,-16
"15967","1570力肯","110/07/09","國票-中正",12,0,12
"15968","1570力肯","110/07/09","元大-新營",0,11,-11
"15969","1570力肯","110/07/09","日盛-高雄",6,0,6
"15970","1570力肯","110/07/09","元大-和平",0,10,-10
"15971","1570力肯","110/07/09","元富-緯城",6,0,6
"15972","1570力肯","110/07/09","元大-草屯",0,10,-10
"15973","1570力肯","110/07/09","群益金鼎-台南",6,0,6
"15974","1570力肯","110/07/09","元大-鹿港",0,9,-9
"15975","1570力肯","110/07/09","華南永昌-岡山",6,0,6
"15976","1570力肯","110/07/09","合庫-基隆",0,7,-7
"15977","1570力肯","110/07/09","統一-中壢",5,0,5
"15978","1570力肯","110/07/09","摩根大通",2,8,-6
"15979","1570力肯","110/07/09","凱基-三峽",5,0,5
"15980","1570力肯","110/07/09","台灣企銀-豐原",0,4,-4
"15981","1570力肯","110/07/09","大昌-樹林",4,0,4
"15982","1570力肯","110/07/09","日盛-桃園",0,4,-4
"15983","1570力肯","110/07/09","新光",3,0,3
"15984","1570力肯","110/07/09","國泰-高雄",0,3,-3
"15985","1570力肯","110/07/09","富邦-新竹華信",3,0,3
"15986","1570力肯","110/07/09","永豐金-敦南",0,3,-3
"15987","1570力肯","110/07/09","合庫-台中",2,0,2
"15988","1570力肯","110/07/09","土銀-彰化",0,2,-2
"15989","1570力肯","110/07/09","臺銀-臺中",2,0,2
"15990","1570力肯","110/07/09","臺銀-鳳山",0,2,-2
"15991","6180橘子","110/07/09","摩根大通",63,1,62
"15992","6180橘子","110/07/09","元大-南京",1,32,-31
"15993","6180橘子","110/07/09","富邦-陽明",73,33,40
"15994","6180橘子","110/07/09","群益金鼎-台北",0,25,-25
"15995","6180橘子","110/07/09","新加坡商瑞銀",31,0,31
"15996","6180橘子","110/07/09","兆豐-復興",0,21,-21
"15997","6180橘子","110/07/09","美商高盛",25,0,25
"15998","6180橘子","110/07/09","永豐金-嘉義",0,21,-21
"15999","6180橘子","110/07/09","凱基-台北",26,10,16
"16000","6180橘子","110/07/09","凱基-中壢",8,24,-16
"16001","6180橘子","110/07/09","華南永昌-楠梓",13,0,13
"16002","6180橘子","110/07/09","致和-崇德",0,15,-15
"16003","6180橘子","110/07/09","華南永昌-朴子",11,0,11
"16004","6180橘子","110/07/09","群益金鼎-屏東",0,15,-15
"16005","6180橘子","110/07/09","元大-北港",11,0,11
"16006","6180橘子","110/07/09","群益金鼎-中山",0,15,-15
"16007","6180橘子","110/07/09","元大-成功",10,1,9
"16008","6180橘子","110/07/09","瑞士信貸",1,15,-14
"16009","6180橘子","110/07/09","新光",26,18,8
"16010","6180橘子","110/07/09","日盛-二林",0,10,-10
"16011","6180橘子","110/07/09","統一-三重",6,0,6
"16012","6180橘子","110/07/09","凱基-東門",0,10,-10
"16013","6180橘子","110/07/09","群益金鼎-嘉義",6,0,6
"16014","6180橘子","110/07/09","華南永昌-三重",0,10,-10
"16015","6180橘子","110/07/09","元大-員林中山",6,0,6
"16016","6180橘子","110/07/09","元大-彰化民生",1,11,-10
"16017","6180橘子","110/07/09","合庫-鳳山",5,0,5
"16018","6180橘子","110/07/09","永豐金-新店",1,11,-10
"16019","6180橘子","110/07/09","富邦-建國",6,1,5
"16020","6180橘子","110/07/09","群益金鼎-丹鳳",0,8,-8
"16021","2390云辰","110/07/09","摩根大通",279,56,223
"16022","2390云辰","110/07/09","元大-天母",0,127,-127
"16023","2390云辰","110/07/09","日盛-鳳山",110,2,108
"16024","2390云辰","110/07/09","中國信託-文心",5,109,-104
"16025","2390云辰","110/07/09","宏遠證券",100,0,100
"16026","2390云辰","110/07/09","永豐金-復興",0,55,-55
"16027","2390云辰","110/07/09","元大-大里",63,6,57
"16028","2390云辰","110/07/09","凱基-台北",239,286,-47
"16029","2390云辰","110/07/09","凱基-八德",59,10,49
"16030","2390云辰","110/07/09","德信",2,32,-30
"16031","2390云辰","110/07/09","合庫-新竹",40,0,40
"16032","2390云辰","110/07/09","兆豐-桃鶯",2,32,-30
"16033","2390云辰","110/07/09","國票",40,1,39
"16034","2390云辰","110/07/09","致和-南京",0,30,-30
"16035","2390云辰","110/07/09","新加坡商瑞銀",49,13,36
"16036","2390云辰","110/07/09","富邦-虎尾",1,31,-30
"16037","2390云辰","110/07/09","統一-新台中",36,2,34
"16038","2390云辰","110/07/09","元大-善化",2,31,-29
"16039","2390云辰","110/07/09","國票-嘉義",31,0,31
"16040","2390云辰","110/07/09","富邦-板橋",0,27,-27
"16041","2390云辰","110/07/09","華南永昌",35,7,28
"16042","2390云辰","110/07/09","富邦-永和",3,28,-25
"16043","2390云辰","110/07/09","玉山-台中",49,22,27
"16044","2390云辰","110/07/09","第一金-自由",20,44,-24
"16045","2390云辰","110/07/09","華南永昌-敦南",25,0,25
"16046","2390云辰","110/07/09","凱基-內湖",0,24,-24
"16047","2390云辰","110/07/09","新光-高雄",27,4,23
"16048","2390云辰","110/07/09","元大-汐止",1,24,-23
"16049","2390云辰","110/07/09","台灣摩根士丹利",85,63,22
"16050","2390云辰","110/07/09","新光-台中",12,33,-21
"16051","4903聯光通","110/07/09","元大-敦南",10,0,10
"16052","4903聯光通","110/07/09","第一金-台中",0,12,-12
"16053","4903聯光通","110/07/09","凱基-士林",5,0,5
"16054","4903聯光通","110/07/09","日盛-忠孝",0,3,-3
"16055","4903聯光通","110/07/09","元大-苗栗",5,0,5
"16056","4903聯光通","110/07/09","群益金鼎-崇德",0,3,-3
"16057","4903聯光通","110/07/09","元大-屏南",3,0,3
"16058","4903聯光通","110/07/09","國票-內壢",0,2,-2
"16059","4903聯光通","110/07/09","中國信託-永康",1,0,1
"16060","4903聯光通","110/07/09","康和-南崁",0,2,-2
"16061","4903聯光通","110/07/09","玉山證券",1,0,1
"16062","4903聯光通","110/07/09","新光-台中",0,2,-2
"16063","4903聯光通","110/07/09","元大-太平",4,3,1
"16064","4903聯光通","110/07/09","玉山-城中",0,2,-2
"16065","4903聯光通","110/07/09","永豐金-嘉義",1,0,1
"16066","4903聯光通","110/07/09","中國信託-文心",0,1,-1
"16067","4903聯光通","110/07/09","大昌",0,0,0
"16068","4903聯光通","110/07/09","大昌",0,0,0
"16069","4903聯光通","110/07/09","中農",0,0,0
"16070","4903聯光通","110/07/09","中農",0,0,0
"16071","4903聯光通","110/07/09","",NA,NA,NA
"16072","4903聯光通","110/07/09","",NA,NA,NA
"16073","4903聯光通","110/07/09","",NA,NA,NA
"16074","4903聯光通","110/07/09","",NA,NA,NA
"16075","4903聯光通","110/07/09","",NA,NA,NA
"16076","4903聯光通","110/07/09","",NA,NA,NA
"16077","4903聯光通","110/07/09","",NA,NA,NA
"16078","4903聯光通","110/07/09","",NA,NA,NA
"16079","4903聯光通","110/07/09","",NA,NA,NA
"16080","4903聯光通","110/07/09","",NA,NA,NA
"16081","2929淘帝","110/07/09","台中銀-台北",110,0,110
"16082","2929淘帝","110/07/09","新光",2,82,-80
"16083","2929淘帝","110/07/09","華南永昌-頭份",72,0,72
"16084","2929淘帝","110/07/09","摩根大通",2,63,-61
"16085","2929淘帝","110/07/09","合庫-高雄",71,0,71
"16086","2929淘帝","110/07/09","第一金-路竹",0,50,-50
"16087","2929淘帝","110/07/09","高橋-龍潭",37,0,37
"16088","2929淘帝","110/07/09","港商麥格理",0,42,-42
"16089","2929淘帝","110/07/09","新光-台中",60,26,34
"16090","2929淘帝","110/07/09","陽信-石牌",0,40,-40
"16091","2929淘帝","110/07/09","元富-大裕",22,1,21
"16092","2929淘帝","110/07/09","台新-左楠",1,39,-38
"16093","2929淘帝","110/07/09","合庫-鳳山",20,0,20
"16094","2929淘帝","110/07/09","凱基-桃園",3,29,-26
"16095","2929淘帝","110/07/09","元大-員林",22,2,20
"16096","2929淘帝","110/07/09","兆豐-內湖",0,25,-25
"16097","2929淘帝","110/07/09","台新-建北",15,0,15
"16098","2929淘帝","110/07/09","元大-北港",0,20,-20
"16099","2929淘帝","110/07/09","兆豐-桃園",13,0,13
"16100","2929淘帝","110/07/09","富邦-北港",0,19,-19
"16101","2929淘帝","110/07/09","兆豐-忠孝",10,0,10
"16102","2929淘帝","110/07/09","富邦-花蓮",0,17,-17
"16103","2929淘帝","110/07/09","國票-敦北法人",10,0,10
"16104","2929淘帝","110/07/09","國泰-台中",2,17,-15
"16105","2929淘帝","110/07/09","永豐金-博愛",10,0,10
"16106","2929淘帝","110/07/09","群益金鼎-彰化",0,15,-15
"16107","2929淘帝","110/07/09","群益金鼎-潭子",8,0,8
"16108","2929淘帝","110/07/09","元大-博愛",0,14,-14
"16109","2929淘帝","110/07/09","富邦-南屯",8,0,8
"16110","2929淘帝","110/07/09","日盛-板橋",0,13,-13
"16111","5410國眾","110/07/09","元大-新盛",14,0,14
"16112","5410國眾","110/07/09","(牛牛牛)亞-鑫豐",1,41,-40
"16113","5410國眾","110/07/09","台灣企銀-民雄",10,0,10
"16114","5410國眾","110/07/09","元富-嘉義",0,25,-25
"16115","5410國眾","110/07/09","元富-虎尾",9,0,9
"16116","5410國眾","110/07/09","凱基-高美館",0,10,-10
"16117","5410國眾","110/07/09","摩根大通",10,1,9
"16118","5410國眾","110/07/09","凱基-城中",0,10,-10
"16119","5410國眾","110/07/09","兆豐-北高雄",7,0,7
"16120","5410國眾","110/07/09","元大-頭份",0,10,-10
"16121","5410國眾","110/07/09","凱基-台北",8,1,7
"16122","5410國眾","110/07/09","群益金鼎-丹鳳",0,7,-7
"16123","5410國眾","110/07/09","華南永昌-公誠",7,0,7
"16124","5410國眾","110/07/09","凱基-復興",0,7,-7
"16125","5410國眾","110/07/09","香港上海匯豐",6,0,6
"16126","5410國眾","110/07/09","元大-員林",0,7,-7
"16127","5410國眾","110/07/09","凱基-中壢",6,0,6
"16128","5410國眾","110/07/09","富邦-竹東",0,6,-6
"16129","5410國眾","110/07/09","華南永昌-南京",6,0,6
"16130","5410國眾","110/07/09","亞東-高雄",0,5,-5
"16131","5410國眾","110/07/09","統一-三重",5,0,5
"16132","5410國眾","110/07/09","大慶-中壢",1,6,-5
"16133","5410國眾","110/07/09","富邦-宜蘭",5,0,5
"16134","5410國眾","110/07/09","群益金鼎-中港",0,5,-5
"16135","5410國眾","110/07/09","元大-崇德",5,0,5
"16136","5410國眾","110/07/09","元大-八德",0,5,-5
"16137","5410國眾","110/07/09","元大-博愛",5,0,5
"16138","5410國眾","110/07/09","富邦-基隆",0,4,-4
"16139","5410國眾","110/07/09","元大-龍潭",5,0,5
"16140","5410國眾","110/07/09","臺銀-新竹",0,3,-3
"16141","2841台開","110/07/09","日盛-雙和",102,0,102
"16142","2841台開","110/07/09","港商野村",0,129,-129
"16143","2841台開","110/07/09","元大-館前",70,0,70
"16144","2841台開","110/07/09","兆豐-永和",0,100,-100
"16145","2841台開","110/07/09","凱基-文心",50,0,50
"16146","2841台開","110/07/09","台新證券",7,28,-21
"16147","2841台開","110/07/09","富邦-嘉義",40,0,40
"16148","2841台開","110/07/09","國票-北高雄",0,20,-20
"16149","2841台開","110/07/09","美商高盛",15,0,15
"16150","2841台開","110/07/09","永豐金-敦南",29,46,-17
"16151","2841台開","110/07/09","台中銀",15,0,15
"16152","2841台開","110/07/09","合庫-基隆",0,12,-12
"16153","2841台開","110/07/09","新光",11,0,11
"16154","2841台開","110/07/09","中國信託-松江",0,12,-12
"16155","2841台開","110/07/09","華南永昌-長虹",10,0,10
"16156","2841台開","110/07/09","兆豐-城中",0,12,-12
"16157","2841台開","110/07/09","永豐金-南投",10,0,10
"16158","2841台開","110/07/09","台中銀-豐原",0,10,-10
"16159","2841台開","110/07/09","合庫-桃園",7,0,7
"16160","2841台開","110/07/09","兆豐-景美",0,10,-10
"16161","2841台開","110/07/09","群益金鼎-古亭",7,0,7
"16162","2841台開","110/07/09","群益金鼎-基隆",0,10,-10
"16163","2841台開","110/07/09","國泰-敦南",6,0,6
"16164","2841台開","110/07/09","元大-北三重",0,10,-10
"16165","2841台開","110/07/09","凱基-桃園",8,2,6
"16166","2841台開","110/07/09","(牛牛牛)亞-網路",0,9,-9
"16167","2841台開","110/07/09","日盛證券",5,0,5
"16168","2841台開","110/07/09","台新-高雄",1,10,-9
"16169","2841台開","110/07/09","元富-文心",5,0,5
"16170","2841台開","110/07/09","凱基-台北",0,7,-7
"16171","6207雷科","110/07/09","群益金鼎-新竹",47,0,47
"16172","6207雷科","110/07/09","新光",7,24,-17
"16173","6207雷科","110/07/09","永豐金-三重",31,0,31
"16174","6207雷科","110/07/09","日盛-和美",0,15,-15
"16175","6207雷科","110/07/09","新加坡商瑞銀",33,5,28
"16176","6207雷科","110/07/09","國泰-台南",0,15,-15
"16177","6207雷科","110/07/09","元大-高雄",26,0,26
"16178","6207雷科","110/07/09","華南永昌-古亭",0,14,-14
"16179","6207雷科","110/07/09","統一-員林",22,0,22
"16180","6207雷科","110/07/09","土銀-白河",0,11,-11
"16181","6207雷科","110/07/09","台新-高雄",22,0,22
"16182","6207雷科","110/07/09","日盛-台南",0,10,-10
"16183","6207雷科","110/07/09","摩根大通",34,17,17
"16184","6207雷科","110/07/09","元富-林園",0,10,-10
"16185","6207雷科","110/07/09","元大-博愛",17,1,16
"16186","6207雷科","110/07/09","富邦-園區",0,10,-10
"16187","6207雷科","110/07/09","日茂-埔里",12,0,12
"16188","6207雷科","110/07/09","元大-上新莊",0,10,-10
"16189","6207雷科","110/07/09","國泰-台中",17,6,11
"16190","6207雷科","110/07/09","永豐金-南京",0,10,-10
"16191","6207雷科","110/07/09","富邦-三重",10,0,10
"16192","6207雷科","110/07/09","兆豐-小港",0,6,-6
"16193","6207雷科","110/07/09","元大-沙鹿",10,0,10
"16194","6207雷科","110/07/09","富邦-羅東",1,7,-6
"16195","6207雷科","110/07/09","元大-八德",10,0,10
"16196","6207雷科","110/07/09","元大-土城永寧",0,6,-6
"16197","6207雷科","110/07/09","第一金-路竹",11,2,9
"16198","6207雷科","110/07/09","永豐金-板盛",0,6,-6
"16199","6207雷科","110/07/09","統一-南京",5,0,5
"16200","6207雷科","110/07/09","日盛-板橋",0,5,-5
"16201","3679新至陞","110/07/09","元大-大天母",10,0,10
"16202","3679新至陞","110/07/09","第一金-光復",0,11,-11
"16203","3679新至陞","110/07/09","日盛-樹林",9,0,9
"16204","3679新至陞","110/07/09","瑞士信貸",0,8,-8
"16205","3679新至陞","110/07/09","凱基-台北",11,2,9
"16206","3679新至陞","110/07/09","大慶-苗栗",0,5,-5
"16207","3679新至陞","110/07/09","華南永昌-小港",8,0,8
"16208","3679新至陞","110/07/09","元大-永春",0,5,-5
"16209","3679新至陞","110/07/09","兆豐-來福",7,0,7
"16210","3679新至陞","110/07/09","日盛-和美",0,4,-4
"16211","3679新至陞","110/07/09","香港上海匯豐",5,0,5
"16212","3679新至陞","110/07/09","元大-雙和",0,3,-3
"16213","3679新至陞","110/07/09","台中銀-員林",3,0,3
"16214","3679新至陞","110/07/09","永豐金-屏東",0,3,-3
"16215","3679新至陞","110/07/09","新光",3,0,3
"16216","3679新至陞","110/07/09","彰銀",0,2,-2
"16217","3679新至陞","110/07/09","土銀-花蓮",2,0,2
"16218","3679新至陞","110/07/09","宏遠-館前",0,2,-2
"16219","3679新至陞","110/07/09","第一金-澎湖",2,0,2
"16220","3679新至陞","110/07/09","港商野村",0,2,-2
"16221","3679新至陞","110/07/09","摩根大通",2,0,2
"16222","3679新至陞","110/07/09","大昌-新店",0,2,-2
"16223","3679新至陞","110/07/09","國泰-敦南",2,0,2
"16224","3679新至陞","110/07/09","元大-新莊",0,2,-2
"16225","3679新至陞","110/07/09","元大-淡水",4,2,2
"16226","3679新至陞","110/07/09","元大-板橋",0,2,-2
"16227","3679新至陞","110/07/09","日盛-士林",1,0,1
"16228","3679新至陞","110/07/09","台灣摩根士丹利",0,1,-1
"16229","3679新至陞","110/07/09","日盛-信義",1,0,1
"16230","3679新至陞","110/07/09","第一金-高雄",0,1,-1
"16231","2727王品","110/07/09","台灣匯立證券",90,0,90
"16232","2727王品","110/07/09","台灣摩根士丹利",0,267,-267
"16233","2727王品","110/07/09","國泰-敦南",166,84,82
"16234","2727王品","110/07/09","富邦-台北",35,299,-264
"16235","2727王品","110/07/09","富邦-仁愛",56,12,44
"16236","2727王品","110/07/09","凱基-台北",174,296,-122
"16237","2727王品","110/07/09","台新證券",109,66,43
"16238","2727王品","110/07/09","第一金",2,102,-100
"16239","2727王品","110/07/09","新光",117,87,30
"16240","2727王品","110/07/09","群益金鼎-大安",0,80,-80
"16241","2727王品","110/07/09","臺銀-臺中",35,6,29
"16242","2727王品","110/07/09","兆豐-大安",7,60,-53
"16243","2727王品","110/07/09","元大-桃園",32,3,29
"16244","2727王品","110/07/09","永豐金-南投",0,50,-50
"16245","2727王品","110/07/09","元富-宜蘭",34,6,28
"16246","2727王品","110/07/09","新加坡商瑞銀",6,46,-40
"16247","2727王品","110/07/09","玉山-台中",34,8,26
"16248","2727王品","110/07/09","合庫-彰化",11,50,-39
"16249","2727王品","110/07/09","群益金鼎-宜蘭",30,4,26
"16250","2727王品","110/07/09","永豐金-萬盛",13,52,-39
"16251","2727王品","110/07/09","富邦-台中",42,16,26
"16252","2727王品","110/07/09","瑞士信貸",0,34,-34
"16253","2727王品","110/07/09","第一金-豐原",25,1,24
"16254","2727王品","110/07/09","元大-和平",4,35,-31
"16255","2727王品","110/07/09","臺銀",30,8,22
"16256","2727王品","110/07/09","美林",14,44,-30
"16257","2727王品","110/07/09","兆豐-來福",23,1,22
"16258","2727王品","110/07/09","元大-員林",9,38,-29
"16259","2727王品","110/07/09","玉山-士林",22,2,20
"16260","2727王品","110/07/09","元富-西松",4,31,-27
"16261","1570力肯","110/07/09","凱基-台北",30,1,29
"16262","1570力肯","110/07/09","群益金鼎-彰化",0,20,-20
"16263","1570力肯","110/07/09","新光-台南",20,0,20
"16264","1570力肯","110/07/09","元大-土城學府",0,20,-20
"16265","1570力肯","110/07/09","元大-高雄",20,0,20
"16266","1570力肯","110/07/09","元大-大統",0,16,-16
"16267","1570力肯","110/07/09","國票-中正",12,0,12
"16268","1570力肯","110/07/09","元大-新營",0,11,-11
"16269","1570力肯","110/07/09","日盛-高雄",6,0,6
"16270","1570力肯","110/07/09","元大-和平",0,10,-10
"16271","1570力肯","110/07/09","元富-緯城",6,0,6
"16272","1570力肯","110/07/09","元大-草屯",0,10,-10
"16273","1570力肯","110/07/09","群益金鼎-台南",6,0,6
"16274","1570力肯","110/07/09","元大-鹿港",0,9,-9
"16275","1570力肯","110/07/09","華南永昌-岡山",6,0,6
"16276","1570力肯","110/07/09","合庫-基隆",0,7,-7
"16277","1570力肯","110/07/09","統一-中壢",5,0,5
"16278","1570力肯","110/07/09","摩根大通",2,8,-6
"16279","1570力肯","110/07/09","凱基-三峽",5,0,5
"16280","1570力肯","110/07/09","台灣企銀-豐原",0,4,-4
"16281","1570力肯","110/07/09","大昌-樹林",4,0,4
"16282","1570力肯","110/07/09","日盛-桃園",0,4,-4
"16283","1570力肯","110/07/09","新光",3,0,3
"16284","1570力肯","110/07/09","國泰-高雄",0,3,-3
"16285","1570力肯","110/07/09","富邦-新竹華信",3,0,3
"16286","1570力肯","110/07/09","永豐金-敦南",0,3,-3
"16287","1570力肯","110/07/09","合庫-台中",2,0,2
"16288","1570力肯","110/07/09","土銀-彰化",0,2,-2
"16289","1570力肯","110/07/09","臺銀-臺中",2,0,2
"16290","1570力肯","110/07/09","臺銀-鳳山",0,2,-2
"16291","6180橘子","110/07/09","摩根大通",63,1,62
"16292","6180橘子","110/07/09","元大-南京",1,32,-31
"16293","6180橘子","110/07/09","富邦-陽明",73,33,40
"16294","6180橘子","110/07/09","群益金鼎-台北",0,25,-25
"16295","6180橘子","110/07/09","新加坡商瑞銀",31,0,31
"16296","6180橘子","110/07/09","兆豐-復興",0,21,-21
"16297","6180橘子","110/07/09","美商高盛",25,0,25
"16298","6180橘子","110/07/09","永豐金-嘉義",0,21,-21
"16299","6180橘子","110/07/09","凱基-台北",26,10,16
"16300","6180橘子","110/07/09","凱基-中壢",8,24,-16
"16301","6180橘子","110/07/09","華南永昌-楠梓",13,0,13
"16302","6180橘子","110/07/09","致和-崇德",0,15,-15
"16303","6180橘子","110/07/09","華南永昌-朴子",11,0,11
"16304","6180橘子","110/07/09","群益金鼎-屏東",0,15,-15
"16305","6180橘子","110/07/09","元大-北港",11,0,11
"16306","6180橘子","110/07/09","群益金鼎-中山",0,15,-15
"16307","6180橘子","110/07/09","元大-成功",10,1,9
"16308","6180橘子","110/07/09","瑞士信貸",1,15,-14
"16309","6180橘子","110/07/09","新光",26,18,8
"16310","6180橘子","110/07/09","日盛-二林",0,10,-10
"16311","6180橘子","110/07/09","統一-三重",6,0,6
"16312","6180橘子","110/07/09","凱基-東門",0,10,-10
"16313","6180橘子","110/07/09","群益金鼎-嘉義",6,0,6
"16314","6180橘子","110/07/09","華南永昌-三重",0,10,-10
"16315","6180橘子","110/07/09","元大-員林中山",6,0,6
"16316","6180橘子","110/07/09","元大-彰化民生",1,11,-10
"16317","6180橘子","110/07/09","合庫-鳳山",5,0,5
"16318","6180橘子","110/07/09","永豐金-新店",1,11,-10
"16319","6180橘子","110/07/09","富邦-建國",6,1,5
"16320","6180橘子","110/07/09","群益金鼎-丹鳳",0,8,-8
"16321","2390云辰","110/07/09","摩根大通",279,56,223
"16322","2390云辰","110/07/09","元大-天母",0,127,-127
"16323","2390云辰","110/07/09","日盛-鳳山",110,2,108
"16324","2390云辰","110/07/09","中國信託-文心",5,109,-104
"16325","2390云辰","110/07/09","宏遠證券",100,0,100
"16326","2390云辰","110/07/09","永豐金-復興",0,55,-55
"16327","2390云辰","110/07/09","元大-大里",63,6,57
"16328","2390云辰","110/07/09","凱基-台北",239,286,-47
"16329","2390云辰","110/07/09","凱基-八德",59,10,49
"16330","2390云辰","110/07/09","德信",2,32,-30
"16331","2390云辰","110/07/09","合庫-新竹",40,0,40
"16332","2390云辰","110/07/09","兆豐-桃鶯",2,32,-30
"16333","2390云辰","110/07/09","國票",40,1,39
"16334","2390云辰","110/07/09","致和-南京",0,30,-30
"16335","2390云辰","110/07/09","新加坡商瑞銀",49,13,36
"16336","2390云辰","110/07/09","富邦-虎尾",1,31,-30
"16337","2390云辰","110/07/09","統一-新台中",36,2,34
"16338","2390云辰","110/07/09","元大-善化",2,31,-29
"16339","2390云辰","110/07/09","國票-嘉義",31,0,31
"16340","2390云辰","110/07/09","富邦-板橋",0,27,-27
"16341","2390云辰","110/07/09","華南永昌",35,7,28
"16342","2390云辰","110/07/09","富邦-永和",3,28,-25
"16343","2390云辰","110/07/09","玉山-台中",49,22,27
"16344","2390云辰","110/07/09","第一金-自由",20,44,-24
"16345","2390云辰","110/07/09","華南永昌-敦南",25,0,25
"16346","2390云辰","110/07/09","凱基-內湖",0,24,-24
"16347","2390云辰","110/07/09","新光-高雄",27,4,23
"16348","2390云辰","110/07/09","元大-汐止",1,24,-23
"16349","2390云辰","110/07/09","台灣摩根士丹利",85,63,22
"16350","2390云辰","110/07/09","新光-台中",12,33,-21
"16351","4903聯光通","110/07/09","元大-敦南",10,0,10
"16352","4903聯光通","110/07/09","第一金-台中",0,12,-12
"16353","4903聯光通","110/07/09","凱基-士林",5,0,5
"16354","4903聯光通","110/07/09","日盛-忠孝",0,3,-3
"16355","4903聯光通","110/07/09","元大-苗栗",5,0,5
"16356","4903聯光通","110/07/09","群益金鼎-崇德",0,3,-3
"16357","4903聯光通","110/07/09","元大-屏南",3,0,3
"16358","4903聯光通","110/07/09","國票-內壢",0,2,-2
"16359","4903聯光通","110/07/09","中國信託-永康",1,0,1
"16360","4903聯光通","110/07/09","康和-南崁",0,2,-2
"16361","4903聯光通","110/07/09","玉山證券",1,0,1
"16362","4903聯光通","110/07/09","新光-台中",0,2,-2
"16363","4903聯光通","110/07/09","元大-太平",4,3,1
"16364","4903聯光通","110/07/09","玉山-城中",0,2,-2
"16365","4903聯光通","110/07/09","永豐金-嘉義",1,0,1
"16366","4903聯光通","110/07/09","中國信託-文心",0,1,-1
"16367","4903聯光通","110/07/09","大昌",0,0,0
"16368","4903聯光通","110/07/09","大昌",0,0,0
"16369","4903聯光通","110/07/09","中農",0,0,0
"16370","4903聯光通","110/07/09","中農",0,0,0
"16371","4903聯光通","110/07/09","",NA,NA,NA
"16372","4903聯光通","110/07/09","",NA,NA,NA
"16373","4903聯光通","110/07/09","",NA,NA,NA
"16374","4903聯光通","110/07/09","",NA,NA,NA
"16375","4903聯光通","110/07/09","",NA,NA,NA
"16376","4903聯光通","110/07/09","",NA,NA,NA
"16377","4903聯光通","110/07/09","",NA,NA,NA
"16378","4903聯光通","110/07/09","",NA,NA,NA
"16379","4903聯光通","110/07/09","",NA,NA,NA
"16380","4903聯光通","110/07/09","",NA,NA,NA
"16381","2929淘帝","110/07/09","台中銀-台北",110,0,110
"16382","2929淘帝","110/07/09","新光",2,82,-80
"16383","2929淘帝","110/07/09","華南永昌-頭份",72,0,72
"16384","2929淘帝","110/07/09","摩根大通",2,63,-61
"16385","2929淘帝","110/07/09","合庫-高雄",71,0,71
"16386","2929淘帝","110/07/09","第一金-路竹",0,50,-50
"16387","2929淘帝","110/07/09","高橋-龍潭",37,0,37
"16388","2929淘帝","110/07/09","港商麥格理",0,42,-42
"16389","2929淘帝","110/07/09","新光-台中",60,26,34
"16390","2929淘帝","110/07/09","陽信-石牌",0,40,-40
"16391","2929淘帝","110/07/09","元富-大裕",22,1,21
"16392","2929淘帝","110/07/09","台新-左楠",1,39,-38
"16393","2929淘帝","110/07/09","合庫-鳳山",20,0,20
"16394","2929淘帝","110/07/09","凱基-桃園",3,29,-26
"16395","2929淘帝","110/07/09","元大-員林",22,2,20
"16396","2929淘帝","110/07/09","兆豐-內湖",0,25,-25
"16397","2929淘帝","110/07/09","台新-建北",15,0,15
"16398","2929淘帝","110/07/09","元大-北港",0,20,-20
"16399","2929淘帝","110/07/09","兆豐-桃園",13,0,13
"16400","2929淘帝","110/07/09","富邦-北港",0,19,-19
"16401","2929淘帝","110/07/09","兆豐-忠孝",10,0,10
"16402","2929淘帝","110/07/09","富邦-花蓮",0,17,-17
"16403","2929淘帝","110/07/09","國票-敦北法人",10,0,10
"16404","2929淘帝","110/07/09","國泰-台中",2,17,-15
"16405","2929淘帝","110/07/09","永豐金-博愛",10,0,10
"16406","2929淘帝","110/07/09","群益金鼎-彰化",0,15,-15
"16407","2929淘帝","110/07/09","群益金鼎-潭子",8,0,8
"16408","2929淘帝","110/07/09","元大-博愛",0,14,-14
"16409","2929淘帝","110/07/09","富邦-南屯",8,0,8
"16410","2929淘帝","110/07/09","日盛-板橋",0,13,-13
"16411","5410國眾","110/07/09","元大-新盛",14,0,14
"16412","5410國眾","110/07/09","(牛牛牛)亞-鑫豐",1,41,-40
"16413","5410國眾","110/07/09","台灣企銀-民雄",10,0,10
"16414","5410國眾","110/07/09","元富-嘉義",0,25,-25
"16415","5410國眾","110/07/09","元富-虎尾",9,0,9
"16416","5410國眾","110/07/09","凱基-高美館",0,10,-10
"16417","5410國眾","110/07/09","摩根大通",10,1,9
"16418","5410國眾","110/07/09","凱基-城中",0,10,-10
"16419","5410國眾","110/07/09","兆豐-北高雄",7,0,7
"16420","5410國眾","110/07/09","元大-頭份",0,10,-10
"16421","5410國眾","110/07/09","凱基-台北",8,1,7
"16422","5410國眾","110/07/09","群益金鼎-丹鳳",0,7,-7
"16423","5410國眾","110/07/09","華南永昌-公誠",7,0,7
"16424","5410國眾","110/07/09","凱基-復興",0,7,-7
"16425","5410國眾","110/07/09","香港上海匯豐",6,0,6
"16426","5410國眾","110/07/09","元大-員林",0,7,-7
"16427","5410國眾","110/07/09","凱基-中壢",6,0,6
"16428","5410國眾","110/07/09","富邦-竹東",0,6,-6
"16429","5410國眾","110/07/09","華南永昌-南京",6,0,6
"16430","5410國眾","110/07/09","亞東-高雄",0,5,-5
"16431","5410國眾","110/07/09","統一-三重",5,0,5
"16432","5410國眾","110/07/09","大慶-中壢",1,6,-5
"16433","5410國眾","110/07/09","富邦-宜蘭",5,0,5
"16434","5410國眾","110/07/09","群益金鼎-中港",0,5,-5
"16435","5410國眾","110/07/09","元大-崇德",5,0,5
"16436","5410國眾","110/07/09","元大-八德",0,5,-5
"16437","5410國眾","110/07/09","元大-博愛",5,0,5
"16438","5410國眾","110/07/09","富邦-基隆",0,4,-4
"16439","5410國眾","110/07/09","元大-龍潭",5,0,5
"16440","5410國眾","110/07/09","臺銀-新竹",0,3,-3
"16441","2841台開","110/07/09","日盛-雙和",102,0,102
"16442","2841台開","110/07/09","港商野村",0,129,-129
"16443","2841台開","110/07/09","元大-館前",70,0,70
"16444","2841台開","110/07/09","兆豐-永和",0,100,-100
"16445","2841台開","110/07/09","凱基-文心",50,0,50
"16446","2841台開","110/07/09","台新證券",7,28,-21
"16447","2841台開","110/07/09","富邦-嘉義",40,0,40
"16448","2841台開","110/07/09","國票-北高雄",0,20,-20
"16449","2841台開","110/07/09","美商高盛",15,0,15
"16450","2841台開","110/07/09","永豐金-敦南",29,46,-17
"16451","2841台開","110/07/09","台中銀",15,0,15
"16452","2841台開","110/07/09","合庫-基隆",0,12,-12
"16453","2841台開","110/07/09","新光",11,0,11
"16454","2841台開","110/07/09","中國信託-松江",0,12,-12
"16455","2841台開","110/07/09","華南永昌-長虹",10,0,10
"16456","2841台開","110/07/09","兆豐-城中",0,12,-12
"16457","2841台開","110/07/09","永豐金-南投",10,0,10
"16458","2841台開","110/07/09","台中銀-豐原",0,10,-10
"16459","2841台開","110/07/09","合庫-桃園",7,0,7
"16460","2841台開","110/07/09","兆豐-景美",0,10,-10
"16461","2841台開","110/07/09","群益金鼎-古亭",7,0,7
"16462","2841台開","110/07/09","群益金鼎-基隆",0,10,-10
"16463","2841台開","110/07/09","國泰-敦南",6,0,6
"16464","2841台開","110/07/09","元大-北三重",0,10,-10
"16465","2841台開","110/07/09","凱基-桃園",8,2,6
"16466","2841台開","110/07/09","(牛牛牛)亞-網路",0,9,-9
"16467","2841台開","110/07/09","日盛證券",5,0,5
"16468","2841台開","110/07/09","台新-高雄",1,10,-9
"16469","2841台開","110/07/09","元富-文心",5,0,5
"16470","2841台開","110/07/09","凱基-台北",0,7,-7
"16471","6207雷科","110/07/09","群益金鼎-新竹",47,0,47
"16472","6207雷科","110/07/09","新光",7,24,-17
"16473","6207雷科","110/07/09","永豐金-三重",31,0,31
"16474","6207雷科","110/07/09","日盛-和美",0,15,-15
"16475","6207雷科","110/07/09","新加坡商瑞銀",33,5,28
"16476","6207雷科","110/07/09","國泰-台南",0,15,-15
"16477","6207雷科","110/07/09","元大-高雄",26,0,26
"16478","6207雷科","110/07/09","華南永昌-古亭",0,14,-14
"16479","6207雷科","110/07/09","統一-員林",22,0,22
"16480","6207雷科","110/07/09","土銀-白河",0,11,-11
"16481","6207雷科","110/07/09","台新-高雄",22,0,22
"16482","6207雷科","110/07/09","日盛-台南",0,10,-10
"16483","6207雷科","110/07/09","摩根大通",34,17,17
"16484","6207雷科","110/07/09","元富-林園",0,10,-10
"16485","6207雷科","110/07/09","元大-博愛",17,1,16
"16486","6207雷科","110/07/09","富邦-園區",0,10,-10
"16487","6207雷科","110/07/09","日茂-埔里",12,0,12
"16488","6207雷科","110/07/09","元大-上新莊",0,10,-10
"16489","6207雷科","110/07/09","國泰-台中",17,6,11
"16490","6207雷科","110/07/09","永豐金-南京",0,10,-10
"16491","6207雷科","110/07/09","富邦-三重",10,0,10
"16492","6207雷科","110/07/09","兆豐-小港",0,6,-6
"16493","6207雷科","110/07/09","元大-沙鹿",10,0,10
"16494","6207雷科","110/07/09","富邦-羅東",1,7,-6
"16495","6207雷科","110/07/09","元大-八德",10,0,10
"16496","6207雷科","110/07/09","元大-土城永寧",0,6,-6
"16497","6207雷科","110/07/09","第一金-路竹",11,2,9
"16498","6207雷科","110/07/09","永豐金-板盛",0,6,-6
"16499","6207雷科","110/07/09","統一-南京",5,0,5
"16500","6207雷科","110/07/09","日盛-板橋",0,5,-5
"16501","3679新至陞","110/07/09","元大-大天母",10,0,10
"16502","3679新至陞","110/07/09","第一金-光復",0,11,-11
"16503","3679新至陞","110/07/09","日盛-樹林",9,0,9
"16504","3679新至陞","110/07/09","瑞士信貸",0,8,-8
"16505","3679新至陞","110/07/09","凱基-台北",11,2,9
"16506","3679新至陞","110/07/09","大慶-苗栗",0,5,-5
"16507","3679新至陞","110/07/09","華南永昌-小港",8,0,8
"16508","3679新至陞","110/07/09","元大-永春",0,5,-5
"16509","3679新至陞","110/07/09","兆豐-來福",7,0,7
"16510","3679新至陞","110/07/09","日盛-和美",0,4,-4
"16511","3679新至陞","110/07/09","香港上海匯豐",5,0,5
"16512","3679新至陞","110/07/09","元大-雙和",0,3,-3
"16513","3679新至陞","110/07/09","台中銀-員林",3,0,3
"16514","3679新至陞","110/07/09","永豐金-屏東",0,3,-3
"16515","3679新至陞","110/07/09","新光",3,0,3
"16516","3679新至陞","110/07/09","彰銀",0,2,-2
"16517","3679新至陞","110/07/09","土銀-花蓮",2,0,2
"16518","3679新至陞","110/07/09","宏遠-館前",0,2,-2
"16519","3679新至陞","110/07/09","第一金-澎湖",2,0,2
"16520","3679新至陞","110/07/09","港商野村",0,2,-2
"16521","3679新至陞","110/07/09","摩根大通",2,0,2
"16522","3679新至陞","110/07/09","大昌-新店",0,2,-2
"16523","3679新至陞","110/07/09","國泰-敦南",2,0,2
"16524","3679新至陞","110/07/09","元大-新莊",0,2,-2
"16525","3679新至陞","110/07/09","元大-淡水",4,2,2
"16526","3679新至陞","110/07/09","元大-板橋",0,2,-2
"16527","3679新至陞","110/07/09","日盛-士林",1,0,1
"16528","3679新至陞","110/07/09","台灣摩根士丹利",0,1,-1
"16529","3679新至陞","110/07/09","日盛-信義",1,0,1
"16530","3679新至陞","110/07/09","第一金-高雄",0,1,-1
"16531","2727王品","110/07/09","台灣匯立證券",90,0,90
"16532","2727王品","110/07/09","台灣摩根士丹利",0,267,-267
"16533","2727王品","110/07/09","國泰-敦南",166,84,82
"16534","2727王品","110/07/09","富邦-台北",35,299,-264
"16535","2727王品","110/07/09","富邦-仁愛",56,12,44
"16536","2727王品","110/07/09","凱基-台北",174,296,-122
"16537","2727王品","110/07/09","台新證券",109,66,43
"16538","2727王品","110/07/09","第一金",2,102,-100
"16539","2727王品","110/07/09","新光",117,87,30
"16540","2727王品","110/07/09","群益金鼎-大安",0,80,-80
"16541","2727王品","110/07/09","臺銀-臺中",35,6,29
"16542","2727王品","110/07/09","兆豐-大安",7,60,-53
"16543","2727王品","110/07/09","元大-桃園",32,3,29
"16544","2727王品","110/07/09","永豐金-南投",0,50,-50
"16545","2727王品","110/07/09","元富-宜蘭",34,6,28
"16546","2727王品","110/07/09","新加坡商瑞銀",6,46,-40
"16547","2727王品","110/07/09","玉山-台中",34,8,26
"16548","2727王品","110/07/09","合庫-彰化",11,50,-39
"16549","2727王品","110/07/09","群益金鼎-宜蘭",30,4,26
"16550","2727王品","110/07/09","永豐金-萬盛",13,52,-39
"16551","2727王品","110/07/09","富邦-台中",42,16,26
"16552","2727王品","110/07/09","瑞士信貸",0,34,-34
"16553","2727王品","110/07/09","第一金-豐原",25,1,24
"16554","2727王品","110/07/09","元大-和平",4,35,-31
"16555","2727王品","110/07/09","臺銀",30,8,22
"16556","2727王品","110/07/09","美林",14,44,-30
"16557","2727王品","110/07/09","兆豐-來福",23,1,22
"16558","2727王品","110/07/09","元大-員林",9,38,-29
"16559","2727王品","110/07/09","玉山-士林",22,2,20
"16560","2727王品","110/07/09","元富-西松",4,31,-27
"16561","1570力肯","110/07/09","凱基-台北",30,1,29
"16562","1570力肯","110/07/09","群益金鼎-彰化",0,20,-20
"16563","1570力肯","110/07/09","新光-台南",20,0,20
"16564","1570力肯","110/07/09","元大-土城學府",0,20,-20
"16565","1570力肯","110/07/09","元大-高雄",20,0,20
"16566","1570力肯","110/07/09","元大-大統",0,16,-16
"16567","1570力肯","110/07/09","國票-中正",12,0,12
"16568","1570力肯","110/07/09","元大-新營",0,11,-11
"16569","1570力肯","110/07/09","日盛-高雄",6,0,6
"16570","1570力肯","110/07/09","元大-和平",0,10,-10
"16571","1570力肯","110/07/09","元富-緯城",6,0,6
"16572","1570力肯","110/07/09","元大-草屯",0,10,-10
"16573","1570力肯","110/07/09","群益金鼎-台南",6,0,6
"16574","1570力肯","110/07/09","元大-鹿港",0,9,-9
"16575","1570力肯","110/07/09","華南永昌-岡山",6,0,6
"16576","1570力肯","110/07/09","合庫-基隆",0,7,-7
"16577","1570力肯","110/07/09","統一-中壢",5,0,5
"16578","1570力肯","110/07/09","摩根大通",2,8,-6
"16579","1570力肯","110/07/09","凱基-三峽",5,0,5
"16580","1570力肯","110/07/09","台灣企銀-豐原",0,4,-4
"16581","1570力肯","110/07/09","大昌-樹林",4,0,4
"16582","1570力肯","110/07/09","日盛-桃園",0,4,-4
"16583","1570力肯","110/07/09","新光",3,0,3
"16584","1570力肯","110/07/09","國泰-高雄",0,3,-3
"16585","1570力肯","110/07/09","富邦-新竹華信",3,0,3
"16586","1570力肯","110/07/09","永豐金-敦南",0,3,-3
"16587","1570力肯","110/07/09","合庫-台中",2,0,2
"16588","1570力肯","110/07/09","土銀-彰化",0,2,-2
"16589","1570力肯","110/07/09","臺銀-臺中",2,0,2
"16590","1570力肯","110/07/09","臺銀-鳳山",0,2,-2
"16591","6180橘子","110/07/09","摩根大通",63,1,62
"16592","6180橘子","110/07/09","元大-南京",1,32,-31
"16593","6180橘子","110/07/09","富邦-陽明",73,33,40
"16594","6180橘子","110/07/09","群益金鼎-台北",0,25,-25
"16595","6180橘子","110/07/09","新加坡商瑞銀",31,0,31
"16596","6180橘子","110/07/09","兆豐-復興",0,21,-21
"16597","6180橘子","110/07/09","美商高盛",25,0,25
"16598","6180橘子","110/07/09","永豐金-嘉義",0,21,-21
"16599","6180橘子","110/07/09","凱基-台北",26,10,16
"16600","6180橘子","110/07/09","凱基-中壢",8,24,-16
"16601","6180橘子","110/07/09","華南永昌-楠梓",13,0,13
"16602","6180橘子","110/07/09","致和-崇德",0,15,-15
"16603","6180橘子","110/07/09","華南永昌-朴子",11,0,11
"16604","6180橘子","110/07/09","群益金鼎-屏東",0,15,-15
"16605","6180橘子","110/07/09","元大-北港",11,0,11
"16606","6180橘子","110/07/09","群益金鼎-中山",0,15,-15
"16607","6180橘子","110/07/09","元大-成功",10,1,9
"16608","6180橘子","110/07/09","瑞士信貸",1,15,-14
"16609","6180橘子","110/07/09","新光",26,18,8
"16610","6180橘子","110/07/09","日盛-二林",0,10,-10
"16611","6180橘子","110/07/09","統一-三重",6,0,6
"16612","6180橘子","110/07/09","凱基-東門",0,10,-10
"16613","6180橘子","110/07/09","群益金鼎-嘉義",6,0,6
"16614","6180橘子","110/07/09","華南永昌-三重",0,10,-10
"16615","6180橘子","110/07/09","元大-員林中山",6,0,6
"16616","6180橘子","110/07/09","元大-彰化民生",1,11,-10
"16617","6180橘子","110/07/09","合庫-鳳山",5,0,5
"16618","6180橘子","110/07/09","永豐金-新店",1,11,-10
"16619","6180橘子","110/07/09","富邦-建國",6,1,5
"16620","6180橘子","110/07/09","群益金鼎-丹鳳",0,8,-8
"16621","2390云辰","110/07/09","摩根大通",279,56,223
"16622","2390云辰","110/07/09","元大-天母",0,127,-127
"16623","2390云辰","110/07/09","日盛-鳳山",110,2,108
"16624","2390云辰","110/07/09","中國信託-文心",5,109,-104
"16625","2390云辰","110/07/09","宏遠證券",100,0,100
"16626","2390云辰","110/07/09","永豐金-復興",0,55,-55
"16627","2390云辰","110/07/09","元大-大里",63,6,57
"16628","2390云辰","110/07/09","凱基-台北",239,286,-47
"16629","2390云辰","110/07/09","凱基-八德",59,10,49
"16630","2390云辰","110/07/09","德信",2,32,-30
"16631","2390云辰","110/07/09","合庫-新竹",40,0,40
"16632","2390云辰","110/07/09","兆豐-桃鶯",2,32,-30
"16633","2390云辰","110/07/09","國票",40,1,39
"16634","2390云辰","110/07/09","致和-南京",0,30,-30
"16635","2390云辰","110/07/09","新加坡商瑞銀",49,13,36
"16636","2390云辰","110/07/09","富邦-虎尾",1,31,-30
"16637","2390云辰","110/07/09","統一-新台中",36,2,34
"16638","2390云辰","110/07/09","元大-善化",2,31,-29
"16639","2390云辰","110/07/09","國票-嘉義",31,0,31
"16640","2390云辰","110/07/09","富邦-板橋",0,27,-27
"16641","2390云辰","110/07/09","華南永昌",35,7,28
"16642","2390云辰","110/07/09","富邦-永和",3,28,-25
"16643","2390云辰","110/07/09","玉山-台中",49,22,27
"16644","2390云辰","110/07/09","第一金-自由",20,44,-24
"16645","2390云辰","110/07/09","華南永昌-敦南",25,0,25
"16646","2390云辰","110/07/09","凱基-內湖",0,24,-24
"16647","2390云辰","110/07/09","新光-高雄",27,4,23
"16648","2390云辰","110/07/09","元大-汐止",1,24,-23
"16649","2390云辰","110/07/09","台灣摩根士丹利",85,63,22
"16650","2390云辰","110/07/09","新光-台中",12,33,-21
"16651","4903聯光通","110/07/09","元大-敦南",10,0,10
"16652","4903聯光通","110/07/09","第一金-台中",0,12,-12
"16653","4903聯光通","110/07/09","凱基-士林",5,0,5
"16654","4903聯光通","110/07/09","日盛-忠孝",0,3,-3
"16655","4903聯光通","110/07/09","元大-苗栗",5,0,5
"16656","4903聯光通","110/07/09","群益金鼎-崇德",0,3,-3
"16657","4903聯光通","110/07/09","元大-屏南",3,0,3
"16658","4903聯光通","110/07/09","國票-內壢",0,2,-2
"16659","4903聯光通","110/07/09","中國信託-永康",1,0,1
"16660","4903聯光通","110/07/09","康和-南崁",0,2,-2
"16661","4903聯光通","110/07/09","玉山證券",1,0,1
"16662","4903聯光通","110/07/09","新光-台中",0,2,-2
"16663","4903聯光通","110/07/09","元大-太平",4,3,1
"16664","4903聯光通","110/07/09","玉山-城中",0,2,-2
"16665","4903聯光通","110/07/09","永豐金-嘉義",1,0,1
"16666","4903聯光通","110/07/09","中國信託-文心",0,1,-1
"16667","4903聯光通","110/07/09","大昌",0,0,0
"16668","4903聯光通","110/07/09","大昌",0,0,0
"16669","4903聯光通","110/07/09","中農",0,0,0
"16670","4903聯光通","110/07/09","中農",0,0,0
"16671","4903聯光通","110/07/09","",NA,NA,NA
"16672","4903聯光通","110/07/09","",NA,NA,NA
"16673","4903聯光通","110/07/09","",NA,NA,NA
"16674","4903聯光通","110/07/09","",NA,NA,NA
"16675","4903聯光通","110/07/09","",NA,NA,NA
"16676","4903聯光通","110/07/09","",NA,NA,NA
"16677","4903聯光通","110/07/09","",NA,NA,NA
"16678","4903聯光通","110/07/09","",NA,NA,NA
"16679","4903聯光通","110/07/09","",NA,NA,NA
"16680","4903聯光通","110/07/09","",NA,NA,NA
"16681","2929淘帝","110/07/09","台中銀-台北",110,0,110
"16682","2929淘帝","110/07/09","新光",2,82,-80
"16683","2929淘帝","110/07/09","華南永昌-頭份",72,0,72
"16684","2929淘帝","110/07/09","摩根大通",2,63,-61
"16685","2929淘帝","110/07/09","合庫-高雄",71,0,71
"16686","2929淘帝","110/07/09","第一金-路竹",0,50,-50
"16687","2929淘帝","110/07/09","高橋-龍潭",37,0,37
"16688","2929淘帝","110/07/09","港商麥格理",0,42,-42
"16689","2929淘帝","110/07/09","新光-台中",60,26,34
"16690","2929淘帝","110/07/09","陽信-石牌",0,40,-40
"16691","2929淘帝","110/07/09","元富-大裕",22,1,21
"16692","2929淘帝","110/07/09","台新-左楠",1,39,-38
"16693","2929淘帝","110/07/09","合庫-鳳山",20,0,20
"16694","2929淘帝","110/07/09","凱基-桃園",3,29,-26
"16695","2929淘帝","110/07/09","元大-員林",22,2,20
"16696","2929淘帝","110/07/09","兆豐-內湖",0,25,-25
"16697","2929淘帝","110/07/09","台新-建北",15,0,15
"16698","2929淘帝","110/07/09","元大-北港",0,20,-20
"16699","2929淘帝","110/07/09","兆豐-桃園",13,0,13
"16700","2929淘帝","110/07/09","富邦-北港",0,19,-19
"16701","2929淘帝","110/07/09","兆豐-忠孝",10,0,10
"16702","2929淘帝","110/07/09","富邦-花蓮",0,17,-17
"16703","2929淘帝","110/07/09","國票-敦北法人",10,0,10
"16704","2929淘帝","110/07/09","國泰-台中",2,17,-15
"16705","2929淘帝","110/07/09","永豐金-博愛",10,0,10
"16706","2929淘帝","110/07/09","群益金鼎-彰化",0,15,-15
"16707","2929淘帝","110/07/09","群益金鼎-潭子",8,0,8
"16708","2929淘帝","110/07/09","元大-博愛",0,14,-14
"16709","2929淘帝","110/07/09","富邦-南屯",8,0,8
"16710","2929淘帝","110/07/09","日盛-板橋",0,13,-13
"16711","5410國眾","110/07/09","元大-新盛",14,0,14
"16712","5410國眾","110/07/09","(牛牛牛)亞-鑫豐",1,41,-40
"16713","5410國眾","110/07/09","台灣企銀-民雄",10,0,10
"16714","5410國眾","110/07/09","元富-嘉義",0,25,-25
"16715","5410國眾","110/07/09","元富-虎尾",9,0,9
"16716","5410國眾","110/07/09","凱基-高美館",0,10,-10
"16717","5410國眾","110/07/09","摩根大通",10,1,9
"16718","5410國眾","110/07/09","凱基-城中",0,10,-10
"16719","5410國眾","110/07/09","兆豐-北高雄",7,0,7
"16720","5410國眾","110/07/09","元大-頭份",0,10,-10
"16721","5410國眾","110/07/09","凱基-台北",8,1,7
"16722","5410國眾","110/07/09","群益金鼎-丹鳳",0,7,-7
"16723","5410國眾","110/07/09","華南永昌-公誠",7,0,7
"16724","5410國眾","110/07/09","凱基-復興",0,7,-7
"16725","5410國眾","110/07/09","香港上海匯豐",6,0,6
"16726","5410國眾","110/07/09","元大-員林",0,7,-7
"16727","5410國眾","110/07/09","凱基-中壢",6,0,6
"16728","5410國眾","110/07/09","富邦-竹東",0,6,-6
"16729","5410國眾","110/07/09","華南永昌-南京",6,0,6
"16730","5410國眾","110/07/09","亞東-高雄",0,5,-5
"16731","5410國眾","110/07/09","統一-三重",5,0,5
"16732","5410國眾","110/07/09","大慶-中壢",1,6,-5
"16733","5410國眾","110/07/09","富邦-宜蘭",5,0,5
"16734","5410國眾","110/07/09","群益金鼎-中港",0,5,-5
"16735","5410國眾","110/07/09","元大-崇德",5,0,5
"16736","5410國眾","110/07/09","元大-八德",0,5,-5
"16737","5410國眾","110/07/09","元大-博愛",5,0,5
"16738","5410國眾","110/07/09","富邦-基隆",0,4,-4
"16739","5410國眾","110/07/09","元大-龍潭",5,0,5
"16740","5410國眾","110/07/09","臺銀-新竹",0,3,-3
"16741","2841台開","110/07/09","日盛-雙和",102,0,102
"16742","2841台開","110/07/09","港商野村",0,129,-129
"16743","2841台開","110/07/09","元大-館前",70,0,70
"16744","2841台開","110/07/09","兆豐-永和",0,100,-100
"16745","2841台開","110/07/09","凱基-文心",50,0,50
"16746","2841台開","110/07/09","台新證券",7,28,-21
"16747","2841台開","110/07/09","富邦-嘉義",40,0,40
"16748","2841台開","110/07/09","國票-北高雄",0,20,-20
"16749","2841台開","110/07/09","美商高盛",15,0,15
"16750","2841台開","110/07/09","永豐金-敦南",29,46,-17
"16751","2841台開","110/07/09","台中銀",15,0,15
"16752","2841台開","110/07/09","合庫-基隆",0,12,-12
"16753","2841台開","110/07/09","新光",11,0,11
"16754","2841台開","110/07/09","中國信託-松江",0,12,-12
"16755","2841台開","110/07/09","華南永昌-長虹",10,0,10
"16756","2841台開","110/07/09","兆豐-城中",0,12,-12
"16757","2841台開","110/07/09","永豐金-南投",10,0,10
"16758","2841台開","110/07/09","台中銀-豐原",0,10,-10
"16759","2841台開","110/07/09","合庫-桃園",7,0,7
"16760","2841台開","110/07/09","兆豐-景美",0,10,-10
"16761","2841台開","110/07/09","群益金鼎-古亭",7,0,7
"16762","2841台開","110/07/09","群益金鼎-基隆",0,10,-10
"16763","2841台開","110/07/09","國泰-敦南",6,0,6
"16764","2841台開","110/07/09","元大-北三重",0,10,-10
"16765","2841台開","110/07/09","凱基-桃園",8,2,6
"16766","2841台開","110/07/09","(牛牛牛)亞-網路",0,9,-9
"16767","2841台開","110/07/09","日盛證券",5,0,5
"16768","2841台開","110/07/09","台新-高雄",1,10,-9
"16769","2841台開","110/07/09","元富-文心",5,0,5
"16770","2841台開","110/07/09","凱基-台北",0,7,-7
"16771","6207雷科","110/07/09","群益金鼎-新竹",47,0,47
"16772","6207雷科","110/07/09","新光",7,24,-17
"16773","6207雷科","110/07/09","永豐金-三重",31,0,31
"16774","6207雷科","110/07/09","日盛-和美",0,15,-15
"16775","6207雷科","110/07/09","新加坡商瑞銀",33,5,28
"16776","6207雷科","110/07/09","國泰-台南",0,15,-15
"16777","6207雷科","110/07/09","元大-高雄",26,0,26
"16778","6207雷科","110/07/09","華南永昌-古亭",0,14,-14
"16779","6207雷科","110/07/09","統一-員林",22,0,22
"16780","6207雷科","110/07/09","土銀-白河",0,11,-11
"16781","6207雷科","110/07/09","台新-高雄",22,0,22
"16782","6207雷科","110/07/09","日盛-台南",0,10,-10
"16783","6207雷科","110/07/09","摩根大通",34,17,17
"16784","6207雷科","110/07/09","元富-林園",0,10,-10
"16785","6207雷科","110/07/09","元大-博愛",17,1,16
"16786","6207雷科","110/07/09","富邦-園區",0,10,-10
"16787","6207雷科","110/07/09","日茂-埔里",12,0,12
"16788","6207雷科","110/07/09","元大-上新莊",0,10,-10
"16789","6207雷科","110/07/09","國泰-台中",17,6,11
"16790","6207雷科","110/07/09","永豐金-南京",0,10,-10
"16791","6207雷科","110/07/09","富邦-三重",10,0,10
"16792","6207雷科","110/07/09","兆豐-小港",0,6,-6
"16793","6207雷科","110/07/09","元大-沙鹿",10,0,10
"16794","6207雷科","110/07/09","富邦-羅東",1,7,-6
"16795","6207雷科","110/07/09","元大-八德",10,0,10
"16796","6207雷科","110/07/09","元大-土城永寧",0,6,-6
"16797","6207雷科","110/07/09","第一金-路竹",11,2,9
"16798","6207雷科","110/07/09","永豐金-板盛",0,6,-6
"16799","6207雷科","110/07/09","統一-南京",5,0,5
"16800","6207雷科","110/07/09","日盛-板橋",0,5,-5
"16801","3679新至陞","110/07/09","元大-大天母",10,0,10
"16802","3679新至陞","110/07/09","第一金-光復",0,11,-11
"16803","3679新至陞","110/07/09","日盛-樹林",9,0,9
"16804","3679新至陞","110/07/09","瑞士信貸",0,8,-8
"16805","3679新至陞","110/07/09","凱基-台北",11,2,9
"16806","3679新至陞","110/07/09","大慶-苗栗",0,5,-5
"16807","3679新至陞","110/07/09","華南永昌-小港",8,0,8
"16808","3679新至陞","110/07/09","元大-永春",0,5,-5
"16809","3679新至陞","110/07/09","兆豐-來福",7,0,7
"16810","3679新至陞","110/07/09","日盛-和美",0,4,-4
"16811","3679新至陞","110/07/09","香港上海匯豐",5,0,5
"16812","3679新至陞","110/07/09","元大-雙和",0,3,-3
"16813","3679新至陞","110/07/09","台中銀-員林",3,0,3
"16814","3679新至陞","110/07/09","永豐金-屏東",0,3,-3
"16815","3679新至陞","110/07/09","新光",3,0,3
"16816","3679新至陞","110/07/09","彰銀",0,2,-2
"16817","3679新至陞","110/07/09","土銀-花蓮",2,0,2
"16818","3679新至陞","110/07/09","宏遠-館前",0,2,-2
"16819","3679新至陞","110/07/09","第一金-澎湖",2,0,2
"16820","3679新至陞","110/07/09","港商野村",0,2,-2
"16821","3679新至陞","110/07/09","摩根大通",2,0,2
"16822","3679新至陞","110/07/09","大昌-新店",0,2,-2
"16823","3679新至陞","110/07/09","國泰-敦南",2,0,2
"16824","3679新至陞","110/07/09","元大-新莊",0,2,-2
"16825","3679新至陞","110/07/09","元大-淡水",4,2,2
"16826","3679新至陞","110/07/09","元大-板橋",0,2,-2
"16827","3679新至陞","110/07/09","日盛-士林",1,0,1
"16828","3679新至陞","110/07/09","台灣摩根士丹利",0,1,-1
"16829","3679新至陞","110/07/09","日盛-信義",1,0,1
"16830","3679新至陞","110/07/09","第一金-高雄",0,1,-1
"16831","2727王品","110/07/09","台灣匯立證券",90,0,90
"16832","2727王品","110/07/09","台灣摩根士丹利",0,267,-267
"16833","2727王品","110/07/09","國泰-敦南",166,84,82
"16834","2727王品","110/07/09","富邦-台北",35,299,-264
"16835","2727王品","110/07/09","富邦-仁愛",56,12,44
"16836","2727王品","110/07/09","凱基-台北",174,296,-122
"16837","2727王品","110/07/09","台新證券",109,66,43
"16838","2727王品","110/07/09","第一金",2,102,-100
"16839","2727王品","110/07/09","新光",117,87,30
"16840","2727王品","110/07/09","群益金鼎-大安",0,80,-80
"16841","2727王品","110/07/09","臺銀-臺中",35,6,29
"16842","2727王品","110/07/09","兆豐-大安",7,60,-53
"16843","2727王品","110/07/09","元大-桃園",32,3,29
"16844","2727王品","110/07/09","永豐金-南投",0,50,-50
"16845","2727王品","110/07/09","元富-宜蘭",34,6,28
"16846","2727王品","110/07/09","新加坡商瑞銀",6,46,-40
"16847","2727王品","110/07/09","玉山-台中",34,8,26
"16848","2727王品","110/07/09","合庫-彰化",11,50,-39
"16849","2727王品","110/07/09","群益金鼎-宜蘭",30,4,26
"16850","2727王品","110/07/09","永豐金-萬盛",13,52,-39
"16851","2727王品","110/07/09","富邦-台中",42,16,26
"16852","2727王品","110/07/09","瑞士信貸",0,34,-34
"16853","2727王品","110/07/09","第一金-豐原",25,1,24
"16854","2727王品","110/07/09","元大-和平",4,35,-31
"16855","2727王品","110/07/09","臺銀",30,8,22
"16856","2727王品","110/07/09","美林",14,44,-30
"16857","2727王品","110/07/09","兆豐-來福",23,1,22
"16858","2727王品","110/07/09","元大-員林",9,38,-29
"16859","2727王品","110/07/09","玉山-士林",22,2,20
"16860","2727王品","110/07/09","元富-西松",4,31,-27
"16861","1570力肯","110/07/09","凱基-台北",30,1,29
"16862","1570力肯","110/07/09","群益金鼎-彰化",0,20,-20
"16863","1570力肯","110/07/09","新光-台南",20,0,20
"16864","1570力肯","110/07/09","元大-土城學府",0,20,-20
"16865","1570力肯","110/07/09","元大-高雄",20,0,20
"16866","1570力肯","110/07/09","元大-大統",0,16,-16
"16867","1570力肯","110/07/09","國票-中正",12,0,12
"16868","1570力肯","110/07/09","元大-新營",0,11,-11
"16869","1570力肯","110/07/09","日盛-高雄",6,0,6
"16870","1570力肯","110/07/09","元大-和平",0,10,-10
"16871","1570力肯","110/07/09","元富-緯城",6,0,6
"16872","1570力肯","110/07/09","元大-草屯",0,10,-10
"16873","1570力肯","110/07/09","群益金鼎-台南",6,0,6
"16874","1570力肯","110/07/09","元大-鹿港",0,9,-9
"16875","1570力肯","110/07/09","華南永昌-岡山",6,0,6
"16876","1570力肯","110/07/09","合庫-基隆",0,7,-7
"16877","1570力肯","110/07/09","統一-中壢",5,0,5
"16878","1570力肯","110/07/09","摩根大通",2,8,-6
"16879","1570力肯","110/07/09","凱基-三峽",5,0,5
"16880","1570力肯","110/07/09","台灣企銀-豐原",0,4,-4
"16881","1570力肯","110/07/09","大昌-樹林",4,0,4
"16882","1570力肯","110/07/09","日盛-桃園",0,4,-4
"16883","1570力肯","110/07/09","新光",3,0,3
"16884","1570力肯","110/07/09","國泰-高雄",0,3,-3
"16885","1570力肯","110/07/09","富邦-新竹華信",3,0,3
"16886","1570力肯","110/07/09","永豐金-敦南",0,3,-3
"16887","1570力肯","110/07/09","合庫-台中",2,0,2
"16888","1570力肯","110/07/09","土銀-彰化",0,2,-2
"16889","1570力肯","110/07/09","臺銀-臺中",2,0,2
"16890","1570力肯","110/07/09","臺銀-鳳山",0,2,-2
"16891","6180橘子","110/07/09","摩根大通",63,1,62
"16892","6180橘子","110/07/09","元大-南京",1,32,-31
"16893","6180橘子","110/07/09","富邦-陽明",73,33,40
"16894","6180橘子","110/07/09","群益金鼎-台北",0,25,-25
"16895","6180橘子","110/07/09","新加坡商瑞銀",31,0,31
"16896","6180橘子","110/07/09","兆豐-復興",0,21,-21
"16897","6180橘子","110/07/09","美商高盛",25,0,25
"16898","6180橘子","110/07/09","永豐金-嘉義",0,21,-21
"16899","6180橘子","110/07/09","凱基-台北",26,10,16
"16900","6180橘子","110/07/09","凱基-中壢",8,24,-16
"16901","6180橘子","110/07/09","華南永昌-楠梓",13,0,13
"16902","6180橘子","110/07/09","致和-崇德",0,15,-15
"16903","6180橘子","110/07/09","華南永昌-朴子",11,0,11
"16904","6180橘子","110/07/09","群益金鼎-屏東",0,15,-15
"16905","6180橘子","110/07/09","元大-北港",11,0,11
"16906","6180橘子","110/07/09","群益金鼎-中山",0,15,-15
"16907","6180橘子","110/07/09","元大-成功",10,1,9
"16908","6180橘子","110/07/09","瑞士信貸",1,15,-14
"16909","6180橘子","110/07/09","新光",26,18,8
"16910","6180橘子","110/07/09","日盛-二林",0,10,-10
"16911","6180橘子","110/07/09","統一-三重",6,0,6
"16912","6180橘子","110/07/09","凱基-東門",0,10,-10
"16913","6180橘子","110/07/09","群益金鼎-嘉義",6,0,6
"16914","6180橘子","110/07/09","華南永昌-三重",0,10,-10
"16915","6180橘子","110/07/09","元大-員林中山",6,0,6
"16916","6180橘子","110/07/09","元大-彰化民生",1,11,-10
"16917","6180橘子","110/07/09","合庫-鳳山",5,0,5
"16918","6180橘子","110/07/09","永豐金-新店",1,11,-10
"16919","6180橘子","110/07/09","富邦-建國",6,1,5
"16920","6180橘子","110/07/09","群益金鼎-丹鳳",0,8,-8
"16921","2390云辰","110/07/09","摩根大通",279,56,223
"16922","2390云辰","110/07/09","元大-天母",0,127,-127
"16923","2390云辰","110/07/09","日盛-鳳山",110,2,108
"16924","2390云辰","110/07/09","中國信託-文心",5,109,-104
"16925","2390云辰","110/07/09","宏遠證券",100,0,100
"16926","2390云辰","110/07/09","永豐金-復興",0,55,-55
"16927","2390云辰","110/07/09","元大-大里",63,6,57
"16928","2390云辰","110/07/09","凱基-台北",239,286,-47
"16929","2390云辰","110/07/09","凱基-八德",59,10,49
"16930","2390云辰","110/07/09","德信",2,32,-30
"16931","2390云辰","110/07/09","合庫-新竹",40,0,40
"16932","2390云辰","110/07/09","兆豐-桃鶯",2,32,-30
"16933","2390云辰","110/07/09","國票",40,1,39
"16934","2390云辰","110/07/09","致和-南京",0,30,-30
"16935","2390云辰","110/07/09","新加坡商瑞銀",49,13,36
"16936","2390云辰","110/07/09","富邦-虎尾",1,31,-30
"16937","2390云辰","110/07/09","統一-新台中",36,2,34
"16938","2390云辰","110/07/09","元大-善化",2,31,-29
"16939","2390云辰","110/07/09","國票-嘉義",31,0,31
"16940","2390云辰","110/07/09","富邦-板橋",0,27,-27
"16941","2390云辰","110/07/09","華南永昌",35,7,28
"16942","2390云辰","110/07/09","富邦-永和",3,28,-25
"16943","2390云辰","110/07/09","玉山-台中",49,22,27
"16944","2390云辰","110/07/09","第一金-自由",20,44,-24
"16945","2390云辰","110/07/09","華南永昌-敦南",25,0,25
"16946","2390云辰","110/07/09","凱基-內湖",0,24,-24
"16947","2390云辰","110/07/09","新光-高雄",27,4,23
"16948","2390云辰","110/07/09","元大-汐止",1,24,-23
"16949","2390云辰","110/07/09","台灣摩根士丹利",85,63,22
"16950","2390云辰","110/07/09","新光-台中",12,33,-21
"16951","4903聯光通","110/07/09","元大-敦南",10,0,10
"16952","4903聯光通","110/07/09","第一金-台中",0,12,-12
"16953","4903聯光通","110/07/09","凱基-士林",5,0,5
"16954","4903聯光通","110/07/09","日盛-忠孝",0,3,-3
"16955","4903聯光通","110/07/09","元大-苗栗",5,0,5
"16956","4903聯光通","110/07/09","群益金鼎-崇德",0,3,-3
"16957","4903聯光通","110/07/09","元大-屏南",3,0,3
"16958","4903聯光通","110/07/09","國票-內壢",0,2,-2
"16959","4903聯光通","110/07/09","中國信託-永康",1,0,1
"16960","4903聯光通","110/07/09","康和-南崁",0,2,-2
"16961","4903聯光通","110/07/09","玉山證券",1,0,1
"16962","4903聯光通","110/07/09","新光-台中",0,2,-2
"16963","4903聯光通","110/07/09","元大-太平",4,3,1
"16964","4903聯光通","110/07/09","玉山-城中",0,2,-2
"16965","4903聯光通","110/07/09","永豐金-嘉義",1,0,1
"16966","4903聯光通","110/07/09","中國信託-文心",0,1,-1
"16967","4903聯光通","110/07/09","大昌",0,0,0
"16968","4903聯光通","110/07/09","大昌",0,0,0
"16969","4903聯光通","110/07/09","中農",0,0,0
"16970","4903聯光通","110/07/09","中農",0,0,0
"16971","4903聯光通","110/07/09","",NA,NA,NA
"16972","4903聯光通","110/07/09","",NA,NA,NA
"16973","4903聯光通","110/07/09","",NA,NA,NA
"16974","4903聯光通","110/07/09","",NA,NA,NA
"16975","4903聯光通","110/07/09","",NA,NA,NA
"16976","4903聯光通","110/07/09","",NA,NA,NA
"16977","4903聯光通","110/07/09","",NA,NA,NA
"16978","4903聯光通","110/07/09","",NA,NA,NA
"16979","4903聯光通","110/07/09","",NA,NA,NA
"16980","4903聯光通","110/07/09","",NA,NA,NA
"16981","2929淘帝","110/07/09","台中銀-台北",110,0,110
"16982","2929淘帝","110/07/09","新光",2,82,-80
"16983","2929淘帝","110/07/09","華南永昌-頭份",72,0,72
"16984","2929淘帝","110/07/09","摩根大通",2,63,-61
"16985","2929淘帝","110/07/09","合庫-高雄",71,0,71
"16986","2929淘帝","110/07/09","第一金-路竹",0,50,-50
"16987","2929淘帝","110/07/09","高橋-龍潭",37,0,37
"16988","2929淘帝","110/07/09","港商麥格理",0,42,-42
"16989","2929淘帝","110/07/09","新光-台中",60,26,34
"16990","2929淘帝","110/07/09","陽信-石牌",0,40,-40
"16991","2929淘帝","110/07/09","元富-大裕",22,1,21
"16992","2929淘帝","110/07/09","台新-左楠",1,39,-38
"16993","2929淘帝","110/07/09","合庫-鳳山",20,0,20
"16994","2929淘帝","110/07/09","凱基-桃園",3,29,-26
"16995","2929淘帝","110/07/09","元大-員林",22,2,20
"16996","2929淘帝","110/07/09","兆豐-內湖",0,25,-25
"16997","2929淘帝","110/07/09","台新-建北",15,0,15
"16998","2929淘帝","110/07/09","元大-北港",0,20,-20
"16999","2929淘帝","110/07/09","兆豐-桃園",13,0,13
"17000","2929淘帝","110/07/09","富邦-北港",0,19,-19
"17001","2929淘帝","110/07/09","兆豐-忠孝",10,0,10
"17002","2929淘帝","110/07/09","富邦-花蓮",0,17,-17
"17003","2929淘帝","110/07/09","國票-敦北法人",10,0,10
"17004","2929淘帝","110/07/09","國泰-台中",2,17,-15
"17005","2929淘帝","110/07/09","永豐金-博愛",10,0,10
"17006","2929淘帝","110/07/09","群益金鼎-彰化",0,15,-15
"17007","2929淘帝","110/07/09","群益金鼎-潭子",8,0,8
"17008","2929淘帝","110/07/09","元大-博愛",0,14,-14
"17009","2929淘帝","110/07/09","富邦-南屯",8,0,8
"17010","2929淘帝","110/07/09","日盛-板橋",0,13,-13
"17011","5410國眾","110/07/09","元大-新盛",14,0,14
"17012","5410國眾","110/07/09","(牛牛牛)亞-鑫豐",1,41,-40
"17013","5410國眾","110/07/09","台灣企銀-民雄",10,0,10
"17014","5410國眾","110/07/09","元富-嘉義",0,25,-25
"17015","5410國眾","110/07/09","元富-虎尾",9,0,9
"17016","5410國眾","110/07/09","凱基-高美館",0,10,-10
"17017","5410國眾","110/07/09","摩根大通",10,1,9
"17018","5410國眾","110/07/09","凱基-城中",0,10,-10
"17019","5410國眾","110/07/09","兆豐-北高雄",7,0,7
"17020","5410國眾","110/07/09","元大-頭份",0,10,-10
"17021","5410國眾","110/07/09","凱基-台北",8,1,7
"17022","5410國眾","110/07/09","群益金鼎-丹鳳",0,7,-7
"17023","5410國眾","110/07/09","華南永昌-公誠",7,0,7
"17024","5410國眾","110/07/09","凱基-復興",0,7,-7
"17025","5410國眾","110/07/09","香港上海匯豐",6,0,6
"17026","5410國眾","110/07/09","元大-員林",0,7,-7
"17027","5410國眾","110/07/09","凱基-中壢",6,0,6
"17028","5410國眾","110/07/09","富邦-竹東",0,6,-6
"17029","5410國眾","110/07/09","華南永昌-南京",6,0,6
"17030","5410國眾","110/07/09","亞東-高雄",0,5,-5
"17031","5410國眾","110/07/09","統一-三重",5,0,5
"17032","5410國眾","110/07/09","大慶-中壢",1,6,-5
"17033","5410國眾","110/07/09","富邦-宜蘭",5,0,5
"17034","5410國眾","110/07/09","群益金鼎-中港",0,5,-5
"17035","5410國眾","110/07/09","元大-崇德",5,0,5
"17036","5410國眾","110/07/09","元大-八德",0,5,-5
"17037","5410國眾","110/07/09","元大-博愛",5,0,5
"17038","5410國眾","110/07/09","富邦-基隆",0,4,-4
"17039","5410國眾","110/07/09","元大-龍潭",5,0,5
"17040","5410國眾","110/07/09","臺銀-新竹",0,3,-3
"17041","2841台開","110/07/09","日盛-雙和",102,0,102
"17042","2841台開","110/07/09","港商野村",0,129,-129
"17043","2841台開","110/07/09","元大-館前",70,0,70
"17044","2841台開","110/07/09","兆豐-永和",0,100,-100
"17045","2841台開","110/07/09","凱基-文心",50,0,50
"17046","2841台開","110/07/09","台新證券",7,28,-21
"17047","2841台開","110/07/09","富邦-嘉義",40,0,40
"17048","2841台開","110/07/09","國票-北高雄",0,20,-20
"17049","2841台開","110/07/09","美商高盛",15,0,15
"17050","2841台開","110/07/09","永豐金-敦南",29,46,-17
"17051","2841台開","110/07/09","台中銀",15,0,15
"17052","2841台開","110/07/09","合庫-基隆",0,12,-12
"17053","2841台開","110/07/09","新光",11,0,11
"17054","2841台開","110/07/09","中國信託-松江",0,12,-12
"17055","2841台開","110/07/09","華南永昌-長虹",10,0,10
"17056","2841台開","110/07/09","兆豐-城中",0,12,-12
"17057","2841台開","110/07/09","永豐金-南投",10,0,10
"17058","2841台開","110/07/09","台中銀-豐原",0,10,-10
"17059","2841台開","110/07/09","合庫-桃園",7,0,7
"17060","2841台開","110/07/09","兆豐-景美",0,10,-10
"17061","2841台開","110/07/09","群益金鼎-古亭",7,0,7
"17062","2841台開","110/07/09","群益金鼎-基隆",0,10,-10
"17063","2841台開","110/07/09","國泰-敦南",6,0,6
"17064","2841台開","110/07/09","元大-北三重",0,10,-10
"17065","2841台開","110/07/09","凱基-桃園",8,2,6
"17066","2841台開","110/07/09","(牛牛牛)亞-網路",0,9,-9
"17067","2841台開","110/07/09","日盛證券",5,0,5
"17068","2841台開","110/07/09","台新-高雄",1,10,-9
"17069","2841台開","110/07/09","元富-文心",5,0,5
"17070","2841台開","110/07/09","凱基-台北",0,7,-7
"17071","6207雷科","110/07/09","群益金鼎-新竹",47,0,47
"17072","6207雷科","110/07/09","新光",7,24,-17
"17073","6207雷科","110/07/09","永豐金-三重",31,0,31
"17074","6207雷科","110/07/09","日盛-和美",0,15,-15
"17075","6207雷科","110/07/09","新加坡商瑞銀",33,5,28
"17076","6207雷科","110/07/09","國泰-台南",0,15,-15
"17077","6207雷科","110/07/09","元大-高雄",26,0,26
"17078","6207雷科","110/07/09","華南永昌-古亭",0,14,-14
"17079","6207雷科","110/07/09","統一-員林",22,0,22
"17080","6207雷科","110/07/09","土銀-白河",0,11,-11
"17081","6207雷科","110/07/09","台新-高雄",22,0,22
"17082","6207雷科","110/07/09","日盛-台南",0,10,-10
"17083","6207雷科","110/07/09","摩根大通",34,17,17
"17084","6207雷科","110/07/09","元富-林園",0,10,-10
"17085","6207雷科","110/07/09","元大-博愛",17,1,16
"17086","6207雷科","110/07/09","富邦-園區",0,10,-10
"17087","6207雷科","110/07/09","日茂-埔里",12,0,12
"17088","6207雷科","110/07/09","元大-上新莊",0,10,-10
"17089","6207雷科","110/07/09","國泰-台中",17,6,11
"17090","6207雷科","110/07/09","永豐金-南京",0,10,-10
"17091","6207雷科","110/07/09","富邦-三重",10,0,10
"17092","6207雷科","110/07/09","兆豐-小港",0,6,-6
"17093","6207雷科","110/07/09","元大-沙鹿",10,0,10
"17094","6207雷科","110/07/09","富邦-羅東",1,7,-6
"17095","6207雷科","110/07/09","元大-八德",10,0,10
"17096","6207雷科","110/07/09","元大-土城永寧",0,6,-6
"17097","6207雷科","110/07/09","第一金-路竹",11,2,9
"17098","6207雷科","110/07/09","永豐金-板盛",0,6,-6
"17099","6207雷科","110/07/09","統一-南京",5,0,5
"17100","6207雷科","110/07/09","日盛-板橋",0,5,-5
"17101","3679新至陞","110/07/09","元大-大天母",10,0,10
"17102","3679新至陞","110/07/09","第一金-光復",0,11,-11
"17103","3679新至陞","110/07/09","日盛-樹林",9,0,9
"17104","3679新至陞","110/07/09","瑞士信貸",0,8,-8
"17105","3679新至陞","110/07/09","凱基-台北",11,2,9
"17106","3679新至陞","110/07/09","大慶-苗栗",0,5,-5
"17107","3679新至陞","110/07/09","華南永昌-小港",8,0,8
"17108","3679新至陞","110/07/09","元大-永春",0,5,-5
"17109","3679新至陞","110/07/09","兆豐-來福",7,0,7
"17110","3679新至陞","110/07/09","日盛-和美",0,4,-4
"17111","3679新至陞","110/07/09","香港上海匯豐",5,0,5
"17112","3679新至陞","110/07/09","元大-雙和",0,3,-3
"17113","3679新至陞","110/07/09","台中銀-員林",3,0,3
"17114","3679新至陞","110/07/09","永豐金-屏東",0,3,-3
"17115","3679新至陞","110/07/09","新光",3,0,3
"17116","3679新至陞","110/07/09","彰銀",0,2,-2
"17117","3679新至陞","110/07/09","土銀-花蓮",2,0,2
"17118","3679新至陞","110/07/09","宏遠-館前",0,2,-2
"17119","3679新至陞","110/07/09","第一金-澎湖",2,0,2
"17120","3679新至陞","110/07/09","港商野村",0,2,-2
"17121","3679新至陞","110/07/09","摩根大通",2,0,2
"17122","3679新至陞","110/07/09","大昌-新店",0,2,-2
"17123","3679新至陞","110/07/09","國泰-敦南",2,0,2
"17124","3679新至陞","110/07/09","元大-新莊",0,2,-2
"17125","3679新至陞","110/07/09","元大-淡水",4,2,2
"17126","3679新至陞","110/07/09","元大-板橋",0,2,-2
"17127","3679新至陞","110/07/09","日盛-士林",1,0,1
"17128","3679新至陞","110/07/09","台灣摩根士丹利",0,1,-1
"17129","3679新至陞","110/07/09","日盛-信義",1,0,1
"17130","3679新至陞","110/07/09","第一金-高雄",0,1,-1
"17131","2727王品","110/07/09","台灣匯立證券",90,0,90
"17132","2727王品","110/07/09","台灣摩根士丹利",0,267,-267
"17133","2727王品","110/07/09","國泰-敦南",166,84,82
"17134","2727王品","110/07/09","富邦-台北",35,299,-264
"17135","2727王品","110/07/09","富邦-仁愛",56,12,44
"17136","2727王品","110/07/09","凱基-台北",174,296,-122
"17137","2727王品","110/07/09","台新證券",109,66,43
"17138","2727王品","110/07/09","第一金",2,102,-100
"17139","2727王品","110/07/09","新光",117,87,30
"17140","2727王品","110/07/09","群益金鼎-大安",0,80,-80
"17141","2727王品","110/07/09","臺銀-臺中",35,6,29
"17142","2727王品","110/07/09","兆豐-大安",7,60,-53
"17143","2727王品","110/07/09","元大-桃園",32,3,29
"17144","2727王品","110/07/09","永豐金-南投",0,50,-50
"17145","2727王品","110/07/09","元富-宜蘭",34,6,28
"17146","2727王品","110/07/09","新加坡商瑞銀",6,46,-40
"17147","2727王品","110/07/09","玉山-台中",34,8,26
"17148","2727王品","110/07/09","合庫-彰化",11,50,-39
"17149","2727王品","110/07/09","群益金鼎-宜蘭",30,4,26
"17150","2727王品","110/07/09","永豐金-萬盛",13,52,-39
"17151","2727王品","110/07/09","富邦-台中",42,16,26
"17152","2727王品","110/07/09","瑞士信貸",0,34,-34
"17153","2727王品","110/07/09","第一金-豐原",25,1,24
"17154","2727王品","110/07/09","元大-和平",4,35,-31
"17155","2727王品","110/07/09","臺銀",30,8,22
"17156","2727王品","110/07/09","美林",14,44,-30
"17157","2727王品","110/07/09","兆豐-來福",23,1,22
"17158","2727王品","110/07/09","元大-員林",9,38,-29
"17159","2727王品","110/07/09","玉山-士林",22,2,20
"17160","2727王品","110/07/09","元富-西松",4,31,-27
"17161","1570力肯","110/07/09","凱基-台北",30,1,29
"17162","1570力肯","110/07/09","群益金鼎-彰化",0,20,-20
"17163","1570力肯","110/07/09","新光-台南",20,0,20
"17164","1570力肯","110/07/09","元大-土城學府",0,20,-20
"17165","1570力肯","110/07/09","元大-高雄",20,0,20
"17166","1570力肯","110/07/09","元大-大統",0,16,-16
"17167","1570力肯","110/07/09","國票-中正",12,0,12
"17168","1570力肯","110/07/09","元大-新營",0,11,-11
"17169","1570力肯","110/07/09","日盛-高雄",6,0,6
"17170","1570力肯","110/07/09","元大-和平",0,10,-10
"17171","1570力肯","110/07/09","元富-緯城",6,0,6
"17172","1570力肯","110/07/09","元大-草屯",0,10,-10
"17173","1570力肯","110/07/09","群益金鼎-台南",6,0,6
"17174","1570力肯","110/07/09","元大-鹿港",0,9,-9
"17175","1570力肯","110/07/09","華南永昌-岡山",6,0,6
"17176","1570力肯","110/07/09","合庫-基隆",0,7,-7
"17177","1570力肯","110/07/09","統一-中壢",5,0,5
"17178","1570力肯","110/07/09","摩根大通",2,8,-6
"17179","1570力肯","110/07/09","凱基-三峽",5,0,5
"17180","1570力肯","110/07/09","台灣企銀-豐原",0,4,-4
"17181","1570力肯","110/07/09","大昌-樹林",4,0,4
"17182","1570力肯","110/07/09","日盛-桃園",0,4,-4
"17183","1570力肯","110/07/09","新光",3,0,3
"17184","1570力肯","110/07/09","國泰-高雄",0,3,-3
"17185","1570力肯","110/07/09","富邦-新竹華信",3,0,3
"17186","1570力肯","110/07/09","永豐金-敦南",0,3,-3
"17187","1570力肯","110/07/09","合庫-台中",2,0,2
"17188","1570力肯","110/07/09","土銀-彰化",0,2,-2
"17189","1570力肯","110/07/09","臺銀-臺中",2,0,2
"17190","1570力肯","110/07/09","臺銀-鳳山",0,2,-2
"17191","6180橘子","110/07/09","摩根大通",63,1,62
"17192","6180橘子","110/07/09","元大-南京",1,32,-31
"17193","6180橘子","110/07/09","富邦-陽明",73,33,40
"17194","6180橘子","110/07/09","群益金鼎-台北",0,25,-25
"17195","6180橘子","110/07/09","新加坡商瑞銀",31,0,31
"17196","6180橘子","110/07/09","兆豐-復興",0,21,-21
"17197","6180橘子","110/07/09","美商高盛",25,0,25
"17198","6180橘子","110/07/09","永豐金-嘉義",0,21,-21
"17199","6180橘子","110/07/09","凱基-台北",26,10,16
"17200","6180橘子","110/07/09","凱基-中壢",8,24,-16
"17201","6180橘子","110/07/09","華南永昌-楠梓",13,0,13
"17202","6180橘子","110/07/09","致和-崇德",0,15,-15
"17203","6180橘子","110/07/09","華南永昌-朴子",11,0,11
"17204","6180橘子","110/07/09","群益金鼎-屏東",0,15,-15
"17205","6180橘子","110/07/09","元大-北港",11,0,11
"17206","6180橘子","110/07/09","群益金鼎-中山",0,15,-15
"17207","6180橘子","110/07/09","元大-成功",10,1,9
"17208","6180橘子","110/07/09","瑞士信貸",1,15,-14
"17209","6180橘子","110/07/09","新光",26,18,8
"17210","6180橘子","110/07/09","日盛-二林",0,10,-10
"17211","6180橘子","110/07/09","統一-三重",6,0,6
"17212","6180橘子","110/07/09","凱基-東門",0,10,-10
"17213","6180橘子","110/07/09","群益金鼎-嘉義",6,0,6
"17214","6180橘子","110/07/09","華南永昌-三重",0,10,-10
"17215","6180橘子","110/07/09","元大-員林中山",6,0,6
"17216","6180橘子","110/07/09","元大-彰化民生",1,11,-10
"17217","6180橘子","110/07/09","合庫-鳳山",5,0,5
"17218","6180橘子","110/07/09","永豐金-新店",1,11,-10
"17219","6180橘子","110/07/09","富邦-建國",6,1,5
"17220","6180橘子","110/07/09","群益金鼎-丹鳳",0,8,-8
"17221","2390云辰","110/07/09","摩根大通",279,56,223
"17222","2390云辰","110/07/09","元大-天母",0,127,-127
"17223","2390云辰","110/07/09","日盛-鳳山",110,2,108
"17224","2390云辰","110/07/09","中國信託-文心",5,109,-104
"17225","2390云辰","110/07/09","宏遠證券",100,0,100
"17226","2390云辰","110/07/09","永豐金-復興",0,55,-55
"17227","2390云辰","110/07/09","元大-大里",63,6,57
"17228","2390云辰","110/07/09","凱基-台北",239,286,-47
"17229","2390云辰","110/07/09","凱基-八德",59,10,49
"17230","2390云辰","110/07/09","德信",2,32,-30
"17231","2390云辰","110/07/09","合庫-新竹",40,0,40
"17232","2390云辰","110/07/09","兆豐-桃鶯",2,32,-30
"17233","2390云辰","110/07/09","國票",40,1,39
"17234","2390云辰","110/07/09","致和-南京",0,30,-30
"17235","2390云辰","110/07/09","新加坡商瑞銀",49,13,36
"17236","2390云辰","110/07/09","富邦-虎尾",1,31,-30
"17237","2390云辰","110/07/09","統一-新台中",36,2,34
"17238","2390云辰","110/07/09","元大-善化",2,31,-29
"17239","2390云辰","110/07/09","國票-嘉義",31,0,31
"17240","2390云辰","110/07/09","富邦-板橋",0,27,-27
"17241","2390云辰","110/07/09","華南永昌",35,7,28
"17242","2390云辰","110/07/09","富邦-永和",3,28,-25
"17243","2390云辰","110/07/09","玉山-台中",49,22,27
"17244","2390云辰","110/07/09","第一金-自由",20,44,-24
"17245","2390云辰","110/07/09","華南永昌-敦南",25,0,25
"17246","2390云辰","110/07/09","凱基-內湖",0,24,-24
"17247","2390云辰","110/07/09","新光-高雄",27,4,23
"17248","2390云辰","110/07/09","元大-汐止",1,24,-23
"17249","2390云辰","110/07/09","台灣摩根士丹利",85,63,22
"17250","2390云辰","110/07/09","新光-台中",12,33,-21
"17251","4903聯光通","110/07/09","元大-敦南",10,0,10
"17252","4903聯光通","110/07/09","第一金-台中",0,12,-12
"17253","4903聯光通","110/07/09","凱基-士林",5,0,5
"17254","4903聯光通","110/07/09","日盛-忠孝",0,3,-3
"17255","4903聯光通","110/07/09","元大-苗栗",5,0,5
"17256","4903聯光通","110/07/09","群益金鼎-崇德",0,3,-3
"17257","4903聯光通","110/07/09","元大-屏南",3,0,3
"17258","4903聯光通","110/07/09","國票-內壢",0,2,-2
"17259","4903聯光通","110/07/09","中國信託-永康",1,0,1
"17260","4903聯光通","110/07/09","康和-南崁",0,2,-2
"17261","4903聯光通","110/07/09","玉山證券",1,0,1
"17262","4903聯光通","110/07/09","新光-台中",0,2,-2
"17263","4903聯光通","110/07/09","元大-太平",4,3,1
"17264","4903聯光通","110/07/09","玉山-城中",0,2,-2
"17265","4903聯光通","110/07/09","永豐金-嘉義",1,0,1
"17266","4903聯光通","110/07/09","中國信託-文心",0,1,-1
"17267","4903聯光通","110/07/09","大昌",0,0,0
"17268","4903聯光通","110/07/09","大昌",0,0,0
"17269","4903聯光通","110/07/09","中農",0,0,0
"17270","4903聯光通","110/07/09","中農",0,0,0
"17271","2929淘帝","110/07/09","台中銀-台北",110,0,110
"17272","2929淘帝","110/07/09","新光",2,82,-80
"17273","2929淘帝","110/07/09","華南永昌-頭份",72,0,72
"17274","2929淘帝","110/07/09","摩根大通",2,63,-61
"17275","2929淘帝","110/07/09","合庫-高雄",71,0,71
"17276","2929淘帝","110/07/09","第一金-路竹",0,50,-50
"17277","2929淘帝","110/07/09","高橋-龍潭",37,0,37
"17278","2929淘帝","110/07/09","港商麥格理",0,42,-42
"17279","2929淘帝","110/07/09","新光-台中",60,26,34
"17280","2929淘帝","110/07/09","陽信-石牌",0,40,-40
"17281","2929淘帝","110/07/09","元富-大裕",22,1,21
"17282","2929淘帝","110/07/09","台新-左楠",1,39,-38
"17283","2929淘帝","110/07/09","合庫-鳳山",20,0,20
"17284","2929淘帝","110/07/09","凱基-桃園",3,29,-26
"17285","2929淘帝","110/07/09","元大-員林",22,2,20
"17286","2929淘帝","110/07/09","兆豐-內湖",0,25,-25
"17287","2929淘帝","110/07/09","台新-建北",15,0,15
"17288","2929淘帝","110/07/09","元大-北港",0,20,-20
"17289","2929淘帝","110/07/09","兆豐-桃園",13,0,13
"17290","2929淘帝","110/07/09","富邦-北港",0,19,-19
"17291","2929淘帝","110/07/09","兆豐-忠孝",10,0,10
"17292","2929淘帝","110/07/09","富邦-花蓮",0,17,-17
"17293","2929淘帝","110/07/09","國票-敦北法人",10,0,10
"17294","2929淘帝","110/07/09","國泰-台中",2,17,-15
"17295","2929淘帝","110/07/09","永豐金-博愛",10,0,10
"17296","2929淘帝","110/07/09","群益金鼎-彰化",0,15,-15
"17297","2929淘帝","110/07/09","群益金鼎-潭子",8,0,8
"17298","2929淘帝","110/07/09","元大-博愛",0,14,-14
"17299","2929淘帝","110/07/09","富邦-南屯",8,0,8
"17300","2929淘帝","110/07/09","日盛-板橋",0,13,-13
"17301","5410國眾","110/07/09","元大-新盛",14,0,14
"17302","5410國眾","110/07/09","(牛牛牛)亞-鑫豐",1,41,-40
"17303","5410國眾","110/07/09","台灣企銀-民雄",10,0,10
"17304","5410國眾","110/07/09","元富-嘉義",0,25,-25
"17305","5410國眾","110/07/09","元富-虎尾",9,0,9
"17306","5410國眾","110/07/09","凱基-高美館",0,10,-10
"17307","5410國眾","110/07/09","摩根大通",10,1,9
"17308","5410國眾","110/07/09","凱基-城中",0,10,-10
"17309","5410國眾","110/07/09","兆豐-北高雄",7,0,7
"17310","5410國眾","110/07/09","元大-頭份",0,10,-10
"17311","5410國眾","110/07/09","凱基-台北",8,1,7
"17312","5410國眾","110/07/09","群益金鼎-丹鳳",0,7,-7
"17313","5410國眾","110/07/09","華南永昌-公誠",7,0,7
"17314","5410國眾","110/07/09","凱基-復興",0,7,-7
"17315","5410國眾","110/07/09","香港上海匯豐",6,0,6
"17316","5410國眾","110/07/09","元大-員林",0,7,-7
"17317","5410國眾","110/07/09","凱基-中壢",6,0,6
"17318","5410國眾","110/07/09","富邦-竹東",0,6,-6
"17319","5410國眾","110/07/09","華南永昌-南京",6,0,6
"17320","5410國眾","110/07/09","亞東-高雄",0,5,-5
"17321","5410國眾","110/07/09","統一-三重",5,0,5
"17322","5410國眾","110/07/09","大慶-中壢",1,6,-5
"17323","5410國眾","110/07/09","富邦-宜蘭",5,0,5
"17324","5410國眾","110/07/09","群益金鼎-中港",0,5,-5
"17325","5410國眾","110/07/09","元大-崇德",5,0,5
"17326","5410國眾","110/07/09","元大-八德",0,5,-5
"17327","5410國眾","110/07/09","元大-博愛",5,0,5
"17328","5410國眾","110/07/09","富邦-基隆",0,4,-4
"17329","5410國眾","110/07/09","元大-龍潭",5,0,5
"17330","5410國眾","110/07/09","臺銀-新竹",0,3,-3
"17331","2841台開","110/07/09","日盛-雙和",102,0,102
"17332","2841台開","110/07/09","港商野村",0,129,-129
"17333","2841台開","110/07/09","元大-館前",70,0,70
"17334","2841台開","110/07/09","兆豐-永和",0,100,-100
"17335","2841台開","110/07/09","凱基-文心",50,0,50
"17336","2841台開","110/07/09","台新證券",7,28,-21
"17337","2841台開","110/07/09","富邦-嘉義",40,0,40
"17338","2841台開","110/07/09","國票-北高雄",0,20,-20
"17339","2841台開","110/07/09","美商高盛",15,0,15
"17340","2841台開","110/07/09","永豐金-敦南",29,46,-17
"17341","2841台開","110/07/09","台中銀",15,0,15
"17342","2841台開","110/07/09","合庫-基隆",0,12,-12
"17343","2841台開","110/07/09","新光",11,0,11
"17344","2841台開","110/07/09","中國信託-松江",0,12,-12
"17345","2841台開","110/07/09","華南永昌-長虹",10,0,10
"17346","2841台開","110/07/09","兆豐-城中",0,12,-12
"17347","2841台開","110/07/09","永豐金-南投",10,0,10
"17348","2841台開","110/07/09","台中銀-豐原",0,10,-10
"17349","2841台開","110/07/09","合庫-桃園",7,0,7
"17350","2841台開","110/07/09","兆豐-景美",0,10,-10
"17351","2841台開","110/07/09","群益金鼎-古亭",7,0,7
"17352","2841台開","110/07/09","群益金鼎-基隆",0,10,-10
"17353","2841台開","110/07/09","國泰-敦南",6,0,6
"17354","2841台開","110/07/09","元大-北三重",0,10,-10
"17355","2841台開","110/07/09","凱基-桃園",8,2,6
"17356","2841台開","110/07/09","(牛牛牛)亞-網路",0,9,-9
"17357","2841台開","110/07/09","日盛證券",5,0,5
"17358","2841台開","110/07/09","台新-高雄",1,10,-9
"17359","2841台開","110/07/09","元富-文心",5,0,5
"17360","2841台開","110/07/09","凱基-台北",0,7,-7
"17361","6207雷科","110/07/09","群益金鼎-新竹",47,0,47
"17362","6207雷科","110/07/09","新光",7,24,-17
"17363","6207雷科","110/07/09","永豐金-三重",31,0,31
"17364","6207雷科","110/07/09","日盛-和美",0,15,-15
"17365","6207雷科","110/07/09","新加坡商瑞銀",33,5,28
"17366","6207雷科","110/07/09","國泰-台南",0,15,-15
"17367","6207雷科","110/07/09","元大-高雄",26,0,26
"17368","6207雷科","110/07/09","華南永昌-古亭",0,14,-14
"17369","6207雷科","110/07/09","統一-員林",22,0,22
"17370","6207雷科","110/07/09","土銀-白河",0,11,-11
"17371","6207雷科","110/07/09","台新-高雄",22,0,22
"17372","6207雷科","110/07/09","日盛-台南",0,10,-10
"17373","6207雷科","110/07/09","摩根大通",34,17,17
"17374","6207雷科","110/07/09","元富-林園",0,10,-10
"17375","6207雷科","110/07/09","元大-博愛",17,1,16
"17376","6207雷科","110/07/09","富邦-園區",0,10,-10
"17377","6207雷科","110/07/09","日茂-埔里",12,0,12
"17378","6207雷科","110/07/09","元大-上新莊",0,10,-10
"17379","6207雷科","110/07/09","國泰-台中",17,6,11
"17380","6207雷科","110/07/09","永豐金-南京",0,10,-10
"17381","6207雷科","110/07/09","富邦-三重",10,0,10
"17382","6207雷科","110/07/09","兆豐-小港",0,6,-6
"17383","6207雷科","110/07/09","元大-沙鹿",10,0,10
"17384","6207雷科","110/07/09","富邦-羅東",1,7,-6
"17385","6207雷科","110/07/09","元大-八德",10,0,10
"17386","6207雷科","110/07/09","元大-土城永寧",0,6,-6
"17387","6207雷科","110/07/09","第一金-路竹",11,2,9
"17388","6207雷科","110/07/09","永豐金-板盛",0,6,-6
"17389","6207雷科","110/07/09","統一-南京",5,0,5
"17390","6207雷科","110/07/09","日盛-板橋",0,5,-5
"17391","3679新至陞","110/07/09","元大-大天母",10,0,10
"17392","3679新至陞","110/07/09","第一金-光復",0,11,-11
"17393","3679新至陞","110/07/09","日盛-樹林",9,0,9
"17394","3679新至陞","110/07/09","瑞士信貸",0,8,-8
"17395","3679新至陞","110/07/09","凱基-台北",11,2,9
"17396","3679新至陞","110/07/09","大慶-苗栗",0,5,-5
"17397","3679新至陞","110/07/09","華南永昌-小港",8,0,8
"17398","3679新至陞","110/07/09","元大-永春",0,5,-5
"17399","3679新至陞","110/07/09","兆豐-來福",7,0,7
"17400","3679新至陞","110/07/09","日盛-和美",0,4,-4
"17401","3679新至陞","110/07/09","香港上海匯豐",5,0,5
"17402","3679新至陞","110/07/09","元大-雙和",0,3,-3
"17403","3679新至陞","110/07/09","台中銀-員林",3,0,3
"17404","3679新至陞","110/07/09","永豐金-屏東",0,3,-3
"17405","3679新至陞","110/07/09","新光",3,0,3
"17406","3679新至陞","110/07/09","彰銀",0,2,-2
"17407","3679新至陞","110/07/09","土銀-花蓮",2,0,2
"17408","3679新至陞","110/07/09","宏遠-館前",0,2,-2
"17409","3679新至陞","110/07/09","第一金-澎湖",2,0,2
"17410","3679新至陞","110/07/09","港商野村",0,2,-2
"17411","3679新至陞","110/07/09","摩根大通",2,0,2
"17412","3679新至陞","110/07/09","大昌-新店",0,2,-2
"17413","3679新至陞","110/07/09","國泰-敦南",2,0,2
"17414","3679新至陞","110/07/09","元大-新莊",0,2,-2
"17415","3679新至陞","110/07/09","元大-淡水",4,2,2
"17416","3679新至陞","110/07/09","元大-板橋",0,2,-2
"17417","3679新至陞","110/07/09","日盛-士林",1,0,1
"17418","3679新至陞","110/07/09","台灣摩根士丹利",0,1,-1
"17419","3679新至陞","110/07/09","日盛-信義",1,0,1
"17420","3679新至陞","110/07/09","第一金-高雄",0,1,-1
"17421","2727王品","110/07/09","台灣匯立證券",90,0,90
"17422","2727王品","110/07/09","台灣摩根士丹利",0,267,-267
"17423","2727王品","110/07/09","國泰-敦南",166,84,82
"17424","2727王品","110/07/09","富邦-台北",35,299,-264
"17425","2727王品","110/07/09","富邦-仁愛",56,12,44
"17426","2727王品","110/07/09","凱基-台北",174,296,-122
"17427","2727王品","110/07/09","台新證券",109,66,43
"17428","2727王品","110/07/09","第一金",2,102,-100
"17429","2727王品","110/07/09","新光",117,87,30
"17430","2727王品","110/07/09","群益金鼎-大安",0,80,-80
"17431","2727王品","110/07/09","臺銀-臺中",35,6,29
"17432","2727王品","110/07/09","兆豐-大安",7,60,-53
"17433","2727王品","110/07/09","元大-桃園",32,3,29
"17434","2727王品","110/07/09","永豐金-南投",0,50,-50
"17435","2727王品","110/07/09","元富-宜蘭",34,6,28
"17436","2727王品","110/07/09","新加坡商瑞銀",6,46,-40
"17437","2727王品","110/07/09","玉山-台中",34,8,26
"17438","2727王品","110/07/09","合庫-彰化",11,50,-39
"17439","2727王品","110/07/09","群益金鼎-宜蘭",30,4,26
"17440","2727王品","110/07/09","永豐金-萬盛",13,52,-39
"17441","2727王品","110/07/09","富邦-台中",42,16,26
"17442","2727王品","110/07/09","瑞士信貸",0,34,-34
"17443","2727王品","110/07/09","第一金-豐原",25,1,24
"17444","2727王品","110/07/09","元大-和平",4,35,-31
"17445","2727王品","110/07/09","臺銀",30,8,22
"17446","2727王品","110/07/09","美林",14,44,-30
"17447","2727王品","110/07/09","兆豐-來福",23,1,22
"17448","2727王品","110/07/09","元大-員林",9,38,-29
"17449","2727王品","110/07/09","玉山-士林",22,2,20
"17450","2727王品","110/07/09","元富-西松",4,31,-27
"17451","1570力肯","110/07/09","凱基-台北",30,1,29
"17452","1570力肯","110/07/09","群益金鼎-彰化",0,20,-20
"17453","1570力肯","110/07/09","新光-台南",20,0,20
"17454","1570力肯","110/07/09","元大-土城學府",0,20,-20
"17455","1570力肯","110/07/09","元大-高雄",20,0,20
"17456","1570力肯","110/07/09","元大-大統",0,16,-16
"17457","1570力肯","110/07/09","國票-中正",12,0,12
"17458","1570力肯","110/07/09","元大-新營",0,11,-11
"17459","1570力肯","110/07/09","日盛-高雄",6,0,6
"17460","1570力肯","110/07/09","元大-和平",0,10,-10
"17461","1570力肯","110/07/09","元富-緯城",6,0,6
"17462","1570力肯","110/07/09","元大-草屯",0,10,-10
"17463","1570力肯","110/07/09","群益金鼎-台南",6,0,6
"17464","1570力肯","110/07/09","元大-鹿港",0,9,-9
"17465","1570力肯","110/07/09","華南永昌-岡山",6,0,6
"17466","1570力肯","110/07/09","合庫-基隆",0,7,-7
"17467","1570力肯","110/07/09","統一-中壢",5,0,5
"17468","1570力肯","110/07/09","摩根大通",2,8,-6
"17469","1570力肯","110/07/09","凱基-三峽",5,0,5
"17470","1570力肯","110/07/09","台灣企銀-豐原",0,4,-4
"17471","1570力肯","110/07/09","大昌-樹林",4,0,4
"17472","1570力肯","110/07/09","日盛-桃園",0,4,-4
"17473","1570力肯","110/07/09","新光",3,0,3
"17474","1570力肯","110/07/09","國泰-高雄",0,3,-3
"17475","1570力肯","110/07/09","富邦-新竹華信",3,0,3
"17476","1570力肯","110/07/09","永豐金-敦南",0,3,-3
"17477","1570力肯","110/07/09","合庫-台中",2,0,2
"17478","1570力肯","110/07/09","土銀-彰化",0,2,-2
"17479","1570力肯","110/07/09","臺銀-臺中",2,0,2
"17480","1570力肯","110/07/09","臺銀-鳳山",0,2,-2
"17481","6180橘子","110/07/09","摩根大通",63,1,62
"17482","6180橘子","110/07/09","元大-南京",1,32,-31
"17483","6180橘子","110/07/09","富邦-陽明",73,33,40
"17484","6180橘子","110/07/09","群益金鼎-台北",0,25,-25
"17485","6180橘子","110/07/09","新加坡商瑞銀",31,0,31
"17486","6180橘子","110/07/09","兆豐-復興",0,21,-21
"17487","6180橘子","110/07/09","美商高盛",25,0,25
"17488","6180橘子","110/07/09","永豐金-嘉義",0,21,-21
"17489","6180橘子","110/07/09","凱基-台北",26,10,16
"17490","6180橘子","110/07/09","凱基-中壢",8,24,-16
"17491","6180橘子","110/07/09","華南永昌-楠梓",13,0,13
"17492","6180橘子","110/07/09","致和-崇德",0,15,-15
"17493","6180橘子","110/07/09","華南永昌-朴子",11,0,11
"17494","6180橘子","110/07/09","群益金鼎-屏東",0,15,-15
"17495","6180橘子","110/07/09","元大-北港",11,0,11
"17496","6180橘子","110/07/09","群益金鼎-中山",0,15,-15
"17497","6180橘子","110/07/09","元大-成功",10,1,9
"17498","6180橘子","110/07/09","瑞士信貸",1,15,-14
"17499","6180橘子","110/07/09","新光",26,18,8
"17500","6180橘子","110/07/09","日盛-二林",0,10,-10
"17501","6180橘子","110/07/09","統一-三重",6,0,6
"17502","6180橘子","110/07/09","凱基-東門",0,10,-10
"17503","6180橘子","110/07/09","群益金鼎-嘉義",6,0,6
"17504","6180橘子","110/07/09","華南永昌-三重",0,10,-10
"17505","6180橘子","110/07/09","元大-員林中山",6,0,6
"17506","6180橘子","110/07/09","元大-彰化民生",1,11,-10
"17507","6180橘子","110/07/09","合庫-鳳山",5,0,5
"17508","6180橘子","110/07/09","永豐金-新店",1,11,-10
"17509","6180橘子","110/07/09","富邦-建國",6,1,5
"17510","6180橘子","110/07/09","群益金鼎-丹鳳",0,8,-8
"17511","2390云辰","110/07/09","摩根大通",279,56,223
"17512","2390云辰","110/07/09","元大-天母",0,127,-127
"17513","2390云辰","110/07/09","日盛-鳳山",110,2,108
"17514","2390云辰","110/07/09","中國信託-文心",5,109,-104
"17515","2390云辰","110/07/09","宏遠證券",100,0,100
"17516","2390云辰","110/07/09","永豐金-復興",0,55,-55
"17517","2390云辰","110/07/09","元大-大里",63,6,57
"17518","2390云辰","110/07/09","凱基-台北",239,286,-47
"17519","2390云辰","110/07/09","凱基-八德",59,10,49
"17520","2390云辰","110/07/09","德信",2,32,-30
"17521","2390云辰","110/07/09","合庫-新竹",40,0,40
"17522","2390云辰","110/07/09","兆豐-桃鶯",2,32,-30
"17523","2390云辰","110/07/09","國票",40,1,39
"17524","2390云辰","110/07/09","致和-南京",0,30,-30
"17525","2390云辰","110/07/09","新加坡商瑞銀",49,13,36
"17526","2390云辰","110/07/09","富邦-虎尾",1,31,-30
"17527","2390云辰","110/07/09","統一-新台中",36,2,34
"17528","2390云辰","110/07/09","元大-善化",2,31,-29
"17529","2390云辰","110/07/09","國票-嘉義",31,0,31
"17530","2390云辰","110/07/09","富邦-板橋",0,27,-27
"17531","2390云辰","110/07/09","華南永昌",35,7,28
"17532","2390云辰","110/07/09","富邦-永和",3,28,-25
"17533","2390云辰","110/07/09","玉山-台中",49,22,27
"17534","2390云辰","110/07/09","第一金-自由",20,44,-24
"17535","2390云辰","110/07/09","華南永昌-敦南",25,0,25
"17536","2390云辰","110/07/09","凱基-內湖",0,24,-24
"17537","2390云辰","110/07/09","新光-高雄",27,4,23
"17538","2390云辰","110/07/09","元大-汐止",1,24,-23
"17539","2390云辰","110/07/09","台灣摩根士丹利",85,63,22
"17540","2390云辰","110/07/09","新光-台中",12,33,-21
"17541","4903聯光通","110/07/08","元富-新興",18,0,18
"17542","4903聯光通","110/07/08","中國信託-中壢",0,14,-14
"17543","4903聯光通","110/07/08","元大-苗栗",9,0,9
"17544","4903聯光通","110/07/08","彰銀",0,7,-7
"17545","4903聯光通","110/07/08","兆豐-鹿港",3,0,3
"17546","4903聯光通","110/07/08","中國信託-松江",0,5,-5
"17547","4903聯光通","110/07/08","群益金鼎-萬華",2,0,2
"17548","4903聯光通","110/07/08","光和",0,2,-2
"17549","4903聯光通","110/07/08","元大-屏南",1,0,1
"17550","4903聯光通","110/07/08","元大-鶯歌",0,2,-2
"17551","4903聯光通","110/07/08","華南永昌-新莊",0,0,0
"17552","4903聯光通","110/07/08","群益金鼎-館前",0,1,-1
"17553","4903聯光通","110/07/08","元大-羅東",0,0,0
"17554","4903聯光通","110/07/08","華南永昌",0,1,-1
"17555","4903聯光通","110/07/08","元大-太平",2,3,-1
"17556","4903聯光通","110/07/08","華南永昌-新莊",0,0,0
"17557","4903聯光通","110/07/08","元大-羅東",0,0,0
"17558","2929淘帝","110/07/08","日盛-園區",90,6,84
"17559","2929淘帝","110/07/08","元大-太平",1,111,-110
"17560","2929淘帝","110/07/08","華南永昌-頭份",54,0,54
"17561","2929淘帝","110/07/08","港商野村",31,106,-75
"17562","2929淘帝","110/07/08","美商高盛",50,0,50
"17563","2929淘帝","110/07/08","凱基-板橋",62,111,-49
"17564","2929淘帝","110/07/08","台中銀-台北",50,0,50
"17565","2929淘帝","110/07/08","新光-台中",30,78,-48
"17566","2929淘帝","110/07/08","臺銀-臺南",30,0,30
"17567","2929淘帝","110/07/08","元富-永和",1,41,-40
"17568","2929淘帝","110/07/08","永豐金-大園",42,12,30
"17569","2929淘帝","110/07/08","永豐金-鳳山",0,28,-28
"17570","2929淘帝","110/07/08","元富-三重",30,1,29
"17571","2929淘帝","110/07/08","元大-南崁",0,26,-26
"17572","2929淘帝","110/07/08","兆豐-桃鶯",29,0,29
"17573","2929淘帝","110/07/08","元大-花蓮",2,27,-25
"17574","2929淘帝","110/07/08","元大-承德",20,3,17
"17575","2929淘帝","110/07/08","元大-府城",0,24,-24
"17576","2929淘帝","110/07/08","新光-新竹",13,0,13
"17577","2929淘帝","110/07/08","新光",21,43,-22
"17578","2929淘帝","110/07/08","富邦-內湖",13,0,13
"17579","2929淘帝","110/07/08","臺銀-民權",0,20,-20
"17580","2929淘帝","110/07/08","國泰-板橋",13,1,12
"17581","2929淘帝","110/07/08","摩根大通",66,84,-18
"17582","2929淘帝","110/07/08","第一金-大稻埕",10,0,10
"17583","2929淘帝","110/07/08","凱基-台北",0,17,-17
"17584","2929淘帝","110/07/08","統一-汐止",10,0,10
"17585","2929淘帝","110/07/08","元大-博愛",6,23,-17
"17586","2929淘帝","110/07/08","元富-大裕",10,0,10
"17587","2929淘帝","110/07/08","永豐金-桃盛",0,16,-16
"17588","5410國眾","110/07/08","元大-新盛",15,0,15
"17589","5410國眾","110/07/08","元大-旗山",0,50,-50
"17590","5410國眾","110/07/08","元大-屏南",10,0,10
"17591","5410國眾","110/07/08","元大-頭份",0,14,-14
"17592","5410國眾","110/07/08","元大-成功",10,0,10
"17593","5410國眾","110/07/08","國泰-高雄",0,8,-8
"17594","5410國眾","110/07/08","元大-東泰",7,0,7
"17595","5410國眾","110/07/08","元大-小港",0,7,-7
"17596","5410國眾","110/07/08","富邦-陽明",6,0,6
"17597","5410國眾","110/07/08","統一-嘉義",0,5,-5
"17598","5410國眾","110/07/08","臺銀-金山",5,0,5
"17599","5410國眾","110/07/08","兆豐-台中港",0,5,-5
"17600","5410國眾","110/07/08","日盛-員林",5,0,5
"17601","5410國眾","110/07/08","凱基-屏東",0,5,-5
"17602","5410國眾","110/07/08","摩根大通",5,0,5
"17603","5410國眾","110/07/08","元大-八德",0,5,-5
"17604","5410國眾","110/07/08","富邦-桃園",5,0,5
"17605","5410國眾","110/07/08","元富-嘉義",0,4,-4
"17606","5410國眾","110/07/08","元富-大昌",4,0,4
"17607","5410國眾","110/07/08","玉山-雙和",0,4,-4
"17608","5410國眾","110/07/08","台新-台中",4,0,4
"17609","5410國眾","110/07/08","凱基-高美館",1,5,-4
"17610","5410國眾","110/07/08","華南永昌-小港",5,1,4
"17611","5410國眾","110/07/08","統一-員林",0,3,-3
"17612","5410國眾","110/07/08","元大-新竹",5,1,4
"17613","5410國眾","110/07/08","臺銀-鳳山",0,2,-2
"17614","5410國眾","110/07/08","元大-土城學府",4,0,4
"17615","5410國眾","110/07/08","亞東",0,2,-2
"17616","5410國眾","110/07/08","元大-新莊",4,0,4
"17617","5410國眾","110/07/08","新光",0,2,-2
"17618","2841台開","110/07/08","元大-樹林",653,0,653
"17619","2841台開","110/07/08","港商野村",0,868,-868
"17620","2841台開","110/07/08","台新證券",115,0,115
"17621","2841台開","110/07/08","群益金鼎-忠孝",0,100,-100
"17622","2841台開","110/07/08","永豐金-豐原",105,0,105
"17623","2841台開","110/07/08","宏遠-高雄",0,56,-56
"17624","2841台開","110/07/08","元富-新興",100,0,100
"17625","2841台開","110/07/08","新光",3,38,-35
"17626","2841台開","110/07/08","凱基-文心",50,0,50
"17627","2841台開","110/07/08","花旗環球",0,29,-29
"17628","2841台開","110/07/08","元大-八德",40,0,40
"17629","2841台開","110/07/08","富邦-仁愛",2,30,-28
"17630","2841台開","110/07/08","日盛-雙和",30,0,30
"17631","2841台開","110/07/08","元富-潮州",0,24,-24
"17632","2841台開","110/07/08","統一-竹南",30,0,30
"17633","2841台開","110/07/08","元大-沙鹿",0,20,-20
"17634","2841台開","110/07/08","凱基-台南",30,0,30
"17635","2841台開","110/07/08","元大-汐止",0,20,-20
"17636","2841台開","110/07/08","元大-福營",30,0,30
"17637","2841台開","110/07/08","合庫-嘉義",2,20,-18
"17638","2841台開","110/07/08","合庫-台中",22,0,22
"17639","2841台開","110/07/08","國泰-敦南",3,21,-18
"17640","2841台開","110/07/08","大昌-安康",28,10,18
"17641","2841台開","110/07/08","日盛-竹北",0,15,-15
"17642","2841台開","110/07/08","元大-斗信",15,0,15
"17643","2841台開","110/07/08","元大-三重",0,15,-15
"17644","2841台開","110/07/08","富邦-台北",13,0,13
"17645","2841台開","110/07/08","永豐金-敦南",45,60,-15
"17646","2841台開","110/07/08","合庫-桃園",10,0,10
"17647","2841台開","110/07/08","(牛牛牛)亞-網路",0,12,-12
"17648","6207雷科","110/07/08","台新-高雄",54,2,52
"17649","6207雷科","110/07/08","群益金鼎-丹鳳",0,60,-60
"17650","6207雷科","110/07/08","新光-台中",18,0,18
"17651","6207雷科","110/07/08","元大-頭份",1,56,-55
"17652","6207雷科","110/07/08","日盛-嘉義",16,0,16
"17653","6207雷科","110/07/08","國票-中和",0,30,-30
"17654","6207雷科","110/07/08","合庫-鳳山",15,0,15
"17655","6207雷科","110/07/08","凱基-台北",1,29,-28
"17656","6207雷科","110/07/08","臺銀-臺中",12,0,12
"17657","6207雷科","110/07/08","兆豐-板橋",0,25,-25
"17658","6207雷科","110/07/08","群益金鼎-土城",12,0,12
"17659","6207雷科","110/07/08","凱基-城中",4,25,-21
"17660","6207雷科","110/07/08","新光",25,14,11
"17661","6207雷科","110/07/08","日進",0,20,-20
"17662","6207雷科","110/07/08","凱基-中壢",11,0,11
"17663","6207雷科","110/07/08","台新證券",3,20,-17
"17664","6207雷科","110/07/08","台灣企銀",10,0,10
"17665","6207雷科","110/07/08","群益金鼎-中山",0,16,-16
"17666","6207雷科","110/07/08","第一金-新興",11,1,10
"17667","6207雷科","110/07/08","元大-東門",0,16,-16
"17668","6207雷科","110/07/08","元富-吉利",10,0,10
"17669","6207雷科","110/07/08","群益金鼎-大甲",0,13,-13
"17670","6207雷科","110/07/08","光和-和美",10,0,10
"17671","6207雷科","110/07/08","日盛-板橋",0,10,-10
"17672","6207雷科","110/07/08","永豐金-南京",10,0,10
"17673","6207雷科","110/07/08","日盛-中壢",0,10,-10
"17674","6207雷科","110/07/08","土銀",8,0,8
"17675","6207雷科","110/07/08","摩根大通",125,135,-10
"17676","6207雷科","110/07/08","中國信託-高雄",8,0,8
"17677","6207雷科","110/07/08","凱基-五股",0,10,-10
"17678","3679新至陞","110/07/08","華南永昌-台中",17,0,17
"17679","3679新至陞","110/07/08","大慶-蘆洲",0,10,-10
"17680","3679新至陞","110/07/08","國泰-桃園",6,0,6
"17681","3679新至陞","110/07/08","華南永昌-小港",0,7,-7
"17682","3679新至陞","110/07/08","元大-永春",6,0,6
"17683","3679新至陞","110/07/08","國泰-館前",0,3,-3
"17684","3679新至陞","110/07/08","香港上海匯豐",4,0,4
"17685","3679新至陞","110/07/08","元大-板橋",0,3,-3
"17686","3679新至陞","110/07/08","中國信託-新竹",3,0,3
"17687","3679新至陞","110/07/08","港商法國興業",0,2,-2
"17688","3679新至陞","110/07/08","國票-敦北法人",3,0,3
"17689","3679新至陞","110/07/08","第一金-忠孝",0,2,-2
"17690","3679新至陞","110/07/08","群益金鼎-台南",2,0,2
"17691","3679新至陞","110/07/08","元富-古亭",0,2,-2
"17692","3679新至陞","110/07/08","凱基",2,0,2
"17693","3679新至陞","110/07/08","摩根大通",1,3,-2
"17694","3679新至陞","110/07/08","凱基-台北",6,4,2
"17695","3679新至陞","110/07/08","富邦-板橋",0,2,-2
"17696","3679新至陞","110/07/08","日盛-信義",1,0,1
"17697","3679新至陞","110/07/08","元大-文心興安",0,2,-2
"17698","3679新至陞","110/07/08","日盛-新莊",1,0,1
"17699","3679新至陞","110/07/08","臺銀-高雄",0,1,-1
"17700","3679新至陞","110/07/08","大慶",1,0,1
"17701","3679新至陞","110/07/08","日盛-高雄",0,1,-1
"17702","3679新至陞","110/07/08","兆豐-三重",1,0,1
"17703","3679新至陞","110/07/08","日盛-文化",0,1,-1
"17704","3679新至陞","110/07/08","致和-東門",1,0,1
"17705","3679新至陞","110/07/08","美商高盛",0,1,-1
"17706","3679新至陞","110/07/08","台新證券",1,0,1
"17707","3679新至陞","110/07/08","瑞士信貸",0,1,-1
"17708","2727王品","110/07/08","群益金鼎-大安",80,0,80
"17709","2727王品","110/07/08","台灣摩根士丹利",1,300,-299
"17710","2727王品","110/07/08","富邦-台北",237,165,72
"17711","2727王品","110/07/08","元大證券",173,439,-266
"17712","2727王品","110/07/08","永豐金-萬盛",55,5,50
"17713","2727王品","110/07/08","統一",33,200,-167
"17714","2727王品","110/07/08","永豐金-南投",53,10,43
"17715","2727王品","110/07/08","凱基-台北",476,615,-139
"17716","2727王品","110/07/08","國泰-敦南",190,148,42
"17717","2727王品","110/07/08","永豐金-松山",8,138,-130
"17718","2727王品","110/07/08","台新-高雄",71,36,35
"17719","2727王品","110/07/08","新加坡商瑞銀",38,138,-100
"17720","2727王品","110/07/08","富邦-建國",62,27,35
"17721","2727王品","110/07/08","富邦-嘉義",84,182,-98
"17722","2727王品","110/07/08","永豐金證券",50,15,35
"17723","2727王品","110/07/08","元富-台南",4,99,-95
"17724","2727王品","110/07/08","港商野村",185,152,33
"17725","2727王品","110/07/08","凱基-永華",4,92,-88
"17726","2727王品","110/07/08","元大-嘉義",35,3,32
"17727","2727王品","110/07/08","凱基-大直",2,73,-71
"17728","2727王品","110/07/08","台新-三民",35,4,31
"17729","2727王品","110/07/08","美林",105,164,-59
"17730","2727王品","110/07/08","凱基-桃園",35,4,31
"17731","2727王品","110/07/08","第一金-台南",11,63,-52
"17732","2727王品","110/07/08","元大-和平",41,10,31
"17733","2727王品","110/07/08","摩根大通",216,259,-43
"17734","2727王品","110/07/08","兆豐-大安",33,5,28
"17735","2727王品","110/07/08","元大-員林",9,50,-41
"17736","2727王品","110/07/08","元大-新盛",33,6,27
"17737","2727王品","110/07/08","兆豐-虎尾",1,41,-40
"17738","1570力肯","110/07/08","群益金鼎-三重",20,0,20
"17739","1570力肯","110/07/08","中國信託-永康",0,26,-26
"17740","1570力肯","110/07/08","凱基-中壢",20,0,20
"17741","1570力肯","110/07/08","統一-敦南",0,12,-12
"17742","1570力肯","110/07/08","群益金鼎-台南",14,0,14
"17743","1570力肯","110/07/08","國票-博愛",0,10,-10
"17744","1570力肯","110/07/08","元富-緯城",10,0,10
"17745","1570力肯","110/07/08","元大-西門",0,10,-10
"17746","1570力肯","110/07/08","瑞士信貸",7,0,7
"17747","1570力肯","110/07/08","新光",0,9,-9
"17748","1570力肯","110/07/08","摩根大通",6,0,6
"17749","1570力肯","110/07/08","永豐金-大園",0,9,-9
"17750","1570力肯","110/07/08","土銀-白河",5,0,5
"17751","1570力肯","110/07/08","日盛-大墩",0,6,-6
"17752","1570力肯","110/07/08","台灣摩根士丹利",4,0,4
"17753","1570力肯","110/07/08","台新證券",0,6,-6
"17754","1570力肯","110/07/08","元大-新莊",3,0,3
"17755","1570力肯","110/07/08","永全",0,5,-5
"17756","1570力肯","110/07/08","永豐金-苓雅",3,0,3
"17757","1570力肯","110/07/08","元大-天母",0,5,-5
"17758","1570力肯","110/07/08","合庫-三重",2,0,2
"17759","1570力肯","110/07/08","元富-吉利",0,3,-3
"17760","1570力肯","110/07/08","(牛牛牛)亞-鑫豐",2,0,2
"17761","1570力肯","110/07/08","國泰-高雄",0,3,-3
"17762","1570力肯","110/07/08","玉山-大里",2,0,2
"17763","1570力肯","110/07/08","群益金鼎-北高雄",0,3,-3
"17764","1570力肯","110/07/08","國泰-敦南",2,0,2
"17765","1570力肯","110/07/08","群益金鼎-東門",0,2,-2
"17766","1570力肯","110/07/08","華南永昌-岡山",2,0,2
"17767","1570力肯","110/07/08","日盛-高雄",5,6,-1
"17768","6180橘子","110/07/08","新光",30,4,26
"17769","6180橘子","110/07/08","元大-土城學府",0,89,-89
"17770","6180橘子","110/07/08","康和-台南",22,0,22
"17771","6180橘子","110/07/08","凱基-東勢",1,66,-65
"17772","6180橘子","110/07/08","國泰-板橋",22,0,22
"17773","6180橘子","110/07/08","光和",0,64,-64
"17774","6180橘子","110/07/08","日盛-文化",21,0,21
"17775","6180橘子","110/07/08","中國信託-忠孝",0,50,-50
"17776","6180橘子","110/07/08","中國信託-文心",20,2,18
"17777","6180橘子","110/07/08","元富-大裕",0,25,-25
"17778","6180橘子","110/07/08","凱基-台北",39,24,15
"17779","6180橘子","110/07/08","統一-基隆",1,25,-24
"17780","6180橘子","110/07/08","元富-新店",14,0,14
"17781","6180橘子","110/07/08","美商高盛",1,21,-20
"17782","6180橘子","110/07/08","元大-土城永寧",11,0,11
"17783","6180橘子","110/07/08","元大證券",1,19,-18
"17784","6180橘子","110/07/08","永豐金-南京",11,0,11
"17785","6180橘子","110/07/08","元大-太平",2,20,-18
"17786","6180橘子","110/07/08","宏遠-館前",10,0,10
"17787","6180橘子","110/07/08","合庫證券",2,18,-16
"17788","6180橘子","110/07/08","國泰-新莊",10,0,10
"17789","6180橘子","110/07/08","台灣摩根士丹利",1,12,-11
"17790","6180橘子","110/07/08","群益金鼎",10,0,10
"17791","6180橘子","110/07/08","瑞士信貸",0,11,-11
"17792","6180橘子","110/07/08","凱基-高雄",10,0,10
"17793","6180橘子","110/07/08","元富-嘉義",0,11,-11
"17794","6180橘子","110/07/08","凱基-大安",10,0,10
"17795","6180橘子","110/07/08","新光-高雄",0,11,-11
"17796","6180橘子","110/07/08","富邦-仁愛",10,0,10
"17797","6180橘子","110/07/08","大慶-苗栗",0,10,-10
"17798","2390云辰","110/07/08","統一-新台中",126,1,125
"17799","2390云辰","110/07/08","摩根大通",62,661,-599
"17800","2390云辰","110/07/08","元大-員林",111,0,111
"17801","2390云辰","110/07/08","新加坡商瑞銀",0,173,-173
"17802","2390云辰","110/07/08","合庫-高雄",105,0,105
"17803","2390云辰","110/07/08","元大-天母",7,150,-143
"17804","2390云辰","110/07/08","凱基-台北",255,177,78
"17805","2390云辰","110/07/08","台灣摩根士丹利",0,134,-134
"17806","2390云辰","110/07/08","新光",71,17,54
"17807","2390云辰","110/07/08","玉山-台中",17,120,-103
"17808","2390云辰","110/07/08","國票-嘉義",53,0,53
"17809","2390云辰","110/07/08","美商高盛",0,78,-78
"17810","2390云辰","110/07/08","富邦-仁愛",53,4,49
"17811","2390云辰","110/07/08","美林",11,82,-71
"17812","2390云辰","110/07/08","兆豐-城中",48,0,48
"17813","2390云辰","110/07/08","群益金鼎-大興",35,106,-71
"17814","2390云辰","110/07/08","元大-新營",47,0,47
"17815","2390云辰","110/07/08","光和",11,71,-60
"17816","2390云辰","110/07/08","國泰-敦南",89,55,34
"17817","2390云辰","110/07/08","國泰-台中",28,70,-42
"17818","2390云辰","110/07/08","兆豐-台中",40,7,33
"17819","2390云辰","110/07/08","玉山-新莊",6,46,-40
"17820","2390云辰","110/07/08","永豐金-中正",36,6,30
"17821","2390云辰","110/07/08","富邦-台北",21,57,-36
"17822","2390云辰","110/07/08","中國信託-三重",29,0,29
"17823","2390云辰","110/07/08","土銀-台中",0,30,-30
"17824","2390云辰","110/07/08","富邦-陽明",33,5,28
"17825","2390云辰","110/07/08","兆豐-埔墘",1,31,-30
"17826","2390云辰","110/07/08","元富-桃園",27,0,27
"17827","2390云辰","110/07/08","玉山-南京東路",3,33,-30
"17828","4903聯光通","110/07/07","元大-太平",47,4,43
"17829","4903聯光通","110/07/07","日盛-板橋",0,15,-15
"17830","4903聯光通","110/07/07","華南永昌-桃園",10,0,10
"17831","4903聯光通","110/07/07","元大-八德",0,9,-9
"17832","4903聯光通","110/07/07","元大-南投",9,0,9
"17833","4903聯光通","110/07/07","宏遠證券",0,7,-7
"17834","4903聯光通","110/07/07","新光-台中",3,0,3
"17835","4903聯光通","110/07/07","大慶",0,7,-7
"17836","4903聯光通","110/07/07","國泰-敦南",1,0,1
"17837","4903聯光通","110/07/07","群益金鼎-館前",0,6,-6
"17838","4903聯光通","110/07/07","國票-中正",0,0,0
"17839","4903聯光通","110/07/07","元大-羅東",0,5,-5
"17840","4903聯光通","110/07/07","康和-內湖",0,0,0
"17841","4903聯光通","110/07/07","新光",8,12,-4
"17842","4903聯光通","110/07/07","凱基-站前",0,0,0
"17843","4903聯光通","110/07/07","國泰-高雄",0,3,-3
"17844","4903聯光通","110/07/07","華南永昌",1,1,0
"17845","4903聯光通","110/07/07","第一金-台中",0,3,-3
"17846","4903聯光通","110/07/07","華南永昌-新莊",0,0,0
"17847","4903聯光通","110/07/07","中農",0,1,-1
"17848","4903聯光通","110/07/07","臺灣企銀-桃園",0,1,-1
"17849","4903聯光通","110/07/07","台新-新營",0,1,-1
"17850","4903聯光通","110/07/07","元大-鶯歌",2,3,-1
"17851","4903聯光通","110/07/07","元大-永和",0,1,-1
"17852","4903聯光通","110/07/07","元大-苑裡",0,1,-1
"17853","2929淘帝","110/07/07","統一",163,0,163
"17854","2929淘帝","110/07/07","新光-台中",57,142,-85
"17855","2929淘帝","110/07/07","港商野村",323,181,142
"17856","2929淘帝","110/07/07","兆豐-忠孝",0,76,-76
"17857","2929淘帝","110/07/07","日盛-中壢",132,10,122
"17858","2929淘帝","110/07/07","台新-建北",0,53,-53
"17859","2929淘帝","110/07/07","新加坡商瑞銀",140,19,121
"17860","2929淘帝","110/07/07","臺銀-鳳山",0,44,-44
"17861","2929淘帝","110/07/07","日盛-嘉義",101,0,101
"17862","2929淘帝","110/07/07","元大-新盛",0,42,-42
"17863","2929淘帝","110/07/07","摩根大通",101,16,85
"17864","2929淘帝","110/07/07","富邦-建國",6,47,-41
"17865","2929淘帝","110/07/07","元大-太平",55,2,53
"17866","2929淘帝","110/07/07","日盛-園區",0,40,-40
"17867","2929淘帝","110/07/07","元富-松德",50,1,49
"17868","2929淘帝","110/07/07","新光-高雄",1,38,-37
"17869","2929淘帝","110/07/07","凱基-板橋",53,5,48
"17870","2929淘帝","110/07/07","永豐金-三重",1,34,-33
"17871","2929淘帝","110/07/07","美林",80,34,46
"17872","2929淘帝","110/07/07","元大-彰化",0,31,-31
"17873","2929淘帝","110/07/07","元富-台南",41,0,41
"17874","2929淘帝","110/07/07","第一金-大稻埕",0,30,-30
"17875","2929淘帝","110/07/07","兆豐-竹北",39,0,39
"17876","2929淘帝","110/07/07","國泰-敦南",3,33,-30
"17877","2929淘帝","110/07/07","元大-西門",36,0,36
"17878","2929淘帝","110/07/07","富邦-員林",0,30,-30
"17879","2929淘帝","110/07/07","華南永昌",39,4,35
"17880","2929淘帝","110/07/07","元大-蘆洲",1,30,-29
"17881","2929淘帝","110/07/07","日盛-板橋中山",30,0,30
"17882","2929淘帝","110/07/07","台新-台南",4,32,-28
"17883","5410國眾","110/07/07","兆豐-城中",66,0,66
"17884","5410國眾","110/07/07","富邦-仁愛",0,115,-115
"17885","5410國眾","110/07/07","摩根大通",21,0,21
"17886","5410國眾","110/07/07","亞東-板橋",0,38,-38
"17887","5410國眾","110/07/07","元大-北投",21,0,21
"17888","5410國眾","110/07/07","凱基-台北",2,24,-22
"17889","5410國眾","110/07/07","亞東-新竹",15,0,15
"17890","5410國眾","110/07/07","彰銀-七賢",0,10,-10
"17891","5410國眾","110/07/07","元大-福營",12,0,12
"17892","5410國眾","110/07/07","凱基-基隆",0,10,-10
"17893","5410國眾","110/07/07","新光-高雄",11,0,11
"17894","5410國眾","110/07/07","凱基-屏東",0,10,-10
"17895","5410國眾","110/07/07","華南永昌-小港",10,0,10
"17896","5410國眾","110/07/07","凱基-鳳山",0,10,-10
"17897","5410國眾","110/07/07","元大-大灣",10,0,10
"17898","5410國眾","110/07/07","永豐金-忠孝",0,10,-10
"17899","5410國眾","110/07/07","元大-莒光",10,0,10
"17900","5410國眾","110/07/07","日盛-板橋中山",0,9,-9
"17901","5410國眾","110/07/07","台中銀-豐原",9,0,9
"17902","5410國眾","110/07/07","統一-高雄",0,5,-5
"17903","5410國眾","110/07/07","元大-南屯",9,0,9
"17904","5410國眾","110/07/07","元大-斗六",0,5,-5
"17905","5410國眾","110/07/07","日盛-新莊",7,0,7
"17906","5410國眾","110/07/07","元大-大益",0,5,-5
"17907","5410國眾","110/07/07","元富-大昌",6,0,6
"17908","5410國眾","110/07/07","元大-南投",0,5,-5
"17909","5410國眾","110/07/07","新光-新竹",6,0,6
"17910","5410國眾","110/07/07","永豐金-員林",0,5,-5
"17911","5410國眾","110/07/07","臺銀-金山",5,0,5
"17912","5410國眾","110/07/07","華南永昌-楠梓",0,4,-4
"17913","2841台開","110/07/07","永豐金-豐原",268,0,268
"17914","2841台開","110/07/07","凱基-市政",0,200,-200
"17915","2841台開","110/07/07","永豐金-南投",200,0,200
"17916","2841台開","110/07/07","永豐金-彰化",0,100,-100
"17917","2841台開","110/07/07","新光",139,9,130
"17918","2841台開","110/07/07","元大-開元",1,93,-92
"17919","2841台開","110/07/07","中國信託-高雄",50,1,49
"17920","2841台開","110/07/07","港商野村",0,80,-80
"17921","2841台開","110/07/07","元大-歸仁",40,0,40
"17922","2841台開","110/07/07","凱基-台南",25,85,-60
"17923","2841台開","110/07/07","台中銀",35,0,35
"17924","2841台開","110/07/07","美商高盛",1,58,-57
"17925","2841台開","110/07/07","台新-新營",30,0,30
"17926","2841台開","110/07/07","統一-三重",0,55,-55
"17927","2841台開","110/07/07","富邦-台南",30,0,30
"17928","2841台開","110/07/07","台新證券",12,50,-38
"17929","2841台開","110/07/07","國泰-板橋",30,1,29
"17930","2841台開","110/07/07","陽信-石牌",0,31,-31
"17931","2841台開","110/07/07","凱基-文心",28,0,28
"17932","2841台開","110/07/07","元大-福營",0,31,-31
"17933","2841台開","110/07/07","凱基-站前",27,0,27
"17934","2841台開","110/07/07","第一金-澎湖",0,30,-30
"17935","2841台開","110/07/07","大昌-安康",38,16,22
"17936","2841台開","110/07/07","元大-新莊",0,30,-30
"17937","2841台開","110/07/07","合庫-台中",20,0,20
"17938","2841台開","110/07/07","國泰-館前",0,28,-28
"17939","2841台開","110/07/07","日盛-台南",20,0,20
"17940","2841台開","110/07/07","元大-竹科",0,25,-25
"17941","2841台開","110/07/07","台中銀-員林",20,0,20
"17942","2841台開","110/07/07","富邦-仁愛",1,22,-21
"17943","6207雷科","110/07/07","元大-大天母",21,0,21
"17944","6207雷科","110/07/07","元大-高雄",0,105,-105
"17945","6207雷科","110/07/07","元大-頭份",18,0,18
"17946","6207雷科","110/07/07","永豐金-中正",0,35,-35
"17947","6207雷科","110/07/07","第一金-新興",16,0,16
"17948","6207雷科","110/07/07","摩根大通",8,39,-31
"17949","6207雷科","110/07/07","富邦-虎尾",12,0,12
"17950","6207雷科","110/07/07","元大-林園",0,30,-30
"17951","6207雷科","110/07/07","兆豐-板橋",10,0,10
"17952","6207雷科","110/07/07","凱基-台北",0,19,-19
"17953","6207雷科","110/07/07","玉山-台大",10,0,10
"17954","6207雷科","110/07/07","國票-中和",13,25,-12
"17955","6207雷科","110/07/07","元大-四維",10,0,10
"17956","6207雷科","110/07/07","新加坡商瑞銀",0,9,-9
"17957","6207雷科","110/07/07","元大-鹿港",10,0,10
"17958","6207雷科","110/07/07","玉山-高雄",0,8,-8
"17959","6207雷科","110/07/07","元大-信義",10,0,10
"17960","6207雷科","110/07/07","玉山-台南",0,8,-8
"17961","6207雷科","110/07/07","台新-三民",8,0,8
"17962","6207雷科","110/07/07","宏遠-高雄",0,5,-5
"17963","6207雷科","110/07/07","元大-上新莊",8,0,8
"17964","6207雷科","110/07/07","元大-南海",0,5,-5
"17965","6207雷科","110/07/07","大昌-桃園",7,0,7
"17966","6207雷科","110/07/07","元大-莒光",0,4,-4
"17967","6207雷科","110/07/07","新光-台中",10,4,6
"17968","6207雷科","110/07/07","港商野村",0,3,-3
"17969","6207雷科","110/07/07","日盛-頭份",5,0,5
"17970","6207雷科","110/07/07","大慶-台南",0,3,-3
"17971","6207雷科","110/07/07","日茂-埔里",5,0,5
"17972","6207雷科","110/07/07","凱基-站前",0,3,-3
"17973","3679新至陞","110/07/07","永豐金證券",18,0,18
"17974","3679新至陞","110/07/07","美林",0,13,-13
"17975","3679新至陞","110/07/07","元大-文心興安",6,0,6
"17976","3679新至陞","110/07/07","兆豐-大安",0,10,-10
"17977","3679新至陞","110/07/07","中農",5,0,5
"17978","3679新至陞","110/07/07","國泰-桃園",0,4,-4
"17979","3679新至陞","110/07/07","台新證券",4,0,4
"17980","3679新至陞","110/07/07","永豐金-虎尾",0,4,-4
"17981","3679新至陞","110/07/07","華南永昌-小港",4,0,4
"17982","3679新至陞","110/07/07","台灣摩根士丹利",0,3,-3
"17983","3679新至陞","110/07/07","元大-天母",4,0,4
"17984","3679新至陞","110/07/07","瑞士信貸",0,3,-3
"17985","3679新至陞","110/07/07","台中銀-員林",4,1,3
"17986","3679新至陞","110/07/07","統一-新竹",0,3,-3
"17987","3679新至陞","110/07/07","摩根大通",4,1,3
"17988","3679新至陞","110/07/07","統一-三重",0,3,-3
"17989","3679新至陞","110/07/07","凱基-台北",7,4,3
"17990","3679新至陞","110/07/07","凱基-竹北",0,3,-3
"17991","3679新至陞","110/07/07","華南永昌-高雄",3,0,3
"17992","3679新至陞","110/07/07","元富-世貿",0,2,-2
"17993","3679新至陞","110/07/07","永豐金-潮州",2,0,2
"17994","3679新至陞","110/07/07","兆豐-鹿港",0,2,-2
"17995","3679新至陞","110/07/07","合庫-新竹",1,0,1
"17996","3679新至陞","110/07/07","玉山-台大",0,2,-2
"17997","3679新至陞","110/07/07","土銀-高雄",1,0,1
"17998","3679新至陞","110/07/07","國泰-館前",0,2,-2
"17999","3679新至陞","110/07/07","元富-新興",1,0,1
"18000","3679新至陞","110/07/07","群益金鼎-新莊",0,2,-2
"18001","3679新至陞","110/07/07","富邦-中壢",1,0,1
"18002","3679新至陞","110/07/07","元大-桃園",0,2,-2
"18003","2727王品","110/07/07","第一金",62,0,62
"18004","2727王品","110/07/07","台灣摩根士丹利",1,177,-176
"18005","2727王品","110/07/07","凱基-埔墘",40,0,40
"18006","2727王品","110/07/07","凱基-台北",49,151,-102
"18007","2727王品","110/07/07","中國信託-忠孝",40,1,39
"18008","2727王品","110/07/07","摩根大通",19,107,-88
"18009","2727王品","110/07/07","玉山-板橋",40,6,34
"18010","2727王品","110/07/07","美商高盛",2,86,-84
"18011","2727王品","110/07/07","亞東-新竹",31,1,30
"18012","2727王品","110/07/07","元大-北屯",1,52,-51
"18013","2727王品","110/07/07","群益金鼎-宜蘭",25,1,24
"18014","2727王品","110/07/07","國泰證券",1,47,-46
"18015","2727王品","110/07/07","富邦-竹北",23,0,23
"18016","2727王品","110/07/07","統一",3,33,-30
"18017","2727王品","110/07/07","元大-旗山",23,0,23
"18018","2727王品","110/07/07","第一金-台中",1,30,-29
"18019","2727王品","110/07/07","元富-宜蘭",21,0,21
"18020","2727王品","110/07/07","華南永昌-中正",4,29,-25
"18021","2727王品","110/07/07","國票-長城",20,0,20
"18022","2727王品","110/07/07","美林",0,23,-23
"18023","2727王品","110/07/07","台新證券",47,28,19
"18024","2727王品","110/07/07","群益金鼎-館前",0,20,-20
"18025","2727王品","110/07/07","富邦-新竹華信",18,1,17
"18026","2727王品","110/07/07","國票-內壢",0,16,-16
"18027","2727王品","110/07/07","永豐金-中正",18,1,17
"18028","2727王品","110/07/07","兆豐-新莊",0,15,-15
"18029","2727王品","110/07/07","華南永昌-麻豆",17,1,16
"18030","2727王品","110/07/07","港商野村",15,28,-13
"18031","2727王品","110/07/07","永豐金-潮州",15,0,15
"18032","2727王品","110/07/07","元大-善化",1,13,-12
"18033","1570力肯","110/07/07","台新證券",88,0,88
"18034","1570力肯","110/07/07","新光",0,54,-54
"18035","1570力肯","110/07/07","摩根大通",49,15,34
"18036","1570力肯","110/07/07","元大-高雄",0,40,-40
"18037","1570力肯","110/07/07","合庫-桃園",20,0,20
"18038","1570力肯","110/07/07","國票-北高雄",38,50,-12
"18039","1570力肯","110/07/07","元大-土城學府",20,0,20
"18040","1570力肯","110/07/07","群益金鼎-嘉義",0,10,-10
"18041","1570力肯","110/07/07","永豐金-板盛",18,0,18
"18042","1570力肯","110/07/07","元大-草屯",0,10,-10
"18043","1570力肯","110/07/07","永豐金-永康",18,0,18
"18044","1570力肯","110/07/07","日盛-高雄",0,9,-9
"18045","1570力肯","110/07/07","統一-員林",14,0,14
"18046","1570力肯","110/07/07","第一金-路竹",0,9,-9
"18047","1570力肯","110/07/07","元大-竹山",6,0,6
"18048","1570力肯","110/07/07","元大-古亭",0,9,-9
"18049","1570力肯","110/07/07","統一-敦南",5,0,5
"18050","1570力肯","110/07/07","國票-中正",0,8,-8
"18051","1570力肯","110/07/07","元大-永和",5,0,5
"18052","1570力肯","110/07/07","群益金鼎-鳳山",0,6,-6
"18053","1570力肯","110/07/07","元富-大裕",4,0,4
"18054","1570力肯","110/07/07","元大-土城永寧",0,6,-6
"18055","1570力肯","110/07/07","華南永昌-斗六",4,0,4
"18056","1570力肯","110/07/07","中國信託",0,5,-5
"18057","1570力肯","110/07/07","永豐金-松山",6,3,3
"18058","1570力肯","110/07/07","日盛-板橋",0,4,-4
"18059","1570力肯","110/07/07","永豐金-南投",4,1,3
"18060","1570力肯","110/07/07","日盛-木柵",0,4,-4
"18061","1570力肯","110/07/07","土銀-彰化",2,0,2
"18062","1570力肯","110/07/07","玉山-桃園",0,4,-4
"18063","6180橘子","110/07/07","臺銀-金山",27,0,27
"18064","6180橘子","110/07/07","凱基-台北",6,36,-30
"18065","6180橘子","110/07/07","元富-潮州",20,0,20
"18066","6180橘子","110/07/07","元大-天母",1,26,-25
"18067","6180橘子","110/07/07","凱基-中山",20,0,20
"18068","6180橘子","110/07/07","富邦-陽明",0,22,-22
"18069","6180橘子","110/07/07","元大-太平",23,4,19
"18070","6180橘子","110/07/07","日盛-頭份",0,20,-20
"18071","6180橘子","110/07/07","摩根大通",17,0,17
"18072","6180橘子","110/07/07","富邦-仁愛",0,20,-20
"18073","6180橘子","110/07/07","元大-草屯",20,3,17
"18074","6180橘子","110/07/07","永豐金-新莊",0,20,-20
"18075","6180橘子","110/07/07","華南永昌-楠梓",15,1,14
"18076","6180橘子","110/07/07","台灣摩根士丹利",0,18,-18
"18077","6180橘子","110/07/07","中國信託-永康",12,0,12
"18078","6180橘子","110/07/07","華南永昌-長虹",1,16,-15
"18079","6180橘子","110/07/07","日盛-文化",10,0,10
"18080","6180橘子","110/07/07","新光-新竹",0,12,-12
"18081","6180橘子","110/07/07","國泰-館前",10,0,10
"18082","6180橘子","110/07/07","凱基-中壢",0,12,-12
"18083","6180橘子","110/07/07","華南永昌-鶯歌",10,0,10
"18084","6180橘子","110/07/07","第一金-忠孝",0,11,-11
"18085","6180橘子","110/07/07","元大-豐原站前",10,0,10
"18086","6180橘子","110/07/07","元大-沙鹿",0,11,-11
"18087","6180橘子","110/07/07","元大-北屯",10,0,10
"18088","6180橘子","110/07/07","永豐金-羅東",0,11,-11
"18089","6180橘子","110/07/07","兆豐-台中",10,1,9
"18090","6180橘子","110/07/07","兆豐-埔墘",0,10,-10
"18091","6180橘子","110/07/07","群益金鼎-開元",9,0,9
"18092","6180橘子","110/07/07","華南永昌-台中",0,10,-10
"18093","2390云辰","110/07/07","元大-向上",144,0,144
"18094","2390云辰","110/07/07","摩根大通",18,674,-656
"18095","2390云辰","110/07/07","元富-中港",102,0,102
"18096","2390云辰","110/07/07","凱基-台北",141,625,-484
"18097","2390云辰","110/07/07","群益金鼎-民權",104,4,100
"18098","2390云辰","110/07/07","美林",32,261,-229
"18099","2390云辰","110/07/07","兆豐-忠孝",81,0,81
"18100","2390云辰","110/07/07","新加坡商瑞銀",50,149,-99
"18101","2390云辰","110/07/07","合庫-新竹",60,0,60
"18102","2390云辰","110/07/07","台灣摩根士丹利",7,87,-80
"18103","2390云辰","110/07/07","元大-土城學府",59,1,58
"18104","2390云辰","110/07/07","元大-金華",2,68,-66
"18105","2390云辰","110/07/07","玉山-大里",58,3,55
"18106","2390云辰","110/07/07","國票-新莊",13,65,-52
"18107","2390云辰","110/07/07","元大-東蘆",54,1,53
"18108","2390云辰","110/07/07","凱基-三重",12,56,-44
"18109","2390云辰","110/07/07","元富-三重",51,0,51
"18110","2390云辰","110/07/07","新光-台中",23,65,-42
"18111","2390云辰","110/07/07","元富-埔里",50,0,50
"18112","2390云辰","110/07/07","第一金-中壢",5,45,-40
"18113","2390云辰","110/07/07","中國信託-三重",52,3,49
"18114","2390云辰","110/07/07","華南永昌-斗六",0,40,-40
"18115","2390云辰","110/07/07","元大-彰化民生",64,15,49
"18116","2390云辰","110/07/07","富邦-新竹華信",25,61,-36
"18117","2390云辰","110/07/07","元大-潮州",50,5,45
"18118","2390云辰","110/07/07","玉山-新莊",2,32,-30
"18119","2390云辰","110/07/07","元富-高雄",57,14,43
"18120","2390云辰","110/07/07","凱基-新豐",17,47,-30
"18121","2390云辰","110/07/07","凱基-和平",40,0,40
"18122","2390云辰","110/07/07","統一-汐止",1,29,-28
"18123","4903聯光通","110/07/06","元大-苗栗",10,0,10
"18124","4903聯光通","110/07/06","宏遠證券",0,13,-13
"18125","4903聯光通","110/07/06","彰銀",5,0,5
"18126","4903聯光通","110/07/06","富邦-新營",0,4,-4
"18127","4903聯光通","110/07/06","元大-松山",5,0,5
"18128","4903聯光通","110/07/06","元富-草屯",0,3,-3
"18129","4903聯光通","110/07/06","新光",3,0,3
"18130","4903聯光通","110/07/06","元大-羅東",0,3,-3
"18131","4903聯光通","110/07/06","群益金鼎-館前",1,0,1
"18132","4903聯光通","110/07/06","元大-北三重",0,2,-2
"18133","4903聯光通","110/07/06","華南永昌-鶯歌",1,0,1
"18134","4903聯光通","110/07/06","國泰-敦南",0,1,-1
"18135","4903聯光通","110/07/06","永豐金-市政",1,0,1
"18136","4903聯光通","110/07/06","元富-板橋",0,0,0
"18137","4903聯光通","110/07/06","元富-板橋",0,0,0
"18138","4903聯光通","110/07/06","華南永昌",0,0,0
"18139","4903聯光通","110/07/06","華南永昌",0,0,0
"18140","4903聯光通","110/07/06","元大-太平",2,2,0
"18141","4903聯光通","110/07/06","元大-太平",2,2,0
"18142","2929淘帝","110/07/06","新光",204,85,119
"18143","2929淘帝","110/07/06","港商野村",62,282,-220
"18144","2929淘帝","110/07/06","日盛-中壢",94,0,94
"18145","2929淘帝","110/07/06","摩根大通",64,264,-200
"18146","2929淘帝","110/07/06","元富-城東",84,0,84
"18147","2929淘帝","110/07/06","統一",0,163,-163
"18148","2929淘帝","110/07/06","日盛-雙和",55,0,55
"18149","2929淘帝","110/07/06","香港上海匯豐",0,141,-141
"18150","2929淘帝","110/07/06","第一金-路竹",71,17,54
"18151","2929淘帝","110/07/06","新加坡商瑞銀",54,179,-125
"18152","2929淘帝","110/07/06","元大-花蓮",44,2,42
"18153","2929淘帝","110/07/06","合庫-高雄",3,122,-119
"18154","2929淘帝","110/07/06","永豐金-大園",73,33,40
"18155","2929淘帝","110/07/06","美林",34,118,-84
"18156","2929淘帝","110/07/06","元大-太平",44,6,38
"18157","2929淘帝","110/07/06","元大-員林",2,82,-80
"18158","2929淘帝","110/07/06","國泰-板橋",40,5,35
"18159","2929淘帝","110/07/06","元富-松德",26,75,-49
"18160","2929淘帝","110/07/06","兆豐-內湖",33,1,32
"18161","2929淘帝","110/07/06","臺銀-臺南",9,52,-43
"18162","2929淘帝","110/07/06","元大-博愛",43,11,32
"18163","2929淘帝","110/07/06","元大-北投",5,48,-43
"18164","2929淘帝","110/07/06","日盛-竹北",40,10,30
"18165","2929淘帝","110/07/06","臺銀-民權",1,41,-40
"18166","2929淘帝","110/07/06","元大-善化",52,22,30
"18167","2929淘帝","110/07/06","兆豐-忠孝",1,41,-40
"18168","2929淘帝","110/07/06","富邦-北港",29,0,29
"18169","2929淘帝","110/07/06","元大-西門",1,36,-35
"18170","2929淘帝","110/07/06","凱基-湖口",27,0,27
"18171","2929淘帝","110/07/06","玉山-嘉義",3,35,-32
"18172","5410國眾","110/07/06","兆豐-城中",28,0,28
"18173","5410國眾","110/07/06","凱基-高美館",1,18,-17
"18174","5410國眾","110/07/06","元大-小港",20,0,20
"18175","5410國眾","110/07/06","國泰-館前",0,15,-15
"18176","5410國眾","110/07/06","元大-新盛",18,0,18
"18177","5410國眾","110/07/06","國泰-板橋",2,17,-15
"18178","5410國眾","110/07/06","香港上海匯豐",15,0,15
"18179","5410國眾","110/07/06","新光",0,13,-13
"18180","5410國眾","110/07/06","華南永昌-小港",15,0,15
"18181","5410國眾","110/07/06","元富-緯城",0,10,-10
"18182","5410國眾","110/07/06","元富-大昌",13,0,13
"18183","5410國眾","110/07/06","中農",0,10,-10
"18184","5410國眾","110/07/06","臺銀-臺南",10,0,10
"18185","5410國眾","110/07/06","凱基-屏東",0,10,-10
"18186","5410國眾","110/07/06","元富-延平",8,0,8
"18187","5410國眾","110/07/06","新光-桃園",0,6,-6
"18188","5410國眾","110/07/06","元大-八德",17,9,8
"18189","5410國眾","110/07/06","高橋-龍潭",0,5,-5
"18190","5410國眾","110/07/06","摩根大通",7,0,7
"18191","5410國眾","110/07/06","元富-世貿",0,5,-5
"18192","5410國眾","110/07/06","凱基-桃園",7,0,7
"18193","5410國眾","110/07/06","群益金鼎-瑞豐",0,5,-5
"18194","5410國眾","110/07/06","永豐金-屏東",7,0,7
"18195","5410國眾","110/07/06","富邦-台中",0,5,-5
"18196","5410國眾","110/07/06","台新-左楠",5,0,5
"18197","5410國眾","110/07/06","永豐金-板橋",0,5,-5
"18198","5410國眾","110/07/06","富邦-竹東",5,0,5
"18199","5410國眾","110/07/06","富邦-台南",0,4,-4
"18200","5410國眾","110/07/06","元大-新莊",5,0,5
"18201","5410國眾","110/07/06","凱基-站前",0,3,-3
"18202","2841台開","110/07/06","群益金鼎-忠孝",100,0,100
"18203","2841台開","110/07/06","港商野村",0,295,-295
"18204","2841台開","110/07/06","台新證券",58,0,58
"18205","2841台開","110/07/06","元大-善化",0,50,-50
"18206","2841台開","110/07/06","台新-台中",58,0,58
"18207","2841台開","110/07/06","元大-四維",0,50,-50
"18208","2841台開","110/07/06","永豐金-敦南",50,0,50
"18209","2841台開","110/07/06","台新-新營",0,30,-30
"18210","2841台開","110/07/06","元大-台中",45,0,45
"18211","2841台開","110/07/06","群益金鼎-桃園",0,21,-21
"18212","2841台開","110/07/06","凱基-文心",43,0,43
"18213","2841台開","110/07/06","台中銀-員林",0,20,-20
"18214","2841台開","110/07/06","永豐金-潮州",30,0,30
"18215","2841台開","110/07/06","群益金鼎-延平",0,15,-15
"18216","2841台開","110/07/06","第一金-自由",25,0,25
"18217","2841台開","110/07/06","元大-三重",0,13,-13
"18218","2841台開","110/07/06","美商高盛",17,0,17
"18219","2841台開","110/07/06","元富-古亭",0,10,-10
"18220","2841台開","110/07/06","大昌-安康",39,22,17
"18221","2841台開","110/07/06","群益金鼎-北高雄",0,10,-10
"18222","2841台開","110/07/06","台中銀",15,0,15
"18223","2841台開","110/07/06","華南永昌-南京",0,10,-10
"18224","2841台開","110/07/06","玉山-嘉義",15,0,15
"18225","2841台開","110/07/06","富邦-花蓮",0,10,-10
"18226","2841台開","110/07/06","新光",11,0,11
"18227","2841台開","110/07/06","富邦-高雄",0,10,-10
"18228","2841台開","110/07/06","兆豐-永和",10,0,10
"18229","2841台開","110/07/06","元大-竹山",0,10,-10
"18230","2841台開","110/07/06","康和-內湖",10,0,10
"18231","2841台開","110/07/06","元大-屏東",0,10,-10
"18232","6207雷科","110/07/06","新光",45,4,41
"18233","6207雷科","110/07/06","凱基-高美館",1,104,-103
"18234","6207雷科","110/07/06","統一-基隆",30,0,30
"18235","6207雷科","110/07/06","摩根大通",11,45,-34
"18236","6207雷科","110/07/06","康和-南崁",13,0,13
"18237","6207雷科","110/07/06","群益金鼎-新竹",0,22,-22
"18238","6207雷科","110/07/06","宏遠-台南",10,0,10
"18239","6207雷科","110/07/06","港商野村",2,23,-21
"18240","6207雷科","110/07/06","國票-和平",10,0,10
"18241","6207雷科","110/07/06","凱基-台北",0,14,-14
"18242","6207雷科","110/07/06","永豐金-天母",10,0,10
"18243","6207雷科","110/07/06","台新-三民",0,12,-12
"18244","6207雷科","110/07/06","台新證券",10,1,9
"18245","6207雷科","110/07/06","群益金鼎-開元",1,11,-10
"18246","6207雷科","110/07/06","群益金鼎-士林",8,0,8
"18247","6207雷科","110/07/06","富邦-南屯",0,8,-8
"18248","6207雷科","110/07/06","群益金鼎-瑞豐",7,0,7
"18249","6207雷科","110/07/06","元大-善化",0,8,-8
"18250","6207雷科","110/07/06","元大-四維",7,0,7
"18251","6207雷科","110/07/06","日盛-頭份",0,5,-5
"18252","6207雷科","110/07/06","國票-中和",6,0,6
"18253","6207雷科","110/07/06","第一金-高雄",0,5,-5
"18254","6207雷科","110/07/06","台新-中壢",6,0,6
"18255","6207雷科","110/07/06","凱基-八德",0,5,-5
"18256","6207雷科","110/07/06","凱基-高雄",6,0,6
"18257","6207雷科","110/07/06","凱基-頭份",0,5,-5
"18258","6207雷科","110/07/06","富邦-彰化",6,0,6
"18259","6207雷科","110/07/06","合庫-新竹",0,4,-4
"18260","6207雷科","110/07/06","凱基-大安",5,0,5
"18261","6207雷科","110/07/06","新光-高雄",0,4,-4
"18262","3679新至陞","110/07/06","凱基",11,0,11
"18263","3679新至陞","110/07/06","摩根大通",0,22,-22
"18264","3679新至陞","110/07/06","台中銀-員林",11,1,10
"18265","3679新至陞","110/07/06","凱基-台北",6,21,-15
"18266","3679新至陞","110/07/06","安泰-大發",10,0,10
"18267","3679新至陞","110/07/06","瑞士信貸",0,13,-13
"18268","3679新至陞","110/07/06","香港上海匯豐",8,0,8
"18269","3679新至陞","110/07/06","富邦-苗栗",0,10,-10
"18270","3679新至陞","110/07/06","永豐金證券",8,2,6
"18271","3679新至陞","110/07/06","元大-永春",0,6,-6
"18272","3679新至陞","110/07/06","第一金-高雄",5,0,5
"18273","3679新至陞","110/07/06","凱基-興隆",0,5,-5
"18274","3679新至陞","110/07/06","群益金鼎-高盛",3,0,3
"18275","3679新至陞","110/07/06","國泰-桃園",0,3,-3
"18276","3679新至陞","110/07/06","元大-嘉義",3,0,3
"18277","3679新至陞","110/07/06","元大-萬華",2,5,-3
"18278","3679新至陞","110/07/06","臺銀-高雄",2,0,2
"18279","3679新至陞","110/07/06","美林",0,2,-2
"18280","3679新至陞","110/07/06","日盛-復興",2,0,2
"18281","3679新至陞","110/07/06","第一金-華江",0,2,-2
"18282","3679新至陞","110/07/06","日盛-樹林",4,2,2
"18283","3679新至陞","110/07/06","新光-台中",0,2,-2
"18284","3679新至陞","110/07/06","宏遠-館前",2,0,2
"18285","3679新至陞","110/07/06","華南永昌-民權",0,2,-2
"18286","3679新至陞","110/07/06","台新證券",2,0,2
"18287","3679新至陞","110/07/06","元大-板橋",0,2,-2
"18288","3679新至陞","110/07/06","康和-板橋",2,0,2
"18289","3679新至陞","110/07/06","日盛-板橋中山",0,1,-1
"18290","3679新至陞","110/07/06","群益金鼎-台南",2,0,2
"18291","3679新至陞","110/07/06","宏遠證券",0,1,-1
"18292","2727王品","110/07/06","元大證券",1033,729,304
"18293","2727王品","110/07/06","台灣摩根士丹利",35,184,-149
"18294","2727王品","110/07/06","富邦-台北",332,46,286
"18295","2727王品","110/07/06","元大-北屯",11,79,-68
"18296","2727王品","110/07/06","統一",252,43,209
"18297","2727王品","110/07/06","元富-敦南",4,70,-66
"18298","2727王品","110/07/06","永豐金-松山",147,14,133
"18299","2727王品","110/07/06","元大-基隆孝二",11,75,-64
"18300","2727王品","110/07/06","富邦-嘉義",301,198,103
"18301","2727王品","110/07/06","臺銀-臺南",9,69,-60
"18302","2727王品","110/07/06","新加坡商瑞銀",128,34,94
"18303","2727王品","110/07/06","中國信託-忠孝",5,48,-43
"18304","2727王品","110/07/06","元富-台南",97,6,91
"18305","2727王品","110/07/06","永豐金-市政",5,46,-41
"18306","2727王品","110/07/06","台新證券",169,105,64
"18307","2727王品","110/07/06","彰銀-台中",19,56,-37
"18308","2727王品","110/07/06","美林",115,58,57
"18309","2727王品","110/07/06","玉山證券",30,67,-37
"18310","2727王品","110/07/06","華南永昌",75,23,52
"18311","2727王品","110/07/06","凱基-埔墘",4,41,-37
"18312","2727王品","110/07/06","凱基-台北",445,398,47
"18313","2727王品","110/07/06","永豐金-大園",3,40,-37
"18314","2727王品","110/07/06","凱基-大直",48,7,41
"18315","2727王品","110/07/06","元富",2,37,-35
"18316","2727王品","110/07/06","凱基-林口",45,4,41
"18317","2727王品","110/07/06","富邦-仁愛",32,64,-32
"18318","2727王品","110/07/06","德信",40,1,39
"18319","2727王品","110/07/06","玉山-板橋",52,82,-30
"18320","2727王品","110/07/06","第一金",42,5,37
"18321","2727王品","110/07/06","中國信託-文心",10,39,-29
"18322","1570力肯","110/07/06","香港上海匯豐",47,0,47
"18323","1570力肯","110/07/06","新光",2,107,-105
"18324","1570力肯","110/07/06","元大-高雄",55,16,39
"18325","1570力肯","110/07/06","摩根大通",11,58,-47
"18326","1570力肯","110/07/06","元富-緯城",37,0,37
"18327","1570力肯","110/07/06","高橋",4,50,-46
"18328","1570力肯","110/07/06","台新-台南",16,0,16
"18329","1570力肯","110/07/06","合庫-桃園",0,20,-20
"18330","1570力肯","110/07/06","元大-新竹經國",14,0,14
"18331","1570力肯","110/07/06","永豐金-板盛",0,18,-18
"18332","1570力肯","110/07/06","富邦-左營",12,0,12
"18333","1570力肯","110/07/06","華南永昌-公誠",0,9,-9
"18334","1570力肯","110/07/06","國票-中正",12,2,10
"18335","1570力肯","110/07/06","凱基-台北",1,9,-8
"18336","1570力肯","110/07/06","國票-博愛",10,0,10
"18337","1570力肯","110/07/06","臺銀-臺中",0,6,-6
"18338","1570力肯","110/07/06","統一-敦南",12,5,7
"18339","1570力肯","110/07/06","台新-三民",0,5,-5
"18340","1570力肯","110/07/06","群益金鼎-三重",7,0,7
"18341","1570力肯","110/07/06","華南永昌-麻豆",0,5,-5
"18342","1570力肯","110/07/06","臺銀-臺南",6,0,6
"18343","1570力肯","110/07/06","合庫-台南",0,4,-4
"18344","1570力肯","110/07/06","大慶-蘆洲",6,0,6
"18345","1570力肯","110/07/06","統一-員林",0,4,-4
"18346","1570力肯","110/07/06","元富-新店",6,0,6
"18347","1570力肯","110/07/06","康和-澎湖",0,4,-4
"18348","1570力肯","110/07/06","玉山-雙和",7,1,6
"18349","1570力肯","110/07/06","華南永昌-斗六",0,4,-4
"18350","1570力肯","110/07/06","永豐金-敦南",9,3,6
"18351","1570力肯","110/07/06","元大-和平",0,4,-4
"18352","6180橘子","110/07/06","凱基-台北",72,12,60
"18353","6180橘子","110/07/06","臺銀-金山",5,105,-100
"18354","6180橘子","110/07/06","美林",29,0,29
"18355","6180橘子","110/07/06","元大-台中",0,100,-100
"18356","6180橘子","110/07/06","合庫-自強",21,0,21
"18357","6180橘子","110/07/06","康和-台南",3,50,-47
"18358","6180橘子","110/07/06","凱基-三峽",17,0,17
"18359","6180橘子","110/07/06","元大-中和",0,35,-35
"18360","6180橘子","110/07/06","富邦-虎尾",15,1,14
"18361","6180橘子","110/07/06","中國信託-忠孝",0,16,-16
"18362","6180橘子","110/07/06","元富-潮州",13,0,13
"18363","6180橘子","110/07/06","玉山-高雄",0,12,-12
"18364","6180橘子","110/07/06","中國信託-永康",13,0,13
"18365","6180橘子","110/07/06","港商野村",0,11,-11
"18366","6180橘子","110/07/06","元大-草屯",18,5,13
"18367","6180橘子","110/07/06","群益金鼎-松山",0,11,-11
"18368","6180橘子","110/07/06","臺銀",11,0,11
"18369","6180橘子","110/07/06","永豐金-豐原",0,11,-11
"18370","6180橘子","110/07/06","新光",15,4,11
"18371","6180橘子","110/07/06","元富-嘉義",5,15,-10
"18372","6180橘子","110/07/06","元大-竹東",11,0,11
"18373","6180橘子","110/07/06","玉山-士林",0,10,-10
"18374","6180橘子","110/07/06","宏遠-台中",10,0,10
"18375","6180橘子","110/07/06","凱基-北門",0,10,-10
"18376","6180橘子","110/07/06","第一金-台南",10,0,10
"18377","6180橘子","110/07/06","第一金-忠孝",0,9,-9
"18378","6180橘子","110/07/06","國泰-敦南",10,0,10
"18379","6180橘子","110/07/06","統一-基隆",0,9,-9
"18380","6180橘子","110/07/06","富邦-嘉義",10,0,10
"18381","6180橘子","110/07/06","安泰-大發",1,10,-9
"18382","2390云辰","110/07/06","元大-天母",975,276,699
"18383","2390云辰","110/07/06","台灣摩根士丹利",3,265,-262
"18384","2390云辰","110/07/06","摩根大通",688,312,376
"18385","2390云辰","110/07/06","群益金鼎-海山",3,166,-163
"18386","2390云辰","110/07/06","國泰-忠孝",164,3,161
"18387","2390云辰","110/07/06","國泰-敦南",188,339,-151
"18388","2390云辰","110/07/06","富邦-北港",140,7,133
"18389","2390云辰","110/07/06","元大-土城學府",12,119,-107
"18390","2390云辰","110/07/06","聯邦商銀",151,22,129
"18391","2390云辰","110/07/06","永豐金-高雄",4,103,-99
"18392","2390云辰","110/07/06","中國信託-文心",143,17,126
"18393","2390云辰","110/07/06","土銀-士林",0,94,-94
"18394","2390云辰","110/07/06","永豐金-中正",133,7,126
"18395","2390云辰","110/07/06","元大-佳里",11,91,-80
"18396","2390云辰","110/07/06","群益金鼎-大興",178,76,102
"18397","2390云辰","110/07/06","玉山-台中",10,86,-76
"18398","2390云辰","110/07/06","元富-中港",103,3,100
"18399","2390云辰","110/07/06","新光",251,324,-73
"18400","2390云辰","110/07/06","統一-新台中",104,12,92
"18401","2390云辰","110/07/06","富邦-敦南",29,101,-72
"18402","2390云辰","110/07/06","新加坡商瑞銀",211,120,91
"18403","2390云辰","110/07/06","兆豐-台中",0,58,-58
"18404","2390云辰","110/07/06","兆豐-忠孝",100,11,89
"18405","2390云辰","110/07/06","日盛證券",16,73,-57
"18406","2390云辰","110/07/06","凱基-林口",87,9,78
"18407","2390云辰","110/07/06","元大-東泰",5,61,-56
"18408","2390云辰","110/07/06","元富-西松",72,4,68
"18409","2390云辰","110/07/06","台新證券",136,190,-54
"18410","2390云辰","110/07/06","台新-左楠",66,9,57
"18411","2390云辰","110/07/06","元大-六合",10,63,-53
