"","stake","date","name","buy","sell","total"
"1","2609陽明","110/08/16","康和",4181,128,4053
"2","2609陽明","110/08/16","凱基-台北",1053,19933,-18880
"3","2609陽明","110/08/16","宏遠證券",2579,659,1920
"4","2609陽明","110/08/16","群益金鼎-三重",162,5149,-4987
"5","2609陽明","110/08/16","華南永昌-竹北",2072,225,1847
"6","2609陽明","110/08/16","兆豐-南京",3041,5871,-2830
"7","2609陽明","110/08/16","凱基-虎尾",4140,2400,1740
"8","2609陽明","110/08/16","中國信託-松江",116,2823,-2707
"9","2609陽明","110/08/16","元大證券",8157,7010,1147
"10","2609陽明","110/08/16","兆豐-復興",107,2607,-2500
"11","2609陽明","110/08/16","摩根大通",5939,5074,865
"12","2609陽明","110/08/16","美林",2802,5073,-2271
"13","2609陽明","110/08/16","永豐金-信義",865,85,780
"14","2609陽明","110/08/16","兆豐-三民",182,2181,-1999
"15","2609陽明","110/08/16","元大-頭份",1005,248,757
"16","2609陽明","110/08/16","新加坡商瑞銀",561,2511,-1950
"17","2609陽明","110/08/16","港商野村",2920,2184,736
"18","2609陽明","110/08/16","凱基-城中",585,1560,-975
"19","2609陽明","110/08/16","元大-信義",944,209,735
"20","2609陽明","110/08/16","元大-竹科",394,1326,-932
"21","2609陽明","110/08/16","凱基-市政",14533,13859,674
"22","2609陽明","110/08/16","群益金鼎-大安",89,951,-862
"23","2609陽明","110/08/16","富邦-嘉義",7027,6481,546
"24","2609陽明","110/08/16","瑞士信貸",910,1607,-697
"25","2609陽明","110/08/16","新光-新竹",1792,1331,461
"26","2609陽明","110/08/16","兆豐-新竹",305,932,-627
"27","2609陽明","110/08/16","凱基-台南",808,378,430
"28","2609陽明","110/08/16","元大-永春",376,856,-480
"29","2609陽明","110/08/16","凱基-信義",434,31,403
"30","2609陽明","110/08/16","元富",483,956,-473
"31","2636台驊投控","110/08/16","凱基",893,138,755
"32","2636台驊投控","110/08/16","日盛-台中",36,221,-185
"33","2636台驊投控","110/08/16","瑞士信貸",524,17,507
"34","2636台驊投控","110/08/16","統一-新竹",4,188,-184
"35","2636台驊投控","110/08/16","台灣摩根士丹利",534,35,499
"36","2636台驊投控","110/08/16","國泰-敦南",291,403,-112
"37","2636台驊投控","110/08/16","富邦-花蓮",283,25,258
"38","2636台驊投控","110/08/16","新光",259,366,-107
"39","2636台驊投控","110/08/16","新光-新竹",349,144,205
"40","2636台驊投控","110/08/16","群益金鼎",89,185,-96
"41","2636台驊投控","110/08/16","國票-彰化",442,282,160
"42","2636台驊投控","110/08/16","新光-桃園",22,98,-76
"43","2636台驊投控","110/08/16","大慶",160,1,159
"44","2636台驊投控","110/08/16","群益金鼎-南京",57,126,-69
"45","2636台驊投控","110/08/16","富邦-虎尾",144,13,131
"46","2636台驊投控","110/08/16","玉山-台南",61,127,-66
"47","2636台驊投控","110/08/16","元大-士林",118,2,116
"48","2636台驊投控","110/08/16","元富-大昌",5,66,-61
"49","2636台驊投控","110/08/16","摩根大通",799,698,101
"50","2636台驊投控","110/08/16","日盛證券",78,137,-59
"51","2636台驊投控","110/08/16","日盛-宜蘭",100,3,97
"52","2636台驊投控","110/08/16","凱基-市政",13,68,-55
"53","2636台驊投控","110/08/16","凱基-台北",786,690,96
"54","2636台驊投控","110/08/16","兆豐-城中",7,58,-51
"55","2636台驊投控","110/08/16","兆豐-東門",101,31,70
"56","2636台驊投控","110/08/16","永豐金-新竹",33,83,-50
"57","2636台驊投控","110/08/16","凱基-長庚",66,6,60
"58","2636台驊投控","110/08/16","國泰-台中",69,115,-46
"59","2636台驊投控","110/08/16","元富-中壢",76,18,58
"60","2636台驊投控","110/08/16","國票-九鼎",18,61,-43
"61","2867三商壽","110/08/16","兆豐-大同",800,0,800
"62","2867三商壽","110/08/16","台新證券",7,983,-976
"63","2867三商壽","110/08/16","元富-世貿",646,5,641
"64","2867三商壽","110/08/16","美林",0,406,-406
"65","2867三商壽","110/08/16","元大-土城永寧",320,0,320
"66","2867三商壽","110/08/16","(牛牛牛)亞-鑫豐",15,120,-105
"67","2867三商壽","110/08/16","新加坡商瑞銀",241,18,223
"68","2867三商壽","110/08/16","土銀",0,100,-100
"69","2867三商壽","110/08/16","玉山-城中",156,0,156
"70","2867三商壽","110/08/16","兆豐-來福",0,100,-100
"71","2867三商壽","110/08/16","元大-桃園",100,0,100
"72","2867三商壽","110/08/16","凱基-虎尾",0,90,-90
"73","2867三商壽","110/08/16","高橋-龍潭",87,1,86
"74","2867三商壽","110/08/16","瑞士信貸",53,140,-87
"75","2867三商壽","110/08/16","富邦-員林",79,0,79
"76","2867三商壽","110/08/16","花旗環球",7,83,-76
"77","2867三商壽","110/08/16","華南永昌-高雄",50,0,50
"78","2867三商壽","110/08/16","元大-大同",0,67,-67
"79","2867三商壽","110/08/16","元大-崇德",50,0,50
"80","2867三商壽","110/08/16","日盛-板橋",0,60,-60
"81","2867三商壽","110/08/16","華南永昌-虎尾",40,0,40
"82","2867三商壽","110/08/16","元大-博愛",2,62,-60
"83","2867三商壽","110/08/16","元大-大統",40,0,40
"84","2867三商壽","110/08/16","(牛牛牛)亞-網路",0,55,-55
"85","2867三商壽","110/08/16","新光",87,48,39
"86","2867三商壽","110/08/16","美商高盛",105,158,-53
"87","2867三商壽","110/08/16","元大-大安",36,0,36
"88","2867三商壽","110/08/16","永豐金-屏東",1,52,-51
"89","2867三商壽","110/08/16","群益金鼎-西松",35,0,35
"90","2867三商壽","110/08/16","兆豐-台中港",0,50,-50
"91","5521工信","110/08/16","第一金-新竹",84,0,84
"92","5521工信","110/08/16","摩根大通",83,306,-223
"93","5521工信","110/08/16","日進",60,0,60
"94","5521工信","110/08/16","日盛證券",0,70,-70
"95","5521工信","110/08/16","凱基-中壢",40,0,40
"96","5521工信","110/08/16","群益金鼎-海山",0,40,-40
"97","5521工信","110/08/16","台新證券",37,0,37
"98","5521工信","110/08/16","華南永昌",0,39,-39
"99","5521工信","110/08/16","群益金鼎-台中",35,0,35
"100","5521工信","110/08/16","美林",5,43,-38
"101","5521工信","110/08/16","富邦-台北",30,0,30
"102","5521工信","110/08/16","康和-澎湖",0,30,-30
"103","5521工信","110/08/16","元大-永和",30,0,30
"104","5521工信","110/08/16","華南永昌-彰化",5,34,-29
"105","5521工信","110/08/16","華南永昌-潮州",28,0,28
"106","5521工信","110/08/16","元大-龍潭",0,25,-25
"107","5521工信","110/08/16","玉山-嘉義",23,0,23
"108","5521工信","110/08/16","兆豐-桃園",0,24,-24
"109","5521工信","110/08/16","元大-新莊",40,17,23
"110","5521工信","110/08/16","華南永昌-林口",1,25,-24
"111","5521工信","110/08/16","第一金-桃園",22,0,22
"112","5521工信","110/08/16","台灣企銀-台中",0,20,-20
"113","5521工信","110/08/16","凱基-鳳山",20,0,20
"114","5521工信","110/08/16","第一金-台南",0,20,-20
"115","5521工信","110/08/16","元大-路竹",20,0,20
"116","5521工信","110/08/16","元富-古亭",0,20,-20
"117","5521工信","110/08/16","合庫-桃園",20,1,19
"118","5521工信","110/08/16","兆豐-中壢",0,20,-20
"119","5521工信","110/08/16","臺銀-鳳山",21,2,19
"120","5521工信","110/08/16","元大-仁愛",0,20,-20
"121","1471首利","110/08/16","摩根大通",196,88,108
"122","1471首利","110/08/16","元大-草屯",1,200,-199
"123","1471首利","110/08/16","瑞士信貸",95,17,78
"124","1471首利","110/08/16","元富-埔里",0,51,-51
"125","1471首利","110/08/16","新加坡商瑞銀",38,0,38
"126","1471首利","110/08/16","凱基-雙和",0,40,-40
"127","1471首利","110/08/16","國泰-敦南",37,2,35
"128","1471首利","110/08/16","華南永昌-公誠",0,40,-40
"129","1471首利","110/08/16","凱基-彰化",31,0,31
"130","1471首利","110/08/16","元大-大灣",0,36,-36
"131","1471首利","110/08/16","光和-溪湖",20,0,20
"132","1471首利","110/08/16","新光-台中",17,42,-25
"133","1471首利","110/08/16","國票-中港",20,0,20
"134","1471首利","110/08/16","富邦-仁愛",0,25,-25
"135","1471首利","110/08/16","美林",15,0,15
"136","1471首利","110/08/16","群益金鼎-台北",0,24,-24
"137","1471首利","110/08/16","元大-板橋",15,0,15
"138","1471首利","110/08/16","永豐金-竹北",0,22,-22
"139","1471首利","110/08/16","凱基-長庚",16,2,14
"140","1471首利","110/08/16","合庫-台中",0,20,-20
"141","1471首利","110/08/16","元大-斗信",14,0,14
"142","1471首利","110/08/16","高橋-龍潭",2,22,-20
"143","1471首利","110/08/16","第一金-高雄",12,0,12
"144","1471首利","110/08/16","國票-台中",0,20,-20
"145","1471首利","110/08/16","玉山-大里",12,0,12
"146","1471首利","110/08/16","群益金鼎-潭子",0,20,-20
"147","1471首利","110/08/16","永豐金-大園",12,0,12
"148","1471首利","110/08/16","台新證券",2,19,-17
"149","1471首利","110/08/16","永豐金-中正",12,0,12
"150","1471首利","110/08/16","聯邦-高雄",0,15,-15
"151","2883開發金","110/08/16","中國信託-文心",4881,27,4854
"152","2883開發金","110/08/16","摩根大通",1712,30864,-29152
"153","2883開發金","110/08/16","國泰-敦南",3101,627,2474
"154","2883開發金","110/08/16","台灣摩根士丹利",453,18916,-18463
"155","2883開發金","110/08/16","亞東-新竹",3614,1222,2392
"156","2883開發金","110/08/16","凱基-台北",8208,20874,-12666
"157","2883開發金","110/08/16","花旗環球",3115,841,2274
"158","2883開發金","110/08/16","新加坡商瑞銀",363,11873,-11510
"159","2883開發金","110/08/16","元大證券",3308,1099,2209
"160","2883開發金","110/08/16","美林",130,9722,-9592
"161","2883開發金","110/08/16","康和-仁愛",2103,0,2103
"162","2883開發金","110/08/16","統一",766,7210,-6444
"163","2883開發金","110/08/16","玉山-大里",1874,31,1843
"164","2883開發金","110/08/16","元富",48,5683,-5635
"165","2883開發金","110/08/16","第一金-忠孝",1836,3,1833
"166","2883開發金","110/08/16","富邦證券",147,4117,-3970
"167","2883開發金","110/08/16","宏遠證券",1825,5,1820
"168","2883開發金","110/08/16","國票-長城",22,2713,-2691
"169","2883開發金","110/08/16","統一-新竹",1630,2,1628
"170","2883開發金","110/08/16","台新證券",1753,4439,-2686
"171","2883開發金","110/08/16","國泰-板橋",1493,346,1147
"172","2883開發金","110/08/16","元大-士林",417,2698,-2281
"173","2883開發金","110/08/16","國泰-館前",1856,775,1081
"174","2883開發金","110/08/16","港商野村",3026,5159,-2133
"175","2883開發金","110/08/16","群益金鼎-高盛",1005,12,993
"176","2883開發金","110/08/16","瑞士信貸",1295,3237,-1942
"177","2883開發金","110/08/16","元大-新莊",860,16,844
"178","2883開發金","110/08/16","美商高盛",162,1917,-1755
"179","2883開發金","110/08/16","臺銀",807,32,775
"180","2883開發金","110/08/16","國泰證券",290,1593,-1303
"181","6205詮欣","110/08/16","凱基-汐止",22,0,22
"182","6205詮欣","110/08/16","凱基-台北",0,10,-10
"183","6205詮欣","110/08/16","臺銀-民權",10,0,10
"184","6205詮欣","110/08/16","永興-水湳",0,6,-6
"185","6205詮欣","110/08/16","德信-新營",6,0,6
"186","6205詮欣","110/08/16","國票-博愛",0,6,-6
"187","6205詮欣","110/08/16","玉山證券",5,0,5
"188","6205詮欣","110/08/16","日盛-三重",5,10,-5
"189","6205詮欣","110/08/16","亞東-板橋",4,0,4
"190","6205詮欣","110/08/16","日盛-永康",0,5,-5
"191","6205詮欣","110/08/16","元大-羅東",4,0,4
"192","6205詮欣","110/08/16","摩根大通",0,5,-5
"193","6205詮欣","110/08/16","元大-汐止",4,0,4
"194","6205詮欣","110/08/16","玉山-台南",0,5,-5
"195","6205詮欣","110/08/16","臺銀-高雄",3,0,3
"196","6205詮欣","110/08/16","元大-大天母",0,4,-4
"197","6205詮欣","110/08/16","美林",2,0,2
"198","6205詮欣","110/08/16","永豐金-中盛",0,3,-3
"199","6205詮欣","110/08/16","群益金鼎-基隆",2,0,2
"200","6205詮欣","110/08/16","華南永昌-彰化",0,2,-2
"201","6205詮欣","110/08/16","合庫-三重",1,0,1
"202","6205詮欣","110/08/16","富邦-中壢",0,2,-2
"203","6205詮欣","110/08/16","(牛牛牛)亞-網路",1,0,1
"204","6205詮欣","110/08/16","元大-成功",0,2,-2
"205","6205詮欣","110/08/16","豐農",1,0,1
"206","6205詮欣","110/08/16","統一-士林",0,1,-1
"207","6205詮欣","110/08/16","凱基-站前",1,0,1
"208","6205詮欣","110/08/16","統一-金門",0,1,-1
"209","6205詮欣","110/08/16","富邦-建國",1,0,1
"210","6205詮欣","110/08/16","元富-文心",0,1,-1
"211","1540喬福","110/08/16","元大-成功",25,0,25
"212","1540喬福","110/08/16","凱基-台北",0,51,-51
"213","1540喬福","110/08/16","新光",16,0,16
"214","1540喬福","110/08/16","新光-新竹",10,29,-19
"215","1540喬福","110/08/16","日盛-鳳山",10,0,10
"216","1540喬福","110/08/16","元大-北屯",0,18,-18
"217","1540喬福","110/08/16","台新-左楠",10,0,10
"218","1540喬福","110/08/16","北城證券",0,16,-16
"219","1540喬福","110/08/16","玉山-左營",10,0,10
"220","1540喬福","110/08/16","國泰-敦南",2,18,-16
"221","1540喬福","110/08/16","富邦-南屯",10,0,10
"222","1540喬福","110/08/16","新光-桃園",0,15,-15
"223","1540喬福","110/08/16","富邦-板橋",8,0,8
"224","1540喬福","110/08/16","新光-台南",0,12,-12
"225","1540喬福","110/08/16","凱基-中壢",7,0,7
"226","1540喬福","110/08/16","凱基-台中",0,12,-12
"227","1540喬福","110/08/16","元富-新竹",5,0,5
"228","1540喬福","110/08/16","元大-汐止",0,10,-10
"229","1540喬福","110/08/16","兆豐-北高雄",5,0,5
"230","1540喬福","110/08/16","凱基-竹北",0,7,-7
"231","1540喬福","110/08/16","台新-台中",5,0,5
"232","1540喬福","110/08/16","日盛-文化",0,4,-4
"233","1540喬福","110/08/16","凱基-台南",5,0,5
"234","1540喬福","110/08/16","富邦-桃園",0,3,-3
"235","1540喬福","110/08/16","元大-龍潭",5,0,5
"236","1540喬福","110/08/16","摩根大通",1,3,-2
"237","1540喬福","110/08/16","元富-緯城",4,0,4
"238","1540喬福","110/08/16","玉山-城中",0,2,-2
"239","1540喬福","110/08/16","元大-大安",4,0,4
"240","1540喬福","110/08/16","永豐金-桃園",0,2,-2
"241","2888新光金","110/08/16","兆豐-公益",12939,12,12927
"242","2888新光金","110/08/16","摩根大通",2056,10998,-8942
"243","2888新光金","110/08/16","元大-忠孝鼎富",11100,189,10911
"244","2888新光金","110/08/16","元富-城東",25,8381,-8356
"245","2888新光金","110/08/16","港商麥格理",9753,0,9753
"246","2888新光金","110/08/16","元富",6,7491,-7485
"247","2888新光金","110/08/16","群益金鼎-大安",3294,0,3294
"248","2888新光金","110/08/16","美林",136,3975,-3839
"249","2888新光金","110/08/16","凱基-復興",3020,0,3020
"250","2888新光金","110/08/16","臺銀-高雄",19,3007,-2988
"251","2888新光金","110/08/16","美商高盛",5603,3216,2387
"252","2888新光金","110/08/16","台灣摩根士丹利",419,2562,-2143
"253","2888新光金","110/08/16","國票-台東",2067,0,2067
"254","2888新光金","110/08/16","瑞士信貸",58,1618,-1560
"255","2888新光金","110/08/16","群益金鼎-台北",1872,0,1872
"256","2888新光金","110/08/16","玉山-新竹",0,1497,-1497
"257","2888新光金","110/08/16","新加坡商瑞銀",2005,179,1826
"258","2888新光金","110/08/16","國票-博愛",3,1208,-1205
"259","2888新光金","110/08/16","華南永昌-忠孝",1827,90,1737
"260","2888新光金","110/08/16","元大-士林",85,1185,-1100
"261","2888新光金","110/08/16","富邦-新營",1400,0,1400
"262","2888新光金","110/08/16","臺銀-民權",19,1095,-1076
"263","2888新光金","110/08/16","華南永昌-鳳山",1174,11,1163
"264","2888新光金","110/08/16","法銀巴黎",0,868,-868
"265","2888新光金","110/08/16","元大-員林",1051,12,1039
"266","2888新光金","110/08/16","群益金鼎",10,847,-837
"267","2888新光金","110/08/16","富邦-高雄",1015,11,1004
"268","2888新光金","110/08/16","元富-世貿",7,794,-787
"269","2888新光金","110/08/16","日盛-南京",1000,5,995
"270","2888新光金","110/08/16","國票-安和",0,724,-724
"271","1340勝悅","110/08/16","元富-成功",30,0,30
"272","1340勝悅","110/08/16","元富-城東",0,107,-107
"273","1340勝悅","110/08/16","華南永昌-公誠",30,0,30
"274","1340勝悅","110/08/16","永豐金-竹科",0,38,-38
"275","1340勝悅","110/08/16","華南永昌-敦南",25,0,25
"276","1340勝悅","110/08/16","德信-新營",0,30,-30
"277","1340勝悅","110/08/16","合庫-自強",15,0,15
"278","1340勝悅","110/08/16","國泰-松江",0,15,-15
"279","1340勝悅","110/08/16","臺銀-鳳山",15,0,15
"280","1340勝悅","110/08/16","摩根大通",5,17,-12
"281","1340勝悅","110/08/16","元富-中港",10,0,10
"282","1340勝悅","110/08/16","港商法國興業",0,11,-11
"283","1340勝悅","110/08/16","永豐金-南京",10,0,10
"284","1340勝悅","110/08/16","玉山-高雄",0,10,-10
"285","1340勝悅","110/08/16","新光",9,0,9
"286","1340勝悅","110/08/16","凱基-台北",0,10,-10
"287","1340勝悅","110/08/16","國泰-台中",14,7,7
"288","1340勝悅","110/08/16","華南永昌-嘉義",0,10,-10
"289","1340勝悅","110/08/16","元大-苗栗",6,0,6
"290","1340勝悅","110/08/16","合庫-台南",0,6,-6
"291","1340勝悅","110/08/16","元大-屏南",6,0,6
"292","1340勝悅","110/08/16","玉山-桃園",0,5,-5
"293","1340勝悅","110/08/16","臺灣企銀-埔墘",5,0,5
"294","1340勝悅","110/08/16","永豐金-博愛",0,5,-5
"295","1340勝悅","110/08/16","日盛-板橋",5,0,5
"296","1340勝悅","110/08/16","美林",0,2,-2
"297","1340勝悅","110/08/16","致和-東門",5,0,5
"298","1340勝悅","110/08/16","兆豐-城中",0,2,-2
"299","1340勝悅","110/08/16","群益金鼎-館前",7,2,5
"300","1340勝悅","110/08/16","元大-大雅",0,2,-2
"301","6246臺龍","110/08/16","元大-南投",25,5,20
"302","6246臺龍","110/08/16","元大-中壢",9,26,-17
"303","6246臺龍","110/08/16","港商野村",65,46,19
"304","6246臺龍","110/08/16","台新-台中",1,15,-14
"305","6246臺龍","110/08/16","華南永昌",23,5,18
"306","6246臺龍","110/08/16","群益金鼎-開元",0,12,-12
"307","6246臺龍","110/08/16","華南永昌-彰化",15,4,11
"308","6246臺龍","110/08/16","凱基-苗栗",0,7,-7
"309","6246臺龍","110/08/16","統一-台中",10,0,10
"310","6246臺龍","110/08/16","日盛-鳳山",0,6,-6
"311","6246臺龍","110/08/16","兆豐-新營",11,1,10
"312","6246臺龍","110/08/16","台新證券",4,10,-6
"313","6246臺龍","110/08/16","玉山-桃園",10,0,10
"314","6246臺龍","110/08/16","新光",4,10,-6
"315","6246臺龍","110/08/16","凱基-台北",12,2,10
"316","6246臺龍","110/08/16","華南永昌-嘉義",0,6,-6
"317","6246臺龍","110/08/16","群益金鼎-東大",9,0,9
"318","6246臺龍","110/08/16","元大-竹北",0,6,-6
"319","6246臺龍","110/08/16","元富-中港",6,0,6
"320","6246臺龍","110/08/16","元大-永康",0,6,-6
"321","6246臺龍","110/08/16","德信-新營",6,0,6
"322","6246臺龍","110/08/16","元富-新店",0,5,-5
"323","6246臺龍","110/08/16","兆豐-西螺",5,0,5
"324","6246臺龍","110/08/16","台中銀",0,5,-5
"325","6246臺龍","110/08/16","群益金鼎-土城",5,0,5
"326","6246臺龍","110/08/16","群益金鼎-永和",0,5,-5
"327","6246臺龍","110/08/16","富邦-仁愛",5,0,5
"328","6246臺龍","110/08/16","元大-台南",0,5,-5
"329","6246臺龍","110/08/16","元大-基隆孝二",7,2,5
"330","6246臺龍","110/08/16","元大-土城",0,5,-5
"331","00715L期街口布蘭特正2","110/08/16","元富",1720,5,1715
"332","00715L期街口布蘭特正2","110/08/16","元大證券",365,4674,-4309
"333","00715L期街口布蘭特正2","110/08/16","港商野村",1350,660,690
"334","00715L期街口布蘭特正2","110/08/16","華南永昌-長虹",50,820,-770
"335","00715L期街口布蘭特正2","110/08/16","(牛牛牛)亞-鑫豐",587,51,536
"336","00715L期街口布蘭特正2","110/08/16","凱基-台北",42,470,-428
"337","00715L期街口布蘭特正2","110/08/16","富邦-嘉義",405,0,405
"338","00715L期街口布蘭特正2","110/08/16","永豐金證券",5,360,-355
"339","00715L期街口布蘭特正2","110/08/16","兆豐-嘉義",303,0,303
"340","00715L期街口布蘭特正2","110/08/16","元大-復北",1,333,-332
"341","00715L期街口布蘭特正2","110/08/16","元大-學甲",272,0,272
"342","00715L期街口布蘭特正2","110/08/16","兆豐-新莊",0,306,-306
"343","00715L期街口布蘭特正2","110/08/16","元大-中和",308,52,256
"344","00715L期街口布蘭特正2","110/08/16","凱基-松山",0,302,-302
"345","00715L期街口布蘭特正2","110/08/16","新光",318,84,234
"346","00715L期街口布蘭特正2","110/08/16","統一-桃園",7,280,-273
"347","00715L期街口布蘭特正2","110/08/16","元大-北港",165,0,165
"348","00715L期街口布蘭特正2","110/08/16","日盛-板橋",31,300,-269
"349","00715L期街口布蘭特正2","110/08/16","台中銀",202,45,157
"350","00715L期街口布蘭特正2","110/08/16","凱基",0,250,-250
"351","00715L期街口布蘭特正2","110/08/16","元大-台中中港",157,0,157
"352","00715L期街口布蘭特正2","110/08/16","富邦-仁愛",11,250,-239
"353","00715L期街口布蘭特正2","110/08/16","元大-花蓮",150,4,146
"354","00715L期街口布蘭特正2","110/08/16","台新-台中",34,262,-228
"355","00715L期街口布蘭特正2","110/08/16","統一-台中",165,32,133
"356","00715L期街口布蘭特正2","110/08/16","元富-吉利",5,210,-205
"357","00715L期街口布蘭特正2","110/08/16","永全-南崁",130,0,130
"358","00715L期街口布蘭特正2","110/08/16","康和",0,150,-150
"359","00715L期街口布蘭特正2","110/08/16","元富-中壢",223,100,123
"360","00715L期街口布蘭特正2","110/08/16","兆豐-台中港",53,190,-137
"361","8941關中","110/08/16","凱基-市府",4,0,4
"362","8941關中","110/08/16","統一-台中",0,3,-3
"363","8941關中","110/08/16","(牛牛牛)亞-鑫豐",2,1,1
"364","8941關中","110/08/16","宏遠-中和",0,1,-1
"365","8941關中","110/08/16","富邦-左營",1,0,1
"366","8941關中","110/08/16","富邦-竹北",0,1,-1
"367","8941關中","110/08/16","元大-路竹",1,0,1
"368","8941關中","110/08/16","元大-華山",0,1,-1
"369","8941關中","110/08/16","統一-新台中",0,0,0
"370","8941關中","110/08/16","永豐金-中正",0,1,-1
"371","8941關中","110/08/16","元富-中港",0,0,0
"372","8941關中","110/08/16","統一-新台中",0,0,0
"373","8941關中","110/08/16","元大證券",0,0,0
"374","8941關中","110/08/16","元富-中港",0,0,0
"375","8941關中","110/08/16","元大-龍潭",0,0,0
"376","8941關中","110/08/16","元大證券",0,0,0
"377","8941關中","110/08/16","永豐金-南投",0,0,0
"378","8941關中","110/08/16","元大-龍潭",0,0,0
"379","8941關中","110/08/16","",NA,NA,NA
"380","8941關中","110/08/16","永豐金-南投",0,0,0
"381","8941關中","110/08/16","",NA,NA,NA
"382","8941關中","110/08/16","",NA,NA,NA
"383","8941關中","110/08/16","",NA,NA,NA
"384","8941關中","110/08/16","",NA,NA,NA
"385","8941關中","110/08/16","",NA,NA,NA
"386","8941關中","110/08/16","",NA,NA,NA
"387","8941關中","110/08/16","",NA,NA,NA
"388","8941關中","110/08/16","",NA,NA,NA
"389","8941關中","110/08/16","",NA,NA,NA
"390","8941關中","110/08/16","",NA,NA,NA
"391","8936國統","110/08/16","台中銀-高雄",200,0,200
"392","8936國統","110/08/16","摩根大通",39,181,-142
"393","8936國統","110/08/16","美林",139,31,108
"394","8936國統","110/08/16","新加坡商瑞銀",48,178,-130
"395","8936國統","110/08/16","元大-天母",50,0,50
"396","8936國統","110/08/16","凱基-台北",66,161,-95
"397","8936國統","110/08/16","中國信託",50,2,48
"398","8936國統","110/08/16","新光-桃園",2,90,-88
"399","8936國統","110/08/16","元大-豐原站前",40,0,40
"400","8936國統","110/08/16","台灣摩根士丹利",1,79,-78
"401","8936國統","110/08/16","元大-北港",32,0,32
"402","8936國統","110/08/16","永豐金-苓雅",10,80,-70
"403","8936國統","110/08/16","永豐金-竹科",28,0,28
"404","8936國統","110/08/16","富邦-南屯",15,64,-49
"405","8936國統","110/08/16","凱基-岡山",27,0,27
"406","8936國統","110/08/16","台新-高雄",10,56,-46
"407","8936國統","110/08/16","第一金-自由",20,0,20
"408","8936國統","110/08/16","國票-北高雄",5,30,-25
"409","8936國統","110/08/16","港商野村",68,50,18
"410","8936國統","110/08/16","台新-屏東",0,25,-25
"411","8936國統","110/08/16","華南永昌-岡山",16,0,16
"412","8936國統","110/08/16","元大-高雄",0,23,-23
"413","8936國統","110/08/16","新光-台中",59,44,15
"414","8936國統","110/08/16","台灣企銀-豐原",0,22,-22
"415","8936國統","110/08/16","日盛證券",14,0,14
"416","8936國統","110/08/16","玉山證券",0,19,-19
"417","8936國統","110/08/16","元富-林園",12,0,12
"418","8936國統","110/08/16","日盛-中壢",0,16,-16
"419","8936國統","110/08/16","兆豐-景美",12,0,12
"420","8936國統","110/08/16","美商高盛",6,21,-15
"421","6226光鼎","110/08/16","凱基-台北",1070,545,525
"422","6226光鼎","110/08/16","台新證券",86,218,-132
"423","6226光鼎","110/08/16","美林",291,133,158
"424","6226光鼎","110/08/16","元富-新竹",10,139,-129
"425","6226光鼎","110/08/16","瑞士信貸",144,6,138
"426","6226光鼎","110/08/16","元大-台南",0,101,-101
"427","6226光鼎","110/08/16","摩根大通",340,206,134
"428","6226光鼎","110/08/16","永豐金-南投",1,100,-99
"429","6226光鼎","110/08/16","美商高盛",222,102,120
"430","6226光鼎","110/08/16","華南永昌-高雄",1,63,-62
"431","6226光鼎","110/08/16","新光",195,77,118
"432","6226光鼎","110/08/16","元大-仁愛",1,61,-60
"433","6226光鼎","110/08/16","第一金-大稻埕",103,1,102
"434","6226光鼎","110/08/16","群益金鼎-士林",39,98,-59
"435","6226光鼎","110/08/16","元大-北投",101,4,97
"436","6226光鼎","110/08/16","元大-府城",20,72,-52
"437","6226光鼎","110/08/16","元大-竹科",101,10,91
"438","6226光鼎","110/08/16","合庫-鳳山",4,53,-49
"439","6226光鼎","110/08/16","元大-北屯",104,15,89
"440","6226光鼎","110/08/16","國票-九鼎",2,44,-42
"441","6226光鼎","110/08/16","國泰-桃園",98,29,69
"442","6226光鼎","110/08/16","元大-金華",13,55,-42
"443","6226光鼎","110/08/16","群益金鼎-東門",67,0,67
"444","6226光鼎","110/08/16","富邦-竹東",5,43,-38
"445","6226光鼎","110/08/16","港商野村",277,215,62
"446","6226光鼎","110/08/16","元大-雙和",6,43,-37
"447","6226光鼎","110/08/16","群益金鼎-西松",51,1,50
"448","6226光鼎","110/08/16","中國信託-忠孝",2,36,-34
"449","6226光鼎","110/08/16","元富-古亭",50,3,47
"450","6226光鼎","110/08/16","華南永昌-三重",3,37,-34
"451","2363矽統","110/08/16","凱基-台北",2187,1127,1060
"452","2363矽統","110/08/16","元大-東泰",32,339,-307
"453","2363矽統","110/08/16","美商高盛",1277,381,896
"454","2363矽統","110/08/16","國泰-敦南",408,608,-200
"455","2363矽統","110/08/16","美林",777,172,605
"456","2363矽統","110/08/16","台灣摩根士丹利",6,185,-179
"457","2363矽統","110/08/16","新加坡商瑞銀",764,476,288
"458","2363矽統","110/08/16","群益金鼎",14,154,-140
"459","2363矽統","110/08/16","永豐金-嘉義",250,2,248
"460","2363矽統","110/08/16","富邦-新竹",103,229,-126
"461","2363矽統","110/08/16","瑞士信貸",247,11,236
"462","2363矽統","110/08/16","凱基",0,120,-120
"463","2363矽統","110/08/16","群益金鼎-士林",173,17,156
"464","2363矽統","110/08/16","元大-大統",25,138,-113
"465","2363矽統","110/08/16","統一-新竹",151,2,149
"466","2363矽統","110/08/16","富邦-中壢",17,125,-108
"467","2363矽統","110/08/16","港商野村",1539,1409,130
"468","2363矽統","110/08/16","兆豐-天母",1,102,-101
"469","2363矽統","110/08/16","凱基-長庚",136,12,124
"470","2363矽統","110/08/16","陽信-石牌",13,105,-92
"471","2363矽統","110/08/16","台新-三民",156,49,107
"472","2363矽統","110/08/16","永豐金-新店",8,100,-92
"473","2363矽統","110/08/16","凱基-南崁",98,26,72
"474","2363矽統","110/08/16","日盛-北高雄",25,105,-80
"475","2363矽統","110/08/16","元富-城東",78,9,69
"476","2363矽統","110/08/16","元大-萬華",36,116,-80
"477","2363矽統","110/08/16","元大-汐止",144,79,65
"478","2363矽統","110/08/16","玉山證券",37,116,-79
"479","2363矽統","110/08/16","永豐金-中壢",91,28,63
"480","2363矽統","110/08/16","元大-敦南",3,81,-78
"481","8112至上","110/08/16","合庫證券",140,7,133
"482","8112至上","110/08/16","摩根大通",19,588,-569
"483","8112至上","110/08/16","新光-桃園",102,4,98
"484","8112至上","110/08/16","新加坡商瑞銀",17,338,-321
"485","8112至上","110/08/16","元大-敦化",80,2,78
"486","8112至上","110/08/16","瑞士信貸",3,181,-178
"487","8112至上","110/08/16","元大-台北",71,0,71
"488","8112至上","110/08/16","美林",84,183,-99
"489","8112至上","110/08/16","凱基-嘉義",97,37,60
"490","8112至上","110/08/16","台灣摩根士丹利",9,101,-92
"491","8112至上","110/08/16","元大-開元",44,1,43
"492","8112至上","110/08/16","凱基-台北",133,201,-68
"493","8112至上","110/08/16","永豐金-台中",43,0,43
"494","8112至上","110/08/16","新光-高雄",3,57,-54
"495","8112至上","110/08/16","元大-仁愛",40,0,40
"496","8112至上","110/08/16","新百王",1,51,-50
"497","8112至上","110/08/16","富邦-仁愛",65,27,38
"498","8112至上","110/08/16","華南永昌-新莊",2,47,-45
"499","8112至上","110/08/16","元大-前金",40,3,37
"500","8112至上","110/08/16","華南永昌-潮州",0,30,-30
"501","8112至上","110/08/16","富邦-中壢",33,1,32
"502","8112至上","110/08/16","國票-長城",18,45,-27
"503","8112至上","110/08/16","統一-中壢",31,0,31
"504","8112至上","110/08/16","群益金鼎-海山",3,30,-27
"505","8112至上","110/08/16","台新-台中",32,1,31
"506","8112至上","110/08/16","元大-發財",1,28,-27
"507","8112至上","110/08/16","新光",38,11,27
"508","8112至上","110/08/16","兆豐-斗南",4,30,-26
"509","8112至上","110/08/16","合庫-嘉義",25,0,25
"510","8112至上","110/08/16","國泰-板橋",9,32,-23
"511","1570力肯","110/08/16","兆豐-民生",80,0,80
"512","1570力肯","110/08/16","台新證券",17,184,-167
"513","1570力肯","110/08/16","國票-北高雄",145,85,60
"514","1570力肯","110/08/16","凱基-台北",61,183,-122
"515","1570力肯","110/08/16","新光",83,31,52
"516","1570力肯","110/08/16","摩根大通",18,89,-71
"517","1570力肯","110/08/16","凱基-三峽",40,0,40
"518","1570力肯","110/08/16","新光-台南",1,50,-49
"519","1570力肯","110/08/16","元大-大雅",40,0,40
"520","1570力肯","110/08/16","國泰-松江",0,30,-30
"521","1570力肯","110/08/16","元富-新竹",30,0,30
"522","1570力肯","110/08/16","永豐金-桃園",0,30,-30
"523","1570力肯","110/08/16","富邦-花蓮",29,0,29
"524","1570力肯","110/08/16","元富-文心",1,23,-22
"525","1570力肯","110/08/16","統一-高雄",26,1,25
"526","1570力肯","110/08/16","永豐金-屏東",3,25,-22
"527","1570力肯","110/08/16","元大-雙和",24,0,24
"528","1570力肯","110/08/16","台灣摩根士丹利",0,18,-18
"529","1570力肯","110/08/16","日盛-高雄",21,0,21
"530","1570力肯","110/08/16","元富-新店",2,20,-18
"531","1570力肯","110/08/16","國票-和平",27,6,21
"532","1570力肯","110/08/16","康和-屏東",0,16,-16
"533","1570力肯","110/08/16","國泰證券",20,0,20
"534","1570力肯","110/08/16","聯邦-三重",0,15,-15
"535","1570力肯","110/08/16","群益金鼎-東門",20,0,20
"536","1570力肯","110/08/16","富邦-內湖",8,21,-13
"537","1570力肯","110/08/16","元大-民生",19,0,19
"538","1570力肯","110/08/16","新光-台中",8,20,-12
"539","1570力肯","110/08/16","元富-民權",15,0,15
"540","1570力肯","110/08/16","國泰-館前",0,12,-12
"541","2929淘帝","110/08/16","日盛-中壢",55,1,54
"542","2929淘帝","110/08/16","摩根大通",10,80,-70
"543","2929淘帝","110/08/16","元大-太平",31,0,31
"544","2929淘帝","110/08/16","港商野村",13,57,-44
"545","2929淘帝","110/08/16","宏遠-館前",30,0,30
"546","2929淘帝","110/08/16","元大-西門",0,37,-37
"547","2929淘帝","110/08/16","凱基-東門",24,0,24
"548","2929淘帝","110/08/16","新加坡商瑞銀",4,26,-22
"549","2929淘帝","110/08/16","台新-台中",21,0,21
"550","2929淘帝","110/08/16","元大-大里",0,22,-22
"551","2929淘帝","110/08/16","日盛-八德",16,0,16
"552","2929淘帝","110/08/16","兆豐-三重",0,20,-20
"553","2929淘帝","110/08/16","元富-文心",10,0,10
"554","2929淘帝","110/08/16","永豐金-鳳山",0,14,-14
"555","2929淘帝","110/08/16","兆豐-桃園",10,0,10
"556","2929淘帝","110/08/16","美林",6,17,-11
"557","2929淘帝","110/08/16","群益金鼎-基隆",10,0,10
"558","2929淘帝","110/08/16","臺銀-金山",0,10,-10
"559","2929淘帝","110/08/16","永豐金證券",10,0,10
"560","2929淘帝","110/08/16","國票-博愛",0,10,-10
"561","2929淘帝","110/08/16","新光",10,2,8
"562","2929淘帝","110/08/16","元大-上新莊",2,12,-10
"563","2929淘帝","110/08/16","元大-承德",8,0,8
"564","2929淘帝","110/08/16","兆豐-大同",0,9,-9
"565","2929淘帝","110/08/16","亞東-新竹",7,0,7
"566","2929淘帝","110/08/16","台新-建北",0,9,-9
"567","2929淘帝","110/08/16","凱基-林口",7,0,7
"568","2929淘帝","110/08/16","國泰-館前",0,7,-7
"569","2929淘帝","110/08/16","凱基-新豐",6,0,6
"570","2929淘帝","110/08/16","兆豐-台南",0,6,-6
"571","5410國眾","110/08/16","兆豐-城中",85,0,85
"572","5410國眾","110/08/16","國泰-敦南",15,99,-84
"573","5410國眾","110/08/16","元大-六合",42,0,42
"574","5410國眾","110/08/16","凱基-高雄",0,50,-50
"575","5410國眾","110/08/16","兆豐-小港",36,0,36
"576","5410國眾","110/08/16","瑞士信貸",0,44,-44
"577","5410國眾","110/08/16","凱基-台南",30,0,30
"578","5410國眾","110/08/16","摩根大通",46,87,-41
"579","5410國眾","110/08/16","富邦-建國",31,1,30
"580","5410國眾","110/08/16","元大-士林",0,38,-38
"581","5410國眾","110/08/16","國票-安和",31,4,27
"582","5410國眾","110/08/16","兆豐-台中港",0,30,-30
"583","5410國眾","110/08/16","凱基-竹北",24,0,24
"584","5410國眾","110/08/16","凱基-台北",27,55,-28
"585","5410國眾","110/08/16","玉山-新莊",15,0,15
"586","5410國眾","110/08/16","元大-古亭",0,26,-26
"587","5410國眾","110/08/16","元大-木柵",12,0,12
"588","5410國眾","110/08/16","臺銀",1,24,-23
"589","5410國眾","110/08/16","元大-新盛",12,0,12
"590","5410國眾","110/08/16","元大-中壢",3,26,-23
"591","5410國眾","110/08/16","永豐金-台南",12,1,11
"592","5410國眾","110/08/16","元大-北港",0,21,-21
"593","5410國眾","110/08/16","合庫-桃園",10,0,10
"594","5410國眾","110/08/16","元大-北投",0,20,-20
"595","5410國眾","110/08/16","日盛-屏東",10,0,10
"596","5410國眾","110/08/16","元富-潮州",0,15,-15
"597","5410國眾","110/08/16","元富-城東",10,0,10
"598","5410國眾","110/08/16","臺銀-鳳山",1,15,-14
"599","5410國眾","110/08/16","富邦-陽明",10,0,10
"600","5410國眾","110/08/16","元大-屏東",0,14,-14
"601","2841台開","110/08/16","宏遠-館前",190,0,190
"602","2841台開","110/08/16","港商野村",0,44,-44
"603","2841台開","110/08/16","合庫證券",30,0,30
"604","2841台開","110/08/16","新光-台南",0,33,-33
"605","2841台開","110/08/16","凱基-竹科",20,0,20
"606","2841台開","110/08/16","台新證券",10,42,-32
"607","2841台開","110/08/16","永豐金-中盛",13,0,13
"608","2841台開","110/08/16","元大-大里德芳",0,30,-30
"609","2841台開","110/08/16","大慶-蘆洲",10,0,10
"610","2841台開","110/08/16","合庫-台中",0,28,-28
"611","2841台開","110/08/16","新光",13,3,10
"612","2841台開","110/08/16","元大-善化",0,20,-20
"613","2841台開","110/08/16","元大-新店中正",10,0,10
"614","2841台開","110/08/16","永豐金-敦南",30,50,-20
"615","2841台開","110/08/16","群益金鼎-崇德",8,0,8
"616","2841台開","110/08/16","新加坡商瑞銀",0,16,-16
"617","2841台開","110/08/16","元富-成功",7,0,7
"618","2841台開","110/08/16","玉山-新莊",0,16,-16
"619","2841台開","110/08/16","元大-彰化",7,0,7
"620","2841台開","110/08/16","日盛-內湖",0,15,-15
"621","2841台開","110/08/16","台中銀",5,0,5
"622","2841台開","110/08/16","兆豐-民生",0,15,-15
"623","2841台開","110/08/16","中國信託-文心",5,0,5
"624","2841台開","110/08/16","華南永昌-高雄",0,15,-15
"625","2841台開","110/08/16","兆豐-台中",5,0,5
"626","2841台開","110/08/16","元大-永康",0,10,-10
"627","2841台開","110/08/16","台新-新營",5,0,5
"628","2841台開","110/08/16","元大-北三重",0,10,-10
"629","2841台開","110/08/16","凱基-東港",10,5,5
"630","2841台開","110/08/16","永豐金證券",0,10,-10
"631","6207雷科","110/08/16","台新-高雄",131,3,128
"632","6207雷科","110/08/16","元大-高雄",0,52,-52
"633","6207雷科","110/08/16","凱基-台北",70,20,50
"634","6207雷科","110/08/16","摩根大通",62,112,-50
"635","6207雷科","110/08/16","元大-東門",42,0,42
"636","6207雷科","110/08/16","華南永昌-三重",0,50,-50
"637","6207雷科","110/08/16","永豐金證券",30,0,30
"638","6207雷科","110/08/16","凱基-復興",0,40,-40
"639","6207雷科","110/08/16","元大-六合",21,0,21
"640","6207雷科","110/08/16","元大-潮州",0,40,-40
"641","6207雷科","110/08/16","群益金鼎-東門",20,0,20
"642","6207雷科","110/08/16","日盛證券",2,37,-35
"643","6207雷科","110/08/16","元大-松江",20,0,20
"644","6207雷科","110/08/16","新加坡商瑞銀",45,80,-35
"645","6207雷科","110/08/16","大昌-桃園",28,10,18
"646","6207雷科","110/08/16","玉山-士林",0,27,-27
"647","6207雷科","110/08/16","統一-新竹",16,0,16
"648","6207雷科","110/08/16","元大-大統",0,22,-22
"649","6207雷科","110/08/16","台中銀",15,0,15
"650","6207雷科","110/08/16","元大-民生",2,24,-22
"651","6207雷科","110/08/16","中國信託-三重",13,0,13
"652","6207雷科","110/08/16","凱基-高雄",6,27,-21
"653","6207雷科","110/08/16","凱基-岡山",11,0,11
"654","6207雷科","110/08/16","國票-北高雄",0,15,-15
"655","6207雷科","110/08/16","富邦-中壢",11,0,11
"656","6207雷科","110/08/16","新光",0,12,-12
"657","6207雷科","110/08/16","港商野村",27,17,10
"658","6207雷科","110/08/16","台新-左楠",1,12,-11
"659","6207雷科","110/08/16","第一金-安和",10,0,10
"660","6207雷科","110/08/16","新光-台南",0,10,-10
"661","3679新至陞","110/08/16","凱基-台北",15,2,13
"662","3679新至陞","110/08/16","摩根大通",7,19,-12
"663","3679新至陞","110/08/16","台灣摩根士丹利",8,3,5
"664","3679新至陞","110/08/16","瑞士信貸",0,11,-11
"665","3679新至陞","110/08/16","國泰-桃園",5,0,5
"666","3679新至陞","110/08/16","永豐金-苓雅",1,5,-4
"667","3679新至陞","110/08/16","美商高盛",3,0,3
"668","3679新至陞","110/08/16","國泰-松江",0,3,-3
"669","3679新至陞","110/08/16","華南永昌",3,0,3
"670","3679新至陞","110/08/16","凱基-台南",0,3,-3
"671","3679新至陞","110/08/16","日盛-竹北",2,0,2
"672","3679新至陞","110/08/16","彰銀",0,2,-2
"673","3679新至陞","110/08/16","日盛-文化",3,1,2
"674","3679新至陞","110/08/16","新加坡商瑞銀",0,2,-2
"675","3679新至陞","110/08/16","大慶-蘆洲",3,1,2
"676","3679新至陞","110/08/16","第一金-頭份",0,2,-2
"677","3679新至陞","110/08/16","國票-九鼎",2,0,2
"678","3679新至陞","110/08/16","康和-嘉義",0,2,-2
"679","3679新至陞","110/08/16","華南永昌-高雄",2,0,2
"680","3679新至陞","110/08/16","凱基-站前",0,2,-2
"681","3679新至陞","110/08/16","元大-新店中正",2,0,2
"682","3679新至陞","110/08/16","元大證券",0,2,-2
"683","3679新至陞","110/08/16","土銀-士林",1,0,1
"684","3679新至陞","110/08/16","元大-頭份",0,2,-2
"685","3679新至陞","110/08/16","日盛證券",1,0,1
"686","3679新至陞","110/08/16","元大-斗信",0,2,-2
"687","3679新至陞","110/08/16","美林",10,9,1
"688","3679新至陞","110/08/16","元大-嘉義",0,2,-2
"689","3679新至陞","110/08/16","第一金-忠孝",1,0,1
"690","3679新至陞","110/08/16","日盛-龍潭",0,1,-1
"691","2727王品","110/08/16","瑞士信貸",49,0,49
"692","2727王品","110/08/16","台新證券",4,162,-158
"693","2727王品","110/08/16","台灣摩根士丹利",33,3,30
"694","2727王品","110/08/16","臺銀-鳳山",5,81,-76
"695","2727王品","110/08/16","新光",37,12,25
"696","2727王品","110/08/16","玉山-台南",2,33,-31
"697","2727王品","110/08/16","日盛-忠孝",20,0,20
"698","2727王品","110/08/16","美商高盛",0,23,-23
"699","2727王品","110/08/16","元大-東蘆",16,1,15
"700","2727王品","110/08/16","兆豐-南京",0,20,-20
"701","2727王品","110/08/16","第一金-台中",15,1,14
"702","2727王品","110/08/16","凱基-虎尾",0,20,-20
"703","2727王品","110/08/16","國泰-敦南",29,15,14
"704","2727王品","110/08/16","中國信託",2,20,-18
"705","2727王品","110/08/16","第一金-桃園",13,0,13
"706","2727王品","110/08/16","新光-桃園",2,20,-18
"707","2727王品","110/08/16","第一金-忠孝",13,1,12
"708","2727王品","110/08/16","永豐金證券",2,20,-18
"709","2727王品","110/08/16","摩根大通",24,12,12
"710","2727王品","110/08/16","統一",6,22,-16
"711","2727王品","110/08/16","富邦-陽明",15,3,12
"712","2727王品","110/08/16","合庫證券",2,14,-12
"713","2727王品","110/08/16","元富-西松",13,2,11
"714","2727王品","110/08/16","富邦-仁愛",7,19,-12
"715","2727王品","110/08/16","聯邦-興中",11,0,11
"716","2727王品","110/08/16","元大-竹科",4,16,-12
"717","2727王品","110/08/16","中國信託-松江",10,0,10
"718","2727王品","110/08/16","元大-和平",0,12,-12
"719","2727王品","110/08/16","凱基-市府",10,0,10
"720","2727王品","110/08/16","凱基-興隆",1,12,-11
"721","1570力肯","110/08/16","兆豐-民生",80,0,80
"722","1570力肯","110/08/16","台新證券",17,184,-167
"723","1570力肯","110/08/16","國票-北高雄",145,85,60
"724","1570力肯","110/08/16","凱基-台北",61,183,-122
"725","1570力肯","110/08/16","新光",83,31,52
"726","1570力肯","110/08/16","摩根大通",18,89,-71
"727","1570力肯","110/08/16","凱基-三峽",40,0,40
"728","1570力肯","110/08/16","新光-台南",1,50,-49
"729","1570力肯","110/08/16","元大-大雅",40,0,40
"730","1570力肯","110/08/16","國泰-松江",0,30,-30
"731","1570力肯","110/08/16","元富-新竹",30,0,30
"732","1570力肯","110/08/16","永豐金-桃園",0,30,-30
"733","1570力肯","110/08/16","富邦-花蓮",29,0,29
"734","1570力肯","110/08/16","元富-文心",1,23,-22
"735","1570力肯","110/08/16","統一-高雄",26,1,25
"736","1570力肯","110/08/16","永豐金-屏東",3,25,-22
"737","1570力肯","110/08/16","元大-雙和",24,0,24
"738","1570力肯","110/08/16","台灣摩根士丹利",0,18,-18
"739","1570力肯","110/08/16","日盛-高雄",21,0,21
"740","1570力肯","110/08/16","元富-新店",2,20,-18
"741","1570力肯","110/08/16","國票-和平",27,6,21
"742","1570力肯","110/08/16","康和-屏東",0,16,-16
"743","1570力肯","110/08/16","國泰證券",20,0,20
"744","1570力肯","110/08/16","聯邦-三重",0,15,-15
"745","1570力肯","110/08/16","群益金鼎-東門",20,0,20
"746","1570力肯","110/08/16","富邦-內湖",8,21,-13
"747","1570力肯","110/08/16","元大-民生",19,0,19
"748","1570力肯","110/08/16","新光-台中",8,20,-12
"749","1570力肯","110/08/16","元富-民權",15,0,15
"750","1570力肯","110/08/16","國泰-館前",0,12,-12
"751","6180橘子","110/08/16","美林",85,0,85
"752","6180橘子","110/08/16","合庫-高雄",2,121,-119
"753","6180橘子","110/08/16","新加坡商瑞銀",42,8,34
"754","6180橘子","110/08/16","群益金鼎-三民",0,100,-100
"755","6180橘子","110/08/16","合庫-自強",30,0,30
"756","6180橘子","110/08/16","台灣摩根士丹利",0,50,-50
"757","6180橘子","110/08/16","元大-中壢",23,0,23
"758","6180橘子","110/08/16","統一",0,30,-30
"759","6180橘子","110/08/16","新光-桃園",24,2,22
"760","6180橘子","110/08/16","凱基-台北",0,27,-27
"761","6180橘子","110/08/16","日盛-板橋",20,0,20
"762","6180橘子","110/08/16","群益金鼎-大安",0,20,-20
"763","6180橘子","110/08/16","康和-嘉義",19,0,19
"764","6180橘子","110/08/16","元大-博愛",1,20,-19
"765","6180橘子","110/08/16","永豐金-敦北",19,1,18
"766","6180橘子","110/08/16","元大-文心興安",2,20,-18
"767","6180橘子","110/08/16","元大-四維",16,0,16
"768","6180橘子","110/08/16","統一-中壢",0,15,-15
"769","6180橘子","110/08/16","元大-和平",16,0,16
"770","6180橘子","110/08/16","元富-宜蘭",2,15,-13
"771","6180橘子","110/08/16","港商野村",27,12,15
"772","6180橘子","110/08/16","元大-沙鹿",0,12,-12
"773","6180橘子","110/08/16","富隆-長安",15,0,15
"774","6180橘子","110/08/16","元大-清水",0,12,-12
"775","6180橘子","110/08/16","摩根大通",51,36,15
"776","6180橘子","110/08/16","臺銀-鳳山",3,14,-11
"777","6180橘子","110/08/16","美商高盛",15,1,14
"778","6180橘子","110/08/16","盈溢",0,10,-10
"779","6180橘子","110/08/16","元大-永和",13,0,13
"780","6180橘子","110/08/16","元富-世貿",0,10,-10
"781","2390云辰","110/08/16","富邦-虎尾",514,48,466
"782","2390云辰","110/08/16","凱基-台北",495,1222,-727
"783","2390云辰","110/08/16","摩根大通",2747,2369,378
"784","2390云辰","110/08/16","元富-西松",194,423,-229
"785","2390云辰","110/08/16","國泰-桃園",291,66,225
"786","2390云辰","110/08/16","國票-安和",121,349,-228
"787","2390云辰","110/08/16","元大-木柵",237,23,214
"788","2390云辰","110/08/16","元大-信義",10,155,-145
"789","2390云辰","110/08/16","新光",859,695,164
"790","2390云辰","110/08/16","統一-新台中",6,137,-131
"791","2390云辰","110/08/16","元大證券",229,67,162
"792","2390云辰","110/08/16","美林",355,470,-115
"793","2390云辰","110/08/16","兆豐-埔墘",719,573,146
"794","2390云辰","110/08/16","台新-高雄",113,208,-95
"795","2390云辰","110/08/16","永豐金-嘉義",144,20,124
"796","2390云辰","110/08/16","豐農",37,114,-77
"797","2390云辰","110/08/16","元大-台中",126,26,100
"798","2390云辰","110/08/16","國泰-忠孝",15,85,-70
"799","2390云辰","110/08/16","瑞士信貸",124,28,96
"800","2390云辰","110/08/16","富邦-北港",154,223,-69
"801","2390云辰","110/08/16","永豐金-古亭",120,24,96
"802","2390云辰","110/08/16","凱基-科園",11,79,-68
"803","2390云辰","110/08/16","富邦-嘉義",2108,2013,95
"804","2390云辰","110/08/16","華南永昌-台中",82,149,-67
"805","2390云辰","110/08/16","富邦-內湖",120,26,94
"806","2390云辰","110/08/16","台新-左楠",61,126,-65
"807","2390云辰","110/08/16","群益金鼎-三重",142,56,86
"808","2390云辰","110/08/16","元大-林園",3,67,-64
"809","2390云辰","110/08/16","元大-前金",200,123,77
"810","2390云辰","110/08/16","永豐金-萬盛",23,84,-61
