"","stake","date","name","buy","sell","total"
"1","2363矽統","110/07/20","第一金-忠孝",400,115,285
"2","2363矽統","110/07/20","國票-長城",3,452,-449
"3","2363矽統","110/07/20","第一金-高雄",188,0,188
"4","2363矽統","110/07/20","美林",158,531,-373
"5","2363矽統","110/07/20","凱基-高美館",199,14,185
"6","2363矽統","110/07/20","台新-左楠",13,310,-297
"7","2363矽統","110/07/20","凱基-台北",434,326,108
"8","2363矽統","110/07/20","玉山-台大",4,228,-224
"9","2363矽統","110/07/20","元富-松德",105,0,105
"10","2363矽統","110/07/20","群益金鼎-大甲",11,227,-216
"11","2363矽統","110/07/20","元大-竹科",109,7,102
"12","2363矽統","110/07/20","群益金鼎-中港",2,111,-109
"13","2363矽統","110/07/20","元大-成功",102,2,100
"14","2363矽統","110/07/20","元大-大天母",0,109,-109
"15","2363矽統","110/07/20","富邦-仁愛",116,17,99
"16","2363矽統","110/07/20","國泰-敦南",114,218,-104
"17","2363矽統","110/07/20","元大-上新莊",102,16,86
"18","2363矽統","110/07/20","港商野村",250,350,-100
"19","2363矽統","110/07/20","台新證券",286,208,78
"20","2363矽統","110/07/20","康和-澎湖",0,90,-90
"21","2363矽統","110/07/20","元大-新營",81,9,72
"22","2363矽統","110/07/20","凱基-中壢",15,99,-84
"23","2363矽統","110/07/20","華南永昌-鳳山",76,5,71
"24","2363矽統","110/07/20","元大-學甲",0,81,-81
"25","2363矽統","110/07/20","富邦-員林",65,2,63
"26","2363矽統","110/07/20","凱基-三重",22,91,-69
"27","2363矽統","110/07/20","元富-成功",67,6,61
"28","2363矽統","110/07/20","永豐金-嘉義",24,92,-68
"29","2363矽統","110/07/20","新光-新竹",62,1,61
"30","2363矽統","110/07/20","大慶-蘆洲",23,89,-66
"31","8112至上","110/07/20","摩根大通",1226,293,933
"32","8112至上","110/07/20","凱基-三重",27,502,-475
"33","8112至上","110/07/20","新加坡商瑞銀",358,83,275
"34","8112至上","110/07/20","宏遠證券",0,418,-418
"35","8112至上","110/07/20","台灣摩根士丹利",159,9,150
"36","8112至上","110/07/20","台新-台中",11,291,-280
"37","8112至上","110/07/20","統一-新竹",115,5,110
"38","8112至上","110/07/20","美林",44,194,-150
"39","8112至上","110/07/20","新光",233,126,107
"40","8112至上","110/07/20","凱基-新莊",0,100,-100
"41","8112至上","110/07/20","凱基-台北",367,260,107
"42","8112至上","110/07/20","富邦-永和",14,104,-90
"43","8112至上","110/07/20","兆豐-西螺",104,10,94
"44","8112至上","110/07/20","國票-敦北法人",4,88,-84
"45","8112至上","110/07/20","永豐金-中正",87,6,81
"46","8112至上","110/07/20","凱基-市政",3,80,-77
"47","8112至上","110/07/20","富邦-新店",102,24,78
"48","8112至上","110/07/20","台新證券",68,142,-74
"49","8112至上","110/07/20","元大-大同",83,5,78
"50","8112至上","110/07/20","永豐金-中壢",11,80,-69
"51","8112至上","110/07/20","富邦-園區",64,2,62
"52","8112至上","110/07/20","永豐金-台南",22,91,-69
"53","8112至上","110/07/20","新光-台南",73,14,59
"54","8112至上","110/07/20","元大-大雅",22,87,-65
"55","8112至上","110/07/20","統一-台中",60,2,58
"56","8112至上","110/07/20","光和",10,67,-57
"57","8112至上","110/07/20","元大-北成功",58,4,54
"58","8112至上","110/07/20","元大-竹科",27,74,-47
"59","8112至上","110/07/20","元富-林園",53,0,53
"60","8112至上","110/07/20","兆豐-公益",1,47,-46
"61","1570力肯","110/07/20","國票-北高雄",36,0,36
"62","1570力肯","110/07/20","國泰-敦南",0,19,-19
"63","1570力肯","110/07/20","群益金鼎-高雄",16,0,16
"64","1570力肯","110/07/20","中國信託-永康",0,12,-12
"65","1570力肯","110/07/20","臺銀-鳳山",10,0,10
"66","1570力肯","110/07/20","第一金-路竹",0,10,-10
"67","1570力肯","110/07/20","群益金鼎-新竹",6,0,6
"68","1570力肯","110/07/20","福勝",0,10,-10
"69","1570力肯","110/07/20","大昌-樹林",5,0,5
"70","1570力肯","110/07/20","群益金鼎-板橋",0,10,-10
"71","1570力肯","110/07/20","華南永昌-楠梓",5,0,5
"72","1570力肯","110/07/20","日盛-鳳山",0,8,-8
"73","1570力肯","110/07/20","元大-基隆孝二",5,0,5
"74","1570力肯","110/07/20","永豐金-新竹",6,14,-8
"75","1570力肯","110/07/20","元大-新竹經國",4,0,4
"76","1570力肯","110/07/20","第一金-彰化",0,7,-7
"77","1570力肯","110/07/20","土銀-高雄",2,0,2
"78","1570力肯","110/07/20","元富-吉利",0,7,-7
"79","1570力肯","110/07/20","台灣企銀-太平",2,0,2
"80","1570力肯","110/07/20","台中銀-員林",0,7,-7
"81","1570力肯","110/07/20","兆豐-忠孝",2,0,2
"82","1570力肯","110/07/20","玉山證券",1,8,-7
"83","1570力肯","110/07/20","玉山-城中",2,0,2
"84","1570力肯","110/07/20","統一-三重",0,5,-5
"85","1570力肯","110/07/20","國泰-板橋",2,0,2
"86","1570力肯","110/07/20","光和-溪湖",0,3,-3
"87","1570力肯","110/07/20","凱基-台北",2,0,2
"88","1570力肯","110/07/20","康和-澎湖",0,3,-3
"89","1570力肯","110/07/20","華南永昌-高雄",2,0,2
"90","1570力肯","110/07/20","摩根大通",0,2,-2
"91","2929淘帝","110/07/20","玉山-新竹",59,0,59
"92","2929淘帝","110/07/20","臺銀",0,45,-45
"93","2929淘帝","110/07/20","兆豐-新莊",50,0,50
"94","2929淘帝","110/07/20","光和-嘉義",0,29,-29
"95","2929淘帝","110/07/20","元大-大甲",30,0,30
"96","2929淘帝","110/07/20","新加坡商瑞銀",27,55,-28
"97","2929淘帝","110/07/20","元大-民生",29,0,29
"98","2929淘帝","110/07/20","華南永昌-潮州",0,20,-20
"99","2929淘帝","110/07/20","元大-員林",20,0,20
"100","2929淘帝","110/07/20","玉山-高雄",0,14,-14
"101","2929淘帝","110/07/20","元富-台南",18,0,18
"102","2929淘帝","110/07/20","富邦-南屯",2,13,-11
"103","2929淘帝","110/07/20","港商野村",63,50,13
"104","2929淘帝","110/07/20","高橋-龍潭",0,10,-10
"105","2929淘帝","110/07/20","高橋",10,0,10
"106","2929淘帝","110/07/20","台新-建北",0,10,-10
"107","2929淘帝","110/07/20","元富-林園",10,0,10
"108","2929淘帝","110/07/20","群益金鼎-台中",0,10,-10
"109","2929淘帝","110/07/20","玉山-台南",10,0,10
"110","2929淘帝","110/07/20","華南永昌-苗栗",0,10,-10
"111","2929淘帝","110/07/20","群益金鼎-士林",10,0,10
"112","2929淘帝","110/07/20","群益金鼎-西松",0,9,-9
"113","2929淘帝","110/07/20","凱基-台北",16,6,10
"114","2929淘帝","110/07/20","台新-三民",0,8,-8
"115","2929淘帝","110/07/20","合庫證券",9,0,9
"116","2929淘帝","110/07/20","群益金鼎",0,8,-8
"117","2929淘帝","110/07/20","永豐金證券",9,2,7
"118","2929淘帝","110/07/20","富邦-永和",0,7,-7
"119","2929淘帝","110/07/20","凱基-基隆",6,0,6
"120","2929淘帝","110/07/20","國泰-台中",6,12,-6
"121","5410國眾","110/07/20","日盛-內湖",27,0,27
"122","5410國眾","110/07/20","永豐金-內湖",0,23,-23
"123","5410國眾","110/07/20","富邦-新營",20,0,20
"124","5410國眾","110/07/20","兆豐-台中港",0,20,-20
"125","5410國眾","110/07/20","大昌",17,0,17
"126","5410國眾","110/07/20","元富-嘉義",0,15,-15
"127","5410國眾","110/07/20","永豐金-台南",17,0,17
"128","5410國眾","110/07/20","元富-吉利",0,11,-11
"129","5410國眾","110/07/20","凱基-站前",15,0,15
"130","5410國眾","110/07/20","凱基-長庚",0,10,-10
"131","5410國眾","110/07/20","凱基-竹北",11,0,11
"132","5410國眾","110/07/20","元大-八德",0,10,-10
"133","5410國眾","110/07/20","元富-民權",9,0,9
"134","5410國眾","110/07/20","元大-天母",0,10,-10
"135","5410國眾","110/07/20","群益金鼎-嘉義",6,0,6
"136","5410國眾","110/07/20","國泰-桃園",0,9,-9
"137","5410國眾","110/07/20","元大-土城學府",6,0,6
"138","5410國眾","110/07/20","新光",5,12,-7
"139","5410國眾","110/07/20","第一金-豐原",5,0,5
"140","5410國眾","110/07/20","玉山-桃園",0,7,-7
"141","5410國眾","110/07/20","華南永昌-林口",5,0,5
"142","5410國眾","110/07/20","玉山-雙和",0,6,-6
"143","5410國眾","110/07/20","元大-博愛",5,0,5
"144","5410國眾","110/07/20","臺銀-臺南",0,5,-5
"145","5410國眾","110/07/20","元大-竹南",5,0,5
"146","5410國眾","110/07/20","彰銀-七賢",0,5,-5
"147","5410國眾","110/07/20","元大-新店中正",5,0,5
"148","5410國眾","110/07/20","宏遠證券",0,5,-5
"149","5410國眾","110/07/20","元富-烏日",4,0,4
"150","5410國眾","110/07/20","摩根大通",0,5,-5
"151","2841台開","110/07/20","中國信託-忠孝",145,0,145
"152","2841台開","110/07/20","凱基-松山",0,100,-100
"153","2841台開","110/07/20","第一金-台中",68,0,68
"154","2841台開","110/07/20","第一金-自由",0,33,-33
"155","2841台開","110/07/20","美商高盛",37,0,37
"156","2841台開","110/07/20","港商野村",0,29,-29
"157","2841台開","110/07/20","台中銀",32,0,32
"158","2841台開","110/07/20","國泰-敦南",11,31,-20
"159","2841台開","110/07/20","台新-台中",20,0,20
"160","2841台開","110/07/20","華南永昌-台中",0,20,-20
"161","2841台開","110/07/20","凱基-東港",10,0,10
"162","2841台開","110/07/20","元大-發財",0,15,-15
"163","2841台開","110/07/20","大昌-安康",10,3,7
"164","2841台開","110/07/20","元大-福營",9,23,-14
"165","2841台開","110/07/20","豐農",7,0,7
"166","2841台開","110/07/20","永豐金-敦南",5,18,-13
"167","2841台開","110/07/20","元大-歸仁",7,0,7
"168","2841台開","110/07/20","統一-城中",0,11,-11
"169","2841台開","110/07/20","日盛-木柵",5,0,5
"170","2841台開","110/07/20","日盛-台南",0,10,-10
"171","2841台開","110/07/20","台新-台南",4,0,4
"172","2841台開","110/07/20","兆豐-寶成",0,10,-10
"173","2841台開","110/07/20","日盛證券",3,0,3
"174","2841台開","110/07/20","國票-中港",0,10,-10
"175","2841台開","110/07/20","台新證券",8,5,3
"176","2841台開","110/07/20","群益金鼎",0,10,-10
"177","2841台開","110/07/20","元大-沙鹿",3,0,3
"178","2841台開","110/07/20","玉山證券",1,10,-9
"179","2841台開","110/07/20","國泰-台中",2,0,2
"180","2841台開","110/07/20","大昌-新店",0,6,-6
"181","6207雷科","110/07/20","元大-西門",100,4,96
"182","6207雷科","110/07/20","永豐金-內湖",0,109,-109
"183","6207雷科","110/07/20","凱基-復興",50,0,50
"184","6207雷科","110/07/20","國泰證券",0,90,-90
"185","6207雷科","110/07/20","凱基-台北",47,1,46
"186","6207雷科","110/07/20","元大-頭份",0,55,-55
"187","6207雷科","110/07/20","玉山-城中",43,1,42
"188","6207雷科","110/07/20","永豐金-虎尾",0,50,-50
"189","6207雷科","110/07/20","華南永昌-長虹",44,5,39
"190","6207雷科","110/07/20","元富-世貿",0,33,-33
"191","6207雷科","110/07/20","凱基-板橋",38,1,37
"192","6207雷科","110/07/20","元大-南崁",0,22,-22
"193","6207雷科","110/07/20","元富-信義",39,3,36
"194","6207雷科","110/07/20","永豐金-鳳山",0,21,-21
"195","6207雷科","110/07/20","元富-彰化",35,0,35
"196","6207雷科","110/07/20","永豐金-三重",6,27,-21
"197","6207雷科","110/07/20","凱基-高美館",34,0,34
"198","6207雷科","110/07/20","第一金-澎湖",0,20,-20
"199","6207雷科","110/07/20","富邦-中壢",26,2,24
"200","6207雷科","110/07/20","群益金鼎-東大",0,20,-20
"201","6207雷科","110/07/20","大昌-桃園",23,0,23
"202","6207雷科","110/07/20","兆豐-民生",0,19,-19
"203","6207雷科","110/07/20","元大-四維",39,17,22
"204","6207雷科","110/07/20","元大-北成功",1,20,-19
"205","6207雷科","110/07/20","台灣摩根士丹利",18,0,18
"206","6207雷科","110/07/20","元大-虎尾",1,18,-17
"207","6207雷科","110/07/20","國票-中和",16,0,16
"208","6207雷科","110/07/20","元大-文心興安",0,15,-15
"209","6207雷科","110/07/20","永豐金-大園",16,0,16
"210","6207雷科","110/07/20","瑞士信貸",0,14,-14
"211","3679新至陞","110/07/20","國票-敦北法人",18,0,18
"212","3679新至陞","110/07/20","華南永昌-台中",0,32,-32
"213","3679新至陞","110/07/20","台中銀-員林",17,3,14
"214","3679新至陞","110/07/20","凱基-台北",12,32,-20
"215","3679新至陞","110/07/20","群益金鼎-高盛",13,0,13
"216","3679新至陞","110/07/20","摩根大通",2,14,-12
"217","3679新至陞","110/07/20","康和-澎湖",8,0,8
"218","3679新至陞","110/07/20","國泰-桃園",0,11,-11
"219","3679新至陞","110/07/20","台新證券",6,0,6
"220","3679新至陞","110/07/20","群益金鼎-台南",0,10,-10
"221","3679新至陞","110/07/20","宏遠-光隆",4,0,4
"222","3679新至陞","110/07/20","群益金鼎-大安",0,10,-10
"223","3679新至陞","110/07/20","玉山-大里",4,0,4
"224","3679新至陞","110/07/20","永豐金證券",4,14,-10
"225","3679新至陞","110/07/20","台中銀-豐原",3,0,3
"226","3679新至陞","110/07/20","兆豐-大同",1,6,-5
"227","3679新至陞","110/07/20","玉山-新莊",3,0,3
"228","3679新至陞","110/07/20","群益金鼎-館前",0,4,-4
"229","3679新至陞","110/07/20","凱基-中山",3,0,3
"230","3679新至陞","110/07/20","富邦-南屯",0,4,-4
"231","3679新至陞","110/07/20","富邦-台北",3,0,3
"232","3679新至陞","110/07/20","瑞士信貸",3,6,-3
"233","3679新至陞","110/07/20","元大-板橋",3,0,3
"234","3679新至陞","110/07/20","國泰-板橋",0,3,-3
"235","3679新至陞","110/07/20","日盛-八德",2,0,2
"236","3679新至陞","110/07/20","富邦-中壢",1,4,-3
"237","3679新至陞","110/07/20","日盛-復興",2,0,2
"238","3679新至陞","110/07/20","台灣企銀",0,2,-2
"239","3679新至陞","110/07/20","康和-板橋",2,0,2
"240","3679新至陞","110/07/20","日盛-大墩",0,2,-2
"241","2727王品","110/07/20","兆豐-南京",200,0,200
"242","2727王品","110/07/20","凱基-市政",1,75,-74
"243","2727王品","110/07/20","富邦證券",88,0,88
"244","2727王品","110/07/20","美商高盛",6,38,-32
"245","2727王品","110/07/20","台新證券",142,55,87
"246","2727王品","110/07/20","富邦-陽明",7,38,-31
"247","2727王品","110/07/20","瑞士信貸",50,0,50
"248","2727王品","110/07/20","永豐金-中正",3,34,-31
"249","2727王品","110/07/20","港商野村",106,57,49
"250","2727王品","110/07/20","永豐金-潮州",0,31,-31
"251","2727王品","110/07/20","凱基-台北",67,27,40
"252","2727王品","110/07/20","兆豐-大安",0,30,-30
"253","2727王品","110/07/20","永豐金-大園",29,2,27
"254","2727王品","110/07/20","摩根大通",50,73,-23
"255","2727王品","110/07/20","康和-高雄",20,0,20
"256","2727王品","110/07/20","日盛證券",4,24,-20
"257","2727王品","110/07/20","第一金-高雄",20,3,17
"258","2727王品","110/07/20","凱基-大里",0,20,-20
"259","2727王品","110/07/20","富邦-板橋",21,4,17
"260","2727王品","110/07/20","群益金鼎-大甲",0,18,-18
"261","2727王品","110/07/20","永豐金-桃盛",15,0,15
"262","2727王品","110/07/20","統一",18,29,-11
"263","2727王品","110/07/20","凱基",13,0,13
"264","2727王品","110/07/20","國泰-台中",12,23,-11
"265","2727王品","110/07/20","新加坡商瑞銀",23,11,12
"266","2727王品","110/07/20","元大-彰化",0,11,-11
"267","2727王品","110/07/20","亞東",10,0,10
"268","2727王品","110/07/20","國泰-館前",4,14,-10
"269","2727王品","110/07/20","康和-台中",13,4,9
"270","2727王品","110/07/20","元大-學甲",0,10,-10
"271","1570力肯","110/07/20","國票-北高雄",36,0,36
"272","1570力肯","110/07/20","國泰-敦南",0,19,-19
"273","1570力肯","110/07/20","群益金鼎-高雄",16,0,16
"274","1570力肯","110/07/20","中國信託-永康",0,12,-12
"275","1570力肯","110/07/20","臺銀-鳳山",10,0,10
"276","1570力肯","110/07/20","第一金-路竹",0,10,-10
"277","1570力肯","110/07/20","群益金鼎-新竹",6,0,6
"278","1570力肯","110/07/20","福勝",0,10,-10
"279","1570力肯","110/07/20","大昌-樹林",5,0,5
"280","1570力肯","110/07/20","群益金鼎-板橋",0,10,-10
"281","1570力肯","110/07/20","華南永昌-楠梓",5,0,5
"282","1570力肯","110/07/20","日盛-鳳山",0,8,-8
"283","1570力肯","110/07/20","元大-基隆孝二",5,0,5
"284","1570力肯","110/07/20","永豐金-新竹",6,14,-8
"285","1570力肯","110/07/20","元大-新竹經國",4,0,4
"286","1570力肯","110/07/20","第一金-彰化",0,7,-7
"287","1570力肯","110/07/20","土銀-高雄",2,0,2
"288","1570力肯","110/07/20","元富-吉利",0,7,-7
"289","1570力肯","110/07/20","台灣企銀-太平",2,0,2
"290","1570力肯","110/07/20","台中銀-員林",0,7,-7
"291","1570力肯","110/07/20","兆豐-忠孝",2,0,2
"292","1570力肯","110/07/20","玉山證券",1,8,-7
"293","1570力肯","110/07/20","玉山-城中",2,0,2
"294","1570力肯","110/07/20","統一-三重",0,5,-5
"295","1570力肯","110/07/20","國泰-板橋",2,0,2
"296","1570力肯","110/07/20","光和-溪湖",0,3,-3
"297","1570力肯","110/07/20","凱基-台北",2,0,2
"298","1570力肯","110/07/20","康和-澎湖",0,3,-3
"299","1570力肯","110/07/20","華南永昌-高雄",2,0,2
"300","1570力肯","110/07/20","摩根大通",0,2,-2
"301","6180橘子","110/07/20","摩根大通",89,31,58
"302","6180橘子","110/07/20","群益金鼎-中山",0,80,-80
"303","6180橘子","110/07/20","美商高盛",27,0,27
"304","6180橘子","110/07/20","台中銀-台北",0,30,-30
"305","6180橘子","110/07/20","新加坡商瑞銀",28,1,27
"306","6180橘子","110/07/20","日盛-新莊",1,22,-21
"307","6180橘子","110/07/20","新光",41,16,25
"308","6180橘子","110/07/20","元富-緯城",2,20,-18
"309","6180橘子","110/07/20","日盛-文化",21,0,21
"310","6180橘子","110/07/20","日盛-新竹",2,15,-13
"311","6180橘子","110/07/20","元富-潮州",20,0,20
"312","6180橘子","110/07/20","元大-汐止",0,12,-12
"313","6180橘子","110/07/20","凱基-台北",31,11,20
"314","6180橘子","110/07/20","元大-豐原站前",0,12,-12
"315","6180橘子","110/07/20","元大-草屯",18,0,18
"316","6180橘子","110/07/20","德信-中正",0,10,-10
"317","6180橘子","110/07/20","花旗環球",13,0,13
"318","6180橘子","110/07/20","新光-台南",0,10,-10
"319","6180橘子","110/07/20","元大-桃園",12,0,12
"320","6180橘子","110/07/20","玉山-雙和",0,10,-10
"321","6180橘子","110/07/20","群益金鼎",10,0,10
"322","6180橘子","110/07/20","元大-四維",0,10,-10
"323","6180橘子","110/07/20","元大-高雄",10,0,10
"324","6180橘子","110/07/20","元大-永春",2,12,-10
"325","6180橘子","110/07/20","群益金鼎-嘉義",9,0,9
"326","6180橘子","110/07/20","凱基-高美館",0,8,-8
"327","6180橘子","110/07/20","富邦-嘉義",9,0,9
"328","6180橘子","110/07/20","華南永昌",2,10,-8
"329","6180橘子","110/07/20","元富-草屯",10,2,8
"330","6180橘子","110/07/20","富邦-台北",0,8,-8
"331","2390云辰","110/07/20","元大證券",6043,11,6032
"332","2390云辰","110/07/20","華南永昌-鳳山",2,312,-310
"333","2390云辰","110/07/20","兆豐-復興",998,0,998
"334","2390云辰","110/07/20","台灣摩根士丹利",0,247,-247
"335","2390云辰","110/07/20","富邦-嘉義",775,7,768
"336","2390云辰","110/07/20","元大-復北",4,239,-235
"337","2390云辰","110/07/20","統一-台中",350,6,344
"338","2390云辰","110/07/20","富邦-建國",25,236,-211
"339","2390云辰","110/07/20","兆豐-城中",240,0,240
"340","2390云辰","110/07/20","元富-中港",0,202,-202
"341","2390云辰","110/07/20","群益金鼎-館前",204,2,202
"342","2390云辰","110/07/20","國泰-敦南",20,194,-174
"343","2390云辰","110/07/20","凱基-大直",187,0,187
"344","2390云辰","110/07/20","元大-土城學府",10,156,-146
"345","2390云辰","110/07/20","永豐金證券",160,10,150
"346","2390云辰","110/07/20","中國信託-松江",0,130,-130
"347","2390云辰","110/07/20","日盛-高雄",104,2,102
"348","2390云辰","110/07/20","凱基-基隆",0,130,-130
"349","2390云辰","110/07/20","凱基-中山",100,3,97
"350","2390云辰","110/07/20","永豐金-中正",1,117,-116
"351","2390云辰","110/07/20","元大-基隆",85,7,78
"352","2390云辰","110/07/20","富邦-陽明",1,94,-93
"353","2390云辰","110/07/20","群益金鼎-東大",64,2,62
"354","2390云辰","110/07/20","元大-潮州",20,112,-92
"355","2390云辰","110/07/20","元大-前金",60,1,59
"356","2390云辰","110/07/20","宏遠證券",0,89,-89
"357","2390云辰","110/07/20","國票-北高雄",63,14,49
"358","2390云辰","110/07/20","兆豐-台中",0,75,-75
"359","2390云辰","110/07/20","群益金鼎-三重",40,6,34
"360","2390云辰","110/07/20","新光",8,82,-74
"361","2363矽統","110/07/19","第一金-忠孝",210,0,210
"362","2363矽統","110/07/19","富邦-仁愛",32,575,-543
"363","2363矽統","110/07/19","中國信託-文心",191,9,182
"364","2363矽統","110/07/19","新加坡商瑞銀",53,486,-433
"365","2363矽統","110/07/19","華南永昌-鳳山",116,1,115
"366","2363矽統","110/07/19","摩根大通",42,320,-278
"367","2363矽統","110/07/19","元大-新竹",113,12,101
"368","2363矽統","110/07/19","元大-竹科",3,201,-198
"369","2363矽統","110/07/19","凱基-中山",89,1,88
"370","2363矽統","110/07/19","元大-成功",7,183,-176
"371","2363矽統","110/07/19","永豐金-嘉義",82,7,75
"372","2363矽統","110/07/19","凱基-大里",0,150,-150
"373","2363矽統","110/07/19","凱基-台南",72,4,68
"374","2363矽統","110/07/19","瑞士信貸",80,215,-135
"375","2363矽統","110/07/19","元富-城東",84,17,67
"376","2363矽統","110/07/19","日盛-新莊",4,135,-131
"377","2363矽統","110/07/19","群益金鼎-東湖",61,0,61
"378","2363矽統","110/07/19","宏遠-桃園",20,150,-130
"379","2363矽統","110/07/19","兆豐-中壢",55,0,55
"380","2363矽統","110/07/19","凱基-三重",7,107,-100
"381","2363矽統","110/07/19","康和-內湖",55,1,54
"382","2363矽統","110/07/19","凱基-台北",384,476,-92
"383","2363矽統","110/07/19","群益金鼎-桃園",55,2,53
"384","2363矽統","110/07/19","合庫-台中",3,84,-81
"385","2363矽統","110/07/19","群益金鼎-大興",50,0,50
"386","2363矽統","110/07/19","致和-金華",1,80,-79
"387","2363矽統","110/07/19","台新-台中",81,32,49
"388","2363矽統","110/07/19","凱基-員林",5,77,-72
"389","2363矽統","110/07/19","北城證券",58,10,48
"390","2363矽統","110/07/19","華南永昌-合泰",2,70,-68
"391","8112至上","110/07/19","摩根大通",1413,144,1269
"392","8112至上","110/07/19","凱基-三重",3,600,-597
"393","8112至上","110/07/19","凱基-台北",1053,266,787
"394","8112至上","110/07/19","元大-府城",0,165,-165
"395","8112至上","110/07/19","新加坡商瑞銀",523,2,521
"396","8112至上","110/07/19","台灣企銀-台中",0,150,-150
"397","8112至上","110/07/19","台灣摩根士丹利",487,8,479
"398","8112至上","110/07/19","(牛牛牛)亞-鑫豐",26,119,-93
"399","8112至上","110/07/19","美林",529,93,436
"400","8112至上","110/07/19","永豐金-台南",15,95,-80
"401","8112至上","110/07/19","港商野村",358,36,322
"402","8112至上","110/07/19","亞東-板橋",2,81,-79
"403","8112至上","110/07/19","美商高盛",276,3,273
"404","8112至上","110/07/19","陽信",0,70,-70
"405","8112至上","110/07/19","兆豐-公益",180,7,173
"406","8112至上","110/07/19","元富-佳里",0,69,-69
"407","8112至上","110/07/19","國泰-板橋",116,15,101
"408","8112至上","110/07/19","臺銀-鳳山",7,72,-65
"409","8112至上","110/07/19","凱基-新莊",100,1,99
"410","8112至上","110/07/19","兆豐-竹北",4,65,-61
"411","8112至上","110/07/19","凱基-市政",89,0,89
"412","8112至上","110/07/19","國泰-新莊",2,62,-60
"413","8112至上","110/07/19","玉山證券",73,7,66
"414","8112至上","110/07/19","元富-大裕",2,60,-58
"415","8112至上","110/07/19","花旗環球",64,0,64
"416","8112至上","110/07/19","臺灣企銀-桃園",0,55,-55
"417","8112至上","110/07/19","合庫-台中",55,3,52
"418","8112至上","110/07/19","康和-台南",4,59,-55
"419","8112至上","110/07/19","永豐金-中壢",50,1,49
"420","8112至上","110/07/19","第一金-華江",3,55,-52
"421","1570力肯","110/07/19","國票-北高雄",34,0,34
"422","1570力肯","110/07/19","合庫-三重",0,8,-8
"423","1570力肯","110/07/19","新光",30,3,27
"424","1570力肯","110/07/19","元大-高雄",0,8,-8
"425","1570力肯","110/07/19","凱基-台北",24,1,23
"426","1570力肯","110/07/19","合庫-台中",0,7,-7
"427","1570力肯","110/07/19","台灣摩根士丹利",7,0,7
"428","1570力肯","110/07/19","臺銀-臺中",0,6,-6
"429","1570力肯","110/07/19","元大-林森",5,0,5
"430","1570力肯","110/07/19","摩根大通",6,11,-5
"431","1570力肯","110/07/19","元大-士林",4,0,4
"432","1570力肯","110/07/19","元富-緯城",0,4,-4
"433","1570力肯","110/07/19","玉山證券",8,5,3
"434","1570力肯","110/07/19","玉山-台大",0,4,-4
"435","1570力肯","110/07/19","統一-城中",2,0,2
"436","1570力肯","110/07/19","群益金鼎-三重",0,4,-4
"437","1570力肯","110/07/19","元大-基隆孝二",2,0,2
"438","1570力肯","110/07/19","凱基-鳳山",1,5,-4
"439","1570力肯","110/07/19","土銀-建國",1,0,1
"440","1570力肯","110/07/19","元大-板橋",0,4,-4
"441","1570力肯","110/07/19","日盛-復興",1,0,1
"442","1570力肯","110/07/19","日盛-和美",0,3,-3
"443","1570力肯","110/07/19","瑞士信貸",1,0,1
"444","1570力肯","110/07/19","元富-新店",2,5,-3
"445","1570力肯","110/07/19","元富-四維",1,0,1
"446","1570力肯","110/07/19","元大-新莊",0,3,-3
"447","1570力肯","110/07/19","群益金鼎-北高雄",1,0,1
"448","1570力肯","110/07/19","永豐金-敦南",0,3,-3
"449","1570力肯","110/07/19","凱基-高美館",1,0,1
"450","1570力肯","110/07/19","永豐金-台中",0,3,-3
"451","2929淘帝","110/07/19","元大-民生",28,0,28
"452","2929淘帝","110/07/19","元大-六合",0,40,-40
"453","2929淘帝","110/07/19","宏遠-光隆",25,0,25
"454","2929淘帝","110/07/19","新光-新竹",0,35,-35
"455","2929淘帝","110/07/19","華南永昌-苗栗",20,0,20
"456","2929淘帝","110/07/19","新加坡商瑞銀",1,30,-29
"457","2929淘帝","110/07/19","元大-員林",20,0,20
"458","2929淘帝","110/07/19","永豐金-永康",0,27,-27
"459","2929淘帝","110/07/19","合庫-高雄",18,0,18
"460","2929淘帝","110/07/19","凱基-復興",0,24,-24
"461","2929淘帝","110/07/19","臺銀-鳳山",18,0,18
"462","2929淘帝","110/07/19","日盛-豐原",0,22,-22
"463","2929淘帝","110/07/19","日盛-雙和",17,0,17
"464","2929淘帝","110/07/19","富邦-南屯",1,22,-21
"465","2929淘帝","110/07/19","華南永昌-林口",15,0,15
"466","2929淘帝","110/07/19","新光",1,21,-20
"467","2929淘帝","110/07/19","元大-屏南",15,0,15
"468","2929淘帝","110/07/19","華南永昌",0,20,-20
"469","2929淘帝","110/07/19","台新-中壢",12,0,12
"470","2929淘帝","110/07/19","富邦-竹東",2,22,-20
"471","2929淘帝","110/07/19","新光-台中",11,0,11
"472","2929淘帝","110/07/19","凱基-士林",0,16,-16
"473","2929淘帝","110/07/19","凱基-台北",20,9,11
"474","2929淘帝","110/07/19","福勝",0,15,-15
"475","2929淘帝","110/07/19","富邦-台北",11,0,11
"476","2929淘帝","110/07/19","港商野村",25,37,-12
"477","2929淘帝","110/07/19","合庫-自強",10,0,10
"478","2929淘帝","110/07/19","群益金鼎-建成",0,11,-11
"479","2929淘帝","110/07/19","凱基-豐中",10,0,10
"480","2929淘帝","110/07/19","華南永昌-朴子",0,11,-11
"481","5410國眾","110/07/19","香港上海匯豐",28,0,28
"482","5410國眾","110/07/19","群益金鼎-內湖",0,80,-80
"483","5410國眾","110/07/19","大昌",26,0,26
"484","5410國眾","110/07/19","永豐金-屏東",0,14,-14
"485","5410國眾","110/07/19","兆豐-公益",20,0,20
"486","5410國眾","110/07/19","永豐金-南京",0,10,-10
"487","5410國眾","110/07/19","合庫-嘉義",10,0,10
"488","5410國眾","110/07/19","元大-內湖",0,9,-9
"489","5410國眾","110/07/19","台新-左楠",20,10,10
"490","5410國眾","110/07/19","富邦-永和",0,8,-8
"491","5410國眾","110/07/19","摩根大通",15,6,9
"492","5410國眾","110/07/19","日盛-景美",0,6,-6
"493","5410國眾","110/07/19","台灣企銀-民雄",8,0,8
"494","5410國眾","110/07/19","光和",1,7,-6
"495","5410國眾","110/07/19","元大-竹科",8,0,8
"496","5410國眾","110/07/19","元大-士林",0,6,-6
"497","5410國眾","110/07/19","凱基-台北",9,3,6
"498","5410國眾","110/07/19","新光-台中",0,5,-5
"499","5410國眾","110/07/19","元大-博愛",6,0,6
"500","5410國眾","110/07/19","元大-景美",0,5,-5
"501","5410國眾","110/07/19","台新-三民",5,0,5
"502","5410國眾","110/07/19","大慶-蘆洲",0,4,-4
"503","5410國眾","110/07/19","群益金鼎-中壢",5,0,5
"504","5410國眾","110/07/19","中國信託-新竹",0,4,-4
"505","5410國眾","110/07/19","群益金鼎-嘉義",5,0,5
"506","5410國眾","110/07/19","新光",6,10,-4
"507","5410國眾","110/07/19","日盛證券",4,0,4
"508","5410國眾","110/07/19","元大-基隆孝二",0,4,-4
"509","5410國眾","110/07/19","群益金鼎-新店",4,0,4
"510","5410國眾","110/07/19","土銀-台中",0,3,-3
"511","2841台開","110/07/19","元富-城東",150,0,150
"512","2841台開","110/07/19","日進",0,80,-80
"513","2841台開","110/07/19","中國信託-忠孝",80,0,80
"514","2841台開","110/07/19","港商野村",0,77,-77
"515","2841台開","110/07/19","凱基-台北",52,0,52
"516","2841台開","110/07/19","摩根大通",0,41,-41
"517","2841台開","110/07/19","美商高盛",48,0,48
"518","2841台開","110/07/19","元大-三重",1,38,-37
"519","2841台開","110/07/19","台中銀",43,0,43
"520","2841台開","110/07/19","元大-福營",0,30,-30
"521","2841台開","110/07/19","永豐金-豐原",32,0,32
"522","2841台開","110/07/19","新光",4,28,-24
"523","2841台開","110/07/19","豐農",20,0,20
"524","2841台開","110/07/19","元大-竹科",0,22,-22
"525","2841台開","110/07/19","台新-台中",30,10,20
"526","2841台開","110/07/19","永豐金-敦南",33,55,-22
"527","2841台開","110/07/19","華南永昌-新莊",20,0,20
"528","2841台開","110/07/19","日盛-二林",0,15,-15
"529","2841台開","110/07/19","第一金-台中",12,0,12
"530","2841台開","110/07/19","元富-虎尾",0,15,-15
"531","2841台開","110/07/19","國泰-台中",12,0,12
"532","2841台開","110/07/19","華南永昌-世貿",0,15,-15
"533","2841台開","110/07/19","日茂",10,0,10
"534","2841台開","110/07/19","統一-三多",0,12,-12
"535","2841台開","110/07/19","凱基-埔墘",10,0,10
"536","2841台開","110/07/19","台中銀-豐原",0,10,-10
"537","2841台開","110/07/19","永豐金-內湖",8,0,8
"538","2841台開","110/07/19","元大-頭份",0,10,-10
"539","2841台開","110/07/19","合庫-台中",7,0,7
"540","2841台開","110/07/19","合庫-台南",0,8,-8
"541","6207雷科","110/07/19","元富-信義",92,0,92
"542","6207雷科","110/07/19","新加坡商瑞銀",5,104,-99
"543","6207雷科","110/07/19","國泰證券",90,0,90
"544","6207雷科","110/07/19","富邦-彰化",2,97,-95
"545","6207雷科","110/07/19","元富-城中",80,4,76
"546","6207雷科","110/07/19","永豐金-內湖",6,85,-79
"547","6207雷科","110/07/19","元大-福營",71,5,66
"548","6207雷科","110/07/19","摩根大通",102,164,-62
"549","6207雷科","110/07/19","凱基-復興",60,0,60
"550","6207雷科","110/07/19","瑞士信貸",0,51,-51
"551","6207雷科","110/07/19","凱基-台北",91,46,45
"552","6207雷科","110/07/19","凱基-板橋",10,55,-45
"553","6207雷科","110/07/19","玉山-城中",42,0,42
"554","6207雷科","110/07/19","華南永昌-大安",0,40,-40
"555","6207雷科","110/07/19","華南永昌-長虹",40,0,40
"556","6207雷科","110/07/19","群益金鼎-東大",1,40,-39
"557","6207雷科","110/07/19","永豐金-羅東",38,0,38
"558","6207雷科","110/07/19","台新-高雄",15,47,-32
"559","6207雷科","110/07/19","日盛-忠孝",36,2,34
"560","6207雷科","110/07/19","玉山-嘉義",1,32,-31
"561","6207雷科","110/07/19","凱基-羅東",37,3,34
"562","6207雷科","110/07/19","凱基-中港",0,30,-30
"563","6207雷科","110/07/19","第一金-新竹",30,0,30
"564","6207雷科","110/07/19","元大-六合",7,36,-29
"565","6207雷科","110/07/19","玉山-數位",27,1,26
"566","6207雷科","110/07/19","元富-花蓮",0,28,-28
"567","6207雷科","110/07/19","凱基-長庚",22,0,22
"568","6207雷科","110/07/19","群益金鼎-瑞豐",6,34,-28
"569","6207雷科","110/07/19","台灣企銀-北高雄",20,0,20
"570","6207雷科","110/07/19","新百王",0,26,-26
"571","3679新至陞","110/07/19","元大-成功",7,0,7
"572","3679新至陞","110/07/19","群益金鼎-大安",0,15,-15
"573","3679新至陞","110/07/19","美商高盛",6,0,6
"574","3679新至陞","110/07/19","凱基-民權",0,10,-10
"575","3679新至陞","110/07/19","台新-高雄",5,0,5
"576","3679新至陞","110/07/19","元大-西門",0,10,-10
"577","3679新至陞","110/07/19","凱基-松山",5,0,5
"578","3679新至陞","110/07/19","瑞士信貸",0,6,-6
"579","3679新至陞","110/07/19","日盛-員林",4,0,4
"580","3679新至陞","110/07/19","兆豐-高雄",0,6,-6
"581","3679新至陞","110/07/19","台中銀-員林",4,0,4
"582","3679新至陞","110/07/19","群益金鼎",0,5,-5
"583","3679新至陞","110/07/19","(牛牛牛)亞-網路",3,0,3
"584","3679新至陞","110/07/19","元大-永春",0,4,-4
"585","3679新至陞","110/07/19","大昌-新店",3,0,3
"586","3679新至陞","110/07/19","凱基-台北",2,5,-3
"587","3679新至陞","110/07/19","凱基-埔墘",3,0,3
"588","3679新至陞","110/07/19","港商法國興業",0,2,-2
"589","3679新至陞","110/07/19","元大-板橋",3,0,3
"590","3679新至陞","110/07/19","摩根大通",2,4,-2
"591","3679新至陞","110/07/19","臺銀-金山",2,0,2
"592","3679新至陞","110/07/19","元大-金門",0,2,-2
"593","3679新至陞","110/07/19","日盛-樹林",2,0,2
"594","3679新至陞","110/07/19","元大-土城",0,2,-2
"595","3679新至陞","110/07/19","致和-東門",2,0,2
"596","3679新至陞","110/07/19","日盛-鳳山",0,1,-1
"597","3679新至陞","110/07/19","國票-敦北法人",2,0,2
"598","3679新至陞","110/07/19","美林",1,2,-1
"599","3679新至陞","110/07/19","台新證券",2,0,2
"600","3679新至陞","110/07/19","第一金",0,1,-1
"601","2727王品","110/07/19","台新證券",374,33,341
"602","2727王品","110/07/19","台灣摩根士丹利",25,188,-163
"603","2727王品","110/07/19","瑞士信貸",217,1,216
"604","2727王品","110/07/19","港商野村",74,198,-124
"605","2727王品","110/07/19","兆豐-南京",200,0,200
"606","2727王品","110/07/19","統一",6,80,-74
"607","2727王品","110/07/19","第一金",70,1,69
"608","2727王品","110/07/19","合庫-台中",8,79,-71
"609","2727王品","110/07/19","元大-小港",59,1,58
"610","2727王品","110/07/19","凱基-台北",178,231,-53
"611","2727王品","110/07/19","玉山-桃園",42,6,36
"612","2727王品","110/07/19","富邦-中壢",3,52,-49
"613","2727王品","110/07/19","永豐金-大園",31,0,31
"614","2727王品","110/07/19","凱基-永華",0,43,-43
"615","2727王品","110/07/19","兆豐-大安",30,0,30
"616","2727王品","110/07/19","土銀-台中",0,36,-36
"617","2727王品","110/07/19","美商高盛",38,15,23
"618","2727王品","110/07/19","美林",8,41,-33
"619","2727王品","110/07/19","康和-澎湖",23,1,22
"620","2727王品","110/07/19","中國信託-忠孝",1,33,-32
"621","2727王品","110/07/19","第一金-高雄",21,0,21
"622","2727王品","110/07/19","新光",31,61,-30
"623","2727王品","110/07/19","國票-內壢",21,0,21
"624","2727王品","110/07/19","第一金-豐原",0,26,-26
"625","2727王品","110/07/19","元大-桃興",19,3,16
"626","2727王品","110/07/19","富邦-彰化",0,26,-26
"627","2727王品","110/07/19","凱基-三重",16,1,15
"628","2727王品","110/07/19","摩根大通",78,97,-19
"629","2727王品","110/07/19","永豐金-南投",16,1,15
"630","2727王品","110/07/19","國泰證券",2,21,-19
"631","1570力肯","110/07/19","國票-北高雄",34,0,34
"632","1570力肯","110/07/19","合庫-三重",0,8,-8
"633","1570力肯","110/07/19","新光",30,3,27
"634","1570力肯","110/07/19","元大-高雄",0,8,-8
"635","1570力肯","110/07/19","凱基-台北",24,1,23
"636","1570力肯","110/07/19","合庫-台中",0,7,-7
"637","1570力肯","110/07/19","台灣摩根士丹利",7,0,7
"638","1570力肯","110/07/19","臺銀-臺中",0,6,-6
"639","1570力肯","110/07/19","元大-林森",5,0,5
"640","1570力肯","110/07/19","摩根大通",6,11,-5
"641","1570力肯","110/07/19","元大-士林",4,0,4
"642","1570力肯","110/07/19","元富-緯城",0,4,-4
"643","1570力肯","110/07/19","玉山證券",8,5,3
"644","1570力肯","110/07/19","玉山-台大",0,4,-4
"645","1570力肯","110/07/19","統一-城中",2,0,2
"646","1570力肯","110/07/19","群益金鼎-三重",0,4,-4
"647","1570力肯","110/07/19","元大-基隆孝二",2,0,2
"648","1570力肯","110/07/19","凱基-鳳山",1,5,-4
"649","1570力肯","110/07/19","土銀-建國",1,0,1
"650","1570力肯","110/07/19","元大-板橋",0,4,-4
"651","1570力肯","110/07/19","日盛-復興",1,0,1
"652","1570力肯","110/07/19","日盛-和美",0,3,-3
"653","1570力肯","110/07/19","瑞士信貸",1,0,1
"654","1570力肯","110/07/19","元富-新店",2,5,-3
"655","1570力肯","110/07/19","元富-四維",1,0,1
"656","1570力肯","110/07/19","元大-新莊",0,3,-3
"657","1570力肯","110/07/19","群益金鼎-北高雄",1,0,1
"658","1570力肯","110/07/19","永豐金-敦南",0,3,-3
"659","1570力肯","110/07/19","凱基-高美館",1,0,1
"660","1570力肯","110/07/19","永豐金-台中",0,3,-3
"661","6180橘子","110/07/19","兆豐證券",55,0,55
"662","6180橘子","110/07/19","石橋證券",0,80,-80
"663","6180橘子","110/07/19","凱基-台北",89,35,54
"664","6180橘子","110/07/19","永豐金-大園",2,50,-48
"665","6180橘子","110/07/19","合庫-自強",36,0,36
"666","6180橘子","110/07/19","群益金鼎-屏東",0,40,-40
"667","6180橘子","110/07/19","新光",50,25,25
"668","6180橘子","110/07/19","國泰-敦南",0,19,-19
"669","6180橘子","110/07/19","日盛-龍潭",20,0,20
"670","6180橘子","110/07/19","日盛-新竹",2,20,-18
"671","6180橘子","110/07/19","元大-斗信",16,1,15
"672","6180橘子","110/07/19","摩根大通",17,35,-18
"673","6180橘子","110/07/19","康和-台中",12,0,12
"674","6180橘子","110/07/19","富邦-陽明",0,17,-17
"675","6180橘子","110/07/19","國泰-台中",14,2,12
"676","6180橘子","110/07/19","美商高盛",11,27,-16
"677","6180橘子","110/07/19","富邦-嘉義",12,0,12
"678","6180橘子","110/07/19","統一-宜蘭",0,14,-14
"679","6180橘子","110/07/19","元大-草屯",12,0,12
"680","6180橘子","110/07/19","凱基-興隆",0,12,-12
"681","6180橘子","110/07/19","元富-桃園",11,0,11
"682","6180橘子","110/07/19","台中銀-豐原",1,11,-10
"683","6180橘子","110/07/19","兆豐-城中",10,0,10
"684","6180橘子","110/07/19","永豐金-豐原",0,10,-10
"685","6180橘子","110/07/19","元大-旗山",10,0,10
"686","6180橘子","110/07/19","永豐金-竹科",0,10,-10
"687","6180橘子","110/07/19","元大-大安",10,0,10
"688","6180橘子","110/07/19","臺銀-鳳山",1,10,-9
"689","6180橘子","110/07/19","大昌-新店",9,0,9
"690","6180橘子","110/07/19","群益金鼎-台南",0,9,-9
"691","2390云辰","110/07/19","摩根大通",1135,266,869
"692","2390云辰","110/07/19","元富-成功",15,119,-104
"693","2390云辰","110/07/19","台灣摩根士丹利",232,40,192
"694","2390云辰","110/07/19","元富-中港",5,101,-96
"695","2390云辰","110/07/19","凱基-台北",669,504,165
"696","2390云辰","110/07/19","元富-嘉義",5,85,-80
"697","2390云辰","110/07/19","美林",290,159,131
"698","2390云辰","110/07/19","美商高盛",11,62,-51
"699","2390云辰","110/07/19","統一",111,8,103
"700","2390云辰","110/07/19","群益金鼎-西松",4,54,-50
"701","2390云辰","110/07/19","元富-埔里",102,0,102
"702","2390云辰","110/07/19","聯邦商銀",0,48,-48
"703","2390云辰","110/07/19","華南永昌-台中",126,26,100
"704","2390云辰","110/07/19","元大-萬華",15,57,-42
"705","2390云辰","110/07/19","永豐金-豐原",100,32,68
"706","2390云辰","110/07/19","群益金鼎-高雄",2,42,-40
"707","2390云辰","110/07/19","台新-台南",87,25,62
"708","2390云辰","110/07/19","國泰-敦南",117,154,-37
"709","2390云辰","110/07/19","台新-左楠",67,11,56
"710","2390云辰","110/07/19","中國信託-文心",5,40,-35
"711","2390云辰","110/07/19","國泰-忠孝",52,0,52
"712","2390云辰","110/07/19","凱基-城中",16,51,-35
"713","2390云辰","110/07/19","台新證券",105,54,51
"714","2390云辰","110/07/19","瑞士信貸",0,31,-31
"715","2390云辰","110/07/19","華南永昌-頭份",53,3,50
"716","2390云辰","110/07/19","中國信託-永康",1,32,-31
"717","2390云辰","110/07/19","新光-台南",44,0,44
"718","2390云辰","110/07/19","統一-彰化",2,32,-30
"719","2390云辰","110/07/19","合庫-西台中",50,8,42
"720","2390云辰","110/07/19","元大-館前",7,37,-30
"721","2363矽統","110/07/16","國票-長城",461,21,440
"722","2363矽統","110/07/16","新加坡商瑞銀",155,482,-327
"723","2363矽統","110/07/16","凱基-豐中",201,3,198
"724","2363矽統","110/07/16","港商野村",253,546,-293
"725","2363矽統","110/07/16","凱基-土城",132,9,123
"726","2363矽統","110/07/16","摩根大通",116,401,-285
"727","2363矽統","110/07/16","台新證券",199,78,121
"728","2363矽統","110/07/16","瑞士信貸",291,533,-242
"729","2363矽統","110/07/16","日盛-中和",74,0,74
"730","2363矽統","110/07/16","日盛-竹北",19,248,-229
"731","2363矽統","110/07/16","日盛-員林",66,3,63
"732","2363矽統","110/07/16","臺銀-金山",4,211,-207
"733","2363矽統","110/07/16","國票-中和",60,3,57
"734","2363矽統","110/07/16","元大-大統",13,138,-125
"735","2363矽統","110/07/16","新光",240,184,56
"736","2363矽統","110/07/16","永豐金證券",11,125,-114
"737","2363矽統","110/07/16","富邦-竹東",65,9,56
"738","2363矽統","110/07/16","兆豐-民生",2,101,-99
"739","2363矽統","110/07/16","華南永昌-鳳山",56,1,55
"740","2363矽統","110/07/16","群益金鼎-松山",2,100,-98
"741","2363矽統","110/07/16","凱基-台北",520,466,54
"742","2363矽統","110/07/16","元大-花蓮",8,99,-91
"743","2363矽統","110/07/16","元富-城東",63,12,51
"744","2363矽統","110/07/16","華南永昌-虎尾",68,154,-86
"745","2363矽統","110/07/16","群益金鼎-桃園",56,5,51
"746","2363矽統","110/07/16","富邦-新竹華信",7,89,-82
"747","2363矽統","110/07/16","北城證券",60,10,50
"748","2363矽統","110/07/16","元大-佳里",3,81,-78
"749","2363矽統","110/07/16","國票-九鼎",57,7,50
"750","2363矽統","110/07/16","玉山-南京東路",0,73,-73
"751","8112至上","110/07/16","宏遠證券",551,6,545
"752","8112至上","110/07/16","玉山-桃園",42,318,-276
"753","8112至上","110/07/16","台灣摩根士丹利",317,11,306
"754","8112至上","110/07/16","美林",64,305,-241
"755","8112至上","110/07/16","新加坡商瑞銀",378,73,305
"756","8112至上","110/07/16","宏遠-館前",16,212,-196
"757","8112至上","110/07/16","凱基-台北",758,553,205
"758","8112至上","110/07/16","玉山-嘉義",19,95,-76
"759","8112至上","110/07/16","富邦證券",127,0,127
"760","8112至上","110/07/16","群益金鼎-三民",7,82,-75
"761","8112至上","110/07/16","台新證券",129,30,99
"762","8112至上","110/07/16","日盛-二林",1,73,-72
"763","8112至上","110/07/16","花旗環球",97,0,97
"764","8112至上","110/07/16","玉山-台大",8,76,-68
"765","8112至上","110/07/16","永豐金-台南",97,8,89
"766","8112至上","110/07/16","元富-台南",1,68,-67
"767","8112至上","110/07/16","元大-大天母",93,15,78
"768","8112至上","110/07/16","玉山-板橋",4,71,-67
"769","8112至上","110/07/16","亞東-板橋",72,2,70
"770","8112至上","110/07/16","臺灣企銀-埔墘",0,60,-60
"771","8112至上","110/07/16","永豐金-中正",64,9,55
"772","8112至上","110/07/16","華南永昌-鶯歌",11,64,-53
"773","8112至上","110/07/16","大昌-樹林",53,2,51
"774","8112至上","110/07/16","元大-士林",7,59,-52
"775","8112至上","110/07/16","凱基-永和",56,5,51
"776","8112至上","110/07/16","元富-新店",8,57,-49
"777","8112至上","110/07/16","兆豐-竹北",53,3,50
"778","8112至上","110/07/16","富邦-陽明",9,58,-49
"779","8112至上","110/07/16","日盛-豐原",48,0,48
"780","8112至上","110/07/16","元大-發財",0,49,-49
"781","1570力肯","110/07/16","新光",71,6,65
"782","1570力肯","110/07/16","元大-高雄",0,23,-23
"783","1570力肯","110/07/16","國票-北高雄",21,0,21
"784","1570力肯","110/07/16","合庫-台南",0,20,-20
"785","1570力肯","110/07/16","凱基-台北",17,1,16
"786","1570力肯","110/07/16","元富-新店",0,15,-15
"787","1570力肯","110/07/16","群益金鼎-高雄",15,0,15
"788","1570力肯","110/07/16","元大-東港",0,10,-10
"789","1570力肯","110/07/16","富邦-建國",10,0,10
"790","1570力肯","110/07/16","中國信託",0,7,-7
"791","1570力肯","110/07/16","元大-士林",5,0,5
"792","1570力肯","110/07/16","台新證券",0,6,-6
"793","1570力肯","110/07/16","瑞士信貸",3,0,3
"794","1570力肯","110/07/16","日盛-信義",0,5,-5
"795","1570力肯","110/07/16","臺銀-高雄",2,0,2
"796","1570力肯","110/07/16","宏遠-館前",0,5,-5
"797","1570力肯","110/07/16","華南永昌",2,0,2
"798","1570力肯","110/07/16","國泰-館前",0,5,-5
"799","1570力肯","110/07/16","元富-同大",1,0,1
"800","1570力肯","110/07/16","富邦-園區",0,5,-5
"801","1570力肯","110/07/16","兆豐-麻豆",1,0,1
"802","1570力肯","110/07/16","永豐金-中正",0,5,-5
"803","1570力肯","110/07/16","國泰-板橋",1,0,1
"804","1570力肯","110/07/16","(牛牛牛)亞-鑫豐",0,4,-4
"805","1570力肯","110/07/16","群益金鼎-東湖",1,0,1
"806","1570力肯","110/07/16","台中銀-員林",0,3,-3
"807","1570力肯","110/07/16","元大-東泰",1,0,1
"808","1570力肯","110/07/16","玉山-新莊",0,3,-3
"809","1570力肯","110/07/16","元大-南勢角",1,0,1
"810","1570力肯","110/07/16","凱基-長庚",0,3,-3
"811","2929淘帝","110/07/16","元大-民生",28,0,28
"812","2929淘帝","110/07/16","玉山-新竹",0,30,-30
"813","2929淘帝","110/07/16","元大-員林",20,0,20
"814","2929淘帝","110/07/16","合庫證券",0,20,-20
"815","2929淘帝","110/07/16","兆豐-桃鶯",12,0,12
"816","2929淘帝","110/07/16","元大-六合",0,20,-20
"817","2929淘帝","110/07/16","元大-大統",10,0,10
"818","2929淘帝","110/07/16","摩根大通",0,12,-12
"819","2929淘帝","110/07/16","新加坡商瑞銀",9,0,9
"820","2929淘帝","110/07/16","永興",0,6,-6
"821","2929淘帝","110/07/16","凱基-基隆",6,0,6
"822","2929淘帝","110/07/16","凱基-長庚",0,5,-5
"823","2929淘帝","110/07/16","合庫-高雄",5,0,5
"824","2929淘帝","110/07/16","群益金鼎-潭子",0,4,-4
"825","2929淘帝","110/07/16","台新-台中",6,1,5
"826","2929淘帝","110/07/16","華南永昌-小港",2,6,-4
"827","2929淘帝","110/07/16","元大-承德",5,0,5
"828","2929淘帝","110/07/16","華南永昌-虎尾",0,4,-4
"829","2929淘帝","110/07/16","元大-沙鹿",5,0,5
"830","2929淘帝","110/07/16","日盛-和美",0,3,-3
"831","2929淘帝","110/07/16","大慶-苗栗",5,1,4
"832","2929淘帝","110/07/16","彰銀",0,3,-3
"833","2929淘帝","110/07/16","台新-新營",4,0,4
"834","2929淘帝","110/07/16","港商野村",7,10,-3
"835","2929淘帝","110/07/16","凱基-台北",6,2,4
"836","2929淘帝","110/07/16","群益金鼎-中山",1,4,-3
"837","2929淘帝","110/07/16","兆豐-台中港",3,0,3
"838","2929淘帝","110/07/16","凱基-嘉義",0,3,-3
"839","2929淘帝","110/07/16","國票-北高雄",3,0,3
"840","2929淘帝","110/07/16","元大-斗信",0,3,-3
"841","5410國眾","110/07/16","盈溢-籬子內",49,0,49
"842","5410國眾","110/07/16","元大-博愛",0,41,-41
"843","5410國眾","110/07/16","香港上海匯豐",31,0,31
"844","5410國眾","110/07/16","元富-嘉義",0,20,-20
"845","5410國眾","110/07/16","元大-東泰",30,0,30
"846","5410國眾","110/07/16","國泰-桃園",0,18,-18
"847","5410國眾","110/07/16","兆豐-台中港",20,0,20
"848","5410國眾","110/07/16","元富",0,17,-17
"849","5410國眾","110/07/16","臺銀-臺南",11,0,11
"850","5410國眾","110/07/16","元大-新竹",0,14,-14
"851","5410國眾","110/07/16","富邦-新竹華信",11,0,11
"852","5410國眾","110/07/16","安泰-大發",0,11,-11
"853","5410國眾","110/07/16","臺銀",10,0,10
"854","5410國眾","110/07/16","大昌-樹林",0,10,-10
"855","5410國眾","110/07/16","凱基-台北",8,1,7
"856","5410國眾","110/07/16","群益金鼎-內湖",0,10,-10
"857","5410國眾","110/07/16","日盛-士林",5,0,5
"858","5410國眾","110/07/16","元大-樹林",0,10,-10
"859","5410國眾","110/07/16","新光-桃園",5,0,5
"860","5410國眾","110/07/16","元大-內湖",0,9,-9
"861","5410國眾","110/07/16","國泰-台南",5,0,5
"862","5410國眾","110/07/16","群益金鼎-永和",0,5,-5
"863","5410國眾","110/07/16","群益金鼎-嘉義",5,0,5
"864","5410國眾","110/07/16","凱基-屏東",0,5,-5
"865","5410國眾","110/07/16","元大-屏南",5,0,5
"866","5410國眾","110/07/16","統一-員林",0,4,-4
"867","5410國眾","110/07/16","日盛-員林",3,0,3
"868","5410國眾","110/07/16","國泰-松江",0,4,-4
"869","5410國眾","110/07/16","瑞士信貸",3,0,3
"870","5410國眾","110/07/16","凱基-台南",0,4,-4
"871","2841台開","110/07/16","日盛證券",250,0,250
"872","2841台開","110/07/16","元大-歸仁",0,590,-590
"873","2841台開","110/07/16","凱基-文心",204,0,204
"874","2841台開","110/07/16","摩根大通",0,245,-245
"875","2841台開","110/07/16","國泰-館前",114,0,114
"876","2841台開","110/07/16","日盛-信義",0,145,-145
"877","2841台開","110/07/16","永豐金-豐原",75,0,75
"878","2841台開","110/07/16","港商野村",0,103,-103
"879","2841台開","110/07/16","台新-台中",76,10,66
"880","2841台開","110/07/16","玉山-嘉義",5,54,-49
"881","2841台開","110/07/16","中國信託-文心",51,5,46
"882","2841台開","110/07/16","台新證券",22,63,-41
"883","2841台開","110/07/16","華南永昌-新莊",41,10,31
"884","2841台開","110/07/16","美商高盛",0,39,-39
"885","2841台開","110/07/16","富邦-嘉義",30,0,30
"886","2841台開","110/07/16","亞東-板橋",0,30,-30
"887","2841台開","110/07/16","新光",26,0,26
"888","2841台開","110/07/16","永豐金-北高雄",0,30,-30
"889","2841台開","110/07/16","富邦-板橋",25,0,25
"890","2841台開","110/07/16","日盛-忠孝",0,20,-20
"891","2841台開","110/07/16","新光-台中",22,0,22
"892","2841台開","110/07/16","元富-草屯",0,15,-15
"893","2841台開","110/07/16","元大-承德",22,0,22
"894","2841台開","110/07/16","永豐金-板新",0,12,-12
"895","2841台開","110/07/16","日盛-三重",20,0,20
"896","2841台開","110/07/16","第一金-華江",0,10,-10
"897","2841台開","110/07/16","日盛-新莊",20,0,20
"898","2841台開","110/07/16","兆豐-南京",0,10,-10
"899","2841台開","110/07/16","凱基-台南",20,0,20
"900","2841台開","110/07/16","國票-中港",0,10,-10
"901","6207雷科","110/07/16","統一-平鎮",215,4,211
"902","6207雷科","110/07/16","凱基-台北",344,628,-284
"903","6207雷科","110/07/16","凱基-復興",166,6,160
"904","6207雷科","110/07/16","新加坡商瑞銀",104,370,-266
"905","6207雷科","110/07/16","永豐金-南京",141,3,138
"906","6207雷科","110/07/16","摩根大通",193,430,-237
"907","6207雷科","110/07/16","永豐金-內湖",117,1,116
"908","6207雷科","110/07/16","富邦證券",0,150,-150
"909","6207雷科","110/07/16","日盛證券",104,2,102
"910","6207雷科","110/07/16","華南永昌-中正",26,169,-143
"911","6207雷科","110/07/16","群益金鼎-古亭",74,2,72
"912","6207雷科","110/07/16","凱基-敦北",1,142,-141
"913","6207雷科","110/07/16","群益金鼎-東門",76,12,64
"914","6207雷科","110/07/16","凱基-板橋",0,120,-120
"915","6207雷科","110/07/16","日盛-板橋",78,25,53
"916","6207雷科","110/07/16","元富-大昌",30,136,-106
"917","6207雷科","110/07/16","元大-斗六",57,6,51
"918","6207雷科","110/07/16","元大-北成功",26,97,-71
"919","6207雷科","110/07/16","元大-頭份",53,3,50
"920","6207雷科","110/07/16","新光-桃園",29,93,-64
"921","6207雷科","110/07/16","群益金鼎-東大",56,11,45
"922","6207雷科","110/07/16","新百王",27,90,-63
"923","6207雷科","110/07/16","永豐金-虎尾",50,8,42
"924","6207雷科","110/07/16","玉山-左營",16,72,-56
"925","6207雷科","110/07/16","元大-西門",39,1,38
"926","6207雷科","110/07/16","群益金鼎-中壢",3,54,-51
"927","6207雷科","110/07/16","凱基-竹科",38,1,37
"928","6207雷科","110/07/16","元富-中原",21,67,-46
"929","6207雷科","110/07/16","元富-世貿",50,15,35
"930","6207雷科","110/07/16","大昌-桃園",26,70,-44
"931","3679新至陞","110/07/16","元大-成功",17,1,16
"932","3679新至陞","110/07/16","國票-桃園",0,11,-11
"933","3679新至陞","110/07/16","玉山-台大",5,0,5
"934","3679新至陞","110/07/16","富邦-台北",0,10,-10
"935","3679新至陞","110/07/16","日盛-員林",4,0,4
"936","3679新至陞","110/07/16","富邦-苗栗",0,10,-10
"937","3679新至陞","110/07/16","凱基-台北",6,2,4
"938","3679新至陞","110/07/16","元大-永春",0,6,-6
"939","3679新至陞","110/07/16","台灣摩根士丹利",3,0,3
"940","3679新至陞","110/07/16","美林",0,5,-5
"941","3679新至陞","110/07/16","凱基-中山",3,0,3
"942","3679新至陞","110/07/16","瑞士信貸",3,7,-4
"943","3679新至陞","110/07/16","元大-承德",3,0,3
"944","3679新至陞","110/07/16","宏遠-館前",0,3,-3
"945","3679新至陞","110/07/16","元大-汐止",4,1,3
"946","3679新至陞","110/07/16","元大-東港",0,3,-3
"947","3679新至陞","110/07/16","日盛-大墩",2,0,2
"948","3679新至陞","110/07/16","元大證券",0,2,-2
"949","3679新至陞","110/07/16","玉山-城中",2,0,2
"950","3679新至陞","110/07/16","永豐金-板新",0,2,-2
"951","3679新至陞","110/07/16","華南永昌-內壢",2,0,2
"952","3679新至陞","110/07/16","臺銀-民權",0,1,-1
"953","3679新至陞","110/07/16","元大-台南",2,0,2
"954","3679新至陞","110/07/16","日盛-台中",0,1,-1
"955","3679新至陞","110/07/16","元大-大同",2,0,2
"956","3679新至陞","110/07/16","日盛-鳳山",0,1,-1
"957","3679新至陞","110/07/16","臺銀-高雄",1,0,1
"958","3679新至陞","110/07/16","元富-古亭",0,1,-1
"959","3679新至陞","110/07/16","日盛-樹林",1,0,1
"960","3679新至陞","110/07/16","元富-新興",0,1,-1
"961","2727王品","110/07/16","富邦證券",570,0,570
"962","2727王品","110/07/16","台新證券",27,77,-50
"963","2727王品","110/07/16","兆豐-南京",200,0,200
"964","2727王品","110/07/16","台灣摩根士丹利",4,47,-43
"965","2727王品","110/07/16","瑞士信貸",133,2,131
"966","2727王品","110/07/16","永豐金-大園",0,33,-33
"967","2727王品","110/07/16","美林",121,26,95
"968","2727王品","110/07/16","元大-北屯",0,32,-32
"969","2727王品","110/07/16","統一",103,43,60
"970","2727王品","110/07/16","富邦-南屯",1,30,-29
"971","2727王品","110/07/16","中國信託-忠孝",36,2,34
"972","2727王品","110/07/16","元大-基隆孝二",0,29,-29
"973","2727王品","110/07/16","元大證券",68,45,23
"974","2727王品","110/07/16","日盛-忠孝",4,30,-26
"975","2727王品","110/07/16","合庫-彰化",22,1,21
"976","2727王品","110/07/16","新光-新竹",1,21,-20
"977","2727王品","110/07/16","港商野村",126,105,21
"978","2727王品","110/07/16","凱基-台北",94,113,-19
"979","2727王品","110/07/16","元富-板橋",22,1,21
"980","2727王品","110/07/16","富邦-虎尾",1,19,-18
"981","2727王品","110/07/16","新加坡商瑞銀",36,18,18
"982","2727王品","110/07/16","元大-南京",0,17,-17
"983","2727王品","110/07/16","國泰證券",20,5,15
"984","2727王品","110/07/16","日盛-鳳山",2,18,-16
"985","2727王品","110/07/16","日盛-桃園",13,1,12
"986","2727王品","110/07/16","新光",34,50,-16
"987","2727王品","110/07/16","凱基-市政",12,1,11
"988","2727王品","110/07/16","富邦-台北",2,18,-16
"989","2727王品","110/07/16","元大-嘉義",14,3,11
"990","2727王品","110/07/16","國票-內壢",1,15,-14
"991","1570力肯","110/07/16","新光",71,6,65
"992","1570力肯","110/07/16","元大-高雄",0,23,-23
"993","1570力肯","110/07/16","國票-北高雄",21,0,21
"994","1570力肯","110/07/16","合庫-台南",0,20,-20
"995","1570力肯","110/07/16","凱基-台北",17,1,16
"996","1570力肯","110/07/16","元富-新店",0,15,-15
"997","1570力肯","110/07/16","群益金鼎-高雄",15,0,15
"998","1570力肯","110/07/16","元大-東港",0,10,-10
"999","1570力肯","110/07/16","富邦-建國",10,0,10
"1000","1570力肯","110/07/16","中國信託",0,7,-7
"1001","1570力肯","110/07/16","元大-士林",5,0,5
"1002","1570力肯","110/07/16","台新證券",0,6,-6
"1003","1570力肯","110/07/16","瑞士信貸",3,0,3
"1004","1570力肯","110/07/16","日盛-信義",0,5,-5
"1005","1570力肯","110/07/16","臺銀-高雄",2,0,2
"1006","1570力肯","110/07/16","宏遠-館前",0,5,-5
"1007","1570力肯","110/07/16","華南永昌",2,0,2
"1008","1570力肯","110/07/16","國泰-館前",0,5,-5
"1009","1570力肯","110/07/16","元富-同大",1,0,1
"1010","1570力肯","110/07/16","富邦-園區",0,5,-5
"1011","1570力肯","110/07/16","兆豐-麻豆",1,0,1
"1012","1570力肯","110/07/16","永豐金-中正",0,5,-5
"1013","1570力肯","110/07/16","國泰-板橋",1,0,1
"1014","1570力肯","110/07/16","(牛牛牛)亞-鑫豐",0,4,-4
"1015","1570力肯","110/07/16","群益金鼎-東湖",1,0,1
"1016","1570力肯","110/07/16","台中銀-員林",0,3,-3
"1017","1570力肯","110/07/16","元大-東泰",1,0,1
"1018","1570力肯","110/07/16","玉山-新莊",0,3,-3
"1019","1570力肯","110/07/16","元大-南勢角",1,0,1
"1020","1570力肯","110/07/16","凱基-長庚",0,3,-3
"1021","6180橘子","110/07/16","日盛-文化",71,5,66
"1022","6180橘子","110/07/16","凱基-台北",110,238,-128
"1023","6180橘子","110/07/16","新加坡商瑞銀",75,19,56
"1024","6180橘子","110/07/16","摩根大通",77,161,-84
"1025","6180橘子","110/07/16","瑞士信貸",51,0,51
"1026","6180橘子","110/07/16","元富-高雄",0,62,-62
"1027","6180橘子","110/07/16","台灣企銀-屏東",50,0,50
"1028","6180橘子","110/07/16","美商高盛",0,40,-40
"1029","6180橘子","110/07/16","元大-桃園",52,2,50
"1030","6180橘子","110/07/16","合庫-自強",0,37,-37
"1031","6180橘子","110/07/16","康和-台北",51,10,41
"1032","6180橘子","110/07/16","美林",15,48,-33
"1033","6180橘子","110/07/16","群益金鼎-屏東",61,20,41
"1034","6180橘子","110/07/16","元富-四維",0,32,-32
"1035","6180橘子","110/07/16","元大-彰化",33,2,31
"1036","6180橘子","110/07/16","新光",63,92,-29
"1037","6180橘子","110/07/16","台中銀-台北",30,0,30
"1038","6180橘子","110/07/16","新光-台南",6,28,-22
"1039","6180橘子","110/07/16","福勝",29,3,26
"1040","6180橘子","110/07/16","港商野村",28,49,-21
"1041","6180橘子","110/07/16","兆豐證券",21,0,21
"1042","6180橘子","110/07/16","統一",2,23,-21
"1043","6180橘子","110/07/16","華南永昌-頭份",20,0,20
"1044","6180橘子","110/07/16","元大-豐原站前",3,21,-18
"1045","6180橘子","110/07/16","富邦-台北",25,5,20
"1046","6180橘子","110/07/16","豐農",3,20,-17
"1047","6180橘子","110/07/16","富邦-員林",23,4,19
"1048","6180橘子","110/07/16","安泰-大發",0,17,-17
"1049","6180橘子","110/07/16","台新-新莊",20,2,18
"1050","6180橘子","110/07/16","群益金鼎",2,19,-17
"1051","2390云辰","110/07/16","兆豐-天母",642,7,635
"1052","2390云辰","110/07/16","凱基",0,5007,-5007
"1053","2390云辰","110/07/16","華南永昌-鳳山",339,35,304
"1054","2390云辰","110/07/16","凱基-台北",1224,2306,-1082
"1055","2390云辰","110/07/16","第一金-大稻埕",269,13,256
"1056","2390云辰","110/07/16","元大證券",206,1177,-971
"1057","2390云辰","110/07/16","國泰-敦南",665,427,238
"1058","2390云辰","110/07/16","摩根大通",1073,1967,-894
"1059","2390云辰","110/07/16","富邦-建國",272,50,222
"1060","2390云辰","110/07/16","台灣摩根士丹利",232,671,-439
"1061","2390云辰","110/07/16","元大-信義",180,15,165
"1062","2390云辰","110/07/16","美林",187,496,-309
"1063","2390云辰","110/07/16","瑞士信貸",155,0,155
"1064","2390云辰","110/07/16","港商野村",680,950,-270
"1065","2390云辰","110/07/16","台新證券",461,317,144
"1066","2390云辰","110/07/16","永豐金-中正",18,170,-152
"1067","2390云辰","110/07/16","兆豐-公益",148,11,137
"1068","2390云辰","110/07/16","元富-板橋",30,169,-139
"1069","2390云辰","110/07/16","元大-土城學府",197,61,136
"1070","2390云辰","110/07/16","新加坡商瑞銀",61,175,-114
"1071","2390云辰","110/07/16","元大-天母",232,122,110
"1072","2390云辰","110/07/16","聯邦商銀",54,167,-113
"1073","2390云辰","110/07/16","凱基-基隆",109,2,107
"1074","2390云辰","110/07/16","群益金鼎-大甲",13,111,-98
"1075","2390云辰","110/07/16","元富-成功",110,5,105
"1076","2390云辰","110/07/16","統一-屏東",4,92,-88
"1077","2390云辰","110/07/16","統一-新營",118,14,104
"1078","2390云辰","110/07/16","凱基-大直",3,80,-77
"1079","2390云辰","110/07/16","國泰-板橋",268,170,98
"1080","2390云辰","110/07/16","元大-桃興",46,117,-71
"1081","2363矽統","110/07/15","康和-台中",626,61,565
"1082","2363矽統","110/07/15","新加坡商瑞銀",202,838,-636
"1083","2363矽統","110/07/15","摩根大通",1271,932,339
"1084","2363矽統","110/07/15","美林",185,720,-535
"1085","2363矽統","110/07/15","瑞士信貸",530,230,300
"1086","2363矽統","110/07/15","富邦-仁愛",60,583,-523
"1087","2363矽統","110/07/15","宏遠-桃園",281,0,281
"1088","2363矽統","110/07/15","元大-板橋",35,368,-333
"1089","2363矽統","110/07/15","大展",252,19,233
"1090","2363矽統","110/07/15","花旗環球",0,308,-308
"1091","2363矽統","110/07/15","凱基-台北",683,498,185
"1092","2363矽統","110/07/15","元富-成功",2,113,-111
"1093","2363矽統","110/07/15","永豐金證券",166,11,155
"1094","2363矽統","110/07/15","富邦-新營",23,132,-109
"1095","2363矽統","110/07/15","群益金鼎",157,5,152
"1096","2363矽統","110/07/15","臺銀-金山",197,304,-107
"1097","2363矽統","110/07/15","新光",333,229,104
"1098","2363矽統","110/07/15","日盛-二林",13,116,-103
"1099","2363矽統","110/07/15","永豐金-台南",130,26,104
"1100","2363矽統","110/07/15","台新-左楠",40,126,-86
"1101","2363矽統","110/07/15","國票-南京",100,0,100
"1102","2363矽統","110/07/15","康和-南崁",15,100,-85
"1103","2363矽統","110/07/15","群益金鼎-松山",150,50,100
"1104","2363矽統","110/07/15","永豐金-員林",9,91,-82
"1105","2363矽統","110/07/15","中國信託-松江",103,5,98
"1106","2363矽統","110/07/15","光和-嘉義",5,78,-73
"1107","2363矽統","110/07/15","國票-新莊",187,92,95
"1108","2363矽統","110/07/15","日盛-板橋中山",3,73,-70
"1109","2363矽統","110/07/15","北城證券",216,126,90
"1110","2363矽統","110/07/15","元大證券",10,75,-65
"1111","8112至上","110/07/15","凱基-台北",535,32,503
"1112","8112至上","110/07/15","群益金鼎-台南",0,116,-116
"1113","8112至上","110/07/15","摩根大通",362,16,346
"1114","8112至上","110/07/15","華南永昌-高雄",2,112,-110
"1115","8112至上","110/07/15","台灣摩根士丹利",254,0,254
"1116","8112至上","110/07/15","永豐金-台南",27,128,-101
"1117","8112至上","110/07/15","花旗環球",159,0,159
"1118","8112至上","110/07/15","元大-東蘆",2,73,-71
"1119","8112至上","110/07/15","新加坡商瑞銀",95,2,93
"1120","8112至上","110/07/15","美林",3,66,-63
"1121","8112至上","110/07/15","玉山-嘉義",84,0,84
"1122","8112至上","110/07/15","元大-館前",0,62,-62
"1123","8112至上","110/07/15","新光",82,6,76
"1124","8112至上","110/07/15","元富-信義",0,50,-50
"1125","8112至上","110/07/15","瑞士信貸",80,7,73
"1126","8112至上","110/07/15","台新證券",35,82,-47
"1127","8112至上","110/07/15","美商高盛",64,0,64
"1128","8112至上","110/07/15","大慶-蘆洲",7,53,-46
"1129","8112至上","110/07/15","兆豐-小港",56,0,56
"1130","8112至上","110/07/15","國票-天祥",0,45,-45
"1131","8112至上","110/07/15","永豐金-內湖",60,11,49
"1132","8112至上","110/07/15","凱基-中山",1,45,-44
"1133","8112至上","110/07/15","永豐金-南投",46,1,45
"1134","8112至上","110/07/15","元大-士林",0,43,-43
"1135","8112至上","110/07/15","凱基-三重",40,0,40
"1136","8112至上","110/07/15","玉山-城中",4,44,-40
"1137","8112至上","110/07/15","台灣企銀",29,0,29
"1138","8112至上","110/07/15","凱基-彰化",0,39,-39
"1139","8112至上","110/07/15","元大-府城",42,14,28
"1140","8112至上","110/07/15","元富-花蓮",2,40,-38
"1141","1570力肯","110/07/15","群益金鼎-高雄",40,0,40
"1142","1570力肯","110/07/15","元大-高雄",0,12,-12
"1143","1570力肯","110/07/15","新光",40,8,32
"1144","1570力肯","110/07/15","永豐金-中正",0,10,-10
"1145","1570力肯","110/07/15","凱基-台北",20,2,18
"1146","1570力肯","110/07/15","國泰-松江",0,9,-9
"1147","1570力肯","110/07/15","凱基-天母",6,0,6
"1148","1570力肯","110/07/15","台新證券",0,8,-8
"1149","1570力肯","110/07/15","元富-新店",5,0,5
"1150","1570力肯","110/07/15","玉山證券",0,7,-7
"1151","1570力肯","110/07/15","凱基-中港",5,0,5
"1152","1570力肯","110/07/15","元大-府城",0,7,-7
"1153","1570力肯","110/07/15","富邦-園區",5,0,5
"1154","1570力肯","110/07/15","元大-板橋",0,6,-6
"1155","1570力肯","110/07/15","瑞士信貸",4,0,4
"1156","1570力肯","110/07/15","日盛-信義",0,5,-5
"1157","1570力肯","110/07/15","第一金-路竹",3,0,3
"1158","1570力肯","110/07/15","國票-和平",0,5,-5
"1159","1570力肯","110/07/15","摩根大通",3,0,3
"1160","1570力肯","110/07/15","元大-民雄",0,5,-5
"1161","1570力肯","110/07/15","凱基-桃園",3,0,3
"1162","1570力肯","110/07/15","統一-台中",0,4,-4
"1163","1570力肯","110/07/15","永豐金-苓雅",3,0,3
"1164","1570力肯","110/07/15","玉山-雙和",0,4,-4
"1165","1570力肯","110/07/15","統一-員林",2,0,2
"1166","1570力肯","110/07/15","凱基-敦北",0,4,-4
"1167","1570力肯","110/07/15","元大-永春",2,0,2
"1168","1570力肯","110/07/15","富邦-新店",0,4,-4
"1169","1570力肯","110/07/15","元大-土城永寧",2,0,2
"1170","1570力肯","110/07/15","日盛-板橋",0,3,-3
"1171","2929淘帝","110/07/15","港商野村",58,4,54
"1172","2929淘帝","110/07/15","日盛-園區",0,25,-25
"1173","2929淘帝","110/07/15","元大-民生",29,0,29
"1174","2929淘帝","110/07/15","兆豐-南京",0,20,-20
"1175","2929淘帝","110/07/15","新加坡商瑞銀",22,1,21
"1176","2929淘帝","110/07/15","玉山-高雄",0,18,-18
"1177","2929淘帝","110/07/15","凱基-台北",20,2,18
"1178","2929淘帝","110/07/15","富邦-南屯",1,15,-14
"1179","2929淘帝","110/07/15","大慶-中壢",15,1,14
"1180","2929淘帝","110/07/15","富邦-員林",0,13,-13
"1181","2929淘帝","110/07/15","日盛-和美",10,0,10
"1182","2929淘帝","110/07/15","凱基-站前",0,10,-10
"1183","2929淘帝","110/07/15","元大-員林",10,0,10
"1184","2929淘帝","110/07/15","元大-台中",0,10,-10
"1185","2929淘帝","110/07/15","凱基-基隆",6,0,6
"1186","2929淘帝","110/07/15","美林",10,19,-9
"1187","2929淘帝","110/07/15","臺銀-鳳山",5,0,5
"1188","2929淘帝","110/07/15","元大-新盛",0,8,-8
"1189","2929淘帝","110/07/15","第一金-路竹",5,0,5
"1190","2929淘帝","110/07/15","台新-台南",0,7,-7
"1191","2929淘帝","110/07/15","元富-大裕",5,0,5
"1192","2929淘帝","110/07/15","元大-大天母",0,7,-7
"1193","2929淘帝","110/07/15","玉山-大里",5,0,5
"1194","2929淘帝","110/07/15","華南永昌-虎尾",0,6,-6
"1195","2929淘帝","110/07/15","元大-博愛",5,0,5
"1196","2929淘帝","110/07/15","永豐金證券",0,6,-6
"1197","2929淘帝","110/07/15","永豐金-新莊",5,0,5
"1198","2929淘帝","110/07/15","兆豐-竹北",0,5,-5
"1199","2929淘帝","110/07/15","元大-南崁",4,0,4
"1200","2929淘帝","110/07/15","元大-文心興安",0,5,-5
"1201","5410國眾","110/07/15","香港上海匯豐",18,0,18
"1202","5410國眾","110/07/15","元大-南屯",0,18,-18
"1203","5410國眾","110/07/15","摩根大通",15,0,15
"1204","5410國眾","110/07/15","亞東-新竹",0,15,-15
"1205","5410國眾","110/07/15","日盛-士林",10,0,10
"1206","5410國眾","110/07/15","兆豐-台中港",0,15,-15
"1207","5410國眾","110/07/15","群益金鼎-嘉義",10,0,10
"1208","5410國眾","110/07/15","日盛-板橋",0,12,-12
"1209","5410國眾","110/07/15","元大-高雄",10,0,10
"1210","5410國眾","110/07/15","台中銀-豐原",0,9,-9
"1211","5410國眾","110/07/15","元大-東港",10,0,10
"1212","5410國眾","110/07/15","臺銀-臺南",3,10,-7
"1213","5410國眾","110/07/15","臺銀",10,5,5
"1214","5410國眾","110/07/15","瑞士信貸",0,5,-5
"1215","5410國眾","110/07/15","台新-新營",5,0,5
"1216","5410國眾","110/07/15","統一-員林",0,5,-5
"1217","5410國眾","110/07/15","富邦-台北",5,0,5
"1218","5410國眾","110/07/15","大昌-樹林",0,5,-5
"1219","5410國眾","110/07/15","日盛-屏東",4,0,4
"1220","5410國眾","110/07/15","兆豐-來福",0,5,-5
"1221","5410國眾","110/07/15","高橋",5,1,4
"1222","5410國眾","110/07/15","豐農",0,5,-5
"1223","5410國眾","110/07/15","中國信託-新竹",4,1,3
"1224","5410國眾","110/07/15","元大-大里",0,5,-5
"1225","5410國眾","110/07/15","富邦-建國",3,0,3
"1226","5410國眾","110/07/15","港商野村",0,3,-3
"1227","5410國眾","110/07/15","永豐金-桃園",3,0,3
"1228","5410國眾","110/07/15","中農",0,3,-3
"1229","5410國眾","110/07/15","大展",2,0,2
"1230","5410國眾","110/07/15","國泰-忠孝",0,3,-3
"1231","2841台開","110/07/15","日盛證券",310,0,310
"1232","2841台開","110/07/15","港商野村",0,97,-97
"1233","2841台開","110/07/15","元富-城東",100,0,100
"1234","2841台開","110/07/15","元大-員林",0,77,-77
"1235","2841台開","110/07/15","凱基-文心",30,0,30
"1236","2841台開","110/07/15","新光",3,73,-70
"1237","2841台開","110/07/15","日盛-雙和",24,0,24
"1238","2841台開","110/07/15","永豐金-北高雄",0,30,-30
"1239","2841台開","110/07/15","第一金-台中",20,0,20
"1240","2841台開","110/07/15","華南永昌",0,25,-25
"1241","2841台開","110/07/15","豐農",20,0,20
"1242","2841台開","110/07/15","日盛-台南",0,20,-20
"1243","2841台開","110/07/15","華南永昌-新莊",19,0,19
"1244","2841台開","110/07/15","致和-佳里",0,20,-20
"1245","2841台開","110/07/15","玉山-大里",12,0,12
"1246","2841台開","110/07/15","國票-中港",0,20,-20
"1247","2841台開","110/07/15","元富-安南",10,0,10
"1248","2841台開","110/07/15","元大-歸仁",0,20,-20
"1249","2841台開","110/07/15","凱基-市政",10,0,10
"1250","2841台開","110/07/15","統一-三多",0,19,-19
"1251","2841台開","110/07/15","凱基-竹科",10,0,10
"1252","2841台開","110/07/15","凱基-城中",0,18,-18
"1253","2841台開","110/07/15","國泰-板橋",10,1,9
"1254","2841台開","110/07/15","國票-中和",0,15,-15
"1255","2841台開","110/07/15","凱基-台北",9,0,9
"1256","2841台開","110/07/15","元大-彰化",0,15,-15
"1257","2841台開","110/07/15","合庫證券",6,0,6
"1258","2841台開","110/07/15","元大-復北",0,15,-15
"1259","2841台開","110/07/15","台中銀",6,0,6
"1260","2841台開","110/07/15","土銀-花蓮",0,14,-14
"1261","6207雷科","110/07/15","凱基-板橋",210,45,165
"1262","6207雷科","110/07/15","群益金鼎-台北",20,80,-60
"1263","6207雷科","110/07/15","富邦證券",150,0,150
"1264","6207雷科","110/07/15","元大-大天母",1,56,-55
"1265","6207雷科","110/07/15","凱基-復興",140,0,140
"1266","6207雷科","110/07/15","大慶-中壢",2,50,-48
"1267","6207雷科","110/07/15","華南永昌-中正",140,0,140
"1268","6207雷科","110/07/15","元富-林園",0,47,-47
"1269","6207雷科","110/07/15","永豐金-內湖",92,10,82
"1270","6207雷科","110/07/15","元大-東門",0,40,-40
"1271","6207雷科","110/07/15","富邦-彰化",81,11,70
"1272","6207雷科","110/07/15","第一金-安和",0,37,-37
"1273","6207雷科","110/07/15","(牛牛牛)亞-網路",67,0,67
"1274","6207雷科","110/07/15","凱基-台北",61,97,-36
"1275","6207雷科","110/07/15","台新證券",60,8,52
"1276","6207雷科","110/07/15","國票-南科",0,32,-32
"1277","6207雷科","110/07/15","華南永昌",50,3,47
"1278","6207雷科","110/07/15","元大-四維",0,32,-32
"1279","6207雷科","110/07/15","新加坡商瑞銀",68,26,42
"1280","6207雷科","110/07/15","元大-板橋",0,30,-30
"1281","6207雷科","110/07/15","日盛-景美",40,0,40
"1282","6207雷科","110/07/15","元大-南崁",1,30,-29
"1283","6207雷科","110/07/15","元富-大昌",40,0,40
"1284","6207雷科","110/07/15","凱基-岡山",0,27,-27
"1285","6207雷科","110/07/15","統一-高雄",38,5,33
"1286","6207雷科","110/07/15","統一-新竹",0,26,-26
"1287","6207雷科","110/07/15","日盛證券",32,0,32
"1288","6207雷科","110/07/15","群益金鼎-三民",1,27,-26
"1289","6207雷科","110/07/15","華南永昌-頭份",31,0,31
"1290","6207雷科","110/07/15","國票-台中",0,25,-25
"1291","3679新至陞","110/07/15","群益金鼎-大安",25,0,25
"1292","3679新至陞","110/07/15","元大-成功",0,10,-10
"1293","3679新至陞","110/07/15","元大-彰化",13,0,13
"1294","3679新至陞","110/07/15","群益金鼎-東大",0,8,-8
"1295","3679新至陞","110/07/15","國票-桃園",10,0,10
"1296","3679新至陞","110/07/15","凱基-台北",4,12,-8
"1297","3679新至陞","110/07/15","群益金鼎-台南",10,0,10
"1298","3679新至陞","110/07/15","第一金-華江",0,5,-5
"1299","3679新至陞","110/07/15","華南永昌-台中",10,0,10
"1300","3679新至陞","110/07/15","兆豐-來福",0,5,-5
"1301","3679新至陞","110/07/15","港商野村",9,0,9
"1302","3679新至陞","110/07/15","元大-北三重",0,5,-5
"1303","3679新至陞","110/07/15","元大-永春",6,0,6
"1304","3679新至陞","110/07/15","瑞士信貸",0,4,-4
"1305","3679新至陞","110/07/15","(牛牛牛)亞-網路",5,0,5
"1306","3679新至陞","110/07/15","新加坡商瑞銀",0,4,-4
"1307","3679新至陞","110/07/15","凱基-高雄",5,0,5
"1308","3679新至陞","110/07/15","元大-汐止",0,4,-4
"1309","3679新至陞","110/07/15","美商高盛",6,2,4
"1310","3679新至陞","110/07/15","台中銀-員林",0,3,-3
"1311","3679新至陞","110/07/15","台新證券",3,1,2
"1312","3679新至陞","110/07/15","兆豐-忠孝",0,3,-3
"1313","3679新至陞","110/07/15","群益金鼎-大興",2,0,2
"1314","3679新至陞","110/07/15","玉山-新莊",0,3,-3
"1315","3679新至陞","110/07/15","元大-六合",2,0,2
"1316","3679新至陞","110/07/15","永豐金-屏東",0,3,-3
"1317","3679新至陞","110/07/15","彰銀",1,0,1
"1318","3679新至陞","110/07/15","永豐金-敦南",0,3,-3
"1319","3679新至陞","110/07/15","美林",2,1,1
"1320","3679新至陞","110/07/15","永豐金-萬盛",0,3,-3
"1321","2727王品","110/07/15","兆豐-南京",101,0,101
"1322","2727王品","110/07/15","富邦-左營",0,102,-102
"1323","2727王品","110/07/15","港商野村",166,73,93
"1324","2727王品","110/07/15","日盛-忠孝",2,32,-30
"1325","2727王品","110/07/15","瑞士信貸",97,8,89
"1326","2727王品","110/07/15","群益金鼎-古亭",2,24,-22
"1327","2727王品","110/07/15","玉山證券",56,12,44
"1328","2727王品","110/07/15","日盛-八德",0,21,-21
"1329","2727王品","110/07/15","第一金-高雄",43,1,42
"1330","2727王品","110/07/15","元大-新盛",2,23,-21
"1331","2727王品","110/07/15","台新證券",74,45,29
"1332","2727王品","110/07/15","摩根大通",53,72,-19
"1333","2727王品","110/07/15","康和-澎湖",27,0,27
"1334","2727王品","110/07/15","富邦-彰化",8,26,-18
"1335","2727王品","110/07/15","富邦-陽明",31,4,27
"1336","2727王品","110/07/15","富邦-台中",7,24,-17
"1337","2727王品","110/07/15","國票-北高雄",27,1,26
"1338","2727王品","110/07/15","新加坡商瑞銀",13,29,-16
"1339","2727王品","110/07/15","國泰-板橋",38,12,26
"1340","2727王品","110/07/15","國泰-敦南",35,50,-15
"1341","2727王品","110/07/15","凱基-興隆",23,0,23
"1342","2727王品","110/07/15","元大-龍潭",0,14,-14
"1343","2727王品","110/07/15","凱基-板橋",29,7,22
"1344","2727王品","110/07/15","中國信託-文心",8,21,-13
"1345","2727王品","110/07/15","合庫-彰化",21,0,21
"1346","2727王品","110/07/15","永豐金-竹科",2,15,-13
"1347","2727王品","110/07/15","土銀-南港",20,0,20
"1348","2727王品","110/07/15","臺銀-臺南",2,14,-12
"1349","2727王品","110/07/15","美林",37,18,19
"1350","2727王品","110/07/15","凱基-台北",56,68,-12
"1351","1570力肯","110/07/15","群益金鼎-高雄",40,0,40
"1352","1570力肯","110/07/15","元大-高雄",0,12,-12
"1353","1570力肯","110/07/15","新光",40,8,32
"1354","1570力肯","110/07/15","永豐金-中正",0,10,-10
"1355","1570力肯","110/07/15","凱基-台北",20,2,18
"1356","1570力肯","110/07/15","國泰-松江",0,9,-9
"1357","1570力肯","110/07/15","凱基-天母",6,0,6
"1358","1570力肯","110/07/15","台新證券",0,8,-8
"1359","1570力肯","110/07/15","元富-新店",5,0,5
"1360","1570力肯","110/07/15","玉山證券",0,7,-7
"1361","1570力肯","110/07/15","凱基-中港",5,0,5
"1362","1570力肯","110/07/15","元大-府城",0,7,-7
"1363","1570力肯","110/07/15","富邦-園區",5,0,5
"1364","1570力肯","110/07/15","元大-板橋",0,6,-6
"1365","1570力肯","110/07/15","瑞士信貸",4,0,4
"1366","1570力肯","110/07/15","日盛-信義",0,5,-5
"1367","1570力肯","110/07/15","第一金-路竹",3,0,3
"1368","1570力肯","110/07/15","國票-和平",0,5,-5
"1369","1570力肯","110/07/15","摩根大通",3,0,3
"1370","1570力肯","110/07/15","元大-民雄",0,5,-5
"1371","1570力肯","110/07/15","凱基-桃園",3,0,3
"1372","1570力肯","110/07/15","統一-台中",0,4,-4
"1373","1570力肯","110/07/15","永豐金-苓雅",3,0,3
"1374","1570力肯","110/07/15","玉山-雙和",0,4,-4
"1375","1570力肯","110/07/15","統一-員林",2,0,2
"1376","1570力肯","110/07/15","凱基-敦北",0,4,-4
"1377","1570力肯","110/07/15","元大-永春",2,0,2
"1378","1570力肯","110/07/15","富邦-新店",0,4,-4
"1379","1570力肯","110/07/15","元大-土城永寧",2,0,2
"1380","1570力肯","110/07/15","日盛-板橋",0,3,-3
"1381","6180橘子","110/07/15","兆豐證券",130,0,130
"1382","6180橘子","110/07/15","港商野村",21,137,-116
"1383","6180橘子","110/07/15","摩根大通",111,0,111
"1384","6180橘子","110/07/15","高橋",0,40,-40
"1385","6180橘子","110/07/15","石橋證券",80,0,80
"1386","6180橘子","110/07/15","臺銀",1,40,-39
"1387","6180橘子","110/07/15","凱基-台北",78,26,52
"1388","6180橘子","110/07/15","玉山-桃園",0,35,-35
"1389","6180橘子","110/07/15","新加坡商瑞銀",38,1,37
"1390","6180橘子","110/07/15","玉山-台南",2,33,-31
"1391","6180橘子","110/07/15","富邦-員林",32,0,32
"1392","6180橘子","110/07/15","統一-南京",0,30,-30
"1393","6180橘子","110/07/15","日盛-文化",23,0,23
"1394","6180橘子","110/07/15","康和-台南",0,25,-25
"1395","6180橘子","110/07/15","元富-新店",20,0,20
"1396","6180橘子","110/07/15","大昌-樹林",0,22,-22
"1397","6180橘子","110/07/15","美林",15,0,15
"1398","6180橘子","110/07/15","康和-新竹",0,20,-20
"1399","6180橘子","110/07/15","新光-新竹",17,2,15
"1400","6180橘子","110/07/15","群益金鼎-台中",0,20,-20
"1401","6180橘子","110/07/15","富邦-嘉義",12,0,12
"1402","6180橘子","110/07/15","元大-彰化民生",0,18,-18
"1403","6180橘子","110/07/15","花旗環球",11,0,11
"1404","6180橘子","110/07/15","元大-草屯",0,16,-16
"1405","6180橘子","110/07/15","第一金-新興",11,0,11
"1406","6180橘子","110/07/15","元富-潮州",0,13,-13
"1407","6180橘子","110/07/15","第一金-桃園",10,0,10
"1408","6180橘子","110/07/15","宏遠-台南",0,11,-11
"1409","6180橘子","110/07/15","永興",10,0,10
"1410","6180橘子","110/07/15","大慶-泰山",0,10,-10
"1411","2390云辰","110/07/15","凱基",5007,0,5007
"1412","2390云辰","110/07/15","凱基-台北",382,616,-234
"1413","2390云辰","110/07/15","元大證券",1006,25,981
"1414","2390云辰","110/07/15","富邦-陽明",69,265,-196
"1415","2390云辰","110/07/15","元大-天母",456,20,436
"1416","2390云辰","110/07/15","永豐金-桃園",63,255,-192
"1417","2390云辰","110/07/15","港商野村",975,675,300
"1418","2390云辰","110/07/15","富邦-仁愛",17,187,-170
"1419","2390云辰","110/07/15","摩根大通",1318,1040,278
"1420","2390云辰","110/07/15","日盛-和美",2,165,-163
"1421","2390云辰","110/07/15","國票-博愛",184,7,177
"1422","2390云辰","110/07/15","國泰-敦南",142,290,-148
"1423","2390云辰","110/07/15","群益金鼎-大甲",113,13,100
"1424","2390云辰","110/07/15","台灣摩根士丹利",51,197,-146
"1425","2390云辰","110/07/15","凱基-大直",89,2,87
"1426","2390云辰","110/07/15","國票-嘉義",4,148,-144
"1427","2390云辰","110/07/15","玉山-台中",77,8,69
"1428","2390云辰","110/07/15","台中銀",8,139,-131
"1429","2390云辰","110/07/15","聯邦商銀",70,4,66
"1430","2390云辰","110/07/15","元大-彰化民生",7,138,-131
"1431","2390云辰","110/07/15","元大-大里",88,25,63
"1432","2390云辰","110/07/15","元富-成功",2,111,-109
"1433","2390云辰","110/07/15","富邦-嘉義",542,480,62
"1434","2390云辰","110/07/15","元大-東泰",3,106,-103
"1435","2390云辰","110/07/15","新加坡商瑞銀",158,97,61
"1436","2390云辰","110/07/15","合庫-三重",1,102,-101
"1437","2390云辰","110/07/15","華南永昌-台中",86,35,51
"1438","2390云辰","110/07/15","元富-大裕",4,87,-83
"1439","2390云辰","110/07/15","群益金鼎",51,6,45
"1440","2390云辰","110/07/15","凱基-和平",17,96,-79
"1441","2363矽統","110/07/14","台灣摩根士丹利",463,0,463
"1442","2363矽統","110/07/14","新加坡商瑞銀",568,1321,-753
"1443","2363矽統","110/07/14","台新證券",750,342,408
"1444","2363矽統","110/07/14","瑞士信貸",149,864,-715
"1445","2363矽統","110/07/14","玉山-台中",363,51,312
"1446","2363矽統","110/07/14","台新-屏東",115,380,-265
"1447","2363矽統","110/07/14","元大-斗六",223,25,198
"1448","2363矽統","110/07/14","永豐金證券",16,265,-249
"1449","2363矽統","110/07/14","華南永昌-朴子",208,38,170
"1450","2363矽統","110/07/14","美林",462,701,-239
"1451","2363矽統","110/07/14","元富-西松",169,12,157
"1452","2363矽統","110/07/14","宏遠-桃園",269,500,-231
"1453","2363矽統","110/07/14","永豐金-大園",146,6,140
"1454","2363矽統","110/07/14","凱基-竹北",36,254,-218
"1455","2363矽統","110/07/14","土銀-和平",134,0,134
"1456","2363矽統","110/07/14","港商法國興業",0,214,-214
"1457","2363矽統","110/07/14","富邦-新營",130,13,117
"1458","2363矽統","110/07/14","港商野村",835,1044,-209
"1459","2363矽統","110/07/14","元富-成功",118,11,107
"1460","2363矽統","110/07/14","北城證券",212,411,-199
"1461","2363矽統","110/07/14","元富-烏日",121,18,103
"1462","2363矽統","110/07/14","(牛牛牛)亞-鑫豐",51,241,-190
"1463","2363矽統","110/07/14","日盛-二林",120,18,102
"1464","2363矽統","110/07/14","國票-博愛",24,213,-189
"1465","2363矽統","110/07/14","兆豐-忠孝",98,2,96
"1466","2363矽統","110/07/14","大慶-蘆洲",134,316,-182
"1467","2363矽統","110/07/14","大慶-楊梅",92,3,89
"1468","2363矽統","110/07/14","彰銀-台中",15,193,-178
"1469","2363矽統","110/07/14","元富-三重",120,33,87
"1470","2363矽統","110/07/14","日盛-和美",18,185,-167
"1471","8112至上","110/07/14","新加坡商瑞銀",223,17,206
"1472","8112至上","110/07/14","瑞士信貸",8,170,-162
"1473","8112至上","110/07/14","摩根大通",285,129,156
"1474","8112至上","110/07/14","美林",55,202,-147
"1475","8112至上","110/07/14","花旗環球",124,0,124
"1476","8112至上","110/07/14","凱基-台北",325,436,-111
"1477","8112至上","110/07/14","兆豐-公益",117,4,113
"1478","8112至上","110/07/14","台中銀-台北",0,98,-98
"1479","8112至上","110/07/14","香港上海匯豐",111,0,111
"1480","8112至上","110/07/14","玉山-台大",17,107,-90
"1481","8112至上","110/07/14","永豐金-內湖",117,21,96
"1482","8112至上","110/07/14","康和-內湖",1,90,-89
"1483","8112至上","110/07/14","台灣摩根士丹利",108,16,92
"1484","8112至上","110/07/14","港商野村",21,84,-63
"1485","8112至上","110/07/14","元大-東蘆",77,0,77
"1486","8112至上","110/07/14","兆豐-北高雄",1,60,-59
"1487","8112至上","110/07/14","新光",108,48,60
"1488","8112至上","110/07/14","群益金鼎-海山",1,52,-51
"1489","8112至上","110/07/14","大慶-蘆洲",59,0,59
"1490","8112至上","110/07/14","群益金鼎-大安",0,50,-50
"1491","8112至上","110/07/14","華南永昌-台中",56,3,53
"1492","8112至上","110/07/14","富邦-仁愛",2,49,-47
"1493","8112至上","110/07/14","土銀-嘉義",52,2,50
"1494","8112至上","110/07/14","元大-金華",0,42,-42
"1495","8112至上","110/07/14","美商高盛",40,0,40
"1496","8112至上","110/07/14","元大-內湖",4,43,-39
"1497","8112至上","110/07/14","臺銀",63,29,34
"1498","8112至上","110/07/14","第一金-華江",2,37,-35
"1499","8112至上","110/07/14","元富-嘉義",31,0,31
"1500","8112至上","110/07/14","永豐金-苓雅",2,34,-32
"1501","1570力肯","110/07/14","國票-北高雄",68,0,68
"1502","1570力肯","110/07/14","摩根大通",0,21,-21
"1503","1570力肯","110/07/14","日盛-八德",30,1,29
"1504","1570力肯","110/07/14","新光",1,19,-18
"1505","1570力肯","110/07/14","玉山-高雄",7,0,7
"1506","1570力肯","110/07/14","(牛牛牛)亞-鑫豐",0,17,-17
"1507","1570力肯","110/07/14","臺銀-臺南",5,0,5
"1508","1570力肯","110/07/14","日盛-士林",0,10,-10
"1509","1570力肯","110/07/14","凱基-三峽",5,0,5
"1510","1570力肯","110/07/14","統一-員林",0,10,-10
"1511","1570力肯","110/07/14","元大-和平",5,0,5
"1512","1570力肯","110/07/14","國票-新莊",0,10,-10
"1513","1570力肯","110/07/14","合庫-三重",4,0,4
"1514","1570力肯","110/07/14","凱基-高美館",0,10,-10
"1515","1570力肯","110/07/14","瑞士信貸",4,0,4
"1516","1570力肯","110/07/14","元大-屏東民生",0,5,-5
"1517","1570力肯","110/07/14","統一-三多",4,0,4
"1518","1570力肯","110/07/14","元大-古亭",0,5,-5
"1519","1570力肯","110/07/14","華南永昌-古亭",4,0,4
"1520","1570力肯","110/07/14","日盛-木柵",0,4,-4
"1521","1570力肯","110/07/14","元大-高雄",3,0,3
"1522","1570力肯","110/07/14","大昌",0,4,-4
"1523","1570力肯","110/07/14","兆豐-忠孝",2,0,2
"1524","1570力肯","110/07/14","群益金鼎-東大",0,4,-4
"1525","1570力肯","110/07/14","富邦-陽明",2,0,2
"1526","1570力肯","110/07/14","凱基-台北",0,4,-4
"1527","1570力肯","110/07/14","元大-松山",2,0,2
"1528","1570力肯","110/07/14","元大-板橋",0,4,-4
"1529","1570力肯","110/07/14","元大-忠孝",2,0,2
"1530","1570力肯","110/07/14","第一金-中山",0,3,-3
"1531","2929淘帝","110/07/14","華南永昌-林口",60,0,60
"1532","2929淘帝","110/07/14","群益金鼎",25,540,-515
"1533","2929淘帝","110/07/14","美林",87,31,56
"1534","2929淘帝","110/07/14","國泰-台南",1,30,-29
"1535","2929淘帝","110/07/14","元富-台南",40,0,40
"1536","2929淘帝","110/07/14","宏遠-桃園",0,20,-20
"1537","2929淘帝","110/07/14","元大-民生",39,0,39
"1538","2929淘帝","110/07/14","摩根大通",11,31,-20
"1539","2929淘帝","110/07/14","臺銀-鳳山",34,0,34
"1540","2929淘帝","110/07/14","台新-建北",5,20,-15
"1541","2929淘帝","110/07/14","合庫-高雄",34,1,33
"1542","2929淘帝","110/07/14","新光",1,16,-15
"1543","2929淘帝","110/07/14","華南永昌-鶯歌",28,0,28
"1544","2929淘帝","110/07/14","玉山-板橋",0,15,-15
"1545","2929淘帝","110/07/14","永興",25,0,25
"1546","2929淘帝","110/07/14","凱基-羅東",0,15,-15
"1547","2929淘帝","110/07/14","元大-新盛",25,1,24
"1548","2929淘帝","110/07/14","元大-頭份",0,15,-15
"1549","2929淘帝","110/07/14","日盛-南京",23,0,23
"1550","2929淘帝","110/07/14","第一金-台南",0,13,-13
"1551","2929淘帝","110/07/14","日茂",20,0,20
"1552","2929淘帝","110/07/14","富邦-基隆",0,12,-12
"1553","2929淘帝","110/07/14","台新-台中",20,0,20
"1554","2929淘帝","110/07/14","日茂-南投",1,12,-11
"1555","2929淘帝","110/07/14","華南永昌",20,0,20
"1556","2929淘帝","110/07/14","元大-豐原站前",0,11,-11
"1557","2929淘帝","110/07/14","福勝",15,0,15
"1558","2929淘帝","110/07/14","玉山-士林",0,10,-10
"1559","2929淘帝","110/07/14","富邦-南屯",15,0,15
"1560","2929淘帝","110/07/14","富邦-台北",0,10,-10
"1561","5410國眾","110/07/14","兆豐-城中",35,0,35
"1562","5410國眾","110/07/14","瑞士信貸",0,29,-29
"1563","5410國眾","110/07/14","新光",21,1,20
"1564","5410國眾","110/07/14","國泰-板橋",1,30,-29
"1565","5410國眾","110/07/14","國泰-敦南",21,1,20
"1566","5410國眾","110/07/14","日盛-高雄",0,20,-20
"1567","5410國眾","110/07/14","國泰-台中",20,1,19
"1568","5410國眾","110/07/14","台新-左楠",1,20,-19
"1569","5410國眾","110/07/14","元大-崇德",19,0,19
"1570","5410國眾","110/07/14","元富-大昌",1,18,-17
"1571","5410國眾","110/07/14","土銀-士林",18,0,18
"1572","5410國眾","110/07/14","富邦-建國",0,15,-15
"1573","5410國眾","110/07/14","元大-新盛",20,2,18
"1574","5410國眾","110/07/14","元富-嘉義",0,12,-12
"1575","5410國眾","110/07/14","兆豐-高雄",15,0,15
"1576","5410國眾","110/07/14","永全-南崁",0,12,-12
"1577","5410國眾","110/07/14","宏遠-中和",10,0,10
"1578","5410國眾","110/07/14","元大-員林",0,11,-11
"1579","5410國眾","110/07/14","新光-桃園",10,0,10
"1580","5410國眾","110/07/14","高橋",0,10,-10
"1581","5410國眾","110/07/14","國泰-台南",10,0,10
"1582","5410國眾","110/07/14","永興",0,10,-10
"1583","5410國眾","110/07/14","元大-復北",10,0,10
"1584","5410國眾","110/07/14","華南永昌-三重",0,10,-10
"1585","5410國眾","110/07/14","元大-竹科",8,0,8
"1586","5410國眾","110/07/14","元大-苑裡",0,7,-7
"1587","5410國眾","110/07/14","台新-新營",6,0,6
"1588","5410國眾","110/07/14","港商野村",0,6,-6
"1589","5410國眾","110/07/14","日盛-士林",5,0,5
"1590","5410國眾","110/07/14","摩根大通",5,11,-6
"1591","2841台開","110/07/14","凱基-文心",73,0,73
"1592","2841台開","110/07/14","國泰-敦南",0,50,-50
"1593","2841台開","110/07/14","元富-潮州",30,0,30
"1594","2841台開","110/07/14","凱基-中壢",0,40,-40
"1595","2841台開","110/07/14","第一金-台中",20,0,20
"1596","2841台開","110/07/14","統一-新竹",0,24,-24
"1597","2841台開","110/07/14","華南永昌-新莊",20,0,20
"1598","2841台開","110/07/14","元富-草屯",0,20,-20
"1599","2841台開","110/07/14","永豐金-豐原",20,0,20
"1600","2841台開","110/07/14","台新-台南",0,20,-20
"1601","2841台開","110/07/14","國泰-館前",15,0,15
"1602","2841台開","110/07/14","永豐金-敦南",45,63,-18
"1603","2841台開","110/07/14","群益金鼎-基隆",12,0,12
"1604","2841台開","110/07/14","國票-北高雄",0,13,-13
"1605","2841台開","110/07/14","日盛-信義",10,0,10
"1606","2841台開","110/07/14","凱基-松山",0,10,-10
"1607","2841台開","110/07/14","台新-台中",10,0,10
"1608","2841台開","110/07/14","元大證券",0,10,-10
"1609","2841台開","110/07/14","新光",10,1,9
"1610","2841台開","110/07/14","元大-中壢",0,10,-10
"1611","2841台開","110/07/14","凱基-新店",8,0,8
"1612","2841台開","110/07/14","富邦-陽明",1,10,-9
"1613","2841台開","110/07/14","元大-斗信",7,0,7
"1614","2841台開","110/07/14","富邦-建國",0,9,-9
"1615","2841台開","110/07/14","元大-三重",6,0,6
"1616","2841台開","110/07/14","富邦-台南",0,8,-8
"1617","2841台開","110/07/14","永豐金-中和",6,0,6
"1618","2841台開","110/07/14","康和-澎湖",0,7,-7
"1619","2841台開","110/07/14","元富-成功",5,0,5
"1620","2841台開","110/07/14","日盛-斗六",0,6,-6
"1621","6207雷科","110/07/14","群益金鼎-台北",60,0,60
"1622","6207雷科","110/07/14","新加坡商瑞銀",10,56,-46
"1623","6207雷科","110/07/14","台新-高雄",43,3,40
"1624","6207雷科","110/07/14","國票-中和",0,41,-41
"1625","6207雷科","110/07/14","元大-高雄",19,0,19
"1626","6207雷科","110/07/14","元大-復北",0,33,-33
"1627","6207雷科","110/07/14","福勝",15,0,15
"1628","6207雷科","110/07/14","光和-和美",0,20,-20
"1629","6207雷科","110/07/14","群益金鼎-中山",15,0,15
"1630","6207雷科","110/07/14","群益金鼎-丹鳳",0,20,-20
"1631","6207雷科","110/07/14","元大-林園",15,0,15
"1632","6207雷科","110/07/14","第一金-路竹",0,10,-10
"1633","6207雷科","110/07/14","新光",12,0,12
"1634","6207雷科","110/07/14","元大-歸仁",0,10,-10
"1635","6207雷科","110/07/14","元大-大天母",10,0,10
"1636","6207雷科","110/07/14","宏遠-館前",0,9,-9
"1637","6207雷科","110/07/14","永豐金-忠孝",9,0,9
"1638","6207雷科","110/07/14","凱基-台北",12,20,-8
"1639","6207雷科","110/07/14","永豐金-新店",7,0,7
"1640","6207雷科","110/07/14","美林",0,7,-7
"1641","6207雷科","110/07/14","玉山-嘉義",6,0,6
"1642","6207雷科","110/07/14","摩根大通",16,23,-7
"1643","6207雷科","110/07/14","元大-屏東",6,0,6
"1644","6207雷科","110/07/14","凱基-高雄",1,7,-6
"1645","6207雷科","110/07/14","凱基-大安",5,0,5
"1646","6207雷科","110/07/14","台中銀-豐原",0,5,-5
"1647","6207雷科","110/07/14","富邦-台南",5,0,5
"1648","6207雷科","110/07/14","元大-新竹經國",0,5,-5
"1649","6207雷科","110/07/14","元大-成功",5,0,5
"1650","6207雷科","110/07/14","光和-田中",0,4,-4
"1651","3679新至陞","110/07/14","凱基-台北",31,6,25
"1652","3679新至陞","110/07/14","群益金鼎-東大",0,15,-15
"1653","3679新至陞","110/07/14","華南永昌-新莊",10,0,10
"1654","3679新至陞","110/07/14","瑞士信貸",0,12,-12
"1655","3679新至陞","110/07/14","新加坡商瑞銀",11,3,8
"1656","3679新至陞","110/07/14","群益金鼎-永和",0,10,-10
"1657","3679新至陞","110/07/14","美商高盛",6,0,6
"1658","3679新至陞","110/07/14","元大-成功",5,15,-10
"1659","3679新至陞","110/07/14","第一金-中壢",6,0,6
"1660","3679新至陞","110/07/14","統一-板橋",1,10,-9
"1661","3679新至陞","110/07/14","(牛牛牛)亞-網路",4,0,4
"1662","3679新至陞","110/07/14","玉山-左營",0,5,-5
"1663","3679新至陞","110/07/14","元大-六合",3,0,3
"1664","3679新至陞","110/07/14","群益金鼎-三民",0,4,-4
"1665","3679新至陞","110/07/14","合庫-自強",2,0,2
"1666","3679新至陞","110/07/14","富邦-宜蘭",0,4,-4
"1667","3679新至陞","110/07/14","高橋-內壢",2,0,2
"1668","3679新至陞","110/07/14","永豐金-苓雅",0,3,-3
"1669","3679新至陞","110/07/14","台中銀-員林",2,0,2
"1670","3679新至陞","110/07/14","摩根大通",5,7,-2
"1671","3679新至陞","110/07/14","凱基-高美館",2,0,2
"1672","3679新至陞","110/07/14","元大-板橋三民",0,2,-2
"1673","3679新至陞","110/07/14","元大-福營",2,0,2
"1674","3679新至陞","110/07/14","宏遠-中和",0,1,-1
"1675","3679新至陞","110/07/14","永豐金-松山",2,0,2
"1676","3679新至陞","110/07/14","元富-佳里",0,1,-1
"1677","3679新至陞","110/07/14","永豐金-萬盛",2,0,2
"1678","3679新至陞","110/07/14","(牛牛牛)亞-鑫豐",0,1,-1
"1679","3679新至陞","110/07/14","元富-松德",1,0,1
"1680","3679新至陞","110/07/14","中國信託-中壢",0,1,-1
"1681","2727王品","110/07/14","富邦-左營",102,1,101
"1682","2727王品","110/07/14","統一-城中",100,234,-134
"1683","2727王品","110/07/14","國泰-板橋",105,11,94
"1684","2727王品","110/07/14","富邦-台北",1,125,-124
"1685","2727王品","110/07/14","港商野村",149,72,77
"1686","2727王品","110/07/14","台灣摩根士丹利",1,48,-47
"1687","2727王品","110/07/14","合庫-台中",66,2,64
"1688","2727王品","110/07/14","國票-新莊",0,40,-40
"1689","2727王品","110/07/14","臺銀-金山",63,8,55
"1690","2727王品","110/07/14","永豐金-忠孝",2,39,-37
"1691","2727王品","110/07/14","摩根大通",83,39,44
"1692","2727王品","110/07/14","富邦-彰化",1,34,-33
"1693","2727王品","110/07/14","凱基-台北",84,42,42
"1694","2727王品","110/07/14","康和-高雄",0,30,-30
"1695","2727王品","110/07/14","土銀-台中",35,1,34
"1696","2727王品","110/07/14","安泰",0,26,-26
"1697","2727王品","110/07/14","華南永昌-麻豆",32,1,31
"1698","2727王品","110/07/14","富邦-新竹華信",0,21,-21
"1699","2727王品","110/07/14","元大證券",85,55,30
"1700","2727王品","110/07/14","元大-南崁",1,22,-21
"1701","2727王品","110/07/14","新加坡商瑞銀",40,15,25
"1702","2727王品","110/07/14","彰銀-台中",0,18,-18
"1703","2727王品","110/07/14","日盛-八德",19,0,19
"1704","2727王品","110/07/14","元富-同大",2,20,-18
"1705","2727王品","110/07/14","統一",35,17,18
"1706","2727王品","110/07/14","玉山-嘉義",1,17,-16
"1707","2727王品","110/07/14","元富-大昌",18,1,17
"1708","2727王品","110/07/14","國泰-館前",4,20,-16
"1709","2727王品","110/07/14","玉山-板橋",15,1,14
"1710","2727王品","110/07/14","第一金-嘉義",1,13,-12
"1711","1570力肯","110/07/14","國票-北高雄",68,0,68
"1712","1570力肯","110/07/14","摩根大通",0,21,-21
"1713","1570力肯","110/07/14","日盛-八德",30,1,29
"1714","1570力肯","110/07/14","新光",1,19,-18
"1715","1570力肯","110/07/14","玉山-高雄",7,0,7
"1716","1570力肯","110/07/14","(牛牛牛)亞-鑫豐",0,17,-17
"1717","1570力肯","110/07/14","臺銀-臺南",5,0,5
"1718","1570力肯","110/07/14","日盛-士林",0,10,-10
"1719","1570力肯","110/07/14","凱基-三峽",5,0,5
"1720","1570力肯","110/07/14","統一-員林",0,10,-10
"1721","1570力肯","110/07/14","元大-和平",5,0,5
"1722","1570力肯","110/07/14","國票-新莊",0,10,-10
"1723","1570力肯","110/07/14","合庫-三重",4,0,4
"1724","1570力肯","110/07/14","凱基-高美館",0,10,-10
"1725","1570力肯","110/07/14","瑞士信貸",4,0,4
"1726","1570力肯","110/07/14","元大-屏東民生",0,5,-5
"1727","1570力肯","110/07/14","統一-三多",4,0,4
"1728","1570力肯","110/07/14","元大-古亭",0,5,-5
"1729","1570力肯","110/07/14","華南永昌-古亭",4,0,4
"1730","1570力肯","110/07/14","日盛-木柵",0,4,-4
"1731","1570力肯","110/07/14","元大-高雄",3,0,3
"1732","1570力肯","110/07/14","大昌",0,4,-4
"1733","1570力肯","110/07/14","兆豐-忠孝",2,0,2
"1734","1570力肯","110/07/14","群益金鼎-東大",0,4,-4
"1735","1570力肯","110/07/14","富邦-陽明",2,0,2
"1736","1570力肯","110/07/14","凱基-台北",0,4,-4
"1737","1570力肯","110/07/14","元大-松山",2,0,2
"1738","1570力肯","110/07/14","元大-板橋",0,4,-4
"1739","1570力肯","110/07/14","元大-忠孝",2,0,2
"1740","1570力肯","110/07/14","第一金-中山",0,3,-3
"1741","6180橘子","110/07/14","新加坡商瑞銀",84,28,56
"1742","6180橘子","110/07/14","凱基-台北",4,37,-33
"1743","6180橘子","110/07/14","日盛-信義",29,1,28
"1744","6180橘子","110/07/14","玉山-台南",1,22,-21
"1745","6180橘子","110/07/14","豐農",28,4,24
"1746","6180橘子","110/07/14","日盛-新竹",1,21,-20
"1747","6180橘子","110/07/14","新光-新竹",24,1,23
"1748","6180橘子","110/07/14","元富-潮州",0,19,-19
"1749","6180橘子","110/07/14","華南永昌-高雄",20,0,20
"1750","6180橘子","110/07/14","元大-信義",0,17,-17
"1751","6180橘子","110/07/14","元大-羅東",20,0,20
"1752","6180橘子","110/07/14","台灣企銀-台中",1,16,-15
"1753","6180橘子","110/07/14","元大-台中中港",20,0,20
"1754","6180橘子","110/07/14","元大-北港",0,15,-15
"1755","6180橘子","110/07/14","富邦-嘉義",24,5,19
"1756","6180橘子","110/07/14","富邦-高雄",0,14,-14
"1757","6180橘子","110/07/14","富邦-仁愛",15,0,15
"1758","6180橘子","110/07/14","兆豐-埔墘",0,13,-13
"1759","6180橘子","110/07/14","國票-九鼎",13,0,13
"1760","6180橘子","110/07/14","第一金-中山",0,10,-10
"1761","6180橘子","110/07/14","日盛-木柵",12,0,12
"1762","6180橘子","110/07/14","元大-彰化民生",0,10,-10
"1763","6180橘子","110/07/14","元大-成功",10,0,10
"1764","6180橘子","110/07/14","福勝",1,10,-9
"1765","6180橘子","110/07/14","港商野村",10,2,8
"1766","6180橘子","110/07/14","群益金鼎-丹鳳",1,10,-9
"1767","6180橘子","110/07/14","玉山-左營",8,0,8
"1768","6180橘子","110/07/14","群益金鼎-板橋",0,8,-8
"1769","6180橘子","110/07/14","富邦-陽明",16,8,8
"1770","6180橘子","110/07/14","合庫-鳳山",0,7,-7
"1771","2390云辰","110/07/14","摩根大通",995,198,797
"1772","2390云辰","110/07/14","新加坡商瑞銀",28,399,-371
"1773","2390云辰","110/07/14","美林",383,22,361
"1774","2390云辰","110/07/14","凱基-新豐",3,198,-195
"1775","2390云辰","110/07/14","台灣摩根士丹利",684,358,326
"1776","2390云辰","110/07/14","元大-士林",1,152,-151
"1777","2390云辰","110/07/14","凱基-台北",656,402,254
"1778","2390云辰","110/07/14","元大-竹山",80,181,-101
"1779","2390云辰","110/07/14","日盛-和美",110,5,105
"1780","2390云辰","110/07/14","群益金鼎-開元",19,95,-76
"1781","2390云辰","110/07/14","元大-天母",72,0,72
"1782","2390云辰","110/07/14","新光",77,150,-73
"1783","2390云辰","110/07/14","永豐金-松山",57,0,57
"1784","2390云辰","110/07/14","元富-高雄",0,71,-71
"1785","2390云辰","110/07/14","統一-屏東",53,0,53
"1786","2390云辰","110/07/14","元大-土城學府",130,201,-71
"1787","2390云辰","110/07/14","港商野村",486,450,36
"1788","2390云辰","110/07/14","元大-善化",12,76,-64
"1789","2390云辰","110/07/14","致和-崇德",30,0,30
"1790","2390云辰","110/07/14","華南永昌-岡山",23,81,-58
"1791","2390云辰","110/07/14","富邦-台北",40,14,26
"1792","2390云辰","110/07/14","群益金鼎-大興",82,125,-43
"1793","2390云辰","110/07/14","台新-高雄",38,13,25
"1794","2390云辰","110/07/14","大慶-中壢",0,41,-41
"1795","2390云辰","110/07/14","富邦-板橋",32,7,25
"1796","2390云辰","110/07/14","玉山-板橋",6,47,-41
"1797","2390云辰","110/07/14","陽信-石牌",24,0,24
"1798","2390云辰","110/07/14","富邦-台東",2,42,-40
"1799","2390云辰","110/07/14","凱基-屏東",32,8,24
"1800","2390云辰","110/07/14","元大-新營",3,42,-39
"1801","2363矽統","110/07/14","台灣摩根士丹利",463,0,463
"1802","2363矽統","110/07/14","新加坡商瑞銀",568,1321,-753
"1803","2363矽統","110/07/14","台新證券",750,342,408
"1804","2363矽統","110/07/14","瑞士信貸",149,864,-715
"1805","2363矽統","110/07/14","玉山-台中",363,51,312
"1806","2363矽統","110/07/14","台新-屏東",115,380,-265
"1807","2363矽統","110/07/14","元大-斗六",223,25,198
"1808","2363矽統","110/07/14","永豐金證券",16,265,-249
"1809","2363矽統","110/07/14","華南永昌-朴子",208,38,170
"1810","2363矽統","110/07/14","美林",462,701,-239
"1811","2363矽統","110/07/14","元富-西松",169,12,157
"1812","2363矽統","110/07/14","宏遠-桃園",269,500,-231
"1813","2363矽統","110/07/14","永豐金-大園",146,6,140
"1814","2363矽統","110/07/14","凱基-竹北",36,254,-218
"1815","2363矽統","110/07/14","土銀-和平",134,0,134
"1816","2363矽統","110/07/14","港商法國興業",0,214,-214
"1817","2363矽統","110/07/14","富邦-新營",130,13,117
"1818","2363矽統","110/07/14","港商野村",835,1044,-209
"1819","2363矽統","110/07/14","元富-成功",118,11,107
"1820","2363矽統","110/07/14","北城證券",212,411,-199
"1821","2363矽統","110/07/14","元富-烏日",121,18,103
"1822","2363矽統","110/07/14","(牛牛牛)亞-鑫豐",51,241,-190
"1823","2363矽統","110/07/14","日盛-二林",120,18,102
"1824","2363矽統","110/07/14","國票-博愛",24,213,-189
"1825","2363矽統","110/07/14","兆豐-忠孝",98,2,96
"1826","2363矽統","110/07/14","大慶-蘆洲",134,316,-182
"1827","2363矽統","110/07/14","大慶-楊梅",92,3,89
"1828","2363矽統","110/07/14","彰銀-台中",15,193,-178
"1829","2363矽統","110/07/14","元富-三重",120,33,87
"1830","2363矽統","110/07/14","日盛-和美",18,185,-167
"1831","8112至上","110/07/14","新加坡商瑞銀",223,17,206
"1832","8112至上","110/07/14","瑞士信貸",8,170,-162
"1833","8112至上","110/07/14","摩根大通",285,129,156
"1834","8112至上","110/07/14","美林",55,202,-147
"1835","8112至上","110/07/14","花旗環球",124,0,124
"1836","8112至上","110/07/14","凱基-台北",325,436,-111
"1837","8112至上","110/07/14","兆豐-公益",117,4,113
"1838","8112至上","110/07/14","台中銀-台北",0,98,-98
"1839","8112至上","110/07/14","香港上海匯豐",111,0,111
"1840","8112至上","110/07/14","玉山-台大",17,107,-90
"1841","8112至上","110/07/14","永豐金-內湖",117,21,96
"1842","8112至上","110/07/14","康和-內湖",1,90,-89
"1843","8112至上","110/07/14","台灣摩根士丹利",108,16,92
"1844","8112至上","110/07/14","港商野村",21,84,-63
"1845","8112至上","110/07/14","元大-東蘆",77,0,77
"1846","8112至上","110/07/14","兆豐-北高雄",1,60,-59
"1847","8112至上","110/07/14","新光",108,48,60
"1848","8112至上","110/07/14","群益金鼎-海山",1,52,-51
"1849","8112至上","110/07/14","大慶-蘆洲",59,0,59
"1850","8112至上","110/07/14","群益金鼎-大安",0,50,-50
"1851","8112至上","110/07/14","華南永昌-台中",56,3,53
"1852","8112至上","110/07/14","富邦-仁愛",2,49,-47
"1853","8112至上","110/07/14","土銀-嘉義",52,2,50
"1854","8112至上","110/07/14","元大-金華",0,42,-42
"1855","8112至上","110/07/14","美商高盛",40,0,40
"1856","8112至上","110/07/14","元大-內湖",4,43,-39
"1857","8112至上","110/07/14","臺銀",63,29,34
"1858","8112至上","110/07/14","第一金-華江",2,37,-35
"1859","8112至上","110/07/14","元富-嘉義",31,0,31
"1860","8112至上","110/07/14","永豐金-苓雅",2,34,-32
"1861","1570力肯","110/07/14","國票-北高雄",68,0,68
"1862","1570力肯","110/07/14","摩根大通",0,21,-21
"1863","1570力肯","110/07/14","日盛-八德",30,1,29
"1864","1570力肯","110/07/14","新光",1,19,-18
"1865","1570力肯","110/07/14","玉山-高雄",7,0,7
"1866","1570力肯","110/07/14","(牛牛牛)亞-鑫豐",0,17,-17
"1867","1570力肯","110/07/14","臺銀-臺南",5,0,5
"1868","1570力肯","110/07/14","日盛-士林",0,10,-10
"1869","1570力肯","110/07/14","凱基-三峽",5,0,5
"1870","1570力肯","110/07/14","統一-員林",0,10,-10
"1871","1570力肯","110/07/14","元大-和平",5,0,5
"1872","1570力肯","110/07/14","國票-新莊",0,10,-10
"1873","1570力肯","110/07/14","合庫-三重",4,0,4
"1874","1570力肯","110/07/14","凱基-高美館",0,10,-10
"1875","1570力肯","110/07/14","瑞士信貸",4,0,4
"1876","1570力肯","110/07/14","元大-屏東民生",0,5,-5
"1877","1570力肯","110/07/14","統一-三多",4,0,4
"1878","1570力肯","110/07/14","元大-古亭",0,5,-5
"1879","1570力肯","110/07/14","華南永昌-古亭",4,0,4
"1880","1570力肯","110/07/14","日盛-木柵",0,4,-4
"1881","1570力肯","110/07/14","元大-高雄",3,0,3
"1882","1570力肯","110/07/14","大昌",0,4,-4
"1883","1570力肯","110/07/14","兆豐-忠孝",2,0,2
"1884","1570力肯","110/07/14","群益金鼎-東大",0,4,-4
"1885","1570力肯","110/07/14","富邦-陽明",2,0,2
"1886","1570力肯","110/07/14","凱基-台北",0,4,-4
"1887","1570力肯","110/07/14","元大-松山",2,0,2
"1888","1570力肯","110/07/14","元大-板橋",0,4,-4
"1889","1570力肯","110/07/14","元大-忠孝",2,0,2
"1890","1570力肯","110/07/14","第一金-中山",0,3,-3
"1891","2929淘帝","110/07/14","華南永昌-林口",60,0,60
"1892","2929淘帝","110/07/14","群益金鼎",25,540,-515
"1893","2929淘帝","110/07/14","美林",87,31,56
"1894","2929淘帝","110/07/14","國泰-台南",1,30,-29
"1895","2929淘帝","110/07/14","元富-台南",40,0,40
"1896","2929淘帝","110/07/14","宏遠-桃園",0,20,-20
"1897","2929淘帝","110/07/14","元大-民生",39,0,39
"1898","2929淘帝","110/07/14","摩根大通",11,31,-20
"1899","2929淘帝","110/07/14","臺銀-鳳山",34,0,34
"1900","2929淘帝","110/07/14","台新-建北",5,20,-15
"1901","2929淘帝","110/07/14","合庫-高雄",34,1,33
"1902","2929淘帝","110/07/14","新光",1,16,-15
"1903","2929淘帝","110/07/14","華南永昌-鶯歌",28,0,28
"1904","2929淘帝","110/07/14","玉山-板橋",0,15,-15
"1905","2929淘帝","110/07/14","永興",25,0,25
"1906","2929淘帝","110/07/14","凱基-羅東",0,15,-15
"1907","2929淘帝","110/07/14","元大-新盛",25,1,24
"1908","2929淘帝","110/07/14","元大-頭份",0,15,-15
"1909","2929淘帝","110/07/14","日盛-南京",23,0,23
"1910","2929淘帝","110/07/14","第一金-台南",0,13,-13
"1911","2929淘帝","110/07/14","日茂",20,0,20
"1912","2929淘帝","110/07/14","富邦-基隆",0,12,-12
"1913","2929淘帝","110/07/14","台新-台中",20,0,20
"1914","2929淘帝","110/07/14","日茂-南投",1,12,-11
"1915","2929淘帝","110/07/14","華南永昌",20,0,20
"1916","2929淘帝","110/07/14","元大-豐原站前",0,11,-11
"1917","2929淘帝","110/07/14","福勝",15,0,15
"1918","2929淘帝","110/07/14","玉山-士林",0,10,-10
"1919","2929淘帝","110/07/14","富邦-南屯",15,0,15
"1920","2929淘帝","110/07/14","富邦-台北",0,10,-10
"1921","5410國眾","110/07/14","兆豐-城中",35,0,35
"1922","5410國眾","110/07/14","瑞士信貸",0,29,-29
"1923","5410國眾","110/07/14","新光",21,1,20
"1924","5410國眾","110/07/14","國泰-板橋",1,30,-29
"1925","5410國眾","110/07/14","國泰-敦南",21,1,20
"1926","5410國眾","110/07/14","日盛-高雄",0,20,-20
"1927","5410國眾","110/07/14","國泰-台中",20,1,19
"1928","5410國眾","110/07/14","台新-左楠",1,20,-19
"1929","5410國眾","110/07/14","元大-崇德",19,0,19
"1930","5410國眾","110/07/14","元富-大昌",1,18,-17
"1931","5410國眾","110/07/14","土銀-士林",18,0,18
"1932","5410國眾","110/07/14","富邦-建國",0,15,-15
"1933","5410國眾","110/07/14","元大-新盛",20,2,18
"1934","5410國眾","110/07/14","元富-嘉義",0,12,-12
"1935","5410國眾","110/07/14","兆豐-高雄",15,0,15
"1936","5410國眾","110/07/14","永全-南崁",0,12,-12
"1937","5410國眾","110/07/14","宏遠-中和",10,0,10
"1938","5410國眾","110/07/14","元大-員林",0,11,-11
"1939","5410國眾","110/07/14","新光-桃園",10,0,10
"1940","5410國眾","110/07/14","高橋",0,10,-10
"1941","5410國眾","110/07/14","國泰-台南",10,0,10
"1942","5410國眾","110/07/14","永興",0,10,-10
"1943","5410國眾","110/07/14","元大-復北",10,0,10
"1944","5410國眾","110/07/14","華南永昌-三重",0,10,-10
"1945","5410國眾","110/07/14","元大-竹科",8,0,8
"1946","5410國眾","110/07/14","元大-苑裡",0,7,-7
"1947","5410國眾","110/07/14","台新-新營",6,0,6
"1948","5410國眾","110/07/14","港商野村",0,6,-6
"1949","5410國眾","110/07/14","日盛-士林",5,0,5
"1950","5410國眾","110/07/14","摩根大通",5,11,-6
"1951","2841台開","110/07/14","凱基-文心",73,0,73
"1952","2841台開","110/07/14","國泰-敦南",0,50,-50
"1953","2841台開","110/07/14","元富-潮州",30,0,30
"1954","2841台開","110/07/14","凱基-中壢",0,40,-40
"1955","2841台開","110/07/14","第一金-台中",20,0,20
"1956","2841台開","110/07/14","統一-新竹",0,24,-24
"1957","2841台開","110/07/14","華南永昌-新莊",20,0,20
"1958","2841台開","110/07/14","元富-草屯",0,20,-20
"1959","2841台開","110/07/14","永豐金-豐原",20,0,20
"1960","2841台開","110/07/14","台新-台南",0,20,-20
"1961","2841台開","110/07/14","國泰-館前",15,0,15
"1962","2841台開","110/07/14","永豐金-敦南",45,63,-18
"1963","2841台開","110/07/14","群益金鼎-基隆",12,0,12
"1964","2841台開","110/07/14","國票-北高雄",0,13,-13
"1965","2841台開","110/07/14","日盛-信義",10,0,10
"1966","2841台開","110/07/14","凱基-松山",0,10,-10
"1967","2841台開","110/07/14","台新-台中",10,0,10
"1968","2841台開","110/07/14","元大證券",0,10,-10
"1969","2841台開","110/07/14","新光",10,1,9
"1970","2841台開","110/07/14","元大-中壢",0,10,-10
"1971","2841台開","110/07/14","凱基-新店",8,0,8
"1972","2841台開","110/07/14","富邦-陽明",1,10,-9
"1973","2841台開","110/07/14","元大-斗信",7,0,7
"1974","2841台開","110/07/14","富邦-建國",0,9,-9
"1975","2841台開","110/07/14","元大-三重",6,0,6
"1976","2841台開","110/07/14","富邦-台南",0,8,-8
"1977","2841台開","110/07/14","永豐金-中和",6,0,6
"1978","2841台開","110/07/14","康和-澎湖",0,7,-7
"1979","2841台開","110/07/14","元富-成功",5,0,5
"1980","2841台開","110/07/14","日盛-斗六",0,6,-6
"1981","6207雷科","110/07/14","群益金鼎-台北",60,0,60
"1982","6207雷科","110/07/14","新加坡商瑞銀",10,56,-46
"1983","6207雷科","110/07/14","台新-高雄",43,3,40
"1984","6207雷科","110/07/14","國票-中和",0,41,-41
"1985","6207雷科","110/07/14","元大-高雄",19,0,19
"1986","6207雷科","110/07/14","元大-復北",0,33,-33
"1987","6207雷科","110/07/14","福勝",15,0,15
"1988","6207雷科","110/07/14","光和-和美",0,20,-20
"1989","6207雷科","110/07/14","群益金鼎-中山",15,0,15
"1990","6207雷科","110/07/14","群益金鼎-丹鳳",0,20,-20
"1991","6207雷科","110/07/14","元大-林園",15,0,15
"1992","6207雷科","110/07/14","第一金-路竹",0,10,-10
"1993","6207雷科","110/07/14","新光",12,0,12
"1994","6207雷科","110/07/14","元大-歸仁",0,10,-10
"1995","6207雷科","110/07/14","元大-大天母",10,0,10
"1996","6207雷科","110/07/14","宏遠-館前",0,9,-9
"1997","6207雷科","110/07/14","永豐金-忠孝",9,0,9
"1998","6207雷科","110/07/14","凱基-台北",12,20,-8
"1999","6207雷科","110/07/14","永豐金-新店",7,0,7
"2000","6207雷科","110/07/14","美林",0,7,-7
"2001","6207雷科","110/07/14","玉山-嘉義",6,0,6
"2002","6207雷科","110/07/14","摩根大通",16,23,-7
"2003","6207雷科","110/07/14","元大-屏東",6,0,6
"2004","6207雷科","110/07/14","凱基-高雄",1,7,-6
"2005","6207雷科","110/07/14","凱基-大安",5,0,5
"2006","6207雷科","110/07/14","台中銀-豐原",0,5,-5
"2007","6207雷科","110/07/14","富邦-台南",5,0,5
"2008","6207雷科","110/07/14","元大-新竹經國",0,5,-5
"2009","6207雷科","110/07/14","元大-成功",5,0,5
"2010","6207雷科","110/07/14","光和-田中",0,4,-4
"2011","3679新至陞","110/07/14","凱基-台北",31,6,25
"2012","3679新至陞","110/07/14","群益金鼎-東大",0,15,-15
"2013","3679新至陞","110/07/14","華南永昌-新莊",10,0,10
"2014","3679新至陞","110/07/14","瑞士信貸",0,12,-12
"2015","3679新至陞","110/07/14","新加坡商瑞銀",11,3,8
"2016","3679新至陞","110/07/14","群益金鼎-永和",0,10,-10
"2017","3679新至陞","110/07/14","美商高盛",6,0,6
"2018","3679新至陞","110/07/14","元大-成功",5,15,-10
"2019","3679新至陞","110/07/14","第一金-中壢",6,0,6
"2020","3679新至陞","110/07/14","統一-板橋",1,10,-9
"2021","3679新至陞","110/07/14","(牛牛牛)亞-網路",4,0,4
"2022","3679新至陞","110/07/14","玉山-左營",0,5,-5
"2023","3679新至陞","110/07/14","元大-六合",3,0,3
"2024","3679新至陞","110/07/14","群益金鼎-三民",0,4,-4
"2025","3679新至陞","110/07/14","合庫-自強",2,0,2
"2026","3679新至陞","110/07/14","富邦-宜蘭",0,4,-4
"2027","3679新至陞","110/07/14","高橋-內壢",2,0,2
"2028","3679新至陞","110/07/14","永豐金-苓雅",0,3,-3
"2029","3679新至陞","110/07/14","台中銀-員林",2,0,2
"2030","3679新至陞","110/07/14","摩根大通",5,7,-2
"2031","3679新至陞","110/07/14","凱基-高美館",2,0,2
"2032","3679新至陞","110/07/14","元大-板橋三民",0,2,-2
"2033","3679新至陞","110/07/14","元大-福營",2,0,2
"2034","3679新至陞","110/07/14","宏遠-中和",0,1,-1
"2035","3679新至陞","110/07/14","永豐金-松山",2,0,2
"2036","3679新至陞","110/07/14","元富-佳里",0,1,-1
"2037","3679新至陞","110/07/14","永豐金-萬盛",2,0,2
"2038","3679新至陞","110/07/14","(牛牛牛)亞-鑫豐",0,1,-1
"2039","3679新至陞","110/07/14","元富-松德",1,0,1
"2040","3679新至陞","110/07/14","中國信託-中壢",0,1,-1
"2041","2727王品","110/07/14","富邦-左營",102,1,101
"2042","2727王品","110/07/14","統一-城中",100,234,-134
"2043","2727王品","110/07/14","國泰-板橋",105,11,94
"2044","2727王品","110/07/14","富邦-台北",1,125,-124
"2045","2727王品","110/07/14","港商野村",149,72,77
"2046","2727王品","110/07/14","台灣摩根士丹利",1,48,-47
"2047","2727王品","110/07/14","合庫-台中",66,2,64
"2048","2727王品","110/07/14","國票-新莊",0,40,-40
"2049","2727王品","110/07/14","臺銀-金山",63,8,55
"2050","2727王品","110/07/14","永豐金-忠孝",2,39,-37
"2051","2727王品","110/07/14","摩根大通",83,39,44
"2052","2727王品","110/07/14","富邦-彰化",1,34,-33
"2053","2727王品","110/07/14","凱基-台北",84,42,42
"2054","2727王品","110/07/14","康和-高雄",0,30,-30
"2055","2727王品","110/07/14","土銀-台中",35,1,34
"2056","2727王品","110/07/14","安泰",0,26,-26
"2057","2727王品","110/07/14","華南永昌-麻豆",32,1,31
"2058","2727王品","110/07/14","富邦-新竹華信",0,21,-21
"2059","2727王品","110/07/14","元大證券",85,55,30
"2060","2727王品","110/07/14","元大-南崁",1,22,-21
"2061","2727王品","110/07/14","新加坡商瑞銀",40,15,25
"2062","2727王品","110/07/14","彰銀-台中",0,18,-18
"2063","2727王品","110/07/14","日盛-八德",19,0,19
"2064","2727王品","110/07/14","元富-同大",2,20,-18
"2065","2727王品","110/07/14","統一",35,17,18
"2066","2727王品","110/07/14","玉山-嘉義",1,17,-16
"2067","2727王品","110/07/14","元富-大昌",18,1,17
"2068","2727王品","110/07/14","國泰-館前",4,20,-16
"2069","2727王品","110/07/14","玉山-板橋",15,1,14
"2070","2727王品","110/07/14","第一金-嘉義",1,13,-12
"2071","1570力肯","110/07/14","國票-北高雄",68,0,68
"2072","1570力肯","110/07/14","摩根大通",0,21,-21
"2073","1570力肯","110/07/14","日盛-八德",30,1,29
"2074","1570力肯","110/07/14","新光",1,19,-18
"2075","1570力肯","110/07/14","玉山-高雄",7,0,7
"2076","1570力肯","110/07/14","(牛牛牛)亞-鑫豐",0,17,-17
"2077","1570力肯","110/07/14","臺銀-臺南",5,0,5
"2078","1570力肯","110/07/14","日盛-士林",0,10,-10
"2079","1570力肯","110/07/14","凱基-三峽",5,0,5
"2080","1570力肯","110/07/14","統一-員林",0,10,-10
"2081","1570力肯","110/07/14","元大-和平",5,0,5
"2082","1570力肯","110/07/14","國票-新莊",0,10,-10
"2083","1570力肯","110/07/14","合庫-三重",4,0,4
"2084","1570力肯","110/07/14","凱基-高美館",0,10,-10
"2085","1570力肯","110/07/14","瑞士信貸",4,0,4
"2086","1570力肯","110/07/14","元大-屏東民生",0,5,-5
"2087","1570力肯","110/07/14","統一-三多",4,0,4
"2088","1570力肯","110/07/14","元大-古亭",0,5,-5
"2089","1570力肯","110/07/14","華南永昌-古亭",4,0,4
"2090","1570力肯","110/07/14","日盛-木柵",0,4,-4
"2091","1570力肯","110/07/14","元大-高雄",3,0,3
"2092","1570力肯","110/07/14","大昌",0,4,-4
"2093","1570力肯","110/07/14","兆豐-忠孝",2,0,2
"2094","1570力肯","110/07/14","群益金鼎-東大",0,4,-4
"2095","1570力肯","110/07/14","富邦-陽明",2,0,2
"2096","1570力肯","110/07/14","凱基-台北",0,4,-4
"2097","1570力肯","110/07/14","元大-松山",2,0,2
"2098","1570力肯","110/07/14","元大-板橋",0,4,-4
"2099","1570力肯","110/07/14","元大-忠孝",2,0,2
"2100","1570力肯","110/07/14","第一金-中山",0,3,-3
"2101","6180橘子","110/07/14","新加坡商瑞銀",84,28,56
"2102","6180橘子","110/07/14","凱基-台北",4,37,-33
"2103","6180橘子","110/07/14","日盛-信義",29,1,28
"2104","6180橘子","110/07/14","玉山-台南",1,22,-21
"2105","6180橘子","110/07/14","豐農",28,4,24
"2106","6180橘子","110/07/14","日盛-新竹",1,21,-20
"2107","6180橘子","110/07/14","新光-新竹",24,1,23
"2108","6180橘子","110/07/14","元富-潮州",0,19,-19
"2109","6180橘子","110/07/14","華南永昌-高雄",20,0,20
"2110","6180橘子","110/07/14","元大-信義",0,17,-17
"2111","6180橘子","110/07/14","元大-羅東",20,0,20
"2112","6180橘子","110/07/14","台灣企銀-台中",1,16,-15
"2113","6180橘子","110/07/14","元大-台中中港",20,0,20
"2114","6180橘子","110/07/14","元大-北港",0,15,-15
"2115","6180橘子","110/07/14","富邦-嘉義",24,5,19
"2116","6180橘子","110/07/14","富邦-高雄",0,14,-14
"2117","6180橘子","110/07/14","富邦-仁愛",15,0,15
"2118","6180橘子","110/07/14","兆豐-埔墘",0,13,-13
"2119","6180橘子","110/07/14","國票-九鼎",13,0,13
"2120","6180橘子","110/07/14","第一金-中山",0,10,-10
"2121","6180橘子","110/07/14","日盛-木柵",12,0,12
"2122","6180橘子","110/07/14","元大-彰化民生",0,10,-10
"2123","6180橘子","110/07/14","元大-成功",10,0,10
"2124","6180橘子","110/07/14","福勝",1,10,-9
"2125","6180橘子","110/07/14","港商野村",10,2,8
"2126","6180橘子","110/07/14","群益金鼎-丹鳳",1,10,-9
"2127","6180橘子","110/07/14","玉山-左營",8,0,8
"2128","6180橘子","110/07/14","群益金鼎-板橋",0,8,-8
"2129","6180橘子","110/07/14","富邦-陽明",16,8,8
"2130","6180橘子","110/07/14","合庫-鳳山",0,7,-7
"2131","2390云辰","110/07/14","摩根大通",995,198,797
"2132","2390云辰","110/07/14","新加坡商瑞銀",28,399,-371
"2133","2390云辰","110/07/14","美林",383,22,361
"2134","2390云辰","110/07/14","凱基-新豐",3,198,-195
"2135","2390云辰","110/07/14","台灣摩根士丹利",684,358,326
"2136","2390云辰","110/07/14","元大-士林",1,152,-151
"2137","2390云辰","110/07/14","凱基-台北",656,402,254
"2138","2390云辰","110/07/14","元大-竹山",80,181,-101
"2139","2390云辰","110/07/14","日盛-和美",110,5,105
"2140","2390云辰","110/07/14","群益金鼎-開元",19,95,-76
"2141","2390云辰","110/07/14","元大-天母",72,0,72
"2142","2390云辰","110/07/14","新光",77,150,-73
"2143","2390云辰","110/07/14","永豐金-松山",57,0,57
"2144","2390云辰","110/07/14","元富-高雄",0,71,-71
"2145","2390云辰","110/07/14","統一-屏東",53,0,53
"2146","2390云辰","110/07/14","元大-土城學府",130,201,-71
"2147","2390云辰","110/07/14","港商野村",486,450,36
"2148","2390云辰","110/07/14","元大-善化",12,76,-64
"2149","2390云辰","110/07/14","致和-崇德",30,0,30
"2150","2390云辰","110/07/14","華南永昌-岡山",23,81,-58
"2151","2390云辰","110/07/14","富邦-台北",40,14,26
"2152","2390云辰","110/07/14","群益金鼎-大興",82,125,-43
"2153","2390云辰","110/07/14","台新-高雄",38,13,25
"2154","2390云辰","110/07/14","大慶-中壢",0,41,-41
"2155","2390云辰","110/07/14","富邦-板橋",32,7,25
"2156","2390云辰","110/07/14","玉山-板橋",6,47,-41
"2157","2390云辰","110/07/14","陽信-石牌",24,0,24
"2158","2390云辰","110/07/14","富邦-台東",2,42,-40
"2159","2390云辰","110/07/14","凱基-屏東",32,8,24
"2160","2390云辰","110/07/14","元大-新營",3,42,-39
"2161","2363矽統","110/07/14","台灣摩根士丹利",463,0,463
"2162","2363矽統","110/07/14","新加坡商瑞銀",568,1321,-753
"2163","2363矽統","110/07/14","台新證券",750,342,408
"2164","2363矽統","110/07/14","瑞士信貸",149,864,-715
"2165","2363矽統","110/07/14","玉山-台中",363,51,312
"2166","2363矽統","110/07/14","台新-屏東",115,380,-265
"2167","2363矽統","110/07/14","元大-斗六",223,25,198
"2168","2363矽統","110/07/14","永豐金證券",16,265,-249
"2169","2363矽統","110/07/14","華南永昌-朴子",208,38,170
"2170","2363矽統","110/07/14","美林",462,701,-239
"2171","2363矽統","110/07/14","元富-西松",169,12,157
"2172","2363矽統","110/07/14","宏遠-桃園",269,500,-231
"2173","2363矽統","110/07/14","永豐金-大園",146,6,140
"2174","2363矽統","110/07/14","凱基-竹北",36,254,-218
"2175","2363矽統","110/07/14","土銀-和平",134,0,134
"2176","2363矽統","110/07/14","港商法國興業",0,214,-214
"2177","2363矽統","110/07/14","富邦-新營",130,13,117
"2178","2363矽統","110/07/14","港商野村",835,1044,-209
"2179","2363矽統","110/07/14","元富-成功",118,11,107
"2180","2363矽統","110/07/14","北城證券",212,411,-199
"2181","2363矽統","110/07/14","元富-烏日",121,18,103
"2182","2363矽統","110/07/14","(牛牛牛)亞-鑫豐",51,241,-190
"2183","2363矽統","110/07/14","日盛-二林",120,18,102
"2184","2363矽統","110/07/14","國票-博愛",24,213,-189
"2185","2363矽統","110/07/14","兆豐-忠孝",98,2,96
"2186","2363矽統","110/07/14","大慶-蘆洲",134,316,-182
"2187","2363矽統","110/07/14","大慶-楊梅",92,3,89
"2188","2363矽統","110/07/14","彰銀-台中",15,193,-178
"2189","2363矽統","110/07/14","元富-三重",120,33,87
"2190","2363矽統","110/07/14","日盛-和美",18,185,-167
"2191","8112至上","110/07/14","新加坡商瑞銀",223,17,206
"2192","8112至上","110/07/14","瑞士信貸",8,170,-162
"2193","8112至上","110/07/14","摩根大通",285,129,156
"2194","8112至上","110/07/14","美林",55,202,-147
"2195","8112至上","110/07/14","花旗環球",124,0,124
"2196","8112至上","110/07/14","凱基-台北",325,436,-111
"2197","8112至上","110/07/14","兆豐-公益",117,4,113
"2198","8112至上","110/07/14","台中銀-台北",0,98,-98
"2199","8112至上","110/07/14","香港上海匯豐",111,0,111
"2200","8112至上","110/07/14","玉山-台大",17,107,-90
"2201","8112至上","110/07/14","永豐金-內湖",117,21,96
"2202","8112至上","110/07/14","康和-內湖",1,90,-89
"2203","8112至上","110/07/14","台灣摩根士丹利",108,16,92
"2204","8112至上","110/07/14","港商野村",21,84,-63
"2205","8112至上","110/07/14","元大-東蘆",77,0,77
"2206","8112至上","110/07/14","兆豐-北高雄",1,60,-59
"2207","8112至上","110/07/14","新光",108,48,60
"2208","8112至上","110/07/14","群益金鼎-海山",1,52,-51
"2209","8112至上","110/07/14","大慶-蘆洲",59,0,59
"2210","8112至上","110/07/14","群益金鼎-大安",0,50,-50
"2211","8112至上","110/07/14","華南永昌-台中",56,3,53
"2212","8112至上","110/07/14","富邦-仁愛",2,49,-47
"2213","8112至上","110/07/14","土銀-嘉義",52,2,50
"2214","8112至上","110/07/14","元大-金華",0,42,-42
"2215","8112至上","110/07/14","美商高盛",40,0,40
"2216","8112至上","110/07/14","元大-內湖",4,43,-39
"2217","8112至上","110/07/14","臺銀",63,29,34
"2218","8112至上","110/07/14","第一金-華江",2,37,-35
"2219","8112至上","110/07/14","元富-嘉義",31,0,31
"2220","8112至上","110/07/14","永豐金-苓雅",2,34,-32
"2221","1570力肯","110/07/14","國票-北高雄",68,0,68
"2222","1570力肯","110/07/14","摩根大通",0,21,-21
"2223","1570力肯","110/07/14","日盛-八德",30,1,29
"2224","1570力肯","110/07/14","新光",1,19,-18
"2225","1570力肯","110/07/14","玉山-高雄",7,0,7
"2226","1570力肯","110/07/14","(牛牛牛)亞-鑫豐",0,17,-17
"2227","1570力肯","110/07/14","臺銀-臺南",5,0,5
"2228","1570力肯","110/07/14","日盛-士林",0,10,-10
"2229","1570力肯","110/07/14","凱基-三峽",5,0,5
"2230","1570力肯","110/07/14","統一-員林",0,10,-10
"2231","1570力肯","110/07/14","元大-和平",5,0,5
"2232","1570力肯","110/07/14","國票-新莊",0,10,-10
"2233","1570力肯","110/07/14","合庫-三重",4,0,4
"2234","1570力肯","110/07/14","凱基-高美館",0,10,-10
"2235","1570力肯","110/07/14","瑞士信貸",4,0,4
"2236","1570力肯","110/07/14","元大-屏東民生",0,5,-5
"2237","1570力肯","110/07/14","統一-三多",4,0,4
"2238","1570力肯","110/07/14","元大-古亭",0,5,-5
"2239","1570力肯","110/07/14","華南永昌-古亭",4,0,4
"2240","1570力肯","110/07/14","日盛-木柵",0,4,-4
"2241","1570力肯","110/07/14","元大-高雄",3,0,3
"2242","1570力肯","110/07/14","大昌",0,4,-4
"2243","1570力肯","110/07/14","兆豐-忠孝",2,0,2
"2244","1570力肯","110/07/14","群益金鼎-東大",0,4,-4
"2245","1570力肯","110/07/14","富邦-陽明",2,0,2
"2246","1570力肯","110/07/14","凱基-台北",0,4,-4
"2247","1570力肯","110/07/14","元大-松山",2,0,2
"2248","1570力肯","110/07/14","元大-板橋",0,4,-4
"2249","1570力肯","110/07/14","元大-忠孝",2,0,2
"2250","1570力肯","110/07/14","第一金-中山",0,3,-3
"2251","2929淘帝","110/07/14","華南永昌-林口",60,0,60
"2252","2929淘帝","110/07/14","群益金鼎",25,540,-515
"2253","2929淘帝","110/07/14","美林",87,31,56
"2254","2929淘帝","110/07/14","國泰-台南",1,30,-29
"2255","2929淘帝","110/07/14","元富-台南",40,0,40
"2256","2929淘帝","110/07/14","宏遠-桃園",0,20,-20
"2257","2929淘帝","110/07/14","元大-民生",39,0,39
"2258","2929淘帝","110/07/14","摩根大通",11,31,-20
"2259","2929淘帝","110/07/14","臺銀-鳳山",34,0,34
"2260","2929淘帝","110/07/14","台新-建北",5,20,-15
"2261","2929淘帝","110/07/14","合庫-高雄",34,1,33
"2262","2929淘帝","110/07/14","新光",1,16,-15
"2263","2929淘帝","110/07/14","華南永昌-鶯歌",28,0,28
"2264","2929淘帝","110/07/14","玉山-板橋",0,15,-15
"2265","2929淘帝","110/07/14","永興",25,0,25
"2266","2929淘帝","110/07/14","凱基-羅東",0,15,-15
"2267","2929淘帝","110/07/14","元大-新盛",25,1,24
"2268","2929淘帝","110/07/14","元大-頭份",0,15,-15
"2269","2929淘帝","110/07/14","日盛-南京",23,0,23
"2270","2929淘帝","110/07/14","第一金-台南",0,13,-13
"2271","2929淘帝","110/07/14","日茂",20,0,20
"2272","2929淘帝","110/07/14","富邦-基隆",0,12,-12
"2273","2929淘帝","110/07/14","台新-台中",20,0,20
"2274","2929淘帝","110/07/14","日茂-南投",1,12,-11
"2275","2929淘帝","110/07/14","華南永昌",20,0,20
"2276","2929淘帝","110/07/14","元大-豐原站前",0,11,-11
"2277","2929淘帝","110/07/14","福勝",15,0,15
"2278","2929淘帝","110/07/14","玉山-士林",0,10,-10
"2279","2929淘帝","110/07/14","富邦-南屯",15,0,15
"2280","2929淘帝","110/07/14","富邦-台北",0,10,-10
"2281","5410國眾","110/07/14","兆豐-城中",35,0,35
"2282","5410國眾","110/07/14","瑞士信貸",0,29,-29
"2283","5410國眾","110/07/14","新光",21,1,20
"2284","5410國眾","110/07/14","國泰-板橋",1,30,-29
"2285","5410國眾","110/07/14","國泰-敦南",21,1,20
"2286","5410國眾","110/07/14","日盛-高雄",0,20,-20
"2287","5410國眾","110/07/14","國泰-台中",20,1,19
"2288","5410國眾","110/07/14","台新-左楠",1,20,-19
"2289","5410國眾","110/07/14","元大-崇德",19,0,19
"2290","5410國眾","110/07/14","元富-大昌",1,18,-17
"2291","5410國眾","110/07/14","土銀-士林",18,0,18
"2292","5410國眾","110/07/14","富邦-建國",0,15,-15
"2293","5410國眾","110/07/14","元大-新盛",20,2,18
"2294","5410國眾","110/07/14","元富-嘉義",0,12,-12
"2295","5410國眾","110/07/14","兆豐-高雄",15,0,15
"2296","5410國眾","110/07/14","永全-南崁",0,12,-12
"2297","5410國眾","110/07/14","宏遠-中和",10,0,10
"2298","5410國眾","110/07/14","元大-員林",0,11,-11
"2299","5410國眾","110/07/14","新光-桃園",10,0,10
"2300","5410國眾","110/07/14","高橋",0,10,-10
"2301","5410國眾","110/07/14","國泰-台南",10,0,10
"2302","5410國眾","110/07/14","永興",0,10,-10
"2303","5410國眾","110/07/14","元大-復北",10,0,10
"2304","5410國眾","110/07/14","華南永昌-三重",0,10,-10
"2305","5410國眾","110/07/14","元大-竹科",8,0,8
"2306","5410國眾","110/07/14","元大-苑裡",0,7,-7
"2307","5410國眾","110/07/14","台新-新營",6,0,6
"2308","5410國眾","110/07/14","港商野村",0,6,-6
"2309","5410國眾","110/07/14","日盛-士林",5,0,5
"2310","5410國眾","110/07/14","摩根大通",5,11,-6
"2311","2841台開","110/07/14","凱基-文心",73,0,73
"2312","2841台開","110/07/14","國泰-敦南",0,50,-50
"2313","2841台開","110/07/14","元富-潮州",30,0,30
"2314","2841台開","110/07/14","凱基-中壢",0,40,-40
"2315","2841台開","110/07/14","第一金-台中",20,0,20
"2316","2841台開","110/07/14","統一-新竹",0,24,-24
"2317","2841台開","110/07/14","華南永昌-新莊",20,0,20
"2318","2841台開","110/07/14","元富-草屯",0,20,-20
"2319","2841台開","110/07/14","永豐金-豐原",20,0,20
"2320","2841台開","110/07/14","台新-台南",0,20,-20
"2321","2841台開","110/07/14","國泰-館前",15,0,15
"2322","2841台開","110/07/14","永豐金-敦南",45,63,-18
"2323","2841台開","110/07/14","群益金鼎-基隆",12,0,12
"2324","2841台開","110/07/14","國票-北高雄",0,13,-13
"2325","2841台開","110/07/14","日盛-信義",10,0,10
"2326","2841台開","110/07/14","凱基-松山",0,10,-10
"2327","2841台開","110/07/14","台新-台中",10,0,10
"2328","2841台開","110/07/14","元大證券",0,10,-10
"2329","2841台開","110/07/14","新光",10,1,9
"2330","2841台開","110/07/14","元大-中壢",0,10,-10
"2331","2841台開","110/07/14","凱基-新店",8,0,8
"2332","2841台開","110/07/14","富邦-陽明",1,10,-9
"2333","2841台開","110/07/14","元大-斗信",7,0,7
"2334","2841台開","110/07/14","富邦-建國",0,9,-9
"2335","2841台開","110/07/14","元大-三重",6,0,6
"2336","2841台開","110/07/14","富邦-台南",0,8,-8
"2337","2841台開","110/07/14","永豐金-中和",6,0,6
"2338","2841台開","110/07/14","康和-澎湖",0,7,-7
"2339","2841台開","110/07/14","元富-成功",5,0,5
"2340","2841台開","110/07/14","日盛-斗六",0,6,-6
"2341","6207雷科","110/07/14","群益金鼎-台北",60,0,60
"2342","6207雷科","110/07/14","新加坡商瑞銀",10,56,-46
"2343","6207雷科","110/07/14","台新-高雄",43,3,40
"2344","6207雷科","110/07/14","國票-中和",0,41,-41
"2345","6207雷科","110/07/14","元大-高雄",19,0,19
"2346","6207雷科","110/07/14","元大-復北",0,33,-33
"2347","6207雷科","110/07/14","福勝",15,0,15
"2348","6207雷科","110/07/14","光和-和美",0,20,-20
"2349","6207雷科","110/07/14","群益金鼎-中山",15,0,15
"2350","6207雷科","110/07/14","群益金鼎-丹鳳",0,20,-20
"2351","6207雷科","110/07/14","元大-林園",15,0,15
"2352","6207雷科","110/07/14","第一金-路竹",0,10,-10
"2353","6207雷科","110/07/14","新光",12,0,12
"2354","6207雷科","110/07/14","元大-歸仁",0,10,-10
"2355","6207雷科","110/07/14","元大-大天母",10,0,10
"2356","6207雷科","110/07/14","宏遠-館前",0,9,-9
"2357","6207雷科","110/07/14","永豐金-忠孝",9,0,9
"2358","6207雷科","110/07/14","凱基-台北",12,20,-8
"2359","6207雷科","110/07/14","永豐金-新店",7,0,7
"2360","6207雷科","110/07/14","美林",0,7,-7
"2361","6207雷科","110/07/14","玉山-嘉義",6,0,6
"2362","6207雷科","110/07/14","摩根大通",16,23,-7
"2363","6207雷科","110/07/14","元大-屏東",6,0,6
"2364","6207雷科","110/07/14","凱基-高雄",1,7,-6
"2365","6207雷科","110/07/14","凱基-大安",5,0,5
"2366","6207雷科","110/07/14","台中銀-豐原",0,5,-5
"2367","6207雷科","110/07/14","富邦-台南",5,0,5
"2368","6207雷科","110/07/14","元大-新竹經國",0,5,-5
"2369","6207雷科","110/07/14","元大-成功",5,0,5
"2370","6207雷科","110/07/14","光和-田中",0,4,-4
"2371","3679新至陞","110/07/14","凱基-台北",31,6,25
"2372","3679新至陞","110/07/14","群益金鼎-東大",0,15,-15
"2373","3679新至陞","110/07/14","華南永昌-新莊",10,0,10
"2374","3679新至陞","110/07/14","瑞士信貸",0,12,-12
"2375","3679新至陞","110/07/14","新加坡商瑞銀",11,3,8
"2376","3679新至陞","110/07/14","群益金鼎-永和",0,10,-10
"2377","3679新至陞","110/07/14","美商高盛",6,0,6
"2378","3679新至陞","110/07/14","元大-成功",5,15,-10
"2379","3679新至陞","110/07/14","第一金-中壢",6,0,6
"2380","3679新至陞","110/07/14","統一-板橋",1,10,-9
"2381","3679新至陞","110/07/14","(牛牛牛)亞-網路",4,0,4
"2382","3679新至陞","110/07/14","玉山-左營",0,5,-5
"2383","3679新至陞","110/07/14","元大-六合",3,0,3
"2384","3679新至陞","110/07/14","群益金鼎-三民",0,4,-4
"2385","3679新至陞","110/07/14","合庫-自強",2,0,2
"2386","3679新至陞","110/07/14","富邦-宜蘭",0,4,-4
"2387","3679新至陞","110/07/14","高橋-內壢",2,0,2
"2388","3679新至陞","110/07/14","永豐金-苓雅",0,3,-3
"2389","3679新至陞","110/07/14","台中銀-員林",2,0,2
"2390","3679新至陞","110/07/14","摩根大通",5,7,-2
"2391","3679新至陞","110/07/14","凱基-高美館",2,0,2
"2392","3679新至陞","110/07/14","元大-板橋三民",0,2,-2
"2393","3679新至陞","110/07/14","元大-福營",2,0,2
"2394","3679新至陞","110/07/14","宏遠-中和",0,1,-1
"2395","3679新至陞","110/07/14","永豐金-松山",2,0,2
"2396","3679新至陞","110/07/14","元富-佳里",0,1,-1
"2397","3679新至陞","110/07/14","永豐金-萬盛",2,0,2
"2398","3679新至陞","110/07/14","(牛牛牛)亞-鑫豐",0,1,-1
"2399","3679新至陞","110/07/14","元富-松德",1,0,1
"2400","3679新至陞","110/07/14","中國信託-中壢",0,1,-1
"2401","2727王品","110/07/14","富邦-左營",102,1,101
"2402","2727王品","110/07/14","統一-城中",100,234,-134
"2403","2727王品","110/07/14","國泰-板橋",105,11,94
"2404","2727王品","110/07/14","富邦-台北",1,125,-124
"2405","2727王品","110/07/14","港商野村",149,72,77
"2406","2727王品","110/07/14","台灣摩根士丹利",1,48,-47
"2407","2727王品","110/07/14","合庫-台中",66,2,64
"2408","2727王品","110/07/14","國票-新莊",0,40,-40
"2409","2727王品","110/07/14","臺銀-金山",63,8,55
"2410","2727王品","110/07/14","永豐金-忠孝",2,39,-37
"2411","2727王品","110/07/14","摩根大通",83,39,44
"2412","2727王品","110/07/14","富邦-彰化",1,34,-33
"2413","2727王品","110/07/14","凱基-台北",84,42,42
"2414","2727王品","110/07/14","康和-高雄",0,30,-30
"2415","2727王品","110/07/14","土銀-台中",35,1,34
"2416","2727王品","110/07/14","安泰",0,26,-26
"2417","2727王品","110/07/14","華南永昌-麻豆",32,1,31
"2418","2727王品","110/07/14","富邦-新竹華信",0,21,-21
"2419","2727王品","110/07/14","元大證券",85,55,30
"2420","2727王品","110/07/14","元大-南崁",1,22,-21
"2421","2727王品","110/07/14","新加坡商瑞銀",40,15,25
"2422","2727王品","110/07/14","彰銀-台中",0,18,-18
"2423","2727王品","110/07/14","日盛-八德",19,0,19
"2424","2727王品","110/07/14","元富-同大",2,20,-18
"2425","2727王品","110/07/14","統一",35,17,18
"2426","2727王品","110/07/14","玉山-嘉義",1,17,-16
"2427","2727王品","110/07/14","元富-大昌",18,1,17
"2428","2727王品","110/07/14","國泰-館前",4,20,-16
"2429","2727王品","110/07/14","玉山-板橋",15,1,14
"2430","2727王品","110/07/14","第一金-嘉義",1,13,-12
"2431","1570力肯","110/07/14","國票-北高雄",68,0,68
"2432","1570力肯","110/07/14","摩根大通",0,21,-21
"2433","1570力肯","110/07/14","日盛-八德",30,1,29
"2434","1570力肯","110/07/14","新光",1,19,-18
"2435","1570力肯","110/07/14","玉山-高雄",7,0,7
"2436","1570力肯","110/07/14","(牛牛牛)亞-鑫豐",0,17,-17
"2437","1570力肯","110/07/14","臺銀-臺南",5,0,5
"2438","1570力肯","110/07/14","日盛-士林",0,10,-10
"2439","1570力肯","110/07/14","凱基-三峽",5,0,5
"2440","1570力肯","110/07/14","統一-員林",0,10,-10
"2441","1570力肯","110/07/14","元大-和平",5,0,5
"2442","1570力肯","110/07/14","國票-新莊",0,10,-10
"2443","1570力肯","110/07/14","合庫-三重",4,0,4
"2444","1570力肯","110/07/14","凱基-高美館",0,10,-10
"2445","1570力肯","110/07/14","瑞士信貸",4,0,4
"2446","1570力肯","110/07/14","元大-屏東民生",0,5,-5
"2447","1570力肯","110/07/14","統一-三多",4,0,4
"2448","1570力肯","110/07/14","元大-古亭",0,5,-5
"2449","1570力肯","110/07/14","華南永昌-古亭",4,0,4
"2450","1570力肯","110/07/14","日盛-木柵",0,4,-4
"2451","1570力肯","110/07/14","元大-高雄",3,0,3
"2452","1570力肯","110/07/14","大昌",0,4,-4
"2453","1570力肯","110/07/14","兆豐-忠孝",2,0,2
"2454","1570力肯","110/07/14","群益金鼎-東大",0,4,-4
"2455","1570力肯","110/07/14","富邦-陽明",2,0,2
"2456","1570力肯","110/07/14","凱基-台北",0,4,-4
"2457","1570力肯","110/07/14","元大-松山",2,0,2
"2458","1570力肯","110/07/14","元大-板橋",0,4,-4
"2459","1570力肯","110/07/14","元大-忠孝",2,0,2
"2460","1570力肯","110/07/14","第一金-中山",0,3,-3
"2461","6180橘子","110/07/14","新加坡商瑞銀",84,28,56
"2462","6180橘子","110/07/14","凱基-台北",4,37,-33
"2463","6180橘子","110/07/14","日盛-信義",29,1,28
"2464","6180橘子","110/07/14","玉山-台南",1,22,-21
"2465","6180橘子","110/07/14","豐農",28,4,24
"2466","6180橘子","110/07/14","日盛-新竹",1,21,-20
"2467","6180橘子","110/07/14","新光-新竹",24,1,23
"2468","6180橘子","110/07/14","元富-潮州",0,19,-19
"2469","6180橘子","110/07/14","華南永昌-高雄",20,0,20
"2470","6180橘子","110/07/14","元大-信義",0,17,-17
"2471","6180橘子","110/07/14","元大-羅東",20,0,20
"2472","6180橘子","110/07/14","台灣企銀-台中",1,16,-15
"2473","6180橘子","110/07/14","元大-台中中港",20,0,20
"2474","6180橘子","110/07/14","元大-北港",0,15,-15
"2475","6180橘子","110/07/14","富邦-嘉義",24,5,19
"2476","6180橘子","110/07/14","富邦-高雄",0,14,-14
"2477","6180橘子","110/07/14","富邦-仁愛",15,0,15
"2478","6180橘子","110/07/14","兆豐-埔墘",0,13,-13
"2479","6180橘子","110/07/14","國票-九鼎",13,0,13
"2480","6180橘子","110/07/14","第一金-中山",0,10,-10
"2481","6180橘子","110/07/14","日盛-木柵",12,0,12
"2482","6180橘子","110/07/14","元大-彰化民生",0,10,-10
"2483","6180橘子","110/07/14","元大-成功",10,0,10
"2484","6180橘子","110/07/14","福勝",1,10,-9
"2485","6180橘子","110/07/14","港商野村",10,2,8
"2486","6180橘子","110/07/14","群益金鼎-丹鳳",1,10,-9
"2487","6180橘子","110/07/14","玉山-左營",8,0,8
"2488","6180橘子","110/07/14","群益金鼎-板橋",0,8,-8
"2489","6180橘子","110/07/14","富邦-陽明",16,8,8
"2490","6180橘子","110/07/14","合庫-鳳山",0,7,-7
"2491","2390云辰","110/07/14","摩根大通",995,198,797
"2492","2390云辰","110/07/14","新加坡商瑞銀",28,399,-371
"2493","2390云辰","110/07/14","美林",383,22,361
"2494","2390云辰","110/07/14","凱基-新豐",3,198,-195
"2495","2390云辰","110/07/14","台灣摩根士丹利",684,358,326
"2496","2390云辰","110/07/14","元大-士林",1,152,-151
"2497","2390云辰","110/07/14","凱基-台北",656,402,254
"2498","2390云辰","110/07/14","元大-竹山",80,181,-101
"2499","2390云辰","110/07/14","日盛-和美",110,5,105
"2500","2390云辰","110/07/14","群益金鼎-開元",19,95,-76
"2501","2390云辰","110/07/14","元大-天母",72,0,72
"2502","2390云辰","110/07/14","新光",77,150,-73
"2503","2390云辰","110/07/14","永豐金-松山",57,0,57
"2504","2390云辰","110/07/14","元富-高雄",0,71,-71
"2505","2390云辰","110/07/14","統一-屏東",53,0,53
"2506","2390云辰","110/07/14","元大-土城學府",130,201,-71
"2507","2390云辰","110/07/14","港商野村",486,450,36
"2508","2390云辰","110/07/14","元大-善化",12,76,-64
"2509","2390云辰","110/07/14","致和-崇德",30,0,30
"2510","2390云辰","110/07/14","華南永昌-岡山",23,81,-58
"2511","2390云辰","110/07/14","富邦-台北",40,14,26
"2512","2390云辰","110/07/14","群益金鼎-大興",82,125,-43
"2513","2390云辰","110/07/14","台新-高雄",38,13,25
"2514","2390云辰","110/07/14","大慶-中壢",0,41,-41
"2515","2390云辰","110/07/14","富邦-板橋",32,7,25
"2516","2390云辰","110/07/14","玉山-板橋",6,47,-41
"2517","2390云辰","110/07/14","陽信-石牌",24,0,24
"2518","2390云辰","110/07/14","富邦-台東",2,42,-40
"2519","2390云辰","110/07/14","凱基-屏東",32,8,24
"2520","2390云辰","110/07/14","元大-新營",3,42,-39
"2521","2363矽統","110/07/14","台灣摩根士丹利",463,0,463
"2522","2363矽統","110/07/14","新加坡商瑞銀",568,1321,-753
"2523","2363矽統","110/07/14","台新證券",750,342,408
"2524","2363矽統","110/07/14","瑞士信貸",149,864,-715
"2525","2363矽統","110/07/14","玉山-台中",363,51,312
"2526","2363矽統","110/07/14","台新-屏東",115,380,-265
"2527","2363矽統","110/07/14","元大-斗六",223,25,198
"2528","2363矽統","110/07/14","永豐金證券",16,265,-249
"2529","2363矽統","110/07/14","華南永昌-朴子",208,38,170
"2530","2363矽統","110/07/14","美林",462,701,-239
"2531","2363矽統","110/07/14","元富-西松",169,12,157
"2532","2363矽統","110/07/14","宏遠-桃園",269,500,-231
"2533","2363矽統","110/07/14","永豐金-大園",146,6,140
"2534","2363矽統","110/07/14","凱基-竹北",36,254,-218
"2535","2363矽統","110/07/14","土銀-和平",134,0,134
"2536","2363矽統","110/07/14","港商法國興業",0,214,-214
"2537","2363矽統","110/07/14","富邦-新營",130,13,117
"2538","2363矽統","110/07/14","港商野村",835,1044,-209
"2539","2363矽統","110/07/14","元富-成功",118,11,107
"2540","2363矽統","110/07/14","北城證券",212,411,-199
"2541","2363矽統","110/07/14","元富-烏日",121,18,103
"2542","2363矽統","110/07/14","(牛牛牛)亞-鑫豐",51,241,-190
"2543","2363矽統","110/07/14","日盛-二林",120,18,102
"2544","2363矽統","110/07/14","國票-博愛",24,213,-189
"2545","2363矽統","110/07/14","兆豐-忠孝",98,2,96
"2546","2363矽統","110/07/14","大慶-蘆洲",134,316,-182
"2547","2363矽統","110/07/14","大慶-楊梅",92,3,89
"2548","2363矽統","110/07/14","彰銀-台中",15,193,-178
"2549","2363矽統","110/07/14","元富-三重",120,33,87
"2550","2363矽統","110/07/14","日盛-和美",18,185,-167
"2551","8112至上","110/07/14","新加坡商瑞銀",223,17,206
"2552","8112至上","110/07/14","瑞士信貸",8,170,-162
"2553","8112至上","110/07/14","摩根大通",285,129,156
"2554","8112至上","110/07/14","美林",55,202,-147
"2555","8112至上","110/07/14","花旗環球",124,0,124
"2556","8112至上","110/07/14","凱基-台北",325,436,-111
"2557","8112至上","110/07/14","兆豐-公益",117,4,113
"2558","8112至上","110/07/14","台中銀-台北",0,98,-98
"2559","8112至上","110/07/14","香港上海匯豐",111,0,111
"2560","8112至上","110/07/14","玉山-台大",17,107,-90
"2561","8112至上","110/07/14","永豐金-內湖",117,21,96
"2562","8112至上","110/07/14","康和-內湖",1,90,-89
"2563","8112至上","110/07/14","台灣摩根士丹利",108,16,92
"2564","8112至上","110/07/14","港商野村",21,84,-63
"2565","8112至上","110/07/14","元大-東蘆",77,0,77
"2566","8112至上","110/07/14","兆豐-北高雄",1,60,-59
"2567","8112至上","110/07/14","新光",108,48,60
"2568","8112至上","110/07/14","群益金鼎-海山",1,52,-51
"2569","8112至上","110/07/14","大慶-蘆洲",59,0,59
"2570","8112至上","110/07/14","群益金鼎-大安",0,50,-50
"2571","8112至上","110/07/14","華南永昌-台中",56,3,53
"2572","8112至上","110/07/14","富邦-仁愛",2,49,-47
"2573","8112至上","110/07/14","土銀-嘉義",52,2,50
"2574","8112至上","110/07/14","元大-金華",0,42,-42
"2575","8112至上","110/07/14","美商高盛",40,0,40
"2576","8112至上","110/07/14","元大-內湖",4,43,-39
"2577","8112至上","110/07/14","臺銀",63,29,34
"2578","8112至上","110/07/14","第一金-華江",2,37,-35
"2579","8112至上","110/07/14","元富-嘉義",31,0,31
"2580","8112至上","110/07/14","永豐金-苓雅",2,34,-32
"2581","1570力肯","110/07/14","國票-北高雄",68,0,68
"2582","1570力肯","110/07/14","摩根大通",0,21,-21
"2583","1570力肯","110/07/14","日盛-八德",30,1,29
"2584","1570力肯","110/07/14","新光",1,19,-18
"2585","1570力肯","110/07/14","玉山-高雄",7,0,7
"2586","1570力肯","110/07/14","(牛牛牛)亞-鑫豐",0,17,-17
"2587","1570力肯","110/07/14","臺銀-臺南",5,0,5
"2588","1570力肯","110/07/14","日盛-士林",0,10,-10
"2589","1570力肯","110/07/14","凱基-三峽",5,0,5
"2590","1570力肯","110/07/14","統一-員林",0,10,-10
"2591","1570力肯","110/07/14","元大-和平",5,0,5
"2592","1570力肯","110/07/14","國票-新莊",0,10,-10
"2593","1570力肯","110/07/14","合庫-三重",4,0,4
"2594","1570力肯","110/07/14","凱基-高美館",0,10,-10
"2595","1570力肯","110/07/14","瑞士信貸",4,0,4
"2596","1570力肯","110/07/14","元大-屏東民生",0,5,-5
"2597","1570力肯","110/07/14","統一-三多",4,0,4
"2598","1570力肯","110/07/14","元大-古亭",0,5,-5
"2599","1570力肯","110/07/14","華南永昌-古亭",4,0,4
"2600","1570力肯","110/07/14","日盛-木柵",0,4,-4
"2601","1570力肯","110/07/14","元大-高雄",3,0,3
"2602","1570力肯","110/07/14","大昌",0,4,-4
"2603","1570力肯","110/07/14","兆豐-忠孝",2,0,2
"2604","1570力肯","110/07/14","群益金鼎-東大",0,4,-4
"2605","1570力肯","110/07/14","富邦-陽明",2,0,2
"2606","1570力肯","110/07/14","凱基-台北",0,4,-4
"2607","1570力肯","110/07/14","元大-松山",2,0,2
"2608","1570力肯","110/07/14","元大-板橋",0,4,-4
"2609","1570力肯","110/07/14","元大-忠孝",2,0,2
"2610","1570力肯","110/07/14","第一金-中山",0,3,-3
"2611","2929淘帝","110/07/14","華南永昌-林口",60,0,60
"2612","2929淘帝","110/07/14","群益金鼎",25,540,-515
"2613","2929淘帝","110/07/14","美林",87,31,56
"2614","2929淘帝","110/07/14","國泰-台南",1,30,-29
"2615","2929淘帝","110/07/14","元富-台南",40,0,40
"2616","2929淘帝","110/07/14","宏遠-桃園",0,20,-20
"2617","2929淘帝","110/07/14","元大-民生",39,0,39
"2618","2929淘帝","110/07/14","摩根大通",11,31,-20
"2619","2929淘帝","110/07/14","臺銀-鳳山",34,0,34
"2620","2929淘帝","110/07/14","台新-建北",5,20,-15
"2621","2929淘帝","110/07/14","合庫-高雄",34,1,33
"2622","2929淘帝","110/07/14","新光",1,16,-15
"2623","2929淘帝","110/07/14","華南永昌-鶯歌",28,0,28
"2624","2929淘帝","110/07/14","玉山-板橋",0,15,-15
"2625","2929淘帝","110/07/14","永興",25,0,25
"2626","2929淘帝","110/07/14","凱基-羅東",0,15,-15
"2627","2929淘帝","110/07/14","元大-新盛",25,1,24
"2628","2929淘帝","110/07/14","元大-頭份",0,15,-15
"2629","2929淘帝","110/07/14","日盛-南京",23,0,23
"2630","2929淘帝","110/07/14","第一金-台南",0,13,-13
"2631","2929淘帝","110/07/14","日茂",20,0,20
"2632","2929淘帝","110/07/14","富邦-基隆",0,12,-12
"2633","2929淘帝","110/07/14","台新-台中",20,0,20
"2634","2929淘帝","110/07/14","日茂-南投",1,12,-11
"2635","2929淘帝","110/07/14","華南永昌",20,0,20
"2636","2929淘帝","110/07/14","元大-豐原站前",0,11,-11
"2637","2929淘帝","110/07/14","福勝",15,0,15
"2638","2929淘帝","110/07/14","玉山-士林",0,10,-10
"2639","2929淘帝","110/07/14","富邦-南屯",15,0,15
"2640","2929淘帝","110/07/14","富邦-台北",0,10,-10
"2641","5410國眾","110/07/14","兆豐-城中",35,0,35
"2642","5410國眾","110/07/14","瑞士信貸",0,29,-29
"2643","5410國眾","110/07/14","新光",21,1,20
"2644","5410國眾","110/07/14","國泰-板橋",1,30,-29
"2645","5410國眾","110/07/14","國泰-敦南",21,1,20
"2646","5410國眾","110/07/14","日盛-高雄",0,20,-20
"2647","5410國眾","110/07/14","國泰-台中",20,1,19
"2648","5410國眾","110/07/14","台新-左楠",1,20,-19
"2649","5410國眾","110/07/14","元大-崇德",19,0,19
"2650","5410國眾","110/07/14","元富-大昌",1,18,-17
"2651","5410國眾","110/07/14","土銀-士林",18,0,18
"2652","5410國眾","110/07/14","富邦-建國",0,15,-15
"2653","5410國眾","110/07/14","元大-新盛",20,2,18
"2654","5410國眾","110/07/14","元富-嘉義",0,12,-12
"2655","5410國眾","110/07/14","兆豐-高雄",15,0,15
"2656","5410國眾","110/07/14","永全-南崁",0,12,-12
"2657","5410國眾","110/07/14","宏遠-中和",10,0,10
"2658","5410國眾","110/07/14","元大-員林",0,11,-11
"2659","5410國眾","110/07/14","新光-桃園",10,0,10
"2660","5410國眾","110/07/14","高橋",0,10,-10
"2661","5410國眾","110/07/14","國泰-台南",10,0,10
"2662","5410國眾","110/07/14","永興",0,10,-10
"2663","5410國眾","110/07/14","元大-復北",10,0,10
"2664","5410國眾","110/07/14","華南永昌-三重",0,10,-10
"2665","5410國眾","110/07/14","元大-竹科",8,0,8
"2666","5410國眾","110/07/14","元大-苑裡",0,7,-7
"2667","5410國眾","110/07/14","台新-新營",6,0,6
"2668","5410國眾","110/07/14","港商野村",0,6,-6
"2669","5410國眾","110/07/14","日盛-士林",5,0,5
"2670","5410國眾","110/07/14","摩根大通",5,11,-6
"2671","2841台開","110/07/14","凱基-文心",73,0,73
"2672","2841台開","110/07/14","國泰-敦南",0,50,-50
"2673","2841台開","110/07/14","元富-潮州",30,0,30
"2674","2841台開","110/07/14","凱基-中壢",0,40,-40
"2675","2841台開","110/07/14","第一金-台中",20,0,20
"2676","2841台開","110/07/14","統一-新竹",0,24,-24
"2677","2841台開","110/07/14","華南永昌-新莊",20,0,20
"2678","2841台開","110/07/14","元富-草屯",0,20,-20
"2679","2841台開","110/07/14","永豐金-豐原",20,0,20
"2680","2841台開","110/07/14","台新-台南",0,20,-20
"2681","2841台開","110/07/14","國泰-館前",15,0,15
"2682","2841台開","110/07/14","永豐金-敦南",45,63,-18
"2683","2841台開","110/07/14","群益金鼎-基隆",12,0,12
"2684","2841台開","110/07/14","國票-北高雄",0,13,-13
"2685","2841台開","110/07/14","日盛-信義",10,0,10
"2686","2841台開","110/07/14","凱基-松山",0,10,-10
"2687","2841台開","110/07/14","台新-台中",10,0,10
"2688","2841台開","110/07/14","元大證券",0,10,-10
"2689","2841台開","110/07/14","新光",10,1,9
"2690","2841台開","110/07/14","元大-中壢",0,10,-10
"2691","2841台開","110/07/14","凱基-新店",8,0,8
"2692","2841台開","110/07/14","富邦-陽明",1,10,-9
"2693","2841台開","110/07/14","元大-斗信",7,0,7
"2694","2841台開","110/07/14","富邦-建國",0,9,-9
"2695","2841台開","110/07/14","元大-三重",6,0,6
"2696","2841台開","110/07/14","富邦-台南",0,8,-8
"2697","2841台開","110/07/14","永豐金-中和",6,0,6
"2698","2841台開","110/07/14","康和-澎湖",0,7,-7
"2699","2841台開","110/07/14","元富-成功",5,0,5
"2700","2841台開","110/07/14","日盛-斗六",0,6,-6
"2701","6207雷科","110/07/14","群益金鼎-台北",60,0,60
"2702","6207雷科","110/07/14","新加坡商瑞銀",10,56,-46
"2703","6207雷科","110/07/14","台新-高雄",43,3,40
"2704","6207雷科","110/07/14","國票-中和",0,41,-41
"2705","6207雷科","110/07/14","元大-高雄",19,0,19
"2706","6207雷科","110/07/14","元大-復北",0,33,-33
"2707","6207雷科","110/07/14","福勝",15,0,15
"2708","6207雷科","110/07/14","光和-和美",0,20,-20
"2709","6207雷科","110/07/14","群益金鼎-中山",15,0,15
"2710","6207雷科","110/07/14","群益金鼎-丹鳳",0,20,-20
"2711","6207雷科","110/07/14","元大-林園",15,0,15
"2712","6207雷科","110/07/14","第一金-路竹",0,10,-10
"2713","6207雷科","110/07/14","新光",12,0,12
"2714","6207雷科","110/07/14","元大-歸仁",0,10,-10
"2715","6207雷科","110/07/14","元大-大天母",10,0,10
"2716","6207雷科","110/07/14","宏遠-館前",0,9,-9
"2717","6207雷科","110/07/14","永豐金-忠孝",9,0,9
"2718","6207雷科","110/07/14","凱基-台北",12,20,-8
"2719","6207雷科","110/07/14","永豐金-新店",7,0,7
"2720","6207雷科","110/07/14","美林",0,7,-7
"2721","6207雷科","110/07/14","玉山-嘉義",6,0,6
"2722","6207雷科","110/07/14","摩根大通",16,23,-7
"2723","6207雷科","110/07/14","元大-屏東",6,0,6
"2724","6207雷科","110/07/14","凱基-高雄",1,7,-6
"2725","6207雷科","110/07/14","凱基-大安",5,0,5
"2726","6207雷科","110/07/14","台中銀-豐原",0,5,-5
"2727","6207雷科","110/07/14","富邦-台南",5,0,5
"2728","6207雷科","110/07/14","元大-新竹經國",0,5,-5
"2729","6207雷科","110/07/14","元大-成功",5,0,5
"2730","6207雷科","110/07/14","光和-田中",0,4,-4
"2731","3679新至陞","110/07/14","凱基-台北",31,6,25
"2732","3679新至陞","110/07/14","群益金鼎-東大",0,15,-15
"2733","3679新至陞","110/07/14","華南永昌-新莊",10,0,10
"2734","3679新至陞","110/07/14","瑞士信貸",0,12,-12
"2735","3679新至陞","110/07/14","新加坡商瑞銀",11,3,8
"2736","3679新至陞","110/07/14","群益金鼎-永和",0,10,-10
"2737","3679新至陞","110/07/14","美商高盛",6,0,6
"2738","3679新至陞","110/07/14","元大-成功",5,15,-10
"2739","3679新至陞","110/07/14","第一金-中壢",6,0,6
"2740","3679新至陞","110/07/14","統一-板橋",1,10,-9
"2741","3679新至陞","110/07/14","(牛牛牛)亞-網路",4,0,4
"2742","3679新至陞","110/07/14","玉山-左營",0,5,-5
"2743","3679新至陞","110/07/14","元大-六合",3,0,3
"2744","3679新至陞","110/07/14","群益金鼎-三民",0,4,-4
"2745","3679新至陞","110/07/14","合庫-自強",2,0,2
"2746","3679新至陞","110/07/14","富邦-宜蘭",0,4,-4
"2747","3679新至陞","110/07/14","高橋-內壢",2,0,2
"2748","3679新至陞","110/07/14","永豐金-苓雅",0,3,-3
"2749","3679新至陞","110/07/14","台中銀-員林",2,0,2
"2750","3679新至陞","110/07/14","摩根大通",5,7,-2
"2751","3679新至陞","110/07/14","凱基-高美館",2,0,2
"2752","3679新至陞","110/07/14","元大-板橋三民",0,2,-2
"2753","3679新至陞","110/07/14","元大-福營",2,0,2
"2754","3679新至陞","110/07/14","宏遠-中和",0,1,-1
"2755","3679新至陞","110/07/14","永豐金-松山",2,0,2
"2756","3679新至陞","110/07/14","元富-佳里",0,1,-1
"2757","3679新至陞","110/07/14","永豐金-萬盛",2,0,2
"2758","3679新至陞","110/07/14","(牛牛牛)亞-鑫豐",0,1,-1
"2759","3679新至陞","110/07/14","元富-松德",1,0,1
"2760","3679新至陞","110/07/14","中國信託-中壢",0,1,-1
"2761","2727王品","110/07/14","富邦-左營",102,1,101
"2762","2727王品","110/07/14","統一-城中",100,234,-134
"2763","2727王品","110/07/14","國泰-板橋",105,11,94
"2764","2727王品","110/07/14","富邦-台北",1,125,-124
"2765","2727王品","110/07/14","港商野村",149,72,77
"2766","2727王品","110/07/14","台灣摩根士丹利",1,48,-47
"2767","2727王品","110/07/14","合庫-台中",66,2,64
"2768","2727王品","110/07/14","國票-新莊",0,40,-40
"2769","2727王品","110/07/14","臺銀-金山",63,8,55
"2770","2727王品","110/07/14","永豐金-忠孝",2,39,-37
"2771","2727王品","110/07/14","摩根大通",83,39,44
"2772","2727王品","110/07/14","富邦-彰化",1,34,-33
"2773","2727王品","110/07/14","凱基-台北",84,42,42
"2774","2727王品","110/07/14","康和-高雄",0,30,-30
"2775","2727王品","110/07/14","土銀-台中",35,1,34
"2776","2727王品","110/07/14","安泰",0,26,-26
"2777","2727王品","110/07/14","華南永昌-麻豆",32,1,31
"2778","2727王品","110/07/14","富邦-新竹華信",0,21,-21
"2779","2727王品","110/07/14","元大證券",85,55,30
"2780","2727王品","110/07/14","元大-南崁",1,22,-21
"2781","2727王品","110/07/14","新加坡商瑞銀",40,15,25
"2782","2727王品","110/07/14","彰銀-台中",0,18,-18
"2783","2727王品","110/07/14","日盛-八德",19,0,19
"2784","2727王品","110/07/14","元富-同大",2,20,-18
"2785","2727王品","110/07/14","統一",35,17,18
"2786","2727王品","110/07/14","玉山-嘉義",1,17,-16
"2787","2727王品","110/07/14","元富-大昌",18,1,17
"2788","2727王品","110/07/14","國泰-館前",4,20,-16
"2789","2727王品","110/07/14","玉山-板橋",15,1,14
"2790","2727王品","110/07/14","第一金-嘉義",1,13,-12
"2791","1570力肯","110/07/14","國票-北高雄",68,0,68
"2792","1570力肯","110/07/14","摩根大通",0,21,-21
"2793","1570力肯","110/07/14","日盛-八德",30,1,29
"2794","1570力肯","110/07/14","新光",1,19,-18
"2795","1570力肯","110/07/14","玉山-高雄",7,0,7
"2796","1570力肯","110/07/14","(牛牛牛)亞-鑫豐",0,17,-17
"2797","1570力肯","110/07/14","臺銀-臺南",5,0,5
"2798","1570力肯","110/07/14","日盛-士林",0,10,-10
"2799","1570力肯","110/07/14","凱基-三峽",5,0,5
"2800","1570力肯","110/07/14","統一-員林",0,10,-10
"2801","1570力肯","110/07/14","元大-和平",5,0,5
"2802","1570力肯","110/07/14","國票-新莊",0,10,-10
"2803","1570力肯","110/07/14","合庫-三重",4,0,4
"2804","1570力肯","110/07/14","凱基-高美館",0,10,-10
"2805","1570力肯","110/07/14","瑞士信貸",4,0,4
"2806","1570力肯","110/07/14","元大-屏東民生",0,5,-5
"2807","1570力肯","110/07/14","統一-三多",4,0,4
"2808","1570力肯","110/07/14","元大-古亭",0,5,-5
"2809","1570力肯","110/07/14","華南永昌-古亭",4,0,4
"2810","1570力肯","110/07/14","日盛-木柵",0,4,-4
"2811","1570力肯","110/07/14","元大-高雄",3,0,3
"2812","1570力肯","110/07/14","大昌",0,4,-4
"2813","1570力肯","110/07/14","兆豐-忠孝",2,0,2
"2814","1570力肯","110/07/14","群益金鼎-東大",0,4,-4
"2815","1570力肯","110/07/14","富邦-陽明",2,0,2
"2816","1570力肯","110/07/14","凱基-台北",0,4,-4
"2817","1570力肯","110/07/14","元大-松山",2,0,2
"2818","1570力肯","110/07/14","元大-板橋",0,4,-4
"2819","1570力肯","110/07/14","元大-忠孝",2,0,2
"2820","1570力肯","110/07/14","第一金-中山",0,3,-3
"2821","6180橘子","110/07/14","新加坡商瑞銀",84,28,56
"2822","6180橘子","110/07/14","凱基-台北",4,37,-33
"2823","6180橘子","110/07/14","日盛-信義",29,1,28
"2824","6180橘子","110/07/14","玉山-台南",1,22,-21
"2825","6180橘子","110/07/14","豐農",28,4,24
"2826","6180橘子","110/07/14","日盛-新竹",1,21,-20
"2827","6180橘子","110/07/14","新光-新竹",24,1,23
"2828","6180橘子","110/07/14","元富-潮州",0,19,-19
"2829","6180橘子","110/07/14","華南永昌-高雄",20,0,20
"2830","6180橘子","110/07/14","元大-信義",0,17,-17
"2831","6180橘子","110/07/14","元大-羅東",20,0,20
"2832","6180橘子","110/07/14","台灣企銀-台中",1,16,-15
"2833","6180橘子","110/07/14","元大-台中中港",20,0,20
"2834","6180橘子","110/07/14","元大-北港",0,15,-15
"2835","6180橘子","110/07/14","富邦-嘉義",24,5,19
"2836","6180橘子","110/07/14","富邦-高雄",0,14,-14
"2837","6180橘子","110/07/14","富邦-仁愛",15,0,15
"2838","6180橘子","110/07/14","兆豐-埔墘",0,13,-13
"2839","6180橘子","110/07/14","國票-九鼎",13,0,13
"2840","6180橘子","110/07/14","第一金-中山",0,10,-10
"2841","6180橘子","110/07/14","日盛-木柵",12,0,12
"2842","6180橘子","110/07/14","元大-彰化民生",0,10,-10
"2843","6180橘子","110/07/14","元大-成功",10,0,10
"2844","6180橘子","110/07/14","福勝",1,10,-9
"2845","6180橘子","110/07/14","港商野村",10,2,8
"2846","6180橘子","110/07/14","群益金鼎-丹鳳",1,10,-9
"2847","6180橘子","110/07/14","玉山-左營",8,0,8
"2848","6180橘子","110/07/14","群益金鼎-板橋",0,8,-8
"2849","6180橘子","110/07/14","富邦-陽明",16,8,8
"2850","6180橘子","110/07/14","合庫-鳳山",0,7,-7
"2851","2390云辰","110/07/14","摩根大通",995,198,797
"2852","2390云辰","110/07/14","新加坡商瑞銀",28,399,-371
"2853","2390云辰","110/07/14","美林",383,22,361
"2854","2390云辰","110/07/14","凱基-新豐",3,198,-195
"2855","2390云辰","110/07/14","台灣摩根士丹利",684,358,326
"2856","2390云辰","110/07/14","元大-士林",1,152,-151
"2857","2390云辰","110/07/14","凱基-台北",656,402,254
"2858","2390云辰","110/07/14","元大-竹山",80,181,-101
"2859","2390云辰","110/07/14","日盛-和美",110,5,105
"2860","2390云辰","110/07/14","群益金鼎-開元",19,95,-76
"2861","2390云辰","110/07/14","元大-天母",72,0,72
"2862","2390云辰","110/07/14","新光",77,150,-73
"2863","2390云辰","110/07/14","永豐金-松山",57,0,57
"2864","2390云辰","110/07/14","元富-高雄",0,71,-71
"2865","2390云辰","110/07/14","統一-屏東",53,0,53
"2866","2390云辰","110/07/14","元大-土城學府",130,201,-71
"2867","2390云辰","110/07/14","港商野村",486,450,36
"2868","2390云辰","110/07/14","元大-善化",12,76,-64
"2869","2390云辰","110/07/14","致和-崇德",30,0,30
"2870","2390云辰","110/07/14","華南永昌-岡山",23,81,-58
"2871","2390云辰","110/07/14","富邦-台北",40,14,26
"2872","2390云辰","110/07/14","群益金鼎-大興",82,125,-43
"2873","2390云辰","110/07/14","台新-高雄",38,13,25
"2874","2390云辰","110/07/14","大慶-中壢",0,41,-41
"2875","2390云辰","110/07/14","富邦-板橋",32,7,25
"2876","2390云辰","110/07/14","玉山-板橋",6,47,-41
"2877","2390云辰","110/07/14","陽信-石牌",24,0,24
"2878","2390云辰","110/07/14","富邦-台東",2,42,-40
"2879","2390云辰","110/07/14","凱基-屏東",32,8,24
"2880","2390云辰","110/07/14","元大-新營",3,42,-39
"2881","2363矽統","110/07/14","台灣摩根士丹利",463,0,463
"2882","2363矽統","110/07/14","新加坡商瑞銀",568,1321,-753
"2883","2363矽統","110/07/14","台新證券",750,342,408
"2884","2363矽統","110/07/14","瑞士信貸",149,864,-715
"2885","2363矽統","110/07/14","玉山-台中",363,51,312
"2886","2363矽統","110/07/14","台新-屏東",115,380,-265
"2887","2363矽統","110/07/14","元大-斗六",223,25,198
"2888","2363矽統","110/07/14","永豐金證券",16,265,-249
"2889","2363矽統","110/07/14","華南永昌-朴子",208,38,170
"2890","2363矽統","110/07/14","美林",462,701,-239
"2891","2363矽統","110/07/14","元富-西松",169,12,157
"2892","2363矽統","110/07/14","宏遠-桃園",269,500,-231
"2893","2363矽統","110/07/14","永豐金-大園",146,6,140
"2894","2363矽統","110/07/14","凱基-竹北",36,254,-218
"2895","2363矽統","110/07/14","土銀-和平",134,0,134
"2896","2363矽統","110/07/14","港商法國興業",0,214,-214
"2897","2363矽統","110/07/14","富邦-新營",130,13,117
"2898","2363矽統","110/07/14","港商野村",835,1044,-209
"2899","2363矽統","110/07/14","元富-成功",118,11,107
"2900","2363矽統","110/07/14","北城證券",212,411,-199
"2901","2363矽統","110/07/14","元富-烏日",121,18,103
"2902","2363矽統","110/07/14","(牛牛牛)亞-鑫豐",51,241,-190
"2903","2363矽統","110/07/14","日盛-二林",120,18,102
"2904","2363矽統","110/07/14","國票-博愛",24,213,-189
"2905","2363矽統","110/07/14","兆豐-忠孝",98,2,96
"2906","2363矽統","110/07/14","大慶-蘆洲",134,316,-182
"2907","2363矽統","110/07/14","大慶-楊梅",92,3,89
"2908","2363矽統","110/07/14","彰銀-台中",15,193,-178
"2909","2363矽統","110/07/14","元富-三重",120,33,87
"2910","2363矽統","110/07/14","日盛-和美",18,185,-167
"2911","8112至上","110/07/14","新加坡商瑞銀",223,17,206
"2912","8112至上","110/07/14","瑞士信貸",8,170,-162
"2913","8112至上","110/07/14","摩根大通",285,129,156
"2914","8112至上","110/07/14","美林",55,202,-147
"2915","8112至上","110/07/14","花旗環球",124,0,124
"2916","8112至上","110/07/14","凱基-台北",325,436,-111
"2917","8112至上","110/07/14","兆豐-公益",117,4,113
"2918","8112至上","110/07/14","台中銀-台北",0,98,-98
"2919","8112至上","110/07/14","香港上海匯豐",111,0,111
"2920","8112至上","110/07/14","玉山-台大",17,107,-90
"2921","8112至上","110/07/14","永豐金-內湖",117,21,96
"2922","8112至上","110/07/14","康和-內湖",1,90,-89
"2923","8112至上","110/07/14","台灣摩根士丹利",108,16,92
"2924","8112至上","110/07/14","港商野村",21,84,-63
"2925","8112至上","110/07/14","元大-東蘆",77,0,77
"2926","8112至上","110/07/14","兆豐-北高雄",1,60,-59
"2927","8112至上","110/07/14","新光",108,48,60
"2928","8112至上","110/07/14","群益金鼎-海山",1,52,-51
"2929","8112至上","110/07/14","大慶-蘆洲",59,0,59
"2930","8112至上","110/07/14","群益金鼎-大安",0,50,-50
"2931","8112至上","110/07/14","華南永昌-台中",56,3,53
"2932","8112至上","110/07/14","富邦-仁愛",2,49,-47
"2933","8112至上","110/07/14","土銀-嘉義",52,2,50
"2934","8112至上","110/07/14","元大-金華",0,42,-42
"2935","8112至上","110/07/14","美商高盛",40,0,40
"2936","8112至上","110/07/14","元大-內湖",4,43,-39
"2937","8112至上","110/07/14","臺銀",63,29,34
"2938","8112至上","110/07/14","第一金-華江",2,37,-35
"2939","8112至上","110/07/14","元富-嘉義",31,0,31
"2940","8112至上","110/07/14","永豐金-苓雅",2,34,-32
"2941","1570力肯","110/07/14","國票-北高雄",68,0,68
"2942","1570力肯","110/07/14","摩根大通",0,21,-21
"2943","1570力肯","110/07/14","日盛-八德",30,1,29
"2944","1570力肯","110/07/14","新光",1,19,-18
"2945","1570力肯","110/07/14","玉山-高雄",7,0,7
"2946","1570力肯","110/07/14","(牛牛牛)亞-鑫豐",0,17,-17
"2947","1570力肯","110/07/14","臺銀-臺南",5,0,5
"2948","1570力肯","110/07/14","日盛-士林",0,10,-10
"2949","1570力肯","110/07/14","凱基-三峽",5,0,5
"2950","1570力肯","110/07/14","統一-員林",0,10,-10
"2951","1570力肯","110/07/14","元大-和平",5,0,5
"2952","1570力肯","110/07/14","國票-新莊",0,10,-10
"2953","1570力肯","110/07/14","合庫-三重",4,0,4
"2954","1570力肯","110/07/14","凱基-高美館",0,10,-10
"2955","1570力肯","110/07/14","瑞士信貸",4,0,4
"2956","1570力肯","110/07/14","元大-屏東民生",0,5,-5
"2957","1570力肯","110/07/14","統一-三多",4,0,4
"2958","1570力肯","110/07/14","元大-古亭",0,5,-5
"2959","1570力肯","110/07/14","華南永昌-古亭",4,0,4
"2960","1570力肯","110/07/14","日盛-木柵",0,4,-4
"2961","1570力肯","110/07/14","元大-高雄",3,0,3
"2962","1570力肯","110/07/14","大昌",0,4,-4
"2963","1570力肯","110/07/14","兆豐-忠孝",2,0,2
"2964","1570力肯","110/07/14","群益金鼎-東大",0,4,-4
"2965","1570力肯","110/07/14","富邦-陽明",2,0,2
"2966","1570力肯","110/07/14","凱基-台北",0,4,-4
"2967","1570力肯","110/07/14","元大-松山",2,0,2
"2968","1570力肯","110/07/14","元大-板橋",0,4,-4
"2969","1570力肯","110/07/14","元大-忠孝",2,0,2
"2970","1570力肯","110/07/14","第一金-中山",0,3,-3
"2971","2929淘帝","110/07/14","華南永昌-林口",60,0,60
"2972","2929淘帝","110/07/14","群益金鼎",25,540,-515
"2973","2929淘帝","110/07/14","美林",87,31,56
"2974","2929淘帝","110/07/14","國泰-台南",1,30,-29
"2975","2929淘帝","110/07/14","元富-台南",40,0,40
"2976","2929淘帝","110/07/14","宏遠-桃園",0,20,-20
"2977","2929淘帝","110/07/14","元大-民生",39,0,39
"2978","2929淘帝","110/07/14","摩根大通",11,31,-20
"2979","2929淘帝","110/07/14","臺銀-鳳山",34,0,34
"2980","2929淘帝","110/07/14","台新-建北",5,20,-15
"2981","2929淘帝","110/07/14","合庫-高雄",34,1,33
"2982","2929淘帝","110/07/14","新光",1,16,-15
"2983","2929淘帝","110/07/14","華南永昌-鶯歌",28,0,28
"2984","2929淘帝","110/07/14","玉山-板橋",0,15,-15
"2985","2929淘帝","110/07/14","永興",25,0,25
"2986","2929淘帝","110/07/14","凱基-羅東",0,15,-15
"2987","2929淘帝","110/07/14","元大-新盛",25,1,24
"2988","2929淘帝","110/07/14","元大-頭份",0,15,-15
"2989","2929淘帝","110/07/14","日盛-南京",23,0,23
"2990","2929淘帝","110/07/14","第一金-台南",0,13,-13
"2991","2929淘帝","110/07/14","日茂",20,0,20
"2992","2929淘帝","110/07/14","富邦-基隆",0,12,-12
"2993","2929淘帝","110/07/14","台新-台中",20,0,20
"2994","2929淘帝","110/07/14","日茂-南投",1,12,-11
"2995","2929淘帝","110/07/14","華南永昌",20,0,20
"2996","2929淘帝","110/07/14","元大-豐原站前",0,11,-11
"2997","2929淘帝","110/07/14","福勝",15,0,15
"2998","2929淘帝","110/07/14","玉山-士林",0,10,-10
"2999","2929淘帝","110/07/14","富邦-南屯",15,0,15
"3000","2929淘帝","110/07/14","富邦-台北",0,10,-10
"3001","5410國眾","110/07/14","兆豐-城中",35,0,35
"3002","5410國眾","110/07/14","瑞士信貸",0,29,-29
"3003","5410國眾","110/07/14","新光",21,1,20
"3004","5410國眾","110/07/14","國泰-板橋",1,30,-29
"3005","5410國眾","110/07/14","國泰-敦南",21,1,20
"3006","5410國眾","110/07/14","日盛-高雄",0,20,-20
"3007","5410國眾","110/07/14","國泰-台中",20,1,19
"3008","5410國眾","110/07/14","台新-左楠",1,20,-19
"3009","5410國眾","110/07/14","元大-崇德",19,0,19
"3010","5410國眾","110/07/14","元富-大昌",1,18,-17
"3011","5410國眾","110/07/14","土銀-士林",18,0,18
"3012","5410國眾","110/07/14","富邦-建國",0,15,-15
"3013","5410國眾","110/07/14","元大-新盛",20,2,18
"3014","5410國眾","110/07/14","元富-嘉義",0,12,-12
"3015","5410國眾","110/07/14","兆豐-高雄",15,0,15
"3016","5410國眾","110/07/14","永全-南崁",0,12,-12
"3017","5410國眾","110/07/14","宏遠-中和",10,0,10
"3018","5410國眾","110/07/14","元大-員林",0,11,-11
"3019","5410國眾","110/07/14","新光-桃園",10,0,10
"3020","5410國眾","110/07/14","高橋",0,10,-10
"3021","5410國眾","110/07/14","國泰-台南",10,0,10
"3022","5410國眾","110/07/14","永興",0,10,-10
"3023","5410國眾","110/07/14","元大-復北",10,0,10
"3024","5410國眾","110/07/14","華南永昌-三重",0,10,-10
"3025","5410國眾","110/07/14","元大-竹科",8,0,8
"3026","5410國眾","110/07/14","元大-苑裡",0,7,-7
"3027","5410國眾","110/07/14","台新-新營",6,0,6
"3028","5410國眾","110/07/14","港商野村",0,6,-6
"3029","5410國眾","110/07/14","日盛-士林",5,0,5
"3030","5410國眾","110/07/14","摩根大通",5,11,-6
"3031","2841台開","110/07/14","凱基-文心",73,0,73
"3032","2841台開","110/07/14","國泰-敦南",0,50,-50
"3033","2841台開","110/07/14","元富-潮州",30,0,30
"3034","2841台開","110/07/14","凱基-中壢",0,40,-40
"3035","2841台開","110/07/14","第一金-台中",20,0,20
"3036","2841台開","110/07/14","統一-新竹",0,24,-24
"3037","2841台開","110/07/14","華南永昌-新莊",20,0,20
"3038","2841台開","110/07/14","元富-草屯",0,20,-20
"3039","2841台開","110/07/14","永豐金-豐原",20,0,20
"3040","2841台開","110/07/14","台新-台南",0,20,-20
"3041","2841台開","110/07/14","國泰-館前",15,0,15
"3042","2841台開","110/07/14","永豐金-敦南",45,63,-18
"3043","2841台開","110/07/14","群益金鼎-基隆",12,0,12
"3044","2841台開","110/07/14","國票-北高雄",0,13,-13
"3045","2841台開","110/07/14","日盛-信義",10,0,10
"3046","2841台開","110/07/14","凱基-松山",0,10,-10
"3047","2841台開","110/07/14","台新-台中",10,0,10
"3048","2841台開","110/07/14","元大證券",0,10,-10
"3049","2841台開","110/07/14","新光",10,1,9
"3050","2841台開","110/07/14","元大-中壢",0,10,-10
"3051","2841台開","110/07/14","凱基-新店",8,0,8
"3052","2841台開","110/07/14","富邦-陽明",1,10,-9
"3053","2841台開","110/07/14","元大-斗信",7,0,7
"3054","2841台開","110/07/14","富邦-建國",0,9,-9
"3055","2841台開","110/07/14","元大-三重",6,0,6
"3056","2841台開","110/07/14","富邦-台南",0,8,-8
"3057","2841台開","110/07/14","永豐金-中和",6,0,6
"3058","2841台開","110/07/14","康和-澎湖",0,7,-7
"3059","2841台開","110/07/14","元富-成功",5,0,5
"3060","2841台開","110/07/14","日盛-斗六",0,6,-6
"3061","6207雷科","110/07/14","群益金鼎-台北",60,0,60
"3062","6207雷科","110/07/14","新加坡商瑞銀",10,56,-46
"3063","6207雷科","110/07/14","台新-高雄",43,3,40
"3064","6207雷科","110/07/14","國票-中和",0,41,-41
"3065","6207雷科","110/07/14","元大-高雄",19,0,19
"3066","6207雷科","110/07/14","元大-復北",0,33,-33
"3067","6207雷科","110/07/14","福勝",15,0,15
"3068","6207雷科","110/07/14","光和-和美",0,20,-20
"3069","6207雷科","110/07/14","群益金鼎-中山",15,0,15
"3070","6207雷科","110/07/14","群益金鼎-丹鳳",0,20,-20
"3071","6207雷科","110/07/14","元大-林園",15,0,15
"3072","6207雷科","110/07/14","第一金-路竹",0,10,-10
"3073","6207雷科","110/07/14","新光",12,0,12
"3074","6207雷科","110/07/14","元大-歸仁",0,10,-10
"3075","6207雷科","110/07/14","元大-大天母",10,0,10
"3076","6207雷科","110/07/14","宏遠-館前",0,9,-9
"3077","6207雷科","110/07/14","永豐金-忠孝",9,0,9
"3078","6207雷科","110/07/14","凱基-台北",12,20,-8
"3079","6207雷科","110/07/14","永豐金-新店",7,0,7
"3080","6207雷科","110/07/14","美林",0,7,-7
"3081","6207雷科","110/07/14","玉山-嘉義",6,0,6
"3082","6207雷科","110/07/14","摩根大通",16,23,-7
"3083","6207雷科","110/07/14","元大-屏東",6,0,6
"3084","6207雷科","110/07/14","凱基-高雄",1,7,-6
"3085","6207雷科","110/07/14","凱基-大安",5,0,5
"3086","6207雷科","110/07/14","台中銀-豐原",0,5,-5
"3087","6207雷科","110/07/14","富邦-台南",5,0,5
"3088","6207雷科","110/07/14","元大-新竹經國",0,5,-5
"3089","6207雷科","110/07/14","元大-成功",5,0,5
"3090","6207雷科","110/07/14","光和-田中",0,4,-4
"3091","3679新至陞","110/07/14","凱基-台北",31,6,25
"3092","3679新至陞","110/07/14","群益金鼎-東大",0,15,-15
"3093","3679新至陞","110/07/14","華南永昌-新莊",10,0,10
"3094","3679新至陞","110/07/14","瑞士信貸",0,12,-12
"3095","3679新至陞","110/07/14","新加坡商瑞銀",11,3,8
"3096","3679新至陞","110/07/14","群益金鼎-永和",0,10,-10
"3097","3679新至陞","110/07/14","美商高盛",6,0,6
"3098","3679新至陞","110/07/14","元大-成功",5,15,-10
"3099","3679新至陞","110/07/14","第一金-中壢",6,0,6
"3100","3679新至陞","110/07/14","統一-板橋",1,10,-9
"3101","3679新至陞","110/07/14","(牛牛牛)亞-網路",4,0,4
"3102","3679新至陞","110/07/14","玉山-左營",0,5,-5
"3103","3679新至陞","110/07/14","元大-六合",3,0,3
"3104","3679新至陞","110/07/14","群益金鼎-三民",0,4,-4
"3105","3679新至陞","110/07/14","合庫-自強",2,0,2
"3106","3679新至陞","110/07/14","富邦-宜蘭",0,4,-4
"3107","3679新至陞","110/07/14","高橋-內壢",2,0,2
"3108","3679新至陞","110/07/14","永豐金-苓雅",0,3,-3
"3109","3679新至陞","110/07/14","台中銀-員林",2,0,2
"3110","3679新至陞","110/07/14","摩根大通",5,7,-2
"3111","3679新至陞","110/07/14","凱基-高美館",2,0,2
"3112","3679新至陞","110/07/14","元大-板橋三民",0,2,-2
"3113","3679新至陞","110/07/14","元大-福營",2,0,2
"3114","3679新至陞","110/07/14","宏遠-中和",0,1,-1
"3115","3679新至陞","110/07/14","永豐金-松山",2,0,2
"3116","3679新至陞","110/07/14","元富-佳里",0,1,-1
"3117","3679新至陞","110/07/14","永豐金-萬盛",2,0,2
"3118","3679新至陞","110/07/14","(牛牛牛)亞-鑫豐",0,1,-1
"3119","3679新至陞","110/07/14","元富-松德",1,0,1
"3120","3679新至陞","110/07/14","中國信託-中壢",0,1,-1
"3121","2727王品","110/07/14","富邦-左營",102,1,101
"3122","2727王品","110/07/14","統一-城中",100,234,-134
"3123","2727王品","110/07/14","國泰-板橋",105,11,94
"3124","2727王品","110/07/14","富邦-台北",1,125,-124
"3125","2727王品","110/07/14","港商野村",149,72,77
"3126","2727王品","110/07/14","台灣摩根士丹利",1,48,-47
"3127","2727王品","110/07/14","合庫-台中",66,2,64
"3128","2727王品","110/07/14","國票-新莊",0,40,-40
"3129","2727王品","110/07/14","臺銀-金山",63,8,55
"3130","2727王品","110/07/14","永豐金-忠孝",2,39,-37
"3131","2727王品","110/07/14","摩根大通",83,39,44
"3132","2727王品","110/07/14","富邦-彰化",1,34,-33
"3133","2727王品","110/07/14","凱基-台北",84,42,42
"3134","2727王品","110/07/14","康和-高雄",0,30,-30
"3135","2727王品","110/07/14","土銀-台中",35,1,34
"3136","2727王品","110/07/14","安泰",0,26,-26
"3137","2727王品","110/07/14","華南永昌-麻豆",32,1,31
"3138","2727王品","110/07/14","富邦-新竹華信",0,21,-21
"3139","2727王品","110/07/14","元大證券",85,55,30
"3140","2727王品","110/07/14","元大-南崁",1,22,-21
"3141","2727王品","110/07/14","新加坡商瑞銀",40,15,25
"3142","2727王品","110/07/14","彰銀-台中",0,18,-18
"3143","2727王品","110/07/14","日盛-八德",19,0,19
"3144","2727王品","110/07/14","元富-同大",2,20,-18
"3145","2727王品","110/07/14","統一",35,17,18
"3146","2727王品","110/07/14","玉山-嘉義",1,17,-16
"3147","2727王品","110/07/14","元富-大昌",18,1,17
"3148","2727王品","110/07/14","國泰-館前",4,20,-16
"3149","2727王品","110/07/14","玉山-板橋",15,1,14
"3150","2727王品","110/07/14","第一金-嘉義",1,13,-12
"3151","1570力肯","110/07/14","國票-北高雄",68,0,68
"3152","1570力肯","110/07/14","摩根大通",0,21,-21
"3153","1570力肯","110/07/14","日盛-八德",30,1,29
"3154","1570力肯","110/07/14","新光",1,19,-18
"3155","1570力肯","110/07/14","玉山-高雄",7,0,7
"3156","1570力肯","110/07/14","(牛牛牛)亞-鑫豐",0,17,-17
"3157","1570力肯","110/07/14","臺銀-臺南",5,0,5
"3158","1570力肯","110/07/14","日盛-士林",0,10,-10
"3159","1570力肯","110/07/14","凱基-三峽",5,0,5
"3160","1570力肯","110/07/14","統一-員林",0,10,-10
"3161","1570力肯","110/07/14","元大-和平",5,0,5
"3162","1570力肯","110/07/14","國票-新莊",0,10,-10
"3163","1570力肯","110/07/14","合庫-三重",4,0,4
"3164","1570力肯","110/07/14","凱基-高美館",0,10,-10
"3165","1570力肯","110/07/14","瑞士信貸",4,0,4
"3166","1570力肯","110/07/14","元大-屏東民生",0,5,-5
"3167","1570力肯","110/07/14","統一-三多",4,0,4
"3168","1570力肯","110/07/14","元大-古亭",0,5,-5
"3169","1570力肯","110/07/14","華南永昌-古亭",4,0,4
"3170","1570力肯","110/07/14","日盛-木柵",0,4,-4
"3171","1570力肯","110/07/14","元大-高雄",3,0,3
"3172","1570力肯","110/07/14","大昌",0,4,-4
"3173","1570力肯","110/07/14","兆豐-忠孝",2,0,2
"3174","1570力肯","110/07/14","群益金鼎-東大",0,4,-4
"3175","1570力肯","110/07/14","富邦-陽明",2,0,2
"3176","1570力肯","110/07/14","凱基-台北",0,4,-4
"3177","1570力肯","110/07/14","元大-松山",2,0,2
"3178","1570力肯","110/07/14","元大-板橋",0,4,-4
"3179","1570力肯","110/07/14","元大-忠孝",2,0,2
"3180","1570力肯","110/07/14","第一金-中山",0,3,-3
"3181","6180橘子","110/07/14","新加坡商瑞銀",84,28,56
"3182","6180橘子","110/07/14","凱基-台北",4,37,-33
"3183","6180橘子","110/07/14","日盛-信義",29,1,28
"3184","6180橘子","110/07/14","玉山-台南",1,22,-21
"3185","6180橘子","110/07/14","豐農",28,4,24
"3186","6180橘子","110/07/14","日盛-新竹",1,21,-20
"3187","6180橘子","110/07/14","新光-新竹",24,1,23
"3188","6180橘子","110/07/14","元富-潮州",0,19,-19
"3189","6180橘子","110/07/14","華南永昌-高雄",20,0,20
"3190","6180橘子","110/07/14","元大-信義",0,17,-17
"3191","6180橘子","110/07/14","元大-羅東",20,0,20
"3192","6180橘子","110/07/14","台灣企銀-台中",1,16,-15
"3193","6180橘子","110/07/14","元大-台中中港",20,0,20
"3194","6180橘子","110/07/14","元大-北港",0,15,-15
"3195","6180橘子","110/07/14","富邦-嘉義",24,5,19
"3196","6180橘子","110/07/14","富邦-高雄",0,14,-14
"3197","6180橘子","110/07/14","富邦-仁愛",15,0,15
"3198","6180橘子","110/07/14","兆豐-埔墘",0,13,-13
"3199","6180橘子","110/07/14","國票-九鼎",13,0,13
"3200","6180橘子","110/07/14","第一金-中山",0,10,-10
"3201","6180橘子","110/07/14","日盛-木柵",12,0,12
"3202","6180橘子","110/07/14","元大-彰化民生",0,10,-10
"3203","6180橘子","110/07/14","元大-成功",10,0,10
"3204","6180橘子","110/07/14","福勝",1,10,-9
"3205","6180橘子","110/07/14","港商野村",10,2,8
"3206","6180橘子","110/07/14","群益金鼎-丹鳳",1,10,-9
"3207","6180橘子","110/07/14","玉山-左營",8,0,8
"3208","6180橘子","110/07/14","群益金鼎-板橋",0,8,-8
"3209","6180橘子","110/07/14","富邦-陽明",16,8,8
"3210","6180橘子","110/07/14","合庫-鳳山",0,7,-7
"3211","2390云辰","110/07/14","摩根大通",995,198,797
"3212","2390云辰","110/07/14","新加坡商瑞銀",28,399,-371
"3213","2390云辰","110/07/14","美林",383,22,361
"3214","2390云辰","110/07/14","凱基-新豐",3,198,-195
"3215","2390云辰","110/07/14","台灣摩根士丹利",684,358,326
"3216","2390云辰","110/07/14","元大-士林",1,152,-151
"3217","2390云辰","110/07/14","凱基-台北",656,402,254
"3218","2390云辰","110/07/14","元大-竹山",80,181,-101
"3219","2390云辰","110/07/14","日盛-和美",110,5,105
"3220","2390云辰","110/07/14","群益金鼎-開元",19,95,-76
"3221","2390云辰","110/07/14","元大-天母",72,0,72
"3222","2390云辰","110/07/14","新光",77,150,-73
"3223","2390云辰","110/07/14","永豐金-松山",57,0,57
"3224","2390云辰","110/07/14","元富-高雄",0,71,-71
"3225","2390云辰","110/07/14","統一-屏東",53,0,53
"3226","2390云辰","110/07/14","元大-土城學府",130,201,-71
"3227","2390云辰","110/07/14","港商野村",486,450,36
"3228","2390云辰","110/07/14","元大-善化",12,76,-64
"3229","2390云辰","110/07/14","致和-崇德",30,0,30
"3230","2390云辰","110/07/14","華南永昌-岡山",23,81,-58
"3231","2390云辰","110/07/14","富邦-台北",40,14,26
"3232","2390云辰","110/07/14","群益金鼎-大興",82,125,-43
"3233","2390云辰","110/07/14","台新-高雄",38,13,25
"3234","2390云辰","110/07/14","大慶-中壢",0,41,-41
"3235","2390云辰","110/07/14","富邦-板橋",32,7,25
"3236","2390云辰","110/07/14","玉山-板橋",6,47,-41
"3237","2390云辰","110/07/14","陽信-石牌",24,0,24
"3238","2390云辰","110/07/14","富邦-台東",2,42,-40
"3239","2390云辰","110/07/14","凱基-屏東",32,8,24
"3240","2390云辰","110/07/14","元大-新營",3,42,-39
"3241","2363矽統","110/07/14","台灣摩根士丹利",463,0,463
"3242","2363矽統","110/07/14","新加坡商瑞銀",568,1321,-753
"3243","2363矽統","110/07/14","台新證券",750,342,408
"3244","2363矽統","110/07/14","瑞士信貸",149,864,-715
"3245","2363矽統","110/07/14","玉山-台中",363,51,312
"3246","2363矽統","110/07/14","台新-屏東",115,380,-265
"3247","2363矽統","110/07/14","元大-斗六",223,25,198
"3248","2363矽統","110/07/14","永豐金證券",16,265,-249
"3249","2363矽統","110/07/14","華南永昌-朴子",208,38,170
"3250","2363矽統","110/07/14","美林",462,701,-239
"3251","2363矽統","110/07/14","元富-西松",169,12,157
"3252","2363矽統","110/07/14","宏遠-桃園",269,500,-231
"3253","2363矽統","110/07/14","永豐金-大園",146,6,140
"3254","2363矽統","110/07/14","凱基-竹北",36,254,-218
"3255","2363矽統","110/07/14","土銀-和平",134,0,134
"3256","2363矽統","110/07/14","港商法國興業",0,214,-214
"3257","2363矽統","110/07/14","富邦-新營",130,13,117
"3258","2363矽統","110/07/14","港商野村",835,1044,-209
"3259","2363矽統","110/07/14","元富-成功",118,11,107
"3260","2363矽統","110/07/14","北城證券",212,411,-199
"3261","2363矽統","110/07/14","元富-烏日",121,18,103
"3262","2363矽統","110/07/14","(牛牛牛)亞-鑫豐",51,241,-190
"3263","2363矽統","110/07/14","日盛-二林",120,18,102
"3264","2363矽統","110/07/14","國票-博愛",24,213,-189
"3265","2363矽統","110/07/14","兆豐-忠孝",98,2,96
"3266","2363矽統","110/07/14","大慶-蘆洲",134,316,-182
"3267","2363矽統","110/07/14","大慶-楊梅",92,3,89
"3268","2363矽統","110/07/14","彰銀-台中",15,193,-178
"3269","2363矽統","110/07/14","元富-三重",120,33,87
"3270","2363矽統","110/07/14","日盛-和美",18,185,-167
"3271","8112至上","110/07/14","新加坡商瑞銀",223,17,206
"3272","8112至上","110/07/14","瑞士信貸",8,170,-162
"3273","8112至上","110/07/14","摩根大通",285,129,156
"3274","8112至上","110/07/14","美林",55,202,-147
"3275","8112至上","110/07/14","花旗環球",124,0,124
"3276","8112至上","110/07/14","凱基-台北",325,436,-111
"3277","8112至上","110/07/14","兆豐-公益",117,4,113
"3278","8112至上","110/07/14","台中銀-台北",0,98,-98
"3279","8112至上","110/07/14","香港上海匯豐",111,0,111
"3280","8112至上","110/07/14","玉山-台大",17,107,-90
"3281","8112至上","110/07/14","永豐金-內湖",117,21,96
"3282","8112至上","110/07/14","康和-內湖",1,90,-89
"3283","8112至上","110/07/14","台灣摩根士丹利",108,16,92
"3284","8112至上","110/07/14","港商野村",21,84,-63
"3285","8112至上","110/07/14","元大-東蘆",77,0,77
"3286","8112至上","110/07/14","兆豐-北高雄",1,60,-59
"3287","8112至上","110/07/14","新光",108,48,60
"3288","8112至上","110/07/14","群益金鼎-海山",1,52,-51
"3289","8112至上","110/07/14","大慶-蘆洲",59,0,59
"3290","8112至上","110/07/14","群益金鼎-大安",0,50,-50
"3291","8112至上","110/07/14","華南永昌-台中",56,3,53
"3292","8112至上","110/07/14","富邦-仁愛",2,49,-47
"3293","8112至上","110/07/14","土銀-嘉義",52,2,50
"3294","8112至上","110/07/14","元大-金華",0,42,-42
"3295","8112至上","110/07/14","美商高盛",40,0,40
"3296","8112至上","110/07/14","元大-內湖",4,43,-39
"3297","8112至上","110/07/14","臺銀",63,29,34
"3298","8112至上","110/07/14","第一金-華江",2,37,-35
"3299","8112至上","110/07/14","元富-嘉義",31,0,31
"3300","8112至上","110/07/14","永豐金-苓雅",2,34,-32
"3301","1570力肯","110/07/14","國票-北高雄",68,0,68
"3302","1570力肯","110/07/14","摩根大通",0,21,-21
"3303","1570力肯","110/07/14","日盛-八德",30,1,29
"3304","1570力肯","110/07/14","新光",1,19,-18
"3305","1570力肯","110/07/14","玉山-高雄",7,0,7
"3306","1570力肯","110/07/14","(牛牛牛)亞-鑫豐",0,17,-17
"3307","1570力肯","110/07/14","臺銀-臺南",5,0,5
"3308","1570力肯","110/07/14","日盛-士林",0,10,-10
"3309","1570力肯","110/07/14","凱基-三峽",5,0,5
"3310","1570力肯","110/07/14","統一-員林",0,10,-10
"3311","1570力肯","110/07/14","元大-和平",5,0,5
"3312","1570力肯","110/07/14","國票-新莊",0,10,-10
"3313","1570力肯","110/07/14","合庫-三重",4,0,4
"3314","1570力肯","110/07/14","凱基-高美館",0,10,-10
"3315","1570力肯","110/07/14","瑞士信貸",4,0,4
"3316","1570力肯","110/07/14","元大-屏東民生",0,5,-5
"3317","1570力肯","110/07/14","統一-三多",4,0,4
"3318","1570力肯","110/07/14","元大-古亭",0,5,-5
"3319","1570力肯","110/07/14","華南永昌-古亭",4,0,4
"3320","1570力肯","110/07/14","日盛-木柵",0,4,-4
"3321","1570力肯","110/07/14","元大-高雄",3,0,3
"3322","1570力肯","110/07/14","大昌",0,4,-4
"3323","1570力肯","110/07/14","兆豐-忠孝",2,0,2
"3324","1570力肯","110/07/14","群益金鼎-東大",0,4,-4
"3325","1570力肯","110/07/14","富邦-陽明",2,0,2
"3326","1570力肯","110/07/14","凱基-台北",0,4,-4
"3327","1570力肯","110/07/14","元大-松山",2,0,2
"3328","1570力肯","110/07/14","元大-板橋",0,4,-4
"3329","1570力肯","110/07/14","元大-忠孝",2,0,2
"3330","1570力肯","110/07/14","第一金-中山",0,3,-3
"3331","2929淘帝","110/07/14","華南永昌-林口",60,0,60
"3332","2929淘帝","110/07/14","群益金鼎",25,540,-515
"3333","2929淘帝","110/07/14","美林",87,31,56
"3334","2929淘帝","110/07/14","國泰-台南",1,30,-29
"3335","2929淘帝","110/07/14","元富-台南",40,0,40
"3336","2929淘帝","110/07/14","宏遠-桃園",0,20,-20
"3337","2929淘帝","110/07/14","元大-民生",39,0,39
"3338","2929淘帝","110/07/14","摩根大通",11,31,-20
"3339","2929淘帝","110/07/14","臺銀-鳳山",34,0,34
"3340","2929淘帝","110/07/14","台新-建北",5,20,-15
"3341","2929淘帝","110/07/14","合庫-高雄",34,1,33
"3342","2929淘帝","110/07/14","新光",1,16,-15
"3343","2929淘帝","110/07/14","華南永昌-鶯歌",28,0,28
"3344","2929淘帝","110/07/14","玉山-板橋",0,15,-15
"3345","2929淘帝","110/07/14","永興",25,0,25
"3346","2929淘帝","110/07/14","凱基-羅東",0,15,-15
"3347","2929淘帝","110/07/14","元大-新盛",25,1,24
"3348","2929淘帝","110/07/14","元大-頭份",0,15,-15
"3349","2929淘帝","110/07/14","日盛-南京",23,0,23
"3350","2929淘帝","110/07/14","第一金-台南",0,13,-13
"3351","2929淘帝","110/07/14","日茂",20,0,20
"3352","2929淘帝","110/07/14","富邦-基隆",0,12,-12
"3353","2929淘帝","110/07/14","台新-台中",20,0,20
"3354","2929淘帝","110/07/14","日茂-南投",1,12,-11
"3355","2929淘帝","110/07/14","華南永昌",20,0,20
"3356","2929淘帝","110/07/14","元大-豐原站前",0,11,-11
"3357","2929淘帝","110/07/14","福勝",15,0,15
"3358","2929淘帝","110/07/14","玉山-士林",0,10,-10
"3359","2929淘帝","110/07/14","富邦-南屯",15,0,15
"3360","2929淘帝","110/07/14","富邦-台北",0,10,-10
"3361","5410國眾","110/07/14","兆豐-城中",35,0,35
"3362","5410國眾","110/07/14","瑞士信貸",0,29,-29
"3363","5410國眾","110/07/14","新光",21,1,20
"3364","5410國眾","110/07/14","國泰-板橋",1,30,-29
"3365","5410國眾","110/07/14","國泰-敦南",21,1,20
"3366","5410國眾","110/07/14","日盛-高雄",0,20,-20
"3367","5410國眾","110/07/14","國泰-台中",20,1,19
"3368","5410國眾","110/07/14","台新-左楠",1,20,-19
"3369","5410國眾","110/07/14","元大-崇德",19,0,19
"3370","5410國眾","110/07/14","元富-大昌",1,18,-17
"3371","5410國眾","110/07/14","土銀-士林",18,0,18
"3372","5410國眾","110/07/14","富邦-建國",0,15,-15
"3373","5410國眾","110/07/14","元大-新盛",20,2,18
"3374","5410國眾","110/07/14","元富-嘉義",0,12,-12
"3375","5410國眾","110/07/14","兆豐-高雄",15,0,15
"3376","5410國眾","110/07/14","永全-南崁",0,12,-12
"3377","5410國眾","110/07/14","宏遠-中和",10,0,10
"3378","5410國眾","110/07/14","元大-員林",0,11,-11
"3379","5410國眾","110/07/14","新光-桃園",10,0,10
"3380","5410國眾","110/07/14","高橋",0,10,-10
"3381","5410國眾","110/07/14","國泰-台南",10,0,10
"3382","5410國眾","110/07/14","永興",0,10,-10
"3383","5410國眾","110/07/14","元大-復北",10,0,10
"3384","5410國眾","110/07/14","華南永昌-三重",0,10,-10
"3385","5410國眾","110/07/14","元大-竹科",8,0,8
"3386","5410國眾","110/07/14","元大-苑裡",0,7,-7
"3387","5410國眾","110/07/14","台新-新營",6,0,6
"3388","5410國眾","110/07/14","港商野村",0,6,-6
"3389","5410國眾","110/07/14","日盛-士林",5,0,5
"3390","5410國眾","110/07/14","摩根大通",5,11,-6
"3391","2841台開","110/07/14","凱基-文心",73,0,73
"3392","2841台開","110/07/14","國泰-敦南",0,50,-50
"3393","2841台開","110/07/14","元富-潮州",30,0,30
"3394","2841台開","110/07/14","凱基-中壢",0,40,-40
"3395","2841台開","110/07/14","第一金-台中",20,0,20
"3396","2841台開","110/07/14","統一-新竹",0,24,-24
"3397","2841台開","110/07/14","華南永昌-新莊",20,0,20
"3398","2841台開","110/07/14","元富-草屯",0,20,-20
"3399","2841台開","110/07/14","永豐金-豐原",20,0,20
"3400","2841台開","110/07/14","台新-台南",0,20,-20
"3401","2841台開","110/07/14","國泰-館前",15,0,15
"3402","2841台開","110/07/14","永豐金-敦南",45,63,-18
"3403","2841台開","110/07/14","群益金鼎-基隆",12,0,12
"3404","2841台開","110/07/14","國票-北高雄",0,13,-13
"3405","2841台開","110/07/14","日盛-信義",10,0,10
"3406","2841台開","110/07/14","凱基-松山",0,10,-10
"3407","2841台開","110/07/14","台新-台中",10,0,10
"3408","2841台開","110/07/14","元大證券",0,10,-10
"3409","2841台開","110/07/14","新光",10,1,9
"3410","2841台開","110/07/14","元大-中壢",0,10,-10
"3411","2841台開","110/07/14","凱基-新店",8,0,8
"3412","2841台開","110/07/14","富邦-陽明",1,10,-9
"3413","2841台開","110/07/14","元大-斗信",7,0,7
"3414","2841台開","110/07/14","富邦-建國",0,9,-9
"3415","2841台開","110/07/14","元大-三重",6,0,6
"3416","2841台開","110/07/14","富邦-台南",0,8,-8
"3417","2841台開","110/07/14","永豐金-中和",6,0,6
"3418","2841台開","110/07/14","康和-澎湖",0,7,-7
"3419","2841台開","110/07/14","元富-成功",5,0,5
"3420","2841台開","110/07/14","日盛-斗六",0,6,-6
"3421","6207雷科","110/07/14","群益金鼎-台北",60,0,60
"3422","6207雷科","110/07/14","新加坡商瑞銀",10,56,-46
"3423","6207雷科","110/07/14","台新-高雄",43,3,40
"3424","6207雷科","110/07/14","國票-中和",0,41,-41
"3425","6207雷科","110/07/14","元大-高雄",19,0,19
"3426","6207雷科","110/07/14","元大-復北",0,33,-33
"3427","6207雷科","110/07/14","福勝",15,0,15
"3428","6207雷科","110/07/14","光和-和美",0,20,-20
"3429","6207雷科","110/07/14","群益金鼎-中山",15,0,15
"3430","6207雷科","110/07/14","群益金鼎-丹鳳",0,20,-20
"3431","6207雷科","110/07/14","元大-林園",15,0,15
"3432","6207雷科","110/07/14","第一金-路竹",0,10,-10
"3433","6207雷科","110/07/14","新光",12,0,12
"3434","6207雷科","110/07/14","元大-歸仁",0,10,-10
"3435","6207雷科","110/07/14","元大-大天母",10,0,10
"3436","6207雷科","110/07/14","宏遠-館前",0,9,-9
"3437","6207雷科","110/07/14","永豐金-忠孝",9,0,9
"3438","6207雷科","110/07/14","凱基-台北",12,20,-8
"3439","6207雷科","110/07/14","永豐金-新店",7,0,7
"3440","6207雷科","110/07/14","美林",0,7,-7
"3441","6207雷科","110/07/14","玉山-嘉義",6,0,6
"3442","6207雷科","110/07/14","摩根大通",16,23,-7
"3443","6207雷科","110/07/14","元大-屏東",6,0,6
"3444","6207雷科","110/07/14","凱基-高雄",1,7,-6
"3445","6207雷科","110/07/14","凱基-大安",5,0,5
"3446","6207雷科","110/07/14","台中銀-豐原",0,5,-5
"3447","6207雷科","110/07/14","富邦-台南",5,0,5
"3448","6207雷科","110/07/14","元大-新竹經國",0,5,-5
"3449","6207雷科","110/07/14","元大-成功",5,0,5
"3450","6207雷科","110/07/14","光和-田中",0,4,-4
"3451","3679新至陞","110/07/14","凱基-台北",31,6,25
"3452","3679新至陞","110/07/14","群益金鼎-東大",0,15,-15
"3453","3679新至陞","110/07/14","華南永昌-新莊",10,0,10
"3454","3679新至陞","110/07/14","瑞士信貸",0,12,-12
"3455","3679新至陞","110/07/14","新加坡商瑞銀",11,3,8
"3456","3679新至陞","110/07/14","群益金鼎-永和",0,10,-10
"3457","3679新至陞","110/07/14","美商高盛",6,0,6
"3458","3679新至陞","110/07/14","元大-成功",5,15,-10
"3459","3679新至陞","110/07/14","第一金-中壢",6,0,6
"3460","3679新至陞","110/07/14","統一-板橋",1,10,-9
"3461","3679新至陞","110/07/14","(牛牛牛)亞-網路",4,0,4
"3462","3679新至陞","110/07/14","玉山-左營",0,5,-5
"3463","3679新至陞","110/07/14","元大-六合",3,0,3
"3464","3679新至陞","110/07/14","群益金鼎-三民",0,4,-4
"3465","3679新至陞","110/07/14","合庫-自強",2,0,2
"3466","3679新至陞","110/07/14","富邦-宜蘭",0,4,-4
"3467","3679新至陞","110/07/14","高橋-內壢",2,0,2
"3468","3679新至陞","110/07/14","永豐金-苓雅",0,3,-3
"3469","3679新至陞","110/07/14","台中銀-員林",2,0,2
"3470","3679新至陞","110/07/14","摩根大通",5,7,-2
"3471","3679新至陞","110/07/14","凱基-高美館",2,0,2
"3472","3679新至陞","110/07/14","元大-板橋三民",0,2,-2
"3473","3679新至陞","110/07/14","元大-福營",2,0,2
"3474","3679新至陞","110/07/14","宏遠-中和",0,1,-1
"3475","3679新至陞","110/07/14","永豐金-松山",2,0,2
"3476","3679新至陞","110/07/14","元富-佳里",0,1,-1
"3477","3679新至陞","110/07/14","永豐金-萬盛",2,0,2
"3478","3679新至陞","110/07/14","(牛牛牛)亞-鑫豐",0,1,-1
"3479","3679新至陞","110/07/14","元富-松德",1,0,1
"3480","3679新至陞","110/07/14","中國信託-中壢",0,1,-1
"3481","2727王品","110/07/14","富邦-左營",102,1,101
"3482","2727王品","110/07/14","統一-城中",100,234,-134
"3483","2727王品","110/07/14","國泰-板橋",105,11,94
"3484","2727王品","110/07/14","富邦-台北",1,125,-124
"3485","2727王品","110/07/14","港商野村",149,72,77
"3486","2727王品","110/07/14","台灣摩根士丹利",1,48,-47
"3487","2727王品","110/07/14","合庫-台中",66,2,64
"3488","2727王品","110/07/14","國票-新莊",0,40,-40
"3489","2727王品","110/07/14","臺銀-金山",63,8,55
"3490","2727王品","110/07/14","永豐金-忠孝",2,39,-37
"3491","2727王品","110/07/14","摩根大通",83,39,44
"3492","2727王品","110/07/14","富邦-彰化",1,34,-33
"3493","2727王品","110/07/14","凱基-台北",84,42,42
"3494","2727王品","110/07/14","康和-高雄",0,30,-30
"3495","2727王品","110/07/14","土銀-台中",35,1,34
"3496","2727王品","110/07/14","安泰",0,26,-26
"3497","2727王品","110/07/14","華南永昌-麻豆",32,1,31
"3498","2727王品","110/07/14","富邦-新竹華信",0,21,-21
"3499","2727王品","110/07/14","元大證券",85,55,30
"3500","2727王品","110/07/14","元大-南崁",1,22,-21
"3501","2727王品","110/07/14","新加坡商瑞銀",40,15,25
"3502","2727王品","110/07/14","彰銀-台中",0,18,-18
"3503","2727王品","110/07/14","日盛-八德",19,0,19
"3504","2727王品","110/07/14","元富-同大",2,20,-18
"3505","2727王品","110/07/14","統一",35,17,18
"3506","2727王品","110/07/14","玉山-嘉義",1,17,-16
"3507","2727王品","110/07/14","元富-大昌",18,1,17
"3508","2727王品","110/07/14","國泰-館前",4,20,-16
"3509","2727王品","110/07/14","玉山-板橋",15,1,14
"3510","2727王品","110/07/14","第一金-嘉義",1,13,-12
"3511","1570力肯","110/07/14","國票-北高雄",68,0,68
"3512","1570力肯","110/07/14","摩根大通",0,21,-21
"3513","1570力肯","110/07/14","日盛-八德",30,1,29
"3514","1570力肯","110/07/14","新光",1,19,-18
"3515","1570力肯","110/07/14","玉山-高雄",7,0,7
"3516","1570力肯","110/07/14","(牛牛牛)亞-鑫豐",0,17,-17
"3517","1570力肯","110/07/14","臺銀-臺南",5,0,5
"3518","1570力肯","110/07/14","日盛-士林",0,10,-10
"3519","1570力肯","110/07/14","凱基-三峽",5,0,5
"3520","1570力肯","110/07/14","統一-員林",0,10,-10
"3521","1570力肯","110/07/14","元大-和平",5,0,5
"3522","1570力肯","110/07/14","國票-新莊",0,10,-10
"3523","1570力肯","110/07/14","合庫-三重",4,0,4
"3524","1570力肯","110/07/14","凱基-高美館",0,10,-10
"3525","1570力肯","110/07/14","瑞士信貸",4,0,4
"3526","1570力肯","110/07/14","元大-屏東民生",0,5,-5
"3527","1570力肯","110/07/14","統一-三多",4,0,4
"3528","1570力肯","110/07/14","元大-古亭",0,5,-5
"3529","1570力肯","110/07/14","華南永昌-古亭",4,0,4
"3530","1570力肯","110/07/14","日盛-木柵",0,4,-4
"3531","1570力肯","110/07/14","元大-高雄",3,0,3
"3532","1570力肯","110/07/14","大昌",0,4,-4
"3533","1570力肯","110/07/14","兆豐-忠孝",2,0,2
"3534","1570力肯","110/07/14","群益金鼎-東大",0,4,-4
"3535","1570力肯","110/07/14","富邦-陽明",2,0,2
"3536","1570力肯","110/07/14","凱基-台北",0,4,-4
"3537","1570力肯","110/07/14","元大-松山",2,0,2
"3538","1570力肯","110/07/14","元大-板橋",0,4,-4
"3539","1570力肯","110/07/14","元大-忠孝",2,0,2
"3540","1570力肯","110/07/14","第一金-中山",0,3,-3
"3541","6180橘子","110/07/14","新加坡商瑞銀",84,28,56
"3542","6180橘子","110/07/14","凱基-台北",4,37,-33
"3543","6180橘子","110/07/14","日盛-信義",29,1,28
"3544","6180橘子","110/07/14","玉山-台南",1,22,-21
"3545","6180橘子","110/07/14","豐農",28,4,24
"3546","6180橘子","110/07/14","日盛-新竹",1,21,-20
"3547","6180橘子","110/07/14","新光-新竹",24,1,23
"3548","6180橘子","110/07/14","元富-潮州",0,19,-19
"3549","6180橘子","110/07/14","華南永昌-高雄",20,0,20
"3550","6180橘子","110/07/14","元大-信義",0,17,-17
"3551","6180橘子","110/07/14","元大-羅東",20,0,20
"3552","6180橘子","110/07/14","台灣企銀-台中",1,16,-15
"3553","6180橘子","110/07/14","元大-台中中港",20,0,20
"3554","6180橘子","110/07/14","元大-北港",0,15,-15
"3555","6180橘子","110/07/14","富邦-嘉義",24,5,19
"3556","6180橘子","110/07/14","富邦-高雄",0,14,-14
"3557","6180橘子","110/07/14","富邦-仁愛",15,0,15
"3558","6180橘子","110/07/14","兆豐-埔墘",0,13,-13
"3559","6180橘子","110/07/14","國票-九鼎",13,0,13
"3560","6180橘子","110/07/14","第一金-中山",0,10,-10
"3561","6180橘子","110/07/14","日盛-木柵",12,0,12
"3562","6180橘子","110/07/14","元大-彰化民生",0,10,-10
"3563","6180橘子","110/07/14","元大-成功",10,0,10
"3564","6180橘子","110/07/14","福勝",1,10,-9
"3565","6180橘子","110/07/14","港商野村",10,2,8
"3566","6180橘子","110/07/14","群益金鼎-丹鳳",1,10,-9
"3567","6180橘子","110/07/14","玉山-左營",8,0,8
"3568","6180橘子","110/07/14","群益金鼎-板橋",0,8,-8
"3569","6180橘子","110/07/14","富邦-陽明",16,8,8
"3570","6180橘子","110/07/14","合庫-鳳山",0,7,-7
"3571","2390云辰","110/07/14","摩根大通",995,198,797
"3572","2390云辰","110/07/14","新加坡商瑞銀",28,399,-371
"3573","2390云辰","110/07/14","美林",383,22,361
"3574","2390云辰","110/07/14","凱基-新豐",3,198,-195
"3575","2390云辰","110/07/14","台灣摩根士丹利",684,358,326
"3576","2390云辰","110/07/14","元大-士林",1,152,-151
"3577","2390云辰","110/07/14","凱基-台北",656,402,254
"3578","2390云辰","110/07/14","元大-竹山",80,181,-101
"3579","2390云辰","110/07/14","日盛-和美",110,5,105
"3580","2390云辰","110/07/14","群益金鼎-開元",19,95,-76
"3581","2390云辰","110/07/14","元大-天母",72,0,72
"3582","2390云辰","110/07/14","新光",77,150,-73
"3583","2390云辰","110/07/14","永豐金-松山",57,0,57
"3584","2390云辰","110/07/14","元富-高雄",0,71,-71
"3585","2390云辰","110/07/14","統一-屏東",53,0,53
"3586","2390云辰","110/07/14","元大-土城學府",130,201,-71
"3587","2390云辰","110/07/14","港商野村",486,450,36
"3588","2390云辰","110/07/14","元大-善化",12,76,-64
"3589","2390云辰","110/07/14","致和-崇德",30,0,30
"3590","2390云辰","110/07/14","華南永昌-岡山",23,81,-58
"3591","2390云辰","110/07/14","富邦-台北",40,14,26
"3592","2390云辰","110/07/14","群益金鼎-大興",82,125,-43
"3593","2390云辰","110/07/14","台新-高雄",38,13,25
"3594","2390云辰","110/07/14","大慶-中壢",0,41,-41
"3595","2390云辰","110/07/14","富邦-板橋",32,7,25
"3596","2390云辰","110/07/14","玉山-板橋",6,47,-41
"3597","2390云辰","110/07/14","陽信-石牌",24,0,24
"3598","2390云辰","110/07/14","富邦-台東",2,42,-40
"3599","2390云辰","110/07/14","凱基-屏東",32,8,24
"3600","2390云辰","110/07/14","元大-新營",3,42,-39
"3601","2363矽統","110/07/13","凱基-南崁",2133,63,2070
"3602","2363矽統","110/07/13","凱基-幸福",36,4048,-4012
"3603","2363矽統","110/07/13","國泰-敦南",2195,1617,578
"3604","2363矽統","110/07/13","統一",192,3325,-3133
"3605","2363矽統","110/07/13","中農",670,139,531
"3606","2363矽統","110/07/13","新加坡商瑞銀",1000,2747,-1747
"3607","2363矽統","110/07/13","康和-台中",638,154,484
"3608","2363矽統","110/07/13","凱基-台北",5359,6609,-1250
"3609","2363矽統","110/07/13","群益金鼎-三民",577,137,440
"3610","2363矽統","110/07/13","摩根大通",1930,2858,-928
"3611","2363矽統","110/07/13","台新-屏東",510,88,422
"3612","2363矽統","110/07/13","港商野村",960,1679,-719
"3613","2363矽統","110/07/13","德信-中正",455,67,388
"3614","2363矽統","110/07/13","兆豐-復興",25,705,-680
"3615","2363矽統","110/07/13","日盛-竹北",365,70,295
"3616","2363矽統","110/07/13","統一-仁愛",114,755,-641
"3617","2363矽統","110/07/13","元大-佳里",452,189,263
"3618","2363矽統","110/07/13","統一-敦南",29,638,-609
"3619","2363矽統","110/07/13","國票-博愛",296,38,258
"3620","2363矽統","110/07/13","統一-土城",100,704,-604
"3621","2363矽統","110/07/13","元大-萬華",340,95,245
"3622","2363矽統","110/07/13","統一-城中",116,676,-560
"3623","2363矽統","110/07/13","新光",1259,1031,228
"3624","2363矽統","110/07/13","永豐金證券",306,859,-553
"3625","2363矽統","110/07/13","元富-成功",323,96,227
"3626","2363矽統","110/07/13","元富",54,567,-513
"3627","2363矽統","110/07/13","豐農",228,23,205
"3628","2363矽統","110/07/13","瑞士信貸",202,666,-464
"3629","2363矽統","110/07/13","台灣企銀-岡山",186,4,182
"3630","2363矽統","110/07/13","永豐金-嘉義",67,468,-401
"3631","8112至上","110/07/13","摩根大通",688,296,392
"3632","8112至上","110/07/13","國票-中和",0,401,-401
"3633","8112至上","110/07/13","港商野村",344,145,199
"3634","8112至上","110/07/13","永豐金-板盛",0,205,-205
"3635","8112至上","110/07/13","兆豐-公益",195,5,190
"3636","8112至上","110/07/13","凱基-五股",43,155,-112
"3637","8112至上","110/07/13","台灣摩根士丹利",183,0,183
"3638","8112至上","110/07/13","凱基-市政",0,100,-100
"3639","8112至上","110/07/13","群益金鼎-敦南",153,2,151
"3640","8112至上","110/07/13","元大-大里德芳",1,92,-91
"3641","8112至上","110/07/13","臺銀-金山",146,26,120
"3642","8112至上","110/07/13","玉山-桃園",26,110,-84
"3643","8112至上","110/07/13","臺銀",133,19,114
"3644","8112至上","110/07/13","兆豐-天母",0,81,-81
"3645","8112至上","110/07/13","合庫-台中",115,6,109
"3646","8112至上","110/07/13","凱基-城中",3,84,-81
"3647","8112至上","110/07/13","亞東-板橋",134,26,108
"3648","8112至上","110/07/13","日盛-新莊",9,85,-76
"3649","8112至上","110/07/13","凱基-台北",414,326,88
"3650","8112至上","110/07/13","日盛-台中",2,64,-62
"3651","8112至上","110/07/13","新加坡商瑞銀",181,100,81
"3652","8112至上","110/07/13","日盛-中壢",3,64,-61
"3653","8112至上","110/07/13","國泰-敦南",108,31,77
"3654","8112至上","110/07/13","元大-台中",2,59,-57
"3655","8112至上","110/07/13","第一金-華江",77,4,73
"3656","8112至上","110/07/13","元大-雙和",7,64,-57
"3657","8112至上","110/07/13","永豐金-內湖",73,1,72
"3658","8112至上","110/07/13","元大-高雄",8,62,-54
"3659","8112至上","110/07/13","元大-永和",68,1,67
"3660","8112至上","110/07/13","元大-館前",2,55,-53
"3661","1570力肯","110/07/13","新光",115,11,104
"3662","1570力肯","110/07/13","元大-北三重",0,162,-162
"3663","1570力肯","110/07/13","群益金鼎-高雄",54,0,54
"3664","1570力肯","110/07/13","元大-大灣",0,25,-25
"3665","1570力肯","110/07/13","國票-新莊",22,0,22
"3666","1570力肯","110/07/13","永豐金-苓雅",0,22,-22
"3667","1570力肯","110/07/13","日盛-桃園",12,0,12
"3668","1570力肯","110/07/13","永豐金-永康",0,19,-19
"3669","1570力肯","110/07/13","元大-高雄",12,0,12
"3670","1570力肯","110/07/13","富邦-員林",0,15,-15
"3671","1570力肯","110/07/13","合庫-自強",11,0,11
"3672","1570力肯","110/07/13","凱基-台南",0,11,-11
"3673","1570力肯","110/07/13","摩根大通",26,15,11
"3674","1570力肯","110/07/13","日盛-竹北",0,10,-10
"3675","1570力肯","110/07/13","永豐金-中盛",11,0,11
"3676","1570力肯","110/07/13","國票-九鼎",0,10,-10
"3677","1570力肯","110/07/13","兆豐-台中港",10,0,10
"3678","1570力肯","110/07/13","凱基-桃園",0,10,-10
"3679","1570力肯","110/07/13","國泰-松江",9,0,9
"3680","1570力肯","110/07/13","凱基-新豐",0,10,-10
"3681","1570力肯","110/07/13","元大-新盛",9,0,9
"3682","1570力肯","110/07/13","元大-學甲",0,10,-10
"3683","1570力肯","110/07/13","元富-緯城",6,0,6
"3684","1570力肯","110/07/13","群益金鼎-東湖",1,10,-9
"3685","1570力肯","110/07/13","統一-三重",5,0,5
"3686","1570力肯","110/07/13","大昌",0,6,-6
"3687","1570力肯","110/07/13","元大-前金",5,0,5
"3688","1570力肯","110/07/13","元大-土城學府",0,6,-6
"3689","1570力肯","110/07/13","永豐金證券",5,0,5
"3690","1570力肯","110/07/13","統一",0,5,-5
"3691","2929淘帝","110/07/13","玉山-新竹",130,0,130
"3692","2929淘帝","110/07/13","美商高盛",0,177,-177
"3693","2929淘帝","110/07/13","臺銀-民權",60,0,60
"3694","2929淘帝","110/07/13","凱基-台北",6,80,-74
"3695","2929淘帝","110/07/13","新百王",31,0,31
"3696","2929淘帝","110/07/13","元富-大裕",0,49,-49
"3697","2929淘帝","110/07/13","日盛-園區",30,0,30
"3698","2929淘帝","110/07/13","國泰-館前",3,51,-48
"3699","2929淘帝","110/07/13","元大-南投",31,1,30
"3700","2929淘帝","110/07/13","凱基-中壢",0,41,-41
"3701","2929淘帝","110/07/13","兆豐-忠孝",28,0,28
"3702","2929淘帝","110/07/13","港商野村",21,55,-34
"3703","2929淘帝","110/07/13","元大-民生",28,0,28
"3704","2929淘帝","110/07/13","華南永昌-南京",2,34,-32
"3705","2929淘帝","110/07/13","合庫-高雄",27,0,27
"3706","2929淘帝","110/07/13","群益金鼎-土城",0,30,-30
"3707","2929淘帝","110/07/13","凱基-豐中",27,0,27
"3708","2929淘帝","110/07/13","富邦-南屯",0,22,-22
"3709","2929淘帝","110/07/13","新光",21,4,17
"3710","2929淘帝","110/07/13","第一金-豐原",0,20,-20
"3711","2929淘帝","110/07/13","元大-天母",17,0,17
"3712","2929淘帝","110/07/13","元大-屏南",6,26,-20
"3713","2929淘帝","110/07/13","永興",14,0,14
"3714","2929淘帝","110/07/13","永豐金-敦南",1,21,-20
"3715","2929淘帝","110/07/13","富邦-台北",12,0,12
"3716","2929淘帝","110/07/13","凱基-三重",2,21,-19
"3717","2929淘帝","110/07/13","元大-永和",12,0,12
"3718","2929淘帝","110/07/13","富邦-仁愛",7,25,-18
"3719","2929淘帝","110/07/13","國票-天祥",11,0,11
"3720","2929淘帝","110/07/13","元大-北投",0,16,-16
"3721","5410國眾","110/07/13","兆豐-城中",274,0,274
"3722","5410國眾","110/07/13","元富-嘉義",0,103,-103
"3723","5410國眾","110/07/13","新光",50,4,46
"3724","5410國眾","110/07/13","凱基-台北",0,50,-50
"3725","5410國眾","110/07/13","國泰-台中",26,0,26
"3726","5410國眾","110/07/13","瑞士信貸",0,31,-31
"3727","5410國眾","110/07/13","新加坡商瑞銀",22,0,22
"3728","5410國眾","110/07/13","台新-新莊",0,27,-27
"3729","5410國眾","110/07/13","光和-嘉義",20,0,20
"3730","5410國眾","110/07/13","元大-汐止",0,20,-20
"3731","5410國眾","110/07/13","凱基-竹北",17,0,17
"3732","5410國眾","110/07/13","亞東-新竹",0,17,-17
"3733","5410國眾","110/07/13","新光-桃園",15,0,15
"3734","5410國眾","110/07/13","元大-南勢角",0,13,-13
"3735","5410國眾","110/07/13","凱基-台東",14,0,14
"3736","5410國眾","110/07/13","台新-台南",0,12,-12
"3737","5410國眾","110/07/13","富邦-竹北",11,0,11
"3738","5410國眾","110/07/13","中國信託",0,11,-11
"3739","5410國眾","110/07/13","元富-同大",10,0,10
"3740","5410國眾","110/07/13","華南永昌",0,11,-11
"3741","5410國眾","110/07/13","國泰-敦南",24,15,9
"3742","5410國眾","110/07/13","臺銀-臺南",0,10,-10
"3743","5410國眾","110/07/13","日盛-內湖",7,0,7
"3744","5410國眾","110/07/13","台灣企銀-民雄",0,10,-10
"3745","5410國眾","110/07/13","台新-左楠",7,0,7
"3746","5410國眾","110/07/13","高橋",0,10,-10
"3747","5410國眾","110/07/13","元大-新盛",18,12,6
"3748","5410國眾","110/07/13","康和-嘉義",0,10,-10
"3749","5410國眾","110/07/13","統一",5,0,5
"3750","5410國眾","110/07/13","凱基-基隆",0,10,-10
"3751","2841台開","110/07/13","中國信託-高雄",251,50,201
"3752","2841台開","110/07/13","兆豐-公益",0,177,-177
"3753","2841台開","110/07/13","日盛證券",210,13,197
"3754","2841台開","110/07/13","日進",0,152,-152
"3755","2841台開","110/07/13","第一金-台中",55,0,55
"3756","2841台開","110/07/13","港商野村",0,109,-109
"3757","2841台開","110/07/13","國泰-板橋",46,0,46
"3758","2841台開","110/07/13","日盛-信義",0,103,-103
"3759","2841台開","110/07/13","國泰-館前",48,3,45
"3760","2841台開","110/07/13","國泰-敦南",11,75,-64
"3761","2841台開","110/07/13","華南永昌-新莊",45,0,45
"3762","2841台開","110/07/13","永興",0,50,-50
"3763","2841台開","110/07/13","日盛-園區",42,0,42
"3764","2841台開","110/07/13","永豐金-敦南",61,104,-43
"3765","2841台開","110/07/13","台新證券",32,0,32
"3766","2841台開","110/07/13","富邦-台南",0,42,-42
"3767","2841台開","110/07/13","台新-高雄",32,2,30
"3768","2841台開","110/07/13","國票-安和",0,30,-30
"3769","2841台開","110/07/13","豐農",23,0,23
"3770","2841台開","110/07/13","元大-桃園",0,25,-25
"3771","2841台開","110/07/13","合庫-嘉義",20,0,20
"3772","2841台開","110/07/13","新光",8,32,-24
"3773","2841台開","110/07/13","華南永昌-高雄",20,0,20
"3774","2841台開","110/07/13","元大-仁愛",0,24,-24
"3775","2841台開","110/07/13","元大-樹林",16,0,16
"3776","2841台開","110/07/13","日盛-中和",0,20,-20
"3777","2841台開","110/07/13","第一金-華江",15,2,13
"3778","2841台開","110/07/13","元富",0,20,-20
"3779","2841台開","110/07/13","美商高盛",12,0,12
"3780","2841台開","110/07/13","富邦-宜蘭",0,20,-20
"3781","6207雷科","110/07/13","元大-高雄",121,0,121
"3782","6207雷科","110/07/13","華南永昌-朴子",1,60,-59
"3783","6207雷科","110/07/13","第一金-新興",20,0,20
"3784","6207雷科","110/07/13","元大-南海",0,36,-36
"3785","6207雷科","110/07/13","元富-三重",20,0,20
"3786","6207雷科","110/07/13","凱基-土城",0,35,-35
"3787","6207雷科","110/07/13","元大-林園",15,0,15
"3788","6207雷科","110/07/13","台灣企銀",0,20,-20
"3789","6207雷科","110/07/13","元大-金華",16,1,15
"3790","6207雷科","110/07/13","群益金鼎-丹鳳",0,20,-20
"3791","6207雷科","110/07/13","日盛證券",10,0,10
"3792","6207雷科","110/07/13","元大-博愛",0,17,-17
"3793","6207雷科","110/07/13","統一-台中",10,0,10
"3794","6207雷科","110/07/13","元大-北港",0,13,-13
"3795","6207雷科","110/07/13","群益金鼎-土城",10,0,10
"3796","6207雷科","110/07/13","新加坡商瑞銀",0,12,-12
"3797","6207雷科","110/07/13","群益金鼎-桃園",10,0,10
"3798","6207雷科","110/07/13","凱基-台北",4,16,-12
"3799","6207雷科","110/07/13","永豐金-新莊",10,0,10
"3800","6207雷科","110/07/13","日茂-埔里",0,11,-11
"3801","6207雷科","110/07/13","永豐金-新店",10,0,10
"3802","6207雷科","110/07/13","元大-莒光",0,11,-11
"3803","6207雷科","110/07/13","元大證券",9,0,9
"3804","6207雷科","110/07/13","統一-新竹",0,10,-10
"3805","6207雷科","110/07/13","日盛-木柵",9,1,8
"3806","6207雷科","110/07/13","元大-西螺",0,10,-10
"3807","6207雷科","110/07/13","兆豐-來福",8,0,8
"3808","6207雷科","110/07/13","康和-台中",0,8,-8
"3809","6207雷科","110/07/13","新光",7,0,7
"3810","6207雷科","110/07/13","兆豐-高雄",0,6,-6
"3811","3679新至陞","110/07/13","永豐金證券",50,0,50
"3812","3679新至陞","110/07/13","摩根大通",2,25,-23
"3813","3679新至陞","110/07/13","國泰-桃園",22,0,22
"3814","3679新至陞","110/07/13","元大-成功",0,22,-22
"3815","3679新至陞","110/07/13","台中銀-員林",11,0,11
"3816","3679新至陞","110/07/13","富邦-板橋",1,19,-18
"3817","3679新至陞","110/07/13","元大-文心興安",8,0,8
"3818","3679新至陞","110/07/13","日盛-新莊",0,10,-10
"3819","3679新至陞","110/07/13","美商高盛",6,0,6
"3820","3679新至陞","110/07/13","台新-台中",0,10,-10
"3821","3679新至陞","110/07/13","台新-高雄",6,0,6
"3822","3679新至陞","110/07/13","永豐金-新竹",0,8,-8
"3823","3679新至陞","110/07/13","凱基-台北",18,12,6
"3824","3679新至陞","110/07/13","瑞士信貸",12,19,-7
"3825","3679新至陞","110/07/13","日盛-復興",5,0,5
"3826","3679新至陞","110/07/13","統一-南京",0,7,-7
"3827","3679新至陞","110/07/13","(牛牛牛)亞-鑫豐",4,0,4
"3828","3679新至陞","110/07/13","凱基-新莊",0,7,-7
"3829","3679新至陞","110/07/13","元富-大昌",3,0,3
"3830","3679新至陞","110/07/13","新加坡商瑞銀",0,6,-6
"3831","3679新至陞","110/07/13","富邦-台北",3,0,3
"3832","3679新至陞","110/07/13","合庫-自強",0,5,-5
"3833","3679新至陞","110/07/13","日盛-樹林",2,0,2
"3834","3679新至陞","110/07/13","富邦-桃園",0,5,-5
"3835","3679新至陞","110/07/13","宏遠-光隆",2,0,2
"3836","3679新至陞","110/07/13","永豐金-潮州",0,4,-4
"3837","3679新至陞","110/07/13","美林",3,1,2
"3838","3679新至陞","110/07/13","臺銀-臺南",0,3,-3
"3839","3679新至陞","110/07/13","第一金-中壢",2,0,2
"3840","3679新至陞","110/07/13","元大-六合",0,3,-3
"3841","2727王品","110/07/13","富邦-台北",43,3,40
"3842","2727王品","110/07/13","台灣摩根士丹利",15,97,-82
"3843","2727王品","110/07/13","元大-基隆孝二",40,0,40
"3844","2727王品","110/07/13","玉山-台南",5,57,-52
"3845","2727王品","110/07/13","國票-新莊",40,1,39
"3846","2727王品","110/07/13","新加坡商瑞銀",0,48,-48
"3847","2727王品","110/07/13","第一金-豐原",66,42,24
"3848","2727王品","110/07/13","凱基-台北",41,77,-36
"3849","2727王品","110/07/13","永豐金-大園",34,10,24
"3850","2727王品","110/07/13","永豐金-永康",0,22,-22
"3851","2727王品","110/07/13","元大-北屯",22,0,22
"3852","2727王品","110/07/13","統一-台中",2,22,-20
"3853","2727王品","110/07/13","元大-東蘆",26,7,19
"3854","2727王品","110/07/13","國泰-台中",21,39,-18
"3855","2727王品","110/07/13","永豐金-萬盛",13,1,12
"3856","2727王品","110/07/13","合庫-彰化",3,20,-17
"3857","2727王品","110/07/13","日盛-嘉義",11,0,11
"3858","2727王品","110/07/13","港商野村",13,30,-17
"3859","2727王品","110/07/13","日盛-八德",11,0,11
"3860","2727王品","110/07/13","元大-楊梅",1,16,-15
"3861","2727王品","110/07/13","統一-竹南",11,0,11
"3862","2727王品","110/07/13","凱基-高美館",2,15,-13
"3863","2727王品","110/07/13","日盛-士林",12,2,10
"3864","2727王品","110/07/13","美商高盛",2,14,-12
"3865","2727王品","110/07/13","統一-敦南",10,0,10
"3866","2727王品","110/07/13","統一-平鎮",1,13,-12
"3867","2727王品","110/07/13","中國信託",15,5,10
"3868","2727王品","110/07/13","兆豐-台中港",4,16,-12
"3869","2727王品","110/07/13","兆豐-竹北",13,3,10
"3870","2727王品","110/07/13","凱基-八德",1,13,-12
"3871","1570力肯","110/07/13","新光",115,11,104
"3872","1570力肯","110/07/13","元大-北三重",0,162,-162
"3873","1570力肯","110/07/13","群益金鼎-高雄",54,0,54
"3874","1570力肯","110/07/13","元大-大灣",0,25,-25
"3875","1570力肯","110/07/13","國票-新莊",22,0,22
"3876","1570力肯","110/07/13","永豐金-苓雅",0,22,-22
"3877","1570力肯","110/07/13","日盛-桃園",12,0,12
"3878","1570力肯","110/07/13","永豐金-永康",0,19,-19
"3879","1570力肯","110/07/13","元大-高雄",12,0,12
"3880","1570力肯","110/07/13","富邦-員林",0,15,-15
"3881","1570力肯","110/07/13","合庫-自強",11,0,11
"3882","1570力肯","110/07/13","凱基-台南",0,11,-11
"3883","1570力肯","110/07/13","摩根大通",26,15,11
"3884","1570力肯","110/07/13","日盛-竹北",0,10,-10
"3885","1570力肯","110/07/13","永豐金-中盛",11,0,11
"3886","1570力肯","110/07/13","國票-九鼎",0,10,-10
"3887","1570力肯","110/07/13","兆豐-台中港",10,0,10
"3888","1570力肯","110/07/13","凱基-桃園",0,10,-10
"3889","1570力肯","110/07/13","國泰-松江",9,0,9
"3890","1570力肯","110/07/13","凱基-新豐",0,10,-10
"3891","1570力肯","110/07/13","元大-新盛",9,0,9
"3892","1570力肯","110/07/13","元大-學甲",0,10,-10
"3893","1570力肯","110/07/13","元富-緯城",6,0,6
"3894","1570力肯","110/07/13","群益金鼎-東湖",1,10,-9
"3895","1570力肯","110/07/13","統一-三重",5,0,5
"3896","1570力肯","110/07/13","大昌",0,6,-6
"3897","1570力肯","110/07/13","元大-前金",5,0,5
"3898","1570力肯","110/07/13","元大-土城學府",0,6,-6
"3899","1570力肯","110/07/13","永豐金證券",5,0,5
"3900","1570力肯","110/07/13","統一",0,5,-5
"3901","6180橘子","110/07/13","摩根大通",119,0,119
"3902","6180橘子","110/07/13","元大-崇德",2,61,-59
"3903","6180橘子","110/07/13","美商高盛",96,0,96
"3904","6180橘子","110/07/13","康和-台中",0,51,-51
"3905","6180橘子","110/07/13","新加坡商瑞銀",86,7,79
"3906","6180橘子","110/07/13","康和-台北",0,50,-50
"3907","6180橘子","110/07/13","元大-和平",40,0,40
"3908","6180橘子","110/07/13","元富-潮州",0,40,-40
"3909","6180橘子","110/07/13","凱基-台北",83,47,36
"3910","6180橘子","110/07/13","日盛-永康",0,26,-26
"3911","6180橘子","110/07/13","美林",39,5,34
"3912","6180橘子","110/07/13","永豐金-中正",0,24,-24
"3913","6180橘子","110/07/13","富邦-新竹華信",31,2,29
"3914","6180橘子","110/07/13","國泰-板橋",2,25,-23
"3915","6180橘子","110/07/13","統一-南京",21,0,21
"3916","6180橘子","110/07/13","日盛-大墩",0,20,-20
"3917","6180橘子","110/07/13","富邦-陽明",24,3,21
"3918","6180橘子","110/07/13","元大-草屯",13,32,-19
"3919","6180橘子","110/07/13","大昌-樹林",21,1,20
"3920","6180橘子","110/07/13","元富-林園",1,18,-17
"3921","6180橘子","110/07/13","花旗環球",19,0,19
"3922","6180橘子","110/07/13","新光-新竹",1,18,-17
"3923","6180橘子","110/07/13","華南永昌-台南",19,0,19
"3924","6180橘子","110/07/13","元大-土城永寧",0,17,-17
"3925","6180橘子","110/07/13","福勝",14,0,14
"3926","6180橘子","110/07/13","國泰-新莊",3,19,-16
"3927","6180橘子","110/07/13","富邦-嘉義",12,1,11
"3928","6180橘子","110/07/13","中國信託-永康",6,21,-15
"3929","6180橘子","110/07/13","元大-板橋三民",11,0,11
"3930","6180橘子","110/07/13","凱基-東港",1,15,-14
"3931","2390云辰","110/07/13","新加坡商瑞銀",562,75,487
"3932","2390云辰","110/07/13","大展-台南",0,532,-532
"3933","2390云辰","110/07/13","台灣摩根士丹利",330,155,175
"3934","2390云辰","110/07/13","凱基-台北",668,854,-186
"3935","2390云辰","110/07/13","兆豐-公益",126,25,101
"3936","2390云辰","110/07/13","凱基-三重",12,172,-160
"3937","2390云辰","110/07/13","元富-中港",100,2,98
"3938","2390云辰","110/07/13","兆豐-忠孝",4,161,-157
"3939","2390云辰","110/07/13","統一-新台中",106,9,97
"3940","2390云辰","110/07/13","元大-士林",19,170,-151
"3941","2390云辰","110/07/13","中國信託-松江",81,11,70
"3942","2390云辰","110/07/13","臺銀-新竹",14,117,-103
"3943","2390云辰","110/07/13","日盛-板橋",72,3,69
"3944","2390云辰","110/07/13","國票-台中",4,102,-98
"3945","2390云辰","110/07/13","日盛-和美",57,0,57
"3946","2390云辰","110/07/13","新光",147,232,-85
"3947","2390云辰","110/07/13","永豐金-桃園",88,36,52
"3948","2390云辰","110/07/13","致和-崇德",2,70,-68
"3949","2390云辰","110/07/13","玉山-士林",54,4,50
"3950","2390云辰","110/07/13","群益金鼎-屏東",2,70,-68
"3951","2390云辰","110/07/13","富邦-仁愛",56,6,50
"3952","2390云辰","110/07/13","元大-大里",35,98,-63
"3953","2390云辰","110/07/13","第一金-豐原",50,1,49
"3954","2390云辰","110/07/13","元大-萬華",35,94,-59
"3955","2390云辰","110/07/13","摩根大通",502,453,49
"3956","2390云辰","110/07/13","元富-吉利",2,60,-58
"3957","2390云辰","110/07/13","凱基-松山",61,13,48
"3958","2390云辰","110/07/13","兆豐-新竹",3,53,-50
"3959","2390云辰","110/07/13","大昌",64,22,42
"3960","2390云辰","110/07/13","富邦-嘉義",65,108,-43
"3961","2363矽統","110/07/13","凱基-南崁",2133,63,2070
"3962","2363矽統","110/07/13","凱基-幸福",36,4048,-4012
"3963","2363矽統","110/07/13","國泰-敦南",2195,1617,578
"3964","2363矽統","110/07/13","統一",192,3325,-3133
"3965","2363矽統","110/07/13","中農",670,139,531
"3966","2363矽統","110/07/13","新加坡商瑞銀",1000,2747,-1747
"3967","2363矽統","110/07/13","康和-台中",638,154,484
"3968","2363矽統","110/07/13","凱基-台北",5359,6609,-1250
"3969","2363矽統","110/07/13","群益金鼎-三民",577,137,440
"3970","2363矽統","110/07/13","摩根大通",1930,2858,-928
"3971","2363矽統","110/07/13","台新-屏東",510,88,422
"3972","2363矽統","110/07/13","港商野村",960,1679,-719
"3973","2363矽統","110/07/13","德信-中正",455,67,388
"3974","2363矽統","110/07/13","兆豐-復興",25,705,-680
"3975","2363矽統","110/07/13","日盛-竹北",365,70,295
"3976","2363矽統","110/07/13","統一-仁愛",114,755,-641
"3977","2363矽統","110/07/13","元大-佳里",452,189,263
"3978","2363矽統","110/07/13","統一-敦南",29,638,-609
"3979","2363矽統","110/07/13","國票-博愛",296,38,258
"3980","2363矽統","110/07/13","統一-土城",100,704,-604
"3981","2363矽統","110/07/13","元大-萬華",340,95,245
"3982","2363矽統","110/07/13","統一-城中",116,676,-560
"3983","2363矽統","110/07/13","新光",1259,1031,228
"3984","2363矽統","110/07/13","永豐金證券",306,859,-553
"3985","2363矽統","110/07/13","元富-成功",323,96,227
"3986","2363矽統","110/07/13","元富",54,567,-513
"3987","2363矽統","110/07/13","豐農",228,23,205
"3988","2363矽統","110/07/13","瑞士信貸",202,666,-464
"3989","2363矽統","110/07/13","台灣企銀-岡山",186,4,182
"3990","2363矽統","110/07/13","永豐金-嘉義",67,468,-401
"3991","8112至上","110/07/13","摩根大通",688,296,392
"3992","8112至上","110/07/13","國票-中和",0,401,-401
"3993","8112至上","110/07/13","港商野村",344,145,199
"3994","8112至上","110/07/13","永豐金-板盛",0,205,-205
"3995","8112至上","110/07/13","兆豐-公益",195,5,190
"3996","8112至上","110/07/13","凱基-五股",43,155,-112
"3997","8112至上","110/07/13","台灣摩根士丹利",183,0,183
"3998","8112至上","110/07/13","凱基-市政",0,100,-100
"3999","8112至上","110/07/13","群益金鼎-敦南",153,2,151
"4000","8112至上","110/07/13","元大-大里德芳",1,92,-91
"4001","8112至上","110/07/13","臺銀-金山",146,26,120
"4002","8112至上","110/07/13","玉山-桃園",26,110,-84
"4003","8112至上","110/07/13","臺銀",133,19,114
"4004","8112至上","110/07/13","兆豐-天母",0,81,-81
"4005","8112至上","110/07/13","合庫-台中",115,6,109
"4006","8112至上","110/07/13","凱基-城中",3,84,-81
"4007","8112至上","110/07/13","亞東-板橋",134,26,108
"4008","8112至上","110/07/13","日盛-新莊",9,85,-76
"4009","8112至上","110/07/13","凱基-台北",414,326,88
"4010","8112至上","110/07/13","日盛-台中",2,64,-62
"4011","8112至上","110/07/13","新加坡商瑞銀",181,100,81
"4012","8112至上","110/07/13","日盛-中壢",3,64,-61
"4013","8112至上","110/07/13","國泰-敦南",108,31,77
"4014","8112至上","110/07/13","元大-台中",2,59,-57
"4015","8112至上","110/07/13","第一金-華江",77,4,73
"4016","8112至上","110/07/13","元大-雙和",7,64,-57
"4017","8112至上","110/07/13","永豐金-內湖",73,1,72
"4018","8112至上","110/07/13","元大-高雄",8,62,-54
"4019","8112至上","110/07/13","元大-永和",68,1,67
"4020","8112至上","110/07/13","元大-館前",2,55,-53
"4021","1570力肯","110/07/13","新光",115,11,104
"4022","1570力肯","110/07/13","元大-北三重",0,162,-162
"4023","1570力肯","110/07/13","群益金鼎-高雄",54,0,54
"4024","1570力肯","110/07/13","元大-大灣",0,25,-25
"4025","1570力肯","110/07/13","國票-新莊",22,0,22
"4026","1570力肯","110/07/13","永豐金-苓雅",0,22,-22
"4027","1570力肯","110/07/13","日盛-桃園",12,0,12
"4028","1570力肯","110/07/13","永豐金-永康",0,19,-19
"4029","1570力肯","110/07/13","元大-高雄",12,0,12
"4030","1570力肯","110/07/13","富邦-員林",0,15,-15
"4031","1570力肯","110/07/13","合庫-自強",11,0,11
"4032","1570力肯","110/07/13","凱基-台南",0,11,-11
"4033","1570力肯","110/07/13","摩根大通",26,15,11
"4034","1570力肯","110/07/13","日盛-竹北",0,10,-10
"4035","1570力肯","110/07/13","永豐金-中盛",11,0,11
"4036","1570力肯","110/07/13","國票-九鼎",0,10,-10
"4037","1570力肯","110/07/13","兆豐-台中港",10,0,10
"4038","1570力肯","110/07/13","凱基-桃園",0,10,-10
"4039","1570力肯","110/07/13","國泰-松江",9,0,9
"4040","1570力肯","110/07/13","凱基-新豐",0,10,-10
"4041","1570力肯","110/07/13","元大-新盛",9,0,9
"4042","1570力肯","110/07/13","元大-學甲",0,10,-10
"4043","1570力肯","110/07/13","元富-緯城",6,0,6
"4044","1570力肯","110/07/13","群益金鼎-東湖",1,10,-9
"4045","1570力肯","110/07/13","統一-三重",5,0,5
"4046","1570力肯","110/07/13","大昌",0,6,-6
"4047","1570力肯","110/07/13","元大-前金",5,0,5
"4048","1570力肯","110/07/13","元大-土城學府",0,6,-6
"4049","1570力肯","110/07/13","永豐金證券",5,0,5
"4050","1570力肯","110/07/13","統一",0,5,-5
"4051","2929淘帝","110/07/13","玉山-新竹",130,0,130
"4052","2929淘帝","110/07/13","美商高盛",0,177,-177
"4053","2929淘帝","110/07/13","臺銀-民權",60,0,60
"4054","2929淘帝","110/07/13","凱基-台北",6,80,-74
"4055","2929淘帝","110/07/13","新百王",31,0,31
"4056","2929淘帝","110/07/13","元富-大裕",0,49,-49
"4057","2929淘帝","110/07/13","日盛-園區",30,0,30
"4058","2929淘帝","110/07/13","國泰-館前",3,51,-48
"4059","2929淘帝","110/07/13","元大-南投",31,1,30
"4060","2929淘帝","110/07/13","凱基-中壢",0,41,-41
"4061","2929淘帝","110/07/13","兆豐-忠孝",28,0,28
"4062","2929淘帝","110/07/13","港商野村",21,55,-34
"4063","2929淘帝","110/07/13","元大-民生",28,0,28
"4064","2929淘帝","110/07/13","華南永昌-南京",2,34,-32
"4065","2929淘帝","110/07/13","合庫-高雄",27,0,27
"4066","2929淘帝","110/07/13","群益金鼎-土城",0,30,-30
"4067","2929淘帝","110/07/13","凱基-豐中",27,0,27
"4068","2929淘帝","110/07/13","富邦-南屯",0,22,-22
"4069","2929淘帝","110/07/13","新光",21,4,17
"4070","2929淘帝","110/07/13","第一金-豐原",0,20,-20
"4071","2929淘帝","110/07/13","元大-天母",17,0,17
"4072","2929淘帝","110/07/13","元大-屏南",6,26,-20
"4073","2929淘帝","110/07/13","永興",14,0,14
"4074","2929淘帝","110/07/13","永豐金-敦南",1,21,-20
"4075","2929淘帝","110/07/13","富邦-台北",12,0,12
"4076","2929淘帝","110/07/13","凱基-三重",2,21,-19
"4077","2929淘帝","110/07/13","元大-永和",12,0,12
"4078","2929淘帝","110/07/13","富邦-仁愛",7,25,-18
"4079","2929淘帝","110/07/13","國票-天祥",11,0,11
"4080","2929淘帝","110/07/13","元大-北投",0,16,-16
"4081","5410國眾","110/07/13","兆豐-城中",274,0,274
"4082","5410國眾","110/07/13","元富-嘉義",0,103,-103
"4083","5410國眾","110/07/13","新光",50,4,46
"4084","5410國眾","110/07/13","凱基-台北",0,50,-50
"4085","5410國眾","110/07/13","國泰-台中",26,0,26
"4086","5410國眾","110/07/13","瑞士信貸",0,31,-31
"4087","5410國眾","110/07/13","新加坡商瑞銀",22,0,22
"4088","5410國眾","110/07/13","台新-新莊",0,27,-27
"4089","5410國眾","110/07/13","光和-嘉義",20,0,20
"4090","5410國眾","110/07/13","元大-汐止",0,20,-20
"4091","5410國眾","110/07/13","凱基-竹北",17,0,17
"4092","5410國眾","110/07/13","亞東-新竹",0,17,-17
"4093","5410國眾","110/07/13","新光-桃園",15,0,15
"4094","5410國眾","110/07/13","元大-南勢角",0,13,-13
"4095","5410國眾","110/07/13","凱基-台東",14,0,14
"4096","5410國眾","110/07/13","台新-台南",0,12,-12
"4097","5410國眾","110/07/13","富邦-竹北",11,0,11
"4098","5410國眾","110/07/13","中國信託",0,11,-11
"4099","5410國眾","110/07/13","元富-同大",10,0,10
"4100","5410國眾","110/07/13","華南永昌",0,11,-11
"4101","5410國眾","110/07/13","國泰-敦南",24,15,9
"4102","5410國眾","110/07/13","臺銀-臺南",0,10,-10
"4103","5410國眾","110/07/13","日盛-內湖",7,0,7
"4104","5410國眾","110/07/13","台灣企銀-民雄",0,10,-10
"4105","5410國眾","110/07/13","台新-左楠",7,0,7
"4106","5410國眾","110/07/13","高橋",0,10,-10
"4107","5410國眾","110/07/13","元大-新盛",18,12,6
"4108","5410國眾","110/07/13","康和-嘉義",0,10,-10
"4109","5410國眾","110/07/13","統一",5,0,5
"4110","5410國眾","110/07/13","凱基-基隆",0,10,-10
"4111","2841台開","110/07/13","中國信託-高雄",251,50,201
"4112","2841台開","110/07/13","兆豐-公益",0,177,-177
"4113","2841台開","110/07/13","日盛證券",210,13,197
"4114","2841台開","110/07/13","日進",0,152,-152
"4115","2841台開","110/07/13","第一金-台中",55,0,55
"4116","2841台開","110/07/13","港商野村",0,109,-109
"4117","2841台開","110/07/13","國泰-板橋",46,0,46
"4118","2841台開","110/07/13","日盛-信義",0,103,-103
"4119","2841台開","110/07/13","國泰-館前",48,3,45
"4120","2841台開","110/07/13","國泰-敦南",11,75,-64
"4121","2841台開","110/07/13","華南永昌-新莊",45,0,45
"4122","2841台開","110/07/13","永興",0,50,-50
"4123","2841台開","110/07/13","日盛-園區",42,0,42
"4124","2841台開","110/07/13","永豐金-敦南",61,104,-43
"4125","2841台開","110/07/13","台新證券",32,0,32
"4126","2841台開","110/07/13","富邦-台南",0,42,-42
"4127","2841台開","110/07/13","台新-高雄",32,2,30
"4128","2841台開","110/07/13","國票-安和",0,30,-30
"4129","2841台開","110/07/13","豐農",23,0,23
"4130","2841台開","110/07/13","元大-桃園",0,25,-25
"4131","2841台開","110/07/13","合庫-嘉義",20,0,20
"4132","2841台開","110/07/13","新光",8,32,-24
"4133","2841台開","110/07/13","華南永昌-高雄",20,0,20
"4134","2841台開","110/07/13","元大-仁愛",0,24,-24
"4135","2841台開","110/07/13","元大-樹林",16,0,16
"4136","2841台開","110/07/13","日盛-中和",0,20,-20
"4137","2841台開","110/07/13","第一金-華江",15,2,13
"4138","2841台開","110/07/13","元富",0,20,-20
"4139","2841台開","110/07/13","美商高盛",12,0,12
"4140","2841台開","110/07/13","富邦-宜蘭",0,20,-20
"4141","6207雷科","110/07/13","元大-高雄",121,0,121
"4142","6207雷科","110/07/13","華南永昌-朴子",1,60,-59
"4143","6207雷科","110/07/13","第一金-新興",20,0,20
"4144","6207雷科","110/07/13","元大-南海",0,36,-36
"4145","6207雷科","110/07/13","元富-三重",20,0,20
"4146","6207雷科","110/07/13","凱基-土城",0,35,-35
"4147","6207雷科","110/07/13","元大-林園",15,0,15
"4148","6207雷科","110/07/13","台灣企銀",0,20,-20
"4149","6207雷科","110/07/13","元大-金華",16,1,15
"4150","6207雷科","110/07/13","群益金鼎-丹鳳",0,20,-20
"4151","6207雷科","110/07/13","日盛證券",10,0,10
"4152","6207雷科","110/07/13","元大-博愛",0,17,-17
"4153","6207雷科","110/07/13","統一-台中",10,0,10
"4154","6207雷科","110/07/13","元大-北港",0,13,-13
"4155","6207雷科","110/07/13","群益金鼎-土城",10,0,10
"4156","6207雷科","110/07/13","新加坡商瑞銀",0,12,-12
"4157","6207雷科","110/07/13","群益金鼎-桃園",10,0,10
"4158","6207雷科","110/07/13","凱基-台北",4,16,-12
"4159","6207雷科","110/07/13","永豐金-新莊",10,0,10
"4160","6207雷科","110/07/13","日茂-埔里",0,11,-11
"4161","6207雷科","110/07/13","永豐金-新店",10,0,10
"4162","6207雷科","110/07/13","元大-莒光",0,11,-11
"4163","6207雷科","110/07/13","元大證券",9,0,9
"4164","6207雷科","110/07/13","統一-新竹",0,10,-10
"4165","6207雷科","110/07/13","日盛-木柵",9,1,8
"4166","6207雷科","110/07/13","元大-西螺",0,10,-10
"4167","6207雷科","110/07/13","兆豐-來福",8,0,8
"4168","6207雷科","110/07/13","康和-台中",0,8,-8
"4169","6207雷科","110/07/13","新光",7,0,7
"4170","6207雷科","110/07/13","兆豐-高雄",0,6,-6
"4171","3679新至陞","110/07/13","永豐金證券",50,0,50
"4172","3679新至陞","110/07/13","摩根大通",2,25,-23
"4173","3679新至陞","110/07/13","國泰-桃園",22,0,22
"4174","3679新至陞","110/07/13","元大-成功",0,22,-22
"4175","3679新至陞","110/07/13","台中銀-員林",11,0,11
"4176","3679新至陞","110/07/13","富邦-板橋",1,19,-18
"4177","3679新至陞","110/07/13","元大-文心興安",8,0,8
"4178","3679新至陞","110/07/13","日盛-新莊",0,10,-10
"4179","3679新至陞","110/07/13","美商高盛",6,0,6
"4180","3679新至陞","110/07/13","台新-台中",0,10,-10
"4181","3679新至陞","110/07/13","台新-高雄",6,0,6
"4182","3679新至陞","110/07/13","永豐金-新竹",0,8,-8
"4183","3679新至陞","110/07/13","凱基-台北",18,12,6
"4184","3679新至陞","110/07/13","瑞士信貸",12,19,-7
"4185","3679新至陞","110/07/13","日盛-復興",5,0,5
"4186","3679新至陞","110/07/13","統一-南京",0,7,-7
"4187","3679新至陞","110/07/13","(牛牛牛)亞-鑫豐",4,0,4
"4188","3679新至陞","110/07/13","凱基-新莊",0,7,-7
"4189","3679新至陞","110/07/13","元富-大昌",3,0,3
"4190","3679新至陞","110/07/13","新加坡商瑞銀",0,6,-6
"4191","3679新至陞","110/07/13","富邦-台北",3,0,3
"4192","3679新至陞","110/07/13","合庫-自強",0,5,-5
"4193","3679新至陞","110/07/13","日盛-樹林",2,0,2
"4194","3679新至陞","110/07/13","富邦-桃園",0,5,-5
"4195","3679新至陞","110/07/13","宏遠-光隆",2,0,2
"4196","3679新至陞","110/07/13","永豐金-潮州",0,4,-4
"4197","3679新至陞","110/07/13","美林",3,1,2
"4198","3679新至陞","110/07/13","臺銀-臺南",0,3,-3
"4199","3679新至陞","110/07/13","第一金-中壢",2,0,2
"4200","3679新至陞","110/07/13","元大-六合",0,3,-3
"4201","2727王品","110/07/13","富邦-台北",43,3,40
"4202","2727王品","110/07/13","台灣摩根士丹利",15,97,-82
"4203","2727王品","110/07/13","元大-基隆孝二",40,0,40
"4204","2727王品","110/07/13","玉山-台南",5,57,-52
"4205","2727王品","110/07/13","國票-新莊",40,1,39
"4206","2727王品","110/07/13","新加坡商瑞銀",0,48,-48
"4207","2727王品","110/07/13","第一金-豐原",66,42,24
"4208","2727王品","110/07/13","凱基-台北",41,77,-36
"4209","2727王品","110/07/13","永豐金-大園",34,10,24
"4210","2727王品","110/07/13","永豐金-永康",0,22,-22
"4211","2727王品","110/07/13","元大-北屯",22,0,22
"4212","2727王品","110/07/13","統一-台中",2,22,-20
"4213","2727王品","110/07/13","元大-東蘆",26,7,19
"4214","2727王品","110/07/13","國泰-台中",21,39,-18
"4215","2727王品","110/07/13","永豐金-萬盛",13,1,12
"4216","2727王品","110/07/13","合庫-彰化",3,20,-17
"4217","2727王品","110/07/13","日盛-嘉義",11,0,11
"4218","2727王品","110/07/13","港商野村",13,30,-17
"4219","2727王品","110/07/13","日盛-八德",11,0,11
"4220","2727王品","110/07/13","元大-楊梅",1,16,-15
"4221","2727王品","110/07/13","統一-竹南",11,0,11
"4222","2727王品","110/07/13","凱基-高美館",2,15,-13
"4223","2727王品","110/07/13","日盛-士林",12,2,10
"4224","2727王品","110/07/13","美商高盛",2,14,-12
"4225","2727王品","110/07/13","統一-敦南",10,0,10
"4226","2727王品","110/07/13","統一-平鎮",1,13,-12
"4227","2727王品","110/07/13","中國信託",15,5,10
"4228","2727王品","110/07/13","兆豐-台中港",4,16,-12
"4229","2727王品","110/07/13","兆豐-竹北",13,3,10
"4230","2727王品","110/07/13","凱基-八德",1,13,-12
"4231","1570力肯","110/07/13","新光",115,11,104
"4232","1570力肯","110/07/13","元大-北三重",0,162,-162
"4233","1570力肯","110/07/13","群益金鼎-高雄",54,0,54
"4234","1570力肯","110/07/13","元大-大灣",0,25,-25
"4235","1570力肯","110/07/13","國票-新莊",22,0,22
"4236","1570力肯","110/07/13","永豐金-苓雅",0,22,-22
"4237","1570力肯","110/07/13","日盛-桃園",12,0,12
"4238","1570力肯","110/07/13","永豐金-永康",0,19,-19
"4239","1570力肯","110/07/13","元大-高雄",12,0,12
"4240","1570力肯","110/07/13","富邦-員林",0,15,-15
"4241","1570力肯","110/07/13","合庫-自強",11,0,11
"4242","1570力肯","110/07/13","凱基-台南",0,11,-11
"4243","1570力肯","110/07/13","摩根大通",26,15,11
"4244","1570力肯","110/07/13","日盛-竹北",0,10,-10
"4245","1570力肯","110/07/13","永豐金-中盛",11,0,11
"4246","1570力肯","110/07/13","國票-九鼎",0,10,-10
"4247","1570力肯","110/07/13","兆豐-台中港",10,0,10
"4248","1570力肯","110/07/13","凱基-桃園",0,10,-10
"4249","1570力肯","110/07/13","國泰-松江",9,0,9
"4250","1570力肯","110/07/13","凱基-新豐",0,10,-10
"4251","1570力肯","110/07/13","元大-新盛",9,0,9
"4252","1570力肯","110/07/13","元大-學甲",0,10,-10
"4253","1570力肯","110/07/13","元富-緯城",6,0,6
"4254","1570力肯","110/07/13","群益金鼎-東湖",1,10,-9
"4255","1570力肯","110/07/13","統一-三重",5,0,5
"4256","1570力肯","110/07/13","大昌",0,6,-6
"4257","1570力肯","110/07/13","元大-前金",5,0,5
"4258","1570力肯","110/07/13","元大-土城學府",0,6,-6
"4259","1570力肯","110/07/13","永豐金證券",5,0,5
"4260","1570力肯","110/07/13","統一",0,5,-5
"4261","6180橘子","110/07/13","摩根大通",119,0,119
"4262","6180橘子","110/07/13","元大-崇德",2,61,-59
"4263","6180橘子","110/07/13","美商高盛",96,0,96
"4264","6180橘子","110/07/13","康和-台中",0,51,-51
"4265","6180橘子","110/07/13","新加坡商瑞銀",86,7,79
"4266","6180橘子","110/07/13","康和-台北",0,50,-50
"4267","6180橘子","110/07/13","元大-和平",40,0,40
"4268","6180橘子","110/07/13","元富-潮州",0,40,-40
"4269","6180橘子","110/07/13","凱基-台北",83,47,36
"4270","6180橘子","110/07/13","日盛-永康",0,26,-26
"4271","6180橘子","110/07/13","美林",39,5,34
"4272","6180橘子","110/07/13","永豐金-中正",0,24,-24
"4273","6180橘子","110/07/13","富邦-新竹華信",31,2,29
"4274","6180橘子","110/07/13","國泰-板橋",2,25,-23
"4275","6180橘子","110/07/13","統一-南京",21,0,21
"4276","6180橘子","110/07/13","日盛-大墩",0,20,-20
"4277","6180橘子","110/07/13","富邦-陽明",24,3,21
"4278","6180橘子","110/07/13","元大-草屯",13,32,-19
"4279","6180橘子","110/07/13","大昌-樹林",21,1,20
"4280","6180橘子","110/07/13","元富-林園",1,18,-17
"4281","6180橘子","110/07/13","花旗環球",19,0,19
"4282","6180橘子","110/07/13","新光-新竹",1,18,-17
"4283","6180橘子","110/07/13","華南永昌-台南",19,0,19
"4284","6180橘子","110/07/13","元大-土城永寧",0,17,-17
"4285","6180橘子","110/07/13","福勝",14,0,14
"4286","6180橘子","110/07/13","國泰-新莊",3,19,-16
"4287","6180橘子","110/07/13","富邦-嘉義",12,1,11
"4288","6180橘子","110/07/13","中國信託-永康",6,21,-15
"4289","6180橘子","110/07/13","元大-板橋三民",11,0,11
"4290","6180橘子","110/07/13","凱基-東港",1,15,-14
"4291","2390云辰","110/07/13","新加坡商瑞銀",562,75,487
"4292","2390云辰","110/07/13","大展-台南",0,532,-532
"4293","2390云辰","110/07/13","台灣摩根士丹利",330,155,175
"4294","2390云辰","110/07/13","凱基-台北",668,854,-186
"4295","2390云辰","110/07/13","兆豐-公益",126,25,101
"4296","2390云辰","110/07/13","凱基-三重",12,172,-160
"4297","2390云辰","110/07/13","元富-中港",100,2,98
"4298","2390云辰","110/07/13","兆豐-忠孝",4,161,-157
"4299","2390云辰","110/07/13","統一-新台中",106,9,97
"4300","2390云辰","110/07/13","元大-士林",19,170,-151
"4301","2390云辰","110/07/13","中國信託-松江",81,11,70
"4302","2390云辰","110/07/13","臺銀-新竹",14,117,-103
"4303","2390云辰","110/07/13","日盛-板橋",72,3,69
"4304","2390云辰","110/07/13","國票-台中",4,102,-98
"4305","2390云辰","110/07/13","日盛-和美",57,0,57
"4306","2390云辰","110/07/13","新光",147,232,-85
"4307","2390云辰","110/07/13","永豐金-桃園",88,36,52
"4308","2390云辰","110/07/13","致和-崇德",2,70,-68
"4309","2390云辰","110/07/13","玉山-士林",54,4,50
"4310","2390云辰","110/07/13","群益金鼎-屏東",2,70,-68
"4311","2390云辰","110/07/13","富邦-仁愛",56,6,50
"4312","2390云辰","110/07/13","元大-大里",35,98,-63
"4313","2390云辰","110/07/13","第一金-豐原",50,1,49
"4314","2390云辰","110/07/13","元大-萬華",35,94,-59
"4315","2390云辰","110/07/13","摩根大通",502,453,49
"4316","2390云辰","110/07/13","元富-吉利",2,60,-58
"4317","2390云辰","110/07/13","凱基-松山",61,13,48
"4318","2390云辰","110/07/13","兆豐-新竹",3,53,-50
"4319","2390云辰","110/07/13","大昌",64,22,42
"4320","2390云辰","110/07/13","富邦-嘉義",65,108,-43
"4321","2363矽統","110/07/13","凱基-南崁",2133,63,2070
"4322","2363矽統","110/07/13","凱基-幸福",36,4048,-4012
"4323","2363矽統","110/07/13","國泰-敦南",2195,1617,578
"4324","2363矽統","110/07/13","統一",192,3325,-3133
"4325","2363矽統","110/07/13","中農",670,139,531
"4326","2363矽統","110/07/13","新加坡商瑞銀",1000,2747,-1747
"4327","2363矽統","110/07/13","康和-台中",638,154,484
"4328","2363矽統","110/07/13","凱基-台北",5359,6609,-1250
"4329","2363矽統","110/07/13","群益金鼎-三民",577,137,440
"4330","2363矽統","110/07/13","摩根大通",1930,2858,-928
"4331","2363矽統","110/07/13","台新-屏東",510,88,422
"4332","2363矽統","110/07/13","港商野村",960,1679,-719
"4333","2363矽統","110/07/13","德信-中正",455,67,388
"4334","2363矽統","110/07/13","兆豐-復興",25,705,-680
"4335","2363矽統","110/07/13","日盛-竹北",365,70,295
"4336","2363矽統","110/07/13","統一-仁愛",114,755,-641
"4337","2363矽統","110/07/13","元大-佳里",452,189,263
"4338","2363矽統","110/07/13","統一-敦南",29,638,-609
"4339","2363矽統","110/07/13","國票-博愛",296,38,258
"4340","2363矽統","110/07/13","統一-土城",100,704,-604
"4341","2363矽統","110/07/13","元大-萬華",340,95,245
"4342","2363矽統","110/07/13","統一-城中",116,676,-560
"4343","2363矽統","110/07/13","新光",1259,1031,228
"4344","2363矽統","110/07/13","永豐金證券",306,859,-553
"4345","2363矽統","110/07/13","元富-成功",323,96,227
"4346","2363矽統","110/07/13","元富",54,567,-513
"4347","2363矽統","110/07/13","豐農",228,23,205
"4348","2363矽統","110/07/13","瑞士信貸",202,666,-464
"4349","2363矽統","110/07/13","台灣企銀-岡山",186,4,182
"4350","2363矽統","110/07/13","永豐金-嘉義",67,468,-401
"4351","2363矽統","110/07/13","凱基-南崁",2133,63,2070
"4352","2363矽統","110/07/13","凱基-幸福",36,4048,-4012
"4353","2363矽統","110/07/13","國泰-敦南",2195,1617,578
"4354","2363矽統","110/07/13","統一",192,3325,-3133
"4355","2363矽統","110/07/13","中農",670,139,531
"4356","2363矽統","110/07/13","新加坡商瑞銀",1000,2747,-1747
"4357","2363矽統","110/07/13","康和-台中",638,154,484
"4358","2363矽統","110/07/13","凱基-台北",5359,6609,-1250
"4359","2363矽統","110/07/13","群益金鼎-三民",577,137,440
"4360","2363矽統","110/07/13","摩根大通",1930,2858,-928
"4361","2363矽統","110/07/13","台新-屏東",510,88,422
"4362","2363矽統","110/07/13","港商野村",960,1679,-719
"4363","2363矽統","110/07/13","德信-中正",455,67,388
"4364","2363矽統","110/07/13","兆豐-復興",25,705,-680
"4365","2363矽統","110/07/13","日盛-竹北",365,70,295
"4366","2363矽統","110/07/13","統一-仁愛",114,755,-641
"4367","2363矽統","110/07/13","元大-佳里",452,189,263
"4368","2363矽統","110/07/13","統一-敦南",29,638,-609
"4369","2363矽統","110/07/13","國票-博愛",296,38,258
"4370","2363矽統","110/07/13","統一-土城",100,704,-604
"4371","2363矽統","110/07/13","元大-萬華",340,95,245
"4372","2363矽統","110/07/13","統一-城中",116,676,-560
"4373","2363矽統","110/07/13","新光",1259,1031,228
"4374","2363矽統","110/07/13","永豐金證券",306,859,-553
"4375","2363矽統","110/07/13","元富-成功",323,96,227
"4376","2363矽統","110/07/13","元富",54,567,-513
"4377","2363矽統","110/07/13","豐農",228,23,205
"4378","2363矽統","110/07/13","瑞士信貸",202,666,-464
"4379","2363矽統","110/07/13","台灣企銀-岡山",186,4,182
"4380","2363矽統","110/07/13","永豐金-嘉義",67,468,-401
"4381","2363矽統","110/07/13","凱基-南崁",2133,63,2070
"4382","2363矽統","110/07/13","凱基-幸福",36,4048,-4012
"4383","2363矽統","110/07/13","國泰-敦南",2195,1617,578
"4384","2363矽統","110/07/13","統一",192,3325,-3133
"4385","2363矽統","110/07/13","中農",670,139,531
"4386","2363矽統","110/07/13","新加坡商瑞銀",1000,2747,-1747
"4387","2363矽統","110/07/13","康和-台中",638,154,484
"4388","2363矽統","110/07/13","凱基-台北",5359,6609,-1250
"4389","2363矽統","110/07/13","群益金鼎-三民",577,137,440
"4390","2363矽統","110/07/13","摩根大通",1930,2858,-928
"4391","2363矽統","110/07/13","台新-屏東",510,88,422
"4392","2363矽統","110/07/13","港商野村",960,1679,-719
"4393","2363矽統","110/07/13","德信-中正",455,67,388
"4394","2363矽統","110/07/13","兆豐-復興",25,705,-680
"4395","2363矽統","110/07/13","日盛-竹北",365,70,295
"4396","2363矽統","110/07/13","統一-仁愛",114,755,-641
"4397","2363矽統","110/07/13","元大-佳里",452,189,263
"4398","2363矽統","110/07/13","統一-敦南",29,638,-609
"4399","2363矽統","110/07/13","國票-博愛",296,38,258
"4400","2363矽統","110/07/13","統一-土城",100,704,-604
"4401","2363矽統","110/07/13","元大-萬華",340,95,245
"4402","2363矽統","110/07/13","統一-城中",116,676,-560
"4403","2363矽統","110/07/13","新光",1259,1031,228
"4404","2363矽統","110/07/13","永豐金證券",306,859,-553
"4405","2363矽統","110/07/13","元富-成功",323,96,227
"4406","2363矽統","110/07/13","元富",54,567,-513
"4407","2363矽統","110/07/13","豐農",228,23,205
"4408","2363矽統","110/07/13","瑞士信貸",202,666,-464
"4409","2363矽統","110/07/13","台灣企銀-岡山",186,4,182
"4410","2363矽統","110/07/13","永豐金-嘉義",67,468,-401
"4411","1570力肯","110/07/13","新光",115,11,104
"4412","1570力肯","110/07/13","元大-北三重",0,162,-162
"4413","1570力肯","110/07/13","群益金鼎-高雄",54,0,54
"4414","1570力肯","110/07/13","元大-大灣",0,25,-25
"4415","1570力肯","110/07/13","國票-新莊",22,0,22
"4416","1570力肯","110/07/13","永豐金-苓雅",0,22,-22
"4417","1570力肯","110/07/13","日盛-桃園",12,0,12
"4418","1570力肯","110/07/13","永豐金-永康",0,19,-19
"4419","1570力肯","110/07/13","元大-高雄",12,0,12
"4420","1570力肯","110/07/13","富邦-員林",0,15,-15
"4421","1570力肯","110/07/13","合庫-自強",11,0,11
"4422","1570力肯","110/07/13","凱基-台南",0,11,-11
"4423","1570力肯","110/07/13","摩根大通",26,15,11
"4424","1570力肯","110/07/13","日盛-竹北",0,10,-10
"4425","1570力肯","110/07/13","永豐金-中盛",11,0,11
"4426","1570力肯","110/07/13","國票-九鼎",0,10,-10
"4427","1570力肯","110/07/13","兆豐-台中港",10,0,10
"4428","1570力肯","110/07/13","凱基-桃園",0,10,-10
"4429","1570力肯","110/07/13","國泰-松江",9,0,9
"4430","1570力肯","110/07/13","凱基-新豐",0,10,-10
"4431","1570力肯","110/07/13","元大-新盛",9,0,9
"4432","1570力肯","110/07/13","元大-學甲",0,10,-10
"4433","1570力肯","110/07/13","元富-緯城",6,0,6
"4434","1570力肯","110/07/13","群益金鼎-東湖",1,10,-9
"4435","1570力肯","110/07/13","統一-三重",5,0,5
"4436","1570力肯","110/07/13","大昌",0,6,-6
"4437","1570力肯","110/07/13","元大-前金",5,0,5
"4438","1570力肯","110/07/13","元大-土城學府",0,6,-6
"4439","1570力肯","110/07/13","永豐金證券",5,0,5
"4440","1570力肯","110/07/13","統一",0,5,-5
"4441","1570力肯","110/07/13","新光",115,11,104
"4442","1570力肯","110/07/13","元大-北三重",0,162,-162
"4443","1570力肯","110/07/13","群益金鼎-高雄",54,0,54
"4444","1570力肯","110/07/13","元大-大灣",0,25,-25
"4445","1570力肯","110/07/13","國票-新莊",22,0,22
"4446","1570力肯","110/07/13","永豐金-苓雅",0,22,-22
"4447","1570力肯","110/07/13","日盛-桃園",12,0,12
"4448","1570力肯","110/07/13","永豐金-永康",0,19,-19
"4449","1570力肯","110/07/13","元大-高雄",12,0,12
"4450","1570力肯","110/07/13","富邦-員林",0,15,-15
"4451","1570力肯","110/07/13","合庫-自強",11,0,11
"4452","1570力肯","110/07/13","凱基-台南",0,11,-11
"4453","1570力肯","110/07/13","摩根大通",26,15,11
"4454","1570力肯","110/07/13","日盛-竹北",0,10,-10
"4455","1570力肯","110/07/13","永豐金-中盛",11,0,11
"4456","1570力肯","110/07/13","國票-九鼎",0,10,-10
"4457","1570力肯","110/07/13","兆豐-台中港",10,0,10
"4458","1570力肯","110/07/13","凱基-桃園",0,10,-10
"4459","1570力肯","110/07/13","國泰-松江",9,0,9
"4460","1570力肯","110/07/13","凱基-新豐",0,10,-10
"4461","1570力肯","110/07/13","元大-新盛",9,0,9
"4462","1570力肯","110/07/13","元大-學甲",0,10,-10
"4463","1570力肯","110/07/13","元富-緯城",6,0,6
"4464","1570力肯","110/07/13","群益金鼎-東湖",1,10,-9
"4465","1570力肯","110/07/13","統一-三重",5,0,5
"4466","1570力肯","110/07/13","大昌",0,6,-6
"4467","1570力肯","110/07/13","元大-前金",5,0,5
"4468","1570力肯","110/07/13","元大-土城學府",0,6,-6
"4469","1570力肯","110/07/13","永豐金證券",5,0,5
"4470","1570力肯","110/07/13","統一",0,5,-5
"4471","6180橘子","110/07/13","摩根大通",119,0,119
"4472","6180橘子","110/07/13","元大-崇德",2,61,-59
"4473","6180橘子","110/07/13","美商高盛",96,0,96
"4474","6180橘子","110/07/13","康和-台中",0,51,-51
"4475","6180橘子","110/07/13","新加坡商瑞銀",86,7,79
"4476","6180橘子","110/07/13","康和-台北",0,50,-50
"4477","6180橘子","110/07/13","元大-和平",40,0,40
"4478","6180橘子","110/07/13","元富-潮州",0,40,-40
"4479","6180橘子","110/07/13","凱基-台北",83,47,36
"4480","6180橘子","110/07/13","日盛-永康",0,26,-26
"4481","6180橘子","110/07/13","美林",39,5,34
"4482","6180橘子","110/07/13","永豐金-中正",0,24,-24
"4483","6180橘子","110/07/13","富邦-新竹華信",31,2,29
"4484","6180橘子","110/07/13","國泰-板橋",2,25,-23
"4485","6180橘子","110/07/13","統一-南京",21,0,21
"4486","6180橘子","110/07/13","日盛-大墩",0,20,-20
"4487","6180橘子","110/07/13","富邦-陽明",24,3,21
"4488","6180橘子","110/07/13","元大-草屯",13,32,-19
"4489","6180橘子","110/07/13","大昌-樹林",21,1,20
"4490","6180橘子","110/07/13","元富-林園",1,18,-17
"4491","6180橘子","110/07/13","花旗環球",19,0,19
"4492","6180橘子","110/07/13","新光-新竹",1,18,-17
"4493","6180橘子","110/07/13","華南永昌-台南",19,0,19
"4494","6180橘子","110/07/13","元大-土城永寧",0,17,-17
"4495","6180橘子","110/07/13","福勝",14,0,14
"4496","6180橘子","110/07/13","國泰-新莊",3,19,-16
"4497","6180橘子","110/07/13","富邦-嘉義",12,1,11
"4498","6180橘子","110/07/13","中國信託-永康",6,21,-15
"4499","6180橘子","110/07/13","元大-板橋三民",11,0,11
"4500","6180橘子","110/07/13","凱基-東港",1,15,-14
"4501","1570力肯","110/07/13","新光",115,11,104
"4502","1570力肯","110/07/13","元大-北三重",0,162,-162
"4503","1570力肯","110/07/13","群益金鼎-高雄",54,0,54
"4504","1570力肯","110/07/13","元大-大灣",0,25,-25
"4505","1570力肯","110/07/13","國票-新莊",22,0,22
"4506","1570力肯","110/07/13","永豐金-苓雅",0,22,-22
"4507","1570力肯","110/07/13","日盛-桃園",12,0,12
"4508","1570力肯","110/07/13","永豐金-永康",0,19,-19
"4509","1570力肯","110/07/13","元大-高雄",12,0,12
"4510","1570力肯","110/07/13","富邦-員林",0,15,-15
"4511","1570力肯","110/07/13","合庫-自強",11,0,11
"4512","1570力肯","110/07/13","凱基-台南",0,11,-11
"4513","1570力肯","110/07/13","摩根大通",26,15,11
"4514","1570力肯","110/07/13","日盛-竹北",0,10,-10
"4515","1570力肯","110/07/13","永豐金-中盛",11,0,11
"4516","1570力肯","110/07/13","國票-九鼎",0,10,-10
"4517","1570力肯","110/07/13","兆豐-台中港",10,0,10
"4518","1570力肯","110/07/13","凱基-桃園",0,10,-10
"4519","1570力肯","110/07/13","國泰-松江",9,0,9
"4520","1570力肯","110/07/13","凱基-新豐",0,10,-10
"4521","1570力肯","110/07/13","元大-新盛",9,0,9
"4522","1570力肯","110/07/13","元大-學甲",0,10,-10
"4523","1570力肯","110/07/13","元富-緯城",6,0,6
"4524","1570力肯","110/07/13","群益金鼎-東湖",1,10,-9
"4525","1570力肯","110/07/13","統一-三重",5,0,5
"4526","1570力肯","110/07/13","大昌",0,6,-6
"4527","1570力肯","110/07/13","元大-前金",5,0,5
"4528","1570力肯","110/07/13","元大-土城學府",0,6,-6
"4529","1570力肯","110/07/13","永豐金證券",5,0,5
"4530","1570力肯","110/07/13","統一",0,5,-5
"4531","6180橘子","110/07/13","摩根大通",119,0,119
"4532","6180橘子","110/07/13","元大-崇德",2,61,-59
"4533","6180橘子","110/07/13","美商高盛",96,0,96
"4534","6180橘子","110/07/13","康和-台中",0,51,-51
"4535","6180橘子","110/07/13","新加坡商瑞銀",86,7,79
"4536","6180橘子","110/07/13","康和-台北",0,50,-50
"4537","6180橘子","110/07/13","元大-和平",40,0,40
"4538","6180橘子","110/07/13","元富-潮州",0,40,-40
"4539","6180橘子","110/07/13","凱基-台北",83,47,36
"4540","6180橘子","110/07/13","日盛-永康",0,26,-26
"4541","6180橘子","110/07/13","美林",39,5,34
"4542","6180橘子","110/07/13","永豐金-中正",0,24,-24
"4543","6180橘子","110/07/13","富邦-新竹華信",31,2,29
"4544","6180橘子","110/07/13","國泰-板橋",2,25,-23
"4545","6180橘子","110/07/13","統一-南京",21,0,21
"4546","6180橘子","110/07/13","日盛-大墩",0,20,-20
"4547","6180橘子","110/07/13","富邦-陽明",24,3,21
"4548","6180橘子","110/07/13","元大-草屯",13,32,-19
"4549","6180橘子","110/07/13","大昌-樹林",21,1,20
"4550","6180橘子","110/07/13","元富-林園",1,18,-17
"4551","6180橘子","110/07/13","花旗環球",19,0,19
"4552","6180橘子","110/07/13","新光-新竹",1,18,-17
"4553","6180橘子","110/07/13","華南永昌-台南",19,0,19
"4554","6180橘子","110/07/13","元大-土城永寧",0,17,-17
"4555","6180橘子","110/07/13","福勝",14,0,14
"4556","6180橘子","110/07/13","國泰-新莊",3,19,-16
"4557","6180橘子","110/07/13","富邦-嘉義",12,1,11
"4558","6180橘子","110/07/13","中國信託-永康",6,21,-15
"4559","6180橘子","110/07/13","元大-板橋三民",11,0,11
"4560","6180橘子","110/07/13","凱基-東港",1,15,-14
"4561","2390云辰","110/07/13","新加坡商瑞銀",562,75,487
"4562","2390云辰","110/07/13","大展-台南",0,532,-532
"4563","2390云辰","110/07/13","台灣摩根士丹利",330,155,175
"4564","2390云辰","110/07/13","凱基-台北",668,854,-186
"4565","2390云辰","110/07/13","兆豐-公益",126,25,101
"4566","2390云辰","110/07/13","凱基-三重",12,172,-160
"4567","2390云辰","110/07/13","元富-中港",100,2,98
"4568","2390云辰","110/07/13","兆豐-忠孝",4,161,-157
"4569","2390云辰","110/07/13","統一-新台中",106,9,97
"4570","2390云辰","110/07/13","元大-士林",19,170,-151
"4571","2390云辰","110/07/13","中國信託-松江",81,11,70
"4572","2390云辰","110/07/13","臺銀-新竹",14,117,-103
"4573","2390云辰","110/07/13","日盛-板橋",72,3,69
"4574","2390云辰","110/07/13","國票-台中",4,102,-98
"4575","2390云辰","110/07/13","日盛-和美",57,0,57
"4576","2390云辰","110/07/13","新光",147,232,-85
"4577","2390云辰","110/07/13","永豐金-桃園",88,36,52
"4578","2390云辰","110/07/13","致和-崇德",2,70,-68
"4579","2390云辰","110/07/13","玉山-士林",54,4,50
"4580","2390云辰","110/07/13","群益金鼎-屏東",2,70,-68
"4581","2390云辰","110/07/13","富邦-仁愛",56,6,50
"4582","2390云辰","110/07/13","元大-大里",35,98,-63
"4583","2390云辰","110/07/13","第一金-豐原",50,1,49
"4584","2390云辰","110/07/13","元大-萬華",35,94,-59
"4585","2390云辰","110/07/13","摩根大通",502,453,49
"4586","2390云辰","110/07/13","元富-吉利",2,60,-58
"4587","2390云辰","110/07/13","凱基-松山",61,13,48
"4588","2390云辰","110/07/13","兆豐-新竹",3,53,-50
"4589","2390云辰","110/07/13","大昌",64,22,42
"4590","2390云辰","110/07/13","富邦-嘉義",65,108,-43
"4591","2363矽統","110/07/13","凱基-南崁",2133,63,2070
"4592","2363矽統","110/07/13","凱基-幸福",36,4048,-4012
"4593","2363矽統","110/07/13","國泰-敦南",2195,1617,578
"4594","2363矽統","110/07/13","統一",192,3325,-3133
"4595","2363矽統","110/07/13","中農",670,139,531
"4596","2363矽統","110/07/13","新加坡商瑞銀",1000,2747,-1747
"4597","2363矽統","110/07/13","康和-台中",638,154,484
"4598","2363矽統","110/07/13","凱基-台北",5359,6609,-1250
"4599","2363矽統","110/07/13","群益金鼎-三民",577,137,440
"4600","2363矽統","110/07/13","摩根大通",1930,2858,-928
"4601","2363矽統","110/07/13","台新-屏東",510,88,422
"4602","2363矽統","110/07/13","港商野村",960,1679,-719
"4603","2363矽統","110/07/13","德信-中正",455,67,388
"4604","2363矽統","110/07/13","兆豐-復興",25,705,-680
"4605","2363矽統","110/07/13","日盛-竹北",365,70,295
"4606","2363矽統","110/07/13","統一-仁愛",114,755,-641
"4607","2363矽統","110/07/13","元大-佳里",452,189,263
"4608","2363矽統","110/07/13","統一-敦南",29,638,-609
"4609","2363矽統","110/07/13","國票-博愛",296,38,258
"4610","2363矽統","110/07/13","統一-土城",100,704,-604
"4611","2363矽統","110/07/13","元大-萬華",340,95,245
"4612","2363矽統","110/07/13","統一-城中",116,676,-560
"4613","2363矽統","110/07/13","新光",1259,1031,228
"4614","2363矽統","110/07/13","永豐金證券",306,859,-553
"4615","2363矽統","110/07/13","元富-成功",323,96,227
"4616","2363矽統","110/07/13","元富",54,567,-513
"4617","2363矽統","110/07/13","豐農",228,23,205
"4618","2363矽統","110/07/13","瑞士信貸",202,666,-464
"4619","2363矽統","110/07/13","台灣企銀-岡山",186,4,182
"4620","2363矽統","110/07/13","永豐金-嘉義",67,468,-401
"4621","8112至上","110/07/13","摩根大通",688,296,392
"4622","8112至上","110/07/13","國票-中和",0,401,-401
"4623","8112至上","110/07/13","港商野村",344,145,199
"4624","8112至上","110/07/13","永豐金-板盛",0,205,-205
"4625","8112至上","110/07/13","兆豐-公益",195,5,190
"4626","8112至上","110/07/13","凱基-五股",43,155,-112
"4627","8112至上","110/07/13","台灣摩根士丹利",183,0,183
"4628","8112至上","110/07/13","凱基-市政",0,100,-100
"4629","8112至上","110/07/13","群益金鼎-敦南",153,2,151
"4630","8112至上","110/07/13","元大-大里德芳",1,92,-91
"4631","8112至上","110/07/13","臺銀-金山",146,26,120
"4632","8112至上","110/07/13","玉山-桃園",26,110,-84
"4633","8112至上","110/07/13","臺銀",133,19,114
"4634","8112至上","110/07/13","兆豐-天母",0,81,-81
"4635","8112至上","110/07/13","合庫-台中",115,6,109
"4636","8112至上","110/07/13","凱基-城中",3,84,-81
"4637","8112至上","110/07/13","亞東-板橋",134,26,108
"4638","8112至上","110/07/13","日盛-新莊",9,85,-76
"4639","8112至上","110/07/13","凱基-台北",414,326,88
"4640","8112至上","110/07/13","日盛-台中",2,64,-62
"4641","8112至上","110/07/13","新加坡商瑞銀",181,100,81
"4642","8112至上","110/07/13","日盛-中壢",3,64,-61
"4643","8112至上","110/07/13","國泰-敦南",108,31,77
"4644","8112至上","110/07/13","元大-台中",2,59,-57
"4645","8112至上","110/07/13","第一金-華江",77,4,73
"4646","8112至上","110/07/13","元大-雙和",7,64,-57
"4647","8112至上","110/07/13","永豐金-內湖",73,1,72
"4648","8112至上","110/07/13","元大-高雄",8,62,-54
"4649","8112至上","110/07/13","元大-永和",68,1,67
"4650","8112至上","110/07/13","元大-館前",2,55,-53
"4651","2929淘帝","110/07/13","玉山-新竹",130,0,130
"4652","2929淘帝","110/07/13","美商高盛",0,177,-177
"4653","2929淘帝","110/07/13","臺銀-民權",60,0,60
"4654","2929淘帝","110/07/13","凱基-台北",6,80,-74
"4655","2929淘帝","110/07/13","新百王",31,0,31
"4656","2929淘帝","110/07/13","元富-大裕",0,49,-49
"4657","2929淘帝","110/07/13","日盛-園區",30,0,30
"4658","2929淘帝","110/07/13","國泰-館前",3,51,-48
"4659","2929淘帝","110/07/13","元大-南投",31,1,30
"4660","2929淘帝","110/07/13","凱基-中壢",0,41,-41
"4661","2929淘帝","110/07/13","兆豐-忠孝",28,0,28
"4662","2929淘帝","110/07/13","港商野村",21,55,-34
"4663","2929淘帝","110/07/13","元大-民生",28,0,28
"4664","2929淘帝","110/07/13","華南永昌-南京",2,34,-32
"4665","2929淘帝","110/07/13","合庫-高雄",27,0,27
"4666","2929淘帝","110/07/13","群益金鼎-土城",0,30,-30
"4667","2929淘帝","110/07/13","凱基-豐中",27,0,27
"4668","2929淘帝","110/07/13","富邦-南屯",0,22,-22
"4669","2929淘帝","110/07/13","新光",21,4,17
"4670","2929淘帝","110/07/13","第一金-豐原",0,20,-20
"4671","2929淘帝","110/07/13","元大-天母",17,0,17
"4672","2929淘帝","110/07/13","元大-屏南",6,26,-20
"4673","2929淘帝","110/07/13","永興",14,0,14
"4674","2929淘帝","110/07/13","永豐金-敦南",1,21,-20
"4675","2929淘帝","110/07/13","富邦-台北",12,0,12
"4676","2929淘帝","110/07/13","凱基-三重",2,21,-19
"4677","2929淘帝","110/07/13","元大-永和",12,0,12
"4678","2929淘帝","110/07/13","富邦-仁愛",7,25,-18
"4679","2929淘帝","110/07/13","國票-天祥",11,0,11
"4680","2929淘帝","110/07/13","元大-北投",0,16,-16
"4681","2841台開","110/07/13","中國信託-高雄",251,50,201
"4682","2841台開","110/07/13","兆豐-公益",0,177,-177
"4683","2841台開","110/07/13","日盛證券",210,13,197
"4684","2841台開","110/07/13","日進",0,152,-152
"4685","2841台開","110/07/13","第一金-台中",55,0,55
"4686","2841台開","110/07/13","港商野村",0,109,-109
"4687","2841台開","110/07/13","國泰-板橋",46,0,46
"4688","2841台開","110/07/13","日盛-信義",0,103,-103
"4689","2841台開","110/07/13","國泰-館前",48,3,45
"4690","2841台開","110/07/13","國泰-敦南",11,75,-64
"4691","2841台開","110/07/13","華南永昌-新莊",45,0,45
"4692","2841台開","110/07/13","永興",0,50,-50
"4693","2841台開","110/07/13","日盛-園區",42,0,42
"4694","2841台開","110/07/13","永豐金-敦南",61,104,-43
"4695","2841台開","110/07/13","台新證券",32,0,32
"4696","2841台開","110/07/13","富邦-台南",0,42,-42
"4697","2841台開","110/07/13","台新-高雄",32,2,30
"4698","2841台開","110/07/13","國票-安和",0,30,-30
"4699","2841台開","110/07/13","豐農",23,0,23
"4700","2841台開","110/07/13","元大-桃園",0,25,-25
"4701","2841台開","110/07/13","合庫-嘉義",20,0,20
"4702","2841台開","110/07/13","新光",8,32,-24
"4703","2841台開","110/07/13","華南永昌-高雄",20,0,20
"4704","2841台開","110/07/13","元大-仁愛",0,24,-24
"4705","2841台開","110/07/13","元大-樹林",16,0,16
"4706","2841台開","110/07/13","日盛-中和",0,20,-20
"4707","2841台開","110/07/13","第一金-華江",15,2,13
"4708","2841台開","110/07/13","元富",0,20,-20
"4709","2841台開","110/07/13","美商高盛",12,0,12
"4710","2841台開","110/07/13","富邦-宜蘭",0,20,-20
"4711","6207雷科","110/07/13","元大-高雄",121,0,121
"4712","6207雷科","110/07/13","華南永昌-朴子",1,60,-59
"4713","6207雷科","110/07/13","第一金-新興",20,0,20
"4714","6207雷科","110/07/13","元大-南海",0,36,-36
"4715","6207雷科","110/07/13","元富-三重",20,0,20
"4716","6207雷科","110/07/13","凱基-土城",0,35,-35
"4717","6207雷科","110/07/13","元大-林園",15,0,15
"4718","6207雷科","110/07/13","台灣企銀",0,20,-20
"4719","6207雷科","110/07/13","元大-金華",16,1,15
"4720","6207雷科","110/07/13","群益金鼎-丹鳳",0,20,-20
"4721","6207雷科","110/07/13","日盛證券",10,0,10
"4722","6207雷科","110/07/13","元大-博愛",0,17,-17
"4723","6207雷科","110/07/13","統一-台中",10,0,10
"4724","6207雷科","110/07/13","元大-北港",0,13,-13
"4725","6207雷科","110/07/13","群益金鼎-土城",10,0,10
"4726","6207雷科","110/07/13","新加坡商瑞銀",0,12,-12
"4727","6207雷科","110/07/13","群益金鼎-桃園",10,0,10
"4728","6207雷科","110/07/13","凱基-台北",4,16,-12
"4729","6207雷科","110/07/13","永豐金-新莊",10,0,10
"4730","6207雷科","110/07/13","日茂-埔里",0,11,-11
"4731","6207雷科","110/07/13","永豐金-新店",10,0,10
"4732","6207雷科","110/07/13","元大-莒光",0,11,-11
"4733","6207雷科","110/07/13","元大證券",9,0,9
"4734","6207雷科","110/07/13","統一-新竹",0,10,-10
"4735","6207雷科","110/07/13","日盛-木柵",9,1,8
"4736","6207雷科","110/07/13","元大-西螺",0,10,-10
"4737","6207雷科","110/07/13","兆豐-來福",8,0,8
"4738","6207雷科","110/07/13","康和-台中",0,8,-8
"4739","6207雷科","110/07/13","新光",7,0,7
"4740","6207雷科","110/07/13","兆豐-高雄",0,6,-6
"4741","3679新至陞","110/07/13","永豐金證券",50,0,50
"4742","3679新至陞","110/07/13","摩根大通",2,25,-23
"4743","3679新至陞","110/07/13","國泰-桃園",22,0,22
"4744","3679新至陞","110/07/13","元大-成功",0,22,-22
"4745","3679新至陞","110/07/13","台中銀-員林",11,0,11
"4746","3679新至陞","110/07/13","富邦-板橋",1,19,-18
"4747","3679新至陞","110/07/13","元大-文心興安",8,0,8
"4748","3679新至陞","110/07/13","日盛-新莊",0,10,-10
"4749","3679新至陞","110/07/13","美商高盛",6,0,6
"4750","3679新至陞","110/07/13","台新-台中",0,10,-10
"4751","3679新至陞","110/07/13","台新-高雄",6,0,6
"4752","3679新至陞","110/07/13","永豐金-新竹",0,8,-8
"4753","3679新至陞","110/07/13","凱基-台北",18,12,6
"4754","3679新至陞","110/07/13","瑞士信貸",12,19,-7
"4755","3679新至陞","110/07/13","日盛-復興",5,0,5
"4756","3679新至陞","110/07/13","統一-南京",0,7,-7
"4757","3679新至陞","110/07/13","(牛牛牛)亞-鑫豐",4,0,4
"4758","3679新至陞","110/07/13","凱基-新莊",0,7,-7
"4759","3679新至陞","110/07/13","元富-大昌",3,0,3
"4760","3679新至陞","110/07/13","新加坡商瑞銀",0,6,-6
"4761","3679新至陞","110/07/13","富邦-台北",3,0,3
"4762","3679新至陞","110/07/13","合庫-自強",0,5,-5
"4763","3679新至陞","110/07/13","日盛-樹林",2,0,2
"4764","3679新至陞","110/07/13","富邦-桃園",0,5,-5
"4765","3679新至陞","110/07/13","宏遠-光隆",2,0,2
"4766","3679新至陞","110/07/13","永豐金-潮州",0,4,-4
"4767","3679新至陞","110/07/13","美林",3,1,2
"4768","3679新至陞","110/07/13","臺銀-臺南",0,3,-3
"4769","3679新至陞","110/07/13","第一金-中壢",2,0,2
"4770","3679新至陞","110/07/13","元大-六合",0,3,-3
"4771","2727王品","110/07/13","富邦-台北",43,3,40
"4772","2727王品","110/07/13","台灣摩根士丹利",15,97,-82
"4773","2727王品","110/07/13","元大-基隆孝二",40,0,40
"4774","2727王品","110/07/13","玉山-台南",5,57,-52
"4775","2727王品","110/07/13","國票-新莊",40,1,39
"4776","2727王品","110/07/13","新加坡商瑞銀",0,48,-48
"4777","2727王品","110/07/13","第一金-豐原",66,42,24
"4778","2727王品","110/07/13","凱基-台北",41,77,-36
"4779","2727王品","110/07/13","永豐金-大園",34,10,24
"4780","2727王品","110/07/13","永豐金-永康",0,22,-22
"4781","2727王品","110/07/13","元大-北屯",22,0,22
"4782","2727王品","110/07/13","統一-台中",2,22,-20
"4783","2727王品","110/07/13","元大-東蘆",26,7,19
"4784","2727王品","110/07/13","國泰-台中",21,39,-18
"4785","2727王品","110/07/13","永豐金-萬盛",13,1,12
"4786","2727王品","110/07/13","合庫-彰化",3,20,-17
"4787","2727王品","110/07/13","日盛-嘉義",11,0,11
"4788","2727王品","110/07/13","港商野村",13,30,-17
"4789","2727王品","110/07/13","日盛-八德",11,0,11
"4790","2727王品","110/07/13","元大-楊梅",1,16,-15
"4791","2727王品","110/07/13","統一-竹南",11,0,11
"4792","2727王品","110/07/13","凱基-高美館",2,15,-13
"4793","2727王品","110/07/13","日盛-士林",12,2,10
"4794","2727王品","110/07/13","美商高盛",2,14,-12
"4795","2727王品","110/07/13","統一-敦南",10,0,10
"4796","2727王品","110/07/13","統一-平鎮",1,13,-12
"4797","2727王品","110/07/13","中國信託",15,5,10
"4798","2727王品","110/07/13","兆豐-台中港",4,16,-12
"4799","2727王品","110/07/13","兆豐-竹北",13,3,10
"4800","2727王品","110/07/13","凱基-八德",1,13,-12
"4801","1570力肯","110/07/13","新光",115,11,104
"4802","1570力肯","110/07/13","元大-北三重",0,162,-162
"4803","1570力肯","110/07/13","群益金鼎-高雄",54,0,54
"4804","1570力肯","110/07/13","元大-大灣",0,25,-25
"4805","1570力肯","110/07/13","國票-新莊",22,0,22
"4806","1570力肯","110/07/13","永豐金-苓雅",0,22,-22
"4807","1570力肯","110/07/13","日盛-桃園",12,0,12
"4808","1570力肯","110/07/13","永豐金-永康",0,19,-19
"4809","1570力肯","110/07/13","元大-高雄",12,0,12
"4810","1570力肯","110/07/13","富邦-員林",0,15,-15
"4811","1570力肯","110/07/13","合庫-自強",11,0,11
"4812","1570力肯","110/07/13","凱基-台南",0,11,-11
"4813","1570力肯","110/07/13","摩根大通",26,15,11
"4814","1570力肯","110/07/13","日盛-竹北",0,10,-10
"4815","1570力肯","110/07/13","永豐金-中盛",11,0,11
"4816","1570力肯","110/07/13","國票-九鼎",0,10,-10
"4817","1570力肯","110/07/13","兆豐-台中港",10,0,10
"4818","1570力肯","110/07/13","凱基-桃園",0,10,-10
"4819","1570力肯","110/07/13","國泰-松江",9,0,9
"4820","1570力肯","110/07/13","凱基-新豐",0,10,-10
"4821","1570力肯","110/07/13","元大-新盛",9,0,9
"4822","1570力肯","110/07/13","元大-學甲",0,10,-10
"4823","1570力肯","110/07/13","元富-緯城",6,0,6
"4824","1570力肯","110/07/13","群益金鼎-東湖",1,10,-9
"4825","1570力肯","110/07/13","統一-三重",5,0,5
"4826","1570力肯","110/07/13","大昌",0,6,-6
"4827","1570力肯","110/07/13","元大-前金",5,0,5
"4828","1570力肯","110/07/13","元大-土城學府",0,6,-6
"4829","1570力肯","110/07/13","永豐金證券",5,0,5
"4830","1570力肯","110/07/13","統一",0,5,-5
"4831","6180橘子","110/07/13","摩根大通",119,0,119
"4832","6180橘子","110/07/13","元大-崇德",2,61,-59
"4833","6180橘子","110/07/13","美商高盛",96,0,96
"4834","6180橘子","110/07/13","康和-台中",0,51,-51
"4835","6180橘子","110/07/13","新加坡商瑞銀",86,7,79
"4836","6180橘子","110/07/13","康和-台北",0,50,-50
"4837","6180橘子","110/07/13","元大-和平",40,0,40
"4838","6180橘子","110/07/13","元富-潮州",0,40,-40
"4839","6180橘子","110/07/13","凱基-台北",83,47,36
"4840","6180橘子","110/07/13","日盛-永康",0,26,-26
"4841","6180橘子","110/07/13","美林",39,5,34
"4842","6180橘子","110/07/13","永豐金-中正",0,24,-24
"4843","6180橘子","110/07/13","富邦-新竹華信",31,2,29
"4844","6180橘子","110/07/13","國泰-板橋",2,25,-23
"4845","6180橘子","110/07/13","統一-南京",21,0,21
"4846","6180橘子","110/07/13","日盛-大墩",0,20,-20
"4847","6180橘子","110/07/13","富邦-陽明",24,3,21
"4848","6180橘子","110/07/13","元大-草屯",13,32,-19
"4849","6180橘子","110/07/13","大昌-樹林",21,1,20
"4850","6180橘子","110/07/13","元富-林園",1,18,-17
"4851","6180橘子","110/07/13","花旗環球",19,0,19
"4852","6180橘子","110/07/13","新光-新竹",1,18,-17
"4853","6180橘子","110/07/13","華南永昌-台南",19,0,19
"4854","6180橘子","110/07/13","元大-土城永寧",0,17,-17
"4855","6180橘子","110/07/13","福勝",14,0,14
"4856","6180橘子","110/07/13","國泰-新莊",3,19,-16
"4857","6180橘子","110/07/13","富邦-嘉義",12,1,11
"4858","6180橘子","110/07/13","中國信託-永康",6,21,-15
"4859","6180橘子","110/07/13","元大-板橋三民",11,0,11
"4860","6180橘子","110/07/13","凱基-東港",1,15,-14
"4861","2390云辰","110/07/13","新加坡商瑞銀",562,75,487
"4862","2390云辰","110/07/13","大展-台南",0,532,-532
"4863","2390云辰","110/07/13","台灣摩根士丹利",330,155,175
"4864","2390云辰","110/07/13","凱基-台北",668,854,-186
"4865","2390云辰","110/07/13","兆豐-公益",126,25,101
"4866","2390云辰","110/07/13","凱基-三重",12,172,-160
"4867","2390云辰","110/07/13","元富-中港",100,2,98
"4868","2390云辰","110/07/13","兆豐-忠孝",4,161,-157
"4869","2390云辰","110/07/13","統一-新台中",106,9,97
"4870","2390云辰","110/07/13","元大-士林",19,170,-151
"4871","2390云辰","110/07/13","中國信託-松江",81,11,70
"4872","2390云辰","110/07/13","臺銀-新竹",14,117,-103
"4873","2390云辰","110/07/13","日盛-板橋",72,3,69
"4874","2390云辰","110/07/13","國票-台中",4,102,-98
"4875","2390云辰","110/07/13","日盛-和美",57,0,57
"4876","2390云辰","110/07/13","新光",147,232,-85
"4877","2390云辰","110/07/13","永豐金-桃園",88,36,52
"4878","2390云辰","110/07/13","致和-崇德",2,70,-68
"4879","2390云辰","110/07/13","玉山-士林",54,4,50
"4880","2390云辰","110/07/13","群益金鼎-屏東",2,70,-68
"4881","2390云辰","110/07/13","富邦-仁愛",56,6,50
"4882","2390云辰","110/07/13","元大-大里",35,98,-63
"4883","2390云辰","110/07/13","第一金-豐原",50,1,49
"4884","2390云辰","110/07/13","元大-萬華",35,94,-59
"4885","2390云辰","110/07/13","摩根大通",502,453,49
"4886","2390云辰","110/07/13","元富-吉利",2,60,-58
"4887","2390云辰","110/07/13","凱基-松山",61,13,48
"4888","2390云辰","110/07/13","兆豐-新竹",3,53,-50
"4889","2390云辰","110/07/13","大昌",64,22,42
"4890","2390云辰","110/07/13","富邦-嘉義",65,108,-43
"4891","2363矽統","110/07/13","凱基-南崁",2133,63,2070
"4892","2363矽統","110/07/13","凱基-幸福",36,4048,-4012
"4893","2363矽統","110/07/13","國泰-敦南",2195,1617,578
"4894","2363矽統","110/07/13","統一",192,3325,-3133
"4895","2363矽統","110/07/13","中農",670,139,531
"4896","2363矽統","110/07/13","新加坡商瑞銀",1000,2747,-1747
"4897","2363矽統","110/07/13","康和-台中",638,154,484
"4898","2363矽統","110/07/13","凱基-台北",5359,6609,-1250
"4899","2363矽統","110/07/13","群益金鼎-三民",577,137,440
"4900","2363矽統","110/07/13","摩根大通",1930,2858,-928
"4901","2363矽統","110/07/13","台新-屏東",510,88,422
"4902","2363矽統","110/07/13","港商野村",960,1679,-719
"4903","2363矽統","110/07/13","德信-中正",455,67,388
"4904","2363矽統","110/07/13","兆豐-復興",25,705,-680
"4905","2363矽統","110/07/13","日盛-竹北",365,70,295
"4906","2363矽統","110/07/13","統一-仁愛",114,755,-641
"4907","2363矽統","110/07/13","元大-佳里",452,189,263
"4908","2363矽統","110/07/13","統一-敦南",29,638,-609
"4909","2363矽統","110/07/13","國票-博愛",296,38,258
"4910","2363矽統","110/07/13","統一-土城",100,704,-604
"4911","2363矽統","110/07/13","元大-萬華",340,95,245
"4912","2363矽統","110/07/13","統一-城中",116,676,-560
"4913","2363矽統","110/07/13","新光",1259,1031,228
"4914","2363矽統","110/07/13","永豐金證券",306,859,-553
"4915","2363矽統","110/07/13","元富-成功",323,96,227
"4916","2363矽統","110/07/13","元富",54,567,-513
"4917","2363矽統","110/07/13","豐農",228,23,205
"4918","2363矽統","110/07/13","瑞士信貸",202,666,-464
"4919","2363矽統","110/07/13","台灣企銀-岡山",186,4,182
"4920","2363矽統","110/07/13","永豐金-嘉義",67,468,-401
"4921","8112至上","110/07/13","摩根大通",688,296,392
"4922","8112至上","110/07/13","國票-中和",0,401,-401
"4923","8112至上","110/07/13","港商野村",344,145,199
"4924","8112至上","110/07/13","永豐金-板盛",0,205,-205
"4925","8112至上","110/07/13","兆豐-公益",195,5,190
"4926","8112至上","110/07/13","凱基-五股",43,155,-112
"4927","8112至上","110/07/13","台灣摩根士丹利",183,0,183
"4928","8112至上","110/07/13","凱基-市政",0,100,-100
"4929","8112至上","110/07/13","群益金鼎-敦南",153,2,151
"4930","8112至上","110/07/13","元大-大里德芳",1,92,-91
"4931","8112至上","110/07/13","臺銀-金山",146,26,120
"4932","8112至上","110/07/13","玉山-桃園",26,110,-84
"4933","8112至上","110/07/13","臺銀",133,19,114
"4934","8112至上","110/07/13","兆豐-天母",0,81,-81
"4935","8112至上","110/07/13","合庫-台中",115,6,109
"4936","8112至上","110/07/13","凱基-城中",3,84,-81
"4937","8112至上","110/07/13","亞東-板橋",134,26,108
"4938","8112至上","110/07/13","日盛-新莊",9,85,-76
"4939","8112至上","110/07/13","凱基-台北",414,326,88
"4940","8112至上","110/07/13","日盛-台中",2,64,-62
"4941","8112至上","110/07/13","新加坡商瑞銀",181,100,81
"4942","8112至上","110/07/13","日盛-中壢",3,64,-61
"4943","8112至上","110/07/13","國泰-敦南",108,31,77
"4944","8112至上","110/07/13","元大-台中",2,59,-57
"4945","8112至上","110/07/13","第一金-華江",77,4,73
"4946","8112至上","110/07/13","元大-雙和",7,64,-57
"4947","8112至上","110/07/13","永豐金-內湖",73,1,72
"4948","8112至上","110/07/13","元大-高雄",8,62,-54
"4949","8112至上","110/07/13","元大-永和",68,1,67
"4950","8112至上","110/07/13","元大-館前",2,55,-53
"4951","2929淘帝","110/07/13","玉山-新竹",130,0,130
"4952","2929淘帝","110/07/13","美商高盛",0,177,-177
"4953","2929淘帝","110/07/13","臺銀-民權",60,0,60
"4954","2929淘帝","110/07/13","凱基-台北",6,80,-74
"4955","2929淘帝","110/07/13","新百王",31,0,31
"4956","2929淘帝","110/07/13","元富-大裕",0,49,-49
"4957","2929淘帝","110/07/13","日盛-園區",30,0,30
"4958","2929淘帝","110/07/13","國泰-館前",3,51,-48
"4959","2929淘帝","110/07/13","元大-南投",31,1,30
"4960","2929淘帝","110/07/13","凱基-中壢",0,41,-41
"4961","2929淘帝","110/07/13","兆豐-忠孝",28,0,28
"4962","2929淘帝","110/07/13","港商野村",21,55,-34
"4963","2929淘帝","110/07/13","元大-民生",28,0,28
"4964","2929淘帝","110/07/13","華南永昌-南京",2,34,-32
"4965","2929淘帝","110/07/13","合庫-高雄",27,0,27
"4966","2929淘帝","110/07/13","群益金鼎-土城",0,30,-30
"4967","2929淘帝","110/07/13","凱基-豐中",27,0,27
"4968","2929淘帝","110/07/13","富邦-南屯",0,22,-22
"4969","2929淘帝","110/07/13","新光",21,4,17
"4970","2929淘帝","110/07/13","第一金-豐原",0,20,-20
"4971","2929淘帝","110/07/13","元大-天母",17,0,17
"4972","2929淘帝","110/07/13","元大-屏南",6,26,-20
"4973","2929淘帝","110/07/13","永興",14,0,14
"4974","2929淘帝","110/07/13","永豐金-敦南",1,21,-20
"4975","2929淘帝","110/07/13","富邦-台北",12,0,12
"4976","2929淘帝","110/07/13","凱基-三重",2,21,-19
"4977","2929淘帝","110/07/13","元大-永和",12,0,12
"4978","2929淘帝","110/07/13","富邦-仁愛",7,25,-18
"4979","2929淘帝","110/07/13","國票-天祥",11,0,11
"4980","2929淘帝","110/07/13","元大-北投",0,16,-16
"4981","5410國眾","110/07/13","兆豐-城中",274,0,274
"4982","5410國眾","110/07/13","元富-嘉義",0,103,-103
"4983","5410國眾","110/07/13","新光",50,4,46
"4984","5410國眾","110/07/13","凱基-台北",0,50,-50
"4985","5410國眾","110/07/13","國泰-台中",26,0,26
"4986","5410國眾","110/07/13","瑞士信貸",0,31,-31
"4987","5410國眾","110/07/13","新加坡商瑞銀",22,0,22
"4988","5410國眾","110/07/13","台新-新莊",0,27,-27
"4989","5410國眾","110/07/13","光和-嘉義",20,0,20
"4990","5410國眾","110/07/13","元大-汐止",0,20,-20
"4991","5410國眾","110/07/13","凱基-竹北",17,0,17
"4992","5410國眾","110/07/13","亞東-新竹",0,17,-17
"4993","5410國眾","110/07/13","新光-桃園",15,0,15
"4994","5410國眾","110/07/13","元大-南勢角",0,13,-13
"4995","5410國眾","110/07/13","凱基-台東",14,0,14
"4996","5410國眾","110/07/13","台新-台南",0,12,-12
"4997","5410國眾","110/07/13","富邦-竹北",11,0,11
"4998","5410國眾","110/07/13","中國信託",0,11,-11
"4999","5410國眾","110/07/13","元富-同大",10,0,10
"5000","5410國眾","110/07/13","華南永昌",0,11,-11
"5001","5410國眾","110/07/13","國泰-敦南",24,15,9
"5002","5410國眾","110/07/13","臺銀-臺南",0,10,-10
"5003","5410國眾","110/07/13","日盛-內湖",7,0,7
"5004","5410國眾","110/07/13","台灣企銀-民雄",0,10,-10
"5005","5410國眾","110/07/13","台新-左楠",7,0,7
"5006","5410國眾","110/07/13","高橋",0,10,-10
"5007","5410國眾","110/07/13","元大-新盛",18,12,6
"5008","5410國眾","110/07/13","康和-嘉義",0,10,-10
"5009","5410國眾","110/07/13","統一",5,0,5
"5010","5410國眾","110/07/13","凱基-基隆",0,10,-10
"5011","2841台開","110/07/13","中國信託-高雄",251,50,201
"5012","2841台開","110/07/13","兆豐-公益",0,177,-177
"5013","2841台開","110/07/13","日盛證券",210,13,197
"5014","2841台開","110/07/13","日進",0,152,-152
"5015","2841台開","110/07/13","第一金-台中",55,0,55
"5016","2841台開","110/07/13","港商野村",0,109,-109
"5017","2841台開","110/07/13","國泰-板橋",46,0,46
"5018","2841台開","110/07/13","日盛-信義",0,103,-103
"5019","2841台開","110/07/13","國泰-館前",48,3,45
"5020","2841台開","110/07/13","國泰-敦南",11,75,-64
"5021","2841台開","110/07/13","華南永昌-新莊",45,0,45
"5022","2841台開","110/07/13","永興",0,50,-50
"5023","2841台開","110/07/13","日盛-園區",42,0,42
"5024","2841台開","110/07/13","永豐金-敦南",61,104,-43
"5025","2841台開","110/07/13","台新證券",32,0,32
"5026","2841台開","110/07/13","富邦-台南",0,42,-42
"5027","2841台開","110/07/13","台新-高雄",32,2,30
"5028","2841台開","110/07/13","國票-安和",0,30,-30
"5029","2841台開","110/07/13","豐農",23,0,23
"5030","2841台開","110/07/13","元大-桃園",0,25,-25
"5031","2841台開","110/07/13","合庫-嘉義",20,0,20
"5032","2841台開","110/07/13","新光",8,32,-24
"5033","2841台開","110/07/13","華南永昌-高雄",20,0,20
"5034","2841台開","110/07/13","元大-仁愛",0,24,-24
"5035","2841台開","110/07/13","元大-樹林",16,0,16
"5036","2841台開","110/07/13","日盛-中和",0,20,-20
"5037","2841台開","110/07/13","第一金-華江",15,2,13
"5038","2841台開","110/07/13","元富",0,20,-20
"5039","2841台開","110/07/13","美商高盛",12,0,12
"5040","2841台開","110/07/13","富邦-宜蘭",0,20,-20
"5041","6207雷科","110/07/13","元大-高雄",121,0,121
"5042","6207雷科","110/07/13","華南永昌-朴子",1,60,-59
"5043","6207雷科","110/07/13","第一金-新興",20,0,20
"5044","6207雷科","110/07/13","元大-南海",0,36,-36
"5045","6207雷科","110/07/13","元富-三重",20,0,20
"5046","6207雷科","110/07/13","凱基-土城",0,35,-35
"5047","6207雷科","110/07/13","元大-林園",15,0,15
"5048","6207雷科","110/07/13","台灣企銀",0,20,-20
"5049","6207雷科","110/07/13","元大-金華",16,1,15
"5050","6207雷科","110/07/13","群益金鼎-丹鳳",0,20,-20
"5051","6207雷科","110/07/13","日盛證券",10,0,10
"5052","6207雷科","110/07/13","元大-博愛",0,17,-17
"5053","6207雷科","110/07/13","統一-台中",10,0,10
"5054","6207雷科","110/07/13","元大-北港",0,13,-13
"5055","6207雷科","110/07/13","群益金鼎-土城",10,0,10
"5056","6207雷科","110/07/13","新加坡商瑞銀",0,12,-12
"5057","6207雷科","110/07/13","群益金鼎-桃園",10,0,10
"5058","6207雷科","110/07/13","凱基-台北",4,16,-12
"5059","6207雷科","110/07/13","永豐金-新莊",10,0,10
"5060","6207雷科","110/07/13","日茂-埔里",0,11,-11
"5061","6207雷科","110/07/13","永豐金-新店",10,0,10
"5062","6207雷科","110/07/13","元大-莒光",0,11,-11
"5063","6207雷科","110/07/13","元大證券",9,0,9
"5064","6207雷科","110/07/13","統一-新竹",0,10,-10
"5065","6207雷科","110/07/13","日盛-木柵",9,1,8
"5066","6207雷科","110/07/13","元大-西螺",0,10,-10
"5067","6207雷科","110/07/13","兆豐-來福",8,0,8
"5068","6207雷科","110/07/13","康和-台中",0,8,-8
"5069","6207雷科","110/07/13","新光",7,0,7
"5070","6207雷科","110/07/13","兆豐-高雄",0,6,-6
"5071","3679新至陞","110/07/13","永豐金證券",50,0,50
"5072","3679新至陞","110/07/13","摩根大通",2,25,-23
"5073","3679新至陞","110/07/13","國泰-桃園",22,0,22
"5074","3679新至陞","110/07/13","元大-成功",0,22,-22
"5075","3679新至陞","110/07/13","台中銀-員林",11,0,11
"5076","3679新至陞","110/07/13","富邦-板橋",1,19,-18
"5077","3679新至陞","110/07/13","元大-文心興安",8,0,8
"5078","3679新至陞","110/07/13","日盛-新莊",0,10,-10
"5079","3679新至陞","110/07/13","美商高盛",6,0,6
"5080","3679新至陞","110/07/13","台新-台中",0,10,-10
"5081","3679新至陞","110/07/13","台新-高雄",6,0,6
"5082","3679新至陞","110/07/13","永豐金-新竹",0,8,-8
"5083","3679新至陞","110/07/13","凱基-台北",18,12,6
"5084","3679新至陞","110/07/13","瑞士信貸",12,19,-7
"5085","3679新至陞","110/07/13","日盛-復興",5,0,5
"5086","3679新至陞","110/07/13","統一-南京",0,7,-7
"5087","3679新至陞","110/07/13","(牛牛牛)亞-鑫豐",4,0,4
"5088","3679新至陞","110/07/13","凱基-新莊",0,7,-7
"5089","3679新至陞","110/07/13","元富-大昌",3,0,3
"5090","3679新至陞","110/07/13","新加坡商瑞銀",0,6,-6
"5091","3679新至陞","110/07/13","富邦-台北",3,0,3
"5092","3679新至陞","110/07/13","合庫-自強",0,5,-5
"5093","3679新至陞","110/07/13","日盛-樹林",2,0,2
"5094","3679新至陞","110/07/13","富邦-桃園",0,5,-5
"5095","3679新至陞","110/07/13","宏遠-光隆",2,0,2
"5096","3679新至陞","110/07/13","永豐金-潮州",0,4,-4
"5097","3679新至陞","110/07/13","美林",3,1,2
"5098","3679新至陞","110/07/13","臺銀-臺南",0,3,-3
"5099","3679新至陞","110/07/13","第一金-中壢",2,0,2
"5100","3679新至陞","110/07/13","元大-六合",0,3,-3
"5101","2727王品","110/07/13","富邦-台北",43,3,40
"5102","2727王品","110/07/13","台灣摩根士丹利",15,97,-82
"5103","2727王品","110/07/13","元大-基隆孝二",40,0,40
"5104","2727王品","110/07/13","玉山-台南",5,57,-52
"5105","2727王品","110/07/13","國票-新莊",40,1,39
"5106","2727王品","110/07/13","新加坡商瑞銀",0,48,-48
"5107","2727王品","110/07/13","第一金-豐原",66,42,24
"5108","2727王品","110/07/13","凱基-台北",41,77,-36
"5109","2727王品","110/07/13","永豐金-大園",34,10,24
"5110","2727王品","110/07/13","永豐金-永康",0,22,-22
"5111","2727王品","110/07/13","元大-北屯",22,0,22
"5112","2727王品","110/07/13","統一-台中",2,22,-20
"5113","2727王品","110/07/13","元大-東蘆",26,7,19
"5114","2727王品","110/07/13","國泰-台中",21,39,-18
"5115","2727王品","110/07/13","永豐金-萬盛",13,1,12
"5116","2727王品","110/07/13","合庫-彰化",3,20,-17
"5117","2727王品","110/07/13","日盛-嘉義",11,0,11
"5118","2727王品","110/07/13","港商野村",13,30,-17
"5119","2727王品","110/07/13","日盛-八德",11,0,11
"5120","2727王品","110/07/13","元大-楊梅",1,16,-15
"5121","2727王品","110/07/13","統一-竹南",11,0,11
"5122","2727王品","110/07/13","凱基-高美館",2,15,-13
"5123","2727王品","110/07/13","日盛-士林",12,2,10
"5124","2727王品","110/07/13","美商高盛",2,14,-12
"5125","2727王品","110/07/13","統一-敦南",10,0,10
"5126","2727王品","110/07/13","統一-平鎮",1,13,-12
"5127","2727王品","110/07/13","中國信託",15,5,10
"5128","2727王品","110/07/13","兆豐-台中港",4,16,-12
"5129","2727王品","110/07/13","兆豐-竹北",13,3,10
"5130","2727王品","110/07/13","凱基-八德",1,13,-12
"5131","1570力肯","110/07/13","新光",115,11,104
"5132","1570力肯","110/07/13","元大-北三重",0,162,-162
"5133","1570力肯","110/07/13","群益金鼎-高雄",54,0,54
"5134","1570力肯","110/07/13","元大-大灣",0,25,-25
"5135","1570力肯","110/07/13","國票-新莊",22,0,22
"5136","1570力肯","110/07/13","永豐金-苓雅",0,22,-22
"5137","1570力肯","110/07/13","日盛-桃園",12,0,12
"5138","1570力肯","110/07/13","永豐金-永康",0,19,-19
"5139","1570力肯","110/07/13","元大-高雄",12,0,12
"5140","1570力肯","110/07/13","富邦-員林",0,15,-15
"5141","1570力肯","110/07/13","合庫-自強",11,0,11
"5142","1570力肯","110/07/13","凱基-台南",0,11,-11
"5143","1570力肯","110/07/13","摩根大通",26,15,11
"5144","1570力肯","110/07/13","日盛-竹北",0,10,-10
"5145","1570力肯","110/07/13","永豐金-中盛",11,0,11
"5146","1570力肯","110/07/13","國票-九鼎",0,10,-10
"5147","1570力肯","110/07/13","兆豐-台中港",10,0,10
"5148","1570力肯","110/07/13","凱基-桃園",0,10,-10
"5149","1570力肯","110/07/13","國泰-松江",9,0,9
"5150","1570力肯","110/07/13","凱基-新豐",0,10,-10
"5151","1570力肯","110/07/13","元大-新盛",9,0,9
"5152","1570力肯","110/07/13","元大-學甲",0,10,-10
"5153","1570力肯","110/07/13","元富-緯城",6,0,6
"5154","1570力肯","110/07/13","群益金鼎-東湖",1,10,-9
"5155","1570力肯","110/07/13","統一-三重",5,0,5
"5156","1570力肯","110/07/13","大昌",0,6,-6
"5157","1570力肯","110/07/13","元大-前金",5,0,5
"5158","1570力肯","110/07/13","元大-土城學府",0,6,-6
"5159","1570力肯","110/07/13","永豐金證券",5,0,5
"5160","1570力肯","110/07/13","統一",0,5,-5
"5161","6180橘子","110/07/13","摩根大通",119,0,119
"5162","6180橘子","110/07/13","元大-崇德",2,61,-59
"5163","6180橘子","110/07/13","美商高盛",96,0,96
"5164","6180橘子","110/07/13","康和-台中",0,51,-51
"5165","6180橘子","110/07/13","新加坡商瑞銀",86,7,79
"5166","6180橘子","110/07/13","康和-台北",0,50,-50
"5167","6180橘子","110/07/13","元大-和平",40,0,40
"5168","6180橘子","110/07/13","元富-潮州",0,40,-40
"5169","6180橘子","110/07/13","凱基-台北",83,47,36
"5170","6180橘子","110/07/13","日盛-永康",0,26,-26
"5171","6180橘子","110/07/13","美林",39,5,34
"5172","6180橘子","110/07/13","永豐金-中正",0,24,-24
"5173","6180橘子","110/07/13","富邦-新竹華信",31,2,29
"5174","6180橘子","110/07/13","國泰-板橋",2,25,-23
"5175","6180橘子","110/07/13","統一-南京",21,0,21
"5176","6180橘子","110/07/13","日盛-大墩",0,20,-20
"5177","6180橘子","110/07/13","富邦-陽明",24,3,21
"5178","6180橘子","110/07/13","元大-草屯",13,32,-19
"5179","6180橘子","110/07/13","大昌-樹林",21,1,20
"5180","6180橘子","110/07/13","元富-林園",1,18,-17
"5181","6180橘子","110/07/13","花旗環球",19,0,19
"5182","6180橘子","110/07/13","新光-新竹",1,18,-17
"5183","6180橘子","110/07/13","華南永昌-台南",19,0,19
"5184","6180橘子","110/07/13","元大-土城永寧",0,17,-17
"5185","6180橘子","110/07/13","福勝",14,0,14
"5186","6180橘子","110/07/13","國泰-新莊",3,19,-16
"5187","6180橘子","110/07/13","富邦-嘉義",12,1,11
"5188","6180橘子","110/07/13","中國信託-永康",6,21,-15
"5189","6180橘子","110/07/13","元大-板橋三民",11,0,11
"5190","6180橘子","110/07/13","凱基-東港",1,15,-14
"5191","2390云辰","110/07/13","新加坡商瑞銀",562,75,487
"5192","2390云辰","110/07/13","大展-台南",0,532,-532
"5193","2390云辰","110/07/13","台灣摩根士丹利",330,155,175
"5194","2390云辰","110/07/13","凱基-台北",668,854,-186
"5195","2390云辰","110/07/13","兆豐-公益",126,25,101
"5196","2390云辰","110/07/13","凱基-三重",12,172,-160
"5197","2390云辰","110/07/13","元富-中港",100,2,98
"5198","2390云辰","110/07/13","兆豐-忠孝",4,161,-157
"5199","2390云辰","110/07/13","統一-新台中",106,9,97
"5200","2390云辰","110/07/13","元大-士林",19,170,-151
"5201","2390云辰","110/07/13","中國信託-松江",81,11,70
"5202","2390云辰","110/07/13","臺銀-新竹",14,117,-103
"5203","2390云辰","110/07/13","日盛-板橋",72,3,69
"5204","2390云辰","110/07/13","國票-台中",4,102,-98
"5205","2390云辰","110/07/13","日盛-和美",57,0,57
"5206","2390云辰","110/07/13","新光",147,232,-85
"5207","2390云辰","110/07/13","永豐金-桃園",88,36,52
"5208","2390云辰","110/07/13","致和-崇德",2,70,-68
"5209","2390云辰","110/07/13","玉山-士林",54,4,50
"5210","2390云辰","110/07/13","群益金鼎-屏東",2,70,-68
"5211","2390云辰","110/07/13","富邦-仁愛",56,6,50
"5212","2390云辰","110/07/13","元大-大里",35,98,-63
"5213","2390云辰","110/07/13","第一金-豐原",50,1,49
"5214","2390云辰","110/07/13","元大-萬華",35,94,-59
"5215","2390云辰","110/07/13","摩根大通",502,453,49
"5216","2390云辰","110/07/13","元富-吉利",2,60,-58
"5217","2390云辰","110/07/13","凱基-松山",61,13,48
"5218","2390云辰","110/07/13","兆豐-新竹",3,53,-50
"5219","2390云辰","110/07/13","大昌",64,22,42
"5220","2390云辰","110/07/13","富邦-嘉義",65,108,-43
"5221","2363矽統","110/07/13","凱基-南崁",2133,63,2070
"5222","2363矽統","110/07/13","凱基-幸福",36,4048,-4012
"5223","2363矽統","110/07/13","國泰-敦南",2195,1617,578
"5224","2363矽統","110/07/13","統一",192,3325,-3133
"5225","2363矽統","110/07/13","中農",670,139,531
"5226","2363矽統","110/07/13","新加坡商瑞銀",1000,2747,-1747
"5227","2363矽統","110/07/13","康和-台中",638,154,484
"5228","2363矽統","110/07/13","凱基-台北",5359,6609,-1250
"5229","2363矽統","110/07/13","群益金鼎-三民",577,137,440
"5230","2363矽統","110/07/13","摩根大通",1930,2858,-928
"5231","2363矽統","110/07/13","台新-屏東",510,88,422
"5232","2363矽統","110/07/13","港商野村",960,1679,-719
"5233","2363矽統","110/07/13","德信-中正",455,67,388
"5234","2363矽統","110/07/13","兆豐-復興",25,705,-680
"5235","2363矽統","110/07/13","日盛-竹北",365,70,295
"5236","2363矽統","110/07/13","統一-仁愛",114,755,-641
"5237","2363矽統","110/07/13","元大-佳里",452,189,263
"5238","2363矽統","110/07/13","統一-敦南",29,638,-609
"5239","2363矽統","110/07/13","國票-博愛",296,38,258
"5240","2363矽統","110/07/13","統一-土城",100,704,-604
"5241","2363矽統","110/07/13","元大-萬華",340,95,245
"5242","2363矽統","110/07/13","統一-城中",116,676,-560
"5243","2363矽統","110/07/13","新光",1259,1031,228
"5244","2363矽統","110/07/13","永豐金證券",306,859,-553
"5245","2363矽統","110/07/13","元富-成功",323,96,227
"5246","2363矽統","110/07/13","元富",54,567,-513
"5247","2363矽統","110/07/13","豐農",228,23,205
"5248","2363矽統","110/07/13","瑞士信貸",202,666,-464
"5249","2363矽統","110/07/13","台灣企銀-岡山",186,4,182
"5250","2363矽統","110/07/13","永豐金-嘉義",67,468,-401
"5251","8112至上","110/07/13","摩根大通",688,296,392
"5252","8112至上","110/07/13","國票-中和",0,401,-401
"5253","8112至上","110/07/13","港商野村",344,145,199
"5254","8112至上","110/07/13","永豐金-板盛",0,205,-205
"5255","8112至上","110/07/13","兆豐-公益",195,5,190
"5256","8112至上","110/07/13","凱基-五股",43,155,-112
"5257","8112至上","110/07/13","台灣摩根士丹利",183,0,183
"5258","8112至上","110/07/13","凱基-市政",0,100,-100
"5259","8112至上","110/07/13","群益金鼎-敦南",153,2,151
"5260","8112至上","110/07/13","元大-大里德芳",1,92,-91
"5261","8112至上","110/07/13","臺銀-金山",146,26,120
"5262","8112至上","110/07/13","玉山-桃園",26,110,-84
"5263","8112至上","110/07/13","臺銀",133,19,114
"5264","8112至上","110/07/13","兆豐-天母",0,81,-81
"5265","8112至上","110/07/13","合庫-台中",115,6,109
"5266","8112至上","110/07/13","凱基-城中",3,84,-81
"5267","8112至上","110/07/13","亞東-板橋",134,26,108
"5268","8112至上","110/07/13","日盛-新莊",9,85,-76
"5269","8112至上","110/07/13","凱基-台北",414,326,88
"5270","8112至上","110/07/13","日盛-台中",2,64,-62
"5271","8112至上","110/07/13","新加坡商瑞銀",181,100,81
"5272","8112至上","110/07/13","日盛-中壢",3,64,-61
"5273","8112至上","110/07/13","國泰-敦南",108,31,77
"5274","8112至上","110/07/13","元大-台中",2,59,-57
"5275","8112至上","110/07/13","第一金-華江",77,4,73
"5276","8112至上","110/07/13","元大-雙和",7,64,-57
"5277","8112至上","110/07/13","永豐金-內湖",73,1,72
"5278","8112至上","110/07/13","元大-高雄",8,62,-54
"5279","8112至上","110/07/13","元大-永和",68,1,67
"5280","8112至上","110/07/13","元大-館前",2,55,-53
"5281","2929淘帝","110/07/13","玉山-新竹",130,0,130
"5282","2929淘帝","110/07/13","美商高盛",0,177,-177
"5283","2929淘帝","110/07/13","臺銀-民權",60,0,60
"5284","2929淘帝","110/07/13","凱基-台北",6,80,-74
"5285","2929淘帝","110/07/13","新百王",31,0,31
"5286","2929淘帝","110/07/13","元富-大裕",0,49,-49
"5287","2929淘帝","110/07/13","日盛-園區",30,0,30
"5288","2929淘帝","110/07/13","國泰-館前",3,51,-48
"5289","2929淘帝","110/07/13","元大-南投",31,1,30
"5290","2929淘帝","110/07/13","凱基-中壢",0,41,-41
"5291","2929淘帝","110/07/13","兆豐-忠孝",28,0,28
"5292","2929淘帝","110/07/13","港商野村",21,55,-34
"5293","2929淘帝","110/07/13","元大-民生",28,0,28
"5294","2929淘帝","110/07/13","華南永昌-南京",2,34,-32
"5295","2929淘帝","110/07/13","合庫-高雄",27,0,27
"5296","2929淘帝","110/07/13","群益金鼎-土城",0,30,-30
"5297","2929淘帝","110/07/13","凱基-豐中",27,0,27
"5298","2929淘帝","110/07/13","富邦-南屯",0,22,-22
"5299","2929淘帝","110/07/13","新光",21,4,17
"5300","2929淘帝","110/07/13","第一金-豐原",0,20,-20
"5301","2929淘帝","110/07/13","元大-天母",17,0,17
"5302","2929淘帝","110/07/13","元大-屏南",6,26,-20
"5303","2929淘帝","110/07/13","永興",14,0,14
"5304","2929淘帝","110/07/13","永豐金-敦南",1,21,-20
"5305","2929淘帝","110/07/13","富邦-台北",12,0,12
"5306","2929淘帝","110/07/13","凱基-三重",2,21,-19
"5307","2929淘帝","110/07/13","元大-永和",12,0,12
"5308","2929淘帝","110/07/13","富邦-仁愛",7,25,-18
"5309","2929淘帝","110/07/13","國票-天祥",11,0,11
"5310","2929淘帝","110/07/13","元大-北投",0,16,-16
"5311","5410國眾","110/07/13","兆豐-城中",274,0,274
"5312","5410國眾","110/07/13","元富-嘉義",0,103,-103
"5313","5410國眾","110/07/13","新光",50,4,46
"5314","5410國眾","110/07/13","凱基-台北",0,50,-50
"5315","5410國眾","110/07/13","國泰-台中",26,0,26
"5316","5410國眾","110/07/13","瑞士信貸",0,31,-31
"5317","5410國眾","110/07/13","新加坡商瑞銀",22,0,22
"5318","5410國眾","110/07/13","台新-新莊",0,27,-27
"5319","5410國眾","110/07/13","光和-嘉義",20,0,20
"5320","5410國眾","110/07/13","元大-汐止",0,20,-20
"5321","5410國眾","110/07/13","凱基-竹北",17,0,17
"5322","5410國眾","110/07/13","亞東-新竹",0,17,-17
"5323","5410國眾","110/07/13","新光-桃園",15,0,15
"5324","5410國眾","110/07/13","元大-南勢角",0,13,-13
"5325","5410國眾","110/07/13","凱基-台東",14,0,14
"5326","5410國眾","110/07/13","台新-台南",0,12,-12
"5327","5410國眾","110/07/13","富邦-竹北",11,0,11
"5328","5410國眾","110/07/13","中國信託",0,11,-11
"5329","5410國眾","110/07/13","元富-同大",10,0,10
"5330","5410國眾","110/07/13","華南永昌",0,11,-11
"5331","5410國眾","110/07/13","國泰-敦南",24,15,9
"5332","5410國眾","110/07/13","臺銀-臺南",0,10,-10
"5333","5410國眾","110/07/13","日盛-內湖",7,0,7
"5334","5410國眾","110/07/13","台灣企銀-民雄",0,10,-10
"5335","5410國眾","110/07/13","台新-左楠",7,0,7
"5336","5410國眾","110/07/13","高橋",0,10,-10
"5337","5410國眾","110/07/13","元大-新盛",18,12,6
"5338","5410國眾","110/07/13","康和-嘉義",0,10,-10
"5339","5410國眾","110/07/13","統一",5,0,5
"5340","5410國眾","110/07/13","凱基-基隆",0,10,-10
"5341","2841台開","110/07/13","中國信託-高雄",251,50,201
"5342","2841台開","110/07/13","兆豐-公益",0,177,-177
"5343","2841台開","110/07/13","日盛證券",210,13,197
"5344","2841台開","110/07/13","日進",0,152,-152
"5345","2841台開","110/07/13","第一金-台中",55,0,55
"5346","2841台開","110/07/13","港商野村",0,109,-109
"5347","2841台開","110/07/13","國泰-板橋",46,0,46
"5348","2841台開","110/07/13","日盛-信義",0,103,-103
"5349","2841台開","110/07/13","國泰-館前",48,3,45
"5350","2841台開","110/07/13","國泰-敦南",11,75,-64
"5351","2841台開","110/07/13","華南永昌-新莊",45,0,45
"5352","2841台開","110/07/13","永興",0,50,-50
"5353","2841台開","110/07/13","日盛-園區",42,0,42
"5354","2841台開","110/07/13","永豐金-敦南",61,104,-43
"5355","2841台開","110/07/13","台新證券",32,0,32
"5356","2841台開","110/07/13","富邦-台南",0,42,-42
"5357","2841台開","110/07/13","台新-高雄",32,2,30
"5358","2841台開","110/07/13","國票-安和",0,30,-30
"5359","2841台開","110/07/13","豐農",23,0,23
"5360","2841台開","110/07/13","元大-桃園",0,25,-25
"5361","2841台開","110/07/13","合庫-嘉義",20,0,20
"5362","2841台開","110/07/13","新光",8,32,-24
"5363","2841台開","110/07/13","華南永昌-高雄",20,0,20
"5364","2841台開","110/07/13","元大-仁愛",0,24,-24
"5365","2841台開","110/07/13","元大-樹林",16,0,16
"5366","2841台開","110/07/13","日盛-中和",0,20,-20
"5367","2841台開","110/07/13","第一金-華江",15,2,13
"5368","2841台開","110/07/13","元富",0,20,-20
"5369","2841台開","110/07/13","美商高盛",12,0,12
"5370","2841台開","110/07/13","富邦-宜蘭",0,20,-20
"5371","6207雷科","110/07/13","元大-高雄",121,0,121
"5372","6207雷科","110/07/13","華南永昌-朴子",1,60,-59
"5373","6207雷科","110/07/13","第一金-新興",20,0,20
"5374","6207雷科","110/07/13","元大-南海",0,36,-36
"5375","6207雷科","110/07/13","元富-三重",20,0,20
"5376","6207雷科","110/07/13","凱基-土城",0,35,-35
"5377","6207雷科","110/07/13","元大-林園",15,0,15
"5378","6207雷科","110/07/13","台灣企銀",0,20,-20
"5379","6207雷科","110/07/13","元大-金華",16,1,15
"5380","6207雷科","110/07/13","群益金鼎-丹鳳",0,20,-20
"5381","6207雷科","110/07/13","日盛證券",10,0,10
"5382","6207雷科","110/07/13","元大-博愛",0,17,-17
"5383","6207雷科","110/07/13","統一-台中",10,0,10
"5384","6207雷科","110/07/13","元大-北港",0,13,-13
"5385","6207雷科","110/07/13","群益金鼎-土城",10,0,10
"5386","6207雷科","110/07/13","新加坡商瑞銀",0,12,-12
"5387","6207雷科","110/07/13","群益金鼎-桃園",10,0,10
"5388","6207雷科","110/07/13","凱基-台北",4,16,-12
"5389","6207雷科","110/07/13","永豐金-新莊",10,0,10
"5390","6207雷科","110/07/13","日茂-埔里",0,11,-11
"5391","6207雷科","110/07/13","永豐金-新店",10,0,10
"5392","6207雷科","110/07/13","元大-莒光",0,11,-11
"5393","6207雷科","110/07/13","元大證券",9,0,9
"5394","6207雷科","110/07/13","統一-新竹",0,10,-10
"5395","6207雷科","110/07/13","日盛-木柵",9,1,8
"5396","6207雷科","110/07/13","元大-西螺",0,10,-10
"5397","6207雷科","110/07/13","兆豐-來福",8,0,8
"5398","6207雷科","110/07/13","康和-台中",0,8,-8
"5399","6207雷科","110/07/13","新光",7,0,7
"5400","6207雷科","110/07/13","兆豐-高雄",0,6,-6
"5401","3679新至陞","110/07/13","永豐金證券",50,0,50
"5402","3679新至陞","110/07/13","摩根大通",2,25,-23
"5403","3679新至陞","110/07/13","國泰-桃園",22,0,22
"5404","3679新至陞","110/07/13","元大-成功",0,22,-22
"5405","3679新至陞","110/07/13","台中銀-員林",11,0,11
"5406","3679新至陞","110/07/13","富邦-板橋",1,19,-18
"5407","3679新至陞","110/07/13","元大-文心興安",8,0,8
"5408","3679新至陞","110/07/13","日盛-新莊",0,10,-10
"5409","3679新至陞","110/07/13","美商高盛",6,0,6
"5410","3679新至陞","110/07/13","台新-台中",0,10,-10
"5411","3679新至陞","110/07/13","台新-高雄",6,0,6
"5412","3679新至陞","110/07/13","永豐金-新竹",0,8,-8
"5413","3679新至陞","110/07/13","凱基-台北",18,12,6
"5414","3679新至陞","110/07/13","瑞士信貸",12,19,-7
"5415","3679新至陞","110/07/13","日盛-復興",5,0,5
"5416","3679新至陞","110/07/13","統一-南京",0,7,-7
"5417","3679新至陞","110/07/13","(牛牛牛)亞-鑫豐",4,0,4
"5418","3679新至陞","110/07/13","凱基-新莊",0,7,-7
"5419","3679新至陞","110/07/13","元富-大昌",3,0,3
"5420","3679新至陞","110/07/13","新加坡商瑞銀",0,6,-6
"5421","3679新至陞","110/07/13","富邦-台北",3,0,3
"5422","3679新至陞","110/07/13","合庫-自強",0,5,-5
"5423","3679新至陞","110/07/13","日盛-樹林",2,0,2
"5424","3679新至陞","110/07/13","富邦-桃園",0,5,-5
"5425","3679新至陞","110/07/13","宏遠-光隆",2,0,2
"5426","3679新至陞","110/07/13","永豐金-潮州",0,4,-4
"5427","3679新至陞","110/07/13","美林",3,1,2
"5428","3679新至陞","110/07/13","臺銀-臺南",0,3,-3
"5429","3679新至陞","110/07/13","第一金-中壢",2,0,2
"5430","3679新至陞","110/07/13","元大-六合",0,3,-3
"5431","2727王品","110/07/13","富邦-台北",43,3,40
"5432","2727王品","110/07/13","台灣摩根士丹利",15,97,-82
"5433","2727王品","110/07/13","元大-基隆孝二",40,0,40
"5434","2727王品","110/07/13","玉山-台南",5,57,-52
"5435","2727王品","110/07/13","國票-新莊",40,1,39
"5436","2727王品","110/07/13","新加坡商瑞銀",0,48,-48
"5437","2727王品","110/07/13","第一金-豐原",66,42,24
"5438","2727王品","110/07/13","凱基-台北",41,77,-36
"5439","2727王品","110/07/13","永豐金-大園",34,10,24
"5440","2727王品","110/07/13","永豐金-永康",0,22,-22
"5441","2727王品","110/07/13","元大-北屯",22,0,22
"5442","2727王品","110/07/13","統一-台中",2,22,-20
"5443","2727王品","110/07/13","元大-東蘆",26,7,19
"5444","2727王品","110/07/13","國泰-台中",21,39,-18
"5445","2727王品","110/07/13","永豐金-萬盛",13,1,12
"5446","2727王品","110/07/13","合庫-彰化",3,20,-17
"5447","2727王品","110/07/13","日盛-嘉義",11,0,11
"5448","2727王品","110/07/13","港商野村",13,30,-17
"5449","2727王品","110/07/13","日盛-八德",11,0,11
"5450","2727王品","110/07/13","元大-楊梅",1,16,-15
"5451","2727王品","110/07/13","統一-竹南",11,0,11
"5452","2727王品","110/07/13","凱基-高美館",2,15,-13
"5453","2727王品","110/07/13","日盛-士林",12,2,10
"5454","2727王品","110/07/13","美商高盛",2,14,-12
"5455","2727王品","110/07/13","統一-敦南",10,0,10
"5456","2727王品","110/07/13","統一-平鎮",1,13,-12
"5457","2727王品","110/07/13","中國信託",15,5,10
"5458","2727王品","110/07/13","兆豐-台中港",4,16,-12
"5459","2727王品","110/07/13","兆豐-竹北",13,3,10
"5460","2727王品","110/07/13","凱基-八德",1,13,-12
"5461","1570力肯","110/07/13","新光",115,11,104
"5462","1570力肯","110/07/13","元大-北三重",0,162,-162
"5463","1570力肯","110/07/13","群益金鼎-高雄",54,0,54
"5464","1570力肯","110/07/13","元大-大灣",0,25,-25
"5465","1570力肯","110/07/13","國票-新莊",22,0,22
"5466","1570力肯","110/07/13","永豐金-苓雅",0,22,-22
"5467","1570力肯","110/07/13","日盛-桃園",12,0,12
"5468","1570力肯","110/07/13","永豐金-永康",0,19,-19
"5469","1570力肯","110/07/13","元大-高雄",12,0,12
"5470","1570力肯","110/07/13","富邦-員林",0,15,-15
"5471","1570力肯","110/07/13","合庫-自強",11,0,11
"5472","1570力肯","110/07/13","凱基-台南",0,11,-11
"5473","1570力肯","110/07/13","摩根大通",26,15,11
"5474","1570力肯","110/07/13","日盛-竹北",0,10,-10
"5475","1570力肯","110/07/13","永豐金-中盛",11,0,11
"5476","1570力肯","110/07/13","國票-九鼎",0,10,-10
"5477","1570力肯","110/07/13","兆豐-台中港",10,0,10
"5478","1570力肯","110/07/13","凱基-桃園",0,10,-10
"5479","1570力肯","110/07/13","國泰-松江",9,0,9
"5480","1570力肯","110/07/13","凱基-新豐",0,10,-10
"5481","1570力肯","110/07/13","元大-新盛",9,0,9
"5482","1570力肯","110/07/13","元大-學甲",0,10,-10
"5483","1570力肯","110/07/13","元富-緯城",6,0,6
"5484","1570力肯","110/07/13","群益金鼎-東湖",1,10,-9
"5485","1570力肯","110/07/13","統一-三重",5,0,5
"5486","1570力肯","110/07/13","大昌",0,6,-6
"5487","1570力肯","110/07/13","元大-前金",5,0,5
"5488","1570力肯","110/07/13","元大-土城學府",0,6,-6
"5489","1570力肯","110/07/13","永豐金證券",5,0,5
"5490","1570力肯","110/07/13","統一",0,5,-5
"5491","6180橘子","110/07/13","摩根大通",119,0,119
"5492","6180橘子","110/07/13","元大-崇德",2,61,-59
"5493","6180橘子","110/07/13","美商高盛",96,0,96
"5494","6180橘子","110/07/13","康和-台中",0,51,-51
"5495","6180橘子","110/07/13","新加坡商瑞銀",86,7,79
"5496","6180橘子","110/07/13","康和-台北",0,50,-50
"5497","6180橘子","110/07/13","元大-和平",40,0,40
"5498","6180橘子","110/07/13","元富-潮州",0,40,-40
"5499","6180橘子","110/07/13","凱基-台北",83,47,36
"5500","6180橘子","110/07/13","日盛-永康",0,26,-26
"5501","6180橘子","110/07/13","美林",39,5,34
"5502","6180橘子","110/07/13","永豐金-中正",0,24,-24
"5503","6180橘子","110/07/13","富邦-新竹華信",31,2,29
"5504","6180橘子","110/07/13","國泰-板橋",2,25,-23
"5505","6180橘子","110/07/13","統一-南京",21,0,21
"5506","6180橘子","110/07/13","日盛-大墩",0,20,-20
"5507","6180橘子","110/07/13","富邦-陽明",24,3,21
"5508","6180橘子","110/07/13","元大-草屯",13,32,-19
"5509","6180橘子","110/07/13","大昌-樹林",21,1,20
"5510","6180橘子","110/07/13","元富-林園",1,18,-17
"5511","6180橘子","110/07/13","花旗環球",19,0,19
"5512","6180橘子","110/07/13","新光-新竹",1,18,-17
"5513","6180橘子","110/07/13","華南永昌-台南",19,0,19
"5514","6180橘子","110/07/13","元大-土城永寧",0,17,-17
"5515","6180橘子","110/07/13","福勝",14,0,14
"5516","6180橘子","110/07/13","國泰-新莊",3,19,-16
"5517","6180橘子","110/07/13","富邦-嘉義",12,1,11
"5518","6180橘子","110/07/13","中國信託-永康",6,21,-15
"5519","6180橘子","110/07/13","元大-板橋三民",11,0,11
"5520","6180橘子","110/07/13","凱基-東港",1,15,-14
"5521","2390云辰","110/07/13","新加坡商瑞銀",562,75,487
"5522","2390云辰","110/07/13","大展-台南",0,532,-532
"5523","2390云辰","110/07/13","台灣摩根士丹利",330,155,175
"5524","2390云辰","110/07/13","凱基-台北",668,854,-186
"5525","2390云辰","110/07/13","兆豐-公益",126,25,101
"5526","2390云辰","110/07/13","凱基-三重",12,172,-160
"5527","2390云辰","110/07/13","元富-中港",100,2,98
"5528","2390云辰","110/07/13","兆豐-忠孝",4,161,-157
"5529","2390云辰","110/07/13","統一-新台中",106,9,97
"5530","2390云辰","110/07/13","元大-士林",19,170,-151
"5531","2390云辰","110/07/13","中國信託-松江",81,11,70
"5532","2390云辰","110/07/13","臺銀-新竹",14,117,-103
"5533","2390云辰","110/07/13","日盛-板橋",72,3,69
"5534","2390云辰","110/07/13","國票-台中",4,102,-98
"5535","2390云辰","110/07/13","日盛-和美",57,0,57
"5536","2390云辰","110/07/13","新光",147,232,-85
"5537","2390云辰","110/07/13","永豐金-桃園",88,36,52
"5538","2390云辰","110/07/13","致和-崇德",2,70,-68
"5539","2390云辰","110/07/13","玉山-士林",54,4,50
"5540","2390云辰","110/07/13","群益金鼎-屏東",2,70,-68
"5541","2390云辰","110/07/13","富邦-仁愛",56,6,50
"5542","2390云辰","110/07/13","元大-大里",35,98,-63
"5543","2390云辰","110/07/13","第一金-豐原",50,1,49
"5544","2390云辰","110/07/13","元大-萬華",35,94,-59
"5545","2390云辰","110/07/13","摩根大通",502,453,49
"5546","2390云辰","110/07/13","元富-吉利",2,60,-58
"5547","2390云辰","110/07/13","凱基-松山",61,13,48
"5548","2390云辰","110/07/13","兆豐-新竹",3,53,-50
"5549","2390云辰","110/07/13","大昌",64,22,42
"5550","2390云辰","110/07/13","富邦-嘉義",65,108,-43
"5551","2363矽統","110/07/13","凱基-南崁",2133,63,2070
"5552","2363矽統","110/07/13","凱基-幸福",36,4048,-4012
"5553","2363矽統","110/07/13","國泰-敦南",2195,1617,578
"5554","2363矽統","110/07/13","統一",192,3325,-3133
"5555","2363矽統","110/07/13","中農",670,139,531
"5556","2363矽統","110/07/13","新加坡商瑞銀",1000,2747,-1747
"5557","2363矽統","110/07/13","康和-台中",638,154,484
"5558","2363矽統","110/07/13","凱基-台北",5359,6609,-1250
"5559","2363矽統","110/07/13","群益金鼎-三民",577,137,440
"5560","2363矽統","110/07/13","摩根大通",1930,2858,-928
"5561","2363矽統","110/07/13","台新-屏東",510,88,422
"5562","2363矽統","110/07/13","港商野村",960,1679,-719
"5563","2363矽統","110/07/13","德信-中正",455,67,388
"5564","2363矽統","110/07/13","兆豐-復興",25,705,-680
"5565","2363矽統","110/07/13","日盛-竹北",365,70,295
"5566","2363矽統","110/07/13","統一-仁愛",114,755,-641
"5567","2363矽統","110/07/13","元大-佳里",452,189,263
"5568","2363矽統","110/07/13","統一-敦南",29,638,-609
"5569","2363矽統","110/07/13","國票-博愛",296,38,258
"5570","2363矽統","110/07/13","統一-土城",100,704,-604
"5571","2363矽統","110/07/13","元大-萬華",340,95,245
"5572","2363矽統","110/07/13","統一-城中",116,676,-560
"5573","2363矽統","110/07/13","新光",1259,1031,228
"5574","2363矽統","110/07/13","永豐金證券",306,859,-553
"5575","2363矽統","110/07/13","元富-成功",323,96,227
"5576","2363矽統","110/07/13","元富",54,567,-513
"5577","2363矽統","110/07/13","豐農",228,23,205
"5578","2363矽統","110/07/13","瑞士信貸",202,666,-464
"5579","2363矽統","110/07/13","台灣企銀-岡山",186,4,182
"5580","2363矽統","110/07/13","永豐金-嘉義",67,468,-401
"5581","8112至上","110/07/13","摩根大通",688,296,392
"5582","8112至上","110/07/13","國票-中和",0,401,-401
"5583","8112至上","110/07/13","港商野村",344,145,199
"5584","8112至上","110/07/13","永豐金-板盛",0,205,-205
"5585","8112至上","110/07/13","兆豐-公益",195,5,190
"5586","8112至上","110/07/13","凱基-五股",43,155,-112
"5587","8112至上","110/07/13","台灣摩根士丹利",183,0,183
"5588","8112至上","110/07/13","凱基-市政",0,100,-100
"5589","8112至上","110/07/13","群益金鼎-敦南",153,2,151
"5590","8112至上","110/07/13","元大-大里德芳",1,92,-91
"5591","8112至上","110/07/13","臺銀-金山",146,26,120
"5592","8112至上","110/07/13","玉山-桃園",26,110,-84
"5593","8112至上","110/07/13","臺銀",133,19,114
"5594","8112至上","110/07/13","兆豐-天母",0,81,-81
"5595","8112至上","110/07/13","合庫-台中",115,6,109
"5596","8112至上","110/07/13","凱基-城中",3,84,-81
"5597","8112至上","110/07/13","亞東-板橋",134,26,108
"5598","8112至上","110/07/13","日盛-新莊",9,85,-76
"5599","8112至上","110/07/13","凱基-台北",414,326,88
"5600","8112至上","110/07/13","日盛-台中",2,64,-62
"5601","8112至上","110/07/13","新加坡商瑞銀",181,100,81
"5602","8112至上","110/07/13","日盛-中壢",3,64,-61
"5603","8112至上","110/07/13","國泰-敦南",108,31,77
"5604","8112至上","110/07/13","元大-台中",2,59,-57
"5605","8112至上","110/07/13","第一金-華江",77,4,73
"5606","8112至上","110/07/13","元大-雙和",7,64,-57
"5607","8112至上","110/07/13","永豐金-內湖",73,1,72
"5608","8112至上","110/07/13","元大-高雄",8,62,-54
"5609","8112至上","110/07/13","元大-永和",68,1,67
"5610","8112至上","110/07/13","元大-館前",2,55,-53
"5611","4903聯光通","110/07/13","台灣企銀-太平",56,0,56
"5612","4903聯光通","110/07/13","土銀",0,32,-32
"5613","4903聯光通","110/07/13","元富-新興",23,0,23
"5614","4903聯光通","110/07/13","元大-樹林",0,19,-19
"5615","4903聯光通","110/07/13","日盛-樹林",22,0,22
"5616","4903聯光通","110/07/13","凱基-士林",0,17,-17
"5617","4903聯光通","110/07/13","兆豐-天母",20,0,20
"5618","4903聯光通","110/07/13","國票-博愛",0,14,-14
"5619","4903聯光通","110/07/13","華南永昌-桃園",20,0,20
"5620","4903聯光通","110/07/13","元富",0,10,-10
"5621","4903聯光通","110/07/13","富邦-新店",10,0,10
"5622","4903聯光通","110/07/13","新光",0,10,-10
"5623","4903聯光通","110/07/13","新光-台中",5,0,5
"5624","4903聯光通","110/07/13","玉山-南京東路",0,10,-10
"5625","4903聯光通","110/07/13","華南永昌-台中",5,0,5
"5626","4903聯光通","110/07/13","富邦-陽明",0,10,-10
"5627","4903聯光通","110/07/13","元大-崇德",5,0,5
"5628","4903聯光通","110/07/13","元大-大甲",0,8,-8
"5629","4903聯光通","110/07/13","元大-草屯",5,0,5
"5630","4903聯光通","110/07/13","富邦-台中",0,7,-7
"5631","4903聯光通","110/07/13","元富-草屯",4,0,4
"5632","4903聯光通","110/07/13","凱基-中壢",0,6,-6
"5633","4903聯光通","110/07/13","元大-清水",4,0,4
"5634","4903聯光通","110/07/13","臺銀-民權",0,5,-5
"5635","4903聯光通","110/07/13","元大-東泰",4,0,4
"5636","4903聯光通","110/07/13","日盛-板橋",0,5,-5
"5637","4903聯光通","110/07/13","元大-佳里",2,0,2
"5638","4903聯光通","110/07/13","中國信託-忠孝",0,5,-5
"5639","4903聯光通","110/07/13","永豐金-板橋",2,0,2
"5640","4903聯光通","110/07/13","永豐金-鳳山",0,5,-5
"5641","2929淘帝","110/07/13","玉山-新竹",130,0,130
"5642","2929淘帝","110/07/13","美商高盛",0,177,-177
"5643","2929淘帝","110/07/13","臺銀-民權",60,0,60
"5644","2929淘帝","110/07/13","凱基-台北",6,80,-74
"5645","2929淘帝","110/07/13","新百王",31,0,31
"5646","2929淘帝","110/07/13","元富-大裕",0,49,-49
"5647","2929淘帝","110/07/13","日盛-園區",30,0,30
"5648","2929淘帝","110/07/13","國泰-館前",3,51,-48
"5649","2929淘帝","110/07/13","元大-南投",31,1,30
"5650","2929淘帝","110/07/13","凱基-中壢",0,41,-41
"5651","2929淘帝","110/07/13","兆豐-忠孝",28,0,28
"5652","2929淘帝","110/07/13","港商野村",21,55,-34
"5653","2929淘帝","110/07/13","元大-民生",28,0,28
"5654","2929淘帝","110/07/13","華南永昌-南京",2,34,-32
"5655","2929淘帝","110/07/13","合庫-高雄",27,0,27
"5656","2929淘帝","110/07/13","群益金鼎-土城",0,30,-30
"5657","2929淘帝","110/07/13","凱基-豐中",27,0,27
"5658","2929淘帝","110/07/13","富邦-南屯",0,22,-22
"5659","2929淘帝","110/07/13","新光",21,4,17
"5660","2929淘帝","110/07/13","第一金-豐原",0,20,-20
"5661","2929淘帝","110/07/13","元大-天母",17,0,17
"5662","2929淘帝","110/07/13","元大-屏南",6,26,-20
"5663","2929淘帝","110/07/13","永興",14,0,14
"5664","2929淘帝","110/07/13","永豐金-敦南",1,21,-20
"5665","2929淘帝","110/07/13","富邦-台北",12,0,12
"5666","2929淘帝","110/07/13","凱基-三重",2,21,-19
"5667","2929淘帝","110/07/13","元大-永和",12,0,12
"5668","2929淘帝","110/07/13","富邦-仁愛",7,25,-18
"5669","2929淘帝","110/07/13","國票-天祥",11,0,11
"5670","2929淘帝","110/07/13","元大-北投",0,16,-16
"5671","5410國眾","110/07/13","兆豐-城中",274,0,274
"5672","5410國眾","110/07/13","元富-嘉義",0,103,-103
"5673","5410國眾","110/07/13","新光",50,4,46
"5674","5410國眾","110/07/13","凱基-台北",0,50,-50
"5675","5410國眾","110/07/13","國泰-台中",26,0,26
"5676","5410國眾","110/07/13","瑞士信貸",0,31,-31
"5677","5410國眾","110/07/13","新加坡商瑞銀",22,0,22
"5678","5410國眾","110/07/13","台新-新莊",0,27,-27
"5679","5410國眾","110/07/13","光和-嘉義",20,0,20
"5680","5410國眾","110/07/13","元大-汐止",0,20,-20
"5681","5410國眾","110/07/13","凱基-竹北",17,0,17
"5682","5410國眾","110/07/13","亞東-新竹",0,17,-17
"5683","5410國眾","110/07/13","新光-桃園",15,0,15
"5684","5410國眾","110/07/13","元大-南勢角",0,13,-13
"5685","5410國眾","110/07/13","凱基-台東",14,0,14
"5686","5410國眾","110/07/13","台新-台南",0,12,-12
"5687","5410國眾","110/07/13","富邦-竹北",11,0,11
"5688","5410國眾","110/07/13","中國信託",0,11,-11
"5689","5410國眾","110/07/13","元富-同大",10,0,10
"5690","5410國眾","110/07/13","華南永昌",0,11,-11
"5691","5410國眾","110/07/13","國泰-敦南",24,15,9
"5692","5410國眾","110/07/13","臺銀-臺南",0,10,-10
"5693","5410國眾","110/07/13","日盛-內湖",7,0,7
"5694","5410國眾","110/07/13","台灣企銀-民雄",0,10,-10
"5695","5410國眾","110/07/13","台新-左楠",7,0,7
"5696","5410國眾","110/07/13","高橋",0,10,-10
"5697","5410國眾","110/07/13","元大-新盛",18,12,6
"5698","5410國眾","110/07/13","康和-嘉義",0,10,-10
"5699","5410國眾","110/07/13","統一",5,0,5
"5700","5410國眾","110/07/13","凱基-基隆",0,10,-10
"5701","2841台開","110/07/13","中國信託-高雄",251,50,201
"5702","2841台開","110/07/13","兆豐-公益",0,177,-177
"5703","2841台開","110/07/13","日盛證券",210,13,197
"5704","2841台開","110/07/13","日進",0,152,-152
"5705","2841台開","110/07/13","第一金-台中",55,0,55
"5706","2841台開","110/07/13","港商野村",0,109,-109
"5707","2841台開","110/07/13","國泰-板橋",46,0,46
"5708","2841台開","110/07/13","日盛-信義",0,103,-103
"5709","2841台開","110/07/13","國泰-館前",48,3,45
"5710","2841台開","110/07/13","國泰-敦南",11,75,-64
"5711","2841台開","110/07/13","華南永昌-新莊",45,0,45
"5712","2841台開","110/07/13","永興",0,50,-50
"5713","2841台開","110/07/13","日盛-園區",42,0,42
"5714","2841台開","110/07/13","永豐金-敦南",61,104,-43
"5715","2841台開","110/07/13","台新證券",32,0,32
"5716","2841台開","110/07/13","富邦-台南",0,42,-42
"5717","2841台開","110/07/13","台新-高雄",32,2,30
"5718","2841台開","110/07/13","國票-安和",0,30,-30
"5719","2841台開","110/07/13","豐農",23,0,23
"5720","2841台開","110/07/13","元大-桃園",0,25,-25
"5721","2841台開","110/07/13","合庫-嘉義",20,0,20
"5722","2841台開","110/07/13","新光",8,32,-24
"5723","2841台開","110/07/13","華南永昌-高雄",20,0,20
"5724","2841台開","110/07/13","元大-仁愛",0,24,-24
"5725","2841台開","110/07/13","元大-樹林",16,0,16
"5726","2841台開","110/07/13","日盛-中和",0,20,-20
"5727","2841台開","110/07/13","第一金-華江",15,2,13
"5728","2841台開","110/07/13","元富",0,20,-20
"5729","2841台開","110/07/13","美商高盛",12,0,12
"5730","2841台開","110/07/13","富邦-宜蘭",0,20,-20
"5731","6207雷科","110/07/13","元大-高雄",121,0,121
"5732","6207雷科","110/07/13","華南永昌-朴子",1,60,-59
"5733","6207雷科","110/07/13","第一金-新興",20,0,20
"5734","6207雷科","110/07/13","元大-南海",0,36,-36
"5735","6207雷科","110/07/13","元富-三重",20,0,20
"5736","6207雷科","110/07/13","凱基-土城",0,35,-35
"5737","6207雷科","110/07/13","元大-林園",15,0,15
"5738","6207雷科","110/07/13","台灣企銀",0,20,-20
"5739","6207雷科","110/07/13","元大-金華",16,1,15
"5740","6207雷科","110/07/13","群益金鼎-丹鳳",0,20,-20
"5741","6207雷科","110/07/13","日盛證券",10,0,10
"5742","6207雷科","110/07/13","元大-博愛",0,17,-17
"5743","6207雷科","110/07/13","統一-台中",10,0,10
"5744","6207雷科","110/07/13","元大-北港",0,13,-13
"5745","6207雷科","110/07/13","群益金鼎-土城",10,0,10
"5746","6207雷科","110/07/13","新加坡商瑞銀",0,12,-12
"5747","6207雷科","110/07/13","群益金鼎-桃園",10,0,10
"5748","6207雷科","110/07/13","凱基-台北",4,16,-12
"5749","6207雷科","110/07/13","永豐金-新莊",10,0,10
"5750","6207雷科","110/07/13","日茂-埔里",0,11,-11
"5751","6207雷科","110/07/13","永豐金-新店",10,0,10
"5752","6207雷科","110/07/13","元大-莒光",0,11,-11
"5753","6207雷科","110/07/13","元大證券",9,0,9
"5754","6207雷科","110/07/13","統一-新竹",0,10,-10
"5755","6207雷科","110/07/13","日盛-木柵",9,1,8
"5756","6207雷科","110/07/13","元大-西螺",0,10,-10
"5757","6207雷科","110/07/13","兆豐-來福",8,0,8
"5758","6207雷科","110/07/13","康和-台中",0,8,-8
"5759","6207雷科","110/07/13","新光",7,0,7
"5760","6207雷科","110/07/13","兆豐-高雄",0,6,-6
"5761","3679新至陞","110/07/13","永豐金證券",50,0,50
"5762","3679新至陞","110/07/13","摩根大通",2,25,-23
"5763","3679新至陞","110/07/13","國泰-桃園",22,0,22
"5764","3679新至陞","110/07/13","元大-成功",0,22,-22
"5765","3679新至陞","110/07/13","台中銀-員林",11,0,11
"5766","3679新至陞","110/07/13","富邦-板橋",1,19,-18
"5767","3679新至陞","110/07/13","元大-文心興安",8,0,8
"5768","3679新至陞","110/07/13","日盛-新莊",0,10,-10
"5769","3679新至陞","110/07/13","美商高盛",6,0,6
"5770","3679新至陞","110/07/13","台新-台中",0,10,-10
"5771","3679新至陞","110/07/13","台新-高雄",6,0,6
"5772","3679新至陞","110/07/13","永豐金-新竹",0,8,-8
"5773","3679新至陞","110/07/13","凱基-台北",18,12,6
"5774","3679新至陞","110/07/13","瑞士信貸",12,19,-7
"5775","3679新至陞","110/07/13","日盛-復興",5,0,5
"5776","3679新至陞","110/07/13","統一-南京",0,7,-7
"5777","3679新至陞","110/07/13","(牛牛牛)亞-鑫豐",4,0,4
"5778","3679新至陞","110/07/13","凱基-新莊",0,7,-7
"5779","3679新至陞","110/07/13","元富-大昌",3,0,3
"5780","3679新至陞","110/07/13","新加坡商瑞銀",0,6,-6
"5781","3679新至陞","110/07/13","富邦-台北",3,0,3
"5782","3679新至陞","110/07/13","合庫-自強",0,5,-5
"5783","3679新至陞","110/07/13","日盛-樹林",2,0,2
"5784","3679新至陞","110/07/13","富邦-桃園",0,5,-5
"5785","3679新至陞","110/07/13","宏遠-光隆",2,0,2
"5786","3679新至陞","110/07/13","永豐金-潮州",0,4,-4
"5787","3679新至陞","110/07/13","美林",3,1,2
"5788","3679新至陞","110/07/13","臺銀-臺南",0,3,-3
"5789","3679新至陞","110/07/13","第一金-中壢",2,0,2
"5790","3679新至陞","110/07/13","元大-六合",0,3,-3
"5791","2727王品","110/07/13","富邦-台北",43,3,40
"5792","2727王品","110/07/13","台灣摩根士丹利",15,97,-82
"5793","2727王品","110/07/13","元大-基隆孝二",40,0,40
"5794","2727王品","110/07/13","玉山-台南",5,57,-52
"5795","2727王品","110/07/13","國票-新莊",40,1,39
"5796","2727王品","110/07/13","新加坡商瑞銀",0,48,-48
"5797","2727王品","110/07/13","第一金-豐原",66,42,24
"5798","2727王品","110/07/13","凱基-台北",41,77,-36
"5799","2727王品","110/07/13","永豐金-大園",34,10,24
"5800","2727王品","110/07/13","永豐金-永康",0,22,-22
"5801","2727王品","110/07/13","元大-北屯",22,0,22
"5802","2727王品","110/07/13","統一-台中",2,22,-20
"5803","2727王品","110/07/13","元大-東蘆",26,7,19
"5804","2727王品","110/07/13","國泰-台中",21,39,-18
"5805","2727王品","110/07/13","永豐金-萬盛",13,1,12
"5806","2727王品","110/07/13","合庫-彰化",3,20,-17
"5807","2727王品","110/07/13","日盛-嘉義",11,0,11
"5808","2727王品","110/07/13","港商野村",13,30,-17
"5809","2727王品","110/07/13","日盛-八德",11,0,11
"5810","2727王品","110/07/13","元大-楊梅",1,16,-15
"5811","2727王品","110/07/13","統一-竹南",11,0,11
"5812","2727王品","110/07/13","凱基-高美館",2,15,-13
"5813","2727王品","110/07/13","日盛-士林",12,2,10
"5814","2727王品","110/07/13","美商高盛",2,14,-12
"5815","2727王品","110/07/13","統一-敦南",10,0,10
"5816","2727王品","110/07/13","統一-平鎮",1,13,-12
"5817","2727王品","110/07/13","中國信託",15,5,10
"5818","2727王品","110/07/13","兆豐-台中港",4,16,-12
"5819","2727王品","110/07/13","兆豐-竹北",13,3,10
"5820","2727王品","110/07/13","凱基-八德",1,13,-12
"5821","1570力肯","110/07/13","新光",115,11,104
"5822","1570力肯","110/07/13","元大-北三重",0,162,-162
"5823","1570力肯","110/07/13","群益金鼎-高雄",54,0,54
"5824","1570力肯","110/07/13","元大-大灣",0,25,-25
"5825","1570力肯","110/07/13","國票-新莊",22,0,22
"5826","1570力肯","110/07/13","永豐金-苓雅",0,22,-22
"5827","1570力肯","110/07/13","日盛-桃園",12,0,12
"5828","1570力肯","110/07/13","永豐金-永康",0,19,-19
"5829","1570力肯","110/07/13","元大-高雄",12,0,12
"5830","1570力肯","110/07/13","富邦-員林",0,15,-15
"5831","1570力肯","110/07/13","合庫-自強",11,0,11
"5832","1570力肯","110/07/13","凱基-台南",0,11,-11
"5833","1570力肯","110/07/13","摩根大通",26,15,11
"5834","1570力肯","110/07/13","日盛-竹北",0,10,-10
"5835","1570力肯","110/07/13","永豐金-中盛",11,0,11
"5836","1570力肯","110/07/13","國票-九鼎",0,10,-10
"5837","1570力肯","110/07/13","兆豐-台中港",10,0,10
"5838","1570力肯","110/07/13","凱基-桃園",0,10,-10
"5839","1570力肯","110/07/13","國泰-松江",9,0,9
"5840","1570力肯","110/07/13","凱基-新豐",0,10,-10
"5841","1570力肯","110/07/13","元大-新盛",9,0,9
"5842","1570力肯","110/07/13","元大-學甲",0,10,-10
"5843","1570力肯","110/07/13","元富-緯城",6,0,6
"5844","1570力肯","110/07/13","群益金鼎-東湖",1,10,-9
"5845","1570力肯","110/07/13","統一-三重",5,0,5
"5846","1570力肯","110/07/13","大昌",0,6,-6
"5847","1570力肯","110/07/13","元大-前金",5,0,5
"5848","1570力肯","110/07/13","元大-土城學府",0,6,-6
"5849","1570力肯","110/07/13","永豐金證券",5,0,5
"5850","1570力肯","110/07/13","統一",0,5,-5
"5851","6180橘子","110/07/13","摩根大通",119,0,119
"5852","6180橘子","110/07/13","元大-崇德",2,61,-59
"5853","6180橘子","110/07/13","美商高盛",96,0,96
"5854","6180橘子","110/07/13","康和-台中",0,51,-51
"5855","6180橘子","110/07/13","新加坡商瑞銀",86,7,79
"5856","6180橘子","110/07/13","康和-台北",0,50,-50
"5857","6180橘子","110/07/13","元大-和平",40,0,40
"5858","6180橘子","110/07/13","元富-潮州",0,40,-40
"5859","6180橘子","110/07/13","凱基-台北",83,47,36
"5860","6180橘子","110/07/13","日盛-永康",0,26,-26
"5861","6180橘子","110/07/13","美林",39,5,34
"5862","6180橘子","110/07/13","永豐金-中正",0,24,-24
"5863","6180橘子","110/07/13","富邦-新竹華信",31,2,29
"5864","6180橘子","110/07/13","國泰-板橋",2,25,-23
"5865","6180橘子","110/07/13","統一-南京",21,0,21
"5866","6180橘子","110/07/13","日盛-大墩",0,20,-20
"5867","6180橘子","110/07/13","富邦-陽明",24,3,21
"5868","6180橘子","110/07/13","元大-草屯",13,32,-19
"5869","6180橘子","110/07/13","大昌-樹林",21,1,20
"5870","6180橘子","110/07/13","元富-林園",1,18,-17
"5871","6180橘子","110/07/13","花旗環球",19,0,19
"5872","6180橘子","110/07/13","新光-新竹",1,18,-17
"5873","6180橘子","110/07/13","華南永昌-台南",19,0,19
"5874","6180橘子","110/07/13","元大-土城永寧",0,17,-17
"5875","6180橘子","110/07/13","福勝",14,0,14
"5876","6180橘子","110/07/13","國泰-新莊",3,19,-16
"5877","6180橘子","110/07/13","富邦-嘉義",12,1,11
"5878","6180橘子","110/07/13","中國信託-永康",6,21,-15
"5879","6180橘子","110/07/13","元大-板橋三民",11,0,11
"5880","6180橘子","110/07/13","凱基-東港",1,15,-14
"5881","2390云辰","110/07/13","新加坡商瑞銀",562,75,487
"5882","2390云辰","110/07/13","大展-台南",0,532,-532
"5883","2390云辰","110/07/13","台灣摩根士丹利",330,155,175
"5884","2390云辰","110/07/13","凱基-台北",668,854,-186
"5885","2390云辰","110/07/13","兆豐-公益",126,25,101
"5886","2390云辰","110/07/13","凱基-三重",12,172,-160
"5887","2390云辰","110/07/13","元富-中港",100,2,98
"5888","2390云辰","110/07/13","兆豐-忠孝",4,161,-157
"5889","2390云辰","110/07/13","統一-新台中",106,9,97
"5890","2390云辰","110/07/13","元大-士林",19,170,-151
"5891","2390云辰","110/07/13","中國信託-松江",81,11,70
"5892","2390云辰","110/07/13","臺銀-新竹",14,117,-103
"5893","2390云辰","110/07/13","日盛-板橋",72,3,69
"5894","2390云辰","110/07/13","國票-台中",4,102,-98
"5895","2390云辰","110/07/13","日盛-和美",57,0,57
"5896","2390云辰","110/07/13","新光",147,232,-85
"5897","2390云辰","110/07/13","永豐金-桃園",88,36,52
"5898","2390云辰","110/07/13","致和-崇德",2,70,-68
"5899","2390云辰","110/07/13","玉山-士林",54,4,50
"5900","2390云辰","110/07/13","群益金鼎-屏東",2,70,-68
"5901","2390云辰","110/07/13","富邦-仁愛",56,6,50
"5902","2390云辰","110/07/13","元大-大里",35,98,-63
"5903","2390云辰","110/07/13","第一金-豐原",50,1,49
"5904","2390云辰","110/07/13","元大-萬華",35,94,-59
"5905","2390云辰","110/07/13","摩根大通",502,453,49
"5906","2390云辰","110/07/13","元富-吉利",2,60,-58
"5907","2390云辰","110/07/13","凱基-松山",61,13,48
"5908","2390云辰","110/07/13","兆豐-新竹",3,53,-50
"5909","2390云辰","110/07/13","大昌",64,22,42
"5910","2390云辰","110/07/13","富邦-嘉義",65,108,-43
"5911","2363矽統","110/07/13","凱基-南崁",2133,63,2070
"5912","2363矽統","110/07/13","凱基-幸福",36,4048,-4012
"5913","2363矽統","110/07/13","國泰-敦南",2195,1617,578
"5914","2363矽統","110/07/13","統一",192,3325,-3133
"5915","2363矽統","110/07/13","中農",670,139,531
"5916","2363矽統","110/07/13","新加坡商瑞銀",1000,2747,-1747
"5917","2363矽統","110/07/13","康和-台中",638,154,484
"5918","2363矽統","110/07/13","凱基-台北",5359,6609,-1250
"5919","2363矽統","110/07/13","群益金鼎-三民",577,137,440
"5920","2363矽統","110/07/13","摩根大通",1930,2858,-928
"5921","2363矽統","110/07/13","台新-屏東",510,88,422
"5922","2363矽統","110/07/13","港商野村",960,1679,-719
"5923","2363矽統","110/07/13","德信-中正",455,67,388
"5924","2363矽統","110/07/13","兆豐-復興",25,705,-680
"5925","2363矽統","110/07/13","日盛-竹北",365,70,295
"5926","2363矽統","110/07/13","統一-仁愛",114,755,-641
"5927","2363矽統","110/07/13","元大-佳里",452,189,263
"5928","2363矽統","110/07/13","統一-敦南",29,638,-609
"5929","2363矽統","110/07/13","國票-博愛",296,38,258
"5930","2363矽統","110/07/13","統一-土城",100,704,-604
"5931","2363矽統","110/07/13","元大-萬華",340,95,245
"5932","2363矽統","110/07/13","統一-城中",116,676,-560
"5933","2363矽統","110/07/13","新光",1259,1031,228
"5934","2363矽統","110/07/13","永豐金證券",306,859,-553
"5935","2363矽統","110/07/13","元富-成功",323,96,227
"5936","2363矽統","110/07/13","元富",54,567,-513
"5937","2363矽統","110/07/13","豐農",228,23,205
"5938","2363矽統","110/07/13","瑞士信貸",202,666,-464
"5939","2363矽統","110/07/13","台灣企銀-岡山",186,4,182
"5940","2363矽統","110/07/13","永豐金-嘉義",67,468,-401
"5941","8112至上","110/07/13","摩根大通",688,296,392
"5942","8112至上","110/07/13","國票-中和",0,401,-401
"5943","8112至上","110/07/13","港商野村",344,145,199
"5944","8112至上","110/07/13","永豐金-板盛",0,205,-205
"5945","8112至上","110/07/13","兆豐-公益",195,5,190
"5946","8112至上","110/07/13","凱基-五股",43,155,-112
"5947","8112至上","110/07/13","台灣摩根士丹利",183,0,183
"5948","8112至上","110/07/13","凱基-市政",0,100,-100
"5949","8112至上","110/07/13","群益金鼎-敦南",153,2,151
"5950","8112至上","110/07/13","元大-大里德芳",1,92,-91
"5951","8112至上","110/07/13","臺銀-金山",146,26,120
"5952","8112至上","110/07/13","玉山-桃園",26,110,-84
"5953","8112至上","110/07/13","臺銀",133,19,114
"5954","8112至上","110/07/13","兆豐-天母",0,81,-81
"5955","8112至上","110/07/13","合庫-台中",115,6,109
"5956","8112至上","110/07/13","凱基-城中",3,84,-81
"5957","8112至上","110/07/13","亞東-板橋",134,26,108
"5958","8112至上","110/07/13","日盛-新莊",9,85,-76
"5959","8112至上","110/07/13","凱基-台北",414,326,88
"5960","8112至上","110/07/13","日盛-台中",2,64,-62
"5961","8112至上","110/07/13","新加坡商瑞銀",181,100,81
"5962","8112至上","110/07/13","日盛-中壢",3,64,-61
"5963","8112至上","110/07/13","國泰-敦南",108,31,77
"5964","8112至上","110/07/13","元大-台中",2,59,-57
"5965","8112至上","110/07/13","第一金-華江",77,4,73
"5966","8112至上","110/07/13","元大-雙和",7,64,-57
"5967","8112至上","110/07/13","永豐金-內湖",73,1,72
"5968","8112至上","110/07/13","元大-高雄",8,62,-54
"5969","8112至上","110/07/13","元大-永和",68,1,67
"5970","8112至上","110/07/13","元大-館前",2,55,-53
"5971","4903聯光通","110/07/13","台灣企銀-太平",56,0,56
"5972","4903聯光通","110/07/13","土銀",0,32,-32
"5973","4903聯光通","110/07/13","元富-新興",23,0,23
"5974","4903聯光通","110/07/13","元大-樹林",0,19,-19
"5975","4903聯光通","110/07/13","日盛-樹林",22,0,22
"5976","4903聯光通","110/07/13","凱基-士林",0,17,-17
"5977","4903聯光通","110/07/13","兆豐-天母",20,0,20
"5978","4903聯光通","110/07/13","國票-博愛",0,14,-14
"5979","4903聯光通","110/07/13","華南永昌-桃園",20,0,20
"5980","4903聯光通","110/07/13","元富",0,10,-10
"5981","4903聯光通","110/07/13","富邦-新店",10,0,10
"5982","4903聯光通","110/07/13","新光",0,10,-10
"5983","4903聯光通","110/07/13","新光-台中",5,0,5
"5984","4903聯光通","110/07/13","玉山-南京東路",0,10,-10
"5985","4903聯光通","110/07/13","華南永昌-台中",5,0,5
"5986","4903聯光通","110/07/13","富邦-陽明",0,10,-10
"5987","4903聯光通","110/07/13","元大-崇德",5,0,5
"5988","4903聯光通","110/07/13","元大-大甲",0,8,-8
"5989","4903聯光通","110/07/13","元大-草屯",5,0,5
"5990","4903聯光通","110/07/13","富邦-台中",0,7,-7
"5991","4903聯光通","110/07/13","元富-草屯",4,0,4
"5992","4903聯光通","110/07/13","凱基-中壢",0,6,-6
"5993","4903聯光通","110/07/13","元大-清水",4,0,4
"5994","4903聯光通","110/07/13","臺銀-民權",0,5,-5
"5995","4903聯光通","110/07/13","元大-東泰",4,0,4
"5996","4903聯光通","110/07/13","日盛-板橋",0,5,-5
"5997","4903聯光通","110/07/13","元大-佳里",2,0,2
"5998","4903聯光通","110/07/13","中國信託-忠孝",0,5,-5
"5999","4903聯光通","110/07/13","永豐金-板橋",2,0,2
"6000","4903聯光通","110/07/13","永豐金-鳳山",0,5,-5
"6001","2929淘帝","110/07/13","玉山-新竹",130,0,130
"6002","2929淘帝","110/07/13","美商高盛",0,177,-177
"6003","2929淘帝","110/07/13","臺銀-民權",60,0,60
"6004","2929淘帝","110/07/13","凱基-台北",6,80,-74
"6005","2929淘帝","110/07/13","新百王",31,0,31
"6006","2929淘帝","110/07/13","元富-大裕",0,49,-49
"6007","2929淘帝","110/07/13","日盛-園區",30,0,30
"6008","2929淘帝","110/07/13","國泰-館前",3,51,-48
"6009","2929淘帝","110/07/13","元大-南投",31,1,30
"6010","2929淘帝","110/07/13","凱基-中壢",0,41,-41
"6011","2929淘帝","110/07/13","兆豐-忠孝",28,0,28
"6012","2929淘帝","110/07/13","港商野村",21,55,-34
"6013","2929淘帝","110/07/13","元大-民生",28,0,28
"6014","2929淘帝","110/07/13","華南永昌-南京",2,34,-32
"6015","2929淘帝","110/07/13","合庫-高雄",27,0,27
"6016","2929淘帝","110/07/13","群益金鼎-土城",0,30,-30
"6017","2929淘帝","110/07/13","凱基-豐中",27,0,27
"6018","2929淘帝","110/07/13","富邦-南屯",0,22,-22
"6019","2929淘帝","110/07/13","新光",21,4,17
"6020","2929淘帝","110/07/13","第一金-豐原",0,20,-20
"6021","2929淘帝","110/07/13","元大-天母",17,0,17
"6022","2929淘帝","110/07/13","元大-屏南",6,26,-20
"6023","2929淘帝","110/07/13","永興",14,0,14
"6024","2929淘帝","110/07/13","永豐金-敦南",1,21,-20
"6025","2929淘帝","110/07/13","富邦-台北",12,0,12
"6026","2929淘帝","110/07/13","凱基-三重",2,21,-19
"6027","2929淘帝","110/07/13","元大-永和",12,0,12
"6028","2929淘帝","110/07/13","富邦-仁愛",7,25,-18
"6029","2929淘帝","110/07/13","國票-天祥",11,0,11
"6030","2929淘帝","110/07/13","元大-北投",0,16,-16
"6031","5410國眾","110/07/13","兆豐-城中",274,0,274
"6032","5410國眾","110/07/13","元富-嘉義",0,103,-103
"6033","5410國眾","110/07/13","新光",50,4,46
"6034","5410國眾","110/07/13","凱基-台北",0,50,-50
"6035","5410國眾","110/07/13","國泰-台中",26,0,26
"6036","5410國眾","110/07/13","瑞士信貸",0,31,-31
"6037","5410國眾","110/07/13","新加坡商瑞銀",22,0,22
"6038","5410國眾","110/07/13","台新-新莊",0,27,-27
"6039","5410國眾","110/07/13","光和-嘉義",20,0,20
"6040","5410國眾","110/07/13","元大-汐止",0,20,-20
"6041","5410國眾","110/07/13","凱基-竹北",17,0,17
"6042","5410國眾","110/07/13","亞東-新竹",0,17,-17
"6043","5410國眾","110/07/13","新光-桃園",15,0,15
"6044","5410國眾","110/07/13","元大-南勢角",0,13,-13
"6045","5410國眾","110/07/13","凱基-台東",14,0,14
"6046","5410國眾","110/07/13","台新-台南",0,12,-12
"6047","5410國眾","110/07/13","富邦-竹北",11,0,11
"6048","5410國眾","110/07/13","中國信託",0,11,-11
"6049","5410國眾","110/07/13","元富-同大",10,0,10
"6050","5410國眾","110/07/13","華南永昌",0,11,-11
"6051","5410國眾","110/07/13","國泰-敦南",24,15,9
"6052","5410國眾","110/07/13","臺銀-臺南",0,10,-10
"6053","5410國眾","110/07/13","日盛-內湖",7,0,7
"6054","5410國眾","110/07/13","台灣企銀-民雄",0,10,-10
"6055","5410國眾","110/07/13","台新-左楠",7,0,7
"6056","5410國眾","110/07/13","高橋",0,10,-10
"6057","5410國眾","110/07/13","元大-新盛",18,12,6
"6058","5410國眾","110/07/13","康和-嘉義",0,10,-10
"6059","5410國眾","110/07/13","統一",5,0,5
"6060","5410國眾","110/07/13","凱基-基隆",0,10,-10
"6061","2841台開","110/07/13","中國信託-高雄",251,50,201
"6062","2841台開","110/07/13","兆豐-公益",0,177,-177
"6063","2841台開","110/07/13","日盛證券",210,13,197
"6064","2841台開","110/07/13","日進",0,152,-152
"6065","2841台開","110/07/13","第一金-台中",55,0,55
"6066","2841台開","110/07/13","港商野村",0,109,-109
"6067","2841台開","110/07/13","國泰-板橋",46,0,46
"6068","2841台開","110/07/13","日盛-信義",0,103,-103
"6069","2841台開","110/07/13","國泰-館前",48,3,45
"6070","2841台開","110/07/13","國泰-敦南",11,75,-64
"6071","2841台開","110/07/13","華南永昌-新莊",45,0,45
"6072","2841台開","110/07/13","永興",0,50,-50
"6073","2841台開","110/07/13","日盛-園區",42,0,42
"6074","2841台開","110/07/13","永豐金-敦南",61,104,-43
"6075","2841台開","110/07/13","台新證券",32,0,32
"6076","2841台開","110/07/13","富邦-台南",0,42,-42
"6077","2841台開","110/07/13","台新-高雄",32,2,30
"6078","2841台開","110/07/13","國票-安和",0,30,-30
"6079","2841台開","110/07/13","豐農",23,0,23
"6080","2841台開","110/07/13","元大-桃園",0,25,-25
"6081","2841台開","110/07/13","合庫-嘉義",20,0,20
"6082","2841台開","110/07/13","新光",8,32,-24
"6083","2841台開","110/07/13","華南永昌-高雄",20,0,20
"6084","2841台開","110/07/13","元大-仁愛",0,24,-24
"6085","2841台開","110/07/13","元大-樹林",16,0,16
"6086","2841台開","110/07/13","日盛-中和",0,20,-20
"6087","2841台開","110/07/13","第一金-華江",15,2,13
"6088","2841台開","110/07/13","元富",0,20,-20
"6089","2841台開","110/07/13","美商高盛",12,0,12
"6090","2841台開","110/07/13","富邦-宜蘭",0,20,-20
"6091","6207雷科","110/07/13","元大-高雄",121,0,121
"6092","6207雷科","110/07/13","華南永昌-朴子",1,60,-59
"6093","6207雷科","110/07/13","第一金-新興",20,0,20
"6094","6207雷科","110/07/13","元大-南海",0,36,-36
"6095","6207雷科","110/07/13","元富-三重",20,0,20
"6096","6207雷科","110/07/13","凱基-土城",0,35,-35
"6097","6207雷科","110/07/13","元大-林園",15,0,15
"6098","6207雷科","110/07/13","台灣企銀",0,20,-20
"6099","6207雷科","110/07/13","元大-金華",16,1,15
"6100","6207雷科","110/07/13","群益金鼎-丹鳳",0,20,-20
"6101","6207雷科","110/07/13","日盛證券",10,0,10
"6102","6207雷科","110/07/13","元大-博愛",0,17,-17
"6103","6207雷科","110/07/13","統一-台中",10,0,10
"6104","6207雷科","110/07/13","元大-北港",0,13,-13
"6105","6207雷科","110/07/13","群益金鼎-土城",10,0,10
"6106","6207雷科","110/07/13","新加坡商瑞銀",0,12,-12
"6107","6207雷科","110/07/13","群益金鼎-桃園",10,0,10
"6108","6207雷科","110/07/13","凱基-台北",4,16,-12
"6109","6207雷科","110/07/13","永豐金-新莊",10,0,10
"6110","6207雷科","110/07/13","日茂-埔里",0,11,-11
"6111","6207雷科","110/07/13","永豐金-新店",10,0,10
"6112","6207雷科","110/07/13","元大-莒光",0,11,-11
"6113","6207雷科","110/07/13","元大證券",9,0,9
"6114","6207雷科","110/07/13","統一-新竹",0,10,-10
"6115","6207雷科","110/07/13","日盛-木柵",9,1,8
"6116","6207雷科","110/07/13","元大-西螺",0,10,-10
"6117","6207雷科","110/07/13","兆豐-來福",8,0,8
"6118","6207雷科","110/07/13","康和-台中",0,8,-8
"6119","6207雷科","110/07/13","新光",7,0,7
"6120","6207雷科","110/07/13","兆豐-高雄",0,6,-6
"6121","3679新至陞","110/07/13","永豐金證券",50,0,50
"6122","3679新至陞","110/07/13","摩根大通",2,25,-23
"6123","3679新至陞","110/07/13","國泰-桃園",22,0,22
"6124","3679新至陞","110/07/13","元大-成功",0,22,-22
"6125","3679新至陞","110/07/13","台中銀-員林",11,0,11
"6126","3679新至陞","110/07/13","富邦-板橋",1,19,-18
"6127","3679新至陞","110/07/13","元大-文心興安",8,0,8
"6128","3679新至陞","110/07/13","日盛-新莊",0,10,-10
"6129","3679新至陞","110/07/13","美商高盛",6,0,6
"6130","3679新至陞","110/07/13","台新-台中",0,10,-10
"6131","3679新至陞","110/07/13","台新-高雄",6,0,6
"6132","3679新至陞","110/07/13","永豐金-新竹",0,8,-8
"6133","3679新至陞","110/07/13","凱基-台北",18,12,6
"6134","3679新至陞","110/07/13","瑞士信貸",12,19,-7
"6135","3679新至陞","110/07/13","日盛-復興",5,0,5
"6136","3679新至陞","110/07/13","統一-南京",0,7,-7
"6137","3679新至陞","110/07/13","(牛牛牛)亞-鑫豐",4,0,4
"6138","3679新至陞","110/07/13","凱基-新莊",0,7,-7
"6139","3679新至陞","110/07/13","元富-大昌",3,0,3
"6140","3679新至陞","110/07/13","新加坡商瑞銀",0,6,-6
"6141","3679新至陞","110/07/13","富邦-台北",3,0,3
"6142","3679新至陞","110/07/13","合庫-自強",0,5,-5
"6143","3679新至陞","110/07/13","日盛-樹林",2,0,2
"6144","3679新至陞","110/07/13","富邦-桃園",0,5,-5
"6145","3679新至陞","110/07/13","宏遠-光隆",2,0,2
"6146","3679新至陞","110/07/13","永豐金-潮州",0,4,-4
"6147","3679新至陞","110/07/13","美林",3,1,2
"6148","3679新至陞","110/07/13","臺銀-臺南",0,3,-3
"6149","3679新至陞","110/07/13","第一金-中壢",2,0,2
"6150","3679新至陞","110/07/13","元大-六合",0,3,-3
"6151","2727王品","110/07/13","富邦-台北",43,3,40
"6152","2727王品","110/07/13","台灣摩根士丹利",15,97,-82
"6153","2727王品","110/07/13","元大-基隆孝二",40,0,40
"6154","2727王品","110/07/13","玉山-台南",5,57,-52
"6155","2727王品","110/07/13","國票-新莊",40,1,39
"6156","2727王品","110/07/13","新加坡商瑞銀",0,48,-48
"6157","2727王品","110/07/13","第一金-豐原",66,42,24
"6158","2727王品","110/07/13","凱基-台北",41,77,-36
"6159","2727王品","110/07/13","永豐金-大園",34,10,24
"6160","2727王品","110/07/13","永豐金-永康",0,22,-22
"6161","2727王品","110/07/13","元大-北屯",22,0,22
"6162","2727王品","110/07/13","統一-台中",2,22,-20
"6163","2727王品","110/07/13","元大-東蘆",26,7,19
"6164","2727王品","110/07/13","國泰-台中",21,39,-18
"6165","2727王品","110/07/13","永豐金-萬盛",13,1,12
"6166","2727王品","110/07/13","合庫-彰化",3,20,-17
"6167","2727王品","110/07/13","日盛-嘉義",11,0,11
"6168","2727王品","110/07/13","港商野村",13,30,-17
"6169","2727王品","110/07/13","日盛-八德",11,0,11
"6170","2727王品","110/07/13","元大-楊梅",1,16,-15
"6171","2727王品","110/07/13","統一-竹南",11,0,11
"6172","2727王品","110/07/13","凱基-高美館",2,15,-13
"6173","2727王品","110/07/13","日盛-士林",12,2,10
"6174","2727王品","110/07/13","美商高盛",2,14,-12
"6175","2727王品","110/07/13","統一-敦南",10,0,10
"6176","2727王品","110/07/13","統一-平鎮",1,13,-12
"6177","2727王品","110/07/13","中國信託",15,5,10
"6178","2727王品","110/07/13","兆豐-台中港",4,16,-12
"6179","2727王品","110/07/13","兆豐-竹北",13,3,10
"6180","2727王品","110/07/13","凱基-八德",1,13,-12
"6181","1570力肯","110/07/13","新光",115,11,104
"6182","1570力肯","110/07/13","元大-北三重",0,162,-162
"6183","1570力肯","110/07/13","群益金鼎-高雄",54,0,54
"6184","1570力肯","110/07/13","元大-大灣",0,25,-25
"6185","1570力肯","110/07/13","國票-新莊",22,0,22
"6186","1570力肯","110/07/13","永豐金-苓雅",0,22,-22
"6187","1570力肯","110/07/13","日盛-桃園",12,0,12
"6188","1570力肯","110/07/13","永豐金-永康",0,19,-19
"6189","1570力肯","110/07/13","元大-高雄",12,0,12
"6190","1570力肯","110/07/13","富邦-員林",0,15,-15
"6191","1570力肯","110/07/13","合庫-自強",11,0,11
"6192","1570力肯","110/07/13","凱基-台南",0,11,-11
"6193","1570力肯","110/07/13","摩根大通",26,15,11
"6194","1570力肯","110/07/13","日盛-竹北",0,10,-10
"6195","1570力肯","110/07/13","永豐金-中盛",11,0,11
"6196","1570力肯","110/07/13","國票-九鼎",0,10,-10
"6197","1570力肯","110/07/13","兆豐-台中港",10,0,10
"6198","1570力肯","110/07/13","凱基-桃園",0,10,-10
"6199","1570力肯","110/07/13","國泰-松江",9,0,9
"6200","1570力肯","110/07/13","凱基-新豐",0,10,-10
"6201","1570力肯","110/07/13","元大-新盛",9,0,9
"6202","1570力肯","110/07/13","元大-學甲",0,10,-10
"6203","1570力肯","110/07/13","元富-緯城",6,0,6
"6204","1570力肯","110/07/13","群益金鼎-東湖",1,10,-9
"6205","1570力肯","110/07/13","統一-三重",5,0,5
"6206","1570力肯","110/07/13","大昌",0,6,-6
"6207","1570力肯","110/07/13","元大-前金",5,0,5
"6208","1570力肯","110/07/13","元大-土城學府",0,6,-6
"6209","1570力肯","110/07/13","永豐金證券",5,0,5
"6210","1570力肯","110/07/13","統一",0,5,-5
"6211","6180橘子","110/07/13","摩根大通",119,0,119
"6212","6180橘子","110/07/13","元大-崇德",2,61,-59
"6213","6180橘子","110/07/13","美商高盛",96,0,96
"6214","6180橘子","110/07/13","康和-台中",0,51,-51
"6215","6180橘子","110/07/13","新加坡商瑞銀",86,7,79
"6216","6180橘子","110/07/13","康和-台北",0,50,-50
"6217","6180橘子","110/07/13","元大-和平",40,0,40
"6218","6180橘子","110/07/13","元富-潮州",0,40,-40
"6219","6180橘子","110/07/13","凱基-台北",83,47,36
"6220","6180橘子","110/07/13","日盛-永康",0,26,-26
"6221","6180橘子","110/07/13","美林",39,5,34
"6222","6180橘子","110/07/13","永豐金-中正",0,24,-24
"6223","6180橘子","110/07/13","富邦-新竹華信",31,2,29
"6224","6180橘子","110/07/13","國泰-板橋",2,25,-23
"6225","6180橘子","110/07/13","統一-南京",21,0,21
"6226","6180橘子","110/07/13","日盛-大墩",0,20,-20
"6227","6180橘子","110/07/13","富邦-陽明",24,3,21
"6228","6180橘子","110/07/13","元大-草屯",13,32,-19
"6229","6180橘子","110/07/13","大昌-樹林",21,1,20
"6230","6180橘子","110/07/13","元富-林園",1,18,-17
"6231","6180橘子","110/07/13","花旗環球",19,0,19
"6232","6180橘子","110/07/13","新光-新竹",1,18,-17
"6233","6180橘子","110/07/13","華南永昌-台南",19,0,19
"6234","6180橘子","110/07/13","元大-土城永寧",0,17,-17
"6235","6180橘子","110/07/13","福勝",14,0,14
"6236","6180橘子","110/07/13","國泰-新莊",3,19,-16
"6237","6180橘子","110/07/13","富邦-嘉義",12,1,11
"6238","6180橘子","110/07/13","中國信託-永康",6,21,-15
"6239","6180橘子","110/07/13","元大-板橋三民",11,0,11
"6240","6180橘子","110/07/13","凱基-東港",1,15,-14
"6241","2390云辰","110/07/13","新加坡商瑞銀",562,75,487
"6242","2390云辰","110/07/13","大展-台南",0,532,-532
"6243","2390云辰","110/07/13","台灣摩根士丹利",330,155,175
"6244","2390云辰","110/07/13","凱基-台北",668,854,-186
"6245","2390云辰","110/07/13","兆豐-公益",126,25,101
"6246","2390云辰","110/07/13","凱基-三重",12,172,-160
"6247","2390云辰","110/07/13","元富-中港",100,2,98
"6248","2390云辰","110/07/13","兆豐-忠孝",4,161,-157
"6249","2390云辰","110/07/13","統一-新台中",106,9,97
"6250","2390云辰","110/07/13","元大-士林",19,170,-151
"6251","2390云辰","110/07/13","中國信託-松江",81,11,70
"6252","2390云辰","110/07/13","臺銀-新竹",14,117,-103
"6253","2390云辰","110/07/13","日盛-板橋",72,3,69
"6254","2390云辰","110/07/13","國票-台中",4,102,-98
"6255","2390云辰","110/07/13","日盛-和美",57,0,57
"6256","2390云辰","110/07/13","新光",147,232,-85
"6257","2390云辰","110/07/13","永豐金-桃園",88,36,52
"6258","2390云辰","110/07/13","致和-崇德",2,70,-68
"6259","2390云辰","110/07/13","玉山-士林",54,4,50
"6260","2390云辰","110/07/13","群益金鼎-屏東",2,70,-68
"6261","2390云辰","110/07/13","富邦-仁愛",56,6,50
"6262","2390云辰","110/07/13","元大-大里",35,98,-63
"6263","2390云辰","110/07/13","第一金-豐原",50,1,49
"6264","2390云辰","110/07/13","元大-萬華",35,94,-59
"6265","2390云辰","110/07/13","摩根大通",502,453,49
"6266","2390云辰","110/07/13","元富-吉利",2,60,-58
"6267","2390云辰","110/07/13","凱基-松山",61,13,48
"6268","2390云辰","110/07/13","兆豐-新竹",3,53,-50
"6269","2390云辰","110/07/13","大昌",64,22,42
"6270","2390云辰","110/07/13","富邦-嘉義",65,108,-43
"6271","2363矽統","110/07/13","凱基-南崁",2133,63,2070
"6272","2363矽統","110/07/13","凱基-幸福",36,4048,-4012
"6273","2363矽統","110/07/13","國泰-敦南",2195,1617,578
"6274","2363矽統","110/07/13","統一",192,3325,-3133
"6275","2363矽統","110/07/13","中農",670,139,531
"6276","2363矽統","110/07/13","新加坡商瑞銀",1000,2747,-1747
"6277","2363矽統","110/07/13","康和-台中",638,154,484
"6278","2363矽統","110/07/13","凱基-台北",5359,6609,-1250
"6279","2363矽統","110/07/13","群益金鼎-三民",577,137,440
"6280","2363矽統","110/07/13","摩根大通",1930,2858,-928
"6281","2363矽統","110/07/13","台新-屏東",510,88,422
"6282","2363矽統","110/07/13","港商野村",960,1679,-719
"6283","2363矽統","110/07/13","德信-中正",455,67,388
"6284","2363矽統","110/07/13","兆豐-復興",25,705,-680
"6285","2363矽統","110/07/13","日盛-竹北",365,70,295
"6286","2363矽統","110/07/13","統一-仁愛",114,755,-641
"6287","2363矽統","110/07/13","元大-佳里",452,189,263
"6288","2363矽統","110/07/13","統一-敦南",29,638,-609
"6289","2363矽統","110/07/13","國票-博愛",296,38,258
"6290","2363矽統","110/07/13","統一-土城",100,704,-604
"6291","2363矽統","110/07/13","元大-萬華",340,95,245
"6292","2363矽統","110/07/13","統一-城中",116,676,-560
"6293","2363矽統","110/07/13","新光",1259,1031,228
"6294","2363矽統","110/07/13","永豐金證券",306,859,-553
"6295","2363矽統","110/07/13","元富-成功",323,96,227
"6296","2363矽統","110/07/13","元富",54,567,-513
"6297","2363矽統","110/07/13","豐農",228,23,205
"6298","2363矽統","110/07/13","瑞士信貸",202,666,-464
"6299","2363矽統","110/07/13","台灣企銀-岡山",186,4,182
"6300","2363矽統","110/07/13","永豐金-嘉義",67,468,-401
"6301","8112至上","110/07/13","摩根大通",688,296,392
"6302","8112至上","110/07/13","國票-中和",0,401,-401
"6303","8112至上","110/07/13","港商野村",344,145,199
"6304","8112至上","110/07/13","永豐金-板盛",0,205,-205
"6305","8112至上","110/07/13","兆豐-公益",195,5,190
"6306","8112至上","110/07/13","凱基-五股",43,155,-112
"6307","8112至上","110/07/13","台灣摩根士丹利",183,0,183
"6308","8112至上","110/07/13","凱基-市政",0,100,-100
"6309","8112至上","110/07/13","群益金鼎-敦南",153,2,151
"6310","8112至上","110/07/13","元大-大里德芳",1,92,-91
"6311","8112至上","110/07/13","臺銀-金山",146,26,120
"6312","8112至上","110/07/13","玉山-桃園",26,110,-84
"6313","8112至上","110/07/13","臺銀",133,19,114
"6314","8112至上","110/07/13","兆豐-天母",0,81,-81
"6315","8112至上","110/07/13","合庫-台中",115,6,109
"6316","8112至上","110/07/13","凱基-城中",3,84,-81
"6317","8112至上","110/07/13","亞東-板橋",134,26,108
"6318","8112至上","110/07/13","日盛-新莊",9,85,-76
"6319","8112至上","110/07/13","凱基-台北",414,326,88
"6320","8112至上","110/07/13","日盛-台中",2,64,-62
"6321","8112至上","110/07/13","新加坡商瑞銀",181,100,81
"6322","8112至上","110/07/13","日盛-中壢",3,64,-61
"6323","8112至上","110/07/13","國泰-敦南",108,31,77
"6324","8112至上","110/07/13","元大-台中",2,59,-57
"6325","8112至上","110/07/13","第一金-華江",77,4,73
"6326","8112至上","110/07/13","元大-雙和",7,64,-57
"6327","8112至上","110/07/13","永豐金-內湖",73,1,72
"6328","8112至上","110/07/13","元大-高雄",8,62,-54
"6329","8112至上","110/07/13","元大-永和",68,1,67
"6330","8112至上","110/07/13","元大-館前",2,55,-53
"6331","4903聯光通","110/07/13","台灣企銀-太平",56,0,56
"6332","4903聯光通","110/07/13","土銀",0,32,-32
"6333","4903聯光通","110/07/13","元富-新興",23,0,23
"6334","4903聯光通","110/07/13","元大-樹林",0,19,-19
"6335","4903聯光通","110/07/13","日盛-樹林",22,0,22
"6336","4903聯光通","110/07/13","凱基-士林",0,17,-17
"6337","4903聯光通","110/07/13","兆豐-天母",20,0,20
"6338","4903聯光通","110/07/13","國票-博愛",0,14,-14
"6339","4903聯光通","110/07/13","華南永昌-桃園",20,0,20
"6340","4903聯光通","110/07/13","元富",0,10,-10
"6341","4903聯光通","110/07/13","富邦-新店",10,0,10
"6342","4903聯光通","110/07/13","新光",0,10,-10
"6343","4903聯光通","110/07/13","新光-台中",5,0,5
"6344","4903聯光通","110/07/13","玉山-南京東路",0,10,-10
"6345","4903聯光通","110/07/13","華南永昌-台中",5,0,5
"6346","4903聯光通","110/07/13","富邦-陽明",0,10,-10
"6347","4903聯光通","110/07/13","元大-崇德",5,0,5
"6348","4903聯光通","110/07/13","元大-大甲",0,8,-8
"6349","4903聯光通","110/07/13","元大-草屯",5,0,5
"6350","4903聯光通","110/07/13","富邦-台中",0,7,-7
"6351","4903聯光通","110/07/13","元富-草屯",4,0,4
"6352","4903聯光通","110/07/13","凱基-中壢",0,6,-6
"6353","4903聯光通","110/07/13","元大-清水",4,0,4
"6354","4903聯光通","110/07/13","臺銀-民權",0,5,-5
"6355","4903聯光通","110/07/13","元大-東泰",4,0,4
"6356","4903聯光通","110/07/13","日盛-板橋",0,5,-5
"6357","4903聯光通","110/07/13","元大-佳里",2,0,2
"6358","4903聯光通","110/07/13","中國信託-忠孝",0,5,-5
"6359","4903聯光通","110/07/13","永豐金-板橋",2,0,2
"6360","4903聯光通","110/07/13","永豐金-鳳山",0,5,-5
"6361","2929淘帝","110/07/13","玉山-新竹",130,0,130
"6362","2929淘帝","110/07/13","美商高盛",0,177,-177
"6363","2929淘帝","110/07/13","臺銀-民權",60,0,60
"6364","2929淘帝","110/07/13","凱基-台北",6,80,-74
"6365","2929淘帝","110/07/13","新百王",31,0,31
"6366","2929淘帝","110/07/13","元富-大裕",0,49,-49
"6367","2929淘帝","110/07/13","日盛-園區",30,0,30
"6368","2929淘帝","110/07/13","國泰-館前",3,51,-48
"6369","2929淘帝","110/07/13","元大-南投",31,1,30
"6370","2929淘帝","110/07/13","凱基-中壢",0,41,-41
"6371","2929淘帝","110/07/13","兆豐-忠孝",28,0,28
"6372","2929淘帝","110/07/13","港商野村",21,55,-34
"6373","2929淘帝","110/07/13","元大-民生",28,0,28
"6374","2929淘帝","110/07/13","華南永昌-南京",2,34,-32
"6375","2929淘帝","110/07/13","合庫-高雄",27,0,27
"6376","2929淘帝","110/07/13","群益金鼎-土城",0,30,-30
"6377","2929淘帝","110/07/13","凱基-豐中",27,0,27
"6378","2929淘帝","110/07/13","富邦-南屯",0,22,-22
"6379","2929淘帝","110/07/13","新光",21,4,17
"6380","2929淘帝","110/07/13","第一金-豐原",0,20,-20
"6381","2929淘帝","110/07/13","元大-天母",17,0,17
"6382","2929淘帝","110/07/13","元大-屏南",6,26,-20
"6383","2929淘帝","110/07/13","永興",14,0,14
"6384","2929淘帝","110/07/13","永豐金-敦南",1,21,-20
"6385","2929淘帝","110/07/13","富邦-台北",12,0,12
"6386","2929淘帝","110/07/13","凱基-三重",2,21,-19
"6387","2929淘帝","110/07/13","元大-永和",12,0,12
"6388","2929淘帝","110/07/13","富邦-仁愛",7,25,-18
"6389","2929淘帝","110/07/13","國票-天祥",11,0,11
"6390","2929淘帝","110/07/13","元大-北投",0,16,-16
"6391","5410國眾","110/07/13","兆豐-城中",274,0,274
"6392","5410國眾","110/07/13","元富-嘉義",0,103,-103
"6393","5410國眾","110/07/13","新光",50,4,46
"6394","5410國眾","110/07/13","凱基-台北",0,50,-50
"6395","5410國眾","110/07/13","國泰-台中",26,0,26
"6396","5410國眾","110/07/13","瑞士信貸",0,31,-31
"6397","5410國眾","110/07/13","新加坡商瑞銀",22,0,22
"6398","5410國眾","110/07/13","台新-新莊",0,27,-27
"6399","5410國眾","110/07/13","光和-嘉義",20,0,20
"6400","5410國眾","110/07/13","元大-汐止",0,20,-20
"6401","5410國眾","110/07/13","凱基-竹北",17,0,17
"6402","5410國眾","110/07/13","亞東-新竹",0,17,-17
"6403","5410國眾","110/07/13","新光-桃園",15,0,15
"6404","5410國眾","110/07/13","元大-南勢角",0,13,-13
"6405","5410國眾","110/07/13","凱基-台東",14,0,14
"6406","5410國眾","110/07/13","台新-台南",0,12,-12
"6407","5410國眾","110/07/13","富邦-竹北",11,0,11
"6408","5410國眾","110/07/13","中國信託",0,11,-11
"6409","5410國眾","110/07/13","元富-同大",10,0,10
"6410","5410國眾","110/07/13","華南永昌",0,11,-11
"6411","5410國眾","110/07/13","國泰-敦南",24,15,9
"6412","5410國眾","110/07/13","臺銀-臺南",0,10,-10
"6413","5410國眾","110/07/13","日盛-內湖",7,0,7
"6414","5410國眾","110/07/13","台灣企銀-民雄",0,10,-10
"6415","5410國眾","110/07/13","台新-左楠",7,0,7
"6416","5410國眾","110/07/13","高橋",0,10,-10
"6417","5410國眾","110/07/13","元大-新盛",18,12,6
"6418","5410國眾","110/07/13","康和-嘉義",0,10,-10
"6419","5410國眾","110/07/13","統一",5,0,5
"6420","5410國眾","110/07/13","凱基-基隆",0,10,-10
"6421","2841台開","110/07/13","中國信託-高雄",251,50,201
"6422","2841台開","110/07/13","兆豐-公益",0,177,-177
"6423","2841台開","110/07/13","日盛證券",210,13,197
"6424","2841台開","110/07/13","日進",0,152,-152
"6425","2841台開","110/07/13","第一金-台中",55,0,55
"6426","2841台開","110/07/13","港商野村",0,109,-109
"6427","2841台開","110/07/13","國泰-板橋",46,0,46
"6428","2841台開","110/07/13","日盛-信義",0,103,-103
"6429","2841台開","110/07/13","國泰-館前",48,3,45
"6430","2841台開","110/07/13","國泰-敦南",11,75,-64
"6431","2841台開","110/07/13","華南永昌-新莊",45,0,45
"6432","2841台開","110/07/13","永興",0,50,-50
"6433","2841台開","110/07/13","日盛-園區",42,0,42
"6434","2841台開","110/07/13","永豐金-敦南",61,104,-43
"6435","2841台開","110/07/13","台新證券",32,0,32
"6436","2841台開","110/07/13","富邦-台南",0,42,-42
"6437","2841台開","110/07/13","台新-高雄",32,2,30
"6438","2841台開","110/07/13","國票-安和",0,30,-30
"6439","2841台開","110/07/13","豐農",23,0,23
"6440","2841台開","110/07/13","元大-桃園",0,25,-25
"6441","2841台開","110/07/13","合庫-嘉義",20,0,20
"6442","2841台開","110/07/13","新光",8,32,-24
"6443","2841台開","110/07/13","華南永昌-高雄",20,0,20
"6444","2841台開","110/07/13","元大-仁愛",0,24,-24
"6445","2841台開","110/07/13","元大-樹林",16,0,16
"6446","2841台開","110/07/13","日盛-中和",0,20,-20
"6447","2841台開","110/07/13","第一金-華江",15,2,13
"6448","2841台開","110/07/13","元富",0,20,-20
"6449","2841台開","110/07/13","美商高盛",12,0,12
"6450","2841台開","110/07/13","富邦-宜蘭",0,20,-20
"6451","6207雷科","110/07/13","元大-高雄",121,0,121
"6452","6207雷科","110/07/13","華南永昌-朴子",1,60,-59
"6453","6207雷科","110/07/13","第一金-新興",20,0,20
"6454","6207雷科","110/07/13","元大-南海",0,36,-36
"6455","6207雷科","110/07/13","元富-三重",20,0,20
"6456","6207雷科","110/07/13","凱基-土城",0,35,-35
"6457","6207雷科","110/07/13","元大-林園",15,0,15
"6458","6207雷科","110/07/13","台灣企銀",0,20,-20
"6459","6207雷科","110/07/13","元大-金華",16,1,15
"6460","6207雷科","110/07/13","群益金鼎-丹鳳",0,20,-20
"6461","6207雷科","110/07/13","日盛證券",10,0,10
"6462","6207雷科","110/07/13","元大-博愛",0,17,-17
"6463","6207雷科","110/07/13","統一-台中",10,0,10
"6464","6207雷科","110/07/13","元大-北港",0,13,-13
"6465","6207雷科","110/07/13","群益金鼎-土城",10,0,10
"6466","6207雷科","110/07/13","新加坡商瑞銀",0,12,-12
"6467","6207雷科","110/07/13","群益金鼎-桃園",10,0,10
"6468","6207雷科","110/07/13","凱基-台北",4,16,-12
"6469","6207雷科","110/07/13","永豐金-新莊",10,0,10
"6470","6207雷科","110/07/13","日茂-埔里",0,11,-11
"6471","6207雷科","110/07/13","永豐金-新店",10,0,10
"6472","6207雷科","110/07/13","元大-莒光",0,11,-11
"6473","6207雷科","110/07/13","元大證券",9,0,9
"6474","6207雷科","110/07/13","統一-新竹",0,10,-10
"6475","6207雷科","110/07/13","日盛-木柵",9,1,8
"6476","6207雷科","110/07/13","元大-西螺",0,10,-10
"6477","6207雷科","110/07/13","兆豐-來福",8,0,8
"6478","6207雷科","110/07/13","康和-台中",0,8,-8
"6479","6207雷科","110/07/13","新光",7,0,7
"6480","6207雷科","110/07/13","兆豐-高雄",0,6,-6
"6481","3679新至陞","110/07/13","永豐金證券",50,0,50
"6482","3679新至陞","110/07/13","摩根大通",2,25,-23
"6483","3679新至陞","110/07/13","國泰-桃園",22,0,22
"6484","3679新至陞","110/07/13","元大-成功",0,22,-22
"6485","3679新至陞","110/07/13","台中銀-員林",11,0,11
"6486","3679新至陞","110/07/13","富邦-板橋",1,19,-18
"6487","3679新至陞","110/07/13","元大-文心興安",8,0,8
"6488","3679新至陞","110/07/13","日盛-新莊",0,10,-10
"6489","3679新至陞","110/07/13","美商高盛",6,0,6
"6490","3679新至陞","110/07/13","台新-台中",0,10,-10
"6491","3679新至陞","110/07/13","台新-高雄",6,0,6
"6492","3679新至陞","110/07/13","永豐金-新竹",0,8,-8
"6493","3679新至陞","110/07/13","凱基-台北",18,12,6
"6494","3679新至陞","110/07/13","瑞士信貸",12,19,-7
"6495","3679新至陞","110/07/13","日盛-復興",5,0,5
"6496","3679新至陞","110/07/13","統一-南京",0,7,-7
"6497","3679新至陞","110/07/13","(牛牛牛)亞-鑫豐",4,0,4
"6498","3679新至陞","110/07/13","凱基-新莊",0,7,-7
"6499","3679新至陞","110/07/13","元富-大昌",3,0,3
"6500","3679新至陞","110/07/13","新加坡商瑞銀",0,6,-6
"6501","3679新至陞","110/07/13","富邦-台北",3,0,3
"6502","3679新至陞","110/07/13","合庫-自強",0,5,-5
"6503","3679新至陞","110/07/13","日盛-樹林",2,0,2
"6504","3679新至陞","110/07/13","富邦-桃園",0,5,-5
"6505","3679新至陞","110/07/13","宏遠-光隆",2,0,2
"6506","3679新至陞","110/07/13","永豐金-潮州",0,4,-4
"6507","3679新至陞","110/07/13","美林",3,1,2
"6508","3679新至陞","110/07/13","臺銀-臺南",0,3,-3
"6509","3679新至陞","110/07/13","第一金-中壢",2,0,2
"6510","3679新至陞","110/07/13","元大-六合",0,3,-3
"6511","2727王品","110/07/13","富邦-台北",43,3,40
"6512","2727王品","110/07/13","台灣摩根士丹利",15,97,-82
"6513","2727王品","110/07/13","元大-基隆孝二",40,0,40
"6514","2727王品","110/07/13","玉山-台南",5,57,-52
"6515","2727王品","110/07/13","國票-新莊",40,1,39
"6516","2727王品","110/07/13","新加坡商瑞銀",0,48,-48
"6517","2727王品","110/07/13","第一金-豐原",66,42,24
"6518","2727王品","110/07/13","凱基-台北",41,77,-36
"6519","2727王品","110/07/13","永豐金-大園",34,10,24
"6520","2727王品","110/07/13","永豐金-永康",0,22,-22
"6521","2727王品","110/07/13","元大-北屯",22,0,22
"6522","2727王品","110/07/13","統一-台中",2,22,-20
"6523","2727王品","110/07/13","元大-東蘆",26,7,19
"6524","2727王品","110/07/13","國泰-台中",21,39,-18
"6525","2727王品","110/07/13","永豐金-萬盛",13,1,12
"6526","2727王品","110/07/13","合庫-彰化",3,20,-17
"6527","2727王品","110/07/13","日盛-嘉義",11,0,11
"6528","2727王品","110/07/13","港商野村",13,30,-17
"6529","2727王品","110/07/13","日盛-八德",11,0,11
"6530","2727王品","110/07/13","元大-楊梅",1,16,-15
"6531","2727王品","110/07/13","統一-竹南",11,0,11
"6532","2727王品","110/07/13","凱基-高美館",2,15,-13
"6533","2727王品","110/07/13","日盛-士林",12,2,10
"6534","2727王品","110/07/13","美商高盛",2,14,-12
"6535","2727王品","110/07/13","統一-敦南",10,0,10
"6536","2727王品","110/07/13","統一-平鎮",1,13,-12
"6537","2727王品","110/07/13","中國信託",15,5,10
"6538","2727王品","110/07/13","兆豐-台中港",4,16,-12
"6539","2727王品","110/07/13","兆豐-竹北",13,3,10
"6540","2727王品","110/07/13","凱基-八德",1,13,-12
"6541","1570力肯","110/07/13","新光",115,11,104
"6542","1570力肯","110/07/13","元大-北三重",0,162,-162
"6543","1570力肯","110/07/13","群益金鼎-高雄",54,0,54
"6544","1570力肯","110/07/13","元大-大灣",0,25,-25
"6545","1570力肯","110/07/13","國票-新莊",22,0,22
"6546","1570力肯","110/07/13","永豐金-苓雅",0,22,-22
"6547","1570力肯","110/07/13","日盛-桃園",12,0,12
"6548","1570力肯","110/07/13","永豐金-永康",0,19,-19
"6549","1570力肯","110/07/13","元大-高雄",12,0,12
"6550","1570力肯","110/07/13","富邦-員林",0,15,-15
"6551","1570力肯","110/07/13","合庫-自強",11,0,11
"6552","1570力肯","110/07/13","凱基-台南",0,11,-11
"6553","1570力肯","110/07/13","摩根大通",26,15,11
"6554","1570力肯","110/07/13","日盛-竹北",0,10,-10
"6555","1570力肯","110/07/13","永豐金-中盛",11,0,11
"6556","1570力肯","110/07/13","國票-九鼎",0,10,-10
"6557","1570力肯","110/07/13","兆豐-台中港",10,0,10
"6558","1570力肯","110/07/13","凱基-桃園",0,10,-10
"6559","1570力肯","110/07/13","國泰-松江",9,0,9
"6560","1570力肯","110/07/13","凱基-新豐",0,10,-10
"6561","1570力肯","110/07/13","元大-新盛",9,0,9
"6562","1570力肯","110/07/13","元大-學甲",0,10,-10
"6563","1570力肯","110/07/13","元富-緯城",6,0,6
"6564","1570力肯","110/07/13","群益金鼎-東湖",1,10,-9
"6565","1570力肯","110/07/13","統一-三重",5,0,5
"6566","1570力肯","110/07/13","大昌",0,6,-6
"6567","1570力肯","110/07/13","元大-前金",5,0,5
"6568","1570力肯","110/07/13","元大-土城學府",0,6,-6
"6569","1570力肯","110/07/13","永豐金證券",5,0,5
"6570","1570力肯","110/07/13","統一",0,5,-5
"6571","6180橘子","110/07/13","摩根大通",119,0,119
"6572","6180橘子","110/07/13","元大-崇德",2,61,-59
"6573","6180橘子","110/07/13","美商高盛",96,0,96
"6574","6180橘子","110/07/13","康和-台中",0,51,-51
"6575","6180橘子","110/07/13","新加坡商瑞銀",86,7,79
"6576","6180橘子","110/07/13","康和-台北",0,50,-50
"6577","6180橘子","110/07/13","元大-和平",40,0,40
"6578","6180橘子","110/07/13","元富-潮州",0,40,-40
"6579","6180橘子","110/07/13","凱基-台北",83,47,36
"6580","6180橘子","110/07/13","日盛-永康",0,26,-26
"6581","6180橘子","110/07/13","美林",39,5,34
"6582","6180橘子","110/07/13","永豐金-中正",0,24,-24
"6583","6180橘子","110/07/13","富邦-新竹華信",31,2,29
"6584","6180橘子","110/07/13","國泰-板橋",2,25,-23
"6585","6180橘子","110/07/13","統一-南京",21,0,21
"6586","6180橘子","110/07/13","日盛-大墩",0,20,-20
"6587","6180橘子","110/07/13","富邦-陽明",24,3,21
"6588","6180橘子","110/07/13","元大-草屯",13,32,-19
"6589","6180橘子","110/07/13","大昌-樹林",21,1,20
"6590","6180橘子","110/07/13","元富-林園",1,18,-17
"6591","6180橘子","110/07/13","花旗環球",19,0,19
"6592","6180橘子","110/07/13","新光-新竹",1,18,-17
"6593","6180橘子","110/07/13","華南永昌-台南",19,0,19
"6594","6180橘子","110/07/13","元大-土城永寧",0,17,-17
"6595","6180橘子","110/07/13","福勝",14,0,14
"6596","6180橘子","110/07/13","國泰-新莊",3,19,-16
"6597","6180橘子","110/07/13","富邦-嘉義",12,1,11
"6598","6180橘子","110/07/13","中國信託-永康",6,21,-15
"6599","6180橘子","110/07/13","元大-板橋三民",11,0,11
"6600","6180橘子","110/07/13","凱基-東港",1,15,-14
"6601","2390云辰","110/07/13","新加坡商瑞銀",562,75,487
"6602","2390云辰","110/07/13","大展-台南",0,532,-532
"6603","2390云辰","110/07/13","台灣摩根士丹利",330,155,175
"6604","2390云辰","110/07/13","凱基-台北",668,854,-186
"6605","2390云辰","110/07/13","兆豐-公益",126,25,101
"6606","2390云辰","110/07/13","凱基-三重",12,172,-160
"6607","2390云辰","110/07/13","元富-中港",100,2,98
"6608","2390云辰","110/07/13","兆豐-忠孝",4,161,-157
"6609","2390云辰","110/07/13","統一-新台中",106,9,97
"6610","2390云辰","110/07/13","元大-士林",19,170,-151
"6611","2390云辰","110/07/13","中國信託-松江",81,11,70
"6612","2390云辰","110/07/13","臺銀-新竹",14,117,-103
"6613","2390云辰","110/07/13","日盛-板橋",72,3,69
"6614","2390云辰","110/07/13","國票-台中",4,102,-98
"6615","2390云辰","110/07/13","日盛-和美",57,0,57
"6616","2390云辰","110/07/13","新光",147,232,-85
"6617","2390云辰","110/07/13","永豐金-桃園",88,36,52
"6618","2390云辰","110/07/13","致和-崇德",2,70,-68
"6619","2390云辰","110/07/13","玉山-士林",54,4,50
"6620","2390云辰","110/07/13","群益金鼎-屏東",2,70,-68
"6621","2390云辰","110/07/13","富邦-仁愛",56,6,50
"6622","2390云辰","110/07/13","元大-大里",35,98,-63
"6623","2390云辰","110/07/13","第一金-豐原",50,1,49
"6624","2390云辰","110/07/13","元大-萬華",35,94,-59
"6625","2390云辰","110/07/13","摩根大通",502,453,49
"6626","2390云辰","110/07/13","元富-吉利",2,60,-58
"6627","2390云辰","110/07/13","凱基-松山",61,13,48
"6628","2390云辰","110/07/13","兆豐-新竹",3,53,-50
"6629","2390云辰","110/07/13","大昌",64,22,42
"6630","2390云辰","110/07/13","富邦-嘉義",65,108,-43
"6631","2363矽統","110/07/13","凱基-南崁",2133,63,2070
"6632","2363矽統","110/07/13","凱基-幸福",36,4048,-4012
"6633","2363矽統","110/07/13","國泰-敦南",2195,1617,578
"6634","2363矽統","110/07/13","統一",192,3325,-3133
"6635","2363矽統","110/07/13","中農",670,139,531
"6636","2363矽統","110/07/13","新加坡商瑞銀",1000,2747,-1747
"6637","2363矽統","110/07/13","康和-台中",638,154,484
"6638","2363矽統","110/07/13","凱基-台北",5359,6609,-1250
"6639","2363矽統","110/07/13","群益金鼎-三民",577,137,440
"6640","2363矽統","110/07/13","摩根大通",1930,2858,-928
"6641","2363矽統","110/07/13","台新-屏東",510,88,422
"6642","2363矽統","110/07/13","港商野村",960,1679,-719
"6643","2363矽統","110/07/13","德信-中正",455,67,388
"6644","2363矽統","110/07/13","兆豐-復興",25,705,-680
"6645","2363矽統","110/07/13","日盛-竹北",365,70,295
"6646","2363矽統","110/07/13","統一-仁愛",114,755,-641
"6647","2363矽統","110/07/13","元大-佳里",452,189,263
"6648","2363矽統","110/07/13","統一-敦南",29,638,-609
"6649","2363矽統","110/07/13","國票-博愛",296,38,258
"6650","2363矽統","110/07/13","統一-土城",100,704,-604
"6651","2363矽統","110/07/13","元大-萬華",340,95,245
"6652","2363矽統","110/07/13","統一-城中",116,676,-560
"6653","2363矽統","110/07/13","新光",1259,1031,228
"6654","2363矽統","110/07/13","永豐金證券",306,859,-553
"6655","2363矽統","110/07/13","元富-成功",323,96,227
"6656","2363矽統","110/07/13","元富",54,567,-513
"6657","2363矽統","110/07/13","豐農",228,23,205
"6658","2363矽統","110/07/13","瑞士信貸",202,666,-464
"6659","2363矽統","110/07/13","台灣企銀-岡山",186,4,182
"6660","2363矽統","110/07/13","永豐金-嘉義",67,468,-401
"6661","8112至上","110/07/13","摩根大通",688,296,392
"6662","8112至上","110/07/13","國票-中和",0,401,-401
"6663","8112至上","110/07/13","港商野村",344,145,199
"6664","8112至上","110/07/13","永豐金-板盛",0,205,-205
"6665","8112至上","110/07/13","兆豐-公益",195,5,190
"6666","8112至上","110/07/13","凱基-五股",43,155,-112
"6667","8112至上","110/07/13","台灣摩根士丹利",183,0,183
"6668","8112至上","110/07/13","凱基-市政",0,100,-100
"6669","8112至上","110/07/13","群益金鼎-敦南",153,2,151
"6670","8112至上","110/07/13","元大-大里德芳",1,92,-91
"6671","8112至上","110/07/13","臺銀-金山",146,26,120
"6672","8112至上","110/07/13","玉山-桃園",26,110,-84
"6673","8112至上","110/07/13","臺銀",133,19,114
"6674","8112至上","110/07/13","兆豐-天母",0,81,-81
"6675","8112至上","110/07/13","合庫-台中",115,6,109
"6676","8112至上","110/07/13","凱基-城中",3,84,-81
"6677","8112至上","110/07/13","亞東-板橋",134,26,108
"6678","8112至上","110/07/13","日盛-新莊",9,85,-76
"6679","8112至上","110/07/13","凱基-台北",414,326,88
"6680","8112至上","110/07/13","日盛-台中",2,64,-62
"6681","8112至上","110/07/13","新加坡商瑞銀",181,100,81
"6682","8112至上","110/07/13","日盛-中壢",3,64,-61
"6683","8112至上","110/07/13","國泰-敦南",108,31,77
"6684","8112至上","110/07/13","元大-台中",2,59,-57
"6685","8112至上","110/07/13","第一金-華江",77,4,73
"6686","8112至上","110/07/13","元大-雙和",7,64,-57
"6687","8112至上","110/07/13","永豐金-內湖",73,1,72
"6688","8112至上","110/07/13","元大-高雄",8,62,-54
"6689","8112至上","110/07/13","元大-永和",68,1,67
"6690","8112至上","110/07/13","元大-館前",2,55,-53
"6691","4903聯光通","110/07/13","台灣企銀-太平",56,0,56
"6692","4903聯光通","110/07/13","土銀",0,32,-32
"6693","4903聯光通","110/07/13","元富-新興",23,0,23
"6694","4903聯光通","110/07/13","元大-樹林",0,19,-19
"6695","4903聯光通","110/07/13","日盛-樹林",22,0,22
"6696","4903聯光通","110/07/13","凱基-士林",0,17,-17
"6697","4903聯光通","110/07/13","兆豐-天母",20,0,20
"6698","4903聯光通","110/07/13","國票-博愛",0,14,-14
"6699","4903聯光通","110/07/13","華南永昌-桃園",20,0,20
"6700","4903聯光通","110/07/13","元富",0,10,-10
"6701","4903聯光通","110/07/13","富邦-新店",10,0,10
"6702","4903聯光通","110/07/13","新光",0,10,-10
"6703","4903聯光通","110/07/13","新光-台中",5,0,5
"6704","4903聯光通","110/07/13","玉山-南京東路",0,10,-10
"6705","4903聯光通","110/07/13","華南永昌-台中",5,0,5
"6706","4903聯光通","110/07/13","富邦-陽明",0,10,-10
"6707","4903聯光通","110/07/13","元大-崇德",5,0,5
"6708","4903聯光通","110/07/13","元大-大甲",0,8,-8
"6709","4903聯光通","110/07/13","元大-草屯",5,0,5
"6710","4903聯光通","110/07/13","富邦-台中",0,7,-7
"6711","4903聯光通","110/07/13","元富-草屯",4,0,4
"6712","4903聯光通","110/07/13","凱基-中壢",0,6,-6
"6713","4903聯光通","110/07/13","元大-清水",4,0,4
"6714","4903聯光通","110/07/13","臺銀-民權",0,5,-5
"6715","4903聯光通","110/07/13","元大-東泰",4,0,4
"6716","4903聯光通","110/07/13","日盛-板橋",0,5,-5
"6717","4903聯光通","110/07/13","元大-佳里",2,0,2
"6718","4903聯光通","110/07/13","中國信託-忠孝",0,5,-5
"6719","4903聯光通","110/07/13","永豐金-板橋",2,0,2
"6720","4903聯光通","110/07/13","永豐金-鳳山",0,5,-5
"6721","2929淘帝","110/07/13","玉山-新竹",130,0,130
"6722","2929淘帝","110/07/13","美商高盛",0,177,-177
"6723","2929淘帝","110/07/13","臺銀-民權",60,0,60
"6724","2929淘帝","110/07/13","凱基-台北",6,80,-74
"6725","2929淘帝","110/07/13","新百王",31,0,31
"6726","2929淘帝","110/07/13","元富-大裕",0,49,-49
"6727","2929淘帝","110/07/13","日盛-園區",30,0,30
"6728","2929淘帝","110/07/13","國泰-館前",3,51,-48
"6729","2929淘帝","110/07/13","元大-南投",31,1,30
"6730","2929淘帝","110/07/13","凱基-中壢",0,41,-41
"6731","2929淘帝","110/07/13","兆豐-忠孝",28,0,28
"6732","2929淘帝","110/07/13","港商野村",21,55,-34
"6733","2929淘帝","110/07/13","元大-民生",28,0,28
"6734","2929淘帝","110/07/13","華南永昌-南京",2,34,-32
"6735","2929淘帝","110/07/13","合庫-高雄",27,0,27
"6736","2929淘帝","110/07/13","群益金鼎-土城",0,30,-30
"6737","2929淘帝","110/07/13","凱基-豐中",27,0,27
"6738","2929淘帝","110/07/13","富邦-南屯",0,22,-22
"6739","2929淘帝","110/07/13","新光",21,4,17
"6740","2929淘帝","110/07/13","第一金-豐原",0,20,-20
"6741","2929淘帝","110/07/13","元大-天母",17,0,17
"6742","2929淘帝","110/07/13","元大-屏南",6,26,-20
"6743","2929淘帝","110/07/13","永興",14,0,14
"6744","2929淘帝","110/07/13","永豐金-敦南",1,21,-20
"6745","2929淘帝","110/07/13","富邦-台北",12,0,12
"6746","2929淘帝","110/07/13","凱基-三重",2,21,-19
"6747","2929淘帝","110/07/13","元大-永和",12,0,12
"6748","2929淘帝","110/07/13","富邦-仁愛",7,25,-18
"6749","2929淘帝","110/07/13","國票-天祥",11,0,11
"6750","2929淘帝","110/07/13","元大-北投",0,16,-16
"6751","5410國眾","110/07/13","兆豐-城中",274,0,274
"6752","5410國眾","110/07/13","元富-嘉義",0,103,-103
"6753","5410國眾","110/07/13","新光",50,4,46
"6754","5410國眾","110/07/13","凱基-台北",0,50,-50
"6755","5410國眾","110/07/13","國泰-台中",26,0,26
"6756","5410國眾","110/07/13","瑞士信貸",0,31,-31
"6757","5410國眾","110/07/13","新加坡商瑞銀",22,0,22
"6758","5410國眾","110/07/13","台新-新莊",0,27,-27
"6759","5410國眾","110/07/13","光和-嘉義",20,0,20
"6760","5410國眾","110/07/13","元大-汐止",0,20,-20
"6761","5410國眾","110/07/13","凱基-竹北",17,0,17
"6762","5410國眾","110/07/13","亞東-新竹",0,17,-17
"6763","5410國眾","110/07/13","新光-桃園",15,0,15
"6764","5410國眾","110/07/13","元大-南勢角",0,13,-13
"6765","5410國眾","110/07/13","凱基-台東",14,0,14
"6766","5410國眾","110/07/13","台新-台南",0,12,-12
"6767","5410國眾","110/07/13","富邦-竹北",11,0,11
"6768","5410國眾","110/07/13","中國信託",0,11,-11
"6769","5410國眾","110/07/13","元富-同大",10,0,10
"6770","5410國眾","110/07/13","華南永昌",0,11,-11
"6771","5410國眾","110/07/13","國泰-敦南",24,15,9
"6772","5410國眾","110/07/13","臺銀-臺南",0,10,-10
"6773","5410國眾","110/07/13","日盛-內湖",7,0,7
"6774","5410國眾","110/07/13","台灣企銀-民雄",0,10,-10
"6775","5410國眾","110/07/13","台新-左楠",7,0,7
"6776","5410國眾","110/07/13","高橋",0,10,-10
"6777","5410國眾","110/07/13","元大-新盛",18,12,6
"6778","5410國眾","110/07/13","康和-嘉義",0,10,-10
"6779","5410國眾","110/07/13","統一",5,0,5
"6780","5410國眾","110/07/13","凱基-基隆",0,10,-10
"6781","2841台開","110/07/13","中國信託-高雄",251,50,201
"6782","2841台開","110/07/13","兆豐-公益",0,177,-177
"6783","2841台開","110/07/13","日盛證券",210,13,197
"6784","2841台開","110/07/13","日進",0,152,-152
"6785","2841台開","110/07/13","第一金-台中",55,0,55
"6786","2841台開","110/07/13","港商野村",0,109,-109
"6787","2841台開","110/07/13","國泰-板橋",46,0,46
"6788","2841台開","110/07/13","日盛-信義",0,103,-103
"6789","2841台開","110/07/13","國泰-館前",48,3,45
"6790","2841台開","110/07/13","國泰-敦南",11,75,-64
"6791","2841台開","110/07/13","華南永昌-新莊",45,0,45
"6792","2841台開","110/07/13","永興",0,50,-50
"6793","2841台開","110/07/13","日盛-園區",42,0,42
"6794","2841台開","110/07/13","永豐金-敦南",61,104,-43
"6795","2841台開","110/07/13","台新證券",32,0,32
"6796","2841台開","110/07/13","富邦-台南",0,42,-42
"6797","2841台開","110/07/13","台新-高雄",32,2,30
"6798","2841台開","110/07/13","國票-安和",0,30,-30
"6799","2841台開","110/07/13","豐農",23,0,23
"6800","2841台開","110/07/13","元大-桃園",0,25,-25
"6801","2841台開","110/07/13","合庫-嘉義",20,0,20
"6802","2841台開","110/07/13","新光",8,32,-24
"6803","2841台開","110/07/13","華南永昌-高雄",20,0,20
"6804","2841台開","110/07/13","元大-仁愛",0,24,-24
"6805","2841台開","110/07/13","元大-樹林",16,0,16
"6806","2841台開","110/07/13","日盛-中和",0,20,-20
"6807","2841台開","110/07/13","第一金-華江",15,2,13
"6808","2841台開","110/07/13","元富",0,20,-20
"6809","2841台開","110/07/13","美商高盛",12,0,12
"6810","2841台開","110/07/13","富邦-宜蘭",0,20,-20
"6811","6207雷科","110/07/13","元大-高雄",121,0,121
"6812","6207雷科","110/07/13","華南永昌-朴子",1,60,-59
"6813","6207雷科","110/07/13","第一金-新興",20,0,20
"6814","6207雷科","110/07/13","元大-南海",0,36,-36
"6815","6207雷科","110/07/13","元富-三重",20,0,20
"6816","6207雷科","110/07/13","凱基-土城",0,35,-35
"6817","6207雷科","110/07/13","元大-林園",15,0,15
"6818","6207雷科","110/07/13","台灣企銀",0,20,-20
"6819","6207雷科","110/07/13","元大-金華",16,1,15
"6820","6207雷科","110/07/13","群益金鼎-丹鳳",0,20,-20
"6821","6207雷科","110/07/13","日盛證券",10,0,10
"6822","6207雷科","110/07/13","元大-博愛",0,17,-17
"6823","6207雷科","110/07/13","統一-台中",10,0,10
"6824","6207雷科","110/07/13","元大-北港",0,13,-13
"6825","6207雷科","110/07/13","群益金鼎-土城",10,0,10
"6826","6207雷科","110/07/13","新加坡商瑞銀",0,12,-12
"6827","6207雷科","110/07/13","群益金鼎-桃園",10,0,10
"6828","6207雷科","110/07/13","凱基-台北",4,16,-12
"6829","6207雷科","110/07/13","永豐金-新莊",10,0,10
"6830","6207雷科","110/07/13","日茂-埔里",0,11,-11
"6831","6207雷科","110/07/13","永豐金-新店",10,0,10
"6832","6207雷科","110/07/13","元大-莒光",0,11,-11
"6833","6207雷科","110/07/13","元大證券",9,0,9
"6834","6207雷科","110/07/13","統一-新竹",0,10,-10
"6835","6207雷科","110/07/13","日盛-木柵",9,1,8
"6836","6207雷科","110/07/13","元大-西螺",0,10,-10
"6837","6207雷科","110/07/13","兆豐-來福",8,0,8
"6838","6207雷科","110/07/13","康和-台中",0,8,-8
"6839","6207雷科","110/07/13","新光",7,0,7
"6840","6207雷科","110/07/13","兆豐-高雄",0,6,-6
"6841","3679新至陞","110/07/13","永豐金證券",50,0,50
"6842","3679新至陞","110/07/13","摩根大通",2,25,-23
"6843","3679新至陞","110/07/13","國泰-桃園",22,0,22
"6844","3679新至陞","110/07/13","元大-成功",0,22,-22
"6845","3679新至陞","110/07/13","台中銀-員林",11,0,11
"6846","3679新至陞","110/07/13","富邦-板橋",1,19,-18
"6847","3679新至陞","110/07/13","元大-文心興安",8,0,8
"6848","3679新至陞","110/07/13","日盛-新莊",0,10,-10
"6849","3679新至陞","110/07/13","美商高盛",6,0,6
"6850","3679新至陞","110/07/13","台新-台中",0,10,-10
"6851","3679新至陞","110/07/13","台新-高雄",6,0,6
"6852","3679新至陞","110/07/13","永豐金-新竹",0,8,-8
"6853","3679新至陞","110/07/13","凱基-台北",18,12,6
"6854","3679新至陞","110/07/13","瑞士信貸",12,19,-7
"6855","3679新至陞","110/07/13","日盛-復興",5,0,5
"6856","3679新至陞","110/07/13","統一-南京",0,7,-7
"6857","3679新至陞","110/07/13","(牛牛牛)亞-鑫豐",4,0,4
"6858","3679新至陞","110/07/13","凱基-新莊",0,7,-7
"6859","3679新至陞","110/07/13","元富-大昌",3,0,3
"6860","3679新至陞","110/07/13","新加坡商瑞銀",0,6,-6
"6861","3679新至陞","110/07/13","富邦-台北",3,0,3
"6862","3679新至陞","110/07/13","合庫-自強",0,5,-5
"6863","3679新至陞","110/07/13","日盛-樹林",2,0,2
"6864","3679新至陞","110/07/13","富邦-桃園",0,5,-5
"6865","3679新至陞","110/07/13","宏遠-光隆",2,0,2
"6866","3679新至陞","110/07/13","永豐金-潮州",0,4,-4
"6867","3679新至陞","110/07/13","美林",3,1,2
"6868","3679新至陞","110/07/13","臺銀-臺南",0,3,-3
"6869","3679新至陞","110/07/13","第一金-中壢",2,0,2
"6870","3679新至陞","110/07/13","元大-六合",0,3,-3
"6871","2727王品","110/07/13","富邦-台北",43,3,40
"6872","2727王品","110/07/13","台灣摩根士丹利",15,97,-82
"6873","2727王品","110/07/13","元大-基隆孝二",40,0,40
"6874","2727王品","110/07/13","玉山-台南",5,57,-52
"6875","2727王品","110/07/13","國票-新莊",40,1,39
"6876","2727王品","110/07/13","新加坡商瑞銀",0,48,-48
"6877","2727王品","110/07/13","第一金-豐原",66,42,24
"6878","2727王品","110/07/13","凱基-台北",41,77,-36
"6879","2727王品","110/07/13","永豐金-大園",34,10,24
"6880","2727王品","110/07/13","永豐金-永康",0,22,-22
"6881","2727王品","110/07/13","元大-北屯",22,0,22
"6882","2727王品","110/07/13","統一-台中",2,22,-20
"6883","2727王品","110/07/13","元大-東蘆",26,7,19
"6884","2727王品","110/07/13","國泰-台中",21,39,-18
"6885","2727王品","110/07/13","永豐金-萬盛",13,1,12
"6886","2727王品","110/07/13","合庫-彰化",3,20,-17
"6887","2727王品","110/07/13","日盛-嘉義",11,0,11
"6888","2727王品","110/07/13","港商野村",13,30,-17
"6889","2727王品","110/07/13","日盛-八德",11,0,11
"6890","2727王品","110/07/13","元大-楊梅",1,16,-15
"6891","2727王品","110/07/13","統一-竹南",11,0,11
"6892","2727王品","110/07/13","凱基-高美館",2,15,-13
"6893","2727王品","110/07/13","日盛-士林",12,2,10
"6894","2727王品","110/07/13","美商高盛",2,14,-12
"6895","2727王品","110/07/13","統一-敦南",10,0,10
"6896","2727王品","110/07/13","統一-平鎮",1,13,-12
"6897","2727王品","110/07/13","中國信託",15,5,10
"6898","2727王品","110/07/13","兆豐-台中港",4,16,-12
"6899","2727王品","110/07/13","兆豐-竹北",13,3,10
"6900","2727王品","110/07/13","凱基-八德",1,13,-12
"6901","1570力肯","110/07/13","新光",115,11,104
"6902","1570力肯","110/07/13","元大-北三重",0,162,-162
"6903","1570力肯","110/07/13","群益金鼎-高雄",54,0,54
"6904","1570力肯","110/07/13","元大-大灣",0,25,-25
"6905","1570力肯","110/07/13","國票-新莊",22,0,22
"6906","1570力肯","110/07/13","永豐金-苓雅",0,22,-22
"6907","1570力肯","110/07/13","日盛-桃園",12,0,12
"6908","1570力肯","110/07/13","永豐金-永康",0,19,-19
"6909","1570力肯","110/07/13","元大-高雄",12,0,12
"6910","1570力肯","110/07/13","富邦-員林",0,15,-15
"6911","1570力肯","110/07/13","合庫-自強",11,0,11
"6912","1570力肯","110/07/13","凱基-台南",0,11,-11
"6913","1570力肯","110/07/13","摩根大通",26,15,11
"6914","1570力肯","110/07/13","日盛-竹北",0,10,-10
"6915","1570力肯","110/07/13","永豐金-中盛",11,0,11
"6916","1570力肯","110/07/13","國票-九鼎",0,10,-10
"6917","1570力肯","110/07/13","兆豐-台中港",10,0,10
"6918","1570力肯","110/07/13","凱基-桃園",0,10,-10
"6919","1570力肯","110/07/13","國泰-松江",9,0,9
"6920","1570力肯","110/07/13","凱基-新豐",0,10,-10
"6921","1570力肯","110/07/13","元大-新盛",9,0,9
"6922","1570力肯","110/07/13","元大-學甲",0,10,-10
"6923","1570力肯","110/07/13","元富-緯城",6,0,6
"6924","1570力肯","110/07/13","群益金鼎-東湖",1,10,-9
"6925","1570力肯","110/07/13","統一-三重",5,0,5
"6926","1570力肯","110/07/13","大昌",0,6,-6
"6927","1570力肯","110/07/13","元大-前金",5,0,5
"6928","1570力肯","110/07/13","元大-土城學府",0,6,-6
"6929","1570力肯","110/07/13","永豐金證券",5,0,5
"6930","1570力肯","110/07/13","統一",0,5,-5
"6931","6180橘子","110/07/13","摩根大通",119,0,119
"6932","6180橘子","110/07/13","元大-崇德",2,61,-59
"6933","6180橘子","110/07/13","美商高盛",96,0,96
"6934","6180橘子","110/07/13","康和-台中",0,51,-51
"6935","6180橘子","110/07/13","新加坡商瑞銀",86,7,79
"6936","6180橘子","110/07/13","康和-台北",0,50,-50
"6937","6180橘子","110/07/13","元大-和平",40,0,40
"6938","6180橘子","110/07/13","元富-潮州",0,40,-40
"6939","6180橘子","110/07/13","凱基-台北",83,47,36
"6940","6180橘子","110/07/13","日盛-永康",0,26,-26
"6941","6180橘子","110/07/13","美林",39,5,34
"6942","6180橘子","110/07/13","永豐金-中正",0,24,-24
"6943","6180橘子","110/07/13","富邦-新竹華信",31,2,29
"6944","6180橘子","110/07/13","國泰-板橋",2,25,-23
"6945","6180橘子","110/07/13","統一-南京",21,0,21
"6946","6180橘子","110/07/13","日盛-大墩",0,20,-20
"6947","6180橘子","110/07/13","富邦-陽明",24,3,21
"6948","6180橘子","110/07/13","元大-草屯",13,32,-19
"6949","6180橘子","110/07/13","大昌-樹林",21,1,20
"6950","6180橘子","110/07/13","元富-林園",1,18,-17
"6951","6180橘子","110/07/13","花旗環球",19,0,19
"6952","6180橘子","110/07/13","新光-新竹",1,18,-17
"6953","6180橘子","110/07/13","華南永昌-台南",19,0,19
"6954","6180橘子","110/07/13","元大-土城永寧",0,17,-17
"6955","6180橘子","110/07/13","福勝",14,0,14
"6956","6180橘子","110/07/13","國泰-新莊",3,19,-16
"6957","6180橘子","110/07/13","富邦-嘉義",12,1,11
"6958","6180橘子","110/07/13","中國信託-永康",6,21,-15
"6959","6180橘子","110/07/13","元大-板橋三民",11,0,11
"6960","6180橘子","110/07/13","凱基-東港",1,15,-14
"6961","2390云辰","110/07/13","新加坡商瑞銀",562,75,487
"6962","2390云辰","110/07/13","大展-台南",0,532,-532
"6963","2390云辰","110/07/13","台灣摩根士丹利",330,155,175
"6964","2390云辰","110/07/13","凱基-台北",668,854,-186
"6965","2390云辰","110/07/13","兆豐-公益",126,25,101
"6966","2390云辰","110/07/13","凱基-三重",12,172,-160
"6967","2390云辰","110/07/13","元富-中港",100,2,98
"6968","2390云辰","110/07/13","兆豐-忠孝",4,161,-157
"6969","2390云辰","110/07/13","統一-新台中",106,9,97
"6970","2390云辰","110/07/13","元大-士林",19,170,-151
"6971","2390云辰","110/07/13","中國信託-松江",81,11,70
"6972","2390云辰","110/07/13","臺銀-新竹",14,117,-103
"6973","2390云辰","110/07/13","日盛-板橋",72,3,69
"6974","2390云辰","110/07/13","國票-台中",4,102,-98
"6975","2390云辰","110/07/13","日盛-和美",57,0,57
"6976","2390云辰","110/07/13","新光",147,232,-85
"6977","2390云辰","110/07/13","永豐金-桃園",88,36,52
"6978","2390云辰","110/07/13","致和-崇德",2,70,-68
"6979","2390云辰","110/07/13","玉山-士林",54,4,50
"6980","2390云辰","110/07/13","群益金鼎-屏東",2,70,-68
"6981","2390云辰","110/07/13","富邦-仁愛",56,6,50
"6982","2390云辰","110/07/13","元大-大里",35,98,-63
"6983","2390云辰","110/07/13","第一金-豐原",50,1,49
"6984","2390云辰","110/07/13","元大-萬華",35,94,-59
"6985","2390云辰","110/07/13","摩根大通",502,453,49
"6986","2390云辰","110/07/13","元富-吉利",2,60,-58
"6987","2390云辰","110/07/13","凱基-松山",61,13,48
"6988","2390云辰","110/07/13","兆豐-新竹",3,53,-50
"6989","2390云辰","110/07/13","大昌",64,22,42
"6990","2390云辰","110/07/13","富邦-嘉義",65,108,-43
"6991","2363矽統","110/07/13","凱基-南崁",2133,63,2070
"6992","2363矽統","110/07/13","凱基-幸福",36,4048,-4012
"6993","2363矽統","110/07/13","國泰-敦南",2195,1617,578
"6994","2363矽統","110/07/13","統一",192,3325,-3133
"6995","2363矽統","110/07/13","中農",670,139,531
"6996","2363矽統","110/07/13","新加坡商瑞銀",1000,2747,-1747
"6997","2363矽統","110/07/13","康和-台中",638,154,484
"6998","2363矽統","110/07/13","凱基-台北",5359,6609,-1250
"6999","2363矽統","110/07/13","群益金鼎-三民",577,137,440
"7000","2363矽統","110/07/13","摩根大通",1930,2858,-928
"7001","2363矽統","110/07/13","台新-屏東",510,88,422
"7002","2363矽統","110/07/13","港商野村",960,1679,-719
"7003","2363矽統","110/07/13","德信-中正",455,67,388
"7004","2363矽統","110/07/13","兆豐-復興",25,705,-680
"7005","2363矽統","110/07/13","日盛-竹北",365,70,295
"7006","2363矽統","110/07/13","統一-仁愛",114,755,-641
"7007","2363矽統","110/07/13","元大-佳里",452,189,263
"7008","2363矽統","110/07/13","統一-敦南",29,638,-609
"7009","2363矽統","110/07/13","國票-博愛",296,38,258
"7010","2363矽統","110/07/13","統一-土城",100,704,-604
"7011","2363矽統","110/07/13","元大-萬華",340,95,245
"7012","2363矽統","110/07/13","統一-城中",116,676,-560
"7013","2363矽統","110/07/13","新光",1259,1031,228
"7014","2363矽統","110/07/13","永豐金證券",306,859,-553
"7015","2363矽統","110/07/13","元富-成功",323,96,227
"7016","2363矽統","110/07/13","元富",54,567,-513
"7017","2363矽統","110/07/13","豐農",228,23,205
"7018","2363矽統","110/07/13","瑞士信貸",202,666,-464
"7019","2363矽統","110/07/13","台灣企銀-岡山",186,4,182
"7020","2363矽統","110/07/13","永豐金-嘉義",67,468,-401
"7021","8112至上","110/07/13","摩根大通",688,296,392
"7022","8112至上","110/07/13","國票-中和",0,401,-401
"7023","8112至上","110/07/13","港商野村",344,145,199
"7024","8112至上","110/07/13","永豐金-板盛",0,205,-205
"7025","8112至上","110/07/13","兆豐-公益",195,5,190
"7026","8112至上","110/07/13","凱基-五股",43,155,-112
"7027","8112至上","110/07/13","台灣摩根士丹利",183,0,183
"7028","8112至上","110/07/13","凱基-市政",0,100,-100
"7029","8112至上","110/07/13","群益金鼎-敦南",153,2,151
"7030","8112至上","110/07/13","元大-大里德芳",1,92,-91
"7031","8112至上","110/07/13","臺銀-金山",146,26,120
"7032","8112至上","110/07/13","玉山-桃園",26,110,-84
"7033","8112至上","110/07/13","臺銀",133,19,114
"7034","8112至上","110/07/13","兆豐-天母",0,81,-81
"7035","8112至上","110/07/13","合庫-台中",115,6,109
"7036","8112至上","110/07/13","凱基-城中",3,84,-81
"7037","8112至上","110/07/13","亞東-板橋",134,26,108
"7038","8112至上","110/07/13","日盛-新莊",9,85,-76
"7039","8112至上","110/07/13","凱基-台北",414,326,88
"7040","8112至上","110/07/13","日盛-台中",2,64,-62
"7041","8112至上","110/07/13","新加坡商瑞銀",181,100,81
"7042","8112至上","110/07/13","日盛-中壢",3,64,-61
"7043","8112至上","110/07/13","國泰-敦南",108,31,77
"7044","8112至上","110/07/13","元大-台中",2,59,-57
"7045","8112至上","110/07/13","第一金-華江",77,4,73
"7046","8112至上","110/07/13","元大-雙和",7,64,-57
"7047","8112至上","110/07/13","永豐金-內湖",73,1,72
"7048","8112至上","110/07/13","元大-高雄",8,62,-54
"7049","8112至上","110/07/13","元大-永和",68,1,67
"7050","8112至上","110/07/13","元大-館前",2,55,-53
"7051","4903聯光通","110/07/13","台灣企銀-太平",56,0,56
"7052","4903聯光通","110/07/13","土銀",0,32,-32
"7053","4903聯光通","110/07/13","元富-新興",23,0,23
"7054","4903聯光通","110/07/13","元大-樹林",0,19,-19
"7055","4903聯光通","110/07/13","日盛-樹林",22,0,22
"7056","4903聯光通","110/07/13","凱基-士林",0,17,-17
"7057","4903聯光通","110/07/13","兆豐-天母",20,0,20
"7058","4903聯光通","110/07/13","國票-博愛",0,14,-14
"7059","4903聯光通","110/07/13","華南永昌-桃園",20,0,20
"7060","4903聯光通","110/07/13","元富",0,10,-10
"7061","4903聯光通","110/07/13","富邦-新店",10,0,10
"7062","4903聯光通","110/07/13","新光",0,10,-10
"7063","4903聯光通","110/07/13","新光-台中",5,0,5
"7064","4903聯光通","110/07/13","玉山-南京東路",0,10,-10
"7065","4903聯光通","110/07/13","華南永昌-台中",5,0,5
"7066","4903聯光通","110/07/13","富邦-陽明",0,10,-10
"7067","4903聯光通","110/07/13","元大-崇德",5,0,5
"7068","4903聯光通","110/07/13","元大-大甲",0,8,-8
"7069","4903聯光通","110/07/13","元大-草屯",5,0,5
"7070","4903聯光通","110/07/13","富邦-台中",0,7,-7
"7071","4903聯光通","110/07/13","元富-草屯",4,0,4
"7072","4903聯光通","110/07/13","凱基-中壢",0,6,-6
"7073","4903聯光通","110/07/13","元大-清水",4,0,4
"7074","4903聯光通","110/07/13","臺銀-民權",0,5,-5
"7075","4903聯光通","110/07/13","元大-東泰",4,0,4
"7076","4903聯光通","110/07/13","日盛-板橋",0,5,-5
"7077","4903聯光通","110/07/13","元大-佳里",2,0,2
"7078","4903聯光通","110/07/13","中國信託-忠孝",0,5,-5
"7079","4903聯光通","110/07/13","永豐金-板橋",2,0,2
"7080","4903聯光通","110/07/13","永豐金-鳳山",0,5,-5
"7081","2929淘帝","110/07/13","玉山-新竹",130,0,130
"7082","2929淘帝","110/07/13","美商高盛",0,177,-177
"7083","2929淘帝","110/07/13","臺銀-民權",60,0,60
"7084","2929淘帝","110/07/13","凱基-台北",6,80,-74
"7085","2929淘帝","110/07/13","新百王",31,0,31
"7086","2929淘帝","110/07/13","元富-大裕",0,49,-49
"7087","2929淘帝","110/07/13","日盛-園區",30,0,30
"7088","2929淘帝","110/07/13","國泰-館前",3,51,-48
"7089","2929淘帝","110/07/13","元大-南投",31,1,30
"7090","2929淘帝","110/07/13","凱基-中壢",0,41,-41
"7091","2929淘帝","110/07/13","兆豐-忠孝",28,0,28
"7092","2929淘帝","110/07/13","港商野村",21,55,-34
"7093","2929淘帝","110/07/13","元大-民生",28,0,28
"7094","2929淘帝","110/07/13","華南永昌-南京",2,34,-32
"7095","2929淘帝","110/07/13","合庫-高雄",27,0,27
"7096","2929淘帝","110/07/13","群益金鼎-土城",0,30,-30
"7097","2929淘帝","110/07/13","凱基-豐中",27,0,27
"7098","2929淘帝","110/07/13","富邦-南屯",0,22,-22
"7099","2929淘帝","110/07/13","新光",21,4,17
"7100","2929淘帝","110/07/13","第一金-豐原",0,20,-20
"7101","2929淘帝","110/07/13","元大-天母",17,0,17
"7102","2929淘帝","110/07/13","元大-屏南",6,26,-20
"7103","2929淘帝","110/07/13","永興",14,0,14
"7104","2929淘帝","110/07/13","永豐金-敦南",1,21,-20
"7105","2929淘帝","110/07/13","富邦-台北",12,0,12
"7106","2929淘帝","110/07/13","凱基-三重",2,21,-19
"7107","2929淘帝","110/07/13","元大-永和",12,0,12
"7108","2929淘帝","110/07/13","富邦-仁愛",7,25,-18
"7109","2929淘帝","110/07/13","國票-天祥",11,0,11
"7110","2929淘帝","110/07/13","元大-北投",0,16,-16
"7111","5410國眾","110/07/13","兆豐-城中",274,0,274
"7112","5410國眾","110/07/13","元富-嘉義",0,103,-103
"7113","5410國眾","110/07/13","新光",50,4,46
"7114","5410國眾","110/07/13","凱基-台北",0,50,-50
"7115","5410國眾","110/07/13","國泰-台中",26,0,26
"7116","5410國眾","110/07/13","瑞士信貸",0,31,-31
"7117","5410國眾","110/07/13","新加坡商瑞銀",22,0,22
"7118","5410國眾","110/07/13","台新-新莊",0,27,-27
"7119","5410國眾","110/07/13","光和-嘉義",20,0,20
"7120","5410國眾","110/07/13","元大-汐止",0,20,-20
"7121","5410國眾","110/07/13","凱基-竹北",17,0,17
"7122","5410國眾","110/07/13","亞東-新竹",0,17,-17
"7123","5410國眾","110/07/13","新光-桃園",15,0,15
"7124","5410國眾","110/07/13","元大-南勢角",0,13,-13
"7125","5410國眾","110/07/13","凱基-台東",14,0,14
"7126","5410國眾","110/07/13","台新-台南",0,12,-12
"7127","5410國眾","110/07/13","富邦-竹北",11,0,11
"7128","5410國眾","110/07/13","中國信託",0,11,-11
"7129","5410國眾","110/07/13","元富-同大",10,0,10
"7130","5410國眾","110/07/13","華南永昌",0,11,-11
"7131","5410國眾","110/07/13","國泰-敦南",24,15,9
"7132","5410國眾","110/07/13","臺銀-臺南",0,10,-10
"7133","5410國眾","110/07/13","日盛-內湖",7,0,7
"7134","5410國眾","110/07/13","台灣企銀-民雄",0,10,-10
"7135","5410國眾","110/07/13","台新-左楠",7,0,7
"7136","5410國眾","110/07/13","高橋",0,10,-10
"7137","5410國眾","110/07/13","元大-新盛",18,12,6
"7138","5410國眾","110/07/13","康和-嘉義",0,10,-10
"7139","5410國眾","110/07/13","統一",5,0,5
"7140","5410國眾","110/07/13","凱基-基隆",0,10,-10
"7141","2841台開","110/07/13","中國信託-高雄",251,50,201
"7142","2841台開","110/07/13","兆豐-公益",0,177,-177
"7143","2841台開","110/07/13","日盛證券",210,13,197
"7144","2841台開","110/07/13","日進",0,152,-152
"7145","2841台開","110/07/13","第一金-台中",55,0,55
"7146","2841台開","110/07/13","港商野村",0,109,-109
"7147","2841台開","110/07/13","國泰-板橋",46,0,46
"7148","2841台開","110/07/13","日盛-信義",0,103,-103
"7149","2841台開","110/07/13","國泰-館前",48,3,45
"7150","2841台開","110/07/13","國泰-敦南",11,75,-64
"7151","2841台開","110/07/13","華南永昌-新莊",45,0,45
"7152","2841台開","110/07/13","永興",0,50,-50
"7153","2841台開","110/07/13","日盛-園區",42,0,42
"7154","2841台開","110/07/13","永豐金-敦南",61,104,-43
"7155","2841台開","110/07/13","台新證券",32,0,32
"7156","2841台開","110/07/13","富邦-台南",0,42,-42
"7157","2841台開","110/07/13","台新-高雄",32,2,30
"7158","2841台開","110/07/13","國票-安和",0,30,-30
"7159","2841台開","110/07/13","豐農",23,0,23
"7160","2841台開","110/07/13","元大-桃園",0,25,-25
"7161","2841台開","110/07/13","合庫-嘉義",20,0,20
"7162","2841台開","110/07/13","新光",8,32,-24
"7163","2841台開","110/07/13","華南永昌-高雄",20,0,20
"7164","2841台開","110/07/13","元大-仁愛",0,24,-24
"7165","2841台開","110/07/13","元大-樹林",16,0,16
"7166","2841台開","110/07/13","日盛-中和",0,20,-20
"7167","2841台開","110/07/13","第一金-華江",15,2,13
"7168","2841台開","110/07/13","元富",0,20,-20
"7169","2841台開","110/07/13","美商高盛",12,0,12
"7170","2841台開","110/07/13","富邦-宜蘭",0,20,-20
"7171","6207雷科","110/07/13","元大-高雄",121,0,121
"7172","6207雷科","110/07/13","華南永昌-朴子",1,60,-59
"7173","6207雷科","110/07/13","第一金-新興",20,0,20
"7174","6207雷科","110/07/13","元大-南海",0,36,-36
"7175","6207雷科","110/07/13","元富-三重",20,0,20
"7176","6207雷科","110/07/13","凱基-土城",0,35,-35
"7177","6207雷科","110/07/13","元大-林園",15,0,15
"7178","6207雷科","110/07/13","台灣企銀",0,20,-20
"7179","6207雷科","110/07/13","元大-金華",16,1,15
"7180","6207雷科","110/07/13","群益金鼎-丹鳳",0,20,-20
"7181","6207雷科","110/07/13","日盛證券",10,0,10
"7182","6207雷科","110/07/13","元大-博愛",0,17,-17
"7183","6207雷科","110/07/13","統一-台中",10,0,10
"7184","6207雷科","110/07/13","元大-北港",0,13,-13
"7185","6207雷科","110/07/13","群益金鼎-土城",10,0,10
"7186","6207雷科","110/07/13","新加坡商瑞銀",0,12,-12
"7187","6207雷科","110/07/13","群益金鼎-桃園",10,0,10
"7188","6207雷科","110/07/13","凱基-台北",4,16,-12
"7189","6207雷科","110/07/13","永豐金-新莊",10,0,10
"7190","6207雷科","110/07/13","日茂-埔里",0,11,-11
"7191","6207雷科","110/07/13","永豐金-新店",10,0,10
"7192","6207雷科","110/07/13","元大-莒光",0,11,-11
"7193","6207雷科","110/07/13","元大證券",9,0,9
"7194","6207雷科","110/07/13","統一-新竹",0,10,-10
"7195","6207雷科","110/07/13","日盛-木柵",9,1,8
"7196","6207雷科","110/07/13","元大-西螺",0,10,-10
"7197","6207雷科","110/07/13","兆豐-來福",8,0,8
"7198","6207雷科","110/07/13","康和-台中",0,8,-8
"7199","6207雷科","110/07/13","新光",7,0,7
"7200","6207雷科","110/07/13","兆豐-高雄",0,6,-6
"7201","3679新至陞","110/07/13","永豐金證券",50,0,50
"7202","3679新至陞","110/07/13","摩根大通",2,25,-23
"7203","3679新至陞","110/07/13","國泰-桃園",22,0,22
"7204","3679新至陞","110/07/13","元大-成功",0,22,-22
"7205","3679新至陞","110/07/13","台中銀-員林",11,0,11
"7206","3679新至陞","110/07/13","富邦-板橋",1,19,-18
"7207","3679新至陞","110/07/13","元大-文心興安",8,0,8
"7208","3679新至陞","110/07/13","日盛-新莊",0,10,-10
"7209","3679新至陞","110/07/13","美商高盛",6,0,6
"7210","3679新至陞","110/07/13","台新-台中",0,10,-10
"7211","3679新至陞","110/07/13","台新-高雄",6,0,6
"7212","3679新至陞","110/07/13","永豐金-新竹",0,8,-8
"7213","3679新至陞","110/07/13","凱基-台北",18,12,6
"7214","3679新至陞","110/07/13","瑞士信貸",12,19,-7
"7215","3679新至陞","110/07/13","日盛-復興",5,0,5
"7216","3679新至陞","110/07/13","統一-南京",0,7,-7
"7217","3679新至陞","110/07/13","(牛牛牛)亞-鑫豐",4,0,4
"7218","3679新至陞","110/07/13","凱基-新莊",0,7,-7
"7219","3679新至陞","110/07/13","元富-大昌",3,0,3
"7220","3679新至陞","110/07/13","新加坡商瑞銀",0,6,-6
"7221","3679新至陞","110/07/13","富邦-台北",3,0,3
"7222","3679新至陞","110/07/13","合庫-自強",0,5,-5
"7223","3679新至陞","110/07/13","日盛-樹林",2,0,2
"7224","3679新至陞","110/07/13","富邦-桃園",0,5,-5
"7225","3679新至陞","110/07/13","宏遠-光隆",2,0,2
"7226","3679新至陞","110/07/13","永豐金-潮州",0,4,-4
"7227","3679新至陞","110/07/13","美林",3,1,2
"7228","3679新至陞","110/07/13","臺銀-臺南",0,3,-3
"7229","3679新至陞","110/07/13","第一金-中壢",2,0,2
"7230","3679新至陞","110/07/13","元大-六合",0,3,-3
"7231","2727王品","110/07/13","富邦-台北",43,3,40
"7232","2727王品","110/07/13","台灣摩根士丹利",15,97,-82
"7233","2727王品","110/07/13","元大-基隆孝二",40,0,40
"7234","2727王品","110/07/13","玉山-台南",5,57,-52
"7235","2727王品","110/07/13","國票-新莊",40,1,39
"7236","2727王品","110/07/13","新加坡商瑞銀",0,48,-48
"7237","2727王品","110/07/13","第一金-豐原",66,42,24
"7238","2727王品","110/07/13","凱基-台北",41,77,-36
"7239","2727王品","110/07/13","永豐金-大園",34,10,24
"7240","2727王品","110/07/13","永豐金-永康",0,22,-22
"7241","2727王品","110/07/13","元大-北屯",22,0,22
"7242","2727王品","110/07/13","統一-台中",2,22,-20
"7243","2727王品","110/07/13","元大-東蘆",26,7,19
"7244","2727王品","110/07/13","國泰-台中",21,39,-18
"7245","2727王品","110/07/13","永豐金-萬盛",13,1,12
"7246","2727王品","110/07/13","合庫-彰化",3,20,-17
"7247","2727王品","110/07/13","日盛-嘉義",11,0,11
"7248","2727王品","110/07/13","港商野村",13,30,-17
"7249","2727王品","110/07/13","日盛-八德",11,0,11
"7250","2727王品","110/07/13","元大-楊梅",1,16,-15
"7251","2727王品","110/07/13","統一-竹南",11,0,11
"7252","2727王品","110/07/13","凱基-高美館",2,15,-13
"7253","2727王品","110/07/13","日盛-士林",12,2,10
"7254","2727王品","110/07/13","美商高盛",2,14,-12
"7255","2727王品","110/07/13","統一-敦南",10,0,10
"7256","2727王品","110/07/13","統一-平鎮",1,13,-12
"7257","2727王品","110/07/13","中國信託",15,5,10
"7258","2727王品","110/07/13","兆豐-台中港",4,16,-12
"7259","2727王品","110/07/13","兆豐-竹北",13,3,10
"7260","2727王品","110/07/13","凱基-八德",1,13,-12
"7261","1570力肯","110/07/13","新光",115,11,104
"7262","1570力肯","110/07/13","元大-北三重",0,162,-162
"7263","1570力肯","110/07/13","群益金鼎-高雄",54,0,54
"7264","1570力肯","110/07/13","元大-大灣",0,25,-25
"7265","1570力肯","110/07/13","國票-新莊",22,0,22
"7266","1570力肯","110/07/13","永豐金-苓雅",0,22,-22
"7267","1570力肯","110/07/13","日盛-桃園",12,0,12
"7268","1570力肯","110/07/13","永豐金-永康",0,19,-19
"7269","1570力肯","110/07/13","元大-高雄",12,0,12
"7270","1570力肯","110/07/13","富邦-員林",0,15,-15
"7271","1570力肯","110/07/13","合庫-自強",11,0,11
"7272","1570力肯","110/07/13","凱基-台南",0,11,-11
"7273","1570力肯","110/07/13","摩根大通",26,15,11
"7274","1570力肯","110/07/13","日盛-竹北",0,10,-10
"7275","1570力肯","110/07/13","永豐金-中盛",11,0,11
"7276","1570力肯","110/07/13","國票-九鼎",0,10,-10
"7277","1570力肯","110/07/13","兆豐-台中港",10,0,10
"7278","1570力肯","110/07/13","凱基-桃園",0,10,-10
"7279","1570力肯","110/07/13","國泰-松江",9,0,9
"7280","1570力肯","110/07/13","凱基-新豐",0,10,-10
"7281","1570力肯","110/07/13","元大-新盛",9,0,9
"7282","1570力肯","110/07/13","元大-學甲",0,10,-10
"7283","1570力肯","110/07/13","元富-緯城",6,0,6
"7284","1570力肯","110/07/13","群益金鼎-東湖",1,10,-9
"7285","1570力肯","110/07/13","統一-三重",5,0,5
"7286","1570力肯","110/07/13","大昌",0,6,-6
"7287","1570力肯","110/07/13","元大-前金",5,0,5
"7288","1570力肯","110/07/13","元大-土城學府",0,6,-6
"7289","1570力肯","110/07/13","永豐金證券",5,0,5
"7290","1570力肯","110/07/13","統一",0,5,-5
"7291","6180橘子","110/07/13","摩根大通",119,0,119
"7292","6180橘子","110/07/13","元大-崇德",2,61,-59
"7293","6180橘子","110/07/13","美商高盛",96,0,96
"7294","6180橘子","110/07/13","康和-台中",0,51,-51
"7295","6180橘子","110/07/13","新加坡商瑞銀",86,7,79
"7296","6180橘子","110/07/13","康和-台北",0,50,-50
"7297","6180橘子","110/07/13","元大-和平",40,0,40
"7298","6180橘子","110/07/13","元富-潮州",0,40,-40
"7299","6180橘子","110/07/13","凱基-台北",83,47,36
"7300","6180橘子","110/07/13","日盛-永康",0,26,-26
"7301","6180橘子","110/07/13","美林",39,5,34
"7302","6180橘子","110/07/13","永豐金-中正",0,24,-24
"7303","6180橘子","110/07/13","富邦-新竹華信",31,2,29
"7304","6180橘子","110/07/13","國泰-板橋",2,25,-23
"7305","6180橘子","110/07/13","統一-南京",21,0,21
"7306","6180橘子","110/07/13","日盛-大墩",0,20,-20
"7307","6180橘子","110/07/13","富邦-陽明",24,3,21
"7308","6180橘子","110/07/13","元大-草屯",13,32,-19
"7309","6180橘子","110/07/13","大昌-樹林",21,1,20
"7310","6180橘子","110/07/13","元富-林園",1,18,-17
"7311","6180橘子","110/07/13","花旗環球",19,0,19
"7312","6180橘子","110/07/13","新光-新竹",1,18,-17
"7313","6180橘子","110/07/13","華南永昌-台南",19,0,19
"7314","6180橘子","110/07/13","元大-土城永寧",0,17,-17
"7315","6180橘子","110/07/13","福勝",14,0,14
"7316","6180橘子","110/07/13","國泰-新莊",3,19,-16
"7317","6180橘子","110/07/13","富邦-嘉義",12,1,11
"7318","6180橘子","110/07/13","中國信託-永康",6,21,-15
"7319","6180橘子","110/07/13","元大-板橋三民",11,0,11
"7320","6180橘子","110/07/13","凱基-東港",1,15,-14
"7321","2390云辰","110/07/13","新加坡商瑞銀",562,75,487
"7322","2390云辰","110/07/13","大展-台南",0,532,-532
"7323","2390云辰","110/07/13","台灣摩根士丹利",330,155,175
"7324","2390云辰","110/07/13","凱基-台北",668,854,-186
"7325","2390云辰","110/07/13","兆豐-公益",126,25,101
"7326","2390云辰","110/07/13","凱基-三重",12,172,-160
"7327","2390云辰","110/07/13","元富-中港",100,2,98
"7328","2390云辰","110/07/13","兆豐-忠孝",4,161,-157
"7329","2390云辰","110/07/13","統一-新台中",106,9,97
"7330","2390云辰","110/07/13","元大-士林",19,170,-151
"7331","2390云辰","110/07/13","中國信託-松江",81,11,70
"7332","2390云辰","110/07/13","臺銀-新竹",14,117,-103
"7333","2390云辰","110/07/13","日盛-板橋",72,3,69
"7334","2390云辰","110/07/13","國票-台中",4,102,-98
"7335","2390云辰","110/07/13","日盛-和美",57,0,57
"7336","2390云辰","110/07/13","新光",147,232,-85
"7337","2390云辰","110/07/13","永豐金-桃園",88,36,52
"7338","2390云辰","110/07/13","致和-崇德",2,70,-68
"7339","2390云辰","110/07/13","玉山-士林",54,4,50
"7340","2390云辰","110/07/13","群益金鼎-屏東",2,70,-68
"7341","2390云辰","110/07/13","富邦-仁愛",56,6,50
"7342","2390云辰","110/07/13","元大-大里",35,98,-63
"7343","2390云辰","110/07/13","第一金-豐原",50,1,49
"7344","2390云辰","110/07/13","元大-萬華",35,94,-59
"7345","2390云辰","110/07/13","摩根大通",502,453,49
"7346","2390云辰","110/07/13","元富-吉利",2,60,-58
"7347","2390云辰","110/07/13","凱基-松山",61,13,48
"7348","2390云辰","110/07/13","兆豐-新竹",3,53,-50
"7349","2390云辰","110/07/13","大昌",64,22,42
"7350","2390云辰","110/07/13","富邦-嘉義",65,108,-43
"7351","2363矽統","110/07/12","凱基-幸福",4046,31,4015
"7352","2363矽統","110/07/12","台新證券",478,2105,-1627
"7353","2363矽統","110/07/12","統一",3504,120,3384
"7354","2363矽統","110/07/12","第一金-忠孝",4,1068,-1064
"7355","2363矽統","110/07/12","摩根大通",3006,2149,857
"7356","2363矽統","110/07/12","台新-台中",381,1003,-622
"7357","2363矽統","110/07/12","永豐金證券",1428,610,818
"7358","2363矽統","110/07/12","新光",1295,1822,-527
"7359","2363矽統","110/07/12","兆豐-復興",1936,1233,703
"7360","2363矽統","110/07/12","大昌-樹林",54,537,-483
"7361","2363矽統","110/07/12","台灣摩根士丹利",701,0,701
"7362","2363矽統","110/07/12","華南永昌-台中",90,549,-459
"7363","2363矽統","110/07/12","永豐金-南投",803,145,658
"7364","2363矽統","110/07/12","玉山-高雄",167,612,-445
"7365","2363矽統","110/07/12","統一-仁愛",1214,586,628
"7366","2363矽統","110/07/12","元富-同大",201,540,-339
"7367","2363矽統","110/07/12","統一-土城",688,75,613
"7368","2363矽統","110/07/12","華南永昌-東勢",31,367,-336
"7369","2363矽統","110/07/12","統一-城中",711,131,580
"7370","2363矽統","110/07/12","土銀-花蓮",9,333,-324
"7371","2363矽統","110/07/12","統一-敦南",632,54,578
"7372","2363矽統","110/07/12","凱基-豐中",120,434,-314
"7373","2363矽統","110/07/12","新加坡商瑞銀",1232,731,501
"7374","2363矽統","110/07/12","永豐金-竹科",54,323,-269
"7375","2363矽統","110/07/12","元富",2640,2142,498
"7376","2363矽統","110/07/12","元大-斗六",53,300,-247
"7377","2363矽統","110/07/12","凱基-永和",460,31,429
"7378","2363矽統","110/07/12","華南永昌-朴子",47,278,-231
"7379","2363矽統","110/07/12","第一金",380,22,358
"7380","2363矽統","110/07/12","永豐金-彰化",22,228,-206
"7381","8112至上","110/07/12","摩根大通",1167,290,877
"7382","8112至上","110/07/12","群益金鼎-新莊",1,156,-155
"7383","8112至上","110/07/12","凱基-台北",983,546,437
"7384","8112至上","110/07/12","國票-中港",0,131,-131
"7385","8112至上","110/07/12","新加坡商瑞銀",429,12,417
"7386","8112至上","110/07/12","元大證券",10,136,-126
"7387","8112至上","110/07/12","元大-屏南",360,2,358
"7388","8112至上","110/07/12","元大-中壢",11,135,-124
"7389","8112至上","110/07/12","美林",323,15,308
"7390","8112至上","110/07/12","合庫-基隆",0,122,-122
"7391","8112至上","110/07/12","台灣摩根士丹利",299,0,299
"7392","8112至上","110/07/12","群益金鼎-高盛",4,103,-99
"7393","8112至上","110/07/12","港商野村",267,28,239
"7394","8112至上","110/07/12","新光",110,202,-92
"7395","8112至上","110/07/12","大慶",165,3,162
"7396","8112至上","110/07/12","元大-府城",2,94,-92
"7397","8112至上","110/07/12","永豐金-台南",170,29,141
"7398","8112至上","110/07/12","富邦-板橋",5,92,-87
"7399","8112至上","110/07/12","華南永昌-長虹",128,2,126
"7400","8112至上","110/07/12","元大-土城",8,89,-81
"7401","8112至上","110/07/12","富邦-仁愛",157,51,106
"7402","8112至上","110/07/12","日盛-頭份",40,117,-77
"7403","8112至上","110/07/12","瑞士信貸",104,0,104
"7404","8112至上","110/07/12","玉山-嘉義",3,80,-77
"7405","8112至上","110/07/12","凱基-站前",100,11,89
"7406","8112至上","110/07/12","永豐金-松山",4,79,-75
"7407","8112至上","110/07/12","富邦-北港",90,3,87
"7408","8112至上","110/07/12","元大-敦南",3,75,-72
"7409","8112至上","110/07/12","元大-北港",101,20,81
"7410","8112至上","110/07/12","元富-大裕",6,77,-71
"7411","4903聯光通","110/07/12","台灣企銀-太平",19,0,19
"7412","4903聯光通","110/07/12","玉山-南京東路",0,16,-16
"7413","4903聯光通","110/07/12","統一-土城",17,0,17
"7414","4903聯光通","110/07/12","新光",0,14,-14
"7415","4903聯光通","110/07/12","國票-博愛",14,0,14
"7416","4903聯光通","110/07/12","兆豐-彰化",0,10,-10
"7417","4903聯光通","110/07/12","新光-台中",15,2,13
"7418","4903聯光通","110/07/12","國票",0,10,-10
"7419","4903聯光通","110/07/12","元大-彰化",11,0,11
"7420","4903聯光通","110/07/12","富邦-敦南",0,10,-10
"7421","4903聯光通","110/07/12","華南永昌-林口",10,0,10
"7422","4903聯光通","110/07/12","元大-前金",0,9,-9
"7423","4903聯光通","110/07/12","永豐金-南投",9,0,9
"7424","4903聯光通","110/07/12","日盛-頭份",0,8,-8
"7425","4903聯光通","110/07/12","元大-清水",8,0,8
"7426","4903聯光通","110/07/12","元大-太平",0,8,-8
"7427","4903聯光通","110/07/12","元大-博愛",8,0,8
"7428","4903聯光通","110/07/12","兆豐-埔墘",0,7,-7
"7429","4903聯光通","110/07/12","玉山-新莊",5,0,5
"7430","4903聯光通","110/07/12","臺銀-民權",0,5,-5
"7431","4903聯光通","110/07/12","凱基-士林",10,5,5
"7432","4903聯光通","110/07/12","富邦-板橋",0,5,-5
"7433","4903聯光通","110/07/12","元大-斗六",4,0,4
"7434","4903聯光通","110/07/12","元大-土城永寧",0,5,-5
"7435","4903聯光通","110/07/12","永豐金-羅東",4,0,4
"7436","4903聯光通","110/07/12","台新證券",0,4,-4
"7437","4903聯光通","110/07/12","日盛-樹林",3,0,3
"7438","4903聯光通","110/07/12","凱基-中壢",0,4,-4
"7439","4903聯光通","110/07/12","華南永昌-鶯歌",2,0,2
"7440","4903聯光通","110/07/12","元大-羅東",0,4,-4
"7441","2929淘帝","110/07/12","新光-台中",95,36,59
"7442","2929淘帝","110/07/12","華南永昌-林口",7,208,-201
"7443","2929淘帝","110/07/12","富邦-板橋",62,5,57
"7444","2929淘帝","110/07/12","富邦-台北",6,200,-194
"7445","2929淘帝","110/07/12","合庫-高雄",56,6,50
"7446","2929淘帝","110/07/12","元富-大裕",11,200,-189
"7447","2929淘帝","110/07/12","永興",41,0,41
"7448","2929淘帝","110/07/12","台中銀-台北",0,160,-160
"7449","2929淘帝","110/07/12","兆豐-忠孝",58,18,40
"7450","2929淘帝","110/07/12","日盛-園區",1,111,-110
"7451","2929淘帝","110/07/12","新光-高雄",39,3,36
"7452","2929淘帝","110/07/12","日盛-八德",0,88,-88
"7453","2929淘帝","110/07/12","凱基-豐中",36,0,36
"7454","2929淘帝","110/07/12","玉山-新竹",32,110,-78
"7455","2929淘帝","110/07/12","元大-民生",35,0,35
"7456","2929淘帝","110/07/12","元大-前金",0,72,-72
"7457","2929淘帝","110/07/12","臺銀-臺南",32,1,31
"7458","2929淘帝","110/07/12","元大-館前",12,83,-71
"7459","2929淘帝","110/07/12","台新證券",44,13,31
"7460","2929淘帝","110/07/12","華南永昌",1,57,-56
"7461","2929淘帝","110/07/12","新百王",30,0,30
"7462","2929淘帝","110/07/12","元大-南崁",4,59,-55
"7463","2929淘帝","110/07/12","群益金鼎-大興",30,0,30
"7464","2929淘帝","110/07/12","元大-嘉義",0,51,-51
"7465","2929淘帝","110/07/12","凱基-台北",32,5,27
"7466","2929淘帝","110/07/12","日茂",1,50,-49
"7467","2929淘帝","110/07/12","元富-城東",26,0,26
"7468","2929淘帝","110/07/12","新光",35,83,-48
"7469","2929淘帝","110/07/12","國泰-松江",26,0,26
"7470","2929淘帝","110/07/12","日盛-新竹",1,48,-47
"7471","5410國眾","110/07/12","群益金鼎-中壢",68,0,68
"7472","5410國眾","110/07/12","摩根大通",6,67,-61
"7473","5410國眾","110/07/12","凱基-市政",40,0,40
"7474","5410國眾","110/07/12","元富-嘉義",0,60,-60
"7475","5410國眾","110/07/12","凱基-竹北",38,0,38
"7476","5410國眾","110/07/12","凱基-台北",0,51,-51
"7477","5410國眾","110/07/12","華南永昌-三重",30,0,30
"7478","5410國眾","110/07/12","元富-大裕",0,33,-33
"7479","5410國眾","110/07/12","永興",20,0,20
"7480","5410國眾","110/07/12","日盛-木柵",0,15,-15
"7481","5410國眾","110/07/12","統一-新台中",20,0,20
"7482","5410國眾","110/07/12","群益金鼎-民權",0,15,-15
"7483","5410國眾","110/07/12","兆豐-三重",20,0,20
"7484","5410國眾","110/07/12","元富-緯城",0,14,-14
"7485","5410國眾","110/07/12","富邦-台中",20,0,20
"7486","5410國眾","110/07/12","元大-大同",0,12,-12
"7487","5410國眾","110/07/12","臺銀",15,0,15
"7488","5410國眾","110/07/12","元大-莒光",0,10,-10
"7489","5410國眾","110/07/12","新光-桃園",20,6,14
"7490","5410國眾","110/07/12","元大-博愛",0,10,-10
"7491","5410國眾","110/07/12","元大-員林",12,0,12
"7492","5410國眾","110/07/12","日盛-永康",0,8,-8
"7493","5410國眾","110/07/12","日盛-員林",10,0,10
"7494","5410國眾","110/07/12","元大-四維",5,13,-8
"7495","5410國眾","110/07/12","元大-新盛",10,0,10
"7496","5410國眾","110/07/12","新加坡商瑞銀",0,7,-7
"7497","5410國眾","110/07/12","永豐金-台南",10,0,10
"7498","5410國眾","110/07/12","致和-金華",0,7,-7
"7499","5410國眾","110/07/12","元富-新莊",8,0,8
"7500","5410國眾","110/07/12","新光-新竹",0,7,-7
"7501","2841台開","110/07/12","永豐金-敦南",139,26,113
"7502","2841台開","110/07/12","華南永昌-朴子",0,528,-528
"7503","2841台開","110/07/12","日盛-雙和",68,0,68
"7504","2841台開","110/07/12","元大-苑裡",2,50,-48
"7505","2841台開","110/07/12","台新證券",62,4,58
"7506","2841台開","110/07/12","群益金鼎-東湖",0,40,-40
"7507","2841台開","110/07/12","凱基-文心",50,0,50
"7508","2841台開","110/07/12","第一金-員林",0,30,-30
"7509","2841台開","110/07/12","第一金-台中",45,0,45
"7510","2841台開","110/07/12","德信-中正",0,20,-20
"7511","2841台開","110/07/12","富邦-嘉義",40,0,40
"7512","2841台開","110/07/12","兆豐-嘉義",0,20,-20
"7513","2841台開","110/07/12","日盛-木柵",30,0,30
"7514","2841台開","110/07/12","彰銀-七賢",0,15,-15
"7515","2841台開","110/07/12","中國信託-文心",31,3,28
"7516","2841台開","110/07/12","元大-承德",0,14,-14
"7517","2841台開","110/07/12","元大-福營",30,7,23
"7518","2841台開","110/07/12","元富",0,12,-12
"7519","2841台開","110/07/12","台中銀",20,0,20
"7520","2841台開","110/07/12","富邦-陽明",0,11,-11
"7521","2841台開","110/07/12","國泰-板橋",20,0,20
"7522","2841台開","110/07/12","元大證券",0,11,-11
"7523","2841台開","110/07/12","元大-前金",20,0,20
"7524","2841台開","110/07/12","元大-大甲",0,10,-10
"7525","2841台開","110/07/12","中國信託-高雄",16,1,15
"7526","2841台開","110/07/12","日盛-新竹",0,8,-8
"7527","2841台開","110/07/12","陽信-石牌",15,0,15
"7528","2841台開","110/07/12","元富-城東",0,8,-8
"7529","2841台開","110/07/12","永豐金-南投",15,0,15
"7530","2841台開","110/07/12","玉山-台南",2,10,-8
"7531","6207雷科","110/07/12","元大-高雄",34,0,34
"7532","6207雷科","110/07/12","永豐金-三重",1,32,-31
"7533","6207雷科","110/07/12","華南永昌-林口",16,1,15
"7534","6207雷科","110/07/12","永全-八德",0,30,-30
"7535","6207雷科","110/07/12","摩根大通",19,6,13
"7536","6207雷科","110/07/12","國泰-台中",0,14,-14
"7537","6207雷科","110/07/12","元富-埔里",10,0,10
"7538","6207雷科","110/07/12","第一金-澎湖",0,10,-10
"7539","6207雷科","110/07/12","凱基-台南",10,0,10
"7540","6207雷科","110/07/12","元富-林園",0,10,-10
"7541","6207雷科","110/07/12","新加坡商瑞銀",9,0,9
"7542","6207雷科","110/07/12","元大-東門",0,10,-10
"7543","6207雷科","110/07/12","瑞士信貸",8,0,8
"7544","6207雷科","110/07/12","兆豐-嘉義",0,4,-4
"7545","6207雷科","110/07/12","中國信託-高雄",9,1,8
"7546","6207雷科","110/07/12","新光",0,4,-4
"7547","6207雷科","110/07/12","凱基-高雄",6,0,6
"7548","6207雷科","110/07/12","新光-台中",0,4,-4
"7549","6207雷科","110/07/12","元大-六合",6,0,6
"7550","6207雷科","110/07/12","群益金鼎-開元",0,4,-4
"7551","6207雷科","110/07/12","永豐金-信義",6,0,6
"7552","6207雷科","110/07/12","凱基-桃園",0,4,-4
"7553","6207雷科","110/07/12","群益金鼎-土城",5,0,5
"7554","6207雷科","110/07/12","凱基-民權",0,4,-4
"7555","6207雷科","110/07/12","群益金鼎-竹南",5,0,5
"7556","6207雷科","110/07/12","玉山-新莊",0,3,-3
"7557","6207雷科","110/07/12","元大-大灣",5,1,4
"7558","6207雷科","110/07/12","國泰-松江",0,3,-3
"7559","6207雷科","110/07/12","永興",3,0,3
"7560","6207雷科","110/07/12","富邦-羅東",0,3,-3
"7561","3679新至陞","110/07/12","富邦-新竹華信",40,2,38
"7562","3679新至陞","110/07/12","瑞士信貸",0,45,-45
"7563","3679新至陞","110/07/12","台中銀-員林",28,2,26
"7564","3679新至陞","110/07/12","永豐金-天母",0,39,-39
"7565","3679新至陞","110/07/12","聯邦-大業",24,0,24
"7566","3679新至陞","110/07/12","摩根大通",7,35,-28
"7567","3679新至陞","110/07/12","永豐金證券",20,0,20
"7568","3679新至陞","110/07/12","凱基-台北",8,36,-28
"7569","3679新至陞","110/07/12","港商法國興業",14,0,14
"7570","3679新至陞","110/07/12","華南永昌-小港",1,23,-22
"7571","3679新至陞","110/07/12","日盛-樹林",13,1,12
"7572","3679新至陞","110/07/12","台新-台中",0,15,-15
"7573","3679新至陞","110/07/12","國泰-桃園",9,0,9
"7574","3679新至陞","110/07/12","統一-台中",0,12,-12
"7575","3679新至陞","110/07/12","宏遠-館前",8,0,8
"7576","3679新至陞","110/07/12","元大-成功",1,12,-11
"7577","3679新至陞","110/07/12","凱基",10,2,8
"7578","3679新至陞","110/07/12","康和-澎湖",0,8,-8
"7579","3679新至陞","110/07/12","(牛牛牛)亞-網路",7,0,7
"7580","3679新至陞","110/07/12","新加坡商瑞銀",0,7,-7
"7581","3679新至陞","110/07/12","兆豐-員林",7,0,7
"7582","3679新至陞","110/07/12","兆豐-來福",0,7,-7
"7583","3679新至陞","110/07/12","大慶-蘆洲",5,0,5
"7584","3679新至陞","110/07/12","元大-佳里",0,6,-6
"7585","3679新至陞","110/07/12","土銀-花蓮",4,0,4
"7586","3679新至陞","110/07/12","美商高盛",0,5,-5
"7587","3679新至陞","110/07/12","台新-高雄",5,1,4
"7588","3679新至陞","110/07/12","國票-新莊",0,5,-5
"7589","3679新至陞","110/07/12","元大-天母",4,0,4
"7590","3679新至陞","110/07/12","台新-屏東",0,5,-5
"7591","2727王品","110/07/12","凱基-台北",354,198,156
"7592","2727王品","110/07/12","台灣摩根士丹利",5,386,-381
"7593","2727王品","110/07/12","統一-城中",159,22,137
"7594","2727王品","110/07/12","元大-嘉義",4,60,-56
"7595","2727王品","110/07/12","日盛-忠孝",60,0,60
"7596","2727王品","110/07/12","元大-大同",2,44,-42
"7597","2727王品","110/07/12","永豐金-忠孝",45,5,40
"7598","2727王品","110/07/12","國泰-台中",32,73,-41
"7599","2727王品","110/07/12","合庫-新竹",31,0,31
"7600","2727王品","110/07/12","元大證券",127,163,-36
"7601","2727王品","110/07/12","富邦-台中",31,3,28
"7602","2727王品","110/07/12","凱基",1,33,-32
"7603","2727王品","110/07/12","元大-桃園",35,10,25
"7604","2727王品","110/07/12","永全-南崁",1,31,-30
"7605","2727王品","110/07/12","新加坡商瑞銀",28,4,24
"7606","2727王品","110/07/12","凱基-和平",2,32,-30
"7607","2727王品","110/07/12","群益金鼎-古亭",25,2,23
"7608","2727王品","110/07/12","永豐金-大園",8,38,-30
"7609","2727王品","110/07/12","元大-龍潭",29,7,22
"7610","2727王品","110/07/12","瑞士信貸",0,28,-28
"7611","2727王品","110/07/12","永豐金-永康",25,3,22
"7612","2727王品","110/07/12","元富",17,44,-27
"7613","2727王品","110/07/12","富邦-竹北",24,3,21
"7614","2727王品","110/07/12","元大-北屯",5,32,-27
"7615","2727王品","110/07/12","群益金鼎-松山",20,0,20
"7616","2727王品","110/07/12","華南永昌",3,28,-25
"7617","2727王品","110/07/12","元大-八德",20,0,20
"7618","2727王品","110/07/12","統一-竹南",1,23,-22
"7619","2727王品","110/07/12","元大-南京",25,6,19
"7620","2727王品","110/07/12","永豐金證券",4,26,-22
"7621","1570力肯","110/07/12","國票-北高雄",40,0,40
"7622","1570力肯","110/07/12","日盛-竹北",0,40,-40
"7623","1570力肯","110/07/12","摩根大通",16,0,16
"7624","1570力肯","110/07/12","第一金-華江",1,38,-37
"7625","1570力肯","110/07/12","新光",31,19,12
"7626","1570力肯","110/07/12","元大-永春",0,26,-26
"7627","1570力肯","110/07/12","元大-台中中港",12,0,12
"7628","1570力肯","110/07/12","元大-古亭",1,20,-19
"7629","1570力肯","110/07/12","日盛-高雄",10,0,10
"7630","1570力肯","110/07/12","國泰-松江",0,16,-16
"7631","1570力肯","110/07/12","第一金-路竹",10,0,10
"7632","1570力肯","110/07/12","台新-台南",0,15,-15
"7633","1570力肯","110/07/12","台新-新莊",10,0,10
"7634","1570力肯","110/07/12","康和-石牌",0,15,-15
"7635","1570力肯","110/07/12","元大-新盛",9,0,9
"7636","1570力肯","110/07/12","國泰-板橋",0,11,-11
"7637","1570力肯","110/07/12","凱基-台北",8,0,8
"7638","1570力肯","110/07/12","元大-高雄",0,11,-11
"7639","1570力肯","110/07/12","彰銀-七賢",6,0,6
"7640","1570力肯","110/07/12","兆豐-桃園",0,10,-10
"7641","1570力肯","110/07/12","元富-緯城",6,0,6
"7642","1570力肯","110/07/12","元大-大益",0,10,-10
"7643","1570力肯","110/07/12","華南永昌-古亭",6,0,6
"7644","1570力肯","110/07/12","中國信託-文心",0,5,-5
"7645","1570力肯","110/07/12","富邦-陽明",6,0,6
"7646","1570力肯","110/07/12","光和",0,5,-5
"7647","1570力肯","110/07/12","臺銀-臺南",5,0,5
"7648","1570力肯","110/07/12","陽信-石牌",0,5,-5
"7649","1570力肯","110/07/12","宏遠-館前",5,0,5
"7650","1570力肯","110/07/12","國泰-高雄",0,5,-5
"7651","6180橘子","110/07/12","康和-台中",32,2,30
"7652","6180橘子","110/07/12","新百王",1,40,-39
"7653","6180橘子","110/07/12","美林",32,3,29
"7654","6180橘子","110/07/12","富邦-陽明",4,42,-38
"7655","6180橘子","110/07/12","元大-羅東",21,0,21
"7656","6180橘子","110/07/12","新光",3,32,-29
"7657","6180橘子","110/07/12","兆豐-埔墘",16,0,16
"7658","6180橘子","110/07/12","日盛-文化",4,20,-16
"7659","6180橘子","110/07/12","元大-雙和",12,0,12
"7660","6180橘子","110/07/12","華南永昌-鶯歌",0,15,-15
"7661","6180橘子","110/07/12","美商高盛",18,7,11
"7662","6180橘子","110/07/12","中國信託-忠孝",7,20,-13
"7663","6180橘子","110/07/12","台新證券",14,3,11
"7664","6180橘子","110/07/12","凱基-台北",5,17,-12
"7665","6180橘子","110/07/12","元大-中壢",12,1,11
"7666","6180橘子","110/07/12","凱基-高雄",0,11,-11
"7667","6180橘子","110/07/12","統一-南京",10,0,10
"7668","6180橘子","110/07/12","凱基-大安",0,10,-10
"7669","6180橘子","110/07/12","致和-崇德",10,0,10
"7670","6180橘子","110/07/12","元大-北屯",0,10,-10
"7671","6180橘子","110/07/12","玉山-板橋",10,0,10
"7672","6180橘子","110/07/12","元大-南京",0,9,-9
"7673","6180橘子","110/07/12","富邦-仁愛",10,0,10
"7674","6180橘子","110/07/12","元大-台南",1,10,-9
"7675","6180橘子","110/07/12","摩根大通",10,1,9
"7676","6180橘子","110/07/12","康和-澎湖",0,8,-8
"7677","6180橘子","110/07/12","元富-林園",8,0,8
"7678","6180橘子","110/07/12","第一金-台中",0,7,-7
"7679","6180橘子","110/07/12","大慶-富順",7,0,7
"7680","6180橘子","110/07/12","台新-台南",1,8,-7
"7681","2390云辰","110/07/12","統一-新台中",170,0,170
"7682","2390云辰","110/07/12","元大-天母",2,450,-448
"7683","2390云辰","110/07/12","華南永昌-麻豆",137,2,135
"7684","2390云辰","110/07/12","國泰-忠孝",1,143,-142
"7685","2390云辰","110/07/12","元富-成功",103,14,89
"7686","2390云辰","110/07/12","摩根大通",377,512,-135
"7687","2390云辰","110/07/12","元大-土城學府",146,69,77
"7688","2390云辰","110/07/12","台灣摩根士丹利",0,91,-91
"7689","2390云辰","110/07/12","永豐金-永康",76,4,72
"7690","2390云辰","110/07/12","美林",84,146,-62
"7691","2390云辰","110/07/12","台中銀",73,2,71
"7692","2390云辰","110/07/12","華南永昌-嘉義",2,61,-59
"7693","2390云辰","110/07/12","大昌",63,3,60
"7694","2390云辰","110/07/12","永豐金-羅東",0,49,-49
"7695","2390云辰","110/07/12","合庫-三重",50,0,50
"7696","2390云辰","110/07/12","玉山-台中",6,53,-47
"7697","2390云辰","110/07/12","元富-高雄",93,50,43
"7698","2390云辰","110/07/12","玉山-新莊",2,48,-46
"7699","2390云辰","110/07/12","元大-館前",40,4,36
"7700","2390云辰","110/07/12","元大-大里",7,52,-45
"7701","2390云辰","110/07/12","港商野村",143,109,34
"7702","2390云辰","110/07/12","元大-內湖",3,48,-45
"7703","2390云辰","110/07/12","元大-雙和",34,0,34
"7704","2390云辰","110/07/12","永豐金-市政",1,42,-41
"7705","2390云辰","110/07/12","群益金鼎-民權",33,2,31
"7706","2390云辰","110/07/12","元大-學甲",1,41,-40
"7707","2390云辰","110/07/12","日盛-八德",40,10,30
"7708","2390云辰","110/07/12","兆豐-高雄",2,41,-39
"7709","2390云辰","110/07/12","國票-嘉義",30,0,30
"7710","2390云辰","110/07/12","新加坡商瑞銀",21,59,-38
"7711","4903聯光通","110/07/12","台灣企銀-太平",19,0,19
"7712","4903聯光通","110/07/12","玉山-南京東路",0,16,-16
"7713","4903聯光通","110/07/12","統一-土城",17,0,17
"7714","4903聯光通","110/07/12","新光",0,14,-14
"7715","4903聯光通","110/07/12","國票-博愛",14,0,14
"7716","4903聯光通","110/07/12","兆豐-彰化",0,10,-10
"7717","4903聯光通","110/07/12","新光-台中",15,2,13
"7718","4903聯光通","110/07/12","國票",0,10,-10
"7719","4903聯光通","110/07/12","元大-彰化",11,0,11
"7720","4903聯光通","110/07/12","富邦-敦南",0,10,-10
"7721","4903聯光通","110/07/12","華南永昌-林口",10,0,10
"7722","4903聯光通","110/07/12","元大-前金",0,9,-9
"7723","4903聯光通","110/07/12","永豐金-南投",9,0,9
"7724","4903聯光通","110/07/12","日盛-頭份",0,8,-8
"7725","4903聯光通","110/07/12","元大-清水",8,0,8
"7726","4903聯光通","110/07/12","元大-太平",0,8,-8
"7727","4903聯光通","110/07/12","元大-博愛",8,0,8
"7728","4903聯光通","110/07/12","兆豐-埔墘",0,7,-7
"7729","4903聯光通","110/07/12","玉山-新莊",5,0,5
"7730","4903聯光通","110/07/12","臺銀-民權",0,5,-5
"7731","4903聯光通","110/07/12","凱基-士林",10,5,5
"7732","4903聯光通","110/07/12","富邦-板橋",0,5,-5
"7733","4903聯光通","110/07/12","元大-斗六",4,0,4
"7734","4903聯光通","110/07/12","元大-土城永寧",0,5,-5
"7735","4903聯光通","110/07/12","永豐金-羅東",4,0,4
"7736","4903聯光通","110/07/12","台新證券",0,4,-4
"7737","4903聯光通","110/07/12","日盛-樹林",3,0,3
"7738","4903聯光通","110/07/12","凱基-中壢",0,4,-4
"7739","4903聯光通","110/07/12","華南永昌-鶯歌",2,0,2
"7740","4903聯光通","110/07/12","元大-羅東",0,4,-4
"7741","2929淘帝","110/07/12","新光-台中",95,36,59
"7742","2929淘帝","110/07/12","華南永昌-林口",7,208,-201
"7743","2929淘帝","110/07/12","富邦-板橋",62,5,57
"7744","2929淘帝","110/07/12","富邦-台北",6,200,-194
"7745","2929淘帝","110/07/12","合庫-高雄",56,6,50
"7746","2929淘帝","110/07/12","元富-大裕",11,200,-189
"7747","2929淘帝","110/07/12","永興",41,0,41
"7748","2929淘帝","110/07/12","台中銀-台北",0,160,-160
"7749","2929淘帝","110/07/12","兆豐-忠孝",58,18,40
"7750","2929淘帝","110/07/12","日盛-園區",1,111,-110
"7751","2929淘帝","110/07/12","新光-高雄",39,3,36
"7752","2929淘帝","110/07/12","日盛-八德",0,88,-88
"7753","2929淘帝","110/07/12","凱基-豐中",36,0,36
"7754","2929淘帝","110/07/12","玉山-新竹",32,110,-78
"7755","2929淘帝","110/07/12","元大-民生",35,0,35
"7756","2929淘帝","110/07/12","元大-前金",0,72,-72
"7757","2929淘帝","110/07/12","臺銀-臺南",32,1,31
"7758","2929淘帝","110/07/12","元大-館前",12,83,-71
"7759","2929淘帝","110/07/12","台新證券",44,13,31
"7760","2929淘帝","110/07/12","華南永昌",1,57,-56
"7761","2929淘帝","110/07/12","新百王",30,0,30
"7762","2929淘帝","110/07/12","元大-南崁",4,59,-55
"7763","2929淘帝","110/07/12","群益金鼎-大興",30,0,30
"7764","2929淘帝","110/07/12","元大-嘉義",0,51,-51
"7765","2929淘帝","110/07/12","凱基-台北",32,5,27
"7766","2929淘帝","110/07/12","日茂",1,50,-49
"7767","2929淘帝","110/07/12","元富-城東",26,0,26
"7768","2929淘帝","110/07/12","新光",35,83,-48
"7769","2929淘帝","110/07/12","國泰-松江",26,0,26
"7770","2929淘帝","110/07/12","日盛-新竹",1,48,-47
"7771","5410國眾","110/07/12","群益金鼎-中壢",68,0,68
"7772","5410國眾","110/07/12","摩根大通",6,67,-61
"7773","5410國眾","110/07/12","凱基-市政",40,0,40
"7774","5410國眾","110/07/12","元富-嘉義",0,60,-60
"7775","5410國眾","110/07/12","凱基-竹北",38,0,38
"7776","5410國眾","110/07/12","凱基-台北",0,51,-51
"7777","5410國眾","110/07/12","華南永昌-三重",30,0,30
"7778","5410國眾","110/07/12","元富-大裕",0,33,-33
"7779","5410國眾","110/07/12","永興",20,0,20
"7780","5410國眾","110/07/12","日盛-木柵",0,15,-15
"7781","5410國眾","110/07/12","統一-新台中",20,0,20
"7782","5410國眾","110/07/12","群益金鼎-民權",0,15,-15
"7783","5410國眾","110/07/12","兆豐-三重",20,0,20
"7784","5410國眾","110/07/12","元富-緯城",0,14,-14
"7785","5410國眾","110/07/12","富邦-台中",20,0,20
"7786","5410國眾","110/07/12","元大-大同",0,12,-12
"7787","5410國眾","110/07/12","臺銀",15,0,15
"7788","5410國眾","110/07/12","元大-莒光",0,10,-10
"7789","5410國眾","110/07/12","新光-桃園",20,6,14
"7790","5410國眾","110/07/12","元大-博愛",0,10,-10
"7791","5410國眾","110/07/12","元大-員林",12,0,12
"7792","5410國眾","110/07/12","日盛-永康",0,8,-8
"7793","5410國眾","110/07/12","日盛-員林",10,0,10
"7794","5410國眾","110/07/12","元大-四維",5,13,-8
"7795","5410國眾","110/07/12","元大-新盛",10,0,10
"7796","5410國眾","110/07/12","新加坡商瑞銀",0,7,-7
"7797","5410國眾","110/07/12","永豐金-台南",10,0,10
"7798","5410國眾","110/07/12","致和-金華",0,7,-7
"7799","5410國眾","110/07/12","元富-新莊",8,0,8
"7800","5410國眾","110/07/12","新光-新竹",0,7,-7
"7801","2841台開","110/07/12","永豐金-敦南",139,26,113
"7802","2841台開","110/07/12","華南永昌-朴子",0,528,-528
"7803","2841台開","110/07/12","日盛-雙和",68,0,68
"7804","2841台開","110/07/12","元大-苑裡",2,50,-48
"7805","2841台開","110/07/12","台新證券",62,4,58
"7806","2841台開","110/07/12","群益金鼎-東湖",0,40,-40
"7807","2841台開","110/07/12","凱基-文心",50,0,50
"7808","2841台開","110/07/12","第一金-員林",0,30,-30
"7809","2841台開","110/07/12","第一金-台中",45,0,45
"7810","2841台開","110/07/12","德信-中正",0,20,-20
"7811","2841台開","110/07/12","富邦-嘉義",40,0,40
"7812","2841台開","110/07/12","兆豐-嘉義",0,20,-20
"7813","2841台開","110/07/12","日盛-木柵",30,0,30
"7814","2841台開","110/07/12","彰銀-七賢",0,15,-15
"7815","2841台開","110/07/12","中國信託-文心",31,3,28
"7816","2841台開","110/07/12","元大-承德",0,14,-14
"7817","2841台開","110/07/12","元大-福營",30,7,23
"7818","2841台開","110/07/12","元富",0,12,-12
"7819","2841台開","110/07/12","台中銀",20,0,20
"7820","2841台開","110/07/12","富邦-陽明",0,11,-11
"7821","2841台開","110/07/12","國泰-板橋",20,0,20
"7822","2841台開","110/07/12","元大證券",0,11,-11
"7823","2841台開","110/07/12","元大-前金",20,0,20
"7824","2841台開","110/07/12","元大-大甲",0,10,-10
"7825","2841台開","110/07/12","中國信託-高雄",16,1,15
"7826","2841台開","110/07/12","日盛-新竹",0,8,-8
"7827","2841台開","110/07/12","陽信-石牌",15,0,15
"7828","2841台開","110/07/12","元富-城東",0,8,-8
"7829","2841台開","110/07/12","永豐金-南投",15,0,15
"7830","2841台開","110/07/12","玉山-台南",2,10,-8
"7831","6207雷科","110/07/12","元大-高雄",34,0,34
"7832","6207雷科","110/07/12","永豐金-三重",1,32,-31
"7833","6207雷科","110/07/12","華南永昌-林口",16,1,15
"7834","6207雷科","110/07/12","永全-八德",0,30,-30
"7835","6207雷科","110/07/12","摩根大通",19,6,13
"7836","6207雷科","110/07/12","國泰-台中",0,14,-14
"7837","6207雷科","110/07/12","元富-埔里",10,0,10
"7838","6207雷科","110/07/12","第一金-澎湖",0,10,-10
"7839","6207雷科","110/07/12","凱基-台南",10,0,10
"7840","6207雷科","110/07/12","元富-林園",0,10,-10
"7841","6207雷科","110/07/12","新加坡商瑞銀",9,0,9
"7842","6207雷科","110/07/12","元大-東門",0,10,-10
"7843","6207雷科","110/07/12","瑞士信貸",8,0,8
"7844","6207雷科","110/07/12","兆豐-嘉義",0,4,-4
"7845","6207雷科","110/07/12","中國信託-高雄",9,1,8
"7846","6207雷科","110/07/12","新光",0,4,-4
"7847","6207雷科","110/07/12","凱基-高雄",6,0,6
"7848","6207雷科","110/07/12","新光-台中",0,4,-4
"7849","6207雷科","110/07/12","元大-六合",6,0,6
"7850","6207雷科","110/07/12","群益金鼎-開元",0,4,-4
"7851","6207雷科","110/07/12","永豐金-信義",6,0,6
"7852","6207雷科","110/07/12","凱基-桃園",0,4,-4
"7853","6207雷科","110/07/12","群益金鼎-土城",5,0,5
"7854","6207雷科","110/07/12","凱基-民權",0,4,-4
"7855","6207雷科","110/07/12","群益金鼎-竹南",5,0,5
"7856","6207雷科","110/07/12","玉山-新莊",0,3,-3
"7857","6207雷科","110/07/12","元大-大灣",5,1,4
"7858","6207雷科","110/07/12","國泰-松江",0,3,-3
"7859","6207雷科","110/07/12","永興",3,0,3
"7860","6207雷科","110/07/12","富邦-羅東",0,3,-3
"7861","3679新至陞","110/07/12","富邦-新竹華信",40,2,38
"7862","3679新至陞","110/07/12","瑞士信貸",0,45,-45
"7863","3679新至陞","110/07/12","台中銀-員林",28,2,26
"7864","3679新至陞","110/07/12","永豐金-天母",0,39,-39
"7865","3679新至陞","110/07/12","聯邦-大業",24,0,24
"7866","3679新至陞","110/07/12","摩根大通",7,35,-28
"7867","3679新至陞","110/07/12","永豐金證券",20,0,20
"7868","3679新至陞","110/07/12","凱基-台北",8,36,-28
"7869","3679新至陞","110/07/12","港商法國興業",14,0,14
"7870","3679新至陞","110/07/12","華南永昌-小港",1,23,-22
"7871","3679新至陞","110/07/12","日盛-樹林",13,1,12
"7872","3679新至陞","110/07/12","台新-台中",0,15,-15
"7873","3679新至陞","110/07/12","國泰-桃園",9,0,9
"7874","3679新至陞","110/07/12","統一-台中",0,12,-12
"7875","3679新至陞","110/07/12","宏遠-館前",8,0,8
"7876","3679新至陞","110/07/12","元大-成功",1,12,-11
"7877","3679新至陞","110/07/12","凱基",10,2,8
"7878","3679新至陞","110/07/12","康和-澎湖",0,8,-8
"7879","3679新至陞","110/07/12","(牛牛牛)亞-網路",7,0,7
"7880","3679新至陞","110/07/12","新加坡商瑞銀",0,7,-7
"7881","3679新至陞","110/07/12","兆豐-員林",7,0,7
"7882","3679新至陞","110/07/12","兆豐-來福",0,7,-7
"7883","3679新至陞","110/07/12","大慶-蘆洲",5,0,5
"7884","3679新至陞","110/07/12","元大-佳里",0,6,-6
"7885","3679新至陞","110/07/12","土銀-花蓮",4,0,4
"7886","3679新至陞","110/07/12","美商高盛",0,5,-5
"7887","3679新至陞","110/07/12","台新-高雄",5,1,4
"7888","3679新至陞","110/07/12","國票-新莊",0,5,-5
"7889","3679新至陞","110/07/12","元大-天母",4,0,4
"7890","3679新至陞","110/07/12","台新-屏東",0,5,-5
"7891","2727王品","110/07/12","凱基-台北",354,198,156
"7892","2727王品","110/07/12","台灣摩根士丹利",5,386,-381
"7893","2727王品","110/07/12","統一-城中",159,22,137
"7894","2727王品","110/07/12","元大-嘉義",4,60,-56
"7895","2727王品","110/07/12","日盛-忠孝",60,0,60
"7896","2727王品","110/07/12","元大-大同",2,44,-42
"7897","2727王品","110/07/12","永豐金-忠孝",45,5,40
"7898","2727王品","110/07/12","國泰-台中",32,73,-41
"7899","2727王品","110/07/12","合庫-新竹",31,0,31
"7900","2727王品","110/07/12","元大證券",127,163,-36
"7901","2727王品","110/07/12","富邦-台中",31,3,28
"7902","2727王品","110/07/12","凱基",1,33,-32
"7903","2727王品","110/07/12","元大-桃園",35,10,25
"7904","2727王品","110/07/12","永全-南崁",1,31,-30
"7905","2727王品","110/07/12","新加坡商瑞銀",28,4,24
"7906","2727王品","110/07/12","凱基-和平",2,32,-30
"7907","2727王品","110/07/12","群益金鼎-古亭",25,2,23
"7908","2727王品","110/07/12","永豐金-大園",8,38,-30
"7909","2727王品","110/07/12","元大-龍潭",29,7,22
"7910","2727王品","110/07/12","瑞士信貸",0,28,-28
"7911","2727王品","110/07/12","永豐金-永康",25,3,22
"7912","2727王品","110/07/12","元富",17,44,-27
"7913","2727王品","110/07/12","富邦-竹北",24,3,21
"7914","2727王品","110/07/12","元大-北屯",5,32,-27
"7915","2727王品","110/07/12","群益金鼎-松山",20,0,20
"7916","2727王品","110/07/12","華南永昌",3,28,-25
"7917","2727王品","110/07/12","元大-八德",20,0,20
"7918","2727王品","110/07/12","統一-竹南",1,23,-22
"7919","2727王品","110/07/12","元大-南京",25,6,19
"7920","2727王品","110/07/12","永豐金證券",4,26,-22
"7921","1570力肯","110/07/12","國票-北高雄",40,0,40
"7922","1570力肯","110/07/12","日盛-竹北",0,40,-40
"7923","1570力肯","110/07/12","摩根大通",16,0,16
"7924","1570力肯","110/07/12","第一金-華江",1,38,-37
"7925","1570力肯","110/07/12","新光",31,19,12
"7926","1570力肯","110/07/12","元大-永春",0,26,-26
"7927","1570力肯","110/07/12","元大-台中中港",12,0,12
"7928","1570力肯","110/07/12","元大-古亭",1,20,-19
"7929","1570力肯","110/07/12","日盛-高雄",10,0,10
"7930","1570力肯","110/07/12","國泰-松江",0,16,-16
"7931","1570力肯","110/07/12","第一金-路竹",10,0,10
"7932","1570力肯","110/07/12","台新-台南",0,15,-15
"7933","1570力肯","110/07/12","台新-新莊",10,0,10
"7934","1570力肯","110/07/12","康和-石牌",0,15,-15
"7935","1570力肯","110/07/12","元大-新盛",9,0,9
"7936","1570力肯","110/07/12","國泰-板橋",0,11,-11
"7937","1570力肯","110/07/12","凱基-台北",8,0,8
"7938","1570力肯","110/07/12","元大-高雄",0,11,-11
"7939","1570力肯","110/07/12","彰銀-七賢",6,0,6
"7940","1570力肯","110/07/12","兆豐-桃園",0,10,-10
"7941","1570力肯","110/07/12","元富-緯城",6,0,6
"7942","1570力肯","110/07/12","元大-大益",0,10,-10
"7943","1570力肯","110/07/12","華南永昌-古亭",6,0,6
"7944","1570力肯","110/07/12","中國信託-文心",0,5,-5
"7945","1570力肯","110/07/12","富邦-陽明",6,0,6
"7946","1570力肯","110/07/12","光和",0,5,-5
"7947","1570力肯","110/07/12","臺銀-臺南",5,0,5
"7948","1570力肯","110/07/12","陽信-石牌",0,5,-5
"7949","1570力肯","110/07/12","宏遠-館前",5,0,5
"7950","1570力肯","110/07/12","國泰-高雄",0,5,-5
"7951","6180橘子","110/07/12","康和-台中",32,2,30
"7952","6180橘子","110/07/12","新百王",1,40,-39
"7953","6180橘子","110/07/12","美林",32,3,29
"7954","6180橘子","110/07/12","富邦-陽明",4,42,-38
"7955","6180橘子","110/07/12","元大-羅東",21,0,21
"7956","6180橘子","110/07/12","新光",3,32,-29
"7957","6180橘子","110/07/12","兆豐-埔墘",16,0,16
"7958","6180橘子","110/07/12","日盛-文化",4,20,-16
"7959","6180橘子","110/07/12","元大-雙和",12,0,12
"7960","6180橘子","110/07/12","華南永昌-鶯歌",0,15,-15
"7961","6180橘子","110/07/12","美商高盛",18,7,11
"7962","6180橘子","110/07/12","中國信託-忠孝",7,20,-13
"7963","6180橘子","110/07/12","台新證券",14,3,11
"7964","6180橘子","110/07/12","凱基-台北",5,17,-12
"7965","6180橘子","110/07/12","元大-中壢",12,1,11
"7966","6180橘子","110/07/12","凱基-高雄",0,11,-11
"7967","6180橘子","110/07/12","統一-南京",10,0,10
"7968","6180橘子","110/07/12","凱基-大安",0,10,-10
"7969","6180橘子","110/07/12","致和-崇德",10,0,10
"7970","6180橘子","110/07/12","元大-北屯",0,10,-10
"7971","6180橘子","110/07/12","玉山-板橋",10,0,10
"7972","6180橘子","110/07/12","元大-南京",0,9,-9
"7973","6180橘子","110/07/12","富邦-仁愛",10,0,10
"7974","6180橘子","110/07/12","元大-台南",1,10,-9
"7975","6180橘子","110/07/12","摩根大通",10,1,9
"7976","6180橘子","110/07/12","康和-澎湖",0,8,-8
"7977","6180橘子","110/07/12","元富-林園",8,0,8
"7978","6180橘子","110/07/12","第一金-台中",0,7,-7
"7979","6180橘子","110/07/12","大慶-富順",7,0,7
"7980","6180橘子","110/07/12","台新-台南",1,8,-7
"7981","2390云辰","110/07/12","統一-新台中",170,0,170
"7982","2390云辰","110/07/12","元大-天母",2,450,-448
"7983","2390云辰","110/07/12","華南永昌-麻豆",137,2,135
"7984","2390云辰","110/07/12","國泰-忠孝",1,143,-142
"7985","2390云辰","110/07/12","元富-成功",103,14,89
"7986","2390云辰","110/07/12","摩根大通",377,512,-135
"7987","2390云辰","110/07/12","元大-土城學府",146,69,77
"7988","2390云辰","110/07/12","台灣摩根士丹利",0,91,-91
"7989","2390云辰","110/07/12","永豐金-永康",76,4,72
"7990","2390云辰","110/07/12","美林",84,146,-62
"7991","2390云辰","110/07/12","台中銀",73,2,71
"7992","2390云辰","110/07/12","華南永昌-嘉義",2,61,-59
"7993","2390云辰","110/07/12","大昌",63,3,60
"7994","2390云辰","110/07/12","永豐金-羅東",0,49,-49
"7995","2390云辰","110/07/12","合庫-三重",50,0,50
"7996","2390云辰","110/07/12","玉山-台中",6,53,-47
"7997","2390云辰","110/07/12","元富-高雄",93,50,43
"7998","2390云辰","110/07/12","玉山-新莊",2,48,-46
"7999","2390云辰","110/07/12","元大-館前",40,4,36
"8000","2390云辰","110/07/12","元大-大里",7,52,-45
"8001","2390云辰","110/07/12","港商野村",143,109,34
"8002","2390云辰","110/07/12","元大-內湖",3,48,-45
"8003","2390云辰","110/07/12","元大-雙和",34,0,34
"8004","2390云辰","110/07/12","永豐金-市政",1,42,-41
"8005","2390云辰","110/07/12","群益金鼎-民權",33,2,31
"8006","2390云辰","110/07/12","元大-學甲",1,41,-40
"8007","2390云辰","110/07/12","日盛-八德",40,10,30
"8008","2390云辰","110/07/12","兆豐-高雄",2,41,-39
"8009","2390云辰","110/07/12","國票-嘉義",30,0,30
"8010","2390云辰","110/07/12","新加坡商瑞銀",21,59,-38
"8011","4903聯光通","110/07/09","元大-敦南",10,0,10
"8012","4903聯光通","110/07/09","第一金-台中",0,12,-12
"8013","4903聯光通","110/07/09","凱基-士林",5,0,5
"8014","4903聯光通","110/07/09","日盛-忠孝",0,3,-3
"8015","4903聯光通","110/07/09","元大-苗栗",5,0,5
"8016","4903聯光通","110/07/09","群益金鼎-崇德",0,3,-3
"8017","4903聯光通","110/07/09","元大-屏南",3,0,3
"8018","4903聯光通","110/07/09","國票-內壢",0,2,-2
"8019","4903聯光通","110/07/09","中國信託-永康",1,0,1
"8020","4903聯光通","110/07/09","康和-南崁",0,2,-2
"8021","4903聯光通","110/07/09","玉山證券",1,0,1
"8022","4903聯光通","110/07/09","新光-台中",0,2,-2
"8023","4903聯光通","110/07/09","元大-太平",4,3,1
"8024","4903聯光通","110/07/09","玉山-城中",0,2,-2
"8025","4903聯光通","110/07/09","永豐金-嘉義",1,0,1
"8026","4903聯光通","110/07/09","中國信託-文心",0,1,-1
"8027","4903聯光通","110/07/09","大昌",0,0,0
"8028","4903聯光通","110/07/09","大昌",0,0,0
"8029","4903聯光通","110/07/09","中農",0,0,0
"8030","4903聯光通","110/07/09","中農",0,0,0
"8031","4903聯光通","110/07/09","",NA,NA,NA
"8032","4903聯光通","110/07/09","",NA,NA,NA
"8033","4903聯光通","110/07/09","",NA,NA,NA
"8034","4903聯光通","110/07/09","",NA,NA,NA
"8035","4903聯光通","110/07/09","",NA,NA,NA
"8036","4903聯光通","110/07/09","",NA,NA,NA
"8037","4903聯光通","110/07/09","",NA,NA,NA
"8038","4903聯光通","110/07/09","",NA,NA,NA
"8039","4903聯光通","110/07/09","",NA,NA,NA
"8040","4903聯光通","110/07/09","",NA,NA,NA
"8041","2929淘帝","110/07/09","台中銀-台北",110,0,110
"8042","2929淘帝","110/07/09","新光",2,82,-80
"8043","2929淘帝","110/07/09","華南永昌-頭份",72,0,72
"8044","2929淘帝","110/07/09","摩根大通",2,63,-61
"8045","2929淘帝","110/07/09","合庫-高雄",71,0,71
"8046","2929淘帝","110/07/09","第一金-路竹",0,50,-50
"8047","2929淘帝","110/07/09","高橋-龍潭",37,0,37
"8048","2929淘帝","110/07/09","港商麥格理",0,42,-42
"8049","2929淘帝","110/07/09","新光-台中",60,26,34
"8050","2929淘帝","110/07/09","陽信-石牌",0,40,-40
"8051","2929淘帝","110/07/09","元富-大裕",22,1,21
"8052","2929淘帝","110/07/09","台新-左楠",1,39,-38
"8053","2929淘帝","110/07/09","合庫-鳳山",20,0,20
"8054","2929淘帝","110/07/09","凱基-桃園",3,29,-26
"8055","2929淘帝","110/07/09","元大-員林",22,2,20
"8056","2929淘帝","110/07/09","兆豐-內湖",0,25,-25
"8057","2929淘帝","110/07/09","台新-建北",15,0,15
"8058","2929淘帝","110/07/09","元大-北港",0,20,-20
"8059","2929淘帝","110/07/09","兆豐-桃園",13,0,13
"8060","2929淘帝","110/07/09","富邦-北港",0,19,-19
"8061","2929淘帝","110/07/09","兆豐-忠孝",10,0,10
"8062","2929淘帝","110/07/09","富邦-花蓮",0,17,-17
"8063","2929淘帝","110/07/09","國票-敦北法人",10,0,10
"8064","2929淘帝","110/07/09","國泰-台中",2,17,-15
"8065","2929淘帝","110/07/09","永豐金-博愛",10,0,10
"8066","2929淘帝","110/07/09","群益金鼎-彰化",0,15,-15
"8067","2929淘帝","110/07/09","群益金鼎-潭子",8,0,8
"8068","2929淘帝","110/07/09","元大-博愛",0,14,-14
"8069","2929淘帝","110/07/09","富邦-南屯",8,0,8
"8070","2929淘帝","110/07/09","日盛-板橋",0,13,-13
"8071","5410國眾","110/07/09","元大-新盛",14,0,14
"8072","5410國眾","110/07/09","(牛牛牛)亞-鑫豐",1,41,-40
"8073","5410國眾","110/07/09","台灣企銀-民雄",10,0,10
"8074","5410國眾","110/07/09","元富-嘉義",0,25,-25
"8075","5410國眾","110/07/09","元富-虎尾",9,0,9
"8076","5410國眾","110/07/09","凱基-高美館",0,10,-10
"8077","5410國眾","110/07/09","摩根大通",10,1,9
"8078","5410國眾","110/07/09","凱基-城中",0,10,-10
"8079","5410國眾","110/07/09","兆豐-北高雄",7,0,7
"8080","5410國眾","110/07/09","元大-頭份",0,10,-10
"8081","5410國眾","110/07/09","凱基-台北",8,1,7
"8082","5410國眾","110/07/09","群益金鼎-丹鳳",0,7,-7
"8083","5410國眾","110/07/09","華南永昌-公誠",7,0,7
"8084","5410國眾","110/07/09","凱基-復興",0,7,-7
"8085","5410國眾","110/07/09","香港上海匯豐",6,0,6
"8086","5410國眾","110/07/09","元大-員林",0,7,-7
"8087","5410國眾","110/07/09","凱基-中壢",6,0,6
"8088","5410國眾","110/07/09","富邦-竹東",0,6,-6
"8089","5410國眾","110/07/09","華南永昌-南京",6,0,6
"8090","5410國眾","110/07/09","亞東-高雄",0,5,-5
"8091","5410國眾","110/07/09","統一-三重",5,0,5
"8092","5410國眾","110/07/09","大慶-中壢",1,6,-5
"8093","5410國眾","110/07/09","富邦-宜蘭",5,0,5
"8094","5410國眾","110/07/09","群益金鼎-中港",0,5,-5
"8095","5410國眾","110/07/09","元大-崇德",5,0,5
"8096","5410國眾","110/07/09","元大-八德",0,5,-5
"8097","5410國眾","110/07/09","元大-博愛",5,0,5
"8098","5410國眾","110/07/09","富邦-基隆",0,4,-4
"8099","5410國眾","110/07/09","元大-龍潭",5,0,5
"8100","5410國眾","110/07/09","臺銀-新竹",0,3,-3
"8101","2841台開","110/07/09","日盛-雙和",102,0,102
"8102","2841台開","110/07/09","港商野村",0,129,-129
"8103","2841台開","110/07/09","元大-館前",70,0,70
"8104","2841台開","110/07/09","兆豐-永和",0,100,-100
"8105","2841台開","110/07/09","凱基-文心",50,0,50
"8106","2841台開","110/07/09","台新證券",7,28,-21
"8107","2841台開","110/07/09","富邦-嘉義",40,0,40
"8108","2841台開","110/07/09","國票-北高雄",0,20,-20
"8109","2841台開","110/07/09","美商高盛",15,0,15
"8110","2841台開","110/07/09","永豐金-敦南",29,46,-17
"8111","2841台開","110/07/09","台中銀",15,0,15
"8112","2841台開","110/07/09","合庫-基隆",0,12,-12
"8113","2841台開","110/07/09","新光",11,0,11
"8114","2841台開","110/07/09","中國信託-松江",0,12,-12
"8115","2841台開","110/07/09","華南永昌-長虹",10,0,10
"8116","2841台開","110/07/09","兆豐-城中",0,12,-12
"8117","2841台開","110/07/09","永豐金-南投",10,0,10
"8118","2841台開","110/07/09","台中銀-豐原",0,10,-10
"8119","2841台開","110/07/09","合庫-桃園",7,0,7
"8120","2841台開","110/07/09","兆豐-景美",0,10,-10
"8121","2841台開","110/07/09","群益金鼎-古亭",7,0,7
"8122","2841台開","110/07/09","群益金鼎-基隆",0,10,-10
"8123","2841台開","110/07/09","國泰-敦南",6,0,6
"8124","2841台開","110/07/09","元大-北三重",0,10,-10
"8125","2841台開","110/07/09","凱基-桃園",8,2,6
"8126","2841台開","110/07/09","(牛牛牛)亞-網路",0,9,-9
"8127","2841台開","110/07/09","日盛證券",5,0,5
"8128","2841台開","110/07/09","台新-高雄",1,10,-9
"8129","2841台開","110/07/09","元富-文心",5,0,5
"8130","2841台開","110/07/09","凱基-台北",0,7,-7
"8131","6207雷科","110/07/09","群益金鼎-新竹",47,0,47
"8132","6207雷科","110/07/09","新光",7,24,-17
"8133","6207雷科","110/07/09","永豐金-三重",31,0,31
"8134","6207雷科","110/07/09","日盛-和美",0,15,-15
"8135","6207雷科","110/07/09","新加坡商瑞銀",33,5,28
"8136","6207雷科","110/07/09","國泰-台南",0,15,-15
"8137","6207雷科","110/07/09","元大-高雄",26,0,26
"8138","6207雷科","110/07/09","華南永昌-古亭",0,14,-14
"8139","6207雷科","110/07/09","統一-員林",22,0,22
"8140","6207雷科","110/07/09","土銀-白河",0,11,-11
"8141","6207雷科","110/07/09","台新-高雄",22,0,22
"8142","6207雷科","110/07/09","日盛-台南",0,10,-10
"8143","6207雷科","110/07/09","摩根大通",34,17,17
"8144","6207雷科","110/07/09","元富-林園",0,10,-10
"8145","6207雷科","110/07/09","元大-博愛",17,1,16
"8146","6207雷科","110/07/09","富邦-園區",0,10,-10
"8147","6207雷科","110/07/09","日茂-埔里",12,0,12
"8148","6207雷科","110/07/09","元大-上新莊",0,10,-10
"8149","6207雷科","110/07/09","國泰-台中",17,6,11
"8150","6207雷科","110/07/09","永豐金-南京",0,10,-10
"8151","6207雷科","110/07/09","富邦-三重",10,0,10
"8152","6207雷科","110/07/09","兆豐-小港",0,6,-6
"8153","6207雷科","110/07/09","元大-沙鹿",10,0,10
"8154","6207雷科","110/07/09","富邦-羅東",1,7,-6
"8155","6207雷科","110/07/09","元大-八德",10,0,10
"8156","6207雷科","110/07/09","元大-土城永寧",0,6,-6
"8157","6207雷科","110/07/09","第一金-路竹",11,2,9
"8158","6207雷科","110/07/09","永豐金-板盛",0,6,-6
"8159","6207雷科","110/07/09","統一-南京",5,0,5
"8160","6207雷科","110/07/09","日盛-板橋",0,5,-5
"8161","3679新至陞","110/07/09","元大-大天母",10,0,10
"8162","3679新至陞","110/07/09","第一金-光復",0,11,-11
"8163","3679新至陞","110/07/09","日盛-樹林",9,0,9
"8164","3679新至陞","110/07/09","瑞士信貸",0,8,-8
"8165","3679新至陞","110/07/09","凱基-台北",11,2,9
"8166","3679新至陞","110/07/09","大慶-苗栗",0,5,-5
"8167","3679新至陞","110/07/09","華南永昌-小港",8,0,8
"8168","3679新至陞","110/07/09","元大-永春",0,5,-5
"8169","3679新至陞","110/07/09","兆豐-來福",7,0,7
"8170","3679新至陞","110/07/09","日盛-和美",0,4,-4
"8171","3679新至陞","110/07/09","香港上海匯豐",5,0,5
"8172","3679新至陞","110/07/09","元大-雙和",0,3,-3
"8173","3679新至陞","110/07/09","台中銀-員林",3,0,3
"8174","3679新至陞","110/07/09","永豐金-屏東",0,3,-3
"8175","3679新至陞","110/07/09","新光",3,0,3
"8176","3679新至陞","110/07/09","彰銀",0,2,-2
"8177","3679新至陞","110/07/09","土銀-花蓮",2,0,2
"8178","3679新至陞","110/07/09","宏遠-館前",0,2,-2
"8179","3679新至陞","110/07/09","第一金-澎湖",2,0,2
"8180","3679新至陞","110/07/09","港商野村",0,2,-2
"8181","3679新至陞","110/07/09","摩根大通",2,0,2
"8182","3679新至陞","110/07/09","大昌-新店",0,2,-2
"8183","3679新至陞","110/07/09","國泰-敦南",2,0,2
"8184","3679新至陞","110/07/09","元大-新莊",0,2,-2
"8185","3679新至陞","110/07/09","元大-淡水",4,2,2
"8186","3679新至陞","110/07/09","元大-板橋",0,2,-2
"8187","3679新至陞","110/07/09","日盛-士林",1,0,1
"8188","3679新至陞","110/07/09","台灣摩根士丹利",0,1,-1
"8189","3679新至陞","110/07/09","日盛-信義",1,0,1
"8190","3679新至陞","110/07/09","第一金-高雄",0,1,-1
"8191","2727王品","110/07/09","台灣匯立證券",90,0,90
"8192","2727王品","110/07/09","台灣摩根士丹利",0,267,-267
"8193","2727王品","110/07/09","國泰-敦南",166,84,82
"8194","2727王品","110/07/09","富邦-台北",35,299,-264
"8195","2727王品","110/07/09","富邦-仁愛",56,12,44
"8196","2727王品","110/07/09","凱基-台北",174,296,-122
"8197","2727王品","110/07/09","台新證券",109,66,43
"8198","2727王品","110/07/09","第一金",2,102,-100
"8199","2727王品","110/07/09","新光",117,87,30
"8200","2727王品","110/07/09","群益金鼎-大安",0,80,-80
"8201","2727王品","110/07/09","臺銀-臺中",35,6,29
"8202","2727王品","110/07/09","兆豐-大安",7,60,-53
"8203","2727王品","110/07/09","元大-桃園",32,3,29
"8204","2727王品","110/07/09","永豐金-南投",0,50,-50
"8205","2727王品","110/07/09","元富-宜蘭",34,6,28
"8206","2727王品","110/07/09","新加坡商瑞銀",6,46,-40
"8207","2727王品","110/07/09","玉山-台中",34,8,26
"8208","2727王品","110/07/09","合庫-彰化",11,50,-39
"8209","2727王品","110/07/09","群益金鼎-宜蘭",30,4,26
"8210","2727王品","110/07/09","永豐金-萬盛",13,52,-39
"8211","2727王品","110/07/09","富邦-台中",42,16,26
"8212","2727王品","110/07/09","瑞士信貸",0,34,-34
"8213","2727王品","110/07/09","第一金-豐原",25,1,24
"8214","2727王品","110/07/09","元大-和平",4,35,-31
"8215","2727王品","110/07/09","臺銀",30,8,22
"8216","2727王品","110/07/09","美林",14,44,-30
"8217","2727王品","110/07/09","兆豐-來福",23,1,22
"8218","2727王品","110/07/09","元大-員林",9,38,-29
"8219","2727王品","110/07/09","玉山-士林",22,2,20
"8220","2727王品","110/07/09","元富-西松",4,31,-27
"8221","1570力肯","110/07/09","凱基-台北",30,1,29
"8222","1570力肯","110/07/09","群益金鼎-彰化",0,20,-20
"8223","1570力肯","110/07/09","新光-台南",20,0,20
"8224","1570力肯","110/07/09","元大-土城學府",0,20,-20
"8225","1570力肯","110/07/09","元大-高雄",20,0,20
"8226","1570力肯","110/07/09","元大-大統",0,16,-16
"8227","1570力肯","110/07/09","國票-中正",12,0,12
"8228","1570力肯","110/07/09","元大-新營",0,11,-11
"8229","1570力肯","110/07/09","日盛-高雄",6,0,6
"8230","1570力肯","110/07/09","元大-和平",0,10,-10
"8231","1570力肯","110/07/09","元富-緯城",6,0,6
"8232","1570力肯","110/07/09","元大-草屯",0,10,-10
"8233","1570力肯","110/07/09","群益金鼎-台南",6,0,6
"8234","1570力肯","110/07/09","元大-鹿港",0,9,-9
"8235","1570力肯","110/07/09","華南永昌-岡山",6,0,6
"8236","1570力肯","110/07/09","合庫-基隆",0,7,-7
"8237","1570力肯","110/07/09","統一-中壢",5,0,5
"8238","1570力肯","110/07/09","摩根大通",2,8,-6
"8239","1570力肯","110/07/09","凱基-三峽",5,0,5
"8240","1570力肯","110/07/09","台灣企銀-豐原",0,4,-4
"8241","1570力肯","110/07/09","大昌-樹林",4,0,4
"8242","1570力肯","110/07/09","日盛-桃園",0,4,-4
"8243","1570力肯","110/07/09","新光",3,0,3
"8244","1570力肯","110/07/09","國泰-高雄",0,3,-3
"8245","1570力肯","110/07/09","富邦-新竹華信",3,0,3
"8246","1570力肯","110/07/09","永豐金-敦南",0,3,-3
"8247","1570力肯","110/07/09","合庫-台中",2,0,2
"8248","1570力肯","110/07/09","土銀-彰化",0,2,-2
"8249","1570力肯","110/07/09","臺銀-臺中",2,0,2
"8250","1570力肯","110/07/09","臺銀-鳳山",0,2,-2
"8251","6180橘子","110/07/09","摩根大通",63,1,62
"8252","6180橘子","110/07/09","元大-南京",1,32,-31
"8253","6180橘子","110/07/09","富邦-陽明",73,33,40
"8254","6180橘子","110/07/09","群益金鼎-台北",0,25,-25
"8255","6180橘子","110/07/09","新加坡商瑞銀",31,0,31
"8256","6180橘子","110/07/09","兆豐-復興",0,21,-21
"8257","6180橘子","110/07/09","美商高盛",25,0,25
"8258","6180橘子","110/07/09","永豐金-嘉義",0,21,-21
"8259","6180橘子","110/07/09","凱基-台北",26,10,16
"8260","6180橘子","110/07/09","凱基-中壢",8,24,-16
"8261","6180橘子","110/07/09","華南永昌-楠梓",13,0,13
"8262","6180橘子","110/07/09","致和-崇德",0,15,-15
"8263","6180橘子","110/07/09","華南永昌-朴子",11,0,11
"8264","6180橘子","110/07/09","群益金鼎-屏東",0,15,-15
"8265","6180橘子","110/07/09","元大-北港",11,0,11
"8266","6180橘子","110/07/09","群益金鼎-中山",0,15,-15
"8267","6180橘子","110/07/09","元大-成功",10,1,9
"8268","6180橘子","110/07/09","瑞士信貸",1,15,-14
"8269","6180橘子","110/07/09","新光",26,18,8
"8270","6180橘子","110/07/09","日盛-二林",0,10,-10
"8271","6180橘子","110/07/09","統一-三重",6,0,6
"8272","6180橘子","110/07/09","凱基-東門",0,10,-10
"8273","6180橘子","110/07/09","群益金鼎-嘉義",6,0,6
"8274","6180橘子","110/07/09","華南永昌-三重",0,10,-10
"8275","6180橘子","110/07/09","元大-員林中山",6,0,6
"8276","6180橘子","110/07/09","元大-彰化民生",1,11,-10
"8277","6180橘子","110/07/09","合庫-鳳山",5,0,5
"8278","6180橘子","110/07/09","永豐金-新店",1,11,-10
"8279","6180橘子","110/07/09","富邦-建國",6,1,5
"8280","6180橘子","110/07/09","群益金鼎-丹鳳",0,8,-8
"8281","2390云辰","110/07/09","摩根大通",279,56,223
"8282","2390云辰","110/07/09","元大-天母",0,127,-127
"8283","2390云辰","110/07/09","日盛-鳳山",110,2,108
"8284","2390云辰","110/07/09","中國信託-文心",5,109,-104
"8285","2390云辰","110/07/09","宏遠證券",100,0,100
"8286","2390云辰","110/07/09","永豐金-復興",0,55,-55
"8287","2390云辰","110/07/09","元大-大里",63,6,57
"8288","2390云辰","110/07/09","凱基-台北",239,286,-47
"8289","2390云辰","110/07/09","凱基-八德",59,10,49
"8290","2390云辰","110/07/09","德信",2,32,-30
"8291","2390云辰","110/07/09","合庫-新竹",40,0,40
"8292","2390云辰","110/07/09","兆豐-桃鶯",2,32,-30
"8293","2390云辰","110/07/09","國票",40,1,39
"8294","2390云辰","110/07/09","致和-南京",0,30,-30
"8295","2390云辰","110/07/09","新加坡商瑞銀",49,13,36
"8296","2390云辰","110/07/09","富邦-虎尾",1,31,-30
"8297","2390云辰","110/07/09","統一-新台中",36,2,34
"8298","2390云辰","110/07/09","元大-善化",2,31,-29
"8299","2390云辰","110/07/09","國票-嘉義",31,0,31
"8300","2390云辰","110/07/09","富邦-板橋",0,27,-27
"8301","2390云辰","110/07/09","華南永昌",35,7,28
"8302","2390云辰","110/07/09","富邦-永和",3,28,-25
"8303","2390云辰","110/07/09","玉山-台中",49,22,27
"8304","2390云辰","110/07/09","第一金-自由",20,44,-24
"8305","2390云辰","110/07/09","華南永昌-敦南",25,0,25
"8306","2390云辰","110/07/09","凱基-內湖",0,24,-24
"8307","2390云辰","110/07/09","新光-高雄",27,4,23
"8308","2390云辰","110/07/09","元大-汐止",1,24,-23
"8309","2390云辰","110/07/09","台灣摩根士丹利",85,63,22
"8310","2390云辰","110/07/09","新光-台中",12,33,-21
"8311","4903聯光通","110/07/09","元大-敦南",10,0,10
"8312","4903聯光通","110/07/09","第一金-台中",0,12,-12
"8313","4903聯光通","110/07/09","凱基-士林",5,0,5
"8314","4903聯光通","110/07/09","日盛-忠孝",0,3,-3
"8315","4903聯光通","110/07/09","元大-苗栗",5,0,5
"8316","4903聯光通","110/07/09","群益金鼎-崇德",0,3,-3
"8317","4903聯光通","110/07/09","元大-屏南",3,0,3
"8318","4903聯光通","110/07/09","國票-內壢",0,2,-2
"8319","4903聯光通","110/07/09","中國信託-永康",1,0,1
"8320","4903聯光通","110/07/09","康和-南崁",0,2,-2
"8321","4903聯光通","110/07/09","玉山證券",1,0,1
"8322","4903聯光通","110/07/09","新光-台中",0,2,-2
"8323","4903聯光通","110/07/09","元大-太平",4,3,1
"8324","4903聯光通","110/07/09","玉山-城中",0,2,-2
"8325","4903聯光通","110/07/09","永豐金-嘉義",1,0,1
"8326","4903聯光通","110/07/09","中國信託-文心",0,1,-1
"8327","4903聯光通","110/07/09","大昌",0,0,0
"8328","4903聯光通","110/07/09","大昌",0,0,0
"8329","4903聯光通","110/07/09","中農",0,0,0
"8330","4903聯光通","110/07/09","中農",0,0,0
"8331","4903聯光通","110/07/09","",NA,NA,NA
"8332","4903聯光通","110/07/09","",NA,NA,NA
"8333","4903聯光通","110/07/09","",NA,NA,NA
"8334","4903聯光通","110/07/09","",NA,NA,NA
"8335","4903聯光通","110/07/09","",NA,NA,NA
"8336","4903聯光通","110/07/09","",NA,NA,NA
"8337","4903聯光通","110/07/09","",NA,NA,NA
"8338","4903聯光通","110/07/09","",NA,NA,NA
"8339","4903聯光通","110/07/09","",NA,NA,NA
"8340","4903聯光通","110/07/09","",NA,NA,NA
"8341","2929淘帝","110/07/09","台中銀-台北",110,0,110
"8342","2929淘帝","110/07/09","新光",2,82,-80
"8343","2929淘帝","110/07/09","華南永昌-頭份",72,0,72
"8344","2929淘帝","110/07/09","摩根大通",2,63,-61
"8345","2929淘帝","110/07/09","合庫-高雄",71,0,71
"8346","2929淘帝","110/07/09","第一金-路竹",0,50,-50
"8347","2929淘帝","110/07/09","高橋-龍潭",37,0,37
"8348","2929淘帝","110/07/09","港商麥格理",0,42,-42
"8349","2929淘帝","110/07/09","新光-台中",60,26,34
"8350","2929淘帝","110/07/09","陽信-石牌",0,40,-40
"8351","2929淘帝","110/07/09","元富-大裕",22,1,21
"8352","2929淘帝","110/07/09","台新-左楠",1,39,-38
"8353","2929淘帝","110/07/09","合庫-鳳山",20,0,20
"8354","2929淘帝","110/07/09","凱基-桃園",3,29,-26
"8355","2929淘帝","110/07/09","元大-員林",22,2,20
"8356","2929淘帝","110/07/09","兆豐-內湖",0,25,-25
"8357","2929淘帝","110/07/09","台新-建北",15,0,15
"8358","2929淘帝","110/07/09","元大-北港",0,20,-20
"8359","2929淘帝","110/07/09","兆豐-桃園",13,0,13
"8360","2929淘帝","110/07/09","富邦-北港",0,19,-19
"8361","2929淘帝","110/07/09","兆豐-忠孝",10,0,10
"8362","2929淘帝","110/07/09","富邦-花蓮",0,17,-17
"8363","2929淘帝","110/07/09","國票-敦北法人",10,0,10
"8364","2929淘帝","110/07/09","國泰-台中",2,17,-15
"8365","2929淘帝","110/07/09","永豐金-博愛",10,0,10
"8366","2929淘帝","110/07/09","群益金鼎-彰化",0,15,-15
"8367","2929淘帝","110/07/09","群益金鼎-潭子",8,0,8
"8368","2929淘帝","110/07/09","元大-博愛",0,14,-14
"8369","2929淘帝","110/07/09","富邦-南屯",8,0,8
"8370","2929淘帝","110/07/09","日盛-板橋",0,13,-13
"8371","5410國眾","110/07/09","元大-新盛",14,0,14
"8372","5410國眾","110/07/09","(牛牛牛)亞-鑫豐",1,41,-40
"8373","5410國眾","110/07/09","台灣企銀-民雄",10,0,10
"8374","5410國眾","110/07/09","元富-嘉義",0,25,-25
"8375","5410國眾","110/07/09","元富-虎尾",9,0,9
"8376","5410國眾","110/07/09","凱基-高美館",0,10,-10
"8377","5410國眾","110/07/09","摩根大通",10,1,9
"8378","5410國眾","110/07/09","凱基-城中",0,10,-10
"8379","5410國眾","110/07/09","兆豐-北高雄",7,0,7
"8380","5410國眾","110/07/09","元大-頭份",0,10,-10
"8381","5410國眾","110/07/09","凱基-台北",8,1,7
"8382","5410國眾","110/07/09","群益金鼎-丹鳳",0,7,-7
"8383","5410國眾","110/07/09","華南永昌-公誠",7,0,7
"8384","5410國眾","110/07/09","凱基-復興",0,7,-7
"8385","5410國眾","110/07/09","香港上海匯豐",6,0,6
"8386","5410國眾","110/07/09","元大-員林",0,7,-7
"8387","5410國眾","110/07/09","凱基-中壢",6,0,6
"8388","5410國眾","110/07/09","富邦-竹東",0,6,-6
"8389","5410國眾","110/07/09","華南永昌-南京",6,0,6
"8390","5410國眾","110/07/09","亞東-高雄",0,5,-5
"8391","5410國眾","110/07/09","統一-三重",5,0,5
"8392","5410國眾","110/07/09","大慶-中壢",1,6,-5
"8393","5410國眾","110/07/09","富邦-宜蘭",5,0,5
"8394","5410國眾","110/07/09","群益金鼎-中港",0,5,-5
"8395","5410國眾","110/07/09","元大-崇德",5,0,5
"8396","5410國眾","110/07/09","元大-八德",0,5,-5
"8397","5410國眾","110/07/09","元大-博愛",5,0,5
"8398","5410國眾","110/07/09","富邦-基隆",0,4,-4
"8399","5410國眾","110/07/09","元大-龍潭",5,0,5
"8400","5410國眾","110/07/09","臺銀-新竹",0,3,-3
"8401","2841台開","110/07/09","日盛-雙和",102,0,102
"8402","2841台開","110/07/09","港商野村",0,129,-129
"8403","2841台開","110/07/09","元大-館前",70,0,70
"8404","2841台開","110/07/09","兆豐-永和",0,100,-100
"8405","2841台開","110/07/09","凱基-文心",50,0,50
"8406","2841台開","110/07/09","台新證券",7,28,-21
"8407","2841台開","110/07/09","富邦-嘉義",40,0,40
"8408","2841台開","110/07/09","國票-北高雄",0,20,-20
"8409","2841台開","110/07/09","美商高盛",15,0,15
"8410","2841台開","110/07/09","永豐金-敦南",29,46,-17
"8411","2841台開","110/07/09","台中銀",15,0,15
"8412","2841台開","110/07/09","合庫-基隆",0,12,-12
"8413","2841台開","110/07/09","新光",11,0,11
"8414","2841台開","110/07/09","中國信託-松江",0,12,-12
"8415","2841台開","110/07/09","華南永昌-長虹",10,0,10
"8416","2841台開","110/07/09","兆豐-城中",0,12,-12
"8417","2841台開","110/07/09","永豐金-南投",10,0,10
"8418","2841台開","110/07/09","台中銀-豐原",0,10,-10
"8419","2841台開","110/07/09","合庫-桃園",7,0,7
"8420","2841台開","110/07/09","兆豐-景美",0,10,-10
"8421","2841台開","110/07/09","群益金鼎-古亭",7,0,7
"8422","2841台開","110/07/09","群益金鼎-基隆",0,10,-10
"8423","2841台開","110/07/09","國泰-敦南",6,0,6
"8424","2841台開","110/07/09","元大-北三重",0,10,-10
"8425","2841台開","110/07/09","凱基-桃園",8,2,6
"8426","2841台開","110/07/09","(牛牛牛)亞-網路",0,9,-9
"8427","2841台開","110/07/09","日盛證券",5,0,5
"8428","2841台開","110/07/09","台新-高雄",1,10,-9
"8429","2841台開","110/07/09","元富-文心",5,0,5
"8430","2841台開","110/07/09","凱基-台北",0,7,-7
"8431","6207雷科","110/07/09","群益金鼎-新竹",47,0,47
"8432","6207雷科","110/07/09","新光",7,24,-17
"8433","6207雷科","110/07/09","永豐金-三重",31,0,31
"8434","6207雷科","110/07/09","日盛-和美",0,15,-15
"8435","6207雷科","110/07/09","新加坡商瑞銀",33,5,28
"8436","6207雷科","110/07/09","國泰-台南",0,15,-15
"8437","6207雷科","110/07/09","元大-高雄",26,0,26
"8438","6207雷科","110/07/09","華南永昌-古亭",0,14,-14
"8439","6207雷科","110/07/09","統一-員林",22,0,22
"8440","6207雷科","110/07/09","土銀-白河",0,11,-11
"8441","6207雷科","110/07/09","台新-高雄",22,0,22
"8442","6207雷科","110/07/09","日盛-台南",0,10,-10
"8443","6207雷科","110/07/09","摩根大通",34,17,17
"8444","6207雷科","110/07/09","元富-林園",0,10,-10
"8445","6207雷科","110/07/09","元大-博愛",17,1,16
"8446","6207雷科","110/07/09","富邦-園區",0,10,-10
"8447","6207雷科","110/07/09","日茂-埔里",12,0,12
"8448","6207雷科","110/07/09","元大-上新莊",0,10,-10
"8449","6207雷科","110/07/09","國泰-台中",17,6,11
"8450","6207雷科","110/07/09","永豐金-南京",0,10,-10
"8451","6207雷科","110/07/09","富邦-三重",10,0,10
"8452","6207雷科","110/07/09","兆豐-小港",0,6,-6
"8453","6207雷科","110/07/09","元大-沙鹿",10,0,10
"8454","6207雷科","110/07/09","富邦-羅東",1,7,-6
"8455","6207雷科","110/07/09","元大-八德",10,0,10
"8456","6207雷科","110/07/09","元大-土城永寧",0,6,-6
"8457","6207雷科","110/07/09","第一金-路竹",11,2,9
"8458","6207雷科","110/07/09","永豐金-板盛",0,6,-6
"8459","6207雷科","110/07/09","統一-南京",5,0,5
"8460","6207雷科","110/07/09","日盛-板橋",0,5,-5
"8461","3679新至陞","110/07/09","元大-大天母",10,0,10
"8462","3679新至陞","110/07/09","第一金-光復",0,11,-11
"8463","3679新至陞","110/07/09","日盛-樹林",9,0,9
"8464","3679新至陞","110/07/09","瑞士信貸",0,8,-8
"8465","3679新至陞","110/07/09","凱基-台北",11,2,9
"8466","3679新至陞","110/07/09","大慶-苗栗",0,5,-5
"8467","3679新至陞","110/07/09","華南永昌-小港",8,0,8
"8468","3679新至陞","110/07/09","元大-永春",0,5,-5
"8469","3679新至陞","110/07/09","兆豐-來福",7,0,7
"8470","3679新至陞","110/07/09","日盛-和美",0,4,-4
"8471","3679新至陞","110/07/09","香港上海匯豐",5,0,5
"8472","3679新至陞","110/07/09","元大-雙和",0,3,-3
"8473","3679新至陞","110/07/09","台中銀-員林",3,0,3
"8474","3679新至陞","110/07/09","永豐金-屏東",0,3,-3
"8475","3679新至陞","110/07/09","新光",3,0,3
"8476","3679新至陞","110/07/09","彰銀",0,2,-2
"8477","3679新至陞","110/07/09","土銀-花蓮",2,0,2
"8478","3679新至陞","110/07/09","宏遠-館前",0,2,-2
"8479","3679新至陞","110/07/09","第一金-澎湖",2,0,2
"8480","3679新至陞","110/07/09","港商野村",0,2,-2
"8481","3679新至陞","110/07/09","摩根大通",2,0,2
"8482","3679新至陞","110/07/09","大昌-新店",0,2,-2
"8483","3679新至陞","110/07/09","國泰-敦南",2,0,2
"8484","3679新至陞","110/07/09","元大-新莊",0,2,-2
"8485","3679新至陞","110/07/09","元大-淡水",4,2,2
"8486","3679新至陞","110/07/09","元大-板橋",0,2,-2
"8487","3679新至陞","110/07/09","日盛-士林",1,0,1
"8488","3679新至陞","110/07/09","台灣摩根士丹利",0,1,-1
"8489","3679新至陞","110/07/09","日盛-信義",1,0,1
"8490","3679新至陞","110/07/09","第一金-高雄",0,1,-1
"8491","2727王品","110/07/09","台灣匯立證券",90,0,90
"8492","2727王品","110/07/09","台灣摩根士丹利",0,267,-267
"8493","2727王品","110/07/09","國泰-敦南",166,84,82
"8494","2727王品","110/07/09","富邦-台北",35,299,-264
"8495","2727王品","110/07/09","富邦-仁愛",56,12,44
"8496","2727王品","110/07/09","凱基-台北",174,296,-122
"8497","2727王品","110/07/09","台新證券",109,66,43
"8498","2727王品","110/07/09","第一金",2,102,-100
"8499","2727王品","110/07/09","新光",117,87,30
"8500","2727王品","110/07/09","群益金鼎-大安",0,80,-80
"8501","2727王品","110/07/09","臺銀-臺中",35,6,29
"8502","2727王品","110/07/09","兆豐-大安",7,60,-53
"8503","2727王品","110/07/09","元大-桃園",32,3,29
"8504","2727王品","110/07/09","永豐金-南投",0,50,-50
"8505","2727王品","110/07/09","元富-宜蘭",34,6,28
"8506","2727王品","110/07/09","新加坡商瑞銀",6,46,-40
"8507","2727王品","110/07/09","玉山-台中",34,8,26
"8508","2727王品","110/07/09","合庫-彰化",11,50,-39
"8509","2727王品","110/07/09","群益金鼎-宜蘭",30,4,26
"8510","2727王品","110/07/09","永豐金-萬盛",13,52,-39
"8511","2727王品","110/07/09","富邦-台中",42,16,26
"8512","2727王品","110/07/09","瑞士信貸",0,34,-34
"8513","2727王品","110/07/09","第一金-豐原",25,1,24
"8514","2727王品","110/07/09","元大-和平",4,35,-31
"8515","2727王品","110/07/09","臺銀",30,8,22
"8516","2727王品","110/07/09","美林",14,44,-30
"8517","2727王品","110/07/09","兆豐-來福",23,1,22
"8518","2727王品","110/07/09","元大-員林",9,38,-29
"8519","2727王品","110/07/09","玉山-士林",22,2,20
"8520","2727王品","110/07/09","元富-西松",4,31,-27
"8521","1570力肯","110/07/09","凱基-台北",30,1,29
"8522","1570力肯","110/07/09","群益金鼎-彰化",0,20,-20
"8523","1570力肯","110/07/09","新光-台南",20,0,20
"8524","1570力肯","110/07/09","元大-土城學府",0,20,-20
"8525","1570力肯","110/07/09","元大-高雄",20,0,20
"8526","1570力肯","110/07/09","元大-大統",0,16,-16
"8527","1570力肯","110/07/09","國票-中正",12,0,12
"8528","1570力肯","110/07/09","元大-新營",0,11,-11
"8529","1570力肯","110/07/09","日盛-高雄",6,0,6
"8530","1570力肯","110/07/09","元大-和平",0,10,-10
"8531","1570力肯","110/07/09","元富-緯城",6,0,6
"8532","1570力肯","110/07/09","元大-草屯",0,10,-10
"8533","1570力肯","110/07/09","群益金鼎-台南",6,0,6
"8534","1570力肯","110/07/09","元大-鹿港",0,9,-9
"8535","1570力肯","110/07/09","華南永昌-岡山",6,0,6
"8536","1570力肯","110/07/09","合庫-基隆",0,7,-7
"8537","1570力肯","110/07/09","統一-中壢",5,0,5
"8538","1570力肯","110/07/09","摩根大通",2,8,-6
"8539","1570力肯","110/07/09","凱基-三峽",5,0,5
"8540","1570力肯","110/07/09","台灣企銀-豐原",0,4,-4
"8541","1570力肯","110/07/09","大昌-樹林",4,0,4
"8542","1570力肯","110/07/09","日盛-桃園",0,4,-4
"8543","1570力肯","110/07/09","新光",3,0,3
"8544","1570力肯","110/07/09","國泰-高雄",0,3,-3
"8545","1570力肯","110/07/09","富邦-新竹華信",3,0,3
"8546","1570力肯","110/07/09","永豐金-敦南",0,3,-3
"8547","1570力肯","110/07/09","合庫-台中",2,0,2
"8548","1570力肯","110/07/09","土銀-彰化",0,2,-2
"8549","1570力肯","110/07/09","臺銀-臺中",2,0,2
"8550","1570力肯","110/07/09","臺銀-鳳山",0,2,-2
"8551","6180橘子","110/07/09","摩根大通",63,1,62
"8552","6180橘子","110/07/09","元大-南京",1,32,-31
"8553","6180橘子","110/07/09","富邦-陽明",73,33,40
"8554","6180橘子","110/07/09","群益金鼎-台北",0,25,-25
"8555","6180橘子","110/07/09","新加坡商瑞銀",31,0,31
"8556","6180橘子","110/07/09","兆豐-復興",0,21,-21
"8557","6180橘子","110/07/09","美商高盛",25,0,25
"8558","6180橘子","110/07/09","永豐金-嘉義",0,21,-21
"8559","6180橘子","110/07/09","凱基-台北",26,10,16
"8560","6180橘子","110/07/09","凱基-中壢",8,24,-16
"8561","6180橘子","110/07/09","華南永昌-楠梓",13,0,13
"8562","6180橘子","110/07/09","致和-崇德",0,15,-15
"8563","6180橘子","110/07/09","華南永昌-朴子",11,0,11
"8564","6180橘子","110/07/09","群益金鼎-屏東",0,15,-15
"8565","6180橘子","110/07/09","元大-北港",11,0,11
"8566","6180橘子","110/07/09","群益金鼎-中山",0,15,-15
"8567","6180橘子","110/07/09","元大-成功",10,1,9
"8568","6180橘子","110/07/09","瑞士信貸",1,15,-14
"8569","6180橘子","110/07/09","新光",26,18,8
"8570","6180橘子","110/07/09","日盛-二林",0,10,-10
"8571","6180橘子","110/07/09","統一-三重",6,0,6
"8572","6180橘子","110/07/09","凱基-東門",0,10,-10
"8573","6180橘子","110/07/09","群益金鼎-嘉義",6,0,6
"8574","6180橘子","110/07/09","華南永昌-三重",0,10,-10
"8575","6180橘子","110/07/09","元大-員林中山",6,0,6
"8576","6180橘子","110/07/09","元大-彰化民生",1,11,-10
"8577","6180橘子","110/07/09","合庫-鳳山",5,0,5
"8578","6180橘子","110/07/09","永豐金-新店",1,11,-10
"8579","6180橘子","110/07/09","富邦-建國",6,1,5
"8580","6180橘子","110/07/09","群益金鼎-丹鳳",0,8,-8
"8581","2390云辰","110/07/09","摩根大通",279,56,223
"8582","2390云辰","110/07/09","元大-天母",0,127,-127
"8583","2390云辰","110/07/09","日盛-鳳山",110,2,108
"8584","2390云辰","110/07/09","中國信託-文心",5,109,-104
"8585","2390云辰","110/07/09","宏遠證券",100,0,100
"8586","2390云辰","110/07/09","永豐金-復興",0,55,-55
"8587","2390云辰","110/07/09","元大-大里",63,6,57
"8588","2390云辰","110/07/09","凱基-台北",239,286,-47
"8589","2390云辰","110/07/09","凱基-八德",59,10,49
"8590","2390云辰","110/07/09","德信",2,32,-30
"8591","2390云辰","110/07/09","合庫-新竹",40,0,40
"8592","2390云辰","110/07/09","兆豐-桃鶯",2,32,-30
"8593","2390云辰","110/07/09","國票",40,1,39
"8594","2390云辰","110/07/09","致和-南京",0,30,-30
"8595","2390云辰","110/07/09","新加坡商瑞銀",49,13,36
"8596","2390云辰","110/07/09","富邦-虎尾",1,31,-30
"8597","2390云辰","110/07/09","統一-新台中",36,2,34
"8598","2390云辰","110/07/09","元大-善化",2,31,-29
"8599","2390云辰","110/07/09","國票-嘉義",31,0,31
"8600","2390云辰","110/07/09","富邦-板橋",0,27,-27
"8601","2390云辰","110/07/09","華南永昌",35,7,28
"8602","2390云辰","110/07/09","富邦-永和",3,28,-25
"8603","2390云辰","110/07/09","玉山-台中",49,22,27
"8604","2390云辰","110/07/09","第一金-自由",20,44,-24
"8605","2390云辰","110/07/09","華南永昌-敦南",25,0,25
"8606","2390云辰","110/07/09","凱基-內湖",0,24,-24
"8607","2390云辰","110/07/09","新光-高雄",27,4,23
"8608","2390云辰","110/07/09","元大-汐止",1,24,-23
"8609","2390云辰","110/07/09","台灣摩根士丹利",85,63,22
"8610","2390云辰","110/07/09","新光-台中",12,33,-21
"8611","4903聯光通","110/07/09","元大-敦南",10,0,10
"8612","4903聯光通","110/07/09","第一金-台中",0,12,-12
"8613","4903聯光通","110/07/09","凱基-士林",5,0,5
"8614","4903聯光通","110/07/09","日盛-忠孝",0,3,-3
"8615","4903聯光通","110/07/09","元大-苗栗",5,0,5
"8616","4903聯光通","110/07/09","群益金鼎-崇德",0,3,-3
"8617","4903聯光通","110/07/09","元大-屏南",3,0,3
"8618","4903聯光通","110/07/09","國票-內壢",0,2,-2
"8619","4903聯光通","110/07/09","中國信託-永康",1,0,1
"8620","4903聯光通","110/07/09","康和-南崁",0,2,-2
"8621","4903聯光通","110/07/09","玉山證券",1,0,1
"8622","4903聯光通","110/07/09","新光-台中",0,2,-2
"8623","4903聯光通","110/07/09","元大-太平",4,3,1
"8624","4903聯光通","110/07/09","玉山-城中",0,2,-2
"8625","4903聯光通","110/07/09","永豐金-嘉義",1,0,1
"8626","4903聯光通","110/07/09","中國信託-文心",0,1,-1
"8627","4903聯光通","110/07/09","大昌",0,0,0
"8628","4903聯光通","110/07/09","大昌",0,0,0
"8629","4903聯光通","110/07/09","中農",0,0,0
"8630","4903聯光通","110/07/09","中農",0,0,0
"8631","4903聯光通","110/07/09","",NA,NA,NA
"8632","4903聯光通","110/07/09","",NA,NA,NA
"8633","4903聯光通","110/07/09","",NA,NA,NA
"8634","4903聯光通","110/07/09","",NA,NA,NA
"8635","4903聯光通","110/07/09","",NA,NA,NA
"8636","4903聯光通","110/07/09","",NA,NA,NA
"8637","4903聯光通","110/07/09","",NA,NA,NA
"8638","4903聯光通","110/07/09","",NA,NA,NA
"8639","4903聯光通","110/07/09","",NA,NA,NA
"8640","4903聯光通","110/07/09","",NA,NA,NA
"8641","2929淘帝","110/07/09","台中銀-台北",110,0,110
"8642","2929淘帝","110/07/09","新光",2,82,-80
"8643","2929淘帝","110/07/09","華南永昌-頭份",72,0,72
"8644","2929淘帝","110/07/09","摩根大通",2,63,-61
"8645","2929淘帝","110/07/09","合庫-高雄",71,0,71
"8646","2929淘帝","110/07/09","第一金-路竹",0,50,-50
"8647","2929淘帝","110/07/09","高橋-龍潭",37,0,37
"8648","2929淘帝","110/07/09","港商麥格理",0,42,-42
"8649","2929淘帝","110/07/09","新光-台中",60,26,34
"8650","2929淘帝","110/07/09","陽信-石牌",0,40,-40
"8651","2929淘帝","110/07/09","元富-大裕",22,1,21
"8652","2929淘帝","110/07/09","台新-左楠",1,39,-38
"8653","2929淘帝","110/07/09","合庫-鳳山",20,0,20
"8654","2929淘帝","110/07/09","凱基-桃園",3,29,-26
"8655","2929淘帝","110/07/09","元大-員林",22,2,20
"8656","2929淘帝","110/07/09","兆豐-內湖",0,25,-25
"8657","2929淘帝","110/07/09","台新-建北",15,0,15
"8658","2929淘帝","110/07/09","元大-北港",0,20,-20
"8659","2929淘帝","110/07/09","兆豐-桃園",13,0,13
"8660","2929淘帝","110/07/09","富邦-北港",0,19,-19
"8661","2929淘帝","110/07/09","兆豐-忠孝",10,0,10
"8662","2929淘帝","110/07/09","富邦-花蓮",0,17,-17
"8663","2929淘帝","110/07/09","國票-敦北法人",10,0,10
"8664","2929淘帝","110/07/09","國泰-台中",2,17,-15
"8665","2929淘帝","110/07/09","永豐金-博愛",10,0,10
"8666","2929淘帝","110/07/09","群益金鼎-彰化",0,15,-15
"8667","2929淘帝","110/07/09","群益金鼎-潭子",8,0,8
"8668","2929淘帝","110/07/09","元大-博愛",0,14,-14
"8669","2929淘帝","110/07/09","富邦-南屯",8,0,8
"8670","2929淘帝","110/07/09","日盛-板橋",0,13,-13
"8671","5410國眾","110/07/09","元大-新盛",14,0,14
"8672","5410國眾","110/07/09","(牛牛牛)亞-鑫豐",1,41,-40
"8673","5410國眾","110/07/09","台灣企銀-民雄",10,0,10
"8674","5410國眾","110/07/09","元富-嘉義",0,25,-25
"8675","5410國眾","110/07/09","元富-虎尾",9,0,9
"8676","5410國眾","110/07/09","凱基-高美館",0,10,-10
"8677","5410國眾","110/07/09","摩根大通",10,1,9
"8678","5410國眾","110/07/09","凱基-城中",0,10,-10
"8679","5410國眾","110/07/09","兆豐-北高雄",7,0,7
"8680","5410國眾","110/07/09","元大-頭份",0,10,-10
"8681","5410國眾","110/07/09","凱基-台北",8,1,7
"8682","5410國眾","110/07/09","群益金鼎-丹鳳",0,7,-7
"8683","5410國眾","110/07/09","華南永昌-公誠",7,0,7
"8684","5410國眾","110/07/09","凱基-復興",0,7,-7
"8685","5410國眾","110/07/09","香港上海匯豐",6,0,6
"8686","5410國眾","110/07/09","元大-員林",0,7,-7
"8687","5410國眾","110/07/09","凱基-中壢",6,0,6
"8688","5410國眾","110/07/09","富邦-竹東",0,6,-6
"8689","5410國眾","110/07/09","華南永昌-南京",6,0,6
"8690","5410國眾","110/07/09","亞東-高雄",0,5,-5
"8691","5410國眾","110/07/09","統一-三重",5,0,5
"8692","5410國眾","110/07/09","大慶-中壢",1,6,-5
"8693","5410國眾","110/07/09","富邦-宜蘭",5,0,5
"8694","5410國眾","110/07/09","群益金鼎-中港",0,5,-5
"8695","5410國眾","110/07/09","元大-崇德",5,0,5
"8696","5410國眾","110/07/09","元大-八德",0,5,-5
"8697","5410國眾","110/07/09","元大-博愛",5,0,5
"8698","5410國眾","110/07/09","富邦-基隆",0,4,-4
"8699","5410國眾","110/07/09","元大-龍潭",5,0,5
"8700","5410國眾","110/07/09","臺銀-新竹",0,3,-3
"8701","2841台開","110/07/09","日盛-雙和",102,0,102
"8702","2841台開","110/07/09","港商野村",0,129,-129
"8703","2841台開","110/07/09","元大-館前",70,0,70
"8704","2841台開","110/07/09","兆豐-永和",0,100,-100
"8705","2841台開","110/07/09","凱基-文心",50,0,50
"8706","2841台開","110/07/09","台新證券",7,28,-21
"8707","2841台開","110/07/09","富邦-嘉義",40,0,40
"8708","2841台開","110/07/09","國票-北高雄",0,20,-20
"8709","2841台開","110/07/09","美商高盛",15,0,15
"8710","2841台開","110/07/09","永豐金-敦南",29,46,-17
"8711","2841台開","110/07/09","台中銀",15,0,15
"8712","2841台開","110/07/09","合庫-基隆",0,12,-12
"8713","2841台開","110/07/09","新光",11,0,11
"8714","2841台開","110/07/09","中國信託-松江",0,12,-12
"8715","2841台開","110/07/09","華南永昌-長虹",10,0,10
"8716","2841台開","110/07/09","兆豐-城中",0,12,-12
"8717","2841台開","110/07/09","永豐金-南投",10,0,10
"8718","2841台開","110/07/09","台中銀-豐原",0,10,-10
"8719","2841台開","110/07/09","合庫-桃園",7,0,7
"8720","2841台開","110/07/09","兆豐-景美",0,10,-10
"8721","2841台開","110/07/09","群益金鼎-古亭",7,0,7
"8722","2841台開","110/07/09","群益金鼎-基隆",0,10,-10
"8723","2841台開","110/07/09","國泰-敦南",6,0,6
"8724","2841台開","110/07/09","元大-北三重",0,10,-10
"8725","2841台開","110/07/09","凱基-桃園",8,2,6
"8726","2841台開","110/07/09","(牛牛牛)亞-網路",0,9,-9
"8727","2841台開","110/07/09","日盛證券",5,0,5
"8728","2841台開","110/07/09","台新-高雄",1,10,-9
"8729","2841台開","110/07/09","元富-文心",5,0,5
"8730","2841台開","110/07/09","凱基-台北",0,7,-7
"8731","6207雷科","110/07/09","群益金鼎-新竹",47,0,47
"8732","6207雷科","110/07/09","新光",7,24,-17
"8733","6207雷科","110/07/09","永豐金-三重",31,0,31
"8734","6207雷科","110/07/09","日盛-和美",0,15,-15
"8735","6207雷科","110/07/09","新加坡商瑞銀",33,5,28
"8736","6207雷科","110/07/09","國泰-台南",0,15,-15
"8737","6207雷科","110/07/09","元大-高雄",26,0,26
"8738","6207雷科","110/07/09","華南永昌-古亭",0,14,-14
"8739","6207雷科","110/07/09","統一-員林",22,0,22
"8740","6207雷科","110/07/09","土銀-白河",0,11,-11
"8741","6207雷科","110/07/09","台新-高雄",22,0,22
"8742","6207雷科","110/07/09","日盛-台南",0,10,-10
"8743","6207雷科","110/07/09","摩根大通",34,17,17
"8744","6207雷科","110/07/09","元富-林園",0,10,-10
"8745","6207雷科","110/07/09","元大-博愛",17,1,16
"8746","6207雷科","110/07/09","富邦-園區",0,10,-10
"8747","6207雷科","110/07/09","日茂-埔里",12,0,12
"8748","6207雷科","110/07/09","元大-上新莊",0,10,-10
"8749","6207雷科","110/07/09","國泰-台中",17,6,11
"8750","6207雷科","110/07/09","永豐金-南京",0,10,-10
"8751","6207雷科","110/07/09","富邦-三重",10,0,10
"8752","6207雷科","110/07/09","兆豐-小港",0,6,-6
"8753","6207雷科","110/07/09","元大-沙鹿",10,0,10
"8754","6207雷科","110/07/09","富邦-羅東",1,7,-6
"8755","6207雷科","110/07/09","元大-八德",10,0,10
"8756","6207雷科","110/07/09","元大-土城永寧",0,6,-6
"8757","6207雷科","110/07/09","第一金-路竹",11,2,9
"8758","6207雷科","110/07/09","永豐金-板盛",0,6,-6
"8759","6207雷科","110/07/09","統一-南京",5,0,5
"8760","6207雷科","110/07/09","日盛-板橋",0,5,-5
"8761","3679新至陞","110/07/09","元大-大天母",10,0,10
"8762","3679新至陞","110/07/09","第一金-光復",0,11,-11
"8763","3679新至陞","110/07/09","日盛-樹林",9,0,9
"8764","3679新至陞","110/07/09","瑞士信貸",0,8,-8
"8765","3679新至陞","110/07/09","凱基-台北",11,2,9
"8766","3679新至陞","110/07/09","大慶-苗栗",0,5,-5
"8767","3679新至陞","110/07/09","華南永昌-小港",8,0,8
"8768","3679新至陞","110/07/09","元大-永春",0,5,-5
"8769","3679新至陞","110/07/09","兆豐-來福",7,0,7
"8770","3679新至陞","110/07/09","日盛-和美",0,4,-4
"8771","3679新至陞","110/07/09","香港上海匯豐",5,0,5
"8772","3679新至陞","110/07/09","元大-雙和",0,3,-3
"8773","3679新至陞","110/07/09","台中銀-員林",3,0,3
"8774","3679新至陞","110/07/09","永豐金-屏東",0,3,-3
"8775","3679新至陞","110/07/09","新光",3,0,3
"8776","3679新至陞","110/07/09","彰銀",0,2,-2
"8777","3679新至陞","110/07/09","土銀-花蓮",2,0,2
"8778","3679新至陞","110/07/09","宏遠-館前",0,2,-2
"8779","3679新至陞","110/07/09","第一金-澎湖",2,0,2
"8780","3679新至陞","110/07/09","港商野村",0,2,-2
"8781","3679新至陞","110/07/09","摩根大通",2,0,2
"8782","3679新至陞","110/07/09","大昌-新店",0,2,-2
"8783","3679新至陞","110/07/09","國泰-敦南",2,0,2
"8784","3679新至陞","110/07/09","元大-新莊",0,2,-2
"8785","3679新至陞","110/07/09","元大-淡水",4,2,2
"8786","3679新至陞","110/07/09","元大-板橋",0,2,-2
"8787","3679新至陞","110/07/09","日盛-士林",1,0,1
"8788","3679新至陞","110/07/09","台灣摩根士丹利",0,1,-1
"8789","3679新至陞","110/07/09","日盛-信義",1,0,1
"8790","3679新至陞","110/07/09","第一金-高雄",0,1,-1
"8791","2727王品","110/07/09","台灣匯立證券",90,0,90
"8792","2727王品","110/07/09","台灣摩根士丹利",0,267,-267
"8793","2727王品","110/07/09","國泰-敦南",166,84,82
"8794","2727王品","110/07/09","富邦-台北",35,299,-264
"8795","2727王品","110/07/09","富邦-仁愛",56,12,44
"8796","2727王品","110/07/09","凱基-台北",174,296,-122
"8797","2727王品","110/07/09","台新證券",109,66,43
"8798","2727王品","110/07/09","第一金",2,102,-100
"8799","2727王品","110/07/09","新光",117,87,30
"8800","2727王品","110/07/09","群益金鼎-大安",0,80,-80
"8801","2727王品","110/07/09","臺銀-臺中",35,6,29
"8802","2727王品","110/07/09","兆豐-大安",7,60,-53
"8803","2727王品","110/07/09","元大-桃園",32,3,29
"8804","2727王品","110/07/09","永豐金-南投",0,50,-50
"8805","2727王品","110/07/09","元富-宜蘭",34,6,28
"8806","2727王品","110/07/09","新加坡商瑞銀",6,46,-40
"8807","2727王品","110/07/09","玉山-台中",34,8,26
"8808","2727王品","110/07/09","合庫-彰化",11,50,-39
"8809","2727王品","110/07/09","群益金鼎-宜蘭",30,4,26
"8810","2727王品","110/07/09","永豐金-萬盛",13,52,-39
"8811","2727王品","110/07/09","富邦-台中",42,16,26
"8812","2727王品","110/07/09","瑞士信貸",0,34,-34
"8813","2727王品","110/07/09","第一金-豐原",25,1,24
"8814","2727王品","110/07/09","元大-和平",4,35,-31
"8815","2727王品","110/07/09","臺銀",30,8,22
"8816","2727王品","110/07/09","美林",14,44,-30
"8817","2727王品","110/07/09","兆豐-來福",23,1,22
"8818","2727王品","110/07/09","元大-員林",9,38,-29
"8819","2727王品","110/07/09","玉山-士林",22,2,20
"8820","2727王品","110/07/09","元富-西松",4,31,-27
"8821","1570力肯","110/07/09","凱基-台北",30,1,29
"8822","1570力肯","110/07/09","群益金鼎-彰化",0,20,-20
"8823","1570力肯","110/07/09","新光-台南",20,0,20
"8824","1570力肯","110/07/09","元大-土城學府",0,20,-20
"8825","1570力肯","110/07/09","元大-高雄",20,0,20
"8826","1570力肯","110/07/09","元大-大統",0,16,-16
"8827","1570力肯","110/07/09","國票-中正",12,0,12
"8828","1570力肯","110/07/09","元大-新營",0,11,-11
"8829","1570力肯","110/07/09","日盛-高雄",6,0,6
"8830","1570力肯","110/07/09","元大-和平",0,10,-10
"8831","1570力肯","110/07/09","元富-緯城",6,0,6
"8832","1570力肯","110/07/09","元大-草屯",0,10,-10
"8833","1570力肯","110/07/09","群益金鼎-台南",6,0,6
"8834","1570力肯","110/07/09","元大-鹿港",0,9,-9
"8835","1570力肯","110/07/09","華南永昌-岡山",6,0,6
"8836","1570力肯","110/07/09","合庫-基隆",0,7,-7
"8837","1570力肯","110/07/09","統一-中壢",5,0,5
"8838","1570力肯","110/07/09","摩根大通",2,8,-6
"8839","1570力肯","110/07/09","凱基-三峽",5,0,5
"8840","1570力肯","110/07/09","台灣企銀-豐原",0,4,-4
"8841","1570力肯","110/07/09","大昌-樹林",4,0,4
"8842","1570力肯","110/07/09","日盛-桃園",0,4,-4
"8843","1570力肯","110/07/09","新光",3,0,3
"8844","1570力肯","110/07/09","國泰-高雄",0,3,-3
"8845","1570力肯","110/07/09","富邦-新竹華信",3,0,3
"8846","1570力肯","110/07/09","永豐金-敦南",0,3,-3
"8847","1570力肯","110/07/09","合庫-台中",2,0,2
"8848","1570力肯","110/07/09","土銀-彰化",0,2,-2
"8849","1570力肯","110/07/09","臺銀-臺中",2,0,2
"8850","1570力肯","110/07/09","臺銀-鳳山",0,2,-2
"8851","6180橘子","110/07/09","摩根大通",63,1,62
"8852","6180橘子","110/07/09","元大-南京",1,32,-31
"8853","6180橘子","110/07/09","富邦-陽明",73,33,40
"8854","6180橘子","110/07/09","群益金鼎-台北",0,25,-25
"8855","6180橘子","110/07/09","新加坡商瑞銀",31,0,31
"8856","6180橘子","110/07/09","兆豐-復興",0,21,-21
"8857","6180橘子","110/07/09","美商高盛",25,0,25
"8858","6180橘子","110/07/09","永豐金-嘉義",0,21,-21
"8859","6180橘子","110/07/09","凱基-台北",26,10,16
"8860","6180橘子","110/07/09","凱基-中壢",8,24,-16
"8861","6180橘子","110/07/09","華南永昌-楠梓",13,0,13
"8862","6180橘子","110/07/09","致和-崇德",0,15,-15
"8863","6180橘子","110/07/09","華南永昌-朴子",11,0,11
"8864","6180橘子","110/07/09","群益金鼎-屏東",0,15,-15
"8865","6180橘子","110/07/09","元大-北港",11,0,11
"8866","6180橘子","110/07/09","群益金鼎-中山",0,15,-15
"8867","6180橘子","110/07/09","元大-成功",10,1,9
"8868","6180橘子","110/07/09","瑞士信貸",1,15,-14
"8869","6180橘子","110/07/09","新光",26,18,8
"8870","6180橘子","110/07/09","日盛-二林",0,10,-10
"8871","6180橘子","110/07/09","統一-三重",6,0,6
"8872","6180橘子","110/07/09","凱基-東門",0,10,-10
"8873","6180橘子","110/07/09","群益金鼎-嘉義",6,0,6
"8874","6180橘子","110/07/09","華南永昌-三重",0,10,-10
"8875","6180橘子","110/07/09","元大-員林中山",6,0,6
"8876","6180橘子","110/07/09","元大-彰化民生",1,11,-10
"8877","6180橘子","110/07/09","合庫-鳳山",5,0,5
"8878","6180橘子","110/07/09","永豐金-新店",1,11,-10
"8879","6180橘子","110/07/09","富邦-建國",6,1,5
"8880","6180橘子","110/07/09","群益金鼎-丹鳳",0,8,-8
"8881","2390云辰","110/07/09","摩根大通",279,56,223
"8882","2390云辰","110/07/09","元大-天母",0,127,-127
"8883","2390云辰","110/07/09","日盛-鳳山",110,2,108
"8884","2390云辰","110/07/09","中國信託-文心",5,109,-104
"8885","2390云辰","110/07/09","宏遠證券",100,0,100
"8886","2390云辰","110/07/09","永豐金-復興",0,55,-55
"8887","2390云辰","110/07/09","元大-大里",63,6,57
"8888","2390云辰","110/07/09","凱基-台北",239,286,-47
"8889","2390云辰","110/07/09","凱基-八德",59,10,49
"8890","2390云辰","110/07/09","德信",2,32,-30
"8891","2390云辰","110/07/09","合庫-新竹",40,0,40
"8892","2390云辰","110/07/09","兆豐-桃鶯",2,32,-30
"8893","2390云辰","110/07/09","國票",40,1,39
"8894","2390云辰","110/07/09","致和-南京",0,30,-30
"8895","2390云辰","110/07/09","新加坡商瑞銀",49,13,36
"8896","2390云辰","110/07/09","富邦-虎尾",1,31,-30
"8897","2390云辰","110/07/09","統一-新台中",36,2,34
"8898","2390云辰","110/07/09","元大-善化",2,31,-29
"8899","2390云辰","110/07/09","國票-嘉義",31,0,31
"8900","2390云辰","110/07/09","富邦-板橋",0,27,-27
"8901","2390云辰","110/07/09","華南永昌",35,7,28
"8902","2390云辰","110/07/09","富邦-永和",3,28,-25
"8903","2390云辰","110/07/09","玉山-台中",49,22,27
"8904","2390云辰","110/07/09","第一金-自由",20,44,-24
"8905","2390云辰","110/07/09","華南永昌-敦南",25,0,25
"8906","2390云辰","110/07/09","凱基-內湖",0,24,-24
"8907","2390云辰","110/07/09","新光-高雄",27,4,23
"8908","2390云辰","110/07/09","元大-汐止",1,24,-23
"8909","2390云辰","110/07/09","台灣摩根士丹利",85,63,22
"8910","2390云辰","110/07/09","新光-台中",12,33,-21
"8911","4903聯光通","110/07/09","元大-敦南",10,0,10
"8912","4903聯光通","110/07/09","第一金-台中",0,12,-12
"8913","4903聯光通","110/07/09","凱基-士林",5,0,5
"8914","4903聯光通","110/07/09","日盛-忠孝",0,3,-3
"8915","4903聯光通","110/07/09","元大-苗栗",5,0,5
"8916","4903聯光通","110/07/09","群益金鼎-崇德",0,3,-3
"8917","4903聯光通","110/07/09","元大-屏南",3,0,3
"8918","4903聯光通","110/07/09","國票-內壢",0,2,-2
"8919","4903聯光通","110/07/09","中國信託-永康",1,0,1
"8920","4903聯光通","110/07/09","康和-南崁",0,2,-2
"8921","4903聯光通","110/07/09","玉山證券",1,0,1
"8922","4903聯光通","110/07/09","新光-台中",0,2,-2
"8923","4903聯光通","110/07/09","元大-太平",4,3,1
"8924","4903聯光通","110/07/09","玉山-城中",0,2,-2
"8925","4903聯光通","110/07/09","永豐金-嘉義",1,0,1
"8926","4903聯光通","110/07/09","中國信託-文心",0,1,-1
"8927","4903聯光通","110/07/09","大昌",0,0,0
"8928","4903聯光通","110/07/09","大昌",0,0,0
"8929","4903聯光通","110/07/09","中農",0,0,0
"8930","4903聯光通","110/07/09","中農",0,0,0
"8931","4903聯光通","110/07/09","",NA,NA,NA
"8932","4903聯光通","110/07/09","",NA,NA,NA
"8933","4903聯光通","110/07/09","",NA,NA,NA
"8934","4903聯光通","110/07/09","",NA,NA,NA
"8935","4903聯光通","110/07/09","",NA,NA,NA
"8936","4903聯光通","110/07/09","",NA,NA,NA
"8937","4903聯光通","110/07/09","",NA,NA,NA
"8938","4903聯光通","110/07/09","",NA,NA,NA
"8939","4903聯光通","110/07/09","",NA,NA,NA
"8940","4903聯光通","110/07/09","",NA,NA,NA
"8941","2929淘帝","110/07/09","台中銀-台北",110,0,110
"8942","2929淘帝","110/07/09","新光",2,82,-80
"8943","2929淘帝","110/07/09","華南永昌-頭份",72,0,72
"8944","2929淘帝","110/07/09","摩根大通",2,63,-61
"8945","2929淘帝","110/07/09","合庫-高雄",71,0,71
"8946","2929淘帝","110/07/09","第一金-路竹",0,50,-50
"8947","2929淘帝","110/07/09","高橋-龍潭",37,0,37
"8948","2929淘帝","110/07/09","港商麥格理",0,42,-42
"8949","2929淘帝","110/07/09","新光-台中",60,26,34
"8950","2929淘帝","110/07/09","陽信-石牌",0,40,-40
"8951","2929淘帝","110/07/09","元富-大裕",22,1,21
"8952","2929淘帝","110/07/09","台新-左楠",1,39,-38
"8953","2929淘帝","110/07/09","合庫-鳳山",20,0,20
"8954","2929淘帝","110/07/09","凱基-桃園",3,29,-26
"8955","2929淘帝","110/07/09","元大-員林",22,2,20
"8956","2929淘帝","110/07/09","兆豐-內湖",0,25,-25
"8957","2929淘帝","110/07/09","台新-建北",15,0,15
"8958","2929淘帝","110/07/09","元大-北港",0,20,-20
"8959","2929淘帝","110/07/09","兆豐-桃園",13,0,13
"8960","2929淘帝","110/07/09","富邦-北港",0,19,-19
"8961","2929淘帝","110/07/09","兆豐-忠孝",10,0,10
"8962","2929淘帝","110/07/09","富邦-花蓮",0,17,-17
"8963","2929淘帝","110/07/09","國票-敦北法人",10,0,10
"8964","2929淘帝","110/07/09","國泰-台中",2,17,-15
"8965","2929淘帝","110/07/09","永豐金-博愛",10,0,10
"8966","2929淘帝","110/07/09","群益金鼎-彰化",0,15,-15
"8967","2929淘帝","110/07/09","群益金鼎-潭子",8,0,8
"8968","2929淘帝","110/07/09","元大-博愛",0,14,-14
"8969","2929淘帝","110/07/09","富邦-南屯",8,0,8
"8970","2929淘帝","110/07/09","日盛-板橋",0,13,-13
"8971","5410國眾","110/07/09","元大-新盛",14,0,14
"8972","5410國眾","110/07/09","(牛牛牛)亞-鑫豐",1,41,-40
"8973","5410國眾","110/07/09","台灣企銀-民雄",10,0,10
"8974","5410國眾","110/07/09","元富-嘉義",0,25,-25
"8975","5410國眾","110/07/09","元富-虎尾",9,0,9
"8976","5410國眾","110/07/09","凱基-高美館",0,10,-10
"8977","5410國眾","110/07/09","摩根大通",10,1,9
"8978","5410國眾","110/07/09","凱基-城中",0,10,-10
"8979","5410國眾","110/07/09","兆豐-北高雄",7,0,7
"8980","5410國眾","110/07/09","元大-頭份",0,10,-10
"8981","5410國眾","110/07/09","凱基-台北",8,1,7
"8982","5410國眾","110/07/09","群益金鼎-丹鳳",0,7,-7
"8983","5410國眾","110/07/09","華南永昌-公誠",7,0,7
"8984","5410國眾","110/07/09","凱基-復興",0,7,-7
"8985","5410國眾","110/07/09","香港上海匯豐",6,0,6
"8986","5410國眾","110/07/09","元大-員林",0,7,-7
"8987","5410國眾","110/07/09","凱基-中壢",6,0,6
"8988","5410國眾","110/07/09","富邦-竹東",0,6,-6
"8989","5410國眾","110/07/09","華南永昌-南京",6,0,6
"8990","5410國眾","110/07/09","亞東-高雄",0,5,-5
"8991","5410國眾","110/07/09","統一-三重",5,0,5
"8992","5410國眾","110/07/09","大慶-中壢",1,6,-5
"8993","5410國眾","110/07/09","富邦-宜蘭",5,0,5
"8994","5410國眾","110/07/09","群益金鼎-中港",0,5,-5
"8995","5410國眾","110/07/09","元大-崇德",5,0,5
"8996","5410國眾","110/07/09","元大-八德",0,5,-5
"8997","5410國眾","110/07/09","元大-博愛",5,0,5
"8998","5410國眾","110/07/09","富邦-基隆",0,4,-4
"8999","5410國眾","110/07/09","元大-龍潭",5,0,5
"9000","5410國眾","110/07/09","臺銀-新竹",0,3,-3
"9001","2841台開","110/07/09","日盛-雙和",102,0,102
"9002","2841台開","110/07/09","港商野村",0,129,-129
"9003","2841台開","110/07/09","元大-館前",70,0,70
"9004","2841台開","110/07/09","兆豐-永和",0,100,-100
"9005","2841台開","110/07/09","凱基-文心",50,0,50
"9006","2841台開","110/07/09","台新證券",7,28,-21
"9007","2841台開","110/07/09","富邦-嘉義",40,0,40
"9008","2841台開","110/07/09","國票-北高雄",0,20,-20
"9009","2841台開","110/07/09","美商高盛",15,0,15
"9010","2841台開","110/07/09","永豐金-敦南",29,46,-17
"9011","2841台開","110/07/09","台中銀",15,0,15
"9012","2841台開","110/07/09","合庫-基隆",0,12,-12
"9013","2841台開","110/07/09","新光",11,0,11
"9014","2841台開","110/07/09","中國信託-松江",0,12,-12
"9015","2841台開","110/07/09","華南永昌-長虹",10,0,10
"9016","2841台開","110/07/09","兆豐-城中",0,12,-12
"9017","2841台開","110/07/09","永豐金-南投",10,0,10
"9018","2841台開","110/07/09","台中銀-豐原",0,10,-10
"9019","2841台開","110/07/09","合庫-桃園",7,0,7
"9020","2841台開","110/07/09","兆豐-景美",0,10,-10
"9021","2841台開","110/07/09","群益金鼎-古亭",7,0,7
"9022","2841台開","110/07/09","群益金鼎-基隆",0,10,-10
"9023","2841台開","110/07/09","國泰-敦南",6,0,6
"9024","2841台開","110/07/09","元大-北三重",0,10,-10
"9025","2841台開","110/07/09","凱基-桃園",8,2,6
"9026","2841台開","110/07/09","(牛牛牛)亞-網路",0,9,-9
"9027","2841台開","110/07/09","日盛證券",5,0,5
"9028","2841台開","110/07/09","台新-高雄",1,10,-9
"9029","2841台開","110/07/09","元富-文心",5,0,5
"9030","2841台開","110/07/09","凱基-台北",0,7,-7
"9031","6207雷科","110/07/09","群益金鼎-新竹",47,0,47
"9032","6207雷科","110/07/09","新光",7,24,-17
"9033","6207雷科","110/07/09","永豐金-三重",31,0,31
"9034","6207雷科","110/07/09","日盛-和美",0,15,-15
"9035","6207雷科","110/07/09","新加坡商瑞銀",33,5,28
"9036","6207雷科","110/07/09","國泰-台南",0,15,-15
"9037","6207雷科","110/07/09","元大-高雄",26,0,26
"9038","6207雷科","110/07/09","華南永昌-古亭",0,14,-14
"9039","6207雷科","110/07/09","統一-員林",22,0,22
"9040","6207雷科","110/07/09","土銀-白河",0,11,-11
"9041","6207雷科","110/07/09","台新-高雄",22,0,22
"9042","6207雷科","110/07/09","日盛-台南",0,10,-10
"9043","6207雷科","110/07/09","摩根大通",34,17,17
"9044","6207雷科","110/07/09","元富-林園",0,10,-10
"9045","6207雷科","110/07/09","元大-博愛",17,1,16
"9046","6207雷科","110/07/09","富邦-園區",0,10,-10
"9047","6207雷科","110/07/09","日茂-埔里",12,0,12
"9048","6207雷科","110/07/09","元大-上新莊",0,10,-10
"9049","6207雷科","110/07/09","國泰-台中",17,6,11
"9050","6207雷科","110/07/09","永豐金-南京",0,10,-10
"9051","6207雷科","110/07/09","富邦-三重",10,0,10
"9052","6207雷科","110/07/09","兆豐-小港",0,6,-6
"9053","6207雷科","110/07/09","元大-沙鹿",10,0,10
"9054","6207雷科","110/07/09","富邦-羅東",1,7,-6
"9055","6207雷科","110/07/09","元大-八德",10,0,10
"9056","6207雷科","110/07/09","元大-土城永寧",0,6,-6
"9057","6207雷科","110/07/09","第一金-路竹",11,2,9
"9058","6207雷科","110/07/09","永豐金-板盛",0,6,-6
"9059","6207雷科","110/07/09","統一-南京",5,0,5
"9060","6207雷科","110/07/09","日盛-板橋",0,5,-5
"9061","3679新至陞","110/07/09","元大-大天母",10,0,10
"9062","3679新至陞","110/07/09","第一金-光復",0,11,-11
"9063","3679新至陞","110/07/09","日盛-樹林",9,0,9
"9064","3679新至陞","110/07/09","瑞士信貸",0,8,-8
"9065","3679新至陞","110/07/09","凱基-台北",11,2,9
"9066","3679新至陞","110/07/09","大慶-苗栗",0,5,-5
"9067","3679新至陞","110/07/09","華南永昌-小港",8,0,8
"9068","3679新至陞","110/07/09","元大-永春",0,5,-5
"9069","3679新至陞","110/07/09","兆豐-來福",7,0,7
"9070","3679新至陞","110/07/09","日盛-和美",0,4,-4
"9071","3679新至陞","110/07/09","香港上海匯豐",5,0,5
"9072","3679新至陞","110/07/09","元大-雙和",0,3,-3
"9073","3679新至陞","110/07/09","台中銀-員林",3,0,3
"9074","3679新至陞","110/07/09","永豐金-屏東",0,3,-3
"9075","3679新至陞","110/07/09","新光",3,0,3
"9076","3679新至陞","110/07/09","彰銀",0,2,-2
"9077","3679新至陞","110/07/09","土銀-花蓮",2,0,2
"9078","3679新至陞","110/07/09","宏遠-館前",0,2,-2
"9079","3679新至陞","110/07/09","第一金-澎湖",2,0,2
"9080","3679新至陞","110/07/09","港商野村",0,2,-2
"9081","3679新至陞","110/07/09","摩根大通",2,0,2
"9082","3679新至陞","110/07/09","大昌-新店",0,2,-2
"9083","3679新至陞","110/07/09","國泰-敦南",2,0,2
"9084","3679新至陞","110/07/09","元大-新莊",0,2,-2
"9085","3679新至陞","110/07/09","元大-淡水",4,2,2
"9086","3679新至陞","110/07/09","元大-板橋",0,2,-2
"9087","3679新至陞","110/07/09","日盛-士林",1,0,1
"9088","3679新至陞","110/07/09","台灣摩根士丹利",0,1,-1
"9089","3679新至陞","110/07/09","日盛-信義",1,0,1
"9090","3679新至陞","110/07/09","第一金-高雄",0,1,-1
"9091","2727王品","110/07/09","台灣匯立證券",90,0,90
"9092","2727王品","110/07/09","台灣摩根士丹利",0,267,-267
"9093","2727王品","110/07/09","國泰-敦南",166,84,82
"9094","2727王品","110/07/09","富邦-台北",35,299,-264
"9095","2727王品","110/07/09","富邦-仁愛",56,12,44
"9096","2727王品","110/07/09","凱基-台北",174,296,-122
"9097","2727王品","110/07/09","台新證券",109,66,43
"9098","2727王品","110/07/09","第一金",2,102,-100
"9099","2727王品","110/07/09","新光",117,87,30
"9100","2727王品","110/07/09","群益金鼎-大安",0,80,-80
"9101","2727王品","110/07/09","臺銀-臺中",35,6,29
"9102","2727王品","110/07/09","兆豐-大安",7,60,-53
"9103","2727王品","110/07/09","元大-桃園",32,3,29
"9104","2727王品","110/07/09","永豐金-南投",0,50,-50
"9105","2727王品","110/07/09","元富-宜蘭",34,6,28
"9106","2727王品","110/07/09","新加坡商瑞銀",6,46,-40
"9107","2727王品","110/07/09","玉山-台中",34,8,26
"9108","2727王品","110/07/09","合庫-彰化",11,50,-39
"9109","2727王品","110/07/09","群益金鼎-宜蘭",30,4,26
"9110","2727王品","110/07/09","永豐金-萬盛",13,52,-39
"9111","2727王品","110/07/09","富邦-台中",42,16,26
"9112","2727王品","110/07/09","瑞士信貸",0,34,-34
"9113","2727王品","110/07/09","第一金-豐原",25,1,24
"9114","2727王品","110/07/09","元大-和平",4,35,-31
"9115","2727王品","110/07/09","臺銀",30,8,22
"9116","2727王品","110/07/09","美林",14,44,-30
"9117","2727王品","110/07/09","兆豐-來福",23,1,22
"9118","2727王品","110/07/09","元大-員林",9,38,-29
"9119","2727王品","110/07/09","玉山-士林",22,2,20
"9120","2727王品","110/07/09","元富-西松",4,31,-27
"9121","1570力肯","110/07/09","凱基-台北",30,1,29
"9122","1570力肯","110/07/09","群益金鼎-彰化",0,20,-20
"9123","1570力肯","110/07/09","新光-台南",20,0,20
"9124","1570力肯","110/07/09","元大-土城學府",0,20,-20
"9125","1570力肯","110/07/09","元大-高雄",20,0,20
"9126","1570力肯","110/07/09","元大-大統",0,16,-16
"9127","1570力肯","110/07/09","國票-中正",12,0,12
"9128","1570力肯","110/07/09","元大-新營",0,11,-11
"9129","1570力肯","110/07/09","日盛-高雄",6,0,6
"9130","1570力肯","110/07/09","元大-和平",0,10,-10
"9131","1570力肯","110/07/09","元富-緯城",6,0,6
"9132","1570力肯","110/07/09","元大-草屯",0,10,-10
"9133","1570力肯","110/07/09","群益金鼎-台南",6,0,6
"9134","1570力肯","110/07/09","元大-鹿港",0,9,-9
"9135","1570力肯","110/07/09","華南永昌-岡山",6,0,6
"9136","1570力肯","110/07/09","合庫-基隆",0,7,-7
"9137","1570力肯","110/07/09","統一-中壢",5,0,5
"9138","1570力肯","110/07/09","摩根大通",2,8,-6
"9139","1570力肯","110/07/09","凱基-三峽",5,0,5
"9140","1570力肯","110/07/09","台灣企銀-豐原",0,4,-4
"9141","1570力肯","110/07/09","大昌-樹林",4,0,4
"9142","1570力肯","110/07/09","日盛-桃園",0,4,-4
"9143","1570力肯","110/07/09","新光",3,0,3
"9144","1570力肯","110/07/09","國泰-高雄",0,3,-3
"9145","1570力肯","110/07/09","富邦-新竹華信",3,0,3
"9146","1570力肯","110/07/09","永豐金-敦南",0,3,-3
"9147","1570力肯","110/07/09","合庫-台中",2,0,2
"9148","1570力肯","110/07/09","土銀-彰化",0,2,-2
"9149","1570力肯","110/07/09","臺銀-臺中",2,0,2
"9150","1570力肯","110/07/09","臺銀-鳳山",0,2,-2
"9151","6180橘子","110/07/09","摩根大通",63,1,62
"9152","6180橘子","110/07/09","元大-南京",1,32,-31
"9153","6180橘子","110/07/09","富邦-陽明",73,33,40
"9154","6180橘子","110/07/09","群益金鼎-台北",0,25,-25
"9155","6180橘子","110/07/09","新加坡商瑞銀",31,0,31
"9156","6180橘子","110/07/09","兆豐-復興",0,21,-21
"9157","6180橘子","110/07/09","美商高盛",25,0,25
"9158","6180橘子","110/07/09","永豐金-嘉義",0,21,-21
"9159","6180橘子","110/07/09","凱基-台北",26,10,16
"9160","6180橘子","110/07/09","凱基-中壢",8,24,-16
"9161","6180橘子","110/07/09","華南永昌-楠梓",13,0,13
"9162","6180橘子","110/07/09","致和-崇德",0,15,-15
"9163","6180橘子","110/07/09","華南永昌-朴子",11,0,11
"9164","6180橘子","110/07/09","群益金鼎-屏東",0,15,-15
"9165","6180橘子","110/07/09","元大-北港",11,0,11
"9166","6180橘子","110/07/09","群益金鼎-中山",0,15,-15
"9167","6180橘子","110/07/09","元大-成功",10,1,9
"9168","6180橘子","110/07/09","瑞士信貸",1,15,-14
"9169","6180橘子","110/07/09","新光",26,18,8
"9170","6180橘子","110/07/09","日盛-二林",0,10,-10
"9171","6180橘子","110/07/09","統一-三重",6,0,6
"9172","6180橘子","110/07/09","凱基-東門",0,10,-10
"9173","6180橘子","110/07/09","群益金鼎-嘉義",6,0,6
"9174","6180橘子","110/07/09","華南永昌-三重",0,10,-10
"9175","6180橘子","110/07/09","元大-員林中山",6,0,6
"9176","6180橘子","110/07/09","元大-彰化民生",1,11,-10
"9177","6180橘子","110/07/09","合庫-鳳山",5,0,5
"9178","6180橘子","110/07/09","永豐金-新店",1,11,-10
"9179","6180橘子","110/07/09","富邦-建國",6,1,5
"9180","6180橘子","110/07/09","群益金鼎-丹鳳",0,8,-8
"9181","2390云辰","110/07/09","摩根大通",279,56,223
"9182","2390云辰","110/07/09","元大-天母",0,127,-127
"9183","2390云辰","110/07/09","日盛-鳳山",110,2,108
"9184","2390云辰","110/07/09","中國信託-文心",5,109,-104
"9185","2390云辰","110/07/09","宏遠證券",100,0,100
"9186","2390云辰","110/07/09","永豐金-復興",0,55,-55
"9187","2390云辰","110/07/09","元大-大里",63,6,57
"9188","2390云辰","110/07/09","凱基-台北",239,286,-47
"9189","2390云辰","110/07/09","凱基-八德",59,10,49
"9190","2390云辰","110/07/09","德信",2,32,-30
"9191","2390云辰","110/07/09","合庫-新竹",40,0,40
"9192","2390云辰","110/07/09","兆豐-桃鶯",2,32,-30
"9193","2390云辰","110/07/09","國票",40,1,39
"9194","2390云辰","110/07/09","致和-南京",0,30,-30
"9195","2390云辰","110/07/09","新加坡商瑞銀",49,13,36
"9196","2390云辰","110/07/09","富邦-虎尾",1,31,-30
"9197","2390云辰","110/07/09","統一-新台中",36,2,34
"9198","2390云辰","110/07/09","元大-善化",2,31,-29
"9199","2390云辰","110/07/09","國票-嘉義",31,0,31
"9200","2390云辰","110/07/09","富邦-板橋",0,27,-27
"9201","2390云辰","110/07/09","華南永昌",35,7,28
"9202","2390云辰","110/07/09","富邦-永和",3,28,-25
"9203","2390云辰","110/07/09","玉山-台中",49,22,27
"9204","2390云辰","110/07/09","第一金-自由",20,44,-24
"9205","2390云辰","110/07/09","華南永昌-敦南",25,0,25
"9206","2390云辰","110/07/09","凱基-內湖",0,24,-24
"9207","2390云辰","110/07/09","新光-高雄",27,4,23
"9208","2390云辰","110/07/09","元大-汐止",1,24,-23
"9209","2390云辰","110/07/09","台灣摩根士丹利",85,63,22
"9210","2390云辰","110/07/09","新光-台中",12,33,-21
"9211","4903聯光通","110/07/09","元大-敦南",10,0,10
"9212","4903聯光通","110/07/09","第一金-台中",0,12,-12
"9213","4903聯光通","110/07/09","凱基-士林",5,0,5
"9214","4903聯光通","110/07/09","日盛-忠孝",0,3,-3
"9215","4903聯光通","110/07/09","元大-苗栗",5,0,5
"9216","4903聯光通","110/07/09","群益金鼎-崇德",0,3,-3
"9217","4903聯光通","110/07/09","元大-屏南",3,0,3
"9218","4903聯光通","110/07/09","國票-內壢",0,2,-2
"9219","4903聯光通","110/07/09","中國信託-永康",1,0,1
"9220","4903聯光通","110/07/09","康和-南崁",0,2,-2
"9221","4903聯光通","110/07/09","玉山證券",1,0,1
"9222","4903聯光通","110/07/09","新光-台中",0,2,-2
"9223","4903聯光通","110/07/09","元大-太平",4,3,1
"9224","4903聯光通","110/07/09","玉山-城中",0,2,-2
"9225","4903聯光通","110/07/09","永豐金-嘉義",1,0,1
"9226","4903聯光通","110/07/09","中國信託-文心",0,1,-1
"9227","4903聯光通","110/07/09","大昌",0,0,0
"9228","4903聯光通","110/07/09","大昌",0,0,0
"9229","4903聯光通","110/07/09","中農",0,0,0
"9230","4903聯光通","110/07/09","中農",0,0,0
"9231","4903聯光通","110/07/09","",NA,NA,NA
"9232","4903聯光通","110/07/09","",NA,NA,NA
"9233","4903聯光通","110/07/09","",NA,NA,NA
"9234","4903聯光通","110/07/09","",NA,NA,NA
"9235","4903聯光通","110/07/09","",NA,NA,NA
"9236","4903聯光通","110/07/09","",NA,NA,NA
"9237","4903聯光通","110/07/09","",NA,NA,NA
"9238","4903聯光通","110/07/09","",NA,NA,NA
"9239","4903聯光通","110/07/09","",NA,NA,NA
"9240","4903聯光通","110/07/09","",NA,NA,NA
"9241","2929淘帝","110/07/09","台中銀-台北",110,0,110
"9242","2929淘帝","110/07/09","新光",2,82,-80
"9243","2929淘帝","110/07/09","華南永昌-頭份",72,0,72
"9244","2929淘帝","110/07/09","摩根大通",2,63,-61
"9245","2929淘帝","110/07/09","合庫-高雄",71,0,71
"9246","2929淘帝","110/07/09","第一金-路竹",0,50,-50
"9247","2929淘帝","110/07/09","高橋-龍潭",37,0,37
"9248","2929淘帝","110/07/09","港商麥格理",0,42,-42
"9249","2929淘帝","110/07/09","新光-台中",60,26,34
"9250","2929淘帝","110/07/09","陽信-石牌",0,40,-40
"9251","2929淘帝","110/07/09","元富-大裕",22,1,21
"9252","2929淘帝","110/07/09","台新-左楠",1,39,-38
"9253","2929淘帝","110/07/09","合庫-鳳山",20,0,20
"9254","2929淘帝","110/07/09","凱基-桃園",3,29,-26
"9255","2929淘帝","110/07/09","元大-員林",22,2,20
"9256","2929淘帝","110/07/09","兆豐-內湖",0,25,-25
"9257","2929淘帝","110/07/09","台新-建北",15,0,15
"9258","2929淘帝","110/07/09","元大-北港",0,20,-20
"9259","2929淘帝","110/07/09","兆豐-桃園",13,0,13
"9260","2929淘帝","110/07/09","富邦-北港",0,19,-19
"9261","2929淘帝","110/07/09","兆豐-忠孝",10,0,10
"9262","2929淘帝","110/07/09","富邦-花蓮",0,17,-17
"9263","2929淘帝","110/07/09","國票-敦北法人",10,0,10
"9264","2929淘帝","110/07/09","國泰-台中",2,17,-15
"9265","2929淘帝","110/07/09","永豐金-博愛",10,0,10
"9266","2929淘帝","110/07/09","群益金鼎-彰化",0,15,-15
"9267","2929淘帝","110/07/09","群益金鼎-潭子",8,0,8
"9268","2929淘帝","110/07/09","元大-博愛",0,14,-14
"9269","2929淘帝","110/07/09","富邦-南屯",8,0,8
"9270","2929淘帝","110/07/09","日盛-板橋",0,13,-13
"9271","5410國眾","110/07/09","元大-新盛",14,0,14
"9272","5410國眾","110/07/09","(牛牛牛)亞-鑫豐",1,41,-40
"9273","5410國眾","110/07/09","台灣企銀-民雄",10,0,10
"9274","5410國眾","110/07/09","元富-嘉義",0,25,-25
"9275","5410國眾","110/07/09","元富-虎尾",9,0,9
"9276","5410國眾","110/07/09","凱基-高美館",0,10,-10
"9277","5410國眾","110/07/09","摩根大通",10,1,9
"9278","5410國眾","110/07/09","凱基-城中",0,10,-10
"9279","5410國眾","110/07/09","兆豐-北高雄",7,0,7
"9280","5410國眾","110/07/09","元大-頭份",0,10,-10
"9281","5410國眾","110/07/09","凱基-台北",8,1,7
"9282","5410國眾","110/07/09","群益金鼎-丹鳳",0,7,-7
"9283","5410國眾","110/07/09","華南永昌-公誠",7,0,7
"9284","5410國眾","110/07/09","凱基-復興",0,7,-7
"9285","5410國眾","110/07/09","香港上海匯豐",6,0,6
"9286","5410國眾","110/07/09","元大-員林",0,7,-7
"9287","5410國眾","110/07/09","凱基-中壢",6,0,6
"9288","5410國眾","110/07/09","富邦-竹東",0,6,-6
"9289","5410國眾","110/07/09","華南永昌-南京",6,0,6
"9290","5410國眾","110/07/09","亞東-高雄",0,5,-5
"9291","5410國眾","110/07/09","統一-三重",5,0,5
"9292","5410國眾","110/07/09","大慶-中壢",1,6,-5
"9293","5410國眾","110/07/09","富邦-宜蘭",5,0,5
"9294","5410國眾","110/07/09","群益金鼎-中港",0,5,-5
"9295","5410國眾","110/07/09","元大-崇德",5,0,5
"9296","5410國眾","110/07/09","元大-八德",0,5,-5
"9297","5410國眾","110/07/09","元大-博愛",5,0,5
"9298","5410國眾","110/07/09","富邦-基隆",0,4,-4
"9299","5410國眾","110/07/09","元大-龍潭",5,0,5
"9300","5410國眾","110/07/09","臺銀-新竹",0,3,-3
"9301","2841台開","110/07/09","日盛-雙和",102,0,102
"9302","2841台開","110/07/09","港商野村",0,129,-129
"9303","2841台開","110/07/09","元大-館前",70,0,70
"9304","2841台開","110/07/09","兆豐-永和",0,100,-100
"9305","2841台開","110/07/09","凱基-文心",50,0,50
"9306","2841台開","110/07/09","台新證券",7,28,-21
"9307","2841台開","110/07/09","富邦-嘉義",40,0,40
"9308","2841台開","110/07/09","國票-北高雄",0,20,-20
"9309","2841台開","110/07/09","美商高盛",15,0,15
"9310","2841台開","110/07/09","永豐金-敦南",29,46,-17
"9311","2841台開","110/07/09","台中銀",15,0,15
"9312","2841台開","110/07/09","合庫-基隆",0,12,-12
"9313","2841台開","110/07/09","新光",11,0,11
"9314","2841台開","110/07/09","中國信託-松江",0,12,-12
"9315","2841台開","110/07/09","華南永昌-長虹",10,0,10
"9316","2841台開","110/07/09","兆豐-城中",0,12,-12
"9317","2841台開","110/07/09","永豐金-南投",10,0,10
"9318","2841台開","110/07/09","台中銀-豐原",0,10,-10
"9319","2841台開","110/07/09","合庫-桃園",7,0,7
"9320","2841台開","110/07/09","兆豐-景美",0,10,-10
"9321","2841台開","110/07/09","群益金鼎-古亭",7,0,7
"9322","2841台開","110/07/09","群益金鼎-基隆",0,10,-10
"9323","2841台開","110/07/09","國泰-敦南",6,0,6
"9324","2841台開","110/07/09","元大-北三重",0,10,-10
"9325","2841台開","110/07/09","凱基-桃園",8,2,6
"9326","2841台開","110/07/09","(牛牛牛)亞-網路",0,9,-9
"9327","2841台開","110/07/09","日盛證券",5,0,5
"9328","2841台開","110/07/09","台新-高雄",1,10,-9
"9329","2841台開","110/07/09","元富-文心",5,0,5
"9330","2841台開","110/07/09","凱基-台北",0,7,-7
"9331","6207雷科","110/07/09","群益金鼎-新竹",47,0,47
"9332","6207雷科","110/07/09","新光",7,24,-17
"9333","6207雷科","110/07/09","永豐金-三重",31,0,31
"9334","6207雷科","110/07/09","日盛-和美",0,15,-15
"9335","6207雷科","110/07/09","新加坡商瑞銀",33,5,28
"9336","6207雷科","110/07/09","國泰-台南",0,15,-15
"9337","6207雷科","110/07/09","元大-高雄",26,0,26
"9338","6207雷科","110/07/09","華南永昌-古亭",0,14,-14
"9339","6207雷科","110/07/09","統一-員林",22,0,22
"9340","6207雷科","110/07/09","土銀-白河",0,11,-11
"9341","6207雷科","110/07/09","台新-高雄",22,0,22
"9342","6207雷科","110/07/09","日盛-台南",0,10,-10
"9343","6207雷科","110/07/09","摩根大通",34,17,17
"9344","6207雷科","110/07/09","元富-林園",0,10,-10
"9345","6207雷科","110/07/09","元大-博愛",17,1,16
"9346","6207雷科","110/07/09","富邦-園區",0,10,-10
"9347","6207雷科","110/07/09","日茂-埔里",12,0,12
"9348","6207雷科","110/07/09","元大-上新莊",0,10,-10
"9349","6207雷科","110/07/09","國泰-台中",17,6,11
"9350","6207雷科","110/07/09","永豐金-南京",0,10,-10
"9351","6207雷科","110/07/09","富邦-三重",10,0,10
"9352","6207雷科","110/07/09","兆豐-小港",0,6,-6
"9353","6207雷科","110/07/09","元大-沙鹿",10,0,10
"9354","6207雷科","110/07/09","富邦-羅東",1,7,-6
"9355","6207雷科","110/07/09","元大-八德",10,0,10
"9356","6207雷科","110/07/09","元大-土城永寧",0,6,-6
"9357","6207雷科","110/07/09","第一金-路竹",11,2,9
"9358","6207雷科","110/07/09","永豐金-板盛",0,6,-6
"9359","6207雷科","110/07/09","統一-南京",5,0,5
"9360","6207雷科","110/07/09","日盛-板橋",0,5,-5
"9361","3679新至陞","110/07/09","元大-大天母",10,0,10
"9362","3679新至陞","110/07/09","第一金-光復",0,11,-11
"9363","3679新至陞","110/07/09","日盛-樹林",9,0,9
"9364","3679新至陞","110/07/09","瑞士信貸",0,8,-8
"9365","3679新至陞","110/07/09","凱基-台北",11,2,9
"9366","3679新至陞","110/07/09","大慶-苗栗",0,5,-5
"9367","3679新至陞","110/07/09","華南永昌-小港",8,0,8
"9368","3679新至陞","110/07/09","元大-永春",0,5,-5
"9369","3679新至陞","110/07/09","兆豐-來福",7,0,7
"9370","3679新至陞","110/07/09","日盛-和美",0,4,-4
"9371","3679新至陞","110/07/09","香港上海匯豐",5,0,5
"9372","3679新至陞","110/07/09","元大-雙和",0,3,-3
"9373","3679新至陞","110/07/09","台中銀-員林",3,0,3
"9374","3679新至陞","110/07/09","永豐金-屏東",0,3,-3
"9375","3679新至陞","110/07/09","新光",3,0,3
"9376","3679新至陞","110/07/09","彰銀",0,2,-2
"9377","3679新至陞","110/07/09","土銀-花蓮",2,0,2
"9378","3679新至陞","110/07/09","宏遠-館前",0,2,-2
"9379","3679新至陞","110/07/09","第一金-澎湖",2,0,2
"9380","3679新至陞","110/07/09","港商野村",0,2,-2
"9381","3679新至陞","110/07/09","摩根大通",2,0,2
"9382","3679新至陞","110/07/09","大昌-新店",0,2,-2
"9383","3679新至陞","110/07/09","國泰-敦南",2,0,2
"9384","3679新至陞","110/07/09","元大-新莊",0,2,-2
"9385","3679新至陞","110/07/09","元大-淡水",4,2,2
"9386","3679新至陞","110/07/09","元大-板橋",0,2,-2
"9387","3679新至陞","110/07/09","日盛-士林",1,0,1
"9388","3679新至陞","110/07/09","台灣摩根士丹利",0,1,-1
"9389","3679新至陞","110/07/09","日盛-信義",1,0,1
"9390","3679新至陞","110/07/09","第一金-高雄",0,1,-1
"9391","2727王品","110/07/09","台灣匯立證券",90,0,90
"9392","2727王品","110/07/09","台灣摩根士丹利",0,267,-267
"9393","2727王品","110/07/09","國泰-敦南",166,84,82
"9394","2727王品","110/07/09","富邦-台北",35,299,-264
"9395","2727王品","110/07/09","富邦-仁愛",56,12,44
"9396","2727王品","110/07/09","凱基-台北",174,296,-122
"9397","2727王品","110/07/09","台新證券",109,66,43
"9398","2727王品","110/07/09","第一金",2,102,-100
"9399","2727王品","110/07/09","新光",117,87,30
"9400","2727王品","110/07/09","群益金鼎-大安",0,80,-80
"9401","2727王品","110/07/09","臺銀-臺中",35,6,29
"9402","2727王品","110/07/09","兆豐-大安",7,60,-53
"9403","2727王品","110/07/09","元大-桃園",32,3,29
"9404","2727王品","110/07/09","永豐金-南投",0,50,-50
"9405","2727王品","110/07/09","元富-宜蘭",34,6,28
"9406","2727王品","110/07/09","新加坡商瑞銀",6,46,-40
"9407","2727王品","110/07/09","玉山-台中",34,8,26
"9408","2727王品","110/07/09","合庫-彰化",11,50,-39
"9409","2727王品","110/07/09","群益金鼎-宜蘭",30,4,26
"9410","2727王品","110/07/09","永豐金-萬盛",13,52,-39
"9411","2727王品","110/07/09","富邦-台中",42,16,26
"9412","2727王品","110/07/09","瑞士信貸",0,34,-34
"9413","2727王品","110/07/09","第一金-豐原",25,1,24
"9414","2727王品","110/07/09","元大-和平",4,35,-31
"9415","2727王品","110/07/09","臺銀",30,8,22
"9416","2727王品","110/07/09","美林",14,44,-30
"9417","2727王品","110/07/09","兆豐-來福",23,1,22
"9418","2727王品","110/07/09","元大-員林",9,38,-29
"9419","2727王品","110/07/09","玉山-士林",22,2,20
"9420","2727王品","110/07/09","元富-西松",4,31,-27
"9421","1570力肯","110/07/09","凱基-台北",30,1,29
"9422","1570力肯","110/07/09","群益金鼎-彰化",0,20,-20
"9423","1570力肯","110/07/09","新光-台南",20,0,20
"9424","1570力肯","110/07/09","元大-土城學府",0,20,-20
"9425","1570力肯","110/07/09","元大-高雄",20,0,20
"9426","1570力肯","110/07/09","元大-大統",0,16,-16
"9427","1570力肯","110/07/09","國票-中正",12,0,12
"9428","1570力肯","110/07/09","元大-新營",0,11,-11
"9429","1570力肯","110/07/09","日盛-高雄",6,0,6
"9430","1570力肯","110/07/09","元大-和平",0,10,-10
"9431","1570力肯","110/07/09","元富-緯城",6,0,6
"9432","1570力肯","110/07/09","元大-草屯",0,10,-10
"9433","1570力肯","110/07/09","群益金鼎-台南",6,0,6
"9434","1570力肯","110/07/09","元大-鹿港",0,9,-9
"9435","1570力肯","110/07/09","華南永昌-岡山",6,0,6
"9436","1570力肯","110/07/09","合庫-基隆",0,7,-7
"9437","1570力肯","110/07/09","統一-中壢",5,0,5
"9438","1570力肯","110/07/09","摩根大通",2,8,-6
"9439","1570力肯","110/07/09","凱基-三峽",5,0,5
"9440","1570力肯","110/07/09","台灣企銀-豐原",0,4,-4
"9441","1570力肯","110/07/09","大昌-樹林",4,0,4
"9442","1570力肯","110/07/09","日盛-桃園",0,4,-4
"9443","1570力肯","110/07/09","新光",3,0,3
"9444","1570力肯","110/07/09","國泰-高雄",0,3,-3
"9445","1570力肯","110/07/09","富邦-新竹華信",3,0,3
"9446","1570力肯","110/07/09","永豐金-敦南",0,3,-3
"9447","1570力肯","110/07/09","合庫-台中",2,0,2
"9448","1570力肯","110/07/09","土銀-彰化",0,2,-2
"9449","1570力肯","110/07/09","臺銀-臺中",2,0,2
"9450","1570力肯","110/07/09","臺銀-鳳山",0,2,-2
"9451","6180橘子","110/07/09","摩根大通",63,1,62
"9452","6180橘子","110/07/09","元大-南京",1,32,-31
"9453","6180橘子","110/07/09","富邦-陽明",73,33,40
"9454","6180橘子","110/07/09","群益金鼎-台北",0,25,-25
"9455","6180橘子","110/07/09","新加坡商瑞銀",31,0,31
"9456","6180橘子","110/07/09","兆豐-復興",0,21,-21
"9457","6180橘子","110/07/09","美商高盛",25,0,25
"9458","6180橘子","110/07/09","永豐金-嘉義",0,21,-21
"9459","6180橘子","110/07/09","凱基-台北",26,10,16
"9460","6180橘子","110/07/09","凱基-中壢",8,24,-16
"9461","6180橘子","110/07/09","華南永昌-楠梓",13,0,13
"9462","6180橘子","110/07/09","致和-崇德",0,15,-15
"9463","6180橘子","110/07/09","華南永昌-朴子",11,0,11
"9464","6180橘子","110/07/09","群益金鼎-屏東",0,15,-15
"9465","6180橘子","110/07/09","元大-北港",11,0,11
"9466","6180橘子","110/07/09","群益金鼎-中山",0,15,-15
"9467","6180橘子","110/07/09","元大-成功",10,1,9
"9468","6180橘子","110/07/09","瑞士信貸",1,15,-14
"9469","6180橘子","110/07/09","新光",26,18,8
"9470","6180橘子","110/07/09","日盛-二林",0,10,-10
"9471","6180橘子","110/07/09","統一-三重",6,0,6
"9472","6180橘子","110/07/09","凱基-東門",0,10,-10
"9473","6180橘子","110/07/09","群益金鼎-嘉義",6,0,6
"9474","6180橘子","110/07/09","華南永昌-三重",0,10,-10
"9475","6180橘子","110/07/09","元大-員林中山",6,0,6
"9476","6180橘子","110/07/09","元大-彰化民生",1,11,-10
"9477","6180橘子","110/07/09","合庫-鳳山",5,0,5
"9478","6180橘子","110/07/09","永豐金-新店",1,11,-10
"9479","6180橘子","110/07/09","富邦-建國",6,1,5
"9480","6180橘子","110/07/09","群益金鼎-丹鳳",0,8,-8
"9481","2390云辰","110/07/09","摩根大通",279,56,223
"9482","2390云辰","110/07/09","元大-天母",0,127,-127
"9483","2390云辰","110/07/09","日盛-鳳山",110,2,108
"9484","2390云辰","110/07/09","中國信託-文心",5,109,-104
"9485","2390云辰","110/07/09","宏遠證券",100,0,100
"9486","2390云辰","110/07/09","永豐金-復興",0,55,-55
"9487","2390云辰","110/07/09","元大-大里",63,6,57
"9488","2390云辰","110/07/09","凱基-台北",239,286,-47
"9489","2390云辰","110/07/09","凱基-八德",59,10,49
"9490","2390云辰","110/07/09","德信",2,32,-30
"9491","2390云辰","110/07/09","合庫-新竹",40,0,40
"9492","2390云辰","110/07/09","兆豐-桃鶯",2,32,-30
"9493","2390云辰","110/07/09","國票",40,1,39
"9494","2390云辰","110/07/09","致和-南京",0,30,-30
"9495","2390云辰","110/07/09","新加坡商瑞銀",49,13,36
"9496","2390云辰","110/07/09","富邦-虎尾",1,31,-30
"9497","2390云辰","110/07/09","統一-新台中",36,2,34
"9498","2390云辰","110/07/09","元大-善化",2,31,-29
"9499","2390云辰","110/07/09","國票-嘉義",31,0,31
"9500","2390云辰","110/07/09","富邦-板橋",0,27,-27
"9501","2390云辰","110/07/09","華南永昌",35,7,28
"9502","2390云辰","110/07/09","富邦-永和",3,28,-25
"9503","2390云辰","110/07/09","玉山-台中",49,22,27
"9504","2390云辰","110/07/09","第一金-自由",20,44,-24
"9505","2390云辰","110/07/09","華南永昌-敦南",25,0,25
"9506","2390云辰","110/07/09","凱基-內湖",0,24,-24
"9507","2390云辰","110/07/09","新光-高雄",27,4,23
"9508","2390云辰","110/07/09","元大-汐止",1,24,-23
"9509","2390云辰","110/07/09","台灣摩根士丹利",85,63,22
"9510","2390云辰","110/07/09","新光-台中",12,33,-21
"9511","4903聯光通","110/07/09","元大-敦南",10,0,10
"9512","4903聯光通","110/07/09","第一金-台中",0,12,-12
"9513","4903聯光通","110/07/09","凱基-士林",5,0,5
"9514","4903聯光通","110/07/09","日盛-忠孝",0,3,-3
"9515","4903聯光通","110/07/09","元大-苗栗",5,0,5
"9516","4903聯光通","110/07/09","群益金鼎-崇德",0,3,-3
"9517","4903聯光通","110/07/09","元大-屏南",3,0,3
"9518","4903聯光通","110/07/09","國票-內壢",0,2,-2
"9519","4903聯光通","110/07/09","中國信託-永康",1,0,1
"9520","4903聯光通","110/07/09","康和-南崁",0,2,-2
"9521","4903聯光通","110/07/09","玉山證券",1,0,1
"9522","4903聯光通","110/07/09","新光-台中",0,2,-2
"9523","4903聯光通","110/07/09","元大-太平",4,3,1
"9524","4903聯光通","110/07/09","玉山-城中",0,2,-2
"9525","4903聯光通","110/07/09","永豐金-嘉義",1,0,1
"9526","4903聯光通","110/07/09","中國信託-文心",0,1,-1
"9527","4903聯光通","110/07/09","大昌",0,0,0
"9528","4903聯光通","110/07/09","大昌",0,0,0
"9529","4903聯光通","110/07/09","中農",0,0,0
"9530","4903聯光通","110/07/09","中農",0,0,0
"9531","4903聯光通","110/07/09","",NA,NA,NA
"9532","4903聯光通","110/07/09","",NA,NA,NA
"9533","4903聯光通","110/07/09","",NA,NA,NA
"9534","4903聯光通","110/07/09","",NA,NA,NA
"9535","4903聯光通","110/07/09","",NA,NA,NA
"9536","4903聯光通","110/07/09","",NA,NA,NA
"9537","4903聯光通","110/07/09","",NA,NA,NA
"9538","4903聯光通","110/07/09","",NA,NA,NA
"9539","4903聯光通","110/07/09","",NA,NA,NA
"9540","4903聯光通","110/07/09","",NA,NA,NA
"9541","2929淘帝","110/07/09","台中銀-台北",110,0,110
"9542","2929淘帝","110/07/09","新光",2,82,-80
"9543","2929淘帝","110/07/09","華南永昌-頭份",72,0,72
"9544","2929淘帝","110/07/09","摩根大通",2,63,-61
"9545","2929淘帝","110/07/09","合庫-高雄",71,0,71
"9546","2929淘帝","110/07/09","第一金-路竹",0,50,-50
"9547","2929淘帝","110/07/09","高橋-龍潭",37,0,37
"9548","2929淘帝","110/07/09","港商麥格理",0,42,-42
"9549","2929淘帝","110/07/09","新光-台中",60,26,34
"9550","2929淘帝","110/07/09","陽信-石牌",0,40,-40
"9551","2929淘帝","110/07/09","元富-大裕",22,1,21
"9552","2929淘帝","110/07/09","台新-左楠",1,39,-38
"9553","2929淘帝","110/07/09","合庫-鳳山",20,0,20
"9554","2929淘帝","110/07/09","凱基-桃園",3,29,-26
"9555","2929淘帝","110/07/09","元大-員林",22,2,20
"9556","2929淘帝","110/07/09","兆豐-內湖",0,25,-25
"9557","2929淘帝","110/07/09","台新-建北",15,0,15
"9558","2929淘帝","110/07/09","元大-北港",0,20,-20
"9559","2929淘帝","110/07/09","兆豐-桃園",13,0,13
"9560","2929淘帝","110/07/09","富邦-北港",0,19,-19
"9561","2929淘帝","110/07/09","兆豐-忠孝",10,0,10
"9562","2929淘帝","110/07/09","富邦-花蓮",0,17,-17
"9563","2929淘帝","110/07/09","國票-敦北法人",10,0,10
"9564","2929淘帝","110/07/09","國泰-台中",2,17,-15
"9565","2929淘帝","110/07/09","永豐金-博愛",10,0,10
"9566","2929淘帝","110/07/09","群益金鼎-彰化",0,15,-15
"9567","2929淘帝","110/07/09","群益金鼎-潭子",8,0,8
"9568","2929淘帝","110/07/09","元大-博愛",0,14,-14
"9569","2929淘帝","110/07/09","富邦-南屯",8,0,8
"9570","2929淘帝","110/07/09","日盛-板橋",0,13,-13
"9571","5410國眾","110/07/09","元大-新盛",14,0,14
"9572","5410國眾","110/07/09","(牛牛牛)亞-鑫豐",1,41,-40
"9573","5410國眾","110/07/09","台灣企銀-民雄",10,0,10
"9574","5410國眾","110/07/09","元富-嘉義",0,25,-25
"9575","5410國眾","110/07/09","元富-虎尾",9,0,9
"9576","5410國眾","110/07/09","凱基-高美館",0,10,-10
"9577","5410國眾","110/07/09","摩根大通",10,1,9
"9578","5410國眾","110/07/09","凱基-城中",0,10,-10
"9579","5410國眾","110/07/09","兆豐-北高雄",7,0,7
"9580","5410國眾","110/07/09","元大-頭份",0,10,-10
"9581","5410國眾","110/07/09","凱基-台北",8,1,7
"9582","5410國眾","110/07/09","群益金鼎-丹鳳",0,7,-7
"9583","5410國眾","110/07/09","華南永昌-公誠",7,0,7
"9584","5410國眾","110/07/09","凱基-復興",0,7,-7
"9585","5410國眾","110/07/09","香港上海匯豐",6,0,6
"9586","5410國眾","110/07/09","元大-員林",0,7,-7
"9587","5410國眾","110/07/09","凱基-中壢",6,0,6
"9588","5410國眾","110/07/09","富邦-竹東",0,6,-6
"9589","5410國眾","110/07/09","華南永昌-南京",6,0,6
"9590","5410國眾","110/07/09","亞東-高雄",0,5,-5
"9591","5410國眾","110/07/09","統一-三重",5,0,5
"9592","5410國眾","110/07/09","大慶-中壢",1,6,-5
"9593","5410國眾","110/07/09","富邦-宜蘭",5,0,5
"9594","5410國眾","110/07/09","群益金鼎-中港",0,5,-5
"9595","5410國眾","110/07/09","元大-崇德",5,0,5
"9596","5410國眾","110/07/09","元大-八德",0,5,-5
"9597","5410國眾","110/07/09","元大-博愛",5,0,5
"9598","5410國眾","110/07/09","富邦-基隆",0,4,-4
"9599","5410國眾","110/07/09","元大-龍潭",5,0,5
"9600","5410國眾","110/07/09","臺銀-新竹",0,3,-3
"9601","2841台開","110/07/09","日盛-雙和",102,0,102
"9602","2841台開","110/07/09","港商野村",0,129,-129
"9603","2841台開","110/07/09","元大-館前",70,0,70
"9604","2841台開","110/07/09","兆豐-永和",0,100,-100
"9605","2841台開","110/07/09","凱基-文心",50,0,50
"9606","2841台開","110/07/09","台新證券",7,28,-21
"9607","2841台開","110/07/09","富邦-嘉義",40,0,40
"9608","2841台開","110/07/09","國票-北高雄",0,20,-20
"9609","2841台開","110/07/09","美商高盛",15,0,15
"9610","2841台開","110/07/09","永豐金-敦南",29,46,-17
"9611","2841台開","110/07/09","台中銀",15,0,15
"9612","2841台開","110/07/09","合庫-基隆",0,12,-12
"9613","2841台開","110/07/09","新光",11,0,11
"9614","2841台開","110/07/09","中國信託-松江",0,12,-12
"9615","2841台開","110/07/09","華南永昌-長虹",10,0,10
"9616","2841台開","110/07/09","兆豐-城中",0,12,-12
"9617","2841台開","110/07/09","永豐金-南投",10,0,10
"9618","2841台開","110/07/09","台中銀-豐原",0,10,-10
"9619","2841台開","110/07/09","合庫-桃園",7,0,7
"9620","2841台開","110/07/09","兆豐-景美",0,10,-10
"9621","2841台開","110/07/09","群益金鼎-古亭",7,0,7
"9622","2841台開","110/07/09","群益金鼎-基隆",0,10,-10
"9623","2841台開","110/07/09","國泰-敦南",6,0,6
"9624","2841台開","110/07/09","元大-北三重",0,10,-10
"9625","2841台開","110/07/09","凱基-桃園",8,2,6
"9626","2841台開","110/07/09","(牛牛牛)亞-網路",0,9,-9
"9627","2841台開","110/07/09","日盛證券",5,0,5
"9628","2841台開","110/07/09","台新-高雄",1,10,-9
"9629","2841台開","110/07/09","元富-文心",5,0,5
"9630","2841台開","110/07/09","凱基-台北",0,7,-7
"9631","6207雷科","110/07/09","群益金鼎-新竹",47,0,47
"9632","6207雷科","110/07/09","新光",7,24,-17
"9633","6207雷科","110/07/09","永豐金-三重",31,0,31
"9634","6207雷科","110/07/09","日盛-和美",0,15,-15
"9635","6207雷科","110/07/09","新加坡商瑞銀",33,5,28
"9636","6207雷科","110/07/09","國泰-台南",0,15,-15
"9637","6207雷科","110/07/09","元大-高雄",26,0,26
"9638","6207雷科","110/07/09","華南永昌-古亭",0,14,-14
"9639","6207雷科","110/07/09","統一-員林",22,0,22
"9640","6207雷科","110/07/09","土銀-白河",0,11,-11
"9641","6207雷科","110/07/09","台新-高雄",22,0,22
"9642","6207雷科","110/07/09","日盛-台南",0,10,-10
"9643","6207雷科","110/07/09","摩根大通",34,17,17
"9644","6207雷科","110/07/09","元富-林園",0,10,-10
"9645","6207雷科","110/07/09","元大-博愛",17,1,16
"9646","6207雷科","110/07/09","富邦-園區",0,10,-10
"9647","6207雷科","110/07/09","日茂-埔里",12,0,12
"9648","6207雷科","110/07/09","元大-上新莊",0,10,-10
"9649","6207雷科","110/07/09","國泰-台中",17,6,11
"9650","6207雷科","110/07/09","永豐金-南京",0,10,-10
"9651","6207雷科","110/07/09","富邦-三重",10,0,10
"9652","6207雷科","110/07/09","兆豐-小港",0,6,-6
"9653","6207雷科","110/07/09","元大-沙鹿",10,0,10
"9654","6207雷科","110/07/09","富邦-羅東",1,7,-6
"9655","6207雷科","110/07/09","元大-八德",10,0,10
"9656","6207雷科","110/07/09","元大-土城永寧",0,6,-6
"9657","6207雷科","110/07/09","第一金-路竹",11,2,9
"9658","6207雷科","110/07/09","永豐金-板盛",0,6,-6
"9659","6207雷科","110/07/09","統一-南京",5,0,5
"9660","6207雷科","110/07/09","日盛-板橋",0,5,-5
"9661","3679新至陞","110/07/09","元大-大天母",10,0,10
"9662","3679新至陞","110/07/09","第一金-光復",0,11,-11
"9663","3679新至陞","110/07/09","日盛-樹林",9,0,9
"9664","3679新至陞","110/07/09","瑞士信貸",0,8,-8
"9665","3679新至陞","110/07/09","凱基-台北",11,2,9
"9666","3679新至陞","110/07/09","大慶-苗栗",0,5,-5
"9667","3679新至陞","110/07/09","華南永昌-小港",8,0,8
"9668","3679新至陞","110/07/09","元大-永春",0,5,-5
"9669","3679新至陞","110/07/09","兆豐-來福",7,0,7
"9670","3679新至陞","110/07/09","日盛-和美",0,4,-4
"9671","3679新至陞","110/07/09","香港上海匯豐",5,0,5
"9672","3679新至陞","110/07/09","元大-雙和",0,3,-3
"9673","3679新至陞","110/07/09","台中銀-員林",3,0,3
"9674","3679新至陞","110/07/09","永豐金-屏東",0,3,-3
"9675","3679新至陞","110/07/09","新光",3,0,3
"9676","3679新至陞","110/07/09","彰銀",0,2,-2
"9677","3679新至陞","110/07/09","土銀-花蓮",2,0,2
"9678","3679新至陞","110/07/09","宏遠-館前",0,2,-2
"9679","3679新至陞","110/07/09","第一金-澎湖",2,0,2
"9680","3679新至陞","110/07/09","港商野村",0,2,-2
"9681","3679新至陞","110/07/09","摩根大通",2,0,2
"9682","3679新至陞","110/07/09","大昌-新店",0,2,-2
"9683","3679新至陞","110/07/09","國泰-敦南",2,0,2
"9684","3679新至陞","110/07/09","元大-新莊",0,2,-2
"9685","3679新至陞","110/07/09","元大-淡水",4,2,2
"9686","3679新至陞","110/07/09","元大-板橋",0,2,-2
"9687","3679新至陞","110/07/09","日盛-士林",1,0,1
"9688","3679新至陞","110/07/09","台灣摩根士丹利",0,1,-1
"9689","3679新至陞","110/07/09","日盛-信義",1,0,1
"9690","3679新至陞","110/07/09","第一金-高雄",0,1,-1
"9691","2727王品","110/07/09","台灣匯立證券",90,0,90
"9692","2727王品","110/07/09","台灣摩根士丹利",0,267,-267
"9693","2727王品","110/07/09","國泰-敦南",166,84,82
"9694","2727王品","110/07/09","富邦-台北",35,299,-264
"9695","2727王品","110/07/09","富邦-仁愛",56,12,44
"9696","2727王品","110/07/09","凱基-台北",174,296,-122
"9697","2727王品","110/07/09","台新證券",109,66,43
"9698","2727王品","110/07/09","第一金",2,102,-100
"9699","2727王品","110/07/09","新光",117,87,30
"9700","2727王品","110/07/09","群益金鼎-大安",0,80,-80
"9701","2727王品","110/07/09","臺銀-臺中",35,6,29
"9702","2727王品","110/07/09","兆豐-大安",7,60,-53
"9703","2727王品","110/07/09","元大-桃園",32,3,29
"9704","2727王品","110/07/09","永豐金-南投",0,50,-50
"9705","2727王品","110/07/09","元富-宜蘭",34,6,28
"9706","2727王品","110/07/09","新加坡商瑞銀",6,46,-40
"9707","2727王品","110/07/09","玉山-台中",34,8,26
"9708","2727王品","110/07/09","合庫-彰化",11,50,-39
"9709","2727王品","110/07/09","群益金鼎-宜蘭",30,4,26
"9710","2727王品","110/07/09","永豐金-萬盛",13,52,-39
"9711","2727王品","110/07/09","富邦-台中",42,16,26
"9712","2727王品","110/07/09","瑞士信貸",0,34,-34
"9713","2727王品","110/07/09","第一金-豐原",25,1,24
"9714","2727王品","110/07/09","元大-和平",4,35,-31
"9715","2727王品","110/07/09","臺銀",30,8,22
"9716","2727王品","110/07/09","美林",14,44,-30
"9717","2727王品","110/07/09","兆豐-來福",23,1,22
"9718","2727王品","110/07/09","元大-員林",9,38,-29
"9719","2727王品","110/07/09","玉山-士林",22,2,20
"9720","2727王品","110/07/09","元富-西松",4,31,-27
"9721","1570力肯","110/07/09","凱基-台北",30,1,29
"9722","1570力肯","110/07/09","群益金鼎-彰化",0,20,-20
"9723","1570力肯","110/07/09","新光-台南",20,0,20
"9724","1570力肯","110/07/09","元大-土城學府",0,20,-20
"9725","1570力肯","110/07/09","元大-高雄",20,0,20
"9726","1570力肯","110/07/09","元大-大統",0,16,-16
"9727","1570力肯","110/07/09","國票-中正",12,0,12
"9728","1570力肯","110/07/09","元大-新營",0,11,-11
"9729","1570力肯","110/07/09","日盛-高雄",6,0,6
"9730","1570力肯","110/07/09","元大-和平",0,10,-10
"9731","1570力肯","110/07/09","元富-緯城",6,0,6
"9732","1570力肯","110/07/09","元大-草屯",0,10,-10
"9733","1570力肯","110/07/09","群益金鼎-台南",6,0,6
"9734","1570力肯","110/07/09","元大-鹿港",0,9,-9
"9735","1570力肯","110/07/09","華南永昌-岡山",6,0,6
"9736","1570力肯","110/07/09","合庫-基隆",0,7,-7
"9737","1570力肯","110/07/09","統一-中壢",5,0,5
"9738","1570力肯","110/07/09","摩根大通",2,8,-6
"9739","1570力肯","110/07/09","凱基-三峽",5,0,5
"9740","1570力肯","110/07/09","台灣企銀-豐原",0,4,-4
"9741","1570力肯","110/07/09","大昌-樹林",4,0,4
"9742","1570力肯","110/07/09","日盛-桃園",0,4,-4
"9743","1570力肯","110/07/09","新光",3,0,3
"9744","1570力肯","110/07/09","國泰-高雄",0,3,-3
"9745","1570力肯","110/07/09","富邦-新竹華信",3,0,3
"9746","1570力肯","110/07/09","永豐金-敦南",0,3,-3
"9747","1570力肯","110/07/09","合庫-台中",2,0,2
"9748","1570力肯","110/07/09","土銀-彰化",0,2,-2
"9749","1570力肯","110/07/09","臺銀-臺中",2,0,2
"9750","1570力肯","110/07/09","臺銀-鳳山",0,2,-2
"9751","6180橘子","110/07/09","摩根大通",63,1,62
"9752","6180橘子","110/07/09","元大-南京",1,32,-31
"9753","6180橘子","110/07/09","富邦-陽明",73,33,40
"9754","6180橘子","110/07/09","群益金鼎-台北",0,25,-25
"9755","6180橘子","110/07/09","新加坡商瑞銀",31,0,31
"9756","6180橘子","110/07/09","兆豐-復興",0,21,-21
"9757","6180橘子","110/07/09","美商高盛",25,0,25
"9758","6180橘子","110/07/09","永豐金-嘉義",0,21,-21
"9759","6180橘子","110/07/09","凱基-台北",26,10,16
"9760","6180橘子","110/07/09","凱基-中壢",8,24,-16
"9761","6180橘子","110/07/09","華南永昌-楠梓",13,0,13
"9762","6180橘子","110/07/09","致和-崇德",0,15,-15
"9763","6180橘子","110/07/09","華南永昌-朴子",11,0,11
"9764","6180橘子","110/07/09","群益金鼎-屏東",0,15,-15
"9765","6180橘子","110/07/09","元大-北港",11,0,11
"9766","6180橘子","110/07/09","群益金鼎-中山",0,15,-15
"9767","6180橘子","110/07/09","元大-成功",10,1,9
"9768","6180橘子","110/07/09","瑞士信貸",1,15,-14
"9769","6180橘子","110/07/09","新光",26,18,8
"9770","6180橘子","110/07/09","日盛-二林",0,10,-10
"9771","6180橘子","110/07/09","統一-三重",6,0,6
"9772","6180橘子","110/07/09","凱基-東門",0,10,-10
"9773","6180橘子","110/07/09","群益金鼎-嘉義",6,0,6
"9774","6180橘子","110/07/09","華南永昌-三重",0,10,-10
"9775","6180橘子","110/07/09","元大-員林中山",6,0,6
"9776","6180橘子","110/07/09","元大-彰化民生",1,11,-10
"9777","6180橘子","110/07/09","合庫-鳳山",5,0,5
"9778","6180橘子","110/07/09","永豐金-新店",1,11,-10
"9779","6180橘子","110/07/09","富邦-建國",6,1,5
"9780","6180橘子","110/07/09","群益金鼎-丹鳳",0,8,-8
"9781","2390云辰","110/07/09","摩根大通",279,56,223
"9782","2390云辰","110/07/09","元大-天母",0,127,-127
"9783","2390云辰","110/07/09","日盛-鳳山",110,2,108
"9784","2390云辰","110/07/09","中國信託-文心",5,109,-104
"9785","2390云辰","110/07/09","宏遠證券",100,0,100
"9786","2390云辰","110/07/09","永豐金-復興",0,55,-55
"9787","2390云辰","110/07/09","元大-大里",63,6,57
"9788","2390云辰","110/07/09","凱基-台北",239,286,-47
"9789","2390云辰","110/07/09","凱基-八德",59,10,49
"9790","2390云辰","110/07/09","德信",2,32,-30
"9791","2390云辰","110/07/09","合庫-新竹",40,0,40
"9792","2390云辰","110/07/09","兆豐-桃鶯",2,32,-30
"9793","2390云辰","110/07/09","國票",40,1,39
"9794","2390云辰","110/07/09","致和-南京",0,30,-30
"9795","2390云辰","110/07/09","新加坡商瑞銀",49,13,36
"9796","2390云辰","110/07/09","富邦-虎尾",1,31,-30
"9797","2390云辰","110/07/09","統一-新台中",36,2,34
"9798","2390云辰","110/07/09","元大-善化",2,31,-29
"9799","2390云辰","110/07/09","國票-嘉義",31,0,31
"9800","2390云辰","110/07/09","富邦-板橋",0,27,-27
"9801","2390云辰","110/07/09","華南永昌",35,7,28
"9802","2390云辰","110/07/09","富邦-永和",3,28,-25
"9803","2390云辰","110/07/09","玉山-台中",49,22,27
"9804","2390云辰","110/07/09","第一金-自由",20,44,-24
"9805","2390云辰","110/07/09","華南永昌-敦南",25,0,25
"9806","2390云辰","110/07/09","凱基-內湖",0,24,-24
"9807","2390云辰","110/07/09","新光-高雄",27,4,23
"9808","2390云辰","110/07/09","元大-汐止",1,24,-23
"9809","2390云辰","110/07/09","台灣摩根士丹利",85,63,22
"9810","2390云辰","110/07/09","新光-台中",12,33,-21
"9811","4903聯光通","110/07/09","元大-敦南",10,0,10
"9812","4903聯光通","110/07/09","第一金-台中",0,12,-12
"9813","4903聯光通","110/07/09","凱基-士林",5,0,5
"9814","4903聯光通","110/07/09","日盛-忠孝",0,3,-3
"9815","4903聯光通","110/07/09","元大-苗栗",5,0,5
"9816","4903聯光通","110/07/09","群益金鼎-崇德",0,3,-3
"9817","4903聯光通","110/07/09","元大-屏南",3,0,3
"9818","4903聯光通","110/07/09","國票-內壢",0,2,-2
"9819","4903聯光通","110/07/09","中國信託-永康",1,0,1
"9820","4903聯光通","110/07/09","康和-南崁",0,2,-2
"9821","4903聯光通","110/07/09","玉山證券",1,0,1
"9822","4903聯光通","110/07/09","新光-台中",0,2,-2
"9823","4903聯光通","110/07/09","元大-太平",4,3,1
"9824","4903聯光通","110/07/09","玉山-城中",0,2,-2
"9825","4903聯光通","110/07/09","永豐金-嘉義",1,0,1
"9826","4903聯光通","110/07/09","中國信託-文心",0,1,-1
"9827","4903聯光通","110/07/09","大昌",0,0,0
"9828","4903聯光通","110/07/09","大昌",0,0,0
"9829","4903聯光通","110/07/09","中農",0,0,0
"9830","4903聯光通","110/07/09","中農",0,0,0
"9831","4903聯光通","110/07/09","",NA,NA,NA
"9832","4903聯光通","110/07/09","",NA,NA,NA
"9833","4903聯光通","110/07/09","",NA,NA,NA
"9834","4903聯光通","110/07/09","",NA,NA,NA
"9835","4903聯光通","110/07/09","",NA,NA,NA
"9836","4903聯光通","110/07/09","",NA,NA,NA
"9837","4903聯光通","110/07/09","",NA,NA,NA
"9838","4903聯光通","110/07/09","",NA,NA,NA
"9839","4903聯光通","110/07/09","",NA,NA,NA
"9840","4903聯光通","110/07/09","",NA,NA,NA
"9841","2929淘帝","110/07/09","台中銀-台北",110,0,110
"9842","2929淘帝","110/07/09","新光",2,82,-80
"9843","2929淘帝","110/07/09","華南永昌-頭份",72,0,72
"9844","2929淘帝","110/07/09","摩根大通",2,63,-61
"9845","2929淘帝","110/07/09","合庫-高雄",71,0,71
"9846","2929淘帝","110/07/09","第一金-路竹",0,50,-50
"9847","2929淘帝","110/07/09","高橋-龍潭",37,0,37
"9848","2929淘帝","110/07/09","港商麥格理",0,42,-42
"9849","2929淘帝","110/07/09","新光-台中",60,26,34
"9850","2929淘帝","110/07/09","陽信-石牌",0,40,-40
"9851","2929淘帝","110/07/09","元富-大裕",22,1,21
"9852","2929淘帝","110/07/09","台新-左楠",1,39,-38
"9853","2929淘帝","110/07/09","合庫-鳳山",20,0,20
"9854","2929淘帝","110/07/09","凱基-桃園",3,29,-26
"9855","2929淘帝","110/07/09","元大-員林",22,2,20
"9856","2929淘帝","110/07/09","兆豐-內湖",0,25,-25
"9857","2929淘帝","110/07/09","台新-建北",15,0,15
"9858","2929淘帝","110/07/09","元大-北港",0,20,-20
"9859","2929淘帝","110/07/09","兆豐-桃園",13,0,13
"9860","2929淘帝","110/07/09","富邦-北港",0,19,-19
"9861","2929淘帝","110/07/09","兆豐-忠孝",10,0,10
"9862","2929淘帝","110/07/09","富邦-花蓮",0,17,-17
"9863","2929淘帝","110/07/09","國票-敦北法人",10,0,10
"9864","2929淘帝","110/07/09","國泰-台中",2,17,-15
"9865","2929淘帝","110/07/09","永豐金-博愛",10,0,10
"9866","2929淘帝","110/07/09","群益金鼎-彰化",0,15,-15
"9867","2929淘帝","110/07/09","群益金鼎-潭子",8,0,8
"9868","2929淘帝","110/07/09","元大-博愛",0,14,-14
"9869","2929淘帝","110/07/09","富邦-南屯",8,0,8
"9870","2929淘帝","110/07/09","日盛-板橋",0,13,-13
"9871","5410國眾","110/07/09","元大-新盛",14,0,14
"9872","5410國眾","110/07/09","(牛牛牛)亞-鑫豐",1,41,-40
"9873","5410國眾","110/07/09","台灣企銀-民雄",10,0,10
"9874","5410國眾","110/07/09","元富-嘉義",0,25,-25
"9875","5410國眾","110/07/09","元富-虎尾",9,0,9
"9876","5410國眾","110/07/09","凱基-高美館",0,10,-10
"9877","5410國眾","110/07/09","摩根大通",10,1,9
"9878","5410國眾","110/07/09","凱基-城中",0,10,-10
"9879","5410國眾","110/07/09","兆豐-北高雄",7,0,7
"9880","5410國眾","110/07/09","元大-頭份",0,10,-10
"9881","5410國眾","110/07/09","凱基-台北",8,1,7
"9882","5410國眾","110/07/09","群益金鼎-丹鳳",0,7,-7
"9883","5410國眾","110/07/09","華南永昌-公誠",7,0,7
"9884","5410國眾","110/07/09","凱基-復興",0,7,-7
"9885","5410國眾","110/07/09","香港上海匯豐",6,0,6
"9886","5410國眾","110/07/09","元大-員林",0,7,-7
"9887","5410國眾","110/07/09","凱基-中壢",6,0,6
"9888","5410國眾","110/07/09","富邦-竹東",0,6,-6
"9889","5410國眾","110/07/09","華南永昌-南京",6,0,6
"9890","5410國眾","110/07/09","亞東-高雄",0,5,-5
"9891","5410國眾","110/07/09","統一-三重",5,0,5
"9892","5410國眾","110/07/09","大慶-中壢",1,6,-5
"9893","5410國眾","110/07/09","富邦-宜蘭",5,0,5
"9894","5410國眾","110/07/09","群益金鼎-中港",0,5,-5
"9895","5410國眾","110/07/09","元大-崇德",5,0,5
"9896","5410國眾","110/07/09","元大-八德",0,5,-5
"9897","5410國眾","110/07/09","元大-博愛",5,0,5
"9898","5410國眾","110/07/09","富邦-基隆",0,4,-4
"9899","5410國眾","110/07/09","元大-龍潭",5,0,5
"9900","5410國眾","110/07/09","臺銀-新竹",0,3,-3
"9901","2841台開","110/07/09","日盛-雙和",102,0,102
"9902","2841台開","110/07/09","港商野村",0,129,-129
"9903","2841台開","110/07/09","元大-館前",70,0,70
"9904","2841台開","110/07/09","兆豐-永和",0,100,-100
"9905","2841台開","110/07/09","凱基-文心",50,0,50
"9906","2841台開","110/07/09","台新證券",7,28,-21
"9907","2841台開","110/07/09","富邦-嘉義",40,0,40
"9908","2841台開","110/07/09","國票-北高雄",0,20,-20
"9909","2841台開","110/07/09","美商高盛",15,0,15
"9910","2841台開","110/07/09","永豐金-敦南",29,46,-17
"9911","2841台開","110/07/09","台中銀",15,0,15
"9912","2841台開","110/07/09","合庫-基隆",0,12,-12
"9913","2841台開","110/07/09","新光",11,0,11
"9914","2841台開","110/07/09","中國信託-松江",0,12,-12
"9915","2841台開","110/07/09","華南永昌-長虹",10,0,10
"9916","2841台開","110/07/09","兆豐-城中",0,12,-12
"9917","2841台開","110/07/09","永豐金-南投",10,0,10
"9918","2841台開","110/07/09","台中銀-豐原",0,10,-10
"9919","2841台開","110/07/09","合庫-桃園",7,0,7
"9920","2841台開","110/07/09","兆豐-景美",0,10,-10
"9921","2841台開","110/07/09","群益金鼎-古亭",7,0,7
"9922","2841台開","110/07/09","群益金鼎-基隆",0,10,-10
"9923","2841台開","110/07/09","國泰-敦南",6,0,6
"9924","2841台開","110/07/09","元大-北三重",0,10,-10
"9925","2841台開","110/07/09","凱基-桃園",8,2,6
"9926","2841台開","110/07/09","(牛牛牛)亞-網路",0,9,-9
"9927","2841台開","110/07/09","日盛證券",5,0,5
"9928","2841台開","110/07/09","台新-高雄",1,10,-9
"9929","2841台開","110/07/09","元富-文心",5,0,5
"9930","2841台開","110/07/09","凱基-台北",0,7,-7
"9931","6207雷科","110/07/09","群益金鼎-新竹",47,0,47
"9932","6207雷科","110/07/09","新光",7,24,-17
"9933","6207雷科","110/07/09","永豐金-三重",31,0,31
"9934","6207雷科","110/07/09","日盛-和美",0,15,-15
"9935","6207雷科","110/07/09","新加坡商瑞銀",33,5,28
"9936","6207雷科","110/07/09","國泰-台南",0,15,-15
"9937","6207雷科","110/07/09","元大-高雄",26,0,26
"9938","6207雷科","110/07/09","華南永昌-古亭",0,14,-14
"9939","6207雷科","110/07/09","統一-員林",22,0,22
"9940","6207雷科","110/07/09","土銀-白河",0,11,-11
"9941","6207雷科","110/07/09","台新-高雄",22,0,22
"9942","6207雷科","110/07/09","日盛-台南",0,10,-10
"9943","6207雷科","110/07/09","摩根大通",34,17,17
"9944","6207雷科","110/07/09","元富-林園",0,10,-10
"9945","6207雷科","110/07/09","元大-博愛",17,1,16
"9946","6207雷科","110/07/09","富邦-園區",0,10,-10
"9947","6207雷科","110/07/09","日茂-埔里",12,0,12
"9948","6207雷科","110/07/09","元大-上新莊",0,10,-10
"9949","6207雷科","110/07/09","國泰-台中",17,6,11
"9950","6207雷科","110/07/09","永豐金-南京",0,10,-10
"9951","6207雷科","110/07/09","富邦-三重",10,0,10
"9952","6207雷科","110/07/09","兆豐-小港",0,6,-6
"9953","6207雷科","110/07/09","元大-沙鹿",10,0,10
"9954","6207雷科","110/07/09","富邦-羅東",1,7,-6
"9955","6207雷科","110/07/09","元大-八德",10,0,10
"9956","6207雷科","110/07/09","元大-土城永寧",0,6,-6
"9957","6207雷科","110/07/09","第一金-路竹",11,2,9
"9958","6207雷科","110/07/09","永豐金-板盛",0,6,-6
"9959","6207雷科","110/07/09","統一-南京",5,0,5
"9960","6207雷科","110/07/09","日盛-板橋",0,5,-5
"9961","3679新至陞","110/07/09","元大-大天母",10,0,10
"9962","3679新至陞","110/07/09","第一金-光復",0,11,-11
"9963","3679新至陞","110/07/09","日盛-樹林",9,0,9
"9964","3679新至陞","110/07/09","瑞士信貸",0,8,-8
"9965","3679新至陞","110/07/09","凱基-台北",11,2,9
"9966","3679新至陞","110/07/09","大慶-苗栗",0,5,-5
"9967","3679新至陞","110/07/09","華南永昌-小港",8,0,8
"9968","3679新至陞","110/07/09","元大-永春",0,5,-5
"9969","3679新至陞","110/07/09","兆豐-來福",7,0,7
"9970","3679新至陞","110/07/09","日盛-和美",0,4,-4
"9971","3679新至陞","110/07/09","香港上海匯豐",5,0,5
"9972","3679新至陞","110/07/09","元大-雙和",0,3,-3
"9973","3679新至陞","110/07/09","台中銀-員林",3,0,3
"9974","3679新至陞","110/07/09","永豐金-屏東",0,3,-3
"9975","3679新至陞","110/07/09","新光",3,0,3
"9976","3679新至陞","110/07/09","彰銀",0,2,-2
"9977","3679新至陞","110/07/09","土銀-花蓮",2,0,2
"9978","3679新至陞","110/07/09","宏遠-館前",0,2,-2
"9979","3679新至陞","110/07/09","第一金-澎湖",2,0,2
"9980","3679新至陞","110/07/09","港商野村",0,2,-2
"9981","3679新至陞","110/07/09","摩根大通",2,0,2
"9982","3679新至陞","110/07/09","大昌-新店",0,2,-2
"9983","3679新至陞","110/07/09","國泰-敦南",2,0,2
"9984","3679新至陞","110/07/09","元大-新莊",0,2,-2
"9985","3679新至陞","110/07/09","元大-淡水",4,2,2
"9986","3679新至陞","110/07/09","元大-板橋",0,2,-2
"9987","3679新至陞","110/07/09","日盛-士林",1,0,1
"9988","3679新至陞","110/07/09","台灣摩根士丹利",0,1,-1
"9989","3679新至陞","110/07/09","日盛-信義",1,0,1
"9990","3679新至陞","110/07/09","第一金-高雄",0,1,-1
"9991","2727王品","110/07/09","台灣匯立證券",90,0,90
"9992","2727王品","110/07/09","台灣摩根士丹利",0,267,-267
"9993","2727王品","110/07/09","國泰-敦南",166,84,82
"9994","2727王品","110/07/09","富邦-台北",35,299,-264
"9995","2727王品","110/07/09","富邦-仁愛",56,12,44
"9996","2727王品","110/07/09","凱基-台北",174,296,-122
"9997","2727王品","110/07/09","台新證券",109,66,43
"9998","2727王品","110/07/09","第一金",2,102,-100
"9999","2727王品","110/07/09","新光",117,87,30
"10000","2727王品","110/07/09","群益金鼎-大安",0,80,-80
"10001","2727王品","110/07/09","臺銀-臺中",35,6,29
"10002","2727王品","110/07/09","兆豐-大安",7,60,-53
"10003","2727王品","110/07/09","元大-桃園",32,3,29
"10004","2727王品","110/07/09","永豐金-南投",0,50,-50
"10005","2727王品","110/07/09","元富-宜蘭",34,6,28
"10006","2727王品","110/07/09","新加坡商瑞銀",6,46,-40
"10007","2727王品","110/07/09","玉山-台中",34,8,26
"10008","2727王品","110/07/09","合庫-彰化",11,50,-39
"10009","2727王品","110/07/09","群益金鼎-宜蘭",30,4,26
"10010","2727王品","110/07/09","永豐金-萬盛",13,52,-39
"10011","2727王品","110/07/09","富邦-台中",42,16,26
"10012","2727王品","110/07/09","瑞士信貸",0,34,-34
"10013","2727王品","110/07/09","第一金-豐原",25,1,24
"10014","2727王品","110/07/09","元大-和平",4,35,-31
"10015","2727王品","110/07/09","臺銀",30,8,22
"10016","2727王品","110/07/09","美林",14,44,-30
"10017","2727王品","110/07/09","兆豐-來福",23,1,22
"10018","2727王品","110/07/09","元大-員林",9,38,-29
"10019","2727王品","110/07/09","玉山-士林",22,2,20
"10020","2727王品","110/07/09","元富-西松",4,31,-27
"10021","1570力肯","110/07/09","凱基-台北",30,1,29
"10022","1570力肯","110/07/09","群益金鼎-彰化",0,20,-20
"10023","1570力肯","110/07/09","新光-台南",20,0,20
"10024","1570力肯","110/07/09","元大-土城學府",0,20,-20
"10025","1570力肯","110/07/09","元大-高雄",20,0,20
"10026","1570力肯","110/07/09","元大-大統",0,16,-16
"10027","1570力肯","110/07/09","國票-中正",12,0,12
"10028","1570力肯","110/07/09","元大-新營",0,11,-11
"10029","1570力肯","110/07/09","日盛-高雄",6,0,6
"10030","1570力肯","110/07/09","元大-和平",0,10,-10
"10031","1570力肯","110/07/09","元富-緯城",6,0,6
"10032","1570力肯","110/07/09","元大-草屯",0,10,-10
"10033","1570力肯","110/07/09","群益金鼎-台南",6,0,6
"10034","1570力肯","110/07/09","元大-鹿港",0,9,-9
"10035","1570力肯","110/07/09","華南永昌-岡山",6,0,6
"10036","1570力肯","110/07/09","合庫-基隆",0,7,-7
"10037","1570力肯","110/07/09","統一-中壢",5,0,5
"10038","1570力肯","110/07/09","摩根大通",2,8,-6
"10039","1570力肯","110/07/09","凱基-三峽",5,0,5
"10040","1570力肯","110/07/09","台灣企銀-豐原",0,4,-4
"10041","1570力肯","110/07/09","大昌-樹林",4,0,4
"10042","1570力肯","110/07/09","日盛-桃園",0,4,-4
"10043","1570力肯","110/07/09","新光",3,0,3
"10044","1570力肯","110/07/09","國泰-高雄",0,3,-3
"10045","1570力肯","110/07/09","富邦-新竹華信",3,0,3
"10046","1570力肯","110/07/09","永豐金-敦南",0,3,-3
"10047","1570力肯","110/07/09","合庫-台中",2,0,2
"10048","1570力肯","110/07/09","土銀-彰化",0,2,-2
"10049","1570力肯","110/07/09","臺銀-臺中",2,0,2
"10050","1570力肯","110/07/09","臺銀-鳳山",0,2,-2
"10051","6180橘子","110/07/09","摩根大通",63,1,62
"10052","6180橘子","110/07/09","元大-南京",1,32,-31
"10053","6180橘子","110/07/09","富邦-陽明",73,33,40
"10054","6180橘子","110/07/09","群益金鼎-台北",0,25,-25
"10055","6180橘子","110/07/09","新加坡商瑞銀",31,0,31
"10056","6180橘子","110/07/09","兆豐-復興",0,21,-21
"10057","6180橘子","110/07/09","美商高盛",25,0,25
"10058","6180橘子","110/07/09","永豐金-嘉義",0,21,-21
"10059","6180橘子","110/07/09","凱基-台北",26,10,16
"10060","6180橘子","110/07/09","凱基-中壢",8,24,-16
"10061","6180橘子","110/07/09","華南永昌-楠梓",13,0,13
"10062","6180橘子","110/07/09","致和-崇德",0,15,-15
"10063","6180橘子","110/07/09","華南永昌-朴子",11,0,11
"10064","6180橘子","110/07/09","群益金鼎-屏東",0,15,-15
"10065","6180橘子","110/07/09","元大-北港",11,0,11
"10066","6180橘子","110/07/09","群益金鼎-中山",0,15,-15
"10067","6180橘子","110/07/09","元大-成功",10,1,9
"10068","6180橘子","110/07/09","瑞士信貸",1,15,-14
"10069","6180橘子","110/07/09","新光",26,18,8
"10070","6180橘子","110/07/09","日盛-二林",0,10,-10
"10071","6180橘子","110/07/09","統一-三重",6,0,6
"10072","6180橘子","110/07/09","凱基-東門",0,10,-10
"10073","6180橘子","110/07/09","群益金鼎-嘉義",6,0,6
"10074","6180橘子","110/07/09","華南永昌-三重",0,10,-10
"10075","6180橘子","110/07/09","元大-員林中山",6,0,6
"10076","6180橘子","110/07/09","元大-彰化民生",1,11,-10
"10077","6180橘子","110/07/09","合庫-鳳山",5,0,5
"10078","6180橘子","110/07/09","永豐金-新店",1,11,-10
"10079","6180橘子","110/07/09","富邦-建國",6,1,5
"10080","6180橘子","110/07/09","群益金鼎-丹鳳",0,8,-8
"10081","2390云辰","110/07/09","摩根大通",279,56,223
"10082","2390云辰","110/07/09","元大-天母",0,127,-127
"10083","2390云辰","110/07/09","日盛-鳳山",110,2,108
"10084","2390云辰","110/07/09","中國信託-文心",5,109,-104
"10085","2390云辰","110/07/09","宏遠證券",100,0,100
"10086","2390云辰","110/07/09","永豐金-復興",0,55,-55
"10087","2390云辰","110/07/09","元大-大里",63,6,57
"10088","2390云辰","110/07/09","凱基-台北",239,286,-47
"10089","2390云辰","110/07/09","凱基-八德",59,10,49
"10090","2390云辰","110/07/09","德信",2,32,-30
"10091","2390云辰","110/07/09","合庫-新竹",40,0,40
"10092","2390云辰","110/07/09","兆豐-桃鶯",2,32,-30
"10093","2390云辰","110/07/09","國票",40,1,39
"10094","2390云辰","110/07/09","致和-南京",0,30,-30
"10095","2390云辰","110/07/09","新加坡商瑞銀",49,13,36
"10096","2390云辰","110/07/09","富邦-虎尾",1,31,-30
"10097","2390云辰","110/07/09","統一-新台中",36,2,34
"10098","2390云辰","110/07/09","元大-善化",2,31,-29
"10099","2390云辰","110/07/09","國票-嘉義",31,0,31
"10100","2390云辰","110/07/09","富邦-板橋",0,27,-27
"10101","2390云辰","110/07/09","華南永昌",35,7,28
"10102","2390云辰","110/07/09","富邦-永和",3,28,-25
"10103","2390云辰","110/07/09","玉山-台中",49,22,27
"10104","2390云辰","110/07/09","第一金-自由",20,44,-24
"10105","2390云辰","110/07/09","華南永昌-敦南",25,0,25
"10106","2390云辰","110/07/09","凱基-內湖",0,24,-24
"10107","2390云辰","110/07/09","新光-高雄",27,4,23
"10108","2390云辰","110/07/09","元大-汐止",1,24,-23
"10109","2390云辰","110/07/09","台灣摩根士丹利",85,63,22
"10110","2390云辰","110/07/09","新光-台中",12,33,-21
"10111","4903聯光通","110/07/09","元大-敦南",10,0,10
"10112","4903聯光通","110/07/09","第一金-台中",0,12,-12
"10113","4903聯光通","110/07/09","凱基-士林",5,0,5
"10114","4903聯光通","110/07/09","日盛-忠孝",0,3,-3
"10115","4903聯光通","110/07/09","元大-苗栗",5,0,5
"10116","4903聯光通","110/07/09","群益金鼎-崇德",0,3,-3
"10117","4903聯光通","110/07/09","元大-屏南",3,0,3
"10118","4903聯光通","110/07/09","國票-內壢",0,2,-2
"10119","4903聯光通","110/07/09","中國信託-永康",1,0,1
"10120","4903聯光通","110/07/09","康和-南崁",0,2,-2
"10121","4903聯光通","110/07/09","玉山證券",1,0,1
"10122","4903聯光通","110/07/09","新光-台中",0,2,-2
"10123","4903聯光通","110/07/09","元大-太平",4,3,1
"10124","4903聯光通","110/07/09","玉山-城中",0,2,-2
"10125","4903聯光通","110/07/09","永豐金-嘉義",1,0,1
"10126","4903聯光通","110/07/09","中國信託-文心",0,1,-1
"10127","4903聯光通","110/07/09","大昌",0,0,0
"10128","4903聯光通","110/07/09","大昌",0,0,0
"10129","4903聯光通","110/07/09","中農",0,0,0
"10130","4903聯光通","110/07/09","中農",0,0,0
"10131","4903聯光通","110/07/09","",NA,NA,NA
"10132","4903聯光通","110/07/09","",NA,NA,NA
"10133","4903聯光通","110/07/09","",NA,NA,NA
"10134","4903聯光通","110/07/09","",NA,NA,NA
"10135","4903聯光通","110/07/09","",NA,NA,NA
"10136","4903聯光通","110/07/09","",NA,NA,NA
"10137","4903聯光通","110/07/09","",NA,NA,NA
"10138","4903聯光通","110/07/09","",NA,NA,NA
"10139","4903聯光通","110/07/09","",NA,NA,NA
"10140","4903聯光通","110/07/09","",NA,NA,NA
"10141","2929淘帝","110/07/09","台中銀-台北",110,0,110
"10142","2929淘帝","110/07/09","新光",2,82,-80
"10143","2929淘帝","110/07/09","華南永昌-頭份",72,0,72
"10144","2929淘帝","110/07/09","摩根大通",2,63,-61
"10145","2929淘帝","110/07/09","合庫-高雄",71,0,71
"10146","2929淘帝","110/07/09","第一金-路竹",0,50,-50
"10147","2929淘帝","110/07/09","高橋-龍潭",37,0,37
"10148","2929淘帝","110/07/09","港商麥格理",0,42,-42
"10149","2929淘帝","110/07/09","新光-台中",60,26,34
"10150","2929淘帝","110/07/09","陽信-石牌",0,40,-40
"10151","2929淘帝","110/07/09","元富-大裕",22,1,21
"10152","2929淘帝","110/07/09","台新-左楠",1,39,-38
"10153","2929淘帝","110/07/09","合庫-鳳山",20,0,20
"10154","2929淘帝","110/07/09","凱基-桃園",3,29,-26
"10155","2929淘帝","110/07/09","元大-員林",22,2,20
"10156","2929淘帝","110/07/09","兆豐-內湖",0,25,-25
"10157","2929淘帝","110/07/09","台新-建北",15,0,15
"10158","2929淘帝","110/07/09","元大-北港",0,20,-20
"10159","2929淘帝","110/07/09","兆豐-桃園",13,0,13
"10160","2929淘帝","110/07/09","富邦-北港",0,19,-19
"10161","2929淘帝","110/07/09","兆豐-忠孝",10,0,10
"10162","2929淘帝","110/07/09","富邦-花蓮",0,17,-17
"10163","2929淘帝","110/07/09","國票-敦北法人",10,0,10
"10164","2929淘帝","110/07/09","國泰-台中",2,17,-15
"10165","2929淘帝","110/07/09","永豐金-博愛",10,0,10
"10166","2929淘帝","110/07/09","群益金鼎-彰化",0,15,-15
"10167","2929淘帝","110/07/09","群益金鼎-潭子",8,0,8
"10168","2929淘帝","110/07/09","元大-博愛",0,14,-14
"10169","2929淘帝","110/07/09","富邦-南屯",8,0,8
"10170","2929淘帝","110/07/09","日盛-板橋",0,13,-13
"10171","5410國眾","110/07/09","元大-新盛",14,0,14
"10172","5410國眾","110/07/09","(牛牛牛)亞-鑫豐",1,41,-40
"10173","5410國眾","110/07/09","台灣企銀-民雄",10,0,10
"10174","5410國眾","110/07/09","元富-嘉義",0,25,-25
"10175","5410國眾","110/07/09","元富-虎尾",9,0,9
"10176","5410國眾","110/07/09","凱基-高美館",0,10,-10
"10177","5410國眾","110/07/09","摩根大通",10,1,9
"10178","5410國眾","110/07/09","凱基-城中",0,10,-10
"10179","5410國眾","110/07/09","兆豐-北高雄",7,0,7
"10180","5410國眾","110/07/09","元大-頭份",0,10,-10
"10181","5410國眾","110/07/09","凱基-台北",8,1,7
"10182","5410國眾","110/07/09","群益金鼎-丹鳳",0,7,-7
"10183","5410國眾","110/07/09","華南永昌-公誠",7,0,7
"10184","5410國眾","110/07/09","凱基-復興",0,7,-7
"10185","5410國眾","110/07/09","香港上海匯豐",6,0,6
"10186","5410國眾","110/07/09","元大-員林",0,7,-7
"10187","5410國眾","110/07/09","凱基-中壢",6,0,6
"10188","5410國眾","110/07/09","富邦-竹東",0,6,-6
"10189","5410國眾","110/07/09","華南永昌-南京",6,0,6
"10190","5410國眾","110/07/09","亞東-高雄",0,5,-5
"10191","5410國眾","110/07/09","統一-三重",5,0,5
"10192","5410國眾","110/07/09","大慶-中壢",1,6,-5
"10193","5410國眾","110/07/09","富邦-宜蘭",5,0,5
"10194","5410國眾","110/07/09","群益金鼎-中港",0,5,-5
"10195","5410國眾","110/07/09","元大-崇德",5,0,5
"10196","5410國眾","110/07/09","元大-八德",0,5,-5
"10197","5410國眾","110/07/09","元大-博愛",5,0,5
"10198","5410國眾","110/07/09","富邦-基隆",0,4,-4
"10199","5410國眾","110/07/09","元大-龍潭",5,0,5
"10200","5410國眾","110/07/09","臺銀-新竹",0,3,-3
"10201","2841台開","110/07/09","日盛-雙和",102,0,102
"10202","2841台開","110/07/09","港商野村",0,129,-129
"10203","2841台開","110/07/09","元大-館前",70,0,70
"10204","2841台開","110/07/09","兆豐-永和",0,100,-100
"10205","2841台開","110/07/09","凱基-文心",50,0,50
"10206","2841台開","110/07/09","台新證券",7,28,-21
"10207","2841台開","110/07/09","富邦-嘉義",40,0,40
"10208","2841台開","110/07/09","國票-北高雄",0,20,-20
"10209","2841台開","110/07/09","美商高盛",15,0,15
"10210","2841台開","110/07/09","永豐金-敦南",29,46,-17
"10211","2841台開","110/07/09","台中銀",15,0,15
"10212","2841台開","110/07/09","合庫-基隆",0,12,-12
"10213","2841台開","110/07/09","新光",11,0,11
"10214","2841台開","110/07/09","中國信託-松江",0,12,-12
"10215","2841台開","110/07/09","華南永昌-長虹",10,0,10
"10216","2841台開","110/07/09","兆豐-城中",0,12,-12
"10217","2841台開","110/07/09","永豐金-南投",10,0,10
"10218","2841台開","110/07/09","台中銀-豐原",0,10,-10
"10219","2841台開","110/07/09","合庫-桃園",7,0,7
"10220","2841台開","110/07/09","兆豐-景美",0,10,-10
"10221","2841台開","110/07/09","群益金鼎-古亭",7,0,7
"10222","2841台開","110/07/09","群益金鼎-基隆",0,10,-10
"10223","2841台開","110/07/09","國泰-敦南",6,0,6
"10224","2841台開","110/07/09","元大-北三重",0,10,-10
"10225","2841台開","110/07/09","凱基-桃園",8,2,6
"10226","2841台開","110/07/09","(牛牛牛)亞-網路",0,9,-9
"10227","2841台開","110/07/09","日盛證券",5,0,5
"10228","2841台開","110/07/09","台新-高雄",1,10,-9
"10229","2841台開","110/07/09","元富-文心",5,0,5
"10230","2841台開","110/07/09","凱基-台北",0,7,-7
"10231","6207雷科","110/07/09","群益金鼎-新竹",47,0,47
"10232","6207雷科","110/07/09","新光",7,24,-17
"10233","6207雷科","110/07/09","永豐金-三重",31,0,31
"10234","6207雷科","110/07/09","日盛-和美",0,15,-15
"10235","6207雷科","110/07/09","新加坡商瑞銀",33,5,28
"10236","6207雷科","110/07/09","國泰-台南",0,15,-15
"10237","6207雷科","110/07/09","元大-高雄",26,0,26
"10238","6207雷科","110/07/09","華南永昌-古亭",0,14,-14
"10239","6207雷科","110/07/09","統一-員林",22,0,22
"10240","6207雷科","110/07/09","土銀-白河",0,11,-11
"10241","6207雷科","110/07/09","台新-高雄",22,0,22
"10242","6207雷科","110/07/09","日盛-台南",0,10,-10
"10243","6207雷科","110/07/09","摩根大通",34,17,17
"10244","6207雷科","110/07/09","元富-林園",0,10,-10
"10245","6207雷科","110/07/09","元大-博愛",17,1,16
"10246","6207雷科","110/07/09","富邦-園區",0,10,-10
"10247","6207雷科","110/07/09","日茂-埔里",12,0,12
"10248","6207雷科","110/07/09","元大-上新莊",0,10,-10
"10249","6207雷科","110/07/09","國泰-台中",17,6,11
"10250","6207雷科","110/07/09","永豐金-南京",0,10,-10
"10251","6207雷科","110/07/09","富邦-三重",10,0,10
"10252","6207雷科","110/07/09","兆豐-小港",0,6,-6
"10253","6207雷科","110/07/09","元大-沙鹿",10,0,10
"10254","6207雷科","110/07/09","富邦-羅東",1,7,-6
"10255","6207雷科","110/07/09","元大-八德",10,0,10
"10256","6207雷科","110/07/09","元大-土城永寧",0,6,-6
"10257","6207雷科","110/07/09","第一金-路竹",11,2,9
"10258","6207雷科","110/07/09","永豐金-板盛",0,6,-6
"10259","6207雷科","110/07/09","統一-南京",5,0,5
"10260","6207雷科","110/07/09","日盛-板橋",0,5,-5
"10261","3679新至陞","110/07/09","元大-大天母",10,0,10
"10262","3679新至陞","110/07/09","第一金-光復",0,11,-11
"10263","3679新至陞","110/07/09","日盛-樹林",9,0,9
"10264","3679新至陞","110/07/09","瑞士信貸",0,8,-8
"10265","3679新至陞","110/07/09","凱基-台北",11,2,9
"10266","3679新至陞","110/07/09","大慶-苗栗",0,5,-5
"10267","3679新至陞","110/07/09","華南永昌-小港",8,0,8
"10268","3679新至陞","110/07/09","元大-永春",0,5,-5
"10269","3679新至陞","110/07/09","兆豐-來福",7,0,7
"10270","3679新至陞","110/07/09","日盛-和美",0,4,-4
"10271","3679新至陞","110/07/09","香港上海匯豐",5,0,5
"10272","3679新至陞","110/07/09","元大-雙和",0,3,-3
"10273","3679新至陞","110/07/09","台中銀-員林",3,0,3
"10274","3679新至陞","110/07/09","永豐金-屏東",0,3,-3
"10275","3679新至陞","110/07/09","新光",3,0,3
"10276","3679新至陞","110/07/09","彰銀",0,2,-2
"10277","3679新至陞","110/07/09","土銀-花蓮",2,0,2
"10278","3679新至陞","110/07/09","宏遠-館前",0,2,-2
"10279","3679新至陞","110/07/09","第一金-澎湖",2,0,2
"10280","3679新至陞","110/07/09","港商野村",0,2,-2
"10281","3679新至陞","110/07/09","摩根大通",2,0,2
"10282","3679新至陞","110/07/09","大昌-新店",0,2,-2
"10283","3679新至陞","110/07/09","國泰-敦南",2,0,2
"10284","3679新至陞","110/07/09","元大-新莊",0,2,-2
"10285","3679新至陞","110/07/09","元大-淡水",4,2,2
"10286","3679新至陞","110/07/09","元大-板橋",0,2,-2
"10287","3679新至陞","110/07/09","日盛-士林",1,0,1
"10288","3679新至陞","110/07/09","台灣摩根士丹利",0,1,-1
"10289","3679新至陞","110/07/09","日盛-信義",1,0,1
"10290","3679新至陞","110/07/09","第一金-高雄",0,1,-1
"10291","2727王品","110/07/09","台灣匯立證券",90,0,90
"10292","2727王品","110/07/09","台灣摩根士丹利",0,267,-267
"10293","2727王品","110/07/09","國泰-敦南",166,84,82
"10294","2727王品","110/07/09","富邦-台北",35,299,-264
"10295","2727王品","110/07/09","富邦-仁愛",56,12,44
"10296","2727王品","110/07/09","凱基-台北",174,296,-122
"10297","2727王品","110/07/09","台新證券",109,66,43
"10298","2727王品","110/07/09","第一金",2,102,-100
"10299","2727王品","110/07/09","新光",117,87,30
"10300","2727王品","110/07/09","群益金鼎-大安",0,80,-80
"10301","2727王品","110/07/09","臺銀-臺中",35,6,29
"10302","2727王品","110/07/09","兆豐-大安",7,60,-53
"10303","2727王品","110/07/09","元大-桃園",32,3,29
"10304","2727王品","110/07/09","永豐金-南投",0,50,-50
"10305","2727王品","110/07/09","元富-宜蘭",34,6,28
"10306","2727王品","110/07/09","新加坡商瑞銀",6,46,-40
"10307","2727王品","110/07/09","玉山-台中",34,8,26
"10308","2727王品","110/07/09","合庫-彰化",11,50,-39
"10309","2727王品","110/07/09","群益金鼎-宜蘭",30,4,26
"10310","2727王品","110/07/09","永豐金-萬盛",13,52,-39
"10311","2727王品","110/07/09","富邦-台中",42,16,26
"10312","2727王品","110/07/09","瑞士信貸",0,34,-34
"10313","2727王品","110/07/09","第一金-豐原",25,1,24
"10314","2727王品","110/07/09","元大-和平",4,35,-31
"10315","2727王品","110/07/09","臺銀",30,8,22
"10316","2727王品","110/07/09","美林",14,44,-30
"10317","2727王品","110/07/09","兆豐-來福",23,1,22
"10318","2727王品","110/07/09","元大-員林",9,38,-29
"10319","2727王品","110/07/09","玉山-士林",22,2,20
"10320","2727王品","110/07/09","元富-西松",4,31,-27
"10321","1570力肯","110/07/09","凱基-台北",30,1,29
"10322","1570力肯","110/07/09","群益金鼎-彰化",0,20,-20
"10323","1570力肯","110/07/09","新光-台南",20,0,20
"10324","1570力肯","110/07/09","元大-土城學府",0,20,-20
"10325","1570力肯","110/07/09","元大-高雄",20,0,20
"10326","1570力肯","110/07/09","元大-大統",0,16,-16
"10327","1570力肯","110/07/09","國票-中正",12,0,12
"10328","1570力肯","110/07/09","元大-新營",0,11,-11
"10329","1570力肯","110/07/09","日盛-高雄",6,0,6
"10330","1570力肯","110/07/09","元大-和平",0,10,-10
"10331","1570力肯","110/07/09","元富-緯城",6,0,6
"10332","1570力肯","110/07/09","元大-草屯",0,10,-10
"10333","1570力肯","110/07/09","群益金鼎-台南",6,0,6
"10334","1570力肯","110/07/09","元大-鹿港",0,9,-9
"10335","1570力肯","110/07/09","華南永昌-岡山",6,0,6
"10336","1570力肯","110/07/09","合庫-基隆",0,7,-7
"10337","1570力肯","110/07/09","統一-中壢",5,0,5
"10338","1570力肯","110/07/09","摩根大通",2,8,-6
"10339","1570力肯","110/07/09","凱基-三峽",5,0,5
"10340","1570力肯","110/07/09","台灣企銀-豐原",0,4,-4
"10341","1570力肯","110/07/09","大昌-樹林",4,0,4
"10342","1570力肯","110/07/09","日盛-桃園",0,4,-4
"10343","1570力肯","110/07/09","新光",3,0,3
"10344","1570力肯","110/07/09","國泰-高雄",0,3,-3
"10345","1570力肯","110/07/09","富邦-新竹華信",3,0,3
"10346","1570力肯","110/07/09","永豐金-敦南",0,3,-3
"10347","1570力肯","110/07/09","合庫-台中",2,0,2
"10348","1570力肯","110/07/09","土銀-彰化",0,2,-2
"10349","1570力肯","110/07/09","臺銀-臺中",2,0,2
"10350","1570力肯","110/07/09","臺銀-鳳山",0,2,-2
"10351","6180橘子","110/07/09","摩根大通",63,1,62
"10352","6180橘子","110/07/09","元大-南京",1,32,-31
"10353","6180橘子","110/07/09","富邦-陽明",73,33,40
"10354","6180橘子","110/07/09","群益金鼎-台北",0,25,-25
"10355","6180橘子","110/07/09","新加坡商瑞銀",31,0,31
"10356","6180橘子","110/07/09","兆豐-復興",0,21,-21
"10357","6180橘子","110/07/09","美商高盛",25,0,25
"10358","6180橘子","110/07/09","永豐金-嘉義",0,21,-21
"10359","6180橘子","110/07/09","凱基-台北",26,10,16
"10360","6180橘子","110/07/09","凱基-中壢",8,24,-16
"10361","6180橘子","110/07/09","華南永昌-楠梓",13,0,13
"10362","6180橘子","110/07/09","致和-崇德",0,15,-15
"10363","6180橘子","110/07/09","華南永昌-朴子",11,0,11
"10364","6180橘子","110/07/09","群益金鼎-屏東",0,15,-15
"10365","6180橘子","110/07/09","元大-北港",11,0,11
"10366","6180橘子","110/07/09","群益金鼎-中山",0,15,-15
"10367","6180橘子","110/07/09","元大-成功",10,1,9
"10368","6180橘子","110/07/09","瑞士信貸",1,15,-14
"10369","6180橘子","110/07/09","新光",26,18,8
"10370","6180橘子","110/07/09","日盛-二林",0,10,-10
"10371","6180橘子","110/07/09","統一-三重",6,0,6
"10372","6180橘子","110/07/09","凱基-東門",0,10,-10
"10373","6180橘子","110/07/09","群益金鼎-嘉義",6,0,6
"10374","6180橘子","110/07/09","華南永昌-三重",0,10,-10
"10375","6180橘子","110/07/09","元大-員林中山",6,0,6
"10376","6180橘子","110/07/09","元大-彰化民生",1,11,-10
"10377","6180橘子","110/07/09","合庫-鳳山",5,0,5
"10378","6180橘子","110/07/09","永豐金-新店",1,11,-10
"10379","6180橘子","110/07/09","富邦-建國",6,1,5
"10380","6180橘子","110/07/09","群益金鼎-丹鳳",0,8,-8
"10381","2390云辰","110/07/09","摩根大通",279,56,223
"10382","2390云辰","110/07/09","元大-天母",0,127,-127
"10383","2390云辰","110/07/09","日盛-鳳山",110,2,108
"10384","2390云辰","110/07/09","中國信託-文心",5,109,-104
"10385","2390云辰","110/07/09","宏遠證券",100,0,100
"10386","2390云辰","110/07/09","永豐金-復興",0,55,-55
"10387","2390云辰","110/07/09","元大-大里",63,6,57
"10388","2390云辰","110/07/09","凱基-台北",239,286,-47
"10389","2390云辰","110/07/09","凱基-八德",59,10,49
"10390","2390云辰","110/07/09","德信",2,32,-30
"10391","2390云辰","110/07/09","合庫-新竹",40,0,40
"10392","2390云辰","110/07/09","兆豐-桃鶯",2,32,-30
"10393","2390云辰","110/07/09","國票",40,1,39
"10394","2390云辰","110/07/09","致和-南京",0,30,-30
"10395","2390云辰","110/07/09","新加坡商瑞銀",49,13,36
"10396","2390云辰","110/07/09","富邦-虎尾",1,31,-30
"10397","2390云辰","110/07/09","統一-新台中",36,2,34
"10398","2390云辰","110/07/09","元大-善化",2,31,-29
"10399","2390云辰","110/07/09","國票-嘉義",31,0,31
"10400","2390云辰","110/07/09","富邦-板橋",0,27,-27
"10401","2390云辰","110/07/09","華南永昌",35,7,28
"10402","2390云辰","110/07/09","富邦-永和",3,28,-25
"10403","2390云辰","110/07/09","玉山-台中",49,22,27
"10404","2390云辰","110/07/09","第一金-自由",20,44,-24
"10405","2390云辰","110/07/09","華南永昌-敦南",25,0,25
"10406","2390云辰","110/07/09","凱基-內湖",0,24,-24
"10407","2390云辰","110/07/09","新光-高雄",27,4,23
"10408","2390云辰","110/07/09","元大-汐止",1,24,-23
"10409","2390云辰","110/07/09","台灣摩根士丹利",85,63,22
"10410","2390云辰","110/07/09","新光-台中",12,33,-21
"10411","4903聯光通","110/07/09","元大-敦南",10,0,10
"10412","4903聯光通","110/07/09","第一金-台中",0,12,-12
"10413","4903聯光通","110/07/09","凱基-士林",5,0,5
"10414","4903聯光通","110/07/09","日盛-忠孝",0,3,-3
"10415","4903聯光通","110/07/09","元大-苗栗",5,0,5
"10416","4903聯光通","110/07/09","群益金鼎-崇德",0,3,-3
"10417","4903聯光通","110/07/09","元大-屏南",3,0,3
"10418","4903聯光通","110/07/09","國票-內壢",0,2,-2
"10419","4903聯光通","110/07/09","中國信託-永康",1,0,1
"10420","4903聯光通","110/07/09","康和-南崁",0,2,-2
"10421","4903聯光通","110/07/09","玉山證券",1,0,1
"10422","4903聯光通","110/07/09","新光-台中",0,2,-2
"10423","4903聯光通","110/07/09","元大-太平",4,3,1
"10424","4903聯光通","110/07/09","玉山-城中",0,2,-2
"10425","4903聯光通","110/07/09","永豐金-嘉義",1,0,1
"10426","4903聯光通","110/07/09","中國信託-文心",0,1,-1
"10427","4903聯光通","110/07/09","大昌",0,0,0
"10428","4903聯光通","110/07/09","大昌",0,0,0
"10429","4903聯光通","110/07/09","中農",0,0,0
"10430","4903聯光通","110/07/09","中農",0,0,0
"10431","2929淘帝","110/07/09","台中銀-台北",110,0,110
"10432","2929淘帝","110/07/09","新光",2,82,-80
"10433","2929淘帝","110/07/09","華南永昌-頭份",72,0,72
"10434","2929淘帝","110/07/09","摩根大通",2,63,-61
"10435","2929淘帝","110/07/09","合庫-高雄",71,0,71
"10436","2929淘帝","110/07/09","第一金-路竹",0,50,-50
"10437","2929淘帝","110/07/09","高橋-龍潭",37,0,37
"10438","2929淘帝","110/07/09","港商麥格理",0,42,-42
"10439","2929淘帝","110/07/09","新光-台中",60,26,34
"10440","2929淘帝","110/07/09","陽信-石牌",0,40,-40
"10441","2929淘帝","110/07/09","元富-大裕",22,1,21
"10442","2929淘帝","110/07/09","台新-左楠",1,39,-38
"10443","2929淘帝","110/07/09","合庫-鳳山",20,0,20
"10444","2929淘帝","110/07/09","凱基-桃園",3,29,-26
"10445","2929淘帝","110/07/09","元大-員林",22,2,20
"10446","2929淘帝","110/07/09","兆豐-內湖",0,25,-25
"10447","2929淘帝","110/07/09","台新-建北",15,0,15
"10448","2929淘帝","110/07/09","元大-北港",0,20,-20
"10449","2929淘帝","110/07/09","兆豐-桃園",13,0,13
"10450","2929淘帝","110/07/09","富邦-北港",0,19,-19
"10451","2929淘帝","110/07/09","兆豐-忠孝",10,0,10
"10452","2929淘帝","110/07/09","富邦-花蓮",0,17,-17
"10453","2929淘帝","110/07/09","國票-敦北法人",10,0,10
"10454","2929淘帝","110/07/09","國泰-台中",2,17,-15
"10455","2929淘帝","110/07/09","永豐金-博愛",10,0,10
"10456","2929淘帝","110/07/09","群益金鼎-彰化",0,15,-15
"10457","2929淘帝","110/07/09","群益金鼎-潭子",8,0,8
"10458","2929淘帝","110/07/09","元大-博愛",0,14,-14
"10459","2929淘帝","110/07/09","富邦-南屯",8,0,8
"10460","2929淘帝","110/07/09","日盛-板橋",0,13,-13
"10461","5410國眾","110/07/09","元大-新盛",14,0,14
"10462","5410國眾","110/07/09","(牛牛牛)亞-鑫豐",1,41,-40
"10463","5410國眾","110/07/09","台灣企銀-民雄",10,0,10
"10464","5410國眾","110/07/09","元富-嘉義",0,25,-25
"10465","5410國眾","110/07/09","元富-虎尾",9,0,9
"10466","5410國眾","110/07/09","凱基-高美館",0,10,-10
"10467","5410國眾","110/07/09","摩根大通",10,1,9
"10468","5410國眾","110/07/09","凱基-城中",0,10,-10
"10469","5410國眾","110/07/09","兆豐-北高雄",7,0,7
"10470","5410國眾","110/07/09","元大-頭份",0,10,-10
"10471","5410國眾","110/07/09","凱基-台北",8,1,7
"10472","5410國眾","110/07/09","群益金鼎-丹鳳",0,7,-7
"10473","5410國眾","110/07/09","華南永昌-公誠",7,0,7
"10474","5410國眾","110/07/09","凱基-復興",0,7,-7
"10475","5410國眾","110/07/09","香港上海匯豐",6,0,6
"10476","5410國眾","110/07/09","元大-員林",0,7,-7
"10477","5410國眾","110/07/09","凱基-中壢",6,0,6
"10478","5410國眾","110/07/09","富邦-竹東",0,6,-6
"10479","5410國眾","110/07/09","華南永昌-南京",6,0,6
"10480","5410國眾","110/07/09","亞東-高雄",0,5,-5
"10481","5410國眾","110/07/09","統一-三重",5,0,5
"10482","5410國眾","110/07/09","大慶-中壢",1,6,-5
"10483","5410國眾","110/07/09","富邦-宜蘭",5,0,5
"10484","5410國眾","110/07/09","群益金鼎-中港",0,5,-5
"10485","5410國眾","110/07/09","元大-崇德",5,0,5
"10486","5410國眾","110/07/09","元大-八德",0,5,-5
"10487","5410國眾","110/07/09","元大-博愛",5,0,5
"10488","5410國眾","110/07/09","富邦-基隆",0,4,-4
"10489","5410國眾","110/07/09","元大-龍潭",5,0,5
"10490","5410國眾","110/07/09","臺銀-新竹",0,3,-3
"10491","2841台開","110/07/09","日盛-雙和",102,0,102
"10492","2841台開","110/07/09","港商野村",0,129,-129
"10493","2841台開","110/07/09","元大-館前",70,0,70
"10494","2841台開","110/07/09","兆豐-永和",0,100,-100
"10495","2841台開","110/07/09","凱基-文心",50,0,50
"10496","2841台開","110/07/09","台新證券",7,28,-21
"10497","2841台開","110/07/09","富邦-嘉義",40,0,40
"10498","2841台開","110/07/09","國票-北高雄",0,20,-20
"10499","2841台開","110/07/09","美商高盛",15,0,15
"10500","2841台開","110/07/09","永豐金-敦南",29,46,-17
"10501","2841台開","110/07/09","台中銀",15,0,15
"10502","2841台開","110/07/09","合庫-基隆",0,12,-12
"10503","2841台開","110/07/09","新光",11,0,11
"10504","2841台開","110/07/09","中國信託-松江",0,12,-12
"10505","2841台開","110/07/09","華南永昌-長虹",10,0,10
"10506","2841台開","110/07/09","兆豐-城中",0,12,-12
"10507","2841台開","110/07/09","永豐金-南投",10,0,10
"10508","2841台開","110/07/09","台中銀-豐原",0,10,-10
"10509","2841台開","110/07/09","合庫-桃園",7,0,7
"10510","2841台開","110/07/09","兆豐-景美",0,10,-10
"10511","2841台開","110/07/09","群益金鼎-古亭",7,0,7
"10512","2841台開","110/07/09","群益金鼎-基隆",0,10,-10
"10513","2841台開","110/07/09","國泰-敦南",6,0,6
"10514","2841台開","110/07/09","元大-北三重",0,10,-10
"10515","2841台開","110/07/09","凱基-桃園",8,2,6
"10516","2841台開","110/07/09","(牛牛牛)亞-網路",0,9,-9
"10517","2841台開","110/07/09","日盛證券",5,0,5
"10518","2841台開","110/07/09","台新-高雄",1,10,-9
"10519","2841台開","110/07/09","元富-文心",5,0,5
"10520","2841台開","110/07/09","凱基-台北",0,7,-7
"10521","6207雷科","110/07/09","群益金鼎-新竹",47,0,47
"10522","6207雷科","110/07/09","新光",7,24,-17
"10523","6207雷科","110/07/09","永豐金-三重",31,0,31
"10524","6207雷科","110/07/09","日盛-和美",0,15,-15
"10525","6207雷科","110/07/09","新加坡商瑞銀",33,5,28
"10526","6207雷科","110/07/09","國泰-台南",0,15,-15
"10527","6207雷科","110/07/09","元大-高雄",26,0,26
"10528","6207雷科","110/07/09","華南永昌-古亭",0,14,-14
"10529","6207雷科","110/07/09","統一-員林",22,0,22
"10530","6207雷科","110/07/09","土銀-白河",0,11,-11
"10531","6207雷科","110/07/09","台新-高雄",22,0,22
"10532","6207雷科","110/07/09","日盛-台南",0,10,-10
"10533","6207雷科","110/07/09","摩根大通",34,17,17
"10534","6207雷科","110/07/09","元富-林園",0,10,-10
"10535","6207雷科","110/07/09","元大-博愛",17,1,16
"10536","6207雷科","110/07/09","富邦-園區",0,10,-10
"10537","6207雷科","110/07/09","日茂-埔里",12,0,12
"10538","6207雷科","110/07/09","元大-上新莊",0,10,-10
"10539","6207雷科","110/07/09","國泰-台中",17,6,11
"10540","6207雷科","110/07/09","永豐金-南京",0,10,-10
"10541","6207雷科","110/07/09","富邦-三重",10,0,10
"10542","6207雷科","110/07/09","兆豐-小港",0,6,-6
"10543","6207雷科","110/07/09","元大-沙鹿",10,0,10
"10544","6207雷科","110/07/09","富邦-羅東",1,7,-6
"10545","6207雷科","110/07/09","元大-八德",10,0,10
"10546","6207雷科","110/07/09","元大-土城永寧",0,6,-6
"10547","6207雷科","110/07/09","第一金-路竹",11,2,9
"10548","6207雷科","110/07/09","永豐金-板盛",0,6,-6
"10549","6207雷科","110/07/09","統一-南京",5,0,5
"10550","6207雷科","110/07/09","日盛-板橋",0,5,-5
"10551","3679新至陞","110/07/09","元大-大天母",10,0,10
"10552","3679新至陞","110/07/09","第一金-光復",0,11,-11
"10553","3679新至陞","110/07/09","日盛-樹林",9,0,9
"10554","3679新至陞","110/07/09","瑞士信貸",0,8,-8
"10555","3679新至陞","110/07/09","凱基-台北",11,2,9
"10556","3679新至陞","110/07/09","大慶-苗栗",0,5,-5
"10557","3679新至陞","110/07/09","華南永昌-小港",8,0,8
"10558","3679新至陞","110/07/09","元大-永春",0,5,-5
"10559","3679新至陞","110/07/09","兆豐-來福",7,0,7
"10560","3679新至陞","110/07/09","日盛-和美",0,4,-4
"10561","3679新至陞","110/07/09","香港上海匯豐",5,0,5
"10562","3679新至陞","110/07/09","元大-雙和",0,3,-3
"10563","3679新至陞","110/07/09","台中銀-員林",3,0,3
"10564","3679新至陞","110/07/09","永豐金-屏東",0,3,-3
"10565","3679新至陞","110/07/09","新光",3,0,3
"10566","3679新至陞","110/07/09","彰銀",0,2,-2
"10567","3679新至陞","110/07/09","土銀-花蓮",2,0,2
"10568","3679新至陞","110/07/09","宏遠-館前",0,2,-2
"10569","3679新至陞","110/07/09","第一金-澎湖",2,0,2
"10570","3679新至陞","110/07/09","港商野村",0,2,-2
"10571","3679新至陞","110/07/09","摩根大通",2,0,2
"10572","3679新至陞","110/07/09","大昌-新店",0,2,-2
"10573","3679新至陞","110/07/09","國泰-敦南",2,0,2
"10574","3679新至陞","110/07/09","元大-新莊",0,2,-2
"10575","3679新至陞","110/07/09","元大-淡水",4,2,2
"10576","3679新至陞","110/07/09","元大-板橋",0,2,-2
"10577","3679新至陞","110/07/09","日盛-士林",1,0,1
"10578","3679新至陞","110/07/09","台灣摩根士丹利",0,1,-1
"10579","3679新至陞","110/07/09","日盛-信義",1,0,1
"10580","3679新至陞","110/07/09","第一金-高雄",0,1,-1
"10581","2727王品","110/07/09","台灣匯立證券",90,0,90
"10582","2727王品","110/07/09","台灣摩根士丹利",0,267,-267
"10583","2727王品","110/07/09","國泰-敦南",166,84,82
"10584","2727王品","110/07/09","富邦-台北",35,299,-264
"10585","2727王品","110/07/09","富邦-仁愛",56,12,44
"10586","2727王品","110/07/09","凱基-台北",174,296,-122
"10587","2727王品","110/07/09","台新證券",109,66,43
"10588","2727王品","110/07/09","第一金",2,102,-100
"10589","2727王品","110/07/09","新光",117,87,30
"10590","2727王品","110/07/09","群益金鼎-大安",0,80,-80
"10591","2727王品","110/07/09","臺銀-臺中",35,6,29
"10592","2727王品","110/07/09","兆豐-大安",7,60,-53
"10593","2727王品","110/07/09","元大-桃園",32,3,29
"10594","2727王品","110/07/09","永豐金-南投",0,50,-50
"10595","2727王品","110/07/09","元富-宜蘭",34,6,28
"10596","2727王品","110/07/09","新加坡商瑞銀",6,46,-40
"10597","2727王品","110/07/09","玉山-台中",34,8,26
"10598","2727王品","110/07/09","合庫-彰化",11,50,-39
"10599","2727王品","110/07/09","群益金鼎-宜蘭",30,4,26
"10600","2727王品","110/07/09","永豐金-萬盛",13,52,-39
"10601","2727王品","110/07/09","富邦-台中",42,16,26
"10602","2727王品","110/07/09","瑞士信貸",0,34,-34
"10603","2727王品","110/07/09","第一金-豐原",25,1,24
"10604","2727王品","110/07/09","元大-和平",4,35,-31
"10605","2727王品","110/07/09","臺銀",30,8,22
"10606","2727王品","110/07/09","美林",14,44,-30
"10607","2727王品","110/07/09","兆豐-來福",23,1,22
"10608","2727王品","110/07/09","元大-員林",9,38,-29
"10609","2727王品","110/07/09","玉山-士林",22,2,20
"10610","2727王品","110/07/09","元富-西松",4,31,-27
"10611","1570力肯","110/07/09","凱基-台北",30,1,29
"10612","1570力肯","110/07/09","群益金鼎-彰化",0,20,-20
"10613","1570力肯","110/07/09","新光-台南",20,0,20
"10614","1570力肯","110/07/09","元大-土城學府",0,20,-20
"10615","1570力肯","110/07/09","元大-高雄",20,0,20
"10616","1570力肯","110/07/09","元大-大統",0,16,-16
"10617","1570力肯","110/07/09","國票-中正",12,0,12
"10618","1570力肯","110/07/09","元大-新營",0,11,-11
"10619","1570力肯","110/07/09","日盛-高雄",6,0,6
"10620","1570力肯","110/07/09","元大-和平",0,10,-10
"10621","1570力肯","110/07/09","元富-緯城",6,0,6
"10622","1570力肯","110/07/09","元大-草屯",0,10,-10
"10623","1570力肯","110/07/09","群益金鼎-台南",6,0,6
"10624","1570力肯","110/07/09","元大-鹿港",0,9,-9
"10625","1570力肯","110/07/09","華南永昌-岡山",6,0,6
"10626","1570力肯","110/07/09","合庫-基隆",0,7,-7
"10627","1570力肯","110/07/09","統一-中壢",5,0,5
"10628","1570力肯","110/07/09","摩根大通",2,8,-6
"10629","1570力肯","110/07/09","凱基-三峽",5,0,5
"10630","1570力肯","110/07/09","台灣企銀-豐原",0,4,-4
"10631","1570力肯","110/07/09","大昌-樹林",4,0,4
"10632","1570力肯","110/07/09","日盛-桃園",0,4,-4
"10633","1570力肯","110/07/09","新光",3,0,3
"10634","1570力肯","110/07/09","國泰-高雄",0,3,-3
"10635","1570力肯","110/07/09","富邦-新竹華信",3,0,3
"10636","1570力肯","110/07/09","永豐金-敦南",0,3,-3
"10637","1570力肯","110/07/09","合庫-台中",2,0,2
"10638","1570力肯","110/07/09","土銀-彰化",0,2,-2
"10639","1570力肯","110/07/09","臺銀-臺中",2,0,2
"10640","1570力肯","110/07/09","臺銀-鳳山",0,2,-2
"10641","6180橘子","110/07/09","摩根大通",63,1,62
"10642","6180橘子","110/07/09","元大-南京",1,32,-31
"10643","6180橘子","110/07/09","富邦-陽明",73,33,40
"10644","6180橘子","110/07/09","群益金鼎-台北",0,25,-25
"10645","6180橘子","110/07/09","新加坡商瑞銀",31,0,31
"10646","6180橘子","110/07/09","兆豐-復興",0,21,-21
"10647","6180橘子","110/07/09","美商高盛",25,0,25
"10648","6180橘子","110/07/09","永豐金-嘉義",0,21,-21
"10649","6180橘子","110/07/09","凱基-台北",26,10,16
"10650","6180橘子","110/07/09","凱基-中壢",8,24,-16
"10651","6180橘子","110/07/09","華南永昌-楠梓",13,0,13
"10652","6180橘子","110/07/09","致和-崇德",0,15,-15
"10653","6180橘子","110/07/09","華南永昌-朴子",11,0,11
"10654","6180橘子","110/07/09","群益金鼎-屏東",0,15,-15
"10655","6180橘子","110/07/09","元大-北港",11,0,11
"10656","6180橘子","110/07/09","群益金鼎-中山",0,15,-15
"10657","6180橘子","110/07/09","元大-成功",10,1,9
"10658","6180橘子","110/07/09","瑞士信貸",1,15,-14
"10659","6180橘子","110/07/09","新光",26,18,8
"10660","6180橘子","110/07/09","日盛-二林",0,10,-10
"10661","6180橘子","110/07/09","統一-三重",6,0,6
"10662","6180橘子","110/07/09","凱基-東門",0,10,-10
"10663","6180橘子","110/07/09","群益金鼎-嘉義",6,0,6
"10664","6180橘子","110/07/09","華南永昌-三重",0,10,-10
"10665","6180橘子","110/07/09","元大-員林中山",6,0,6
"10666","6180橘子","110/07/09","元大-彰化民生",1,11,-10
"10667","6180橘子","110/07/09","合庫-鳳山",5,0,5
"10668","6180橘子","110/07/09","永豐金-新店",1,11,-10
"10669","6180橘子","110/07/09","富邦-建國",6,1,5
"10670","6180橘子","110/07/09","群益金鼎-丹鳳",0,8,-8
"10671","2390云辰","110/07/09","摩根大通",279,56,223
"10672","2390云辰","110/07/09","元大-天母",0,127,-127
"10673","2390云辰","110/07/09","日盛-鳳山",110,2,108
"10674","2390云辰","110/07/09","中國信託-文心",5,109,-104
"10675","2390云辰","110/07/09","宏遠證券",100,0,100
"10676","2390云辰","110/07/09","永豐金-復興",0,55,-55
"10677","2390云辰","110/07/09","元大-大里",63,6,57
"10678","2390云辰","110/07/09","凱基-台北",239,286,-47
"10679","2390云辰","110/07/09","凱基-八德",59,10,49
"10680","2390云辰","110/07/09","德信",2,32,-30
"10681","2390云辰","110/07/09","合庫-新竹",40,0,40
"10682","2390云辰","110/07/09","兆豐-桃鶯",2,32,-30
"10683","2390云辰","110/07/09","國票",40,1,39
"10684","2390云辰","110/07/09","致和-南京",0,30,-30
"10685","2390云辰","110/07/09","新加坡商瑞銀",49,13,36
"10686","2390云辰","110/07/09","富邦-虎尾",1,31,-30
"10687","2390云辰","110/07/09","統一-新台中",36,2,34
"10688","2390云辰","110/07/09","元大-善化",2,31,-29
"10689","2390云辰","110/07/09","國票-嘉義",31,0,31
"10690","2390云辰","110/07/09","富邦-板橋",0,27,-27
"10691","2390云辰","110/07/09","華南永昌",35,7,28
"10692","2390云辰","110/07/09","富邦-永和",3,28,-25
"10693","2390云辰","110/07/09","玉山-台中",49,22,27
"10694","2390云辰","110/07/09","第一金-自由",20,44,-24
"10695","2390云辰","110/07/09","華南永昌-敦南",25,0,25
"10696","2390云辰","110/07/09","凱基-內湖",0,24,-24
"10697","2390云辰","110/07/09","新光-高雄",27,4,23
"10698","2390云辰","110/07/09","元大-汐止",1,24,-23
"10699","2390云辰","110/07/09","台灣摩根士丹利",85,63,22
"10700","2390云辰","110/07/09","新光-台中",12,33,-21
"10701","4903聯光通","110/07/08","元富-新興",18,0,18
"10702","4903聯光通","110/07/08","中國信託-中壢",0,14,-14
"10703","4903聯光通","110/07/08","元大-苗栗",9,0,9
"10704","4903聯光通","110/07/08","彰銀",0,7,-7
"10705","4903聯光通","110/07/08","兆豐-鹿港",3,0,3
"10706","4903聯光通","110/07/08","中國信託-松江",0,5,-5
"10707","4903聯光通","110/07/08","群益金鼎-萬華",2,0,2
"10708","4903聯光通","110/07/08","光和",0,2,-2
"10709","4903聯光通","110/07/08","元大-屏南",1,0,1
"10710","4903聯光通","110/07/08","元大-鶯歌",0,2,-2
"10711","4903聯光通","110/07/08","華南永昌-新莊",0,0,0
"10712","4903聯光通","110/07/08","群益金鼎-館前",0,1,-1
"10713","4903聯光通","110/07/08","元大-羅東",0,0,0
"10714","4903聯光通","110/07/08","華南永昌",0,1,-1
"10715","4903聯光通","110/07/08","元大-太平",2,3,-1
"10716","4903聯光通","110/07/08","華南永昌-新莊",0,0,0
"10717","4903聯光通","110/07/08","元大-羅東",0,0,0
"10718","2929淘帝","110/07/08","日盛-園區",90,6,84
"10719","2929淘帝","110/07/08","元大-太平",1,111,-110
"10720","2929淘帝","110/07/08","華南永昌-頭份",54,0,54
"10721","2929淘帝","110/07/08","港商野村",31,106,-75
"10722","2929淘帝","110/07/08","美商高盛",50,0,50
"10723","2929淘帝","110/07/08","凱基-板橋",62,111,-49
"10724","2929淘帝","110/07/08","台中銀-台北",50,0,50
"10725","2929淘帝","110/07/08","新光-台中",30,78,-48
"10726","2929淘帝","110/07/08","臺銀-臺南",30,0,30
"10727","2929淘帝","110/07/08","元富-永和",1,41,-40
"10728","2929淘帝","110/07/08","永豐金-大園",42,12,30
"10729","2929淘帝","110/07/08","永豐金-鳳山",0,28,-28
"10730","2929淘帝","110/07/08","元富-三重",30,1,29
"10731","2929淘帝","110/07/08","元大-南崁",0,26,-26
"10732","2929淘帝","110/07/08","兆豐-桃鶯",29,0,29
"10733","2929淘帝","110/07/08","元大-花蓮",2,27,-25
"10734","2929淘帝","110/07/08","元大-承德",20,3,17
"10735","2929淘帝","110/07/08","元大-府城",0,24,-24
"10736","2929淘帝","110/07/08","新光-新竹",13,0,13
"10737","2929淘帝","110/07/08","新光",21,43,-22
"10738","2929淘帝","110/07/08","富邦-內湖",13,0,13
"10739","2929淘帝","110/07/08","臺銀-民權",0,20,-20
"10740","2929淘帝","110/07/08","國泰-板橋",13,1,12
"10741","2929淘帝","110/07/08","摩根大通",66,84,-18
"10742","2929淘帝","110/07/08","第一金-大稻埕",10,0,10
"10743","2929淘帝","110/07/08","凱基-台北",0,17,-17
"10744","2929淘帝","110/07/08","統一-汐止",10,0,10
"10745","2929淘帝","110/07/08","元大-博愛",6,23,-17
"10746","2929淘帝","110/07/08","元富-大裕",10,0,10
"10747","2929淘帝","110/07/08","永豐金-桃盛",0,16,-16
"10748","5410國眾","110/07/08","元大-新盛",15,0,15
"10749","5410國眾","110/07/08","元大-旗山",0,50,-50
"10750","5410國眾","110/07/08","元大-屏南",10,0,10
"10751","5410國眾","110/07/08","元大-頭份",0,14,-14
"10752","5410國眾","110/07/08","元大-成功",10,0,10
"10753","5410國眾","110/07/08","國泰-高雄",0,8,-8
"10754","5410國眾","110/07/08","元大-東泰",7,0,7
"10755","5410國眾","110/07/08","元大-小港",0,7,-7
"10756","5410國眾","110/07/08","富邦-陽明",6,0,6
"10757","5410國眾","110/07/08","統一-嘉義",0,5,-5
"10758","5410國眾","110/07/08","臺銀-金山",5,0,5
"10759","5410國眾","110/07/08","兆豐-台中港",0,5,-5
"10760","5410國眾","110/07/08","日盛-員林",5,0,5
"10761","5410國眾","110/07/08","凱基-屏東",0,5,-5
"10762","5410國眾","110/07/08","摩根大通",5,0,5
"10763","5410國眾","110/07/08","元大-八德",0,5,-5
"10764","5410國眾","110/07/08","富邦-桃園",5,0,5
"10765","5410國眾","110/07/08","元富-嘉義",0,4,-4
"10766","5410國眾","110/07/08","元富-大昌",4,0,4
"10767","5410國眾","110/07/08","玉山-雙和",0,4,-4
"10768","5410國眾","110/07/08","台新-台中",4,0,4
"10769","5410國眾","110/07/08","凱基-高美館",1,5,-4
"10770","5410國眾","110/07/08","華南永昌-小港",5,1,4
"10771","5410國眾","110/07/08","統一-員林",0,3,-3
"10772","5410國眾","110/07/08","元大-新竹",5,1,4
"10773","5410國眾","110/07/08","臺銀-鳳山",0,2,-2
"10774","5410國眾","110/07/08","元大-土城學府",4,0,4
"10775","5410國眾","110/07/08","亞東",0,2,-2
"10776","5410國眾","110/07/08","元大-新莊",4,0,4
"10777","5410國眾","110/07/08","新光",0,2,-2
"10778","2841台開","110/07/08","元大-樹林",653,0,653
"10779","2841台開","110/07/08","港商野村",0,868,-868
"10780","2841台開","110/07/08","台新證券",115,0,115
"10781","2841台開","110/07/08","群益金鼎-忠孝",0,100,-100
"10782","2841台開","110/07/08","永豐金-豐原",105,0,105
"10783","2841台開","110/07/08","宏遠-高雄",0,56,-56
"10784","2841台開","110/07/08","元富-新興",100,0,100
"10785","2841台開","110/07/08","新光",3,38,-35
"10786","2841台開","110/07/08","凱基-文心",50,0,50
"10787","2841台開","110/07/08","花旗環球",0,29,-29
"10788","2841台開","110/07/08","元大-八德",40,0,40
"10789","2841台開","110/07/08","富邦-仁愛",2,30,-28
"10790","2841台開","110/07/08","日盛-雙和",30,0,30
"10791","2841台開","110/07/08","元富-潮州",0,24,-24
"10792","2841台開","110/07/08","統一-竹南",30,0,30
"10793","2841台開","110/07/08","元大-沙鹿",0,20,-20
"10794","2841台開","110/07/08","凱基-台南",30,0,30
"10795","2841台開","110/07/08","元大-汐止",0,20,-20
"10796","2841台開","110/07/08","元大-福營",30,0,30
"10797","2841台開","110/07/08","合庫-嘉義",2,20,-18
"10798","2841台開","110/07/08","合庫-台中",22,0,22
"10799","2841台開","110/07/08","國泰-敦南",3,21,-18
"10800","2841台開","110/07/08","大昌-安康",28,10,18
"10801","2841台開","110/07/08","日盛-竹北",0,15,-15
"10802","2841台開","110/07/08","元大-斗信",15,0,15
"10803","2841台開","110/07/08","元大-三重",0,15,-15
"10804","2841台開","110/07/08","富邦-台北",13,0,13
"10805","2841台開","110/07/08","永豐金-敦南",45,60,-15
"10806","2841台開","110/07/08","合庫-桃園",10,0,10
"10807","2841台開","110/07/08","(牛牛牛)亞-網路",0,12,-12
"10808","6207雷科","110/07/08","台新-高雄",54,2,52
"10809","6207雷科","110/07/08","群益金鼎-丹鳳",0,60,-60
"10810","6207雷科","110/07/08","新光-台中",18,0,18
"10811","6207雷科","110/07/08","元大-頭份",1,56,-55
"10812","6207雷科","110/07/08","日盛-嘉義",16,0,16
"10813","6207雷科","110/07/08","國票-中和",0,30,-30
"10814","6207雷科","110/07/08","合庫-鳳山",15,0,15
"10815","6207雷科","110/07/08","凱基-台北",1,29,-28
"10816","6207雷科","110/07/08","臺銀-臺中",12,0,12
"10817","6207雷科","110/07/08","兆豐-板橋",0,25,-25
"10818","6207雷科","110/07/08","群益金鼎-土城",12,0,12
"10819","6207雷科","110/07/08","凱基-城中",4,25,-21
"10820","6207雷科","110/07/08","新光",25,14,11
"10821","6207雷科","110/07/08","日進",0,20,-20
"10822","6207雷科","110/07/08","凱基-中壢",11,0,11
"10823","6207雷科","110/07/08","台新證券",3,20,-17
"10824","6207雷科","110/07/08","台灣企銀",10,0,10
"10825","6207雷科","110/07/08","群益金鼎-中山",0,16,-16
"10826","6207雷科","110/07/08","第一金-新興",11,1,10
"10827","6207雷科","110/07/08","元大-東門",0,16,-16
"10828","6207雷科","110/07/08","元富-吉利",10,0,10
"10829","6207雷科","110/07/08","群益金鼎-大甲",0,13,-13
"10830","6207雷科","110/07/08","光和-和美",10,0,10
"10831","6207雷科","110/07/08","日盛-板橋",0,10,-10
"10832","6207雷科","110/07/08","永豐金-南京",10,0,10
"10833","6207雷科","110/07/08","日盛-中壢",0,10,-10
"10834","6207雷科","110/07/08","土銀",8,0,8
"10835","6207雷科","110/07/08","摩根大通",125,135,-10
"10836","6207雷科","110/07/08","中國信託-高雄",8,0,8
"10837","6207雷科","110/07/08","凱基-五股",0,10,-10
"10838","3679新至陞","110/07/08","華南永昌-台中",17,0,17
"10839","3679新至陞","110/07/08","大慶-蘆洲",0,10,-10
"10840","3679新至陞","110/07/08","國泰-桃園",6,0,6
"10841","3679新至陞","110/07/08","華南永昌-小港",0,7,-7
"10842","3679新至陞","110/07/08","元大-永春",6,0,6
"10843","3679新至陞","110/07/08","國泰-館前",0,3,-3
"10844","3679新至陞","110/07/08","香港上海匯豐",4,0,4
"10845","3679新至陞","110/07/08","元大-板橋",0,3,-3
"10846","3679新至陞","110/07/08","中國信託-新竹",3,0,3
"10847","3679新至陞","110/07/08","港商法國興業",0,2,-2
"10848","3679新至陞","110/07/08","國票-敦北法人",3,0,3
"10849","3679新至陞","110/07/08","第一金-忠孝",0,2,-2
"10850","3679新至陞","110/07/08","群益金鼎-台南",2,0,2
"10851","3679新至陞","110/07/08","元富-古亭",0,2,-2
"10852","3679新至陞","110/07/08","凱基",2,0,2
"10853","3679新至陞","110/07/08","摩根大通",1,3,-2
"10854","3679新至陞","110/07/08","凱基-台北",6,4,2
"10855","3679新至陞","110/07/08","富邦-板橋",0,2,-2
"10856","3679新至陞","110/07/08","日盛-信義",1,0,1
"10857","3679新至陞","110/07/08","元大-文心興安",0,2,-2
"10858","3679新至陞","110/07/08","日盛-新莊",1,0,1
"10859","3679新至陞","110/07/08","臺銀-高雄",0,1,-1
"10860","3679新至陞","110/07/08","大慶",1,0,1
"10861","3679新至陞","110/07/08","日盛-高雄",0,1,-1
"10862","3679新至陞","110/07/08","兆豐-三重",1,0,1
"10863","3679新至陞","110/07/08","日盛-文化",0,1,-1
"10864","3679新至陞","110/07/08","致和-東門",1,0,1
"10865","3679新至陞","110/07/08","美商高盛",0,1,-1
"10866","3679新至陞","110/07/08","台新證券",1,0,1
"10867","3679新至陞","110/07/08","瑞士信貸",0,1,-1
"10868","2727王品","110/07/08","群益金鼎-大安",80,0,80
"10869","2727王品","110/07/08","台灣摩根士丹利",1,300,-299
"10870","2727王品","110/07/08","富邦-台北",237,165,72
"10871","2727王品","110/07/08","元大證券",173,439,-266
"10872","2727王品","110/07/08","永豐金-萬盛",55,5,50
"10873","2727王品","110/07/08","統一",33,200,-167
"10874","2727王品","110/07/08","永豐金-南投",53,10,43
"10875","2727王品","110/07/08","凱基-台北",476,615,-139
"10876","2727王品","110/07/08","國泰-敦南",190,148,42
"10877","2727王品","110/07/08","永豐金-松山",8,138,-130
"10878","2727王品","110/07/08","台新-高雄",71,36,35
"10879","2727王品","110/07/08","新加坡商瑞銀",38,138,-100
"10880","2727王品","110/07/08","富邦-建國",62,27,35
"10881","2727王品","110/07/08","富邦-嘉義",84,182,-98
"10882","2727王品","110/07/08","永豐金證券",50,15,35
"10883","2727王品","110/07/08","元富-台南",4,99,-95
"10884","2727王品","110/07/08","港商野村",185,152,33
"10885","2727王品","110/07/08","凱基-永華",4,92,-88
"10886","2727王品","110/07/08","元大-嘉義",35,3,32
"10887","2727王品","110/07/08","凱基-大直",2,73,-71
"10888","2727王品","110/07/08","台新-三民",35,4,31
"10889","2727王品","110/07/08","美林",105,164,-59
"10890","2727王品","110/07/08","凱基-桃園",35,4,31
"10891","2727王品","110/07/08","第一金-台南",11,63,-52
"10892","2727王品","110/07/08","元大-和平",41,10,31
"10893","2727王品","110/07/08","摩根大通",216,259,-43
"10894","2727王品","110/07/08","兆豐-大安",33,5,28
"10895","2727王品","110/07/08","元大-員林",9,50,-41
"10896","2727王品","110/07/08","元大-新盛",33,6,27
"10897","2727王品","110/07/08","兆豐-虎尾",1,41,-40
"10898","1570力肯","110/07/08","群益金鼎-三重",20,0,20
"10899","1570力肯","110/07/08","中國信託-永康",0,26,-26
"10900","1570力肯","110/07/08","凱基-中壢",20,0,20
"10901","1570力肯","110/07/08","統一-敦南",0,12,-12
"10902","1570力肯","110/07/08","群益金鼎-台南",14,0,14
"10903","1570力肯","110/07/08","國票-博愛",0,10,-10
"10904","1570力肯","110/07/08","元富-緯城",10,0,10
"10905","1570力肯","110/07/08","元大-西門",0,10,-10
"10906","1570力肯","110/07/08","瑞士信貸",7,0,7
"10907","1570力肯","110/07/08","新光",0,9,-9
"10908","1570力肯","110/07/08","摩根大通",6,0,6
"10909","1570力肯","110/07/08","永豐金-大園",0,9,-9
"10910","1570力肯","110/07/08","土銀-白河",5,0,5
"10911","1570力肯","110/07/08","日盛-大墩",0,6,-6
"10912","1570力肯","110/07/08","台灣摩根士丹利",4,0,4
"10913","1570力肯","110/07/08","台新證券",0,6,-6
"10914","1570力肯","110/07/08","元大-新莊",3,0,3
"10915","1570力肯","110/07/08","永全",0,5,-5
"10916","1570力肯","110/07/08","永豐金-苓雅",3,0,3
"10917","1570力肯","110/07/08","元大-天母",0,5,-5
"10918","1570力肯","110/07/08","合庫-三重",2,0,2
"10919","1570力肯","110/07/08","元富-吉利",0,3,-3
"10920","1570力肯","110/07/08","(牛牛牛)亞-鑫豐",2,0,2
"10921","1570力肯","110/07/08","國泰-高雄",0,3,-3
"10922","1570力肯","110/07/08","玉山-大里",2,0,2
"10923","1570力肯","110/07/08","群益金鼎-北高雄",0,3,-3
"10924","1570力肯","110/07/08","國泰-敦南",2,0,2
"10925","1570力肯","110/07/08","群益金鼎-東門",0,2,-2
"10926","1570力肯","110/07/08","華南永昌-岡山",2,0,2
"10927","1570力肯","110/07/08","日盛-高雄",5,6,-1
"10928","6180橘子","110/07/08","新光",30,4,26
"10929","6180橘子","110/07/08","元大-土城學府",0,89,-89
"10930","6180橘子","110/07/08","康和-台南",22,0,22
"10931","6180橘子","110/07/08","凱基-東勢",1,66,-65
"10932","6180橘子","110/07/08","國泰-板橋",22,0,22
"10933","6180橘子","110/07/08","光和",0,64,-64
"10934","6180橘子","110/07/08","日盛-文化",21,0,21
"10935","6180橘子","110/07/08","中國信託-忠孝",0,50,-50
"10936","6180橘子","110/07/08","中國信託-文心",20,2,18
"10937","6180橘子","110/07/08","元富-大裕",0,25,-25
"10938","6180橘子","110/07/08","凱基-台北",39,24,15
"10939","6180橘子","110/07/08","統一-基隆",1,25,-24
"10940","6180橘子","110/07/08","元富-新店",14,0,14
"10941","6180橘子","110/07/08","美商高盛",1,21,-20
"10942","6180橘子","110/07/08","元大-土城永寧",11,0,11
"10943","6180橘子","110/07/08","元大證券",1,19,-18
"10944","6180橘子","110/07/08","永豐金-南京",11,0,11
"10945","6180橘子","110/07/08","元大-太平",2,20,-18
"10946","6180橘子","110/07/08","宏遠-館前",10,0,10
"10947","6180橘子","110/07/08","合庫證券",2,18,-16
"10948","6180橘子","110/07/08","國泰-新莊",10,0,10
"10949","6180橘子","110/07/08","台灣摩根士丹利",1,12,-11
"10950","6180橘子","110/07/08","群益金鼎",10,0,10
"10951","6180橘子","110/07/08","瑞士信貸",0,11,-11
"10952","6180橘子","110/07/08","凱基-高雄",10,0,10
"10953","6180橘子","110/07/08","元富-嘉義",0,11,-11
"10954","6180橘子","110/07/08","凱基-大安",10,0,10
"10955","6180橘子","110/07/08","新光-高雄",0,11,-11
"10956","6180橘子","110/07/08","富邦-仁愛",10,0,10
"10957","6180橘子","110/07/08","大慶-苗栗",0,10,-10
"10958","2390云辰","110/07/08","統一-新台中",126,1,125
"10959","2390云辰","110/07/08","摩根大通",62,661,-599
"10960","2390云辰","110/07/08","元大-員林",111,0,111
"10961","2390云辰","110/07/08","新加坡商瑞銀",0,173,-173
"10962","2390云辰","110/07/08","合庫-高雄",105,0,105
"10963","2390云辰","110/07/08","元大-天母",7,150,-143
"10964","2390云辰","110/07/08","凱基-台北",255,177,78
"10965","2390云辰","110/07/08","台灣摩根士丹利",0,134,-134
"10966","2390云辰","110/07/08","新光",71,17,54
"10967","2390云辰","110/07/08","玉山-台中",17,120,-103
"10968","2390云辰","110/07/08","國票-嘉義",53,0,53
"10969","2390云辰","110/07/08","美商高盛",0,78,-78
"10970","2390云辰","110/07/08","富邦-仁愛",53,4,49
"10971","2390云辰","110/07/08","美林",11,82,-71
"10972","2390云辰","110/07/08","兆豐-城中",48,0,48
"10973","2390云辰","110/07/08","群益金鼎-大興",35,106,-71
"10974","2390云辰","110/07/08","元大-新營",47,0,47
"10975","2390云辰","110/07/08","光和",11,71,-60
"10976","2390云辰","110/07/08","國泰-敦南",89,55,34
"10977","2390云辰","110/07/08","國泰-台中",28,70,-42
"10978","2390云辰","110/07/08","兆豐-台中",40,7,33
"10979","2390云辰","110/07/08","玉山-新莊",6,46,-40
"10980","2390云辰","110/07/08","永豐金-中正",36,6,30
"10981","2390云辰","110/07/08","富邦-台北",21,57,-36
"10982","2390云辰","110/07/08","中國信託-三重",29,0,29
"10983","2390云辰","110/07/08","土銀-台中",0,30,-30
"10984","2390云辰","110/07/08","富邦-陽明",33,5,28
"10985","2390云辰","110/07/08","兆豐-埔墘",1,31,-30
"10986","2390云辰","110/07/08","元富-桃園",27,0,27
"10987","2390云辰","110/07/08","玉山-南京東路",3,33,-30
"10988","4903聯光通","110/07/07","元大-太平",47,4,43
"10989","4903聯光通","110/07/07","日盛-板橋",0,15,-15
"10990","4903聯光通","110/07/07","華南永昌-桃園",10,0,10
"10991","4903聯光通","110/07/07","元大-八德",0,9,-9
"10992","4903聯光通","110/07/07","元大-南投",9,0,9
"10993","4903聯光通","110/07/07","宏遠證券",0,7,-7
"10994","4903聯光通","110/07/07","新光-台中",3,0,3
"10995","4903聯光通","110/07/07","大慶",0,7,-7
"10996","4903聯光通","110/07/07","國泰-敦南",1,0,1
"10997","4903聯光通","110/07/07","群益金鼎-館前",0,6,-6
"10998","4903聯光通","110/07/07","國票-中正",0,0,0
"10999","4903聯光通","110/07/07","元大-羅東",0,5,-5
"11000","4903聯光通","110/07/07","康和-內湖",0,0,0
"11001","4903聯光通","110/07/07","新光",8,12,-4
"11002","4903聯光通","110/07/07","凱基-站前",0,0,0
"11003","4903聯光通","110/07/07","國泰-高雄",0,3,-3
"11004","4903聯光通","110/07/07","華南永昌",1,1,0
"11005","4903聯光通","110/07/07","第一金-台中",0,3,-3
"11006","4903聯光通","110/07/07","華南永昌-新莊",0,0,0
"11007","4903聯光通","110/07/07","中農",0,1,-1
"11008","4903聯光通","110/07/07","臺灣企銀-桃園",0,1,-1
"11009","4903聯光通","110/07/07","台新-新營",0,1,-1
"11010","4903聯光通","110/07/07","元大-鶯歌",2,3,-1
"11011","4903聯光通","110/07/07","元大-永和",0,1,-1
"11012","4903聯光通","110/07/07","元大-苑裡",0,1,-1
"11013","2929淘帝","110/07/07","統一",163,0,163
"11014","2929淘帝","110/07/07","新光-台中",57,142,-85
"11015","2929淘帝","110/07/07","港商野村",323,181,142
"11016","2929淘帝","110/07/07","兆豐-忠孝",0,76,-76
"11017","2929淘帝","110/07/07","日盛-中壢",132,10,122
"11018","2929淘帝","110/07/07","台新-建北",0,53,-53
"11019","2929淘帝","110/07/07","新加坡商瑞銀",140,19,121
"11020","2929淘帝","110/07/07","臺銀-鳳山",0,44,-44
"11021","2929淘帝","110/07/07","日盛-嘉義",101,0,101
"11022","2929淘帝","110/07/07","元大-新盛",0,42,-42
"11023","2929淘帝","110/07/07","摩根大通",101,16,85
"11024","2929淘帝","110/07/07","富邦-建國",6,47,-41
"11025","2929淘帝","110/07/07","元大-太平",55,2,53
"11026","2929淘帝","110/07/07","日盛-園區",0,40,-40
"11027","2929淘帝","110/07/07","元富-松德",50,1,49
"11028","2929淘帝","110/07/07","新光-高雄",1,38,-37
"11029","2929淘帝","110/07/07","凱基-板橋",53,5,48
"11030","2929淘帝","110/07/07","永豐金-三重",1,34,-33
"11031","2929淘帝","110/07/07","美林",80,34,46
"11032","2929淘帝","110/07/07","元大-彰化",0,31,-31
"11033","2929淘帝","110/07/07","元富-台南",41,0,41
"11034","2929淘帝","110/07/07","第一金-大稻埕",0,30,-30
"11035","2929淘帝","110/07/07","兆豐-竹北",39,0,39
"11036","2929淘帝","110/07/07","國泰-敦南",3,33,-30
"11037","2929淘帝","110/07/07","元大-西門",36,0,36
"11038","2929淘帝","110/07/07","富邦-員林",0,30,-30
"11039","2929淘帝","110/07/07","華南永昌",39,4,35
"11040","2929淘帝","110/07/07","元大-蘆洲",1,30,-29
"11041","2929淘帝","110/07/07","日盛-板橋中山",30,0,30
"11042","2929淘帝","110/07/07","台新-台南",4,32,-28
"11043","5410國眾","110/07/07","兆豐-城中",66,0,66
"11044","5410國眾","110/07/07","富邦-仁愛",0,115,-115
"11045","5410國眾","110/07/07","摩根大通",21,0,21
"11046","5410國眾","110/07/07","亞東-板橋",0,38,-38
"11047","5410國眾","110/07/07","元大-北投",21,0,21
"11048","5410國眾","110/07/07","凱基-台北",2,24,-22
"11049","5410國眾","110/07/07","亞東-新竹",15,0,15
"11050","5410國眾","110/07/07","彰銀-七賢",0,10,-10
"11051","5410國眾","110/07/07","元大-福營",12,0,12
"11052","5410國眾","110/07/07","凱基-基隆",0,10,-10
"11053","5410國眾","110/07/07","新光-高雄",11,0,11
"11054","5410國眾","110/07/07","凱基-屏東",0,10,-10
"11055","5410國眾","110/07/07","華南永昌-小港",10,0,10
"11056","5410國眾","110/07/07","凱基-鳳山",0,10,-10
"11057","5410國眾","110/07/07","元大-大灣",10,0,10
"11058","5410國眾","110/07/07","永豐金-忠孝",0,10,-10
"11059","5410國眾","110/07/07","元大-莒光",10,0,10
"11060","5410國眾","110/07/07","日盛-板橋中山",0,9,-9
"11061","5410國眾","110/07/07","台中銀-豐原",9,0,9
"11062","5410國眾","110/07/07","統一-高雄",0,5,-5
"11063","5410國眾","110/07/07","元大-南屯",9,0,9
"11064","5410國眾","110/07/07","元大-斗六",0,5,-5
"11065","5410國眾","110/07/07","日盛-新莊",7,0,7
"11066","5410國眾","110/07/07","元大-大益",0,5,-5
"11067","5410國眾","110/07/07","元富-大昌",6,0,6
"11068","5410國眾","110/07/07","元大-南投",0,5,-5
"11069","5410國眾","110/07/07","新光-新竹",6,0,6
"11070","5410國眾","110/07/07","永豐金-員林",0,5,-5
"11071","5410國眾","110/07/07","臺銀-金山",5,0,5
"11072","5410國眾","110/07/07","華南永昌-楠梓",0,4,-4
"11073","2841台開","110/07/07","永豐金-豐原",268,0,268
"11074","2841台開","110/07/07","凱基-市政",0,200,-200
"11075","2841台開","110/07/07","永豐金-南投",200,0,200
"11076","2841台開","110/07/07","永豐金-彰化",0,100,-100
"11077","2841台開","110/07/07","新光",139,9,130
"11078","2841台開","110/07/07","元大-開元",1,93,-92
"11079","2841台開","110/07/07","中國信託-高雄",50,1,49
"11080","2841台開","110/07/07","港商野村",0,80,-80
"11081","2841台開","110/07/07","元大-歸仁",40,0,40
"11082","2841台開","110/07/07","凱基-台南",25,85,-60
"11083","2841台開","110/07/07","台中銀",35,0,35
"11084","2841台開","110/07/07","美商高盛",1,58,-57
"11085","2841台開","110/07/07","台新-新營",30,0,30
"11086","2841台開","110/07/07","統一-三重",0,55,-55
"11087","2841台開","110/07/07","富邦-台南",30,0,30
"11088","2841台開","110/07/07","台新證券",12,50,-38
"11089","2841台開","110/07/07","國泰-板橋",30,1,29
"11090","2841台開","110/07/07","陽信-石牌",0,31,-31
"11091","2841台開","110/07/07","凱基-文心",28,0,28
"11092","2841台開","110/07/07","元大-福營",0,31,-31
"11093","2841台開","110/07/07","凱基-站前",27,0,27
"11094","2841台開","110/07/07","第一金-澎湖",0,30,-30
"11095","2841台開","110/07/07","大昌-安康",38,16,22
"11096","2841台開","110/07/07","元大-新莊",0,30,-30
"11097","2841台開","110/07/07","合庫-台中",20,0,20
"11098","2841台開","110/07/07","國泰-館前",0,28,-28
"11099","2841台開","110/07/07","日盛-台南",20,0,20
"11100","2841台開","110/07/07","元大-竹科",0,25,-25
"11101","2841台開","110/07/07","台中銀-員林",20,0,20
"11102","2841台開","110/07/07","富邦-仁愛",1,22,-21
"11103","6207雷科","110/07/07","元大-大天母",21,0,21
"11104","6207雷科","110/07/07","元大-高雄",0,105,-105
"11105","6207雷科","110/07/07","元大-頭份",18,0,18
"11106","6207雷科","110/07/07","永豐金-中正",0,35,-35
"11107","6207雷科","110/07/07","第一金-新興",16,0,16
"11108","6207雷科","110/07/07","摩根大通",8,39,-31
"11109","6207雷科","110/07/07","富邦-虎尾",12,0,12
"11110","6207雷科","110/07/07","元大-林園",0,30,-30
"11111","6207雷科","110/07/07","兆豐-板橋",10,0,10
"11112","6207雷科","110/07/07","凱基-台北",0,19,-19
"11113","6207雷科","110/07/07","玉山-台大",10,0,10
"11114","6207雷科","110/07/07","國票-中和",13,25,-12
"11115","6207雷科","110/07/07","元大-四維",10,0,10
"11116","6207雷科","110/07/07","新加坡商瑞銀",0,9,-9
"11117","6207雷科","110/07/07","元大-鹿港",10,0,10
"11118","6207雷科","110/07/07","玉山-高雄",0,8,-8
"11119","6207雷科","110/07/07","元大-信義",10,0,10
"11120","6207雷科","110/07/07","玉山-台南",0,8,-8
"11121","6207雷科","110/07/07","台新-三民",8,0,8
"11122","6207雷科","110/07/07","宏遠-高雄",0,5,-5
"11123","6207雷科","110/07/07","元大-上新莊",8,0,8
"11124","6207雷科","110/07/07","元大-南海",0,5,-5
"11125","6207雷科","110/07/07","大昌-桃園",7,0,7
"11126","6207雷科","110/07/07","元大-莒光",0,4,-4
"11127","6207雷科","110/07/07","新光-台中",10,4,6
"11128","6207雷科","110/07/07","港商野村",0,3,-3
"11129","6207雷科","110/07/07","日盛-頭份",5,0,5
"11130","6207雷科","110/07/07","大慶-台南",0,3,-3
"11131","6207雷科","110/07/07","日茂-埔里",5,0,5
"11132","6207雷科","110/07/07","凱基-站前",0,3,-3
"11133","3679新至陞","110/07/07","永豐金證券",18,0,18
"11134","3679新至陞","110/07/07","美林",0,13,-13
"11135","3679新至陞","110/07/07","元大-文心興安",6,0,6
"11136","3679新至陞","110/07/07","兆豐-大安",0,10,-10
"11137","3679新至陞","110/07/07","中農",5,0,5
"11138","3679新至陞","110/07/07","國泰-桃園",0,4,-4
"11139","3679新至陞","110/07/07","台新證券",4,0,4
"11140","3679新至陞","110/07/07","永豐金-虎尾",0,4,-4
"11141","3679新至陞","110/07/07","華南永昌-小港",4,0,4
"11142","3679新至陞","110/07/07","台灣摩根士丹利",0,3,-3
"11143","3679新至陞","110/07/07","元大-天母",4,0,4
"11144","3679新至陞","110/07/07","瑞士信貸",0,3,-3
"11145","3679新至陞","110/07/07","台中銀-員林",4,1,3
"11146","3679新至陞","110/07/07","統一-新竹",0,3,-3
"11147","3679新至陞","110/07/07","摩根大通",4,1,3
"11148","3679新至陞","110/07/07","統一-三重",0,3,-3
"11149","3679新至陞","110/07/07","凱基-台北",7,4,3
"11150","3679新至陞","110/07/07","凱基-竹北",0,3,-3
"11151","3679新至陞","110/07/07","華南永昌-高雄",3,0,3
"11152","3679新至陞","110/07/07","元富-世貿",0,2,-2
"11153","3679新至陞","110/07/07","永豐金-潮州",2,0,2
"11154","3679新至陞","110/07/07","兆豐-鹿港",0,2,-2
"11155","3679新至陞","110/07/07","合庫-新竹",1,0,1
"11156","3679新至陞","110/07/07","玉山-台大",0,2,-2
"11157","3679新至陞","110/07/07","土銀-高雄",1,0,1
"11158","3679新至陞","110/07/07","國泰-館前",0,2,-2
"11159","3679新至陞","110/07/07","元富-新興",1,0,1
"11160","3679新至陞","110/07/07","群益金鼎-新莊",0,2,-2
"11161","3679新至陞","110/07/07","富邦-中壢",1,0,1
"11162","3679新至陞","110/07/07","元大-桃園",0,2,-2
"11163","2727王品","110/07/07","第一金",62,0,62
"11164","2727王品","110/07/07","台灣摩根士丹利",1,177,-176
"11165","2727王品","110/07/07","凱基-埔墘",40,0,40
"11166","2727王品","110/07/07","凱基-台北",49,151,-102
"11167","2727王品","110/07/07","中國信託-忠孝",40,1,39
"11168","2727王品","110/07/07","摩根大通",19,107,-88
"11169","2727王品","110/07/07","玉山-板橋",40,6,34
"11170","2727王品","110/07/07","美商高盛",2,86,-84
"11171","2727王品","110/07/07","亞東-新竹",31,1,30
"11172","2727王品","110/07/07","元大-北屯",1,52,-51
"11173","2727王品","110/07/07","群益金鼎-宜蘭",25,1,24
"11174","2727王品","110/07/07","國泰證券",1,47,-46
"11175","2727王品","110/07/07","富邦-竹北",23,0,23
"11176","2727王品","110/07/07","統一",3,33,-30
"11177","2727王品","110/07/07","元大-旗山",23,0,23
"11178","2727王品","110/07/07","第一金-台中",1,30,-29
"11179","2727王品","110/07/07","元富-宜蘭",21,0,21
"11180","2727王品","110/07/07","華南永昌-中正",4,29,-25
"11181","2727王品","110/07/07","國票-長城",20,0,20
"11182","2727王品","110/07/07","美林",0,23,-23
"11183","2727王品","110/07/07","台新證券",47,28,19
"11184","2727王品","110/07/07","群益金鼎-館前",0,20,-20
"11185","2727王品","110/07/07","富邦-新竹華信",18,1,17
"11186","2727王品","110/07/07","國票-內壢",0,16,-16
"11187","2727王品","110/07/07","永豐金-中正",18,1,17
"11188","2727王品","110/07/07","兆豐-新莊",0,15,-15
"11189","2727王品","110/07/07","華南永昌-麻豆",17,1,16
"11190","2727王品","110/07/07","港商野村",15,28,-13
"11191","2727王品","110/07/07","永豐金-潮州",15,0,15
"11192","2727王品","110/07/07","元大-善化",1,13,-12
"11193","1570力肯","110/07/07","台新證券",88,0,88
"11194","1570力肯","110/07/07","新光",0,54,-54
"11195","1570力肯","110/07/07","摩根大通",49,15,34
"11196","1570力肯","110/07/07","元大-高雄",0,40,-40
"11197","1570力肯","110/07/07","合庫-桃園",20,0,20
"11198","1570力肯","110/07/07","國票-北高雄",38,50,-12
"11199","1570力肯","110/07/07","元大-土城學府",20,0,20
"11200","1570力肯","110/07/07","群益金鼎-嘉義",0,10,-10
"11201","1570力肯","110/07/07","永豐金-板盛",18,0,18
"11202","1570力肯","110/07/07","元大-草屯",0,10,-10
"11203","1570力肯","110/07/07","永豐金-永康",18,0,18
"11204","1570力肯","110/07/07","日盛-高雄",0,9,-9
"11205","1570力肯","110/07/07","統一-員林",14,0,14
"11206","1570力肯","110/07/07","第一金-路竹",0,9,-9
"11207","1570力肯","110/07/07","元大-竹山",6,0,6
"11208","1570力肯","110/07/07","元大-古亭",0,9,-9
"11209","1570力肯","110/07/07","統一-敦南",5,0,5
"11210","1570力肯","110/07/07","國票-中正",0,8,-8
"11211","1570力肯","110/07/07","元大-永和",5,0,5
"11212","1570力肯","110/07/07","群益金鼎-鳳山",0,6,-6
"11213","1570力肯","110/07/07","元富-大裕",4,0,4
"11214","1570力肯","110/07/07","元大-土城永寧",0,6,-6
"11215","1570力肯","110/07/07","華南永昌-斗六",4,0,4
"11216","1570力肯","110/07/07","中國信託",0,5,-5
"11217","1570力肯","110/07/07","永豐金-松山",6,3,3
"11218","1570力肯","110/07/07","日盛-板橋",0,4,-4
"11219","1570力肯","110/07/07","永豐金-南投",4,1,3
"11220","1570力肯","110/07/07","日盛-木柵",0,4,-4
"11221","1570力肯","110/07/07","土銀-彰化",2,0,2
"11222","1570力肯","110/07/07","玉山-桃園",0,4,-4
"11223","6180橘子","110/07/07","臺銀-金山",27,0,27
"11224","6180橘子","110/07/07","凱基-台北",6,36,-30
"11225","6180橘子","110/07/07","元富-潮州",20,0,20
"11226","6180橘子","110/07/07","元大-天母",1,26,-25
"11227","6180橘子","110/07/07","凱基-中山",20,0,20
"11228","6180橘子","110/07/07","富邦-陽明",0,22,-22
"11229","6180橘子","110/07/07","元大-太平",23,4,19
"11230","6180橘子","110/07/07","日盛-頭份",0,20,-20
"11231","6180橘子","110/07/07","摩根大通",17,0,17
"11232","6180橘子","110/07/07","富邦-仁愛",0,20,-20
"11233","6180橘子","110/07/07","元大-草屯",20,3,17
"11234","6180橘子","110/07/07","永豐金-新莊",0,20,-20
"11235","6180橘子","110/07/07","華南永昌-楠梓",15,1,14
"11236","6180橘子","110/07/07","台灣摩根士丹利",0,18,-18
"11237","6180橘子","110/07/07","中國信託-永康",12,0,12
"11238","6180橘子","110/07/07","華南永昌-長虹",1,16,-15
"11239","6180橘子","110/07/07","日盛-文化",10,0,10
"11240","6180橘子","110/07/07","新光-新竹",0,12,-12
"11241","6180橘子","110/07/07","國泰-館前",10,0,10
"11242","6180橘子","110/07/07","凱基-中壢",0,12,-12
"11243","6180橘子","110/07/07","華南永昌-鶯歌",10,0,10
"11244","6180橘子","110/07/07","第一金-忠孝",0,11,-11
"11245","6180橘子","110/07/07","元大-豐原站前",10,0,10
"11246","6180橘子","110/07/07","元大-沙鹿",0,11,-11
"11247","6180橘子","110/07/07","元大-北屯",10,0,10
"11248","6180橘子","110/07/07","永豐金-羅東",0,11,-11
"11249","6180橘子","110/07/07","兆豐-台中",10,1,9
"11250","6180橘子","110/07/07","兆豐-埔墘",0,10,-10
"11251","6180橘子","110/07/07","群益金鼎-開元",9,0,9
"11252","6180橘子","110/07/07","華南永昌-台中",0,10,-10
"11253","2390云辰","110/07/07","元大-向上",144,0,144
"11254","2390云辰","110/07/07","摩根大通",18,674,-656
"11255","2390云辰","110/07/07","元富-中港",102,0,102
"11256","2390云辰","110/07/07","凱基-台北",141,625,-484
"11257","2390云辰","110/07/07","群益金鼎-民權",104,4,100
"11258","2390云辰","110/07/07","美林",32,261,-229
"11259","2390云辰","110/07/07","兆豐-忠孝",81,0,81
"11260","2390云辰","110/07/07","新加坡商瑞銀",50,149,-99
"11261","2390云辰","110/07/07","合庫-新竹",60,0,60
"11262","2390云辰","110/07/07","台灣摩根士丹利",7,87,-80
"11263","2390云辰","110/07/07","元大-土城學府",59,1,58
"11264","2390云辰","110/07/07","元大-金華",2,68,-66
"11265","2390云辰","110/07/07","玉山-大里",58,3,55
"11266","2390云辰","110/07/07","國票-新莊",13,65,-52
"11267","2390云辰","110/07/07","元大-東蘆",54,1,53
"11268","2390云辰","110/07/07","凱基-三重",12,56,-44
"11269","2390云辰","110/07/07","元富-三重",51,0,51
"11270","2390云辰","110/07/07","新光-台中",23,65,-42
"11271","2390云辰","110/07/07","元富-埔里",50,0,50
"11272","2390云辰","110/07/07","第一金-中壢",5,45,-40
"11273","2390云辰","110/07/07","中國信託-三重",52,3,49
"11274","2390云辰","110/07/07","華南永昌-斗六",0,40,-40
"11275","2390云辰","110/07/07","元大-彰化民生",64,15,49
"11276","2390云辰","110/07/07","富邦-新竹華信",25,61,-36
"11277","2390云辰","110/07/07","元大-潮州",50,5,45
"11278","2390云辰","110/07/07","玉山-新莊",2,32,-30
"11279","2390云辰","110/07/07","元富-高雄",57,14,43
"11280","2390云辰","110/07/07","凱基-新豐",17,47,-30
"11281","2390云辰","110/07/07","凱基-和平",40,0,40
"11282","2390云辰","110/07/07","統一-汐止",1,29,-28
"11283","4903聯光通","110/07/06","元大-苗栗",10,0,10
"11284","4903聯光通","110/07/06","宏遠證券",0,13,-13
"11285","4903聯光通","110/07/06","彰銀",5,0,5
"11286","4903聯光通","110/07/06","富邦-新營",0,4,-4
"11287","4903聯光通","110/07/06","元大-松山",5,0,5
"11288","4903聯光通","110/07/06","元富-草屯",0,3,-3
"11289","4903聯光通","110/07/06","新光",3,0,3
"11290","4903聯光通","110/07/06","元大-羅東",0,3,-3
"11291","4903聯光通","110/07/06","群益金鼎-館前",1,0,1
"11292","4903聯光通","110/07/06","元大-北三重",0,2,-2
"11293","4903聯光通","110/07/06","華南永昌-鶯歌",1,0,1
"11294","4903聯光通","110/07/06","國泰-敦南",0,1,-1
"11295","4903聯光通","110/07/06","永豐金-市政",1,0,1
"11296","4903聯光通","110/07/06","元富-板橋",0,0,0
"11297","4903聯光通","110/07/06","元富-板橋",0,0,0
"11298","4903聯光通","110/07/06","華南永昌",0,0,0
"11299","4903聯光通","110/07/06","華南永昌",0,0,0
"11300","4903聯光通","110/07/06","元大-太平",2,2,0
"11301","4903聯光通","110/07/06","元大-太平",2,2,0
"11302","2929淘帝","110/07/06","新光",204,85,119
"11303","2929淘帝","110/07/06","港商野村",62,282,-220
"11304","2929淘帝","110/07/06","日盛-中壢",94,0,94
"11305","2929淘帝","110/07/06","摩根大通",64,264,-200
"11306","2929淘帝","110/07/06","元富-城東",84,0,84
"11307","2929淘帝","110/07/06","統一",0,163,-163
"11308","2929淘帝","110/07/06","日盛-雙和",55,0,55
"11309","2929淘帝","110/07/06","香港上海匯豐",0,141,-141
"11310","2929淘帝","110/07/06","第一金-路竹",71,17,54
"11311","2929淘帝","110/07/06","新加坡商瑞銀",54,179,-125
"11312","2929淘帝","110/07/06","元大-花蓮",44,2,42
"11313","2929淘帝","110/07/06","合庫-高雄",3,122,-119
"11314","2929淘帝","110/07/06","永豐金-大園",73,33,40
"11315","2929淘帝","110/07/06","美林",34,118,-84
"11316","2929淘帝","110/07/06","元大-太平",44,6,38
"11317","2929淘帝","110/07/06","元大-員林",2,82,-80
"11318","2929淘帝","110/07/06","國泰-板橋",40,5,35
"11319","2929淘帝","110/07/06","元富-松德",26,75,-49
"11320","2929淘帝","110/07/06","兆豐-內湖",33,1,32
"11321","2929淘帝","110/07/06","臺銀-臺南",9,52,-43
"11322","2929淘帝","110/07/06","元大-博愛",43,11,32
"11323","2929淘帝","110/07/06","元大-北投",5,48,-43
"11324","2929淘帝","110/07/06","日盛-竹北",40,10,30
"11325","2929淘帝","110/07/06","臺銀-民權",1,41,-40
"11326","2929淘帝","110/07/06","元大-善化",52,22,30
"11327","2929淘帝","110/07/06","兆豐-忠孝",1,41,-40
"11328","2929淘帝","110/07/06","富邦-北港",29,0,29
"11329","2929淘帝","110/07/06","元大-西門",1,36,-35
"11330","2929淘帝","110/07/06","凱基-湖口",27,0,27
"11331","2929淘帝","110/07/06","玉山-嘉義",3,35,-32
"11332","5410國眾","110/07/06","兆豐-城中",28,0,28
"11333","5410國眾","110/07/06","凱基-高美館",1,18,-17
"11334","5410國眾","110/07/06","元大-小港",20,0,20
"11335","5410國眾","110/07/06","國泰-館前",0,15,-15
"11336","5410國眾","110/07/06","元大-新盛",18,0,18
"11337","5410國眾","110/07/06","國泰-板橋",2,17,-15
"11338","5410國眾","110/07/06","香港上海匯豐",15,0,15
"11339","5410國眾","110/07/06","新光",0,13,-13
"11340","5410國眾","110/07/06","華南永昌-小港",15,0,15
"11341","5410國眾","110/07/06","元富-緯城",0,10,-10
"11342","5410國眾","110/07/06","元富-大昌",13,0,13
"11343","5410國眾","110/07/06","中農",0,10,-10
"11344","5410國眾","110/07/06","臺銀-臺南",10,0,10
"11345","5410國眾","110/07/06","凱基-屏東",0,10,-10
"11346","5410國眾","110/07/06","元富-延平",8,0,8
"11347","5410國眾","110/07/06","新光-桃園",0,6,-6
"11348","5410國眾","110/07/06","元大-八德",17,9,8
"11349","5410國眾","110/07/06","高橋-龍潭",0,5,-5
"11350","5410國眾","110/07/06","摩根大通",7,0,7
"11351","5410國眾","110/07/06","元富-世貿",0,5,-5
"11352","5410國眾","110/07/06","凱基-桃園",7,0,7
"11353","5410國眾","110/07/06","群益金鼎-瑞豐",0,5,-5
"11354","5410國眾","110/07/06","永豐金-屏東",7,0,7
"11355","5410國眾","110/07/06","富邦-台中",0,5,-5
"11356","5410國眾","110/07/06","台新-左楠",5,0,5
"11357","5410國眾","110/07/06","永豐金-板橋",0,5,-5
"11358","5410國眾","110/07/06","富邦-竹東",5,0,5
"11359","5410國眾","110/07/06","富邦-台南",0,4,-4
"11360","5410國眾","110/07/06","元大-新莊",5,0,5
"11361","5410國眾","110/07/06","凱基-站前",0,3,-3
"11362","2841台開","110/07/06","群益金鼎-忠孝",100,0,100
"11363","2841台開","110/07/06","港商野村",0,295,-295
"11364","2841台開","110/07/06","台新證券",58,0,58
"11365","2841台開","110/07/06","元大-善化",0,50,-50
"11366","2841台開","110/07/06","台新-台中",58,0,58
"11367","2841台開","110/07/06","元大-四維",0,50,-50
"11368","2841台開","110/07/06","永豐金-敦南",50,0,50
"11369","2841台開","110/07/06","台新-新營",0,30,-30
"11370","2841台開","110/07/06","元大-台中",45,0,45
"11371","2841台開","110/07/06","群益金鼎-桃園",0,21,-21
"11372","2841台開","110/07/06","凱基-文心",43,0,43
"11373","2841台開","110/07/06","台中銀-員林",0,20,-20
"11374","2841台開","110/07/06","永豐金-潮州",30,0,30
"11375","2841台開","110/07/06","群益金鼎-延平",0,15,-15
"11376","2841台開","110/07/06","第一金-自由",25,0,25
"11377","2841台開","110/07/06","元大-三重",0,13,-13
"11378","2841台開","110/07/06","美商高盛",17,0,17
"11379","2841台開","110/07/06","元富-古亭",0,10,-10
"11380","2841台開","110/07/06","大昌-安康",39,22,17
"11381","2841台開","110/07/06","群益金鼎-北高雄",0,10,-10
"11382","2841台開","110/07/06","台中銀",15,0,15
"11383","2841台開","110/07/06","華南永昌-南京",0,10,-10
"11384","2841台開","110/07/06","玉山-嘉義",15,0,15
"11385","2841台開","110/07/06","富邦-花蓮",0,10,-10
"11386","2841台開","110/07/06","新光",11,0,11
"11387","2841台開","110/07/06","富邦-高雄",0,10,-10
"11388","2841台開","110/07/06","兆豐-永和",10,0,10
"11389","2841台開","110/07/06","元大-竹山",0,10,-10
"11390","2841台開","110/07/06","康和-內湖",10,0,10
"11391","2841台開","110/07/06","元大-屏東",0,10,-10
"11392","6207雷科","110/07/06","新光",45,4,41
"11393","6207雷科","110/07/06","凱基-高美館",1,104,-103
"11394","6207雷科","110/07/06","統一-基隆",30,0,30
"11395","6207雷科","110/07/06","摩根大通",11,45,-34
"11396","6207雷科","110/07/06","康和-南崁",13,0,13
"11397","6207雷科","110/07/06","群益金鼎-新竹",0,22,-22
"11398","6207雷科","110/07/06","宏遠-台南",10,0,10
"11399","6207雷科","110/07/06","港商野村",2,23,-21
"11400","6207雷科","110/07/06","國票-和平",10,0,10
"11401","6207雷科","110/07/06","凱基-台北",0,14,-14
"11402","6207雷科","110/07/06","永豐金-天母",10,0,10
"11403","6207雷科","110/07/06","台新-三民",0,12,-12
"11404","6207雷科","110/07/06","台新證券",10,1,9
"11405","6207雷科","110/07/06","群益金鼎-開元",1,11,-10
"11406","6207雷科","110/07/06","群益金鼎-士林",8,0,8
"11407","6207雷科","110/07/06","富邦-南屯",0,8,-8
"11408","6207雷科","110/07/06","群益金鼎-瑞豐",7,0,7
"11409","6207雷科","110/07/06","元大-善化",0,8,-8
"11410","6207雷科","110/07/06","元大-四維",7,0,7
"11411","6207雷科","110/07/06","日盛-頭份",0,5,-5
"11412","6207雷科","110/07/06","國票-中和",6,0,6
"11413","6207雷科","110/07/06","第一金-高雄",0,5,-5
"11414","6207雷科","110/07/06","台新-中壢",6,0,6
"11415","6207雷科","110/07/06","凱基-八德",0,5,-5
"11416","6207雷科","110/07/06","凱基-高雄",6,0,6
"11417","6207雷科","110/07/06","凱基-頭份",0,5,-5
"11418","6207雷科","110/07/06","富邦-彰化",6,0,6
"11419","6207雷科","110/07/06","合庫-新竹",0,4,-4
"11420","6207雷科","110/07/06","凱基-大安",5,0,5
"11421","6207雷科","110/07/06","新光-高雄",0,4,-4
"11422","3679新至陞","110/07/06","凱基",11,0,11
"11423","3679新至陞","110/07/06","摩根大通",0,22,-22
"11424","3679新至陞","110/07/06","台中銀-員林",11,1,10
"11425","3679新至陞","110/07/06","凱基-台北",6,21,-15
"11426","3679新至陞","110/07/06","安泰-大發",10,0,10
"11427","3679新至陞","110/07/06","瑞士信貸",0,13,-13
"11428","3679新至陞","110/07/06","香港上海匯豐",8,0,8
"11429","3679新至陞","110/07/06","富邦-苗栗",0,10,-10
"11430","3679新至陞","110/07/06","永豐金證券",8,2,6
"11431","3679新至陞","110/07/06","元大-永春",0,6,-6
"11432","3679新至陞","110/07/06","第一金-高雄",5,0,5
"11433","3679新至陞","110/07/06","凱基-興隆",0,5,-5
"11434","3679新至陞","110/07/06","群益金鼎-高盛",3,0,3
"11435","3679新至陞","110/07/06","國泰-桃園",0,3,-3
"11436","3679新至陞","110/07/06","元大-嘉義",3,0,3
"11437","3679新至陞","110/07/06","元大-萬華",2,5,-3
"11438","3679新至陞","110/07/06","臺銀-高雄",2,0,2
"11439","3679新至陞","110/07/06","美林",0,2,-2
"11440","3679新至陞","110/07/06","日盛-復興",2,0,2
"11441","3679新至陞","110/07/06","第一金-華江",0,2,-2
"11442","3679新至陞","110/07/06","日盛-樹林",4,2,2
"11443","3679新至陞","110/07/06","新光-台中",0,2,-2
"11444","3679新至陞","110/07/06","宏遠-館前",2,0,2
"11445","3679新至陞","110/07/06","華南永昌-民權",0,2,-2
"11446","3679新至陞","110/07/06","台新證券",2,0,2
"11447","3679新至陞","110/07/06","元大-板橋",0,2,-2
"11448","3679新至陞","110/07/06","康和-板橋",2,0,2
"11449","3679新至陞","110/07/06","日盛-板橋中山",0,1,-1
"11450","3679新至陞","110/07/06","群益金鼎-台南",2,0,2
"11451","3679新至陞","110/07/06","宏遠證券",0,1,-1
"11452","2727王品","110/07/06","元大證券",1033,729,304
"11453","2727王品","110/07/06","台灣摩根士丹利",35,184,-149
"11454","2727王品","110/07/06","富邦-台北",332,46,286
"11455","2727王品","110/07/06","元大-北屯",11,79,-68
"11456","2727王品","110/07/06","統一",252,43,209
"11457","2727王品","110/07/06","元富-敦南",4,70,-66
"11458","2727王品","110/07/06","永豐金-松山",147,14,133
"11459","2727王品","110/07/06","元大-基隆孝二",11,75,-64
"11460","2727王品","110/07/06","富邦-嘉義",301,198,103
"11461","2727王品","110/07/06","臺銀-臺南",9,69,-60
"11462","2727王品","110/07/06","新加坡商瑞銀",128,34,94
"11463","2727王品","110/07/06","中國信託-忠孝",5,48,-43
"11464","2727王品","110/07/06","元富-台南",97,6,91
"11465","2727王品","110/07/06","永豐金-市政",5,46,-41
"11466","2727王品","110/07/06","台新證券",169,105,64
"11467","2727王品","110/07/06","彰銀-台中",19,56,-37
"11468","2727王品","110/07/06","美林",115,58,57
"11469","2727王品","110/07/06","玉山證券",30,67,-37
"11470","2727王品","110/07/06","華南永昌",75,23,52
"11471","2727王品","110/07/06","凱基-埔墘",4,41,-37
"11472","2727王品","110/07/06","凱基-台北",445,398,47
"11473","2727王品","110/07/06","永豐金-大園",3,40,-37
"11474","2727王品","110/07/06","凱基-大直",48,7,41
"11475","2727王品","110/07/06","元富",2,37,-35
"11476","2727王品","110/07/06","凱基-林口",45,4,41
"11477","2727王品","110/07/06","富邦-仁愛",32,64,-32
"11478","2727王品","110/07/06","德信",40,1,39
"11479","2727王品","110/07/06","玉山-板橋",52,82,-30
"11480","2727王品","110/07/06","第一金",42,5,37
"11481","2727王品","110/07/06","中國信託-文心",10,39,-29
"11482","1570力肯","110/07/06","香港上海匯豐",47,0,47
"11483","1570力肯","110/07/06","新光",2,107,-105
"11484","1570力肯","110/07/06","元大-高雄",55,16,39
"11485","1570力肯","110/07/06","摩根大通",11,58,-47
"11486","1570力肯","110/07/06","元富-緯城",37,0,37
"11487","1570力肯","110/07/06","高橋",4,50,-46
"11488","1570力肯","110/07/06","台新-台南",16,0,16
"11489","1570力肯","110/07/06","合庫-桃園",0,20,-20
"11490","1570力肯","110/07/06","元大-新竹經國",14,0,14
"11491","1570力肯","110/07/06","永豐金-板盛",0,18,-18
"11492","1570力肯","110/07/06","富邦-左營",12,0,12
"11493","1570力肯","110/07/06","華南永昌-公誠",0,9,-9
"11494","1570力肯","110/07/06","國票-中正",12,2,10
"11495","1570力肯","110/07/06","凱基-台北",1,9,-8
"11496","1570力肯","110/07/06","國票-博愛",10,0,10
"11497","1570力肯","110/07/06","臺銀-臺中",0,6,-6
"11498","1570力肯","110/07/06","統一-敦南",12,5,7
"11499","1570力肯","110/07/06","台新-三民",0,5,-5
"11500","1570力肯","110/07/06","群益金鼎-三重",7,0,7
"11501","1570力肯","110/07/06","華南永昌-麻豆",0,5,-5
"11502","1570力肯","110/07/06","臺銀-臺南",6,0,6
"11503","1570力肯","110/07/06","合庫-台南",0,4,-4
"11504","1570力肯","110/07/06","大慶-蘆洲",6,0,6
"11505","1570力肯","110/07/06","統一-員林",0,4,-4
"11506","1570力肯","110/07/06","元富-新店",6,0,6
"11507","1570力肯","110/07/06","康和-澎湖",0,4,-4
"11508","1570力肯","110/07/06","玉山-雙和",7,1,6
"11509","1570力肯","110/07/06","華南永昌-斗六",0,4,-4
"11510","1570力肯","110/07/06","永豐金-敦南",9,3,6
"11511","1570力肯","110/07/06","元大-和平",0,4,-4
"11512","6180橘子","110/07/06","凱基-台北",72,12,60
"11513","6180橘子","110/07/06","臺銀-金山",5,105,-100
"11514","6180橘子","110/07/06","美林",29,0,29
"11515","6180橘子","110/07/06","元大-台中",0,100,-100
"11516","6180橘子","110/07/06","合庫-自強",21,0,21
"11517","6180橘子","110/07/06","康和-台南",3,50,-47
"11518","6180橘子","110/07/06","凱基-三峽",17,0,17
"11519","6180橘子","110/07/06","元大-中和",0,35,-35
"11520","6180橘子","110/07/06","富邦-虎尾",15,1,14
"11521","6180橘子","110/07/06","中國信託-忠孝",0,16,-16
"11522","6180橘子","110/07/06","元富-潮州",13,0,13
"11523","6180橘子","110/07/06","玉山-高雄",0,12,-12
"11524","6180橘子","110/07/06","中國信託-永康",13,0,13
"11525","6180橘子","110/07/06","港商野村",0,11,-11
"11526","6180橘子","110/07/06","元大-草屯",18,5,13
"11527","6180橘子","110/07/06","群益金鼎-松山",0,11,-11
"11528","6180橘子","110/07/06","臺銀",11,0,11
"11529","6180橘子","110/07/06","永豐金-豐原",0,11,-11
"11530","6180橘子","110/07/06","新光",15,4,11
"11531","6180橘子","110/07/06","元富-嘉義",5,15,-10
"11532","6180橘子","110/07/06","元大-竹東",11,0,11
"11533","6180橘子","110/07/06","玉山-士林",0,10,-10
"11534","6180橘子","110/07/06","宏遠-台中",10,0,10
"11535","6180橘子","110/07/06","凱基-北門",0,10,-10
"11536","6180橘子","110/07/06","第一金-台南",10,0,10
"11537","6180橘子","110/07/06","第一金-忠孝",0,9,-9
"11538","6180橘子","110/07/06","國泰-敦南",10,0,10
"11539","6180橘子","110/07/06","統一-基隆",0,9,-9
"11540","6180橘子","110/07/06","富邦-嘉義",10,0,10
"11541","6180橘子","110/07/06","安泰-大發",1,10,-9
"11542","2390云辰","110/07/06","元大-天母",975,276,699
"11543","2390云辰","110/07/06","台灣摩根士丹利",3,265,-262
"11544","2390云辰","110/07/06","摩根大通",688,312,376
"11545","2390云辰","110/07/06","群益金鼎-海山",3,166,-163
"11546","2390云辰","110/07/06","國泰-忠孝",164,3,161
"11547","2390云辰","110/07/06","國泰-敦南",188,339,-151
"11548","2390云辰","110/07/06","富邦-北港",140,7,133
"11549","2390云辰","110/07/06","元大-土城學府",12,119,-107
"11550","2390云辰","110/07/06","聯邦商銀",151,22,129
"11551","2390云辰","110/07/06","永豐金-高雄",4,103,-99
"11552","2390云辰","110/07/06","中國信託-文心",143,17,126
"11553","2390云辰","110/07/06","土銀-士林",0,94,-94
"11554","2390云辰","110/07/06","永豐金-中正",133,7,126
"11555","2390云辰","110/07/06","元大-佳里",11,91,-80
"11556","2390云辰","110/07/06","群益金鼎-大興",178,76,102
"11557","2390云辰","110/07/06","玉山-台中",10,86,-76
"11558","2390云辰","110/07/06","元富-中港",103,3,100
"11559","2390云辰","110/07/06","新光",251,324,-73
"11560","2390云辰","110/07/06","統一-新台中",104,12,92
"11561","2390云辰","110/07/06","富邦-敦南",29,101,-72
"11562","2390云辰","110/07/06","新加坡商瑞銀",211,120,91
"11563","2390云辰","110/07/06","兆豐-台中",0,58,-58
"11564","2390云辰","110/07/06","兆豐-忠孝",100,11,89
"11565","2390云辰","110/07/06","日盛證券",16,73,-57
"11566","2390云辰","110/07/06","凱基-林口",87,9,78
"11567","2390云辰","110/07/06","元大-東泰",5,61,-56
"11568","2390云辰","110/07/06","元富-西松",72,4,68
"11569","2390云辰","110/07/06","台新證券",136,190,-54
"11570","2390云辰","110/07/06","台新-左楠",66,9,57
"11571","2390云辰","110/07/06","元大-六合",10,63,-53
