"","stake","date","name","buy","sell","total"
"1","2409友達","110/08/26","瑞士信貸",5742,260,5482
"2","2409友達","110/08/26","台灣摩根士丹利",0,14178,-14178
"3","2409友達","110/08/26","合庫證券",2042,26,2016
"4","2409友達","110/08/26","永豐金證券",1250,5082,-3832
"5","2409友達","110/08/26","富邦-竹北",1538,15,1523
"6","2409友達","110/08/26","元大證券",2913,6388,-3475
"7","2409友達","110/08/26","新加坡商瑞銀",3216,1839,1377
"8","2409友達","110/08/26","元富",57,1810,-1753
"9","2409友達","110/08/26","統一-中壢",1303,254,1049
"10","2409友達","110/08/26","新光-桃園",116,1416,-1300
"11","2409友達","110/08/26","美林",2739,1770,969
"12","2409友達","110/08/26","元大-南屯",185,1037,-852
"13","2409友達","110/08/26","玉山證券",934,96,838
"14","2409友達","110/08/26","摩根大通",1924,2694,-770
"15","2409友達","110/08/26","第一金-中壢",848,13,835
"16","2409友達","110/08/26","香港上海匯豐",120,777,-657
"17","2409友達","110/08/26","台新證券",985,418,567
"18","2409友達","110/08/26","兆豐-台中",12,635,-623
"19","2409友達","110/08/26","美商高盛",1582,1030,552
"20","2409友達","110/08/26","元大-敦南",18,506,-488
"21","2409友達","110/08/26","富邦-新竹",587,92,495
"22","2409友達","110/08/26","國泰證券",30,503,-473
"23","2409友達","110/08/26","元大-員林中山",478,26,452
"24","2409友達","110/08/26","元大-東蘆",118,570,-452
"25","2409友達","110/08/26","元大-清水",462,12,450
"26","2409友達","110/08/26","港商野村",3731,4150,-419
"27","2409友達","110/08/26","新光",1195,749,446
"28","2409友達","110/08/26","大展",48,380,-332
"29","2409友達","110/08/26","兆豐-桃園",469,57,412
"30","2409友達","110/08/26","臺銀-臺中",319,608,-289
"31","1315達新","110/08/26","豐農",32,0,32
"32","1315達新","110/08/26","永豐金證券",1,17,-16
"33","1315達新","110/08/26","統一-台中",5,0,5
"34","1315達新","110/08/26","凱基-台北",0,9,-9
"35","1315達新","110/08/26","凱基-中港",5,0,5
"36","1315達新","110/08/26","永豐金-市政",0,8,-8
"37","1315達新","110/08/26","台灣摩根士丹利",5,1,4
"38","1315達新","110/08/26","富邦-台中",0,5,-5
"39","1315達新","110/08/26","美商高盛",4,0,4
"40","1315達新","110/08/26","元大-花蓮",0,5,-5
"41","1315達新","110/08/26","聯邦-三重",2,0,2
"42","1315達新","110/08/26","日盛-新竹",0,2,-2
"43","1315達新","110/08/26","富邦-內湖",2,0,2
"44","1315達新","110/08/26","美林",0,2,-2
"45","1315達新","110/08/26","永興",1,0,1
"46","1315達新","110/08/26","兆豐-南京",0,2,-2
"47","1315達新","110/08/26","致和-佳里",1,0,1
"48","1315達新","110/08/26","國泰-台中",1,3,-2
"49","1315達新","110/08/26","凱基-三重",1,0,1
"50","1315達新","110/08/26","華南永昌-楠梓",0,2,-2
"51","1315達新","110/08/26","凱基-高美館",1,0,1
"52","1315達新","110/08/26","瑞士信貸",0,1,-1
"53","1315達新","110/08/26","凱基-內埔",1,0,1
"54","1315達新","110/08/26","花旗環球",0,1,-1
"55","1315達新","110/08/26","元大證券",1,0,1
"56","1315達新","110/08/26","亞東-台南",0,1,-1
"57","1315達新","110/08/26","元大-沙鹿",1,0,1
"58","1315達新","110/08/26","第一金",0,1,-1
"59","1315達新","110/08/26","元大-台北",1,0,1
"60","1315達新","110/08/26","元富-花蓮",0,1,-1
"61","2609陽明","110/08/26","永豐金-信義",3562,119,3443
"62","2609陽明","110/08/26","凱基-台北",2973,9333,-6360
"63","2609陽明","110/08/26","康和",4424,1135,3289
"64","2609陽明","110/08/26","台灣摩根士丹利",92,1881,-1789
"65","2609陽明","110/08/26","摩根大通",6387,3687,2700
"66","2609陽明","110/08/26","美林",515,1703,-1188
"67","2609陽明","110/08/26","兆豐-三民",2069,35,2034
"68","2609陽明","110/08/26","兆豐-中壢",10,856,-846
"69","2609陽明","110/08/26","花旗環球",1142,0,1142
"70","2609陽明","110/08/26","富邦-台東",35,624,-589
"71","2609陽明","110/08/26","統一-敦南",2070,936,1134
"72","2609陽明","110/08/26","瑞士信貸",390,948,-558
"73","2609陽明","110/08/26","兆豐-南京",1088,76,1012
"74","2609陽明","110/08/26","日盛-板橋",169,679,-510
"75","2609陽明","110/08/26","富邦-建國",1011,325,686
"76","2609陽明","110/08/26","宏遠證券",1001,1420,-419
"77","2609陽明","110/08/26","兆豐-虎尾",4061,3405,656
"78","2609陽明","110/08/26","元大證券",1362,1772,-410
"79","2609陽明","110/08/26","凱基-市政",1854,1349,505
"80","2609陽明","110/08/26","富邦-南屯",218,600,-382
"81","2609陽明","110/08/26","國票-彰化",1013,618,395
"82","2609陽明","110/08/26","新加坡商瑞銀",1501,1879,-378
"83","2609陽明","110/08/26","元大-樹林",436,112,324
"84","2609陽明","110/08/26","兆豐-彰化",382,743,-361
"85","2609陽明","110/08/26","群益金鼎",517,212,305
"86","2609陽明","110/08/26","富邦-虎尾",3490,3837,-347
"87","2609陽明","110/08/26","元富-文心",572,288,284
"88","2609陽明","110/08/26","寶盛",15,315,-300
"89","2609陽明","110/08/26","兆豐-埔墘",354,143,211
"90","2609陽明","110/08/26","華南永昌-竹北",709,1009,-300
"91","2636台驊投控","110/08/26","富邦-台北",72,6,66
"92","2636台驊投控","110/08/26","凱基-台北",566,1251,-685
"93","2636台驊投控","110/08/26","元大-松江",77,15,62
"94","2636台驊投控","110/08/26","瑞士信貸",31,462,-431
"95","2636台驊投控","110/08/26","永豐金-嘉義",114,54,60
"96","2636台驊投控","110/08/26","美商高盛",35,394,-359
"97","2636台驊投控","110/08/26","華南永昌-南京",78,22,56
"98","2636台驊投控","110/08/26","台灣摩根士丹利",7,344,-337
"99","2636台驊投控","110/08/26","國泰-敦南",176,125,51
"100","2636台驊投控","110/08/26","國票-彰化",466,763,-297
"101","2636台驊投控","110/08/26","宏遠-館前",50,0,50
"102","2636台驊投控","110/08/26","美林",290,532,-242
"103","2636台驊投控","110/08/26","群益金鼎-海山",62,18,44
"104","2636台驊投控","110/08/26","兆豐-中壢",30,234,-204
"105","2636台驊投控","110/08/26","第一金-中壢",50,7,43
"106","2636台驊投控","110/08/26","港商野村",679,881,-202
"107","2636台驊投控","110/08/26","兆豐-南京",54,11,43
"108","2636台驊投控","110/08/26","元富-西松",54,219,-165
"109","2636台驊投控","110/08/26","富邦-嘉義",53,11,42
"110","2636台驊投控","110/08/26","元大-淡水",8,54,-46
"111","2636台驊投控","110/08/26","新光",183,143,40
"112","2636台驊投控","110/08/26","元大-士林",41,82,-41
"113","2636台驊投控","110/08/26","元大-林森",42,3,39
"114","2636台驊投控","110/08/26","新加坡商瑞銀",127,164,-37
"115","2636台驊投控","110/08/26","日盛-忠孝",45,9,36
"116","2636台驊投控","110/08/26","摩根大通",363,399,-36
"117","2636台驊投控","110/08/26","華南永昌-合泰",56,20,36
"118","2636台驊投控","110/08/26","日盛-永康",14,43,-29
"119","2636台驊投控","110/08/26","日盛-木柵",46,11,35
"120","2636台驊投控","110/08/26","台中銀-台北",5,33,-28
"121","2867三商壽","110/08/26","美林",559,133,426
"122","2867三商壽","110/08/26","台灣摩根士丹利",25,307,-282
"123","2867三商壽","110/08/26","瑞士信貸",223,8,215
"124","2867三商壽","110/08/26","凱基-中港",2,279,-277
"125","2867三商壽","110/08/26","日盛-頭份",108,0,108
"126","2867三商壽","110/08/26","花旗環球",0,180,-180
"127","2867三商壽","110/08/26","臺銀-臺中",103,0,103
"128","2867三商壽","110/08/26","元大-桃園",20,199,-179
"129","2867三商壽","110/08/26","日盛-樹林",100,0,100
"130","2867三商壽","110/08/26","國泰證券",0,150,-150
"131","2867三商壽","110/08/26","新光",90,1,89
"132","2867三商壽","110/08/26","凱基-台北",18,156,-138
"133","2867三商壽","110/08/26","光和",80,0,80
"134","2867三商壽","110/08/26","凱基-長庚",0,120,-120
"135","2867三商壽","110/08/26","兆豐-城中",70,0,70
"136","2867三商壽","110/08/26","摩根大通",59,172,-113
"137","2867三商壽","110/08/26","凱基-高雄",60,0,60
"138","2867三商壽","110/08/26","群益金鼎-大甲",0,90,-90
"139","2867三商壽","110/08/26","凱基-林口",50,0,50
"140","2867三商壽","110/08/26","中國信託-忠孝",0,70,-70
"141","2867三商壽","110/08/26","富邦-高雄",60,11,49
"142","2867三商壽","110/08/26","兆豐-新營",0,50,-50
"143","2867三商壽","110/08/26","港商野村",66,29,37
"144","2867三商壽","110/08/26","台灣企銀",0,40,-40
"145","2867三商壽","110/08/26","大昌-新店",37,0,37
"146","2867三商壽","110/08/26","華南永昌-高雄",24,60,-36
"147","2867三商壽","110/08/26","國票-南崁",30,0,30
"148","2867三商壽","110/08/26","兆豐-西螺",0,30,-30
"149","2867三商壽","110/08/26","中農",25,0,25
"150","2867三商壽","110/08/26","兆豐-斗南",0,30,-30
"151","5521工信","110/08/26","摩根大通",563,0,563
"152","5521工信","110/08/26","華南永昌-民權",0,100,-100
"153","5521工信","110/08/26","凱基-台北",346,17,329
"154","5521工信","110/08/26","台灣摩根士丹利",14,103,-89
"155","5521工信","110/08/26","群益金鼎-大甲",145,0,145
"156","5521工信","110/08/26","富邦-台北",0,47,-47
"157","5521工信","110/08/26","美林",61,9,52
"158","5521工信","110/08/26","國泰-板橋",0,46,-46
"159","5521工信","110/08/26","兆豐-嘉義",50,0,50
"160","5521工信","110/08/26","元富-新店",0,40,-40
"161","5521工信","110/08/26","美商高盛",49,0,49
"162","5521工信","110/08/26","中國信託-三重",0,40,-40
"163","5521工信","110/08/26","日進",45,0,45
"164","5521工信","110/08/26","永豐金-中盛",0,33,-33
"165","5521工信","110/08/26","元大證券",47,2,45
"166","5521工信","110/08/26","日盛-中壢",0,32,-32
"167","5521工信","110/08/26","康和-台中",30,0,30
"168","5521工信","110/08/26","新光",0,32,-32
"169","5521工信","110/08/26","福勝",30,12,18
"170","5521工信","110/08/26","富邦-嘉義",0,31,-31
"171","5521工信","110/08/26","港商野村",16,0,16
"172","5521工信","110/08/26","日盛-雙和",0,30,-30
"173","5521工信","110/08/26","統一-屏東",15,0,15
"174","5521工信","110/08/26","國票-安和",0,24,-24
"175","5521工信","110/08/26","日盛-新莊",30,20,10
"176","5521工信","110/08/26","第一金-桃園",0,23,-23
"177","5521工信","110/08/26","日盛-中和",10,0,10
"178","5521工信","110/08/26","日盛-大墩",0,20,-20
"179","5521工信","110/08/26","凱基-高雄",10,0,10
"180","5521工信","110/08/26","第一金-華江",0,20,-20
"181","1471首利","110/08/26","瑞士信貸",60,4,56
"182","1471首利","110/08/26","群益金鼎-東大",0,120,-120
"183","1471首利","110/08/26","永豐金-台南",34,0,34
"184","1471首利","110/08/26","元大-敦化",0,86,-86
"185","1471首利","110/08/26","大慶",25,0,25
"186","1471首利","110/08/26","美林",0,40,-40
"187","1471首利","110/08/26","台中銀-員林",20,0,20
"188","1471首利","110/08/26","台灣摩根士丹利",0,36,-36
"189","1471首利","110/08/26","群益金鼎-土城",20,0,20
"190","1471首利","110/08/26","摩根大通",25,61,-36
"191","1471首利","110/08/26","新光",16,0,16
"192","1471首利","110/08/26","元大-內湖",0,30,-30
"193","1471首利","110/08/26","永豐金-大園",11,0,11
"194","1471首利","110/08/26","凱基-五股",0,25,-25
"195","1471首利","110/08/26","永豐金-竹北",11,0,11
"196","1471首利","110/08/26","元大-大甲",0,20,-20
"197","1471首利","110/08/26","第一金-台南",10,0,10
"198","1471首利","110/08/26","台新證券",3,20,-17
"199","1471首利","110/08/26","中國信託",10,0,10
"200","1471首利","110/08/26","兆豐-西螺",0,14,-14
"201","1471首利","110/08/26","中國信託-永康",10,0,10
"202","1471首利","110/08/26","凱基-台北",4,18,-14
"203","1471首利","110/08/26","群益金鼎-海山",10,0,10
"204","1471首利","110/08/26","大慶-富順",0,10,-10
"205","1471首利","110/08/26","富邦-板橋",10,0,10
"206","1471首利","110/08/26","國票-九鼎",0,5,-5
"207","1471首利","110/08/26","元大-永康",10,0,10
"208","1471首利","110/08/26","元大-斗信",0,5,-5
"209","1471首利","110/08/26","元富-草屯",9,0,9
"210","1471首利","110/08/26","永豐金-敦北",0,5,-5
"211","2883開發金","110/08/26","美林",3929,1002,2927
"212","2883開發金","110/08/26","台灣摩根士丹利",24,5752,-5728
"213","2883開發金","110/08/26","元大證券",2303,84,2219
"214","2883開發金","110/08/26","統一",3,2525,-2522
"215","2883開發金","110/08/26","港商法國興業",1967,153,1814
"216","2883開發金","110/08/26","瑞士信貸",71,2033,-1962
"217","2883開發金","110/08/26","玉山證券",1626,46,1580
"218","2883開發金","110/08/26","永豐金-新莊",1,1001,-1000
"219","2883開發金","110/08/26","摩根大通",2510,1213,1297
"220","2883開發金","110/08/26","新加坡商瑞銀",508,1498,-990
"221","2883開發金","110/08/26","元大-草屯",1002,18,984
"222","2883開發金","110/08/26","港商野村",4,846,-842
"223","2883開發金","110/08/26","華南永昌",1021,206,815
"224","2883開發金","110/08/26","香港上海匯豐",0,698,-698
"225","2883開發金","110/08/26","陽信",400,0,400
"226","2883開發金","110/08/26","凱基-台北",725,1403,-678
"227","2883開發金","110/08/26","第一金-台南",314,12,302
"228","2883開發金","110/08/26","永豐金證券",100,493,-393
"229","2883開發金","110/08/26","國泰-館前",373,86,287
"230","2883開發金","110/08/26","美商高盛",32,393,-361
"231","2883開發金","110/08/26","亞東-台中",282,0,282
"232","2883開發金","110/08/26","元富-城東",4,287,-283
"233","2883開發金","110/08/26","台新證券",390,136,254
"234","2883開發金","110/08/26","兆豐-北高雄",172,451,-279
"235","2883開發金","110/08/26","凱基-宜蘭",270,25,245
"236","2883開發金","110/08/26","富邦證券",10,235,-225
"237","2883開發金","110/08/26","凱基-台東",342,113,229
"238","2883開發金","110/08/26","兆豐-三民",2,210,-208
"239","2883開發金","110/08/26","永豐金-竹科",233,10,223
"240","2883開發金","110/08/26","新光",885,1069,-184
"241","6205詮欣","110/08/26","凱基-信義",20,0,20
"242","6205詮欣","110/08/26","永豐金-敦南",0,30,-30
"243","6205詮欣","110/08/26","凱基-長庚",11,0,11
"244","6205詮欣","110/08/26","凱基-台北",0,9,-9
"245","6205詮欣","110/08/26","日盛-北高雄",5,0,5
"246","6205詮欣","110/08/26","凱基-台南",0,7,-7
"247","6205詮欣","110/08/26","台中銀",5,0,5
"248","6205詮欣","110/08/26","摩根大通",4,10,-6
"249","6205詮欣","110/08/26","臺銀-民權",4,0,4
"250","6205詮欣","110/08/26","兆豐-公益",0,4,-4
"251","6205詮欣","110/08/26","臺銀-臺中",3,0,3
"252","6205詮欣","110/08/26","永豐金證券",0,4,-4
"253","6205詮欣","110/08/26","台新-屏東",3,0,3
"254","6205詮欣","110/08/26","港商法國興業",0,3,-3
"255","6205詮欣","110/08/26","日盛-土城",2,0,2
"256","6205詮欣","110/08/26","瑞士信貸",0,2,-2
"257","6205詮欣","110/08/26","中農",2,0,2
"258","6205詮欣","110/08/26","亞東",0,2,-2
"259","6205詮欣","110/08/26","玉山-台大",2,0,2
"260","6205詮欣","110/08/26","新光-高雄",0,2,-2
"261","6205詮欣","110/08/26","玉山-大里",2,0,2
"262","6205詮欣","110/08/26","元大-屏東民生",0,2,-2
"263","6205詮欣","110/08/26","國泰-板橋",2,0,2
"264","6205詮欣","110/08/26","元大-仁愛",0,2,-2
"265","6205詮欣","110/08/26","凱基-高美館",2,0,2
"266","6205詮欣","110/08/26","永豐金-台南",0,2,-2
"267","6205詮欣","110/08/26","華南永昌-台中",2,0,2
"268","6205詮欣","110/08/26","大慶-台南",0,1,-1
"269","6205詮欣","110/08/26","永豐金-中和",2,0,2
"270","6205詮欣","110/08/26","新光",0,1,-1
"271","1540喬福","110/08/26","元大-士林",12,0,12
"272","1540喬福","110/08/26","富邦-中壢",0,14,-14
"273","1540喬福","110/08/26","凱基-中壢",5,0,5
"274","1540喬福","110/08/26","富邦-虎尾",0,13,-13
"275","1540喬福","110/08/26","富邦-仁愛",5,0,5
"276","1540喬福","110/08/26","台新-高雄",0,5,-5
"277","1540喬福","110/08/26","凱基-台北",4,0,4
"278","1540喬福","110/08/26","日盛-花蓮",0,2,-2
"279","1540喬福","110/08/26","富邦-建國",3,0,3
"280","1540喬福","110/08/26","北城證券",0,2,-2
"281","1540喬福","110/08/26","中國信託",2,0,2
"282","1540喬福","110/08/26","元大-南屯",0,1,-1
"283","1540喬福","110/08/26","國泰-忠孝",2,0,2
"284","1540喬福","110/08/26","凱基-北門",0,1,-1
"285","1540喬福","110/08/26","群益金鼎-崇德",2,0,2
"286","1540喬福","110/08/26","統一-員林",0,1,-1
"287","1540喬福","110/08/26","永豐金-埔里",1,0,1
"288","1540喬福","110/08/26","美商高盛",0,1,-1
"289","1540喬福","110/08/26","致和-南京",1,0,1
"290","1540喬福","110/08/26","美林",0,1,-1
"291","1540喬福","110/08/26","華南永昌-中正",1,0,1
"292","1540喬福","110/08/26","康和-板橋",0,0,0
"293","1540喬福","110/08/26","富邦-台北",1,0,1
"294","1540喬福","110/08/26","凱基-竹北",0,0,0
"295","1540喬福","110/08/26","富邦-左營",1,0,1
"296","1540喬福","110/08/26","高橋",0,0,0
"297","1540喬福","110/08/26","華南永昌-敦南",0,0,0
"298","1540喬福","110/08/26","華南永昌-敦南",0,0,0
"299","1540喬福","110/08/26","元大-金門",0,0,0
"300","1540喬福","110/08/26","元大-莒光",0,0,0
"301","2888新光金","110/08/26","瑞士信貸",3038,457,2581
"302","2888新光金","110/08/26","元富-大昌",7,9389,-9382
"303","2888新光金","110/08/26","群益金鼎-崇德",1739,0,1739
"304","2888新光金","110/08/26","元富-城東",37,2318,-2281
"305","2888新光金","110/08/26","富邦-岡山",1647,23,1624
"306","2888新光金","110/08/26","永豐金證券",28,1552,-1524
"307","2888新光金","110/08/26","凱基-台北",3564,2278,1286
"308","2888新光金","110/08/26","國票-長城",500,2005,-1505
"309","2888新光金","110/08/26","致和證券",1108,5,1103
"310","2888新光金","110/08/26","花旗環球",138,1202,-1064
"311","2888新光金","110/08/26","美林",1537,539,998
"312","2888新光金","110/08/26","台灣摩根士丹利",55,1026,-971
"313","2888新光金","110/08/26","群益金鼎-嘉義",903,17,886
"314","2888新光金","110/08/26","元富",1,799,-798
"315","2888新光金","110/08/26","大慶-高雄",832,0,832
"316","2888新光金","110/08/26","元富-世貿",8,776,-768
"317","2888新光金","110/08/26","永豐金-板橋",820,1,819
"318","2888新光金","110/08/26","(牛牛牛)亞-鑫豐",34,645,-611
"319","2888新光金","110/08/26","凱基-桃園",774,15,759
"320","2888新光金","110/08/26","香港上海匯豐",0,600,-600
"321","2888新光金","110/08/26","日盛-忠孝",744,10,734
"322","2888新光金","110/08/26","元大-板橋",37,499,-462
"323","2888新光金","110/08/26","新光",766,153,613
"324","2888新光金","110/08/26","港商法國興業",135,568,-433
"325","2888新光金","110/08/26","合庫-高雄",607,0,607
"326","2888新光金","110/08/26","元大證券",239,634,-395
"327","2888新光金","110/08/26","宏遠-桃園",504,0,504
"328","2888新光金","110/08/26","元富-文心",132,483,-351
"329","2888新光金","110/08/26","凱基-台南",520,23,497
"330","2888新光金","110/08/26","元富-成功",19,358,-339
"331","1340勝悅","110/08/26","元大-基隆孝二",10,0,10
"332","1340勝悅","110/08/26","元大-新盛",0,16,-16
"333","1340勝悅","110/08/26","凱基-台北",9,1,8
"334","1340勝悅","110/08/26","元大-四維",0,11,-11
"335","1340勝悅","110/08/26","國泰-台中",7,0,7
"336","1340勝悅","110/08/26","凱基-松山",0,10,-10
"337","1340勝悅","110/08/26","美林",6,0,6
"338","1340勝悅","110/08/26","元大-東門",0,10,-10
"339","1340勝悅","110/08/26","臺灣企銀-埔墘",5,0,5
"340","1340勝悅","110/08/26","統一-南京",0,8,-8
"341","1340勝悅","110/08/26","統一-城中",5,1,4
"342","1340勝悅","110/08/26","國票-台東",0,5,-5
"343","1340勝悅","110/08/26","群益金鼎-北高雄",4,0,4
"344","1340勝悅","110/08/26","摩根大通",2,7,-5
"345","1340勝悅","110/08/26","日盛-鳳山",3,0,3
"346","1340勝悅","110/08/26","元大-忠孝鼎富",0,5,-5
"347","1340勝悅","110/08/26","元大-林園",5,2,3
"348","1340勝悅","110/08/26","港商法國興業",0,2,-2
"349","1340勝悅","110/08/26","宏遠-桃園",2,0,2
"350","1340勝悅","110/08/26","兆豐-三民",0,2,-2
"351","1340勝悅","110/08/26","第一金-華江",2,0,2
"352","1340勝悅","110/08/26","臺銀",0,1,-1
"353","1340勝悅","110/08/26","中農",2,0,2
"354","1340勝悅","110/08/26","中國信託-文心",0,1,-1
"355","1340勝悅","110/08/26","國泰-敦南",5,3,2
"356","1340勝悅","110/08/26","凱基",0,1,-1
"357","1340勝悅","110/08/26","國泰-館前",2,0,2
"358","1340勝悅","110/08/26","富邦-嘉義",0,1,-1
"359","1340勝悅","110/08/26","富邦-北港",2,0,2
"360","1340勝悅","110/08/26","元大-東泰",0,1,-1
"361","6246臺龍","110/08/26","兆豐-內湖",40,0,40
"362","6246臺龍","110/08/26","兆豐-忠孝",0,20,-20
"363","6246臺龍","110/08/26","新光-台中",11,0,11
"364","6246臺龍","110/08/26","統一-台南",0,15,-15
"365","6246臺龍","110/08/26","凱基-永康",10,0,10
"366","6246臺龍","110/08/26","聯邦-大業",0,10,-10
"367","6246臺龍","110/08/26","元大-屏南",10,0,10
"368","6246臺龍","110/08/26","港商野村",0,9,-9
"369","6246臺龍","110/08/26","元富-板橋",5,0,5
"370","6246臺龍","110/08/26","元大-員林",0,6,-6
"371","6246臺龍","110/08/26","元大-北港",5,0,5
"372","6246臺龍","110/08/26","元富-宜蘭",0,5,-5
"373","6246臺龍","110/08/26","元大-小港",5,0,5
"374","6246臺龍","110/08/26","永豐金-板橋",0,5,-5
"375","6246臺龍","110/08/26","兆豐-竹北",4,0,4
"376","6246臺龍","110/08/26","兆豐-公益",0,4,-4
"377","6246臺龍","110/08/26","華南永昌-台中",4,0,4
"378","6246臺龍","110/08/26","兆豐-新營",0,4,-4
"379","6246臺龍","110/08/26","華南永昌-彰化",3,0,3
"380","6246臺龍","110/08/26","國票-新莊",0,4,-4
"381","6246臺龍","110/08/26","元大-大雅",3,0,3
"382","6246臺龍","110/08/26","玉山證券",0,4,-4
"383","6246臺龍","110/08/26","土銀-新竹",2,0,2
"384","6246臺龍","110/08/26","凱基-長庚",0,4,-4
"385","6246臺龍","110/08/26","日盛-八德",2,0,2
"386","6246臺龍","110/08/26","永豐金-復興",1,5,-4
"387","6246臺龍","110/08/26","高橋",2,0,2
"388","6246臺龍","110/08/26","元大-永康",0,3,-3
"389","6246臺龍","110/08/26","玉山-台南",2,0,2
"390","6246臺龍","110/08/26","台新證券",0,2,-2
"391","00715L期街口布蘭特正2","110/08/26","元大證券",27288,25,27263
"392","00715L期街口布蘭特正2","110/08/26","宏遠-高雄",0,11055,-11055
"393","00715L期街口布蘭特正2","110/08/26","永豐金證券",6471,22,6449
"394","00715L期街口布蘭特正2","110/08/26","元大-萬華",0,2051,-2051
"395","00715L期街口布蘭特正2","110/08/26","元富",3942,0,3942
"396","00715L期街口布蘭特正2","110/08/26","(牛牛牛)亞-鑫豐",17,1456,-1439
"397","00715L期街口布蘭特正2","110/08/26","合庫證券",3500,20,3480
"398","00715L期街口布蘭特正2","110/08/26","元大-新竹",110,1320,-1210
"399","00715L期街口布蘭特正2","110/08/26","國票",2138,8,2130
"400","00715L期街口布蘭特正2","110/08/26","元大-永康",0,1053,-1053
"401","00715L期街口布蘭特正2","110/08/26","群益金鼎",1740,0,1740
"402","00715L期街口布蘭特正2","110/08/26","華南永昌-台中",102,827,-725
"403","00715L期街口布蘭特正2","110/08/26","統一",1396,3,1393
"404","00715L期街口布蘭特正2","110/08/26","玉山-大里",2,630,-628
"405","00715L期街口布蘭特正2","110/08/26","台新證券",1085,223,862
"406","00715L期街口布蘭特正2","110/08/26","華南永昌",0,606,-606
"407","00715L期街口布蘭特正2","110/08/26","聯邦-三重",550,19,531
"408","00715L期街口布蘭特正2","110/08/26","新光",179,718,-539
"409","00715L期街口布蘭特正2","110/08/26","國票-博愛",550,30,520
"410","00715L期街口布蘭特正2","110/08/26","國泰-敦南",607,1119,-512
"411","00715L期街口布蘭特正2","110/08/26","富邦證券",562,99,463
"412","00715L期街口布蘭特正2","110/08/26","元大-大雅",22,524,-502
"413","00715L期街口布蘭特正2","110/08/26","兆豐證券",600,156,444
"414","00715L期街口布蘭特正2","110/08/26","玉山-新竹",0,489,-489
"415","00715L期街口布蘭特正2","110/08/26","凱基-台北",401,129,272
"416","00715L期街口布蘭特正2","110/08/26","第一金-路竹",5,459,-454
"417","00715L期街口布蘭特正2","110/08/26","凱基-新豐",208,20,188
"418","00715L期街口布蘭特正2","110/08/26","富邦-嘉義",0,406,-406
"419","00715L期街口布蘭特正2","110/08/26","新光-桃園",92,29,63
"420","00715L期街口布蘭特正2","110/08/26","元大-淡水",1,326,-325
"421","8941關中","110/08/26","元大-四維",6,0,6
"422","8941關中","110/08/26","凱基-中山",0,4,-4
"423","8941關中","110/08/26","玉山證券",4,0,4
"424","8941關中","110/08/26","富邦-員林",2,6,-4
"425","8941關中","110/08/26","元富-台中",1,0,1
"426","8941關中","110/08/26","彰銀-台中",0,1,-1
"427","8941關中","110/08/26","元大-斗六",1,0,1
"428","8941關中","110/08/26","第一金-台中",0,1,-1
"429","8941關中","110/08/26","凱基-高美館",3,3,0
"430","8941關中","110/08/26","康和-板橋",0,1,-1
"431","8941關中","110/08/26","元大-金華",3,3,0
"432","8941關中","110/08/26","元大-桃興",1,2,-1
"433","8941關中","110/08/26","永豐金-敦北",0,0,0
"434","8941關中","110/08/26","凱基-高美館",3,3,0
"435","8941關中","110/08/26","永豐金-萬盛",0,0,0
"436","8941關中","110/08/26","元大-金華",3,3,0
"437","8941關中","110/08/26","永豐金-南投",0,0,0
"438","8941關中","110/08/26","永豐金-敦北",0,0,0
"439","8941關中","110/08/26","",NA,NA,NA
"440","8941關中","110/08/26","永豐金-萬盛",0,0,0
"441","8941關中","110/08/26","",NA,NA,NA
"442","8941關中","110/08/26","永豐金-南投",0,0,0
"443","8941關中","110/08/26","",NA,NA,NA
"444","8941關中","110/08/26","",NA,NA,NA
"445","8941關中","110/08/26","",NA,NA,NA
"446","8941關中","110/08/26","",NA,NA,NA
"447","8941關中","110/08/26","",NA,NA,NA
"448","8941關中","110/08/26","",NA,NA,NA
"449","8941關中","110/08/26","",NA,NA,NA
"450","8941關中","110/08/26","",NA,NA,NA
"451","8936國統","110/08/26","永豐金-苓雅",106,0,106
"452","8936國統","110/08/26","元大-蘆洲",0,107,-107
"453","8936國統","110/08/26","台新-高雄",48,2,46
"454","8936國統","110/08/26","元富-新興",0,96,-96
"455","8936國統","110/08/26","元大-天母",43,0,43
"456","8936國統","110/08/26","康和-嘉義",2,79,-77
"457","8936國統","110/08/26","光和-溪湖",40,0,40
"458","8936國統","110/08/26","凱基-台北",1,72,-71
"459","8936國統","110/08/26","元富-敦南",32,0,32
"460","8936國統","110/08/26","新光-台中",30,89,-59
"461","8936國統","110/08/26","中國信託-高雄",31,0,31
"462","8936國統","110/08/26","國票-台東",0,50,-50
"463","8936國統","110/08/26","國票-敦北法人",20,0,20
"464","8936國統","110/08/26","摩根大通",4,39,-35
"465","8936國統","110/08/26","台灣摩根士丹利",14,0,14
"466","8936國統","110/08/26","富邦-陽明",0,30,-30
"467","8936國統","110/08/26","美林",12,0,12
"468","8936國統","110/08/26","新加坡商瑞銀",23,51,-28
"469","8936國統","110/08/26","國泰-館前",12,0,12
"470","8936國統","110/08/26","新光-新竹",5,25,-20
"471","8936國統","110/08/26","第一金-桃園",11,0,11
"472","8936國統","110/08/26","永豐金-北高雄",0,15,-15
"473","8936國統","110/08/26","日盛證券",10,0,10
"474","8936國統","110/08/26","群益金鼎-彰化",0,12,-12
"475","8936國統","110/08/26","日盛-北高雄",10,0,10
"476","8936國統","110/08/26","日盛-忠孝",0,10,-10
"477","8936國統","110/08/26","統一-台中",10,0,10
"478","8936國統","110/08/26","中國信託-松江",0,10,-10
"479","8936國統","110/08/26","兆豐-竹北",10,0,10
"480","8936國統","110/08/26","富邦-三重",0,10,-10
"481","6226光鼎","110/08/26","大展-台南",235,14,221
"482","6226光鼎","110/08/26","摩根大通",0,1105,-1105
"483","6226光鼎","110/08/26","宏遠-光隆",186,32,154
"484","6226光鼎","110/08/26","台灣摩根士丹利",12,742,-730
"485","6226光鼎","110/08/26","兆豐-松德",145,0,145
"486","6226光鼎","110/08/26","元大-大同",6,557,-551
"487","6226光鼎","110/08/26","凱基-台北",204,67,137
"488","6226光鼎","110/08/26","統一",13,410,-397
"489","6226光鼎","110/08/26","合庫-台中",127,13,114
"490","6226光鼎","110/08/26","凱基-永和",10,305,-295
"491","6226光鼎","110/08/26","元大-敦化",97,0,97
"492","6226光鼎","110/08/26","港商野村",193,480,-287
"493","6226光鼎","110/08/26","中國信託-忠孝",97,13,84
"494","6226光鼎","110/08/26","美商高盛",48,329,-281
"495","6226光鼎","110/08/26","國泰-敦南",354,272,82
"496","6226光鼎","110/08/26","美林",73,274,-201
"497","6226光鼎","110/08/26","臺銀-鳳山",84,12,72
"498","6226光鼎","110/08/26","統一-南京",5,205,-200
"499","6226光鼎","110/08/26","元大-木柵",80,12,68
"500","6226光鼎","110/08/26","富邦證券",0,95,-95
"501","6226光鼎","110/08/26","富邦-台北",73,6,67
"502","6226光鼎","110/08/26","凱基-大直",110,187,-77
"503","6226光鼎","110/08/26","永豐金-苓雅",67,0,67
"504","6226光鼎","110/08/26","元大-四維",61,135,-74
"505","6226光鼎","110/08/26","元大-大雅",184,127,57
"506","6226光鼎","110/08/26","群益金鼎-鳳山",2,61,-59
"507","6226光鼎","110/08/26","玉山-板橋",55,0,55
"508","6226光鼎","110/08/26","富邦-建國",18,74,-56
"509","6226光鼎","110/08/26","元大-仁愛",55,0,55
"510","6226光鼎","110/08/26","永豐金-虎尾",1,50,-49
"511","2363矽統","110/08/26","美林",676,159,517
"512","2363矽統","110/08/26","凱基-台北",1056,1726,-670
"513","2363矽統","110/08/26","合庫-基隆",1381,1003,378
"514","2363矽統","110/08/26","宏遠-光隆",18,368,-350
"515","2363矽統","110/08/26","富邦-彰化",380,25,355
"516","2363矽統","110/08/26","台新-台南",56,248,-192
"517","2363矽統","110/08/26","第一金-桃園",311,12,299
"518","2363矽統","110/08/26","日盛-南京",34,170,-136
"519","2363矽統","110/08/26","華南永昌-台中",349,81,268
"520","2363矽統","110/08/26","北城證券",206,329,-123
"521","2363矽統","110/08/26","新光",480,249,231
"522","2363矽統","110/08/26","光和-嘉義",20,137,-117
"523","2363矽統","110/08/26","瑞士信貸",198,3,195
"524","2363矽統","110/08/26","統一-城中",75,189,-114
"525","2363矽統","110/08/26","元大-前金",160,31,129
"526","2363矽統","110/08/26","華南永昌-朴子",28,131,-103
"527","2363矽統","110/08/26","元大-博愛",157,31,126
"528","2363矽統","110/08/26","康和-嘉義",3,101,-98
"529","2363矽統","110/08/26","凱基-嘉義",90,6,84
"530","2363矽統","110/08/26","凱基-中山",8,105,-97
"531","2363矽統","110/08/26","玉山-桃園",104,24,80
"532","2363矽統","110/08/26","台新-台中",29,118,-89
"533","2363矽統","110/08/26","元大-和平",80,13,67
"534","2363矽統","110/08/26","凱基-大直",30,108,-78
"535","2363矽統","110/08/26","第一金-嘉義",71,11,60
"536","2363矽統","110/08/26","亞東-板橋",17,89,-72
"537","2363矽統","110/08/26","新光-桃園",163,105,58
"538","2363矽統","110/08/26","國泰-板橋",93,164,-71
"539","2363矽統","110/08/26","元大-左營",68,13,55
"540","2363矽統","110/08/26","統一-永和",2,62,-60
"541","8112至上","110/08/26","凱基-台北",372,56,316
"542","8112至上","110/08/26","群益金鼎",0,150,-150
"543","8112至上","110/08/26","摩根大通",376,62,314
"544","8112至上","110/08/26","台新-台中",10,113,-103
"545","8112至上","110/08/26","凱基-竹科",151,1,150
"546","8112至上","110/08/26","群益金鼎-基隆",0,90,-90
"547","8112至上","110/08/26","新加坡商瑞銀",191,45,146
"548","8112至上","110/08/26","永豐金-台中",1,80,-79
"549","8112至上","110/08/26","台灣摩根士丹利",129,41,88
"550","8112至上","110/08/26","凱基-東勢",0,50,-50
"551","8112至上","110/08/26","美商高盛",172,92,80
"552","8112至上","110/08/26","凱基-北門",0,50,-50
"553","8112至上","110/08/26","日進",69,3,66
"554","8112至上","110/08/26","元大-西門",0,50,-50
"555","8112至上","110/08/26","兆豐-西螺",60,0,60
"556","8112至上","110/08/26","群益金鼎-高雄",0,40,-40
"557","8112至上","110/08/26","港商野村",63,24,39
"558","8112至上","110/08/26","元富-新莊",0,31,-31
"559","8112至上","110/08/26","元大-竹東",30,0,30
"560","8112至上","110/08/26","日盛-復興",1,31,-30
"561","8112至上","110/08/26","元大-淡水",30,2,28
"562","8112至上","110/08/26","統一-南京",0,30,-30
"563","8112至上","110/08/26","康和",30,5,25
"564","8112至上","110/08/26","凱基-士林",1,31,-30
"565","8112至上","110/08/26","凱基-三重",22,0,22
"566","8112至上","110/08/26","元大-佳里",0,30,-30
"567","8112至上","110/08/26","元大-楊梅",20,1,19
"568","8112至上","110/08/26","台灣企銀-民雄",0,27,-27
"569","8112至上","110/08/26","元大-豐原",20,2,18
"570","8112至上","110/08/26","日盛-台南",0,27,-27
"571","1570力肯","110/08/26","群益金鼎-高雄",34,0,34
"572","1570力肯","110/08/26","永豐金-虎尾",0,50,-50
"573","1570力肯","110/08/26","香港上海匯豐",21,0,21
"574","1570力肯","110/08/26","富邦-高雄",0,38,-38
"575","1570力肯","110/08/26","凱基-台北",9,1,8
"576","1570力肯","110/08/26","華南永昌-麻豆",0,14,-14
"577","1570力肯","110/08/26","國票-台中",7,0,7
"578","1570力肯","110/08/26","摩根大通",0,11,-11
"579","1570力肯","110/08/26","美林",6,0,6
"580","1570力肯","110/08/26","凱基-復興",0,7,-7
"581","1570力肯","110/08/26","群益金鼎-瑞豐",6,0,6
"582","1570力肯","110/08/26","元大-基隆孝二",0,7,-7
"583","1570力肯","110/08/26","日茂-南投",5,0,5
"584","1570力肯","110/08/26","國票-博愛",2,8,-6
"585","1570力肯","110/08/26","兆豐-鹿港",5,0,5
"586","1570力肯","110/08/26","元富-城東",0,5,-5
"587","1570力肯","110/08/26","兆豐-松德",5,0,5
"588","1570力肯","110/08/26","兆豐-中壢",0,4,-4
"589","1570力肯","110/08/26","國票-和平",5,0,5
"590","1570力肯","110/08/26","華南永昌-大安",0,4,-4
"591","1570力肯","110/08/26","凱基-站前",5,0,5
"592","1570力肯","110/08/26","統一-三重",0,3,-3
"593","1570力肯","110/08/26","元大-新竹經國",5,0,5
"594","1570力肯","110/08/26","統一-員林",0,2,-2
"595","1570力肯","110/08/26","元大-草屯",4,0,4
"596","1570力肯","110/08/26","凱基-天母",0,2,-2
"597","1570力肯","110/08/26","(牛牛牛)亞-鑫豐",3,0,3
"598","1570力肯","110/08/26","元大-大里",0,2,-2
"599","1570力肯","110/08/26","國票-北高雄",4,1,3
"600","1570力肯","110/08/26","大慶-富順",0,1,-1
"601","2929淘帝","110/08/26","新光-新竹",47,0,47
"602","2929淘帝","110/08/26","元大-豐原站前",0,20,-20
"603","2929淘帝","110/08/26","摩根大通",20,0,20
"604","2929淘帝","110/08/26","康和-仁愛",0,17,-17
"605","2929淘帝","110/08/26","兆豐-民生",10,0,10
"606","2929淘帝","110/08/26","新光-台中",16,32,-16
"607","2929淘帝","110/08/26","元大-承德",10,0,10
"608","2929淘帝","110/08/26","港商野村",3,15,-12
"609","2929淘帝","110/08/26","元大-萬華",10,0,10
"610","2929淘帝","110/08/26","合庫-自強",0,10,-10
"611","2929淘帝","110/08/26","日盛-和美",5,0,5
"612","2929淘帝","110/08/26","美林",3,12,-9
"613","2929淘帝","110/08/26","台中銀-豐原",5,0,5
"614","2929淘帝","110/08/26","富邦-南屯",1,10,-9
"615","2929淘帝","110/08/26","國泰-敦南",5,0,5
"616","2929淘帝","110/08/26","元富-花蓮",0,8,-8
"617","2929淘帝","110/08/26","元大-大雅",5,0,5
"618","2929淘帝","110/08/26","富邦-高雄",0,8,-8
"619","2929淘帝","110/08/26","元大-蘆洲",5,0,5
"620","2929淘帝","110/08/26","華南永昌-古亭",0,5,-5
"621","2929淘帝","110/08/26","富邦-內湖",4,0,4
"622","2929淘帝","110/08/26","港商法國興業",0,4,-4
"623","2929淘帝","110/08/26","元大-太平",4,0,4
"624","2929淘帝","110/08/26","新加坡商瑞銀",0,4,-4
"625","2929淘帝","110/08/26","新光-台南",3,0,3
"626","2929淘帝","110/08/26","第一金-台南",0,4,-4
"627","2929淘帝","110/08/26","陽信",3,0,3
"628","2929淘帝","110/08/26","凱基-長庚",0,4,-4
"629","2929淘帝","110/08/26","國泰-板橋",3,0,3
"630","2929淘帝","110/08/26","元大-新竹經國",0,4,-4
"631","5410國眾","110/08/26","香港上海匯豐",34,0,34
"632","5410國眾","110/08/26","高橋",0,20,-20
"633","5410國眾","110/08/26","凱基-台北",34,1,33
"634","5410國眾","110/08/26","寶盛",0,10,-10
"635","5410國眾","110/08/26","玉山-高雄",15,0,15
"636","5410國眾","110/08/26","安泰",0,10,-10
"637","5410國眾","110/08/26","富邦-內湖",10,0,10
"638","5410國眾","110/08/26","國泰-敦南",0,10,-10
"639","5410國眾","110/08/26","元大-中壢",7,0,7
"640","5410國眾","110/08/26","國泰-台南",0,9,-9
"641","5410國眾","110/08/26","元大-內湖",7,0,7
"642","5410國眾","110/08/26","玉山-雙和",0,7,-7
"643","5410國眾","110/08/26","康和-新竹",6,0,6
"644","5410國眾","110/08/26","元大-金華",0,7,-7
"645","5410國眾","110/08/26","摩根大通",5,0,5
"646","5410國眾","110/08/26","台新-建北",0,6,-6
"647","5410國眾","110/08/26","凱基-長庚",5,0,5
"648","5410國眾","110/08/26","元大-羅東",0,6,-6
"649","5410國眾","110/08/26","元大-向上",5,0,5
"650","5410國眾","110/08/26","合庫-嘉義",0,5,-5
"651","5410國眾","110/08/26","元大-南屯",5,0,5
"652","5410國眾","110/08/26","新光",1,6,-5
"653","5410國眾","110/08/26","華南永昌-林口",4,0,4
"654","5410國眾","110/08/26","富邦-台北",0,5,-5
"655","5410國眾","110/08/26","台新-中壢",3,0,3
"656","5410國眾","110/08/26","元大-土城",0,5,-5
"657","5410國眾","110/08/26","華南永昌-內壢",3,0,3
"658","5410國眾","110/08/26","臺銀-臺中",0,3,-3
"659","5410國眾","110/08/26","元大-北投",2,0,2
"660","5410國眾","110/08/26","第一金-澎湖",0,3,-3
"661","2841台開","110/08/26","宏遠-館前",180,0,180
"662","2841台開","110/08/26","台中銀",0,50,-50
"663","2841台開","110/08/26","元富-新興",25,0,25
"664","2841台開","110/08/26","港商野村",0,35,-35
"665","2841台開","110/08/26","永豐金-敦南",23,12,11
"666","2841台開","110/08/26","台新-屏東",0,21,-21
"667","2841台開","110/08/26","康和-內湖",8,0,8
"668","2841台開","110/08/26","新加坡商瑞銀",0,20,-20
"669","2841台開","110/08/26","永豐金-古亭",6,0,6
"670","2841台開","110/08/26","新光-新竹",0,20,-20
"671","2841台開","110/08/26","台新-新營",5,0,5
"672","2841台開","110/08/26","元大-彰化民生",0,18,-18
"673","2841台開","110/08/26","玉山證券",5,0,5
"674","2841台開","110/08/26","台灣摩根士丹利",0,12,-12
"675","2841台開","110/08/26","元大-板橋",4,0,4
"676","2841台開","110/08/26","日盛-頭份",0,11,-11
"677","2841台開","110/08/26","國泰-敦南",3,0,3
"678","2841台開","110/08/26","華南永昌-虎尾",0,10,-10
"679","2841台開","110/08/26","日盛-和美",2,0,2
"680","2841台開","110/08/26","元大-承德",0,10,-10
"681","2841台開","110/08/26","台新-台南",2,0,2
"682","2841台開","110/08/26","元大-北三重",0,10,-10
"683","2841台開","110/08/26","凱基-台北",5,3,2
"684","2841台開","110/08/26","富邦-宜蘭",0,7,-7
"685","2841台開","110/08/26","合庫-自強",1,0,1
"686","2841台開","110/08/26","華南永昌-岡山",0,5,-5
"687","2841台開","110/08/26","元富-板橋",1,0,1
"688","2841台開","110/08/26","富邦-中壢",0,5,-5
"689","2841台開","110/08/26","群益金鼎-崇德",1,0,1
"690","2841台開","110/08/26","日盛-二林",0,4,-4
"691","6207雷科","110/08/26","凱基-台北",21,0,21
"692","6207雷科","110/08/26","新加坡商瑞銀",1,63,-62
"693","6207雷科","110/08/26","統一-竹南",18,0,18
"694","6207雷科","110/08/26","凱基-高美館",5,32,-27
"695","6207雷科","110/08/26","凱基-台東",15,0,15
"696","6207雷科","110/08/26","第一金-華江",0,11,-11
"697","6207雷科","110/08/26","元大-六合",12,0,12
"698","6207雷科","110/08/26","國泰-板橋",0,11,-11
"699","6207雷科","110/08/26","元大-大灣",10,0,10
"700","6207雷科","110/08/26","港商野村",10,20,-10
"701","6207雷科","110/08/26","瑞士信貸",7,0,7
"702","6207雷科","110/08/26","國票-中正",0,10,-10
"703","6207雷科","110/08/26","亞東-台南",7,0,7
"704","6207雷科","110/08/26","永豐金-內湖",0,10,-10
"705","6207雷科","110/08/26","寶盛",6,0,6
"706","6207雷科","110/08/26","中國信託-高雄",0,9,-9
"707","6207雷科","110/08/26","永豐金-板新",6,0,6
"708","6207雷科","110/08/26","元大-大同",0,8,-8
"709","6207雷科","110/08/26","日盛-員林",22,17,5
"710","6207雷科","110/08/26","合庫-台中",0,5,-5
"711","6207雷科","110/08/26","第一金-高雄",5,0,5
"712","6207雷科","110/08/26","第一金-中山",0,5,-5
"713","6207雷科","110/08/26","第一金-路竹",5,0,5
"714","6207雷科","110/08/26","德信-和平",0,5,-5
"715","6207雷科","110/08/26","兆豐-三民",5,0,5
"716","6207雷科","110/08/26","群益金鼎-忠孝",0,5,-5
"717","6207雷科","110/08/26","國票-新莊",5,0,5
"718","6207雷科","110/08/26","凱基-長庚",0,5,-5
"719","6207雷科","110/08/26","群益金鼎-高盛",5,0,5
"720","6207雷科","110/08/26","華南永昌-林口",0,5,-5
"721","3679新至陞","110/08/26","永豐金-南投",13,0,13
"722","3679新至陞","110/08/26","凱基-台北",0,11,-11
"723","3679新至陞","110/08/26","元大-大天母",10,0,10
"724","3679新至陞","110/08/26","摩根大通",0,10,-10
"725","3679新至陞","110/08/26","玉山-台大",6,0,6
"726","3679新至陞","110/08/26","美林",0,9,-9
"727","3679新至陞","110/08/26","台灣摩根士丹利",3,2,1
"728","3679新至陞","110/08/26","瑞士信貸",0,5,-5
"729","3679新至陞","110/08/26","亞東-板橋",1,0,1
"730","3679新至陞","110/08/26","華南永昌-嘉義",0,4,-4
"731","3679新至陞","110/08/26","統一-桃園",1,0,1
"732","3679新至陞","110/08/26","元大-福營",0,3,-3
"733","3679新至陞","110/08/26","元富-埔里",1,0,1
"734","3679新至陞","110/08/26","花旗環球",0,1,-1
"735","3679新至陞","110/08/26","台中銀-員林",1,0,1
"736","3679新至陞","110/08/26","新加坡商瑞銀",0,1,-1
"737","3679新至陞","110/08/26","兆豐-來福",1,0,1
"738","3679新至陞","110/08/26","中國信託-永康",0,1,-1
"739","3679新至陞","110/08/26","兆豐-松德",1,0,1
"740","3679新至陞","110/08/26","國票-中和",0,1,-1
"741","3679新至陞","110/08/26","玉山-高雄",2,1,1
"742","3679新至陞","110/08/26","香港上海匯豐",0,1,-1
"743","3679新至陞","110/08/26","凱基-桃園",1,0,1
"744","3679新至陞","110/08/26","富邦-建國",0,1,-1
"745","3679新至陞","110/08/26","凱基-幸福",1,0,1
"746","3679新至陞","110/08/26","富邦-新店",1,2,-1
"747","3679新至陞","110/08/26","凱基-城中",1,0,1
"748","3679新至陞","110/08/26","元大-永春",0,1,-1
"749","3679新至陞","110/08/26","華南永昌-大安",1,0,1
"750","3679新至陞","110/08/26","永豐金證券",0,1,-1
"751","2727王品","110/08/26","瑞士信貸",54,0,54
"752","2727王品","110/08/26","凱基-台北",11,70,-59
"753","2727王品","110/08/26","元大-桃園",26,0,26
"754","2727王品","110/08/26","永豐金證券",0,48,-48
"755","2727王品","110/08/26","兆豐-北高雄",32,7,25
"756","2727王品","110/08/26","華南永昌-鳳山",0,36,-36
"757","2727王品","110/08/26","台新證券",29,8,21
"758","2727王品","110/08/26","元大-彰化民生",1,35,-34
"759","2727王品","110/08/26","康和-澎湖",20,0,20
"760","2727王品","110/08/26","摩根大通",13,46,-33
"761","2727王品","110/08/26","台灣摩根士丹利",54,35,19
"762","2727王品","110/08/26","元大證券",25,57,-32
"763","2727王品","110/08/26","(牛牛牛)亞-鑫豐",18,2,16
"764","2727王品","110/08/26","彰銀-台中",1,30,-29
"765","2727王品","110/08/26","元大-中壢",16,1,15
"766","2727王品","110/08/26","國泰證券",0,19,-19
"767","2727王品","110/08/26","華南永昌",13,1,12
"768","2727王品","110/08/26","富邦-建國",2,21,-19
"769","2727王品","110/08/26","永豐金-萬盛",12,0,12
"770","2727王品","110/08/26","美林",5,19,-14
"771","2727王品","110/08/26","新光-台中",14,3,11
"772","2727王品","110/08/26","統一",0,14,-14
"773","2727王品","110/08/26","新光",19,9,10
"774","2727王品","110/08/26","國票-內壢",1,14,-13
"775","2727王品","110/08/26","國泰-台南",12,3,9
"776","2727王品","110/08/26","台灣企銀",0,12,-12
"777","2727王品","110/08/26","元大-景美",9,1,8
"778","2727王品","110/08/26","康和-高雄",0,10,-10
"779","2727王品","110/08/26","國泰-敦南",20,13,7
"780","2727王品","110/08/26","統一-松江",0,8,-8
"781","1570力肯","110/08/26","群益金鼎-高雄",34,0,34
"782","1570力肯","110/08/26","永豐金-虎尾",0,50,-50
"783","1570力肯","110/08/26","香港上海匯豐",21,0,21
"784","1570力肯","110/08/26","富邦-高雄",0,38,-38
"785","1570力肯","110/08/26","凱基-台北",9,1,8
"786","1570力肯","110/08/26","華南永昌-麻豆",0,14,-14
"787","1570力肯","110/08/26","國票-台中",7,0,7
"788","1570力肯","110/08/26","摩根大通",0,11,-11
"789","1570力肯","110/08/26","美林",6,0,6
"790","1570力肯","110/08/26","凱基-復興",0,7,-7
"791","1570力肯","110/08/26","群益金鼎-瑞豐",6,0,6
"792","1570力肯","110/08/26","元大-基隆孝二",0,7,-7
"793","1570力肯","110/08/26","日茂-南投",5,0,5
"794","1570力肯","110/08/26","國票-博愛",2,8,-6
"795","1570力肯","110/08/26","兆豐-鹿港",5,0,5
"796","1570力肯","110/08/26","元富-城東",0,5,-5
"797","1570力肯","110/08/26","兆豐-松德",5,0,5
"798","1570力肯","110/08/26","兆豐-中壢",0,4,-4
"799","1570力肯","110/08/26","國票-和平",5,0,5
"800","1570力肯","110/08/26","華南永昌-大安",0,4,-4
"801","1570力肯","110/08/26","凱基-站前",5,0,5
"802","1570力肯","110/08/26","統一-三重",0,3,-3
"803","1570力肯","110/08/26","元大-新竹經國",5,0,5
"804","1570力肯","110/08/26","統一-員林",0,2,-2
"805","1570力肯","110/08/26","元大-草屯",4,0,4
"806","1570力肯","110/08/26","凱基-天母",0,2,-2
"807","1570力肯","110/08/26","(牛牛牛)亞-鑫豐",3,0,3
"808","1570力肯","110/08/26","元大-大里",0,2,-2
"809","1570力肯","110/08/26","國票-北高雄",4,1,3
"810","1570力肯","110/08/26","大慶-富順",0,1,-1
"811","6180橘子","110/08/26","港商野村",126,2,124
"812","6180橘子","110/08/26","國票-南港",0,71,-71
"813","6180橘子","110/08/26","美林",29,0,29
"814","6180橘子","110/08/26","新加坡商瑞銀",0,31,-31
"815","6180橘子","110/08/26","國泰-敦南",19,1,18
"816","6180橘子","110/08/26","大慶-富順",0,22,-22
"817","6180橘子","110/08/26","日盛-文化",15,0,15
"818","6180橘子","110/08/26","摩根大通",28,47,-19
"819","6180橘子","110/08/26","美商高盛",26,11,15
"820","6180橘子","110/08/26","華南永昌-公誠",1,20,-19
"821","6180橘子","110/08/26","高橋",15,0,15
"822","6180橘子","110/08/26","元大-台中中港",1,17,-16
"823","6180橘子","110/08/26","新光-台中",14,0,14
"824","6180橘子","110/08/26","新光",5,20,-15
"825","6180橘子","110/08/26","日盛-中壢",13,0,13
"826","6180橘子","110/08/26","國泰-高雄",1,16,-15
"827","6180橘子","110/08/26","富邦-新營",13,0,13
"828","6180橘子","110/08/26","凱基-台北",263,277,-14
"829","6180橘子","110/08/26","永豐金-松山",14,1,13
"830","6180橘子","110/08/26","元大-天母",0,14,-14
"831","6180橘子","110/08/26","日盛-花蓮",10,0,10
"832","6180橘子","110/08/26","元大-草屯",0,13,-13
"833","6180橘子","110/08/26","第一金-光復",14,4,10
"834","6180橘子","110/08/26","富隆-長安",0,12,-12
"835","6180橘子","110/08/26","台新-高雄",10,0,10
"836","6180橘子","110/08/26","凱基-站前",0,12,-12
"837","6180橘子","110/08/26","玉山-高雄",12,2,10
"838","6180橘子","110/08/26","元大-北成功",0,12,-12
"839","6180橘子","110/08/26","凱基-高雄",10,0,10
"840","6180橘子","110/08/26","合庫-新竹",2,12,-10
"841","2390云辰","110/08/26","統一-新台中",134,19,115
"842","2390云辰","110/08/26","元大證券",22,150,-128
"843","2390云辰","110/08/26","元大-松山",82,0,82
"844","2390云辰","110/08/26","摩根大通",18,141,-123
"845","2390云辰","110/08/26","國泰-桃園",78,7,71
"846","2390云辰","110/08/26","凱基-湖口",6,101,-95
"847","2390云辰","110/08/26","元大-土城學府",121,63,58
"848","2390云辰","110/08/26","元大-前金",3,82,-79
"849","2390云辰","110/08/26","台新-左楠",47,0,47
"850","2390云辰","110/08/26","康和-石牌",3,53,-50
"851","2390云辰","110/08/26","玉山-板橋",45,1,44
"852","2390云辰","110/08/26","港商野村",348,393,-45
"853","2390云辰","110/08/26","國票-嘉義",40,0,40
"854","2390云辰","110/08/26","凱基-大直",0,45,-45
"855","2390云辰","110/08/26","凱基-台北",142,106,36
"856","2390云辰","110/08/26","新加坡商瑞銀",4,48,-44
"857","2390云辰","110/08/26","群益金鼎-民權",33,0,33
"858","2390云辰","110/08/26","永豐金-敦北",1,40,-39
"859","2390云辰","110/08/26","富邦-三重",33,1,32
"860","2390云辰","110/08/26","大慶-富順",7,40,-33
"861","2390云辰","110/08/26","富邦-中壢",35,8,27
"862","2390云辰","110/08/26","元大-豐原",3,36,-33
"863","2390云辰","110/08/26","玉山-嘉義",29,3,26
"864","2390云辰","110/08/26","日盛-和美",0,30,-30
"865","2390云辰","110/08/26","高橋-中壢",25,0,25
"866","2390云辰","110/08/26","宏遠證券",0,30,-30
"867","2390云辰","110/08/26","國泰-板橋",44,19,25
"868","2390云辰","110/08/26","元大-士林",4,34,-30
"869","2390云辰","110/08/26","富邦-陽明",43,18,25
"870","2390云辰","110/08/26","台灣摩根士丹利",5,34,-29
