"","stake","date","name","buy","sell","total"
"1","1471首利","110/08/02","日盛-和美",31,0,31
"2","1471首利","110/08/02","日盛-八德",0,63,-63
"3","1471首利","110/08/02","宏遠-光隆",30,0,30
"4","1471首利","110/08/02","凱基-幸福",0,49,-49
"5","1471首利","110/08/02","元富-花蓮",25,0,25
"6","1471首利","110/08/02","富邦-台北",0,30,-30
"7","1471首利","110/08/02","凱基-台北",25,0,25
"8","1471首利","110/08/02","元大-東蘆",0,30,-30
"9","1471首利","110/08/02","日盛-木柵",20,0,20
"10","1471首利","110/08/02","合庫-桃園",0,20,-20
"11","1471首利","110/08/02","凱基-高美館",20,0,20
"12","1471首利","110/08/02","康和-澎湖",0,15,-15
"13","1471首利","110/08/02","新光-台中",24,5,19
"14","1471首利","110/08/02","元大-斗信",0,15,-15
"15","1471首利","110/08/02","富邦-羅東",15,0,15
"16","1471首利","110/08/02","元富-民權",0,12,-12
"17","1471首利","110/08/02","兆豐-鹿港",14,0,14
"18","1471首利","110/08/02","玉山-新莊",0,12,-12
"19","1471首利","110/08/02","美林",16,4,12
"20","1471首利","110/08/02","宏遠-桃園",0,10,-10
"21","1471首利","110/08/02","統一-桃園",12,0,12
"22","1471首利","110/08/02","瑞士信貸",0,10,-10
"23","1471首利","110/08/02","合庫-高雄",10,0,10
"24","1471首利","110/08/02","大慶-苗栗",0,10,-10
"25","1471首利","110/08/02","日盛-士林",10,0,10
"26","1471首利","110/08/02","統一-新營",0,10,-10
"27","1471首利","110/08/02","港商法國興業",10,0,10
"28","1471首利","110/08/02","群益金鼎-三重",0,10,-10
"29","1471首利","110/08/02","第一金-台南",10,0,10
"30","1471首利","110/08/02","元大-基隆",0,10,-10
"31","2883開發金","110/08/02","統一",3076,29,3047
"32","2883開發金","110/08/02","中農",2,3126,-3124
"33","2883開發金","110/08/02","凱基-台北",2789,192,2597
"34","2883開發金","110/08/02","群益金鼎",11,2008,-1997
"35","2883開發金","110/08/02","元富-城東",2139,5,2134
"36","2883開發金","110/08/02","摩根大通",2081,3944,-1863
"37","2883開發金","110/08/02","瑞士信貸",2184,316,1868
"38","2883開發金","110/08/02","港商野村",949,2553,-1604
"39","2883開發金","110/08/02","美林",1160,271,889
"40","2883開發金","110/08/02","台灣匯立證券",198,1533,-1335
"41","2883開發金","110/08/02","港商麥格理",855,0,855
"42","2883開發金","110/08/02","中國信託",69,1041,-972
"43","2883開發金","110/08/02","元大-金華",533,33,500
"44","2883開發金","110/08/02","兆豐證券",1,863,-862
"45","2883開發金","110/08/02","新加坡商瑞銀",1089,624,465
"46","2883開發金","110/08/02","美商高盛",6,644,-638
"47","2883開發金","110/08/02","法銀巴黎",441,0,441
"48","2883開發金","110/08/02","華南永昌-中正",4,632,-628
"49","2883開發金","110/08/02","富邦-嘉義",425,24,401
"50","2883開發金","110/08/02","第一金-安和",156,757,-601
"51","2883開發金","110/08/02","元富-烏日",367,3,364
"52","2883開發金","110/08/02","國票",0,524,-524
"53","2883開發金","110/08/02","台灣摩根士丹利",634,280,354
"54","2883開發金","110/08/02","元富",266,770,-504
"55","2883開發金","110/08/02","國泰-館前",516,180,336
"56","2883開發金","110/08/02","新光",1651,1984,-333
"57","2883開發金","110/08/02","聯邦-敦化",321,5,316
"58","2883開發金","110/08/02","元富-安南",20,324,-304
"59","2883開發金","110/08/02","玉山-士林",307,13,294
"60","2883開發金","110/08/02","群益金鼎-東門",6,280,-274
"61","6205詮欣","110/08/02","元大-館前",16,0,16
"62","6205詮欣","110/08/02","永豐金-敦南",0,21,-21
"63","6205詮欣","110/08/02","臺銀",11,0,11
"64","6205詮欣","110/08/02","日盛-三重",0,17,-17
"65","6205詮欣","110/08/02","臺銀-民權",10,0,10
"66","6205詮欣","110/08/02","永豐金-博愛",0,10,-10
"67","6205詮欣","110/08/02","摩根大通",11,1,10
"68","6205詮欣","110/08/02","國票-台南",0,5,-5
"69","6205詮欣","110/08/02","合庫-三重",5,0,5
"70","6205詮欣","110/08/02","群益金鼎-三重",0,4,-4
"71","6205詮欣","110/08/02","元大-東蘆",5,0,5
"72","6205詮欣","110/08/02","元大-土城",0,4,-4
"73","6205詮欣","110/08/02","凱基",3,0,3
"74","6205詮欣","110/08/02","元大-草屯",0,4,-4
"75","6205詮欣","110/08/02","日盛-雙和",2,0,2
"76","6205詮欣","110/08/02","臺銀-新竹",1,4,-3
"77","6205詮欣","110/08/02","兆豐-南京",2,0,2
"78","6205詮欣","110/08/02","光和-嘉義",0,3,-3
"79","6205詮欣","110/08/02","凱基-台北",3,1,2
"80","6205詮欣","110/08/02","永豐金-內湖",0,3,-3
"81","6205詮欣","110/08/02","元大-西螺",2,0,2
"82","6205詮欣","110/08/02","第一金-華江",0,2,-2
"83","6205詮欣","110/08/02","元大-新竹經國",2,0,2
"84","6205詮欣","110/08/02","中國信託-高雄",0,2,-2
"85","6205詮欣","110/08/02","元大-北成功",2,0,2
"86","6205詮欣","110/08/02","兆豐-鹿港",0,2,-2
"87","6205詮欣","110/08/02","臺銀-臺中",1,0,1
"88","6205詮欣","110/08/02","統一-平鎮",0,1,-1
"89","6205詮欣","110/08/02","德信-新營",1,0,1
"90","6205詮欣","110/08/02","台新-台中",0,1,-1
"91","1540喬福","110/08/02","富邦-南屯",10,0,10
"92","1540喬福","110/08/02","永豐金-埔里",0,22,-22
"93","1540喬福","110/08/02","元富-中原",10,2,8
"94","1540喬福","110/08/02","統一-新台中",0,17,-17
"95","1540喬福","110/08/02","德信-新營",6,0,6
"96","1540喬福","110/08/02","統一-三多",0,3,-3
"97","1540喬福","110/08/02","元大-龍潭",3,0,3
"98","1540喬福","110/08/02","光和-高雄",0,2,-2
"99","1540喬福","110/08/02","凱基-台北",3,0,3
"100","1540喬福","110/08/02","兆豐-嘉義",0,2,-2
"101","1540喬福","110/08/02","新光-桃園",3,0,3
"102","1540喬福","110/08/02","台新-高雄",0,1,-1
"103","1540喬福","110/08/02","永豐金-內湖",2,0,2
"104","1540喬福","110/08/02","新光",0,1,-1
"105","1540喬福","110/08/02","港商法國興業",2,0,2
"106","1540喬福","110/08/02","國泰-館前",0,1,-1
"107","1540喬福","110/08/02","統一-台南",2,0,2
"108","1540喬福","110/08/02","群益金鼎-民權",0,1,-1
"109","1540喬福","110/08/02","元富-桃園",2,0,2
"110","1540喬福","110/08/02","富邦-嘉義",0,1,-1
"111","1540喬福","110/08/02","台中銀-豐原",2,0,2
"112","1540喬福","110/08/02","元大-新竹",0,1,-1
"113","1540喬福","110/08/02","(牛牛牛)亞-網路",1,0,1
"114","1540喬福","110/08/02","元大-豐原站前",0,1,-1
"115","1540喬福","110/08/02","元富",1,0,1
"116","1540喬福","110/08/02","臺銀-鳳山",0,0,0
"117","1540喬福","110/08/02","第一金-桃園",1,0,1
"118","1540喬福","110/08/02","第一金",0,0,0
"119","1540喬福","110/08/02","瑞士信貸",1,0,1
"120","1540喬福","110/08/02","華南永昌-南京",0,0,0
"121","2888新光金","110/08/02","花旗環球",2291,0,2291
"122","2888新光金","110/08/02","瑞士信貸",1405,3997,-2592
"123","2888新光金","110/08/02","美林",2235,208,2027
"124","2888新光金","110/08/02","新加坡商瑞銀",780,2173,-1393
"125","2888新光金","110/08/02","群益金鼎-彰化",1014,2,1012
"126","2888新光金","110/08/02","美商高盛",369,1356,-987
"127","2888新光金","110/08/02","富邦-建國",823,9,814
"128","2888新光金","110/08/02","元大-仁愛",69,795,-726
"129","2888新光金","110/08/02","元大-華山",532,1,531
"130","2888新光金","110/08/02","永興-台中",0,500,-500
"131","2888新光金","110/08/02","法銀巴黎",666,166,500
"132","2888新光金","110/08/02","凱基-站前",17,506,-489
"133","2888新光金","110/08/02","台灣匯立證券",421,0,421
"134","2888新光金","110/08/02","元富-城東",38,496,-458
"135","2888新光金","110/08/02","凱基-台南",376,17,359
"136","2888新光金","110/08/02","群益金鼎-中港",2,450,-448
"137","2888新光金","110/08/02","永豐金-嘉義",352,0,352
"138","2888新光金","110/08/02","華南永昌",25,461,-436
"139","2888新光金","110/08/02","合庫-台中",339,1,338
"140","2888新光金","110/08/02","港商野村",135,550,-415
"141","2888新光金","110/08/02","港商麥格理",316,0,316
"142","2888新光金","110/08/02","大慶-苗栗",1,406,-405
"143","2888新光金","110/08/02","群益金鼎-建成",298,5,293
"144","2888新光金","110/08/02","華南永昌-中正",34,419,-385
"145","2888新光金","110/08/02","永豐金-板盛",221,0,221
"146","2888新光金","110/08/02","玉山-台大",0,350,-350
"147","2888新光金","110/08/02","台灣摩根士丹利",1700,1488,212
"148","2888新光金","110/08/02","元大-汐止",66,363,-297
"149","2888新光金","110/08/02","凱基-竹北",200,0,200
"150","2888新光金","110/08/02","台新-新莊",14,265,-251
"151","1340勝悅","110/08/02","國泰-台中",22,0,22
"152","1340勝悅","110/08/02","中國信託",0,83,-83
"153","1340勝悅","110/08/02","港商法國興業",14,0,14
"154","1340勝悅","110/08/02","元大-開元",0,11,-11
"155","1340勝悅","110/08/02","新光",18,5,13
"156","1340勝悅","110/08/02","凱基-永康",0,10,-10
"157","1340勝悅","110/08/02","元大-基隆孝二",11,0,11
"158","1340勝悅","110/08/02","富邦-宜蘭",0,10,-10
"159","1340勝悅","110/08/02","玉山-士林",10,0,10
"160","1340勝悅","110/08/02","元大-大統",0,10,-10
"161","1340勝悅","110/08/02","凱基",6,0,6
"162","1340勝悅","110/08/02","富邦-板橋",0,5,-5
"163","1340勝悅","110/08/02","摩根大通",4,0,4
"164","1340勝悅","110/08/02","瑞士信貸",1,5,-4
"165","1340勝悅","110/08/02","國泰-敦南",8,4,4
"166","1340勝悅","110/08/02","華南永昌-忠孝",0,2,-2
"167","1340勝悅","110/08/02","國泰-新莊",3,0,3
"168","1340勝悅","110/08/02","元大-虎尾",0,2,-2
"169","1340勝悅","110/08/02","凱基-嘉義",3,0,3
"170","1340勝悅","110/08/02","元大-路竹",0,2,-2
"171","1340勝悅","110/08/02","群益金鼎-館前",3,0,3
"172","1340勝悅","110/08/02","元大-信義",0,2,-2
"173","1340勝悅","110/08/02","國泰-館前",3,0,3
"174","1340勝悅","110/08/02","華南永昌-高雄",0,1,-1
"175","1340勝悅","110/08/02","臺銀-鳳山",3,0,3
"176","1340勝悅","110/08/02","玉山-大里",0,0,0
"177","1340勝悅","110/08/02","國泰-高雄",4,1,3
"178","1340勝悅","110/08/02","群益金鼎-丹鳳",0,0,0
"179","1340勝悅","110/08/02","美商高盛",3,0,3
"180","1340勝悅","110/08/02","富邦-虎尾",0,0,0
"181","6246臺龍","110/08/02","台新證券",19,1,18
"182","6246臺龍","110/08/02","元大-新竹經國",0,6,-6
"183","6246臺龍","110/08/02","凱基-台北",7,2,5
"184","6246臺龍","110/08/02","台新-台南",0,5,-5
"185","6246臺龍","110/08/02","國票-九鼎",3,0,3
"186","6246臺龍","110/08/02","宏遠-新化",1,4,-3
"187","6246臺龍","110/08/02","國票-南京",3,0,3
"188","6246臺龍","110/08/02","元富-板橋",0,3,-3
"189","6246臺龍","110/08/02","新光-台中",3,0,3
"190","6246臺龍","110/08/02","國泰-敦南",0,3,-3
"191","6246臺龍","110/08/02","元大-員林",3,0,3
"192","6246臺龍","110/08/02","富邦-台中",0,3,-3
"193","6246臺龍","110/08/02","元大-永和",3,0,3
"194","6246臺龍","110/08/02","元大-大益",2,5,-3
"195","6246臺龍","110/08/02","港商野村",2,0,2
"196","6246臺龍","110/08/02","日盛-永康",0,2,-2
"197","6246臺龍","110/08/02","台新-高雄",2,0,2
"198","6246臺龍","110/08/02","日盛-宜蘭",0,2,-2
"199","6246臺龍","110/08/02","新光-台南",2,0,2
"200","6246臺龍","110/08/02","宏遠-台南",0,2,-2
"201","6246臺龍","110/08/02","日盛-文化",1,0,1
"202","6246臺龍","110/08/02","高橋-龍潭",0,2,-2
"203","6246臺龍","110/08/02","國泰-忠孝",1,0,1
"204","6246臺龍","110/08/02","群益金鼎-中壢",0,2,-2
"205","6246臺龍","110/08/02","群益金鼎-崇德",3,2,1
"206","6246臺龍","110/08/02","凱基-三多",0,2,-2
"207","6246臺龍","110/08/02","富邦-員林",1,0,1
"208","6246臺龍","110/08/02","統一-中壢",0,1,-1
"209","6246臺龍","110/08/02","富邦-三重",1,0,1
"210","6246臺龍","110/08/02","中國信託-嘉義",0,1,-1
"211","00715L期街口布蘭特正2","110/08/02","元大證券",7296,1000,6296
"212","00715L期街口布蘭特正2","110/08/02","富邦-基隆",0,850,-850
"213","00715L期街口布蘭特正2","110/08/02","永豐金證券",2221,338,1883
"214","00715L期街口布蘭特正2","110/08/02","(牛牛牛)亞-鑫豐",10,850,-840
"215","00715L期街口布蘭特正2","110/08/02","統一",1460,100,1360
"216","00715L期街口布蘭特正2","110/08/02","華南永昌-長虹",57,820,-763
"217","00715L期街口布蘭特正2","110/08/02","國票-中港",1000,0,1000
"218","00715L期街口布蘭特正2","110/08/02","富邦-彰化",0,700,-700
"219","00715L期街口布蘭特正2","110/08/02","第一金-台中",900,13,887
"220","00715L期街口布蘭特正2","110/08/02","第一金-路竹",0,682,-682
"221","00715L期街口布蘭特正2","110/08/02","群益金鼎",728,0,728
"222","00715L期街口布蘭特正2","110/08/02","台新證券",112,791,-679
"223","00715L期街口布蘭特正2","110/08/02","群益金鼎-古亭",433,1,432
"224","00715L期街口布蘭特正2","110/08/02","第一金-忠孝",45,483,-438
"225","00715L期街口布蘭特正2","110/08/02","凱基-市政",525,125,400
"226","00715L期街口布蘭特正2","110/08/02","玉山-台南",0,373,-373
"227","00715L期街口布蘭特正2","110/08/02","元大-敦化",400,0,400
"228","00715L期街口布蘭特正2","110/08/02","國泰-板橋",3,313,-310
"229","00715L期街口布蘭特正2","110/08/02","元大-草屯",353,21,332
"230","00715L期街口布蘭特正2","110/08/02","凱基",0,300,-300
"231","00715L期街口布蘭特正2","110/08/02","元大-萬華",250,0,250
"232","00715L期街口布蘭特正2","110/08/02","元大-嘉義",1,300,-299
"233","00715L期街口布蘭特正2","110/08/02","統一-員林",180,0,180
"234","00715L期街口布蘭特正2","110/08/02","元大-大灣",14,303,-289
"235","00715L期街口布蘭特正2","110/08/02","富邦證券",282,152,130
"236","00715L期街口布蘭特正2","110/08/02","新光-桃園",45,295,-250
"237","00715L期街口布蘭特正2","110/08/02","元富-潮州",125,0,125
"238","00715L期街口布蘭特正2","110/08/02","元大-新莊",76,306,-230
"239","00715L期街口布蘭特正2","110/08/02","兆豐-台中港",106,0,106
"240","00715L期街口布蘭特正2","110/08/02","富邦-台北",0,211,-211
"241","8941關中","110/08/02","宏遠-館前",3,0,3
"242","8941關中","110/08/02","富邦-台中",0,5,-5
"243","8941關中","110/08/02","群益金鼎-彰化",2,0,2
"244","8941關中","110/08/02","富邦-員林",0,4,-4
"245","8941關中","110/08/02","第一金-台中",1,0,1
"246","8941關中","110/08/02","元大-新竹經國",0,0,0
"247","8941關中","110/08/02","台新-台中",1,0,1
"248","8941關中","110/08/02","永豐金-萬盛",0,0,0
"249","8941關中","110/08/02","華南永昌-南京",1,0,1
"250","8941關中","110/08/02","",NA,NA,NA
"251","8941關中","110/08/02","元大-桃興",2,1,1
"252","8941關中","110/08/02","",NA,NA,NA
"253","8941關中","110/08/02","元大-新竹經國",0,0,0
"254","8941關中","110/08/02","",NA,NA,NA
"255","8941關中","110/08/02","永豐金-萬盛",0,0,0
"256","8941關中","110/08/02","",NA,NA,NA
"257","8941關中","110/08/02","",NA,NA,NA
"258","8941關中","110/08/02","",NA,NA,NA
"259","8941關中","110/08/02","",NA,NA,NA
"260","8941關中","110/08/02","",NA,NA,NA
"261","8941關中","110/08/02","",NA,NA,NA
"262","8941關中","110/08/02","",NA,NA,NA
"263","8941關中","110/08/02","",NA,NA,NA
"264","8941關中","110/08/02","",NA,NA,NA
"265","8941關中","110/08/02","",NA,NA,NA
"266","8941關中","110/08/02","",NA,NA,NA
"267","8941關中","110/08/02","",NA,NA,NA
"268","8941關中","110/08/02","",NA,NA,NA
"269","8941關中","110/08/02","",NA,NA,NA
"270","8941關中","110/08/02","",NA,NA,NA
"271","8936國統","110/08/02","合庫-高雄",68,0,68
"272","8936國統","110/08/02","凱基-台北",0,125,-125
"273","8936國統","110/08/02","元大-蘆洲",33,0,33
"274","8936國統","110/08/02","摩根大通",9,125,-116
"275","8936國統","110/08/02","富邦-高雄",30,4,26
"276","8936國統","110/08/02","永全-南崁",0,50,-50
"277","8936國統","110/08/02","大慶-蘆洲",20,0,20
"278","8936國統","110/08/02","新光-台中",16,55,-39
"279","8936國統","110/08/02","兆豐-桃鶯",20,0,20
"280","8936國統","110/08/02","凱基-市政",0,31,-31
"281","8936國統","110/08/02","元大-東泰",20,0,20
"282","8936國統","110/08/02","美商高盛",1,20,-19
"283","8936國統","110/08/02","永豐金-忠孝",20,0,20
"284","8936國統","110/08/02","元大-東港",3,20,-17
"285","8936國統","110/08/02","元大-旗山",15,0,15
"286","8936國統","110/08/02","台灣企銀-台中",0,15,-15
"287","8936國統","110/08/02","中國信託-文心",12,0,12
"288","8936國統","110/08/02","日盛-竹北",0,15,-15
"289","8936國統","110/08/02","國泰-敦南",14,2,12
"290","8936國統","110/08/02","瑞士信貸",0,11,-11
"291","8936國統","110/08/02","元大-敦南",12,0,12
"292","8936國統","110/08/02","港商野村",26,36,-10
"293","8936國統","110/08/02","日盛-三峽",11,0,11
"294","8936國統","110/08/02","統一-竹南",0,10,-10
"295","8936國統","110/08/02","永豐金-苓雅",11,0,11
"296","8936國統","110/08/02","國泰-高雄",1,11,-10
"297","8936國統","110/08/02","宏遠-高雄",11,1,10
"298","8936國統","110/08/02","元大-天母",0,9,-9
"299","8936國統","110/08/02","第一金-嘉義",10,0,10
"300","8936國統","110/08/02","元大-台中中港",0,9,-9
"301","6226光鼎","110/08/02","新百王",283,0,283
"302","6226光鼎","110/08/02","元富-安南",3,113,-110
"303","6226光鼎","110/08/02","日盛-文化",219,3,216
"304","6226光鼎","110/08/02","群益金鼎-東大",24,124,-100
"305","6226光鼎","110/08/02","元大-嘉義",127,37,90
"306","6226光鼎","110/08/02","富邦-南屯",3,100,-97
"307","6226光鼎","110/08/02","統一-新竹",113,31,82
"308","6226光鼎","110/08/02","元大-鳳中",2,99,-97
"309","6226光鼎","110/08/02","台中銀-員林",111,47,64
"310","6226光鼎","110/08/02","元大-忠孝鼎富",10,100,-90
"311","6226光鼎","110/08/02","永豐金證券",66,5,61
"312","6226光鼎","110/08/02","華南永昌-小港",0,84,-84
"313","6226光鼎","110/08/02","日盛-員林",107,50,57
"314","6226光鼎","110/08/02","國泰-敦南",247,324,-77
"315","6226光鼎","110/08/02","國票-九鼎",72,24,48
"316","6226光鼎","110/08/02","亞東",5,76,-71
"317","6226光鼎","110/08/02","元大-士林",53,6,47
"318","6226光鼎","110/08/02","中國信託-新竹",2,62,-60
"319","6226光鼎","110/08/02","元大-鹿港",48,7,41
"320","6226光鼎","110/08/02","元大-南屯",12,64,-52
"321","6226光鼎","110/08/02","中國信託-文心",48,8,40
"322","6226光鼎","110/08/02","元大-高雄",9,61,-52
"323","6226光鼎","110/08/02","國泰-新莊",56,17,39
"324","6226光鼎","110/08/02","元大-台北",2,53,-51
"325","6226光鼎","110/08/02","元大-大同",39,0,39
"326","6226光鼎","110/08/02","第一金-華江",8,52,-44
"327","6226光鼎","110/08/02","富邦-建國",39,1,38
"328","6226光鼎","110/08/02","元富-新莊",3,44,-41
"329","6226光鼎","110/08/02","統一-三重",54,18,36
"330","6226光鼎","110/08/02","玉山-桃園",3,40,-37
"331","2363矽統","110/08/02","中國信託-忠孝",405,25,380
"332","2363矽統","110/08/02","富邦證券",16,4082,-4066
"333","2363矽統","110/08/02","群益金鼎-屏東",349,123,226
"334","2363矽統","110/08/02","凱基-台北",2669,4466,-1797
"335","2363矽統","110/08/02","群益金鼎-永和",233,20,213
"336","2363矽統","110/08/02","台灣摩根士丹利",69,1749,-1680
"337","2363矽統","110/08/02","富邦-中壢",299,91,208
"338","2363矽統","110/08/02","新加坡商瑞銀",361,1486,-1125
"339","2363矽統","110/08/02","永豐金-彰化",188,4,184
"340","2363矽統","110/08/02","港商野村",619,1622,-1003
"341","2363矽統","110/08/02","元大-承德",253,73,180
"342","2363矽統","110/08/02","美商高盛",214,1077,-863
"343","2363矽統","110/08/02","康和-台中",192,23,169
"344","2363矽統","110/08/02","兆豐-復興",124,973,-849
"345","2363矽統","110/08/02","新光",550,382,168
"346","2363矽統","110/08/02","統一-仁愛",132,666,-534
"347","2363矽統","110/08/02","元大-萬華",224,61,163
"348","2363矽統","110/08/02","美林",520,1028,-508
"349","2363矽統","110/08/02","元大-博愛",204,44,160
"350","2363矽統","110/08/02","統一-土城",32,536,-504
"351","2363矽統","110/08/02","兆豐-三民",171,17,154
"352","2363矽統","110/08/02","華南永昌-斗六",33,526,-493
"353","2363矽統","110/08/02","元大-新竹",196,44,152
"354","2363矽統","110/08/02","統一-敦南",35,527,-492
"355","2363矽統","110/08/02","凱基-三重",178,29,149
"356","2363矽統","110/08/02","永豐金-員林",12,495,-483
"357","2363矽統","110/08/02","元大-忠孝",181,38,143
"358","2363矽統","110/08/02","統一-城中",117,589,-472
"359","2363矽統","110/08/02","元富-世貿",142,4,138
"360","2363矽統","110/08/02","摩根大通",1070,1471,-401
"361","8112至上","110/08/02","合庫證券",213,0,213
"362","8112至上","110/08/02","台灣摩根士丹利",9,287,-278
"363","8112至上","110/08/02","凱基-台北",298,152,146
"364","8112至上","110/08/02","凱基-三重",3,236,-233
"365","8112至上","110/08/02","大慶",87,0,87
"366","8112至上","110/08/02","臺銀-鳳山",11,124,-113
"367","8112至上","110/08/02","凱基-新店",84,0,84
"368","8112至上","110/08/02","合庫-台中",1,112,-111
"369","8112至上","110/08/02","香港上海匯豐",76,0,76
"370","8112至上","110/08/02","土銀-嘉義",0,105,-105
"371","8112至上","110/08/02","群益金鼎-建成",65,1,64
"372","8112至上","110/08/02","元大-新莊",2,106,-104
"373","8112至上","110/08/02","玉山-板橋",63,0,63
"374","8112至上","110/08/02","台新-建北",0,95,-95
"375","8112至上","110/08/02","元大-前金",61,2,59
"376","8112至上","110/08/02","華南永昌-彰化",2,64,-62
"377","8112至上","110/08/02","台新-台中",58,5,53
"378","8112至上","110/08/02","群益金鼎-北高雄",3,50,-47
"379","8112至上","110/08/02","亞東",51,0,51
"380","8112至上","110/08/02","元大-福營",1,45,-44
"381","8112至上","110/08/02","美林",49,1,48
"382","8112至上","110/08/02","永豐金-南京",2,38,-36
"383","8112至上","110/08/02","摩根大通",114,67,47
"384","8112至上","110/08/02","亞東-板橋",2,34,-32
"385","8112至上","110/08/02","美商高盛",46,0,46
"386","8112至上","110/08/02","元大-台南",2,33,-31
"387","8112至上","110/08/02","凱基-松山",43,1,42
"388","8112至上","110/08/02","統一-城中",0,30,-30
"389","8112至上","110/08/02","群益金鼎-大安",40,0,40
"390","8112至上","110/08/02","元富-板橋",5,35,-30
"391","1570力肯","110/08/02","群益金鼎-高雄",11,0,11
"392","1570力肯","110/08/02","大慶",0,5,-5
"393","1570力肯","110/08/02","臺銀-臺南",4,0,4
"394","1570力肯","110/08/02","元大-板橋",0,4,-4
"395","1570力肯","110/08/02","新光-台中",4,0,4
"396","1570力肯","110/08/02","玉山證券",0,4,-4
"397","1570力肯","110/08/02","(牛牛牛)亞-鑫豐",3,0,3
"398","1570力肯","110/08/02","國泰-台南",0,3,-3
"399","1570力肯","110/08/02","土銀-白河",2,0,2
"400","1570力肯","110/08/02","元富-新店",0,3,-3
"401","1570力肯","110/08/02","統一-松江",2,0,2
"402","1570力肯","110/08/02","元富-永和",0,2,-2
"403","1570力肯","110/08/02","中國信託-永康",1,0,1
"404","1570力肯","110/08/02","凱基-台北",0,2,-2
"405","1570力肯","110/08/02","凱基-信義",1,0,1
"406","1570力肯","110/08/02","統一-城中",0,2,-2
"407","1570力肯","110/08/02","凱基-幸福",1,0,1
"408","1570力肯","110/08/02","新光",0,1,-1
"409","1570力肯","110/08/02","元大-歸仁",1,0,1
"410","1570力肯","110/08/02","凱基-岡山",0,1,-1
"411","1570力肯","110/08/02","合庫-台中",0,0,0
"412","1570力肯","110/08/02","富邦-台南",0,1,-1
"413","1570力肯","110/08/02","康和-板橋",0,0,0
"414","1570力肯","110/08/02","元大-新盛",0,1,-1
"415","1570力肯","110/08/02","群益金鼎-鳳山",0,0,0
"416","1570力肯","110/08/02","永豐金-嘉義",0,1,-1
"417","1570力肯","110/08/02","元大-樹林",0,0,0
"418","1570力肯","110/08/02","康和-板橋",0,0,0
"419","1570力肯","110/08/02","",NA,NA,NA
"420","1570力肯","110/08/02","合庫-台中",0,0,0
"421","2929淘帝","110/08/02","元大-民生",29,0,29
"422","2929淘帝","110/08/02","新加坡商瑞銀",4,70,-66
"423","2929淘帝","110/08/02","兆豐-桃園",20,0,20
"424","2929淘帝","110/08/02","富邦-建國",0,26,-26
"425","2929淘帝","110/08/02","新光",14,0,14
"426","2929淘帝","110/08/02","美林",0,24,-24
"427","2929淘帝","110/08/02","兆豐-忠孝",13,0,13
"428","2929淘帝","110/08/02","元大-和平",0,13,-13
"429","2929淘帝","110/08/02","兆豐-彰化",12,0,12
"430","2929淘帝","110/08/02","元大-永和",0,10,-10
"431","2929淘帝","110/08/02","合庫-高雄",10,0,10
"432","2929淘帝","110/08/02","日盛-頭份",0,9,-9
"433","2929淘帝","110/08/02","富邦-台北",10,0,10
"434","2929淘帝","110/08/02","群益金鼎-中山",0,9,-9
"435","2929淘帝","110/08/02","國泰-敦南",9,0,9
"436","2929淘帝","110/08/02","華南永昌-頭份",0,7,-7
"437","2929淘帝","110/08/02","元富-文心",10,2,8
"438","2929淘帝","110/08/02","永豐金-敦南",0,7,-7
"439","2929淘帝","110/08/02","台新-台中",7,0,7
"440","2929淘帝","110/08/02","凱基-台北",5,11,-6
"441","2929淘帝","110/08/02","元大-文心",6,0,6
"442","2929淘帝","110/08/02","臺銀-鳳山",0,5,-5
"443","2929淘帝","110/08/02","日盛-忠孝",5,0,5
"444","2929淘帝","110/08/02","凱基-城中",0,5,-5
"445","2929淘帝","110/08/02","第一金-高雄",5,0,5
"446","2929淘帝","110/08/02","華南永昌-台中",0,5,-5
"447","2929淘帝","110/08/02","富邦-基隆",6,1,5
"448","2929淘帝","110/08/02","元大-博愛",0,5,-5
"449","2929淘帝","110/08/02","富邦-新店",5,0,5
"450","2929淘帝","110/08/02","元富-緯城",0,4,-4
"451","5410國眾","110/08/02","新加坡商瑞銀",19,0,19
"452","5410國眾","110/08/02","日盛-斗六",0,15,-15
"453","5410國眾","110/08/02","兆豐-城中",18,0,18
"454","5410國眾","110/08/02","元大-大同",0,15,-15
"455","5410國眾","110/08/02","日盛-新莊",10,0,10
"456","5410國眾","110/08/02","元大-博愛",0,10,-10
"457","5410國眾","110/08/02","元富-佳里",10,0,10
"458","5410國眾","110/08/02","凱基-台北",0,7,-7
"459","5410國眾","110/08/02","摩根大通",9,0,9
"460","5410國眾","110/08/02","臺銀-臺南",0,6,-6
"461","5410國眾","110/08/02","國泰-桃園",6,0,6
"462","5410國眾","110/08/02","元富-嘉義",0,6,-6
"463","5410國眾","110/08/02","元富-新竹",5,0,5
"464","5410國眾","110/08/02","第一金-中壢",0,5,-5
"465","5410國眾","110/08/02","元大-復北",5,0,5
"466","5410國眾","110/08/02","致和證券",0,5,-5
"467","5410國眾","110/08/02","永豐金-桃園",5,0,5
"468","5410國眾","110/08/02","群益金鼎-土城",0,5,-5
"469","5410國眾","110/08/02","安泰-楠梓",4,0,4
"470","5410國眾","110/08/02","華南永昌-中正",0,5,-5
"471","5410國眾","110/08/02","台灣企銀-太平",3,0,3
"472","5410國眾","110/08/02","元大-新莊",0,5,-5
"473","5410國眾","110/08/02","新光",3,0,3
"474","5410國眾","110/08/02","土銀-新竹",0,4,-4
"475","5410國眾","110/08/02","富邦-內湖",3,0,3
"476","5410國眾","110/08/02","日盛-員林",0,3,-3
"477","5410國眾","110/08/02","中國信託-新竹",2,0,2
"478","5410國眾","110/08/02","元大-新竹經國",0,3,-3
"479","5410國眾","110/08/02","華南永昌-楠梓",2,0,2
"480","5410國眾","110/08/02","元富-緯城",0,2,-2
"481","2841台開","110/08/02","富邦-敦南",71,0,71
"482","2841台開","110/08/02","永豐金-松山",0,91,-91
"483","2841台開","110/08/02","國泰-館前",38,0,38
"484","2841台開","110/08/02","元大-蘆洲",0,40,-40
"485","2841台開","110/08/02","台中銀",19,0,19
"486","2841台開","110/08/02","凱基-台北",2,33,-31
"487","2841台開","110/08/02","元富-烏日",18,0,18
"488","2841台開","110/08/02","兆豐-寶成",0,20,-20
"489","2841台開","110/08/02","國泰-板橋",15,0,15
"490","2841台開","110/08/02","華南永昌-民權",0,20,-20
"491","2841台開","110/08/02","元大-台中",15,0,15
"492","2841台開","110/08/02","國票-敦北法人",0,18,-18
"493","2841台開","110/08/02","元大-福營",15,0,15
"494","2841台開","110/08/02","第一金-路竹",0,17,-17
"495","2841台開","110/08/02","日盛-花蓮",14,0,14
"496","2841台開","110/08/02","中國信託-高雄",0,15,-15
"497","2841台開","110/08/02","新光",12,0,12
"498","2841台開","110/08/02","日進",0,10,-10
"499","2841台開","110/08/02","永豐金-敦南",62,51,11
"500","2841台開","110/08/02","統一-三多",0,10,-10
"501","2841台開","110/08/02","日盛-台中",10,0,10
"502","2841台開","110/08/02","元大-路竹",0,10,-10
"503","2841台開","110/08/02","群益金鼎-崇德",10,0,10
"504","2841台開","110/08/02","元大-中和",0,10,-10
"505","2841台開","110/08/02","元大-南海",10,0,10
"506","2841台開","110/08/02","宏遠-桃園",0,9,-9
"507","2841台開","110/08/02","國泰-桃園",8,0,8
"508","2841台開","110/08/02","大昌-新店",0,6,-6
"509","2841台開","110/08/02","台新-台中",6,0,6
"510","2841台開","110/08/02","國票-天祥",0,6,-6
"511","6207雷科","110/08/02","摩根大通",173,19,154
"512","6207雷科","110/08/02","凱基-高雄",0,50,-50
"513","6207雷科","110/08/02","凱基-台北",150,10,140
"514","6207雷科","110/08/02","群益金鼎-東門",0,26,-26
"515","6207雷科","110/08/02","華南永昌-朴子",55,0,55
"516","6207雷科","110/08/02","富邦-竹東",0,25,-25
"517","6207雷科","110/08/02","新加坡商瑞銀",51,5,46
"518","6207雷科","110/08/02","華南永昌-東勢",3,27,-24
"519","6207雷科","110/08/02","元大-西門",54,12,42
"520","6207雷科","110/08/02","富邦-岡山",1,25,-24
"521","6207雷科","110/08/02","兆豐-景美",42,2,40
"522","6207雷科","110/08/02","台灣摩根士丹利",0,22,-22
"523","6207雷科","110/08/02","日盛-忠孝",35,0,35
"524","6207雷科","110/08/02","國泰-高雄",1,23,-22
"525","6207雷科","110/08/02","美林",25,0,25
"526","6207雷科","110/08/02","富邦-建國",0,17,-17
"527","6207雷科","110/08/02","日盛-北高雄",16,0,16
"528","6207雷科","110/08/02","元大-上新莊",0,16,-16
"529","6207雷科","110/08/02","統一-板橋",15,0,15
"530","6207雷科","110/08/02","中國信託-高雄",0,15,-15
"531","6207雷科","110/08/02","凱基-市政",15,0,15
"532","6207雷科","110/08/02","宏遠證券",0,13,-13
"533","6207雷科","110/08/02","新光-新竹",16,2,14
"534","6207雷科","110/08/02","凱基-彰化",0,13,-13
"535","6207雷科","110/08/02","港商野村",23,12,11
"536","6207雷科","110/08/02","永豐金-內湖",0,13,-13
"537","6207雷科","110/08/02","統一-南京",11,0,11
"538","6207雷科","110/08/02","新百王",0,12,-12
"539","6207雷科","110/08/02","元大-嘉義",11,0,11
"540","6207雷科","110/08/02","玉山-大里",0,12,-12
"541","3679新至陞","110/08/02","元大-成功",26,0,26
"542","3679新至陞","110/08/02","富邦-陽明",1,34,-33
"543","3679新至陞","110/08/02","元大-樹林",20,0,20
"544","3679新至陞","110/08/02","富邦-中壢",0,20,-20
"545","3679新至陞","110/08/02","(牛牛牛)亞-網路",18,0,18
"546","3679新至陞","110/08/02","凱基-台北",34,48,-14
"547","3679新至陞","110/08/02","凱基-中山",12,0,12
"548","3679新至陞","110/08/02","永豐金證券",0,14,-14
"549","3679新至陞","110/08/02","統一",21,11,10
"550","3679新至陞","110/08/02","臺銀-臺南",2,14,-12
"551","3679新至陞","110/08/02","玉山-台大",10,0,10
"552","3679新至陞","110/08/02","摩根大通",20,32,-12
"553","3679新至陞","110/08/02","台中銀",8,0,8
"554","3679新至陞","110/08/02","富邦-嘉義",0,10,-10
"555","3679新至陞","110/08/02","港商野村",8,2,6
"556","3679新至陞","110/08/02","國票-北高雄",1,10,-9
"557","3679新至陞","110/08/02","群益金鼎-丹鳳",6,0,6
"558","3679新至陞","110/08/02","台新-台中",0,9,-9
"559","3679新至陞","110/08/02","元大-高雄",6,0,6
"560","3679新至陞","110/08/02","凱基-宜蘭",0,7,-7
"561","3679新至陞","110/08/02","新加坡商瑞銀",5,0,5
"562","3679新至陞","110/08/02","凱基-埔墘",0,7,-7
"563","3679新至陞","110/08/02","台灣摩根士丹利",13,9,4
"564","3679新至陞","110/08/02","永豐金-台中",0,7,-7
"565","3679新至陞","110/08/02","第一金-華江",4,0,4
"566","3679新至陞","110/08/02","永豐金-潮州",0,7,-7
"567","3679新至陞","110/08/02","新光",11,7,4
"568","3679新至陞","110/08/02","凱基-五股",0,6,-6
"569","3679新至陞","110/08/02","國泰-館前",4,0,4
"570","3679新至陞","110/08/02","富邦-建國",0,6,-6
"571","2727王品","110/08/02","摩根大通",38,5,33
"572","2727王品","110/08/02","台灣摩根士丹利",13,170,-157
"573","2727王品","110/08/02","日盛-忠孝",33,3,30
"574","2727王品","110/08/02","華南永昌",7,156,-149
"575","2727王品","110/08/02","凱基-天母",30,0,30
"576","2727王品","110/08/02","凱基-台北",37,57,-20
"577","2727王品","110/08/02","花旗環球",17,0,17
"578","2727王品","110/08/02","國票-北高雄",1,19,-18
"579","2727王品","110/08/02","永豐金-竹科",20,5,15
"580","2727王品","110/08/02","港商野村",39,54,-15
"581","2727王品","110/08/02","彰銀-台中",16,2,14
"582","2727王品","110/08/02","元大-四維",1,15,-14
"583","2727王品","110/08/02","國票-內壢",14,0,14
"584","2727王品","110/08/02","美林",12,25,-13
"585","2727王品","110/08/02","新光-台中",17,3,14
"586","2727王品","110/08/02","瑞士信貸",0,12,-12
"587","2727王品","110/08/02","永豐金-南京",16,3,13
"588","2727王品","110/08/02","元大-北成功",0,10,-10
"589","2727王品","110/08/02","元大-樹林",13,1,12
"590","2727王品","110/08/02","元大-崇德",0,8,-8
"591","2727王品","110/08/02","國泰-板橋",17,7,10
"592","2727王品","110/08/02","永豐金-內湖",3,10,-7
"593","2727王品","110/08/02","凱基-埔墘",10,0,10
"594","2727王品","110/08/02","大昌",5,11,-6
"595","2727王品","110/08/02","元大-豐原",10,0,10
"596","2727王品","110/08/02","華南永昌-斗六",2,8,-6
"597","2727王品","110/08/02","元大-桃園",10,0,10
"598","2727王品","110/08/02","國泰-台中",4,9,-5
"599","2727王品","110/08/02","凱基-科園",9,0,9
"600","2727王品","110/08/02","群益金鼎-土城",0,5,-5
"601","1570力肯","110/08/02","群益金鼎-高雄",11,0,11
"602","1570力肯","110/08/02","大慶",0,5,-5
"603","1570力肯","110/08/02","臺銀-臺南",4,0,4
"604","1570力肯","110/08/02","元大-板橋",0,4,-4
"605","1570力肯","110/08/02","新光-台中",4,0,4
"606","1570力肯","110/08/02","玉山證券",0,4,-4
"607","1570力肯","110/08/02","(牛牛牛)亞-鑫豐",3,0,3
"608","1570力肯","110/08/02","國泰-台南",0,3,-3
"609","1570力肯","110/08/02","土銀-白河",2,0,2
"610","1570力肯","110/08/02","元富-新店",0,3,-3
"611","1570力肯","110/08/02","統一-松江",2,0,2
"612","1570力肯","110/08/02","元富-永和",0,2,-2
"613","1570力肯","110/08/02","中國信託-永康",1,0,1
"614","1570力肯","110/08/02","凱基-台北",0,2,-2
"615","1570力肯","110/08/02","凱基-信義",1,0,1
"616","1570力肯","110/08/02","統一-城中",0,2,-2
"617","1570力肯","110/08/02","凱基-幸福",1,0,1
"618","1570力肯","110/08/02","新光",0,1,-1
"619","1570力肯","110/08/02","元大-歸仁",1,0,1
"620","1570力肯","110/08/02","凱基-岡山",0,1,-1
"621","1570力肯","110/08/02","合庫-台中",0,0,0
"622","1570力肯","110/08/02","富邦-台南",0,1,-1
"623","1570力肯","110/08/02","康和-板橋",0,0,0
"624","1570力肯","110/08/02","元大-新盛",0,1,-1
"625","1570力肯","110/08/02","群益金鼎-鳳山",0,0,0
"626","1570力肯","110/08/02","永豐金-嘉義",0,1,-1
"627","1570力肯","110/08/02","元大-樹林",0,0,0
"628","1570力肯","110/08/02","康和-板橋",0,0,0
"629","1570力肯","110/08/02","",NA,NA,NA
"630","1570力肯","110/08/02","合庫-台中",0,0,0
"631","6180橘子","110/08/02","美商高盛",21,8,13
"632","6180橘子","110/08/02","國票-嘉義",0,29,-29
"633","6180橘子","110/08/02","統一-彰化",10,0,10
"634","6180橘子","110/08/02","新加坡商瑞銀",0,21,-21
"635","6180橘子","110/08/02","中國信託-高雄",10,0,10
"636","6180橘子","110/08/02","凱基-台北",20,40,-20
"637","6180橘子","110/08/02","兆豐-斗南",10,0,10
"638","6180橘子","110/08/02","摩根大通",3,15,-12
"639","6180橘子","110/08/02","兆豐-埔墘",10,0,10
"640","6180橘子","110/08/02","第一金-桃園",0,10,-10
"641","6180橘子","110/08/02","玉山證券",10,0,10
"642","6180橘子","110/08/02","凱基-東港",0,10,-10
"643","6180橘子","110/08/02","富邦-羅東",8,1,7
"644","6180橘子","110/08/02","元大-桃園",0,10,-10
"645","6180橘子","110/08/02","元大證券",7,0,7
"646","6180橘子","110/08/02","元大-館前",0,9,-9
"647","6180橘子","110/08/02","元大-復北",7,0,7
"648","6180橘子","110/08/02","台灣摩根士丹利",3,10,-7
"649","6180橘子","110/08/02","華南永昌-長虹",6,0,6
"650","6180橘子","110/08/02","光和-花壇",0,5,-5
"651","6180橘子","110/08/02","元富-文心",5,0,5
"652","6180橘子","110/08/02","玉山-嘉義",0,5,-5
"653","6180橘子","110/08/02","台新-新莊",5,0,5
"654","6180橘子","110/08/02","凱基-松山",0,5,-5
"655","6180橘子","110/08/02","康和-嘉義",5,0,5
"656","6180橘子","110/08/02","永豐金-員林",0,4,-4
"657","6180橘子","110/08/02","凱基-興隆",5,0,5
"658","6180橘子","110/08/02","元富-大裕",0,3,-3
"659","6180橘子","110/08/02","華南永昌-楠梓",5,0,5
"660","6180橘子","110/08/02","富邦-板橋",0,3,-3
"661","2390云辰","110/08/02","摩根大通",1945,913,1032
"662","2390云辰","110/08/02","華南永昌-鳳山",154,448,-294
"663","2390云辰","110/08/02","富邦-陽明",118,11,107
"664","2390云辰","110/08/02","群益金鼎-三重",1,168,-167
"665","2390云辰","110/08/02","兆豐-三民",153,62,91
"666","2390云辰","110/08/02","統一-內湖",5,102,-97
"667","2390云辰","110/08/02","光和-嘉義",83,4,79
"668","2390云辰","110/08/02","台新證券",235,320,-85
"669","2390云辰","110/08/02","華南永昌-新莊",78,4,74
"670","2390云辰","110/08/02","統一-新台中",8,87,-79
"671","2390云辰","110/08/02","統一-城中",182,111,71
"672","2390云辰","110/08/02","美商高盛",10,88,-78
"673","2390云辰","110/08/02","台灣摩根士丹利",153,85,68
"674","2390云辰","110/08/02","元大-汐止",57,130,-73
"675","2390云辰","110/08/02","凱基-和平",115,47,68
"676","2390云辰","110/08/02","港商野村",580,638,-58
"677","2390云辰","110/08/02","華南永昌-公誠",75,13,62
"678","2390云辰","110/08/02","元富-板橋",5,61,-56
"679","2390云辰","110/08/02","永豐金-竹科",71,9,62
"680","2390云辰","110/08/02","新加坡商瑞銀",11,66,-55
"681","2390云辰","110/08/02","新光",160,100,60
"682","2390云辰","110/08/02","元大-豐原",6,56,-50
"683","2390云辰","110/08/02","凱基-岡山",61,1,60
"684","2390云辰","110/08/02","元大-土城",5,55,-50
"685","2390云辰","110/08/02","美林",254,195,59
"686","2390云辰","110/08/02","凱基-站前",1,49,-48
"687","2390云辰","110/08/02","凱基-大里",76,22,54
"688","2390云辰","110/08/02","元大-中壢",6,54,-48
"689","2390云辰","110/08/02","元大-鳳中",60,8,52
"690","2390云辰","110/08/02","日盛證券",48,95,-47
"691","1471首利","110/07/29","宏遠-光隆",35,0,35
"692","1471首利","110/07/29","摩根大通",24,132,-108
"693","1471首利","110/07/29","玉山-桃園",33,3,30
"694","1471首利","110/07/29","台灣企銀-太平",0,60,-60
"695","1471首利","110/07/29","富邦-台南",30,0,30
"696","1471首利","110/07/29","元大-斗六",0,40,-40
"697","1471首利","110/07/29","臺灣企銀-桃園",25,0,25
"698","1471首利","110/07/29","元大-歸仁",0,23,-23
"699","1471首利","110/07/29","元富-草屯",15,0,15
"700","1471首利","110/07/29","日盛-永康",0,20,-20
"701","1471首利","110/07/29","新光-桃園",15,0,15
"702","1471首利","110/07/29","台中銀-員林",0,20,-20
"703","1471首利","110/07/29","元大-博愛",15,2,13
"704","1471首利","110/07/29","凱基-東門",0,14,-14
"705","1471首利","110/07/29","臺銀-鳳山",12,0,12
"706","1471首利","110/07/29","元大-草屯",1,15,-14
"707","1471首利","110/07/29","元富-新莊",11,0,11
"708","1471首利","110/07/29","元大-新竹經國",0,13,-13
"709","1471首利","110/07/29","兆豐-來福",11,0,11
"710","1471首利","110/07/29","日盛-土城",0,10,-10
"711","1471首利","110/07/29","統一-新營",10,0,10
"712","1471首利","110/07/29","美林",0,10,-10
"713","1471首利","110/07/29","光和-溪湖",10,0,10
"714","1471首利","110/07/29","永興-水湳",0,10,-10
"715","1471首利","110/07/29","台新-左楠",10,0,10
"716","1471首利","110/07/29","玉山證券",0,10,-10
"717","1471首利","110/07/29","群益金鼎-台中",10,0,10
"718","1471首利","110/07/29","群益金鼎-海山",2,12,-10
"719","1471首利","110/07/29","凱基-內埔",10,0,10
"720","1471首利","110/07/29","凱基-羅東",0,10,-10
"721","2883開發金","110/07/29","國泰證券",2782,3,2779
"722","2883開發金","110/07/29","永豐金證券",223,3618,-3395
"723","2883開發金","110/07/29","凱基-台北",2299,284,2015
"724","2883開發金","110/07/29","摩根大通",411,2625,-2214
"725","2883開發金","110/07/29","第一金",1539,7,1532
"726","2883開發金","110/07/29","台灣企銀",5,1717,-1712
"727","2883開發金","110/07/29","港商野村",1983,585,1398
"728","2883開發金","110/07/29","新加坡商瑞銀",843,2324,-1481
"729","2883開發金","110/07/29","元富",1805,427,1378
"730","2883開發金","110/07/29","港商麥格理",0,1129,-1129
"731","2883開發金","110/07/29","台灣摩根士丹利",1634,398,1236
"732","2883開發金","110/07/29","元大-學甲",1,953,-952
"733","2883開發金","110/07/29","花旗環球",932,0,932
"734","2883開發金","110/07/29","國票-博愛",100,1025,-925
"735","2883開發金","110/07/29","凱基-敦北",590,5,585
"736","2883開發金","110/07/29","國泰-館前",220,944,-724
"737","2883開發金","110/07/29","國票-長城",506,4,502
"738","2883開發金","110/07/29","兆豐-高雄",33,650,-617
"739","2883開發金","110/07/29","港商法國興業",506,18,488
"740","2883開發金","110/07/29","元富-緯城",1,513,-512
"741","2883開發金","110/07/29","台新證券",753,287,466
"742","2883開發金","110/07/29","美林",232,698,-466
"743","2883開發金","110/07/29","元大-鳳中",495,71,424
"744","2883開發金","110/07/29","元富-城中",50,513,-463
"745","2883開發金","110/07/29","日茂",374,3,371
"746","2883開發金","110/07/29","致和-崇德",0,404,-404
"747","2883開發金","110/07/29","大和國泰",368,0,368
"748","2883開發金","110/07/29","永豐金-板橋",123,506,-383
"749","2883開發金","110/07/29","新光",603,243,360
"750","2883開發金","110/07/29","中國信託-忠孝",100,423,-323
"751","6205詮欣","110/07/29","臺銀-鳳山",31,0,31
"752","6205詮欣","110/07/29","永豐金-敦南",0,53,-53
"753","6205詮欣","110/07/29","摩根大通",16,2,14
"754","6205詮欣","110/07/29","元大-土城學府",2,16,-14
"755","6205詮欣","110/07/29","臺銀",10,0,10
"756","6205詮欣","110/07/29","元富-潮州",0,11,-11
"757","6205詮欣","110/07/29","日盛證券",10,0,10
"758","6205詮欣","110/07/29","元大-清水",0,10,-10
"759","6205詮欣","110/07/29","兆豐-新莊",10,0,10
"760","6205詮欣","110/07/29","日盛-三重",0,7,-7
"761","6205詮欣","110/07/29","元大-南屯",10,0,10
"762","6205詮欣","110/07/29","日盛-屏東",0,6,-6
"763","6205詮欣","110/07/29","富邦-建國",4,0,4
"764","6205詮欣","110/07/29","華南永昌-公誠",0,5,-5
"765","6205詮欣","110/07/29","富邦-南屯",4,0,4
"766","6205詮欣","110/07/29","元大-南京",0,5,-5
"767","6205詮欣","110/07/29","臺銀-臺中",3,0,3
"768","6205詮欣","110/07/29","瑞士信貸",0,4,-4
"769","6205詮欣","110/07/29","日盛-和美",3,0,3
"770","6205詮欣","110/07/29","凱基-大安",0,4,-4
"771","6205詮欣","110/07/29","德信-新營",3,0,3
"772","6205詮欣","110/07/29","元大-大里德芳",0,4,-4
"773","6205詮欣","110/07/29","兆豐-景美",3,0,3
"774","6205詮欣","110/07/29","合庫-基隆",0,2,-2
"775","6205詮欣","110/07/29","國票",3,0,3
"776","6205詮欣","110/07/29","中國信託-永康",0,2,-2
"777","6205詮欣","110/07/29","國票-南崁",3,0,3
"778","6205詮欣","110/07/29","兆豐-小港",0,2,-2
"779","6205詮欣","110/07/29","元大-蘆洲",3,0,3
"780","6205詮欣","110/07/29","康和-台中",0,2,-2
"781","1540喬福","110/07/29","高橋-龍潭",10,0,10
"782","1540喬福","110/07/29","統一-新台中",0,19,-19
"783","1540喬福","110/07/29","富邦-南屯",10,0,10
"784","1540喬福","110/07/29","元富-大昌",0,10,-10
"785","1540喬福","110/07/29","元大-斗六",5,0,5
"786","1540喬福","110/07/29","大昌-新店",0,6,-6
"787","1540喬福","110/07/29","兆豐-北高雄",3,0,3
"788","1540喬福","110/07/29","凱基-台北",0,3,-3
"789","1540喬福","110/07/29","元大-大安",3,0,3
"790","1540喬福","110/07/29","台新-台中",0,2,-2
"791","1540喬福","110/07/29","永豐金-台中",3,0,3
"792","1540喬福","110/07/29","群益金鼎-嘉義",0,2,-2
"793","1540喬福","110/07/29","臺銀-金山",2,0,2
"794","1540喬福","110/07/29","凱基-天母",0,2,-2
"795","1540喬福","110/07/29","日盛-士林",2,0,2
"796","1540喬福","110/07/29","花旗環球",0,1,-1
"797","1540喬福","110/07/29","元大-土城學府",2,0,2
"798","1540喬福","110/07/29","第一金-大稻埕",0,1,-1
"799","1540喬福","110/07/29","元大-南京",2,0,2
"800","1540喬福","110/07/29","統一-嘉義",0,1,-1
"801","1540喬福","110/07/29","臺銀-臺南",1,0,1
"802","1540喬福","110/07/29","元富-中港",0,1,-1
"803","1540喬福","110/07/29","第一金-台南",1,0,1
"804","1540喬福","110/07/29","(牛牛牛)亞-網路",0,1,-1
"805","1540喬福","110/07/29","台中銀-豐原",1,0,1
"806","1540喬福","110/07/29","玉山-高雄",0,1,-1
"807","1540喬福","110/07/29","中國信託-高雄",1,0,1
"808","1540喬福","110/07/29","群益金鼎-台南",0,1,-1
"809","1540喬福","110/07/29","兆豐-台中港",1,0,1
"810","1540喬福","110/07/29","凱基-鳳山",0,1,-1
"811","2888新光金","110/07/29","美商高盛",6409,110,6299
"812","2888新光金","110/07/29","元大-忠孝鼎富",0,6714,-6714
"813","2888新光金","110/07/29","台灣摩根士丹利",4583,443,4140
"814","2888新光金","110/07/29","凱基-台北",5855,11898,-6043
"815","2888新光金","110/07/29","元富-草屯",2193,2,2191
"816","2888新光金","110/07/29","瑞士信貸",161,6090,-5929
"817","2888新光金","110/07/29","華南永昌-南京",2059,21,2038
"818","2888新光金","110/07/29","永豐金-萬盛",124,3599,-3475
"819","2888新光金","110/07/29","凱基-市政",1558,0,1558
"820","2888新光金","110/07/29","群益金鼎-大安",2,3306,-3304
"821","2888新光金","110/07/29","法銀巴黎",1234,0,1234
"822","2888新光金","110/07/29","凱基-復興",15,3015,-3000
"823","2888新光金","110/07/29","永豐金-台中",1166,49,1117
"824","2888新光金","110/07/29","新加坡商瑞銀",1429,4265,-2836
"825","2888新光金","110/07/29","群益金鼎-崇德",1083,10,1073
"826","2888新光金","110/07/29","凱基-大安",10,2564,-2554
"827","2888新光金","110/07/29","兆豐-竹北",1002,29,973
"828","2888新光金","110/07/29","中國信託",46,2012,-1966
"829","2888新光金","110/07/29","美林",1767,804,963
"830","2888新光金","110/07/29","群益金鼎-台北",10,1875,-1865
"831","2888新光金","110/07/29","元大-三重",882,0,882
"832","2888新光金","110/07/29","元富-城東",142,1856,-1714
"833","2888新光金","110/07/29","元大-豐原站前",983,114,869
"834","2888新光金","110/07/29","華南永昌-忠孝",10,1600,-1590
"835","2888新光金","110/07/29","元大-北港",868,5,863
"836","2888新光金","110/07/29","永豐金-信義",10,1497,-1487
"837","2888新光金","110/07/29","合庫-台中",891,54,837
"838","2888新光金","110/07/29","富邦-建國",350,1736,-1386
"839","2888新光金","110/07/29","統一-汐止",725,14,711
"840","2888新光金","110/07/29","富邦-新營",60,1402,-1342
"841","1340勝悅","110/07/29","新光-新竹",18,0,18
"842","1340勝悅","110/07/29","瑞士信貸",0,8,-8
"843","1340勝悅","110/07/29","華南永昌-彰化",5,0,5
"844","1340勝悅","110/07/29","台新證券",0,7,-7
"845","1340勝悅","110/07/29","元大-六合",5,0,5
"846","1340勝悅","110/07/29","元富-緯城",0,5,-5
"847","1340勝悅","110/07/29","第一金-自由",4,0,4
"848","1340勝悅","110/07/29","兆豐-南京",0,5,-5
"849","1340勝悅","110/07/29","新光",4,0,4
"850","1340勝悅","110/07/29","富邦-南屯",0,5,-5
"851","1340勝悅","110/07/29","美商高盛",3,0,3
"852","1340勝悅","110/07/29","元富-安南",0,4,-4
"853","1340勝悅","110/07/29","元富-彰化",3,0,3
"854","1340勝悅","110/07/29","兆豐-三民",0,4,-4
"855","1340勝悅","110/07/29","大昌",2,0,2
"856","1340勝悅","110/07/29","兆豐-松德",0,4,-4
"857","1340勝悅","110/07/29","兆豐-大安",2,0,2
"858","1340勝悅","110/07/29","國票-台中",0,4,-4
"859","1340勝悅","110/07/29","摩根大通",2,0,2
"860","1340勝悅","110/07/29","第一金-路竹",0,3,-3
"861","1340勝悅","110/07/29","新光-台中",2,0,2
"862","1340勝悅","110/07/29","統一-城中",2,4,-2
"863","1340勝悅","110/07/29","凱基-八德",2,0,2
"864","1340勝悅","110/07/29","元富-同大",0,2,-2
"865","1340勝悅","110/07/29","合庫-高雄",1,0,1
"866","1340勝悅","110/07/29","台新-高雄",0,2,-2
"867","1340勝悅","110/07/29","日進",1,0,1
"868","1340勝悅","110/07/29","凱基-北門",0,2,-2
"869","1340勝悅","110/07/29","新光-台南",1,0,1
"870","1340勝悅","110/07/29","元大-汐止",0,2,-2
"871","6246臺龍","110/07/29","港商野村",38,1,37
"872","6246臺龍","110/07/29","玉山-台南",0,27,-27
"873","6246臺龍","110/07/29","凱基-幸福",25,0,25
"874","6246臺龍","110/07/29","國泰-忠孝",0,25,-25
"875","6246臺龍","110/07/29","亞東-板橋",16,0,16
"876","6246臺龍","110/07/29","光和",0,21,-21
"877","6246臺龍","110/07/29","元大-台中",10,0,10
"878","6246臺龍","110/07/29","第一金-安和",0,20,-20
"879","6246臺龍","110/07/29","兆豐-松德",9,0,9
"880","6246臺龍","110/07/29","兆豐-竹北",5,25,-20
"881","6246臺龍","110/07/29","兆豐-公益",8,0,8
"882","6246臺龍","110/07/29","元大-大里",0,20,-20
"883","6246臺龍","110/07/29","華南永昌",7,0,7
"884","6246臺龍","110/07/29","台新-台南",0,15,-15
"885","6246臺龍","110/07/29","日盛-斗六",6,0,6
"886","6246臺龍","110/07/29","永豐金-羅東",2,15,-13
"887","6246臺龍","110/07/29","元富-中港",6,0,6
"888","6246臺龍","110/07/29","元大-博愛",1,10,-9
"889","6246臺龍","110/07/29","台新證券",8,2,6
"890","6246臺龍","110/07/29","宏遠-台中",0,5,-5
"891","6246臺龍","110/07/29","臺銀-臺中",5,0,5
"892","6246臺龍","110/07/29","台新-左楠",0,5,-5
"893","6246臺龍","110/07/29","元富-宜蘭",5,0,5
"894","6246臺龍","110/07/29","中農",0,5,-5
"895","6246臺龍","110/07/29","德信-新營",5,0,5
"896","6246臺龍","110/07/29","群益金鼎-竹南",0,5,-5
"897","6246臺龍","110/07/29","新光-新竹",5,0,5
"898","6246臺龍","110/07/29","凱基-科園",0,5,-5
"899","6246臺龍","110/07/29","國泰-敦南",10,5,5
"900","6246臺龍","110/07/29","日盛-宜蘭",1,5,-4
"901","00715L期街口布蘭特正2","110/07/29","永豐金證券",2129,2,2127
"902","00715L期街口布蘭特正2","110/07/29","國票-博愛",55,702,-647
"903","00715L期街口布蘭特正2","110/07/29","元大證券",1918,115,1803
"904","00715L期街口布蘭特正2","110/07/29","富邦-彰化",0,605,-605
"905","00715L期街口布蘭特正2","110/07/29","統一",1050,313,737
"906","00715L期街口布蘭特正2","110/07/29","元大-前金",0,440,-440
"907","00715L期街口布蘭特正2","110/07/29","港商野村",821,263,558
"908","00715L期街口布蘭特正2","110/07/29","群益金鼎-崇德",0,340,-340
"909","00715L期街口布蘭特正2","110/07/29","永豐金-內湖",500,0,500
"910","00715L期街口布蘭特正2","110/07/29","元富-板橋",7,330,-323
"911","00715L期街口布蘭特正2","110/07/29","元富-大裕",505,23,482
"912","00715L期街口布蘭特正2","110/07/29","元大-三重",3,200,-197
"913","00715L期街口布蘭特正2","110/07/29","國票-台中",276,0,276
"914","00715L期街口布蘭特正2","110/07/29","凱基-東勢",5,194,-189
"915","00715L期街口布蘭特正2","110/07/29","統一-高雄",300,118,182
"916","00715L期街口布蘭特正2","110/07/29","富邦-台北",0,181,-181
"917","00715L期街口布蘭特正2","110/07/29","群益金鼎-瑞豐",180,0,180
"918","00715L期街口布蘭特正2","110/07/29","大慶-中和",0,174,-174
"919","00715L期街口布蘭特正2","110/07/29","元大-南崁",128,0,128
"920","00715L期街口布蘭特正2","110/07/29","永豐金-萬盛",0,153,-153
"921","00715L期街口布蘭特正2","110/07/29","大慶-蘆洲",106,0,106
"922","00715L期街口布蘭特正2","110/07/29","元大-開元",0,151,-151
"923","00715L期街口布蘭特正2","110/07/29","統一-中壢",100,0,100
"924","00715L期街口布蘭特正2","110/07/29","日盛-新竹",0,126,-126
"925","00715L期街口布蘭特正2","110/07/29","第一金-自由",100,2,98
"926","00715L期街口布蘭特正2","110/07/29","凱基-豐中",0,123,-123
"927","00715L期街口布蘭特正2","110/07/29","華南永昌-內壢",100,2,98
"928","00715L期街口布蘭特正2","110/07/29","元大-東泰",0,122,-122
"929","00715L期街口布蘭特正2","110/07/29","永豐金-板橋",98,0,98
"930","00715L期街口布蘭特正2","110/07/29","台新-高雄",0,121,-121
"931","8941關中","110/07/29","富邦-仁愛",1,0,1
"932","8941關中","110/07/29","富邦-員林",0,1,-1
"933","8941關中","110/07/29","康和-板橋",0,0,0
"934","8941關中","110/07/29","康和-板橋",0,0,0
"935","8941關中","110/07/29","玉山證券",0,0,0
"936","8941關中","110/07/29","玉山證券",0,0,0
"937","8941關中","110/07/29","玉山-數位",0,0,0
"938","8941關中","110/07/29","玉山-數位",0,0,0
"939","8941關中","110/07/29","凱基-市府",0,0,0
"940","8941關中","110/07/29","凱基-市府",0,0,0
"941","8941關中","110/07/29","元大-鶯歌",0,0,0
"942","8941關中","110/07/29","元大-鶯歌",0,0,0
"943","8941關中","110/07/29","元大-花蓮",0,0,0
"944","8941關中","110/07/29","元大-花蓮",0,0,0
"945","8941關中","110/07/29","",NA,NA,NA
"946","8941關中","110/07/29","",NA,NA,NA
"947","8941關中","110/07/29","",NA,NA,NA
"948","8941關中","110/07/29","",NA,NA,NA
"949","8941關中","110/07/29","",NA,NA,NA
"950","8941關中","110/07/29","",NA,NA,NA
"951","8941關中","110/07/29","",NA,NA,NA
"952","8941關中","110/07/29","",NA,NA,NA
"953","8941關中","110/07/29","",NA,NA,NA
"954","8941關中","110/07/29","",NA,NA,NA
"955","8941關中","110/07/29","",NA,NA,NA
"956","8941關中","110/07/29","",NA,NA,NA
"957","8941關中","110/07/29","",NA,NA,NA
"958","8941關中","110/07/29","",NA,NA,NA
"959","8941關中","110/07/29","",NA,NA,NA
"960","8941關中","110/07/29","",NA,NA,NA
"961","8936國統","110/07/29","新加坡商瑞銀",89,19,70
"962","8936國統","110/07/29","日盛-忠孝",11,135,-124
"963","8936國統","110/07/29","瑞士信貸",55,3,52
"964","8936國統","110/07/29","元富-敦南",0,80,-80
"965","8936國統","110/07/29","凱基-台北",48,3,45
"966","8936國統","110/07/29","康和",0,20,-20
"967","8936國統","110/07/29","摩根大通",97,60,37
"968","8936國統","110/07/29","元大-竹科",0,20,-20
"969","8936國統","110/07/29","美林",27,2,25
"970","8936國統","110/07/29","永豐金-桃園",0,19,-19
"971","8936國統","110/07/29","凱基-三多",25,0,25
"972","8936國統","110/07/29","群益金鼎-高盛",0,14,-14
"973","8936國統","110/07/29","凱基-北門",27,2,25
"974","8936國統","110/07/29","元富-安南",2,15,-13
"975","8936國統","110/07/29","兆豐-桃鶯",30,10,20
"976","8936國統","110/07/29","富邦-內湖",2,15,-13
"977","8936國統","110/07/29","永豐金-台中",20,0,20
"978","8936國統","110/07/29","元大-復北",0,11,-11
"979","8936國統","110/07/29","台灣摩根士丹利",30,12,18
"980","8936國統","110/07/29","合庫-鳳山",0,10,-10
"981","8936國統","110/07/29","兆豐-大同",15,0,15
"982","8936國統","110/07/29","元富-潮州",0,10,-10
"983","8936國統","110/07/29","新光-台中",39,24,15
"984","8936國統","110/07/29","群益金鼎-台北",0,10,-10
"985","8936國統","110/07/29","兆豐-新營",10,0,10
"986","8936國統","110/07/29","凱基-高雄",20,30,-10
"987","8936國統","110/07/29","台新-高雄",10,0,10
"988","8936國統","110/07/29","富邦-桃園",0,10,-10
"989","8936國統","110/07/29","玉山-士林",10,0,10
"990","8936國統","110/07/29","新光",1,10,-9
"991","6226光鼎","110/07/29","台新-台中",396,46,350
"992","6226光鼎","110/07/29","群益金鼎-東大",11,309,-298
"993","6226光鼎","110/07/29","元富-永和",242,0,242
"994","6226光鼎","110/07/29","日盛證券",2,176,-174
"995","6226光鼎","110/07/29","永豐金-古亭",200,0,200
"996","6226光鼎","110/07/29","國泰-敦南",90,197,-107
"997","6226光鼎","110/07/29","華南永昌",216,46,170
"998","6226光鼎","110/07/29","元大-雙和",16,111,-95
"999","6226光鼎","110/07/29","國票-北高雄",188,36,152
"1000","6226光鼎","110/07/29","元大-大統",2,94,-92
"1001","6226光鼎","110/07/29","國票-台南",120,4,116
"1002","6226光鼎","110/07/29","元大-板橋",5,78,-73
"1003","6226光鼎","110/07/29","永豐金證券",101,3,98
"1004","6226光鼎","110/07/29","群益金鼎-萬華",46,111,-65
"1005","6226光鼎","110/07/29","富邦-建國",125,28,97
"1006","6226光鼎","110/07/29","華南永昌-竹北",1,60,-59
"1007","6226光鼎","110/07/29","群益金鼎-土城",94,9,85
"1008","6226光鼎","110/07/29","玉山證券",28,86,-58
"1009","6226光鼎","110/07/29","元富-四維",82,4,78
"1010","6226光鼎","110/07/29","元大-土城學府",13,68,-55
"1011","6226光鼎","110/07/29","元大-鳳中",69,15,54
"1012","6226光鼎","110/07/29","元大-豐原",5,59,-54
"1013","6226光鼎","110/07/29","台新-新莊",54,1,53
"1014","6226光鼎","110/07/29","統一",56,107,-51
"1015","6226光鼎","110/07/29","中國信託-新竹",63,13,50
"1016","6226光鼎","110/07/29","統一-內湖",0,48,-48
"1017","6226光鼎","110/07/29","群益金鼎-士林",50,0,50
"1018","6226光鼎","110/07/29","元大-東港",2,50,-48
"1019","6226光鼎","110/07/29","台新-高雄",125,80,45
"1020","6226光鼎","110/07/29","元大-太平",1,46,-45
"1021","2363矽統","110/07/29","凱基-台北",2235,1238,997
"1022","2363矽統","110/07/29","康和-台中",10,437,-427
"1023","2363矽統","110/07/29","摩根大通",1784,793,991
"1024","2363矽統","110/07/29","第一金-新興",11,310,-299
"1025","2363矽統","110/07/29","港商野村",1833,1300,533
"1026","2363矽統","110/07/29","瑞士信貸",9,190,-181
"1027","2363矽統","110/07/29","美林",652,288,364
"1028","2363矽統","110/07/29","台新證券",659,808,-149
"1029","2363矽統","110/07/29","元大-台中",376,38,338
"1030","2363矽統","110/07/29","元大-萬華",42,189,-147
"1031","2363矽統","110/07/29","新加坡商瑞銀",748,474,274
"1032","2363矽統","110/07/29","台新-左楠",26,171,-145
"1033","2363矽統","110/07/29","國泰-敦南",566,333,233
"1034","2363矽統","110/07/29","華南永昌-鳳山",116,241,-125
"1035","2363矽統","110/07/29","元大-旗山",299,66,233
"1036","2363矽統","110/07/29","永全-南崁",0,117,-117
"1037","2363矽統","110/07/29","美商高盛",600,433,167
"1038","2363矽統","110/07/29","群益金鼎-桃園",25,131,-106
"1039","2363矽統","110/07/29","元大-永和",146,12,134
"1040","2363矽統","110/07/29","宏遠-新化",3,103,-100
"1041","2363矽統","110/07/29","元大證券",137,9,128
"1042","2363矽統","110/07/29","新光",331,429,-98
"1043","2363矽統","110/07/29","永豐金-彰化",135,10,125
"1044","2363矽統","110/07/29","中國信託-忠孝",101,188,-87
"1045","2363矽統","110/07/29","北城證券",139,19,120
"1046","2363矽統","110/07/29","群益金鼎-建成",11,95,-84
"1047","2363矽統","110/07/29","富邦-高雄",153,34,119
"1048","2363矽統","110/07/29","群益金鼎-三民",23,105,-82
"1049","2363矽統","110/07/29","元大-蘆洲",120,19,101
"1050","2363矽統","110/07/29","元大-豐原",104,186,-82
"1051","8112至上","110/07/29","合庫證券",194,1,193
"1052","8112至上","110/07/29","摩根大通",4,424,-420
"1053","8112至上","110/07/29","美商高盛",154,5,149
"1054","8112至上","110/07/29","日盛-高雄",2,400,-398
"1055","8112至上","110/07/29","永豐金證券",144,0,144
"1056","8112至上","110/07/29","港商法國興業",0,374,-374
"1057","8112至上","110/07/29","新光-台中",123,12,111
"1058","8112至上","110/07/29","凱基-台北",50,312,-262
"1059","8112至上","110/07/29","新加坡商瑞銀",189,83,106
"1060","8112至上","110/07/29","美林",69,232,-163
"1061","8112至上","110/07/29","華南永昌-新莊",73,0,73
"1062","8112至上","110/07/29","兆豐-公益",0,120,-120
"1063","8112至上","110/07/29","新光",108,49,59
"1064","8112至上","110/07/29","瑞士信貸",1,109,-108
"1065","8112至上","110/07/29","元富-文心",45,3,42
"1066","8112至上","110/07/29","華南永昌-小港",4,30,-26
"1067","8112至上","110/07/29","華南永昌-林口",41,0,41
"1068","8112至上","110/07/29","富邦-中壢",1,24,-23
"1069","8112至上","110/07/29","港商野村",146,112,34
"1070","8112至上","110/07/29","元大-歸仁",2,24,-22
"1071","8112至上","110/07/29","臺銀-高雄",30,0,30
"1072","8112至上","110/07/29","華南永昌-麻豆",0,21,-21
"1073","8112至上","110/07/29","元富-佳里",30,0,30
"1074","8112至上","110/07/29","台新-松江",0,20,-20
"1075","8112至上","110/07/29","永豐金-內湖",30,1,29
"1076","8112至上","110/07/29","元大-新莊",1,20,-19
"1077","8112至上","110/07/29","台新-新營",31,3,28
"1078","8112至上","110/07/29","華南永昌-岡山",1,19,-18
"1079","8112至上","110/07/29","永豐金-彰化",27,0,27
"1080","8112至上","110/07/29","元大-崇德",3,20,-17
"1081","1570力肯","110/07/29","群益金鼎-高雄",20,0,20
"1082","1570力肯","110/07/29","聯邦-興中",0,17,-17
"1083","1570力肯","110/07/29","群益金鼎-板橋",16,0,16
"1084","1570力肯","110/07/29","富邦-建國",0,10,-10
"1085","1570力肯","110/07/29","統一-敦南",5,0,5
"1086","1570力肯","110/07/29","凱基-站前",0,5,-5
"1087","1570力肯","110/07/29","元富-松德",4,0,4
"1088","1570力肯","110/07/29","國泰-板橋",0,4,-4
"1089","1570力肯","110/07/29","元大-和平",4,0,4
"1090","1570力肯","110/07/29","統一-土城",0,3,-3
"1091","1570力肯","110/07/29","凱基-幸福",3,0,3
"1092","1570力肯","110/07/29","凱基-大里",0,3,-3
"1093","1570力肯","110/07/29","華南永昌-鳳山",3,0,3
"1094","1570力肯","110/07/29","凱基-台北",0,3,-3
"1095","1570力肯","110/07/29","元大-北港",4,2,2
"1096","1570力肯","110/07/29","元大-屏東民生",0,3,-3
"1097","1570力肯","110/07/29","美林",1,0,1
"1098","1570力肯","110/07/29","元富-緯城",0,2,-2
"1099","1570力肯","110/07/29","國泰-台南",1,0,1
"1100","1570力肯","110/07/29","台新-高雄",0,2,-2
"1101","1570力肯","110/07/29","元大-歸仁",1,0,1
"1102","1570力肯","110/07/29","華南永昌-楠梓",0,2,-2
"1103","1570力肯","110/07/29","元大-松山",1,0,1
"1104","1570力肯","110/07/29","元大-北成功",0,2,-2
"1105","1570力肯","110/07/29","元大-文心興安",1,0,1
"1106","1570力肯","110/07/29","元大-板橋",0,2,-2
"1107","1570力肯","110/07/29","元大-東蘆",1,0,1
"1108","1570力肯","110/07/29","統一-台南",0,1,-1
"1109","1570力肯","110/07/29","群益金鼎-鳳山",0,0,0
"1110","1570力肯","110/07/29","台新證券",0,1,-1
"1111","2929淘帝","110/07/29","新光-新竹",118,13,105
"1112","2929淘帝","110/07/29","元富-敦南",0,91,-91
"1113","2929淘帝","110/07/29","新加坡商瑞銀",56,0,56
"1114","2929淘帝","110/07/29","日盛-板橋中山",0,38,-38
"1115","2929淘帝","110/07/29","凱基-台北",39,4,35
"1116","2929淘帝","110/07/29","群益金鼎-士林",0,20,-20
"1117","2929淘帝","110/07/29","元大-民生",29,0,29
"1118","2929淘帝","110/07/29","華南永昌-敦南",0,20,-20
"1119","2929淘帝","110/07/29","美林",37,9,28
"1120","2929淘帝","110/07/29","高橋-龍潭",3,20,-17
"1121","2929淘帝","110/07/29","元大-承德",15,0,15
"1122","2929淘帝","110/07/29","凱基-中山",4,19,-15
"1123","2929淘帝","110/07/29","第一金-台南",10,0,10
"1124","2929淘帝","110/07/29","富邦-台北",0,15,-15
"1125","2929淘帝","110/07/29","富邦-桃園",9,0,9
"1126","2929淘帝","110/07/29","元富-台中",0,14,-14
"1127","2929淘帝","110/07/29","港商野村",17,10,7
"1128","2929淘帝","110/07/29","台新-建北",0,13,-13
"1129","2929淘帝","110/07/29","台中銀-豐原",6,0,6
"1130","2929淘帝","110/07/29","永豐金-敦南",0,12,-12
"1131","2929淘帝","110/07/29","元大-文心興安",6,0,6
"1132","2929淘帝","110/07/29","新光-台南",0,11,-11
"1133","2929淘帝","110/07/29","德信-新營",5,0,5
"1134","2929淘帝","110/07/29","宏遠-光隆",0,10,-10
"1135","2929淘帝","110/07/29","元大-博愛",5,0,5
"1136","2929淘帝","110/07/29","元大-嘉義",0,6,-6
"1137","2929淘帝","110/07/29","元大-員林",5,0,5
"1138","2929淘帝","110/07/29","日茂-南投",0,5,-5
"1139","2929淘帝","110/07/29","富邦-中壢",4,0,4
"1140","2929淘帝","110/07/29","新光",0,5,-5
"1141","5410國眾","110/07/29","兆豐-城中",32,0,32
"1142","5410國眾","110/07/29","第一金-台南",0,51,-51
"1143","5410國眾","110/07/29","新加坡商瑞銀",19,0,19
"1144","5410國眾","110/07/29","元富-大昌",0,13,-13
"1145","5410國眾","110/07/29","華南永昌-新莊",16,0,16
"1146","5410國眾","110/07/29","臺銀-臺南",0,12,-12
"1147","5410國眾","110/07/29","元大-小港",11,0,11
"1148","5410國眾","110/07/29","日盛-木柵",0,10,-10
"1149","5410國眾","110/07/29","臺銀",10,0,10
"1150","5410國眾","110/07/29","元富-安南",0,10,-10
"1151","5410國眾","110/07/29","臺銀-臺中",10,0,10
"1152","5410國眾","110/07/29","新光",4,13,-9
"1153","5410國眾","110/07/29","宏遠-館前",10,0,10
"1154","5410國眾","110/07/29","永豐金-屏東",0,5,-5
"1155","5410國眾","110/07/29","台新-中壢",10,0,10
"1156","5410國眾","110/07/29","永豐金-苓雅",0,5,-5
"1157","5410國眾","110/07/29","摩根大通",10,1,9
"1158","5410國眾","110/07/29","國票-台南",0,4,-4
"1159","5410國眾","110/07/29","元大-北投",9,0,9
"1160","5410國眾","110/07/29","永豐金-埔里",0,4,-4
"1161","5410國眾","110/07/29","台新證券",7,1,6
"1162","5410國眾","110/07/29","光和",0,3,-3
"1163","5410國眾","110/07/29","元富-新竹",5,0,5
"1164","5410國眾","110/07/29","凱基-汐止",0,3,-3
"1165","5410國眾","110/07/29","凱基-竹北",5,0,5
"1166","5410國眾","110/07/29","元大-善化",0,3,-3
"1167","5410國眾","110/07/29","永豐金-敦南",5,1,4
"1168","5410國眾","110/07/29","元大-員林",0,3,-3
"1169","5410國眾","110/07/29","美林",4,1,3
"1170","5410國眾","110/07/29","永豐金-台南",0,3,-3
"1171","2841台開","110/07/29","兆豐-台南",237,0,237
"1172","2841台開","110/07/29","元大-四維",0,184,-184
"1173","2841台開","110/07/29","永豐金-敦南",60,10,50
"1174","2841台開","110/07/29","玉山-新竹",0,145,-145
"1175","2841台開","110/07/29","永豐金-板新",50,0,50
"1176","2841台開","110/07/29","港商野村",0,124,-124
"1177","2841台開","110/07/29","華南永昌-南京",45,2,43
"1178","2841台開","110/07/29","永豐金-台南",0,32,-32
"1179","2841台開","110/07/29","群益金鼎-崇德",23,0,23
"1180","2841台開","110/07/29","華南永昌-公誠",0,23,-23
"1181","2841台開","110/07/29","日盛-園區",20,0,20
"1182","2841台開","110/07/29","元大-善化",0,22,-22
"1183","2841台開","110/07/29","台新-台中",20,0,20
"1184","2841台開","110/07/29","元大-豐原",0,20,-20
"1185","2841台開","110/07/29","華南永昌-新莊",20,0,20
"1186","2841台開","110/07/29","凱基-台北",0,15,-15
"1187","2841台開","110/07/29","富邦-仁愛",20,0,20
"1188","2841台開","110/07/29","富邦-台北",0,15,-15
"1189","2841台開","110/07/29","新光",15,0,15
"1190","2841台開","110/07/29","臺銀",0,10,-10
"1191","2841台開","110/07/29","華南永昌-台中",15,0,15
"1192","2841台開","110/07/29","元富-三重",0,10,-10
"1193","2841台開","110/07/29","凱基-彰化",13,0,13
"1194","2841台開","110/07/29","元大-林森",0,10,-10
"1195","2841台開","110/07/29","兆豐-台中",10,0,10
"1196","2841台開","110/07/29","光和-花壇",0,9,-9
"1197","2841台開","110/07/29","永豐金-松山",10,0,10
"1198","2841台開","110/07/29","國泰-桃園",1,10,-9
"1199","2841台開","110/07/29","國泰-館前",9,0,9
"1200","2841台開","110/07/29","玉山-嘉義",0,8,-8
"1201","6207雷科","110/07/29","永豐金-古亭",100,0,100
"1202","6207雷科","110/07/29","摩根大通",59,151,-92
"1203","6207雷科","110/07/29","國泰-館前",52,6,46
"1204","6207雷科","110/07/29","凱基-高雄",0,82,-82
"1205","6207雷科","110/07/29","新加坡商瑞銀",41,12,29
"1206","6207雷科","110/07/29","元大-松江",0,25,-25
"1207","6207雷科","110/07/29","大慶-蘆洲",29,6,23
"1208","6207雷科","110/07/29","元大-雙和",2,25,-23
"1209","6207雷科","110/07/29","永豐金-羅東",21,0,21
"1210","6207雷科","110/07/29","港商野村",16,36,-20
"1211","6207雷科","110/07/29","統一-南京",16,0,16
"1212","6207雷科","110/07/29","盈溢-楠梓",0,20,-20
"1213","6207雷科","110/07/29","凱基-台北",45,29,16
"1214","6207雷科","110/07/29","統一",2,20,-18
"1215","6207雷科","110/07/29","富邦-敦南",16,0,16
"1216","6207雷科","110/07/29","日盛-新竹",1,16,-15
"1217","6207雷科","110/07/29","統一-高雄",15,0,15
"1218","6207雷科","110/07/29","康和-台中",0,15,-15
"1219","6207雷科","110/07/29","台新-中壢",11,0,11
"1220","6207雷科","110/07/29","凱基-竹科",0,13,-13
"1221","6207雷科","110/07/29","台灣企銀-竹北",10,0,10
"1222","6207雷科","110/07/29","元大-鳳中",0,12,-12
"1223","6207雷科","110/07/29","宏遠證券",10,0,10
"1224","6207雷科","110/07/29","元大-土城",0,12,-12
"1225","6207雷科","110/07/29","中國信託-忠孝",10,0,10
"1226","6207雷科","110/07/29","華南永昌-高雄",0,11,-11
"1227","6207雷科","110/07/29","大昌-桃園",11,1,10
"1228","6207雷科","110/07/29","元大-木柵",0,10,-10
"1229","6207雷科","110/07/29","玉山-城中",11,1,10
"1230","6207雷科","110/07/29","日盛-板橋",1,10,-9
"1231","3679新至陞","110/07/29","華南永昌-淡水",5,0,5
"1232","3679新至陞","110/07/29","元富-板橋",0,16,-16
"1233","3679新至陞","110/07/29","富邦-新竹華信",5,0,5
"1234","3679新至陞","110/07/29","凱基-台北",0,8,-8
"1235","3679新至陞","110/07/29","永豐金-中和",5,0,5
"1236","3679新至陞","110/07/29","摩根大通",1,6,-5
"1237","3679新至陞","110/07/29","富邦-台北",4,0,4
"1238","3679新至陞","110/07/29","美林",0,4,-4
"1239","3679新至陞","110/07/29","元富-彰化",2,0,2
"1240","3679新至陞","110/07/29","瑞士信貸",0,4,-4
"1241","3679新至陞","110/07/29","兆豐-台中港",2,0,2
"1242","3679新至陞","110/07/29","元大-成功",0,3,-3
"1243","3679新至陞","110/07/29","富邦-三重",2,0,2
"1244","3679新至陞","110/07/29","統一-台南",0,2,-2
"1245","3679新至陞","110/07/29","元大-沙鹿",2,0,2
"1246","3679新至陞","110/07/29","元富-新興",0,2,-2
"1247","3679新至陞","110/07/29","元大-福營",2,0,2
"1248","3679新至陞","110/07/29","凱基-竹科",0,2,-2
"1249","3679新至陞","110/07/29","元大-花蓮",2,0,2
"1250","3679新至陞","110/07/29","元大證券",0,2,-2
"1251","3679新至陞","110/07/29","元大-板橋",2,0,2
"1252","3679新至陞","110/07/29","日盛-北高雄",0,1,-1
"1253","3679新至陞","110/07/29","永豐金-台南",2,0,2
"1254","3679新至陞","110/07/29","宏遠-高雄",0,1,-1
"1255","3679新至陞","110/07/29","合庫-彰化",1,0,1
"1256","3679新至陞","110/07/29","花旗環球",0,1,-1
"1257","3679新至陞","110/07/29","臺銀-臺南",1,0,1
"1258","3679新至陞","110/07/29","華南永昌-岡山",0,1,-1
"1259","3679新至陞","110/07/29","永興-水湳",1,0,1
"1260","3679新至陞","110/07/29","元大-佳里",0,1,-1
"1261","2727王品","110/07/29","第一金",30,0,30
"1262","2727王品","110/07/29","元大-高雄",1,93,-92
"1263","2727王品","110/07/29","港商麥格理",22,0,22
"1264","2727王品","110/07/29","新加坡商瑞銀",5,82,-77
"1265","2727王品","110/07/29","國票-北高雄",24,2,22
"1266","2727王品","110/07/29","美林",0,27,-27
"1267","2727王品","110/07/29","日盛-忠孝",21,0,21
"1268","2727王品","110/07/29","港商野村",21,48,-27
"1269","2727王品","110/07/29","新光",22,3,19
"1270","2727王品","110/07/29","凱基-台北",43,61,-18
"1271","2727王品","110/07/29","國泰-敦南",18,7,11
"1272","2727王品","110/07/29","華南永昌-麻豆",0,18,-18
"1273","2727王品","110/07/29","凱基-五股",11,0,11
"1274","2727王品","110/07/29","國泰-台中",2,17,-15
"1275","2727王品","110/07/29","兆豐-鹿港",12,2,10
"1276","2727王品","110/07/29","永豐金-桃盛",0,15,-15
"1277","2727王品","110/07/29","凱基-埔墘",10,0,10
"1278","2727王品","110/07/29","美商高盛",1,15,-14
"1279","2727王品","110/07/29","永豐金-潮州",10,0,10
"1280","2727王品","110/07/29","玉山證券",4,15,-11
"1281","2727王品","110/07/29","統一",12,4,8
"1282","2727王品","110/07/29","摩根大通",12,22,-10
"1283","2727王品","110/07/29","國泰-板橋",7,0,7
"1284","2727王品","110/07/29","元大-四維",2,12,-10
"1285","2727王品","110/07/29","彰銀-台中",7,1,6
"1286","2727王品","110/07/29","凱基-興隆",0,9,-9
"1287","2727王品","110/07/29","新光-高雄",12,6,6
"1288","2727王品","110/07/29","瑞士信貸",0,8,-8
"1289","2727王品","110/07/29","玉山-數位",6,0,6
"1290","2727王品","110/07/29","大昌-桃園",0,7,-7
"1291","1570力肯","110/07/29","群益金鼎-高雄",20,0,20
"1292","1570力肯","110/07/29","聯邦-興中",0,17,-17
"1293","1570力肯","110/07/29","群益金鼎-板橋",16,0,16
"1294","1570力肯","110/07/29","富邦-建國",0,10,-10
"1295","1570力肯","110/07/29","統一-敦南",5,0,5
"1296","1570力肯","110/07/29","凱基-站前",0,5,-5
"1297","1570力肯","110/07/29","元富-松德",4,0,4
"1298","1570力肯","110/07/29","國泰-板橋",0,4,-4
"1299","1570力肯","110/07/29","元大-和平",4,0,4
"1300","1570力肯","110/07/29","統一-土城",0,3,-3
"1301","1570力肯","110/07/29","凱基-幸福",3,0,3
"1302","1570力肯","110/07/29","凱基-大里",0,3,-3
"1303","1570力肯","110/07/29","華南永昌-鳳山",3,0,3
"1304","1570力肯","110/07/29","凱基-台北",0,3,-3
"1305","1570力肯","110/07/29","元大-北港",4,2,2
"1306","1570力肯","110/07/29","元大-屏東民生",0,3,-3
"1307","1570力肯","110/07/29","美林",1,0,1
"1308","1570力肯","110/07/29","元富-緯城",0,2,-2
"1309","1570力肯","110/07/29","國泰-台南",1,0,1
"1310","1570力肯","110/07/29","台新-高雄",0,2,-2
"1311","1570力肯","110/07/29","元大-歸仁",1,0,1
"1312","1570力肯","110/07/29","華南永昌-楠梓",0,2,-2
"1313","1570力肯","110/07/29","元大-松山",1,0,1
"1314","1570力肯","110/07/29","元大-北成功",0,2,-2
"1315","1570力肯","110/07/29","元大-文心興安",1,0,1
"1316","1570力肯","110/07/29","元大-板橋",0,2,-2
"1317","1570力肯","110/07/29","元大-東蘆",1,0,1
"1318","1570力肯","110/07/29","統一-台南",0,1,-1
"1319","1570力肯","110/07/29","群益金鼎-鳳山",0,0,0
"1320","1570力肯","110/07/29","台新證券",0,1,-1
"1321","6180橘子","110/07/29","凱基-台北",50,4,46
"1322","6180橘子","110/07/29","兆豐證券",0,95,-95
"1323","6180橘子","110/07/29","花旗環球",25,0,25
"1324","6180橘子","110/07/29","香港上海匯豐",0,74,-74
"1325","6180橘子","110/07/29","瑞士信貸",26,2,24
"1326","6180橘子","110/07/29","福勝",0,24,-24
"1327","6180橘子","110/07/29","兆豐-大同",20,0,20
"1328","6180橘子","110/07/29","第一金-安和",0,20,-20
"1329","6180橘子","110/07/29","新光-台中",17,0,17
"1330","6180橘子","110/07/29","永豐金-敦北",0,18,-18
"1331","6180橘子","110/07/29","元大-南屯",15,0,15
"1332","6180橘子","110/07/29","致和-崇德",0,10,-10
"1333","6180橘子","110/07/29","摩根大通",54,40,14
"1334","6180橘子","110/07/29","玉山-台大",0,10,-10
"1335","6180橘子","110/07/29","玉山-桃園",10,0,10
"1336","6180橘子","110/07/29","元大-四維",0,10,-10
"1337","6180橘子","110/07/29","永豐金-中正",10,0,10
"1338","6180橘子","110/07/29","元大-小港",0,8,-8
"1339","6180橘子","110/07/29","元富-三重",8,0,8
"1340","6180橘子","110/07/29","台灣摩根士丹利",7,13,-6
"1341","6180橘子","110/07/29","國泰-新莊",9,1,8
"1342","6180橘子","110/07/29","群益金鼎-丹鳳",0,6,-6
"1343","6180橘子","110/07/29","元大-木柵",8,0,8
"1344","6180橘子","110/07/29","永豐金-南京",2,8,-6
"1345","6180橘子","110/07/29","國票-敦北法人",7,0,7
"1346","6180橘子","110/07/29","日盛-頭份",5,10,-5
"1347","6180橘子","110/07/29","元大證券",7,0,7
"1348","6180橘子","110/07/29","宏遠-高雄",0,5,-5
"1349","6180橘子","110/07/29","高橋",6,0,6
"1350","6180橘子","110/07/29","第一金-中山",1,5,-4
"1351","2390云辰","110/07/29","元大-永和",561,61,500
"1352","2390云辰","110/07/29","摩根大通",152,377,-225
"1353","2390云辰","110/07/29","台灣摩根士丹利",163,1,162
"1354","2390云辰","110/07/29","元富-同大",3,139,-136
"1355","2390云辰","110/07/29","元大-善化",87,0,87
"1356","2390云辰","110/07/29","豐農",3,128,-125
"1357","2390云辰","110/07/29","元大-草屯",89,6,83
"1358","2390云辰","110/07/29","美商高盛",6,88,-82
"1359","2390云辰","110/07/29","富邦-羅東",74,10,64
"1360","2390云辰","110/07/29","美林",43,112,-69
"1361","2390云辰","110/07/29","元大-鑫永和",61,1,60
"1362","2390云辰","110/07/29","元大-發財",4,61,-57
"1363","2390云辰","110/07/29","元富-高雄",93,40,53
"1364","2390云辰","110/07/29","大慶-泰山",0,51,-51
"1365","2390云辰","110/07/29","台新-左楠",43,1,42
"1366","2390云辰","110/07/29","群益金鼎",5,49,-44
"1367","2390云辰","110/07/29","日盛-永康",35,2,33
"1368","2390云辰","110/07/29","元大-松江",0,40,-40
"1369","2390云辰","110/07/29","玉山-板橋",37,5,32
"1370","2390云辰","110/07/29","統一-新台中",123,161,-38
"1371","2390云辰","110/07/29","日盛-板橋中山",45,15,30
"1372","2390云辰","110/07/29","兆豐-員林",0,35,-35
"1373","2390云辰","110/07/29","元大-大統",30,0,30
"1374","2390云辰","110/07/29","第一金-新竹",1,35,-34
"1375","2390云辰","110/07/29","元大-竹北",30,1,29
"1376","2390云辰","110/07/29","日盛-員林",3,33,-30
"1377","2390云辰","110/07/29","元大-北屯",26,0,26
"1378","2390云辰","110/07/29","新光",40,70,-30
"1379","2390云辰","110/07/29","元大-林園",25,0,25
"1380","2390云辰","110/07/29","永豐金-松山",21,49,-28
"1381","1471首利","110/07/28","美林",138,26,112
"1382","1471首利","110/07/28","玉山-台大",0,234,-234
"1383","1471首利","110/07/28","摩根大通",164,80,84
"1384","1471首利","110/07/28","國票-九鼎",0,149,-149
"1385","1471首利","110/07/28","(牛牛牛)亞-鑫豐",65,0,65
"1386","1471首利","110/07/28","台中銀",0,69,-69
"1387","1471首利","110/07/28","大昌-新店",44,0,44
"1388","1471首利","110/07/28","元大-博愛",0,32,-32
"1389","1471首利","110/07/28","玉山-桃園",69,30,39
"1390","1471首利","110/07/28","凱基-竹北",0,30,-30
"1391","1471首利","110/07/28","兆豐-鹿港",28,0,28
"1392","1471首利","110/07/28","富邦-苗栗",0,30,-30
"1393","1471首利","110/07/28","聯邦-高雄",21,0,21
"1394","1471首利","110/07/28","港商法國興業",0,22,-22
"1395","1471首利","110/07/28","永豐金-中正",21,0,21
"1396","1471首利","110/07/28","國票-安和",0,20,-20
"1397","1471首利","110/07/28","第一金-高雄",16,0,16
"1398","1471首利","110/07/28","華南永昌-苑裡",0,15,-15
"1399","1471首利","110/07/28","統一-桃園",13,0,13
"1400","1471首利","110/07/28","日盛-中壢",0,13,-13
"1401","1471首利","110/07/28","新光-台中",19,6,13
"1402","1471首利","110/07/28","玉山-台南",0,13,-13
"1403","1471首利","110/07/28","彰銀-七賢",11,0,11
"1404","1471首利","110/07/28","凱基-桃園",0,12,-12
"1405","1471首利","110/07/28","第一金-台南",11,0,11
"1406","1471首利","110/07/28","聯邦-雙和",0,11,-11
"1407","1471首利","110/07/28","台新證券",11,0,11
"1408","1471首利","110/07/28","統一-新營",0,10,-10
"1409","1471首利","110/07/28","凱基-東勢",11,0,11
"1410","1471首利","110/07/28","凱基-城中",0,10,-10
"1411","2883開發金","110/07/28","摩根大通",5171,647,4524
"1412","2883開發金","110/07/28","台灣摩根士丹利",921,11451,-10530
"1413","2883開發金","110/07/28","瑞士信貸",4234,62,4172
"1414","2883開發金","110/07/28","美商高盛",522,3615,-3093
"1415","2883開發金","110/07/28","國泰證券",2247,28,2219
"1416","2883開發金","110/07/28","(牛牛牛)亞證券",0,3000,-3000
"1417","2883開發金","110/07/28","元大證券",2306,91,2215
"1418","2883開發金","110/07/28","康和-仁愛",17,3004,-2987
"1419","2883開發金","110/07/28","元富-城東",2203,113,2090
"1420","2883開發金","110/07/28","第一金",18,2301,-2283
"1421","2883開發金","110/07/28","新加坡商瑞銀",1840,81,1759
"1422","2883開發金","110/07/28","凱基-台北",3735,5169,-1434
"1423","2883開發金","110/07/28","永豐金-彰化",1682,27,1655
"1424","2883開發金","110/07/28","宏遠-高雄",4,1420,-1416
"1425","2883開發金","110/07/28","日盛證券",1637,9,1628
"1426","2883開發金","110/07/28","亞東-板橋",507,1722,-1215
"1427","2883開發金","110/07/28","元大-彰化",1183,11,1172
"1428","2883開發金","110/07/28","凱基-豐中",32,1127,-1095
"1429","2883開發金","110/07/28","美林",2507,1378,1129
"1430","2883開發金","110/07/28","群益金鼎-三重",65,993,-928
"1431","2883開發金","110/07/28","華南永昌",1204,239,965
"1432","2883開發金","110/07/28","元大-羅東",30,872,-842
"1433","2883開發金","110/07/28","日盛-台南",816,6,810
"1434","2883開發金","110/07/28","花旗環球",188,1004,-816
"1435","2883開發金","110/07/28","台新-松江",722,40,682
"1436","2883開發金","110/07/28","華南永昌-朴子",33,716,-683
"1437","2883開發金","110/07/28","新光-台中",858,231,627
"1438","2883開發金","110/07/28","元大-永和",31,700,-669
"1439","2883開發金","110/07/28","凱基-員林",634,25,609
"1440","2883開發金","110/07/28","玉山-台南",97,738,-641
"1441","6205詮欣","110/07/28","臺銀",30,0,30
"1442","6205詮欣","110/07/28","台灣摩根士丹利",0,59,-59
"1443","6205詮欣","110/07/28","元大-善化",30,0,30
"1444","6205詮欣","110/07/28","凱基-大安",0,50,-50
"1445","6205詮欣","110/07/28","日盛證券",16,0,16
"1446","6205詮欣","110/07/28","元大-板橋",0,20,-20
"1447","6205詮欣","110/07/28","元大-土城學府",15,3,12
"1448","6205詮欣","110/07/28","摩根大通",17,30,-13
"1449","6205詮欣","110/07/28","臺銀-民權",10,0,10
"1450","6205詮欣","110/07/28","凱基-台北",0,11,-11
"1451","6205詮欣","110/07/28","德信-新營",10,0,10
"1452","6205詮欣","110/07/28","新加坡商瑞銀",0,10,-10
"1453","6205詮欣","110/07/28","福勝",10,0,10
"1454","6205詮欣","110/07/28","第一金-新竹",0,10,-10
"1455","6205詮欣","110/07/28","元大-清水",10,0,10
"1456","6205詮欣","110/07/28","台新-高雄",0,6,-6
"1457","6205詮欣","110/07/28","新光",9,0,9
"1458","6205詮欣","110/07/28","凱基-三多",0,6,-6
"1459","6205詮欣","110/07/28","群益金鼎-屏東",7,0,7
"1460","6205詮欣","110/07/28","美林",2,7,-5
"1461","6205詮欣","110/07/28","元大-汐止",6,0,6
"1462","6205詮欣","110/07/28","瑞士信貸",0,5,-5
"1463","6205詮欣","110/07/28","統一-屏東",5,0,5
"1464","6205詮欣","110/07/28","中國信託-三重",0,5,-5
"1465","6205詮欣","110/07/28","日盛-三重",4,0,4
"1466","6205詮欣","110/07/28","日盛-雙和",0,4,-4
"1467","6205詮欣","110/07/28","亞東-板橋",4,0,4
"1468","6205詮欣","110/07/28","宏遠-光隆",0,4,-4
"1469","6205詮欣","110/07/28","台中銀",4,0,4
"1470","6205詮欣","110/07/28","兆豐-新莊",0,4,-4
"1471","1540喬福","110/07/28","兆豐-北高雄",48,0,48
"1472","1540喬福","110/07/28","合庫-台中",1,60,-59
"1473","1540喬福","110/07/28","兆豐-台中港",33,0,33
"1474","1540喬福","110/07/28","凱基-台北",0,44,-44
"1475","1540喬福","110/07/28","大慶-中壢",19,0,19
"1476","1540喬福","110/07/28","元大-學甲",0,35,-35
"1477","1540喬福","110/07/28","富邦-員林",18,0,18
"1478","1540喬福","110/07/28","統一-新台中",0,26,-26
"1479","1540喬福","110/07/28","(牛牛牛)亞-鑫豐",12,0,12
"1480","1540喬福","110/07/28","新光-新竹",0,21,-21
"1481","1540喬福","110/07/28","元富-文心",10,0,10
"1482","1540喬福","110/07/28","富邦-台北",0,20,-20
"1483","1540喬福","110/07/28","光和-和美",10,0,10
"1484","1540喬福","110/07/28","富邦-南屯",0,20,-20
"1485","1540喬福","110/07/28","永豐金-三重",9,0,9
"1486","1540喬福","110/07/28","元大-鶯歌",0,10,-10
"1487","1540喬福","110/07/28","臺銀-鳳山",8,0,8
"1488","1540喬福","110/07/28","元大-豐原",0,7,-7
"1489","1540喬福","110/07/28","元大-斗六",7,0,7
"1490","1540喬福","110/07/28","大昌-樹林",0,6,-6
"1491","1540喬福","110/07/28","台新-台中",6,0,6
"1492","1540喬福","110/07/28","新光-桃園",0,5,-5
"1493","1540喬福","110/07/28","華南永昌-中正",6,0,6
"1494","1540喬福","110/07/28","凱基-站前",0,5,-5
"1495","1540喬福","110/07/28","永豐金-台中",6,0,6
"1496","1540喬福","110/07/28","臺銀",0,4,-4
"1497","1540喬福","110/07/28","臺銀-民權",5,0,5
"1498","1540喬福","110/07/28","台新證券",0,3,-3
"1499","1540喬福","110/07/28","元富-中原",5,0,5
"1500","1540喬福","110/07/28","台新-高雄",0,3,-3
"1501","2888新光金","110/07/28","臺銀-高雄",3050,3,3047
"1502","2888新光金","110/07/28","摩根大通",2543,11316,-8773
"1503","2888新光金","110/07/28","元富-城東",2019,129,1890
"1504","2888新光金","110/07/28","香港上海匯豐",120,7576,-7456
"1505","2888新光金","110/07/28","元大證券",2106,407,1699
"1506","2888新光金","110/07/28","凱基-台北",1641,5238,-3597
"1507","2888新光金","110/07/28","凱基-台南",1068,33,1035
"1508","2888新光金","110/07/28","新加坡商瑞銀",0,3572,-3572
"1509","2888新光金","110/07/28","彰銀-台中",1098,75,1023
"1510","2888新光金","110/07/28","台灣摩根士丹利",4358,7129,-2771
"1511","2888新光金","110/07/28","元富-城中",1003,0,1003
"1512","2888新光金","110/07/28","元大-大統",103,2853,-2750
"1513","2888新光金","110/07/28","元大-大天母",1113,119,994
"1514","2888新光金","110/07/28","光和",204,2235,-2031
"1515","2888新光金","110/07/28","元大-仁愛",761,1,760
"1516","2888新光金","110/07/28","兆豐-鹿港",80,1755,-1675
"1517","2888新光金","110/07/28","日盛-雙和",927,179,748
"1518","2888新光金","110/07/28","凱基-市政",17,1447,-1430
"1519","2888新光金","110/07/28","元大-大里",648,0,648
"1520","2888新光金","110/07/28","華南永昌-敦南",66,1320,-1254
"1521","2888新光金","110/07/28","凱基-竹科",2665,2026,639
"1522","2888新光金","110/07/28","法銀巴黎",195,1423,-1228
"1523","2888新光金","110/07/28","日盛-高雄",619,11,608
"1524","2888新光金","110/07/28","臺銀",123,1343,-1220
"1525","2888新光金","110/07/28","群益金鼎-海山",710,151,559
"1526","2888新光金","110/07/28","花旗環球",0,865,-865
"1527","2888新光金","110/07/28","台新證券",855,305,550
"1528","2888新光金","110/07/28","元大-鹿港",46,848,-802
"1529","2888新光金","110/07/28","國泰-敦南",774,237,537
"1530","2888新光金","110/07/28","合庫-台中",121,800,-679
"1531","1340勝悅","110/07/28","新光-台南",50,0,50
"1532","1340勝悅","110/07/28","兆豐-南京",0,25,-25
"1533","1340勝悅","110/07/28","臺銀-臺中",6,0,6
"1534","1340勝悅","110/07/28","凱基-台北",0,22,-22
"1535","1340勝悅","110/07/28","新光",6,0,6
"1536","1340勝悅","110/07/28","美林",0,12,-12
"1537","1340勝悅","110/07/28","臺灣企銀-埔墘",5,0,5
"1538","1340勝悅","110/07/28","群益金鼎-台中",0,11,-11
"1539","1340勝悅","110/07/28","國票-敦北法人",5,0,5
"1540","1340勝悅","110/07/28","合庫-西台中",1,10,-9
"1541","1340勝悅","110/07/28","國泰-高雄",5,0,5
"1542","1340勝悅","110/07/28","元大-基隆孝二",0,8,-8
"1543","1340勝悅","110/07/28","國泰-台中",5,0,5
"1544","1340勝悅","110/07/28","統一-城中",0,7,-7
"1545","1340勝悅","110/07/28","群益金鼎-館前",5,0,5
"1546","1340勝悅","110/07/28","凱基-幸福",0,7,-7
"1547","1340勝悅","110/07/28","中國信託-文心",3,0,3
"1548","1340勝悅","110/07/28","臺銀-新竹",0,5,-5
"1549","1340勝悅","110/07/28","群益金鼎-崇德",3,0,3
"1550","1340勝悅","110/07/28","港商法國興業",0,5,-5
"1551","1340勝悅","110/07/28","元大-永春",3,0,3
"1552","1340勝悅","110/07/28","元大-新竹經國",0,5,-5
"1553","1340勝悅","110/07/28","永豐金-松山",3,0,3
"1554","1340勝悅","110/07/28","台新證券",0,4,-4
"1555","1340勝悅","110/07/28","永豐金-嘉義",3,0,3
"1556","1340勝悅","110/07/28","港商野村",0,3,-3
"1557","1340勝悅","110/07/28","日盛-木柵",2,0,2
"1558","1340勝悅","110/07/28","摩根大通",0,3,-3
"1559","1340勝悅","110/07/28","台新-台中",2,0,2
"1560","1340勝悅","110/07/28","富邦-台北",0,3,-3
"1561","6246臺龍","110/07/28","元大-基隆孝二",32,0,32
"1562","6246臺龍","110/07/28","永豐金-桃園",4,135,-131
"1563","6246臺龍","110/07/28","合庫-台中",30,0,30
"1564","6246臺龍","110/07/28","港商野村",5,93,-88
"1565","6246臺龍","110/07/28","元大-木柵",30,0,30
"1566","6246臺龍","110/07/28","凱基-台北",9,65,-56
"1567","6246臺龍","110/07/28","光和",21,0,21
"1568","6246臺龍","110/07/28","元大-西螺",0,31,-31
"1569","6246臺龍","110/07/28","宏遠-民生",20,0,20
"1570","6246臺龍","110/07/28","群益金鼎-鳳山",0,27,-27
"1571","6246臺龍","110/07/28","第一金-安和",20,0,20
"1572","6246臺龍","110/07/28","元大-西屯",0,25,-25
"1573","6246臺龍","110/07/28","兆豐-竹北",24,4,20
"1574","6246臺龍","110/07/28","永豐金-虎尾",6,27,-21
"1575","6246臺龍","110/07/28","凱基-幸福",20,0,20
"1576","6246臺龍","110/07/28","日盛-台中",1,20,-19
"1577","6246臺龍","110/07/28","德信-新營",19,0,19
"1578","6246臺龍","110/07/28","統一",0,16,-16
"1579","6246臺龍","110/07/28","台新證券",21,4,17
"1580","6246臺龍","110/07/28","群益金鼎-土城",0,16,-16
"1581","6246臺龍","110/07/28","華南永昌-公誠",17,0,17
"1582","6246臺龍","110/07/28","元大-員林",0,15,-15
"1583","6246臺龍","110/07/28","中國信託-文心",15,0,15
"1584","6246臺龍","110/07/28","華南永昌-長虹",0,11,-11
"1585","6246臺龍","110/07/28","群益金鼎-崇德",15,0,15
"1586","6246臺龍","110/07/28","日盛-中壢",0,10,-10
"1587","6246臺龍","110/07/28","兆豐-公益",12,0,12
"1588","6246臺龍","110/07/28","第一金-彰化",0,10,-10
"1589","6246臺龍","110/07/28","國票",12,0,12
"1590","6246臺龍","110/07/28","元富-中原",0,10,-10
"1591","00715L期街口布蘭特正2","110/07/28","永豐金證券",5725,30,5695
"1592","00715L期街口布蘭特正2","110/07/28","元大-四維",0,2013,-2013
"1593","00715L期街口布蘭特正2","110/07/28","元大證券",5235,705,4530
"1594","00715L期街口布蘭特正2","110/07/28","凱基-豐中",0,1536,-1536
"1595","00715L期街口布蘭特正2","110/07/28","國票",2733,11,2722
"1596","00715L期街口布蘭特正2","110/07/28","華南永昌-東昇",0,1010,-1010
"1597","00715L期街口布蘭特正2","110/07/28","富邦證券",2340,417,1923
"1598","00715L期街口布蘭特正2","110/07/28","兆豐-三民",0,1004,-1004
"1599","00715L期街口布蘭特正2","110/07/28","凱基-台北",2241,325,1916
"1600","00715L期街口布蘭特正2","110/07/28","元富-古亭",0,600,-600
"1601","00715L期街口布蘭特正2","110/07/28","統一",1635,132,1503
"1602","00715L期街口布蘭特正2","110/07/28","台新-新營",20,558,-538
"1603","00715L期街口布蘭特正2","110/07/28","國票-中港",1500,0,1500
"1604","00715L期街口布蘭特正2","110/07/28","富邦-台北",0,453,-453
"1605","00715L期街口布蘭特正2","110/07/28","兆豐-台中",525,6,519
"1606","00715L期街口布蘭特正2","110/07/28","港商野村",71,519,-448
"1607","00715L期街口布蘭特正2","110/07/28","合庫證券",1008,500,508
"1608","00715L期街口布蘭特正2","110/07/28","第一金-自由",10,405,-395
"1609","00715L期街口布蘭特正2","110/07/28","永豐金-三重",500,0,500
"1610","00715L期街口布蘭特正2","110/07/28","玉山-高雄",17,387,-370
"1611","00715L期街口布蘭特正2","110/07/28","凱基-市政",500,1,499
"1612","00715L期街口布蘭特正2","110/07/28","統一-桃園",0,331,-331
"1613","00715L期街口布蘭特正2","110/07/28","元富-大裕",500,8,492
"1614","00715L期街口布蘭特正2","110/07/28","元富-中壢",0,309,-309
"1615","00715L期街口布蘭特正2","110/07/28","永豐金-內湖",503,18,485
"1616","00715L期街口布蘭特正2","110/07/28","台新證券",21,329,-308
"1617","00715L期街口布蘭特正2","110/07/28","元富-吉利",280,0,280
"1618","00715L期街口布蘭特正2","110/07/28","國票-台中",0,275,-275
"1619","00715L期街口布蘭特正2","110/07/28","國票-博愛",200,0,200
"1620","00715L期街口布蘭特正2","110/07/28","日盛-木柵",0,268,-268
"1621","8941關中","110/07/28","第一金-台南",2,0,2
"1622","8941關中","110/07/28","聯邦-富強",0,3,-3
"1623","8941關中","110/07/28","元大-西屯",2,0,2
"1624","8941關中","110/07/28","富邦-員林",0,3,-3
"1625","8941關中","110/07/28","玉山證券",1,0,1
"1626","8941關中","110/07/28","第一金-安和",0,2,-2
"1627","8941關中","110/07/28","國泰-忠孝",1,0,1
"1628","8941關中","110/07/28","第一金-台中",0,1,-1
"1629","8941關中","110/07/28","凱基-岡山",1,0,1
"1630","8941關中","110/07/28","玉山-台中",0,0,0
"1631","8941關中","110/07/28","富邦-羅東",1,0,1
"1632","8941關中","110/07/28","元大-新竹經國",0,0,0
"1633","8941關中","110/07/28","永豐金-敦南",1,0,1
"1634","8941關中","110/07/28","元大-桃興",1,1,0
"1635","8941關中","110/07/28","玉山-台中",0,0,0
"1636","8941關中","110/07/28","",NA,NA,NA
"1637","8941關中","110/07/28","元大-新竹經國",0,0,0
"1638","8941關中","110/07/28","",NA,NA,NA
"1639","8941關中","110/07/28","元大-桃興",1,1,0
"1640","8941關中","110/07/28","",NA,NA,NA
"1641","8941關中","110/07/28","",NA,NA,NA
"1642","8941關中","110/07/28","",NA,NA,NA
"1643","8941關中","110/07/28","",NA,NA,NA
"1644","8941關中","110/07/28","",NA,NA,NA
"1645","8941關中","110/07/28","",NA,NA,NA
"1646","8941關中","110/07/28","",NA,NA,NA
"1647","8941關中","110/07/28","",NA,NA,NA
"1648","8941關中","110/07/28","",NA,NA,NA
"1649","8941關中","110/07/28","",NA,NA,NA
"1650","8941關中","110/07/28","",NA,NA,NA
"1651","8936國統","110/07/28","宏遠-高雄",141,1,140
"1652","8936國統","110/07/28","摩根大通",82,517,-435
"1653","8936國統","110/07/28","日盛-景美",100,0,100
"1654","8936國統","110/07/28","凱基-台北",5,290,-285
"1655","8936國統","110/07/28","永豐金-苓雅",67,0,67
"1656","8936國統","110/07/28","瑞士信貸",0,245,-245
"1657","8936國統","110/07/28","玉山-台南",64,0,64
"1658","8936國統","110/07/28","台灣摩根士丹利",16,176,-160
"1659","8936國統","110/07/28","國票-北高雄",61,1,60
"1660","8936國統","110/07/28","凱基-市政",11,110,-99
"1661","8936國統","110/07/28","玉山-高雄",49,0,49
"1662","8936國統","110/07/28","元大-東蘆",0,82,-82
"1663","8936國統","110/07/28","元大-小港",47,0,47
"1664","8936國統","110/07/28","新加坡商瑞銀",128,205,-77
"1665","8936國統","110/07/28","元大-台中",40,0,40
"1666","8936國統","110/07/28","元大-歸仁",30,75,-45
"1667","8936國統","110/07/28","新光-台中",41,7,34
"1668","8936國統","110/07/28","台新-台中",17,55,-38
"1669","8936國統","110/07/28","元大-豐原站前",32,0,32
"1670","8936國統","110/07/28","康和",20,58,-38
"1671","8936國統","110/07/28","玉山-台中",31,0,31
"1672","8936國統","110/07/28","第一金-新興",0,31,-31
"1673","8936國統","110/07/28","富邦-高雄",26,0,26
"1674","8936國統","110/07/28","元富-松德",0,30,-30
"1675","8936國統","110/07/28","元大-鳳中",30,5,25
"1676","8936國統","110/07/28","元大-中和",2,30,-28
"1677","8936國統","110/07/28","元富-林園",20,0,20
"1678","8936國統","110/07/28","兆豐-嘉義",0,22,-22
"1679","8936國統","110/07/28","兆豐-北高雄",20,0,20
"1680","8936國統","110/07/28","美林",11,32,-21
"1681","6226光鼎","110/07/28","群益金鼎-萬華",147,14,133
"1682","6226光鼎","110/07/28","群益金鼎-敦南",5,282,-277
"1683","6226光鼎","110/07/28","台新-台中",227,114,113
"1684","6226光鼎","110/07/28","華南永昌",19,142,-123
"1685","6226光鼎","110/07/28","摩根大通",109,0,109
"1686","6226光鼎","110/07/28","康和-台北",0,100,-100
"1687","6226光鼎","110/07/28","統一",107,0,107
"1688","6226光鼎","110/07/28","臺銀-民權",4,100,-96
"1689","6226光鼎","110/07/28","凱基-台北",103,1,102
"1690","6226光鼎","110/07/28","元大-潮州",11,102,-91
"1691","6226光鼎","110/07/28","台灣摩根士丹利",104,7,97
"1692","6226光鼎","110/07/28","華南永昌-嘉義",50,130,-80
"1693","6226光鼎","110/07/28","群益金鼎-館前",97,0,97
"1694","6226光鼎","110/07/28","台新證券",79,153,-74
"1695","6226光鼎","110/07/28","國泰-台中",97,20,77
"1696","6226光鼎","110/07/28","玉山-台南",4,74,-70
"1697","6226光鼎","110/07/28","元大-嘉義",83,16,67
"1698","6226光鼎","110/07/28","臺銀-臺中",6,65,-59
"1699","6226光鼎","110/07/28","新光-桃園",69,8,61
"1700","6226光鼎","110/07/28","富邦-仁愛",6,63,-57
"1701","6226光鼎","110/07/28","群益金鼎-三重",59,2,57
"1702","6226光鼎","110/07/28","凱基-大里",0,51,-51
"1703","6226光鼎","110/07/28","日盛-員林",63,12,51
"1704","6226光鼎","110/07/28","國泰-敦南",116,166,-50
"1705","6226光鼎","110/07/28","永豐金-松山",66,20,46
"1706","6226光鼎","110/07/28","元富-中港",2,51,-49
"1707","6226光鼎","110/07/28","統一-內湖",48,7,41
"1708","6226光鼎","110/07/28","群益金鼎-延平",0,49,-49
"1709","6226光鼎","110/07/28","凱基-高美館",51,10,41
"1710","6226光鼎","110/07/28","元大-新竹經國",5,53,-48
"1711","2363矽統","110/07/28","摩根大通",809,282,527
"1712","2363矽統","110/07/28","國泰-敦南",145,861,-716
"1713","2363矽統","110/07/28","美商高盛",532,264,268
"1714","2363矽統","110/07/28","元大-台中",18,384,-366
"1715","2363矽統","110/07/28","台新-三民",263,18,245
"1716","2363矽統","110/07/28","新光",197,525,-328
"1717","2363矽統","110/07/28","台新證券",929,703,226
"1718","2363矽統","110/07/28","群益金鼎-三民",24,266,-242
"1719","2363矽統","110/07/28","第一金-嘉義",154,0,154
"1720","2363矽統","110/07/28","凱基-斗六",0,187,-187
"1721","2363矽統","110/07/28","凱基-台北",1039,889,150
"1722","2363矽統","110/07/28","元大-上新莊",3,134,-131
"1723","2363矽統","110/07/28","永豐金-竹科",132,11,121
"1724","2363矽統","110/07/28","永豐金-彰化",5,134,-129
"1725","2363矽統","110/07/28","華南永昌-鳳山",146,34,112
"1726","2363矽統","110/07/28","日盛-二林",15,142,-127
"1727","2363矽統","110/07/28","第一金-新興",108,1,107
"1728","2363矽統","110/07/28","元大證券",18,125,-107
"1729","2363矽統","110/07/28","港商野村",673,568,105
"1730","2363矽統","110/07/28","新光-台南",25,129,-104
"1731","2363矽統","110/07/28","群益金鼎-桃園",111,11,100
"1732","2363矽統","110/07/28","統一",7,109,-102
"1733","2363矽統","110/07/28","台新-左楠",94,15,79
"1734","2363矽統","110/07/28","康和-南崁",11,108,-97
"1735","2363矽統","110/07/28","新加坡商瑞銀",789,711,78
"1736","2363矽統","110/07/28","國票",25,121,-96
"1737","2363矽統","110/07/28","國票-九鼎",99,26,73
"1738","2363矽統","110/07/28","群益金鼎-敦南",11,107,-96
"1739","2363矽統","110/07/28","兆豐-埔墘",62,0,62
"1740","2363矽統","110/07/28","兆豐-寶成",2,79,-77
"1741","8112至上","110/07/28","摩根大通",630,183,447
"1742","8112至上","110/07/28","永豐金-永康",0,242,-242
"1743","8112至上","110/07/28","合庫證券",317,21,296
"1744","8112至上","110/07/28","高橋",3,222,-219
"1745","8112至上","110/07/28","新加坡商瑞銀",417,132,285
"1746","8112至上","110/07/28","玉山證券",2,206,-204
"1747","8112至上","110/07/28","台灣摩根士丹利",253,58,195
"1748","8112至上","110/07/28","新光",50,206,-156
"1749","8112至上","110/07/28","港商野村",350,164,186
"1750","8112至上","110/07/28","永豐金-苓雅",2,102,-100
"1751","8112至上","110/07/28","美商高盛",184,7,177
"1752","8112至上","110/07/28","凱基-永和",0,80,-80
"1753","8112至上","110/07/28","美林",213,53,160
"1754","8112至上","110/07/28","華南永昌-新莊",60,134,-74
"1755","8112至上","110/07/28","花旗環球",86,16,70
"1756","8112至上","110/07/28","台新-松江",27,90,-63
"1757","8112至上","110/07/28","玉山-板橋",82,17,65
"1758","8112至上","110/07/28","宏遠證券",1,50,-49
"1759","8112至上","110/07/28","凱基-竹科",67,3,64
"1760","8112至上","110/07/28","元大-苑裡",23,72,-49
"1761","8112至上","110/07/28","元大-府城",56,0,56
"1762","8112至上","110/07/28","元大-基隆孝二",5,53,-48
"1763","8112至上","110/07/28","永豐金-內湖",37,0,37
"1764","8112至上","110/07/28","康和-仁愛",5,51,-46
"1765","8112至上","110/07/28","瑞士信貸",58,26,32
"1766","8112至上","110/07/28","台新證券",31,73,-42
"1767","8112至上","110/07/28","元大證券",60,29,31
"1768","8112至上","110/07/28","兆豐-公益",0,40,-40
"1769","8112至上","110/07/28","元富-新店",35,5,30
"1770","8112至上","110/07/28","中國信託-忠孝",1,37,-36
"1771","1570力肯","110/07/28","國泰-敦南",50,0,50
"1772","1570力肯","110/07/28","元大-高雄",0,42,-42
"1773","1570力肯","110/07/28","群益金鼎-高雄",31,0,31
"1774","1570力肯","110/07/28","國票-新莊",0,14,-14
"1775","1570力肯","110/07/28","元富-延平",15,0,15
"1776","1570力肯","110/07/28","凱基-站前",0,10,-10
"1777","1570力肯","110/07/28","(牛牛牛)亞-鑫豐",10,0,10
"1778","1570力肯","110/07/28","凱基-台北",0,10,-10
"1779","1570力肯","110/07/28","元富-緯城",6,0,6
"1780","1570力肯","110/07/28","元大-忠孝",0,10,-10
"1781","1570力肯","110/07/28","合庫-自強",5,0,5
"1782","1570力肯","110/07/28","台灣摩根士丹利",0,9,-9
"1783","1570力肯","110/07/28","臺銀-臺南",4,0,4
"1784","1570力肯","110/07/28","群益金鼎-板橋",0,8,-8
"1785","1570力肯","110/07/28","兆豐-台中港",3,0,3
"1786","1570力肯","110/07/28","永豐金-大園",0,7,-7
"1787","1570力肯","110/07/28","日盛-板橋",2,0,2
"1788","1570力肯","110/07/28","元大-台南",0,5,-5
"1789","1570力肯","110/07/28","統一-松江",2,0,2
"1790","1570力肯","110/07/28","合庫-台中",0,4,-4
"1791","1570力肯","110/07/28","台新-三民",2,0,2
"1792","1570力肯","110/07/28","富邦-板橋",0,3,-3
"1793","1570力肯","110/07/28","群益金鼎-土城",2,0,2
"1794","1570力肯","110/07/28","元大-板橋",0,3,-3
"1795","1570力肯","110/07/28","元大-和平",2,0,2
"1796","1570力肯","110/07/28","統一-桃園",0,2,-2
"1797","1570力肯","110/07/28","元大-土城永寧",2,0,2
"1798","1570力肯","110/07/28","凱基-三多",0,2,-2
"1799","1570力肯","110/07/28","大昌-樹林",1,0,1
"1800","1570力肯","110/07/28","華南永昌-高雄",0,2,-2
"1801","2929淘帝","110/07/28","日盛-八德",40,0,40
"1802","2929淘帝","110/07/28","凱基-林口",0,150,-150
"1803","2929淘帝","110/07/28","玉山-新竹",30,0,30
"1804","2929淘帝","110/07/28","日盛-台中",0,35,-35
"1805","2929淘帝","110/07/28","國泰-松江",33,3,30
"1806","2929淘帝","110/07/28","永豐金-永康",0,21,-21
"1807","2929淘帝","110/07/28","元大-民生",28,0,28
"1808","2929淘帝","110/07/28","新加坡商瑞銀",13,32,-19
"1809","2929淘帝","110/07/28","合庫-高雄",21,0,21
"1810","2929淘帝","110/07/28","國泰-敦南",2,20,-18
"1811","2929淘帝","110/07/28","華南永昌",20,0,20
"1812","2929淘帝","110/07/28","臺銀",2,17,-15
"1813","2929淘帝","110/07/28","台新證券",12,0,12
"1814","2929淘帝","110/07/28","群益金鼎-敦南",0,13,-13
"1815","2929淘帝","110/07/28","第一金-大稻埕",10,0,10
"1816","2929淘帝","110/07/28","富邦-建國",1,13,-12
"1817","2929淘帝","110/07/28","華南永昌-台中",10,0,10
"1818","2929淘帝","110/07/28","元富-城東",0,10,-10
"1819","2929淘帝","110/07/28","元大-士林",10,0,10
"1820","2929淘帝","110/07/28","兆豐-景美",0,8,-8
"1821","2929淘帝","110/07/28","元大-屏南",10,0,10
"1822","2929淘帝","110/07/28","美林",3,10,-7
"1823","2929淘帝","110/07/28","元大-員林",10,0,10
"1824","2929淘帝","110/07/28","元富-彰化",0,7,-7
"1825","2929淘帝","110/07/28","新光-桃園",9,0,9
"1826","2929淘帝","110/07/28","港商法國興業",0,6,-6
"1827","2929淘帝","110/07/28","日盛-景美",7,0,7
"1828","2929淘帝","110/07/28","新光-高雄",0,6,-6
"1829","2929淘帝","110/07/28","玉山證券",7,0,7
"1830","2929淘帝","110/07/28","港商野村",3,8,-5
"1831","5410國眾","110/07/28","兆豐-城中",38,0,38
"1832","5410國眾","110/07/28","兆豐-南門",3,80,-77
"1833","5410國眾","110/07/28","大展",20,0,20
"1834","5410國眾","110/07/28","摩根大通",12,56,-44
"1835","5410國眾","110/07/28","新光-桃園",20,0,20
"1836","5410國眾","110/07/28","凱基-台北",0,28,-28
"1837","5410國眾","110/07/28","凱基-竹北",20,0,20
"1838","5410國眾","110/07/28","亞東-板橋",0,20,-20
"1839","5410國眾","110/07/28","元大-新莊",17,0,17
"1840","5410國眾","110/07/28","統一-新台中",0,20,-20
"1841","5410國眾","110/07/28","新光",20,8,12
"1842","5410國眾","110/07/28","瑞士信貸",0,16,-16
"1843","5410國眾","110/07/28","國泰-敦南",11,0,11
"1844","5410國眾","110/07/28","新加坡商瑞銀",0,15,-15
"1845","5410國眾","110/07/28","日盛-內湖",10,0,10
"1846","5410國眾","110/07/28","統一-金門",0,15,-15
"1847","5410國眾","110/07/28","元富-新竹",10,0,10
"1848","5410國眾","110/07/28","元大-北投",0,12,-12
"1849","5410國眾","110/07/28","群益金鼎-永和",10,0,10
"1850","5410國眾","110/07/28","新百王",0,10,-10
"1851","5410國眾","110/07/28","華南永昌-中正",10,0,10
"1852","5410國眾","110/07/28","元大-館前",0,10,-10
"1853","5410國眾","110/07/28","元大-旗山",10,0,10
"1854","5410國眾","110/07/28","元富-安南",0,9,-9
"1855","5410國眾","110/07/28","元大-大天母",10,0,10
"1856","5410國眾","110/07/28","元大-龍潭",1,10,-9
"1857","5410國眾","110/07/28","大昌",9,0,9
"1858","5410國眾","110/07/28","港商野村",1,7,-6
"1859","5410國眾","110/07/28","臺銀-鳳山",8,0,8
"1860","5410國眾","110/07/28","元大-東泰",0,6,-6
"1861","2841台開","110/07/28","台新-台中",36,0,36
"1862","2841台開","110/07/28","元大-大雅",0,90,-90
"1863","2841台開","110/07/28","群益金鼎-大甲",24,0,24
"1864","2841台開","110/07/28","凱基-台北",0,73,-73
"1865","2841台開","110/07/28","永豐金-敦南",29,8,21
"1866","2841台開","110/07/28","港商野村",0,27,-27
"1867","2841台開","110/07/28","第一金-台中",20,0,20
"1868","2841台開","110/07/28","大慶-富順",0,20,-20
"1869","2841台開","110/07/28","元富-烏日",20,0,20
"1870","2841台開","110/07/28","豐農",0,17,-17
"1871","2841台開","110/07/28","元大-歸仁",20,0,20
"1872","2841台開","110/07/28","元大-大里德芳",0,15,-15
"1873","2841台開","110/07/28","永豐金-豐原",20,0,20
"1874","2841台開","110/07/28","日盛-大墩",0,10,-10
"1875","2841台開","110/07/28","日盛-花蓮",15,0,15
"1876","2841台開","110/07/28","元大-博愛",0,10,-10
"1877","2841台開","110/07/28","大昌-安康",18,3,15
"1878","2841台開","110/07/28","元大-豐原站前",0,10,-10
"1879","2841台開","110/07/28","陽信-石牌",13,0,13
"1880","2841台開","110/07/28","台新證券",6,13,-7
"1881","2841台開","110/07/28","台灣摩根士丹利",10,0,10
"1882","2841台開","110/07/28","台中銀",0,5,-5
"1883","2841台開","110/07/28","台新-高雄",10,0,10
"1884","2841台開","110/07/28","中國信託-中壢",0,5,-5
"1885","2841台開","110/07/28","國泰-忠孝",10,0,10
"1886","2841台開","110/07/28","元大-大同",0,5,-5
"1887","2841台開","110/07/28","元大-竹南",10,0,10
"1888","2841台開","110/07/28","元大-大益",0,4,-4
"1889","2841台開","110/07/28","元大-屏南",9,0,9
"1890","2841台開","110/07/28","元富-松德",0,3,-3
"1891","6207雷科","110/07/28","新加坡商瑞銀",153,44,109
"1892","6207雷科","110/07/28","康和-延平",0,48,-48
"1893","6207雷科","110/07/28","摩根大通",219,131,88
"1894","6207雷科","110/07/28","元富-大昌",0,33,-33
"1895","6207雷科","110/07/28","康和-台中",70,0,70
"1896","6207雷科","110/07/28","聯邦商銀",0,30,-30
"1897","6207雷科","110/07/28","凱基-台北",112,49,63
"1898","6207雷科","110/07/28","兆豐-三民",1,30,-29
"1899","6207雷科","110/07/28","凱基-復興",63,3,60
"1900","6207雷科","110/07/28","元大-龍潭",0,25,-25
"1901","6207雷科","110/07/28","群益金鼎-三民",59,8,51
"1902","6207雷科","110/07/28","宏遠證券",0,23,-23
"1903","6207雷科","110/07/28","永豐金-羅東",50,0,50
"1904","6207雷科","110/07/28","大昌-桃園",15,36,-21
"1905","6207雷科","110/07/28","美林",46,3,43
"1906","6207雷科","110/07/28","國泰-桃園",0,21,-21
"1907","6207雷科","110/07/28","群益金鼎-敦南",51,16,35
"1908","6207雷科","110/07/28","凱基-中壢",0,21,-21
"1909","6207雷科","110/07/28","日盛-忠孝",31,0,31
"1910","6207雷科","110/07/28","富邦-台北",4,24,-20
"1911","6207雷科","110/07/28","港商野村",32,8,24
"1912","6207雷科","110/07/28","臺銀-臺南",0,19,-19
"1913","6207雷科","110/07/28","群益金鼎-東門",22,0,22
"1914","6207雷科","110/07/28","新光",5,24,-19
"1915","6207雷科","110/07/28","統一-高雄",41,20,21
"1916","6207雷科","110/07/28","群益金鼎-大甲",1,20,-19
"1917","6207雷科","110/07/28","群益金鼎-延平",21,0,21
"1918","6207雷科","110/07/28","元大-中壢",10,28,-18
"1919","6207雷科","110/07/28","彰銀-台中",20,0,20
"1920","6207雷科","110/07/28","永豐金-北高雄",3,20,-17
"1921","3679新至陞","110/07/28","華南永昌-淡水",10,0,10
"1922","3679新至陞","110/07/28","瑞士信貸",0,25,-25
"1923","3679新至陞","110/07/28","富邦-嘉義",10,0,10
"1924","3679新至陞","110/07/28","凱基-台北",6,14,-8
"1925","3679新至陞","110/07/28","台中銀-員林",11,2,9
"1926","3679新至陞","110/07/28","美林",5,12,-7
"1927","3679新至陞","110/07/28","大昌-樹林",7,0,7
"1928","3679新至陞","110/07/28","摩根大通",5,11,-6
"1929","3679新至陞","110/07/28","康和-澎湖",5,0,5
"1930","3679新至陞","110/07/28","兆豐-新莊",0,5,-5
"1931","3679新至陞","110/07/28","富邦-台北",5,0,5
"1932","3679新至陞","110/07/28","群益金鼎-新莊",0,5,-5
"1933","3679新至陞","110/07/28","元大-成功",5,0,5
"1934","3679新至陞","110/07/28","台灣摩根士丹利",0,4,-4
"1935","3679新至陞","110/07/28","新加坡商瑞銀",3,0,3
"1936","3679新至陞","110/07/28","日盛-新竹",0,3,-3
"1937","3679新至陞","110/07/28","中國信託-新竹",3,0,3
"1938","3679新至陞","110/07/28","群益金鼎-東門",0,3,-3
"1939","3679新至陞","110/07/28","元大-新莊",3,0,3
"1940","3679新至陞","110/07/28","元大證券",0,3,-3
"1941","3679新至陞","110/07/28","宏遠-光隆",2,0,2
"1942","3679新至陞","110/07/28","元大-忠孝",0,3,-3
"1943","3679新至陞","110/07/28","大慶-蘆洲",2,0,2
"1944","3679新至陞","110/07/28","合庫-西台中",0,2,-2
"1945","3679新至陞","110/07/28","台新-左楠",2,0,2
"1946","3679新至陞","110/07/28","日盛-板橋",0,2,-2
"1947","3679新至陞","110/07/28","群益金鼎-三重",2,0,2
"1948","3679新至陞","110/07/28","國票-桃園",0,2,-2
"1949","3679新至陞","110/07/28","華南永昌-高雄",2,0,2
"1950","3679新至陞","110/07/28","台新-台南",0,2,-2
"1951","2727王品","110/07/28","凱基-台北",139,50,89
"1952","2727王品","110/07/28","新光-台中",9,68,-59
"1953","2727王品","110/07/28","美林",77,10,67
"1954","2727王品","110/07/28","瑞士信貸",16,54,-38
"1955","2727王品","110/07/28","港商野村",118,64,54
"1956","2727王品","110/07/28","華南永昌",4,41,-37
"1957","2727王品","110/07/28","國泰-敦南",51,30,21
"1958","2727王品","110/07/28","美商高盛",2,30,-28
"1959","2727王品","110/07/28","新加坡商瑞銀",58,38,20
"1960","2727王品","110/07/28","富邦-板橋",17,38,-21
"1961","2727王品","110/07/28","永豐金-中盛",24,4,20
"1962","2727王品","110/07/28","富邦-竹北",0,20,-20
"1963","2727王品","110/07/28","元大-南崁",20,2,18
"1964","2727王品","110/07/28","元大-小港",1,21,-20
"1965","2727王品","110/07/28","摩根大通",48,32,16
"1966","2727王品","110/07/28","凱基",0,18,-18
"1967","2727王品","110/07/28","臺銀-高雄",14,0,14
"1968","2727王品","110/07/28","統一",15,31,-16
"1969","2727王品","110/07/28","永豐金-桃盛",19,5,14
"1970","2727王品","110/07/28","國泰-台中",12,28,-16
"1971","2727王品","110/07/28","凱基-內湖",13,0,13
"1972","2727王品","110/07/28","元大-台中",7,22,-15
"1973","2727王品","110/07/28","永豐金-中正",15,2,13
"1974","2727王品","110/07/28","華南永昌-麻豆",0,14,-14
"1975","2727王品","110/07/28","富邦-建國",18,7,11
"1976","2727王品","110/07/28","永豐金-豐原",1,15,-14
"1977","2727王品","110/07/28","富邦-陽明",15,5,10
"1978","2727王品","110/07/28","國票-內壢",1,14,-13
"1979","2727王品","110/07/28","元大-南京",10,0,10
"1980","2727王品","110/07/28","永豐金證券",2,15,-13
"1981","1570力肯","110/07/28","國泰-敦南",50,0,50
"1982","1570力肯","110/07/28","元大-高雄",0,42,-42
"1983","1570力肯","110/07/28","群益金鼎-高雄",31,0,31
"1984","1570力肯","110/07/28","國票-新莊",0,14,-14
"1985","1570力肯","110/07/28","元富-延平",15,0,15
"1986","1570力肯","110/07/28","凱基-站前",0,10,-10
"1987","1570力肯","110/07/28","(牛牛牛)亞-鑫豐",10,0,10
"1988","1570力肯","110/07/28","凱基-台北",0,10,-10
"1989","1570力肯","110/07/28","元富-緯城",6,0,6
"1990","1570力肯","110/07/28","元大-忠孝",0,10,-10
"1991","1570力肯","110/07/28","合庫-自強",5,0,5
"1992","1570力肯","110/07/28","台灣摩根士丹利",0,9,-9
"1993","1570力肯","110/07/28","臺銀-臺南",4,0,4
"1994","1570力肯","110/07/28","群益金鼎-板橋",0,8,-8
"1995","1570力肯","110/07/28","兆豐-台中港",3,0,3
"1996","1570力肯","110/07/28","永豐金-大園",0,7,-7
"1997","1570力肯","110/07/28","日盛-板橋",2,0,2
"1998","1570力肯","110/07/28","元大-台南",0,5,-5
"1999","1570力肯","110/07/28","統一-松江",2,0,2
"2000","1570力肯","110/07/28","合庫-台中",0,4,-4
"2001","1570力肯","110/07/28","台新-三民",2,0,2
"2002","1570力肯","110/07/28","富邦-板橋",0,3,-3
"2003","1570力肯","110/07/28","群益金鼎-土城",2,0,2
"2004","1570力肯","110/07/28","元大-板橋",0,3,-3
"2005","1570力肯","110/07/28","元大-和平",2,0,2
"2006","1570力肯","110/07/28","統一-桃園",0,2,-2
"2007","1570力肯","110/07/28","元大-土城永寧",2,0,2
"2008","1570力肯","110/07/28","凱基-三多",0,2,-2
"2009","1570力肯","110/07/28","大昌-樹林",1,0,1
"2010","1570力肯","110/07/28","華南永昌-高雄",0,2,-2
"2011","6180橘子","110/07/28","凱基-台北",152,85,67
"2012","6180橘子","110/07/28","摩根大通",20,92,-72
"2013","6180橘子","110/07/28","新光",57,18,39
"2014","6180橘子","110/07/28","大慶-台中",0,33,-33
"2015","6180橘子","110/07/28","美商高盛",49,12,37
"2016","6180橘子","110/07/28","兆豐證券",0,25,-25
"2017","6180橘子","110/07/28","第一金-安和",20,0,20
"2018","6180橘子","110/07/28","元大-上新莊",0,22,-22
"2019","6180橘子","110/07/28","元富-桃園",20,0,20
"2020","6180橘子","110/07/28","新加坡商瑞銀",23,44,-21
"2021","6180橘子","110/07/28","第一金-員林",19,0,19
"2022","6180橘子","110/07/28","富邦-內湖",0,21,-21
"2023","6180橘子","110/07/28","富邦-嘉義",22,4,18
"2024","6180橘子","110/07/28","第一金-新興",0,20,-20
"2025","6180橘子","110/07/28","統一-嘉義",16,0,16
"2026","6180橘子","110/07/28","臺銀-臺南",5,22,-17
"2027","6180橘子","110/07/28","國票-九鼎",15,0,15
"2028","6180橘子","110/07/28","第一金-忠孝",0,10,-10
"2029","6180橘子","110/07/28","華南永昌-朴子",14,0,14
"2030","6180橘子","110/07/28","元富-屏東",0,10,-10
"2031","6180橘子","110/07/28","群益金鼎-台南",13,0,13
"2032","6180橘子","110/07/28","凱基-八德",1,11,-10
"2033","6180橘子","110/07/28","富邦-建國",13,1,12
"2034","6180橘子","110/07/28","元大-和平",1,11,-10
"2035","6180橘子","110/07/28","富邦-板橋",16,5,11
"2036","6180橘子","110/07/28","元大-台中中港",0,10,-10
"2037","6180橘子","110/07/28","元富-新店",10,0,10
"2038","6180橘子","110/07/28","元大-南屯",0,9,-9
"2039","6180橘子","110/07/28","元大-台南",10,0,10
"2040","6180橘子","110/07/28","永豐金-屏東",0,9,-9
"2041","2390云辰","110/07/28","摩根大通",1589,780,809
"2042","2390云辰","110/07/28","華南永昌-鳳山",34,290,-256
"2043","2390云辰","110/07/28","凱基-台北",457,300,157
"2044","2390云辰","110/07/28","凱基-基隆",0,224,-224
"2045","2390云辰","110/07/28","美林",330,206,124
"2046","2390云辰","110/07/28","元富-高雄",56,177,-121
"2047","2390云辰","110/07/28","元富-同大",159,35,124
"2048","2390云辰","110/07/28","元富-中港",1,100,-99
"2049","2390云辰","110/07/28","台灣摩根士丹利",193,71,122
"2050","2390云辰","110/07/28","兆豐-公益",4,100,-96
"2051","2390云辰","110/07/28","元大-前金",150,49,101
"2052","2390云辰","110/07/28","統一-新台中",180,274,-94
"2053","2390云辰","110/07/28","永豐金-鳳山",110,18,92
"2054","2390云辰","110/07/28","日盛-新莊",4,76,-72
"2055","2390云辰","110/07/28","元大-林園",99,11,88
"2056","2390云辰","110/07/28","永豐金-新店",0,57,-57
"2057","2390云辰","110/07/28","元大-信義",121,35,86
"2058","2390云辰","110/07/28","華南永昌-內壢",0,56,-56
"2059","2390云辰","110/07/28","美商高盛",206,123,83
"2060","2390云辰","110/07/28","第一金-豐原",9,63,-54
"2061","2390云辰","110/07/28","統一-城中",101,37,64
"2062","2390云辰","110/07/28","華南永昌-中正",13,67,-54
"2063","2390云辰","110/07/28","元大-竹山",75,20,55
"2064","2390云辰","110/07/28","元大-大益",7,59,-52
"2065","2390云辰","110/07/28","豐農",79,25,54
"2066","2390云辰","110/07/28","大慶",0,50,-50
"2067","2390云辰","110/07/28","新加坡商瑞銀",68,15,53
"2068","2390云辰","110/07/28","凱基-豐中",3,49,-46
"2069","2390云辰","110/07/28","統一-屏東",54,5,49
"2070","2390云辰","110/07/28","元大-彰化民生",7,51,-44
"2071","1471首利","110/07/27","永全-八德",50,0,50
"2072","1471首利","110/07/27","國票-九鼎",0,306,-306
"2073","1471首利","110/07/27","中國信託-松江",48,0,48
"2074","1471首利","110/07/27","兆豐-天母",1,115,-114
"2075","1471首利","110/07/27","富邦-嘉義",40,0,40
"2076","1471首利","110/07/27","美林",0,42,-42
"2077","1471首利","110/07/27","富邦-台南",33,0,33
"2078","1471首利","110/07/27","摩根大通",45,75,-30
"2079","1471首利","110/07/27","(牛牛牛)亞-鑫豐",32,0,32
"2080","1471首利","110/07/27","凱基-八德",0,30,-30
"2081","1471首利","110/07/27","台灣企銀-太平",25,0,25
"2082","1471首利","110/07/27","中國信託-高雄",0,25,-25
"2083","1471首利","110/07/27","群益金鼎-台中",23,0,23
"2084","1471首利","110/07/27","統一-新台中",0,24,-24
"2085","1471首利","110/07/27","元富-潮州",20,0,20
"2086","1471首利","110/07/27","聯邦-高雄",0,21,-21
"2087","1471首利","110/07/27","凱基-信義",20,0,20
"2088","1471首利","110/07/27","德信-中正",0,20,-20
"2089","1471首利","110/07/27","富邦-基隆",26,8,18
"2090","1471首利","110/07/27","元大-福營",3,20,-17
"2091","1471首利","110/07/27","日盛-高雄",17,0,17
"2092","1471首利","110/07/27","凱基-宜蘭",0,16,-16
"2093","1471首利","110/07/27","國泰-敦南",16,2,14
"2094","1471首利","110/07/27","凱基-天母",0,15,-15
"2095","1471首利","110/07/27","元大-大甲",13,0,13
"2096","1471首利","110/07/27","第一金-高雄",6,20,-14
"2097","1471首利","110/07/27","合庫-鳳山",12,0,12
"2098","1471首利","110/07/27","元大-中壢",0,13,-13
"2099","1471首利","110/07/27","日盛-大墩",12,0,12
"2100","1471首利","110/07/27","元富-安南",0,12,-12
"2101","2883開發金","110/07/27","元富",1762,67,1695
"2102","2883開發金","110/07/27","美林",0,11931,-11931
"2103","2883開發金","110/07/27","福邦證券",1450,0,1450
"2104","2883開發金","110/07/27","新加坡商瑞銀",1513,8370,-6857
"2105","2883開發金","110/07/27","凱基",1422,0,1422
"2106","2883開發金","110/07/27","凱基-台北",1081,5265,-4184
"2107","2883開發金","110/07/27","瑞士信貸",2044,731,1313
"2108","2883開發金","110/07/27","摩根大通",612,3392,-2780
"2109","2883開發金","110/07/27","台灣摩根士丹利",2112,921,1191
"2110","2883開發金","110/07/27","統一-仁愛",31,2002,-1971
"2111","2883開發金","110/07/27","新光",1474,461,1013
"2112","2883開發金","110/07/27","兆豐證券",192,1910,-1718
"2113","2883開發金","110/07/27","國票-長城",1003,20,983
"2114","2883開發金","110/07/27","(牛牛牛)亞-鑫豐",276,1815,-1539
"2115","2883開發金","110/07/27","台新證券",1207,362,845
"2116","2883開發金","110/07/27","永豐金-板橋",197,1610,-1413
"2117","2883開發金","110/07/27","港商野村",2209,1498,711
"2118","2883開發金","110/07/27","美商高盛",16,1337,-1321
"2119","2883開發金","110/07/27","永豐金-彰化",680,26,654
"2120","2883開發金","110/07/27","兆豐-北高雄",60,1360,-1300
"2121","2883開發金","110/07/27","台新-高雄",918,265,653
"2122","2883開發金","110/07/27","兆豐-景美",26,1070,-1044
"2123","2883開發金","110/07/27","國泰-敦南",1273,634,639
"2124","2883開發金","110/07/27","亞東-新竹",7,1001,-994
"2125","2883開發金","110/07/27","元大證券",876,246,630
"2126","2883開發金","110/07/27","富邦-羅東",201,1098,-897
"2127","2883開發金","110/07/27","致和證券",684,92,592
"2128","2883開發金","110/07/27","統一",159,811,-652
"2129","2883開發金","110/07/27","元大-民生",550,2,548
"2130","2883開發金","110/07/27","香港上海匯豐",0,584,-584
"2131","6205詮欣","110/07/27","土銀-和平",20,0,20
"2132","6205詮欣","110/07/27","摩根大通",3,22,-19
"2133","6205詮欣","110/07/27","臺銀-民權",20,6,14
"2134","6205詮欣","110/07/27","瑞士信貸",5,16,-11
"2135","6205詮欣","110/07/27","台新證券",5,0,5
"2136","6205詮欣","110/07/27","臺銀-鳳山",0,6,-6
"2137","6205詮欣","110/07/27","華南永昌-小港",5,0,5
"2138","6205詮欣","110/07/27","臺銀-新竹",0,5,-5
"2139","6205詮欣","110/07/27","日盛-新莊",4,0,4
"2140","6205詮欣","110/07/27","國票-和平",0,4,-4
"2141","6205詮欣","110/07/27","元富-三重",4,0,4
"2142","6205詮欣","110/07/27","凱基-東門",0,4,-4
"2143","6205詮欣","110/07/27","致和-佳里",4,1,3
"2144","6205詮欣","110/07/27","富邦-花蓮",0,3,-3
"2145","6205詮欣","110/07/27","華南永昌-岡山",3,0,3
"2146","6205詮欣","110/07/27","元大-北投",0,3,-3
"2147","6205詮欣","110/07/27","元大-成功",3,0,3
"2148","6205詮欣","110/07/27","元大-民生",2,5,-3
"2149","6205詮欣","110/07/27","土銀-嘉義",2,0,2
"2150","6205詮欣","110/07/27","日盛-三重",0,2,-2
"2151","6205詮欣","110/07/27","第一金-光復",2,0,2
"2152","6205詮欣","110/07/27","日盛-北高雄",0,2,-2
"2153","6205詮欣","110/07/27","統一-屏東",2,0,2
"2154","6205詮欣","110/07/27","港商野村",0,2,-2
"2155","6205詮欣","110/07/27","元富-新莊",2,0,2
"2156","6205詮欣","110/07/27","統一-彰化",0,2,-2
"2157","6205詮欣","110/07/27","兆豐-竹北",2,0,2
"2158","6205詮欣","110/07/27","永全",0,2,-2
"2159","6205詮欣","110/07/27","新光",2,0,2
"2160","6205詮欣","110/07/27","兆豐-西螺",0,2,-2
"2161","1540喬福","110/07/27","富邦-員林",10,0,10
"2162","1540喬福","110/07/27","合庫-台中",0,26,-26
"2163","1540喬福","110/07/27","元大-中壢",10,0,10
"2164","1540喬福","110/07/27","統一-新台中",0,25,-25
"2165","1540喬福","110/07/27","凱基-台中",8,0,8
"2166","1540喬福","110/07/27","元大-斗六",0,10,-10
"2167","1540喬福","110/07/27","大慶-中壢",5,0,5
"2168","1540喬福","110/07/27","凱基-中港",0,9,-9
"2169","1540喬福","110/07/27","兆豐-北高雄",5,0,5
"2170","1540喬福","110/07/27","國票-中正",0,8,-8
"2171","1540喬福","110/07/27","兆豐-三民",5,0,5
"2172","1540喬福","110/07/27","臺銀-臺中",0,5,-5
"2173","1540喬福","110/07/27","台新-台中",5,0,5
"2174","1540喬福","110/07/27","元富-中原",0,5,-5
"2175","1540喬福","110/07/27","國票-九鼎",4,0,4
"2176","1540喬福","110/07/27","新光-桃園",0,5,-5
"2177","1540喬福","110/07/27","富邦-高雄",5,1,4
"2178","1540喬福","110/07/27","大昌-新竹",0,4,-4
"2179","1540喬福","110/07/27","永豐金-羅東",4,0,4
"2180","1540喬福","110/07/27","元大-員林中山",0,4,-4
"2181","1540喬福","110/07/27","台新證券",3,0,3
"2182","1540喬福","110/07/27","群益金鼎-瑞豐",0,3,-3
"2183","1540喬福","110/07/27","華南永昌-台中",3,0,3
"2184","1540喬福","110/07/27","凱基-台北",0,3,-3
"2185","1540喬福","110/07/27","富邦-台東",3,0,3
"2186","1540喬福","110/07/27","富邦-建國",0,3,-3
"2187","1540喬福","110/07/27","元大-台中中港",3,0,3
"2188","1540喬福","110/07/27","國票-北投",0,2,-2
"2189","1540喬福","110/07/27","亞東",2,0,2
"2190","1540喬福","110/07/27","元大-鳳山",0,2,-2
"2191","2888新光金","110/07/27","台灣摩根士丹利",11737,746,10991
"2192","2888新光金","110/07/27","玉山-城中",112,6002,-5890
"2193","2888新光金","110/07/27","美林",3692,417,3275
"2194","2888新光金","110/07/27","新加坡商瑞銀",120,5935,-5815
"2195","2888新光金","110/07/27","凱基-台北",4378,2713,1665
"2196","2888新光金","110/07/27","摩根大通",1586,7187,-5601
"2197","2888新光金","110/07/27","凱基-台南",1551,3,1548
"2198","2888新光金","110/07/27","富邦-建國",298,5641,-5343
"2199","2888新光金","110/07/27","台新證券",1494,124,1370
"2200","2888新光金","110/07/27","第一金-高雄",81,5014,-4933
"2201","2888新光金","110/07/27","新光",2434,1212,1222
"2202","2888新光金","110/07/27","瑞士信貸",191,4524,-4333
"2203","2888新光金","110/07/27","元大-四維",1246,25,1221
"2204","2888新光金","110/07/27","兆豐-鹿港",45,2632,-2587
"2205","2888新光金","110/07/27","富隆-長安",1070,0,1070
"2206","2888新光金","110/07/27","國票-彰化",3,1803,-1800
"2207","2888新光金","110/07/27","永豐金-萬盛",1052,0,1052
"2208","2888新光金","110/07/27","港商野村",0,1434,-1434
"2209","2888新光金","110/07/27","法銀巴黎",1116,120,996
"2210","2888新光金","110/07/27","統一-高雄",173,1511,-1338
"2211","2888新光金","110/07/27","凱基-竹科",853,4,849
"2212","2888新光金","110/07/27","群益金鼎-古亭",40,1202,-1162
"2213","2888新光金","110/07/27","元大-斗信",874,50,824
"2214","2888新光金","110/07/27","日盛-樹林",34,1034,-1000
"2215","2888新光金","110/07/27","日盛-景美",811,119,692
"2216","2888新光金","110/07/27","統一-土城",18,1000,-982
"2217","2888新光金","110/07/27","元富-世貿",568,2,566
"2218","2888新光金","110/07/27","元大-鹿港",125,1057,-932
"2219","2888新光金","110/07/27","日盛-雙和",567,2,565
"2220","2888新光金","110/07/27","新光-桃園",91,993,-902
"2221","1340勝悅","110/07/27","亞東-台中",15,0,15
"2222","1340勝悅","110/07/27","凱基-岡山",0,25,-25
"2223","1340勝悅","110/07/27","元大-路竹",15,0,15
"2224","1340勝悅","110/07/27","合庫-嘉義",0,14,-14
"2225","1340勝悅","110/07/27","臺銀-臺中",7,0,7
"2226","1340勝悅","110/07/27","元大-北港",0,14,-14
"2227","1340勝悅","110/07/27","台新-台中",7,0,7
"2228","1340勝悅","110/07/27","凱基-台北",0,12,-12
"2229","1340勝悅","110/07/27","元大-屏南",6,0,6
"2230","1340勝悅","110/07/27","兆豐-三民",0,7,-7
"2231","1340勝悅","110/07/27","臺灣企銀-埔墘",5,0,5
"2232","1340勝悅","110/07/27","華南永昌-台中",1,7,-6
"2233","1340勝悅","110/07/27","日盛-板橋",5,0,5
"2234","1340勝悅","110/07/27","日盛-信義",0,5,-5
"2235","1340勝悅","110/07/27","日盛-新莊",5,0,5
"2236","1340勝悅","110/07/27","德信-和平",0,5,-5
"2237","1340勝悅","110/07/27","臺銀-鳳山",4,0,4
"2238","1340勝悅","110/07/27","台新證券",0,5,-5
"2239","1340勝悅","110/07/27","玉山-城中",4,0,4
"2240","1340勝悅","110/07/27","新光-高雄",0,4,-4
"2241","1340勝悅","110/07/27","美商高盛",3,0,3
"2242","1340勝悅","110/07/27","瑞士信貸",0,2,-2
"2243","1340勝悅","110/07/27","(牛牛牛)亞-鑫豐",3,0,3
"2244","1340勝悅","110/07/27","港商野村",0,2,-2
"2245","1340勝悅","110/07/27","國票-長城",2,0,2
"2246","1340勝悅","110/07/27","台新-高雄",1,3,-2
"2247","1340勝悅","110/07/27","新光",2,0,2
"2248","1340勝悅","110/07/27","玉山證券",0,2,-2
"2249","1340勝悅","110/07/27","群益金鼎-館前",2,0,2
"2250","1340勝悅","110/07/27","玉山-南京東路",0,2,-2
"2251","6246臺龍","110/07/27","永豐金-桃園",135,0,135
"2252","6246臺龍","110/07/27","元大-木柵",0,59,-59
"2253","6246臺龍","110/07/27","港商野村",111,30,81
"2254","6246臺龍","110/07/27","日盛-景美",0,52,-52
"2255","6246臺龍","110/07/27","元大-西螺",31,0,31
"2256","6246臺龍","110/07/27","華南永昌-彰化",0,46,-46
"2257","6246臺龍","110/07/27","群益金鼎-鳳山",27,0,27
"2258","6246臺龍","110/07/27","兆豐-松德",0,43,-43
"2259","6246臺龍","110/07/27","永豐金-虎尾",27,0,27
"2260","6246臺龍","110/07/27","華南永昌-公誠",5,35,-30
"2261","6246臺龍","110/07/27","玉山-台南",28,2,26
"2262","6246臺龍","110/07/27","凱基-幸福",0,28,-28
"2263","6246臺龍","110/07/27","元大-西屯",25,0,25
"2264","6246臺龍","110/07/27","元富-安南",0,22,-22
"2265","6246臺龍","110/07/27","國泰-忠孝",23,0,23
"2266","6246臺龍","110/07/27","日盛-文化",0,20,-20
"2267","6246臺龍","110/07/27","元大-大里",21,0,21
"2268","6246臺龍","110/07/27","兆豐-寶成",0,20,-20
"2269","6246臺龍","110/07/27","兆豐-竹北",20,0,20
"2270","6246臺龍","110/07/27","華南永昌-虎尾",0,20,-20
"2271","6246臺龍","110/07/27","元大-員林",20,0,20
"2272","6246臺龍","110/07/27","永豐金-埔里",0,19,-19
"2273","6246臺龍","110/07/27","永豐金-敦南",20,0,20
"2274","6246臺龍","110/07/27","兆豐-新營",2,20,-18
"2275","6246臺龍","110/07/27","永豐金-羅東",23,5,18
"2276","6246臺龍","110/07/27","新光-台中",3,20,-17
"2277","6246臺龍","110/07/27","永豐金-桃盛",18,0,18
"2278","6246臺龍","110/07/27","凱基-市政",0,17,-17
"2279","6246臺龍","110/07/27","統一",16,0,16
"2280","6246臺龍","110/07/27","元大-蘆洲",0,16,-16
"2281","00715L期街口布蘭特正2","110/07/27","元大證券",10436,28,10408
"2282","00715L期街口布蘭特正2","110/07/27","元大-萬華",0,751,-751
"2283","00715L期街口布蘭特正2","110/07/27","凱基-台北",4269,129,4140
"2284","00715L期街口布蘭特正2","110/07/27","元大-大里德芳",0,734,-734
"2285","00715L期街口布蘭特正2","110/07/27","群益金鼎",3798,0,3798
"2286","00715L期街口布蘭特正2","110/07/27","新光",380,1105,-725
"2287","00715L期街口布蘭特正2","110/07/27","永豐金證券",2610,22,2588
"2288","00715L期街口布蘭特正2","110/07/27","(牛牛牛)亞-網路",10,697,-687
"2289","00715L期街口布蘭特正2","110/07/27","國票",2605,21,2584
"2290","00715L期街口布蘭特正2","110/07/27","日盛-新莊",5,550,-545
"2291","00715L期街口布蘭特正2","110/07/27","富邦證券",1522,0,1522
"2292","00715L期街口布蘭特正2","110/07/27","玉山-高雄",7,494,-487
"2293","00715L期街口布蘭特正2","110/07/27","合庫證券",1507,239,1268
"2294","00715L期街口布蘭特正2","110/07/27","華南永昌",1,471,-470
"2295","00715L期街口布蘭特正2","110/07/27","元富",1102,0,1102
"2296","00715L期街口布蘭特正2","110/07/27","華南永昌-竹北",0,469,-469
"2297","00715L期街口布蘭特正2","110/07/27","凱基",980,0,980
"2298","00715L期街口布蘭特正2","110/07/27","兆豐-嘉義",0,420,-420
"2299","00715L期街口布蘭特正2","110/07/27","國票-博愛",702,0,702
"2300","00715L期街口布蘭特正2","110/07/27","國票-九鼎",0,409,-409
"2301","00715L期街口布蘭特正2","110/07/27","統一",796,117,679
"2302","00715L期街口布蘭特正2","110/07/27","統一-高雄",0,405,-405
"2303","00715L期街口布蘭特正2","110/07/27","華南永昌-長虹",810,185,625
"2304","00715L期街口布蘭特正2","110/07/27","富邦-彰化",0,402,-402
"2305","00715L期街口布蘭特正2","110/07/27","港商野村",1076,494,582
"2306","00715L期街口布蘭特正2","110/07/27","元大-羅東",0,400,-400
"2307","00715L期街口布蘭特正2","110/07/27","永豐金-三重",500,16,484
"2308","00715L期街口布蘭特正2","110/07/27","富邦-高雄",0,398,-398
"2309","00715L期街口布蘭特正2","110/07/27","元大-敦化",420,0,420
"2310","00715L期街口布蘭特正2","110/07/27","新光-台中",17,391,-374
"2311","8941關中","110/07/27","富邦-仁愛",4,0,4
"2312","8941關中","110/07/27","光和-溪湖",0,2,-2
"2313","8941關中","110/07/27","日盛-新莊",1,0,1
"2314","8941關中","110/07/27","富邦-園區",0,2,-2
"2315","8941關中","110/07/27","台新-高雄",1,0,1
"2316","8941關中","110/07/27","合庫-高雄",0,1,-1
"2317","8941關中","110/07/27","元大-金華",1,0,1
"2318","8941關中","110/07/27","凱基-台北",0,1,-1
"2319","8941關中","110/07/27","臺銀-鳳山",0,0,0
"2320","8941關中","110/07/27","富邦-台東",0,1,-1
"2321","8941關中","110/07/27","日盛-花蓮",0,0,0
"2322","8941關中","110/07/27","臺銀-鳳山",0,0,0
"2323","8941關中","110/07/27","康和-板橋",0,0,0
"2324","8941關中","110/07/27","日盛-花蓮",0,0,0
"2325","8941關中","110/07/27","富邦-宜蘭",0,0,0
"2326","8941關中","110/07/27","康和-板橋",0,0,0
"2327","8941關中","110/07/27","元大-新竹經國",0,0,0
"2328","8941關中","110/07/27","富邦-宜蘭",0,0,0
"2329","8941關中","110/07/27","永豐金-萬盛",0,0,0
"2330","8941關中","110/07/27","元大-新竹經國",0,0,0
"2331","8941關中","110/07/27","永豐金-桃盛",0,0,0
"2332","8941關中","110/07/27","永豐金-萬盛",0,0,0
"2333","8941關中","110/07/27","",NA,NA,NA
"2334","8941關中","110/07/27","永豐金-桃盛",0,0,0
"2335","8941關中","110/07/27","",NA,NA,NA
"2336","8941關中","110/07/27","",NA,NA,NA
"2337","8941關中","110/07/27","",NA,NA,NA
"2338","8941關中","110/07/27","",NA,NA,NA
"2339","8941關中","110/07/27","",NA,NA,NA
"2340","8941關中","110/07/27","",NA,NA,NA
"2341","8936國統","110/07/27","日盛-景美",100,0,100
"2342","8936國統","110/07/27","摩根大通",115,220,-105
"2343","8936國統","110/07/27","大慶-蘆洲",90,0,90
"2344","8936國統","110/07/27","玉山-桃園",0,75,-75
"2345","8936國統","110/07/27","台新-建北",60,0,60
"2346","8936國統","110/07/27","凱基-台北",13,77,-64
"2347","8936國統","110/07/27","日盛-忠孝",40,1,39
"2348","8936國統","110/07/27","元富-大昌",2,50,-48
"2349","8936國統","110/07/27","新加坡商瑞銀",109,71,38
"2350","8936國統","110/07/27","華南永昌-台中",4,45,-41
"2351","8936國統","110/07/27","華南永昌",30,0,30
"2352","8936國統","110/07/27","新光-台中",26,66,-40
"2353","8936國統","110/07/27","兆豐-來福",29,0,29
"2354","8936國統","110/07/27","台灣摩根士丹利",20,54,-34
"2355","8936國統","110/07/27","元大-旗山",28,0,28
"2356","8936國統","110/07/27","元大-東蘆",0,34,-34
"2357","8936國統","110/07/27","元大-松江",27,0,27
"2358","8936國統","110/07/27","富邦-仁愛",1,34,-33
"2359","8936國統","110/07/27","新光",41,19,22
"2360","8936國統","110/07/27","凱基-板橋",0,31,-31
"2361","8936國統","110/07/27","元富-林園",20,0,20
"2362","8936國統","110/07/27","凱基-信義",0,30,-30
"2363","8936國統","110/07/27","玉山-高雄",20,0,20
"2364","8936國統","110/07/27","瑞士信貸",1,30,-29
"2365","8936國統","110/07/27","凱基-桃園",23,3,20
"2366","8936國統","110/07/27","元大-花蓮",2,24,-22
"2367","8936國統","110/07/27","永豐金-永康",20,0,20
"2368","8936國統","110/07/27","元富-緯城",0,20,-20
"2369","8936國統","110/07/27","日盛-屏東",23,4,19
"2370","8936國統","110/07/27","群益金鼎-宜蘭",0,20,-20
"2371","6226光鼎","110/07/27","第一金-忠孝",405,4,401
"2372","6226光鼎","110/07/27","華南永昌-台南",5,240,-235
"2373","6226光鼎","110/07/27","台新-台中",272,75,197
"2374","6226光鼎","110/07/27","大慶-泰山",0,201,-201
"2375","6226光鼎","110/07/27","凱基-和平",155,7,148
"2376","6226光鼎","110/07/27","富邦-員林",2,151,-149
"2377","6226光鼎","110/07/27","新加坡商瑞銀",133,0,133
"2378","6226光鼎","110/07/27","群益金鼎-東大",23,165,-142
"2379","6226光鼎","110/07/27","統一-敦南",126,3,123
"2380","6226光鼎","110/07/27","元大-景美",3,132,-129
"2381","6226光鼎","110/07/27","台灣摩根士丹利",129,8,121
"2382","6226光鼎","110/07/27","台新-高雄",84,186,-102
"2383","6226光鼎","110/07/27","統一-新竹",117,1,116
"2384","6226光鼎","110/07/27","合庫證券",27,121,-94
"2385","6226光鼎","110/07/27","日盛證券",122,13,109
"2386","6226光鼎","110/07/27","致和-佳里",5,81,-76
"2387","6226光鼎","110/07/27","元大-潮州",101,1,100
"2388","6226光鼎","110/07/27","永豐金-南投",3,77,-74
"2389","6226光鼎","110/07/27","國泰-敦南",232,145,87
"2390","6226光鼎","110/07/27","台新-新莊",1,57,-56
"2391","6226光鼎","110/07/27","摩根大通",86,0,86
"2392","6226光鼎","110/07/27","日盛-中壢",11,64,-53
"2393","6226光鼎","110/07/27","元富",80,0,80
"2394","6226光鼎","110/07/27","日進",11,63,-52
"2395","6226光鼎","110/07/27","華南永昌-嘉義",80,1,79
"2396","6226光鼎","110/07/27","高橋",13,64,-51
"2397","6226光鼎","110/07/27","元大-高雄",70,3,67
"2398","6226光鼎","110/07/27","元大-土城",1,52,-51
"2399","6226光鼎","110/07/27","華南永昌",82,21,61
"2400","6226光鼎","110/07/27","華南永昌-林口",11,60,-49
"2401","2363矽統","110/07/27","國泰-敦南",541,118,423
"2402","2363矽統","110/07/27","摩根大通",317,1405,-1088
"2403","2363矽統","110/07/27","台新證券",564,333,231
"2404","2363矽統","110/07/27","美林",210,1095,-885
"2405","2363矽統","110/07/27","元大-沙鹿",196,9,187
"2406","2363矽統","110/07/27","港商野村",275,1065,-790
"2407","2363矽統","110/07/27","新光",300,151,149
"2408","2363矽統","110/07/27","凱基-台北",518,1192,-674
"2409","2363矽統","110/07/27","華南永昌-台南",108,3,105
"2410","2363矽統","110/07/27","新加坡商瑞銀",213,703,-490
"2411","2363矽統","110/07/27","華南永昌-朴子",140,43,97
"2412","2363矽統","110/07/27","富邦-南屯",6,272,-266
"2413","2363矽統","110/07/27","華南永昌-公誠",109,13,96
"2414","2363矽統","110/07/27","美商高盛",31,233,-202
"2415","2363矽統","110/07/27","元富-松德",95,1,94
"2416","2363矽統","110/07/27","元大證券",38,235,-197
"2417","2363矽統","110/07/27","中國信託-永康",102,8,94
"2418","2363矽統","110/07/27","永豐金證券",15,201,-186
"2419","2363矽統","110/07/27","台新-三民",111,21,90
"2420","2363矽統","110/07/27","亞東",46,206,-160
"2421","2363矽統","110/07/27","凱基-中港",85,3,82
"2422","2363矽統","110/07/27","群益金鼎",21,169,-148
"2423","2363矽統","110/07/27","元富-烏日",87,6,81
"2424","2363矽統","110/07/27","第一金-嘉義",0,100,-100
"2425","2363矽統","110/07/27","富邦-台北",135,56,79
"2426","2363矽統","110/07/27","凱基-彰化",9,100,-91
"2427","2363矽統","110/07/27","元大-復北",81,12,69
"2428","2363矽統","110/07/27","元富-佳里",27,97,-70
"2429","2363矽統","110/07/27","中國信託-忠孝",94,26,68
"2430","2363矽統","110/07/27","合庫-桃園",8,76,-68
"2431","8112至上","110/07/27","凱基-竹科",300,10,290
"2432","8112至上","110/07/27","凱基-三重",1,501,-500
"2433","8112至上","110/07/27","台灣摩根士丹利",271,49,222
"2434","8112至上","110/07/27","美林",21,339,-318
"2435","8112至上","110/07/27","摩根大通",488,427,61
"2436","8112至上","110/07/27","凱基-台北",423,615,-192
"2437","8112至上","110/07/27","香港上海匯豐",61,0,61
"2438","8112至上","110/07/27","港商野村",83,183,-100
"2439","8112至上","110/07/27","日盛證券",62,4,58
"2440","8112至上","110/07/27","永豐金-台南",2,79,-77
"2441","8112至上","110/07/27","元大-基隆孝二",52,0,52
"2442","8112至上","110/07/27","福邦證券",0,71,-71
"2443","8112至上","110/07/27","永豐金-中正",59,7,52
"2444","8112至上","110/07/27","兆豐-天母",0,50,-50
"2445","8112至上","110/07/27","群益金鼎-高盛",47,0,47
"2446","8112至上","110/07/27","元富-林園",3,52,-49
"2447","8112至上","110/07/27","永豐金-內湖",47,0,47
"2448","8112至上","110/07/27","永豐金-苓雅",1,50,-49
"2449","8112至上","110/07/27","富邦-台北",45,5,40
"2450","8112至上","110/07/27","元大-新莊",9,53,-44
"2451","8112至上","110/07/27","台新證券",78,39,39
"2452","8112至上","110/07/27","第一金-路竹",20,57,-37
"2453","8112至上","110/07/27","新光-台中",44,7,37
"2454","8112至上","110/07/27","新光-桃園",2,36,-34
"2455","8112至上","110/07/27","元大-羅東",38,1,37
"2456","8112至上","110/07/27","元大-東港",0,27,-27
"2457","8112至上","110/07/27","新光",101,65,36
"2458","8112至上","110/07/27","國泰-松江",2,28,-26
"2459","8112至上","110/07/27","元大-新竹",63,28,35
"2460","8112至上","110/07/27","群益金鼎-潭子",2,28,-26
"2461","1570力肯","110/07/27","國票-北高雄",7,0,7
"2462","1570力肯","110/07/27","元大-高雄",0,16,-16
"2463","1570力肯","110/07/27","富邦-陽明",5,0,5
"2464","1570力肯","110/07/27","國票-新莊",0,5,-5
"2465","1570力肯","110/07/27","元大-民雄",3,0,3
"2466","1570力肯","110/07/27","凱基-台北",0,5,-5
"2467","1570力肯","110/07/27","凱基-大里",3,0,3
"2468","1570力肯","110/07/27","美林",0,2,-2
"2469","1570力肯","110/07/27","凱基-長庚",3,0,3
"2470","1570力肯","110/07/27","富邦-南屯",0,2,-2
"2471","1570力肯","110/07/27","元大-新莊",2,0,2
"2472","1570力肯","110/07/27","元大-南崁",0,2,-2
"2473","1570力肯","110/07/27","大昌-樹林",2,0,2
"2474","1570力肯","110/07/27","元大-板橋",0,2,-2
"2475","1570力肯","110/07/27","台新-台中",2,0,2
"2476","1570力肯","110/07/27","新光",0,1,-1
"2477","1570力肯","110/07/27","新光-新竹",2,0,2
"2478","1570力肯","110/07/27","國泰-板橋",0,1,-1
"2479","1570力肯","110/07/27","富邦-左營",2,0,2
"2480","1570力肯","110/07/27","凱基-鳳山",0,1,-1
"2481","1570力肯","110/07/27","群益金鼎-土城",1,0,1
"2482","1570力肯","110/07/27","(牛牛牛)亞-鑫豐",2,2,0
"2483","1570力肯","110/07/27","凱基-竹東",1,0,1
"2484","1570力肯","110/07/27","元大-新盛",1,1,0
"2485","1570力肯","110/07/27","日盛-員林",1,0,1
"2486","1570力肯","110/07/27","",NA,NA,NA
"2487","1570力肯","110/07/27","玉山-板橋",1,0,1
"2488","1570力肯","110/07/27","",NA,NA,NA
"2489","1570力肯","110/07/27","元富-同大",1,0,1
"2490","1570力肯","110/07/27","",NA,NA,NA
"2491","2929淘帝","110/07/27","元大-民生",28,0,28
"2492","2929淘帝","110/07/27","元大-鳳山",0,20,-20
"2493","2929淘帝","110/07/27","臺銀-民權",18,0,18
"2494","2929淘帝","110/07/27","港商野村",1,18,-17
"2495","2929淘帝","110/07/27","合庫-高雄",13,0,13
"2496","2929淘帝","110/07/27","玉山-板橋",0,15,-15
"2497","2929淘帝","110/07/27","永興-水湳",10,0,10
"2498","2929淘帝","110/07/27","美林",0,10,-10
"2499","2929淘帝","110/07/27","富邦-陽明",10,0,10
"2500","2929淘帝","110/07/27","凱基-八德",0,10,-10
"2501","2929淘帝","110/07/27","元大-中和",10,0,10
"2502","2929淘帝","110/07/27","永豐金證券",0,9,-9
"2503","2929淘帝","110/07/27","國泰-館前",6,0,6
"2504","2929淘帝","110/07/27","新加坡商瑞銀",10,18,-8
"2505","2929淘帝","110/07/27","富邦-內湖",6,0,6
"2506","2929淘帝","110/07/27","富邦-台北",0,8,-8
"2507","2929淘帝","110/07/27","合庫-台南",5,0,5
"2508","2929淘帝","110/07/27","宏遠-台中",0,7,-7
"2509","2929淘帝","110/07/27","凱基-東門",5,0,5
"2510","2929淘帝","110/07/27","元富-潮州",0,7,-7
"2511","2929淘帝","110/07/27","元大-大益",5,0,5
"2512","2929淘帝","110/07/27","群益金鼎-延平",0,6,-6
"2513","2929淘帝","110/07/27","元大-屏南",5,0,5
"2514","2929淘帝","110/07/27","元大-文心",0,6,-6
"2515","2929淘帝","110/07/27","永豐金-板盛",5,0,5
"2516","2929淘帝","110/07/27","永豐金-中壢",0,6,-6
"2517","2929淘帝","110/07/27","臺銀",4,0,4
"2518","2929淘帝","110/07/27","美商高盛",0,5,-5
"2519","2929淘帝","110/07/27","永豐金-市政",4,0,4
"2520","2929淘帝","110/07/27","兆豐-南門",0,5,-5
"2521","5410國眾","110/07/27","摩根大通",47,0,47
"2522","5410國眾","110/07/27","元富-嘉義",0,48,-48
"2523","5410國眾","110/07/27","兆豐-城中",43,0,43
"2524","5410國眾","110/07/27","統一-平鎮",0,20,-20
"2525","5410國眾","110/07/27","香港上海匯豐",36,0,36
"2526","5410國眾","110/07/27","元大-大益",0,18,-18
"2527","5410國眾","110/07/27","港商麥格理",26,0,26
"2528","5410國眾","110/07/27","凱基-台北",0,16,-16
"2529","5410國眾","110/07/27","元富-大昌",21,0,21
"2530","5410國眾","110/07/27","凱基-站前",0,15,-15
"2531","5410國眾","110/07/27","元富-四維",20,0,20
"2532","5410國眾","110/07/27","元大-南勢角",0,13,-13
"2533","5410國眾","110/07/27","新光-台中",20,0,20
"2534","5410國眾","110/07/27","日盛-忠孝",0,11,-11
"2535","5410國眾","110/07/27","統一-金門",15,0,15
"2536","5410國眾","110/07/27","玉山-板橋",0,11,-11
"2537","5410國眾","110/07/27","玉山-高雄",15,0,15
"2538","5410國眾","110/07/27","元大-崇德",0,11,-11
"2539","5410國眾","110/07/27","凱基-竹北",15,0,15
"2540","5410國眾","110/07/27","元大-大天母",0,11,-11
"2541","5410國眾","110/07/27","元大-新莊",14,1,13
"2542","5410國眾","110/07/27","元富-松德",0,10,-10
"2543","5410國眾","110/07/27","華南永昌-中正",14,4,10
"2544","5410國眾","110/07/27","豐農",0,10,-10
"2545","5410國眾","110/07/27","元大-屏南",10,0,10
"2546","5410國眾","110/07/27","新光-新竹",0,10,-10
"2547","5410國眾","110/07/27","元大-中和",10,0,10
"2548","5410國眾","110/07/27","凱基-虎尾",0,10,-10
"2549","5410國眾","110/07/27","台新證券",10,1,9
"2550","5410國眾","110/07/27","元大-善化",0,10,-10
"2551","2841台開","110/07/27","日盛證券",620,0,620
"2552","2841台開","110/07/27","玉山-新竹",0,312,-312
"2553","2841台開","110/07/27","永豐金-豐原",65,0,65
"2554","2841台開","110/07/27","港商野村",0,216,-216
"2555","2841台開","110/07/27","元大-南投",50,0,50
"2556","2841台開","110/07/27","永興-水湳",0,90,-90
"2557","2841台開","110/07/27","台灣摩根士丹利",40,0,40
"2558","2841台開","110/07/27","凱基-興隆",0,64,-64
"2559","2841台開","110/07/27","玉山-高雄",29,0,29
"2560","2841台開","110/07/27","美林",0,30,-30
"2561","2841台開","110/07/27","第一金-台中",20,0,20
"2562","2841台開","110/07/27","國泰-松江",5,35,-30
"2563","2841台開","110/07/27","凱基-市政",20,0,20
"2564","2841台開","110/07/27","台新-左楠",0,25,-25
"2565","2841台開","110/07/27","群益金鼎-大甲",18,1,17
"2566","2841台開","110/07/27","大昌-樹林",0,20,-20
"2567","2841台開","110/07/27","台中銀",16,1,15
"2568","2841台開","110/07/27","富邦-仁愛",0,20,-20
"2569","2841台開","110/07/27","國泰-板橋",12,0,12
"2570","2841台開","110/07/27","致和-南京",0,16,-16
"2571","2841台開","110/07/27","群益金鼎-基隆",10,0,10
"2572","2841台開","110/07/27","凱基-台北",2,16,-14
"2573","2841台開","110/07/27","華南永昌-新莊",10,0,10
"2574","2841台開","110/07/27","日盛-台南",0,10,-10
"2575","2841台開","110/07/27","元大-福營",10,0,10
"2576","2841台開","110/07/27","國票-台東",0,10,-10
"2577","2841台開","110/07/27","元大-歸仁",10,0,10
"2578","2841台開","110/07/27","台新-台中",5,15,-10
"2579","2841台開","110/07/27","中國信託-文心",5,0,5
"2580","2841台開","110/07/27","凱基-台中",0,10,-10
"2581","6207雷科","110/07/27","摩根大通",249,119,130
"2582","6207雷科","110/07/27","永豐金-台南",2,82,-80
"2583","6207雷科","110/07/27","群益金鼎-丹鳳",70,0,70
"2584","6207雷科","110/07/27","永豐金-內湖",39,109,-70
"2585","6207雷科","110/07/27","群益金鼎-東門",42,0,42
"2586","6207雷科","110/07/27","新加坡商瑞銀",22,76,-54
"2587","6207雷科","110/07/27","永豐金-敦南",38,4,34
"2588","6207雷科","110/07/27","新光-高雄",4,57,-53
"2589","6207雷科","110/07/27","凱基-復興",30,0,30
"2590","6207雷科","110/07/27","瑞士信貸",0,40,-40
"2591","6207雷科","110/07/27","元大-東門",30,0,30
"2592","6207雷科","110/07/27","凱基-高雄",4,43,-39
"2593","6207雷科","110/07/27","大昌-桃園",33,8,25
"2594","6207雷科","110/07/27","華南永昌-高雄",4,40,-36
"2595","6207雷科","110/07/27","富邦-虎尾",24,0,24
"2596","6207雷科","110/07/27","新光",11,44,-33
"2597","6207雷科","110/07/27","凱基-羅東",24,2,22
"2598","6207雷科","110/07/27","日盛-板橋中山",0,29,-29
"2599","6207雷科","110/07/27","群益金鼎-延平",21,0,21
"2600","6207雷科","110/07/27","元大-六合",3,30,-27
"2601","6207雷科","110/07/27","群益金鼎-屏東",20,0,20
"2602","6207雷科","110/07/27","中國信託-新竹",7,33,-26
"2603","6207雷科","110/07/27","永豐金-埔里",20,0,20
"2604","6207雷科","110/07/27","元富-城中",0,23,-23
"2605","6207雷科","110/07/27","康和-延平",21,3,18
"2606","6207雷科","110/07/27","元大-大雅",2,20,-18
"2607","6207雷科","110/07/27","群益金鼎-中壢",20,2,18
"2608","6207雷科","110/07/27","永豐金-新莊",2,20,-18
"2609","6207雷科","110/07/27","宏遠證券",31,15,16
"2610","6207雷科","110/07/27","富邦-台中",5,21,-16
"2611","3679新至陞","110/07/27","凱基-市政",25,0,25
"2612","3679新至陞","110/07/27","瑞士信貸",0,13,-13
"2613","3679新至陞","110/07/27","兆豐-高雄",10,0,10
"2614","3679新至陞","110/07/27","元大-天母",0,9,-9
"2615","3679新至陞","110/07/27","光和-溪湖",8,0,8
"2616","3679新至陞","110/07/27","元大-彰化民生",0,6,-6
"2617","3679新至陞","110/07/27","臺銀-新竹",7,0,7
"2618","3679新至陞","110/07/27","康和-澎湖",2,7,-5
"2619","3679新至陞","110/07/27","新加坡商瑞銀",7,0,7
"2620","3679新至陞","110/07/27","聯邦-大業",0,5,-5
"2621","3679新至陞","110/07/27","永豐金-板橋",6,0,6
"2622","3679新至陞","110/07/27","元大-成功",0,5,-5
"2623","3679新至陞","110/07/27","宏遠-光隆",5,0,5
"2624","3679新至陞","110/07/27","康和-板橋",0,4,-4
"2625","3679新至陞","110/07/27","統一",5,0,5
"2626","3679新至陞","110/07/27","凱基-新豐",0,4,-4
"2627","3679新至陞","110/07/27","統一-新竹",5,0,5
"2628","3679新至陞","110/07/27","統一-高雄",0,3,-3
"2629","3679新至陞","110/07/27","元富-松德",5,0,5
"2630","3679新至陞","110/07/27","統一-新台中",0,3,-3
"2631","3679新至陞","110/07/27","元大-淡水",5,0,5
"2632","3679新至陞","110/07/27","元富-安南",0,3,-3
"2633","3679新至陞","110/07/27","日盛證券",4,0,4
"2634","3679新至陞","110/07/27","國票-北高雄",0,3,-3
"2635","3679新至陞","110/07/27","國泰-板橋",4,0,4
"2636","3679新至陞","110/07/27","玉山-新莊",0,3,-3
"2637","3679新至陞","110/07/27","(牛牛牛)亞-網路",3,0,3
"2638","3679新至陞","110/07/27","凱基-屏東",0,3,-3
"2639","3679新至陞","110/07/27","國票-九鼎",3,0,3
"2640","3679新至陞","110/07/27","台灣摩根士丹利",0,2,-2
"2641","2727王品","110/07/27","台灣摩根士丹利",103,12,91
"2642","2727王品","110/07/27","元大-彰化民生",11,420,-409
"2643","2727王品","110/07/27","華南永昌-麻豆",33,0,33
"2644","2727王品","110/07/27","美商高盛",0,247,-247
"2645","2727王品","110/07/27","元大-龍潭",31,1,30
"2646","2727王品","110/07/27","華南永昌",7,193,-186
"2647","2727王品","110/07/27","國泰-敦南",38,11,27
"2648","2727王品","110/07/27","花旗環球",0,86,-86
"2649","2727王品","110/07/27","群益金鼎-基隆",27,1,26
"2650","2727王品","110/07/27","凱基-台北",81,139,-58
"2651","2727王品","110/07/27","富邦-台中",26,0,26
"2652","2727王品","110/07/27","元大證券",23,64,-41
"2653","2727王品","110/07/27","元富",31,6,25
"2654","2727王品","110/07/27","瑞士信貸",0,37,-37
"2655","2727王品","110/07/27","元大-桃園",25,0,25
"2656","2727王品","110/07/27","富邦-建國",8,35,-27
"2657","2727王品","110/07/27","凱基-大直",21,1,20
"2658","2727王品","110/07/27","凱基-埔墘",6,29,-23
"2659","2727王品","110/07/27","日盛-士林",16,0,16
"2660","2727王品","110/07/27","美林",5,26,-21
"2661","2727王品","110/07/27","國票-敦北法人",17,1,16
"2662","2727王品","110/07/27","港商野村",12,30,-18
"2663","2727王品","110/07/27","群益金鼎-高雄",16,0,16
"2664","2727王品","110/07/27","華南永昌-林口",3,21,-18
"2665","2727王品","110/07/27","永豐金-忠孝",18,2,16
"2666","2727王品","110/07/27","彰銀-台中",4,20,-16
"2667","2727王品","110/07/27","臺銀-高雄",16,1,15
"2668","2727王品","110/07/27","統一",3,17,-14
"2669","2727王品","110/07/27","台新-台中",18,3,15
"2670","2727王品","110/07/27","富邦-新竹華信",2,15,-13
"2671","1570力肯","110/07/27","國票-北高雄",7,0,7
"2672","1570力肯","110/07/27","元大-高雄",0,16,-16
"2673","1570力肯","110/07/27","富邦-陽明",5,0,5
"2674","1570力肯","110/07/27","國票-新莊",0,5,-5
"2675","1570力肯","110/07/27","元大-民雄",3,0,3
"2676","1570力肯","110/07/27","凱基-台北",0,5,-5
"2677","1570力肯","110/07/27","凱基-大里",3,0,3
"2678","1570力肯","110/07/27","美林",0,2,-2
"2679","1570力肯","110/07/27","凱基-長庚",3,0,3
"2680","1570力肯","110/07/27","富邦-南屯",0,2,-2
"2681","1570力肯","110/07/27","元大-新莊",2,0,2
"2682","1570力肯","110/07/27","元大-南崁",0,2,-2
"2683","1570力肯","110/07/27","大昌-樹林",2,0,2
"2684","1570力肯","110/07/27","元大-板橋",0,2,-2
"2685","1570力肯","110/07/27","台新-台中",2,0,2
"2686","1570力肯","110/07/27","新光",0,1,-1
"2687","1570力肯","110/07/27","新光-新竹",2,0,2
"2688","1570力肯","110/07/27","國泰-板橋",0,1,-1
"2689","1570力肯","110/07/27","富邦-左營",2,0,2
"2690","1570力肯","110/07/27","凱基-鳳山",0,1,-1
"2691","1570力肯","110/07/27","群益金鼎-土城",1,0,1
"2692","1570力肯","110/07/27","(牛牛牛)亞-鑫豐",2,2,0
"2693","1570力肯","110/07/27","凱基-竹東",1,0,1
"2694","1570力肯","110/07/27","元大-新盛",1,1,0
"2695","1570力肯","110/07/27","日盛-員林",1,0,1
"2696","1570力肯","110/07/27","",NA,NA,NA
"2697","1570力肯","110/07/27","玉山-板橋",1,0,1
"2698","1570力肯","110/07/27","",NA,NA,NA
"2699","1570力肯","110/07/27","元富-同大",1,0,1
"2700","1570力肯","110/07/27","",NA,NA,NA
"2701","6180橘子","110/07/27","新加坡商瑞銀",166,24,142
"2702","6180橘子","110/07/27","花旗環球",31,87,-56
"2703","6180橘子","110/07/27","彰銀-台中",50,1,49
"2704","6180橘子","110/07/27","凱基-台北",53,108,-55
"2705","6180橘子","110/07/27","日盛-文化",48,8,40
"2706","6180橘子","110/07/27","新光",39,81,-42
"2707","6180橘子","110/07/27","美林",39,0,39
"2708","6180橘子","110/07/27","富邦-台北",1,25,-24
"2709","6180橘子","110/07/27","元大-草屯",54,17,37
"2710","6180橘子","110/07/27","第一金-員林",0,22,-22
"2711","6180橘子","110/07/27","美商高盛",35,1,34
"2712","6180橘子","110/07/27","富邦-新竹華信",7,28,-21
"2713","6180橘子","110/07/27","元大-上新莊",32,0,32
"2714","6180橘子","110/07/27","凱基-中山",5,24,-19
"2715","6180橘子","110/07/27","台灣摩根士丹利",30,0,30
"2716","6180橘子","110/07/27","國泰-敦南",22,37,-15
"2717","6180橘子","110/07/27","摩根大通",49,21,28
"2718","6180橘子","110/07/27","合庫-自強",2,16,-14
"2719","6180橘子","110/07/27","兆豐-大同",30,4,26
"2720","6180橘子","110/07/27","大昌-安康",1,14,-13
"2721","6180橘子","110/07/27","元大-羅東",21,0,21
"2722","6180橘子","110/07/27","高橋",0,11,-11
"2723","6180橘子","110/07/27","日盛-頭份",16,0,16
"2724","6180橘子","110/07/27","土銀-新竹",0,10,-10
"2725","6180橘子","110/07/27","瑞士信貸",24,8,16
"2726","6180橘子","110/07/27","兆豐-麻豆",0,10,-10
"2727","6180橘子","110/07/27","群益金鼎-士林",15,0,15
"2728","6180橘子","110/07/27","康和-永和",0,10,-10
"2729","6180橘子","110/07/27","永豐金-南京",15,1,14
"2730","6180橘子","110/07/27","永豐金-竹科",2,12,-10
"2731","2390云辰","110/07/27","凱基-基隆",207,3,204
"2732","2390云辰","110/07/27","凱基-台北",248,732,-484
"2733","2390云辰","110/07/27","摩根大通",730,560,170
"2734","2390云辰","110/07/27","美林",17,218,-201
"2735","2390云辰","110/07/27","華南永昌-中正",182,43,139
"2736","2390云辰","110/07/27","港商野村",85,277,-192
"2737","2390云辰","110/07/27","兆豐-北高雄",124,1,123
"2738","2390云辰","110/07/27","玉山-新莊",4,87,-83
"2739","2390云辰","110/07/27","元大-信義",108,5,103
"2740","2390云辰","110/07/27","新光",96,163,-67
"2741","2390云辰","110/07/27","富邦-陽明",94,22,72
"2742","2390云辰","110/07/27","新光-新竹",7,74,-67
"2743","2390云辰","110/07/27","日盛證券",140,71,69
"2744","2390云辰","110/07/27","富邦-左營",46,107,-61
"2745","2390云辰","110/07/27","第一金-豐原",56,0,56
"2746","2390云辰","110/07/27","大昌-新店",9,64,-55
"2747","2390云辰","110/07/27","統一-新台中",67,22,45
"2748","2390云辰","110/07/27","日盛-和美",28,81,-53
"2749","2390云辰","110/07/27","元大-復北",47,2,45
"2750","2390云辰","110/07/27","元大-台南",3,54,-51
"2751","2390云辰","110/07/27","富邦-建國",54,10,44
"2752","2390云辰","110/07/27","元富-世貿",10,60,-50
"2753","2390云辰","110/07/27","兆豐-桃鶯",46,5,41
"2754","2390云辰","110/07/27","華南永昌-鳳山",41,90,-49
"2755","2390云辰","110/07/27","富邦-中壢",45,4,41
"2756","2390云辰","110/07/27","聯邦商銀",6,52,-46
"2757","2390云辰","110/07/27","富邦-新竹華信",46,11,35
"2758","2390云辰","110/07/27","合庫-高雄",7,50,-43
"2759","2390云辰","110/07/27","第一金-華江",30,2,28
"2760","2390云辰","110/07/27","瑞士信貸",0,42,-42
"2761","2363矽統","110/07/26","凱基-台北",1994,468,1526
"2762","2363矽統","110/07/26","富邦-南屯",5,375,-370
"2763","2363矽統","110/07/26","新加坡商瑞銀",1537,208,1329
"2764","2363矽統","110/07/26","聯邦-興中",0,203,-203
"2765","2363矽統","110/07/26","摩根大通",2033,997,1036
"2766","2363矽統","110/07/26","台新證券",427,622,-195
"2767","2363矽統","110/07/26","瑞士信貸",930,0,930
"2768","2363矽統","110/07/26","元大-鳳中",10,203,-193
"2769","2363矽統","110/07/26","美林",985,76,909
"2770","2363矽統","110/07/26","國泰-板橋",69,209,-140
"2771","2363矽統","110/07/26","港商野村",1072,282,790
"2772","2363矽統","110/07/26","北城證券",6,132,-126
"2773","2363矽統","110/07/26","美商高盛",711,7,704
"2774","2363矽統","110/07/26","華南永昌-朴子",30,152,-122
"2775","2363矽統","110/07/26","新光",570,278,292
"2776","2363矽統","110/07/26","台新-台中",27,145,-118
"2777","2363矽統","110/07/26","台新-台南",244,39,205
"2778","2363矽統","110/07/26","群益金鼎-萬華",13,128,-115
"2779","2363矽統","110/07/26","元大證券",243,52,191
"2780","2363矽統","110/07/26","日盛-樹林",7,116,-109
"2781","2363矽統","110/07/26","永豐金證券",189,27,162
"2782","2363矽統","110/07/26","群益金鼎-屏東",200,303,-103
"2783","2363矽統","110/07/26","元大-楊梅",177,16,161
"2784","2363矽統","110/07/26","元大-潮州",6,102,-96
"2785","2363矽統","110/07/26","群益金鼎",158,21,137
"2786","2363矽統","110/07/26","新光-桃園",22,117,-95
"2787","2363矽統","110/07/26","元富-城東",107,8,99
"2788","2363矽統","110/07/26","凱基-和平",45,140,-95
"2789","2363矽統","110/07/26","日盛-雙和",109,14,95
"2790","2363矽統","110/07/26","合庫-台南",5,95,-90
"2791","8112至上","110/07/26","摩根大通",1728,41,1687
"2792","8112至上","110/07/26","玉山-左營",3,600,-597
"2793","8112至上","110/07/26","台灣摩根士丹利",408,10,398
"2794","8112至上","110/07/26","凱基-三重",1,527,-526
"2795","8112至上","110/07/26","凱基-台北",693,311,382
"2796","8112至上","110/07/26","中國信託-忠孝",0,103,-103
"2797","8112至上","110/07/26","港商法國興業",376,1,375
"2798","8112至上","110/07/26","凱基-站前",7,105,-98
"2799","8112至上","110/07/26","美商高盛",172,26,146
"2800","8112至上","110/07/26","國票-中港",0,96,-96
"2801","8112至上","110/07/26","新加坡商瑞銀",201,69,132
"2802","8112至上","110/07/26","兆豐-公益",3,84,-81
"2803","8112至上","110/07/26","美林",192,62,130
"2804","8112至上","110/07/26","玉山證券",2,65,-63
"2805","8112至上","110/07/26","港商野村",142,58,84
"2806","8112至上","110/07/26","統一-台中",1,62,-61
"2807","8112至上","110/07/26","凱基-永和",75,0,75
"2808","8112至上","110/07/26","富邦-陽明",3,60,-57
"2809","8112至上","110/07/26","凱基-竹科",65,2,63
"2810","8112至上","110/07/26","新光-新竹",86,141,-55
"2811","8112至上","110/07/26","華南永昌-敦南",63,1,62
"2812","8112至上","110/07/26","富邦-台北",2,57,-55
"2813","8112至上","110/07/26","兆豐-天母",50,0,50
"2814","8112至上","110/07/26","玉山-板橋",2,51,-49
"2815","8112至上","110/07/26","新光-桃園",57,11,46
"2816","8112至上","110/07/26","台新-新營",6,47,-41
"2817","8112至上","110/07/26","光和",35,1,34
"2818","8112至上","110/07/26","元大-虎尾",4,42,-38
"2819","8112至上","110/07/26","華南永昌-新莊",31,3,28
"2820","8112至上","110/07/26","日盛-新竹",1,38,-37
"2821","1570力肯","110/07/26","元大-民雄",10,0,10
"2822","1570力肯","110/07/26","元大-高雄",0,33,-33
"2823","1570力肯","110/07/26","新光-台中",10,1,9
"2824","1570力肯","110/07/26","日盛-宜蘭",0,8,-8
"2825","1570力肯","110/07/26","富邦-陽明",9,0,9
"2826","1570力肯","110/07/26","美林",0,5,-5
"2827","1570力肯","110/07/26","大慶-蘆洲",8,0,8
"2828","1570力肯","110/07/26","凱基-永康",0,5,-5
"2829","1570力肯","110/07/26","福勝",8,0,8
"2830","1570力肯","110/07/26","台新證券",0,4,-4
"2831","1570力肯","110/07/26","凱基-桃園",7,0,7
"2832","1570力肯","110/07/26","元大-汐止",0,4,-4
"2833","1570力肯","110/07/26","中國信託-永康",3,0,3
"2834","1570力肯","110/07/26","元大-桃興",0,3,-3
"2835","1570力肯","110/07/26","兆豐-台中港",3,0,3
"2836","1570力肯","110/07/26","元富-吉利",0,2,-2
"2837","1570力肯","110/07/26","國票-北高雄",3,0,3
"2838","1570力肯","110/07/26","國泰-板橋",0,2,-2
"2839","1570力肯","110/07/26","富邦-員林",3,0,3
"2840","1570力肯","110/07/26","元大-台中",0,2,-2
"2841","1570力肯","110/07/26","瑞士信貸",2,0,2
"2842","1570力肯","110/07/26","元大-西螺",0,2,-2
"2843","1570力肯","110/07/26","大昌-樹林",2,0,2
"2844","1570力肯","110/07/26","元大-苑裡",0,2,-2
"2845","1570力肯","110/07/26","兆豐-忠孝",2,0,2
"2846","1570力肯","110/07/26","合庫-三重",0,1,-1
"2847","1570力肯","110/07/26","新光",2,0,2
"2848","1570力肯","110/07/26","臺銀-臺南",0,1,-1
"2849","1570力肯","110/07/26","凱基-台北",2,0,2
"2850","1570力肯","110/07/26","元富-永和",0,1,-1
"2851","2929淘帝","110/07/26","合庫-高雄",47,0,47
"2852","2929淘帝","110/07/26","港商野村",11,42,-31
"2853","2929淘帝","110/07/26","元大-民生",28,0,28
"2854","2929淘帝","110/07/26","凱基-林口",0,30,-30
"2855","2929淘帝","110/07/26","臺銀-鳳山",10,0,10
"2856","2929淘帝","110/07/26","美林",1,28,-27
"2857","2929淘帝","110/07/26","華南永昌-鶯歌",10,0,10
"2858","2929淘帝","110/07/26","富邦-竹北",0,20,-20
"2859","2929淘帝","110/07/26","元大-永和",10,0,10
"2860","2929淘帝","110/07/26","凱基-台北",0,12,-12
"2861","2929淘帝","110/07/26","永豐金證券",8,0,8
"2862","2929淘帝","110/07/26","中國信託-永康",0,10,-10
"2863","2929淘帝","110/07/26","元大-太平",8,1,7
"2864","2929淘帝","110/07/26","摩根大通",0,10,-10
"2865","2929淘帝","110/07/26","德信-和平",6,0,6
"2866","2929淘帝","110/07/26","群益金鼎-高雄",0,10,-10
"2867","2929淘帝","110/07/26","兆豐-南門",6,0,6
"2868","2929淘帝","110/07/26","富邦-宜蘭",0,10,-10
"2869","2929淘帝","110/07/26","元大-新竹經國",6,0,6
"2870","2929淘帝","110/07/26","新加坡商瑞銀",4,13,-9
"2871","2929淘帝","110/07/26","合庫-台南",5,0,5
"2872","2929淘帝","110/07/26","元富-敦南",0,7,-7
"2873","2929淘帝","110/07/26","第一金-新興",5,0,5
"2874","2929淘帝","110/07/26","元大-基隆",0,6,-6
"2875","2929淘帝","110/07/26","玉山-新竹",5,0,5
"2876","2929淘帝","110/07/26","新光-台中",1,6,-5
"2877","2929淘帝","110/07/26","元大-金門",5,0,5
"2878","2929淘帝","110/07/26","華南永昌",0,5,-5
"2879","2929淘帝","110/07/26","台新-台中",4,0,4
"2880","2929淘帝","110/07/26","永豐金-中和",0,5,-5
"2881","5410國眾","110/07/26","摩根大通",71,0,71
"2882","5410國眾","110/07/26","日盛-忠孝",0,142,-142
"2883","5410國眾","110/07/26","凱基-台北",67,4,63
"2884","5410國眾","110/07/26","元富-嘉義",0,55,-55
"2885","5410國眾","110/07/26","兆豐-城中",47,0,47
"2886","5410國眾","110/07/26","國泰-敦南",2,30,-28
"2887","5410國眾","110/07/26","永豐金-內湖",45,0,45
"2888","5410國眾","110/07/26","群益金鼎-板橋",0,15,-15
"2889","5410國眾","110/07/26","元大-新莊",26,0,26
"2890","5410國眾","110/07/26","華南永昌-三重",0,11,-11
"2891","5410國眾","110/07/26","兆豐-麻豆",10,0,10
"2892","5410國眾","110/07/26","永全-南崁",0,10,-10
"2893","5410國眾","110/07/26","新光-台中",10,0,10
"2894","5410國眾","110/07/26","台新-建北",1,11,-10
"2895","5410國眾","110/07/26","元大-屏南",10,0,10
"2896","5410國眾","110/07/26","臺銀-臺南",0,8,-8
"2897","5410國眾","110/07/26","港商野村",9,0,9
"2898","5410國眾","110/07/26","群益金鼎-東大",0,7,-7
"2899","5410國眾","110/07/26","新光",13,4,9
"2900","5410國眾","110/07/26","永豐金-中正",0,7,-7
"2901","5410國眾","110/07/26","華南永昌-小港",7,0,7
"2902","5410國眾","110/07/26","永豐金-桃園",0,7,-7
"2903","5410國眾","110/07/26","玉山-左營",6,0,6
"2904","5410國眾","110/07/26","第一金-高雄",0,6,-6
"2905","5410國眾","110/07/26","土銀-台南",5,0,5
"2906","5410國眾","110/07/26","台中銀-豐原",0,6,-6
"2907","5410國眾","110/07/26","新加坡商瑞銀",5,0,5
"2908","5410國眾","110/07/26","亞東-高雄",0,5,-5
"2909","5410國眾","110/07/26","元富-三重",8,3,5
"2910","5410國眾","110/07/26","國票-北高雄",0,5,-5
"2911","2841台開","110/07/26","台新-台中",282,5,277
"2912","2841台開","110/07/26","港商野村",0,128,-128
"2913","2841台開","110/07/26","凱基-台北",41,0,41
"2914","2841台開","110/07/26","富邦-仁愛",0,70,-70
"2915","2841台開","110/07/26","台灣摩根士丹利",40,0,40
"2916","2841台開","110/07/26","元大-彰化",0,60,-60
"2917","2841台開","110/07/26","元富-緯城",40,0,40
"2918","2841台開","110/07/26","永興-水湳",0,30,-30
"2919","2841台開","110/07/26","玉山-高雄",38,0,38
"2920","2841台開","110/07/26","富邦-新竹華信",0,23,-23
"2921","2841台開","110/07/26","日盛-樹林",21,0,21
"2922","2841台開","110/07/26","宏遠-光隆",0,20,-20
"2923","2841台開","110/07/26","元大-松江",20,0,20
"2924","2841台開","110/07/26","玉山證券",0,20,-20
"2925","2841台開","110/07/26","元大-歸仁",20,0,20
"2926","2841台開","110/07/26","富邦-板橋",0,20,-20
"2927","2841台開","110/07/26","國泰-桃園",20,3,17
"2928","2841台開","110/07/26","元大-台中中港",0,19,-19
"2929","2841台開","110/07/26","新光-台中",15,0,15
"2930","2841台開","110/07/26","臺銀-臺南",0,18,-18
"2931","2841台開","110/07/26","群益金鼎-東門",11,0,11
"2932","2841台開","110/07/26","永豐金-敦南",3,19,-16
"2933","2841台開","110/07/26","華南永昌-內壢",11,0,11
"2934","2841台開","110/07/26","統一-桃園",0,13,-13
"2935","2841台開","110/07/26","元富-烏日",10,0,10
"2936","2841台開","110/07/26","國泰-台中",0,11,-11
"2937","2841台開","110/07/26","國泰-忠孝",10,2,8
"2938","2841台開","110/07/26","元大-福營",0,11,-11
"2939","2841台開","110/07/26","元大-潮州",6,0,6
"2940","2841台開","110/07/26","凱基-站前",0,10,-10
"2941","6207雷科","110/07/26","元大-向上",70,0,70
"2942","6207雷科","110/07/26","摩根大通",45,241,-196
"2943","6207雷科","110/07/26","國票-中和",67,5,62
"2944","6207雷科","110/07/26","華南永昌-台中",16,180,-164
"2945","6207雷科","110/07/26","永豐金-台南",63,2,61
"2946","6207雷科","110/07/26","瑞士信貸",4,69,-65
"2947","6207雷科","110/07/26","國泰-板橋",32,0,32
"2948","6207雷科","110/07/26","國票-天祥",11,76,-65
"2949","6207雷科","110/07/26","華南永昌-朴子",24,0,24
"2950","6207雷科","110/07/26","新加坡商瑞銀",15,78,-63
"2951","6207雷科","110/07/26","台新證券",35,12,23
"2952","6207雷科","110/07/26","凱基-台北",86,134,-48
"2953","6207雷科","110/07/26","永豐金-板盛",24,1,23
"2954","6207雷科","110/07/26","富邦-台中",58,100,-42
"2955","6207雷科","110/07/26","康和-台中",24,2,22
"2956","6207雷科","110/07/26","兆豐-大安",0,41,-41
"2957","6207雷科","110/07/26","台新-台南",22,2,20
"2958","6207雷科","110/07/26","群益金鼎-館前",0,40,-40
"2959","6207雷科","110/07/26","元大-大統",22,2,20
"2960","6207雷科","110/07/26","富邦-羅東",2,39,-37
"2961","6207雷科","110/07/26","元富-桃園",19,0,19
"2962","6207雷科","110/07/26","國票-台東",0,30,-30
"2963","6207雷科","110/07/26","高橋",17,0,17
"2964","6207雷科","110/07/26","凱基-士林",1,30,-29
"2965","6207雷科","110/07/26","元富-同大",30,13,17
"2966","6207雷科","110/07/26","元大-南京",3,31,-28
"2967","6207雷科","110/07/26","元大-內湖",17,0,17
"2968","6207雷科","110/07/26","宏遠-桃園",0,24,-24
"2969","6207雷科","110/07/26","永豐金-內湖",19,2,17
"2970","6207雷科","110/07/26","國票-和平",0,23,-23
"2971","3679新至陞","110/07/26","元富-板橋",16,0,16
"2972","3679新至陞","110/07/26","台新-台中",0,19,-19
"2973","3679新至陞","110/07/26","華南永昌-淡水",10,0,10
"2974","3679新至陞","110/07/26","元大-成功",0,10,-10
"2975","3679新至陞","110/07/26","光和-溪湖",8,0,8
"2976","3679新至陞","110/07/26","日進",0,9,-9
"2977","3679新至陞","110/07/26","宏遠-光隆",6,0,6
"2978","3679新至陞","110/07/26","臺銀-臺中",0,5,-5
"2979","3679新至陞","110/07/26","玉山-嘉義",5,0,5
"2980","3679新至陞","110/07/26","港商法國興業",0,4,-4
"2981","3679新至陞","110/07/26","元富-安南",3,0,3
"2982","3679新至陞","110/07/26","統一-新台中",0,3,-3
"2983","3679新至陞","110/07/26","摩根大通",4,1,3
"2984","3679新至陞","110/07/26","大慶-苗栗",1,3,-2
"2985","3679新至陞","110/07/26","凱基-台北",5,2,3
"2986","3679新至陞","110/07/26","元富-松德",0,2,-2
"2987","3679新至陞","110/07/26","凱基-站前",2,0,2
"2988","3679新至陞","110/07/26","富邦-仁愛",0,2,-2
"2989","3679新至陞","110/07/26","華南永昌",2,0,2
"2990","3679新至陞","110/07/26","元大-文心興安",0,2,-2
"2991","3679新至陞","110/07/26","元大-上新莊",2,0,2
"2992","3679新至陞","110/07/26","永豐金證券",0,2,-2
"2993","3679新至陞","110/07/26","美林",4,3,1
"2994","3679新至陞","110/07/26","臺銀-高雄",0,1,-1
"2995","3679新至陞","110/07/26","台灣摩根士丹利",2,1,1
"2996","3679新至陞","110/07/26","台灣企銀-屏東",0,1,-1
"2997","3679新至陞","110/07/26","美商高盛",1,0,1
"2998","3679新至陞","110/07/26","大慶-富順",0,1,-1
"2999","3679新至陞","110/07/26","富邦-台北",1,0,1
"3000","3679新至陞","110/07/26","統一-彰化",0,1,-1
"3001","2727王品","110/07/26","兆豐-南京",300,0,300
"3002","2727王品","110/07/26","元富-安南",0,62,-62
"3003","2727王品","110/07/26","凱基-台北",74,29,45
"3004","2727王品","110/07/26","瑞士信貸",0,44,-44
"3005","2727王品","110/07/26","富邦-建國",25,2,23
"3006","2727王品","110/07/26","新加坡商瑞銀",0,44,-44
"3007","2727王品","110/07/26","台灣摩根士丹利",22,0,22
"3008","2727王品","110/07/26","統一",11,54,-43
"3009","2727王品","110/07/26","永豐金-屏東",14,1,13
"3010","2727王品","110/07/26","美林",4,39,-35
"3011","2727王品","110/07/26","富邦-桃園",12,1,11
"3012","2727王品","110/07/26","第一金",0,30,-30
"3013","2727王品","110/07/26","日盛-鳳山",11,1,10
"3014","2727王品","110/07/26","康和-台中",0,30,-30
"3015","2727王品","110/07/26","元富-城中",10,0,10
"3016","2727王品","110/07/26","國泰證券",1,31,-30
"3017","2727王品","110/07/26","元大-龍潭",11,1,10
"3018","2727王品","110/07/26","元大證券",37,67,-30
"3019","2727王品","110/07/26","新光-台中",15,6,9
"3020","2727王品","110/07/26","康和",1,29,-28
"3021","2727王品","110/07/26","富邦-台中",10,1,9
"3022","2727王品","110/07/26","永豐金證券",0,27,-27
"3023","2727王品","110/07/26","元大-基隆孝二",10,1,9
"3024","2727王品","110/07/26","安泰",1,26,-25
"3025","2727王品","110/07/26","臺銀-臺中",10,2,8
"3026","2727王品","110/07/26","永豐金-古亭",2,20,-18
"3027","2727王品","110/07/26","元大-花蓮",8,0,8
"3028","2727王品","110/07/26","國票-天祥",0,16,-16
"3029","2727王品","110/07/26","元大-斗信",9,1,8
"3030","2727王品","110/07/26","摩根大通",17,33,-16
"3031","1570力肯","110/07/26","元大-民雄",10,0,10
"3032","1570力肯","110/07/26","元大-高雄",0,33,-33
"3033","1570力肯","110/07/26","新光-台中",10,1,9
"3034","1570力肯","110/07/26","日盛-宜蘭",0,8,-8
"3035","1570力肯","110/07/26","富邦-陽明",9,0,9
"3036","1570力肯","110/07/26","美林",0,5,-5
"3037","1570力肯","110/07/26","大慶-蘆洲",8,0,8
"3038","1570力肯","110/07/26","凱基-永康",0,5,-5
"3039","1570力肯","110/07/26","福勝",8,0,8
"3040","1570力肯","110/07/26","台新證券",0,4,-4
"3041","1570力肯","110/07/26","凱基-桃園",7,0,7
"3042","1570力肯","110/07/26","元大-汐止",0,4,-4
"3043","1570力肯","110/07/26","中國信託-永康",3,0,3
"3044","1570力肯","110/07/26","元大-桃興",0,3,-3
"3045","1570力肯","110/07/26","兆豐-台中港",3,0,3
"3046","1570力肯","110/07/26","元富-吉利",0,2,-2
"3047","1570力肯","110/07/26","國票-北高雄",3,0,3
"3048","1570力肯","110/07/26","國泰-板橋",0,2,-2
"3049","1570力肯","110/07/26","富邦-員林",3,0,3
"3050","1570力肯","110/07/26","元大-台中",0,2,-2
"3051","1570力肯","110/07/26","瑞士信貸",2,0,2
"3052","1570力肯","110/07/26","元大-西螺",0,2,-2
"3053","1570力肯","110/07/26","大昌-樹林",2,0,2
"3054","1570力肯","110/07/26","元大-苑裡",0,2,-2
"3055","1570力肯","110/07/26","兆豐-忠孝",2,0,2
"3056","1570力肯","110/07/26","合庫-三重",0,1,-1
"3057","1570力肯","110/07/26","新光",2,0,2
"3058","1570力肯","110/07/26","臺銀-臺南",0,1,-1
"3059","1570力肯","110/07/26","凱基-台北",2,0,2
"3060","1570力肯","110/07/26","元富-永和",0,1,-1
"3061","6180橘子","110/07/26","凱基-台北",121,1,120
"3062","6180橘子","110/07/26","元大-竹山",0,35,-35
"3063","6180橘子","110/07/26","新加坡商瑞銀",71,2,69
"3064","6180橘子","110/07/26","元大-和平",0,30,-30
"3065","6180橘子","110/07/26","摩根大通",70,4,66
"3066","6180橘子","110/07/26","元大-草屯",3,27,-24
"3067","6180橘子","110/07/26","美林",33,0,33
"3068","6180橘子","110/07/26","華南永昌-高雄",0,21,-21
"3069","6180橘子","110/07/26","台灣摩根士丹利",20,4,16
"3070","6180橘子","110/07/26","兆豐-埔墘",0,18,-18
"3071","6180橘子","110/07/26","合庫-高雄",11,0,11
"3072","6180橘子","110/07/26","元富-林園",0,17,-17
"3073","6180橘子","110/07/26","港商野村",10,0,10
"3074","6180橘子","110/07/26","元富-成功",0,16,-16
"3075","6180橘子","110/07/26","富邦-宜蘭",10,0,10
"3076","6180橘子","110/07/26","群益金鼎-台南",0,13,-13
"3077","6180橘子","110/07/26","統一-彰化",10,1,9
"3078","6180橘子","110/07/26","元大-開元",0,13,-13
"3079","6180橘子","110/07/26","兆豐-北高雄",9,1,8
"3080","6180橘子","110/07/26","富邦-台中",0,12,-12
"3081","6180橘子","110/07/26","元大-新店中正",10,2,8
"3082","6180橘子","110/07/26","(牛牛牛)亞-鑫豐",1,12,-11
"3083","6180橘子","110/07/26","國泰-敦南",10,3,7
"3084","6180橘子","110/07/26","台新-台南",0,11,-11
"3085","6180橘子","110/07/26","合庫-自強",5,0,5
"3086","6180橘子","110/07/26","聯邦-興中",0,11,-11
"3087","6180橘子","110/07/26","大慶-蘆洲",5,0,5
"3088","6180橘子","110/07/26","日盛-中和",0,10,-10
"3089","6180橘子","110/07/26","統一-中壢",5,0,5
"3090","6180橘子","110/07/26","康和-台北",0,10,-10
"3091","2390云辰","110/07/26","元大-大同",311,3,308
"3092","2390云辰","110/07/26","摩根大通",139,570,-431
"3093","2390云辰","110/07/26","華南永昌-鳳山",276,4,272
"3094","2390云辰","110/07/26","美林",103,243,-140
"3095","2390云辰","110/07/26","永豐金-竹北",201,6,195
"3096","2390云辰","110/07/26","元大-彰化民生",0,117,-117
"3097","2390云辰","110/07/26","富邦-左營",107,17,90
"3098","2390云辰","110/07/26","元富-中港",0,102,-102
"3099","2390云辰","110/07/26","元富-高雄",82,5,77
"3100","2390云辰","110/07/26","凱基-台北",161,249,-88
"3101","2390云辰","110/07/26","元大-太平",75,10,65
"3102","2390云辰","110/07/26","國票-新莊",15,78,-63
"3103","2390云辰","110/07/26","元大-大益",63,13,50
"3104","2390云辰","110/07/26","第一金-豐原",1,59,-58
"3105","2390云辰","110/07/26","元富-新竹",41,1,40
"3106","2390云辰","110/07/26","統一-竹南",5,48,-43
"3107","2390云辰","110/07/26","日盛-永康",42,4,38
"3108","2390云辰","110/07/26","第一金-台南",28,62,-34
"3109","2390云辰","110/07/26","群益金鼎-中壢",50,12,38
"3110","2390云辰","110/07/26","台灣摩根士丹利",38,70,-32
"3111","2390云辰","110/07/26","元大-鑫永和",54,18,36
"3112","2390云辰","110/07/26","群益金鼎-士林",20,52,-32
"3113","2390云辰","110/07/26","元富-同大",34,1,33
"3114","2390云辰","110/07/26","群益金鼎-延平",2,31,-29
"3115","2390云辰","110/07/26","致和-崇德",52,21,31
"3116","2390云辰","110/07/26","凱基-豐中",12,40,-28
"3117","2390云辰","110/07/26","永豐金-松山",32,2,30
"3118","2390云辰","110/07/26","富邦-中壢",19,47,-28
"3119","2390云辰","110/07/26","凱基-三重",36,8,28
"3120","2390云辰","110/07/26","統一-基隆",2,27,-25
"3121","2363矽統","110/07/20","第一金-忠孝",400,115,285
"3122","2363矽統","110/07/20","國票-長城",3,452,-449
"3123","2363矽統","110/07/20","第一金-高雄",188,0,188
"3124","2363矽統","110/07/20","美林",158,531,-373
"3125","2363矽統","110/07/20","凱基-高美館",199,14,185
"3126","2363矽統","110/07/20","台新-左楠",13,310,-297
"3127","2363矽統","110/07/20","凱基-台北",434,326,108
"3128","2363矽統","110/07/20","玉山-台大",4,228,-224
"3129","2363矽統","110/07/20","元富-松德",105,0,105
"3130","2363矽統","110/07/20","群益金鼎-大甲",11,227,-216
"3131","2363矽統","110/07/20","元大-竹科",109,7,102
"3132","2363矽統","110/07/20","群益金鼎-中港",2,111,-109
"3133","2363矽統","110/07/20","元大-成功",102,2,100
"3134","2363矽統","110/07/20","元大-大天母",0,109,-109
"3135","2363矽統","110/07/20","富邦-仁愛",116,17,99
"3136","2363矽統","110/07/20","國泰-敦南",114,218,-104
"3137","2363矽統","110/07/20","元大-上新莊",102,16,86
"3138","2363矽統","110/07/20","港商野村",250,350,-100
"3139","2363矽統","110/07/20","台新證券",286,208,78
"3140","2363矽統","110/07/20","康和-澎湖",0,90,-90
"3141","2363矽統","110/07/20","元大-新營",81,9,72
"3142","2363矽統","110/07/20","凱基-中壢",15,99,-84
"3143","2363矽統","110/07/20","華南永昌-鳳山",76,5,71
"3144","2363矽統","110/07/20","元大-學甲",0,81,-81
"3145","2363矽統","110/07/20","富邦-員林",65,2,63
"3146","2363矽統","110/07/20","凱基-三重",22,91,-69
"3147","2363矽統","110/07/20","元富-成功",67,6,61
"3148","2363矽統","110/07/20","永豐金-嘉義",24,92,-68
"3149","2363矽統","110/07/20","新光-新竹",62,1,61
"3150","2363矽統","110/07/20","大慶-蘆洲",23,89,-66
"3151","8112至上","110/07/20","摩根大通",1226,293,933
"3152","8112至上","110/07/20","凱基-三重",27,502,-475
"3153","8112至上","110/07/20","新加坡商瑞銀",358,83,275
"3154","8112至上","110/07/20","宏遠證券",0,418,-418
"3155","8112至上","110/07/20","台灣摩根士丹利",159,9,150
"3156","8112至上","110/07/20","台新-台中",11,291,-280
"3157","8112至上","110/07/20","統一-新竹",115,5,110
"3158","8112至上","110/07/20","美林",44,194,-150
"3159","8112至上","110/07/20","新光",233,126,107
"3160","8112至上","110/07/20","凱基-新莊",0,100,-100
"3161","8112至上","110/07/20","凱基-台北",367,260,107
"3162","8112至上","110/07/20","富邦-永和",14,104,-90
"3163","8112至上","110/07/20","兆豐-西螺",104,10,94
"3164","8112至上","110/07/20","國票-敦北法人",4,88,-84
"3165","8112至上","110/07/20","永豐金-中正",87,6,81
"3166","8112至上","110/07/20","凱基-市政",3,80,-77
"3167","8112至上","110/07/20","富邦-新店",102,24,78
"3168","8112至上","110/07/20","台新證券",68,142,-74
"3169","8112至上","110/07/20","元大-大同",83,5,78
"3170","8112至上","110/07/20","永豐金-中壢",11,80,-69
"3171","8112至上","110/07/20","富邦-園區",64,2,62
"3172","8112至上","110/07/20","永豐金-台南",22,91,-69
"3173","8112至上","110/07/20","新光-台南",73,14,59
"3174","8112至上","110/07/20","元大-大雅",22,87,-65
"3175","8112至上","110/07/20","統一-台中",60,2,58
"3176","8112至上","110/07/20","光和",10,67,-57
"3177","8112至上","110/07/20","元大-北成功",58,4,54
"3178","8112至上","110/07/20","元大-竹科",27,74,-47
"3179","8112至上","110/07/20","元富-林園",53,0,53
"3180","8112至上","110/07/20","兆豐-公益",1,47,-46
"3181","1570力肯","110/07/20","國票-北高雄",36,0,36
"3182","1570力肯","110/07/20","國泰-敦南",0,19,-19
"3183","1570力肯","110/07/20","群益金鼎-高雄",16,0,16
"3184","1570力肯","110/07/20","中國信託-永康",0,12,-12
"3185","1570力肯","110/07/20","臺銀-鳳山",10,0,10
"3186","1570力肯","110/07/20","第一金-路竹",0,10,-10
"3187","1570力肯","110/07/20","群益金鼎-新竹",6,0,6
"3188","1570力肯","110/07/20","福勝",0,10,-10
"3189","1570力肯","110/07/20","大昌-樹林",5,0,5
"3190","1570力肯","110/07/20","群益金鼎-板橋",0,10,-10
"3191","1570力肯","110/07/20","華南永昌-楠梓",5,0,5
"3192","1570力肯","110/07/20","日盛-鳳山",0,8,-8
"3193","1570力肯","110/07/20","元大-基隆孝二",5,0,5
"3194","1570力肯","110/07/20","永豐金-新竹",6,14,-8
"3195","1570力肯","110/07/20","元大-新竹經國",4,0,4
"3196","1570力肯","110/07/20","第一金-彰化",0,7,-7
"3197","1570力肯","110/07/20","土銀-高雄",2,0,2
"3198","1570力肯","110/07/20","元富-吉利",0,7,-7
"3199","1570力肯","110/07/20","台灣企銀-太平",2,0,2
"3200","1570力肯","110/07/20","台中銀-員林",0,7,-7
"3201","1570力肯","110/07/20","兆豐-忠孝",2,0,2
"3202","1570力肯","110/07/20","玉山證券",1,8,-7
"3203","1570力肯","110/07/20","玉山-城中",2,0,2
"3204","1570力肯","110/07/20","統一-三重",0,5,-5
"3205","1570力肯","110/07/20","國泰-板橋",2,0,2
"3206","1570力肯","110/07/20","光和-溪湖",0,3,-3
"3207","1570力肯","110/07/20","凱基-台北",2,0,2
"3208","1570力肯","110/07/20","康和-澎湖",0,3,-3
"3209","1570力肯","110/07/20","華南永昌-高雄",2,0,2
"3210","1570力肯","110/07/20","摩根大通",0,2,-2
"3211","2929淘帝","110/07/20","玉山-新竹",59,0,59
"3212","2929淘帝","110/07/20","臺銀",0,45,-45
"3213","2929淘帝","110/07/20","兆豐-新莊",50,0,50
"3214","2929淘帝","110/07/20","光和-嘉義",0,29,-29
"3215","2929淘帝","110/07/20","元大-大甲",30,0,30
"3216","2929淘帝","110/07/20","新加坡商瑞銀",27,55,-28
"3217","2929淘帝","110/07/20","元大-民生",29,0,29
"3218","2929淘帝","110/07/20","華南永昌-潮州",0,20,-20
"3219","2929淘帝","110/07/20","元大-員林",20,0,20
"3220","2929淘帝","110/07/20","玉山-高雄",0,14,-14
"3221","2929淘帝","110/07/20","元富-台南",18,0,18
"3222","2929淘帝","110/07/20","富邦-南屯",2,13,-11
"3223","2929淘帝","110/07/20","港商野村",63,50,13
"3224","2929淘帝","110/07/20","高橋-龍潭",0,10,-10
"3225","2929淘帝","110/07/20","高橋",10,0,10
"3226","2929淘帝","110/07/20","台新-建北",0,10,-10
"3227","2929淘帝","110/07/20","元富-林園",10,0,10
"3228","2929淘帝","110/07/20","群益金鼎-台中",0,10,-10
"3229","2929淘帝","110/07/20","玉山-台南",10,0,10
"3230","2929淘帝","110/07/20","華南永昌-苗栗",0,10,-10
"3231","2929淘帝","110/07/20","群益金鼎-士林",10,0,10
"3232","2929淘帝","110/07/20","群益金鼎-西松",0,9,-9
"3233","2929淘帝","110/07/20","凱基-台北",16,6,10
"3234","2929淘帝","110/07/20","台新-三民",0,8,-8
"3235","2929淘帝","110/07/20","合庫證券",9,0,9
"3236","2929淘帝","110/07/20","群益金鼎",0,8,-8
"3237","2929淘帝","110/07/20","永豐金證券",9,2,7
"3238","2929淘帝","110/07/20","富邦-永和",0,7,-7
"3239","2929淘帝","110/07/20","凱基-基隆",6,0,6
"3240","2929淘帝","110/07/20","國泰-台中",6,12,-6
"3241","5410國眾","110/07/20","日盛-內湖",27,0,27
"3242","5410國眾","110/07/20","永豐金-內湖",0,23,-23
"3243","5410國眾","110/07/20","富邦-新營",20,0,20
"3244","5410國眾","110/07/20","兆豐-台中港",0,20,-20
"3245","5410國眾","110/07/20","大昌",17,0,17
"3246","5410國眾","110/07/20","元富-嘉義",0,15,-15
"3247","5410國眾","110/07/20","永豐金-台南",17,0,17
"3248","5410國眾","110/07/20","元富-吉利",0,11,-11
"3249","5410國眾","110/07/20","凱基-站前",15,0,15
"3250","5410國眾","110/07/20","凱基-長庚",0,10,-10
"3251","5410國眾","110/07/20","凱基-竹北",11,0,11
"3252","5410國眾","110/07/20","元大-八德",0,10,-10
"3253","5410國眾","110/07/20","元富-民權",9,0,9
"3254","5410國眾","110/07/20","元大-天母",0,10,-10
"3255","5410國眾","110/07/20","群益金鼎-嘉義",6,0,6
"3256","5410國眾","110/07/20","國泰-桃園",0,9,-9
"3257","5410國眾","110/07/20","元大-土城學府",6,0,6
"3258","5410國眾","110/07/20","新光",5,12,-7
"3259","5410國眾","110/07/20","第一金-豐原",5,0,5
"3260","5410國眾","110/07/20","玉山-桃園",0,7,-7
"3261","5410國眾","110/07/20","華南永昌-林口",5,0,5
"3262","5410國眾","110/07/20","玉山-雙和",0,6,-6
"3263","5410國眾","110/07/20","元大-博愛",5,0,5
"3264","5410國眾","110/07/20","臺銀-臺南",0,5,-5
"3265","5410國眾","110/07/20","元大-竹南",5,0,5
"3266","5410國眾","110/07/20","彰銀-七賢",0,5,-5
"3267","5410國眾","110/07/20","元大-新店中正",5,0,5
"3268","5410國眾","110/07/20","宏遠證券",0,5,-5
"3269","5410國眾","110/07/20","元富-烏日",4,0,4
"3270","5410國眾","110/07/20","摩根大通",0,5,-5
"3271","2841台開","110/07/20","中國信託-忠孝",145,0,145
"3272","2841台開","110/07/20","凱基-松山",0,100,-100
"3273","2841台開","110/07/20","第一金-台中",68,0,68
"3274","2841台開","110/07/20","第一金-自由",0,33,-33
"3275","2841台開","110/07/20","美商高盛",37,0,37
"3276","2841台開","110/07/20","港商野村",0,29,-29
"3277","2841台開","110/07/20","台中銀",32,0,32
"3278","2841台開","110/07/20","國泰-敦南",11,31,-20
"3279","2841台開","110/07/20","台新-台中",20,0,20
"3280","2841台開","110/07/20","華南永昌-台中",0,20,-20
"3281","2841台開","110/07/20","凱基-東港",10,0,10
"3282","2841台開","110/07/20","元大-發財",0,15,-15
"3283","2841台開","110/07/20","大昌-安康",10,3,7
"3284","2841台開","110/07/20","元大-福營",9,23,-14
"3285","2841台開","110/07/20","豐農",7,0,7
"3286","2841台開","110/07/20","永豐金-敦南",5,18,-13
"3287","2841台開","110/07/20","元大-歸仁",7,0,7
"3288","2841台開","110/07/20","統一-城中",0,11,-11
"3289","2841台開","110/07/20","日盛-木柵",5,0,5
"3290","2841台開","110/07/20","日盛-台南",0,10,-10
"3291","2841台開","110/07/20","台新-台南",4,0,4
"3292","2841台開","110/07/20","兆豐-寶成",0,10,-10
"3293","2841台開","110/07/20","日盛證券",3,0,3
"3294","2841台開","110/07/20","國票-中港",0,10,-10
"3295","2841台開","110/07/20","台新證券",8,5,3
"3296","2841台開","110/07/20","群益金鼎",0,10,-10
"3297","2841台開","110/07/20","元大-沙鹿",3,0,3
"3298","2841台開","110/07/20","玉山證券",1,10,-9
"3299","2841台開","110/07/20","國泰-台中",2,0,2
"3300","2841台開","110/07/20","大昌-新店",0,6,-6
"3301","6207雷科","110/07/20","元大-西門",100,4,96
"3302","6207雷科","110/07/20","永豐金-內湖",0,109,-109
"3303","6207雷科","110/07/20","凱基-復興",50,0,50
"3304","6207雷科","110/07/20","國泰證券",0,90,-90
"3305","6207雷科","110/07/20","凱基-台北",47,1,46
"3306","6207雷科","110/07/20","元大-頭份",0,55,-55
"3307","6207雷科","110/07/20","玉山-城中",43,1,42
"3308","6207雷科","110/07/20","永豐金-虎尾",0,50,-50
"3309","6207雷科","110/07/20","華南永昌-長虹",44,5,39
"3310","6207雷科","110/07/20","元富-世貿",0,33,-33
"3311","6207雷科","110/07/20","凱基-板橋",38,1,37
"3312","6207雷科","110/07/20","元大-南崁",0,22,-22
"3313","6207雷科","110/07/20","元富-信義",39,3,36
"3314","6207雷科","110/07/20","永豐金-鳳山",0,21,-21
"3315","6207雷科","110/07/20","元富-彰化",35,0,35
"3316","6207雷科","110/07/20","永豐金-三重",6,27,-21
"3317","6207雷科","110/07/20","凱基-高美館",34,0,34
"3318","6207雷科","110/07/20","第一金-澎湖",0,20,-20
"3319","6207雷科","110/07/20","富邦-中壢",26,2,24
"3320","6207雷科","110/07/20","群益金鼎-東大",0,20,-20
"3321","6207雷科","110/07/20","大昌-桃園",23,0,23
"3322","6207雷科","110/07/20","兆豐-民生",0,19,-19
"3323","6207雷科","110/07/20","元大-四維",39,17,22
"3324","6207雷科","110/07/20","元大-北成功",1,20,-19
"3325","6207雷科","110/07/20","台灣摩根士丹利",18,0,18
"3326","6207雷科","110/07/20","元大-虎尾",1,18,-17
"3327","6207雷科","110/07/20","國票-中和",16,0,16
"3328","6207雷科","110/07/20","元大-文心興安",0,15,-15
"3329","6207雷科","110/07/20","永豐金-大園",16,0,16
"3330","6207雷科","110/07/20","瑞士信貸",0,14,-14
"3331","3679新至陞","110/07/20","國票-敦北法人",18,0,18
"3332","3679新至陞","110/07/20","華南永昌-台中",0,32,-32
"3333","3679新至陞","110/07/20","台中銀-員林",17,3,14
"3334","3679新至陞","110/07/20","凱基-台北",12,32,-20
"3335","3679新至陞","110/07/20","群益金鼎-高盛",13,0,13
"3336","3679新至陞","110/07/20","摩根大通",2,14,-12
"3337","3679新至陞","110/07/20","康和-澎湖",8,0,8
"3338","3679新至陞","110/07/20","國泰-桃園",0,11,-11
"3339","3679新至陞","110/07/20","台新證券",6,0,6
"3340","3679新至陞","110/07/20","群益金鼎-台南",0,10,-10
"3341","3679新至陞","110/07/20","宏遠-光隆",4,0,4
"3342","3679新至陞","110/07/20","群益金鼎-大安",0,10,-10
"3343","3679新至陞","110/07/20","玉山-大里",4,0,4
"3344","3679新至陞","110/07/20","永豐金證券",4,14,-10
"3345","3679新至陞","110/07/20","台中銀-豐原",3,0,3
"3346","3679新至陞","110/07/20","兆豐-大同",1,6,-5
"3347","3679新至陞","110/07/20","玉山-新莊",3,0,3
"3348","3679新至陞","110/07/20","群益金鼎-館前",0,4,-4
"3349","3679新至陞","110/07/20","凱基-中山",3,0,3
"3350","3679新至陞","110/07/20","富邦-南屯",0,4,-4
"3351","3679新至陞","110/07/20","富邦-台北",3,0,3
"3352","3679新至陞","110/07/20","瑞士信貸",3,6,-3
"3353","3679新至陞","110/07/20","元大-板橋",3,0,3
"3354","3679新至陞","110/07/20","國泰-板橋",0,3,-3
"3355","3679新至陞","110/07/20","日盛-八德",2,0,2
"3356","3679新至陞","110/07/20","富邦-中壢",1,4,-3
"3357","3679新至陞","110/07/20","日盛-復興",2,0,2
"3358","3679新至陞","110/07/20","台灣企銀",0,2,-2
"3359","3679新至陞","110/07/20","康和-板橋",2,0,2
"3360","3679新至陞","110/07/20","日盛-大墩",0,2,-2
"3361","2727王品","110/07/20","兆豐-南京",200,0,200
"3362","2727王品","110/07/20","凱基-市政",1,75,-74
"3363","2727王品","110/07/20","富邦證券",88,0,88
"3364","2727王品","110/07/20","美商高盛",6,38,-32
"3365","2727王品","110/07/20","台新證券",142,55,87
"3366","2727王品","110/07/20","富邦-陽明",7,38,-31
"3367","2727王品","110/07/20","瑞士信貸",50,0,50
"3368","2727王品","110/07/20","永豐金-中正",3,34,-31
"3369","2727王品","110/07/20","港商野村",106,57,49
"3370","2727王品","110/07/20","永豐金-潮州",0,31,-31
"3371","2727王品","110/07/20","凱基-台北",67,27,40
"3372","2727王品","110/07/20","兆豐-大安",0,30,-30
"3373","2727王品","110/07/20","永豐金-大園",29,2,27
"3374","2727王品","110/07/20","摩根大通",50,73,-23
"3375","2727王品","110/07/20","康和-高雄",20,0,20
"3376","2727王品","110/07/20","日盛證券",4,24,-20
"3377","2727王品","110/07/20","第一金-高雄",20,3,17
"3378","2727王品","110/07/20","凱基-大里",0,20,-20
"3379","2727王品","110/07/20","富邦-板橋",21,4,17
"3380","2727王品","110/07/20","群益金鼎-大甲",0,18,-18
"3381","2727王品","110/07/20","永豐金-桃盛",15,0,15
"3382","2727王品","110/07/20","統一",18,29,-11
"3383","2727王品","110/07/20","凱基",13,0,13
"3384","2727王品","110/07/20","國泰-台中",12,23,-11
"3385","2727王品","110/07/20","新加坡商瑞銀",23,11,12
"3386","2727王品","110/07/20","元大-彰化",0,11,-11
"3387","2727王品","110/07/20","亞東",10,0,10
"3388","2727王品","110/07/20","國泰-館前",4,14,-10
"3389","2727王品","110/07/20","康和-台中",13,4,9
"3390","2727王品","110/07/20","元大-學甲",0,10,-10
"3391","1570力肯","110/07/20","國票-北高雄",36,0,36
"3392","1570力肯","110/07/20","國泰-敦南",0,19,-19
"3393","1570力肯","110/07/20","群益金鼎-高雄",16,0,16
"3394","1570力肯","110/07/20","中國信託-永康",0,12,-12
"3395","1570力肯","110/07/20","臺銀-鳳山",10,0,10
"3396","1570力肯","110/07/20","第一金-路竹",0,10,-10
"3397","1570力肯","110/07/20","群益金鼎-新竹",6,0,6
"3398","1570力肯","110/07/20","福勝",0,10,-10
"3399","1570力肯","110/07/20","大昌-樹林",5,0,5
"3400","1570力肯","110/07/20","群益金鼎-板橋",0,10,-10
"3401","1570力肯","110/07/20","華南永昌-楠梓",5,0,5
"3402","1570力肯","110/07/20","日盛-鳳山",0,8,-8
"3403","1570力肯","110/07/20","元大-基隆孝二",5,0,5
"3404","1570力肯","110/07/20","永豐金-新竹",6,14,-8
"3405","1570力肯","110/07/20","元大-新竹經國",4,0,4
"3406","1570力肯","110/07/20","第一金-彰化",0,7,-7
"3407","1570力肯","110/07/20","土銀-高雄",2,0,2
"3408","1570力肯","110/07/20","元富-吉利",0,7,-7
"3409","1570力肯","110/07/20","台灣企銀-太平",2,0,2
"3410","1570力肯","110/07/20","台中銀-員林",0,7,-7
"3411","1570力肯","110/07/20","兆豐-忠孝",2,0,2
"3412","1570力肯","110/07/20","玉山證券",1,8,-7
"3413","1570力肯","110/07/20","玉山-城中",2,0,2
"3414","1570力肯","110/07/20","統一-三重",0,5,-5
"3415","1570力肯","110/07/20","國泰-板橋",2,0,2
"3416","1570力肯","110/07/20","光和-溪湖",0,3,-3
"3417","1570力肯","110/07/20","凱基-台北",2,0,2
"3418","1570力肯","110/07/20","康和-澎湖",0,3,-3
"3419","1570力肯","110/07/20","華南永昌-高雄",2,0,2
"3420","1570力肯","110/07/20","摩根大通",0,2,-2
"3421","6180橘子","110/07/20","摩根大通",89,31,58
"3422","6180橘子","110/07/20","群益金鼎-中山",0,80,-80
"3423","6180橘子","110/07/20","美商高盛",27,0,27
"3424","6180橘子","110/07/20","台中銀-台北",0,30,-30
"3425","6180橘子","110/07/20","新加坡商瑞銀",28,1,27
"3426","6180橘子","110/07/20","日盛-新莊",1,22,-21
"3427","6180橘子","110/07/20","新光",41,16,25
"3428","6180橘子","110/07/20","元富-緯城",2,20,-18
"3429","6180橘子","110/07/20","日盛-文化",21,0,21
"3430","6180橘子","110/07/20","日盛-新竹",2,15,-13
"3431","6180橘子","110/07/20","元富-潮州",20,0,20
"3432","6180橘子","110/07/20","元大-汐止",0,12,-12
"3433","6180橘子","110/07/20","凱基-台北",31,11,20
"3434","6180橘子","110/07/20","元大-豐原站前",0,12,-12
"3435","6180橘子","110/07/20","元大-草屯",18,0,18
"3436","6180橘子","110/07/20","德信-中正",0,10,-10
"3437","6180橘子","110/07/20","花旗環球",13,0,13
"3438","6180橘子","110/07/20","新光-台南",0,10,-10
"3439","6180橘子","110/07/20","元大-桃園",12,0,12
"3440","6180橘子","110/07/20","玉山-雙和",0,10,-10
"3441","6180橘子","110/07/20","群益金鼎",10,0,10
"3442","6180橘子","110/07/20","元大-四維",0,10,-10
"3443","6180橘子","110/07/20","元大-高雄",10,0,10
"3444","6180橘子","110/07/20","元大-永春",2,12,-10
"3445","6180橘子","110/07/20","群益金鼎-嘉義",9,0,9
"3446","6180橘子","110/07/20","凱基-高美館",0,8,-8
"3447","6180橘子","110/07/20","富邦-嘉義",9,0,9
"3448","6180橘子","110/07/20","華南永昌",2,10,-8
"3449","6180橘子","110/07/20","元富-草屯",10,2,8
"3450","6180橘子","110/07/20","富邦-台北",0,8,-8
"3451","2390云辰","110/07/20","元大證券",6043,11,6032
"3452","2390云辰","110/07/20","華南永昌-鳳山",2,312,-310
"3453","2390云辰","110/07/20","兆豐-復興",998,0,998
"3454","2390云辰","110/07/20","台灣摩根士丹利",0,247,-247
"3455","2390云辰","110/07/20","富邦-嘉義",775,7,768
"3456","2390云辰","110/07/20","元大-復北",4,239,-235
"3457","2390云辰","110/07/20","統一-台中",350,6,344
"3458","2390云辰","110/07/20","富邦-建國",25,236,-211
"3459","2390云辰","110/07/20","兆豐-城中",240,0,240
"3460","2390云辰","110/07/20","元富-中港",0,202,-202
"3461","2390云辰","110/07/20","群益金鼎-館前",204,2,202
"3462","2390云辰","110/07/20","國泰-敦南",20,194,-174
"3463","2390云辰","110/07/20","凱基-大直",187,0,187
"3464","2390云辰","110/07/20","元大-土城學府",10,156,-146
"3465","2390云辰","110/07/20","永豐金證券",160,10,150
"3466","2390云辰","110/07/20","中國信託-松江",0,130,-130
"3467","2390云辰","110/07/20","日盛-高雄",104,2,102
"3468","2390云辰","110/07/20","凱基-基隆",0,130,-130
"3469","2390云辰","110/07/20","凱基-中山",100,3,97
"3470","2390云辰","110/07/20","永豐金-中正",1,117,-116
"3471","2390云辰","110/07/20","元大-基隆",85,7,78
"3472","2390云辰","110/07/20","富邦-陽明",1,94,-93
"3473","2390云辰","110/07/20","群益金鼎-東大",64,2,62
"3474","2390云辰","110/07/20","元大-潮州",20,112,-92
"3475","2390云辰","110/07/20","元大-前金",60,1,59
"3476","2390云辰","110/07/20","宏遠證券",0,89,-89
"3477","2390云辰","110/07/20","國票-北高雄",63,14,49
"3478","2390云辰","110/07/20","兆豐-台中",0,75,-75
"3479","2390云辰","110/07/20","群益金鼎-三重",40,6,34
"3480","2390云辰","110/07/20","新光",8,82,-74
"3481","2363矽統","110/07/19","第一金-忠孝",210,0,210
"3482","2363矽統","110/07/19","富邦-仁愛",32,575,-543
"3483","2363矽統","110/07/19","中國信託-文心",191,9,182
"3484","2363矽統","110/07/19","新加坡商瑞銀",53,486,-433
"3485","2363矽統","110/07/19","華南永昌-鳳山",116,1,115
"3486","2363矽統","110/07/19","摩根大通",42,320,-278
"3487","2363矽統","110/07/19","元大-新竹",113,12,101
"3488","2363矽統","110/07/19","元大-竹科",3,201,-198
"3489","2363矽統","110/07/19","凱基-中山",89,1,88
"3490","2363矽統","110/07/19","元大-成功",7,183,-176
"3491","2363矽統","110/07/19","永豐金-嘉義",82,7,75
"3492","2363矽統","110/07/19","凱基-大里",0,150,-150
"3493","2363矽統","110/07/19","凱基-台南",72,4,68
"3494","2363矽統","110/07/19","瑞士信貸",80,215,-135
"3495","2363矽統","110/07/19","元富-城東",84,17,67
"3496","2363矽統","110/07/19","日盛-新莊",4,135,-131
"3497","2363矽統","110/07/19","群益金鼎-東湖",61,0,61
"3498","2363矽統","110/07/19","宏遠-桃園",20,150,-130
"3499","2363矽統","110/07/19","兆豐-中壢",55,0,55
"3500","2363矽統","110/07/19","凱基-三重",7,107,-100
"3501","2363矽統","110/07/19","康和-內湖",55,1,54
"3502","2363矽統","110/07/19","凱基-台北",384,476,-92
"3503","2363矽統","110/07/19","群益金鼎-桃園",55,2,53
"3504","2363矽統","110/07/19","合庫-台中",3,84,-81
"3505","2363矽統","110/07/19","群益金鼎-大興",50,0,50
"3506","2363矽統","110/07/19","致和-金華",1,80,-79
"3507","2363矽統","110/07/19","台新-台中",81,32,49
"3508","2363矽統","110/07/19","凱基-員林",5,77,-72
"3509","2363矽統","110/07/19","北城證券",58,10,48
"3510","2363矽統","110/07/19","華南永昌-合泰",2,70,-68
"3511","8112至上","110/07/19","摩根大通",1413,144,1269
"3512","8112至上","110/07/19","凱基-三重",3,600,-597
"3513","8112至上","110/07/19","凱基-台北",1053,266,787
"3514","8112至上","110/07/19","元大-府城",0,165,-165
"3515","8112至上","110/07/19","新加坡商瑞銀",523,2,521
"3516","8112至上","110/07/19","台灣企銀-台中",0,150,-150
"3517","8112至上","110/07/19","台灣摩根士丹利",487,8,479
"3518","8112至上","110/07/19","(牛牛牛)亞-鑫豐",26,119,-93
"3519","8112至上","110/07/19","美林",529,93,436
"3520","8112至上","110/07/19","永豐金-台南",15,95,-80
"3521","8112至上","110/07/19","港商野村",358,36,322
"3522","8112至上","110/07/19","亞東-板橋",2,81,-79
"3523","8112至上","110/07/19","美商高盛",276,3,273
"3524","8112至上","110/07/19","陽信",0,70,-70
"3525","8112至上","110/07/19","兆豐-公益",180,7,173
"3526","8112至上","110/07/19","元富-佳里",0,69,-69
"3527","8112至上","110/07/19","國泰-板橋",116,15,101
"3528","8112至上","110/07/19","臺銀-鳳山",7,72,-65
"3529","8112至上","110/07/19","凱基-新莊",100,1,99
"3530","8112至上","110/07/19","兆豐-竹北",4,65,-61
"3531","8112至上","110/07/19","凱基-市政",89,0,89
"3532","8112至上","110/07/19","國泰-新莊",2,62,-60
"3533","8112至上","110/07/19","玉山證券",73,7,66
"3534","8112至上","110/07/19","元富-大裕",2,60,-58
"3535","8112至上","110/07/19","花旗環球",64,0,64
"3536","8112至上","110/07/19","臺灣企銀-桃園",0,55,-55
"3537","8112至上","110/07/19","合庫-台中",55,3,52
"3538","8112至上","110/07/19","康和-台南",4,59,-55
"3539","8112至上","110/07/19","永豐金-中壢",50,1,49
"3540","8112至上","110/07/19","第一金-華江",3,55,-52
"3541","1570力肯","110/07/19","國票-北高雄",34,0,34
"3542","1570力肯","110/07/19","合庫-三重",0,8,-8
"3543","1570力肯","110/07/19","新光",30,3,27
"3544","1570力肯","110/07/19","元大-高雄",0,8,-8
"3545","1570力肯","110/07/19","凱基-台北",24,1,23
"3546","1570力肯","110/07/19","合庫-台中",0,7,-7
"3547","1570力肯","110/07/19","台灣摩根士丹利",7,0,7
"3548","1570力肯","110/07/19","臺銀-臺中",0,6,-6
"3549","1570力肯","110/07/19","元大-林森",5,0,5
"3550","1570力肯","110/07/19","摩根大通",6,11,-5
"3551","1570力肯","110/07/19","元大-士林",4,0,4
"3552","1570力肯","110/07/19","元富-緯城",0,4,-4
"3553","1570力肯","110/07/19","玉山證券",8,5,3
"3554","1570力肯","110/07/19","玉山-台大",0,4,-4
"3555","1570力肯","110/07/19","統一-城中",2,0,2
"3556","1570力肯","110/07/19","群益金鼎-三重",0,4,-4
"3557","1570力肯","110/07/19","元大-基隆孝二",2,0,2
"3558","1570力肯","110/07/19","凱基-鳳山",1,5,-4
"3559","1570力肯","110/07/19","土銀-建國",1,0,1
"3560","1570力肯","110/07/19","元大-板橋",0,4,-4
"3561","1570力肯","110/07/19","日盛-復興",1,0,1
"3562","1570力肯","110/07/19","日盛-和美",0,3,-3
"3563","1570力肯","110/07/19","瑞士信貸",1,0,1
"3564","1570力肯","110/07/19","元富-新店",2,5,-3
"3565","1570力肯","110/07/19","元富-四維",1,0,1
"3566","1570力肯","110/07/19","元大-新莊",0,3,-3
"3567","1570力肯","110/07/19","群益金鼎-北高雄",1,0,1
"3568","1570力肯","110/07/19","永豐金-敦南",0,3,-3
"3569","1570力肯","110/07/19","凱基-高美館",1,0,1
"3570","1570力肯","110/07/19","永豐金-台中",0,3,-3
"3571","2929淘帝","110/07/19","元大-民生",28,0,28
"3572","2929淘帝","110/07/19","元大-六合",0,40,-40
"3573","2929淘帝","110/07/19","宏遠-光隆",25,0,25
"3574","2929淘帝","110/07/19","新光-新竹",0,35,-35
"3575","2929淘帝","110/07/19","華南永昌-苗栗",20,0,20
"3576","2929淘帝","110/07/19","新加坡商瑞銀",1,30,-29
"3577","2929淘帝","110/07/19","元大-員林",20,0,20
"3578","2929淘帝","110/07/19","永豐金-永康",0,27,-27
"3579","2929淘帝","110/07/19","合庫-高雄",18,0,18
"3580","2929淘帝","110/07/19","凱基-復興",0,24,-24
"3581","2929淘帝","110/07/19","臺銀-鳳山",18,0,18
"3582","2929淘帝","110/07/19","日盛-豐原",0,22,-22
"3583","2929淘帝","110/07/19","日盛-雙和",17,0,17
"3584","2929淘帝","110/07/19","富邦-南屯",1,22,-21
"3585","2929淘帝","110/07/19","華南永昌-林口",15,0,15
"3586","2929淘帝","110/07/19","新光",1,21,-20
"3587","2929淘帝","110/07/19","元大-屏南",15,0,15
"3588","2929淘帝","110/07/19","華南永昌",0,20,-20
"3589","2929淘帝","110/07/19","台新-中壢",12,0,12
"3590","2929淘帝","110/07/19","富邦-竹東",2,22,-20
"3591","2929淘帝","110/07/19","新光-台中",11,0,11
"3592","2929淘帝","110/07/19","凱基-士林",0,16,-16
"3593","2929淘帝","110/07/19","凱基-台北",20,9,11
"3594","2929淘帝","110/07/19","福勝",0,15,-15
"3595","2929淘帝","110/07/19","富邦-台北",11,0,11
"3596","2929淘帝","110/07/19","港商野村",25,37,-12
"3597","2929淘帝","110/07/19","合庫-自強",10,0,10
"3598","2929淘帝","110/07/19","群益金鼎-建成",0,11,-11
"3599","2929淘帝","110/07/19","凱基-豐中",10,0,10
"3600","2929淘帝","110/07/19","華南永昌-朴子",0,11,-11
"3601","5410國眾","110/07/19","香港上海匯豐",28,0,28
"3602","5410國眾","110/07/19","群益金鼎-內湖",0,80,-80
"3603","5410國眾","110/07/19","大昌",26,0,26
"3604","5410國眾","110/07/19","永豐金-屏東",0,14,-14
"3605","5410國眾","110/07/19","兆豐-公益",20,0,20
"3606","5410國眾","110/07/19","永豐金-南京",0,10,-10
"3607","5410國眾","110/07/19","合庫-嘉義",10,0,10
"3608","5410國眾","110/07/19","元大-內湖",0,9,-9
"3609","5410國眾","110/07/19","台新-左楠",20,10,10
"3610","5410國眾","110/07/19","富邦-永和",0,8,-8
"3611","5410國眾","110/07/19","摩根大通",15,6,9
"3612","5410國眾","110/07/19","日盛-景美",0,6,-6
"3613","5410國眾","110/07/19","台灣企銀-民雄",8,0,8
"3614","5410國眾","110/07/19","光和",1,7,-6
"3615","5410國眾","110/07/19","元大-竹科",8,0,8
"3616","5410國眾","110/07/19","元大-士林",0,6,-6
"3617","5410國眾","110/07/19","凱基-台北",9,3,6
"3618","5410國眾","110/07/19","新光-台中",0,5,-5
"3619","5410國眾","110/07/19","元大-博愛",6,0,6
"3620","5410國眾","110/07/19","元大-景美",0,5,-5
"3621","5410國眾","110/07/19","台新-三民",5,0,5
"3622","5410國眾","110/07/19","大慶-蘆洲",0,4,-4
"3623","5410國眾","110/07/19","群益金鼎-中壢",5,0,5
"3624","5410國眾","110/07/19","中國信託-新竹",0,4,-4
"3625","5410國眾","110/07/19","群益金鼎-嘉義",5,0,5
"3626","5410國眾","110/07/19","新光",6,10,-4
"3627","5410國眾","110/07/19","日盛證券",4,0,4
"3628","5410國眾","110/07/19","元大-基隆孝二",0,4,-4
"3629","5410國眾","110/07/19","群益金鼎-新店",4,0,4
"3630","5410國眾","110/07/19","土銀-台中",0,3,-3
"3631","2841台開","110/07/19","元富-城東",150,0,150
"3632","2841台開","110/07/19","日進",0,80,-80
"3633","2841台開","110/07/19","中國信託-忠孝",80,0,80
"3634","2841台開","110/07/19","港商野村",0,77,-77
"3635","2841台開","110/07/19","凱基-台北",52,0,52
"3636","2841台開","110/07/19","摩根大通",0,41,-41
"3637","2841台開","110/07/19","美商高盛",48,0,48
"3638","2841台開","110/07/19","元大-三重",1,38,-37
"3639","2841台開","110/07/19","台中銀",43,0,43
"3640","2841台開","110/07/19","元大-福營",0,30,-30
"3641","2841台開","110/07/19","永豐金-豐原",32,0,32
"3642","2841台開","110/07/19","新光",4,28,-24
"3643","2841台開","110/07/19","豐農",20,0,20
"3644","2841台開","110/07/19","元大-竹科",0,22,-22
"3645","2841台開","110/07/19","台新-台中",30,10,20
"3646","2841台開","110/07/19","永豐金-敦南",33,55,-22
"3647","2841台開","110/07/19","華南永昌-新莊",20,0,20
"3648","2841台開","110/07/19","日盛-二林",0,15,-15
"3649","2841台開","110/07/19","第一金-台中",12,0,12
"3650","2841台開","110/07/19","元富-虎尾",0,15,-15
"3651","2841台開","110/07/19","國泰-台中",12,0,12
"3652","2841台開","110/07/19","華南永昌-世貿",0,15,-15
"3653","2841台開","110/07/19","日茂",10,0,10
"3654","2841台開","110/07/19","統一-三多",0,12,-12
"3655","2841台開","110/07/19","凱基-埔墘",10,0,10
"3656","2841台開","110/07/19","台中銀-豐原",0,10,-10
"3657","2841台開","110/07/19","永豐金-內湖",8,0,8
"3658","2841台開","110/07/19","元大-頭份",0,10,-10
"3659","2841台開","110/07/19","合庫-台中",7,0,7
"3660","2841台開","110/07/19","合庫-台南",0,8,-8
"3661","6207雷科","110/07/19","元富-信義",92,0,92
"3662","6207雷科","110/07/19","新加坡商瑞銀",5,104,-99
"3663","6207雷科","110/07/19","國泰證券",90,0,90
"3664","6207雷科","110/07/19","富邦-彰化",2,97,-95
"3665","6207雷科","110/07/19","元富-城中",80,4,76
"3666","6207雷科","110/07/19","永豐金-內湖",6,85,-79
"3667","6207雷科","110/07/19","元大-福營",71,5,66
"3668","6207雷科","110/07/19","摩根大通",102,164,-62
"3669","6207雷科","110/07/19","凱基-復興",60,0,60
"3670","6207雷科","110/07/19","瑞士信貸",0,51,-51
"3671","6207雷科","110/07/19","凱基-台北",91,46,45
"3672","6207雷科","110/07/19","凱基-板橋",10,55,-45
"3673","6207雷科","110/07/19","玉山-城中",42,0,42
"3674","6207雷科","110/07/19","華南永昌-大安",0,40,-40
"3675","6207雷科","110/07/19","華南永昌-長虹",40,0,40
"3676","6207雷科","110/07/19","群益金鼎-東大",1,40,-39
"3677","6207雷科","110/07/19","永豐金-羅東",38,0,38
"3678","6207雷科","110/07/19","台新-高雄",15,47,-32
"3679","6207雷科","110/07/19","日盛-忠孝",36,2,34
"3680","6207雷科","110/07/19","玉山-嘉義",1,32,-31
"3681","6207雷科","110/07/19","凱基-羅東",37,3,34
"3682","6207雷科","110/07/19","凱基-中港",0,30,-30
"3683","6207雷科","110/07/19","第一金-新竹",30,0,30
"3684","6207雷科","110/07/19","元大-六合",7,36,-29
"3685","6207雷科","110/07/19","玉山-數位",27,1,26
"3686","6207雷科","110/07/19","元富-花蓮",0,28,-28
"3687","6207雷科","110/07/19","凱基-長庚",22,0,22
"3688","6207雷科","110/07/19","群益金鼎-瑞豐",6,34,-28
"3689","6207雷科","110/07/19","台灣企銀-北高雄",20,0,20
"3690","6207雷科","110/07/19","新百王",0,26,-26
"3691","3679新至陞","110/07/19","元大-成功",7,0,7
"3692","3679新至陞","110/07/19","群益金鼎-大安",0,15,-15
"3693","3679新至陞","110/07/19","美商高盛",6,0,6
"3694","3679新至陞","110/07/19","凱基-民權",0,10,-10
"3695","3679新至陞","110/07/19","台新-高雄",5,0,5
"3696","3679新至陞","110/07/19","元大-西門",0,10,-10
"3697","3679新至陞","110/07/19","凱基-松山",5,0,5
"3698","3679新至陞","110/07/19","瑞士信貸",0,6,-6
"3699","3679新至陞","110/07/19","日盛-員林",4,0,4
"3700","3679新至陞","110/07/19","兆豐-高雄",0,6,-6
"3701","3679新至陞","110/07/19","台中銀-員林",4,0,4
"3702","3679新至陞","110/07/19","群益金鼎",0,5,-5
"3703","3679新至陞","110/07/19","(牛牛牛)亞-網路",3,0,3
"3704","3679新至陞","110/07/19","元大-永春",0,4,-4
"3705","3679新至陞","110/07/19","大昌-新店",3,0,3
"3706","3679新至陞","110/07/19","凱基-台北",2,5,-3
"3707","3679新至陞","110/07/19","凱基-埔墘",3,0,3
"3708","3679新至陞","110/07/19","港商法國興業",0,2,-2
"3709","3679新至陞","110/07/19","元大-板橋",3,0,3
"3710","3679新至陞","110/07/19","摩根大通",2,4,-2
"3711","3679新至陞","110/07/19","臺銀-金山",2,0,2
"3712","3679新至陞","110/07/19","元大-金門",0,2,-2
"3713","3679新至陞","110/07/19","日盛-樹林",2,0,2
"3714","3679新至陞","110/07/19","元大-土城",0,2,-2
"3715","3679新至陞","110/07/19","致和-東門",2,0,2
"3716","3679新至陞","110/07/19","日盛-鳳山",0,1,-1
"3717","3679新至陞","110/07/19","國票-敦北法人",2,0,2
"3718","3679新至陞","110/07/19","美林",1,2,-1
"3719","3679新至陞","110/07/19","台新證券",2,0,2
"3720","3679新至陞","110/07/19","第一金",0,1,-1
"3721","2727王品","110/07/19","台新證券",374,33,341
"3722","2727王品","110/07/19","台灣摩根士丹利",25,188,-163
"3723","2727王品","110/07/19","瑞士信貸",217,1,216
"3724","2727王品","110/07/19","港商野村",74,198,-124
"3725","2727王品","110/07/19","兆豐-南京",200,0,200
"3726","2727王品","110/07/19","統一",6,80,-74
"3727","2727王品","110/07/19","第一金",70,1,69
"3728","2727王品","110/07/19","合庫-台中",8,79,-71
"3729","2727王品","110/07/19","元大-小港",59,1,58
"3730","2727王品","110/07/19","凱基-台北",178,231,-53
"3731","2727王品","110/07/19","玉山-桃園",42,6,36
"3732","2727王品","110/07/19","富邦-中壢",3,52,-49
"3733","2727王品","110/07/19","永豐金-大園",31,0,31
"3734","2727王品","110/07/19","凱基-永華",0,43,-43
"3735","2727王品","110/07/19","兆豐-大安",30,0,30
"3736","2727王品","110/07/19","土銀-台中",0,36,-36
"3737","2727王品","110/07/19","美商高盛",38,15,23
"3738","2727王品","110/07/19","美林",8,41,-33
"3739","2727王品","110/07/19","康和-澎湖",23,1,22
"3740","2727王品","110/07/19","中國信託-忠孝",1,33,-32
"3741","2727王品","110/07/19","第一金-高雄",21,0,21
"3742","2727王品","110/07/19","新光",31,61,-30
"3743","2727王品","110/07/19","國票-內壢",21,0,21
"3744","2727王品","110/07/19","第一金-豐原",0,26,-26
"3745","2727王品","110/07/19","元大-桃興",19,3,16
"3746","2727王品","110/07/19","富邦-彰化",0,26,-26
"3747","2727王品","110/07/19","凱基-三重",16,1,15
"3748","2727王品","110/07/19","摩根大通",78,97,-19
"3749","2727王品","110/07/19","永豐金-南投",16,1,15
"3750","2727王品","110/07/19","國泰證券",2,21,-19
"3751","1570力肯","110/07/19","國票-北高雄",34,0,34
"3752","1570力肯","110/07/19","合庫-三重",0,8,-8
"3753","1570力肯","110/07/19","新光",30,3,27
"3754","1570力肯","110/07/19","元大-高雄",0,8,-8
"3755","1570力肯","110/07/19","凱基-台北",24,1,23
"3756","1570力肯","110/07/19","合庫-台中",0,7,-7
"3757","1570力肯","110/07/19","台灣摩根士丹利",7,0,7
"3758","1570力肯","110/07/19","臺銀-臺中",0,6,-6
"3759","1570力肯","110/07/19","元大-林森",5,0,5
"3760","1570力肯","110/07/19","摩根大通",6,11,-5
"3761","1570力肯","110/07/19","元大-士林",4,0,4
"3762","1570力肯","110/07/19","元富-緯城",0,4,-4
"3763","1570力肯","110/07/19","玉山證券",8,5,3
"3764","1570力肯","110/07/19","玉山-台大",0,4,-4
"3765","1570力肯","110/07/19","統一-城中",2,0,2
"3766","1570力肯","110/07/19","群益金鼎-三重",0,4,-4
"3767","1570力肯","110/07/19","元大-基隆孝二",2,0,2
"3768","1570力肯","110/07/19","凱基-鳳山",1,5,-4
"3769","1570力肯","110/07/19","土銀-建國",1,0,1
"3770","1570力肯","110/07/19","元大-板橋",0,4,-4
"3771","1570力肯","110/07/19","日盛-復興",1,0,1
"3772","1570力肯","110/07/19","日盛-和美",0,3,-3
"3773","1570力肯","110/07/19","瑞士信貸",1,0,1
"3774","1570力肯","110/07/19","元富-新店",2,5,-3
"3775","1570力肯","110/07/19","元富-四維",1,0,1
"3776","1570力肯","110/07/19","元大-新莊",0,3,-3
"3777","1570力肯","110/07/19","群益金鼎-北高雄",1,0,1
"3778","1570力肯","110/07/19","永豐金-敦南",0,3,-3
"3779","1570力肯","110/07/19","凱基-高美館",1,0,1
"3780","1570力肯","110/07/19","永豐金-台中",0,3,-3
"3781","6180橘子","110/07/19","兆豐證券",55,0,55
"3782","6180橘子","110/07/19","石橋證券",0,80,-80
"3783","6180橘子","110/07/19","凱基-台北",89,35,54
"3784","6180橘子","110/07/19","永豐金-大園",2,50,-48
"3785","6180橘子","110/07/19","合庫-自強",36,0,36
"3786","6180橘子","110/07/19","群益金鼎-屏東",0,40,-40
"3787","6180橘子","110/07/19","新光",50,25,25
"3788","6180橘子","110/07/19","國泰-敦南",0,19,-19
"3789","6180橘子","110/07/19","日盛-龍潭",20,0,20
"3790","6180橘子","110/07/19","日盛-新竹",2,20,-18
"3791","6180橘子","110/07/19","元大-斗信",16,1,15
"3792","6180橘子","110/07/19","摩根大通",17,35,-18
"3793","6180橘子","110/07/19","康和-台中",12,0,12
"3794","6180橘子","110/07/19","富邦-陽明",0,17,-17
"3795","6180橘子","110/07/19","國泰-台中",14,2,12
"3796","6180橘子","110/07/19","美商高盛",11,27,-16
"3797","6180橘子","110/07/19","富邦-嘉義",12,0,12
"3798","6180橘子","110/07/19","統一-宜蘭",0,14,-14
"3799","6180橘子","110/07/19","元大-草屯",12,0,12
"3800","6180橘子","110/07/19","凱基-興隆",0,12,-12
"3801","6180橘子","110/07/19","元富-桃園",11,0,11
"3802","6180橘子","110/07/19","台中銀-豐原",1,11,-10
"3803","6180橘子","110/07/19","兆豐-城中",10,0,10
"3804","6180橘子","110/07/19","永豐金-豐原",0,10,-10
"3805","6180橘子","110/07/19","元大-旗山",10,0,10
"3806","6180橘子","110/07/19","永豐金-竹科",0,10,-10
"3807","6180橘子","110/07/19","元大-大安",10,0,10
"3808","6180橘子","110/07/19","臺銀-鳳山",1,10,-9
"3809","6180橘子","110/07/19","大昌-新店",9,0,9
"3810","6180橘子","110/07/19","群益金鼎-台南",0,9,-9
"3811","2390云辰","110/07/19","摩根大通",1135,266,869
"3812","2390云辰","110/07/19","元富-成功",15,119,-104
"3813","2390云辰","110/07/19","台灣摩根士丹利",232,40,192
"3814","2390云辰","110/07/19","元富-中港",5,101,-96
"3815","2390云辰","110/07/19","凱基-台北",669,504,165
"3816","2390云辰","110/07/19","元富-嘉義",5,85,-80
"3817","2390云辰","110/07/19","美林",290,159,131
"3818","2390云辰","110/07/19","美商高盛",11,62,-51
"3819","2390云辰","110/07/19","統一",111,8,103
"3820","2390云辰","110/07/19","群益金鼎-西松",4,54,-50
"3821","2390云辰","110/07/19","元富-埔里",102,0,102
"3822","2390云辰","110/07/19","聯邦商銀",0,48,-48
"3823","2390云辰","110/07/19","華南永昌-台中",126,26,100
"3824","2390云辰","110/07/19","元大-萬華",15,57,-42
"3825","2390云辰","110/07/19","永豐金-豐原",100,32,68
"3826","2390云辰","110/07/19","群益金鼎-高雄",2,42,-40
"3827","2390云辰","110/07/19","台新-台南",87,25,62
"3828","2390云辰","110/07/19","國泰-敦南",117,154,-37
"3829","2390云辰","110/07/19","台新-左楠",67,11,56
"3830","2390云辰","110/07/19","中國信託-文心",5,40,-35
"3831","2390云辰","110/07/19","國泰-忠孝",52,0,52
"3832","2390云辰","110/07/19","凱基-城中",16,51,-35
"3833","2390云辰","110/07/19","台新證券",105,54,51
"3834","2390云辰","110/07/19","瑞士信貸",0,31,-31
"3835","2390云辰","110/07/19","華南永昌-頭份",53,3,50
"3836","2390云辰","110/07/19","中國信託-永康",1,32,-31
"3837","2390云辰","110/07/19","新光-台南",44,0,44
"3838","2390云辰","110/07/19","統一-彰化",2,32,-30
"3839","2390云辰","110/07/19","合庫-西台中",50,8,42
"3840","2390云辰","110/07/19","元大-館前",7,37,-30
"3841","2363矽統","110/07/16","國票-長城",461,21,440
"3842","2363矽統","110/07/16","新加坡商瑞銀",155,482,-327
"3843","2363矽統","110/07/16","凱基-豐中",201,3,198
"3844","2363矽統","110/07/16","港商野村",253,546,-293
"3845","2363矽統","110/07/16","凱基-土城",132,9,123
"3846","2363矽統","110/07/16","摩根大通",116,401,-285
"3847","2363矽統","110/07/16","台新證券",199,78,121
"3848","2363矽統","110/07/16","瑞士信貸",291,533,-242
"3849","2363矽統","110/07/16","日盛-中和",74,0,74
"3850","2363矽統","110/07/16","日盛-竹北",19,248,-229
"3851","2363矽統","110/07/16","日盛-員林",66,3,63
"3852","2363矽統","110/07/16","臺銀-金山",4,211,-207
"3853","2363矽統","110/07/16","國票-中和",60,3,57
"3854","2363矽統","110/07/16","元大-大統",13,138,-125
"3855","2363矽統","110/07/16","新光",240,184,56
"3856","2363矽統","110/07/16","永豐金證券",11,125,-114
"3857","2363矽統","110/07/16","富邦-竹東",65,9,56
"3858","2363矽統","110/07/16","兆豐-民生",2,101,-99
"3859","2363矽統","110/07/16","華南永昌-鳳山",56,1,55
"3860","2363矽統","110/07/16","群益金鼎-松山",2,100,-98
"3861","2363矽統","110/07/16","凱基-台北",520,466,54
"3862","2363矽統","110/07/16","元大-花蓮",8,99,-91
"3863","2363矽統","110/07/16","元富-城東",63,12,51
"3864","2363矽統","110/07/16","華南永昌-虎尾",68,154,-86
"3865","2363矽統","110/07/16","群益金鼎-桃園",56,5,51
"3866","2363矽統","110/07/16","富邦-新竹華信",7,89,-82
"3867","2363矽統","110/07/16","北城證券",60,10,50
"3868","2363矽統","110/07/16","元大-佳里",3,81,-78
"3869","2363矽統","110/07/16","國票-九鼎",57,7,50
"3870","2363矽統","110/07/16","玉山-南京東路",0,73,-73
"3871","8112至上","110/07/16","宏遠證券",551,6,545
"3872","8112至上","110/07/16","玉山-桃園",42,318,-276
"3873","8112至上","110/07/16","台灣摩根士丹利",317,11,306
"3874","8112至上","110/07/16","美林",64,305,-241
"3875","8112至上","110/07/16","新加坡商瑞銀",378,73,305
"3876","8112至上","110/07/16","宏遠-館前",16,212,-196
"3877","8112至上","110/07/16","凱基-台北",758,553,205
"3878","8112至上","110/07/16","玉山-嘉義",19,95,-76
"3879","8112至上","110/07/16","富邦證券",127,0,127
"3880","8112至上","110/07/16","群益金鼎-三民",7,82,-75
"3881","8112至上","110/07/16","台新證券",129,30,99
"3882","8112至上","110/07/16","日盛-二林",1,73,-72
"3883","8112至上","110/07/16","花旗環球",97,0,97
"3884","8112至上","110/07/16","玉山-台大",8,76,-68
"3885","8112至上","110/07/16","永豐金-台南",97,8,89
"3886","8112至上","110/07/16","元富-台南",1,68,-67
"3887","8112至上","110/07/16","元大-大天母",93,15,78
"3888","8112至上","110/07/16","玉山-板橋",4,71,-67
"3889","8112至上","110/07/16","亞東-板橋",72,2,70
"3890","8112至上","110/07/16","臺灣企銀-埔墘",0,60,-60
"3891","8112至上","110/07/16","永豐金-中正",64,9,55
"3892","8112至上","110/07/16","華南永昌-鶯歌",11,64,-53
"3893","8112至上","110/07/16","大昌-樹林",53,2,51
"3894","8112至上","110/07/16","元大-士林",7,59,-52
"3895","8112至上","110/07/16","凱基-永和",56,5,51
"3896","8112至上","110/07/16","元富-新店",8,57,-49
"3897","8112至上","110/07/16","兆豐-竹北",53,3,50
"3898","8112至上","110/07/16","富邦-陽明",9,58,-49
"3899","8112至上","110/07/16","日盛-豐原",48,0,48
"3900","8112至上","110/07/16","元大-發財",0,49,-49
"3901","1570力肯","110/07/16","新光",71,6,65
"3902","1570力肯","110/07/16","元大-高雄",0,23,-23
"3903","1570力肯","110/07/16","國票-北高雄",21,0,21
"3904","1570力肯","110/07/16","合庫-台南",0,20,-20
"3905","1570力肯","110/07/16","凱基-台北",17,1,16
"3906","1570力肯","110/07/16","元富-新店",0,15,-15
"3907","1570力肯","110/07/16","群益金鼎-高雄",15,0,15
"3908","1570力肯","110/07/16","元大-東港",0,10,-10
"3909","1570力肯","110/07/16","富邦-建國",10,0,10
"3910","1570力肯","110/07/16","中國信託",0,7,-7
"3911","1570力肯","110/07/16","元大-士林",5,0,5
"3912","1570力肯","110/07/16","台新證券",0,6,-6
"3913","1570力肯","110/07/16","瑞士信貸",3,0,3
"3914","1570力肯","110/07/16","日盛-信義",0,5,-5
"3915","1570力肯","110/07/16","臺銀-高雄",2,0,2
"3916","1570力肯","110/07/16","宏遠-館前",0,5,-5
"3917","1570力肯","110/07/16","華南永昌",2,0,2
"3918","1570力肯","110/07/16","國泰-館前",0,5,-5
"3919","1570力肯","110/07/16","元富-同大",1,0,1
"3920","1570力肯","110/07/16","富邦-園區",0,5,-5
"3921","1570力肯","110/07/16","兆豐-麻豆",1,0,1
"3922","1570力肯","110/07/16","永豐金-中正",0,5,-5
"3923","1570力肯","110/07/16","國泰-板橋",1,0,1
"3924","1570力肯","110/07/16","(牛牛牛)亞-鑫豐",0,4,-4
"3925","1570力肯","110/07/16","群益金鼎-東湖",1,0,1
"3926","1570力肯","110/07/16","台中銀-員林",0,3,-3
"3927","1570力肯","110/07/16","元大-東泰",1,0,1
"3928","1570力肯","110/07/16","玉山-新莊",0,3,-3
"3929","1570力肯","110/07/16","元大-南勢角",1,0,1
"3930","1570力肯","110/07/16","凱基-長庚",0,3,-3
"3931","2929淘帝","110/07/16","元大-民生",28,0,28
"3932","2929淘帝","110/07/16","玉山-新竹",0,30,-30
"3933","2929淘帝","110/07/16","元大-員林",20,0,20
"3934","2929淘帝","110/07/16","合庫證券",0,20,-20
"3935","2929淘帝","110/07/16","兆豐-桃鶯",12,0,12
"3936","2929淘帝","110/07/16","元大-六合",0,20,-20
"3937","2929淘帝","110/07/16","元大-大統",10,0,10
"3938","2929淘帝","110/07/16","摩根大通",0,12,-12
"3939","2929淘帝","110/07/16","新加坡商瑞銀",9,0,9
"3940","2929淘帝","110/07/16","永興",0,6,-6
"3941","2929淘帝","110/07/16","凱基-基隆",6,0,6
"3942","2929淘帝","110/07/16","凱基-長庚",0,5,-5
"3943","2929淘帝","110/07/16","合庫-高雄",5,0,5
"3944","2929淘帝","110/07/16","群益金鼎-潭子",0,4,-4
"3945","2929淘帝","110/07/16","台新-台中",6,1,5
"3946","2929淘帝","110/07/16","華南永昌-小港",2,6,-4
"3947","2929淘帝","110/07/16","元大-承德",5,0,5
"3948","2929淘帝","110/07/16","華南永昌-虎尾",0,4,-4
"3949","2929淘帝","110/07/16","元大-沙鹿",5,0,5
"3950","2929淘帝","110/07/16","日盛-和美",0,3,-3
"3951","2929淘帝","110/07/16","大慶-苗栗",5,1,4
"3952","2929淘帝","110/07/16","彰銀",0,3,-3
"3953","2929淘帝","110/07/16","台新-新營",4,0,4
"3954","2929淘帝","110/07/16","港商野村",7,10,-3
"3955","2929淘帝","110/07/16","凱基-台北",6,2,4
"3956","2929淘帝","110/07/16","群益金鼎-中山",1,4,-3
"3957","2929淘帝","110/07/16","兆豐-台中港",3,0,3
"3958","2929淘帝","110/07/16","凱基-嘉義",0,3,-3
"3959","2929淘帝","110/07/16","國票-北高雄",3,0,3
"3960","2929淘帝","110/07/16","元大-斗信",0,3,-3
"3961","5410國眾","110/07/16","盈溢-籬子內",49,0,49
"3962","5410國眾","110/07/16","元大-博愛",0,41,-41
"3963","5410國眾","110/07/16","香港上海匯豐",31,0,31
"3964","5410國眾","110/07/16","元富-嘉義",0,20,-20
"3965","5410國眾","110/07/16","元大-東泰",30,0,30
"3966","5410國眾","110/07/16","國泰-桃園",0,18,-18
"3967","5410國眾","110/07/16","兆豐-台中港",20,0,20
"3968","5410國眾","110/07/16","元富",0,17,-17
"3969","5410國眾","110/07/16","臺銀-臺南",11,0,11
"3970","5410國眾","110/07/16","元大-新竹",0,14,-14
"3971","5410國眾","110/07/16","富邦-新竹華信",11,0,11
"3972","5410國眾","110/07/16","安泰-大發",0,11,-11
"3973","5410國眾","110/07/16","臺銀",10,0,10
"3974","5410國眾","110/07/16","大昌-樹林",0,10,-10
"3975","5410國眾","110/07/16","凱基-台北",8,1,7
"3976","5410國眾","110/07/16","群益金鼎-內湖",0,10,-10
"3977","5410國眾","110/07/16","日盛-士林",5,0,5
"3978","5410國眾","110/07/16","元大-樹林",0,10,-10
"3979","5410國眾","110/07/16","新光-桃園",5,0,5
"3980","5410國眾","110/07/16","元大-內湖",0,9,-9
"3981","5410國眾","110/07/16","國泰-台南",5,0,5
"3982","5410國眾","110/07/16","群益金鼎-永和",0,5,-5
"3983","5410國眾","110/07/16","群益金鼎-嘉義",5,0,5
"3984","5410國眾","110/07/16","凱基-屏東",0,5,-5
"3985","5410國眾","110/07/16","元大-屏南",5,0,5
"3986","5410國眾","110/07/16","統一-員林",0,4,-4
"3987","5410國眾","110/07/16","日盛-員林",3,0,3
"3988","5410國眾","110/07/16","國泰-松江",0,4,-4
"3989","5410國眾","110/07/16","瑞士信貸",3,0,3
"3990","5410國眾","110/07/16","凱基-台南",0,4,-4
"3991","2841台開","110/07/16","日盛證券",250,0,250
"3992","2841台開","110/07/16","元大-歸仁",0,590,-590
"3993","2841台開","110/07/16","凱基-文心",204,0,204
"3994","2841台開","110/07/16","摩根大通",0,245,-245
"3995","2841台開","110/07/16","國泰-館前",114,0,114
"3996","2841台開","110/07/16","日盛-信義",0,145,-145
"3997","2841台開","110/07/16","永豐金-豐原",75,0,75
"3998","2841台開","110/07/16","港商野村",0,103,-103
"3999","2841台開","110/07/16","台新-台中",76,10,66
"4000","2841台開","110/07/16","玉山-嘉義",5,54,-49
"4001","2841台開","110/07/16","中國信託-文心",51,5,46
"4002","2841台開","110/07/16","台新證券",22,63,-41
"4003","2841台開","110/07/16","華南永昌-新莊",41,10,31
"4004","2841台開","110/07/16","美商高盛",0,39,-39
"4005","2841台開","110/07/16","富邦-嘉義",30,0,30
"4006","2841台開","110/07/16","亞東-板橋",0,30,-30
"4007","2841台開","110/07/16","新光",26,0,26
"4008","2841台開","110/07/16","永豐金-北高雄",0,30,-30
"4009","2841台開","110/07/16","富邦-板橋",25,0,25
"4010","2841台開","110/07/16","日盛-忠孝",0,20,-20
"4011","2841台開","110/07/16","新光-台中",22,0,22
"4012","2841台開","110/07/16","元富-草屯",0,15,-15
"4013","2841台開","110/07/16","元大-承德",22,0,22
"4014","2841台開","110/07/16","永豐金-板新",0,12,-12
"4015","2841台開","110/07/16","日盛-三重",20,0,20
"4016","2841台開","110/07/16","第一金-華江",0,10,-10
"4017","2841台開","110/07/16","日盛-新莊",20,0,20
"4018","2841台開","110/07/16","兆豐-南京",0,10,-10
"4019","2841台開","110/07/16","凱基-台南",20,0,20
"4020","2841台開","110/07/16","國票-中港",0,10,-10
"4021","6207雷科","110/07/16","統一-平鎮",215,4,211
"4022","6207雷科","110/07/16","凱基-台北",344,628,-284
"4023","6207雷科","110/07/16","凱基-復興",166,6,160
"4024","6207雷科","110/07/16","新加坡商瑞銀",104,370,-266
"4025","6207雷科","110/07/16","永豐金-南京",141,3,138
"4026","6207雷科","110/07/16","摩根大通",193,430,-237
"4027","6207雷科","110/07/16","永豐金-內湖",117,1,116
"4028","6207雷科","110/07/16","富邦證券",0,150,-150
"4029","6207雷科","110/07/16","日盛證券",104,2,102
"4030","6207雷科","110/07/16","華南永昌-中正",26,169,-143
"4031","6207雷科","110/07/16","群益金鼎-古亭",74,2,72
"4032","6207雷科","110/07/16","凱基-敦北",1,142,-141
"4033","6207雷科","110/07/16","群益金鼎-東門",76,12,64
"4034","6207雷科","110/07/16","凱基-板橋",0,120,-120
"4035","6207雷科","110/07/16","日盛-板橋",78,25,53
"4036","6207雷科","110/07/16","元富-大昌",30,136,-106
"4037","6207雷科","110/07/16","元大-斗六",57,6,51
"4038","6207雷科","110/07/16","元大-北成功",26,97,-71
"4039","6207雷科","110/07/16","元大-頭份",53,3,50
"4040","6207雷科","110/07/16","新光-桃園",29,93,-64
"4041","6207雷科","110/07/16","群益金鼎-東大",56,11,45
"4042","6207雷科","110/07/16","新百王",27,90,-63
"4043","6207雷科","110/07/16","永豐金-虎尾",50,8,42
"4044","6207雷科","110/07/16","玉山-左營",16,72,-56
"4045","6207雷科","110/07/16","元大-西門",39,1,38
"4046","6207雷科","110/07/16","群益金鼎-中壢",3,54,-51
"4047","6207雷科","110/07/16","凱基-竹科",38,1,37
"4048","6207雷科","110/07/16","元富-中原",21,67,-46
"4049","6207雷科","110/07/16","元富-世貿",50,15,35
"4050","6207雷科","110/07/16","大昌-桃園",26,70,-44
"4051","3679新至陞","110/07/16","元大-成功",17,1,16
"4052","3679新至陞","110/07/16","國票-桃園",0,11,-11
"4053","3679新至陞","110/07/16","玉山-台大",5,0,5
"4054","3679新至陞","110/07/16","富邦-台北",0,10,-10
"4055","3679新至陞","110/07/16","日盛-員林",4,0,4
"4056","3679新至陞","110/07/16","富邦-苗栗",0,10,-10
"4057","3679新至陞","110/07/16","凱基-台北",6,2,4
"4058","3679新至陞","110/07/16","元大-永春",0,6,-6
"4059","3679新至陞","110/07/16","台灣摩根士丹利",3,0,3
"4060","3679新至陞","110/07/16","美林",0,5,-5
"4061","3679新至陞","110/07/16","凱基-中山",3,0,3
"4062","3679新至陞","110/07/16","瑞士信貸",3,7,-4
"4063","3679新至陞","110/07/16","元大-承德",3,0,3
"4064","3679新至陞","110/07/16","宏遠-館前",0,3,-3
"4065","3679新至陞","110/07/16","元大-汐止",4,1,3
"4066","3679新至陞","110/07/16","元大-東港",0,3,-3
"4067","3679新至陞","110/07/16","日盛-大墩",2,0,2
"4068","3679新至陞","110/07/16","元大證券",0,2,-2
"4069","3679新至陞","110/07/16","玉山-城中",2,0,2
"4070","3679新至陞","110/07/16","永豐金-板新",0,2,-2
"4071","3679新至陞","110/07/16","華南永昌-內壢",2,0,2
"4072","3679新至陞","110/07/16","臺銀-民權",0,1,-1
"4073","3679新至陞","110/07/16","元大-台南",2,0,2
"4074","3679新至陞","110/07/16","日盛-台中",0,1,-1
"4075","3679新至陞","110/07/16","元大-大同",2,0,2
"4076","3679新至陞","110/07/16","日盛-鳳山",0,1,-1
"4077","3679新至陞","110/07/16","臺銀-高雄",1,0,1
"4078","3679新至陞","110/07/16","元富-古亭",0,1,-1
"4079","3679新至陞","110/07/16","日盛-樹林",1,0,1
"4080","3679新至陞","110/07/16","元富-新興",0,1,-1
"4081","2727王品","110/07/16","富邦證券",570,0,570
"4082","2727王品","110/07/16","台新證券",27,77,-50
"4083","2727王品","110/07/16","兆豐-南京",200,0,200
"4084","2727王品","110/07/16","台灣摩根士丹利",4,47,-43
"4085","2727王品","110/07/16","瑞士信貸",133,2,131
"4086","2727王品","110/07/16","永豐金-大園",0,33,-33
"4087","2727王品","110/07/16","美林",121,26,95
"4088","2727王品","110/07/16","元大-北屯",0,32,-32
"4089","2727王品","110/07/16","統一",103,43,60
"4090","2727王品","110/07/16","富邦-南屯",1,30,-29
"4091","2727王品","110/07/16","中國信託-忠孝",36,2,34
"4092","2727王品","110/07/16","元大-基隆孝二",0,29,-29
"4093","2727王品","110/07/16","元大證券",68,45,23
"4094","2727王品","110/07/16","日盛-忠孝",4,30,-26
"4095","2727王品","110/07/16","合庫-彰化",22,1,21
"4096","2727王品","110/07/16","新光-新竹",1,21,-20
"4097","2727王品","110/07/16","港商野村",126,105,21
"4098","2727王品","110/07/16","凱基-台北",94,113,-19
"4099","2727王品","110/07/16","元富-板橋",22,1,21
"4100","2727王品","110/07/16","富邦-虎尾",1,19,-18
"4101","2727王品","110/07/16","新加坡商瑞銀",36,18,18
"4102","2727王品","110/07/16","元大-南京",0,17,-17
"4103","2727王品","110/07/16","國泰證券",20,5,15
"4104","2727王品","110/07/16","日盛-鳳山",2,18,-16
"4105","2727王品","110/07/16","日盛-桃園",13,1,12
"4106","2727王品","110/07/16","新光",34,50,-16
"4107","2727王品","110/07/16","凱基-市政",12,1,11
"4108","2727王品","110/07/16","富邦-台北",2,18,-16
"4109","2727王品","110/07/16","元大-嘉義",14,3,11
"4110","2727王品","110/07/16","國票-內壢",1,15,-14
"4111","1570力肯","110/07/16","新光",71,6,65
"4112","1570力肯","110/07/16","元大-高雄",0,23,-23
"4113","1570力肯","110/07/16","國票-北高雄",21,0,21
"4114","1570力肯","110/07/16","合庫-台南",0,20,-20
"4115","1570力肯","110/07/16","凱基-台北",17,1,16
"4116","1570力肯","110/07/16","元富-新店",0,15,-15
"4117","1570力肯","110/07/16","群益金鼎-高雄",15,0,15
"4118","1570力肯","110/07/16","元大-東港",0,10,-10
"4119","1570力肯","110/07/16","富邦-建國",10,0,10
"4120","1570力肯","110/07/16","中國信託",0,7,-7
"4121","1570力肯","110/07/16","元大-士林",5,0,5
"4122","1570力肯","110/07/16","台新證券",0,6,-6
"4123","1570力肯","110/07/16","瑞士信貸",3,0,3
"4124","1570力肯","110/07/16","日盛-信義",0,5,-5
"4125","1570力肯","110/07/16","臺銀-高雄",2,0,2
"4126","1570力肯","110/07/16","宏遠-館前",0,5,-5
"4127","1570力肯","110/07/16","華南永昌",2,0,2
"4128","1570力肯","110/07/16","國泰-館前",0,5,-5
"4129","1570力肯","110/07/16","元富-同大",1,0,1
"4130","1570力肯","110/07/16","富邦-園區",0,5,-5
"4131","1570力肯","110/07/16","兆豐-麻豆",1,0,1
"4132","1570力肯","110/07/16","永豐金-中正",0,5,-5
"4133","1570力肯","110/07/16","國泰-板橋",1,0,1
"4134","1570力肯","110/07/16","(牛牛牛)亞-鑫豐",0,4,-4
"4135","1570力肯","110/07/16","群益金鼎-東湖",1,0,1
"4136","1570力肯","110/07/16","台中銀-員林",0,3,-3
"4137","1570力肯","110/07/16","元大-東泰",1,0,1
"4138","1570力肯","110/07/16","玉山-新莊",0,3,-3
"4139","1570力肯","110/07/16","元大-南勢角",1,0,1
"4140","1570力肯","110/07/16","凱基-長庚",0,3,-3
"4141","6180橘子","110/07/16","日盛-文化",71,5,66
"4142","6180橘子","110/07/16","凱基-台北",110,238,-128
"4143","6180橘子","110/07/16","新加坡商瑞銀",75,19,56
"4144","6180橘子","110/07/16","摩根大通",77,161,-84
"4145","6180橘子","110/07/16","瑞士信貸",51,0,51
"4146","6180橘子","110/07/16","元富-高雄",0,62,-62
"4147","6180橘子","110/07/16","台灣企銀-屏東",50,0,50
"4148","6180橘子","110/07/16","美商高盛",0,40,-40
"4149","6180橘子","110/07/16","元大-桃園",52,2,50
"4150","6180橘子","110/07/16","合庫-自強",0,37,-37
"4151","6180橘子","110/07/16","康和-台北",51,10,41
"4152","6180橘子","110/07/16","美林",15,48,-33
"4153","6180橘子","110/07/16","群益金鼎-屏東",61,20,41
"4154","6180橘子","110/07/16","元富-四維",0,32,-32
"4155","6180橘子","110/07/16","元大-彰化",33,2,31
"4156","6180橘子","110/07/16","新光",63,92,-29
"4157","6180橘子","110/07/16","台中銀-台北",30,0,30
"4158","6180橘子","110/07/16","新光-台南",6,28,-22
"4159","6180橘子","110/07/16","福勝",29,3,26
"4160","6180橘子","110/07/16","港商野村",28,49,-21
"4161","6180橘子","110/07/16","兆豐證券",21,0,21
"4162","6180橘子","110/07/16","統一",2,23,-21
"4163","6180橘子","110/07/16","華南永昌-頭份",20,0,20
"4164","6180橘子","110/07/16","元大-豐原站前",3,21,-18
"4165","6180橘子","110/07/16","富邦-台北",25,5,20
"4166","6180橘子","110/07/16","豐農",3,20,-17
"4167","6180橘子","110/07/16","富邦-員林",23,4,19
"4168","6180橘子","110/07/16","安泰-大發",0,17,-17
"4169","6180橘子","110/07/16","台新-新莊",20,2,18
"4170","6180橘子","110/07/16","群益金鼎",2,19,-17
"4171","2390云辰","110/07/16","兆豐-天母",642,7,635
"4172","2390云辰","110/07/16","凱基",0,5007,-5007
"4173","2390云辰","110/07/16","華南永昌-鳳山",339,35,304
"4174","2390云辰","110/07/16","凱基-台北",1224,2306,-1082
"4175","2390云辰","110/07/16","第一金-大稻埕",269,13,256
"4176","2390云辰","110/07/16","元大證券",206,1177,-971
"4177","2390云辰","110/07/16","國泰-敦南",665,427,238
"4178","2390云辰","110/07/16","摩根大通",1073,1967,-894
"4179","2390云辰","110/07/16","富邦-建國",272,50,222
"4180","2390云辰","110/07/16","台灣摩根士丹利",232,671,-439
"4181","2390云辰","110/07/16","元大-信義",180,15,165
"4182","2390云辰","110/07/16","美林",187,496,-309
"4183","2390云辰","110/07/16","瑞士信貸",155,0,155
"4184","2390云辰","110/07/16","港商野村",680,950,-270
"4185","2390云辰","110/07/16","台新證券",461,317,144
"4186","2390云辰","110/07/16","永豐金-中正",18,170,-152
"4187","2390云辰","110/07/16","兆豐-公益",148,11,137
"4188","2390云辰","110/07/16","元富-板橋",30,169,-139
"4189","2390云辰","110/07/16","元大-土城學府",197,61,136
"4190","2390云辰","110/07/16","新加坡商瑞銀",61,175,-114
"4191","2390云辰","110/07/16","元大-天母",232,122,110
"4192","2390云辰","110/07/16","聯邦商銀",54,167,-113
"4193","2390云辰","110/07/16","凱基-基隆",109,2,107
"4194","2390云辰","110/07/16","群益金鼎-大甲",13,111,-98
"4195","2390云辰","110/07/16","元富-成功",110,5,105
"4196","2390云辰","110/07/16","統一-屏東",4,92,-88
"4197","2390云辰","110/07/16","統一-新營",118,14,104
"4198","2390云辰","110/07/16","凱基-大直",3,80,-77
"4199","2390云辰","110/07/16","國泰-板橋",268,170,98
"4200","2390云辰","110/07/16","元大-桃興",46,117,-71
"4201","2363矽統","110/07/15","康和-台中",626,61,565
"4202","2363矽統","110/07/15","新加坡商瑞銀",202,838,-636
"4203","2363矽統","110/07/15","摩根大通",1271,932,339
"4204","2363矽統","110/07/15","美林",185,720,-535
"4205","2363矽統","110/07/15","瑞士信貸",530,230,300
"4206","2363矽統","110/07/15","富邦-仁愛",60,583,-523
"4207","2363矽統","110/07/15","宏遠-桃園",281,0,281
"4208","2363矽統","110/07/15","元大-板橋",35,368,-333
"4209","2363矽統","110/07/15","大展",252,19,233
"4210","2363矽統","110/07/15","花旗環球",0,308,-308
"4211","2363矽統","110/07/15","凱基-台北",683,498,185
"4212","2363矽統","110/07/15","元富-成功",2,113,-111
"4213","2363矽統","110/07/15","永豐金證券",166,11,155
"4214","2363矽統","110/07/15","富邦-新營",23,132,-109
"4215","2363矽統","110/07/15","群益金鼎",157,5,152
"4216","2363矽統","110/07/15","臺銀-金山",197,304,-107
"4217","2363矽統","110/07/15","新光",333,229,104
"4218","2363矽統","110/07/15","日盛-二林",13,116,-103
"4219","2363矽統","110/07/15","永豐金-台南",130,26,104
"4220","2363矽統","110/07/15","台新-左楠",40,126,-86
"4221","2363矽統","110/07/15","國票-南京",100,0,100
"4222","2363矽統","110/07/15","康和-南崁",15,100,-85
"4223","2363矽統","110/07/15","群益金鼎-松山",150,50,100
"4224","2363矽統","110/07/15","永豐金-員林",9,91,-82
"4225","2363矽統","110/07/15","中國信託-松江",103,5,98
"4226","2363矽統","110/07/15","光和-嘉義",5,78,-73
"4227","2363矽統","110/07/15","國票-新莊",187,92,95
"4228","2363矽統","110/07/15","日盛-板橋中山",3,73,-70
"4229","2363矽統","110/07/15","北城證券",216,126,90
"4230","2363矽統","110/07/15","元大證券",10,75,-65
"4231","8112至上","110/07/15","凱基-台北",535,32,503
"4232","8112至上","110/07/15","群益金鼎-台南",0,116,-116
"4233","8112至上","110/07/15","摩根大通",362,16,346
"4234","8112至上","110/07/15","華南永昌-高雄",2,112,-110
"4235","8112至上","110/07/15","台灣摩根士丹利",254,0,254
"4236","8112至上","110/07/15","永豐金-台南",27,128,-101
"4237","8112至上","110/07/15","花旗環球",159,0,159
"4238","8112至上","110/07/15","元大-東蘆",2,73,-71
"4239","8112至上","110/07/15","新加坡商瑞銀",95,2,93
"4240","8112至上","110/07/15","美林",3,66,-63
"4241","8112至上","110/07/15","玉山-嘉義",84,0,84
"4242","8112至上","110/07/15","元大-館前",0,62,-62
"4243","8112至上","110/07/15","新光",82,6,76
"4244","8112至上","110/07/15","元富-信義",0,50,-50
"4245","8112至上","110/07/15","瑞士信貸",80,7,73
"4246","8112至上","110/07/15","台新證券",35,82,-47
"4247","8112至上","110/07/15","美商高盛",64,0,64
"4248","8112至上","110/07/15","大慶-蘆洲",7,53,-46
"4249","8112至上","110/07/15","兆豐-小港",56,0,56
"4250","8112至上","110/07/15","國票-天祥",0,45,-45
"4251","8112至上","110/07/15","永豐金-內湖",60,11,49
"4252","8112至上","110/07/15","凱基-中山",1,45,-44
"4253","8112至上","110/07/15","永豐金-南投",46,1,45
"4254","8112至上","110/07/15","元大-士林",0,43,-43
"4255","8112至上","110/07/15","凱基-三重",40,0,40
"4256","8112至上","110/07/15","玉山-城中",4,44,-40
"4257","8112至上","110/07/15","台灣企銀",29,0,29
"4258","8112至上","110/07/15","凱基-彰化",0,39,-39
"4259","8112至上","110/07/15","元大-府城",42,14,28
"4260","8112至上","110/07/15","元富-花蓮",2,40,-38
"4261","1570力肯","110/07/15","群益金鼎-高雄",40,0,40
"4262","1570力肯","110/07/15","元大-高雄",0,12,-12
"4263","1570力肯","110/07/15","新光",40,8,32
"4264","1570力肯","110/07/15","永豐金-中正",0,10,-10
"4265","1570力肯","110/07/15","凱基-台北",20,2,18
"4266","1570力肯","110/07/15","國泰-松江",0,9,-9
"4267","1570力肯","110/07/15","凱基-天母",6,0,6
"4268","1570力肯","110/07/15","台新證券",0,8,-8
"4269","1570力肯","110/07/15","元富-新店",5,0,5
"4270","1570力肯","110/07/15","玉山證券",0,7,-7
"4271","1570力肯","110/07/15","凱基-中港",5,0,5
"4272","1570力肯","110/07/15","元大-府城",0,7,-7
"4273","1570力肯","110/07/15","富邦-園區",5,0,5
"4274","1570力肯","110/07/15","元大-板橋",0,6,-6
"4275","1570力肯","110/07/15","瑞士信貸",4,0,4
"4276","1570力肯","110/07/15","日盛-信義",0,5,-5
"4277","1570力肯","110/07/15","第一金-路竹",3,0,3
"4278","1570力肯","110/07/15","國票-和平",0,5,-5
"4279","1570力肯","110/07/15","摩根大通",3,0,3
"4280","1570力肯","110/07/15","元大-民雄",0,5,-5
"4281","1570力肯","110/07/15","凱基-桃園",3,0,3
"4282","1570力肯","110/07/15","統一-台中",0,4,-4
"4283","1570力肯","110/07/15","永豐金-苓雅",3,0,3
"4284","1570力肯","110/07/15","玉山-雙和",0,4,-4
"4285","1570力肯","110/07/15","統一-員林",2,0,2
"4286","1570力肯","110/07/15","凱基-敦北",0,4,-4
"4287","1570力肯","110/07/15","元大-永春",2,0,2
"4288","1570力肯","110/07/15","富邦-新店",0,4,-4
"4289","1570力肯","110/07/15","元大-土城永寧",2,0,2
"4290","1570力肯","110/07/15","日盛-板橋",0,3,-3
"4291","2929淘帝","110/07/15","港商野村",58,4,54
"4292","2929淘帝","110/07/15","日盛-園區",0,25,-25
"4293","2929淘帝","110/07/15","元大-民生",29,0,29
"4294","2929淘帝","110/07/15","兆豐-南京",0,20,-20
"4295","2929淘帝","110/07/15","新加坡商瑞銀",22,1,21
"4296","2929淘帝","110/07/15","玉山-高雄",0,18,-18
"4297","2929淘帝","110/07/15","凱基-台北",20,2,18
"4298","2929淘帝","110/07/15","富邦-南屯",1,15,-14
"4299","2929淘帝","110/07/15","大慶-中壢",15,1,14
"4300","2929淘帝","110/07/15","富邦-員林",0,13,-13
"4301","2929淘帝","110/07/15","日盛-和美",10,0,10
"4302","2929淘帝","110/07/15","凱基-站前",0,10,-10
"4303","2929淘帝","110/07/15","元大-員林",10,0,10
"4304","2929淘帝","110/07/15","元大-台中",0,10,-10
"4305","2929淘帝","110/07/15","凱基-基隆",6,0,6
"4306","2929淘帝","110/07/15","美林",10,19,-9
"4307","2929淘帝","110/07/15","臺銀-鳳山",5,0,5
"4308","2929淘帝","110/07/15","元大-新盛",0,8,-8
"4309","2929淘帝","110/07/15","第一金-路竹",5,0,5
"4310","2929淘帝","110/07/15","台新-台南",0,7,-7
"4311","2929淘帝","110/07/15","元富-大裕",5,0,5
"4312","2929淘帝","110/07/15","元大-大天母",0,7,-7
"4313","2929淘帝","110/07/15","玉山-大里",5,0,5
"4314","2929淘帝","110/07/15","華南永昌-虎尾",0,6,-6
"4315","2929淘帝","110/07/15","元大-博愛",5,0,5
"4316","2929淘帝","110/07/15","永豐金證券",0,6,-6
"4317","2929淘帝","110/07/15","永豐金-新莊",5,0,5
"4318","2929淘帝","110/07/15","兆豐-竹北",0,5,-5
"4319","2929淘帝","110/07/15","元大-南崁",4,0,4
"4320","2929淘帝","110/07/15","元大-文心興安",0,5,-5
"4321","5410國眾","110/07/15","香港上海匯豐",18,0,18
"4322","5410國眾","110/07/15","元大-南屯",0,18,-18
"4323","5410國眾","110/07/15","摩根大通",15,0,15
"4324","5410國眾","110/07/15","亞東-新竹",0,15,-15
"4325","5410國眾","110/07/15","日盛-士林",10,0,10
"4326","5410國眾","110/07/15","兆豐-台中港",0,15,-15
"4327","5410國眾","110/07/15","群益金鼎-嘉義",10,0,10
"4328","5410國眾","110/07/15","日盛-板橋",0,12,-12
"4329","5410國眾","110/07/15","元大-高雄",10,0,10
"4330","5410國眾","110/07/15","台中銀-豐原",0,9,-9
"4331","5410國眾","110/07/15","元大-東港",10,0,10
"4332","5410國眾","110/07/15","臺銀-臺南",3,10,-7
"4333","5410國眾","110/07/15","臺銀",10,5,5
"4334","5410國眾","110/07/15","瑞士信貸",0,5,-5
"4335","5410國眾","110/07/15","台新-新營",5,0,5
"4336","5410國眾","110/07/15","統一-員林",0,5,-5
"4337","5410國眾","110/07/15","富邦-台北",5,0,5
"4338","5410國眾","110/07/15","大昌-樹林",0,5,-5
"4339","5410國眾","110/07/15","日盛-屏東",4,0,4
"4340","5410國眾","110/07/15","兆豐-來福",0,5,-5
"4341","5410國眾","110/07/15","高橋",5,1,4
"4342","5410國眾","110/07/15","豐農",0,5,-5
"4343","5410國眾","110/07/15","中國信託-新竹",4,1,3
"4344","5410國眾","110/07/15","元大-大里",0,5,-5
"4345","5410國眾","110/07/15","富邦-建國",3,0,3
"4346","5410國眾","110/07/15","港商野村",0,3,-3
"4347","5410國眾","110/07/15","永豐金-桃園",3,0,3
"4348","5410國眾","110/07/15","中農",0,3,-3
"4349","5410國眾","110/07/15","大展",2,0,2
"4350","5410國眾","110/07/15","國泰-忠孝",0,3,-3
"4351","2841台開","110/07/15","日盛證券",310,0,310
"4352","2841台開","110/07/15","港商野村",0,97,-97
"4353","2841台開","110/07/15","元富-城東",100,0,100
"4354","2841台開","110/07/15","元大-員林",0,77,-77
"4355","2841台開","110/07/15","凱基-文心",30,0,30
"4356","2841台開","110/07/15","新光",3,73,-70
"4357","2841台開","110/07/15","日盛-雙和",24,0,24
"4358","2841台開","110/07/15","永豐金-北高雄",0,30,-30
"4359","2841台開","110/07/15","第一金-台中",20,0,20
"4360","2841台開","110/07/15","華南永昌",0,25,-25
"4361","2841台開","110/07/15","豐農",20,0,20
"4362","2841台開","110/07/15","日盛-台南",0,20,-20
"4363","2841台開","110/07/15","華南永昌-新莊",19,0,19
"4364","2841台開","110/07/15","致和-佳里",0,20,-20
"4365","2841台開","110/07/15","玉山-大里",12,0,12
"4366","2841台開","110/07/15","國票-中港",0,20,-20
"4367","2841台開","110/07/15","元富-安南",10,0,10
"4368","2841台開","110/07/15","元大-歸仁",0,20,-20
"4369","2841台開","110/07/15","凱基-市政",10,0,10
"4370","2841台開","110/07/15","統一-三多",0,19,-19
"4371","2841台開","110/07/15","凱基-竹科",10,0,10
"4372","2841台開","110/07/15","凱基-城中",0,18,-18
"4373","2841台開","110/07/15","國泰-板橋",10,1,9
"4374","2841台開","110/07/15","國票-中和",0,15,-15
"4375","2841台開","110/07/15","凱基-台北",9,0,9
"4376","2841台開","110/07/15","元大-彰化",0,15,-15
"4377","2841台開","110/07/15","合庫證券",6,0,6
"4378","2841台開","110/07/15","元大-復北",0,15,-15
"4379","2841台開","110/07/15","台中銀",6,0,6
"4380","2841台開","110/07/15","土銀-花蓮",0,14,-14
"4381","6207雷科","110/07/15","凱基-板橋",210,45,165
"4382","6207雷科","110/07/15","群益金鼎-台北",20,80,-60
"4383","6207雷科","110/07/15","富邦證券",150,0,150
"4384","6207雷科","110/07/15","元大-大天母",1,56,-55
"4385","6207雷科","110/07/15","凱基-復興",140,0,140
"4386","6207雷科","110/07/15","大慶-中壢",2,50,-48
"4387","6207雷科","110/07/15","華南永昌-中正",140,0,140
"4388","6207雷科","110/07/15","元富-林園",0,47,-47
"4389","6207雷科","110/07/15","永豐金-內湖",92,10,82
"4390","6207雷科","110/07/15","元大-東門",0,40,-40
"4391","6207雷科","110/07/15","富邦-彰化",81,11,70
"4392","6207雷科","110/07/15","第一金-安和",0,37,-37
"4393","6207雷科","110/07/15","(牛牛牛)亞-網路",67,0,67
"4394","6207雷科","110/07/15","凱基-台北",61,97,-36
"4395","6207雷科","110/07/15","台新證券",60,8,52
"4396","6207雷科","110/07/15","國票-南科",0,32,-32
"4397","6207雷科","110/07/15","華南永昌",50,3,47
"4398","6207雷科","110/07/15","元大-四維",0,32,-32
"4399","6207雷科","110/07/15","新加坡商瑞銀",68,26,42
"4400","6207雷科","110/07/15","元大-板橋",0,30,-30
"4401","6207雷科","110/07/15","日盛-景美",40,0,40
"4402","6207雷科","110/07/15","元大-南崁",1,30,-29
"4403","6207雷科","110/07/15","元富-大昌",40,0,40
"4404","6207雷科","110/07/15","凱基-岡山",0,27,-27
"4405","6207雷科","110/07/15","統一-高雄",38,5,33
"4406","6207雷科","110/07/15","統一-新竹",0,26,-26
"4407","6207雷科","110/07/15","日盛證券",32,0,32
"4408","6207雷科","110/07/15","群益金鼎-三民",1,27,-26
"4409","6207雷科","110/07/15","華南永昌-頭份",31,0,31
"4410","6207雷科","110/07/15","國票-台中",0,25,-25
"4411","3679新至陞","110/07/15","群益金鼎-大安",25,0,25
"4412","3679新至陞","110/07/15","元大-成功",0,10,-10
"4413","3679新至陞","110/07/15","元大-彰化",13,0,13
"4414","3679新至陞","110/07/15","群益金鼎-東大",0,8,-8
"4415","3679新至陞","110/07/15","國票-桃園",10,0,10
"4416","3679新至陞","110/07/15","凱基-台北",4,12,-8
"4417","3679新至陞","110/07/15","群益金鼎-台南",10,0,10
"4418","3679新至陞","110/07/15","第一金-華江",0,5,-5
"4419","3679新至陞","110/07/15","華南永昌-台中",10,0,10
"4420","3679新至陞","110/07/15","兆豐-來福",0,5,-5
"4421","3679新至陞","110/07/15","港商野村",9,0,9
"4422","3679新至陞","110/07/15","元大-北三重",0,5,-5
"4423","3679新至陞","110/07/15","元大-永春",6,0,6
"4424","3679新至陞","110/07/15","瑞士信貸",0,4,-4
"4425","3679新至陞","110/07/15","(牛牛牛)亞-網路",5,0,5
"4426","3679新至陞","110/07/15","新加坡商瑞銀",0,4,-4
"4427","3679新至陞","110/07/15","凱基-高雄",5,0,5
"4428","3679新至陞","110/07/15","元大-汐止",0,4,-4
"4429","3679新至陞","110/07/15","美商高盛",6,2,4
"4430","3679新至陞","110/07/15","台中銀-員林",0,3,-3
"4431","3679新至陞","110/07/15","台新證券",3,1,2
"4432","3679新至陞","110/07/15","兆豐-忠孝",0,3,-3
"4433","3679新至陞","110/07/15","群益金鼎-大興",2,0,2
"4434","3679新至陞","110/07/15","玉山-新莊",0,3,-3
"4435","3679新至陞","110/07/15","元大-六合",2,0,2
"4436","3679新至陞","110/07/15","永豐金-屏東",0,3,-3
"4437","3679新至陞","110/07/15","彰銀",1,0,1
"4438","3679新至陞","110/07/15","永豐金-敦南",0,3,-3
"4439","3679新至陞","110/07/15","美林",2,1,1
"4440","3679新至陞","110/07/15","永豐金-萬盛",0,3,-3
"4441","2727王品","110/07/15","兆豐-南京",101,0,101
"4442","2727王品","110/07/15","富邦-左營",0,102,-102
"4443","2727王品","110/07/15","港商野村",166,73,93
"4444","2727王品","110/07/15","日盛-忠孝",2,32,-30
"4445","2727王品","110/07/15","瑞士信貸",97,8,89
"4446","2727王品","110/07/15","群益金鼎-古亭",2,24,-22
"4447","2727王品","110/07/15","玉山證券",56,12,44
"4448","2727王品","110/07/15","日盛-八德",0,21,-21
"4449","2727王品","110/07/15","第一金-高雄",43,1,42
"4450","2727王品","110/07/15","元大-新盛",2,23,-21
"4451","2727王品","110/07/15","台新證券",74,45,29
"4452","2727王品","110/07/15","摩根大通",53,72,-19
"4453","2727王品","110/07/15","康和-澎湖",27,0,27
"4454","2727王品","110/07/15","富邦-彰化",8,26,-18
"4455","2727王品","110/07/15","富邦-陽明",31,4,27
"4456","2727王品","110/07/15","富邦-台中",7,24,-17
"4457","2727王品","110/07/15","國票-北高雄",27,1,26
"4458","2727王品","110/07/15","新加坡商瑞銀",13,29,-16
"4459","2727王品","110/07/15","國泰-板橋",38,12,26
"4460","2727王品","110/07/15","國泰-敦南",35,50,-15
"4461","2727王品","110/07/15","凱基-興隆",23,0,23
"4462","2727王品","110/07/15","元大-龍潭",0,14,-14
"4463","2727王品","110/07/15","凱基-板橋",29,7,22
"4464","2727王品","110/07/15","中國信託-文心",8,21,-13
"4465","2727王品","110/07/15","合庫-彰化",21,0,21
"4466","2727王品","110/07/15","永豐金-竹科",2,15,-13
"4467","2727王品","110/07/15","土銀-南港",20,0,20
"4468","2727王品","110/07/15","臺銀-臺南",2,14,-12
"4469","2727王品","110/07/15","美林",37,18,19
"4470","2727王品","110/07/15","凱基-台北",56,68,-12
"4471","1570力肯","110/07/15","群益金鼎-高雄",40,0,40
"4472","1570力肯","110/07/15","元大-高雄",0,12,-12
"4473","1570力肯","110/07/15","新光",40,8,32
"4474","1570力肯","110/07/15","永豐金-中正",0,10,-10
"4475","1570力肯","110/07/15","凱基-台北",20,2,18
"4476","1570力肯","110/07/15","國泰-松江",0,9,-9
"4477","1570力肯","110/07/15","凱基-天母",6,0,6
"4478","1570力肯","110/07/15","台新證券",0,8,-8
"4479","1570力肯","110/07/15","元富-新店",5,0,5
"4480","1570力肯","110/07/15","玉山證券",0,7,-7
"4481","1570力肯","110/07/15","凱基-中港",5,0,5
"4482","1570力肯","110/07/15","元大-府城",0,7,-7
"4483","1570力肯","110/07/15","富邦-園區",5,0,5
"4484","1570力肯","110/07/15","元大-板橋",0,6,-6
"4485","1570力肯","110/07/15","瑞士信貸",4,0,4
"4486","1570力肯","110/07/15","日盛-信義",0,5,-5
"4487","1570力肯","110/07/15","第一金-路竹",3,0,3
"4488","1570力肯","110/07/15","國票-和平",0,5,-5
"4489","1570力肯","110/07/15","摩根大通",3,0,3
"4490","1570力肯","110/07/15","元大-民雄",0,5,-5
"4491","1570力肯","110/07/15","凱基-桃園",3,0,3
"4492","1570力肯","110/07/15","統一-台中",0,4,-4
"4493","1570力肯","110/07/15","永豐金-苓雅",3,0,3
"4494","1570力肯","110/07/15","玉山-雙和",0,4,-4
"4495","1570力肯","110/07/15","統一-員林",2,0,2
"4496","1570力肯","110/07/15","凱基-敦北",0,4,-4
"4497","1570力肯","110/07/15","元大-永春",2,0,2
"4498","1570力肯","110/07/15","富邦-新店",0,4,-4
"4499","1570力肯","110/07/15","元大-土城永寧",2,0,2
"4500","1570力肯","110/07/15","日盛-板橋",0,3,-3
"4501","6180橘子","110/07/15","兆豐證券",130,0,130
"4502","6180橘子","110/07/15","港商野村",21,137,-116
"4503","6180橘子","110/07/15","摩根大通",111,0,111
"4504","6180橘子","110/07/15","高橋",0,40,-40
"4505","6180橘子","110/07/15","石橋證券",80,0,80
"4506","6180橘子","110/07/15","臺銀",1,40,-39
"4507","6180橘子","110/07/15","凱基-台北",78,26,52
"4508","6180橘子","110/07/15","玉山-桃園",0,35,-35
"4509","6180橘子","110/07/15","新加坡商瑞銀",38,1,37
"4510","6180橘子","110/07/15","玉山-台南",2,33,-31
"4511","6180橘子","110/07/15","富邦-員林",32,0,32
"4512","6180橘子","110/07/15","統一-南京",0,30,-30
"4513","6180橘子","110/07/15","日盛-文化",23,0,23
"4514","6180橘子","110/07/15","康和-台南",0,25,-25
"4515","6180橘子","110/07/15","元富-新店",20,0,20
"4516","6180橘子","110/07/15","大昌-樹林",0,22,-22
"4517","6180橘子","110/07/15","美林",15,0,15
"4518","6180橘子","110/07/15","康和-新竹",0,20,-20
"4519","6180橘子","110/07/15","新光-新竹",17,2,15
"4520","6180橘子","110/07/15","群益金鼎-台中",0,20,-20
"4521","6180橘子","110/07/15","富邦-嘉義",12,0,12
"4522","6180橘子","110/07/15","元大-彰化民生",0,18,-18
"4523","6180橘子","110/07/15","花旗環球",11,0,11
"4524","6180橘子","110/07/15","元大-草屯",0,16,-16
"4525","6180橘子","110/07/15","第一金-新興",11,0,11
"4526","6180橘子","110/07/15","元富-潮州",0,13,-13
"4527","6180橘子","110/07/15","第一金-桃園",10,0,10
"4528","6180橘子","110/07/15","宏遠-台南",0,11,-11
"4529","6180橘子","110/07/15","永興",10,0,10
"4530","6180橘子","110/07/15","大慶-泰山",0,10,-10
"4531","2390云辰","110/07/15","凱基",5007,0,5007
"4532","2390云辰","110/07/15","凱基-台北",382,616,-234
"4533","2390云辰","110/07/15","元大證券",1006,25,981
"4534","2390云辰","110/07/15","富邦-陽明",69,265,-196
"4535","2390云辰","110/07/15","元大-天母",456,20,436
"4536","2390云辰","110/07/15","永豐金-桃園",63,255,-192
"4537","2390云辰","110/07/15","港商野村",975,675,300
"4538","2390云辰","110/07/15","富邦-仁愛",17,187,-170
"4539","2390云辰","110/07/15","摩根大通",1318,1040,278
"4540","2390云辰","110/07/15","日盛-和美",2,165,-163
"4541","2390云辰","110/07/15","國票-博愛",184,7,177
"4542","2390云辰","110/07/15","國泰-敦南",142,290,-148
"4543","2390云辰","110/07/15","群益金鼎-大甲",113,13,100
"4544","2390云辰","110/07/15","台灣摩根士丹利",51,197,-146
"4545","2390云辰","110/07/15","凱基-大直",89,2,87
"4546","2390云辰","110/07/15","國票-嘉義",4,148,-144
"4547","2390云辰","110/07/15","玉山-台中",77,8,69
"4548","2390云辰","110/07/15","台中銀",8,139,-131
"4549","2390云辰","110/07/15","聯邦商銀",70,4,66
"4550","2390云辰","110/07/15","元大-彰化民生",7,138,-131
"4551","2390云辰","110/07/15","元大-大里",88,25,63
"4552","2390云辰","110/07/15","元富-成功",2,111,-109
"4553","2390云辰","110/07/15","富邦-嘉義",542,480,62
"4554","2390云辰","110/07/15","元大-東泰",3,106,-103
"4555","2390云辰","110/07/15","新加坡商瑞銀",158,97,61
"4556","2390云辰","110/07/15","合庫-三重",1,102,-101
"4557","2390云辰","110/07/15","華南永昌-台中",86,35,51
"4558","2390云辰","110/07/15","元富-大裕",4,87,-83
"4559","2390云辰","110/07/15","群益金鼎",51,6,45
"4560","2390云辰","110/07/15","凱基-和平",17,96,-79
"4561","2363矽統","110/07/14","台灣摩根士丹利",463,0,463
"4562","2363矽統","110/07/14","新加坡商瑞銀",568,1321,-753
"4563","2363矽統","110/07/14","台新證券",750,342,408
"4564","2363矽統","110/07/14","瑞士信貸",149,864,-715
"4565","2363矽統","110/07/14","玉山-台中",363,51,312
"4566","2363矽統","110/07/14","台新-屏東",115,380,-265
"4567","2363矽統","110/07/14","元大-斗六",223,25,198
"4568","2363矽統","110/07/14","永豐金證券",16,265,-249
"4569","2363矽統","110/07/14","華南永昌-朴子",208,38,170
"4570","2363矽統","110/07/14","美林",462,701,-239
"4571","2363矽統","110/07/14","元富-西松",169,12,157
"4572","2363矽統","110/07/14","宏遠-桃園",269,500,-231
"4573","2363矽統","110/07/14","永豐金-大園",146,6,140
"4574","2363矽統","110/07/14","凱基-竹北",36,254,-218
"4575","2363矽統","110/07/14","土銀-和平",134,0,134
"4576","2363矽統","110/07/14","港商法國興業",0,214,-214
"4577","2363矽統","110/07/14","富邦-新營",130,13,117
"4578","2363矽統","110/07/14","港商野村",835,1044,-209
"4579","2363矽統","110/07/14","元富-成功",118,11,107
"4580","2363矽統","110/07/14","北城證券",212,411,-199
"4581","2363矽統","110/07/14","元富-烏日",121,18,103
"4582","2363矽統","110/07/14","(牛牛牛)亞-鑫豐",51,241,-190
"4583","2363矽統","110/07/14","日盛-二林",120,18,102
"4584","2363矽統","110/07/14","國票-博愛",24,213,-189
"4585","2363矽統","110/07/14","兆豐-忠孝",98,2,96
"4586","2363矽統","110/07/14","大慶-蘆洲",134,316,-182
"4587","2363矽統","110/07/14","大慶-楊梅",92,3,89
"4588","2363矽統","110/07/14","彰銀-台中",15,193,-178
"4589","2363矽統","110/07/14","元富-三重",120,33,87
"4590","2363矽統","110/07/14","日盛-和美",18,185,-167
"4591","8112至上","110/07/14","新加坡商瑞銀",223,17,206
"4592","8112至上","110/07/14","瑞士信貸",8,170,-162
"4593","8112至上","110/07/14","摩根大通",285,129,156
"4594","8112至上","110/07/14","美林",55,202,-147
"4595","8112至上","110/07/14","花旗環球",124,0,124
"4596","8112至上","110/07/14","凱基-台北",325,436,-111
"4597","8112至上","110/07/14","兆豐-公益",117,4,113
"4598","8112至上","110/07/14","台中銀-台北",0,98,-98
"4599","8112至上","110/07/14","香港上海匯豐",111,0,111
"4600","8112至上","110/07/14","玉山-台大",17,107,-90
"4601","8112至上","110/07/14","永豐金-內湖",117,21,96
"4602","8112至上","110/07/14","康和-內湖",1,90,-89
"4603","8112至上","110/07/14","台灣摩根士丹利",108,16,92
"4604","8112至上","110/07/14","港商野村",21,84,-63
"4605","8112至上","110/07/14","元大-東蘆",77,0,77
"4606","8112至上","110/07/14","兆豐-北高雄",1,60,-59
"4607","8112至上","110/07/14","新光",108,48,60
"4608","8112至上","110/07/14","群益金鼎-海山",1,52,-51
"4609","8112至上","110/07/14","大慶-蘆洲",59,0,59
"4610","8112至上","110/07/14","群益金鼎-大安",0,50,-50
"4611","8112至上","110/07/14","華南永昌-台中",56,3,53
"4612","8112至上","110/07/14","富邦-仁愛",2,49,-47
"4613","8112至上","110/07/14","土銀-嘉義",52,2,50
"4614","8112至上","110/07/14","元大-金華",0,42,-42
"4615","8112至上","110/07/14","美商高盛",40,0,40
"4616","8112至上","110/07/14","元大-內湖",4,43,-39
"4617","8112至上","110/07/14","臺銀",63,29,34
"4618","8112至上","110/07/14","第一金-華江",2,37,-35
"4619","8112至上","110/07/14","元富-嘉義",31,0,31
"4620","8112至上","110/07/14","永豐金-苓雅",2,34,-32
"4621","1570力肯","110/07/14","國票-北高雄",68,0,68
"4622","1570力肯","110/07/14","摩根大通",0,21,-21
"4623","1570力肯","110/07/14","日盛-八德",30,1,29
"4624","1570力肯","110/07/14","新光",1,19,-18
"4625","1570力肯","110/07/14","玉山-高雄",7,0,7
"4626","1570力肯","110/07/14","(牛牛牛)亞-鑫豐",0,17,-17
"4627","1570力肯","110/07/14","臺銀-臺南",5,0,5
"4628","1570力肯","110/07/14","日盛-士林",0,10,-10
"4629","1570力肯","110/07/14","凱基-三峽",5,0,5
"4630","1570力肯","110/07/14","統一-員林",0,10,-10
"4631","1570力肯","110/07/14","元大-和平",5,0,5
"4632","1570力肯","110/07/14","國票-新莊",0,10,-10
"4633","1570力肯","110/07/14","合庫-三重",4,0,4
"4634","1570力肯","110/07/14","凱基-高美館",0,10,-10
"4635","1570力肯","110/07/14","瑞士信貸",4,0,4
"4636","1570力肯","110/07/14","元大-屏東民生",0,5,-5
"4637","1570力肯","110/07/14","統一-三多",4,0,4
"4638","1570力肯","110/07/14","元大-古亭",0,5,-5
"4639","1570力肯","110/07/14","華南永昌-古亭",4,0,4
"4640","1570力肯","110/07/14","日盛-木柵",0,4,-4
"4641","1570力肯","110/07/14","元大-高雄",3,0,3
"4642","1570力肯","110/07/14","大昌",0,4,-4
"4643","1570力肯","110/07/14","兆豐-忠孝",2,0,2
"4644","1570力肯","110/07/14","群益金鼎-東大",0,4,-4
"4645","1570力肯","110/07/14","富邦-陽明",2,0,2
"4646","1570力肯","110/07/14","凱基-台北",0,4,-4
"4647","1570力肯","110/07/14","元大-松山",2,0,2
"4648","1570力肯","110/07/14","元大-板橋",0,4,-4
"4649","1570力肯","110/07/14","元大-忠孝",2,0,2
"4650","1570力肯","110/07/14","第一金-中山",0,3,-3
"4651","2929淘帝","110/07/14","華南永昌-林口",60,0,60
"4652","2929淘帝","110/07/14","群益金鼎",25,540,-515
"4653","2929淘帝","110/07/14","美林",87,31,56
"4654","2929淘帝","110/07/14","國泰-台南",1,30,-29
"4655","2929淘帝","110/07/14","元富-台南",40,0,40
"4656","2929淘帝","110/07/14","宏遠-桃園",0,20,-20
"4657","2929淘帝","110/07/14","元大-民生",39,0,39
"4658","2929淘帝","110/07/14","摩根大通",11,31,-20
"4659","2929淘帝","110/07/14","臺銀-鳳山",34,0,34
"4660","2929淘帝","110/07/14","台新-建北",5,20,-15
"4661","2929淘帝","110/07/14","合庫-高雄",34,1,33
"4662","2929淘帝","110/07/14","新光",1,16,-15
"4663","2929淘帝","110/07/14","華南永昌-鶯歌",28,0,28
"4664","2929淘帝","110/07/14","玉山-板橋",0,15,-15
"4665","2929淘帝","110/07/14","永興",25,0,25
"4666","2929淘帝","110/07/14","凱基-羅東",0,15,-15
"4667","2929淘帝","110/07/14","元大-新盛",25,1,24
"4668","2929淘帝","110/07/14","元大-頭份",0,15,-15
"4669","2929淘帝","110/07/14","日盛-南京",23,0,23
"4670","2929淘帝","110/07/14","第一金-台南",0,13,-13
"4671","2929淘帝","110/07/14","日茂",20,0,20
"4672","2929淘帝","110/07/14","富邦-基隆",0,12,-12
"4673","2929淘帝","110/07/14","台新-台中",20,0,20
"4674","2929淘帝","110/07/14","日茂-南投",1,12,-11
"4675","2929淘帝","110/07/14","華南永昌",20,0,20
"4676","2929淘帝","110/07/14","元大-豐原站前",0,11,-11
"4677","2929淘帝","110/07/14","福勝",15,0,15
"4678","2929淘帝","110/07/14","玉山-士林",0,10,-10
"4679","2929淘帝","110/07/14","富邦-南屯",15,0,15
"4680","2929淘帝","110/07/14","富邦-台北",0,10,-10
"4681","5410國眾","110/07/14","兆豐-城中",35,0,35
"4682","5410國眾","110/07/14","瑞士信貸",0,29,-29
"4683","5410國眾","110/07/14","新光",21,1,20
"4684","5410國眾","110/07/14","國泰-板橋",1,30,-29
"4685","5410國眾","110/07/14","國泰-敦南",21,1,20
"4686","5410國眾","110/07/14","日盛-高雄",0,20,-20
"4687","5410國眾","110/07/14","國泰-台中",20,1,19
"4688","5410國眾","110/07/14","台新-左楠",1,20,-19
"4689","5410國眾","110/07/14","元大-崇德",19,0,19
"4690","5410國眾","110/07/14","元富-大昌",1,18,-17
"4691","5410國眾","110/07/14","土銀-士林",18,0,18
"4692","5410國眾","110/07/14","富邦-建國",0,15,-15
"4693","5410國眾","110/07/14","元大-新盛",20,2,18
"4694","5410國眾","110/07/14","元富-嘉義",0,12,-12
"4695","5410國眾","110/07/14","兆豐-高雄",15,0,15
"4696","5410國眾","110/07/14","永全-南崁",0,12,-12
"4697","5410國眾","110/07/14","宏遠-中和",10,0,10
"4698","5410國眾","110/07/14","元大-員林",0,11,-11
"4699","5410國眾","110/07/14","新光-桃園",10,0,10
"4700","5410國眾","110/07/14","高橋",0,10,-10
"4701","5410國眾","110/07/14","國泰-台南",10,0,10
"4702","5410國眾","110/07/14","永興",0,10,-10
"4703","5410國眾","110/07/14","元大-復北",10,0,10
"4704","5410國眾","110/07/14","華南永昌-三重",0,10,-10
"4705","5410國眾","110/07/14","元大-竹科",8,0,8
"4706","5410國眾","110/07/14","元大-苑裡",0,7,-7
"4707","5410國眾","110/07/14","台新-新營",6,0,6
"4708","5410國眾","110/07/14","港商野村",0,6,-6
"4709","5410國眾","110/07/14","日盛-士林",5,0,5
"4710","5410國眾","110/07/14","摩根大通",5,11,-6
"4711","2841台開","110/07/14","凱基-文心",73,0,73
"4712","2841台開","110/07/14","國泰-敦南",0,50,-50
"4713","2841台開","110/07/14","元富-潮州",30,0,30
"4714","2841台開","110/07/14","凱基-中壢",0,40,-40
"4715","2841台開","110/07/14","第一金-台中",20,0,20
"4716","2841台開","110/07/14","統一-新竹",0,24,-24
"4717","2841台開","110/07/14","華南永昌-新莊",20,0,20
"4718","2841台開","110/07/14","元富-草屯",0,20,-20
"4719","2841台開","110/07/14","永豐金-豐原",20,0,20
"4720","2841台開","110/07/14","台新-台南",0,20,-20
"4721","2841台開","110/07/14","國泰-館前",15,0,15
"4722","2841台開","110/07/14","永豐金-敦南",45,63,-18
"4723","2841台開","110/07/14","群益金鼎-基隆",12,0,12
"4724","2841台開","110/07/14","國票-北高雄",0,13,-13
"4725","2841台開","110/07/14","日盛-信義",10,0,10
"4726","2841台開","110/07/14","凱基-松山",0,10,-10
"4727","2841台開","110/07/14","台新-台中",10,0,10
"4728","2841台開","110/07/14","元大證券",0,10,-10
"4729","2841台開","110/07/14","新光",10,1,9
"4730","2841台開","110/07/14","元大-中壢",0,10,-10
"4731","2841台開","110/07/14","凱基-新店",8,0,8
"4732","2841台開","110/07/14","富邦-陽明",1,10,-9
"4733","2841台開","110/07/14","元大-斗信",7,0,7
"4734","2841台開","110/07/14","富邦-建國",0,9,-9
"4735","2841台開","110/07/14","元大-三重",6,0,6
"4736","2841台開","110/07/14","富邦-台南",0,8,-8
"4737","2841台開","110/07/14","永豐金-中和",6,0,6
"4738","2841台開","110/07/14","康和-澎湖",0,7,-7
"4739","2841台開","110/07/14","元富-成功",5,0,5
"4740","2841台開","110/07/14","日盛-斗六",0,6,-6
"4741","6207雷科","110/07/14","群益金鼎-台北",60,0,60
"4742","6207雷科","110/07/14","新加坡商瑞銀",10,56,-46
"4743","6207雷科","110/07/14","台新-高雄",43,3,40
"4744","6207雷科","110/07/14","國票-中和",0,41,-41
"4745","6207雷科","110/07/14","元大-高雄",19,0,19
"4746","6207雷科","110/07/14","元大-復北",0,33,-33
"4747","6207雷科","110/07/14","福勝",15,0,15
"4748","6207雷科","110/07/14","光和-和美",0,20,-20
"4749","6207雷科","110/07/14","群益金鼎-中山",15,0,15
"4750","6207雷科","110/07/14","群益金鼎-丹鳳",0,20,-20
"4751","6207雷科","110/07/14","元大-林園",15,0,15
"4752","6207雷科","110/07/14","第一金-路竹",0,10,-10
"4753","6207雷科","110/07/14","新光",12,0,12
"4754","6207雷科","110/07/14","元大-歸仁",0,10,-10
"4755","6207雷科","110/07/14","元大-大天母",10,0,10
"4756","6207雷科","110/07/14","宏遠-館前",0,9,-9
"4757","6207雷科","110/07/14","永豐金-忠孝",9,0,9
"4758","6207雷科","110/07/14","凱基-台北",12,20,-8
"4759","6207雷科","110/07/14","永豐金-新店",7,0,7
"4760","6207雷科","110/07/14","美林",0,7,-7
"4761","6207雷科","110/07/14","玉山-嘉義",6,0,6
"4762","6207雷科","110/07/14","摩根大通",16,23,-7
"4763","6207雷科","110/07/14","元大-屏東",6,0,6
"4764","6207雷科","110/07/14","凱基-高雄",1,7,-6
"4765","6207雷科","110/07/14","凱基-大安",5,0,5
"4766","6207雷科","110/07/14","台中銀-豐原",0,5,-5
"4767","6207雷科","110/07/14","富邦-台南",5,0,5
"4768","6207雷科","110/07/14","元大-新竹經國",0,5,-5
"4769","6207雷科","110/07/14","元大-成功",5,0,5
"4770","6207雷科","110/07/14","光和-田中",0,4,-4
"4771","3679新至陞","110/07/14","凱基-台北",31,6,25
"4772","3679新至陞","110/07/14","群益金鼎-東大",0,15,-15
"4773","3679新至陞","110/07/14","華南永昌-新莊",10,0,10
"4774","3679新至陞","110/07/14","瑞士信貸",0,12,-12
"4775","3679新至陞","110/07/14","新加坡商瑞銀",11,3,8
"4776","3679新至陞","110/07/14","群益金鼎-永和",0,10,-10
"4777","3679新至陞","110/07/14","美商高盛",6,0,6
"4778","3679新至陞","110/07/14","元大-成功",5,15,-10
"4779","3679新至陞","110/07/14","第一金-中壢",6,0,6
"4780","3679新至陞","110/07/14","統一-板橋",1,10,-9
"4781","3679新至陞","110/07/14","(牛牛牛)亞-網路",4,0,4
"4782","3679新至陞","110/07/14","玉山-左營",0,5,-5
"4783","3679新至陞","110/07/14","元大-六合",3,0,3
"4784","3679新至陞","110/07/14","群益金鼎-三民",0,4,-4
"4785","3679新至陞","110/07/14","合庫-自強",2,0,2
"4786","3679新至陞","110/07/14","富邦-宜蘭",0,4,-4
"4787","3679新至陞","110/07/14","高橋-內壢",2,0,2
"4788","3679新至陞","110/07/14","永豐金-苓雅",0,3,-3
"4789","3679新至陞","110/07/14","台中銀-員林",2,0,2
"4790","3679新至陞","110/07/14","摩根大通",5,7,-2
"4791","3679新至陞","110/07/14","凱基-高美館",2,0,2
"4792","3679新至陞","110/07/14","元大-板橋三民",0,2,-2
"4793","3679新至陞","110/07/14","元大-福營",2,0,2
"4794","3679新至陞","110/07/14","宏遠-中和",0,1,-1
"4795","3679新至陞","110/07/14","永豐金-松山",2,0,2
"4796","3679新至陞","110/07/14","元富-佳里",0,1,-1
"4797","3679新至陞","110/07/14","永豐金-萬盛",2,0,2
"4798","3679新至陞","110/07/14","(牛牛牛)亞-鑫豐",0,1,-1
"4799","3679新至陞","110/07/14","元富-松德",1,0,1
"4800","3679新至陞","110/07/14","中國信託-中壢",0,1,-1
"4801","2727王品","110/07/14","富邦-左營",102,1,101
"4802","2727王品","110/07/14","統一-城中",100,234,-134
"4803","2727王品","110/07/14","國泰-板橋",105,11,94
"4804","2727王品","110/07/14","富邦-台北",1,125,-124
"4805","2727王品","110/07/14","港商野村",149,72,77
"4806","2727王品","110/07/14","台灣摩根士丹利",1,48,-47
"4807","2727王品","110/07/14","合庫-台中",66,2,64
"4808","2727王品","110/07/14","國票-新莊",0,40,-40
"4809","2727王品","110/07/14","臺銀-金山",63,8,55
"4810","2727王品","110/07/14","永豐金-忠孝",2,39,-37
"4811","2727王品","110/07/14","摩根大通",83,39,44
"4812","2727王品","110/07/14","富邦-彰化",1,34,-33
"4813","2727王品","110/07/14","凱基-台北",84,42,42
"4814","2727王品","110/07/14","康和-高雄",0,30,-30
"4815","2727王品","110/07/14","土銀-台中",35,1,34
"4816","2727王品","110/07/14","安泰",0,26,-26
"4817","2727王品","110/07/14","華南永昌-麻豆",32,1,31
"4818","2727王品","110/07/14","富邦-新竹華信",0,21,-21
"4819","2727王品","110/07/14","元大證券",85,55,30
"4820","2727王品","110/07/14","元大-南崁",1,22,-21
"4821","2727王品","110/07/14","新加坡商瑞銀",40,15,25
"4822","2727王品","110/07/14","彰銀-台中",0,18,-18
"4823","2727王品","110/07/14","日盛-八德",19,0,19
"4824","2727王品","110/07/14","元富-同大",2,20,-18
"4825","2727王品","110/07/14","統一",35,17,18
"4826","2727王品","110/07/14","玉山-嘉義",1,17,-16
"4827","2727王品","110/07/14","元富-大昌",18,1,17
"4828","2727王品","110/07/14","國泰-館前",4,20,-16
"4829","2727王品","110/07/14","玉山-板橋",15,1,14
"4830","2727王品","110/07/14","第一金-嘉義",1,13,-12
"4831","1570力肯","110/07/14","國票-北高雄",68,0,68
"4832","1570力肯","110/07/14","摩根大通",0,21,-21
"4833","1570力肯","110/07/14","日盛-八德",30,1,29
"4834","1570力肯","110/07/14","新光",1,19,-18
"4835","1570力肯","110/07/14","玉山-高雄",7,0,7
"4836","1570力肯","110/07/14","(牛牛牛)亞-鑫豐",0,17,-17
"4837","1570力肯","110/07/14","臺銀-臺南",5,0,5
"4838","1570力肯","110/07/14","日盛-士林",0,10,-10
"4839","1570力肯","110/07/14","凱基-三峽",5,0,5
"4840","1570力肯","110/07/14","統一-員林",0,10,-10
"4841","1570力肯","110/07/14","元大-和平",5,0,5
"4842","1570力肯","110/07/14","國票-新莊",0,10,-10
"4843","1570力肯","110/07/14","合庫-三重",4,0,4
"4844","1570力肯","110/07/14","凱基-高美館",0,10,-10
"4845","1570力肯","110/07/14","瑞士信貸",4,0,4
"4846","1570力肯","110/07/14","元大-屏東民生",0,5,-5
"4847","1570力肯","110/07/14","統一-三多",4,0,4
"4848","1570力肯","110/07/14","元大-古亭",0,5,-5
"4849","1570力肯","110/07/14","華南永昌-古亭",4,0,4
"4850","1570力肯","110/07/14","日盛-木柵",0,4,-4
"4851","1570力肯","110/07/14","元大-高雄",3,0,3
"4852","1570力肯","110/07/14","大昌",0,4,-4
"4853","1570力肯","110/07/14","兆豐-忠孝",2,0,2
"4854","1570力肯","110/07/14","群益金鼎-東大",0,4,-4
"4855","1570力肯","110/07/14","富邦-陽明",2,0,2
"4856","1570力肯","110/07/14","凱基-台北",0,4,-4
"4857","1570力肯","110/07/14","元大-松山",2,0,2
"4858","1570力肯","110/07/14","元大-板橋",0,4,-4
"4859","1570力肯","110/07/14","元大-忠孝",2,0,2
"4860","1570力肯","110/07/14","第一金-中山",0,3,-3
"4861","6180橘子","110/07/14","新加坡商瑞銀",84,28,56
"4862","6180橘子","110/07/14","凱基-台北",4,37,-33
"4863","6180橘子","110/07/14","日盛-信義",29,1,28
"4864","6180橘子","110/07/14","玉山-台南",1,22,-21
"4865","6180橘子","110/07/14","豐農",28,4,24
"4866","6180橘子","110/07/14","日盛-新竹",1,21,-20
"4867","6180橘子","110/07/14","新光-新竹",24,1,23
"4868","6180橘子","110/07/14","元富-潮州",0,19,-19
"4869","6180橘子","110/07/14","華南永昌-高雄",20,0,20
"4870","6180橘子","110/07/14","元大-信義",0,17,-17
"4871","6180橘子","110/07/14","元大-羅東",20,0,20
"4872","6180橘子","110/07/14","台灣企銀-台中",1,16,-15
"4873","6180橘子","110/07/14","元大-台中中港",20,0,20
"4874","6180橘子","110/07/14","元大-北港",0,15,-15
"4875","6180橘子","110/07/14","富邦-嘉義",24,5,19
"4876","6180橘子","110/07/14","富邦-高雄",0,14,-14
"4877","6180橘子","110/07/14","富邦-仁愛",15,0,15
"4878","6180橘子","110/07/14","兆豐-埔墘",0,13,-13
"4879","6180橘子","110/07/14","國票-九鼎",13,0,13
"4880","6180橘子","110/07/14","第一金-中山",0,10,-10
"4881","6180橘子","110/07/14","日盛-木柵",12,0,12
"4882","6180橘子","110/07/14","元大-彰化民生",0,10,-10
"4883","6180橘子","110/07/14","元大-成功",10,0,10
"4884","6180橘子","110/07/14","福勝",1,10,-9
"4885","6180橘子","110/07/14","港商野村",10,2,8
"4886","6180橘子","110/07/14","群益金鼎-丹鳳",1,10,-9
"4887","6180橘子","110/07/14","玉山-左營",8,0,8
"4888","6180橘子","110/07/14","群益金鼎-板橋",0,8,-8
"4889","6180橘子","110/07/14","富邦-陽明",16,8,8
"4890","6180橘子","110/07/14","合庫-鳳山",0,7,-7
"4891","2390云辰","110/07/14","摩根大通",995,198,797
"4892","2390云辰","110/07/14","新加坡商瑞銀",28,399,-371
"4893","2390云辰","110/07/14","美林",383,22,361
"4894","2390云辰","110/07/14","凱基-新豐",3,198,-195
"4895","2390云辰","110/07/14","台灣摩根士丹利",684,358,326
"4896","2390云辰","110/07/14","元大-士林",1,152,-151
"4897","2390云辰","110/07/14","凱基-台北",656,402,254
"4898","2390云辰","110/07/14","元大-竹山",80,181,-101
"4899","2390云辰","110/07/14","日盛-和美",110,5,105
"4900","2390云辰","110/07/14","群益金鼎-開元",19,95,-76
"4901","2390云辰","110/07/14","元大-天母",72,0,72
"4902","2390云辰","110/07/14","新光",77,150,-73
"4903","2390云辰","110/07/14","永豐金-松山",57,0,57
"4904","2390云辰","110/07/14","元富-高雄",0,71,-71
"4905","2390云辰","110/07/14","統一-屏東",53,0,53
"4906","2390云辰","110/07/14","元大-土城學府",130,201,-71
"4907","2390云辰","110/07/14","港商野村",486,450,36
"4908","2390云辰","110/07/14","元大-善化",12,76,-64
"4909","2390云辰","110/07/14","致和-崇德",30,0,30
"4910","2390云辰","110/07/14","華南永昌-岡山",23,81,-58
"4911","2390云辰","110/07/14","富邦-台北",40,14,26
"4912","2390云辰","110/07/14","群益金鼎-大興",82,125,-43
"4913","2390云辰","110/07/14","台新-高雄",38,13,25
"4914","2390云辰","110/07/14","大慶-中壢",0,41,-41
"4915","2390云辰","110/07/14","富邦-板橋",32,7,25
"4916","2390云辰","110/07/14","玉山-板橋",6,47,-41
"4917","2390云辰","110/07/14","陽信-石牌",24,0,24
"4918","2390云辰","110/07/14","富邦-台東",2,42,-40
"4919","2390云辰","110/07/14","凱基-屏東",32,8,24
"4920","2390云辰","110/07/14","元大-新營",3,42,-39
"4921","2363矽統","110/07/14","台灣摩根士丹利",463,0,463
"4922","2363矽統","110/07/14","新加坡商瑞銀",568,1321,-753
"4923","2363矽統","110/07/14","台新證券",750,342,408
"4924","2363矽統","110/07/14","瑞士信貸",149,864,-715
"4925","2363矽統","110/07/14","玉山-台中",363,51,312
"4926","2363矽統","110/07/14","台新-屏東",115,380,-265
"4927","2363矽統","110/07/14","元大-斗六",223,25,198
"4928","2363矽統","110/07/14","永豐金證券",16,265,-249
"4929","2363矽統","110/07/14","華南永昌-朴子",208,38,170
"4930","2363矽統","110/07/14","美林",462,701,-239
"4931","2363矽統","110/07/14","元富-西松",169,12,157
"4932","2363矽統","110/07/14","宏遠-桃園",269,500,-231
"4933","2363矽統","110/07/14","永豐金-大園",146,6,140
"4934","2363矽統","110/07/14","凱基-竹北",36,254,-218
"4935","2363矽統","110/07/14","土銀-和平",134,0,134
"4936","2363矽統","110/07/14","港商法國興業",0,214,-214
"4937","2363矽統","110/07/14","富邦-新營",130,13,117
"4938","2363矽統","110/07/14","港商野村",835,1044,-209
"4939","2363矽統","110/07/14","元富-成功",118,11,107
"4940","2363矽統","110/07/14","北城證券",212,411,-199
"4941","2363矽統","110/07/14","元富-烏日",121,18,103
"4942","2363矽統","110/07/14","(牛牛牛)亞-鑫豐",51,241,-190
"4943","2363矽統","110/07/14","日盛-二林",120,18,102
"4944","2363矽統","110/07/14","國票-博愛",24,213,-189
"4945","2363矽統","110/07/14","兆豐-忠孝",98,2,96
"4946","2363矽統","110/07/14","大慶-蘆洲",134,316,-182
"4947","2363矽統","110/07/14","大慶-楊梅",92,3,89
"4948","2363矽統","110/07/14","彰銀-台中",15,193,-178
"4949","2363矽統","110/07/14","元富-三重",120,33,87
"4950","2363矽統","110/07/14","日盛-和美",18,185,-167
"4951","8112至上","110/07/14","新加坡商瑞銀",223,17,206
"4952","8112至上","110/07/14","瑞士信貸",8,170,-162
"4953","8112至上","110/07/14","摩根大通",285,129,156
"4954","8112至上","110/07/14","美林",55,202,-147
"4955","8112至上","110/07/14","花旗環球",124,0,124
"4956","8112至上","110/07/14","凱基-台北",325,436,-111
"4957","8112至上","110/07/14","兆豐-公益",117,4,113
"4958","8112至上","110/07/14","台中銀-台北",0,98,-98
"4959","8112至上","110/07/14","香港上海匯豐",111,0,111
"4960","8112至上","110/07/14","玉山-台大",17,107,-90
"4961","8112至上","110/07/14","永豐金-內湖",117,21,96
"4962","8112至上","110/07/14","康和-內湖",1,90,-89
"4963","8112至上","110/07/14","台灣摩根士丹利",108,16,92
"4964","8112至上","110/07/14","港商野村",21,84,-63
"4965","8112至上","110/07/14","元大-東蘆",77,0,77
"4966","8112至上","110/07/14","兆豐-北高雄",1,60,-59
"4967","8112至上","110/07/14","新光",108,48,60
"4968","8112至上","110/07/14","群益金鼎-海山",1,52,-51
"4969","8112至上","110/07/14","大慶-蘆洲",59,0,59
"4970","8112至上","110/07/14","群益金鼎-大安",0,50,-50
"4971","8112至上","110/07/14","華南永昌-台中",56,3,53
"4972","8112至上","110/07/14","富邦-仁愛",2,49,-47
"4973","8112至上","110/07/14","土銀-嘉義",52,2,50
"4974","8112至上","110/07/14","元大-金華",0,42,-42
"4975","8112至上","110/07/14","美商高盛",40,0,40
"4976","8112至上","110/07/14","元大-內湖",4,43,-39
"4977","8112至上","110/07/14","臺銀",63,29,34
"4978","8112至上","110/07/14","第一金-華江",2,37,-35
"4979","8112至上","110/07/14","元富-嘉義",31,0,31
"4980","8112至上","110/07/14","永豐金-苓雅",2,34,-32
"4981","1570力肯","110/07/14","國票-北高雄",68,0,68
"4982","1570力肯","110/07/14","摩根大通",0,21,-21
"4983","1570力肯","110/07/14","日盛-八德",30,1,29
"4984","1570力肯","110/07/14","新光",1,19,-18
"4985","1570力肯","110/07/14","玉山-高雄",7,0,7
"4986","1570力肯","110/07/14","(牛牛牛)亞-鑫豐",0,17,-17
"4987","1570力肯","110/07/14","臺銀-臺南",5,0,5
"4988","1570力肯","110/07/14","日盛-士林",0,10,-10
"4989","1570力肯","110/07/14","凱基-三峽",5,0,5
"4990","1570力肯","110/07/14","統一-員林",0,10,-10
"4991","1570力肯","110/07/14","元大-和平",5,0,5
"4992","1570力肯","110/07/14","國票-新莊",0,10,-10
"4993","1570力肯","110/07/14","合庫-三重",4,0,4
"4994","1570力肯","110/07/14","凱基-高美館",0,10,-10
"4995","1570力肯","110/07/14","瑞士信貸",4,0,4
"4996","1570力肯","110/07/14","元大-屏東民生",0,5,-5
"4997","1570力肯","110/07/14","統一-三多",4,0,4
"4998","1570力肯","110/07/14","元大-古亭",0,5,-5
"4999","1570力肯","110/07/14","華南永昌-古亭",4,0,4
"5000","1570力肯","110/07/14","日盛-木柵",0,4,-4
"5001","1570力肯","110/07/14","元大-高雄",3,0,3
"5002","1570力肯","110/07/14","大昌",0,4,-4
"5003","1570力肯","110/07/14","兆豐-忠孝",2,0,2
"5004","1570力肯","110/07/14","群益金鼎-東大",0,4,-4
"5005","1570力肯","110/07/14","富邦-陽明",2,0,2
"5006","1570力肯","110/07/14","凱基-台北",0,4,-4
"5007","1570力肯","110/07/14","元大-松山",2,0,2
"5008","1570力肯","110/07/14","元大-板橋",0,4,-4
"5009","1570力肯","110/07/14","元大-忠孝",2,0,2
"5010","1570力肯","110/07/14","第一金-中山",0,3,-3
"5011","2929淘帝","110/07/14","華南永昌-林口",60,0,60
"5012","2929淘帝","110/07/14","群益金鼎",25,540,-515
"5013","2929淘帝","110/07/14","美林",87,31,56
"5014","2929淘帝","110/07/14","國泰-台南",1,30,-29
"5015","2929淘帝","110/07/14","元富-台南",40,0,40
"5016","2929淘帝","110/07/14","宏遠-桃園",0,20,-20
"5017","2929淘帝","110/07/14","元大-民生",39,0,39
"5018","2929淘帝","110/07/14","摩根大通",11,31,-20
"5019","2929淘帝","110/07/14","臺銀-鳳山",34,0,34
"5020","2929淘帝","110/07/14","台新-建北",5,20,-15
"5021","2929淘帝","110/07/14","合庫-高雄",34,1,33
"5022","2929淘帝","110/07/14","新光",1,16,-15
"5023","2929淘帝","110/07/14","華南永昌-鶯歌",28,0,28
"5024","2929淘帝","110/07/14","玉山-板橋",0,15,-15
"5025","2929淘帝","110/07/14","永興",25,0,25
"5026","2929淘帝","110/07/14","凱基-羅東",0,15,-15
"5027","2929淘帝","110/07/14","元大-新盛",25,1,24
"5028","2929淘帝","110/07/14","元大-頭份",0,15,-15
"5029","2929淘帝","110/07/14","日盛-南京",23,0,23
"5030","2929淘帝","110/07/14","第一金-台南",0,13,-13
"5031","2929淘帝","110/07/14","日茂",20,0,20
"5032","2929淘帝","110/07/14","富邦-基隆",0,12,-12
"5033","2929淘帝","110/07/14","台新-台中",20,0,20
"5034","2929淘帝","110/07/14","日茂-南投",1,12,-11
"5035","2929淘帝","110/07/14","華南永昌",20,0,20
"5036","2929淘帝","110/07/14","元大-豐原站前",0,11,-11
"5037","2929淘帝","110/07/14","福勝",15,0,15
"5038","2929淘帝","110/07/14","玉山-士林",0,10,-10
"5039","2929淘帝","110/07/14","富邦-南屯",15,0,15
"5040","2929淘帝","110/07/14","富邦-台北",0,10,-10
"5041","5410國眾","110/07/14","兆豐-城中",35,0,35
"5042","5410國眾","110/07/14","瑞士信貸",0,29,-29
"5043","5410國眾","110/07/14","新光",21,1,20
"5044","5410國眾","110/07/14","國泰-板橋",1,30,-29
"5045","5410國眾","110/07/14","國泰-敦南",21,1,20
"5046","5410國眾","110/07/14","日盛-高雄",0,20,-20
"5047","5410國眾","110/07/14","國泰-台中",20,1,19
"5048","5410國眾","110/07/14","台新-左楠",1,20,-19
"5049","5410國眾","110/07/14","元大-崇德",19,0,19
"5050","5410國眾","110/07/14","元富-大昌",1,18,-17
"5051","5410國眾","110/07/14","土銀-士林",18,0,18
"5052","5410國眾","110/07/14","富邦-建國",0,15,-15
"5053","5410國眾","110/07/14","元大-新盛",20,2,18
"5054","5410國眾","110/07/14","元富-嘉義",0,12,-12
"5055","5410國眾","110/07/14","兆豐-高雄",15,0,15
"5056","5410國眾","110/07/14","永全-南崁",0,12,-12
"5057","5410國眾","110/07/14","宏遠-中和",10,0,10
"5058","5410國眾","110/07/14","元大-員林",0,11,-11
"5059","5410國眾","110/07/14","新光-桃園",10,0,10
"5060","5410國眾","110/07/14","高橋",0,10,-10
"5061","5410國眾","110/07/14","國泰-台南",10,0,10
"5062","5410國眾","110/07/14","永興",0,10,-10
"5063","5410國眾","110/07/14","元大-復北",10,0,10
"5064","5410國眾","110/07/14","華南永昌-三重",0,10,-10
"5065","5410國眾","110/07/14","元大-竹科",8,0,8
"5066","5410國眾","110/07/14","元大-苑裡",0,7,-7
"5067","5410國眾","110/07/14","台新-新營",6,0,6
"5068","5410國眾","110/07/14","港商野村",0,6,-6
"5069","5410國眾","110/07/14","日盛-士林",5,0,5
"5070","5410國眾","110/07/14","摩根大通",5,11,-6
"5071","2841台開","110/07/14","凱基-文心",73,0,73
"5072","2841台開","110/07/14","國泰-敦南",0,50,-50
"5073","2841台開","110/07/14","元富-潮州",30,0,30
"5074","2841台開","110/07/14","凱基-中壢",0,40,-40
"5075","2841台開","110/07/14","第一金-台中",20,0,20
"5076","2841台開","110/07/14","統一-新竹",0,24,-24
"5077","2841台開","110/07/14","華南永昌-新莊",20,0,20
"5078","2841台開","110/07/14","元富-草屯",0,20,-20
"5079","2841台開","110/07/14","永豐金-豐原",20,0,20
"5080","2841台開","110/07/14","台新-台南",0,20,-20
"5081","2841台開","110/07/14","國泰-館前",15,0,15
"5082","2841台開","110/07/14","永豐金-敦南",45,63,-18
"5083","2841台開","110/07/14","群益金鼎-基隆",12,0,12
"5084","2841台開","110/07/14","國票-北高雄",0,13,-13
"5085","2841台開","110/07/14","日盛-信義",10,0,10
"5086","2841台開","110/07/14","凱基-松山",0,10,-10
"5087","2841台開","110/07/14","台新-台中",10,0,10
"5088","2841台開","110/07/14","元大證券",0,10,-10
"5089","2841台開","110/07/14","新光",10,1,9
"5090","2841台開","110/07/14","元大-中壢",0,10,-10
"5091","2841台開","110/07/14","凱基-新店",8,0,8
"5092","2841台開","110/07/14","富邦-陽明",1,10,-9
"5093","2841台開","110/07/14","元大-斗信",7,0,7
"5094","2841台開","110/07/14","富邦-建國",0,9,-9
"5095","2841台開","110/07/14","元大-三重",6,0,6
"5096","2841台開","110/07/14","富邦-台南",0,8,-8
"5097","2841台開","110/07/14","永豐金-中和",6,0,6
"5098","2841台開","110/07/14","康和-澎湖",0,7,-7
"5099","2841台開","110/07/14","元富-成功",5,0,5
"5100","2841台開","110/07/14","日盛-斗六",0,6,-6
"5101","6207雷科","110/07/14","群益金鼎-台北",60,0,60
"5102","6207雷科","110/07/14","新加坡商瑞銀",10,56,-46
"5103","6207雷科","110/07/14","台新-高雄",43,3,40
"5104","6207雷科","110/07/14","國票-中和",0,41,-41
"5105","6207雷科","110/07/14","元大-高雄",19,0,19
"5106","6207雷科","110/07/14","元大-復北",0,33,-33
"5107","6207雷科","110/07/14","福勝",15,0,15
"5108","6207雷科","110/07/14","光和-和美",0,20,-20
"5109","6207雷科","110/07/14","群益金鼎-中山",15,0,15
"5110","6207雷科","110/07/14","群益金鼎-丹鳳",0,20,-20
"5111","6207雷科","110/07/14","元大-林園",15,0,15
"5112","6207雷科","110/07/14","第一金-路竹",0,10,-10
"5113","6207雷科","110/07/14","新光",12,0,12
"5114","6207雷科","110/07/14","元大-歸仁",0,10,-10
"5115","6207雷科","110/07/14","元大-大天母",10,0,10
"5116","6207雷科","110/07/14","宏遠-館前",0,9,-9
"5117","6207雷科","110/07/14","永豐金-忠孝",9,0,9
"5118","6207雷科","110/07/14","凱基-台北",12,20,-8
"5119","6207雷科","110/07/14","永豐金-新店",7,0,7
"5120","6207雷科","110/07/14","美林",0,7,-7
"5121","6207雷科","110/07/14","玉山-嘉義",6,0,6
"5122","6207雷科","110/07/14","摩根大通",16,23,-7
"5123","6207雷科","110/07/14","元大-屏東",6,0,6
"5124","6207雷科","110/07/14","凱基-高雄",1,7,-6
"5125","6207雷科","110/07/14","凱基-大安",5,0,5
"5126","6207雷科","110/07/14","台中銀-豐原",0,5,-5
"5127","6207雷科","110/07/14","富邦-台南",5,0,5
"5128","6207雷科","110/07/14","元大-新竹經國",0,5,-5
"5129","6207雷科","110/07/14","元大-成功",5,0,5
"5130","6207雷科","110/07/14","光和-田中",0,4,-4
"5131","3679新至陞","110/07/14","凱基-台北",31,6,25
"5132","3679新至陞","110/07/14","群益金鼎-東大",0,15,-15
"5133","3679新至陞","110/07/14","華南永昌-新莊",10,0,10
"5134","3679新至陞","110/07/14","瑞士信貸",0,12,-12
"5135","3679新至陞","110/07/14","新加坡商瑞銀",11,3,8
"5136","3679新至陞","110/07/14","群益金鼎-永和",0,10,-10
"5137","3679新至陞","110/07/14","美商高盛",6,0,6
"5138","3679新至陞","110/07/14","元大-成功",5,15,-10
"5139","3679新至陞","110/07/14","第一金-中壢",6,0,6
"5140","3679新至陞","110/07/14","統一-板橋",1,10,-9
"5141","3679新至陞","110/07/14","(牛牛牛)亞-網路",4,0,4
"5142","3679新至陞","110/07/14","玉山-左營",0,5,-5
"5143","3679新至陞","110/07/14","元大-六合",3,0,3
"5144","3679新至陞","110/07/14","群益金鼎-三民",0,4,-4
"5145","3679新至陞","110/07/14","合庫-自強",2,0,2
"5146","3679新至陞","110/07/14","富邦-宜蘭",0,4,-4
"5147","3679新至陞","110/07/14","高橋-內壢",2,0,2
"5148","3679新至陞","110/07/14","永豐金-苓雅",0,3,-3
"5149","3679新至陞","110/07/14","台中銀-員林",2,0,2
"5150","3679新至陞","110/07/14","摩根大通",5,7,-2
"5151","3679新至陞","110/07/14","凱基-高美館",2,0,2
"5152","3679新至陞","110/07/14","元大-板橋三民",0,2,-2
"5153","3679新至陞","110/07/14","元大-福營",2,0,2
"5154","3679新至陞","110/07/14","宏遠-中和",0,1,-1
"5155","3679新至陞","110/07/14","永豐金-松山",2,0,2
"5156","3679新至陞","110/07/14","元富-佳里",0,1,-1
"5157","3679新至陞","110/07/14","永豐金-萬盛",2,0,2
"5158","3679新至陞","110/07/14","(牛牛牛)亞-鑫豐",0,1,-1
"5159","3679新至陞","110/07/14","元富-松德",1,0,1
"5160","3679新至陞","110/07/14","中國信託-中壢",0,1,-1
"5161","2727王品","110/07/14","富邦-左營",102,1,101
"5162","2727王品","110/07/14","統一-城中",100,234,-134
"5163","2727王品","110/07/14","國泰-板橋",105,11,94
"5164","2727王品","110/07/14","富邦-台北",1,125,-124
"5165","2727王品","110/07/14","港商野村",149,72,77
"5166","2727王品","110/07/14","台灣摩根士丹利",1,48,-47
"5167","2727王品","110/07/14","合庫-台中",66,2,64
"5168","2727王品","110/07/14","國票-新莊",0,40,-40
"5169","2727王品","110/07/14","臺銀-金山",63,8,55
"5170","2727王品","110/07/14","永豐金-忠孝",2,39,-37
"5171","2727王品","110/07/14","摩根大通",83,39,44
"5172","2727王品","110/07/14","富邦-彰化",1,34,-33
"5173","2727王品","110/07/14","凱基-台北",84,42,42
"5174","2727王品","110/07/14","康和-高雄",0,30,-30
"5175","2727王品","110/07/14","土銀-台中",35,1,34
"5176","2727王品","110/07/14","安泰",0,26,-26
"5177","2727王品","110/07/14","華南永昌-麻豆",32,1,31
"5178","2727王品","110/07/14","富邦-新竹華信",0,21,-21
"5179","2727王品","110/07/14","元大證券",85,55,30
"5180","2727王品","110/07/14","元大-南崁",1,22,-21
"5181","2727王品","110/07/14","新加坡商瑞銀",40,15,25
"5182","2727王品","110/07/14","彰銀-台中",0,18,-18
"5183","2727王品","110/07/14","日盛-八德",19,0,19
"5184","2727王品","110/07/14","元富-同大",2,20,-18
"5185","2727王品","110/07/14","統一",35,17,18
"5186","2727王品","110/07/14","玉山-嘉義",1,17,-16
"5187","2727王品","110/07/14","元富-大昌",18,1,17
"5188","2727王品","110/07/14","國泰-館前",4,20,-16
"5189","2727王品","110/07/14","玉山-板橋",15,1,14
"5190","2727王品","110/07/14","第一金-嘉義",1,13,-12
"5191","1570力肯","110/07/14","國票-北高雄",68,0,68
"5192","1570力肯","110/07/14","摩根大通",0,21,-21
"5193","1570力肯","110/07/14","日盛-八德",30,1,29
"5194","1570力肯","110/07/14","新光",1,19,-18
"5195","1570力肯","110/07/14","玉山-高雄",7,0,7
"5196","1570力肯","110/07/14","(牛牛牛)亞-鑫豐",0,17,-17
"5197","1570力肯","110/07/14","臺銀-臺南",5,0,5
"5198","1570力肯","110/07/14","日盛-士林",0,10,-10
"5199","1570力肯","110/07/14","凱基-三峽",5,0,5
"5200","1570力肯","110/07/14","統一-員林",0,10,-10
"5201","1570力肯","110/07/14","元大-和平",5,0,5
"5202","1570力肯","110/07/14","國票-新莊",0,10,-10
"5203","1570力肯","110/07/14","合庫-三重",4,0,4
"5204","1570力肯","110/07/14","凱基-高美館",0,10,-10
"5205","1570力肯","110/07/14","瑞士信貸",4,0,4
"5206","1570力肯","110/07/14","元大-屏東民生",0,5,-5
"5207","1570力肯","110/07/14","統一-三多",4,0,4
"5208","1570力肯","110/07/14","元大-古亭",0,5,-5
"5209","1570力肯","110/07/14","華南永昌-古亭",4,0,4
"5210","1570力肯","110/07/14","日盛-木柵",0,4,-4
"5211","1570力肯","110/07/14","元大-高雄",3,0,3
"5212","1570力肯","110/07/14","大昌",0,4,-4
"5213","1570力肯","110/07/14","兆豐-忠孝",2,0,2
"5214","1570力肯","110/07/14","群益金鼎-東大",0,4,-4
"5215","1570力肯","110/07/14","富邦-陽明",2,0,2
"5216","1570力肯","110/07/14","凱基-台北",0,4,-4
"5217","1570力肯","110/07/14","元大-松山",2,0,2
"5218","1570力肯","110/07/14","元大-板橋",0,4,-4
"5219","1570力肯","110/07/14","元大-忠孝",2,0,2
"5220","1570力肯","110/07/14","第一金-中山",0,3,-3
"5221","6180橘子","110/07/14","新加坡商瑞銀",84,28,56
"5222","6180橘子","110/07/14","凱基-台北",4,37,-33
"5223","6180橘子","110/07/14","日盛-信義",29,1,28
"5224","6180橘子","110/07/14","玉山-台南",1,22,-21
"5225","6180橘子","110/07/14","豐農",28,4,24
"5226","6180橘子","110/07/14","日盛-新竹",1,21,-20
"5227","6180橘子","110/07/14","新光-新竹",24,1,23
"5228","6180橘子","110/07/14","元富-潮州",0,19,-19
"5229","6180橘子","110/07/14","華南永昌-高雄",20,0,20
"5230","6180橘子","110/07/14","元大-信義",0,17,-17
"5231","6180橘子","110/07/14","元大-羅東",20,0,20
"5232","6180橘子","110/07/14","台灣企銀-台中",1,16,-15
"5233","6180橘子","110/07/14","元大-台中中港",20,0,20
"5234","6180橘子","110/07/14","元大-北港",0,15,-15
"5235","6180橘子","110/07/14","富邦-嘉義",24,5,19
"5236","6180橘子","110/07/14","富邦-高雄",0,14,-14
"5237","6180橘子","110/07/14","富邦-仁愛",15,0,15
"5238","6180橘子","110/07/14","兆豐-埔墘",0,13,-13
"5239","6180橘子","110/07/14","國票-九鼎",13,0,13
"5240","6180橘子","110/07/14","第一金-中山",0,10,-10
"5241","6180橘子","110/07/14","日盛-木柵",12,0,12
"5242","6180橘子","110/07/14","元大-彰化民生",0,10,-10
"5243","6180橘子","110/07/14","元大-成功",10,0,10
"5244","6180橘子","110/07/14","福勝",1,10,-9
"5245","6180橘子","110/07/14","港商野村",10,2,8
"5246","6180橘子","110/07/14","群益金鼎-丹鳳",1,10,-9
"5247","6180橘子","110/07/14","玉山-左營",8,0,8
"5248","6180橘子","110/07/14","群益金鼎-板橋",0,8,-8
"5249","6180橘子","110/07/14","富邦-陽明",16,8,8
"5250","6180橘子","110/07/14","合庫-鳳山",0,7,-7
"5251","2390云辰","110/07/14","摩根大通",995,198,797
"5252","2390云辰","110/07/14","新加坡商瑞銀",28,399,-371
"5253","2390云辰","110/07/14","美林",383,22,361
"5254","2390云辰","110/07/14","凱基-新豐",3,198,-195
"5255","2390云辰","110/07/14","台灣摩根士丹利",684,358,326
"5256","2390云辰","110/07/14","元大-士林",1,152,-151
"5257","2390云辰","110/07/14","凱基-台北",656,402,254
"5258","2390云辰","110/07/14","元大-竹山",80,181,-101
"5259","2390云辰","110/07/14","日盛-和美",110,5,105
"5260","2390云辰","110/07/14","群益金鼎-開元",19,95,-76
"5261","2390云辰","110/07/14","元大-天母",72,0,72
"5262","2390云辰","110/07/14","新光",77,150,-73
"5263","2390云辰","110/07/14","永豐金-松山",57,0,57
"5264","2390云辰","110/07/14","元富-高雄",0,71,-71
"5265","2390云辰","110/07/14","統一-屏東",53,0,53
"5266","2390云辰","110/07/14","元大-土城學府",130,201,-71
"5267","2390云辰","110/07/14","港商野村",486,450,36
"5268","2390云辰","110/07/14","元大-善化",12,76,-64
"5269","2390云辰","110/07/14","致和-崇德",30,0,30
"5270","2390云辰","110/07/14","華南永昌-岡山",23,81,-58
"5271","2390云辰","110/07/14","富邦-台北",40,14,26
"5272","2390云辰","110/07/14","群益金鼎-大興",82,125,-43
"5273","2390云辰","110/07/14","台新-高雄",38,13,25
"5274","2390云辰","110/07/14","大慶-中壢",0,41,-41
"5275","2390云辰","110/07/14","富邦-板橋",32,7,25
"5276","2390云辰","110/07/14","玉山-板橋",6,47,-41
"5277","2390云辰","110/07/14","陽信-石牌",24,0,24
"5278","2390云辰","110/07/14","富邦-台東",2,42,-40
"5279","2390云辰","110/07/14","凱基-屏東",32,8,24
"5280","2390云辰","110/07/14","元大-新營",3,42,-39
"5281","2363矽統","110/07/14","台灣摩根士丹利",463,0,463
"5282","2363矽統","110/07/14","新加坡商瑞銀",568,1321,-753
"5283","2363矽統","110/07/14","台新證券",750,342,408
"5284","2363矽統","110/07/14","瑞士信貸",149,864,-715
"5285","2363矽統","110/07/14","玉山-台中",363,51,312
"5286","2363矽統","110/07/14","台新-屏東",115,380,-265
"5287","2363矽統","110/07/14","元大-斗六",223,25,198
"5288","2363矽統","110/07/14","永豐金證券",16,265,-249
"5289","2363矽統","110/07/14","華南永昌-朴子",208,38,170
"5290","2363矽統","110/07/14","美林",462,701,-239
"5291","2363矽統","110/07/14","元富-西松",169,12,157
"5292","2363矽統","110/07/14","宏遠-桃園",269,500,-231
"5293","2363矽統","110/07/14","永豐金-大園",146,6,140
"5294","2363矽統","110/07/14","凱基-竹北",36,254,-218
"5295","2363矽統","110/07/14","土銀-和平",134,0,134
"5296","2363矽統","110/07/14","港商法國興業",0,214,-214
"5297","2363矽統","110/07/14","富邦-新營",130,13,117
"5298","2363矽統","110/07/14","港商野村",835,1044,-209
"5299","2363矽統","110/07/14","元富-成功",118,11,107
"5300","2363矽統","110/07/14","北城證券",212,411,-199
"5301","2363矽統","110/07/14","元富-烏日",121,18,103
"5302","2363矽統","110/07/14","(牛牛牛)亞-鑫豐",51,241,-190
"5303","2363矽統","110/07/14","日盛-二林",120,18,102
"5304","2363矽統","110/07/14","國票-博愛",24,213,-189
"5305","2363矽統","110/07/14","兆豐-忠孝",98,2,96
"5306","2363矽統","110/07/14","大慶-蘆洲",134,316,-182
"5307","2363矽統","110/07/14","大慶-楊梅",92,3,89
"5308","2363矽統","110/07/14","彰銀-台中",15,193,-178
"5309","2363矽統","110/07/14","元富-三重",120,33,87
"5310","2363矽統","110/07/14","日盛-和美",18,185,-167
"5311","8112至上","110/07/14","新加坡商瑞銀",223,17,206
"5312","8112至上","110/07/14","瑞士信貸",8,170,-162
"5313","8112至上","110/07/14","摩根大通",285,129,156
"5314","8112至上","110/07/14","美林",55,202,-147
"5315","8112至上","110/07/14","花旗環球",124,0,124
"5316","8112至上","110/07/14","凱基-台北",325,436,-111
"5317","8112至上","110/07/14","兆豐-公益",117,4,113
"5318","8112至上","110/07/14","台中銀-台北",0,98,-98
"5319","8112至上","110/07/14","香港上海匯豐",111,0,111
"5320","8112至上","110/07/14","玉山-台大",17,107,-90
"5321","8112至上","110/07/14","永豐金-內湖",117,21,96
"5322","8112至上","110/07/14","康和-內湖",1,90,-89
"5323","8112至上","110/07/14","台灣摩根士丹利",108,16,92
"5324","8112至上","110/07/14","港商野村",21,84,-63
"5325","8112至上","110/07/14","元大-東蘆",77,0,77
"5326","8112至上","110/07/14","兆豐-北高雄",1,60,-59
"5327","8112至上","110/07/14","新光",108,48,60
"5328","8112至上","110/07/14","群益金鼎-海山",1,52,-51
"5329","8112至上","110/07/14","大慶-蘆洲",59,0,59
"5330","8112至上","110/07/14","群益金鼎-大安",0,50,-50
"5331","8112至上","110/07/14","華南永昌-台中",56,3,53
"5332","8112至上","110/07/14","富邦-仁愛",2,49,-47
"5333","8112至上","110/07/14","土銀-嘉義",52,2,50
"5334","8112至上","110/07/14","元大-金華",0,42,-42
"5335","8112至上","110/07/14","美商高盛",40,0,40
"5336","8112至上","110/07/14","元大-內湖",4,43,-39
"5337","8112至上","110/07/14","臺銀",63,29,34
"5338","8112至上","110/07/14","第一金-華江",2,37,-35
"5339","8112至上","110/07/14","元富-嘉義",31,0,31
"5340","8112至上","110/07/14","永豐金-苓雅",2,34,-32
"5341","1570力肯","110/07/14","國票-北高雄",68,0,68
"5342","1570力肯","110/07/14","摩根大通",0,21,-21
"5343","1570力肯","110/07/14","日盛-八德",30,1,29
"5344","1570力肯","110/07/14","新光",1,19,-18
"5345","1570力肯","110/07/14","玉山-高雄",7,0,7
"5346","1570力肯","110/07/14","(牛牛牛)亞-鑫豐",0,17,-17
"5347","1570力肯","110/07/14","臺銀-臺南",5,0,5
"5348","1570力肯","110/07/14","日盛-士林",0,10,-10
"5349","1570力肯","110/07/14","凱基-三峽",5,0,5
"5350","1570力肯","110/07/14","統一-員林",0,10,-10
"5351","1570力肯","110/07/14","元大-和平",5,0,5
"5352","1570力肯","110/07/14","國票-新莊",0,10,-10
"5353","1570力肯","110/07/14","合庫-三重",4,0,4
"5354","1570力肯","110/07/14","凱基-高美館",0,10,-10
"5355","1570力肯","110/07/14","瑞士信貸",4,0,4
"5356","1570力肯","110/07/14","元大-屏東民生",0,5,-5
"5357","1570力肯","110/07/14","統一-三多",4,0,4
"5358","1570力肯","110/07/14","元大-古亭",0,5,-5
"5359","1570力肯","110/07/14","華南永昌-古亭",4,0,4
"5360","1570力肯","110/07/14","日盛-木柵",0,4,-4
"5361","1570力肯","110/07/14","元大-高雄",3,0,3
"5362","1570力肯","110/07/14","大昌",0,4,-4
"5363","1570力肯","110/07/14","兆豐-忠孝",2,0,2
"5364","1570力肯","110/07/14","群益金鼎-東大",0,4,-4
"5365","1570力肯","110/07/14","富邦-陽明",2,0,2
"5366","1570力肯","110/07/14","凱基-台北",0,4,-4
"5367","1570力肯","110/07/14","元大-松山",2,0,2
"5368","1570力肯","110/07/14","元大-板橋",0,4,-4
"5369","1570力肯","110/07/14","元大-忠孝",2,0,2
"5370","1570力肯","110/07/14","第一金-中山",0,3,-3
"5371","2929淘帝","110/07/14","華南永昌-林口",60,0,60
"5372","2929淘帝","110/07/14","群益金鼎",25,540,-515
"5373","2929淘帝","110/07/14","美林",87,31,56
"5374","2929淘帝","110/07/14","國泰-台南",1,30,-29
"5375","2929淘帝","110/07/14","元富-台南",40,0,40
"5376","2929淘帝","110/07/14","宏遠-桃園",0,20,-20
"5377","2929淘帝","110/07/14","元大-民生",39,0,39
"5378","2929淘帝","110/07/14","摩根大通",11,31,-20
"5379","2929淘帝","110/07/14","臺銀-鳳山",34,0,34
"5380","2929淘帝","110/07/14","台新-建北",5,20,-15
"5381","2929淘帝","110/07/14","合庫-高雄",34,1,33
"5382","2929淘帝","110/07/14","新光",1,16,-15
"5383","2929淘帝","110/07/14","華南永昌-鶯歌",28,0,28
"5384","2929淘帝","110/07/14","玉山-板橋",0,15,-15
"5385","2929淘帝","110/07/14","永興",25,0,25
"5386","2929淘帝","110/07/14","凱基-羅東",0,15,-15
"5387","2929淘帝","110/07/14","元大-新盛",25,1,24
"5388","2929淘帝","110/07/14","元大-頭份",0,15,-15
"5389","2929淘帝","110/07/14","日盛-南京",23,0,23
"5390","2929淘帝","110/07/14","第一金-台南",0,13,-13
"5391","2929淘帝","110/07/14","日茂",20,0,20
"5392","2929淘帝","110/07/14","富邦-基隆",0,12,-12
"5393","2929淘帝","110/07/14","台新-台中",20,0,20
"5394","2929淘帝","110/07/14","日茂-南投",1,12,-11
"5395","2929淘帝","110/07/14","華南永昌",20,0,20
"5396","2929淘帝","110/07/14","元大-豐原站前",0,11,-11
"5397","2929淘帝","110/07/14","福勝",15,0,15
"5398","2929淘帝","110/07/14","玉山-士林",0,10,-10
"5399","2929淘帝","110/07/14","富邦-南屯",15,0,15
"5400","2929淘帝","110/07/14","富邦-台北",0,10,-10
"5401","5410國眾","110/07/14","兆豐-城中",35,0,35
"5402","5410國眾","110/07/14","瑞士信貸",0,29,-29
"5403","5410國眾","110/07/14","新光",21,1,20
"5404","5410國眾","110/07/14","國泰-板橋",1,30,-29
"5405","5410國眾","110/07/14","國泰-敦南",21,1,20
"5406","5410國眾","110/07/14","日盛-高雄",0,20,-20
"5407","5410國眾","110/07/14","國泰-台中",20,1,19
"5408","5410國眾","110/07/14","台新-左楠",1,20,-19
"5409","5410國眾","110/07/14","元大-崇德",19,0,19
"5410","5410國眾","110/07/14","元富-大昌",1,18,-17
"5411","5410國眾","110/07/14","土銀-士林",18,0,18
"5412","5410國眾","110/07/14","富邦-建國",0,15,-15
"5413","5410國眾","110/07/14","元大-新盛",20,2,18
"5414","5410國眾","110/07/14","元富-嘉義",0,12,-12
"5415","5410國眾","110/07/14","兆豐-高雄",15,0,15
"5416","5410國眾","110/07/14","永全-南崁",0,12,-12
"5417","5410國眾","110/07/14","宏遠-中和",10,0,10
"5418","5410國眾","110/07/14","元大-員林",0,11,-11
"5419","5410國眾","110/07/14","新光-桃園",10,0,10
"5420","5410國眾","110/07/14","高橋",0,10,-10
"5421","5410國眾","110/07/14","國泰-台南",10,0,10
"5422","5410國眾","110/07/14","永興",0,10,-10
"5423","5410國眾","110/07/14","元大-復北",10,0,10
"5424","5410國眾","110/07/14","華南永昌-三重",0,10,-10
"5425","5410國眾","110/07/14","元大-竹科",8,0,8
"5426","5410國眾","110/07/14","元大-苑裡",0,7,-7
"5427","5410國眾","110/07/14","台新-新營",6,0,6
"5428","5410國眾","110/07/14","港商野村",0,6,-6
"5429","5410國眾","110/07/14","日盛-士林",5,0,5
"5430","5410國眾","110/07/14","摩根大通",5,11,-6
"5431","2841台開","110/07/14","凱基-文心",73,0,73
"5432","2841台開","110/07/14","國泰-敦南",0,50,-50
"5433","2841台開","110/07/14","元富-潮州",30,0,30
"5434","2841台開","110/07/14","凱基-中壢",0,40,-40
"5435","2841台開","110/07/14","第一金-台中",20,0,20
"5436","2841台開","110/07/14","統一-新竹",0,24,-24
"5437","2841台開","110/07/14","華南永昌-新莊",20,0,20
"5438","2841台開","110/07/14","元富-草屯",0,20,-20
"5439","2841台開","110/07/14","永豐金-豐原",20,0,20
"5440","2841台開","110/07/14","台新-台南",0,20,-20
"5441","2841台開","110/07/14","國泰-館前",15,0,15
"5442","2841台開","110/07/14","永豐金-敦南",45,63,-18
"5443","2841台開","110/07/14","群益金鼎-基隆",12,0,12
"5444","2841台開","110/07/14","國票-北高雄",0,13,-13
"5445","2841台開","110/07/14","日盛-信義",10,0,10
"5446","2841台開","110/07/14","凱基-松山",0,10,-10
"5447","2841台開","110/07/14","台新-台中",10,0,10
"5448","2841台開","110/07/14","元大證券",0,10,-10
"5449","2841台開","110/07/14","新光",10,1,9
"5450","2841台開","110/07/14","元大-中壢",0,10,-10
"5451","2841台開","110/07/14","凱基-新店",8,0,8
"5452","2841台開","110/07/14","富邦-陽明",1,10,-9
"5453","2841台開","110/07/14","元大-斗信",7,0,7
"5454","2841台開","110/07/14","富邦-建國",0,9,-9
"5455","2841台開","110/07/14","元大-三重",6,0,6
"5456","2841台開","110/07/14","富邦-台南",0,8,-8
"5457","2841台開","110/07/14","永豐金-中和",6,0,6
"5458","2841台開","110/07/14","康和-澎湖",0,7,-7
"5459","2841台開","110/07/14","元富-成功",5,0,5
"5460","2841台開","110/07/14","日盛-斗六",0,6,-6
"5461","6207雷科","110/07/14","群益金鼎-台北",60,0,60
"5462","6207雷科","110/07/14","新加坡商瑞銀",10,56,-46
"5463","6207雷科","110/07/14","台新-高雄",43,3,40
"5464","6207雷科","110/07/14","國票-中和",0,41,-41
"5465","6207雷科","110/07/14","元大-高雄",19,0,19
"5466","6207雷科","110/07/14","元大-復北",0,33,-33
"5467","6207雷科","110/07/14","福勝",15,0,15
"5468","6207雷科","110/07/14","光和-和美",0,20,-20
"5469","6207雷科","110/07/14","群益金鼎-中山",15,0,15
"5470","6207雷科","110/07/14","群益金鼎-丹鳳",0,20,-20
"5471","6207雷科","110/07/14","元大-林園",15,0,15
"5472","6207雷科","110/07/14","第一金-路竹",0,10,-10
"5473","6207雷科","110/07/14","新光",12,0,12
"5474","6207雷科","110/07/14","元大-歸仁",0,10,-10
"5475","6207雷科","110/07/14","元大-大天母",10,0,10
"5476","6207雷科","110/07/14","宏遠-館前",0,9,-9
"5477","6207雷科","110/07/14","永豐金-忠孝",9,0,9
"5478","6207雷科","110/07/14","凱基-台北",12,20,-8
"5479","6207雷科","110/07/14","永豐金-新店",7,0,7
"5480","6207雷科","110/07/14","美林",0,7,-7
"5481","6207雷科","110/07/14","玉山-嘉義",6,0,6
"5482","6207雷科","110/07/14","摩根大通",16,23,-7
"5483","6207雷科","110/07/14","元大-屏東",6,0,6
"5484","6207雷科","110/07/14","凱基-高雄",1,7,-6
"5485","6207雷科","110/07/14","凱基-大安",5,0,5
"5486","6207雷科","110/07/14","台中銀-豐原",0,5,-5
"5487","6207雷科","110/07/14","富邦-台南",5,0,5
"5488","6207雷科","110/07/14","元大-新竹經國",0,5,-5
"5489","6207雷科","110/07/14","元大-成功",5,0,5
"5490","6207雷科","110/07/14","光和-田中",0,4,-4
"5491","3679新至陞","110/07/14","凱基-台北",31,6,25
"5492","3679新至陞","110/07/14","群益金鼎-東大",0,15,-15
"5493","3679新至陞","110/07/14","華南永昌-新莊",10,0,10
"5494","3679新至陞","110/07/14","瑞士信貸",0,12,-12
"5495","3679新至陞","110/07/14","新加坡商瑞銀",11,3,8
"5496","3679新至陞","110/07/14","群益金鼎-永和",0,10,-10
"5497","3679新至陞","110/07/14","美商高盛",6,0,6
"5498","3679新至陞","110/07/14","元大-成功",5,15,-10
"5499","3679新至陞","110/07/14","第一金-中壢",6,0,6
"5500","3679新至陞","110/07/14","統一-板橋",1,10,-9
"5501","3679新至陞","110/07/14","(牛牛牛)亞-網路",4,0,4
"5502","3679新至陞","110/07/14","玉山-左營",0,5,-5
"5503","3679新至陞","110/07/14","元大-六合",3,0,3
"5504","3679新至陞","110/07/14","群益金鼎-三民",0,4,-4
"5505","3679新至陞","110/07/14","合庫-自強",2,0,2
"5506","3679新至陞","110/07/14","富邦-宜蘭",0,4,-4
"5507","3679新至陞","110/07/14","高橋-內壢",2,0,2
"5508","3679新至陞","110/07/14","永豐金-苓雅",0,3,-3
"5509","3679新至陞","110/07/14","台中銀-員林",2,0,2
"5510","3679新至陞","110/07/14","摩根大通",5,7,-2
"5511","3679新至陞","110/07/14","凱基-高美館",2,0,2
"5512","3679新至陞","110/07/14","元大-板橋三民",0,2,-2
"5513","3679新至陞","110/07/14","元大-福營",2,0,2
"5514","3679新至陞","110/07/14","宏遠-中和",0,1,-1
"5515","3679新至陞","110/07/14","永豐金-松山",2,0,2
"5516","3679新至陞","110/07/14","元富-佳里",0,1,-1
"5517","3679新至陞","110/07/14","永豐金-萬盛",2,0,2
"5518","3679新至陞","110/07/14","(牛牛牛)亞-鑫豐",0,1,-1
"5519","3679新至陞","110/07/14","元富-松德",1,0,1
"5520","3679新至陞","110/07/14","中國信託-中壢",0,1,-1
"5521","2727王品","110/07/14","富邦-左營",102,1,101
"5522","2727王品","110/07/14","統一-城中",100,234,-134
"5523","2727王品","110/07/14","國泰-板橋",105,11,94
"5524","2727王品","110/07/14","富邦-台北",1,125,-124
"5525","2727王品","110/07/14","港商野村",149,72,77
"5526","2727王品","110/07/14","台灣摩根士丹利",1,48,-47
"5527","2727王品","110/07/14","合庫-台中",66,2,64
"5528","2727王品","110/07/14","國票-新莊",0,40,-40
"5529","2727王品","110/07/14","臺銀-金山",63,8,55
"5530","2727王品","110/07/14","永豐金-忠孝",2,39,-37
"5531","2727王品","110/07/14","摩根大通",83,39,44
"5532","2727王品","110/07/14","富邦-彰化",1,34,-33
"5533","2727王品","110/07/14","凱基-台北",84,42,42
"5534","2727王品","110/07/14","康和-高雄",0,30,-30
"5535","2727王品","110/07/14","土銀-台中",35,1,34
"5536","2727王品","110/07/14","安泰",0,26,-26
"5537","2727王品","110/07/14","華南永昌-麻豆",32,1,31
"5538","2727王品","110/07/14","富邦-新竹華信",0,21,-21
"5539","2727王品","110/07/14","元大證券",85,55,30
"5540","2727王品","110/07/14","元大-南崁",1,22,-21
"5541","2727王品","110/07/14","新加坡商瑞銀",40,15,25
"5542","2727王品","110/07/14","彰銀-台中",0,18,-18
"5543","2727王品","110/07/14","日盛-八德",19,0,19
"5544","2727王品","110/07/14","元富-同大",2,20,-18
"5545","2727王品","110/07/14","統一",35,17,18
"5546","2727王品","110/07/14","玉山-嘉義",1,17,-16
"5547","2727王品","110/07/14","元富-大昌",18,1,17
"5548","2727王品","110/07/14","國泰-館前",4,20,-16
"5549","2727王品","110/07/14","玉山-板橋",15,1,14
"5550","2727王品","110/07/14","第一金-嘉義",1,13,-12
"5551","1570力肯","110/07/14","國票-北高雄",68,0,68
"5552","1570力肯","110/07/14","摩根大通",0,21,-21
"5553","1570力肯","110/07/14","日盛-八德",30,1,29
"5554","1570力肯","110/07/14","新光",1,19,-18
"5555","1570力肯","110/07/14","玉山-高雄",7,0,7
"5556","1570力肯","110/07/14","(牛牛牛)亞-鑫豐",0,17,-17
"5557","1570力肯","110/07/14","臺銀-臺南",5,0,5
"5558","1570力肯","110/07/14","日盛-士林",0,10,-10
"5559","1570力肯","110/07/14","凱基-三峽",5,0,5
"5560","1570力肯","110/07/14","統一-員林",0,10,-10
"5561","1570力肯","110/07/14","元大-和平",5,0,5
"5562","1570力肯","110/07/14","國票-新莊",0,10,-10
"5563","1570力肯","110/07/14","合庫-三重",4,0,4
"5564","1570力肯","110/07/14","凱基-高美館",0,10,-10
"5565","1570力肯","110/07/14","瑞士信貸",4,0,4
"5566","1570力肯","110/07/14","元大-屏東民生",0,5,-5
"5567","1570力肯","110/07/14","統一-三多",4,0,4
"5568","1570力肯","110/07/14","元大-古亭",0,5,-5
"5569","1570力肯","110/07/14","華南永昌-古亭",4,0,4
"5570","1570力肯","110/07/14","日盛-木柵",0,4,-4
"5571","1570力肯","110/07/14","元大-高雄",3,0,3
"5572","1570力肯","110/07/14","大昌",0,4,-4
"5573","1570力肯","110/07/14","兆豐-忠孝",2,0,2
"5574","1570力肯","110/07/14","群益金鼎-東大",0,4,-4
"5575","1570力肯","110/07/14","富邦-陽明",2,0,2
"5576","1570力肯","110/07/14","凱基-台北",0,4,-4
"5577","1570力肯","110/07/14","元大-松山",2,0,2
"5578","1570力肯","110/07/14","元大-板橋",0,4,-4
"5579","1570力肯","110/07/14","元大-忠孝",2,0,2
"5580","1570力肯","110/07/14","第一金-中山",0,3,-3
"5581","6180橘子","110/07/14","新加坡商瑞銀",84,28,56
"5582","6180橘子","110/07/14","凱基-台北",4,37,-33
"5583","6180橘子","110/07/14","日盛-信義",29,1,28
"5584","6180橘子","110/07/14","玉山-台南",1,22,-21
"5585","6180橘子","110/07/14","豐農",28,4,24
"5586","6180橘子","110/07/14","日盛-新竹",1,21,-20
"5587","6180橘子","110/07/14","新光-新竹",24,1,23
"5588","6180橘子","110/07/14","元富-潮州",0,19,-19
"5589","6180橘子","110/07/14","華南永昌-高雄",20,0,20
"5590","6180橘子","110/07/14","元大-信義",0,17,-17
"5591","6180橘子","110/07/14","元大-羅東",20,0,20
"5592","6180橘子","110/07/14","台灣企銀-台中",1,16,-15
"5593","6180橘子","110/07/14","元大-台中中港",20,0,20
"5594","6180橘子","110/07/14","元大-北港",0,15,-15
"5595","6180橘子","110/07/14","富邦-嘉義",24,5,19
"5596","6180橘子","110/07/14","富邦-高雄",0,14,-14
"5597","6180橘子","110/07/14","富邦-仁愛",15,0,15
"5598","6180橘子","110/07/14","兆豐-埔墘",0,13,-13
"5599","6180橘子","110/07/14","國票-九鼎",13,0,13
"5600","6180橘子","110/07/14","第一金-中山",0,10,-10
"5601","6180橘子","110/07/14","日盛-木柵",12,0,12
"5602","6180橘子","110/07/14","元大-彰化民生",0,10,-10
"5603","6180橘子","110/07/14","元大-成功",10,0,10
"5604","6180橘子","110/07/14","福勝",1,10,-9
"5605","6180橘子","110/07/14","港商野村",10,2,8
"5606","6180橘子","110/07/14","群益金鼎-丹鳳",1,10,-9
"5607","6180橘子","110/07/14","玉山-左營",8,0,8
"5608","6180橘子","110/07/14","群益金鼎-板橋",0,8,-8
"5609","6180橘子","110/07/14","富邦-陽明",16,8,8
"5610","6180橘子","110/07/14","合庫-鳳山",0,7,-7
"5611","2390云辰","110/07/14","摩根大通",995,198,797
"5612","2390云辰","110/07/14","新加坡商瑞銀",28,399,-371
"5613","2390云辰","110/07/14","美林",383,22,361
"5614","2390云辰","110/07/14","凱基-新豐",3,198,-195
"5615","2390云辰","110/07/14","台灣摩根士丹利",684,358,326
"5616","2390云辰","110/07/14","元大-士林",1,152,-151
"5617","2390云辰","110/07/14","凱基-台北",656,402,254
"5618","2390云辰","110/07/14","元大-竹山",80,181,-101
"5619","2390云辰","110/07/14","日盛-和美",110,5,105
"5620","2390云辰","110/07/14","群益金鼎-開元",19,95,-76
"5621","2390云辰","110/07/14","元大-天母",72,0,72
"5622","2390云辰","110/07/14","新光",77,150,-73
"5623","2390云辰","110/07/14","永豐金-松山",57,0,57
"5624","2390云辰","110/07/14","元富-高雄",0,71,-71
"5625","2390云辰","110/07/14","統一-屏東",53,0,53
"5626","2390云辰","110/07/14","元大-土城學府",130,201,-71
"5627","2390云辰","110/07/14","港商野村",486,450,36
"5628","2390云辰","110/07/14","元大-善化",12,76,-64
"5629","2390云辰","110/07/14","致和-崇德",30,0,30
"5630","2390云辰","110/07/14","華南永昌-岡山",23,81,-58
"5631","2390云辰","110/07/14","富邦-台北",40,14,26
"5632","2390云辰","110/07/14","群益金鼎-大興",82,125,-43
"5633","2390云辰","110/07/14","台新-高雄",38,13,25
"5634","2390云辰","110/07/14","大慶-中壢",0,41,-41
"5635","2390云辰","110/07/14","富邦-板橋",32,7,25
"5636","2390云辰","110/07/14","玉山-板橋",6,47,-41
"5637","2390云辰","110/07/14","陽信-石牌",24,0,24
"5638","2390云辰","110/07/14","富邦-台東",2,42,-40
"5639","2390云辰","110/07/14","凱基-屏東",32,8,24
"5640","2390云辰","110/07/14","元大-新營",3,42,-39
"5641","2363矽統","110/07/14","台灣摩根士丹利",463,0,463
"5642","2363矽統","110/07/14","新加坡商瑞銀",568,1321,-753
"5643","2363矽統","110/07/14","台新證券",750,342,408
"5644","2363矽統","110/07/14","瑞士信貸",149,864,-715
"5645","2363矽統","110/07/14","玉山-台中",363,51,312
"5646","2363矽統","110/07/14","台新-屏東",115,380,-265
"5647","2363矽統","110/07/14","元大-斗六",223,25,198
"5648","2363矽統","110/07/14","永豐金證券",16,265,-249
"5649","2363矽統","110/07/14","華南永昌-朴子",208,38,170
"5650","2363矽統","110/07/14","美林",462,701,-239
"5651","2363矽統","110/07/14","元富-西松",169,12,157
"5652","2363矽統","110/07/14","宏遠-桃園",269,500,-231
"5653","2363矽統","110/07/14","永豐金-大園",146,6,140
"5654","2363矽統","110/07/14","凱基-竹北",36,254,-218
"5655","2363矽統","110/07/14","土銀-和平",134,0,134
"5656","2363矽統","110/07/14","港商法國興業",0,214,-214
"5657","2363矽統","110/07/14","富邦-新營",130,13,117
"5658","2363矽統","110/07/14","港商野村",835,1044,-209
"5659","2363矽統","110/07/14","元富-成功",118,11,107
"5660","2363矽統","110/07/14","北城證券",212,411,-199
"5661","2363矽統","110/07/14","元富-烏日",121,18,103
"5662","2363矽統","110/07/14","(牛牛牛)亞-鑫豐",51,241,-190
"5663","2363矽統","110/07/14","日盛-二林",120,18,102
"5664","2363矽統","110/07/14","國票-博愛",24,213,-189
"5665","2363矽統","110/07/14","兆豐-忠孝",98,2,96
"5666","2363矽統","110/07/14","大慶-蘆洲",134,316,-182
"5667","2363矽統","110/07/14","大慶-楊梅",92,3,89
"5668","2363矽統","110/07/14","彰銀-台中",15,193,-178
"5669","2363矽統","110/07/14","元富-三重",120,33,87
"5670","2363矽統","110/07/14","日盛-和美",18,185,-167
"5671","8112至上","110/07/14","新加坡商瑞銀",223,17,206
"5672","8112至上","110/07/14","瑞士信貸",8,170,-162
"5673","8112至上","110/07/14","摩根大通",285,129,156
"5674","8112至上","110/07/14","美林",55,202,-147
"5675","8112至上","110/07/14","花旗環球",124,0,124
"5676","8112至上","110/07/14","凱基-台北",325,436,-111
"5677","8112至上","110/07/14","兆豐-公益",117,4,113
"5678","8112至上","110/07/14","台中銀-台北",0,98,-98
"5679","8112至上","110/07/14","香港上海匯豐",111,0,111
"5680","8112至上","110/07/14","玉山-台大",17,107,-90
"5681","8112至上","110/07/14","永豐金-內湖",117,21,96
"5682","8112至上","110/07/14","康和-內湖",1,90,-89
"5683","8112至上","110/07/14","台灣摩根士丹利",108,16,92
"5684","8112至上","110/07/14","港商野村",21,84,-63
"5685","8112至上","110/07/14","元大-東蘆",77,0,77
"5686","8112至上","110/07/14","兆豐-北高雄",1,60,-59
"5687","8112至上","110/07/14","新光",108,48,60
"5688","8112至上","110/07/14","群益金鼎-海山",1,52,-51
"5689","8112至上","110/07/14","大慶-蘆洲",59,0,59
"5690","8112至上","110/07/14","群益金鼎-大安",0,50,-50
"5691","8112至上","110/07/14","華南永昌-台中",56,3,53
"5692","8112至上","110/07/14","富邦-仁愛",2,49,-47
"5693","8112至上","110/07/14","土銀-嘉義",52,2,50
"5694","8112至上","110/07/14","元大-金華",0,42,-42
"5695","8112至上","110/07/14","美商高盛",40,0,40
"5696","8112至上","110/07/14","元大-內湖",4,43,-39
"5697","8112至上","110/07/14","臺銀",63,29,34
"5698","8112至上","110/07/14","第一金-華江",2,37,-35
"5699","8112至上","110/07/14","元富-嘉義",31,0,31
"5700","8112至上","110/07/14","永豐金-苓雅",2,34,-32
"5701","1570力肯","110/07/14","國票-北高雄",68,0,68
"5702","1570力肯","110/07/14","摩根大通",0,21,-21
"5703","1570力肯","110/07/14","日盛-八德",30,1,29
"5704","1570力肯","110/07/14","新光",1,19,-18
"5705","1570力肯","110/07/14","玉山-高雄",7,0,7
"5706","1570力肯","110/07/14","(牛牛牛)亞-鑫豐",0,17,-17
"5707","1570力肯","110/07/14","臺銀-臺南",5,0,5
"5708","1570力肯","110/07/14","日盛-士林",0,10,-10
"5709","1570力肯","110/07/14","凱基-三峽",5,0,5
"5710","1570力肯","110/07/14","統一-員林",0,10,-10
"5711","1570力肯","110/07/14","元大-和平",5,0,5
"5712","1570力肯","110/07/14","國票-新莊",0,10,-10
"5713","1570力肯","110/07/14","合庫-三重",4,0,4
"5714","1570力肯","110/07/14","凱基-高美館",0,10,-10
"5715","1570力肯","110/07/14","瑞士信貸",4,0,4
"5716","1570力肯","110/07/14","元大-屏東民生",0,5,-5
"5717","1570力肯","110/07/14","統一-三多",4,0,4
"5718","1570力肯","110/07/14","元大-古亭",0,5,-5
"5719","1570力肯","110/07/14","華南永昌-古亭",4,0,4
"5720","1570力肯","110/07/14","日盛-木柵",0,4,-4
"5721","1570力肯","110/07/14","元大-高雄",3,0,3
"5722","1570力肯","110/07/14","大昌",0,4,-4
"5723","1570力肯","110/07/14","兆豐-忠孝",2,0,2
"5724","1570力肯","110/07/14","群益金鼎-東大",0,4,-4
"5725","1570力肯","110/07/14","富邦-陽明",2,0,2
"5726","1570力肯","110/07/14","凱基-台北",0,4,-4
"5727","1570力肯","110/07/14","元大-松山",2,0,2
"5728","1570力肯","110/07/14","元大-板橋",0,4,-4
"5729","1570力肯","110/07/14","元大-忠孝",2,0,2
"5730","1570力肯","110/07/14","第一金-中山",0,3,-3
"5731","2929淘帝","110/07/14","華南永昌-林口",60,0,60
"5732","2929淘帝","110/07/14","群益金鼎",25,540,-515
"5733","2929淘帝","110/07/14","美林",87,31,56
"5734","2929淘帝","110/07/14","國泰-台南",1,30,-29
"5735","2929淘帝","110/07/14","元富-台南",40,0,40
"5736","2929淘帝","110/07/14","宏遠-桃園",0,20,-20
"5737","2929淘帝","110/07/14","元大-民生",39,0,39
"5738","2929淘帝","110/07/14","摩根大通",11,31,-20
"5739","2929淘帝","110/07/14","臺銀-鳳山",34,0,34
"5740","2929淘帝","110/07/14","台新-建北",5,20,-15
"5741","2929淘帝","110/07/14","合庫-高雄",34,1,33
"5742","2929淘帝","110/07/14","新光",1,16,-15
"5743","2929淘帝","110/07/14","華南永昌-鶯歌",28,0,28
"5744","2929淘帝","110/07/14","玉山-板橋",0,15,-15
"5745","2929淘帝","110/07/14","永興",25,0,25
"5746","2929淘帝","110/07/14","凱基-羅東",0,15,-15
"5747","2929淘帝","110/07/14","元大-新盛",25,1,24
"5748","2929淘帝","110/07/14","元大-頭份",0,15,-15
"5749","2929淘帝","110/07/14","日盛-南京",23,0,23
"5750","2929淘帝","110/07/14","第一金-台南",0,13,-13
"5751","2929淘帝","110/07/14","日茂",20,0,20
"5752","2929淘帝","110/07/14","富邦-基隆",0,12,-12
"5753","2929淘帝","110/07/14","台新-台中",20,0,20
"5754","2929淘帝","110/07/14","日茂-南投",1,12,-11
"5755","2929淘帝","110/07/14","華南永昌",20,0,20
"5756","2929淘帝","110/07/14","元大-豐原站前",0,11,-11
"5757","2929淘帝","110/07/14","福勝",15,0,15
"5758","2929淘帝","110/07/14","玉山-士林",0,10,-10
"5759","2929淘帝","110/07/14","富邦-南屯",15,0,15
"5760","2929淘帝","110/07/14","富邦-台北",0,10,-10
"5761","5410國眾","110/07/14","兆豐-城中",35,0,35
"5762","5410國眾","110/07/14","瑞士信貸",0,29,-29
"5763","5410國眾","110/07/14","新光",21,1,20
"5764","5410國眾","110/07/14","國泰-板橋",1,30,-29
"5765","5410國眾","110/07/14","國泰-敦南",21,1,20
"5766","5410國眾","110/07/14","日盛-高雄",0,20,-20
"5767","5410國眾","110/07/14","國泰-台中",20,1,19
"5768","5410國眾","110/07/14","台新-左楠",1,20,-19
"5769","5410國眾","110/07/14","元大-崇德",19,0,19
"5770","5410國眾","110/07/14","元富-大昌",1,18,-17
"5771","5410國眾","110/07/14","土銀-士林",18,0,18
"5772","5410國眾","110/07/14","富邦-建國",0,15,-15
"5773","5410國眾","110/07/14","元大-新盛",20,2,18
"5774","5410國眾","110/07/14","元富-嘉義",0,12,-12
"5775","5410國眾","110/07/14","兆豐-高雄",15,0,15
"5776","5410國眾","110/07/14","永全-南崁",0,12,-12
"5777","5410國眾","110/07/14","宏遠-中和",10,0,10
"5778","5410國眾","110/07/14","元大-員林",0,11,-11
"5779","5410國眾","110/07/14","新光-桃園",10,0,10
"5780","5410國眾","110/07/14","高橋",0,10,-10
"5781","5410國眾","110/07/14","國泰-台南",10,0,10
"5782","5410國眾","110/07/14","永興",0,10,-10
"5783","5410國眾","110/07/14","元大-復北",10,0,10
"5784","5410國眾","110/07/14","華南永昌-三重",0,10,-10
"5785","5410國眾","110/07/14","元大-竹科",8,0,8
"5786","5410國眾","110/07/14","元大-苑裡",0,7,-7
"5787","5410國眾","110/07/14","台新-新營",6,0,6
"5788","5410國眾","110/07/14","港商野村",0,6,-6
"5789","5410國眾","110/07/14","日盛-士林",5,0,5
"5790","5410國眾","110/07/14","摩根大通",5,11,-6
"5791","2841台開","110/07/14","凱基-文心",73,0,73
"5792","2841台開","110/07/14","國泰-敦南",0,50,-50
"5793","2841台開","110/07/14","元富-潮州",30,0,30
"5794","2841台開","110/07/14","凱基-中壢",0,40,-40
"5795","2841台開","110/07/14","第一金-台中",20,0,20
"5796","2841台開","110/07/14","統一-新竹",0,24,-24
"5797","2841台開","110/07/14","華南永昌-新莊",20,0,20
"5798","2841台開","110/07/14","元富-草屯",0,20,-20
"5799","2841台開","110/07/14","永豐金-豐原",20,0,20
"5800","2841台開","110/07/14","台新-台南",0,20,-20
"5801","2841台開","110/07/14","國泰-館前",15,0,15
"5802","2841台開","110/07/14","永豐金-敦南",45,63,-18
"5803","2841台開","110/07/14","群益金鼎-基隆",12,0,12
"5804","2841台開","110/07/14","國票-北高雄",0,13,-13
"5805","2841台開","110/07/14","日盛-信義",10,0,10
"5806","2841台開","110/07/14","凱基-松山",0,10,-10
"5807","2841台開","110/07/14","台新-台中",10,0,10
"5808","2841台開","110/07/14","元大證券",0,10,-10
"5809","2841台開","110/07/14","新光",10,1,9
"5810","2841台開","110/07/14","元大-中壢",0,10,-10
"5811","2841台開","110/07/14","凱基-新店",8,0,8
"5812","2841台開","110/07/14","富邦-陽明",1,10,-9
"5813","2841台開","110/07/14","元大-斗信",7,0,7
"5814","2841台開","110/07/14","富邦-建國",0,9,-9
"5815","2841台開","110/07/14","元大-三重",6,0,6
"5816","2841台開","110/07/14","富邦-台南",0,8,-8
"5817","2841台開","110/07/14","永豐金-中和",6,0,6
"5818","2841台開","110/07/14","康和-澎湖",0,7,-7
"5819","2841台開","110/07/14","元富-成功",5,0,5
"5820","2841台開","110/07/14","日盛-斗六",0,6,-6
"5821","6207雷科","110/07/14","群益金鼎-台北",60,0,60
"5822","6207雷科","110/07/14","新加坡商瑞銀",10,56,-46
"5823","6207雷科","110/07/14","台新-高雄",43,3,40
"5824","6207雷科","110/07/14","國票-中和",0,41,-41
"5825","6207雷科","110/07/14","元大-高雄",19,0,19
"5826","6207雷科","110/07/14","元大-復北",0,33,-33
"5827","6207雷科","110/07/14","福勝",15,0,15
"5828","6207雷科","110/07/14","光和-和美",0,20,-20
"5829","6207雷科","110/07/14","群益金鼎-中山",15,0,15
"5830","6207雷科","110/07/14","群益金鼎-丹鳳",0,20,-20
"5831","6207雷科","110/07/14","元大-林園",15,0,15
"5832","6207雷科","110/07/14","第一金-路竹",0,10,-10
"5833","6207雷科","110/07/14","新光",12,0,12
"5834","6207雷科","110/07/14","元大-歸仁",0,10,-10
"5835","6207雷科","110/07/14","元大-大天母",10,0,10
"5836","6207雷科","110/07/14","宏遠-館前",0,9,-9
"5837","6207雷科","110/07/14","永豐金-忠孝",9,0,9
"5838","6207雷科","110/07/14","凱基-台北",12,20,-8
"5839","6207雷科","110/07/14","永豐金-新店",7,0,7
"5840","6207雷科","110/07/14","美林",0,7,-7
"5841","6207雷科","110/07/14","玉山-嘉義",6,0,6
"5842","6207雷科","110/07/14","摩根大通",16,23,-7
"5843","6207雷科","110/07/14","元大-屏東",6,0,6
"5844","6207雷科","110/07/14","凱基-高雄",1,7,-6
"5845","6207雷科","110/07/14","凱基-大安",5,0,5
"5846","6207雷科","110/07/14","台中銀-豐原",0,5,-5
"5847","6207雷科","110/07/14","富邦-台南",5,0,5
"5848","6207雷科","110/07/14","元大-新竹經國",0,5,-5
"5849","6207雷科","110/07/14","元大-成功",5,0,5
"5850","6207雷科","110/07/14","光和-田中",0,4,-4
"5851","3679新至陞","110/07/14","凱基-台北",31,6,25
"5852","3679新至陞","110/07/14","群益金鼎-東大",0,15,-15
"5853","3679新至陞","110/07/14","華南永昌-新莊",10,0,10
"5854","3679新至陞","110/07/14","瑞士信貸",0,12,-12
"5855","3679新至陞","110/07/14","新加坡商瑞銀",11,3,8
"5856","3679新至陞","110/07/14","群益金鼎-永和",0,10,-10
"5857","3679新至陞","110/07/14","美商高盛",6,0,6
"5858","3679新至陞","110/07/14","元大-成功",5,15,-10
"5859","3679新至陞","110/07/14","第一金-中壢",6,0,6
"5860","3679新至陞","110/07/14","統一-板橋",1,10,-9
"5861","3679新至陞","110/07/14","(牛牛牛)亞-網路",4,0,4
"5862","3679新至陞","110/07/14","玉山-左營",0,5,-5
"5863","3679新至陞","110/07/14","元大-六合",3,0,3
"5864","3679新至陞","110/07/14","群益金鼎-三民",0,4,-4
"5865","3679新至陞","110/07/14","合庫-自強",2,0,2
"5866","3679新至陞","110/07/14","富邦-宜蘭",0,4,-4
"5867","3679新至陞","110/07/14","高橋-內壢",2,0,2
"5868","3679新至陞","110/07/14","永豐金-苓雅",0,3,-3
"5869","3679新至陞","110/07/14","台中銀-員林",2,0,2
"5870","3679新至陞","110/07/14","摩根大通",5,7,-2
"5871","3679新至陞","110/07/14","凱基-高美館",2,0,2
"5872","3679新至陞","110/07/14","元大-板橋三民",0,2,-2
"5873","3679新至陞","110/07/14","元大-福營",2,0,2
"5874","3679新至陞","110/07/14","宏遠-中和",0,1,-1
"5875","3679新至陞","110/07/14","永豐金-松山",2,0,2
"5876","3679新至陞","110/07/14","元富-佳里",0,1,-1
"5877","3679新至陞","110/07/14","永豐金-萬盛",2,0,2
"5878","3679新至陞","110/07/14","(牛牛牛)亞-鑫豐",0,1,-1
"5879","3679新至陞","110/07/14","元富-松德",1,0,1
"5880","3679新至陞","110/07/14","中國信託-中壢",0,1,-1
"5881","2727王品","110/07/14","富邦-左營",102,1,101
"5882","2727王品","110/07/14","統一-城中",100,234,-134
"5883","2727王品","110/07/14","國泰-板橋",105,11,94
"5884","2727王品","110/07/14","富邦-台北",1,125,-124
"5885","2727王品","110/07/14","港商野村",149,72,77
"5886","2727王品","110/07/14","台灣摩根士丹利",1,48,-47
"5887","2727王品","110/07/14","合庫-台中",66,2,64
"5888","2727王品","110/07/14","國票-新莊",0,40,-40
"5889","2727王品","110/07/14","臺銀-金山",63,8,55
"5890","2727王品","110/07/14","永豐金-忠孝",2,39,-37
"5891","2727王品","110/07/14","摩根大通",83,39,44
"5892","2727王品","110/07/14","富邦-彰化",1,34,-33
"5893","2727王品","110/07/14","凱基-台北",84,42,42
"5894","2727王品","110/07/14","康和-高雄",0,30,-30
"5895","2727王品","110/07/14","土銀-台中",35,1,34
"5896","2727王品","110/07/14","安泰",0,26,-26
"5897","2727王品","110/07/14","華南永昌-麻豆",32,1,31
"5898","2727王品","110/07/14","富邦-新竹華信",0,21,-21
"5899","2727王品","110/07/14","元大證券",85,55,30
"5900","2727王品","110/07/14","元大-南崁",1,22,-21
"5901","2727王品","110/07/14","新加坡商瑞銀",40,15,25
"5902","2727王品","110/07/14","彰銀-台中",0,18,-18
"5903","2727王品","110/07/14","日盛-八德",19,0,19
"5904","2727王品","110/07/14","元富-同大",2,20,-18
"5905","2727王品","110/07/14","統一",35,17,18
"5906","2727王品","110/07/14","玉山-嘉義",1,17,-16
"5907","2727王品","110/07/14","元富-大昌",18,1,17
"5908","2727王品","110/07/14","國泰-館前",4,20,-16
"5909","2727王品","110/07/14","玉山-板橋",15,1,14
"5910","2727王品","110/07/14","第一金-嘉義",1,13,-12
"5911","1570力肯","110/07/14","國票-北高雄",68,0,68
"5912","1570力肯","110/07/14","摩根大通",0,21,-21
"5913","1570力肯","110/07/14","日盛-八德",30,1,29
"5914","1570力肯","110/07/14","新光",1,19,-18
"5915","1570力肯","110/07/14","玉山-高雄",7,0,7
"5916","1570力肯","110/07/14","(牛牛牛)亞-鑫豐",0,17,-17
"5917","1570力肯","110/07/14","臺銀-臺南",5,0,5
"5918","1570力肯","110/07/14","日盛-士林",0,10,-10
"5919","1570力肯","110/07/14","凱基-三峽",5,0,5
"5920","1570力肯","110/07/14","統一-員林",0,10,-10
"5921","1570力肯","110/07/14","元大-和平",5,0,5
"5922","1570力肯","110/07/14","國票-新莊",0,10,-10
"5923","1570力肯","110/07/14","合庫-三重",4,0,4
"5924","1570力肯","110/07/14","凱基-高美館",0,10,-10
"5925","1570力肯","110/07/14","瑞士信貸",4,0,4
"5926","1570力肯","110/07/14","元大-屏東民生",0,5,-5
"5927","1570力肯","110/07/14","統一-三多",4,0,4
"5928","1570力肯","110/07/14","元大-古亭",0,5,-5
"5929","1570力肯","110/07/14","華南永昌-古亭",4,0,4
"5930","1570力肯","110/07/14","日盛-木柵",0,4,-4
"5931","1570力肯","110/07/14","元大-高雄",3,0,3
"5932","1570力肯","110/07/14","大昌",0,4,-4
"5933","1570力肯","110/07/14","兆豐-忠孝",2,0,2
"5934","1570力肯","110/07/14","群益金鼎-東大",0,4,-4
"5935","1570力肯","110/07/14","富邦-陽明",2,0,2
"5936","1570力肯","110/07/14","凱基-台北",0,4,-4
"5937","1570力肯","110/07/14","元大-松山",2,0,2
"5938","1570力肯","110/07/14","元大-板橋",0,4,-4
"5939","1570力肯","110/07/14","元大-忠孝",2,0,2
"5940","1570力肯","110/07/14","第一金-中山",0,3,-3
"5941","6180橘子","110/07/14","新加坡商瑞銀",84,28,56
"5942","6180橘子","110/07/14","凱基-台北",4,37,-33
"5943","6180橘子","110/07/14","日盛-信義",29,1,28
"5944","6180橘子","110/07/14","玉山-台南",1,22,-21
"5945","6180橘子","110/07/14","豐農",28,4,24
"5946","6180橘子","110/07/14","日盛-新竹",1,21,-20
"5947","6180橘子","110/07/14","新光-新竹",24,1,23
"5948","6180橘子","110/07/14","元富-潮州",0,19,-19
"5949","6180橘子","110/07/14","華南永昌-高雄",20,0,20
"5950","6180橘子","110/07/14","元大-信義",0,17,-17
"5951","6180橘子","110/07/14","元大-羅東",20,0,20
"5952","6180橘子","110/07/14","台灣企銀-台中",1,16,-15
"5953","6180橘子","110/07/14","元大-台中中港",20,0,20
"5954","6180橘子","110/07/14","元大-北港",0,15,-15
"5955","6180橘子","110/07/14","富邦-嘉義",24,5,19
"5956","6180橘子","110/07/14","富邦-高雄",0,14,-14
"5957","6180橘子","110/07/14","富邦-仁愛",15,0,15
"5958","6180橘子","110/07/14","兆豐-埔墘",0,13,-13
"5959","6180橘子","110/07/14","國票-九鼎",13,0,13
"5960","6180橘子","110/07/14","第一金-中山",0,10,-10
"5961","6180橘子","110/07/14","日盛-木柵",12,0,12
"5962","6180橘子","110/07/14","元大-彰化民生",0,10,-10
"5963","6180橘子","110/07/14","元大-成功",10,0,10
"5964","6180橘子","110/07/14","福勝",1,10,-9
"5965","6180橘子","110/07/14","港商野村",10,2,8
"5966","6180橘子","110/07/14","群益金鼎-丹鳳",1,10,-9
"5967","6180橘子","110/07/14","玉山-左營",8,0,8
"5968","6180橘子","110/07/14","群益金鼎-板橋",0,8,-8
"5969","6180橘子","110/07/14","富邦-陽明",16,8,8
"5970","6180橘子","110/07/14","合庫-鳳山",0,7,-7
"5971","2390云辰","110/07/14","摩根大通",995,198,797
"5972","2390云辰","110/07/14","新加坡商瑞銀",28,399,-371
"5973","2390云辰","110/07/14","美林",383,22,361
"5974","2390云辰","110/07/14","凱基-新豐",3,198,-195
"5975","2390云辰","110/07/14","台灣摩根士丹利",684,358,326
"5976","2390云辰","110/07/14","元大-士林",1,152,-151
"5977","2390云辰","110/07/14","凱基-台北",656,402,254
"5978","2390云辰","110/07/14","元大-竹山",80,181,-101
"5979","2390云辰","110/07/14","日盛-和美",110,5,105
"5980","2390云辰","110/07/14","群益金鼎-開元",19,95,-76
"5981","2390云辰","110/07/14","元大-天母",72,0,72
"5982","2390云辰","110/07/14","新光",77,150,-73
"5983","2390云辰","110/07/14","永豐金-松山",57,0,57
"5984","2390云辰","110/07/14","元富-高雄",0,71,-71
"5985","2390云辰","110/07/14","統一-屏東",53,0,53
"5986","2390云辰","110/07/14","元大-土城學府",130,201,-71
"5987","2390云辰","110/07/14","港商野村",486,450,36
"5988","2390云辰","110/07/14","元大-善化",12,76,-64
"5989","2390云辰","110/07/14","致和-崇德",30,0,30
"5990","2390云辰","110/07/14","華南永昌-岡山",23,81,-58
"5991","2390云辰","110/07/14","富邦-台北",40,14,26
"5992","2390云辰","110/07/14","群益金鼎-大興",82,125,-43
"5993","2390云辰","110/07/14","台新-高雄",38,13,25
"5994","2390云辰","110/07/14","大慶-中壢",0,41,-41
"5995","2390云辰","110/07/14","富邦-板橋",32,7,25
"5996","2390云辰","110/07/14","玉山-板橋",6,47,-41
"5997","2390云辰","110/07/14","陽信-石牌",24,0,24
"5998","2390云辰","110/07/14","富邦-台東",2,42,-40
"5999","2390云辰","110/07/14","凱基-屏東",32,8,24
"6000","2390云辰","110/07/14","元大-新營",3,42,-39
"6001","2363矽統","110/07/14","台灣摩根士丹利",463,0,463
"6002","2363矽統","110/07/14","新加坡商瑞銀",568,1321,-753
"6003","2363矽統","110/07/14","台新證券",750,342,408
"6004","2363矽統","110/07/14","瑞士信貸",149,864,-715
"6005","2363矽統","110/07/14","玉山-台中",363,51,312
"6006","2363矽統","110/07/14","台新-屏東",115,380,-265
"6007","2363矽統","110/07/14","元大-斗六",223,25,198
"6008","2363矽統","110/07/14","永豐金證券",16,265,-249
"6009","2363矽統","110/07/14","華南永昌-朴子",208,38,170
"6010","2363矽統","110/07/14","美林",462,701,-239
"6011","2363矽統","110/07/14","元富-西松",169,12,157
"6012","2363矽統","110/07/14","宏遠-桃園",269,500,-231
"6013","2363矽統","110/07/14","永豐金-大園",146,6,140
"6014","2363矽統","110/07/14","凱基-竹北",36,254,-218
"6015","2363矽統","110/07/14","土銀-和平",134,0,134
"6016","2363矽統","110/07/14","港商法國興業",0,214,-214
"6017","2363矽統","110/07/14","富邦-新營",130,13,117
"6018","2363矽統","110/07/14","港商野村",835,1044,-209
"6019","2363矽統","110/07/14","元富-成功",118,11,107
"6020","2363矽統","110/07/14","北城證券",212,411,-199
"6021","2363矽統","110/07/14","元富-烏日",121,18,103
"6022","2363矽統","110/07/14","(牛牛牛)亞-鑫豐",51,241,-190
"6023","2363矽統","110/07/14","日盛-二林",120,18,102
"6024","2363矽統","110/07/14","國票-博愛",24,213,-189
"6025","2363矽統","110/07/14","兆豐-忠孝",98,2,96
"6026","2363矽統","110/07/14","大慶-蘆洲",134,316,-182
"6027","2363矽統","110/07/14","大慶-楊梅",92,3,89
"6028","2363矽統","110/07/14","彰銀-台中",15,193,-178
"6029","2363矽統","110/07/14","元富-三重",120,33,87
"6030","2363矽統","110/07/14","日盛-和美",18,185,-167
"6031","8112至上","110/07/14","新加坡商瑞銀",223,17,206
"6032","8112至上","110/07/14","瑞士信貸",8,170,-162
"6033","8112至上","110/07/14","摩根大通",285,129,156
"6034","8112至上","110/07/14","美林",55,202,-147
"6035","8112至上","110/07/14","花旗環球",124,0,124
"6036","8112至上","110/07/14","凱基-台北",325,436,-111
"6037","8112至上","110/07/14","兆豐-公益",117,4,113
"6038","8112至上","110/07/14","台中銀-台北",0,98,-98
"6039","8112至上","110/07/14","香港上海匯豐",111,0,111
"6040","8112至上","110/07/14","玉山-台大",17,107,-90
"6041","8112至上","110/07/14","永豐金-內湖",117,21,96
"6042","8112至上","110/07/14","康和-內湖",1,90,-89
"6043","8112至上","110/07/14","台灣摩根士丹利",108,16,92
"6044","8112至上","110/07/14","港商野村",21,84,-63
"6045","8112至上","110/07/14","元大-東蘆",77,0,77
"6046","8112至上","110/07/14","兆豐-北高雄",1,60,-59
"6047","8112至上","110/07/14","新光",108,48,60
"6048","8112至上","110/07/14","群益金鼎-海山",1,52,-51
"6049","8112至上","110/07/14","大慶-蘆洲",59,0,59
"6050","8112至上","110/07/14","群益金鼎-大安",0,50,-50
"6051","8112至上","110/07/14","華南永昌-台中",56,3,53
"6052","8112至上","110/07/14","富邦-仁愛",2,49,-47
"6053","8112至上","110/07/14","土銀-嘉義",52,2,50
"6054","8112至上","110/07/14","元大-金華",0,42,-42
"6055","8112至上","110/07/14","美商高盛",40,0,40
"6056","8112至上","110/07/14","元大-內湖",4,43,-39
"6057","8112至上","110/07/14","臺銀",63,29,34
"6058","8112至上","110/07/14","第一金-華江",2,37,-35
"6059","8112至上","110/07/14","元富-嘉義",31,0,31
"6060","8112至上","110/07/14","永豐金-苓雅",2,34,-32
"6061","1570力肯","110/07/14","國票-北高雄",68,0,68
"6062","1570力肯","110/07/14","摩根大通",0,21,-21
"6063","1570力肯","110/07/14","日盛-八德",30,1,29
"6064","1570力肯","110/07/14","新光",1,19,-18
"6065","1570力肯","110/07/14","玉山-高雄",7,0,7
"6066","1570力肯","110/07/14","(牛牛牛)亞-鑫豐",0,17,-17
"6067","1570力肯","110/07/14","臺銀-臺南",5,0,5
"6068","1570力肯","110/07/14","日盛-士林",0,10,-10
"6069","1570力肯","110/07/14","凱基-三峽",5,0,5
"6070","1570力肯","110/07/14","統一-員林",0,10,-10
"6071","1570力肯","110/07/14","元大-和平",5,0,5
"6072","1570力肯","110/07/14","國票-新莊",0,10,-10
"6073","1570力肯","110/07/14","合庫-三重",4,0,4
"6074","1570力肯","110/07/14","凱基-高美館",0,10,-10
"6075","1570力肯","110/07/14","瑞士信貸",4,0,4
"6076","1570力肯","110/07/14","元大-屏東民生",0,5,-5
"6077","1570力肯","110/07/14","統一-三多",4,0,4
"6078","1570力肯","110/07/14","元大-古亭",0,5,-5
"6079","1570力肯","110/07/14","華南永昌-古亭",4,0,4
"6080","1570力肯","110/07/14","日盛-木柵",0,4,-4
"6081","1570力肯","110/07/14","元大-高雄",3,0,3
"6082","1570力肯","110/07/14","大昌",0,4,-4
"6083","1570力肯","110/07/14","兆豐-忠孝",2,0,2
"6084","1570力肯","110/07/14","群益金鼎-東大",0,4,-4
"6085","1570力肯","110/07/14","富邦-陽明",2,0,2
"6086","1570力肯","110/07/14","凱基-台北",0,4,-4
"6087","1570力肯","110/07/14","元大-松山",2,0,2
"6088","1570力肯","110/07/14","元大-板橋",0,4,-4
"6089","1570力肯","110/07/14","元大-忠孝",2,0,2
"6090","1570力肯","110/07/14","第一金-中山",0,3,-3
"6091","2929淘帝","110/07/14","華南永昌-林口",60,0,60
"6092","2929淘帝","110/07/14","群益金鼎",25,540,-515
"6093","2929淘帝","110/07/14","美林",87,31,56
"6094","2929淘帝","110/07/14","國泰-台南",1,30,-29
"6095","2929淘帝","110/07/14","元富-台南",40,0,40
"6096","2929淘帝","110/07/14","宏遠-桃園",0,20,-20
"6097","2929淘帝","110/07/14","元大-民生",39,0,39
"6098","2929淘帝","110/07/14","摩根大通",11,31,-20
"6099","2929淘帝","110/07/14","臺銀-鳳山",34,0,34
"6100","2929淘帝","110/07/14","台新-建北",5,20,-15
"6101","2929淘帝","110/07/14","合庫-高雄",34,1,33
"6102","2929淘帝","110/07/14","新光",1,16,-15
"6103","2929淘帝","110/07/14","華南永昌-鶯歌",28,0,28
"6104","2929淘帝","110/07/14","玉山-板橋",0,15,-15
"6105","2929淘帝","110/07/14","永興",25,0,25
"6106","2929淘帝","110/07/14","凱基-羅東",0,15,-15
"6107","2929淘帝","110/07/14","元大-新盛",25,1,24
"6108","2929淘帝","110/07/14","元大-頭份",0,15,-15
"6109","2929淘帝","110/07/14","日盛-南京",23,0,23
"6110","2929淘帝","110/07/14","第一金-台南",0,13,-13
"6111","2929淘帝","110/07/14","日茂",20,0,20
"6112","2929淘帝","110/07/14","富邦-基隆",0,12,-12
"6113","2929淘帝","110/07/14","台新-台中",20,0,20
"6114","2929淘帝","110/07/14","日茂-南投",1,12,-11
"6115","2929淘帝","110/07/14","華南永昌",20,0,20
"6116","2929淘帝","110/07/14","元大-豐原站前",0,11,-11
"6117","2929淘帝","110/07/14","福勝",15,0,15
"6118","2929淘帝","110/07/14","玉山-士林",0,10,-10
"6119","2929淘帝","110/07/14","富邦-南屯",15,0,15
"6120","2929淘帝","110/07/14","富邦-台北",0,10,-10
"6121","5410國眾","110/07/14","兆豐-城中",35,0,35
"6122","5410國眾","110/07/14","瑞士信貸",0,29,-29
"6123","5410國眾","110/07/14","新光",21,1,20
"6124","5410國眾","110/07/14","國泰-板橋",1,30,-29
"6125","5410國眾","110/07/14","國泰-敦南",21,1,20
"6126","5410國眾","110/07/14","日盛-高雄",0,20,-20
"6127","5410國眾","110/07/14","國泰-台中",20,1,19
"6128","5410國眾","110/07/14","台新-左楠",1,20,-19
"6129","5410國眾","110/07/14","元大-崇德",19,0,19
"6130","5410國眾","110/07/14","元富-大昌",1,18,-17
"6131","5410國眾","110/07/14","土銀-士林",18,0,18
"6132","5410國眾","110/07/14","富邦-建國",0,15,-15
"6133","5410國眾","110/07/14","元大-新盛",20,2,18
"6134","5410國眾","110/07/14","元富-嘉義",0,12,-12
"6135","5410國眾","110/07/14","兆豐-高雄",15,0,15
"6136","5410國眾","110/07/14","永全-南崁",0,12,-12
"6137","5410國眾","110/07/14","宏遠-中和",10,0,10
"6138","5410國眾","110/07/14","元大-員林",0,11,-11
"6139","5410國眾","110/07/14","新光-桃園",10,0,10
"6140","5410國眾","110/07/14","高橋",0,10,-10
"6141","5410國眾","110/07/14","國泰-台南",10,0,10
"6142","5410國眾","110/07/14","永興",0,10,-10
"6143","5410國眾","110/07/14","元大-復北",10,0,10
"6144","5410國眾","110/07/14","華南永昌-三重",0,10,-10
"6145","5410國眾","110/07/14","元大-竹科",8,0,8
"6146","5410國眾","110/07/14","元大-苑裡",0,7,-7
"6147","5410國眾","110/07/14","台新-新營",6,0,6
"6148","5410國眾","110/07/14","港商野村",0,6,-6
"6149","5410國眾","110/07/14","日盛-士林",5,0,5
"6150","5410國眾","110/07/14","摩根大通",5,11,-6
"6151","2841台開","110/07/14","凱基-文心",73,0,73
"6152","2841台開","110/07/14","國泰-敦南",0,50,-50
"6153","2841台開","110/07/14","元富-潮州",30,0,30
"6154","2841台開","110/07/14","凱基-中壢",0,40,-40
"6155","2841台開","110/07/14","第一金-台中",20,0,20
"6156","2841台開","110/07/14","統一-新竹",0,24,-24
"6157","2841台開","110/07/14","華南永昌-新莊",20,0,20
"6158","2841台開","110/07/14","元富-草屯",0,20,-20
"6159","2841台開","110/07/14","永豐金-豐原",20,0,20
"6160","2841台開","110/07/14","台新-台南",0,20,-20
"6161","2841台開","110/07/14","國泰-館前",15,0,15
"6162","2841台開","110/07/14","永豐金-敦南",45,63,-18
"6163","2841台開","110/07/14","群益金鼎-基隆",12,0,12
"6164","2841台開","110/07/14","國票-北高雄",0,13,-13
"6165","2841台開","110/07/14","日盛-信義",10,0,10
"6166","2841台開","110/07/14","凱基-松山",0,10,-10
"6167","2841台開","110/07/14","台新-台中",10,0,10
"6168","2841台開","110/07/14","元大證券",0,10,-10
"6169","2841台開","110/07/14","新光",10,1,9
"6170","2841台開","110/07/14","元大-中壢",0,10,-10
"6171","2841台開","110/07/14","凱基-新店",8,0,8
"6172","2841台開","110/07/14","富邦-陽明",1,10,-9
"6173","2841台開","110/07/14","元大-斗信",7,0,7
"6174","2841台開","110/07/14","富邦-建國",0,9,-9
"6175","2841台開","110/07/14","元大-三重",6,0,6
"6176","2841台開","110/07/14","富邦-台南",0,8,-8
"6177","2841台開","110/07/14","永豐金-中和",6,0,6
"6178","2841台開","110/07/14","康和-澎湖",0,7,-7
"6179","2841台開","110/07/14","元富-成功",5,0,5
"6180","2841台開","110/07/14","日盛-斗六",0,6,-6
"6181","6207雷科","110/07/14","群益金鼎-台北",60,0,60
"6182","6207雷科","110/07/14","新加坡商瑞銀",10,56,-46
"6183","6207雷科","110/07/14","台新-高雄",43,3,40
"6184","6207雷科","110/07/14","國票-中和",0,41,-41
"6185","6207雷科","110/07/14","元大-高雄",19,0,19
"6186","6207雷科","110/07/14","元大-復北",0,33,-33
"6187","6207雷科","110/07/14","福勝",15,0,15
"6188","6207雷科","110/07/14","光和-和美",0,20,-20
"6189","6207雷科","110/07/14","群益金鼎-中山",15,0,15
"6190","6207雷科","110/07/14","群益金鼎-丹鳳",0,20,-20
"6191","6207雷科","110/07/14","元大-林園",15,0,15
"6192","6207雷科","110/07/14","第一金-路竹",0,10,-10
"6193","6207雷科","110/07/14","新光",12,0,12
"6194","6207雷科","110/07/14","元大-歸仁",0,10,-10
"6195","6207雷科","110/07/14","元大-大天母",10,0,10
"6196","6207雷科","110/07/14","宏遠-館前",0,9,-9
"6197","6207雷科","110/07/14","永豐金-忠孝",9,0,9
"6198","6207雷科","110/07/14","凱基-台北",12,20,-8
"6199","6207雷科","110/07/14","永豐金-新店",7,0,7
"6200","6207雷科","110/07/14","美林",0,7,-7
"6201","6207雷科","110/07/14","玉山-嘉義",6,0,6
"6202","6207雷科","110/07/14","摩根大通",16,23,-7
"6203","6207雷科","110/07/14","元大-屏東",6,0,6
"6204","6207雷科","110/07/14","凱基-高雄",1,7,-6
"6205","6207雷科","110/07/14","凱基-大安",5,0,5
"6206","6207雷科","110/07/14","台中銀-豐原",0,5,-5
"6207","6207雷科","110/07/14","富邦-台南",5,0,5
"6208","6207雷科","110/07/14","元大-新竹經國",0,5,-5
"6209","6207雷科","110/07/14","元大-成功",5,0,5
"6210","6207雷科","110/07/14","光和-田中",0,4,-4
"6211","3679新至陞","110/07/14","凱基-台北",31,6,25
"6212","3679新至陞","110/07/14","群益金鼎-東大",0,15,-15
"6213","3679新至陞","110/07/14","華南永昌-新莊",10,0,10
"6214","3679新至陞","110/07/14","瑞士信貸",0,12,-12
"6215","3679新至陞","110/07/14","新加坡商瑞銀",11,3,8
"6216","3679新至陞","110/07/14","群益金鼎-永和",0,10,-10
"6217","3679新至陞","110/07/14","美商高盛",6,0,6
"6218","3679新至陞","110/07/14","元大-成功",5,15,-10
"6219","3679新至陞","110/07/14","第一金-中壢",6,0,6
"6220","3679新至陞","110/07/14","統一-板橋",1,10,-9
"6221","3679新至陞","110/07/14","(牛牛牛)亞-網路",4,0,4
"6222","3679新至陞","110/07/14","玉山-左營",0,5,-5
"6223","3679新至陞","110/07/14","元大-六合",3,0,3
"6224","3679新至陞","110/07/14","群益金鼎-三民",0,4,-4
"6225","3679新至陞","110/07/14","合庫-自強",2,0,2
"6226","3679新至陞","110/07/14","富邦-宜蘭",0,4,-4
"6227","3679新至陞","110/07/14","高橋-內壢",2,0,2
"6228","3679新至陞","110/07/14","永豐金-苓雅",0,3,-3
"6229","3679新至陞","110/07/14","台中銀-員林",2,0,2
"6230","3679新至陞","110/07/14","摩根大通",5,7,-2
"6231","3679新至陞","110/07/14","凱基-高美館",2,0,2
"6232","3679新至陞","110/07/14","元大-板橋三民",0,2,-2
"6233","3679新至陞","110/07/14","元大-福營",2,0,2
"6234","3679新至陞","110/07/14","宏遠-中和",0,1,-1
"6235","3679新至陞","110/07/14","永豐金-松山",2,0,2
"6236","3679新至陞","110/07/14","元富-佳里",0,1,-1
"6237","3679新至陞","110/07/14","永豐金-萬盛",2,0,2
"6238","3679新至陞","110/07/14","(牛牛牛)亞-鑫豐",0,1,-1
"6239","3679新至陞","110/07/14","元富-松德",1,0,1
"6240","3679新至陞","110/07/14","中國信託-中壢",0,1,-1
"6241","2727王品","110/07/14","富邦-左營",102,1,101
"6242","2727王品","110/07/14","統一-城中",100,234,-134
"6243","2727王品","110/07/14","國泰-板橋",105,11,94
"6244","2727王品","110/07/14","富邦-台北",1,125,-124
"6245","2727王品","110/07/14","港商野村",149,72,77
"6246","2727王品","110/07/14","台灣摩根士丹利",1,48,-47
"6247","2727王品","110/07/14","合庫-台中",66,2,64
"6248","2727王品","110/07/14","國票-新莊",0,40,-40
"6249","2727王品","110/07/14","臺銀-金山",63,8,55
"6250","2727王品","110/07/14","永豐金-忠孝",2,39,-37
"6251","2727王品","110/07/14","摩根大通",83,39,44
"6252","2727王品","110/07/14","富邦-彰化",1,34,-33
"6253","2727王品","110/07/14","凱基-台北",84,42,42
"6254","2727王品","110/07/14","康和-高雄",0,30,-30
"6255","2727王品","110/07/14","土銀-台中",35,1,34
"6256","2727王品","110/07/14","安泰",0,26,-26
"6257","2727王品","110/07/14","華南永昌-麻豆",32,1,31
"6258","2727王品","110/07/14","富邦-新竹華信",0,21,-21
"6259","2727王品","110/07/14","元大證券",85,55,30
"6260","2727王品","110/07/14","元大-南崁",1,22,-21
"6261","2727王品","110/07/14","新加坡商瑞銀",40,15,25
"6262","2727王品","110/07/14","彰銀-台中",0,18,-18
"6263","2727王品","110/07/14","日盛-八德",19,0,19
"6264","2727王品","110/07/14","元富-同大",2,20,-18
"6265","2727王品","110/07/14","統一",35,17,18
"6266","2727王品","110/07/14","玉山-嘉義",1,17,-16
"6267","2727王品","110/07/14","元富-大昌",18,1,17
"6268","2727王品","110/07/14","國泰-館前",4,20,-16
"6269","2727王品","110/07/14","玉山-板橋",15,1,14
"6270","2727王品","110/07/14","第一金-嘉義",1,13,-12
"6271","1570力肯","110/07/14","國票-北高雄",68,0,68
"6272","1570力肯","110/07/14","摩根大通",0,21,-21
"6273","1570力肯","110/07/14","日盛-八德",30,1,29
"6274","1570力肯","110/07/14","新光",1,19,-18
"6275","1570力肯","110/07/14","玉山-高雄",7,0,7
"6276","1570力肯","110/07/14","(牛牛牛)亞-鑫豐",0,17,-17
"6277","1570力肯","110/07/14","臺銀-臺南",5,0,5
"6278","1570力肯","110/07/14","日盛-士林",0,10,-10
"6279","1570力肯","110/07/14","凱基-三峽",5,0,5
"6280","1570力肯","110/07/14","統一-員林",0,10,-10
"6281","1570力肯","110/07/14","元大-和平",5,0,5
"6282","1570力肯","110/07/14","國票-新莊",0,10,-10
"6283","1570力肯","110/07/14","合庫-三重",4,0,4
"6284","1570力肯","110/07/14","凱基-高美館",0,10,-10
"6285","1570力肯","110/07/14","瑞士信貸",4,0,4
"6286","1570力肯","110/07/14","元大-屏東民生",0,5,-5
"6287","1570力肯","110/07/14","統一-三多",4,0,4
"6288","1570力肯","110/07/14","元大-古亭",0,5,-5
"6289","1570力肯","110/07/14","華南永昌-古亭",4,0,4
"6290","1570力肯","110/07/14","日盛-木柵",0,4,-4
"6291","1570力肯","110/07/14","元大-高雄",3,0,3
"6292","1570力肯","110/07/14","大昌",0,4,-4
"6293","1570力肯","110/07/14","兆豐-忠孝",2,0,2
"6294","1570力肯","110/07/14","群益金鼎-東大",0,4,-4
"6295","1570力肯","110/07/14","富邦-陽明",2,0,2
"6296","1570力肯","110/07/14","凱基-台北",0,4,-4
"6297","1570力肯","110/07/14","元大-松山",2,0,2
"6298","1570力肯","110/07/14","元大-板橋",0,4,-4
"6299","1570力肯","110/07/14","元大-忠孝",2,0,2
"6300","1570力肯","110/07/14","第一金-中山",0,3,-3
"6301","6180橘子","110/07/14","新加坡商瑞銀",84,28,56
"6302","6180橘子","110/07/14","凱基-台北",4,37,-33
"6303","6180橘子","110/07/14","日盛-信義",29,1,28
"6304","6180橘子","110/07/14","玉山-台南",1,22,-21
"6305","6180橘子","110/07/14","豐農",28,4,24
"6306","6180橘子","110/07/14","日盛-新竹",1,21,-20
"6307","6180橘子","110/07/14","新光-新竹",24,1,23
"6308","6180橘子","110/07/14","元富-潮州",0,19,-19
"6309","6180橘子","110/07/14","華南永昌-高雄",20,0,20
"6310","6180橘子","110/07/14","元大-信義",0,17,-17
"6311","6180橘子","110/07/14","元大-羅東",20,0,20
"6312","6180橘子","110/07/14","台灣企銀-台中",1,16,-15
"6313","6180橘子","110/07/14","元大-台中中港",20,0,20
"6314","6180橘子","110/07/14","元大-北港",0,15,-15
"6315","6180橘子","110/07/14","富邦-嘉義",24,5,19
"6316","6180橘子","110/07/14","富邦-高雄",0,14,-14
"6317","6180橘子","110/07/14","富邦-仁愛",15,0,15
"6318","6180橘子","110/07/14","兆豐-埔墘",0,13,-13
"6319","6180橘子","110/07/14","國票-九鼎",13,0,13
"6320","6180橘子","110/07/14","第一金-中山",0,10,-10
"6321","6180橘子","110/07/14","日盛-木柵",12,0,12
"6322","6180橘子","110/07/14","元大-彰化民生",0,10,-10
"6323","6180橘子","110/07/14","元大-成功",10,0,10
"6324","6180橘子","110/07/14","福勝",1,10,-9
"6325","6180橘子","110/07/14","港商野村",10,2,8
"6326","6180橘子","110/07/14","群益金鼎-丹鳳",1,10,-9
"6327","6180橘子","110/07/14","玉山-左營",8,0,8
"6328","6180橘子","110/07/14","群益金鼎-板橋",0,8,-8
"6329","6180橘子","110/07/14","富邦-陽明",16,8,8
"6330","6180橘子","110/07/14","合庫-鳳山",0,7,-7
"6331","2390云辰","110/07/14","摩根大通",995,198,797
"6332","2390云辰","110/07/14","新加坡商瑞銀",28,399,-371
"6333","2390云辰","110/07/14","美林",383,22,361
"6334","2390云辰","110/07/14","凱基-新豐",3,198,-195
"6335","2390云辰","110/07/14","台灣摩根士丹利",684,358,326
"6336","2390云辰","110/07/14","元大-士林",1,152,-151
"6337","2390云辰","110/07/14","凱基-台北",656,402,254
"6338","2390云辰","110/07/14","元大-竹山",80,181,-101
"6339","2390云辰","110/07/14","日盛-和美",110,5,105
"6340","2390云辰","110/07/14","群益金鼎-開元",19,95,-76
"6341","2390云辰","110/07/14","元大-天母",72,0,72
"6342","2390云辰","110/07/14","新光",77,150,-73
"6343","2390云辰","110/07/14","永豐金-松山",57,0,57
"6344","2390云辰","110/07/14","元富-高雄",0,71,-71
"6345","2390云辰","110/07/14","統一-屏東",53,0,53
"6346","2390云辰","110/07/14","元大-土城學府",130,201,-71
"6347","2390云辰","110/07/14","港商野村",486,450,36
"6348","2390云辰","110/07/14","元大-善化",12,76,-64
"6349","2390云辰","110/07/14","致和-崇德",30,0,30
"6350","2390云辰","110/07/14","華南永昌-岡山",23,81,-58
"6351","2390云辰","110/07/14","富邦-台北",40,14,26
"6352","2390云辰","110/07/14","群益金鼎-大興",82,125,-43
"6353","2390云辰","110/07/14","台新-高雄",38,13,25
"6354","2390云辰","110/07/14","大慶-中壢",0,41,-41
"6355","2390云辰","110/07/14","富邦-板橋",32,7,25
"6356","2390云辰","110/07/14","玉山-板橋",6,47,-41
"6357","2390云辰","110/07/14","陽信-石牌",24,0,24
"6358","2390云辰","110/07/14","富邦-台東",2,42,-40
"6359","2390云辰","110/07/14","凱基-屏東",32,8,24
"6360","2390云辰","110/07/14","元大-新營",3,42,-39
"6361","2363矽統","110/07/14","台灣摩根士丹利",463,0,463
"6362","2363矽統","110/07/14","新加坡商瑞銀",568,1321,-753
"6363","2363矽統","110/07/14","台新證券",750,342,408
"6364","2363矽統","110/07/14","瑞士信貸",149,864,-715
"6365","2363矽統","110/07/14","玉山-台中",363,51,312
"6366","2363矽統","110/07/14","台新-屏東",115,380,-265
"6367","2363矽統","110/07/14","元大-斗六",223,25,198
"6368","2363矽統","110/07/14","永豐金證券",16,265,-249
"6369","2363矽統","110/07/14","華南永昌-朴子",208,38,170
"6370","2363矽統","110/07/14","美林",462,701,-239
"6371","2363矽統","110/07/14","元富-西松",169,12,157
"6372","2363矽統","110/07/14","宏遠-桃園",269,500,-231
"6373","2363矽統","110/07/14","永豐金-大園",146,6,140
"6374","2363矽統","110/07/14","凱基-竹北",36,254,-218
"6375","2363矽統","110/07/14","土銀-和平",134,0,134
"6376","2363矽統","110/07/14","港商法國興業",0,214,-214
"6377","2363矽統","110/07/14","富邦-新營",130,13,117
"6378","2363矽統","110/07/14","港商野村",835,1044,-209
"6379","2363矽統","110/07/14","元富-成功",118,11,107
"6380","2363矽統","110/07/14","北城證券",212,411,-199
"6381","2363矽統","110/07/14","元富-烏日",121,18,103
"6382","2363矽統","110/07/14","(牛牛牛)亞-鑫豐",51,241,-190
"6383","2363矽統","110/07/14","日盛-二林",120,18,102
"6384","2363矽統","110/07/14","國票-博愛",24,213,-189
"6385","2363矽統","110/07/14","兆豐-忠孝",98,2,96
"6386","2363矽統","110/07/14","大慶-蘆洲",134,316,-182
"6387","2363矽統","110/07/14","大慶-楊梅",92,3,89
"6388","2363矽統","110/07/14","彰銀-台中",15,193,-178
"6389","2363矽統","110/07/14","元富-三重",120,33,87
"6390","2363矽統","110/07/14","日盛-和美",18,185,-167
"6391","8112至上","110/07/14","新加坡商瑞銀",223,17,206
"6392","8112至上","110/07/14","瑞士信貸",8,170,-162
"6393","8112至上","110/07/14","摩根大通",285,129,156
"6394","8112至上","110/07/14","美林",55,202,-147
"6395","8112至上","110/07/14","花旗環球",124,0,124
"6396","8112至上","110/07/14","凱基-台北",325,436,-111
"6397","8112至上","110/07/14","兆豐-公益",117,4,113
"6398","8112至上","110/07/14","台中銀-台北",0,98,-98
"6399","8112至上","110/07/14","香港上海匯豐",111,0,111
"6400","8112至上","110/07/14","玉山-台大",17,107,-90
"6401","8112至上","110/07/14","永豐金-內湖",117,21,96
"6402","8112至上","110/07/14","康和-內湖",1,90,-89
"6403","8112至上","110/07/14","台灣摩根士丹利",108,16,92
"6404","8112至上","110/07/14","港商野村",21,84,-63
"6405","8112至上","110/07/14","元大-東蘆",77,0,77
"6406","8112至上","110/07/14","兆豐-北高雄",1,60,-59
"6407","8112至上","110/07/14","新光",108,48,60
"6408","8112至上","110/07/14","群益金鼎-海山",1,52,-51
"6409","8112至上","110/07/14","大慶-蘆洲",59,0,59
"6410","8112至上","110/07/14","群益金鼎-大安",0,50,-50
"6411","8112至上","110/07/14","華南永昌-台中",56,3,53
"6412","8112至上","110/07/14","富邦-仁愛",2,49,-47
"6413","8112至上","110/07/14","土銀-嘉義",52,2,50
"6414","8112至上","110/07/14","元大-金華",0,42,-42
"6415","8112至上","110/07/14","美商高盛",40,0,40
"6416","8112至上","110/07/14","元大-內湖",4,43,-39
"6417","8112至上","110/07/14","臺銀",63,29,34
"6418","8112至上","110/07/14","第一金-華江",2,37,-35
"6419","8112至上","110/07/14","元富-嘉義",31,0,31
"6420","8112至上","110/07/14","永豐金-苓雅",2,34,-32
"6421","1570力肯","110/07/14","國票-北高雄",68,0,68
"6422","1570力肯","110/07/14","摩根大通",0,21,-21
"6423","1570力肯","110/07/14","日盛-八德",30,1,29
"6424","1570力肯","110/07/14","新光",1,19,-18
"6425","1570力肯","110/07/14","玉山-高雄",7,0,7
"6426","1570力肯","110/07/14","(牛牛牛)亞-鑫豐",0,17,-17
"6427","1570力肯","110/07/14","臺銀-臺南",5,0,5
"6428","1570力肯","110/07/14","日盛-士林",0,10,-10
"6429","1570力肯","110/07/14","凱基-三峽",5,0,5
"6430","1570力肯","110/07/14","統一-員林",0,10,-10
"6431","1570力肯","110/07/14","元大-和平",5,0,5
"6432","1570力肯","110/07/14","國票-新莊",0,10,-10
"6433","1570力肯","110/07/14","合庫-三重",4,0,4
"6434","1570力肯","110/07/14","凱基-高美館",0,10,-10
"6435","1570力肯","110/07/14","瑞士信貸",4,0,4
"6436","1570力肯","110/07/14","元大-屏東民生",0,5,-5
"6437","1570力肯","110/07/14","統一-三多",4,0,4
"6438","1570力肯","110/07/14","元大-古亭",0,5,-5
"6439","1570力肯","110/07/14","華南永昌-古亭",4,0,4
"6440","1570力肯","110/07/14","日盛-木柵",0,4,-4
"6441","1570力肯","110/07/14","元大-高雄",3,0,3
"6442","1570力肯","110/07/14","大昌",0,4,-4
"6443","1570力肯","110/07/14","兆豐-忠孝",2,0,2
"6444","1570力肯","110/07/14","群益金鼎-東大",0,4,-4
"6445","1570力肯","110/07/14","富邦-陽明",2,0,2
"6446","1570力肯","110/07/14","凱基-台北",0,4,-4
"6447","1570力肯","110/07/14","元大-松山",2,0,2
"6448","1570力肯","110/07/14","元大-板橋",0,4,-4
"6449","1570力肯","110/07/14","元大-忠孝",2,0,2
"6450","1570力肯","110/07/14","第一金-中山",0,3,-3
"6451","2929淘帝","110/07/14","華南永昌-林口",60,0,60
"6452","2929淘帝","110/07/14","群益金鼎",25,540,-515
"6453","2929淘帝","110/07/14","美林",87,31,56
"6454","2929淘帝","110/07/14","國泰-台南",1,30,-29
"6455","2929淘帝","110/07/14","元富-台南",40,0,40
"6456","2929淘帝","110/07/14","宏遠-桃園",0,20,-20
"6457","2929淘帝","110/07/14","元大-民生",39,0,39
"6458","2929淘帝","110/07/14","摩根大通",11,31,-20
"6459","2929淘帝","110/07/14","臺銀-鳳山",34,0,34
"6460","2929淘帝","110/07/14","台新-建北",5,20,-15
"6461","2929淘帝","110/07/14","合庫-高雄",34,1,33
"6462","2929淘帝","110/07/14","新光",1,16,-15
"6463","2929淘帝","110/07/14","華南永昌-鶯歌",28,0,28
"6464","2929淘帝","110/07/14","玉山-板橋",0,15,-15
"6465","2929淘帝","110/07/14","永興",25,0,25
"6466","2929淘帝","110/07/14","凱基-羅東",0,15,-15
"6467","2929淘帝","110/07/14","元大-新盛",25,1,24
"6468","2929淘帝","110/07/14","元大-頭份",0,15,-15
"6469","2929淘帝","110/07/14","日盛-南京",23,0,23
"6470","2929淘帝","110/07/14","第一金-台南",0,13,-13
"6471","2929淘帝","110/07/14","日茂",20,0,20
"6472","2929淘帝","110/07/14","富邦-基隆",0,12,-12
"6473","2929淘帝","110/07/14","台新-台中",20,0,20
"6474","2929淘帝","110/07/14","日茂-南投",1,12,-11
"6475","2929淘帝","110/07/14","華南永昌",20,0,20
"6476","2929淘帝","110/07/14","元大-豐原站前",0,11,-11
"6477","2929淘帝","110/07/14","福勝",15,0,15
"6478","2929淘帝","110/07/14","玉山-士林",0,10,-10
"6479","2929淘帝","110/07/14","富邦-南屯",15,0,15
"6480","2929淘帝","110/07/14","富邦-台北",0,10,-10
"6481","5410國眾","110/07/14","兆豐-城中",35,0,35
"6482","5410國眾","110/07/14","瑞士信貸",0,29,-29
"6483","5410國眾","110/07/14","新光",21,1,20
"6484","5410國眾","110/07/14","國泰-板橋",1,30,-29
"6485","5410國眾","110/07/14","國泰-敦南",21,1,20
"6486","5410國眾","110/07/14","日盛-高雄",0,20,-20
"6487","5410國眾","110/07/14","國泰-台中",20,1,19
"6488","5410國眾","110/07/14","台新-左楠",1,20,-19
"6489","5410國眾","110/07/14","元大-崇德",19,0,19
"6490","5410國眾","110/07/14","元富-大昌",1,18,-17
"6491","5410國眾","110/07/14","土銀-士林",18,0,18
"6492","5410國眾","110/07/14","富邦-建國",0,15,-15
"6493","5410國眾","110/07/14","元大-新盛",20,2,18
"6494","5410國眾","110/07/14","元富-嘉義",0,12,-12
"6495","5410國眾","110/07/14","兆豐-高雄",15,0,15
"6496","5410國眾","110/07/14","永全-南崁",0,12,-12
"6497","5410國眾","110/07/14","宏遠-中和",10,0,10
"6498","5410國眾","110/07/14","元大-員林",0,11,-11
"6499","5410國眾","110/07/14","新光-桃園",10,0,10
"6500","5410國眾","110/07/14","高橋",0,10,-10
"6501","5410國眾","110/07/14","國泰-台南",10,0,10
"6502","5410國眾","110/07/14","永興",0,10,-10
"6503","5410國眾","110/07/14","元大-復北",10,0,10
"6504","5410國眾","110/07/14","華南永昌-三重",0,10,-10
"6505","5410國眾","110/07/14","元大-竹科",8,0,8
"6506","5410國眾","110/07/14","元大-苑裡",0,7,-7
"6507","5410國眾","110/07/14","台新-新營",6,0,6
"6508","5410國眾","110/07/14","港商野村",0,6,-6
"6509","5410國眾","110/07/14","日盛-士林",5,0,5
"6510","5410國眾","110/07/14","摩根大通",5,11,-6
"6511","2841台開","110/07/14","凱基-文心",73,0,73
"6512","2841台開","110/07/14","國泰-敦南",0,50,-50
"6513","2841台開","110/07/14","元富-潮州",30,0,30
"6514","2841台開","110/07/14","凱基-中壢",0,40,-40
"6515","2841台開","110/07/14","第一金-台中",20,0,20
"6516","2841台開","110/07/14","統一-新竹",0,24,-24
"6517","2841台開","110/07/14","華南永昌-新莊",20,0,20
"6518","2841台開","110/07/14","元富-草屯",0,20,-20
"6519","2841台開","110/07/14","永豐金-豐原",20,0,20
"6520","2841台開","110/07/14","台新-台南",0,20,-20
"6521","2841台開","110/07/14","國泰-館前",15,0,15
"6522","2841台開","110/07/14","永豐金-敦南",45,63,-18
"6523","2841台開","110/07/14","群益金鼎-基隆",12,0,12
"6524","2841台開","110/07/14","國票-北高雄",0,13,-13
"6525","2841台開","110/07/14","日盛-信義",10,0,10
"6526","2841台開","110/07/14","凱基-松山",0,10,-10
"6527","2841台開","110/07/14","台新-台中",10,0,10
"6528","2841台開","110/07/14","元大證券",0,10,-10
"6529","2841台開","110/07/14","新光",10,1,9
"6530","2841台開","110/07/14","元大-中壢",0,10,-10
"6531","2841台開","110/07/14","凱基-新店",8,0,8
"6532","2841台開","110/07/14","富邦-陽明",1,10,-9
"6533","2841台開","110/07/14","元大-斗信",7,0,7
"6534","2841台開","110/07/14","富邦-建國",0,9,-9
"6535","2841台開","110/07/14","元大-三重",6,0,6
"6536","2841台開","110/07/14","富邦-台南",0,8,-8
"6537","2841台開","110/07/14","永豐金-中和",6,0,6
"6538","2841台開","110/07/14","康和-澎湖",0,7,-7
"6539","2841台開","110/07/14","元富-成功",5,0,5
"6540","2841台開","110/07/14","日盛-斗六",0,6,-6
"6541","6207雷科","110/07/14","群益金鼎-台北",60,0,60
"6542","6207雷科","110/07/14","新加坡商瑞銀",10,56,-46
"6543","6207雷科","110/07/14","台新-高雄",43,3,40
"6544","6207雷科","110/07/14","國票-中和",0,41,-41
"6545","6207雷科","110/07/14","元大-高雄",19,0,19
"6546","6207雷科","110/07/14","元大-復北",0,33,-33
"6547","6207雷科","110/07/14","福勝",15,0,15
"6548","6207雷科","110/07/14","光和-和美",0,20,-20
"6549","6207雷科","110/07/14","群益金鼎-中山",15,0,15
"6550","6207雷科","110/07/14","群益金鼎-丹鳳",0,20,-20
"6551","6207雷科","110/07/14","元大-林園",15,0,15
"6552","6207雷科","110/07/14","第一金-路竹",0,10,-10
"6553","6207雷科","110/07/14","新光",12,0,12
"6554","6207雷科","110/07/14","元大-歸仁",0,10,-10
"6555","6207雷科","110/07/14","元大-大天母",10,0,10
"6556","6207雷科","110/07/14","宏遠-館前",0,9,-9
"6557","6207雷科","110/07/14","永豐金-忠孝",9,0,9
"6558","6207雷科","110/07/14","凱基-台北",12,20,-8
"6559","6207雷科","110/07/14","永豐金-新店",7,0,7
"6560","6207雷科","110/07/14","美林",0,7,-7
"6561","6207雷科","110/07/14","玉山-嘉義",6,0,6
"6562","6207雷科","110/07/14","摩根大通",16,23,-7
"6563","6207雷科","110/07/14","元大-屏東",6,0,6
"6564","6207雷科","110/07/14","凱基-高雄",1,7,-6
"6565","6207雷科","110/07/14","凱基-大安",5,0,5
"6566","6207雷科","110/07/14","台中銀-豐原",0,5,-5
"6567","6207雷科","110/07/14","富邦-台南",5,0,5
"6568","6207雷科","110/07/14","元大-新竹經國",0,5,-5
"6569","6207雷科","110/07/14","元大-成功",5,0,5
"6570","6207雷科","110/07/14","光和-田中",0,4,-4
"6571","3679新至陞","110/07/14","凱基-台北",31,6,25
"6572","3679新至陞","110/07/14","群益金鼎-東大",0,15,-15
"6573","3679新至陞","110/07/14","華南永昌-新莊",10,0,10
"6574","3679新至陞","110/07/14","瑞士信貸",0,12,-12
"6575","3679新至陞","110/07/14","新加坡商瑞銀",11,3,8
"6576","3679新至陞","110/07/14","群益金鼎-永和",0,10,-10
"6577","3679新至陞","110/07/14","美商高盛",6,0,6
"6578","3679新至陞","110/07/14","元大-成功",5,15,-10
"6579","3679新至陞","110/07/14","第一金-中壢",6,0,6
"6580","3679新至陞","110/07/14","統一-板橋",1,10,-9
"6581","3679新至陞","110/07/14","(牛牛牛)亞-網路",4,0,4
"6582","3679新至陞","110/07/14","玉山-左營",0,5,-5
"6583","3679新至陞","110/07/14","元大-六合",3,0,3
"6584","3679新至陞","110/07/14","群益金鼎-三民",0,4,-4
"6585","3679新至陞","110/07/14","合庫-自強",2,0,2
"6586","3679新至陞","110/07/14","富邦-宜蘭",0,4,-4
"6587","3679新至陞","110/07/14","高橋-內壢",2,0,2
"6588","3679新至陞","110/07/14","永豐金-苓雅",0,3,-3
"6589","3679新至陞","110/07/14","台中銀-員林",2,0,2
"6590","3679新至陞","110/07/14","摩根大通",5,7,-2
"6591","3679新至陞","110/07/14","凱基-高美館",2,0,2
"6592","3679新至陞","110/07/14","元大-板橋三民",0,2,-2
"6593","3679新至陞","110/07/14","元大-福營",2,0,2
"6594","3679新至陞","110/07/14","宏遠-中和",0,1,-1
"6595","3679新至陞","110/07/14","永豐金-松山",2,0,2
"6596","3679新至陞","110/07/14","元富-佳里",0,1,-1
"6597","3679新至陞","110/07/14","永豐金-萬盛",2,0,2
"6598","3679新至陞","110/07/14","(牛牛牛)亞-鑫豐",0,1,-1
"6599","3679新至陞","110/07/14","元富-松德",1,0,1
"6600","3679新至陞","110/07/14","中國信託-中壢",0,1,-1
"6601","2727王品","110/07/14","富邦-左營",102,1,101
"6602","2727王品","110/07/14","統一-城中",100,234,-134
"6603","2727王品","110/07/14","國泰-板橋",105,11,94
"6604","2727王品","110/07/14","富邦-台北",1,125,-124
"6605","2727王品","110/07/14","港商野村",149,72,77
"6606","2727王品","110/07/14","台灣摩根士丹利",1,48,-47
"6607","2727王品","110/07/14","合庫-台中",66,2,64
"6608","2727王品","110/07/14","國票-新莊",0,40,-40
"6609","2727王品","110/07/14","臺銀-金山",63,8,55
"6610","2727王品","110/07/14","永豐金-忠孝",2,39,-37
"6611","2727王品","110/07/14","摩根大通",83,39,44
"6612","2727王品","110/07/14","富邦-彰化",1,34,-33
"6613","2727王品","110/07/14","凱基-台北",84,42,42
"6614","2727王品","110/07/14","康和-高雄",0,30,-30
"6615","2727王品","110/07/14","土銀-台中",35,1,34
"6616","2727王品","110/07/14","安泰",0,26,-26
"6617","2727王品","110/07/14","華南永昌-麻豆",32,1,31
"6618","2727王品","110/07/14","富邦-新竹華信",0,21,-21
"6619","2727王品","110/07/14","元大證券",85,55,30
"6620","2727王品","110/07/14","元大-南崁",1,22,-21
"6621","2727王品","110/07/14","新加坡商瑞銀",40,15,25
"6622","2727王品","110/07/14","彰銀-台中",0,18,-18
"6623","2727王品","110/07/14","日盛-八德",19,0,19
"6624","2727王品","110/07/14","元富-同大",2,20,-18
"6625","2727王品","110/07/14","統一",35,17,18
"6626","2727王品","110/07/14","玉山-嘉義",1,17,-16
"6627","2727王品","110/07/14","元富-大昌",18,1,17
"6628","2727王品","110/07/14","國泰-館前",4,20,-16
"6629","2727王品","110/07/14","玉山-板橋",15,1,14
"6630","2727王品","110/07/14","第一金-嘉義",1,13,-12
"6631","1570力肯","110/07/14","國票-北高雄",68,0,68
"6632","1570力肯","110/07/14","摩根大通",0,21,-21
"6633","1570力肯","110/07/14","日盛-八德",30,1,29
"6634","1570力肯","110/07/14","新光",1,19,-18
"6635","1570力肯","110/07/14","玉山-高雄",7,0,7
"6636","1570力肯","110/07/14","(牛牛牛)亞-鑫豐",0,17,-17
"6637","1570力肯","110/07/14","臺銀-臺南",5,0,5
"6638","1570力肯","110/07/14","日盛-士林",0,10,-10
"6639","1570力肯","110/07/14","凱基-三峽",5,0,5
"6640","1570力肯","110/07/14","統一-員林",0,10,-10
"6641","1570力肯","110/07/14","元大-和平",5,0,5
"6642","1570力肯","110/07/14","國票-新莊",0,10,-10
"6643","1570力肯","110/07/14","合庫-三重",4,0,4
"6644","1570力肯","110/07/14","凱基-高美館",0,10,-10
"6645","1570力肯","110/07/14","瑞士信貸",4,0,4
"6646","1570力肯","110/07/14","元大-屏東民生",0,5,-5
"6647","1570力肯","110/07/14","統一-三多",4,0,4
"6648","1570力肯","110/07/14","元大-古亭",0,5,-5
"6649","1570力肯","110/07/14","華南永昌-古亭",4,0,4
"6650","1570力肯","110/07/14","日盛-木柵",0,4,-4
"6651","1570力肯","110/07/14","元大-高雄",3,0,3
"6652","1570力肯","110/07/14","大昌",0,4,-4
"6653","1570力肯","110/07/14","兆豐-忠孝",2,0,2
"6654","1570力肯","110/07/14","群益金鼎-東大",0,4,-4
"6655","1570力肯","110/07/14","富邦-陽明",2,0,2
"6656","1570力肯","110/07/14","凱基-台北",0,4,-4
"6657","1570力肯","110/07/14","元大-松山",2,0,2
"6658","1570力肯","110/07/14","元大-板橋",0,4,-4
"6659","1570力肯","110/07/14","元大-忠孝",2,0,2
"6660","1570力肯","110/07/14","第一金-中山",0,3,-3
"6661","6180橘子","110/07/14","新加坡商瑞銀",84,28,56
"6662","6180橘子","110/07/14","凱基-台北",4,37,-33
"6663","6180橘子","110/07/14","日盛-信義",29,1,28
"6664","6180橘子","110/07/14","玉山-台南",1,22,-21
"6665","6180橘子","110/07/14","豐農",28,4,24
"6666","6180橘子","110/07/14","日盛-新竹",1,21,-20
"6667","6180橘子","110/07/14","新光-新竹",24,1,23
"6668","6180橘子","110/07/14","元富-潮州",0,19,-19
"6669","6180橘子","110/07/14","華南永昌-高雄",20,0,20
"6670","6180橘子","110/07/14","元大-信義",0,17,-17
"6671","6180橘子","110/07/14","元大-羅東",20,0,20
"6672","6180橘子","110/07/14","台灣企銀-台中",1,16,-15
"6673","6180橘子","110/07/14","元大-台中中港",20,0,20
"6674","6180橘子","110/07/14","元大-北港",0,15,-15
"6675","6180橘子","110/07/14","富邦-嘉義",24,5,19
"6676","6180橘子","110/07/14","富邦-高雄",0,14,-14
"6677","6180橘子","110/07/14","富邦-仁愛",15,0,15
"6678","6180橘子","110/07/14","兆豐-埔墘",0,13,-13
"6679","6180橘子","110/07/14","國票-九鼎",13,0,13
"6680","6180橘子","110/07/14","第一金-中山",0,10,-10
"6681","6180橘子","110/07/14","日盛-木柵",12,0,12
"6682","6180橘子","110/07/14","元大-彰化民生",0,10,-10
"6683","6180橘子","110/07/14","元大-成功",10,0,10
"6684","6180橘子","110/07/14","福勝",1,10,-9
"6685","6180橘子","110/07/14","港商野村",10,2,8
"6686","6180橘子","110/07/14","群益金鼎-丹鳳",1,10,-9
"6687","6180橘子","110/07/14","玉山-左營",8,0,8
"6688","6180橘子","110/07/14","群益金鼎-板橋",0,8,-8
"6689","6180橘子","110/07/14","富邦-陽明",16,8,8
"6690","6180橘子","110/07/14","合庫-鳳山",0,7,-7
"6691","2390云辰","110/07/14","摩根大通",995,198,797
"6692","2390云辰","110/07/14","新加坡商瑞銀",28,399,-371
"6693","2390云辰","110/07/14","美林",383,22,361
"6694","2390云辰","110/07/14","凱基-新豐",3,198,-195
"6695","2390云辰","110/07/14","台灣摩根士丹利",684,358,326
"6696","2390云辰","110/07/14","元大-士林",1,152,-151
"6697","2390云辰","110/07/14","凱基-台北",656,402,254
"6698","2390云辰","110/07/14","元大-竹山",80,181,-101
"6699","2390云辰","110/07/14","日盛-和美",110,5,105
"6700","2390云辰","110/07/14","群益金鼎-開元",19,95,-76
"6701","2390云辰","110/07/14","元大-天母",72,0,72
"6702","2390云辰","110/07/14","新光",77,150,-73
"6703","2390云辰","110/07/14","永豐金-松山",57,0,57
"6704","2390云辰","110/07/14","元富-高雄",0,71,-71
"6705","2390云辰","110/07/14","統一-屏東",53,0,53
"6706","2390云辰","110/07/14","元大-土城學府",130,201,-71
"6707","2390云辰","110/07/14","港商野村",486,450,36
"6708","2390云辰","110/07/14","元大-善化",12,76,-64
"6709","2390云辰","110/07/14","致和-崇德",30,0,30
"6710","2390云辰","110/07/14","華南永昌-岡山",23,81,-58
"6711","2390云辰","110/07/14","富邦-台北",40,14,26
"6712","2390云辰","110/07/14","群益金鼎-大興",82,125,-43
"6713","2390云辰","110/07/14","台新-高雄",38,13,25
"6714","2390云辰","110/07/14","大慶-中壢",0,41,-41
"6715","2390云辰","110/07/14","富邦-板橋",32,7,25
"6716","2390云辰","110/07/14","玉山-板橋",6,47,-41
"6717","2390云辰","110/07/14","陽信-石牌",24,0,24
"6718","2390云辰","110/07/14","富邦-台東",2,42,-40
"6719","2390云辰","110/07/14","凱基-屏東",32,8,24
"6720","2390云辰","110/07/14","元大-新營",3,42,-39
"6721","2363矽統","110/07/13","凱基-南崁",2133,63,2070
"6722","2363矽統","110/07/13","凱基-幸福",36,4048,-4012
"6723","2363矽統","110/07/13","國泰-敦南",2195,1617,578
"6724","2363矽統","110/07/13","統一",192,3325,-3133
"6725","2363矽統","110/07/13","中農",670,139,531
"6726","2363矽統","110/07/13","新加坡商瑞銀",1000,2747,-1747
"6727","2363矽統","110/07/13","康和-台中",638,154,484
"6728","2363矽統","110/07/13","凱基-台北",5359,6609,-1250
"6729","2363矽統","110/07/13","群益金鼎-三民",577,137,440
"6730","2363矽統","110/07/13","摩根大通",1930,2858,-928
"6731","2363矽統","110/07/13","台新-屏東",510,88,422
"6732","2363矽統","110/07/13","港商野村",960,1679,-719
"6733","2363矽統","110/07/13","德信-中正",455,67,388
"6734","2363矽統","110/07/13","兆豐-復興",25,705,-680
"6735","2363矽統","110/07/13","日盛-竹北",365,70,295
"6736","2363矽統","110/07/13","統一-仁愛",114,755,-641
"6737","2363矽統","110/07/13","元大-佳里",452,189,263
"6738","2363矽統","110/07/13","統一-敦南",29,638,-609
"6739","2363矽統","110/07/13","國票-博愛",296,38,258
"6740","2363矽統","110/07/13","統一-土城",100,704,-604
"6741","2363矽統","110/07/13","元大-萬華",340,95,245
"6742","2363矽統","110/07/13","統一-城中",116,676,-560
"6743","2363矽統","110/07/13","新光",1259,1031,228
"6744","2363矽統","110/07/13","永豐金證券",306,859,-553
"6745","2363矽統","110/07/13","元富-成功",323,96,227
"6746","2363矽統","110/07/13","元富",54,567,-513
"6747","2363矽統","110/07/13","豐農",228,23,205
"6748","2363矽統","110/07/13","瑞士信貸",202,666,-464
"6749","2363矽統","110/07/13","台灣企銀-岡山",186,4,182
"6750","2363矽統","110/07/13","永豐金-嘉義",67,468,-401
"6751","8112至上","110/07/13","摩根大通",688,296,392
"6752","8112至上","110/07/13","國票-中和",0,401,-401
"6753","8112至上","110/07/13","港商野村",344,145,199
"6754","8112至上","110/07/13","永豐金-板盛",0,205,-205
"6755","8112至上","110/07/13","兆豐-公益",195,5,190
"6756","8112至上","110/07/13","凱基-五股",43,155,-112
"6757","8112至上","110/07/13","台灣摩根士丹利",183,0,183
"6758","8112至上","110/07/13","凱基-市政",0,100,-100
"6759","8112至上","110/07/13","群益金鼎-敦南",153,2,151
"6760","8112至上","110/07/13","元大-大里德芳",1,92,-91
"6761","8112至上","110/07/13","臺銀-金山",146,26,120
"6762","8112至上","110/07/13","玉山-桃園",26,110,-84
"6763","8112至上","110/07/13","臺銀",133,19,114
"6764","8112至上","110/07/13","兆豐-天母",0,81,-81
"6765","8112至上","110/07/13","合庫-台中",115,6,109
"6766","8112至上","110/07/13","凱基-城中",3,84,-81
"6767","8112至上","110/07/13","亞東-板橋",134,26,108
"6768","8112至上","110/07/13","日盛-新莊",9,85,-76
"6769","8112至上","110/07/13","凱基-台北",414,326,88
"6770","8112至上","110/07/13","日盛-台中",2,64,-62
"6771","8112至上","110/07/13","新加坡商瑞銀",181,100,81
"6772","8112至上","110/07/13","日盛-中壢",3,64,-61
"6773","8112至上","110/07/13","國泰-敦南",108,31,77
"6774","8112至上","110/07/13","元大-台中",2,59,-57
"6775","8112至上","110/07/13","第一金-華江",77,4,73
"6776","8112至上","110/07/13","元大-雙和",7,64,-57
"6777","8112至上","110/07/13","永豐金-內湖",73,1,72
"6778","8112至上","110/07/13","元大-高雄",8,62,-54
"6779","8112至上","110/07/13","元大-永和",68,1,67
"6780","8112至上","110/07/13","元大-館前",2,55,-53
"6781","1570力肯","110/07/13","新光",115,11,104
"6782","1570力肯","110/07/13","元大-北三重",0,162,-162
"6783","1570力肯","110/07/13","群益金鼎-高雄",54,0,54
"6784","1570力肯","110/07/13","元大-大灣",0,25,-25
"6785","1570力肯","110/07/13","國票-新莊",22,0,22
"6786","1570力肯","110/07/13","永豐金-苓雅",0,22,-22
"6787","1570力肯","110/07/13","日盛-桃園",12,0,12
"6788","1570力肯","110/07/13","永豐金-永康",0,19,-19
"6789","1570力肯","110/07/13","元大-高雄",12,0,12
"6790","1570力肯","110/07/13","富邦-員林",0,15,-15
"6791","1570力肯","110/07/13","合庫-自強",11,0,11
"6792","1570力肯","110/07/13","凱基-台南",0,11,-11
"6793","1570力肯","110/07/13","摩根大通",26,15,11
"6794","1570力肯","110/07/13","日盛-竹北",0,10,-10
"6795","1570力肯","110/07/13","永豐金-中盛",11,0,11
"6796","1570力肯","110/07/13","國票-九鼎",0,10,-10
"6797","1570力肯","110/07/13","兆豐-台中港",10,0,10
"6798","1570力肯","110/07/13","凱基-桃園",0,10,-10
"6799","1570力肯","110/07/13","國泰-松江",9,0,9
"6800","1570力肯","110/07/13","凱基-新豐",0,10,-10
"6801","1570力肯","110/07/13","元大-新盛",9,0,9
"6802","1570力肯","110/07/13","元大-學甲",0,10,-10
"6803","1570力肯","110/07/13","元富-緯城",6,0,6
"6804","1570力肯","110/07/13","群益金鼎-東湖",1,10,-9
"6805","1570力肯","110/07/13","統一-三重",5,0,5
"6806","1570力肯","110/07/13","大昌",0,6,-6
"6807","1570力肯","110/07/13","元大-前金",5,0,5
"6808","1570力肯","110/07/13","元大-土城學府",0,6,-6
"6809","1570力肯","110/07/13","永豐金證券",5,0,5
"6810","1570力肯","110/07/13","統一",0,5,-5
"6811","2929淘帝","110/07/13","玉山-新竹",130,0,130
"6812","2929淘帝","110/07/13","美商高盛",0,177,-177
"6813","2929淘帝","110/07/13","臺銀-民權",60,0,60
"6814","2929淘帝","110/07/13","凱基-台北",6,80,-74
"6815","2929淘帝","110/07/13","新百王",31,0,31
"6816","2929淘帝","110/07/13","元富-大裕",0,49,-49
"6817","2929淘帝","110/07/13","日盛-園區",30,0,30
"6818","2929淘帝","110/07/13","國泰-館前",3,51,-48
"6819","2929淘帝","110/07/13","元大-南投",31,1,30
"6820","2929淘帝","110/07/13","凱基-中壢",0,41,-41
"6821","2929淘帝","110/07/13","兆豐-忠孝",28,0,28
"6822","2929淘帝","110/07/13","港商野村",21,55,-34
"6823","2929淘帝","110/07/13","元大-民生",28,0,28
"6824","2929淘帝","110/07/13","華南永昌-南京",2,34,-32
"6825","2929淘帝","110/07/13","合庫-高雄",27,0,27
"6826","2929淘帝","110/07/13","群益金鼎-土城",0,30,-30
"6827","2929淘帝","110/07/13","凱基-豐中",27,0,27
"6828","2929淘帝","110/07/13","富邦-南屯",0,22,-22
"6829","2929淘帝","110/07/13","新光",21,4,17
"6830","2929淘帝","110/07/13","第一金-豐原",0,20,-20
"6831","2929淘帝","110/07/13","元大-天母",17,0,17
"6832","2929淘帝","110/07/13","元大-屏南",6,26,-20
"6833","2929淘帝","110/07/13","永興",14,0,14
"6834","2929淘帝","110/07/13","永豐金-敦南",1,21,-20
"6835","2929淘帝","110/07/13","富邦-台北",12,0,12
"6836","2929淘帝","110/07/13","凱基-三重",2,21,-19
"6837","2929淘帝","110/07/13","元大-永和",12,0,12
"6838","2929淘帝","110/07/13","富邦-仁愛",7,25,-18
"6839","2929淘帝","110/07/13","國票-天祥",11,0,11
"6840","2929淘帝","110/07/13","元大-北投",0,16,-16
"6841","5410國眾","110/07/13","兆豐-城中",274,0,274
"6842","5410國眾","110/07/13","元富-嘉義",0,103,-103
"6843","5410國眾","110/07/13","新光",50,4,46
"6844","5410國眾","110/07/13","凱基-台北",0,50,-50
"6845","5410國眾","110/07/13","國泰-台中",26,0,26
"6846","5410國眾","110/07/13","瑞士信貸",0,31,-31
"6847","5410國眾","110/07/13","新加坡商瑞銀",22,0,22
"6848","5410國眾","110/07/13","台新-新莊",0,27,-27
"6849","5410國眾","110/07/13","光和-嘉義",20,0,20
"6850","5410國眾","110/07/13","元大-汐止",0,20,-20
"6851","5410國眾","110/07/13","凱基-竹北",17,0,17
"6852","5410國眾","110/07/13","亞東-新竹",0,17,-17
"6853","5410國眾","110/07/13","新光-桃園",15,0,15
"6854","5410國眾","110/07/13","元大-南勢角",0,13,-13
"6855","5410國眾","110/07/13","凱基-台東",14,0,14
"6856","5410國眾","110/07/13","台新-台南",0,12,-12
"6857","5410國眾","110/07/13","富邦-竹北",11,0,11
"6858","5410國眾","110/07/13","中國信託",0,11,-11
"6859","5410國眾","110/07/13","元富-同大",10,0,10
"6860","5410國眾","110/07/13","華南永昌",0,11,-11
"6861","5410國眾","110/07/13","國泰-敦南",24,15,9
"6862","5410國眾","110/07/13","臺銀-臺南",0,10,-10
"6863","5410國眾","110/07/13","日盛-內湖",7,0,7
"6864","5410國眾","110/07/13","台灣企銀-民雄",0,10,-10
"6865","5410國眾","110/07/13","台新-左楠",7,0,7
"6866","5410國眾","110/07/13","高橋",0,10,-10
"6867","5410國眾","110/07/13","元大-新盛",18,12,6
"6868","5410國眾","110/07/13","康和-嘉義",0,10,-10
"6869","5410國眾","110/07/13","統一",5,0,5
"6870","5410國眾","110/07/13","凱基-基隆",0,10,-10
"6871","2841台開","110/07/13","中國信託-高雄",251,50,201
"6872","2841台開","110/07/13","兆豐-公益",0,177,-177
"6873","2841台開","110/07/13","日盛證券",210,13,197
"6874","2841台開","110/07/13","日進",0,152,-152
"6875","2841台開","110/07/13","第一金-台中",55,0,55
"6876","2841台開","110/07/13","港商野村",0,109,-109
"6877","2841台開","110/07/13","國泰-板橋",46,0,46
"6878","2841台開","110/07/13","日盛-信義",0,103,-103
"6879","2841台開","110/07/13","國泰-館前",48,3,45
"6880","2841台開","110/07/13","國泰-敦南",11,75,-64
"6881","2841台開","110/07/13","華南永昌-新莊",45,0,45
"6882","2841台開","110/07/13","永興",0,50,-50
"6883","2841台開","110/07/13","日盛-園區",42,0,42
"6884","2841台開","110/07/13","永豐金-敦南",61,104,-43
"6885","2841台開","110/07/13","台新證券",32,0,32
"6886","2841台開","110/07/13","富邦-台南",0,42,-42
"6887","2841台開","110/07/13","台新-高雄",32,2,30
"6888","2841台開","110/07/13","國票-安和",0,30,-30
"6889","2841台開","110/07/13","豐農",23,0,23
"6890","2841台開","110/07/13","元大-桃園",0,25,-25
"6891","2841台開","110/07/13","合庫-嘉義",20,0,20
"6892","2841台開","110/07/13","新光",8,32,-24
"6893","2841台開","110/07/13","華南永昌-高雄",20,0,20
"6894","2841台開","110/07/13","元大-仁愛",0,24,-24
"6895","2841台開","110/07/13","元大-樹林",16,0,16
"6896","2841台開","110/07/13","日盛-中和",0,20,-20
"6897","2841台開","110/07/13","第一金-華江",15,2,13
"6898","2841台開","110/07/13","元富",0,20,-20
"6899","2841台開","110/07/13","美商高盛",12,0,12
"6900","2841台開","110/07/13","富邦-宜蘭",0,20,-20
"6901","6207雷科","110/07/13","元大-高雄",121,0,121
"6902","6207雷科","110/07/13","華南永昌-朴子",1,60,-59
"6903","6207雷科","110/07/13","第一金-新興",20,0,20
"6904","6207雷科","110/07/13","元大-南海",0,36,-36
"6905","6207雷科","110/07/13","元富-三重",20,0,20
"6906","6207雷科","110/07/13","凱基-土城",0,35,-35
"6907","6207雷科","110/07/13","元大-林園",15,0,15
"6908","6207雷科","110/07/13","台灣企銀",0,20,-20
"6909","6207雷科","110/07/13","元大-金華",16,1,15
"6910","6207雷科","110/07/13","群益金鼎-丹鳳",0,20,-20
"6911","6207雷科","110/07/13","日盛證券",10,0,10
"6912","6207雷科","110/07/13","元大-博愛",0,17,-17
"6913","6207雷科","110/07/13","統一-台中",10,0,10
"6914","6207雷科","110/07/13","元大-北港",0,13,-13
"6915","6207雷科","110/07/13","群益金鼎-土城",10,0,10
"6916","6207雷科","110/07/13","新加坡商瑞銀",0,12,-12
"6917","6207雷科","110/07/13","群益金鼎-桃園",10,0,10
"6918","6207雷科","110/07/13","凱基-台北",4,16,-12
"6919","6207雷科","110/07/13","永豐金-新莊",10,0,10
"6920","6207雷科","110/07/13","日茂-埔里",0,11,-11
"6921","6207雷科","110/07/13","永豐金-新店",10,0,10
"6922","6207雷科","110/07/13","元大-莒光",0,11,-11
"6923","6207雷科","110/07/13","元大證券",9,0,9
"6924","6207雷科","110/07/13","統一-新竹",0,10,-10
"6925","6207雷科","110/07/13","日盛-木柵",9,1,8
"6926","6207雷科","110/07/13","元大-西螺",0,10,-10
"6927","6207雷科","110/07/13","兆豐-來福",8,0,8
"6928","6207雷科","110/07/13","康和-台中",0,8,-8
"6929","6207雷科","110/07/13","新光",7,0,7
"6930","6207雷科","110/07/13","兆豐-高雄",0,6,-6
"6931","3679新至陞","110/07/13","永豐金證券",50,0,50
"6932","3679新至陞","110/07/13","摩根大通",2,25,-23
"6933","3679新至陞","110/07/13","國泰-桃園",22,0,22
"6934","3679新至陞","110/07/13","元大-成功",0,22,-22
"6935","3679新至陞","110/07/13","台中銀-員林",11,0,11
"6936","3679新至陞","110/07/13","富邦-板橋",1,19,-18
"6937","3679新至陞","110/07/13","元大-文心興安",8,0,8
"6938","3679新至陞","110/07/13","日盛-新莊",0,10,-10
"6939","3679新至陞","110/07/13","美商高盛",6,0,6
"6940","3679新至陞","110/07/13","台新-台中",0,10,-10
"6941","3679新至陞","110/07/13","台新-高雄",6,0,6
"6942","3679新至陞","110/07/13","永豐金-新竹",0,8,-8
"6943","3679新至陞","110/07/13","凱基-台北",18,12,6
"6944","3679新至陞","110/07/13","瑞士信貸",12,19,-7
"6945","3679新至陞","110/07/13","日盛-復興",5,0,5
"6946","3679新至陞","110/07/13","統一-南京",0,7,-7
"6947","3679新至陞","110/07/13","(牛牛牛)亞-鑫豐",4,0,4
"6948","3679新至陞","110/07/13","凱基-新莊",0,7,-7
"6949","3679新至陞","110/07/13","元富-大昌",3,0,3
"6950","3679新至陞","110/07/13","新加坡商瑞銀",0,6,-6
"6951","3679新至陞","110/07/13","富邦-台北",3,0,3
"6952","3679新至陞","110/07/13","合庫-自強",0,5,-5
"6953","3679新至陞","110/07/13","日盛-樹林",2,0,2
"6954","3679新至陞","110/07/13","富邦-桃園",0,5,-5
"6955","3679新至陞","110/07/13","宏遠-光隆",2,0,2
"6956","3679新至陞","110/07/13","永豐金-潮州",0,4,-4
"6957","3679新至陞","110/07/13","美林",3,1,2
"6958","3679新至陞","110/07/13","臺銀-臺南",0,3,-3
"6959","3679新至陞","110/07/13","第一金-中壢",2,0,2
"6960","3679新至陞","110/07/13","元大-六合",0,3,-3
"6961","2727王品","110/07/13","富邦-台北",43,3,40
"6962","2727王品","110/07/13","台灣摩根士丹利",15,97,-82
"6963","2727王品","110/07/13","元大-基隆孝二",40,0,40
"6964","2727王品","110/07/13","玉山-台南",5,57,-52
"6965","2727王品","110/07/13","國票-新莊",40,1,39
"6966","2727王品","110/07/13","新加坡商瑞銀",0,48,-48
"6967","2727王品","110/07/13","第一金-豐原",66,42,24
"6968","2727王品","110/07/13","凱基-台北",41,77,-36
"6969","2727王品","110/07/13","永豐金-大園",34,10,24
"6970","2727王品","110/07/13","永豐金-永康",0,22,-22
"6971","2727王品","110/07/13","元大-北屯",22,0,22
"6972","2727王品","110/07/13","統一-台中",2,22,-20
"6973","2727王品","110/07/13","元大-東蘆",26,7,19
"6974","2727王品","110/07/13","國泰-台中",21,39,-18
"6975","2727王品","110/07/13","永豐金-萬盛",13,1,12
"6976","2727王品","110/07/13","合庫-彰化",3,20,-17
"6977","2727王品","110/07/13","日盛-嘉義",11,0,11
"6978","2727王品","110/07/13","港商野村",13,30,-17
"6979","2727王品","110/07/13","日盛-八德",11,0,11
"6980","2727王品","110/07/13","元大-楊梅",1,16,-15
"6981","2727王品","110/07/13","統一-竹南",11,0,11
"6982","2727王品","110/07/13","凱基-高美館",2,15,-13
"6983","2727王品","110/07/13","日盛-士林",12,2,10
"6984","2727王品","110/07/13","美商高盛",2,14,-12
"6985","2727王品","110/07/13","統一-敦南",10,0,10
"6986","2727王品","110/07/13","統一-平鎮",1,13,-12
"6987","2727王品","110/07/13","中國信託",15,5,10
"6988","2727王品","110/07/13","兆豐-台中港",4,16,-12
"6989","2727王品","110/07/13","兆豐-竹北",13,3,10
"6990","2727王品","110/07/13","凱基-八德",1,13,-12
"6991","1570力肯","110/07/13","新光",115,11,104
"6992","1570力肯","110/07/13","元大-北三重",0,162,-162
"6993","1570力肯","110/07/13","群益金鼎-高雄",54,0,54
"6994","1570力肯","110/07/13","元大-大灣",0,25,-25
"6995","1570力肯","110/07/13","國票-新莊",22,0,22
"6996","1570力肯","110/07/13","永豐金-苓雅",0,22,-22
"6997","1570力肯","110/07/13","日盛-桃園",12,0,12
"6998","1570力肯","110/07/13","永豐金-永康",0,19,-19
"6999","1570力肯","110/07/13","元大-高雄",12,0,12
"7000","1570力肯","110/07/13","富邦-員林",0,15,-15
"7001","1570力肯","110/07/13","合庫-自強",11,0,11
"7002","1570力肯","110/07/13","凱基-台南",0,11,-11
"7003","1570力肯","110/07/13","摩根大通",26,15,11
"7004","1570力肯","110/07/13","日盛-竹北",0,10,-10
"7005","1570力肯","110/07/13","永豐金-中盛",11,0,11
"7006","1570力肯","110/07/13","國票-九鼎",0,10,-10
"7007","1570力肯","110/07/13","兆豐-台中港",10,0,10
"7008","1570力肯","110/07/13","凱基-桃園",0,10,-10
"7009","1570力肯","110/07/13","國泰-松江",9,0,9
"7010","1570力肯","110/07/13","凱基-新豐",0,10,-10
"7011","1570力肯","110/07/13","元大-新盛",9,0,9
"7012","1570力肯","110/07/13","元大-學甲",0,10,-10
"7013","1570力肯","110/07/13","元富-緯城",6,0,6
"7014","1570力肯","110/07/13","群益金鼎-東湖",1,10,-9
"7015","1570力肯","110/07/13","統一-三重",5,0,5
"7016","1570力肯","110/07/13","大昌",0,6,-6
"7017","1570力肯","110/07/13","元大-前金",5,0,5
"7018","1570力肯","110/07/13","元大-土城學府",0,6,-6
"7019","1570力肯","110/07/13","永豐金證券",5,0,5
"7020","1570力肯","110/07/13","統一",0,5,-5
"7021","6180橘子","110/07/13","摩根大通",119,0,119
"7022","6180橘子","110/07/13","元大-崇德",2,61,-59
"7023","6180橘子","110/07/13","美商高盛",96,0,96
"7024","6180橘子","110/07/13","康和-台中",0,51,-51
"7025","6180橘子","110/07/13","新加坡商瑞銀",86,7,79
"7026","6180橘子","110/07/13","康和-台北",0,50,-50
"7027","6180橘子","110/07/13","元大-和平",40,0,40
"7028","6180橘子","110/07/13","元富-潮州",0,40,-40
"7029","6180橘子","110/07/13","凱基-台北",83,47,36
"7030","6180橘子","110/07/13","日盛-永康",0,26,-26
"7031","6180橘子","110/07/13","美林",39,5,34
"7032","6180橘子","110/07/13","永豐金-中正",0,24,-24
"7033","6180橘子","110/07/13","富邦-新竹華信",31,2,29
"7034","6180橘子","110/07/13","國泰-板橋",2,25,-23
"7035","6180橘子","110/07/13","統一-南京",21,0,21
"7036","6180橘子","110/07/13","日盛-大墩",0,20,-20
"7037","6180橘子","110/07/13","富邦-陽明",24,3,21
"7038","6180橘子","110/07/13","元大-草屯",13,32,-19
"7039","6180橘子","110/07/13","大昌-樹林",21,1,20
"7040","6180橘子","110/07/13","元富-林園",1,18,-17
"7041","6180橘子","110/07/13","花旗環球",19,0,19
"7042","6180橘子","110/07/13","新光-新竹",1,18,-17
"7043","6180橘子","110/07/13","華南永昌-台南",19,0,19
"7044","6180橘子","110/07/13","元大-土城永寧",0,17,-17
"7045","6180橘子","110/07/13","福勝",14,0,14
"7046","6180橘子","110/07/13","國泰-新莊",3,19,-16
"7047","6180橘子","110/07/13","富邦-嘉義",12,1,11
"7048","6180橘子","110/07/13","中國信託-永康",6,21,-15
"7049","6180橘子","110/07/13","元大-板橋三民",11,0,11
"7050","6180橘子","110/07/13","凱基-東港",1,15,-14
"7051","2390云辰","110/07/13","新加坡商瑞銀",562,75,487
"7052","2390云辰","110/07/13","大展-台南",0,532,-532
"7053","2390云辰","110/07/13","台灣摩根士丹利",330,155,175
"7054","2390云辰","110/07/13","凱基-台北",668,854,-186
"7055","2390云辰","110/07/13","兆豐-公益",126,25,101
"7056","2390云辰","110/07/13","凱基-三重",12,172,-160
"7057","2390云辰","110/07/13","元富-中港",100,2,98
"7058","2390云辰","110/07/13","兆豐-忠孝",4,161,-157
"7059","2390云辰","110/07/13","統一-新台中",106,9,97
"7060","2390云辰","110/07/13","元大-士林",19,170,-151
"7061","2390云辰","110/07/13","中國信託-松江",81,11,70
"7062","2390云辰","110/07/13","臺銀-新竹",14,117,-103
"7063","2390云辰","110/07/13","日盛-板橋",72,3,69
"7064","2390云辰","110/07/13","國票-台中",4,102,-98
"7065","2390云辰","110/07/13","日盛-和美",57,0,57
"7066","2390云辰","110/07/13","新光",147,232,-85
"7067","2390云辰","110/07/13","永豐金-桃園",88,36,52
"7068","2390云辰","110/07/13","致和-崇德",2,70,-68
"7069","2390云辰","110/07/13","玉山-士林",54,4,50
"7070","2390云辰","110/07/13","群益金鼎-屏東",2,70,-68
"7071","2390云辰","110/07/13","富邦-仁愛",56,6,50
"7072","2390云辰","110/07/13","元大-大里",35,98,-63
"7073","2390云辰","110/07/13","第一金-豐原",50,1,49
"7074","2390云辰","110/07/13","元大-萬華",35,94,-59
"7075","2390云辰","110/07/13","摩根大通",502,453,49
"7076","2390云辰","110/07/13","元富-吉利",2,60,-58
"7077","2390云辰","110/07/13","凱基-松山",61,13,48
"7078","2390云辰","110/07/13","兆豐-新竹",3,53,-50
"7079","2390云辰","110/07/13","大昌",64,22,42
"7080","2390云辰","110/07/13","富邦-嘉義",65,108,-43
"7081","2363矽統","110/07/13","凱基-南崁",2133,63,2070
"7082","2363矽統","110/07/13","凱基-幸福",36,4048,-4012
"7083","2363矽統","110/07/13","國泰-敦南",2195,1617,578
"7084","2363矽統","110/07/13","統一",192,3325,-3133
"7085","2363矽統","110/07/13","中農",670,139,531
"7086","2363矽統","110/07/13","新加坡商瑞銀",1000,2747,-1747
"7087","2363矽統","110/07/13","康和-台中",638,154,484
"7088","2363矽統","110/07/13","凱基-台北",5359,6609,-1250
"7089","2363矽統","110/07/13","群益金鼎-三民",577,137,440
"7090","2363矽統","110/07/13","摩根大通",1930,2858,-928
"7091","2363矽統","110/07/13","台新-屏東",510,88,422
"7092","2363矽統","110/07/13","港商野村",960,1679,-719
"7093","2363矽統","110/07/13","德信-中正",455,67,388
"7094","2363矽統","110/07/13","兆豐-復興",25,705,-680
"7095","2363矽統","110/07/13","日盛-竹北",365,70,295
"7096","2363矽統","110/07/13","統一-仁愛",114,755,-641
"7097","2363矽統","110/07/13","元大-佳里",452,189,263
"7098","2363矽統","110/07/13","統一-敦南",29,638,-609
"7099","2363矽統","110/07/13","國票-博愛",296,38,258
"7100","2363矽統","110/07/13","統一-土城",100,704,-604
"7101","2363矽統","110/07/13","元大-萬華",340,95,245
"7102","2363矽統","110/07/13","統一-城中",116,676,-560
"7103","2363矽統","110/07/13","新光",1259,1031,228
"7104","2363矽統","110/07/13","永豐金證券",306,859,-553
"7105","2363矽統","110/07/13","元富-成功",323,96,227
"7106","2363矽統","110/07/13","元富",54,567,-513
"7107","2363矽統","110/07/13","豐農",228,23,205
"7108","2363矽統","110/07/13","瑞士信貸",202,666,-464
"7109","2363矽統","110/07/13","台灣企銀-岡山",186,4,182
"7110","2363矽統","110/07/13","永豐金-嘉義",67,468,-401
"7111","8112至上","110/07/13","摩根大通",688,296,392
"7112","8112至上","110/07/13","國票-中和",0,401,-401
"7113","8112至上","110/07/13","港商野村",344,145,199
"7114","8112至上","110/07/13","永豐金-板盛",0,205,-205
"7115","8112至上","110/07/13","兆豐-公益",195,5,190
"7116","8112至上","110/07/13","凱基-五股",43,155,-112
"7117","8112至上","110/07/13","台灣摩根士丹利",183,0,183
"7118","8112至上","110/07/13","凱基-市政",0,100,-100
"7119","8112至上","110/07/13","群益金鼎-敦南",153,2,151
"7120","8112至上","110/07/13","元大-大里德芳",1,92,-91
"7121","8112至上","110/07/13","臺銀-金山",146,26,120
"7122","8112至上","110/07/13","玉山-桃園",26,110,-84
"7123","8112至上","110/07/13","臺銀",133,19,114
"7124","8112至上","110/07/13","兆豐-天母",0,81,-81
"7125","8112至上","110/07/13","合庫-台中",115,6,109
"7126","8112至上","110/07/13","凱基-城中",3,84,-81
"7127","8112至上","110/07/13","亞東-板橋",134,26,108
"7128","8112至上","110/07/13","日盛-新莊",9,85,-76
"7129","8112至上","110/07/13","凱基-台北",414,326,88
"7130","8112至上","110/07/13","日盛-台中",2,64,-62
"7131","8112至上","110/07/13","新加坡商瑞銀",181,100,81
"7132","8112至上","110/07/13","日盛-中壢",3,64,-61
"7133","8112至上","110/07/13","國泰-敦南",108,31,77
"7134","8112至上","110/07/13","元大-台中",2,59,-57
"7135","8112至上","110/07/13","第一金-華江",77,4,73
"7136","8112至上","110/07/13","元大-雙和",7,64,-57
"7137","8112至上","110/07/13","永豐金-內湖",73,1,72
"7138","8112至上","110/07/13","元大-高雄",8,62,-54
"7139","8112至上","110/07/13","元大-永和",68,1,67
"7140","8112至上","110/07/13","元大-館前",2,55,-53
"7141","1570力肯","110/07/13","新光",115,11,104
"7142","1570力肯","110/07/13","元大-北三重",0,162,-162
"7143","1570力肯","110/07/13","群益金鼎-高雄",54,0,54
"7144","1570力肯","110/07/13","元大-大灣",0,25,-25
"7145","1570力肯","110/07/13","國票-新莊",22,0,22
"7146","1570力肯","110/07/13","永豐金-苓雅",0,22,-22
"7147","1570力肯","110/07/13","日盛-桃園",12,0,12
"7148","1570力肯","110/07/13","永豐金-永康",0,19,-19
"7149","1570力肯","110/07/13","元大-高雄",12,0,12
"7150","1570力肯","110/07/13","富邦-員林",0,15,-15
"7151","1570力肯","110/07/13","合庫-自強",11,0,11
"7152","1570力肯","110/07/13","凱基-台南",0,11,-11
"7153","1570力肯","110/07/13","摩根大通",26,15,11
"7154","1570力肯","110/07/13","日盛-竹北",0,10,-10
"7155","1570力肯","110/07/13","永豐金-中盛",11,0,11
"7156","1570力肯","110/07/13","國票-九鼎",0,10,-10
"7157","1570力肯","110/07/13","兆豐-台中港",10,0,10
"7158","1570力肯","110/07/13","凱基-桃園",0,10,-10
"7159","1570力肯","110/07/13","國泰-松江",9,0,9
"7160","1570力肯","110/07/13","凱基-新豐",0,10,-10
"7161","1570力肯","110/07/13","元大-新盛",9,0,9
"7162","1570力肯","110/07/13","元大-學甲",0,10,-10
"7163","1570力肯","110/07/13","元富-緯城",6,0,6
"7164","1570力肯","110/07/13","群益金鼎-東湖",1,10,-9
"7165","1570力肯","110/07/13","統一-三重",5,0,5
"7166","1570力肯","110/07/13","大昌",0,6,-6
"7167","1570力肯","110/07/13","元大-前金",5,0,5
"7168","1570力肯","110/07/13","元大-土城學府",0,6,-6
"7169","1570力肯","110/07/13","永豐金證券",5,0,5
"7170","1570力肯","110/07/13","統一",0,5,-5
"7171","2929淘帝","110/07/13","玉山-新竹",130,0,130
"7172","2929淘帝","110/07/13","美商高盛",0,177,-177
"7173","2929淘帝","110/07/13","臺銀-民權",60,0,60
"7174","2929淘帝","110/07/13","凱基-台北",6,80,-74
"7175","2929淘帝","110/07/13","新百王",31,0,31
"7176","2929淘帝","110/07/13","元富-大裕",0,49,-49
"7177","2929淘帝","110/07/13","日盛-園區",30,0,30
"7178","2929淘帝","110/07/13","國泰-館前",3,51,-48
"7179","2929淘帝","110/07/13","元大-南投",31,1,30
"7180","2929淘帝","110/07/13","凱基-中壢",0,41,-41
"7181","2929淘帝","110/07/13","兆豐-忠孝",28,0,28
"7182","2929淘帝","110/07/13","港商野村",21,55,-34
"7183","2929淘帝","110/07/13","元大-民生",28,0,28
"7184","2929淘帝","110/07/13","華南永昌-南京",2,34,-32
"7185","2929淘帝","110/07/13","合庫-高雄",27,0,27
"7186","2929淘帝","110/07/13","群益金鼎-土城",0,30,-30
"7187","2929淘帝","110/07/13","凱基-豐中",27,0,27
"7188","2929淘帝","110/07/13","富邦-南屯",0,22,-22
"7189","2929淘帝","110/07/13","新光",21,4,17
"7190","2929淘帝","110/07/13","第一金-豐原",0,20,-20
"7191","2929淘帝","110/07/13","元大-天母",17,0,17
"7192","2929淘帝","110/07/13","元大-屏南",6,26,-20
"7193","2929淘帝","110/07/13","永興",14,0,14
"7194","2929淘帝","110/07/13","永豐金-敦南",1,21,-20
"7195","2929淘帝","110/07/13","富邦-台北",12,0,12
"7196","2929淘帝","110/07/13","凱基-三重",2,21,-19
"7197","2929淘帝","110/07/13","元大-永和",12,0,12
"7198","2929淘帝","110/07/13","富邦-仁愛",7,25,-18
"7199","2929淘帝","110/07/13","國票-天祥",11,0,11
"7200","2929淘帝","110/07/13","元大-北投",0,16,-16
"7201","5410國眾","110/07/13","兆豐-城中",274,0,274
"7202","5410國眾","110/07/13","元富-嘉義",0,103,-103
"7203","5410國眾","110/07/13","新光",50,4,46
"7204","5410國眾","110/07/13","凱基-台北",0,50,-50
"7205","5410國眾","110/07/13","國泰-台中",26,0,26
"7206","5410國眾","110/07/13","瑞士信貸",0,31,-31
"7207","5410國眾","110/07/13","新加坡商瑞銀",22,0,22
"7208","5410國眾","110/07/13","台新-新莊",0,27,-27
"7209","5410國眾","110/07/13","光和-嘉義",20,0,20
"7210","5410國眾","110/07/13","元大-汐止",0,20,-20
"7211","5410國眾","110/07/13","凱基-竹北",17,0,17
"7212","5410國眾","110/07/13","亞東-新竹",0,17,-17
"7213","5410國眾","110/07/13","新光-桃園",15,0,15
"7214","5410國眾","110/07/13","元大-南勢角",0,13,-13
"7215","5410國眾","110/07/13","凱基-台東",14,0,14
"7216","5410國眾","110/07/13","台新-台南",0,12,-12
"7217","5410國眾","110/07/13","富邦-竹北",11,0,11
"7218","5410國眾","110/07/13","中國信託",0,11,-11
"7219","5410國眾","110/07/13","元富-同大",10,0,10
"7220","5410國眾","110/07/13","華南永昌",0,11,-11
"7221","5410國眾","110/07/13","國泰-敦南",24,15,9
"7222","5410國眾","110/07/13","臺銀-臺南",0,10,-10
"7223","5410國眾","110/07/13","日盛-內湖",7,0,7
"7224","5410國眾","110/07/13","台灣企銀-民雄",0,10,-10
"7225","5410國眾","110/07/13","台新-左楠",7,0,7
"7226","5410國眾","110/07/13","高橋",0,10,-10
"7227","5410國眾","110/07/13","元大-新盛",18,12,6
"7228","5410國眾","110/07/13","康和-嘉義",0,10,-10
"7229","5410國眾","110/07/13","統一",5,0,5
"7230","5410國眾","110/07/13","凱基-基隆",0,10,-10
"7231","2841台開","110/07/13","中國信託-高雄",251,50,201
"7232","2841台開","110/07/13","兆豐-公益",0,177,-177
"7233","2841台開","110/07/13","日盛證券",210,13,197
"7234","2841台開","110/07/13","日進",0,152,-152
"7235","2841台開","110/07/13","第一金-台中",55,0,55
"7236","2841台開","110/07/13","港商野村",0,109,-109
"7237","2841台開","110/07/13","國泰-板橋",46,0,46
"7238","2841台開","110/07/13","日盛-信義",0,103,-103
"7239","2841台開","110/07/13","國泰-館前",48,3,45
"7240","2841台開","110/07/13","國泰-敦南",11,75,-64
"7241","2841台開","110/07/13","華南永昌-新莊",45,0,45
"7242","2841台開","110/07/13","永興",0,50,-50
"7243","2841台開","110/07/13","日盛-園區",42,0,42
"7244","2841台開","110/07/13","永豐金-敦南",61,104,-43
"7245","2841台開","110/07/13","台新證券",32,0,32
"7246","2841台開","110/07/13","富邦-台南",0,42,-42
"7247","2841台開","110/07/13","台新-高雄",32,2,30
"7248","2841台開","110/07/13","國票-安和",0,30,-30
"7249","2841台開","110/07/13","豐農",23,0,23
"7250","2841台開","110/07/13","元大-桃園",0,25,-25
"7251","2841台開","110/07/13","合庫-嘉義",20,0,20
"7252","2841台開","110/07/13","新光",8,32,-24
"7253","2841台開","110/07/13","華南永昌-高雄",20,0,20
"7254","2841台開","110/07/13","元大-仁愛",0,24,-24
"7255","2841台開","110/07/13","元大-樹林",16,0,16
"7256","2841台開","110/07/13","日盛-中和",0,20,-20
"7257","2841台開","110/07/13","第一金-華江",15,2,13
"7258","2841台開","110/07/13","元富",0,20,-20
"7259","2841台開","110/07/13","美商高盛",12,0,12
"7260","2841台開","110/07/13","富邦-宜蘭",0,20,-20
"7261","6207雷科","110/07/13","元大-高雄",121,0,121
"7262","6207雷科","110/07/13","華南永昌-朴子",1,60,-59
"7263","6207雷科","110/07/13","第一金-新興",20,0,20
"7264","6207雷科","110/07/13","元大-南海",0,36,-36
"7265","6207雷科","110/07/13","元富-三重",20,0,20
"7266","6207雷科","110/07/13","凱基-土城",0,35,-35
"7267","6207雷科","110/07/13","元大-林園",15,0,15
"7268","6207雷科","110/07/13","台灣企銀",0,20,-20
"7269","6207雷科","110/07/13","元大-金華",16,1,15
"7270","6207雷科","110/07/13","群益金鼎-丹鳳",0,20,-20
"7271","6207雷科","110/07/13","日盛證券",10,0,10
"7272","6207雷科","110/07/13","元大-博愛",0,17,-17
"7273","6207雷科","110/07/13","統一-台中",10,0,10
"7274","6207雷科","110/07/13","元大-北港",0,13,-13
"7275","6207雷科","110/07/13","群益金鼎-土城",10,0,10
"7276","6207雷科","110/07/13","新加坡商瑞銀",0,12,-12
"7277","6207雷科","110/07/13","群益金鼎-桃園",10,0,10
"7278","6207雷科","110/07/13","凱基-台北",4,16,-12
"7279","6207雷科","110/07/13","永豐金-新莊",10,0,10
"7280","6207雷科","110/07/13","日茂-埔里",0,11,-11
"7281","6207雷科","110/07/13","永豐金-新店",10,0,10
"7282","6207雷科","110/07/13","元大-莒光",0,11,-11
"7283","6207雷科","110/07/13","元大證券",9,0,9
"7284","6207雷科","110/07/13","統一-新竹",0,10,-10
"7285","6207雷科","110/07/13","日盛-木柵",9,1,8
"7286","6207雷科","110/07/13","元大-西螺",0,10,-10
"7287","6207雷科","110/07/13","兆豐-來福",8,0,8
"7288","6207雷科","110/07/13","康和-台中",0,8,-8
"7289","6207雷科","110/07/13","新光",7,0,7
"7290","6207雷科","110/07/13","兆豐-高雄",0,6,-6
"7291","3679新至陞","110/07/13","永豐金證券",50,0,50
"7292","3679新至陞","110/07/13","摩根大通",2,25,-23
"7293","3679新至陞","110/07/13","國泰-桃園",22,0,22
"7294","3679新至陞","110/07/13","元大-成功",0,22,-22
"7295","3679新至陞","110/07/13","台中銀-員林",11,0,11
"7296","3679新至陞","110/07/13","富邦-板橋",1,19,-18
"7297","3679新至陞","110/07/13","元大-文心興安",8,0,8
"7298","3679新至陞","110/07/13","日盛-新莊",0,10,-10
"7299","3679新至陞","110/07/13","美商高盛",6,0,6
"7300","3679新至陞","110/07/13","台新-台中",0,10,-10
"7301","3679新至陞","110/07/13","台新-高雄",6,0,6
"7302","3679新至陞","110/07/13","永豐金-新竹",0,8,-8
"7303","3679新至陞","110/07/13","凱基-台北",18,12,6
"7304","3679新至陞","110/07/13","瑞士信貸",12,19,-7
"7305","3679新至陞","110/07/13","日盛-復興",5,0,5
"7306","3679新至陞","110/07/13","統一-南京",0,7,-7
"7307","3679新至陞","110/07/13","(牛牛牛)亞-鑫豐",4,0,4
"7308","3679新至陞","110/07/13","凱基-新莊",0,7,-7
"7309","3679新至陞","110/07/13","元富-大昌",3,0,3
"7310","3679新至陞","110/07/13","新加坡商瑞銀",0,6,-6
"7311","3679新至陞","110/07/13","富邦-台北",3,0,3
"7312","3679新至陞","110/07/13","合庫-自強",0,5,-5
"7313","3679新至陞","110/07/13","日盛-樹林",2,0,2
"7314","3679新至陞","110/07/13","富邦-桃園",0,5,-5
"7315","3679新至陞","110/07/13","宏遠-光隆",2,0,2
"7316","3679新至陞","110/07/13","永豐金-潮州",0,4,-4
"7317","3679新至陞","110/07/13","美林",3,1,2
"7318","3679新至陞","110/07/13","臺銀-臺南",0,3,-3
"7319","3679新至陞","110/07/13","第一金-中壢",2,0,2
"7320","3679新至陞","110/07/13","元大-六合",0,3,-3
"7321","2727王品","110/07/13","富邦-台北",43,3,40
"7322","2727王品","110/07/13","台灣摩根士丹利",15,97,-82
"7323","2727王品","110/07/13","元大-基隆孝二",40,0,40
"7324","2727王品","110/07/13","玉山-台南",5,57,-52
"7325","2727王品","110/07/13","國票-新莊",40,1,39
"7326","2727王品","110/07/13","新加坡商瑞銀",0,48,-48
"7327","2727王品","110/07/13","第一金-豐原",66,42,24
"7328","2727王品","110/07/13","凱基-台北",41,77,-36
"7329","2727王品","110/07/13","永豐金-大園",34,10,24
"7330","2727王品","110/07/13","永豐金-永康",0,22,-22
"7331","2727王品","110/07/13","元大-北屯",22,0,22
"7332","2727王品","110/07/13","統一-台中",2,22,-20
"7333","2727王品","110/07/13","元大-東蘆",26,7,19
"7334","2727王品","110/07/13","國泰-台中",21,39,-18
"7335","2727王品","110/07/13","永豐金-萬盛",13,1,12
"7336","2727王品","110/07/13","合庫-彰化",3,20,-17
"7337","2727王品","110/07/13","日盛-嘉義",11,0,11
"7338","2727王品","110/07/13","港商野村",13,30,-17
"7339","2727王品","110/07/13","日盛-八德",11,0,11
"7340","2727王品","110/07/13","元大-楊梅",1,16,-15
"7341","2727王品","110/07/13","統一-竹南",11,0,11
"7342","2727王品","110/07/13","凱基-高美館",2,15,-13
"7343","2727王品","110/07/13","日盛-士林",12,2,10
"7344","2727王品","110/07/13","美商高盛",2,14,-12
"7345","2727王品","110/07/13","統一-敦南",10,0,10
"7346","2727王品","110/07/13","統一-平鎮",1,13,-12
"7347","2727王品","110/07/13","中國信託",15,5,10
"7348","2727王品","110/07/13","兆豐-台中港",4,16,-12
"7349","2727王品","110/07/13","兆豐-竹北",13,3,10
"7350","2727王品","110/07/13","凱基-八德",1,13,-12
"7351","1570力肯","110/07/13","新光",115,11,104
"7352","1570力肯","110/07/13","元大-北三重",0,162,-162
"7353","1570力肯","110/07/13","群益金鼎-高雄",54,0,54
"7354","1570力肯","110/07/13","元大-大灣",0,25,-25
"7355","1570力肯","110/07/13","國票-新莊",22,0,22
"7356","1570力肯","110/07/13","永豐金-苓雅",0,22,-22
"7357","1570力肯","110/07/13","日盛-桃園",12,0,12
"7358","1570力肯","110/07/13","永豐金-永康",0,19,-19
"7359","1570力肯","110/07/13","元大-高雄",12,0,12
"7360","1570力肯","110/07/13","富邦-員林",0,15,-15
"7361","1570力肯","110/07/13","合庫-自強",11,0,11
"7362","1570力肯","110/07/13","凱基-台南",0,11,-11
"7363","1570力肯","110/07/13","摩根大通",26,15,11
"7364","1570力肯","110/07/13","日盛-竹北",0,10,-10
"7365","1570力肯","110/07/13","永豐金-中盛",11,0,11
"7366","1570力肯","110/07/13","國票-九鼎",0,10,-10
"7367","1570力肯","110/07/13","兆豐-台中港",10,0,10
"7368","1570力肯","110/07/13","凱基-桃園",0,10,-10
"7369","1570力肯","110/07/13","國泰-松江",9,0,9
"7370","1570力肯","110/07/13","凱基-新豐",0,10,-10
"7371","1570力肯","110/07/13","元大-新盛",9,0,9
"7372","1570力肯","110/07/13","元大-學甲",0,10,-10
"7373","1570力肯","110/07/13","元富-緯城",6,0,6
"7374","1570力肯","110/07/13","群益金鼎-東湖",1,10,-9
"7375","1570力肯","110/07/13","統一-三重",5,0,5
"7376","1570力肯","110/07/13","大昌",0,6,-6
"7377","1570力肯","110/07/13","元大-前金",5,0,5
"7378","1570力肯","110/07/13","元大-土城學府",0,6,-6
"7379","1570力肯","110/07/13","永豐金證券",5,0,5
"7380","1570力肯","110/07/13","統一",0,5,-5
"7381","6180橘子","110/07/13","摩根大通",119,0,119
"7382","6180橘子","110/07/13","元大-崇德",2,61,-59
"7383","6180橘子","110/07/13","美商高盛",96,0,96
"7384","6180橘子","110/07/13","康和-台中",0,51,-51
"7385","6180橘子","110/07/13","新加坡商瑞銀",86,7,79
"7386","6180橘子","110/07/13","康和-台北",0,50,-50
"7387","6180橘子","110/07/13","元大-和平",40,0,40
"7388","6180橘子","110/07/13","元富-潮州",0,40,-40
"7389","6180橘子","110/07/13","凱基-台北",83,47,36
"7390","6180橘子","110/07/13","日盛-永康",0,26,-26
"7391","6180橘子","110/07/13","美林",39,5,34
"7392","6180橘子","110/07/13","永豐金-中正",0,24,-24
"7393","6180橘子","110/07/13","富邦-新竹華信",31,2,29
"7394","6180橘子","110/07/13","國泰-板橋",2,25,-23
"7395","6180橘子","110/07/13","統一-南京",21,0,21
"7396","6180橘子","110/07/13","日盛-大墩",0,20,-20
"7397","6180橘子","110/07/13","富邦-陽明",24,3,21
"7398","6180橘子","110/07/13","元大-草屯",13,32,-19
"7399","6180橘子","110/07/13","大昌-樹林",21,1,20
"7400","6180橘子","110/07/13","元富-林園",1,18,-17
"7401","6180橘子","110/07/13","花旗環球",19,0,19
"7402","6180橘子","110/07/13","新光-新竹",1,18,-17
"7403","6180橘子","110/07/13","華南永昌-台南",19,0,19
"7404","6180橘子","110/07/13","元大-土城永寧",0,17,-17
"7405","6180橘子","110/07/13","福勝",14,0,14
"7406","6180橘子","110/07/13","國泰-新莊",3,19,-16
"7407","6180橘子","110/07/13","富邦-嘉義",12,1,11
"7408","6180橘子","110/07/13","中國信託-永康",6,21,-15
"7409","6180橘子","110/07/13","元大-板橋三民",11,0,11
"7410","6180橘子","110/07/13","凱基-東港",1,15,-14
"7411","2390云辰","110/07/13","新加坡商瑞銀",562,75,487
"7412","2390云辰","110/07/13","大展-台南",0,532,-532
"7413","2390云辰","110/07/13","台灣摩根士丹利",330,155,175
"7414","2390云辰","110/07/13","凱基-台北",668,854,-186
"7415","2390云辰","110/07/13","兆豐-公益",126,25,101
"7416","2390云辰","110/07/13","凱基-三重",12,172,-160
"7417","2390云辰","110/07/13","元富-中港",100,2,98
"7418","2390云辰","110/07/13","兆豐-忠孝",4,161,-157
"7419","2390云辰","110/07/13","統一-新台中",106,9,97
"7420","2390云辰","110/07/13","元大-士林",19,170,-151
"7421","2390云辰","110/07/13","中國信託-松江",81,11,70
"7422","2390云辰","110/07/13","臺銀-新竹",14,117,-103
"7423","2390云辰","110/07/13","日盛-板橋",72,3,69
"7424","2390云辰","110/07/13","國票-台中",4,102,-98
"7425","2390云辰","110/07/13","日盛-和美",57,0,57
"7426","2390云辰","110/07/13","新光",147,232,-85
"7427","2390云辰","110/07/13","永豐金-桃園",88,36,52
"7428","2390云辰","110/07/13","致和-崇德",2,70,-68
"7429","2390云辰","110/07/13","玉山-士林",54,4,50
"7430","2390云辰","110/07/13","群益金鼎-屏東",2,70,-68
"7431","2390云辰","110/07/13","富邦-仁愛",56,6,50
"7432","2390云辰","110/07/13","元大-大里",35,98,-63
"7433","2390云辰","110/07/13","第一金-豐原",50,1,49
"7434","2390云辰","110/07/13","元大-萬華",35,94,-59
"7435","2390云辰","110/07/13","摩根大通",502,453,49
"7436","2390云辰","110/07/13","元富-吉利",2,60,-58
"7437","2390云辰","110/07/13","凱基-松山",61,13,48
"7438","2390云辰","110/07/13","兆豐-新竹",3,53,-50
"7439","2390云辰","110/07/13","大昌",64,22,42
"7440","2390云辰","110/07/13","富邦-嘉義",65,108,-43
"7441","2363矽統","110/07/13","凱基-南崁",2133,63,2070
"7442","2363矽統","110/07/13","凱基-幸福",36,4048,-4012
"7443","2363矽統","110/07/13","國泰-敦南",2195,1617,578
"7444","2363矽統","110/07/13","統一",192,3325,-3133
"7445","2363矽統","110/07/13","中農",670,139,531
"7446","2363矽統","110/07/13","新加坡商瑞銀",1000,2747,-1747
"7447","2363矽統","110/07/13","康和-台中",638,154,484
"7448","2363矽統","110/07/13","凱基-台北",5359,6609,-1250
"7449","2363矽統","110/07/13","群益金鼎-三民",577,137,440
"7450","2363矽統","110/07/13","摩根大通",1930,2858,-928
"7451","2363矽統","110/07/13","台新-屏東",510,88,422
"7452","2363矽統","110/07/13","港商野村",960,1679,-719
"7453","2363矽統","110/07/13","德信-中正",455,67,388
"7454","2363矽統","110/07/13","兆豐-復興",25,705,-680
"7455","2363矽統","110/07/13","日盛-竹北",365,70,295
"7456","2363矽統","110/07/13","統一-仁愛",114,755,-641
"7457","2363矽統","110/07/13","元大-佳里",452,189,263
"7458","2363矽統","110/07/13","統一-敦南",29,638,-609
"7459","2363矽統","110/07/13","國票-博愛",296,38,258
"7460","2363矽統","110/07/13","統一-土城",100,704,-604
"7461","2363矽統","110/07/13","元大-萬華",340,95,245
"7462","2363矽統","110/07/13","統一-城中",116,676,-560
"7463","2363矽統","110/07/13","新光",1259,1031,228
"7464","2363矽統","110/07/13","永豐金證券",306,859,-553
"7465","2363矽統","110/07/13","元富-成功",323,96,227
"7466","2363矽統","110/07/13","元富",54,567,-513
"7467","2363矽統","110/07/13","豐農",228,23,205
"7468","2363矽統","110/07/13","瑞士信貸",202,666,-464
"7469","2363矽統","110/07/13","台灣企銀-岡山",186,4,182
"7470","2363矽統","110/07/13","永豐金-嘉義",67,468,-401
"7471","2363矽統","110/07/13","凱基-南崁",2133,63,2070
"7472","2363矽統","110/07/13","凱基-幸福",36,4048,-4012
"7473","2363矽統","110/07/13","國泰-敦南",2195,1617,578
"7474","2363矽統","110/07/13","統一",192,3325,-3133
"7475","2363矽統","110/07/13","中農",670,139,531
"7476","2363矽統","110/07/13","新加坡商瑞銀",1000,2747,-1747
"7477","2363矽統","110/07/13","康和-台中",638,154,484
"7478","2363矽統","110/07/13","凱基-台北",5359,6609,-1250
"7479","2363矽統","110/07/13","群益金鼎-三民",577,137,440
"7480","2363矽統","110/07/13","摩根大通",1930,2858,-928
"7481","2363矽統","110/07/13","台新-屏東",510,88,422
"7482","2363矽統","110/07/13","港商野村",960,1679,-719
"7483","2363矽統","110/07/13","德信-中正",455,67,388
"7484","2363矽統","110/07/13","兆豐-復興",25,705,-680
"7485","2363矽統","110/07/13","日盛-竹北",365,70,295
"7486","2363矽統","110/07/13","統一-仁愛",114,755,-641
"7487","2363矽統","110/07/13","元大-佳里",452,189,263
"7488","2363矽統","110/07/13","統一-敦南",29,638,-609
"7489","2363矽統","110/07/13","國票-博愛",296,38,258
"7490","2363矽統","110/07/13","統一-土城",100,704,-604
"7491","2363矽統","110/07/13","元大-萬華",340,95,245
"7492","2363矽統","110/07/13","統一-城中",116,676,-560
"7493","2363矽統","110/07/13","新光",1259,1031,228
"7494","2363矽統","110/07/13","永豐金證券",306,859,-553
"7495","2363矽統","110/07/13","元富-成功",323,96,227
"7496","2363矽統","110/07/13","元富",54,567,-513
"7497","2363矽統","110/07/13","豐農",228,23,205
"7498","2363矽統","110/07/13","瑞士信貸",202,666,-464
"7499","2363矽統","110/07/13","台灣企銀-岡山",186,4,182
"7500","2363矽統","110/07/13","永豐金-嘉義",67,468,-401
"7501","2363矽統","110/07/13","凱基-南崁",2133,63,2070
"7502","2363矽統","110/07/13","凱基-幸福",36,4048,-4012
"7503","2363矽統","110/07/13","國泰-敦南",2195,1617,578
"7504","2363矽統","110/07/13","統一",192,3325,-3133
"7505","2363矽統","110/07/13","中農",670,139,531
"7506","2363矽統","110/07/13","新加坡商瑞銀",1000,2747,-1747
"7507","2363矽統","110/07/13","康和-台中",638,154,484
"7508","2363矽統","110/07/13","凱基-台北",5359,6609,-1250
"7509","2363矽統","110/07/13","群益金鼎-三民",577,137,440
"7510","2363矽統","110/07/13","摩根大通",1930,2858,-928
"7511","2363矽統","110/07/13","台新-屏東",510,88,422
"7512","2363矽統","110/07/13","港商野村",960,1679,-719
"7513","2363矽統","110/07/13","德信-中正",455,67,388
"7514","2363矽統","110/07/13","兆豐-復興",25,705,-680
"7515","2363矽統","110/07/13","日盛-竹北",365,70,295
"7516","2363矽統","110/07/13","統一-仁愛",114,755,-641
"7517","2363矽統","110/07/13","元大-佳里",452,189,263
"7518","2363矽統","110/07/13","統一-敦南",29,638,-609
"7519","2363矽統","110/07/13","國票-博愛",296,38,258
"7520","2363矽統","110/07/13","統一-土城",100,704,-604
"7521","2363矽統","110/07/13","元大-萬華",340,95,245
"7522","2363矽統","110/07/13","統一-城中",116,676,-560
"7523","2363矽統","110/07/13","新光",1259,1031,228
"7524","2363矽統","110/07/13","永豐金證券",306,859,-553
"7525","2363矽統","110/07/13","元富-成功",323,96,227
"7526","2363矽統","110/07/13","元富",54,567,-513
"7527","2363矽統","110/07/13","豐農",228,23,205
"7528","2363矽統","110/07/13","瑞士信貸",202,666,-464
"7529","2363矽統","110/07/13","台灣企銀-岡山",186,4,182
"7530","2363矽統","110/07/13","永豐金-嘉義",67,468,-401
"7531","1570力肯","110/07/13","新光",115,11,104
"7532","1570力肯","110/07/13","元大-北三重",0,162,-162
"7533","1570力肯","110/07/13","群益金鼎-高雄",54,0,54
"7534","1570力肯","110/07/13","元大-大灣",0,25,-25
"7535","1570力肯","110/07/13","國票-新莊",22,0,22
"7536","1570力肯","110/07/13","永豐金-苓雅",0,22,-22
"7537","1570力肯","110/07/13","日盛-桃園",12,0,12
"7538","1570力肯","110/07/13","永豐金-永康",0,19,-19
"7539","1570力肯","110/07/13","元大-高雄",12,0,12
"7540","1570力肯","110/07/13","富邦-員林",0,15,-15
"7541","1570力肯","110/07/13","合庫-自強",11,0,11
"7542","1570力肯","110/07/13","凱基-台南",0,11,-11
"7543","1570力肯","110/07/13","摩根大通",26,15,11
"7544","1570力肯","110/07/13","日盛-竹北",0,10,-10
"7545","1570力肯","110/07/13","永豐金-中盛",11,0,11
"7546","1570力肯","110/07/13","國票-九鼎",0,10,-10
"7547","1570力肯","110/07/13","兆豐-台中港",10,0,10
"7548","1570力肯","110/07/13","凱基-桃園",0,10,-10
"7549","1570力肯","110/07/13","國泰-松江",9,0,9
"7550","1570力肯","110/07/13","凱基-新豐",0,10,-10
"7551","1570力肯","110/07/13","元大-新盛",9,0,9
"7552","1570力肯","110/07/13","元大-學甲",0,10,-10
"7553","1570力肯","110/07/13","元富-緯城",6,0,6
"7554","1570力肯","110/07/13","群益金鼎-東湖",1,10,-9
"7555","1570力肯","110/07/13","統一-三重",5,0,5
"7556","1570力肯","110/07/13","大昌",0,6,-6
"7557","1570力肯","110/07/13","元大-前金",5,0,5
"7558","1570力肯","110/07/13","元大-土城學府",0,6,-6
"7559","1570力肯","110/07/13","永豐金證券",5,0,5
"7560","1570力肯","110/07/13","統一",0,5,-5
"7561","1570力肯","110/07/13","新光",115,11,104
"7562","1570力肯","110/07/13","元大-北三重",0,162,-162
"7563","1570力肯","110/07/13","群益金鼎-高雄",54,0,54
"7564","1570力肯","110/07/13","元大-大灣",0,25,-25
"7565","1570力肯","110/07/13","國票-新莊",22,0,22
"7566","1570力肯","110/07/13","永豐金-苓雅",0,22,-22
"7567","1570力肯","110/07/13","日盛-桃園",12,0,12
"7568","1570力肯","110/07/13","永豐金-永康",0,19,-19
"7569","1570力肯","110/07/13","元大-高雄",12,0,12
"7570","1570力肯","110/07/13","富邦-員林",0,15,-15
"7571","1570力肯","110/07/13","合庫-自強",11,0,11
"7572","1570力肯","110/07/13","凱基-台南",0,11,-11
"7573","1570力肯","110/07/13","摩根大通",26,15,11
"7574","1570力肯","110/07/13","日盛-竹北",0,10,-10
"7575","1570力肯","110/07/13","永豐金-中盛",11,0,11
"7576","1570力肯","110/07/13","國票-九鼎",0,10,-10
"7577","1570力肯","110/07/13","兆豐-台中港",10,0,10
"7578","1570力肯","110/07/13","凱基-桃園",0,10,-10
"7579","1570力肯","110/07/13","國泰-松江",9,0,9
"7580","1570力肯","110/07/13","凱基-新豐",0,10,-10
"7581","1570力肯","110/07/13","元大-新盛",9,0,9
"7582","1570力肯","110/07/13","元大-學甲",0,10,-10
"7583","1570力肯","110/07/13","元富-緯城",6,0,6
"7584","1570力肯","110/07/13","群益金鼎-東湖",1,10,-9
"7585","1570力肯","110/07/13","統一-三重",5,0,5
"7586","1570力肯","110/07/13","大昌",0,6,-6
"7587","1570力肯","110/07/13","元大-前金",5,0,5
"7588","1570力肯","110/07/13","元大-土城學府",0,6,-6
"7589","1570力肯","110/07/13","永豐金證券",5,0,5
"7590","1570力肯","110/07/13","統一",0,5,-5
"7591","6180橘子","110/07/13","摩根大通",119,0,119
"7592","6180橘子","110/07/13","元大-崇德",2,61,-59
"7593","6180橘子","110/07/13","美商高盛",96,0,96
"7594","6180橘子","110/07/13","康和-台中",0,51,-51
"7595","6180橘子","110/07/13","新加坡商瑞銀",86,7,79
"7596","6180橘子","110/07/13","康和-台北",0,50,-50
"7597","6180橘子","110/07/13","元大-和平",40,0,40
"7598","6180橘子","110/07/13","元富-潮州",0,40,-40
"7599","6180橘子","110/07/13","凱基-台北",83,47,36
"7600","6180橘子","110/07/13","日盛-永康",0,26,-26
"7601","6180橘子","110/07/13","美林",39,5,34
"7602","6180橘子","110/07/13","永豐金-中正",0,24,-24
"7603","6180橘子","110/07/13","富邦-新竹華信",31,2,29
"7604","6180橘子","110/07/13","國泰-板橋",2,25,-23
"7605","6180橘子","110/07/13","統一-南京",21,0,21
"7606","6180橘子","110/07/13","日盛-大墩",0,20,-20
"7607","6180橘子","110/07/13","富邦-陽明",24,3,21
"7608","6180橘子","110/07/13","元大-草屯",13,32,-19
"7609","6180橘子","110/07/13","大昌-樹林",21,1,20
"7610","6180橘子","110/07/13","元富-林園",1,18,-17
"7611","6180橘子","110/07/13","花旗環球",19,0,19
"7612","6180橘子","110/07/13","新光-新竹",1,18,-17
"7613","6180橘子","110/07/13","華南永昌-台南",19,0,19
"7614","6180橘子","110/07/13","元大-土城永寧",0,17,-17
"7615","6180橘子","110/07/13","福勝",14,0,14
"7616","6180橘子","110/07/13","國泰-新莊",3,19,-16
"7617","6180橘子","110/07/13","富邦-嘉義",12,1,11
"7618","6180橘子","110/07/13","中國信託-永康",6,21,-15
"7619","6180橘子","110/07/13","元大-板橋三民",11,0,11
"7620","6180橘子","110/07/13","凱基-東港",1,15,-14
"7621","1570力肯","110/07/13","新光",115,11,104
"7622","1570力肯","110/07/13","元大-北三重",0,162,-162
"7623","1570力肯","110/07/13","群益金鼎-高雄",54,0,54
"7624","1570力肯","110/07/13","元大-大灣",0,25,-25
"7625","1570力肯","110/07/13","國票-新莊",22,0,22
"7626","1570力肯","110/07/13","永豐金-苓雅",0,22,-22
"7627","1570力肯","110/07/13","日盛-桃園",12,0,12
"7628","1570力肯","110/07/13","永豐金-永康",0,19,-19
"7629","1570力肯","110/07/13","元大-高雄",12,0,12
"7630","1570力肯","110/07/13","富邦-員林",0,15,-15
"7631","1570力肯","110/07/13","合庫-自強",11,0,11
"7632","1570力肯","110/07/13","凱基-台南",0,11,-11
"7633","1570力肯","110/07/13","摩根大通",26,15,11
"7634","1570力肯","110/07/13","日盛-竹北",0,10,-10
"7635","1570力肯","110/07/13","永豐金-中盛",11,0,11
"7636","1570力肯","110/07/13","國票-九鼎",0,10,-10
"7637","1570力肯","110/07/13","兆豐-台中港",10,0,10
"7638","1570力肯","110/07/13","凱基-桃園",0,10,-10
"7639","1570力肯","110/07/13","國泰-松江",9,0,9
"7640","1570力肯","110/07/13","凱基-新豐",0,10,-10
"7641","1570力肯","110/07/13","元大-新盛",9,0,9
"7642","1570力肯","110/07/13","元大-學甲",0,10,-10
"7643","1570力肯","110/07/13","元富-緯城",6,0,6
"7644","1570力肯","110/07/13","群益金鼎-東湖",1,10,-9
"7645","1570力肯","110/07/13","統一-三重",5,0,5
"7646","1570力肯","110/07/13","大昌",0,6,-6
"7647","1570力肯","110/07/13","元大-前金",5,0,5
"7648","1570力肯","110/07/13","元大-土城學府",0,6,-6
"7649","1570力肯","110/07/13","永豐金證券",5,0,5
"7650","1570力肯","110/07/13","統一",0,5,-5
"7651","6180橘子","110/07/13","摩根大通",119,0,119
"7652","6180橘子","110/07/13","元大-崇德",2,61,-59
"7653","6180橘子","110/07/13","美商高盛",96,0,96
"7654","6180橘子","110/07/13","康和-台中",0,51,-51
"7655","6180橘子","110/07/13","新加坡商瑞銀",86,7,79
"7656","6180橘子","110/07/13","康和-台北",0,50,-50
"7657","6180橘子","110/07/13","元大-和平",40,0,40
"7658","6180橘子","110/07/13","元富-潮州",0,40,-40
"7659","6180橘子","110/07/13","凱基-台北",83,47,36
"7660","6180橘子","110/07/13","日盛-永康",0,26,-26
"7661","6180橘子","110/07/13","美林",39,5,34
"7662","6180橘子","110/07/13","永豐金-中正",0,24,-24
"7663","6180橘子","110/07/13","富邦-新竹華信",31,2,29
"7664","6180橘子","110/07/13","國泰-板橋",2,25,-23
"7665","6180橘子","110/07/13","統一-南京",21,0,21
"7666","6180橘子","110/07/13","日盛-大墩",0,20,-20
"7667","6180橘子","110/07/13","富邦-陽明",24,3,21
"7668","6180橘子","110/07/13","元大-草屯",13,32,-19
"7669","6180橘子","110/07/13","大昌-樹林",21,1,20
"7670","6180橘子","110/07/13","元富-林園",1,18,-17
"7671","6180橘子","110/07/13","花旗環球",19,0,19
"7672","6180橘子","110/07/13","新光-新竹",1,18,-17
"7673","6180橘子","110/07/13","華南永昌-台南",19,0,19
"7674","6180橘子","110/07/13","元大-土城永寧",0,17,-17
"7675","6180橘子","110/07/13","福勝",14,0,14
"7676","6180橘子","110/07/13","國泰-新莊",3,19,-16
"7677","6180橘子","110/07/13","富邦-嘉義",12,1,11
"7678","6180橘子","110/07/13","中國信託-永康",6,21,-15
"7679","6180橘子","110/07/13","元大-板橋三民",11,0,11
"7680","6180橘子","110/07/13","凱基-東港",1,15,-14
"7681","2390云辰","110/07/13","新加坡商瑞銀",562,75,487
"7682","2390云辰","110/07/13","大展-台南",0,532,-532
"7683","2390云辰","110/07/13","台灣摩根士丹利",330,155,175
"7684","2390云辰","110/07/13","凱基-台北",668,854,-186
"7685","2390云辰","110/07/13","兆豐-公益",126,25,101
"7686","2390云辰","110/07/13","凱基-三重",12,172,-160
"7687","2390云辰","110/07/13","元富-中港",100,2,98
"7688","2390云辰","110/07/13","兆豐-忠孝",4,161,-157
"7689","2390云辰","110/07/13","統一-新台中",106,9,97
"7690","2390云辰","110/07/13","元大-士林",19,170,-151
"7691","2390云辰","110/07/13","中國信託-松江",81,11,70
"7692","2390云辰","110/07/13","臺銀-新竹",14,117,-103
"7693","2390云辰","110/07/13","日盛-板橋",72,3,69
"7694","2390云辰","110/07/13","國票-台中",4,102,-98
"7695","2390云辰","110/07/13","日盛-和美",57,0,57
"7696","2390云辰","110/07/13","新光",147,232,-85
"7697","2390云辰","110/07/13","永豐金-桃園",88,36,52
"7698","2390云辰","110/07/13","致和-崇德",2,70,-68
"7699","2390云辰","110/07/13","玉山-士林",54,4,50
"7700","2390云辰","110/07/13","群益金鼎-屏東",2,70,-68
"7701","2390云辰","110/07/13","富邦-仁愛",56,6,50
"7702","2390云辰","110/07/13","元大-大里",35,98,-63
"7703","2390云辰","110/07/13","第一金-豐原",50,1,49
"7704","2390云辰","110/07/13","元大-萬華",35,94,-59
"7705","2390云辰","110/07/13","摩根大通",502,453,49
"7706","2390云辰","110/07/13","元富-吉利",2,60,-58
"7707","2390云辰","110/07/13","凱基-松山",61,13,48
"7708","2390云辰","110/07/13","兆豐-新竹",3,53,-50
"7709","2390云辰","110/07/13","大昌",64,22,42
"7710","2390云辰","110/07/13","富邦-嘉義",65,108,-43
"7711","2363矽統","110/07/13","凱基-南崁",2133,63,2070
"7712","2363矽統","110/07/13","凱基-幸福",36,4048,-4012
"7713","2363矽統","110/07/13","國泰-敦南",2195,1617,578
"7714","2363矽統","110/07/13","統一",192,3325,-3133
"7715","2363矽統","110/07/13","中農",670,139,531
"7716","2363矽統","110/07/13","新加坡商瑞銀",1000,2747,-1747
"7717","2363矽統","110/07/13","康和-台中",638,154,484
"7718","2363矽統","110/07/13","凱基-台北",5359,6609,-1250
"7719","2363矽統","110/07/13","群益金鼎-三民",577,137,440
"7720","2363矽統","110/07/13","摩根大通",1930,2858,-928
"7721","2363矽統","110/07/13","台新-屏東",510,88,422
"7722","2363矽統","110/07/13","港商野村",960,1679,-719
"7723","2363矽統","110/07/13","德信-中正",455,67,388
"7724","2363矽統","110/07/13","兆豐-復興",25,705,-680
"7725","2363矽統","110/07/13","日盛-竹北",365,70,295
"7726","2363矽統","110/07/13","統一-仁愛",114,755,-641
"7727","2363矽統","110/07/13","元大-佳里",452,189,263
"7728","2363矽統","110/07/13","統一-敦南",29,638,-609
"7729","2363矽統","110/07/13","國票-博愛",296,38,258
"7730","2363矽統","110/07/13","統一-土城",100,704,-604
"7731","2363矽統","110/07/13","元大-萬華",340,95,245
"7732","2363矽統","110/07/13","統一-城中",116,676,-560
"7733","2363矽統","110/07/13","新光",1259,1031,228
"7734","2363矽統","110/07/13","永豐金證券",306,859,-553
"7735","2363矽統","110/07/13","元富-成功",323,96,227
"7736","2363矽統","110/07/13","元富",54,567,-513
"7737","2363矽統","110/07/13","豐農",228,23,205
"7738","2363矽統","110/07/13","瑞士信貸",202,666,-464
"7739","2363矽統","110/07/13","台灣企銀-岡山",186,4,182
"7740","2363矽統","110/07/13","永豐金-嘉義",67,468,-401
"7741","8112至上","110/07/13","摩根大通",688,296,392
"7742","8112至上","110/07/13","國票-中和",0,401,-401
"7743","8112至上","110/07/13","港商野村",344,145,199
"7744","8112至上","110/07/13","永豐金-板盛",0,205,-205
"7745","8112至上","110/07/13","兆豐-公益",195,5,190
"7746","8112至上","110/07/13","凱基-五股",43,155,-112
"7747","8112至上","110/07/13","台灣摩根士丹利",183,0,183
"7748","8112至上","110/07/13","凱基-市政",0,100,-100
"7749","8112至上","110/07/13","群益金鼎-敦南",153,2,151
"7750","8112至上","110/07/13","元大-大里德芳",1,92,-91
"7751","8112至上","110/07/13","臺銀-金山",146,26,120
"7752","8112至上","110/07/13","玉山-桃園",26,110,-84
"7753","8112至上","110/07/13","臺銀",133,19,114
"7754","8112至上","110/07/13","兆豐-天母",0,81,-81
"7755","8112至上","110/07/13","合庫-台中",115,6,109
"7756","8112至上","110/07/13","凱基-城中",3,84,-81
"7757","8112至上","110/07/13","亞東-板橋",134,26,108
"7758","8112至上","110/07/13","日盛-新莊",9,85,-76
"7759","8112至上","110/07/13","凱基-台北",414,326,88
"7760","8112至上","110/07/13","日盛-台中",2,64,-62
"7761","8112至上","110/07/13","新加坡商瑞銀",181,100,81
"7762","8112至上","110/07/13","日盛-中壢",3,64,-61
"7763","8112至上","110/07/13","國泰-敦南",108,31,77
"7764","8112至上","110/07/13","元大-台中",2,59,-57
"7765","8112至上","110/07/13","第一金-華江",77,4,73
"7766","8112至上","110/07/13","元大-雙和",7,64,-57
"7767","8112至上","110/07/13","永豐金-內湖",73,1,72
"7768","8112至上","110/07/13","元大-高雄",8,62,-54
"7769","8112至上","110/07/13","元大-永和",68,1,67
"7770","8112至上","110/07/13","元大-館前",2,55,-53
"7771","2929淘帝","110/07/13","玉山-新竹",130,0,130
"7772","2929淘帝","110/07/13","美商高盛",0,177,-177
"7773","2929淘帝","110/07/13","臺銀-民權",60,0,60
"7774","2929淘帝","110/07/13","凱基-台北",6,80,-74
"7775","2929淘帝","110/07/13","新百王",31,0,31
"7776","2929淘帝","110/07/13","元富-大裕",0,49,-49
"7777","2929淘帝","110/07/13","日盛-園區",30,0,30
"7778","2929淘帝","110/07/13","國泰-館前",3,51,-48
"7779","2929淘帝","110/07/13","元大-南投",31,1,30
"7780","2929淘帝","110/07/13","凱基-中壢",0,41,-41
"7781","2929淘帝","110/07/13","兆豐-忠孝",28,0,28
"7782","2929淘帝","110/07/13","港商野村",21,55,-34
"7783","2929淘帝","110/07/13","元大-民生",28,0,28
"7784","2929淘帝","110/07/13","華南永昌-南京",2,34,-32
"7785","2929淘帝","110/07/13","合庫-高雄",27,0,27
"7786","2929淘帝","110/07/13","群益金鼎-土城",0,30,-30
"7787","2929淘帝","110/07/13","凱基-豐中",27,0,27
"7788","2929淘帝","110/07/13","富邦-南屯",0,22,-22
"7789","2929淘帝","110/07/13","新光",21,4,17
"7790","2929淘帝","110/07/13","第一金-豐原",0,20,-20
"7791","2929淘帝","110/07/13","元大-天母",17,0,17
"7792","2929淘帝","110/07/13","元大-屏南",6,26,-20
"7793","2929淘帝","110/07/13","永興",14,0,14
"7794","2929淘帝","110/07/13","永豐金-敦南",1,21,-20
"7795","2929淘帝","110/07/13","富邦-台北",12,0,12
"7796","2929淘帝","110/07/13","凱基-三重",2,21,-19
"7797","2929淘帝","110/07/13","元大-永和",12,0,12
"7798","2929淘帝","110/07/13","富邦-仁愛",7,25,-18
"7799","2929淘帝","110/07/13","國票-天祥",11,0,11
"7800","2929淘帝","110/07/13","元大-北投",0,16,-16
"7801","2841台開","110/07/13","中國信託-高雄",251,50,201
"7802","2841台開","110/07/13","兆豐-公益",0,177,-177
"7803","2841台開","110/07/13","日盛證券",210,13,197
"7804","2841台開","110/07/13","日進",0,152,-152
"7805","2841台開","110/07/13","第一金-台中",55,0,55
"7806","2841台開","110/07/13","港商野村",0,109,-109
"7807","2841台開","110/07/13","國泰-板橋",46,0,46
"7808","2841台開","110/07/13","日盛-信義",0,103,-103
"7809","2841台開","110/07/13","國泰-館前",48,3,45
"7810","2841台開","110/07/13","國泰-敦南",11,75,-64
"7811","2841台開","110/07/13","華南永昌-新莊",45,0,45
"7812","2841台開","110/07/13","永興",0,50,-50
"7813","2841台開","110/07/13","日盛-園區",42,0,42
"7814","2841台開","110/07/13","永豐金-敦南",61,104,-43
"7815","2841台開","110/07/13","台新證券",32,0,32
"7816","2841台開","110/07/13","富邦-台南",0,42,-42
"7817","2841台開","110/07/13","台新-高雄",32,2,30
"7818","2841台開","110/07/13","國票-安和",0,30,-30
"7819","2841台開","110/07/13","豐農",23,0,23
"7820","2841台開","110/07/13","元大-桃園",0,25,-25
"7821","2841台開","110/07/13","合庫-嘉義",20,0,20
"7822","2841台開","110/07/13","新光",8,32,-24
"7823","2841台開","110/07/13","華南永昌-高雄",20,0,20
"7824","2841台開","110/07/13","元大-仁愛",0,24,-24
"7825","2841台開","110/07/13","元大-樹林",16,0,16
"7826","2841台開","110/07/13","日盛-中和",0,20,-20
"7827","2841台開","110/07/13","第一金-華江",15,2,13
"7828","2841台開","110/07/13","元富",0,20,-20
"7829","2841台開","110/07/13","美商高盛",12,0,12
"7830","2841台開","110/07/13","富邦-宜蘭",0,20,-20
"7831","6207雷科","110/07/13","元大-高雄",121,0,121
"7832","6207雷科","110/07/13","華南永昌-朴子",1,60,-59
"7833","6207雷科","110/07/13","第一金-新興",20,0,20
"7834","6207雷科","110/07/13","元大-南海",0,36,-36
"7835","6207雷科","110/07/13","元富-三重",20,0,20
"7836","6207雷科","110/07/13","凱基-土城",0,35,-35
"7837","6207雷科","110/07/13","元大-林園",15,0,15
"7838","6207雷科","110/07/13","台灣企銀",0,20,-20
"7839","6207雷科","110/07/13","元大-金華",16,1,15
"7840","6207雷科","110/07/13","群益金鼎-丹鳳",0,20,-20
"7841","6207雷科","110/07/13","日盛證券",10,0,10
"7842","6207雷科","110/07/13","元大-博愛",0,17,-17
"7843","6207雷科","110/07/13","統一-台中",10,0,10
"7844","6207雷科","110/07/13","元大-北港",0,13,-13
"7845","6207雷科","110/07/13","群益金鼎-土城",10,0,10
"7846","6207雷科","110/07/13","新加坡商瑞銀",0,12,-12
"7847","6207雷科","110/07/13","群益金鼎-桃園",10,0,10
"7848","6207雷科","110/07/13","凱基-台北",4,16,-12
"7849","6207雷科","110/07/13","永豐金-新莊",10,0,10
"7850","6207雷科","110/07/13","日茂-埔里",0,11,-11
"7851","6207雷科","110/07/13","永豐金-新店",10,0,10
"7852","6207雷科","110/07/13","元大-莒光",0,11,-11
"7853","6207雷科","110/07/13","元大證券",9,0,9
"7854","6207雷科","110/07/13","統一-新竹",0,10,-10
"7855","6207雷科","110/07/13","日盛-木柵",9,1,8
"7856","6207雷科","110/07/13","元大-西螺",0,10,-10
"7857","6207雷科","110/07/13","兆豐-來福",8,0,8
"7858","6207雷科","110/07/13","康和-台中",0,8,-8
"7859","6207雷科","110/07/13","新光",7,0,7
"7860","6207雷科","110/07/13","兆豐-高雄",0,6,-6
"7861","3679新至陞","110/07/13","永豐金證券",50,0,50
"7862","3679新至陞","110/07/13","摩根大通",2,25,-23
"7863","3679新至陞","110/07/13","國泰-桃園",22,0,22
"7864","3679新至陞","110/07/13","元大-成功",0,22,-22
"7865","3679新至陞","110/07/13","台中銀-員林",11,0,11
"7866","3679新至陞","110/07/13","富邦-板橋",1,19,-18
"7867","3679新至陞","110/07/13","元大-文心興安",8,0,8
"7868","3679新至陞","110/07/13","日盛-新莊",0,10,-10
"7869","3679新至陞","110/07/13","美商高盛",6,0,6
"7870","3679新至陞","110/07/13","台新-台中",0,10,-10
"7871","3679新至陞","110/07/13","台新-高雄",6,0,6
"7872","3679新至陞","110/07/13","永豐金-新竹",0,8,-8
"7873","3679新至陞","110/07/13","凱基-台北",18,12,6
"7874","3679新至陞","110/07/13","瑞士信貸",12,19,-7
"7875","3679新至陞","110/07/13","日盛-復興",5,0,5
"7876","3679新至陞","110/07/13","統一-南京",0,7,-7
"7877","3679新至陞","110/07/13","(牛牛牛)亞-鑫豐",4,0,4
"7878","3679新至陞","110/07/13","凱基-新莊",0,7,-7
"7879","3679新至陞","110/07/13","元富-大昌",3,0,3
"7880","3679新至陞","110/07/13","新加坡商瑞銀",0,6,-6
"7881","3679新至陞","110/07/13","富邦-台北",3,0,3
"7882","3679新至陞","110/07/13","合庫-自強",0,5,-5
"7883","3679新至陞","110/07/13","日盛-樹林",2,0,2
"7884","3679新至陞","110/07/13","富邦-桃園",0,5,-5
"7885","3679新至陞","110/07/13","宏遠-光隆",2,0,2
"7886","3679新至陞","110/07/13","永豐金-潮州",0,4,-4
"7887","3679新至陞","110/07/13","美林",3,1,2
"7888","3679新至陞","110/07/13","臺銀-臺南",0,3,-3
"7889","3679新至陞","110/07/13","第一金-中壢",2,0,2
"7890","3679新至陞","110/07/13","元大-六合",0,3,-3
"7891","2727王品","110/07/13","富邦-台北",43,3,40
"7892","2727王品","110/07/13","台灣摩根士丹利",15,97,-82
"7893","2727王品","110/07/13","元大-基隆孝二",40,0,40
"7894","2727王品","110/07/13","玉山-台南",5,57,-52
"7895","2727王品","110/07/13","國票-新莊",40,1,39
"7896","2727王品","110/07/13","新加坡商瑞銀",0,48,-48
"7897","2727王品","110/07/13","第一金-豐原",66,42,24
"7898","2727王品","110/07/13","凱基-台北",41,77,-36
"7899","2727王品","110/07/13","永豐金-大園",34,10,24
"7900","2727王品","110/07/13","永豐金-永康",0,22,-22
"7901","2727王品","110/07/13","元大-北屯",22,0,22
"7902","2727王品","110/07/13","統一-台中",2,22,-20
"7903","2727王品","110/07/13","元大-東蘆",26,7,19
"7904","2727王品","110/07/13","國泰-台中",21,39,-18
"7905","2727王品","110/07/13","永豐金-萬盛",13,1,12
"7906","2727王品","110/07/13","合庫-彰化",3,20,-17
"7907","2727王品","110/07/13","日盛-嘉義",11,0,11
"7908","2727王品","110/07/13","港商野村",13,30,-17
"7909","2727王品","110/07/13","日盛-八德",11,0,11
"7910","2727王品","110/07/13","元大-楊梅",1,16,-15
"7911","2727王品","110/07/13","統一-竹南",11,0,11
"7912","2727王品","110/07/13","凱基-高美館",2,15,-13
"7913","2727王品","110/07/13","日盛-士林",12,2,10
"7914","2727王品","110/07/13","美商高盛",2,14,-12
"7915","2727王品","110/07/13","統一-敦南",10,0,10
"7916","2727王品","110/07/13","統一-平鎮",1,13,-12
"7917","2727王品","110/07/13","中國信託",15,5,10
"7918","2727王品","110/07/13","兆豐-台中港",4,16,-12
"7919","2727王品","110/07/13","兆豐-竹北",13,3,10
"7920","2727王品","110/07/13","凱基-八德",1,13,-12
"7921","1570力肯","110/07/13","新光",115,11,104
"7922","1570力肯","110/07/13","元大-北三重",0,162,-162
"7923","1570力肯","110/07/13","群益金鼎-高雄",54,0,54
"7924","1570力肯","110/07/13","元大-大灣",0,25,-25
"7925","1570力肯","110/07/13","國票-新莊",22,0,22
"7926","1570力肯","110/07/13","永豐金-苓雅",0,22,-22
"7927","1570力肯","110/07/13","日盛-桃園",12,0,12
"7928","1570力肯","110/07/13","永豐金-永康",0,19,-19
"7929","1570力肯","110/07/13","元大-高雄",12,0,12
"7930","1570力肯","110/07/13","富邦-員林",0,15,-15
"7931","1570力肯","110/07/13","合庫-自強",11,0,11
"7932","1570力肯","110/07/13","凱基-台南",0,11,-11
"7933","1570力肯","110/07/13","摩根大通",26,15,11
"7934","1570力肯","110/07/13","日盛-竹北",0,10,-10
"7935","1570力肯","110/07/13","永豐金-中盛",11,0,11
"7936","1570力肯","110/07/13","國票-九鼎",0,10,-10
"7937","1570力肯","110/07/13","兆豐-台中港",10,0,10
"7938","1570力肯","110/07/13","凱基-桃園",0,10,-10
"7939","1570力肯","110/07/13","國泰-松江",9,0,9
"7940","1570力肯","110/07/13","凱基-新豐",0,10,-10
"7941","1570力肯","110/07/13","元大-新盛",9,0,9
"7942","1570力肯","110/07/13","元大-學甲",0,10,-10
"7943","1570力肯","110/07/13","元富-緯城",6,0,6
"7944","1570力肯","110/07/13","群益金鼎-東湖",1,10,-9
"7945","1570力肯","110/07/13","統一-三重",5,0,5
"7946","1570力肯","110/07/13","大昌",0,6,-6
"7947","1570力肯","110/07/13","元大-前金",5,0,5
"7948","1570力肯","110/07/13","元大-土城學府",0,6,-6
"7949","1570力肯","110/07/13","永豐金證券",5,0,5
"7950","1570力肯","110/07/13","統一",0,5,-5
"7951","6180橘子","110/07/13","摩根大通",119,0,119
"7952","6180橘子","110/07/13","元大-崇德",2,61,-59
"7953","6180橘子","110/07/13","美商高盛",96,0,96
"7954","6180橘子","110/07/13","康和-台中",0,51,-51
"7955","6180橘子","110/07/13","新加坡商瑞銀",86,7,79
"7956","6180橘子","110/07/13","康和-台北",0,50,-50
"7957","6180橘子","110/07/13","元大-和平",40,0,40
"7958","6180橘子","110/07/13","元富-潮州",0,40,-40
"7959","6180橘子","110/07/13","凱基-台北",83,47,36
"7960","6180橘子","110/07/13","日盛-永康",0,26,-26
"7961","6180橘子","110/07/13","美林",39,5,34
"7962","6180橘子","110/07/13","永豐金-中正",0,24,-24
"7963","6180橘子","110/07/13","富邦-新竹華信",31,2,29
"7964","6180橘子","110/07/13","國泰-板橋",2,25,-23
"7965","6180橘子","110/07/13","統一-南京",21,0,21
"7966","6180橘子","110/07/13","日盛-大墩",0,20,-20
"7967","6180橘子","110/07/13","富邦-陽明",24,3,21
"7968","6180橘子","110/07/13","元大-草屯",13,32,-19
"7969","6180橘子","110/07/13","大昌-樹林",21,1,20
"7970","6180橘子","110/07/13","元富-林園",1,18,-17
"7971","6180橘子","110/07/13","花旗環球",19,0,19
"7972","6180橘子","110/07/13","新光-新竹",1,18,-17
"7973","6180橘子","110/07/13","華南永昌-台南",19,0,19
"7974","6180橘子","110/07/13","元大-土城永寧",0,17,-17
"7975","6180橘子","110/07/13","福勝",14,0,14
"7976","6180橘子","110/07/13","國泰-新莊",3,19,-16
"7977","6180橘子","110/07/13","富邦-嘉義",12,1,11
"7978","6180橘子","110/07/13","中國信託-永康",6,21,-15
"7979","6180橘子","110/07/13","元大-板橋三民",11,0,11
"7980","6180橘子","110/07/13","凱基-東港",1,15,-14
"7981","2390云辰","110/07/13","新加坡商瑞銀",562,75,487
"7982","2390云辰","110/07/13","大展-台南",0,532,-532
"7983","2390云辰","110/07/13","台灣摩根士丹利",330,155,175
"7984","2390云辰","110/07/13","凱基-台北",668,854,-186
"7985","2390云辰","110/07/13","兆豐-公益",126,25,101
"7986","2390云辰","110/07/13","凱基-三重",12,172,-160
"7987","2390云辰","110/07/13","元富-中港",100,2,98
"7988","2390云辰","110/07/13","兆豐-忠孝",4,161,-157
"7989","2390云辰","110/07/13","統一-新台中",106,9,97
"7990","2390云辰","110/07/13","元大-士林",19,170,-151
"7991","2390云辰","110/07/13","中國信託-松江",81,11,70
"7992","2390云辰","110/07/13","臺銀-新竹",14,117,-103
"7993","2390云辰","110/07/13","日盛-板橋",72,3,69
"7994","2390云辰","110/07/13","國票-台中",4,102,-98
"7995","2390云辰","110/07/13","日盛-和美",57,0,57
"7996","2390云辰","110/07/13","新光",147,232,-85
"7997","2390云辰","110/07/13","永豐金-桃園",88,36,52
"7998","2390云辰","110/07/13","致和-崇德",2,70,-68
"7999","2390云辰","110/07/13","玉山-士林",54,4,50
"8000","2390云辰","110/07/13","群益金鼎-屏東",2,70,-68
"8001","2390云辰","110/07/13","富邦-仁愛",56,6,50
"8002","2390云辰","110/07/13","元大-大里",35,98,-63
"8003","2390云辰","110/07/13","第一金-豐原",50,1,49
"8004","2390云辰","110/07/13","元大-萬華",35,94,-59
"8005","2390云辰","110/07/13","摩根大通",502,453,49
"8006","2390云辰","110/07/13","元富-吉利",2,60,-58
"8007","2390云辰","110/07/13","凱基-松山",61,13,48
"8008","2390云辰","110/07/13","兆豐-新竹",3,53,-50
"8009","2390云辰","110/07/13","大昌",64,22,42
"8010","2390云辰","110/07/13","富邦-嘉義",65,108,-43
"8011","2363矽統","110/07/13","凱基-南崁",2133,63,2070
"8012","2363矽統","110/07/13","凱基-幸福",36,4048,-4012
"8013","2363矽統","110/07/13","國泰-敦南",2195,1617,578
"8014","2363矽統","110/07/13","統一",192,3325,-3133
"8015","2363矽統","110/07/13","中農",670,139,531
"8016","2363矽統","110/07/13","新加坡商瑞銀",1000,2747,-1747
"8017","2363矽統","110/07/13","康和-台中",638,154,484
"8018","2363矽統","110/07/13","凱基-台北",5359,6609,-1250
"8019","2363矽統","110/07/13","群益金鼎-三民",577,137,440
"8020","2363矽統","110/07/13","摩根大通",1930,2858,-928
"8021","2363矽統","110/07/13","台新-屏東",510,88,422
"8022","2363矽統","110/07/13","港商野村",960,1679,-719
"8023","2363矽統","110/07/13","德信-中正",455,67,388
"8024","2363矽統","110/07/13","兆豐-復興",25,705,-680
"8025","2363矽統","110/07/13","日盛-竹北",365,70,295
"8026","2363矽統","110/07/13","統一-仁愛",114,755,-641
"8027","2363矽統","110/07/13","元大-佳里",452,189,263
"8028","2363矽統","110/07/13","統一-敦南",29,638,-609
"8029","2363矽統","110/07/13","國票-博愛",296,38,258
"8030","2363矽統","110/07/13","統一-土城",100,704,-604
"8031","2363矽統","110/07/13","元大-萬華",340,95,245
"8032","2363矽統","110/07/13","統一-城中",116,676,-560
"8033","2363矽統","110/07/13","新光",1259,1031,228
"8034","2363矽統","110/07/13","永豐金證券",306,859,-553
"8035","2363矽統","110/07/13","元富-成功",323,96,227
"8036","2363矽統","110/07/13","元富",54,567,-513
"8037","2363矽統","110/07/13","豐農",228,23,205
"8038","2363矽統","110/07/13","瑞士信貸",202,666,-464
"8039","2363矽統","110/07/13","台灣企銀-岡山",186,4,182
"8040","2363矽統","110/07/13","永豐金-嘉義",67,468,-401
"8041","8112至上","110/07/13","摩根大通",688,296,392
"8042","8112至上","110/07/13","國票-中和",0,401,-401
"8043","8112至上","110/07/13","港商野村",344,145,199
"8044","8112至上","110/07/13","永豐金-板盛",0,205,-205
"8045","8112至上","110/07/13","兆豐-公益",195,5,190
"8046","8112至上","110/07/13","凱基-五股",43,155,-112
"8047","8112至上","110/07/13","台灣摩根士丹利",183,0,183
"8048","8112至上","110/07/13","凱基-市政",0,100,-100
"8049","8112至上","110/07/13","群益金鼎-敦南",153,2,151
"8050","8112至上","110/07/13","元大-大里德芳",1,92,-91
"8051","8112至上","110/07/13","臺銀-金山",146,26,120
"8052","8112至上","110/07/13","玉山-桃園",26,110,-84
"8053","8112至上","110/07/13","臺銀",133,19,114
"8054","8112至上","110/07/13","兆豐-天母",0,81,-81
"8055","8112至上","110/07/13","合庫-台中",115,6,109
"8056","8112至上","110/07/13","凱基-城中",3,84,-81
"8057","8112至上","110/07/13","亞東-板橋",134,26,108
"8058","8112至上","110/07/13","日盛-新莊",9,85,-76
"8059","8112至上","110/07/13","凱基-台北",414,326,88
"8060","8112至上","110/07/13","日盛-台中",2,64,-62
"8061","8112至上","110/07/13","新加坡商瑞銀",181,100,81
"8062","8112至上","110/07/13","日盛-中壢",3,64,-61
"8063","8112至上","110/07/13","國泰-敦南",108,31,77
"8064","8112至上","110/07/13","元大-台中",2,59,-57
"8065","8112至上","110/07/13","第一金-華江",77,4,73
"8066","8112至上","110/07/13","元大-雙和",7,64,-57
"8067","8112至上","110/07/13","永豐金-內湖",73,1,72
"8068","8112至上","110/07/13","元大-高雄",8,62,-54
"8069","8112至上","110/07/13","元大-永和",68,1,67
"8070","8112至上","110/07/13","元大-館前",2,55,-53
"8071","2929淘帝","110/07/13","玉山-新竹",130,0,130
"8072","2929淘帝","110/07/13","美商高盛",0,177,-177
"8073","2929淘帝","110/07/13","臺銀-民權",60,0,60
"8074","2929淘帝","110/07/13","凱基-台北",6,80,-74
"8075","2929淘帝","110/07/13","新百王",31,0,31
"8076","2929淘帝","110/07/13","元富-大裕",0,49,-49
"8077","2929淘帝","110/07/13","日盛-園區",30,0,30
"8078","2929淘帝","110/07/13","國泰-館前",3,51,-48
"8079","2929淘帝","110/07/13","元大-南投",31,1,30
"8080","2929淘帝","110/07/13","凱基-中壢",0,41,-41
"8081","2929淘帝","110/07/13","兆豐-忠孝",28,0,28
"8082","2929淘帝","110/07/13","港商野村",21,55,-34
"8083","2929淘帝","110/07/13","元大-民生",28,0,28
"8084","2929淘帝","110/07/13","華南永昌-南京",2,34,-32
"8085","2929淘帝","110/07/13","合庫-高雄",27,0,27
"8086","2929淘帝","110/07/13","群益金鼎-土城",0,30,-30
"8087","2929淘帝","110/07/13","凱基-豐中",27,0,27
"8088","2929淘帝","110/07/13","富邦-南屯",0,22,-22
"8089","2929淘帝","110/07/13","新光",21,4,17
"8090","2929淘帝","110/07/13","第一金-豐原",0,20,-20
"8091","2929淘帝","110/07/13","元大-天母",17,0,17
"8092","2929淘帝","110/07/13","元大-屏南",6,26,-20
"8093","2929淘帝","110/07/13","永興",14,0,14
"8094","2929淘帝","110/07/13","永豐金-敦南",1,21,-20
"8095","2929淘帝","110/07/13","富邦-台北",12,0,12
"8096","2929淘帝","110/07/13","凱基-三重",2,21,-19
"8097","2929淘帝","110/07/13","元大-永和",12,0,12
"8098","2929淘帝","110/07/13","富邦-仁愛",7,25,-18
"8099","2929淘帝","110/07/13","國票-天祥",11,0,11
"8100","2929淘帝","110/07/13","元大-北投",0,16,-16
"8101","5410國眾","110/07/13","兆豐-城中",274,0,274
"8102","5410國眾","110/07/13","元富-嘉義",0,103,-103
"8103","5410國眾","110/07/13","新光",50,4,46
"8104","5410國眾","110/07/13","凱基-台北",0,50,-50
"8105","5410國眾","110/07/13","國泰-台中",26,0,26
"8106","5410國眾","110/07/13","瑞士信貸",0,31,-31
"8107","5410國眾","110/07/13","新加坡商瑞銀",22,0,22
"8108","5410國眾","110/07/13","台新-新莊",0,27,-27
"8109","5410國眾","110/07/13","光和-嘉義",20,0,20
"8110","5410國眾","110/07/13","元大-汐止",0,20,-20
"8111","5410國眾","110/07/13","凱基-竹北",17,0,17
"8112","5410國眾","110/07/13","亞東-新竹",0,17,-17
"8113","5410國眾","110/07/13","新光-桃園",15,0,15
"8114","5410國眾","110/07/13","元大-南勢角",0,13,-13
"8115","5410國眾","110/07/13","凱基-台東",14,0,14
"8116","5410國眾","110/07/13","台新-台南",0,12,-12
"8117","5410國眾","110/07/13","富邦-竹北",11,0,11
"8118","5410國眾","110/07/13","中國信託",0,11,-11
"8119","5410國眾","110/07/13","元富-同大",10,0,10
"8120","5410國眾","110/07/13","華南永昌",0,11,-11
"8121","5410國眾","110/07/13","國泰-敦南",24,15,9
"8122","5410國眾","110/07/13","臺銀-臺南",0,10,-10
"8123","5410國眾","110/07/13","日盛-內湖",7,0,7
"8124","5410國眾","110/07/13","台灣企銀-民雄",0,10,-10
"8125","5410國眾","110/07/13","台新-左楠",7,0,7
"8126","5410國眾","110/07/13","高橋",0,10,-10
"8127","5410國眾","110/07/13","元大-新盛",18,12,6
"8128","5410國眾","110/07/13","康和-嘉義",0,10,-10
"8129","5410國眾","110/07/13","統一",5,0,5
"8130","5410國眾","110/07/13","凱基-基隆",0,10,-10
"8131","2841台開","110/07/13","中國信託-高雄",251,50,201
"8132","2841台開","110/07/13","兆豐-公益",0,177,-177
"8133","2841台開","110/07/13","日盛證券",210,13,197
"8134","2841台開","110/07/13","日進",0,152,-152
"8135","2841台開","110/07/13","第一金-台中",55,0,55
"8136","2841台開","110/07/13","港商野村",0,109,-109
"8137","2841台開","110/07/13","國泰-板橋",46,0,46
"8138","2841台開","110/07/13","日盛-信義",0,103,-103
"8139","2841台開","110/07/13","國泰-館前",48,3,45
"8140","2841台開","110/07/13","國泰-敦南",11,75,-64
"8141","2841台開","110/07/13","華南永昌-新莊",45,0,45
"8142","2841台開","110/07/13","永興",0,50,-50
"8143","2841台開","110/07/13","日盛-園區",42,0,42
"8144","2841台開","110/07/13","永豐金-敦南",61,104,-43
"8145","2841台開","110/07/13","台新證券",32,0,32
"8146","2841台開","110/07/13","富邦-台南",0,42,-42
"8147","2841台開","110/07/13","台新-高雄",32,2,30
"8148","2841台開","110/07/13","國票-安和",0,30,-30
"8149","2841台開","110/07/13","豐農",23,0,23
"8150","2841台開","110/07/13","元大-桃園",0,25,-25
"8151","2841台開","110/07/13","合庫-嘉義",20,0,20
"8152","2841台開","110/07/13","新光",8,32,-24
"8153","2841台開","110/07/13","華南永昌-高雄",20,0,20
"8154","2841台開","110/07/13","元大-仁愛",0,24,-24
"8155","2841台開","110/07/13","元大-樹林",16,0,16
"8156","2841台開","110/07/13","日盛-中和",0,20,-20
"8157","2841台開","110/07/13","第一金-華江",15,2,13
"8158","2841台開","110/07/13","元富",0,20,-20
"8159","2841台開","110/07/13","美商高盛",12,0,12
"8160","2841台開","110/07/13","富邦-宜蘭",0,20,-20
"8161","6207雷科","110/07/13","元大-高雄",121,0,121
"8162","6207雷科","110/07/13","華南永昌-朴子",1,60,-59
"8163","6207雷科","110/07/13","第一金-新興",20,0,20
"8164","6207雷科","110/07/13","元大-南海",0,36,-36
"8165","6207雷科","110/07/13","元富-三重",20,0,20
"8166","6207雷科","110/07/13","凱基-土城",0,35,-35
"8167","6207雷科","110/07/13","元大-林園",15,0,15
"8168","6207雷科","110/07/13","台灣企銀",0,20,-20
"8169","6207雷科","110/07/13","元大-金華",16,1,15
"8170","6207雷科","110/07/13","群益金鼎-丹鳳",0,20,-20
"8171","6207雷科","110/07/13","日盛證券",10,0,10
"8172","6207雷科","110/07/13","元大-博愛",0,17,-17
"8173","6207雷科","110/07/13","統一-台中",10,0,10
"8174","6207雷科","110/07/13","元大-北港",0,13,-13
"8175","6207雷科","110/07/13","群益金鼎-土城",10,0,10
"8176","6207雷科","110/07/13","新加坡商瑞銀",0,12,-12
"8177","6207雷科","110/07/13","群益金鼎-桃園",10,0,10
"8178","6207雷科","110/07/13","凱基-台北",4,16,-12
"8179","6207雷科","110/07/13","永豐金-新莊",10,0,10
"8180","6207雷科","110/07/13","日茂-埔里",0,11,-11
"8181","6207雷科","110/07/13","永豐金-新店",10,0,10
"8182","6207雷科","110/07/13","元大-莒光",0,11,-11
"8183","6207雷科","110/07/13","元大證券",9,0,9
"8184","6207雷科","110/07/13","統一-新竹",0,10,-10
"8185","6207雷科","110/07/13","日盛-木柵",9,1,8
"8186","6207雷科","110/07/13","元大-西螺",0,10,-10
"8187","6207雷科","110/07/13","兆豐-來福",8,0,8
"8188","6207雷科","110/07/13","康和-台中",0,8,-8
"8189","6207雷科","110/07/13","新光",7,0,7
"8190","6207雷科","110/07/13","兆豐-高雄",0,6,-6
"8191","3679新至陞","110/07/13","永豐金證券",50,0,50
"8192","3679新至陞","110/07/13","摩根大通",2,25,-23
"8193","3679新至陞","110/07/13","國泰-桃園",22,0,22
"8194","3679新至陞","110/07/13","元大-成功",0,22,-22
"8195","3679新至陞","110/07/13","台中銀-員林",11,0,11
"8196","3679新至陞","110/07/13","富邦-板橋",1,19,-18
"8197","3679新至陞","110/07/13","元大-文心興安",8,0,8
"8198","3679新至陞","110/07/13","日盛-新莊",0,10,-10
"8199","3679新至陞","110/07/13","美商高盛",6,0,6
"8200","3679新至陞","110/07/13","台新-台中",0,10,-10
"8201","3679新至陞","110/07/13","台新-高雄",6,0,6
"8202","3679新至陞","110/07/13","永豐金-新竹",0,8,-8
"8203","3679新至陞","110/07/13","凱基-台北",18,12,6
"8204","3679新至陞","110/07/13","瑞士信貸",12,19,-7
"8205","3679新至陞","110/07/13","日盛-復興",5,0,5
"8206","3679新至陞","110/07/13","統一-南京",0,7,-7
"8207","3679新至陞","110/07/13","(牛牛牛)亞-鑫豐",4,0,4
"8208","3679新至陞","110/07/13","凱基-新莊",0,7,-7
"8209","3679新至陞","110/07/13","元富-大昌",3,0,3
"8210","3679新至陞","110/07/13","新加坡商瑞銀",0,6,-6
"8211","3679新至陞","110/07/13","富邦-台北",3,0,3
"8212","3679新至陞","110/07/13","合庫-自強",0,5,-5
"8213","3679新至陞","110/07/13","日盛-樹林",2,0,2
"8214","3679新至陞","110/07/13","富邦-桃園",0,5,-5
"8215","3679新至陞","110/07/13","宏遠-光隆",2,0,2
"8216","3679新至陞","110/07/13","永豐金-潮州",0,4,-4
"8217","3679新至陞","110/07/13","美林",3,1,2
"8218","3679新至陞","110/07/13","臺銀-臺南",0,3,-3
"8219","3679新至陞","110/07/13","第一金-中壢",2,0,2
"8220","3679新至陞","110/07/13","元大-六合",0,3,-3
"8221","2727王品","110/07/13","富邦-台北",43,3,40
"8222","2727王品","110/07/13","台灣摩根士丹利",15,97,-82
"8223","2727王品","110/07/13","元大-基隆孝二",40,0,40
"8224","2727王品","110/07/13","玉山-台南",5,57,-52
"8225","2727王品","110/07/13","國票-新莊",40,1,39
"8226","2727王品","110/07/13","新加坡商瑞銀",0,48,-48
"8227","2727王品","110/07/13","第一金-豐原",66,42,24
"8228","2727王品","110/07/13","凱基-台北",41,77,-36
"8229","2727王品","110/07/13","永豐金-大園",34,10,24
"8230","2727王品","110/07/13","永豐金-永康",0,22,-22
"8231","2727王品","110/07/13","元大-北屯",22,0,22
"8232","2727王品","110/07/13","統一-台中",2,22,-20
"8233","2727王品","110/07/13","元大-東蘆",26,7,19
"8234","2727王品","110/07/13","國泰-台中",21,39,-18
"8235","2727王品","110/07/13","永豐金-萬盛",13,1,12
"8236","2727王品","110/07/13","合庫-彰化",3,20,-17
"8237","2727王品","110/07/13","日盛-嘉義",11,0,11
"8238","2727王品","110/07/13","港商野村",13,30,-17
"8239","2727王品","110/07/13","日盛-八德",11,0,11
"8240","2727王品","110/07/13","元大-楊梅",1,16,-15
"8241","2727王品","110/07/13","統一-竹南",11,0,11
"8242","2727王品","110/07/13","凱基-高美館",2,15,-13
"8243","2727王品","110/07/13","日盛-士林",12,2,10
"8244","2727王品","110/07/13","美商高盛",2,14,-12
"8245","2727王品","110/07/13","統一-敦南",10,0,10
"8246","2727王品","110/07/13","統一-平鎮",1,13,-12
"8247","2727王品","110/07/13","中國信託",15,5,10
"8248","2727王品","110/07/13","兆豐-台中港",4,16,-12
"8249","2727王品","110/07/13","兆豐-竹北",13,3,10
"8250","2727王品","110/07/13","凱基-八德",1,13,-12
"8251","1570力肯","110/07/13","新光",115,11,104
"8252","1570力肯","110/07/13","元大-北三重",0,162,-162
"8253","1570力肯","110/07/13","群益金鼎-高雄",54,0,54
"8254","1570力肯","110/07/13","元大-大灣",0,25,-25
"8255","1570力肯","110/07/13","國票-新莊",22,0,22
"8256","1570力肯","110/07/13","永豐金-苓雅",0,22,-22
"8257","1570力肯","110/07/13","日盛-桃園",12,0,12
"8258","1570力肯","110/07/13","永豐金-永康",0,19,-19
"8259","1570力肯","110/07/13","元大-高雄",12,0,12
"8260","1570力肯","110/07/13","富邦-員林",0,15,-15
"8261","1570力肯","110/07/13","合庫-自強",11,0,11
"8262","1570力肯","110/07/13","凱基-台南",0,11,-11
"8263","1570力肯","110/07/13","摩根大通",26,15,11
"8264","1570力肯","110/07/13","日盛-竹北",0,10,-10
"8265","1570力肯","110/07/13","永豐金-中盛",11,0,11
"8266","1570力肯","110/07/13","國票-九鼎",0,10,-10
"8267","1570力肯","110/07/13","兆豐-台中港",10,0,10
"8268","1570力肯","110/07/13","凱基-桃園",0,10,-10
"8269","1570力肯","110/07/13","國泰-松江",9,0,9
"8270","1570力肯","110/07/13","凱基-新豐",0,10,-10
"8271","1570力肯","110/07/13","元大-新盛",9,0,9
"8272","1570力肯","110/07/13","元大-學甲",0,10,-10
"8273","1570力肯","110/07/13","元富-緯城",6,0,6
"8274","1570力肯","110/07/13","群益金鼎-東湖",1,10,-9
"8275","1570力肯","110/07/13","統一-三重",5,0,5
"8276","1570力肯","110/07/13","大昌",0,6,-6
"8277","1570力肯","110/07/13","元大-前金",5,0,5
"8278","1570力肯","110/07/13","元大-土城學府",0,6,-6
"8279","1570力肯","110/07/13","永豐金證券",5,0,5
"8280","1570力肯","110/07/13","統一",0,5,-5
"8281","6180橘子","110/07/13","摩根大通",119,0,119
"8282","6180橘子","110/07/13","元大-崇德",2,61,-59
"8283","6180橘子","110/07/13","美商高盛",96,0,96
"8284","6180橘子","110/07/13","康和-台中",0,51,-51
"8285","6180橘子","110/07/13","新加坡商瑞銀",86,7,79
"8286","6180橘子","110/07/13","康和-台北",0,50,-50
"8287","6180橘子","110/07/13","元大-和平",40,0,40
"8288","6180橘子","110/07/13","元富-潮州",0,40,-40
"8289","6180橘子","110/07/13","凱基-台北",83,47,36
"8290","6180橘子","110/07/13","日盛-永康",0,26,-26
"8291","6180橘子","110/07/13","美林",39,5,34
"8292","6180橘子","110/07/13","永豐金-中正",0,24,-24
"8293","6180橘子","110/07/13","富邦-新竹華信",31,2,29
"8294","6180橘子","110/07/13","國泰-板橋",2,25,-23
"8295","6180橘子","110/07/13","統一-南京",21,0,21
"8296","6180橘子","110/07/13","日盛-大墩",0,20,-20
"8297","6180橘子","110/07/13","富邦-陽明",24,3,21
"8298","6180橘子","110/07/13","元大-草屯",13,32,-19
"8299","6180橘子","110/07/13","大昌-樹林",21,1,20
"8300","6180橘子","110/07/13","元富-林園",1,18,-17
"8301","6180橘子","110/07/13","花旗環球",19,0,19
"8302","6180橘子","110/07/13","新光-新竹",1,18,-17
"8303","6180橘子","110/07/13","華南永昌-台南",19,0,19
"8304","6180橘子","110/07/13","元大-土城永寧",0,17,-17
"8305","6180橘子","110/07/13","福勝",14,0,14
"8306","6180橘子","110/07/13","國泰-新莊",3,19,-16
"8307","6180橘子","110/07/13","富邦-嘉義",12,1,11
"8308","6180橘子","110/07/13","中國信託-永康",6,21,-15
"8309","6180橘子","110/07/13","元大-板橋三民",11,0,11
"8310","6180橘子","110/07/13","凱基-東港",1,15,-14
"8311","2390云辰","110/07/13","新加坡商瑞銀",562,75,487
"8312","2390云辰","110/07/13","大展-台南",0,532,-532
"8313","2390云辰","110/07/13","台灣摩根士丹利",330,155,175
"8314","2390云辰","110/07/13","凱基-台北",668,854,-186
"8315","2390云辰","110/07/13","兆豐-公益",126,25,101
"8316","2390云辰","110/07/13","凱基-三重",12,172,-160
"8317","2390云辰","110/07/13","元富-中港",100,2,98
"8318","2390云辰","110/07/13","兆豐-忠孝",4,161,-157
"8319","2390云辰","110/07/13","統一-新台中",106,9,97
"8320","2390云辰","110/07/13","元大-士林",19,170,-151
"8321","2390云辰","110/07/13","中國信託-松江",81,11,70
"8322","2390云辰","110/07/13","臺銀-新竹",14,117,-103
"8323","2390云辰","110/07/13","日盛-板橋",72,3,69
"8324","2390云辰","110/07/13","國票-台中",4,102,-98
"8325","2390云辰","110/07/13","日盛-和美",57,0,57
"8326","2390云辰","110/07/13","新光",147,232,-85
"8327","2390云辰","110/07/13","永豐金-桃園",88,36,52
"8328","2390云辰","110/07/13","致和-崇德",2,70,-68
"8329","2390云辰","110/07/13","玉山-士林",54,4,50
"8330","2390云辰","110/07/13","群益金鼎-屏東",2,70,-68
"8331","2390云辰","110/07/13","富邦-仁愛",56,6,50
"8332","2390云辰","110/07/13","元大-大里",35,98,-63
"8333","2390云辰","110/07/13","第一金-豐原",50,1,49
"8334","2390云辰","110/07/13","元大-萬華",35,94,-59
"8335","2390云辰","110/07/13","摩根大通",502,453,49
"8336","2390云辰","110/07/13","元富-吉利",2,60,-58
"8337","2390云辰","110/07/13","凱基-松山",61,13,48
"8338","2390云辰","110/07/13","兆豐-新竹",3,53,-50
"8339","2390云辰","110/07/13","大昌",64,22,42
"8340","2390云辰","110/07/13","富邦-嘉義",65,108,-43
"8341","2363矽統","110/07/13","凱基-南崁",2133,63,2070
"8342","2363矽統","110/07/13","凱基-幸福",36,4048,-4012
"8343","2363矽統","110/07/13","國泰-敦南",2195,1617,578
"8344","2363矽統","110/07/13","統一",192,3325,-3133
"8345","2363矽統","110/07/13","中農",670,139,531
"8346","2363矽統","110/07/13","新加坡商瑞銀",1000,2747,-1747
"8347","2363矽統","110/07/13","康和-台中",638,154,484
"8348","2363矽統","110/07/13","凱基-台北",5359,6609,-1250
"8349","2363矽統","110/07/13","群益金鼎-三民",577,137,440
"8350","2363矽統","110/07/13","摩根大通",1930,2858,-928
"8351","2363矽統","110/07/13","台新-屏東",510,88,422
"8352","2363矽統","110/07/13","港商野村",960,1679,-719
"8353","2363矽統","110/07/13","德信-中正",455,67,388
"8354","2363矽統","110/07/13","兆豐-復興",25,705,-680
"8355","2363矽統","110/07/13","日盛-竹北",365,70,295
"8356","2363矽統","110/07/13","統一-仁愛",114,755,-641
"8357","2363矽統","110/07/13","元大-佳里",452,189,263
"8358","2363矽統","110/07/13","統一-敦南",29,638,-609
"8359","2363矽統","110/07/13","國票-博愛",296,38,258
"8360","2363矽統","110/07/13","統一-土城",100,704,-604
"8361","2363矽統","110/07/13","元大-萬華",340,95,245
"8362","2363矽統","110/07/13","統一-城中",116,676,-560
"8363","2363矽統","110/07/13","新光",1259,1031,228
"8364","2363矽統","110/07/13","永豐金證券",306,859,-553
"8365","2363矽統","110/07/13","元富-成功",323,96,227
"8366","2363矽統","110/07/13","元富",54,567,-513
"8367","2363矽統","110/07/13","豐農",228,23,205
"8368","2363矽統","110/07/13","瑞士信貸",202,666,-464
"8369","2363矽統","110/07/13","台灣企銀-岡山",186,4,182
"8370","2363矽統","110/07/13","永豐金-嘉義",67,468,-401
"8371","8112至上","110/07/13","摩根大通",688,296,392
"8372","8112至上","110/07/13","國票-中和",0,401,-401
"8373","8112至上","110/07/13","港商野村",344,145,199
"8374","8112至上","110/07/13","永豐金-板盛",0,205,-205
"8375","8112至上","110/07/13","兆豐-公益",195,5,190
"8376","8112至上","110/07/13","凱基-五股",43,155,-112
"8377","8112至上","110/07/13","台灣摩根士丹利",183,0,183
"8378","8112至上","110/07/13","凱基-市政",0,100,-100
"8379","8112至上","110/07/13","群益金鼎-敦南",153,2,151
"8380","8112至上","110/07/13","元大-大里德芳",1,92,-91
"8381","8112至上","110/07/13","臺銀-金山",146,26,120
"8382","8112至上","110/07/13","玉山-桃園",26,110,-84
"8383","8112至上","110/07/13","臺銀",133,19,114
"8384","8112至上","110/07/13","兆豐-天母",0,81,-81
"8385","8112至上","110/07/13","合庫-台中",115,6,109
"8386","8112至上","110/07/13","凱基-城中",3,84,-81
"8387","8112至上","110/07/13","亞東-板橋",134,26,108
"8388","8112至上","110/07/13","日盛-新莊",9,85,-76
"8389","8112至上","110/07/13","凱基-台北",414,326,88
"8390","8112至上","110/07/13","日盛-台中",2,64,-62
"8391","8112至上","110/07/13","新加坡商瑞銀",181,100,81
"8392","8112至上","110/07/13","日盛-中壢",3,64,-61
"8393","8112至上","110/07/13","國泰-敦南",108,31,77
"8394","8112至上","110/07/13","元大-台中",2,59,-57
"8395","8112至上","110/07/13","第一金-華江",77,4,73
"8396","8112至上","110/07/13","元大-雙和",7,64,-57
"8397","8112至上","110/07/13","永豐金-內湖",73,1,72
"8398","8112至上","110/07/13","元大-高雄",8,62,-54
"8399","8112至上","110/07/13","元大-永和",68,1,67
"8400","8112至上","110/07/13","元大-館前",2,55,-53
"8401","2929淘帝","110/07/13","玉山-新竹",130,0,130
"8402","2929淘帝","110/07/13","美商高盛",0,177,-177
"8403","2929淘帝","110/07/13","臺銀-民權",60,0,60
"8404","2929淘帝","110/07/13","凱基-台北",6,80,-74
"8405","2929淘帝","110/07/13","新百王",31,0,31
"8406","2929淘帝","110/07/13","元富-大裕",0,49,-49
"8407","2929淘帝","110/07/13","日盛-園區",30,0,30
"8408","2929淘帝","110/07/13","國泰-館前",3,51,-48
"8409","2929淘帝","110/07/13","元大-南投",31,1,30
"8410","2929淘帝","110/07/13","凱基-中壢",0,41,-41
"8411","2929淘帝","110/07/13","兆豐-忠孝",28,0,28
"8412","2929淘帝","110/07/13","港商野村",21,55,-34
"8413","2929淘帝","110/07/13","元大-民生",28,0,28
"8414","2929淘帝","110/07/13","華南永昌-南京",2,34,-32
"8415","2929淘帝","110/07/13","合庫-高雄",27,0,27
"8416","2929淘帝","110/07/13","群益金鼎-土城",0,30,-30
"8417","2929淘帝","110/07/13","凱基-豐中",27,0,27
"8418","2929淘帝","110/07/13","富邦-南屯",0,22,-22
"8419","2929淘帝","110/07/13","新光",21,4,17
"8420","2929淘帝","110/07/13","第一金-豐原",0,20,-20
"8421","2929淘帝","110/07/13","元大-天母",17,0,17
"8422","2929淘帝","110/07/13","元大-屏南",6,26,-20
"8423","2929淘帝","110/07/13","永興",14,0,14
"8424","2929淘帝","110/07/13","永豐金-敦南",1,21,-20
"8425","2929淘帝","110/07/13","富邦-台北",12,0,12
"8426","2929淘帝","110/07/13","凱基-三重",2,21,-19
"8427","2929淘帝","110/07/13","元大-永和",12,0,12
"8428","2929淘帝","110/07/13","富邦-仁愛",7,25,-18
"8429","2929淘帝","110/07/13","國票-天祥",11,0,11
"8430","2929淘帝","110/07/13","元大-北投",0,16,-16
"8431","5410國眾","110/07/13","兆豐-城中",274,0,274
"8432","5410國眾","110/07/13","元富-嘉義",0,103,-103
"8433","5410國眾","110/07/13","新光",50,4,46
"8434","5410國眾","110/07/13","凱基-台北",0,50,-50
"8435","5410國眾","110/07/13","國泰-台中",26,0,26
"8436","5410國眾","110/07/13","瑞士信貸",0,31,-31
"8437","5410國眾","110/07/13","新加坡商瑞銀",22,0,22
"8438","5410國眾","110/07/13","台新-新莊",0,27,-27
"8439","5410國眾","110/07/13","光和-嘉義",20,0,20
"8440","5410國眾","110/07/13","元大-汐止",0,20,-20
"8441","5410國眾","110/07/13","凱基-竹北",17,0,17
"8442","5410國眾","110/07/13","亞東-新竹",0,17,-17
"8443","5410國眾","110/07/13","新光-桃園",15,0,15
"8444","5410國眾","110/07/13","元大-南勢角",0,13,-13
"8445","5410國眾","110/07/13","凱基-台東",14,0,14
"8446","5410國眾","110/07/13","台新-台南",0,12,-12
"8447","5410國眾","110/07/13","富邦-竹北",11,0,11
"8448","5410國眾","110/07/13","中國信託",0,11,-11
"8449","5410國眾","110/07/13","元富-同大",10,0,10
"8450","5410國眾","110/07/13","華南永昌",0,11,-11
"8451","5410國眾","110/07/13","國泰-敦南",24,15,9
"8452","5410國眾","110/07/13","臺銀-臺南",0,10,-10
"8453","5410國眾","110/07/13","日盛-內湖",7,0,7
"8454","5410國眾","110/07/13","台灣企銀-民雄",0,10,-10
"8455","5410國眾","110/07/13","台新-左楠",7,0,7
"8456","5410國眾","110/07/13","高橋",0,10,-10
"8457","5410國眾","110/07/13","元大-新盛",18,12,6
"8458","5410國眾","110/07/13","康和-嘉義",0,10,-10
"8459","5410國眾","110/07/13","統一",5,0,5
"8460","5410國眾","110/07/13","凱基-基隆",0,10,-10
"8461","2841台開","110/07/13","中國信託-高雄",251,50,201
"8462","2841台開","110/07/13","兆豐-公益",0,177,-177
"8463","2841台開","110/07/13","日盛證券",210,13,197
"8464","2841台開","110/07/13","日進",0,152,-152
"8465","2841台開","110/07/13","第一金-台中",55,0,55
"8466","2841台開","110/07/13","港商野村",0,109,-109
"8467","2841台開","110/07/13","國泰-板橋",46,0,46
"8468","2841台開","110/07/13","日盛-信義",0,103,-103
"8469","2841台開","110/07/13","國泰-館前",48,3,45
"8470","2841台開","110/07/13","國泰-敦南",11,75,-64
"8471","2841台開","110/07/13","華南永昌-新莊",45,0,45
"8472","2841台開","110/07/13","永興",0,50,-50
"8473","2841台開","110/07/13","日盛-園區",42,0,42
"8474","2841台開","110/07/13","永豐金-敦南",61,104,-43
"8475","2841台開","110/07/13","台新證券",32,0,32
"8476","2841台開","110/07/13","富邦-台南",0,42,-42
"8477","2841台開","110/07/13","台新-高雄",32,2,30
"8478","2841台開","110/07/13","國票-安和",0,30,-30
"8479","2841台開","110/07/13","豐農",23,0,23
"8480","2841台開","110/07/13","元大-桃園",0,25,-25
"8481","2841台開","110/07/13","合庫-嘉義",20,0,20
"8482","2841台開","110/07/13","新光",8,32,-24
"8483","2841台開","110/07/13","華南永昌-高雄",20,0,20
"8484","2841台開","110/07/13","元大-仁愛",0,24,-24
"8485","2841台開","110/07/13","元大-樹林",16,0,16
"8486","2841台開","110/07/13","日盛-中和",0,20,-20
"8487","2841台開","110/07/13","第一金-華江",15,2,13
"8488","2841台開","110/07/13","元富",0,20,-20
"8489","2841台開","110/07/13","美商高盛",12,0,12
"8490","2841台開","110/07/13","富邦-宜蘭",0,20,-20
"8491","6207雷科","110/07/13","元大-高雄",121,0,121
"8492","6207雷科","110/07/13","華南永昌-朴子",1,60,-59
"8493","6207雷科","110/07/13","第一金-新興",20,0,20
"8494","6207雷科","110/07/13","元大-南海",0,36,-36
"8495","6207雷科","110/07/13","元富-三重",20,0,20
"8496","6207雷科","110/07/13","凱基-土城",0,35,-35
"8497","6207雷科","110/07/13","元大-林園",15,0,15
"8498","6207雷科","110/07/13","台灣企銀",0,20,-20
"8499","6207雷科","110/07/13","元大-金華",16,1,15
"8500","6207雷科","110/07/13","群益金鼎-丹鳳",0,20,-20
"8501","6207雷科","110/07/13","日盛證券",10,0,10
"8502","6207雷科","110/07/13","元大-博愛",0,17,-17
"8503","6207雷科","110/07/13","統一-台中",10,0,10
"8504","6207雷科","110/07/13","元大-北港",0,13,-13
"8505","6207雷科","110/07/13","群益金鼎-土城",10,0,10
"8506","6207雷科","110/07/13","新加坡商瑞銀",0,12,-12
"8507","6207雷科","110/07/13","群益金鼎-桃園",10,0,10
"8508","6207雷科","110/07/13","凱基-台北",4,16,-12
"8509","6207雷科","110/07/13","永豐金-新莊",10,0,10
"8510","6207雷科","110/07/13","日茂-埔里",0,11,-11
"8511","6207雷科","110/07/13","永豐金-新店",10,0,10
"8512","6207雷科","110/07/13","元大-莒光",0,11,-11
"8513","6207雷科","110/07/13","元大證券",9,0,9
"8514","6207雷科","110/07/13","統一-新竹",0,10,-10
"8515","6207雷科","110/07/13","日盛-木柵",9,1,8
"8516","6207雷科","110/07/13","元大-西螺",0,10,-10
"8517","6207雷科","110/07/13","兆豐-來福",8,0,8
"8518","6207雷科","110/07/13","康和-台中",0,8,-8
"8519","6207雷科","110/07/13","新光",7,0,7
"8520","6207雷科","110/07/13","兆豐-高雄",0,6,-6
"8521","3679新至陞","110/07/13","永豐金證券",50,0,50
"8522","3679新至陞","110/07/13","摩根大通",2,25,-23
"8523","3679新至陞","110/07/13","國泰-桃園",22,0,22
"8524","3679新至陞","110/07/13","元大-成功",0,22,-22
"8525","3679新至陞","110/07/13","台中銀-員林",11,0,11
"8526","3679新至陞","110/07/13","富邦-板橋",1,19,-18
"8527","3679新至陞","110/07/13","元大-文心興安",8,0,8
"8528","3679新至陞","110/07/13","日盛-新莊",0,10,-10
"8529","3679新至陞","110/07/13","美商高盛",6,0,6
"8530","3679新至陞","110/07/13","台新-台中",0,10,-10
"8531","3679新至陞","110/07/13","台新-高雄",6,0,6
"8532","3679新至陞","110/07/13","永豐金-新竹",0,8,-8
"8533","3679新至陞","110/07/13","凱基-台北",18,12,6
"8534","3679新至陞","110/07/13","瑞士信貸",12,19,-7
"8535","3679新至陞","110/07/13","日盛-復興",5,0,5
"8536","3679新至陞","110/07/13","統一-南京",0,7,-7
"8537","3679新至陞","110/07/13","(牛牛牛)亞-鑫豐",4,0,4
"8538","3679新至陞","110/07/13","凱基-新莊",0,7,-7
"8539","3679新至陞","110/07/13","元富-大昌",3,0,3
"8540","3679新至陞","110/07/13","新加坡商瑞銀",0,6,-6
"8541","3679新至陞","110/07/13","富邦-台北",3,0,3
"8542","3679新至陞","110/07/13","合庫-自強",0,5,-5
"8543","3679新至陞","110/07/13","日盛-樹林",2,0,2
"8544","3679新至陞","110/07/13","富邦-桃園",0,5,-5
"8545","3679新至陞","110/07/13","宏遠-光隆",2,0,2
"8546","3679新至陞","110/07/13","永豐金-潮州",0,4,-4
"8547","3679新至陞","110/07/13","美林",3,1,2
"8548","3679新至陞","110/07/13","臺銀-臺南",0,3,-3
"8549","3679新至陞","110/07/13","第一金-中壢",2,0,2
"8550","3679新至陞","110/07/13","元大-六合",0,3,-3
"8551","2727王品","110/07/13","富邦-台北",43,3,40
"8552","2727王品","110/07/13","台灣摩根士丹利",15,97,-82
"8553","2727王品","110/07/13","元大-基隆孝二",40,0,40
"8554","2727王品","110/07/13","玉山-台南",5,57,-52
"8555","2727王品","110/07/13","國票-新莊",40,1,39
"8556","2727王品","110/07/13","新加坡商瑞銀",0,48,-48
"8557","2727王品","110/07/13","第一金-豐原",66,42,24
"8558","2727王品","110/07/13","凱基-台北",41,77,-36
"8559","2727王品","110/07/13","永豐金-大園",34,10,24
"8560","2727王品","110/07/13","永豐金-永康",0,22,-22
"8561","2727王品","110/07/13","元大-北屯",22,0,22
"8562","2727王品","110/07/13","統一-台中",2,22,-20
"8563","2727王品","110/07/13","元大-東蘆",26,7,19
"8564","2727王品","110/07/13","國泰-台中",21,39,-18
"8565","2727王品","110/07/13","永豐金-萬盛",13,1,12
"8566","2727王品","110/07/13","合庫-彰化",3,20,-17
"8567","2727王品","110/07/13","日盛-嘉義",11,0,11
"8568","2727王品","110/07/13","港商野村",13,30,-17
"8569","2727王品","110/07/13","日盛-八德",11,0,11
"8570","2727王品","110/07/13","元大-楊梅",1,16,-15
"8571","2727王品","110/07/13","統一-竹南",11,0,11
"8572","2727王品","110/07/13","凱基-高美館",2,15,-13
"8573","2727王品","110/07/13","日盛-士林",12,2,10
"8574","2727王品","110/07/13","美商高盛",2,14,-12
"8575","2727王品","110/07/13","統一-敦南",10,0,10
"8576","2727王品","110/07/13","統一-平鎮",1,13,-12
"8577","2727王品","110/07/13","中國信託",15,5,10
"8578","2727王品","110/07/13","兆豐-台中港",4,16,-12
"8579","2727王品","110/07/13","兆豐-竹北",13,3,10
"8580","2727王品","110/07/13","凱基-八德",1,13,-12
"8581","1570力肯","110/07/13","新光",115,11,104
"8582","1570力肯","110/07/13","元大-北三重",0,162,-162
"8583","1570力肯","110/07/13","群益金鼎-高雄",54,0,54
"8584","1570力肯","110/07/13","元大-大灣",0,25,-25
"8585","1570力肯","110/07/13","國票-新莊",22,0,22
"8586","1570力肯","110/07/13","永豐金-苓雅",0,22,-22
"8587","1570力肯","110/07/13","日盛-桃園",12,0,12
"8588","1570力肯","110/07/13","永豐金-永康",0,19,-19
"8589","1570力肯","110/07/13","元大-高雄",12,0,12
"8590","1570力肯","110/07/13","富邦-員林",0,15,-15
"8591","1570力肯","110/07/13","合庫-自強",11,0,11
"8592","1570力肯","110/07/13","凱基-台南",0,11,-11
"8593","1570力肯","110/07/13","摩根大通",26,15,11
"8594","1570力肯","110/07/13","日盛-竹北",0,10,-10
"8595","1570力肯","110/07/13","永豐金-中盛",11,0,11
"8596","1570力肯","110/07/13","國票-九鼎",0,10,-10
"8597","1570力肯","110/07/13","兆豐-台中港",10,0,10
"8598","1570力肯","110/07/13","凱基-桃園",0,10,-10
"8599","1570力肯","110/07/13","國泰-松江",9,0,9
"8600","1570力肯","110/07/13","凱基-新豐",0,10,-10
"8601","1570力肯","110/07/13","元大-新盛",9,0,9
"8602","1570力肯","110/07/13","元大-學甲",0,10,-10
"8603","1570力肯","110/07/13","元富-緯城",6,0,6
"8604","1570力肯","110/07/13","群益金鼎-東湖",1,10,-9
"8605","1570力肯","110/07/13","統一-三重",5,0,5
"8606","1570力肯","110/07/13","大昌",0,6,-6
"8607","1570力肯","110/07/13","元大-前金",5,0,5
"8608","1570力肯","110/07/13","元大-土城學府",0,6,-6
"8609","1570力肯","110/07/13","永豐金證券",5,0,5
"8610","1570力肯","110/07/13","統一",0,5,-5
"8611","6180橘子","110/07/13","摩根大通",119,0,119
"8612","6180橘子","110/07/13","元大-崇德",2,61,-59
"8613","6180橘子","110/07/13","美商高盛",96,0,96
"8614","6180橘子","110/07/13","康和-台中",0,51,-51
"8615","6180橘子","110/07/13","新加坡商瑞銀",86,7,79
"8616","6180橘子","110/07/13","康和-台北",0,50,-50
"8617","6180橘子","110/07/13","元大-和平",40,0,40
"8618","6180橘子","110/07/13","元富-潮州",0,40,-40
"8619","6180橘子","110/07/13","凱基-台北",83,47,36
"8620","6180橘子","110/07/13","日盛-永康",0,26,-26
"8621","6180橘子","110/07/13","美林",39,5,34
"8622","6180橘子","110/07/13","永豐金-中正",0,24,-24
"8623","6180橘子","110/07/13","富邦-新竹華信",31,2,29
"8624","6180橘子","110/07/13","國泰-板橋",2,25,-23
"8625","6180橘子","110/07/13","統一-南京",21,0,21
"8626","6180橘子","110/07/13","日盛-大墩",0,20,-20
"8627","6180橘子","110/07/13","富邦-陽明",24,3,21
"8628","6180橘子","110/07/13","元大-草屯",13,32,-19
"8629","6180橘子","110/07/13","大昌-樹林",21,1,20
"8630","6180橘子","110/07/13","元富-林園",1,18,-17
"8631","6180橘子","110/07/13","花旗環球",19,0,19
"8632","6180橘子","110/07/13","新光-新竹",1,18,-17
"8633","6180橘子","110/07/13","華南永昌-台南",19,0,19
"8634","6180橘子","110/07/13","元大-土城永寧",0,17,-17
"8635","6180橘子","110/07/13","福勝",14,0,14
"8636","6180橘子","110/07/13","國泰-新莊",3,19,-16
"8637","6180橘子","110/07/13","富邦-嘉義",12,1,11
"8638","6180橘子","110/07/13","中國信託-永康",6,21,-15
"8639","6180橘子","110/07/13","元大-板橋三民",11,0,11
"8640","6180橘子","110/07/13","凱基-東港",1,15,-14
"8641","2390云辰","110/07/13","新加坡商瑞銀",562,75,487
"8642","2390云辰","110/07/13","大展-台南",0,532,-532
"8643","2390云辰","110/07/13","台灣摩根士丹利",330,155,175
"8644","2390云辰","110/07/13","凱基-台北",668,854,-186
"8645","2390云辰","110/07/13","兆豐-公益",126,25,101
"8646","2390云辰","110/07/13","凱基-三重",12,172,-160
"8647","2390云辰","110/07/13","元富-中港",100,2,98
"8648","2390云辰","110/07/13","兆豐-忠孝",4,161,-157
"8649","2390云辰","110/07/13","統一-新台中",106,9,97
"8650","2390云辰","110/07/13","元大-士林",19,170,-151
"8651","2390云辰","110/07/13","中國信託-松江",81,11,70
"8652","2390云辰","110/07/13","臺銀-新竹",14,117,-103
"8653","2390云辰","110/07/13","日盛-板橋",72,3,69
"8654","2390云辰","110/07/13","國票-台中",4,102,-98
"8655","2390云辰","110/07/13","日盛-和美",57,0,57
"8656","2390云辰","110/07/13","新光",147,232,-85
"8657","2390云辰","110/07/13","永豐金-桃園",88,36,52
"8658","2390云辰","110/07/13","致和-崇德",2,70,-68
"8659","2390云辰","110/07/13","玉山-士林",54,4,50
"8660","2390云辰","110/07/13","群益金鼎-屏東",2,70,-68
"8661","2390云辰","110/07/13","富邦-仁愛",56,6,50
"8662","2390云辰","110/07/13","元大-大里",35,98,-63
"8663","2390云辰","110/07/13","第一金-豐原",50,1,49
"8664","2390云辰","110/07/13","元大-萬華",35,94,-59
"8665","2390云辰","110/07/13","摩根大通",502,453,49
"8666","2390云辰","110/07/13","元富-吉利",2,60,-58
"8667","2390云辰","110/07/13","凱基-松山",61,13,48
"8668","2390云辰","110/07/13","兆豐-新竹",3,53,-50
"8669","2390云辰","110/07/13","大昌",64,22,42
"8670","2390云辰","110/07/13","富邦-嘉義",65,108,-43
"8671","2363矽統","110/07/13","凱基-南崁",2133,63,2070
"8672","2363矽統","110/07/13","凱基-幸福",36,4048,-4012
"8673","2363矽統","110/07/13","國泰-敦南",2195,1617,578
"8674","2363矽統","110/07/13","統一",192,3325,-3133
"8675","2363矽統","110/07/13","中農",670,139,531
"8676","2363矽統","110/07/13","新加坡商瑞銀",1000,2747,-1747
"8677","2363矽統","110/07/13","康和-台中",638,154,484
"8678","2363矽統","110/07/13","凱基-台北",5359,6609,-1250
"8679","2363矽統","110/07/13","群益金鼎-三民",577,137,440
"8680","2363矽統","110/07/13","摩根大通",1930,2858,-928
"8681","2363矽統","110/07/13","台新-屏東",510,88,422
"8682","2363矽統","110/07/13","港商野村",960,1679,-719
"8683","2363矽統","110/07/13","德信-中正",455,67,388
"8684","2363矽統","110/07/13","兆豐-復興",25,705,-680
"8685","2363矽統","110/07/13","日盛-竹北",365,70,295
"8686","2363矽統","110/07/13","統一-仁愛",114,755,-641
"8687","2363矽統","110/07/13","元大-佳里",452,189,263
"8688","2363矽統","110/07/13","統一-敦南",29,638,-609
"8689","2363矽統","110/07/13","國票-博愛",296,38,258
"8690","2363矽統","110/07/13","統一-土城",100,704,-604
"8691","2363矽統","110/07/13","元大-萬華",340,95,245
"8692","2363矽統","110/07/13","統一-城中",116,676,-560
"8693","2363矽統","110/07/13","新光",1259,1031,228
"8694","2363矽統","110/07/13","永豐金證券",306,859,-553
"8695","2363矽統","110/07/13","元富-成功",323,96,227
"8696","2363矽統","110/07/13","元富",54,567,-513
"8697","2363矽統","110/07/13","豐農",228,23,205
"8698","2363矽統","110/07/13","瑞士信貸",202,666,-464
"8699","2363矽統","110/07/13","台灣企銀-岡山",186,4,182
"8700","2363矽統","110/07/13","永豐金-嘉義",67,468,-401
"8701","8112至上","110/07/13","摩根大通",688,296,392
"8702","8112至上","110/07/13","國票-中和",0,401,-401
"8703","8112至上","110/07/13","港商野村",344,145,199
"8704","8112至上","110/07/13","永豐金-板盛",0,205,-205
"8705","8112至上","110/07/13","兆豐-公益",195,5,190
"8706","8112至上","110/07/13","凱基-五股",43,155,-112
"8707","8112至上","110/07/13","台灣摩根士丹利",183,0,183
"8708","8112至上","110/07/13","凱基-市政",0,100,-100
"8709","8112至上","110/07/13","群益金鼎-敦南",153,2,151
"8710","8112至上","110/07/13","元大-大里德芳",1,92,-91
"8711","8112至上","110/07/13","臺銀-金山",146,26,120
"8712","8112至上","110/07/13","玉山-桃園",26,110,-84
"8713","8112至上","110/07/13","臺銀",133,19,114
"8714","8112至上","110/07/13","兆豐-天母",0,81,-81
"8715","8112至上","110/07/13","合庫-台中",115,6,109
"8716","8112至上","110/07/13","凱基-城中",3,84,-81
"8717","8112至上","110/07/13","亞東-板橋",134,26,108
"8718","8112至上","110/07/13","日盛-新莊",9,85,-76
"8719","8112至上","110/07/13","凱基-台北",414,326,88
"8720","8112至上","110/07/13","日盛-台中",2,64,-62
"8721","8112至上","110/07/13","新加坡商瑞銀",181,100,81
"8722","8112至上","110/07/13","日盛-中壢",3,64,-61
"8723","8112至上","110/07/13","國泰-敦南",108,31,77
"8724","8112至上","110/07/13","元大-台中",2,59,-57
"8725","8112至上","110/07/13","第一金-華江",77,4,73
"8726","8112至上","110/07/13","元大-雙和",7,64,-57
"8727","8112至上","110/07/13","永豐金-內湖",73,1,72
"8728","8112至上","110/07/13","元大-高雄",8,62,-54
"8729","8112至上","110/07/13","元大-永和",68,1,67
"8730","8112至上","110/07/13","元大-館前",2,55,-53
"8731","4903聯光通","110/07/13","台灣企銀-太平",56,0,56
"8732","4903聯光通","110/07/13","土銀",0,32,-32
"8733","4903聯光通","110/07/13","元富-新興",23,0,23
"8734","4903聯光通","110/07/13","元大-樹林",0,19,-19
"8735","4903聯光通","110/07/13","日盛-樹林",22,0,22
"8736","4903聯光通","110/07/13","凱基-士林",0,17,-17
"8737","4903聯光通","110/07/13","兆豐-天母",20,0,20
"8738","4903聯光通","110/07/13","國票-博愛",0,14,-14
"8739","4903聯光通","110/07/13","華南永昌-桃園",20,0,20
"8740","4903聯光通","110/07/13","元富",0,10,-10
"8741","4903聯光通","110/07/13","富邦-新店",10,0,10
"8742","4903聯光通","110/07/13","新光",0,10,-10
"8743","4903聯光通","110/07/13","新光-台中",5,0,5
"8744","4903聯光通","110/07/13","玉山-南京東路",0,10,-10
"8745","4903聯光通","110/07/13","華南永昌-台中",5,0,5
"8746","4903聯光通","110/07/13","富邦-陽明",0,10,-10
"8747","4903聯光通","110/07/13","元大-崇德",5,0,5
"8748","4903聯光通","110/07/13","元大-大甲",0,8,-8
"8749","4903聯光通","110/07/13","元大-草屯",5,0,5
"8750","4903聯光通","110/07/13","富邦-台中",0,7,-7
"8751","4903聯光通","110/07/13","元富-草屯",4,0,4
"8752","4903聯光通","110/07/13","凱基-中壢",0,6,-6
"8753","4903聯光通","110/07/13","元大-清水",4,0,4
"8754","4903聯光通","110/07/13","臺銀-民權",0,5,-5
"8755","4903聯光通","110/07/13","元大-東泰",4,0,4
"8756","4903聯光通","110/07/13","日盛-板橋",0,5,-5
"8757","4903聯光通","110/07/13","元大-佳里",2,0,2
"8758","4903聯光通","110/07/13","中國信託-忠孝",0,5,-5
"8759","4903聯光通","110/07/13","永豐金-板橋",2,0,2
"8760","4903聯光通","110/07/13","永豐金-鳳山",0,5,-5
"8761","2929淘帝","110/07/13","玉山-新竹",130,0,130
"8762","2929淘帝","110/07/13","美商高盛",0,177,-177
"8763","2929淘帝","110/07/13","臺銀-民權",60,0,60
"8764","2929淘帝","110/07/13","凱基-台北",6,80,-74
"8765","2929淘帝","110/07/13","新百王",31,0,31
"8766","2929淘帝","110/07/13","元富-大裕",0,49,-49
"8767","2929淘帝","110/07/13","日盛-園區",30,0,30
"8768","2929淘帝","110/07/13","國泰-館前",3,51,-48
"8769","2929淘帝","110/07/13","元大-南投",31,1,30
"8770","2929淘帝","110/07/13","凱基-中壢",0,41,-41
"8771","2929淘帝","110/07/13","兆豐-忠孝",28,0,28
"8772","2929淘帝","110/07/13","港商野村",21,55,-34
"8773","2929淘帝","110/07/13","元大-民生",28,0,28
"8774","2929淘帝","110/07/13","華南永昌-南京",2,34,-32
"8775","2929淘帝","110/07/13","合庫-高雄",27,0,27
"8776","2929淘帝","110/07/13","群益金鼎-土城",0,30,-30
"8777","2929淘帝","110/07/13","凱基-豐中",27,0,27
"8778","2929淘帝","110/07/13","富邦-南屯",0,22,-22
"8779","2929淘帝","110/07/13","新光",21,4,17
"8780","2929淘帝","110/07/13","第一金-豐原",0,20,-20
"8781","2929淘帝","110/07/13","元大-天母",17,0,17
"8782","2929淘帝","110/07/13","元大-屏南",6,26,-20
"8783","2929淘帝","110/07/13","永興",14,0,14
"8784","2929淘帝","110/07/13","永豐金-敦南",1,21,-20
"8785","2929淘帝","110/07/13","富邦-台北",12,0,12
"8786","2929淘帝","110/07/13","凱基-三重",2,21,-19
"8787","2929淘帝","110/07/13","元大-永和",12,0,12
"8788","2929淘帝","110/07/13","富邦-仁愛",7,25,-18
"8789","2929淘帝","110/07/13","國票-天祥",11,0,11
"8790","2929淘帝","110/07/13","元大-北投",0,16,-16
"8791","5410國眾","110/07/13","兆豐-城中",274,0,274
"8792","5410國眾","110/07/13","元富-嘉義",0,103,-103
"8793","5410國眾","110/07/13","新光",50,4,46
"8794","5410國眾","110/07/13","凱基-台北",0,50,-50
"8795","5410國眾","110/07/13","國泰-台中",26,0,26
"8796","5410國眾","110/07/13","瑞士信貸",0,31,-31
"8797","5410國眾","110/07/13","新加坡商瑞銀",22,0,22
"8798","5410國眾","110/07/13","台新-新莊",0,27,-27
"8799","5410國眾","110/07/13","光和-嘉義",20,0,20
"8800","5410國眾","110/07/13","元大-汐止",0,20,-20
"8801","5410國眾","110/07/13","凱基-竹北",17,0,17
"8802","5410國眾","110/07/13","亞東-新竹",0,17,-17
"8803","5410國眾","110/07/13","新光-桃園",15,0,15
"8804","5410國眾","110/07/13","元大-南勢角",0,13,-13
"8805","5410國眾","110/07/13","凱基-台東",14,0,14
"8806","5410國眾","110/07/13","台新-台南",0,12,-12
"8807","5410國眾","110/07/13","富邦-竹北",11,0,11
"8808","5410國眾","110/07/13","中國信託",0,11,-11
"8809","5410國眾","110/07/13","元富-同大",10,0,10
"8810","5410國眾","110/07/13","華南永昌",0,11,-11
"8811","5410國眾","110/07/13","國泰-敦南",24,15,9
"8812","5410國眾","110/07/13","臺銀-臺南",0,10,-10
"8813","5410國眾","110/07/13","日盛-內湖",7,0,7
"8814","5410國眾","110/07/13","台灣企銀-民雄",0,10,-10
"8815","5410國眾","110/07/13","台新-左楠",7,0,7
"8816","5410國眾","110/07/13","高橋",0,10,-10
"8817","5410國眾","110/07/13","元大-新盛",18,12,6
"8818","5410國眾","110/07/13","康和-嘉義",0,10,-10
"8819","5410國眾","110/07/13","統一",5,0,5
"8820","5410國眾","110/07/13","凱基-基隆",0,10,-10
"8821","2841台開","110/07/13","中國信託-高雄",251,50,201
"8822","2841台開","110/07/13","兆豐-公益",0,177,-177
"8823","2841台開","110/07/13","日盛證券",210,13,197
"8824","2841台開","110/07/13","日進",0,152,-152
"8825","2841台開","110/07/13","第一金-台中",55,0,55
"8826","2841台開","110/07/13","港商野村",0,109,-109
"8827","2841台開","110/07/13","國泰-板橋",46,0,46
"8828","2841台開","110/07/13","日盛-信義",0,103,-103
"8829","2841台開","110/07/13","國泰-館前",48,3,45
"8830","2841台開","110/07/13","國泰-敦南",11,75,-64
"8831","2841台開","110/07/13","華南永昌-新莊",45,0,45
"8832","2841台開","110/07/13","永興",0,50,-50
"8833","2841台開","110/07/13","日盛-園區",42,0,42
"8834","2841台開","110/07/13","永豐金-敦南",61,104,-43
"8835","2841台開","110/07/13","台新證券",32,0,32
"8836","2841台開","110/07/13","富邦-台南",0,42,-42
"8837","2841台開","110/07/13","台新-高雄",32,2,30
"8838","2841台開","110/07/13","國票-安和",0,30,-30
"8839","2841台開","110/07/13","豐農",23,0,23
"8840","2841台開","110/07/13","元大-桃園",0,25,-25
"8841","2841台開","110/07/13","合庫-嘉義",20,0,20
"8842","2841台開","110/07/13","新光",8,32,-24
"8843","2841台開","110/07/13","華南永昌-高雄",20,0,20
"8844","2841台開","110/07/13","元大-仁愛",0,24,-24
"8845","2841台開","110/07/13","元大-樹林",16,0,16
"8846","2841台開","110/07/13","日盛-中和",0,20,-20
"8847","2841台開","110/07/13","第一金-華江",15,2,13
"8848","2841台開","110/07/13","元富",0,20,-20
"8849","2841台開","110/07/13","美商高盛",12,0,12
"8850","2841台開","110/07/13","富邦-宜蘭",0,20,-20
"8851","6207雷科","110/07/13","元大-高雄",121,0,121
"8852","6207雷科","110/07/13","華南永昌-朴子",1,60,-59
"8853","6207雷科","110/07/13","第一金-新興",20,0,20
"8854","6207雷科","110/07/13","元大-南海",0,36,-36
"8855","6207雷科","110/07/13","元富-三重",20,0,20
"8856","6207雷科","110/07/13","凱基-土城",0,35,-35
"8857","6207雷科","110/07/13","元大-林園",15,0,15
"8858","6207雷科","110/07/13","台灣企銀",0,20,-20
"8859","6207雷科","110/07/13","元大-金華",16,1,15
"8860","6207雷科","110/07/13","群益金鼎-丹鳳",0,20,-20
"8861","6207雷科","110/07/13","日盛證券",10,0,10
"8862","6207雷科","110/07/13","元大-博愛",0,17,-17
"8863","6207雷科","110/07/13","統一-台中",10,0,10
"8864","6207雷科","110/07/13","元大-北港",0,13,-13
"8865","6207雷科","110/07/13","群益金鼎-土城",10,0,10
"8866","6207雷科","110/07/13","新加坡商瑞銀",0,12,-12
"8867","6207雷科","110/07/13","群益金鼎-桃園",10,0,10
"8868","6207雷科","110/07/13","凱基-台北",4,16,-12
"8869","6207雷科","110/07/13","永豐金-新莊",10,0,10
"8870","6207雷科","110/07/13","日茂-埔里",0,11,-11
"8871","6207雷科","110/07/13","永豐金-新店",10,0,10
"8872","6207雷科","110/07/13","元大-莒光",0,11,-11
"8873","6207雷科","110/07/13","元大證券",9,0,9
"8874","6207雷科","110/07/13","統一-新竹",0,10,-10
"8875","6207雷科","110/07/13","日盛-木柵",9,1,8
"8876","6207雷科","110/07/13","元大-西螺",0,10,-10
"8877","6207雷科","110/07/13","兆豐-來福",8,0,8
"8878","6207雷科","110/07/13","康和-台中",0,8,-8
"8879","6207雷科","110/07/13","新光",7,0,7
"8880","6207雷科","110/07/13","兆豐-高雄",0,6,-6
"8881","3679新至陞","110/07/13","永豐金證券",50,0,50
"8882","3679新至陞","110/07/13","摩根大通",2,25,-23
"8883","3679新至陞","110/07/13","國泰-桃園",22,0,22
"8884","3679新至陞","110/07/13","元大-成功",0,22,-22
"8885","3679新至陞","110/07/13","台中銀-員林",11,0,11
"8886","3679新至陞","110/07/13","富邦-板橋",1,19,-18
"8887","3679新至陞","110/07/13","元大-文心興安",8,0,8
"8888","3679新至陞","110/07/13","日盛-新莊",0,10,-10
"8889","3679新至陞","110/07/13","美商高盛",6,0,6
"8890","3679新至陞","110/07/13","台新-台中",0,10,-10
"8891","3679新至陞","110/07/13","台新-高雄",6,0,6
"8892","3679新至陞","110/07/13","永豐金-新竹",0,8,-8
"8893","3679新至陞","110/07/13","凱基-台北",18,12,6
"8894","3679新至陞","110/07/13","瑞士信貸",12,19,-7
"8895","3679新至陞","110/07/13","日盛-復興",5,0,5
"8896","3679新至陞","110/07/13","統一-南京",0,7,-7
"8897","3679新至陞","110/07/13","(牛牛牛)亞-鑫豐",4,0,4
"8898","3679新至陞","110/07/13","凱基-新莊",0,7,-7
"8899","3679新至陞","110/07/13","元富-大昌",3,0,3
"8900","3679新至陞","110/07/13","新加坡商瑞銀",0,6,-6
"8901","3679新至陞","110/07/13","富邦-台北",3,0,3
"8902","3679新至陞","110/07/13","合庫-自強",0,5,-5
"8903","3679新至陞","110/07/13","日盛-樹林",2,0,2
"8904","3679新至陞","110/07/13","富邦-桃園",0,5,-5
"8905","3679新至陞","110/07/13","宏遠-光隆",2,0,2
"8906","3679新至陞","110/07/13","永豐金-潮州",0,4,-4
"8907","3679新至陞","110/07/13","美林",3,1,2
"8908","3679新至陞","110/07/13","臺銀-臺南",0,3,-3
"8909","3679新至陞","110/07/13","第一金-中壢",2,0,2
"8910","3679新至陞","110/07/13","元大-六合",0,3,-3
"8911","2727王品","110/07/13","富邦-台北",43,3,40
"8912","2727王品","110/07/13","台灣摩根士丹利",15,97,-82
"8913","2727王品","110/07/13","元大-基隆孝二",40,0,40
"8914","2727王品","110/07/13","玉山-台南",5,57,-52
"8915","2727王品","110/07/13","國票-新莊",40,1,39
"8916","2727王品","110/07/13","新加坡商瑞銀",0,48,-48
"8917","2727王品","110/07/13","第一金-豐原",66,42,24
"8918","2727王品","110/07/13","凱基-台北",41,77,-36
"8919","2727王品","110/07/13","永豐金-大園",34,10,24
"8920","2727王品","110/07/13","永豐金-永康",0,22,-22
"8921","2727王品","110/07/13","元大-北屯",22,0,22
"8922","2727王品","110/07/13","統一-台中",2,22,-20
"8923","2727王品","110/07/13","元大-東蘆",26,7,19
"8924","2727王品","110/07/13","國泰-台中",21,39,-18
"8925","2727王品","110/07/13","永豐金-萬盛",13,1,12
"8926","2727王品","110/07/13","合庫-彰化",3,20,-17
"8927","2727王品","110/07/13","日盛-嘉義",11,0,11
"8928","2727王品","110/07/13","港商野村",13,30,-17
"8929","2727王品","110/07/13","日盛-八德",11,0,11
"8930","2727王品","110/07/13","元大-楊梅",1,16,-15
"8931","2727王品","110/07/13","統一-竹南",11,0,11
"8932","2727王品","110/07/13","凱基-高美館",2,15,-13
"8933","2727王品","110/07/13","日盛-士林",12,2,10
"8934","2727王品","110/07/13","美商高盛",2,14,-12
"8935","2727王品","110/07/13","統一-敦南",10,0,10
"8936","2727王品","110/07/13","統一-平鎮",1,13,-12
"8937","2727王品","110/07/13","中國信託",15,5,10
"8938","2727王品","110/07/13","兆豐-台中港",4,16,-12
"8939","2727王品","110/07/13","兆豐-竹北",13,3,10
"8940","2727王品","110/07/13","凱基-八德",1,13,-12
"8941","1570力肯","110/07/13","新光",115,11,104
"8942","1570力肯","110/07/13","元大-北三重",0,162,-162
"8943","1570力肯","110/07/13","群益金鼎-高雄",54,0,54
"8944","1570力肯","110/07/13","元大-大灣",0,25,-25
"8945","1570力肯","110/07/13","國票-新莊",22,0,22
"8946","1570力肯","110/07/13","永豐金-苓雅",0,22,-22
"8947","1570力肯","110/07/13","日盛-桃園",12,0,12
"8948","1570力肯","110/07/13","永豐金-永康",0,19,-19
"8949","1570力肯","110/07/13","元大-高雄",12,0,12
"8950","1570力肯","110/07/13","富邦-員林",0,15,-15
"8951","1570力肯","110/07/13","合庫-自強",11,0,11
"8952","1570力肯","110/07/13","凱基-台南",0,11,-11
"8953","1570力肯","110/07/13","摩根大通",26,15,11
"8954","1570力肯","110/07/13","日盛-竹北",0,10,-10
"8955","1570力肯","110/07/13","永豐金-中盛",11,0,11
"8956","1570力肯","110/07/13","國票-九鼎",0,10,-10
"8957","1570力肯","110/07/13","兆豐-台中港",10,0,10
"8958","1570力肯","110/07/13","凱基-桃園",0,10,-10
"8959","1570力肯","110/07/13","國泰-松江",9,0,9
"8960","1570力肯","110/07/13","凱基-新豐",0,10,-10
"8961","1570力肯","110/07/13","元大-新盛",9,0,9
"8962","1570力肯","110/07/13","元大-學甲",0,10,-10
"8963","1570力肯","110/07/13","元富-緯城",6,0,6
"8964","1570力肯","110/07/13","群益金鼎-東湖",1,10,-9
"8965","1570力肯","110/07/13","統一-三重",5,0,5
"8966","1570力肯","110/07/13","大昌",0,6,-6
"8967","1570力肯","110/07/13","元大-前金",5,0,5
"8968","1570力肯","110/07/13","元大-土城學府",0,6,-6
"8969","1570力肯","110/07/13","永豐金證券",5,0,5
"8970","1570力肯","110/07/13","統一",0,5,-5
"8971","6180橘子","110/07/13","摩根大通",119,0,119
"8972","6180橘子","110/07/13","元大-崇德",2,61,-59
"8973","6180橘子","110/07/13","美商高盛",96,0,96
"8974","6180橘子","110/07/13","康和-台中",0,51,-51
"8975","6180橘子","110/07/13","新加坡商瑞銀",86,7,79
"8976","6180橘子","110/07/13","康和-台北",0,50,-50
"8977","6180橘子","110/07/13","元大-和平",40,0,40
"8978","6180橘子","110/07/13","元富-潮州",0,40,-40
"8979","6180橘子","110/07/13","凱基-台北",83,47,36
"8980","6180橘子","110/07/13","日盛-永康",0,26,-26
"8981","6180橘子","110/07/13","美林",39,5,34
"8982","6180橘子","110/07/13","永豐金-中正",0,24,-24
"8983","6180橘子","110/07/13","富邦-新竹華信",31,2,29
"8984","6180橘子","110/07/13","國泰-板橋",2,25,-23
"8985","6180橘子","110/07/13","統一-南京",21,0,21
"8986","6180橘子","110/07/13","日盛-大墩",0,20,-20
"8987","6180橘子","110/07/13","富邦-陽明",24,3,21
"8988","6180橘子","110/07/13","元大-草屯",13,32,-19
"8989","6180橘子","110/07/13","大昌-樹林",21,1,20
"8990","6180橘子","110/07/13","元富-林園",1,18,-17
"8991","6180橘子","110/07/13","花旗環球",19,0,19
"8992","6180橘子","110/07/13","新光-新竹",1,18,-17
"8993","6180橘子","110/07/13","華南永昌-台南",19,0,19
"8994","6180橘子","110/07/13","元大-土城永寧",0,17,-17
"8995","6180橘子","110/07/13","福勝",14,0,14
"8996","6180橘子","110/07/13","國泰-新莊",3,19,-16
"8997","6180橘子","110/07/13","富邦-嘉義",12,1,11
"8998","6180橘子","110/07/13","中國信託-永康",6,21,-15
"8999","6180橘子","110/07/13","元大-板橋三民",11,0,11
"9000","6180橘子","110/07/13","凱基-東港",1,15,-14
"9001","2390云辰","110/07/13","新加坡商瑞銀",562,75,487
"9002","2390云辰","110/07/13","大展-台南",0,532,-532
"9003","2390云辰","110/07/13","台灣摩根士丹利",330,155,175
"9004","2390云辰","110/07/13","凱基-台北",668,854,-186
"9005","2390云辰","110/07/13","兆豐-公益",126,25,101
"9006","2390云辰","110/07/13","凱基-三重",12,172,-160
"9007","2390云辰","110/07/13","元富-中港",100,2,98
"9008","2390云辰","110/07/13","兆豐-忠孝",4,161,-157
"9009","2390云辰","110/07/13","統一-新台中",106,9,97
"9010","2390云辰","110/07/13","元大-士林",19,170,-151
"9011","2390云辰","110/07/13","中國信託-松江",81,11,70
"9012","2390云辰","110/07/13","臺銀-新竹",14,117,-103
"9013","2390云辰","110/07/13","日盛-板橋",72,3,69
"9014","2390云辰","110/07/13","國票-台中",4,102,-98
"9015","2390云辰","110/07/13","日盛-和美",57,0,57
"9016","2390云辰","110/07/13","新光",147,232,-85
"9017","2390云辰","110/07/13","永豐金-桃園",88,36,52
"9018","2390云辰","110/07/13","致和-崇德",2,70,-68
"9019","2390云辰","110/07/13","玉山-士林",54,4,50
"9020","2390云辰","110/07/13","群益金鼎-屏東",2,70,-68
"9021","2390云辰","110/07/13","富邦-仁愛",56,6,50
"9022","2390云辰","110/07/13","元大-大里",35,98,-63
"9023","2390云辰","110/07/13","第一金-豐原",50,1,49
"9024","2390云辰","110/07/13","元大-萬華",35,94,-59
"9025","2390云辰","110/07/13","摩根大通",502,453,49
"9026","2390云辰","110/07/13","元富-吉利",2,60,-58
"9027","2390云辰","110/07/13","凱基-松山",61,13,48
"9028","2390云辰","110/07/13","兆豐-新竹",3,53,-50
"9029","2390云辰","110/07/13","大昌",64,22,42
"9030","2390云辰","110/07/13","富邦-嘉義",65,108,-43
"9031","2363矽統","110/07/13","凱基-南崁",2133,63,2070
"9032","2363矽統","110/07/13","凱基-幸福",36,4048,-4012
"9033","2363矽統","110/07/13","國泰-敦南",2195,1617,578
"9034","2363矽統","110/07/13","統一",192,3325,-3133
"9035","2363矽統","110/07/13","中農",670,139,531
"9036","2363矽統","110/07/13","新加坡商瑞銀",1000,2747,-1747
"9037","2363矽統","110/07/13","康和-台中",638,154,484
"9038","2363矽統","110/07/13","凱基-台北",5359,6609,-1250
"9039","2363矽統","110/07/13","群益金鼎-三民",577,137,440
"9040","2363矽統","110/07/13","摩根大通",1930,2858,-928
"9041","2363矽統","110/07/13","台新-屏東",510,88,422
"9042","2363矽統","110/07/13","港商野村",960,1679,-719
"9043","2363矽統","110/07/13","德信-中正",455,67,388
"9044","2363矽統","110/07/13","兆豐-復興",25,705,-680
"9045","2363矽統","110/07/13","日盛-竹北",365,70,295
"9046","2363矽統","110/07/13","統一-仁愛",114,755,-641
"9047","2363矽統","110/07/13","元大-佳里",452,189,263
"9048","2363矽統","110/07/13","統一-敦南",29,638,-609
"9049","2363矽統","110/07/13","國票-博愛",296,38,258
"9050","2363矽統","110/07/13","統一-土城",100,704,-604
"9051","2363矽統","110/07/13","元大-萬華",340,95,245
"9052","2363矽統","110/07/13","統一-城中",116,676,-560
"9053","2363矽統","110/07/13","新光",1259,1031,228
"9054","2363矽統","110/07/13","永豐金證券",306,859,-553
"9055","2363矽統","110/07/13","元富-成功",323,96,227
"9056","2363矽統","110/07/13","元富",54,567,-513
"9057","2363矽統","110/07/13","豐農",228,23,205
"9058","2363矽統","110/07/13","瑞士信貸",202,666,-464
"9059","2363矽統","110/07/13","台灣企銀-岡山",186,4,182
"9060","2363矽統","110/07/13","永豐金-嘉義",67,468,-401
"9061","8112至上","110/07/13","摩根大通",688,296,392
"9062","8112至上","110/07/13","國票-中和",0,401,-401
"9063","8112至上","110/07/13","港商野村",344,145,199
"9064","8112至上","110/07/13","永豐金-板盛",0,205,-205
"9065","8112至上","110/07/13","兆豐-公益",195,5,190
"9066","8112至上","110/07/13","凱基-五股",43,155,-112
"9067","8112至上","110/07/13","台灣摩根士丹利",183,0,183
"9068","8112至上","110/07/13","凱基-市政",0,100,-100
"9069","8112至上","110/07/13","群益金鼎-敦南",153,2,151
"9070","8112至上","110/07/13","元大-大里德芳",1,92,-91
"9071","8112至上","110/07/13","臺銀-金山",146,26,120
"9072","8112至上","110/07/13","玉山-桃園",26,110,-84
"9073","8112至上","110/07/13","臺銀",133,19,114
"9074","8112至上","110/07/13","兆豐-天母",0,81,-81
"9075","8112至上","110/07/13","合庫-台中",115,6,109
"9076","8112至上","110/07/13","凱基-城中",3,84,-81
"9077","8112至上","110/07/13","亞東-板橋",134,26,108
"9078","8112至上","110/07/13","日盛-新莊",9,85,-76
"9079","8112至上","110/07/13","凱基-台北",414,326,88
"9080","8112至上","110/07/13","日盛-台中",2,64,-62
"9081","8112至上","110/07/13","新加坡商瑞銀",181,100,81
"9082","8112至上","110/07/13","日盛-中壢",3,64,-61
"9083","8112至上","110/07/13","國泰-敦南",108,31,77
"9084","8112至上","110/07/13","元大-台中",2,59,-57
"9085","8112至上","110/07/13","第一金-華江",77,4,73
"9086","8112至上","110/07/13","元大-雙和",7,64,-57
"9087","8112至上","110/07/13","永豐金-內湖",73,1,72
"9088","8112至上","110/07/13","元大-高雄",8,62,-54
"9089","8112至上","110/07/13","元大-永和",68,1,67
"9090","8112至上","110/07/13","元大-館前",2,55,-53
"9091","4903聯光通","110/07/13","台灣企銀-太平",56,0,56
"9092","4903聯光通","110/07/13","土銀",0,32,-32
"9093","4903聯光通","110/07/13","元富-新興",23,0,23
"9094","4903聯光通","110/07/13","元大-樹林",0,19,-19
"9095","4903聯光通","110/07/13","日盛-樹林",22,0,22
"9096","4903聯光通","110/07/13","凱基-士林",0,17,-17
"9097","4903聯光通","110/07/13","兆豐-天母",20,0,20
"9098","4903聯光通","110/07/13","國票-博愛",0,14,-14
"9099","4903聯光通","110/07/13","華南永昌-桃園",20,0,20
"9100","4903聯光通","110/07/13","元富",0,10,-10
"9101","4903聯光通","110/07/13","富邦-新店",10,0,10
"9102","4903聯光通","110/07/13","新光",0,10,-10
"9103","4903聯光通","110/07/13","新光-台中",5,0,5
"9104","4903聯光通","110/07/13","玉山-南京東路",0,10,-10
"9105","4903聯光通","110/07/13","華南永昌-台中",5,0,5
"9106","4903聯光通","110/07/13","富邦-陽明",0,10,-10
"9107","4903聯光通","110/07/13","元大-崇德",5,0,5
"9108","4903聯光通","110/07/13","元大-大甲",0,8,-8
"9109","4903聯光通","110/07/13","元大-草屯",5,0,5
"9110","4903聯光通","110/07/13","富邦-台中",0,7,-7
"9111","4903聯光通","110/07/13","元富-草屯",4,0,4
"9112","4903聯光通","110/07/13","凱基-中壢",0,6,-6
"9113","4903聯光通","110/07/13","元大-清水",4,0,4
"9114","4903聯光通","110/07/13","臺銀-民權",0,5,-5
"9115","4903聯光通","110/07/13","元大-東泰",4,0,4
"9116","4903聯光通","110/07/13","日盛-板橋",0,5,-5
"9117","4903聯光通","110/07/13","元大-佳里",2,0,2
"9118","4903聯光通","110/07/13","中國信託-忠孝",0,5,-5
"9119","4903聯光通","110/07/13","永豐金-板橋",2,0,2
"9120","4903聯光通","110/07/13","永豐金-鳳山",0,5,-5
"9121","2929淘帝","110/07/13","玉山-新竹",130,0,130
"9122","2929淘帝","110/07/13","美商高盛",0,177,-177
"9123","2929淘帝","110/07/13","臺銀-民權",60,0,60
"9124","2929淘帝","110/07/13","凱基-台北",6,80,-74
"9125","2929淘帝","110/07/13","新百王",31,0,31
"9126","2929淘帝","110/07/13","元富-大裕",0,49,-49
"9127","2929淘帝","110/07/13","日盛-園區",30,0,30
"9128","2929淘帝","110/07/13","國泰-館前",3,51,-48
"9129","2929淘帝","110/07/13","元大-南投",31,1,30
"9130","2929淘帝","110/07/13","凱基-中壢",0,41,-41
"9131","2929淘帝","110/07/13","兆豐-忠孝",28,0,28
"9132","2929淘帝","110/07/13","港商野村",21,55,-34
"9133","2929淘帝","110/07/13","元大-民生",28,0,28
"9134","2929淘帝","110/07/13","華南永昌-南京",2,34,-32
"9135","2929淘帝","110/07/13","合庫-高雄",27,0,27
"9136","2929淘帝","110/07/13","群益金鼎-土城",0,30,-30
"9137","2929淘帝","110/07/13","凱基-豐中",27,0,27
"9138","2929淘帝","110/07/13","富邦-南屯",0,22,-22
"9139","2929淘帝","110/07/13","新光",21,4,17
"9140","2929淘帝","110/07/13","第一金-豐原",0,20,-20
"9141","2929淘帝","110/07/13","元大-天母",17,0,17
"9142","2929淘帝","110/07/13","元大-屏南",6,26,-20
"9143","2929淘帝","110/07/13","永興",14,0,14
"9144","2929淘帝","110/07/13","永豐金-敦南",1,21,-20
"9145","2929淘帝","110/07/13","富邦-台北",12,0,12
"9146","2929淘帝","110/07/13","凱基-三重",2,21,-19
"9147","2929淘帝","110/07/13","元大-永和",12,0,12
"9148","2929淘帝","110/07/13","富邦-仁愛",7,25,-18
"9149","2929淘帝","110/07/13","國票-天祥",11,0,11
"9150","2929淘帝","110/07/13","元大-北投",0,16,-16
"9151","5410國眾","110/07/13","兆豐-城中",274,0,274
"9152","5410國眾","110/07/13","元富-嘉義",0,103,-103
"9153","5410國眾","110/07/13","新光",50,4,46
"9154","5410國眾","110/07/13","凱基-台北",0,50,-50
"9155","5410國眾","110/07/13","國泰-台中",26,0,26
"9156","5410國眾","110/07/13","瑞士信貸",0,31,-31
"9157","5410國眾","110/07/13","新加坡商瑞銀",22,0,22
"9158","5410國眾","110/07/13","台新-新莊",0,27,-27
"9159","5410國眾","110/07/13","光和-嘉義",20,0,20
"9160","5410國眾","110/07/13","元大-汐止",0,20,-20
"9161","5410國眾","110/07/13","凱基-竹北",17,0,17
"9162","5410國眾","110/07/13","亞東-新竹",0,17,-17
"9163","5410國眾","110/07/13","新光-桃園",15,0,15
"9164","5410國眾","110/07/13","元大-南勢角",0,13,-13
"9165","5410國眾","110/07/13","凱基-台東",14,0,14
"9166","5410國眾","110/07/13","台新-台南",0,12,-12
"9167","5410國眾","110/07/13","富邦-竹北",11,0,11
"9168","5410國眾","110/07/13","中國信託",0,11,-11
"9169","5410國眾","110/07/13","元富-同大",10,0,10
"9170","5410國眾","110/07/13","華南永昌",0,11,-11
"9171","5410國眾","110/07/13","國泰-敦南",24,15,9
"9172","5410國眾","110/07/13","臺銀-臺南",0,10,-10
"9173","5410國眾","110/07/13","日盛-內湖",7,0,7
"9174","5410國眾","110/07/13","台灣企銀-民雄",0,10,-10
"9175","5410國眾","110/07/13","台新-左楠",7,0,7
"9176","5410國眾","110/07/13","高橋",0,10,-10
"9177","5410國眾","110/07/13","元大-新盛",18,12,6
"9178","5410國眾","110/07/13","康和-嘉義",0,10,-10
"9179","5410國眾","110/07/13","統一",5,0,5
"9180","5410國眾","110/07/13","凱基-基隆",0,10,-10
"9181","2841台開","110/07/13","中國信託-高雄",251,50,201
"9182","2841台開","110/07/13","兆豐-公益",0,177,-177
"9183","2841台開","110/07/13","日盛證券",210,13,197
"9184","2841台開","110/07/13","日進",0,152,-152
"9185","2841台開","110/07/13","第一金-台中",55,0,55
"9186","2841台開","110/07/13","港商野村",0,109,-109
"9187","2841台開","110/07/13","國泰-板橋",46,0,46
"9188","2841台開","110/07/13","日盛-信義",0,103,-103
"9189","2841台開","110/07/13","國泰-館前",48,3,45
"9190","2841台開","110/07/13","國泰-敦南",11,75,-64
"9191","2841台開","110/07/13","華南永昌-新莊",45,0,45
"9192","2841台開","110/07/13","永興",0,50,-50
"9193","2841台開","110/07/13","日盛-園區",42,0,42
"9194","2841台開","110/07/13","永豐金-敦南",61,104,-43
"9195","2841台開","110/07/13","台新證券",32,0,32
"9196","2841台開","110/07/13","富邦-台南",0,42,-42
"9197","2841台開","110/07/13","台新-高雄",32,2,30
"9198","2841台開","110/07/13","國票-安和",0,30,-30
"9199","2841台開","110/07/13","豐農",23,0,23
"9200","2841台開","110/07/13","元大-桃園",0,25,-25
"9201","2841台開","110/07/13","合庫-嘉義",20,0,20
"9202","2841台開","110/07/13","新光",8,32,-24
"9203","2841台開","110/07/13","華南永昌-高雄",20,0,20
"9204","2841台開","110/07/13","元大-仁愛",0,24,-24
"9205","2841台開","110/07/13","元大-樹林",16,0,16
"9206","2841台開","110/07/13","日盛-中和",0,20,-20
"9207","2841台開","110/07/13","第一金-華江",15,2,13
"9208","2841台開","110/07/13","元富",0,20,-20
"9209","2841台開","110/07/13","美商高盛",12,0,12
"9210","2841台開","110/07/13","富邦-宜蘭",0,20,-20
"9211","6207雷科","110/07/13","元大-高雄",121,0,121
"9212","6207雷科","110/07/13","華南永昌-朴子",1,60,-59
"9213","6207雷科","110/07/13","第一金-新興",20,0,20
"9214","6207雷科","110/07/13","元大-南海",0,36,-36
"9215","6207雷科","110/07/13","元富-三重",20,0,20
"9216","6207雷科","110/07/13","凱基-土城",0,35,-35
"9217","6207雷科","110/07/13","元大-林園",15,0,15
"9218","6207雷科","110/07/13","台灣企銀",0,20,-20
"9219","6207雷科","110/07/13","元大-金華",16,1,15
"9220","6207雷科","110/07/13","群益金鼎-丹鳳",0,20,-20
"9221","6207雷科","110/07/13","日盛證券",10,0,10
"9222","6207雷科","110/07/13","元大-博愛",0,17,-17
"9223","6207雷科","110/07/13","統一-台中",10,0,10
"9224","6207雷科","110/07/13","元大-北港",0,13,-13
"9225","6207雷科","110/07/13","群益金鼎-土城",10,0,10
"9226","6207雷科","110/07/13","新加坡商瑞銀",0,12,-12
"9227","6207雷科","110/07/13","群益金鼎-桃園",10,0,10
"9228","6207雷科","110/07/13","凱基-台北",4,16,-12
"9229","6207雷科","110/07/13","永豐金-新莊",10,0,10
"9230","6207雷科","110/07/13","日茂-埔里",0,11,-11
"9231","6207雷科","110/07/13","永豐金-新店",10,0,10
"9232","6207雷科","110/07/13","元大-莒光",0,11,-11
"9233","6207雷科","110/07/13","元大證券",9,0,9
"9234","6207雷科","110/07/13","統一-新竹",0,10,-10
"9235","6207雷科","110/07/13","日盛-木柵",9,1,8
"9236","6207雷科","110/07/13","元大-西螺",0,10,-10
"9237","6207雷科","110/07/13","兆豐-來福",8,0,8
"9238","6207雷科","110/07/13","康和-台中",0,8,-8
"9239","6207雷科","110/07/13","新光",7,0,7
"9240","6207雷科","110/07/13","兆豐-高雄",0,6,-6
"9241","3679新至陞","110/07/13","永豐金證券",50,0,50
"9242","3679新至陞","110/07/13","摩根大通",2,25,-23
"9243","3679新至陞","110/07/13","國泰-桃園",22,0,22
"9244","3679新至陞","110/07/13","元大-成功",0,22,-22
"9245","3679新至陞","110/07/13","台中銀-員林",11,0,11
"9246","3679新至陞","110/07/13","富邦-板橋",1,19,-18
"9247","3679新至陞","110/07/13","元大-文心興安",8,0,8
"9248","3679新至陞","110/07/13","日盛-新莊",0,10,-10
"9249","3679新至陞","110/07/13","美商高盛",6,0,6
"9250","3679新至陞","110/07/13","台新-台中",0,10,-10
"9251","3679新至陞","110/07/13","台新-高雄",6,0,6
"9252","3679新至陞","110/07/13","永豐金-新竹",0,8,-8
"9253","3679新至陞","110/07/13","凱基-台北",18,12,6
"9254","3679新至陞","110/07/13","瑞士信貸",12,19,-7
"9255","3679新至陞","110/07/13","日盛-復興",5,0,5
"9256","3679新至陞","110/07/13","統一-南京",0,7,-7
"9257","3679新至陞","110/07/13","(牛牛牛)亞-鑫豐",4,0,4
"9258","3679新至陞","110/07/13","凱基-新莊",0,7,-7
"9259","3679新至陞","110/07/13","元富-大昌",3,0,3
"9260","3679新至陞","110/07/13","新加坡商瑞銀",0,6,-6
"9261","3679新至陞","110/07/13","富邦-台北",3,0,3
"9262","3679新至陞","110/07/13","合庫-自強",0,5,-5
"9263","3679新至陞","110/07/13","日盛-樹林",2,0,2
"9264","3679新至陞","110/07/13","富邦-桃園",0,5,-5
"9265","3679新至陞","110/07/13","宏遠-光隆",2,0,2
"9266","3679新至陞","110/07/13","永豐金-潮州",0,4,-4
"9267","3679新至陞","110/07/13","美林",3,1,2
"9268","3679新至陞","110/07/13","臺銀-臺南",0,3,-3
"9269","3679新至陞","110/07/13","第一金-中壢",2,0,2
"9270","3679新至陞","110/07/13","元大-六合",0,3,-3
"9271","2727王品","110/07/13","富邦-台北",43,3,40
"9272","2727王品","110/07/13","台灣摩根士丹利",15,97,-82
"9273","2727王品","110/07/13","元大-基隆孝二",40,0,40
"9274","2727王品","110/07/13","玉山-台南",5,57,-52
"9275","2727王品","110/07/13","國票-新莊",40,1,39
"9276","2727王品","110/07/13","新加坡商瑞銀",0,48,-48
"9277","2727王品","110/07/13","第一金-豐原",66,42,24
"9278","2727王品","110/07/13","凱基-台北",41,77,-36
"9279","2727王品","110/07/13","永豐金-大園",34,10,24
"9280","2727王品","110/07/13","永豐金-永康",0,22,-22
"9281","2727王品","110/07/13","元大-北屯",22,0,22
"9282","2727王品","110/07/13","統一-台中",2,22,-20
"9283","2727王品","110/07/13","元大-東蘆",26,7,19
"9284","2727王品","110/07/13","國泰-台中",21,39,-18
"9285","2727王品","110/07/13","永豐金-萬盛",13,1,12
"9286","2727王品","110/07/13","合庫-彰化",3,20,-17
"9287","2727王品","110/07/13","日盛-嘉義",11,0,11
"9288","2727王品","110/07/13","港商野村",13,30,-17
"9289","2727王品","110/07/13","日盛-八德",11,0,11
"9290","2727王品","110/07/13","元大-楊梅",1,16,-15
"9291","2727王品","110/07/13","統一-竹南",11,0,11
"9292","2727王品","110/07/13","凱基-高美館",2,15,-13
"9293","2727王品","110/07/13","日盛-士林",12,2,10
"9294","2727王品","110/07/13","美商高盛",2,14,-12
"9295","2727王品","110/07/13","統一-敦南",10,0,10
"9296","2727王品","110/07/13","統一-平鎮",1,13,-12
"9297","2727王品","110/07/13","中國信託",15,5,10
"9298","2727王品","110/07/13","兆豐-台中港",4,16,-12
"9299","2727王品","110/07/13","兆豐-竹北",13,3,10
"9300","2727王品","110/07/13","凱基-八德",1,13,-12
"9301","1570力肯","110/07/13","新光",115,11,104
"9302","1570力肯","110/07/13","元大-北三重",0,162,-162
"9303","1570力肯","110/07/13","群益金鼎-高雄",54,0,54
"9304","1570力肯","110/07/13","元大-大灣",0,25,-25
"9305","1570力肯","110/07/13","國票-新莊",22,0,22
"9306","1570力肯","110/07/13","永豐金-苓雅",0,22,-22
"9307","1570力肯","110/07/13","日盛-桃園",12,0,12
"9308","1570力肯","110/07/13","永豐金-永康",0,19,-19
"9309","1570力肯","110/07/13","元大-高雄",12,0,12
"9310","1570力肯","110/07/13","富邦-員林",0,15,-15
"9311","1570力肯","110/07/13","合庫-自強",11,0,11
"9312","1570力肯","110/07/13","凱基-台南",0,11,-11
"9313","1570力肯","110/07/13","摩根大通",26,15,11
"9314","1570力肯","110/07/13","日盛-竹北",0,10,-10
"9315","1570力肯","110/07/13","永豐金-中盛",11,0,11
"9316","1570力肯","110/07/13","國票-九鼎",0,10,-10
"9317","1570力肯","110/07/13","兆豐-台中港",10,0,10
"9318","1570力肯","110/07/13","凱基-桃園",0,10,-10
"9319","1570力肯","110/07/13","國泰-松江",9,0,9
"9320","1570力肯","110/07/13","凱基-新豐",0,10,-10
"9321","1570力肯","110/07/13","元大-新盛",9,0,9
"9322","1570力肯","110/07/13","元大-學甲",0,10,-10
"9323","1570力肯","110/07/13","元富-緯城",6,0,6
"9324","1570力肯","110/07/13","群益金鼎-東湖",1,10,-9
"9325","1570力肯","110/07/13","統一-三重",5,0,5
"9326","1570力肯","110/07/13","大昌",0,6,-6
"9327","1570力肯","110/07/13","元大-前金",5,0,5
"9328","1570力肯","110/07/13","元大-土城學府",0,6,-6
"9329","1570力肯","110/07/13","永豐金證券",5,0,5
"9330","1570力肯","110/07/13","統一",0,5,-5
"9331","6180橘子","110/07/13","摩根大通",119,0,119
"9332","6180橘子","110/07/13","元大-崇德",2,61,-59
"9333","6180橘子","110/07/13","美商高盛",96,0,96
"9334","6180橘子","110/07/13","康和-台中",0,51,-51
"9335","6180橘子","110/07/13","新加坡商瑞銀",86,7,79
"9336","6180橘子","110/07/13","康和-台北",0,50,-50
"9337","6180橘子","110/07/13","元大-和平",40,0,40
"9338","6180橘子","110/07/13","元富-潮州",0,40,-40
"9339","6180橘子","110/07/13","凱基-台北",83,47,36
"9340","6180橘子","110/07/13","日盛-永康",0,26,-26
"9341","6180橘子","110/07/13","美林",39,5,34
"9342","6180橘子","110/07/13","永豐金-中正",0,24,-24
"9343","6180橘子","110/07/13","富邦-新竹華信",31,2,29
"9344","6180橘子","110/07/13","國泰-板橋",2,25,-23
"9345","6180橘子","110/07/13","統一-南京",21,0,21
"9346","6180橘子","110/07/13","日盛-大墩",0,20,-20
"9347","6180橘子","110/07/13","富邦-陽明",24,3,21
"9348","6180橘子","110/07/13","元大-草屯",13,32,-19
"9349","6180橘子","110/07/13","大昌-樹林",21,1,20
"9350","6180橘子","110/07/13","元富-林園",1,18,-17
"9351","6180橘子","110/07/13","花旗環球",19,0,19
"9352","6180橘子","110/07/13","新光-新竹",1,18,-17
"9353","6180橘子","110/07/13","華南永昌-台南",19,0,19
"9354","6180橘子","110/07/13","元大-土城永寧",0,17,-17
"9355","6180橘子","110/07/13","福勝",14,0,14
"9356","6180橘子","110/07/13","國泰-新莊",3,19,-16
"9357","6180橘子","110/07/13","富邦-嘉義",12,1,11
"9358","6180橘子","110/07/13","中國信託-永康",6,21,-15
"9359","6180橘子","110/07/13","元大-板橋三民",11,0,11
"9360","6180橘子","110/07/13","凱基-東港",1,15,-14
"9361","2390云辰","110/07/13","新加坡商瑞銀",562,75,487
"9362","2390云辰","110/07/13","大展-台南",0,532,-532
"9363","2390云辰","110/07/13","台灣摩根士丹利",330,155,175
"9364","2390云辰","110/07/13","凱基-台北",668,854,-186
"9365","2390云辰","110/07/13","兆豐-公益",126,25,101
"9366","2390云辰","110/07/13","凱基-三重",12,172,-160
"9367","2390云辰","110/07/13","元富-中港",100,2,98
"9368","2390云辰","110/07/13","兆豐-忠孝",4,161,-157
"9369","2390云辰","110/07/13","統一-新台中",106,9,97
"9370","2390云辰","110/07/13","元大-士林",19,170,-151
"9371","2390云辰","110/07/13","中國信託-松江",81,11,70
"9372","2390云辰","110/07/13","臺銀-新竹",14,117,-103
"9373","2390云辰","110/07/13","日盛-板橋",72,3,69
"9374","2390云辰","110/07/13","國票-台中",4,102,-98
"9375","2390云辰","110/07/13","日盛-和美",57,0,57
"9376","2390云辰","110/07/13","新光",147,232,-85
"9377","2390云辰","110/07/13","永豐金-桃園",88,36,52
"9378","2390云辰","110/07/13","致和-崇德",2,70,-68
"9379","2390云辰","110/07/13","玉山-士林",54,4,50
"9380","2390云辰","110/07/13","群益金鼎-屏東",2,70,-68
"9381","2390云辰","110/07/13","富邦-仁愛",56,6,50
"9382","2390云辰","110/07/13","元大-大里",35,98,-63
"9383","2390云辰","110/07/13","第一金-豐原",50,1,49
"9384","2390云辰","110/07/13","元大-萬華",35,94,-59
"9385","2390云辰","110/07/13","摩根大通",502,453,49
"9386","2390云辰","110/07/13","元富-吉利",2,60,-58
"9387","2390云辰","110/07/13","凱基-松山",61,13,48
"9388","2390云辰","110/07/13","兆豐-新竹",3,53,-50
"9389","2390云辰","110/07/13","大昌",64,22,42
"9390","2390云辰","110/07/13","富邦-嘉義",65,108,-43
"9391","2363矽統","110/07/13","凱基-南崁",2133,63,2070
"9392","2363矽統","110/07/13","凱基-幸福",36,4048,-4012
"9393","2363矽統","110/07/13","國泰-敦南",2195,1617,578
"9394","2363矽統","110/07/13","統一",192,3325,-3133
"9395","2363矽統","110/07/13","中農",670,139,531
"9396","2363矽統","110/07/13","新加坡商瑞銀",1000,2747,-1747
"9397","2363矽統","110/07/13","康和-台中",638,154,484
"9398","2363矽統","110/07/13","凱基-台北",5359,6609,-1250
"9399","2363矽統","110/07/13","群益金鼎-三民",577,137,440
"9400","2363矽統","110/07/13","摩根大通",1930,2858,-928
"9401","2363矽統","110/07/13","台新-屏東",510,88,422
"9402","2363矽統","110/07/13","港商野村",960,1679,-719
"9403","2363矽統","110/07/13","德信-中正",455,67,388
"9404","2363矽統","110/07/13","兆豐-復興",25,705,-680
"9405","2363矽統","110/07/13","日盛-竹北",365,70,295
"9406","2363矽統","110/07/13","統一-仁愛",114,755,-641
"9407","2363矽統","110/07/13","元大-佳里",452,189,263
"9408","2363矽統","110/07/13","統一-敦南",29,638,-609
"9409","2363矽統","110/07/13","國票-博愛",296,38,258
"9410","2363矽統","110/07/13","統一-土城",100,704,-604
"9411","2363矽統","110/07/13","元大-萬華",340,95,245
"9412","2363矽統","110/07/13","統一-城中",116,676,-560
"9413","2363矽統","110/07/13","新光",1259,1031,228
"9414","2363矽統","110/07/13","永豐金證券",306,859,-553
"9415","2363矽統","110/07/13","元富-成功",323,96,227
"9416","2363矽統","110/07/13","元富",54,567,-513
"9417","2363矽統","110/07/13","豐農",228,23,205
"9418","2363矽統","110/07/13","瑞士信貸",202,666,-464
"9419","2363矽統","110/07/13","台灣企銀-岡山",186,4,182
"9420","2363矽統","110/07/13","永豐金-嘉義",67,468,-401
"9421","8112至上","110/07/13","摩根大通",688,296,392
"9422","8112至上","110/07/13","國票-中和",0,401,-401
"9423","8112至上","110/07/13","港商野村",344,145,199
"9424","8112至上","110/07/13","永豐金-板盛",0,205,-205
"9425","8112至上","110/07/13","兆豐-公益",195,5,190
"9426","8112至上","110/07/13","凱基-五股",43,155,-112
"9427","8112至上","110/07/13","台灣摩根士丹利",183,0,183
"9428","8112至上","110/07/13","凱基-市政",0,100,-100
"9429","8112至上","110/07/13","群益金鼎-敦南",153,2,151
"9430","8112至上","110/07/13","元大-大里德芳",1,92,-91
"9431","8112至上","110/07/13","臺銀-金山",146,26,120
"9432","8112至上","110/07/13","玉山-桃園",26,110,-84
"9433","8112至上","110/07/13","臺銀",133,19,114
"9434","8112至上","110/07/13","兆豐-天母",0,81,-81
"9435","8112至上","110/07/13","合庫-台中",115,6,109
"9436","8112至上","110/07/13","凱基-城中",3,84,-81
"9437","8112至上","110/07/13","亞東-板橋",134,26,108
"9438","8112至上","110/07/13","日盛-新莊",9,85,-76
"9439","8112至上","110/07/13","凱基-台北",414,326,88
"9440","8112至上","110/07/13","日盛-台中",2,64,-62
"9441","8112至上","110/07/13","新加坡商瑞銀",181,100,81
"9442","8112至上","110/07/13","日盛-中壢",3,64,-61
"9443","8112至上","110/07/13","國泰-敦南",108,31,77
"9444","8112至上","110/07/13","元大-台中",2,59,-57
"9445","8112至上","110/07/13","第一金-華江",77,4,73
"9446","8112至上","110/07/13","元大-雙和",7,64,-57
"9447","8112至上","110/07/13","永豐金-內湖",73,1,72
"9448","8112至上","110/07/13","元大-高雄",8,62,-54
"9449","8112至上","110/07/13","元大-永和",68,1,67
"9450","8112至上","110/07/13","元大-館前",2,55,-53
"9451","4903聯光通","110/07/13","台灣企銀-太平",56,0,56
"9452","4903聯光通","110/07/13","土銀",0,32,-32
"9453","4903聯光通","110/07/13","元富-新興",23,0,23
"9454","4903聯光通","110/07/13","元大-樹林",0,19,-19
"9455","4903聯光通","110/07/13","日盛-樹林",22,0,22
"9456","4903聯光通","110/07/13","凱基-士林",0,17,-17
"9457","4903聯光通","110/07/13","兆豐-天母",20,0,20
"9458","4903聯光通","110/07/13","國票-博愛",0,14,-14
"9459","4903聯光通","110/07/13","華南永昌-桃園",20,0,20
"9460","4903聯光通","110/07/13","元富",0,10,-10
"9461","4903聯光通","110/07/13","富邦-新店",10,0,10
"9462","4903聯光通","110/07/13","新光",0,10,-10
"9463","4903聯光通","110/07/13","新光-台中",5,0,5
"9464","4903聯光通","110/07/13","玉山-南京東路",0,10,-10
"9465","4903聯光通","110/07/13","華南永昌-台中",5,0,5
"9466","4903聯光通","110/07/13","富邦-陽明",0,10,-10
"9467","4903聯光通","110/07/13","元大-崇德",5,0,5
"9468","4903聯光通","110/07/13","元大-大甲",0,8,-8
"9469","4903聯光通","110/07/13","元大-草屯",5,0,5
"9470","4903聯光通","110/07/13","富邦-台中",0,7,-7
"9471","4903聯光通","110/07/13","元富-草屯",4,0,4
"9472","4903聯光通","110/07/13","凱基-中壢",0,6,-6
"9473","4903聯光通","110/07/13","元大-清水",4,0,4
"9474","4903聯光通","110/07/13","臺銀-民權",0,5,-5
"9475","4903聯光通","110/07/13","元大-東泰",4,0,4
"9476","4903聯光通","110/07/13","日盛-板橋",0,5,-5
"9477","4903聯光通","110/07/13","元大-佳里",2,0,2
"9478","4903聯光通","110/07/13","中國信託-忠孝",0,5,-5
"9479","4903聯光通","110/07/13","永豐金-板橋",2,0,2
"9480","4903聯光通","110/07/13","永豐金-鳳山",0,5,-5
"9481","2929淘帝","110/07/13","玉山-新竹",130,0,130
"9482","2929淘帝","110/07/13","美商高盛",0,177,-177
"9483","2929淘帝","110/07/13","臺銀-民權",60,0,60
"9484","2929淘帝","110/07/13","凱基-台北",6,80,-74
"9485","2929淘帝","110/07/13","新百王",31,0,31
"9486","2929淘帝","110/07/13","元富-大裕",0,49,-49
"9487","2929淘帝","110/07/13","日盛-園區",30,0,30
"9488","2929淘帝","110/07/13","國泰-館前",3,51,-48
"9489","2929淘帝","110/07/13","元大-南投",31,1,30
"9490","2929淘帝","110/07/13","凱基-中壢",0,41,-41
"9491","2929淘帝","110/07/13","兆豐-忠孝",28,0,28
"9492","2929淘帝","110/07/13","港商野村",21,55,-34
"9493","2929淘帝","110/07/13","元大-民生",28,0,28
"9494","2929淘帝","110/07/13","華南永昌-南京",2,34,-32
"9495","2929淘帝","110/07/13","合庫-高雄",27,0,27
"9496","2929淘帝","110/07/13","群益金鼎-土城",0,30,-30
"9497","2929淘帝","110/07/13","凱基-豐中",27,0,27
"9498","2929淘帝","110/07/13","富邦-南屯",0,22,-22
"9499","2929淘帝","110/07/13","新光",21,4,17
"9500","2929淘帝","110/07/13","第一金-豐原",0,20,-20
"9501","2929淘帝","110/07/13","元大-天母",17,0,17
"9502","2929淘帝","110/07/13","元大-屏南",6,26,-20
"9503","2929淘帝","110/07/13","永興",14,0,14
"9504","2929淘帝","110/07/13","永豐金-敦南",1,21,-20
"9505","2929淘帝","110/07/13","富邦-台北",12,0,12
"9506","2929淘帝","110/07/13","凱基-三重",2,21,-19
"9507","2929淘帝","110/07/13","元大-永和",12,0,12
"9508","2929淘帝","110/07/13","富邦-仁愛",7,25,-18
"9509","2929淘帝","110/07/13","國票-天祥",11,0,11
"9510","2929淘帝","110/07/13","元大-北投",0,16,-16
"9511","5410國眾","110/07/13","兆豐-城中",274,0,274
"9512","5410國眾","110/07/13","元富-嘉義",0,103,-103
"9513","5410國眾","110/07/13","新光",50,4,46
"9514","5410國眾","110/07/13","凱基-台北",0,50,-50
"9515","5410國眾","110/07/13","國泰-台中",26,0,26
"9516","5410國眾","110/07/13","瑞士信貸",0,31,-31
"9517","5410國眾","110/07/13","新加坡商瑞銀",22,0,22
"9518","5410國眾","110/07/13","台新-新莊",0,27,-27
"9519","5410國眾","110/07/13","光和-嘉義",20,0,20
"9520","5410國眾","110/07/13","元大-汐止",0,20,-20
"9521","5410國眾","110/07/13","凱基-竹北",17,0,17
"9522","5410國眾","110/07/13","亞東-新竹",0,17,-17
"9523","5410國眾","110/07/13","新光-桃園",15,0,15
"9524","5410國眾","110/07/13","元大-南勢角",0,13,-13
"9525","5410國眾","110/07/13","凱基-台東",14,0,14
"9526","5410國眾","110/07/13","台新-台南",0,12,-12
"9527","5410國眾","110/07/13","富邦-竹北",11,0,11
"9528","5410國眾","110/07/13","中國信託",0,11,-11
"9529","5410國眾","110/07/13","元富-同大",10,0,10
"9530","5410國眾","110/07/13","華南永昌",0,11,-11
"9531","5410國眾","110/07/13","國泰-敦南",24,15,9
"9532","5410國眾","110/07/13","臺銀-臺南",0,10,-10
"9533","5410國眾","110/07/13","日盛-內湖",7,0,7
"9534","5410國眾","110/07/13","台灣企銀-民雄",0,10,-10
"9535","5410國眾","110/07/13","台新-左楠",7,0,7
"9536","5410國眾","110/07/13","高橋",0,10,-10
"9537","5410國眾","110/07/13","元大-新盛",18,12,6
"9538","5410國眾","110/07/13","康和-嘉義",0,10,-10
"9539","5410國眾","110/07/13","統一",5,0,5
"9540","5410國眾","110/07/13","凱基-基隆",0,10,-10
"9541","2841台開","110/07/13","中國信託-高雄",251,50,201
"9542","2841台開","110/07/13","兆豐-公益",0,177,-177
"9543","2841台開","110/07/13","日盛證券",210,13,197
"9544","2841台開","110/07/13","日進",0,152,-152
"9545","2841台開","110/07/13","第一金-台中",55,0,55
"9546","2841台開","110/07/13","港商野村",0,109,-109
"9547","2841台開","110/07/13","國泰-板橋",46,0,46
"9548","2841台開","110/07/13","日盛-信義",0,103,-103
"9549","2841台開","110/07/13","國泰-館前",48,3,45
"9550","2841台開","110/07/13","國泰-敦南",11,75,-64
"9551","2841台開","110/07/13","華南永昌-新莊",45,0,45
"9552","2841台開","110/07/13","永興",0,50,-50
"9553","2841台開","110/07/13","日盛-園區",42,0,42
"9554","2841台開","110/07/13","永豐金-敦南",61,104,-43
"9555","2841台開","110/07/13","台新證券",32,0,32
"9556","2841台開","110/07/13","富邦-台南",0,42,-42
"9557","2841台開","110/07/13","台新-高雄",32,2,30
"9558","2841台開","110/07/13","國票-安和",0,30,-30
"9559","2841台開","110/07/13","豐農",23,0,23
"9560","2841台開","110/07/13","元大-桃園",0,25,-25
"9561","2841台開","110/07/13","合庫-嘉義",20,0,20
"9562","2841台開","110/07/13","新光",8,32,-24
"9563","2841台開","110/07/13","華南永昌-高雄",20,0,20
"9564","2841台開","110/07/13","元大-仁愛",0,24,-24
"9565","2841台開","110/07/13","元大-樹林",16,0,16
"9566","2841台開","110/07/13","日盛-中和",0,20,-20
"9567","2841台開","110/07/13","第一金-華江",15,2,13
"9568","2841台開","110/07/13","元富",0,20,-20
"9569","2841台開","110/07/13","美商高盛",12,0,12
"9570","2841台開","110/07/13","富邦-宜蘭",0,20,-20
"9571","6207雷科","110/07/13","元大-高雄",121,0,121
"9572","6207雷科","110/07/13","華南永昌-朴子",1,60,-59
"9573","6207雷科","110/07/13","第一金-新興",20,0,20
"9574","6207雷科","110/07/13","元大-南海",0,36,-36
"9575","6207雷科","110/07/13","元富-三重",20,0,20
"9576","6207雷科","110/07/13","凱基-土城",0,35,-35
"9577","6207雷科","110/07/13","元大-林園",15,0,15
"9578","6207雷科","110/07/13","台灣企銀",0,20,-20
"9579","6207雷科","110/07/13","元大-金華",16,1,15
"9580","6207雷科","110/07/13","群益金鼎-丹鳳",0,20,-20
"9581","6207雷科","110/07/13","日盛證券",10,0,10
"9582","6207雷科","110/07/13","元大-博愛",0,17,-17
"9583","6207雷科","110/07/13","統一-台中",10,0,10
"9584","6207雷科","110/07/13","元大-北港",0,13,-13
"9585","6207雷科","110/07/13","群益金鼎-土城",10,0,10
"9586","6207雷科","110/07/13","新加坡商瑞銀",0,12,-12
"9587","6207雷科","110/07/13","群益金鼎-桃園",10,0,10
"9588","6207雷科","110/07/13","凱基-台北",4,16,-12
"9589","6207雷科","110/07/13","永豐金-新莊",10,0,10
"9590","6207雷科","110/07/13","日茂-埔里",0,11,-11
"9591","6207雷科","110/07/13","永豐金-新店",10,0,10
"9592","6207雷科","110/07/13","元大-莒光",0,11,-11
"9593","6207雷科","110/07/13","元大證券",9,0,9
"9594","6207雷科","110/07/13","統一-新竹",0,10,-10
"9595","6207雷科","110/07/13","日盛-木柵",9,1,8
"9596","6207雷科","110/07/13","元大-西螺",0,10,-10
"9597","6207雷科","110/07/13","兆豐-來福",8,0,8
"9598","6207雷科","110/07/13","康和-台中",0,8,-8
"9599","6207雷科","110/07/13","新光",7,0,7
"9600","6207雷科","110/07/13","兆豐-高雄",0,6,-6
"9601","3679新至陞","110/07/13","永豐金證券",50,0,50
"9602","3679新至陞","110/07/13","摩根大通",2,25,-23
"9603","3679新至陞","110/07/13","國泰-桃園",22,0,22
"9604","3679新至陞","110/07/13","元大-成功",0,22,-22
"9605","3679新至陞","110/07/13","台中銀-員林",11,0,11
"9606","3679新至陞","110/07/13","富邦-板橋",1,19,-18
"9607","3679新至陞","110/07/13","元大-文心興安",8,0,8
"9608","3679新至陞","110/07/13","日盛-新莊",0,10,-10
"9609","3679新至陞","110/07/13","美商高盛",6,0,6
"9610","3679新至陞","110/07/13","台新-台中",0,10,-10
"9611","3679新至陞","110/07/13","台新-高雄",6,0,6
"9612","3679新至陞","110/07/13","永豐金-新竹",0,8,-8
"9613","3679新至陞","110/07/13","凱基-台北",18,12,6
"9614","3679新至陞","110/07/13","瑞士信貸",12,19,-7
"9615","3679新至陞","110/07/13","日盛-復興",5,0,5
"9616","3679新至陞","110/07/13","統一-南京",0,7,-7
"9617","3679新至陞","110/07/13","(牛牛牛)亞-鑫豐",4,0,4
"9618","3679新至陞","110/07/13","凱基-新莊",0,7,-7
"9619","3679新至陞","110/07/13","元富-大昌",3,0,3
"9620","3679新至陞","110/07/13","新加坡商瑞銀",0,6,-6
"9621","3679新至陞","110/07/13","富邦-台北",3,0,3
"9622","3679新至陞","110/07/13","合庫-自強",0,5,-5
"9623","3679新至陞","110/07/13","日盛-樹林",2,0,2
"9624","3679新至陞","110/07/13","富邦-桃園",0,5,-5
"9625","3679新至陞","110/07/13","宏遠-光隆",2,0,2
"9626","3679新至陞","110/07/13","永豐金-潮州",0,4,-4
"9627","3679新至陞","110/07/13","美林",3,1,2
"9628","3679新至陞","110/07/13","臺銀-臺南",0,3,-3
"9629","3679新至陞","110/07/13","第一金-中壢",2,0,2
"9630","3679新至陞","110/07/13","元大-六合",0,3,-3
"9631","2727王品","110/07/13","富邦-台北",43,3,40
"9632","2727王品","110/07/13","台灣摩根士丹利",15,97,-82
"9633","2727王品","110/07/13","元大-基隆孝二",40,0,40
"9634","2727王品","110/07/13","玉山-台南",5,57,-52
"9635","2727王品","110/07/13","國票-新莊",40,1,39
"9636","2727王品","110/07/13","新加坡商瑞銀",0,48,-48
"9637","2727王品","110/07/13","第一金-豐原",66,42,24
"9638","2727王品","110/07/13","凱基-台北",41,77,-36
"9639","2727王品","110/07/13","永豐金-大園",34,10,24
"9640","2727王品","110/07/13","永豐金-永康",0,22,-22
"9641","2727王品","110/07/13","元大-北屯",22,0,22
"9642","2727王品","110/07/13","統一-台中",2,22,-20
"9643","2727王品","110/07/13","元大-東蘆",26,7,19
"9644","2727王品","110/07/13","國泰-台中",21,39,-18
"9645","2727王品","110/07/13","永豐金-萬盛",13,1,12
"9646","2727王品","110/07/13","合庫-彰化",3,20,-17
"9647","2727王品","110/07/13","日盛-嘉義",11,0,11
"9648","2727王品","110/07/13","港商野村",13,30,-17
"9649","2727王品","110/07/13","日盛-八德",11,0,11
"9650","2727王品","110/07/13","元大-楊梅",1,16,-15
"9651","2727王品","110/07/13","統一-竹南",11,0,11
"9652","2727王品","110/07/13","凱基-高美館",2,15,-13
"9653","2727王品","110/07/13","日盛-士林",12,2,10
"9654","2727王品","110/07/13","美商高盛",2,14,-12
"9655","2727王品","110/07/13","統一-敦南",10,0,10
"9656","2727王品","110/07/13","統一-平鎮",1,13,-12
"9657","2727王品","110/07/13","中國信託",15,5,10
"9658","2727王品","110/07/13","兆豐-台中港",4,16,-12
"9659","2727王品","110/07/13","兆豐-竹北",13,3,10
"9660","2727王品","110/07/13","凱基-八德",1,13,-12
"9661","1570力肯","110/07/13","新光",115,11,104
"9662","1570力肯","110/07/13","元大-北三重",0,162,-162
"9663","1570力肯","110/07/13","群益金鼎-高雄",54,0,54
"9664","1570力肯","110/07/13","元大-大灣",0,25,-25
"9665","1570力肯","110/07/13","國票-新莊",22,0,22
"9666","1570力肯","110/07/13","永豐金-苓雅",0,22,-22
"9667","1570力肯","110/07/13","日盛-桃園",12,0,12
"9668","1570力肯","110/07/13","永豐金-永康",0,19,-19
"9669","1570力肯","110/07/13","元大-高雄",12,0,12
"9670","1570力肯","110/07/13","富邦-員林",0,15,-15
"9671","1570力肯","110/07/13","合庫-自強",11,0,11
"9672","1570力肯","110/07/13","凱基-台南",0,11,-11
"9673","1570力肯","110/07/13","摩根大通",26,15,11
"9674","1570力肯","110/07/13","日盛-竹北",0,10,-10
"9675","1570力肯","110/07/13","永豐金-中盛",11,0,11
"9676","1570力肯","110/07/13","國票-九鼎",0,10,-10
"9677","1570力肯","110/07/13","兆豐-台中港",10,0,10
"9678","1570力肯","110/07/13","凱基-桃園",0,10,-10
"9679","1570力肯","110/07/13","國泰-松江",9,0,9
"9680","1570力肯","110/07/13","凱基-新豐",0,10,-10
"9681","1570力肯","110/07/13","元大-新盛",9,0,9
"9682","1570力肯","110/07/13","元大-學甲",0,10,-10
"9683","1570力肯","110/07/13","元富-緯城",6,0,6
"9684","1570力肯","110/07/13","群益金鼎-東湖",1,10,-9
"9685","1570力肯","110/07/13","統一-三重",5,0,5
"9686","1570力肯","110/07/13","大昌",0,6,-6
"9687","1570力肯","110/07/13","元大-前金",5,0,5
"9688","1570力肯","110/07/13","元大-土城學府",0,6,-6
"9689","1570力肯","110/07/13","永豐金證券",5,0,5
"9690","1570力肯","110/07/13","統一",0,5,-5
"9691","6180橘子","110/07/13","摩根大通",119,0,119
"9692","6180橘子","110/07/13","元大-崇德",2,61,-59
"9693","6180橘子","110/07/13","美商高盛",96,0,96
"9694","6180橘子","110/07/13","康和-台中",0,51,-51
"9695","6180橘子","110/07/13","新加坡商瑞銀",86,7,79
"9696","6180橘子","110/07/13","康和-台北",0,50,-50
"9697","6180橘子","110/07/13","元大-和平",40,0,40
"9698","6180橘子","110/07/13","元富-潮州",0,40,-40
"9699","6180橘子","110/07/13","凱基-台北",83,47,36
"9700","6180橘子","110/07/13","日盛-永康",0,26,-26
"9701","6180橘子","110/07/13","美林",39,5,34
"9702","6180橘子","110/07/13","永豐金-中正",0,24,-24
"9703","6180橘子","110/07/13","富邦-新竹華信",31,2,29
"9704","6180橘子","110/07/13","國泰-板橋",2,25,-23
"9705","6180橘子","110/07/13","統一-南京",21,0,21
"9706","6180橘子","110/07/13","日盛-大墩",0,20,-20
"9707","6180橘子","110/07/13","富邦-陽明",24,3,21
"9708","6180橘子","110/07/13","元大-草屯",13,32,-19
"9709","6180橘子","110/07/13","大昌-樹林",21,1,20
"9710","6180橘子","110/07/13","元富-林園",1,18,-17
"9711","6180橘子","110/07/13","花旗環球",19,0,19
"9712","6180橘子","110/07/13","新光-新竹",1,18,-17
"9713","6180橘子","110/07/13","華南永昌-台南",19,0,19
"9714","6180橘子","110/07/13","元大-土城永寧",0,17,-17
"9715","6180橘子","110/07/13","福勝",14,0,14
"9716","6180橘子","110/07/13","國泰-新莊",3,19,-16
"9717","6180橘子","110/07/13","富邦-嘉義",12,1,11
"9718","6180橘子","110/07/13","中國信託-永康",6,21,-15
"9719","6180橘子","110/07/13","元大-板橋三民",11,0,11
"9720","6180橘子","110/07/13","凱基-東港",1,15,-14
"9721","2390云辰","110/07/13","新加坡商瑞銀",562,75,487
"9722","2390云辰","110/07/13","大展-台南",0,532,-532
"9723","2390云辰","110/07/13","台灣摩根士丹利",330,155,175
"9724","2390云辰","110/07/13","凱基-台北",668,854,-186
"9725","2390云辰","110/07/13","兆豐-公益",126,25,101
"9726","2390云辰","110/07/13","凱基-三重",12,172,-160
"9727","2390云辰","110/07/13","元富-中港",100,2,98
"9728","2390云辰","110/07/13","兆豐-忠孝",4,161,-157
"9729","2390云辰","110/07/13","統一-新台中",106,9,97
"9730","2390云辰","110/07/13","元大-士林",19,170,-151
"9731","2390云辰","110/07/13","中國信託-松江",81,11,70
"9732","2390云辰","110/07/13","臺銀-新竹",14,117,-103
"9733","2390云辰","110/07/13","日盛-板橋",72,3,69
"9734","2390云辰","110/07/13","國票-台中",4,102,-98
"9735","2390云辰","110/07/13","日盛-和美",57,0,57
"9736","2390云辰","110/07/13","新光",147,232,-85
"9737","2390云辰","110/07/13","永豐金-桃園",88,36,52
"9738","2390云辰","110/07/13","致和-崇德",2,70,-68
"9739","2390云辰","110/07/13","玉山-士林",54,4,50
"9740","2390云辰","110/07/13","群益金鼎-屏東",2,70,-68
"9741","2390云辰","110/07/13","富邦-仁愛",56,6,50
"9742","2390云辰","110/07/13","元大-大里",35,98,-63
"9743","2390云辰","110/07/13","第一金-豐原",50,1,49
"9744","2390云辰","110/07/13","元大-萬華",35,94,-59
"9745","2390云辰","110/07/13","摩根大通",502,453,49
"9746","2390云辰","110/07/13","元富-吉利",2,60,-58
"9747","2390云辰","110/07/13","凱基-松山",61,13,48
"9748","2390云辰","110/07/13","兆豐-新竹",3,53,-50
"9749","2390云辰","110/07/13","大昌",64,22,42
"9750","2390云辰","110/07/13","富邦-嘉義",65,108,-43
"9751","2363矽統","110/07/13","凱基-南崁",2133,63,2070
"9752","2363矽統","110/07/13","凱基-幸福",36,4048,-4012
"9753","2363矽統","110/07/13","國泰-敦南",2195,1617,578
"9754","2363矽統","110/07/13","統一",192,3325,-3133
"9755","2363矽統","110/07/13","中農",670,139,531
"9756","2363矽統","110/07/13","新加坡商瑞銀",1000,2747,-1747
"9757","2363矽統","110/07/13","康和-台中",638,154,484
"9758","2363矽統","110/07/13","凱基-台北",5359,6609,-1250
"9759","2363矽統","110/07/13","群益金鼎-三民",577,137,440
"9760","2363矽統","110/07/13","摩根大通",1930,2858,-928
"9761","2363矽統","110/07/13","台新-屏東",510,88,422
"9762","2363矽統","110/07/13","港商野村",960,1679,-719
"9763","2363矽統","110/07/13","德信-中正",455,67,388
"9764","2363矽統","110/07/13","兆豐-復興",25,705,-680
"9765","2363矽統","110/07/13","日盛-竹北",365,70,295
"9766","2363矽統","110/07/13","統一-仁愛",114,755,-641
"9767","2363矽統","110/07/13","元大-佳里",452,189,263
"9768","2363矽統","110/07/13","統一-敦南",29,638,-609
"9769","2363矽統","110/07/13","國票-博愛",296,38,258
"9770","2363矽統","110/07/13","統一-土城",100,704,-604
"9771","2363矽統","110/07/13","元大-萬華",340,95,245
"9772","2363矽統","110/07/13","統一-城中",116,676,-560
"9773","2363矽統","110/07/13","新光",1259,1031,228
"9774","2363矽統","110/07/13","永豐金證券",306,859,-553
"9775","2363矽統","110/07/13","元富-成功",323,96,227
"9776","2363矽統","110/07/13","元富",54,567,-513
"9777","2363矽統","110/07/13","豐農",228,23,205
"9778","2363矽統","110/07/13","瑞士信貸",202,666,-464
"9779","2363矽統","110/07/13","台灣企銀-岡山",186,4,182
"9780","2363矽統","110/07/13","永豐金-嘉義",67,468,-401
"9781","8112至上","110/07/13","摩根大通",688,296,392
"9782","8112至上","110/07/13","國票-中和",0,401,-401
"9783","8112至上","110/07/13","港商野村",344,145,199
"9784","8112至上","110/07/13","永豐金-板盛",0,205,-205
"9785","8112至上","110/07/13","兆豐-公益",195,5,190
"9786","8112至上","110/07/13","凱基-五股",43,155,-112
"9787","8112至上","110/07/13","台灣摩根士丹利",183,0,183
"9788","8112至上","110/07/13","凱基-市政",0,100,-100
"9789","8112至上","110/07/13","群益金鼎-敦南",153,2,151
"9790","8112至上","110/07/13","元大-大里德芳",1,92,-91
"9791","8112至上","110/07/13","臺銀-金山",146,26,120
"9792","8112至上","110/07/13","玉山-桃園",26,110,-84
"9793","8112至上","110/07/13","臺銀",133,19,114
"9794","8112至上","110/07/13","兆豐-天母",0,81,-81
"9795","8112至上","110/07/13","合庫-台中",115,6,109
"9796","8112至上","110/07/13","凱基-城中",3,84,-81
"9797","8112至上","110/07/13","亞東-板橋",134,26,108
"9798","8112至上","110/07/13","日盛-新莊",9,85,-76
"9799","8112至上","110/07/13","凱基-台北",414,326,88
"9800","8112至上","110/07/13","日盛-台中",2,64,-62
"9801","8112至上","110/07/13","新加坡商瑞銀",181,100,81
"9802","8112至上","110/07/13","日盛-中壢",3,64,-61
"9803","8112至上","110/07/13","國泰-敦南",108,31,77
"9804","8112至上","110/07/13","元大-台中",2,59,-57
"9805","8112至上","110/07/13","第一金-華江",77,4,73
"9806","8112至上","110/07/13","元大-雙和",7,64,-57
"9807","8112至上","110/07/13","永豐金-內湖",73,1,72
"9808","8112至上","110/07/13","元大-高雄",8,62,-54
"9809","8112至上","110/07/13","元大-永和",68,1,67
"9810","8112至上","110/07/13","元大-館前",2,55,-53
"9811","4903聯光通","110/07/13","台灣企銀-太平",56,0,56
"9812","4903聯光通","110/07/13","土銀",0,32,-32
"9813","4903聯光通","110/07/13","元富-新興",23,0,23
"9814","4903聯光通","110/07/13","元大-樹林",0,19,-19
"9815","4903聯光通","110/07/13","日盛-樹林",22,0,22
"9816","4903聯光通","110/07/13","凱基-士林",0,17,-17
"9817","4903聯光通","110/07/13","兆豐-天母",20,0,20
"9818","4903聯光通","110/07/13","國票-博愛",0,14,-14
"9819","4903聯光通","110/07/13","華南永昌-桃園",20,0,20
"9820","4903聯光通","110/07/13","元富",0,10,-10
"9821","4903聯光通","110/07/13","富邦-新店",10,0,10
"9822","4903聯光通","110/07/13","新光",0,10,-10
"9823","4903聯光通","110/07/13","新光-台中",5,0,5
"9824","4903聯光通","110/07/13","玉山-南京東路",0,10,-10
"9825","4903聯光通","110/07/13","華南永昌-台中",5,0,5
"9826","4903聯光通","110/07/13","富邦-陽明",0,10,-10
"9827","4903聯光通","110/07/13","元大-崇德",5,0,5
"9828","4903聯光通","110/07/13","元大-大甲",0,8,-8
"9829","4903聯光通","110/07/13","元大-草屯",5,0,5
"9830","4903聯光通","110/07/13","富邦-台中",0,7,-7
"9831","4903聯光通","110/07/13","元富-草屯",4,0,4
"9832","4903聯光通","110/07/13","凱基-中壢",0,6,-6
"9833","4903聯光通","110/07/13","元大-清水",4,0,4
"9834","4903聯光通","110/07/13","臺銀-民權",0,5,-5
"9835","4903聯光通","110/07/13","元大-東泰",4,0,4
"9836","4903聯光通","110/07/13","日盛-板橋",0,5,-5
"9837","4903聯光通","110/07/13","元大-佳里",2,0,2
"9838","4903聯光通","110/07/13","中國信託-忠孝",0,5,-5
"9839","4903聯光通","110/07/13","永豐金-板橋",2,0,2
"9840","4903聯光通","110/07/13","永豐金-鳳山",0,5,-5
"9841","2929淘帝","110/07/13","玉山-新竹",130,0,130
"9842","2929淘帝","110/07/13","美商高盛",0,177,-177
"9843","2929淘帝","110/07/13","臺銀-民權",60,0,60
"9844","2929淘帝","110/07/13","凱基-台北",6,80,-74
"9845","2929淘帝","110/07/13","新百王",31,0,31
"9846","2929淘帝","110/07/13","元富-大裕",0,49,-49
"9847","2929淘帝","110/07/13","日盛-園區",30,0,30
"9848","2929淘帝","110/07/13","國泰-館前",3,51,-48
"9849","2929淘帝","110/07/13","元大-南投",31,1,30
"9850","2929淘帝","110/07/13","凱基-中壢",0,41,-41
"9851","2929淘帝","110/07/13","兆豐-忠孝",28,0,28
"9852","2929淘帝","110/07/13","港商野村",21,55,-34
"9853","2929淘帝","110/07/13","元大-民生",28,0,28
"9854","2929淘帝","110/07/13","華南永昌-南京",2,34,-32
"9855","2929淘帝","110/07/13","合庫-高雄",27,0,27
"9856","2929淘帝","110/07/13","群益金鼎-土城",0,30,-30
"9857","2929淘帝","110/07/13","凱基-豐中",27,0,27
"9858","2929淘帝","110/07/13","富邦-南屯",0,22,-22
"9859","2929淘帝","110/07/13","新光",21,4,17
"9860","2929淘帝","110/07/13","第一金-豐原",0,20,-20
"9861","2929淘帝","110/07/13","元大-天母",17,0,17
"9862","2929淘帝","110/07/13","元大-屏南",6,26,-20
"9863","2929淘帝","110/07/13","永興",14,0,14
"9864","2929淘帝","110/07/13","永豐金-敦南",1,21,-20
"9865","2929淘帝","110/07/13","富邦-台北",12,0,12
"9866","2929淘帝","110/07/13","凱基-三重",2,21,-19
"9867","2929淘帝","110/07/13","元大-永和",12,0,12
"9868","2929淘帝","110/07/13","富邦-仁愛",7,25,-18
"9869","2929淘帝","110/07/13","國票-天祥",11,0,11
"9870","2929淘帝","110/07/13","元大-北投",0,16,-16
"9871","5410國眾","110/07/13","兆豐-城中",274,0,274
"9872","5410國眾","110/07/13","元富-嘉義",0,103,-103
"9873","5410國眾","110/07/13","新光",50,4,46
"9874","5410國眾","110/07/13","凱基-台北",0,50,-50
"9875","5410國眾","110/07/13","國泰-台中",26,0,26
"9876","5410國眾","110/07/13","瑞士信貸",0,31,-31
"9877","5410國眾","110/07/13","新加坡商瑞銀",22,0,22
"9878","5410國眾","110/07/13","台新-新莊",0,27,-27
"9879","5410國眾","110/07/13","光和-嘉義",20,0,20
"9880","5410國眾","110/07/13","元大-汐止",0,20,-20
"9881","5410國眾","110/07/13","凱基-竹北",17,0,17
"9882","5410國眾","110/07/13","亞東-新竹",0,17,-17
"9883","5410國眾","110/07/13","新光-桃園",15,0,15
"9884","5410國眾","110/07/13","元大-南勢角",0,13,-13
"9885","5410國眾","110/07/13","凱基-台東",14,0,14
"9886","5410國眾","110/07/13","台新-台南",0,12,-12
"9887","5410國眾","110/07/13","富邦-竹北",11,0,11
"9888","5410國眾","110/07/13","中國信託",0,11,-11
"9889","5410國眾","110/07/13","元富-同大",10,0,10
"9890","5410國眾","110/07/13","華南永昌",0,11,-11
"9891","5410國眾","110/07/13","國泰-敦南",24,15,9
"9892","5410國眾","110/07/13","臺銀-臺南",0,10,-10
"9893","5410國眾","110/07/13","日盛-內湖",7,0,7
"9894","5410國眾","110/07/13","台灣企銀-民雄",0,10,-10
"9895","5410國眾","110/07/13","台新-左楠",7,0,7
"9896","5410國眾","110/07/13","高橋",0,10,-10
"9897","5410國眾","110/07/13","元大-新盛",18,12,6
"9898","5410國眾","110/07/13","康和-嘉義",0,10,-10
"9899","5410國眾","110/07/13","統一",5,0,5
"9900","5410國眾","110/07/13","凱基-基隆",0,10,-10
"9901","2841台開","110/07/13","中國信託-高雄",251,50,201
"9902","2841台開","110/07/13","兆豐-公益",0,177,-177
"9903","2841台開","110/07/13","日盛證券",210,13,197
"9904","2841台開","110/07/13","日進",0,152,-152
"9905","2841台開","110/07/13","第一金-台中",55,0,55
"9906","2841台開","110/07/13","港商野村",0,109,-109
"9907","2841台開","110/07/13","國泰-板橋",46,0,46
"9908","2841台開","110/07/13","日盛-信義",0,103,-103
"9909","2841台開","110/07/13","國泰-館前",48,3,45
"9910","2841台開","110/07/13","國泰-敦南",11,75,-64
"9911","2841台開","110/07/13","華南永昌-新莊",45,0,45
"9912","2841台開","110/07/13","永興",0,50,-50
"9913","2841台開","110/07/13","日盛-園區",42,0,42
"9914","2841台開","110/07/13","永豐金-敦南",61,104,-43
"9915","2841台開","110/07/13","台新證券",32,0,32
"9916","2841台開","110/07/13","富邦-台南",0,42,-42
"9917","2841台開","110/07/13","台新-高雄",32,2,30
"9918","2841台開","110/07/13","國票-安和",0,30,-30
"9919","2841台開","110/07/13","豐農",23,0,23
"9920","2841台開","110/07/13","元大-桃園",0,25,-25
"9921","2841台開","110/07/13","合庫-嘉義",20,0,20
"9922","2841台開","110/07/13","新光",8,32,-24
"9923","2841台開","110/07/13","華南永昌-高雄",20,0,20
"9924","2841台開","110/07/13","元大-仁愛",0,24,-24
"9925","2841台開","110/07/13","元大-樹林",16,0,16
"9926","2841台開","110/07/13","日盛-中和",0,20,-20
"9927","2841台開","110/07/13","第一金-華江",15,2,13
"9928","2841台開","110/07/13","元富",0,20,-20
"9929","2841台開","110/07/13","美商高盛",12,0,12
"9930","2841台開","110/07/13","富邦-宜蘭",0,20,-20
"9931","6207雷科","110/07/13","元大-高雄",121,0,121
"9932","6207雷科","110/07/13","華南永昌-朴子",1,60,-59
"9933","6207雷科","110/07/13","第一金-新興",20,0,20
"9934","6207雷科","110/07/13","元大-南海",0,36,-36
"9935","6207雷科","110/07/13","元富-三重",20,0,20
"9936","6207雷科","110/07/13","凱基-土城",0,35,-35
"9937","6207雷科","110/07/13","元大-林園",15,0,15
"9938","6207雷科","110/07/13","台灣企銀",0,20,-20
"9939","6207雷科","110/07/13","元大-金華",16,1,15
"9940","6207雷科","110/07/13","群益金鼎-丹鳳",0,20,-20
"9941","6207雷科","110/07/13","日盛證券",10,0,10
"9942","6207雷科","110/07/13","元大-博愛",0,17,-17
"9943","6207雷科","110/07/13","統一-台中",10,0,10
"9944","6207雷科","110/07/13","元大-北港",0,13,-13
"9945","6207雷科","110/07/13","群益金鼎-土城",10,0,10
"9946","6207雷科","110/07/13","新加坡商瑞銀",0,12,-12
"9947","6207雷科","110/07/13","群益金鼎-桃園",10,0,10
"9948","6207雷科","110/07/13","凱基-台北",4,16,-12
"9949","6207雷科","110/07/13","永豐金-新莊",10,0,10
"9950","6207雷科","110/07/13","日茂-埔里",0,11,-11
"9951","6207雷科","110/07/13","永豐金-新店",10,0,10
"9952","6207雷科","110/07/13","元大-莒光",0,11,-11
"9953","6207雷科","110/07/13","元大證券",9,0,9
"9954","6207雷科","110/07/13","統一-新竹",0,10,-10
"9955","6207雷科","110/07/13","日盛-木柵",9,1,8
"9956","6207雷科","110/07/13","元大-西螺",0,10,-10
"9957","6207雷科","110/07/13","兆豐-來福",8,0,8
"9958","6207雷科","110/07/13","康和-台中",0,8,-8
"9959","6207雷科","110/07/13","新光",7,0,7
"9960","6207雷科","110/07/13","兆豐-高雄",0,6,-6
"9961","3679新至陞","110/07/13","永豐金證券",50,0,50
"9962","3679新至陞","110/07/13","摩根大通",2,25,-23
"9963","3679新至陞","110/07/13","國泰-桃園",22,0,22
"9964","3679新至陞","110/07/13","元大-成功",0,22,-22
"9965","3679新至陞","110/07/13","台中銀-員林",11,0,11
"9966","3679新至陞","110/07/13","富邦-板橋",1,19,-18
"9967","3679新至陞","110/07/13","元大-文心興安",8,0,8
"9968","3679新至陞","110/07/13","日盛-新莊",0,10,-10
"9969","3679新至陞","110/07/13","美商高盛",6,0,6
"9970","3679新至陞","110/07/13","台新-台中",0,10,-10
"9971","3679新至陞","110/07/13","台新-高雄",6,0,6
"9972","3679新至陞","110/07/13","永豐金-新竹",0,8,-8
"9973","3679新至陞","110/07/13","凱基-台北",18,12,6
"9974","3679新至陞","110/07/13","瑞士信貸",12,19,-7
"9975","3679新至陞","110/07/13","日盛-復興",5,0,5
"9976","3679新至陞","110/07/13","統一-南京",0,7,-7
"9977","3679新至陞","110/07/13","(牛牛牛)亞-鑫豐",4,0,4
"9978","3679新至陞","110/07/13","凱基-新莊",0,7,-7
"9979","3679新至陞","110/07/13","元富-大昌",3,0,3
"9980","3679新至陞","110/07/13","新加坡商瑞銀",0,6,-6
"9981","3679新至陞","110/07/13","富邦-台北",3,0,3
"9982","3679新至陞","110/07/13","合庫-自強",0,5,-5
"9983","3679新至陞","110/07/13","日盛-樹林",2,0,2
"9984","3679新至陞","110/07/13","富邦-桃園",0,5,-5
"9985","3679新至陞","110/07/13","宏遠-光隆",2,0,2
"9986","3679新至陞","110/07/13","永豐金-潮州",0,4,-4
"9987","3679新至陞","110/07/13","美林",3,1,2
"9988","3679新至陞","110/07/13","臺銀-臺南",0,3,-3
"9989","3679新至陞","110/07/13","第一金-中壢",2,0,2
"9990","3679新至陞","110/07/13","元大-六合",0,3,-3
"9991","2727王品","110/07/13","富邦-台北",43,3,40
"9992","2727王品","110/07/13","台灣摩根士丹利",15,97,-82
"9993","2727王品","110/07/13","元大-基隆孝二",40,0,40
"9994","2727王品","110/07/13","玉山-台南",5,57,-52
"9995","2727王品","110/07/13","國票-新莊",40,1,39
"9996","2727王品","110/07/13","新加坡商瑞銀",0,48,-48
"9997","2727王品","110/07/13","第一金-豐原",66,42,24
"9998","2727王品","110/07/13","凱基-台北",41,77,-36
"9999","2727王品","110/07/13","永豐金-大園",34,10,24
"10000","2727王品","110/07/13","永豐金-永康",0,22,-22
"10001","2727王品","110/07/13","元大-北屯",22,0,22
"10002","2727王品","110/07/13","統一-台中",2,22,-20
"10003","2727王品","110/07/13","元大-東蘆",26,7,19
"10004","2727王品","110/07/13","國泰-台中",21,39,-18
"10005","2727王品","110/07/13","永豐金-萬盛",13,1,12
"10006","2727王品","110/07/13","合庫-彰化",3,20,-17
"10007","2727王品","110/07/13","日盛-嘉義",11,0,11
"10008","2727王品","110/07/13","港商野村",13,30,-17
"10009","2727王品","110/07/13","日盛-八德",11,0,11
"10010","2727王品","110/07/13","元大-楊梅",1,16,-15
"10011","2727王品","110/07/13","統一-竹南",11,0,11
"10012","2727王品","110/07/13","凱基-高美館",2,15,-13
"10013","2727王品","110/07/13","日盛-士林",12,2,10
"10014","2727王品","110/07/13","美商高盛",2,14,-12
"10015","2727王品","110/07/13","統一-敦南",10,0,10
"10016","2727王品","110/07/13","統一-平鎮",1,13,-12
"10017","2727王品","110/07/13","中國信託",15,5,10
"10018","2727王品","110/07/13","兆豐-台中港",4,16,-12
"10019","2727王品","110/07/13","兆豐-竹北",13,3,10
"10020","2727王品","110/07/13","凱基-八德",1,13,-12
"10021","1570力肯","110/07/13","新光",115,11,104
"10022","1570力肯","110/07/13","元大-北三重",0,162,-162
"10023","1570力肯","110/07/13","群益金鼎-高雄",54,0,54
"10024","1570力肯","110/07/13","元大-大灣",0,25,-25
"10025","1570力肯","110/07/13","國票-新莊",22,0,22
"10026","1570力肯","110/07/13","永豐金-苓雅",0,22,-22
"10027","1570力肯","110/07/13","日盛-桃園",12,0,12
"10028","1570力肯","110/07/13","永豐金-永康",0,19,-19
"10029","1570力肯","110/07/13","元大-高雄",12,0,12
"10030","1570力肯","110/07/13","富邦-員林",0,15,-15
"10031","1570力肯","110/07/13","合庫-自強",11,0,11
"10032","1570力肯","110/07/13","凱基-台南",0,11,-11
"10033","1570力肯","110/07/13","摩根大通",26,15,11
"10034","1570力肯","110/07/13","日盛-竹北",0,10,-10
"10035","1570力肯","110/07/13","永豐金-中盛",11,0,11
"10036","1570力肯","110/07/13","國票-九鼎",0,10,-10
"10037","1570力肯","110/07/13","兆豐-台中港",10,0,10
"10038","1570力肯","110/07/13","凱基-桃園",0,10,-10
"10039","1570力肯","110/07/13","國泰-松江",9,0,9
"10040","1570力肯","110/07/13","凱基-新豐",0,10,-10
"10041","1570力肯","110/07/13","元大-新盛",9,0,9
"10042","1570力肯","110/07/13","元大-學甲",0,10,-10
"10043","1570力肯","110/07/13","元富-緯城",6,0,6
"10044","1570力肯","110/07/13","群益金鼎-東湖",1,10,-9
"10045","1570力肯","110/07/13","統一-三重",5,0,5
"10046","1570力肯","110/07/13","大昌",0,6,-6
"10047","1570力肯","110/07/13","元大-前金",5,0,5
"10048","1570力肯","110/07/13","元大-土城學府",0,6,-6
"10049","1570力肯","110/07/13","永豐金證券",5,0,5
"10050","1570力肯","110/07/13","統一",0,5,-5
"10051","6180橘子","110/07/13","摩根大通",119,0,119
"10052","6180橘子","110/07/13","元大-崇德",2,61,-59
"10053","6180橘子","110/07/13","美商高盛",96,0,96
"10054","6180橘子","110/07/13","康和-台中",0,51,-51
"10055","6180橘子","110/07/13","新加坡商瑞銀",86,7,79
"10056","6180橘子","110/07/13","康和-台北",0,50,-50
"10057","6180橘子","110/07/13","元大-和平",40,0,40
"10058","6180橘子","110/07/13","元富-潮州",0,40,-40
"10059","6180橘子","110/07/13","凱基-台北",83,47,36
"10060","6180橘子","110/07/13","日盛-永康",0,26,-26
"10061","6180橘子","110/07/13","美林",39,5,34
"10062","6180橘子","110/07/13","永豐金-中正",0,24,-24
"10063","6180橘子","110/07/13","富邦-新竹華信",31,2,29
"10064","6180橘子","110/07/13","國泰-板橋",2,25,-23
"10065","6180橘子","110/07/13","統一-南京",21,0,21
"10066","6180橘子","110/07/13","日盛-大墩",0,20,-20
"10067","6180橘子","110/07/13","富邦-陽明",24,3,21
"10068","6180橘子","110/07/13","元大-草屯",13,32,-19
"10069","6180橘子","110/07/13","大昌-樹林",21,1,20
"10070","6180橘子","110/07/13","元富-林園",1,18,-17
"10071","6180橘子","110/07/13","花旗環球",19,0,19
"10072","6180橘子","110/07/13","新光-新竹",1,18,-17
"10073","6180橘子","110/07/13","華南永昌-台南",19,0,19
"10074","6180橘子","110/07/13","元大-土城永寧",0,17,-17
"10075","6180橘子","110/07/13","福勝",14,0,14
"10076","6180橘子","110/07/13","國泰-新莊",3,19,-16
"10077","6180橘子","110/07/13","富邦-嘉義",12,1,11
"10078","6180橘子","110/07/13","中國信託-永康",6,21,-15
"10079","6180橘子","110/07/13","元大-板橋三民",11,0,11
"10080","6180橘子","110/07/13","凱基-東港",1,15,-14
"10081","2390云辰","110/07/13","新加坡商瑞銀",562,75,487
"10082","2390云辰","110/07/13","大展-台南",0,532,-532
"10083","2390云辰","110/07/13","台灣摩根士丹利",330,155,175
"10084","2390云辰","110/07/13","凱基-台北",668,854,-186
"10085","2390云辰","110/07/13","兆豐-公益",126,25,101
"10086","2390云辰","110/07/13","凱基-三重",12,172,-160
"10087","2390云辰","110/07/13","元富-中港",100,2,98
"10088","2390云辰","110/07/13","兆豐-忠孝",4,161,-157
"10089","2390云辰","110/07/13","統一-新台中",106,9,97
"10090","2390云辰","110/07/13","元大-士林",19,170,-151
"10091","2390云辰","110/07/13","中國信託-松江",81,11,70
"10092","2390云辰","110/07/13","臺銀-新竹",14,117,-103
"10093","2390云辰","110/07/13","日盛-板橋",72,3,69
"10094","2390云辰","110/07/13","國票-台中",4,102,-98
"10095","2390云辰","110/07/13","日盛-和美",57,0,57
"10096","2390云辰","110/07/13","新光",147,232,-85
"10097","2390云辰","110/07/13","永豐金-桃園",88,36,52
"10098","2390云辰","110/07/13","致和-崇德",2,70,-68
"10099","2390云辰","110/07/13","玉山-士林",54,4,50
"10100","2390云辰","110/07/13","群益金鼎-屏東",2,70,-68
"10101","2390云辰","110/07/13","富邦-仁愛",56,6,50
"10102","2390云辰","110/07/13","元大-大里",35,98,-63
"10103","2390云辰","110/07/13","第一金-豐原",50,1,49
"10104","2390云辰","110/07/13","元大-萬華",35,94,-59
"10105","2390云辰","110/07/13","摩根大通",502,453,49
"10106","2390云辰","110/07/13","元富-吉利",2,60,-58
"10107","2390云辰","110/07/13","凱基-松山",61,13,48
"10108","2390云辰","110/07/13","兆豐-新竹",3,53,-50
"10109","2390云辰","110/07/13","大昌",64,22,42
"10110","2390云辰","110/07/13","富邦-嘉義",65,108,-43
"10111","2363矽統","110/07/13","凱基-南崁",2133,63,2070
"10112","2363矽統","110/07/13","凱基-幸福",36,4048,-4012
"10113","2363矽統","110/07/13","國泰-敦南",2195,1617,578
"10114","2363矽統","110/07/13","統一",192,3325,-3133
"10115","2363矽統","110/07/13","中農",670,139,531
"10116","2363矽統","110/07/13","新加坡商瑞銀",1000,2747,-1747
"10117","2363矽統","110/07/13","康和-台中",638,154,484
"10118","2363矽統","110/07/13","凱基-台北",5359,6609,-1250
"10119","2363矽統","110/07/13","群益金鼎-三民",577,137,440
"10120","2363矽統","110/07/13","摩根大通",1930,2858,-928
"10121","2363矽統","110/07/13","台新-屏東",510,88,422
"10122","2363矽統","110/07/13","港商野村",960,1679,-719
"10123","2363矽統","110/07/13","德信-中正",455,67,388
"10124","2363矽統","110/07/13","兆豐-復興",25,705,-680
"10125","2363矽統","110/07/13","日盛-竹北",365,70,295
"10126","2363矽統","110/07/13","統一-仁愛",114,755,-641
"10127","2363矽統","110/07/13","元大-佳里",452,189,263
"10128","2363矽統","110/07/13","統一-敦南",29,638,-609
"10129","2363矽統","110/07/13","國票-博愛",296,38,258
"10130","2363矽統","110/07/13","統一-土城",100,704,-604
"10131","2363矽統","110/07/13","元大-萬華",340,95,245
"10132","2363矽統","110/07/13","統一-城中",116,676,-560
"10133","2363矽統","110/07/13","新光",1259,1031,228
"10134","2363矽統","110/07/13","永豐金證券",306,859,-553
"10135","2363矽統","110/07/13","元富-成功",323,96,227
"10136","2363矽統","110/07/13","元富",54,567,-513
"10137","2363矽統","110/07/13","豐農",228,23,205
"10138","2363矽統","110/07/13","瑞士信貸",202,666,-464
"10139","2363矽統","110/07/13","台灣企銀-岡山",186,4,182
"10140","2363矽統","110/07/13","永豐金-嘉義",67,468,-401
"10141","8112至上","110/07/13","摩根大通",688,296,392
"10142","8112至上","110/07/13","國票-中和",0,401,-401
"10143","8112至上","110/07/13","港商野村",344,145,199
"10144","8112至上","110/07/13","永豐金-板盛",0,205,-205
"10145","8112至上","110/07/13","兆豐-公益",195,5,190
"10146","8112至上","110/07/13","凱基-五股",43,155,-112
"10147","8112至上","110/07/13","台灣摩根士丹利",183,0,183
"10148","8112至上","110/07/13","凱基-市政",0,100,-100
"10149","8112至上","110/07/13","群益金鼎-敦南",153,2,151
"10150","8112至上","110/07/13","元大-大里德芳",1,92,-91
"10151","8112至上","110/07/13","臺銀-金山",146,26,120
"10152","8112至上","110/07/13","玉山-桃園",26,110,-84
"10153","8112至上","110/07/13","臺銀",133,19,114
"10154","8112至上","110/07/13","兆豐-天母",0,81,-81
"10155","8112至上","110/07/13","合庫-台中",115,6,109
"10156","8112至上","110/07/13","凱基-城中",3,84,-81
"10157","8112至上","110/07/13","亞東-板橋",134,26,108
"10158","8112至上","110/07/13","日盛-新莊",9,85,-76
"10159","8112至上","110/07/13","凱基-台北",414,326,88
"10160","8112至上","110/07/13","日盛-台中",2,64,-62
"10161","8112至上","110/07/13","新加坡商瑞銀",181,100,81
"10162","8112至上","110/07/13","日盛-中壢",3,64,-61
"10163","8112至上","110/07/13","國泰-敦南",108,31,77
"10164","8112至上","110/07/13","元大-台中",2,59,-57
"10165","8112至上","110/07/13","第一金-華江",77,4,73
"10166","8112至上","110/07/13","元大-雙和",7,64,-57
"10167","8112至上","110/07/13","永豐金-內湖",73,1,72
"10168","8112至上","110/07/13","元大-高雄",8,62,-54
"10169","8112至上","110/07/13","元大-永和",68,1,67
"10170","8112至上","110/07/13","元大-館前",2,55,-53
"10171","4903聯光通","110/07/13","台灣企銀-太平",56,0,56
"10172","4903聯光通","110/07/13","土銀",0,32,-32
"10173","4903聯光通","110/07/13","元富-新興",23,0,23
"10174","4903聯光通","110/07/13","元大-樹林",0,19,-19
"10175","4903聯光通","110/07/13","日盛-樹林",22,0,22
"10176","4903聯光通","110/07/13","凱基-士林",0,17,-17
"10177","4903聯光通","110/07/13","兆豐-天母",20,0,20
"10178","4903聯光通","110/07/13","國票-博愛",0,14,-14
"10179","4903聯光通","110/07/13","華南永昌-桃園",20,0,20
"10180","4903聯光通","110/07/13","元富",0,10,-10
"10181","4903聯光通","110/07/13","富邦-新店",10,0,10
"10182","4903聯光通","110/07/13","新光",0,10,-10
"10183","4903聯光通","110/07/13","新光-台中",5,0,5
"10184","4903聯光通","110/07/13","玉山-南京東路",0,10,-10
"10185","4903聯光通","110/07/13","華南永昌-台中",5,0,5
"10186","4903聯光通","110/07/13","富邦-陽明",0,10,-10
"10187","4903聯光通","110/07/13","元大-崇德",5,0,5
"10188","4903聯光通","110/07/13","元大-大甲",0,8,-8
"10189","4903聯光通","110/07/13","元大-草屯",5,0,5
"10190","4903聯光通","110/07/13","富邦-台中",0,7,-7
"10191","4903聯光通","110/07/13","元富-草屯",4,0,4
"10192","4903聯光通","110/07/13","凱基-中壢",0,6,-6
"10193","4903聯光通","110/07/13","元大-清水",4,0,4
"10194","4903聯光通","110/07/13","臺銀-民權",0,5,-5
"10195","4903聯光通","110/07/13","元大-東泰",4,0,4
"10196","4903聯光通","110/07/13","日盛-板橋",0,5,-5
"10197","4903聯光通","110/07/13","元大-佳里",2,0,2
"10198","4903聯光通","110/07/13","中國信託-忠孝",0,5,-5
"10199","4903聯光通","110/07/13","永豐金-板橋",2,0,2
"10200","4903聯光通","110/07/13","永豐金-鳳山",0,5,-5
"10201","2929淘帝","110/07/13","玉山-新竹",130,0,130
"10202","2929淘帝","110/07/13","美商高盛",0,177,-177
"10203","2929淘帝","110/07/13","臺銀-民權",60,0,60
"10204","2929淘帝","110/07/13","凱基-台北",6,80,-74
"10205","2929淘帝","110/07/13","新百王",31,0,31
"10206","2929淘帝","110/07/13","元富-大裕",0,49,-49
"10207","2929淘帝","110/07/13","日盛-園區",30,0,30
"10208","2929淘帝","110/07/13","國泰-館前",3,51,-48
"10209","2929淘帝","110/07/13","元大-南投",31,1,30
"10210","2929淘帝","110/07/13","凱基-中壢",0,41,-41
"10211","2929淘帝","110/07/13","兆豐-忠孝",28,0,28
"10212","2929淘帝","110/07/13","港商野村",21,55,-34
"10213","2929淘帝","110/07/13","元大-民生",28,0,28
"10214","2929淘帝","110/07/13","華南永昌-南京",2,34,-32
"10215","2929淘帝","110/07/13","合庫-高雄",27,0,27
"10216","2929淘帝","110/07/13","群益金鼎-土城",0,30,-30
"10217","2929淘帝","110/07/13","凱基-豐中",27,0,27
"10218","2929淘帝","110/07/13","富邦-南屯",0,22,-22
"10219","2929淘帝","110/07/13","新光",21,4,17
"10220","2929淘帝","110/07/13","第一金-豐原",0,20,-20
"10221","2929淘帝","110/07/13","元大-天母",17,0,17
"10222","2929淘帝","110/07/13","元大-屏南",6,26,-20
"10223","2929淘帝","110/07/13","永興",14,0,14
"10224","2929淘帝","110/07/13","永豐金-敦南",1,21,-20
"10225","2929淘帝","110/07/13","富邦-台北",12,0,12
"10226","2929淘帝","110/07/13","凱基-三重",2,21,-19
"10227","2929淘帝","110/07/13","元大-永和",12,0,12
"10228","2929淘帝","110/07/13","富邦-仁愛",7,25,-18
"10229","2929淘帝","110/07/13","國票-天祥",11,0,11
"10230","2929淘帝","110/07/13","元大-北投",0,16,-16
"10231","5410國眾","110/07/13","兆豐-城中",274,0,274
"10232","5410國眾","110/07/13","元富-嘉義",0,103,-103
"10233","5410國眾","110/07/13","新光",50,4,46
"10234","5410國眾","110/07/13","凱基-台北",0,50,-50
"10235","5410國眾","110/07/13","國泰-台中",26,0,26
"10236","5410國眾","110/07/13","瑞士信貸",0,31,-31
"10237","5410國眾","110/07/13","新加坡商瑞銀",22,0,22
"10238","5410國眾","110/07/13","台新-新莊",0,27,-27
"10239","5410國眾","110/07/13","光和-嘉義",20,0,20
"10240","5410國眾","110/07/13","元大-汐止",0,20,-20
"10241","5410國眾","110/07/13","凱基-竹北",17,0,17
"10242","5410國眾","110/07/13","亞東-新竹",0,17,-17
"10243","5410國眾","110/07/13","新光-桃園",15,0,15
"10244","5410國眾","110/07/13","元大-南勢角",0,13,-13
"10245","5410國眾","110/07/13","凱基-台東",14,0,14
"10246","5410國眾","110/07/13","台新-台南",0,12,-12
"10247","5410國眾","110/07/13","富邦-竹北",11,0,11
"10248","5410國眾","110/07/13","中國信託",0,11,-11
"10249","5410國眾","110/07/13","元富-同大",10,0,10
"10250","5410國眾","110/07/13","華南永昌",0,11,-11
"10251","5410國眾","110/07/13","國泰-敦南",24,15,9
"10252","5410國眾","110/07/13","臺銀-臺南",0,10,-10
"10253","5410國眾","110/07/13","日盛-內湖",7,0,7
"10254","5410國眾","110/07/13","台灣企銀-民雄",0,10,-10
"10255","5410國眾","110/07/13","台新-左楠",7,0,7
"10256","5410國眾","110/07/13","高橋",0,10,-10
"10257","5410國眾","110/07/13","元大-新盛",18,12,6
"10258","5410國眾","110/07/13","康和-嘉義",0,10,-10
"10259","5410國眾","110/07/13","統一",5,0,5
"10260","5410國眾","110/07/13","凱基-基隆",0,10,-10
"10261","2841台開","110/07/13","中國信託-高雄",251,50,201
"10262","2841台開","110/07/13","兆豐-公益",0,177,-177
"10263","2841台開","110/07/13","日盛證券",210,13,197
"10264","2841台開","110/07/13","日進",0,152,-152
"10265","2841台開","110/07/13","第一金-台中",55,0,55
"10266","2841台開","110/07/13","港商野村",0,109,-109
"10267","2841台開","110/07/13","國泰-板橋",46,0,46
"10268","2841台開","110/07/13","日盛-信義",0,103,-103
"10269","2841台開","110/07/13","國泰-館前",48,3,45
"10270","2841台開","110/07/13","國泰-敦南",11,75,-64
"10271","2841台開","110/07/13","華南永昌-新莊",45,0,45
"10272","2841台開","110/07/13","永興",0,50,-50
"10273","2841台開","110/07/13","日盛-園區",42,0,42
"10274","2841台開","110/07/13","永豐金-敦南",61,104,-43
"10275","2841台開","110/07/13","台新證券",32,0,32
"10276","2841台開","110/07/13","富邦-台南",0,42,-42
"10277","2841台開","110/07/13","台新-高雄",32,2,30
"10278","2841台開","110/07/13","國票-安和",0,30,-30
"10279","2841台開","110/07/13","豐農",23,0,23
"10280","2841台開","110/07/13","元大-桃園",0,25,-25
"10281","2841台開","110/07/13","合庫-嘉義",20,0,20
"10282","2841台開","110/07/13","新光",8,32,-24
"10283","2841台開","110/07/13","華南永昌-高雄",20,0,20
"10284","2841台開","110/07/13","元大-仁愛",0,24,-24
"10285","2841台開","110/07/13","元大-樹林",16,0,16
"10286","2841台開","110/07/13","日盛-中和",0,20,-20
"10287","2841台開","110/07/13","第一金-華江",15,2,13
"10288","2841台開","110/07/13","元富",0,20,-20
"10289","2841台開","110/07/13","美商高盛",12,0,12
"10290","2841台開","110/07/13","富邦-宜蘭",0,20,-20
"10291","6207雷科","110/07/13","元大-高雄",121,0,121
"10292","6207雷科","110/07/13","華南永昌-朴子",1,60,-59
"10293","6207雷科","110/07/13","第一金-新興",20,0,20
"10294","6207雷科","110/07/13","元大-南海",0,36,-36
"10295","6207雷科","110/07/13","元富-三重",20,0,20
"10296","6207雷科","110/07/13","凱基-土城",0,35,-35
"10297","6207雷科","110/07/13","元大-林園",15,0,15
"10298","6207雷科","110/07/13","台灣企銀",0,20,-20
"10299","6207雷科","110/07/13","元大-金華",16,1,15
"10300","6207雷科","110/07/13","群益金鼎-丹鳳",0,20,-20
"10301","6207雷科","110/07/13","日盛證券",10,0,10
"10302","6207雷科","110/07/13","元大-博愛",0,17,-17
"10303","6207雷科","110/07/13","統一-台中",10,0,10
"10304","6207雷科","110/07/13","元大-北港",0,13,-13
"10305","6207雷科","110/07/13","群益金鼎-土城",10,0,10
"10306","6207雷科","110/07/13","新加坡商瑞銀",0,12,-12
"10307","6207雷科","110/07/13","群益金鼎-桃園",10,0,10
"10308","6207雷科","110/07/13","凱基-台北",4,16,-12
"10309","6207雷科","110/07/13","永豐金-新莊",10,0,10
"10310","6207雷科","110/07/13","日茂-埔里",0,11,-11
"10311","6207雷科","110/07/13","永豐金-新店",10,0,10
"10312","6207雷科","110/07/13","元大-莒光",0,11,-11
"10313","6207雷科","110/07/13","元大證券",9,0,9
"10314","6207雷科","110/07/13","統一-新竹",0,10,-10
"10315","6207雷科","110/07/13","日盛-木柵",9,1,8
"10316","6207雷科","110/07/13","元大-西螺",0,10,-10
"10317","6207雷科","110/07/13","兆豐-來福",8,0,8
"10318","6207雷科","110/07/13","康和-台中",0,8,-8
"10319","6207雷科","110/07/13","新光",7,0,7
"10320","6207雷科","110/07/13","兆豐-高雄",0,6,-6
"10321","3679新至陞","110/07/13","永豐金證券",50,0,50
"10322","3679新至陞","110/07/13","摩根大通",2,25,-23
"10323","3679新至陞","110/07/13","國泰-桃園",22,0,22
"10324","3679新至陞","110/07/13","元大-成功",0,22,-22
"10325","3679新至陞","110/07/13","台中銀-員林",11,0,11
"10326","3679新至陞","110/07/13","富邦-板橋",1,19,-18
"10327","3679新至陞","110/07/13","元大-文心興安",8,0,8
"10328","3679新至陞","110/07/13","日盛-新莊",0,10,-10
"10329","3679新至陞","110/07/13","美商高盛",6,0,6
"10330","3679新至陞","110/07/13","台新-台中",0,10,-10
"10331","3679新至陞","110/07/13","台新-高雄",6,0,6
"10332","3679新至陞","110/07/13","永豐金-新竹",0,8,-8
"10333","3679新至陞","110/07/13","凱基-台北",18,12,6
"10334","3679新至陞","110/07/13","瑞士信貸",12,19,-7
"10335","3679新至陞","110/07/13","日盛-復興",5,0,5
"10336","3679新至陞","110/07/13","統一-南京",0,7,-7
"10337","3679新至陞","110/07/13","(牛牛牛)亞-鑫豐",4,0,4
"10338","3679新至陞","110/07/13","凱基-新莊",0,7,-7
"10339","3679新至陞","110/07/13","元富-大昌",3,0,3
"10340","3679新至陞","110/07/13","新加坡商瑞銀",0,6,-6
"10341","3679新至陞","110/07/13","富邦-台北",3,0,3
"10342","3679新至陞","110/07/13","合庫-自強",0,5,-5
"10343","3679新至陞","110/07/13","日盛-樹林",2,0,2
"10344","3679新至陞","110/07/13","富邦-桃園",0,5,-5
"10345","3679新至陞","110/07/13","宏遠-光隆",2,0,2
"10346","3679新至陞","110/07/13","永豐金-潮州",0,4,-4
"10347","3679新至陞","110/07/13","美林",3,1,2
"10348","3679新至陞","110/07/13","臺銀-臺南",0,3,-3
"10349","3679新至陞","110/07/13","第一金-中壢",2,0,2
"10350","3679新至陞","110/07/13","元大-六合",0,3,-3
"10351","2727王品","110/07/13","富邦-台北",43,3,40
"10352","2727王品","110/07/13","台灣摩根士丹利",15,97,-82
"10353","2727王品","110/07/13","元大-基隆孝二",40,0,40
"10354","2727王品","110/07/13","玉山-台南",5,57,-52
"10355","2727王品","110/07/13","國票-新莊",40,1,39
"10356","2727王品","110/07/13","新加坡商瑞銀",0,48,-48
"10357","2727王品","110/07/13","第一金-豐原",66,42,24
"10358","2727王品","110/07/13","凱基-台北",41,77,-36
"10359","2727王品","110/07/13","永豐金-大園",34,10,24
"10360","2727王品","110/07/13","永豐金-永康",0,22,-22
"10361","2727王品","110/07/13","元大-北屯",22,0,22
"10362","2727王品","110/07/13","統一-台中",2,22,-20
"10363","2727王品","110/07/13","元大-東蘆",26,7,19
"10364","2727王品","110/07/13","國泰-台中",21,39,-18
"10365","2727王品","110/07/13","永豐金-萬盛",13,1,12
"10366","2727王品","110/07/13","合庫-彰化",3,20,-17
"10367","2727王品","110/07/13","日盛-嘉義",11,0,11
"10368","2727王品","110/07/13","港商野村",13,30,-17
"10369","2727王品","110/07/13","日盛-八德",11,0,11
"10370","2727王品","110/07/13","元大-楊梅",1,16,-15
"10371","2727王品","110/07/13","統一-竹南",11,0,11
"10372","2727王品","110/07/13","凱基-高美館",2,15,-13
"10373","2727王品","110/07/13","日盛-士林",12,2,10
"10374","2727王品","110/07/13","美商高盛",2,14,-12
"10375","2727王品","110/07/13","統一-敦南",10,0,10
"10376","2727王品","110/07/13","統一-平鎮",1,13,-12
"10377","2727王品","110/07/13","中國信託",15,5,10
"10378","2727王品","110/07/13","兆豐-台中港",4,16,-12
"10379","2727王品","110/07/13","兆豐-竹北",13,3,10
"10380","2727王品","110/07/13","凱基-八德",1,13,-12
"10381","1570力肯","110/07/13","新光",115,11,104
"10382","1570力肯","110/07/13","元大-北三重",0,162,-162
"10383","1570力肯","110/07/13","群益金鼎-高雄",54,0,54
"10384","1570力肯","110/07/13","元大-大灣",0,25,-25
"10385","1570力肯","110/07/13","國票-新莊",22,0,22
"10386","1570力肯","110/07/13","永豐金-苓雅",0,22,-22
"10387","1570力肯","110/07/13","日盛-桃園",12,0,12
"10388","1570力肯","110/07/13","永豐金-永康",0,19,-19
"10389","1570力肯","110/07/13","元大-高雄",12,0,12
"10390","1570力肯","110/07/13","富邦-員林",0,15,-15
"10391","1570力肯","110/07/13","合庫-自強",11,0,11
"10392","1570力肯","110/07/13","凱基-台南",0,11,-11
"10393","1570力肯","110/07/13","摩根大通",26,15,11
"10394","1570力肯","110/07/13","日盛-竹北",0,10,-10
"10395","1570力肯","110/07/13","永豐金-中盛",11,0,11
"10396","1570力肯","110/07/13","國票-九鼎",0,10,-10
"10397","1570力肯","110/07/13","兆豐-台中港",10,0,10
"10398","1570力肯","110/07/13","凱基-桃園",0,10,-10
"10399","1570力肯","110/07/13","國泰-松江",9,0,9
"10400","1570力肯","110/07/13","凱基-新豐",0,10,-10
"10401","1570力肯","110/07/13","元大-新盛",9,0,9
"10402","1570力肯","110/07/13","元大-學甲",0,10,-10
"10403","1570力肯","110/07/13","元富-緯城",6,0,6
"10404","1570力肯","110/07/13","群益金鼎-東湖",1,10,-9
"10405","1570力肯","110/07/13","統一-三重",5,0,5
"10406","1570力肯","110/07/13","大昌",0,6,-6
"10407","1570力肯","110/07/13","元大-前金",5,0,5
"10408","1570力肯","110/07/13","元大-土城學府",0,6,-6
"10409","1570力肯","110/07/13","永豐金證券",5,0,5
"10410","1570力肯","110/07/13","統一",0,5,-5
"10411","6180橘子","110/07/13","摩根大通",119,0,119
"10412","6180橘子","110/07/13","元大-崇德",2,61,-59
"10413","6180橘子","110/07/13","美商高盛",96,0,96
"10414","6180橘子","110/07/13","康和-台中",0,51,-51
"10415","6180橘子","110/07/13","新加坡商瑞銀",86,7,79
"10416","6180橘子","110/07/13","康和-台北",0,50,-50
"10417","6180橘子","110/07/13","元大-和平",40,0,40
"10418","6180橘子","110/07/13","元富-潮州",0,40,-40
"10419","6180橘子","110/07/13","凱基-台北",83,47,36
"10420","6180橘子","110/07/13","日盛-永康",0,26,-26
"10421","6180橘子","110/07/13","美林",39,5,34
"10422","6180橘子","110/07/13","永豐金-中正",0,24,-24
"10423","6180橘子","110/07/13","富邦-新竹華信",31,2,29
"10424","6180橘子","110/07/13","國泰-板橋",2,25,-23
"10425","6180橘子","110/07/13","統一-南京",21,0,21
"10426","6180橘子","110/07/13","日盛-大墩",0,20,-20
"10427","6180橘子","110/07/13","富邦-陽明",24,3,21
"10428","6180橘子","110/07/13","元大-草屯",13,32,-19
"10429","6180橘子","110/07/13","大昌-樹林",21,1,20
"10430","6180橘子","110/07/13","元富-林園",1,18,-17
"10431","6180橘子","110/07/13","花旗環球",19,0,19
"10432","6180橘子","110/07/13","新光-新竹",1,18,-17
"10433","6180橘子","110/07/13","華南永昌-台南",19,0,19
"10434","6180橘子","110/07/13","元大-土城永寧",0,17,-17
"10435","6180橘子","110/07/13","福勝",14,0,14
"10436","6180橘子","110/07/13","國泰-新莊",3,19,-16
"10437","6180橘子","110/07/13","富邦-嘉義",12,1,11
"10438","6180橘子","110/07/13","中國信託-永康",6,21,-15
"10439","6180橘子","110/07/13","元大-板橋三民",11,0,11
"10440","6180橘子","110/07/13","凱基-東港",1,15,-14
"10441","2390云辰","110/07/13","新加坡商瑞銀",562,75,487
"10442","2390云辰","110/07/13","大展-台南",0,532,-532
"10443","2390云辰","110/07/13","台灣摩根士丹利",330,155,175
"10444","2390云辰","110/07/13","凱基-台北",668,854,-186
"10445","2390云辰","110/07/13","兆豐-公益",126,25,101
"10446","2390云辰","110/07/13","凱基-三重",12,172,-160
"10447","2390云辰","110/07/13","元富-中港",100,2,98
"10448","2390云辰","110/07/13","兆豐-忠孝",4,161,-157
"10449","2390云辰","110/07/13","統一-新台中",106,9,97
"10450","2390云辰","110/07/13","元大-士林",19,170,-151
"10451","2390云辰","110/07/13","中國信託-松江",81,11,70
"10452","2390云辰","110/07/13","臺銀-新竹",14,117,-103
"10453","2390云辰","110/07/13","日盛-板橋",72,3,69
"10454","2390云辰","110/07/13","國票-台中",4,102,-98
"10455","2390云辰","110/07/13","日盛-和美",57,0,57
"10456","2390云辰","110/07/13","新光",147,232,-85
"10457","2390云辰","110/07/13","永豐金-桃園",88,36,52
"10458","2390云辰","110/07/13","致和-崇德",2,70,-68
"10459","2390云辰","110/07/13","玉山-士林",54,4,50
"10460","2390云辰","110/07/13","群益金鼎-屏東",2,70,-68
"10461","2390云辰","110/07/13","富邦-仁愛",56,6,50
"10462","2390云辰","110/07/13","元大-大里",35,98,-63
"10463","2390云辰","110/07/13","第一金-豐原",50,1,49
"10464","2390云辰","110/07/13","元大-萬華",35,94,-59
"10465","2390云辰","110/07/13","摩根大通",502,453,49
"10466","2390云辰","110/07/13","元富-吉利",2,60,-58
"10467","2390云辰","110/07/13","凱基-松山",61,13,48
"10468","2390云辰","110/07/13","兆豐-新竹",3,53,-50
"10469","2390云辰","110/07/13","大昌",64,22,42
"10470","2390云辰","110/07/13","富邦-嘉義",65,108,-43
"10471","2363矽統","110/07/12","凱基-幸福",4046,31,4015
"10472","2363矽統","110/07/12","台新證券",478,2105,-1627
"10473","2363矽統","110/07/12","統一",3504,120,3384
"10474","2363矽統","110/07/12","第一金-忠孝",4,1068,-1064
"10475","2363矽統","110/07/12","摩根大通",3006,2149,857
"10476","2363矽統","110/07/12","台新-台中",381,1003,-622
"10477","2363矽統","110/07/12","永豐金證券",1428,610,818
"10478","2363矽統","110/07/12","新光",1295,1822,-527
"10479","2363矽統","110/07/12","兆豐-復興",1936,1233,703
"10480","2363矽統","110/07/12","大昌-樹林",54,537,-483
"10481","2363矽統","110/07/12","台灣摩根士丹利",701,0,701
"10482","2363矽統","110/07/12","華南永昌-台中",90,549,-459
"10483","2363矽統","110/07/12","永豐金-南投",803,145,658
"10484","2363矽統","110/07/12","玉山-高雄",167,612,-445
"10485","2363矽統","110/07/12","統一-仁愛",1214,586,628
"10486","2363矽統","110/07/12","元富-同大",201,540,-339
"10487","2363矽統","110/07/12","統一-土城",688,75,613
"10488","2363矽統","110/07/12","華南永昌-東勢",31,367,-336
"10489","2363矽統","110/07/12","統一-城中",711,131,580
"10490","2363矽統","110/07/12","土銀-花蓮",9,333,-324
"10491","2363矽統","110/07/12","統一-敦南",632,54,578
"10492","2363矽統","110/07/12","凱基-豐中",120,434,-314
"10493","2363矽統","110/07/12","新加坡商瑞銀",1232,731,501
"10494","2363矽統","110/07/12","永豐金-竹科",54,323,-269
"10495","2363矽統","110/07/12","元富",2640,2142,498
"10496","2363矽統","110/07/12","元大-斗六",53,300,-247
"10497","2363矽統","110/07/12","凱基-永和",460,31,429
"10498","2363矽統","110/07/12","華南永昌-朴子",47,278,-231
"10499","2363矽統","110/07/12","第一金",380,22,358
"10500","2363矽統","110/07/12","永豐金-彰化",22,228,-206
"10501","8112至上","110/07/12","摩根大通",1167,290,877
"10502","8112至上","110/07/12","群益金鼎-新莊",1,156,-155
"10503","8112至上","110/07/12","凱基-台北",983,546,437
"10504","8112至上","110/07/12","國票-中港",0,131,-131
"10505","8112至上","110/07/12","新加坡商瑞銀",429,12,417
"10506","8112至上","110/07/12","元大證券",10,136,-126
"10507","8112至上","110/07/12","元大-屏南",360,2,358
"10508","8112至上","110/07/12","元大-中壢",11,135,-124
"10509","8112至上","110/07/12","美林",323,15,308
"10510","8112至上","110/07/12","合庫-基隆",0,122,-122
"10511","8112至上","110/07/12","台灣摩根士丹利",299,0,299
"10512","8112至上","110/07/12","群益金鼎-高盛",4,103,-99
"10513","8112至上","110/07/12","港商野村",267,28,239
"10514","8112至上","110/07/12","新光",110,202,-92
"10515","8112至上","110/07/12","大慶",165,3,162
"10516","8112至上","110/07/12","元大-府城",2,94,-92
"10517","8112至上","110/07/12","永豐金-台南",170,29,141
"10518","8112至上","110/07/12","富邦-板橋",5,92,-87
"10519","8112至上","110/07/12","華南永昌-長虹",128,2,126
"10520","8112至上","110/07/12","元大-土城",8,89,-81
"10521","8112至上","110/07/12","富邦-仁愛",157,51,106
"10522","8112至上","110/07/12","日盛-頭份",40,117,-77
"10523","8112至上","110/07/12","瑞士信貸",104,0,104
"10524","8112至上","110/07/12","玉山-嘉義",3,80,-77
"10525","8112至上","110/07/12","凱基-站前",100,11,89
"10526","8112至上","110/07/12","永豐金-松山",4,79,-75
"10527","8112至上","110/07/12","富邦-北港",90,3,87
"10528","8112至上","110/07/12","元大-敦南",3,75,-72
"10529","8112至上","110/07/12","元大-北港",101,20,81
"10530","8112至上","110/07/12","元富-大裕",6,77,-71
"10531","4903聯光通","110/07/12","台灣企銀-太平",19,0,19
"10532","4903聯光通","110/07/12","玉山-南京東路",0,16,-16
"10533","4903聯光通","110/07/12","統一-土城",17,0,17
"10534","4903聯光通","110/07/12","新光",0,14,-14
"10535","4903聯光通","110/07/12","國票-博愛",14,0,14
"10536","4903聯光通","110/07/12","兆豐-彰化",0,10,-10
"10537","4903聯光通","110/07/12","新光-台中",15,2,13
"10538","4903聯光通","110/07/12","國票",0,10,-10
"10539","4903聯光通","110/07/12","元大-彰化",11,0,11
"10540","4903聯光通","110/07/12","富邦-敦南",0,10,-10
"10541","4903聯光通","110/07/12","華南永昌-林口",10,0,10
"10542","4903聯光通","110/07/12","元大-前金",0,9,-9
"10543","4903聯光通","110/07/12","永豐金-南投",9,0,9
"10544","4903聯光通","110/07/12","日盛-頭份",0,8,-8
"10545","4903聯光通","110/07/12","元大-清水",8,0,8
"10546","4903聯光通","110/07/12","元大-太平",0,8,-8
"10547","4903聯光通","110/07/12","元大-博愛",8,0,8
"10548","4903聯光通","110/07/12","兆豐-埔墘",0,7,-7
"10549","4903聯光通","110/07/12","玉山-新莊",5,0,5
"10550","4903聯光通","110/07/12","臺銀-民權",0,5,-5
"10551","4903聯光通","110/07/12","凱基-士林",10,5,5
"10552","4903聯光通","110/07/12","富邦-板橋",0,5,-5
"10553","4903聯光通","110/07/12","元大-斗六",4,0,4
"10554","4903聯光通","110/07/12","元大-土城永寧",0,5,-5
"10555","4903聯光通","110/07/12","永豐金-羅東",4,0,4
"10556","4903聯光通","110/07/12","台新證券",0,4,-4
"10557","4903聯光通","110/07/12","日盛-樹林",3,0,3
"10558","4903聯光通","110/07/12","凱基-中壢",0,4,-4
"10559","4903聯光通","110/07/12","華南永昌-鶯歌",2,0,2
"10560","4903聯光通","110/07/12","元大-羅東",0,4,-4
"10561","2929淘帝","110/07/12","新光-台中",95,36,59
"10562","2929淘帝","110/07/12","華南永昌-林口",7,208,-201
"10563","2929淘帝","110/07/12","富邦-板橋",62,5,57
"10564","2929淘帝","110/07/12","富邦-台北",6,200,-194
"10565","2929淘帝","110/07/12","合庫-高雄",56,6,50
"10566","2929淘帝","110/07/12","元富-大裕",11,200,-189
"10567","2929淘帝","110/07/12","永興",41,0,41
"10568","2929淘帝","110/07/12","台中銀-台北",0,160,-160
"10569","2929淘帝","110/07/12","兆豐-忠孝",58,18,40
"10570","2929淘帝","110/07/12","日盛-園區",1,111,-110
"10571","2929淘帝","110/07/12","新光-高雄",39,3,36
"10572","2929淘帝","110/07/12","日盛-八德",0,88,-88
"10573","2929淘帝","110/07/12","凱基-豐中",36,0,36
"10574","2929淘帝","110/07/12","玉山-新竹",32,110,-78
"10575","2929淘帝","110/07/12","元大-民生",35,0,35
"10576","2929淘帝","110/07/12","元大-前金",0,72,-72
"10577","2929淘帝","110/07/12","臺銀-臺南",32,1,31
"10578","2929淘帝","110/07/12","元大-館前",12,83,-71
"10579","2929淘帝","110/07/12","台新證券",44,13,31
"10580","2929淘帝","110/07/12","華南永昌",1,57,-56
"10581","2929淘帝","110/07/12","新百王",30,0,30
"10582","2929淘帝","110/07/12","元大-南崁",4,59,-55
"10583","2929淘帝","110/07/12","群益金鼎-大興",30,0,30
"10584","2929淘帝","110/07/12","元大-嘉義",0,51,-51
"10585","2929淘帝","110/07/12","凱基-台北",32,5,27
"10586","2929淘帝","110/07/12","日茂",1,50,-49
"10587","2929淘帝","110/07/12","元富-城東",26,0,26
"10588","2929淘帝","110/07/12","新光",35,83,-48
"10589","2929淘帝","110/07/12","國泰-松江",26,0,26
"10590","2929淘帝","110/07/12","日盛-新竹",1,48,-47
"10591","5410國眾","110/07/12","群益金鼎-中壢",68,0,68
"10592","5410國眾","110/07/12","摩根大通",6,67,-61
"10593","5410國眾","110/07/12","凱基-市政",40,0,40
"10594","5410國眾","110/07/12","元富-嘉義",0,60,-60
"10595","5410國眾","110/07/12","凱基-竹北",38,0,38
"10596","5410國眾","110/07/12","凱基-台北",0,51,-51
"10597","5410國眾","110/07/12","華南永昌-三重",30,0,30
"10598","5410國眾","110/07/12","元富-大裕",0,33,-33
"10599","5410國眾","110/07/12","永興",20,0,20
"10600","5410國眾","110/07/12","日盛-木柵",0,15,-15
"10601","5410國眾","110/07/12","統一-新台中",20,0,20
"10602","5410國眾","110/07/12","群益金鼎-民權",0,15,-15
"10603","5410國眾","110/07/12","兆豐-三重",20,0,20
"10604","5410國眾","110/07/12","元富-緯城",0,14,-14
"10605","5410國眾","110/07/12","富邦-台中",20,0,20
"10606","5410國眾","110/07/12","元大-大同",0,12,-12
"10607","5410國眾","110/07/12","臺銀",15,0,15
"10608","5410國眾","110/07/12","元大-莒光",0,10,-10
"10609","5410國眾","110/07/12","新光-桃園",20,6,14
"10610","5410國眾","110/07/12","元大-博愛",0,10,-10
"10611","5410國眾","110/07/12","元大-員林",12,0,12
"10612","5410國眾","110/07/12","日盛-永康",0,8,-8
"10613","5410國眾","110/07/12","日盛-員林",10,0,10
"10614","5410國眾","110/07/12","元大-四維",5,13,-8
"10615","5410國眾","110/07/12","元大-新盛",10,0,10
"10616","5410國眾","110/07/12","新加坡商瑞銀",0,7,-7
"10617","5410國眾","110/07/12","永豐金-台南",10,0,10
"10618","5410國眾","110/07/12","致和-金華",0,7,-7
"10619","5410國眾","110/07/12","元富-新莊",8,0,8
"10620","5410國眾","110/07/12","新光-新竹",0,7,-7
"10621","2841台開","110/07/12","永豐金-敦南",139,26,113
"10622","2841台開","110/07/12","華南永昌-朴子",0,528,-528
"10623","2841台開","110/07/12","日盛-雙和",68,0,68
"10624","2841台開","110/07/12","元大-苑裡",2,50,-48
"10625","2841台開","110/07/12","台新證券",62,4,58
"10626","2841台開","110/07/12","群益金鼎-東湖",0,40,-40
"10627","2841台開","110/07/12","凱基-文心",50,0,50
"10628","2841台開","110/07/12","第一金-員林",0,30,-30
"10629","2841台開","110/07/12","第一金-台中",45,0,45
"10630","2841台開","110/07/12","德信-中正",0,20,-20
"10631","2841台開","110/07/12","富邦-嘉義",40,0,40
"10632","2841台開","110/07/12","兆豐-嘉義",0,20,-20
"10633","2841台開","110/07/12","日盛-木柵",30,0,30
"10634","2841台開","110/07/12","彰銀-七賢",0,15,-15
"10635","2841台開","110/07/12","中國信託-文心",31,3,28
"10636","2841台開","110/07/12","元大-承德",0,14,-14
"10637","2841台開","110/07/12","元大-福營",30,7,23
"10638","2841台開","110/07/12","元富",0,12,-12
"10639","2841台開","110/07/12","台中銀",20,0,20
"10640","2841台開","110/07/12","富邦-陽明",0,11,-11
"10641","2841台開","110/07/12","國泰-板橋",20,0,20
"10642","2841台開","110/07/12","元大證券",0,11,-11
"10643","2841台開","110/07/12","元大-前金",20,0,20
"10644","2841台開","110/07/12","元大-大甲",0,10,-10
"10645","2841台開","110/07/12","中國信託-高雄",16,1,15
"10646","2841台開","110/07/12","日盛-新竹",0,8,-8
"10647","2841台開","110/07/12","陽信-石牌",15,0,15
"10648","2841台開","110/07/12","元富-城東",0,8,-8
"10649","2841台開","110/07/12","永豐金-南投",15,0,15
"10650","2841台開","110/07/12","玉山-台南",2,10,-8
"10651","6207雷科","110/07/12","元大-高雄",34,0,34
"10652","6207雷科","110/07/12","永豐金-三重",1,32,-31
"10653","6207雷科","110/07/12","華南永昌-林口",16,1,15
"10654","6207雷科","110/07/12","永全-八德",0,30,-30
"10655","6207雷科","110/07/12","摩根大通",19,6,13
"10656","6207雷科","110/07/12","國泰-台中",0,14,-14
"10657","6207雷科","110/07/12","元富-埔里",10,0,10
"10658","6207雷科","110/07/12","第一金-澎湖",0,10,-10
"10659","6207雷科","110/07/12","凱基-台南",10,0,10
"10660","6207雷科","110/07/12","元富-林園",0,10,-10
"10661","6207雷科","110/07/12","新加坡商瑞銀",9,0,9
"10662","6207雷科","110/07/12","元大-東門",0,10,-10
"10663","6207雷科","110/07/12","瑞士信貸",8,0,8
"10664","6207雷科","110/07/12","兆豐-嘉義",0,4,-4
"10665","6207雷科","110/07/12","中國信託-高雄",9,1,8
"10666","6207雷科","110/07/12","新光",0,4,-4
"10667","6207雷科","110/07/12","凱基-高雄",6,0,6
"10668","6207雷科","110/07/12","新光-台中",0,4,-4
"10669","6207雷科","110/07/12","元大-六合",6,0,6
"10670","6207雷科","110/07/12","群益金鼎-開元",0,4,-4
"10671","6207雷科","110/07/12","永豐金-信義",6,0,6
"10672","6207雷科","110/07/12","凱基-桃園",0,4,-4
"10673","6207雷科","110/07/12","群益金鼎-土城",5,0,5
"10674","6207雷科","110/07/12","凱基-民權",0,4,-4
"10675","6207雷科","110/07/12","群益金鼎-竹南",5,0,5
"10676","6207雷科","110/07/12","玉山-新莊",0,3,-3
"10677","6207雷科","110/07/12","元大-大灣",5,1,4
"10678","6207雷科","110/07/12","國泰-松江",0,3,-3
"10679","6207雷科","110/07/12","永興",3,0,3
"10680","6207雷科","110/07/12","富邦-羅東",0,3,-3
"10681","3679新至陞","110/07/12","富邦-新竹華信",40,2,38
"10682","3679新至陞","110/07/12","瑞士信貸",0,45,-45
"10683","3679新至陞","110/07/12","台中銀-員林",28,2,26
"10684","3679新至陞","110/07/12","永豐金-天母",0,39,-39
"10685","3679新至陞","110/07/12","聯邦-大業",24,0,24
"10686","3679新至陞","110/07/12","摩根大通",7,35,-28
"10687","3679新至陞","110/07/12","永豐金證券",20,0,20
"10688","3679新至陞","110/07/12","凱基-台北",8,36,-28
"10689","3679新至陞","110/07/12","港商法國興業",14,0,14
"10690","3679新至陞","110/07/12","華南永昌-小港",1,23,-22
"10691","3679新至陞","110/07/12","日盛-樹林",13,1,12
"10692","3679新至陞","110/07/12","台新-台中",0,15,-15
"10693","3679新至陞","110/07/12","國泰-桃園",9,0,9
"10694","3679新至陞","110/07/12","統一-台中",0,12,-12
"10695","3679新至陞","110/07/12","宏遠-館前",8,0,8
"10696","3679新至陞","110/07/12","元大-成功",1,12,-11
"10697","3679新至陞","110/07/12","凱基",10,2,8
"10698","3679新至陞","110/07/12","康和-澎湖",0,8,-8
"10699","3679新至陞","110/07/12","(牛牛牛)亞-網路",7,0,7
"10700","3679新至陞","110/07/12","新加坡商瑞銀",0,7,-7
"10701","3679新至陞","110/07/12","兆豐-員林",7,0,7
"10702","3679新至陞","110/07/12","兆豐-來福",0,7,-7
"10703","3679新至陞","110/07/12","大慶-蘆洲",5,0,5
"10704","3679新至陞","110/07/12","元大-佳里",0,6,-6
"10705","3679新至陞","110/07/12","土銀-花蓮",4,0,4
"10706","3679新至陞","110/07/12","美商高盛",0,5,-5
"10707","3679新至陞","110/07/12","台新-高雄",5,1,4
"10708","3679新至陞","110/07/12","國票-新莊",0,5,-5
"10709","3679新至陞","110/07/12","元大-天母",4,0,4
"10710","3679新至陞","110/07/12","台新-屏東",0,5,-5
"10711","2727王品","110/07/12","凱基-台北",354,198,156
"10712","2727王品","110/07/12","台灣摩根士丹利",5,386,-381
"10713","2727王品","110/07/12","統一-城中",159,22,137
"10714","2727王品","110/07/12","元大-嘉義",4,60,-56
"10715","2727王品","110/07/12","日盛-忠孝",60,0,60
"10716","2727王品","110/07/12","元大-大同",2,44,-42
"10717","2727王品","110/07/12","永豐金-忠孝",45,5,40
"10718","2727王品","110/07/12","國泰-台中",32,73,-41
"10719","2727王品","110/07/12","合庫-新竹",31,0,31
"10720","2727王品","110/07/12","元大證券",127,163,-36
"10721","2727王品","110/07/12","富邦-台中",31,3,28
"10722","2727王品","110/07/12","凱基",1,33,-32
"10723","2727王品","110/07/12","元大-桃園",35,10,25
"10724","2727王品","110/07/12","永全-南崁",1,31,-30
"10725","2727王品","110/07/12","新加坡商瑞銀",28,4,24
"10726","2727王品","110/07/12","凱基-和平",2,32,-30
"10727","2727王品","110/07/12","群益金鼎-古亭",25,2,23
"10728","2727王品","110/07/12","永豐金-大園",8,38,-30
"10729","2727王品","110/07/12","元大-龍潭",29,7,22
"10730","2727王品","110/07/12","瑞士信貸",0,28,-28
"10731","2727王品","110/07/12","永豐金-永康",25,3,22
"10732","2727王品","110/07/12","元富",17,44,-27
"10733","2727王品","110/07/12","富邦-竹北",24,3,21
"10734","2727王品","110/07/12","元大-北屯",5,32,-27
"10735","2727王品","110/07/12","群益金鼎-松山",20,0,20
"10736","2727王品","110/07/12","華南永昌",3,28,-25
"10737","2727王品","110/07/12","元大-八德",20,0,20
"10738","2727王品","110/07/12","統一-竹南",1,23,-22
"10739","2727王品","110/07/12","元大-南京",25,6,19
"10740","2727王品","110/07/12","永豐金證券",4,26,-22
"10741","1570力肯","110/07/12","國票-北高雄",40,0,40
"10742","1570力肯","110/07/12","日盛-竹北",0,40,-40
"10743","1570力肯","110/07/12","摩根大通",16,0,16
"10744","1570力肯","110/07/12","第一金-華江",1,38,-37
"10745","1570力肯","110/07/12","新光",31,19,12
"10746","1570力肯","110/07/12","元大-永春",0,26,-26
"10747","1570力肯","110/07/12","元大-台中中港",12,0,12
"10748","1570力肯","110/07/12","元大-古亭",1,20,-19
"10749","1570力肯","110/07/12","日盛-高雄",10,0,10
"10750","1570力肯","110/07/12","國泰-松江",0,16,-16
"10751","1570力肯","110/07/12","第一金-路竹",10,0,10
"10752","1570力肯","110/07/12","台新-台南",0,15,-15
"10753","1570力肯","110/07/12","台新-新莊",10,0,10
"10754","1570力肯","110/07/12","康和-石牌",0,15,-15
"10755","1570力肯","110/07/12","元大-新盛",9,0,9
"10756","1570力肯","110/07/12","國泰-板橋",0,11,-11
"10757","1570力肯","110/07/12","凱基-台北",8,0,8
"10758","1570力肯","110/07/12","元大-高雄",0,11,-11
"10759","1570力肯","110/07/12","彰銀-七賢",6,0,6
"10760","1570力肯","110/07/12","兆豐-桃園",0,10,-10
"10761","1570力肯","110/07/12","元富-緯城",6,0,6
"10762","1570力肯","110/07/12","元大-大益",0,10,-10
"10763","1570力肯","110/07/12","華南永昌-古亭",6,0,6
"10764","1570力肯","110/07/12","中國信託-文心",0,5,-5
"10765","1570力肯","110/07/12","富邦-陽明",6,0,6
"10766","1570力肯","110/07/12","光和",0,5,-5
"10767","1570力肯","110/07/12","臺銀-臺南",5,0,5
"10768","1570力肯","110/07/12","陽信-石牌",0,5,-5
"10769","1570力肯","110/07/12","宏遠-館前",5,0,5
"10770","1570力肯","110/07/12","國泰-高雄",0,5,-5
"10771","6180橘子","110/07/12","康和-台中",32,2,30
"10772","6180橘子","110/07/12","新百王",1,40,-39
"10773","6180橘子","110/07/12","美林",32,3,29
"10774","6180橘子","110/07/12","富邦-陽明",4,42,-38
"10775","6180橘子","110/07/12","元大-羅東",21,0,21
"10776","6180橘子","110/07/12","新光",3,32,-29
"10777","6180橘子","110/07/12","兆豐-埔墘",16,0,16
"10778","6180橘子","110/07/12","日盛-文化",4,20,-16
"10779","6180橘子","110/07/12","元大-雙和",12,0,12
"10780","6180橘子","110/07/12","華南永昌-鶯歌",0,15,-15
"10781","6180橘子","110/07/12","美商高盛",18,7,11
"10782","6180橘子","110/07/12","中國信託-忠孝",7,20,-13
"10783","6180橘子","110/07/12","台新證券",14,3,11
"10784","6180橘子","110/07/12","凱基-台北",5,17,-12
"10785","6180橘子","110/07/12","元大-中壢",12,1,11
"10786","6180橘子","110/07/12","凱基-高雄",0,11,-11
"10787","6180橘子","110/07/12","統一-南京",10,0,10
"10788","6180橘子","110/07/12","凱基-大安",0,10,-10
"10789","6180橘子","110/07/12","致和-崇德",10,0,10
"10790","6180橘子","110/07/12","元大-北屯",0,10,-10
"10791","6180橘子","110/07/12","玉山-板橋",10,0,10
"10792","6180橘子","110/07/12","元大-南京",0,9,-9
"10793","6180橘子","110/07/12","富邦-仁愛",10,0,10
"10794","6180橘子","110/07/12","元大-台南",1,10,-9
"10795","6180橘子","110/07/12","摩根大通",10,1,9
"10796","6180橘子","110/07/12","康和-澎湖",0,8,-8
"10797","6180橘子","110/07/12","元富-林園",8,0,8
"10798","6180橘子","110/07/12","第一金-台中",0,7,-7
"10799","6180橘子","110/07/12","大慶-富順",7,0,7
"10800","6180橘子","110/07/12","台新-台南",1,8,-7
"10801","2390云辰","110/07/12","統一-新台中",170,0,170
"10802","2390云辰","110/07/12","元大-天母",2,450,-448
"10803","2390云辰","110/07/12","華南永昌-麻豆",137,2,135
"10804","2390云辰","110/07/12","國泰-忠孝",1,143,-142
"10805","2390云辰","110/07/12","元富-成功",103,14,89
"10806","2390云辰","110/07/12","摩根大通",377,512,-135
"10807","2390云辰","110/07/12","元大-土城學府",146,69,77
"10808","2390云辰","110/07/12","台灣摩根士丹利",0,91,-91
"10809","2390云辰","110/07/12","永豐金-永康",76,4,72
"10810","2390云辰","110/07/12","美林",84,146,-62
"10811","2390云辰","110/07/12","台中銀",73,2,71
"10812","2390云辰","110/07/12","華南永昌-嘉義",2,61,-59
"10813","2390云辰","110/07/12","大昌",63,3,60
"10814","2390云辰","110/07/12","永豐金-羅東",0,49,-49
"10815","2390云辰","110/07/12","合庫-三重",50,0,50
"10816","2390云辰","110/07/12","玉山-台中",6,53,-47
"10817","2390云辰","110/07/12","元富-高雄",93,50,43
"10818","2390云辰","110/07/12","玉山-新莊",2,48,-46
"10819","2390云辰","110/07/12","元大-館前",40,4,36
"10820","2390云辰","110/07/12","元大-大里",7,52,-45
"10821","2390云辰","110/07/12","港商野村",143,109,34
"10822","2390云辰","110/07/12","元大-內湖",3,48,-45
"10823","2390云辰","110/07/12","元大-雙和",34,0,34
"10824","2390云辰","110/07/12","永豐金-市政",1,42,-41
"10825","2390云辰","110/07/12","群益金鼎-民權",33,2,31
"10826","2390云辰","110/07/12","元大-學甲",1,41,-40
"10827","2390云辰","110/07/12","日盛-八德",40,10,30
"10828","2390云辰","110/07/12","兆豐-高雄",2,41,-39
"10829","2390云辰","110/07/12","國票-嘉義",30,0,30
"10830","2390云辰","110/07/12","新加坡商瑞銀",21,59,-38
"10831","4903聯光通","110/07/12","台灣企銀-太平",19,0,19
"10832","4903聯光通","110/07/12","玉山-南京東路",0,16,-16
"10833","4903聯光通","110/07/12","統一-土城",17,0,17
"10834","4903聯光通","110/07/12","新光",0,14,-14
"10835","4903聯光通","110/07/12","國票-博愛",14,0,14
"10836","4903聯光通","110/07/12","兆豐-彰化",0,10,-10
"10837","4903聯光通","110/07/12","新光-台中",15,2,13
"10838","4903聯光通","110/07/12","國票",0,10,-10
"10839","4903聯光通","110/07/12","元大-彰化",11,0,11
"10840","4903聯光通","110/07/12","富邦-敦南",0,10,-10
"10841","4903聯光通","110/07/12","華南永昌-林口",10,0,10
"10842","4903聯光通","110/07/12","元大-前金",0,9,-9
"10843","4903聯光通","110/07/12","永豐金-南投",9,0,9
"10844","4903聯光通","110/07/12","日盛-頭份",0,8,-8
"10845","4903聯光通","110/07/12","元大-清水",8,0,8
"10846","4903聯光通","110/07/12","元大-太平",0,8,-8
"10847","4903聯光通","110/07/12","元大-博愛",8,0,8
"10848","4903聯光通","110/07/12","兆豐-埔墘",0,7,-7
"10849","4903聯光通","110/07/12","玉山-新莊",5,0,5
"10850","4903聯光通","110/07/12","臺銀-民權",0,5,-5
"10851","4903聯光通","110/07/12","凱基-士林",10,5,5
"10852","4903聯光通","110/07/12","富邦-板橋",0,5,-5
"10853","4903聯光通","110/07/12","元大-斗六",4,0,4
"10854","4903聯光通","110/07/12","元大-土城永寧",0,5,-5
"10855","4903聯光通","110/07/12","永豐金-羅東",4,0,4
"10856","4903聯光通","110/07/12","台新證券",0,4,-4
"10857","4903聯光通","110/07/12","日盛-樹林",3,0,3
"10858","4903聯光通","110/07/12","凱基-中壢",0,4,-4
"10859","4903聯光通","110/07/12","華南永昌-鶯歌",2,0,2
"10860","4903聯光通","110/07/12","元大-羅東",0,4,-4
"10861","2929淘帝","110/07/12","新光-台中",95,36,59
"10862","2929淘帝","110/07/12","華南永昌-林口",7,208,-201
"10863","2929淘帝","110/07/12","富邦-板橋",62,5,57
"10864","2929淘帝","110/07/12","富邦-台北",6,200,-194
"10865","2929淘帝","110/07/12","合庫-高雄",56,6,50
"10866","2929淘帝","110/07/12","元富-大裕",11,200,-189
"10867","2929淘帝","110/07/12","永興",41,0,41
"10868","2929淘帝","110/07/12","台中銀-台北",0,160,-160
"10869","2929淘帝","110/07/12","兆豐-忠孝",58,18,40
"10870","2929淘帝","110/07/12","日盛-園區",1,111,-110
"10871","2929淘帝","110/07/12","新光-高雄",39,3,36
"10872","2929淘帝","110/07/12","日盛-八德",0,88,-88
"10873","2929淘帝","110/07/12","凱基-豐中",36,0,36
"10874","2929淘帝","110/07/12","玉山-新竹",32,110,-78
"10875","2929淘帝","110/07/12","元大-民生",35,0,35
"10876","2929淘帝","110/07/12","元大-前金",0,72,-72
"10877","2929淘帝","110/07/12","臺銀-臺南",32,1,31
"10878","2929淘帝","110/07/12","元大-館前",12,83,-71
"10879","2929淘帝","110/07/12","台新證券",44,13,31
"10880","2929淘帝","110/07/12","華南永昌",1,57,-56
"10881","2929淘帝","110/07/12","新百王",30,0,30
"10882","2929淘帝","110/07/12","元大-南崁",4,59,-55
"10883","2929淘帝","110/07/12","群益金鼎-大興",30,0,30
"10884","2929淘帝","110/07/12","元大-嘉義",0,51,-51
"10885","2929淘帝","110/07/12","凱基-台北",32,5,27
"10886","2929淘帝","110/07/12","日茂",1,50,-49
"10887","2929淘帝","110/07/12","元富-城東",26,0,26
"10888","2929淘帝","110/07/12","新光",35,83,-48
"10889","2929淘帝","110/07/12","國泰-松江",26,0,26
"10890","2929淘帝","110/07/12","日盛-新竹",1,48,-47
"10891","5410國眾","110/07/12","群益金鼎-中壢",68,0,68
"10892","5410國眾","110/07/12","摩根大通",6,67,-61
"10893","5410國眾","110/07/12","凱基-市政",40,0,40
"10894","5410國眾","110/07/12","元富-嘉義",0,60,-60
"10895","5410國眾","110/07/12","凱基-竹北",38,0,38
"10896","5410國眾","110/07/12","凱基-台北",0,51,-51
"10897","5410國眾","110/07/12","華南永昌-三重",30,0,30
"10898","5410國眾","110/07/12","元富-大裕",0,33,-33
"10899","5410國眾","110/07/12","永興",20,0,20
"10900","5410國眾","110/07/12","日盛-木柵",0,15,-15
"10901","5410國眾","110/07/12","統一-新台中",20,0,20
"10902","5410國眾","110/07/12","群益金鼎-民權",0,15,-15
"10903","5410國眾","110/07/12","兆豐-三重",20,0,20
"10904","5410國眾","110/07/12","元富-緯城",0,14,-14
"10905","5410國眾","110/07/12","富邦-台中",20,0,20
"10906","5410國眾","110/07/12","元大-大同",0,12,-12
"10907","5410國眾","110/07/12","臺銀",15,0,15
"10908","5410國眾","110/07/12","元大-莒光",0,10,-10
"10909","5410國眾","110/07/12","新光-桃園",20,6,14
"10910","5410國眾","110/07/12","元大-博愛",0,10,-10
"10911","5410國眾","110/07/12","元大-員林",12,0,12
"10912","5410國眾","110/07/12","日盛-永康",0,8,-8
"10913","5410國眾","110/07/12","日盛-員林",10,0,10
"10914","5410國眾","110/07/12","元大-四維",5,13,-8
"10915","5410國眾","110/07/12","元大-新盛",10,0,10
"10916","5410國眾","110/07/12","新加坡商瑞銀",0,7,-7
"10917","5410國眾","110/07/12","永豐金-台南",10,0,10
"10918","5410國眾","110/07/12","致和-金華",0,7,-7
"10919","5410國眾","110/07/12","元富-新莊",8,0,8
"10920","5410國眾","110/07/12","新光-新竹",0,7,-7
"10921","2841台開","110/07/12","永豐金-敦南",139,26,113
"10922","2841台開","110/07/12","華南永昌-朴子",0,528,-528
"10923","2841台開","110/07/12","日盛-雙和",68,0,68
"10924","2841台開","110/07/12","元大-苑裡",2,50,-48
"10925","2841台開","110/07/12","台新證券",62,4,58
"10926","2841台開","110/07/12","群益金鼎-東湖",0,40,-40
"10927","2841台開","110/07/12","凱基-文心",50,0,50
"10928","2841台開","110/07/12","第一金-員林",0,30,-30
"10929","2841台開","110/07/12","第一金-台中",45,0,45
"10930","2841台開","110/07/12","德信-中正",0,20,-20
"10931","2841台開","110/07/12","富邦-嘉義",40,0,40
"10932","2841台開","110/07/12","兆豐-嘉義",0,20,-20
"10933","2841台開","110/07/12","日盛-木柵",30,0,30
"10934","2841台開","110/07/12","彰銀-七賢",0,15,-15
"10935","2841台開","110/07/12","中國信託-文心",31,3,28
"10936","2841台開","110/07/12","元大-承德",0,14,-14
"10937","2841台開","110/07/12","元大-福營",30,7,23
"10938","2841台開","110/07/12","元富",0,12,-12
"10939","2841台開","110/07/12","台中銀",20,0,20
"10940","2841台開","110/07/12","富邦-陽明",0,11,-11
"10941","2841台開","110/07/12","國泰-板橋",20,0,20
"10942","2841台開","110/07/12","元大證券",0,11,-11
"10943","2841台開","110/07/12","元大-前金",20,0,20
"10944","2841台開","110/07/12","元大-大甲",0,10,-10
"10945","2841台開","110/07/12","中國信託-高雄",16,1,15
"10946","2841台開","110/07/12","日盛-新竹",0,8,-8
"10947","2841台開","110/07/12","陽信-石牌",15,0,15
"10948","2841台開","110/07/12","元富-城東",0,8,-8
"10949","2841台開","110/07/12","永豐金-南投",15,0,15
"10950","2841台開","110/07/12","玉山-台南",2,10,-8
"10951","6207雷科","110/07/12","元大-高雄",34,0,34
"10952","6207雷科","110/07/12","永豐金-三重",1,32,-31
"10953","6207雷科","110/07/12","華南永昌-林口",16,1,15
"10954","6207雷科","110/07/12","永全-八德",0,30,-30
"10955","6207雷科","110/07/12","摩根大通",19,6,13
"10956","6207雷科","110/07/12","國泰-台中",0,14,-14
"10957","6207雷科","110/07/12","元富-埔里",10,0,10
"10958","6207雷科","110/07/12","第一金-澎湖",0,10,-10
"10959","6207雷科","110/07/12","凱基-台南",10,0,10
"10960","6207雷科","110/07/12","元富-林園",0,10,-10
"10961","6207雷科","110/07/12","新加坡商瑞銀",9,0,9
"10962","6207雷科","110/07/12","元大-東門",0,10,-10
"10963","6207雷科","110/07/12","瑞士信貸",8,0,8
"10964","6207雷科","110/07/12","兆豐-嘉義",0,4,-4
"10965","6207雷科","110/07/12","中國信託-高雄",9,1,8
"10966","6207雷科","110/07/12","新光",0,4,-4
"10967","6207雷科","110/07/12","凱基-高雄",6,0,6
"10968","6207雷科","110/07/12","新光-台中",0,4,-4
"10969","6207雷科","110/07/12","元大-六合",6,0,6
"10970","6207雷科","110/07/12","群益金鼎-開元",0,4,-4
"10971","6207雷科","110/07/12","永豐金-信義",6,0,6
"10972","6207雷科","110/07/12","凱基-桃園",0,4,-4
"10973","6207雷科","110/07/12","群益金鼎-土城",5,0,5
"10974","6207雷科","110/07/12","凱基-民權",0,4,-4
"10975","6207雷科","110/07/12","群益金鼎-竹南",5,0,5
"10976","6207雷科","110/07/12","玉山-新莊",0,3,-3
"10977","6207雷科","110/07/12","元大-大灣",5,1,4
"10978","6207雷科","110/07/12","國泰-松江",0,3,-3
"10979","6207雷科","110/07/12","永興",3,0,3
"10980","6207雷科","110/07/12","富邦-羅東",0,3,-3
"10981","3679新至陞","110/07/12","富邦-新竹華信",40,2,38
"10982","3679新至陞","110/07/12","瑞士信貸",0,45,-45
"10983","3679新至陞","110/07/12","台中銀-員林",28,2,26
"10984","3679新至陞","110/07/12","永豐金-天母",0,39,-39
"10985","3679新至陞","110/07/12","聯邦-大業",24,0,24
"10986","3679新至陞","110/07/12","摩根大通",7,35,-28
"10987","3679新至陞","110/07/12","永豐金證券",20,0,20
"10988","3679新至陞","110/07/12","凱基-台北",8,36,-28
"10989","3679新至陞","110/07/12","港商法國興業",14,0,14
"10990","3679新至陞","110/07/12","華南永昌-小港",1,23,-22
"10991","3679新至陞","110/07/12","日盛-樹林",13,1,12
"10992","3679新至陞","110/07/12","台新-台中",0,15,-15
"10993","3679新至陞","110/07/12","國泰-桃園",9,0,9
"10994","3679新至陞","110/07/12","統一-台中",0,12,-12
"10995","3679新至陞","110/07/12","宏遠-館前",8,0,8
"10996","3679新至陞","110/07/12","元大-成功",1,12,-11
"10997","3679新至陞","110/07/12","凱基",10,2,8
"10998","3679新至陞","110/07/12","康和-澎湖",0,8,-8
"10999","3679新至陞","110/07/12","(牛牛牛)亞-網路",7,0,7
"11000","3679新至陞","110/07/12","新加坡商瑞銀",0,7,-7
"11001","3679新至陞","110/07/12","兆豐-員林",7,0,7
"11002","3679新至陞","110/07/12","兆豐-來福",0,7,-7
"11003","3679新至陞","110/07/12","大慶-蘆洲",5,0,5
"11004","3679新至陞","110/07/12","元大-佳里",0,6,-6
"11005","3679新至陞","110/07/12","土銀-花蓮",4,0,4
"11006","3679新至陞","110/07/12","美商高盛",0,5,-5
"11007","3679新至陞","110/07/12","台新-高雄",5,1,4
"11008","3679新至陞","110/07/12","國票-新莊",0,5,-5
"11009","3679新至陞","110/07/12","元大-天母",4,0,4
"11010","3679新至陞","110/07/12","台新-屏東",0,5,-5
"11011","2727王品","110/07/12","凱基-台北",354,198,156
"11012","2727王品","110/07/12","台灣摩根士丹利",5,386,-381
"11013","2727王品","110/07/12","統一-城中",159,22,137
"11014","2727王品","110/07/12","元大-嘉義",4,60,-56
"11015","2727王品","110/07/12","日盛-忠孝",60,0,60
"11016","2727王品","110/07/12","元大-大同",2,44,-42
"11017","2727王品","110/07/12","永豐金-忠孝",45,5,40
"11018","2727王品","110/07/12","國泰-台中",32,73,-41
"11019","2727王品","110/07/12","合庫-新竹",31,0,31
"11020","2727王品","110/07/12","元大證券",127,163,-36
"11021","2727王品","110/07/12","富邦-台中",31,3,28
"11022","2727王品","110/07/12","凱基",1,33,-32
"11023","2727王品","110/07/12","元大-桃園",35,10,25
"11024","2727王品","110/07/12","永全-南崁",1,31,-30
"11025","2727王品","110/07/12","新加坡商瑞銀",28,4,24
"11026","2727王品","110/07/12","凱基-和平",2,32,-30
"11027","2727王品","110/07/12","群益金鼎-古亭",25,2,23
"11028","2727王品","110/07/12","永豐金-大園",8,38,-30
"11029","2727王品","110/07/12","元大-龍潭",29,7,22
"11030","2727王品","110/07/12","瑞士信貸",0,28,-28
"11031","2727王品","110/07/12","永豐金-永康",25,3,22
"11032","2727王品","110/07/12","元富",17,44,-27
"11033","2727王品","110/07/12","富邦-竹北",24,3,21
"11034","2727王品","110/07/12","元大-北屯",5,32,-27
"11035","2727王品","110/07/12","群益金鼎-松山",20,0,20
"11036","2727王品","110/07/12","華南永昌",3,28,-25
"11037","2727王品","110/07/12","元大-八德",20,0,20
"11038","2727王品","110/07/12","統一-竹南",1,23,-22
"11039","2727王品","110/07/12","元大-南京",25,6,19
"11040","2727王品","110/07/12","永豐金證券",4,26,-22
"11041","1570力肯","110/07/12","國票-北高雄",40,0,40
"11042","1570力肯","110/07/12","日盛-竹北",0,40,-40
"11043","1570力肯","110/07/12","摩根大通",16,0,16
"11044","1570力肯","110/07/12","第一金-華江",1,38,-37
"11045","1570力肯","110/07/12","新光",31,19,12
"11046","1570力肯","110/07/12","元大-永春",0,26,-26
"11047","1570力肯","110/07/12","元大-台中中港",12,0,12
"11048","1570力肯","110/07/12","元大-古亭",1,20,-19
"11049","1570力肯","110/07/12","日盛-高雄",10,0,10
"11050","1570力肯","110/07/12","國泰-松江",0,16,-16
"11051","1570力肯","110/07/12","第一金-路竹",10,0,10
"11052","1570力肯","110/07/12","台新-台南",0,15,-15
"11053","1570力肯","110/07/12","台新-新莊",10,0,10
"11054","1570力肯","110/07/12","康和-石牌",0,15,-15
"11055","1570力肯","110/07/12","元大-新盛",9,0,9
"11056","1570力肯","110/07/12","國泰-板橋",0,11,-11
"11057","1570力肯","110/07/12","凱基-台北",8,0,8
"11058","1570力肯","110/07/12","元大-高雄",0,11,-11
"11059","1570力肯","110/07/12","彰銀-七賢",6,0,6
"11060","1570力肯","110/07/12","兆豐-桃園",0,10,-10
"11061","1570力肯","110/07/12","元富-緯城",6,0,6
"11062","1570力肯","110/07/12","元大-大益",0,10,-10
"11063","1570力肯","110/07/12","華南永昌-古亭",6,0,6
"11064","1570力肯","110/07/12","中國信託-文心",0,5,-5
"11065","1570力肯","110/07/12","富邦-陽明",6,0,6
"11066","1570力肯","110/07/12","光和",0,5,-5
"11067","1570力肯","110/07/12","臺銀-臺南",5,0,5
"11068","1570力肯","110/07/12","陽信-石牌",0,5,-5
"11069","1570力肯","110/07/12","宏遠-館前",5,0,5
"11070","1570力肯","110/07/12","國泰-高雄",0,5,-5
"11071","6180橘子","110/07/12","康和-台中",32,2,30
"11072","6180橘子","110/07/12","新百王",1,40,-39
"11073","6180橘子","110/07/12","美林",32,3,29
"11074","6180橘子","110/07/12","富邦-陽明",4,42,-38
"11075","6180橘子","110/07/12","元大-羅東",21,0,21
"11076","6180橘子","110/07/12","新光",3,32,-29
"11077","6180橘子","110/07/12","兆豐-埔墘",16,0,16
"11078","6180橘子","110/07/12","日盛-文化",4,20,-16
"11079","6180橘子","110/07/12","元大-雙和",12,0,12
"11080","6180橘子","110/07/12","華南永昌-鶯歌",0,15,-15
"11081","6180橘子","110/07/12","美商高盛",18,7,11
"11082","6180橘子","110/07/12","中國信託-忠孝",7,20,-13
"11083","6180橘子","110/07/12","台新證券",14,3,11
"11084","6180橘子","110/07/12","凱基-台北",5,17,-12
"11085","6180橘子","110/07/12","元大-中壢",12,1,11
"11086","6180橘子","110/07/12","凱基-高雄",0,11,-11
"11087","6180橘子","110/07/12","統一-南京",10,0,10
"11088","6180橘子","110/07/12","凱基-大安",0,10,-10
"11089","6180橘子","110/07/12","致和-崇德",10,0,10
"11090","6180橘子","110/07/12","元大-北屯",0,10,-10
"11091","6180橘子","110/07/12","玉山-板橋",10,0,10
"11092","6180橘子","110/07/12","元大-南京",0,9,-9
"11093","6180橘子","110/07/12","富邦-仁愛",10,0,10
"11094","6180橘子","110/07/12","元大-台南",1,10,-9
"11095","6180橘子","110/07/12","摩根大通",10,1,9
"11096","6180橘子","110/07/12","康和-澎湖",0,8,-8
"11097","6180橘子","110/07/12","元富-林園",8,0,8
"11098","6180橘子","110/07/12","第一金-台中",0,7,-7
"11099","6180橘子","110/07/12","大慶-富順",7,0,7
"11100","6180橘子","110/07/12","台新-台南",1,8,-7
"11101","2390云辰","110/07/12","統一-新台中",170,0,170
"11102","2390云辰","110/07/12","元大-天母",2,450,-448
"11103","2390云辰","110/07/12","華南永昌-麻豆",137,2,135
"11104","2390云辰","110/07/12","國泰-忠孝",1,143,-142
"11105","2390云辰","110/07/12","元富-成功",103,14,89
"11106","2390云辰","110/07/12","摩根大通",377,512,-135
"11107","2390云辰","110/07/12","元大-土城學府",146,69,77
"11108","2390云辰","110/07/12","台灣摩根士丹利",0,91,-91
"11109","2390云辰","110/07/12","永豐金-永康",76,4,72
"11110","2390云辰","110/07/12","美林",84,146,-62
"11111","2390云辰","110/07/12","台中銀",73,2,71
"11112","2390云辰","110/07/12","華南永昌-嘉義",2,61,-59
"11113","2390云辰","110/07/12","大昌",63,3,60
"11114","2390云辰","110/07/12","永豐金-羅東",0,49,-49
"11115","2390云辰","110/07/12","合庫-三重",50,0,50
"11116","2390云辰","110/07/12","玉山-台中",6,53,-47
"11117","2390云辰","110/07/12","元富-高雄",93,50,43
"11118","2390云辰","110/07/12","玉山-新莊",2,48,-46
"11119","2390云辰","110/07/12","元大-館前",40,4,36
"11120","2390云辰","110/07/12","元大-大里",7,52,-45
"11121","2390云辰","110/07/12","港商野村",143,109,34
"11122","2390云辰","110/07/12","元大-內湖",3,48,-45
"11123","2390云辰","110/07/12","元大-雙和",34,0,34
"11124","2390云辰","110/07/12","永豐金-市政",1,42,-41
"11125","2390云辰","110/07/12","群益金鼎-民權",33,2,31
"11126","2390云辰","110/07/12","元大-學甲",1,41,-40
"11127","2390云辰","110/07/12","日盛-八德",40,10,30
"11128","2390云辰","110/07/12","兆豐-高雄",2,41,-39
"11129","2390云辰","110/07/12","國票-嘉義",30,0,30
"11130","2390云辰","110/07/12","新加坡商瑞銀",21,59,-38
"11131","4903聯光通","110/07/09","元大-敦南",10,0,10
"11132","4903聯光通","110/07/09","第一金-台中",0,12,-12
"11133","4903聯光通","110/07/09","凱基-士林",5,0,5
"11134","4903聯光通","110/07/09","日盛-忠孝",0,3,-3
"11135","4903聯光通","110/07/09","元大-苗栗",5,0,5
"11136","4903聯光通","110/07/09","群益金鼎-崇德",0,3,-3
"11137","4903聯光通","110/07/09","元大-屏南",3,0,3
"11138","4903聯光通","110/07/09","國票-內壢",0,2,-2
"11139","4903聯光通","110/07/09","中國信託-永康",1,0,1
"11140","4903聯光通","110/07/09","康和-南崁",0,2,-2
"11141","4903聯光通","110/07/09","玉山證券",1,0,1
"11142","4903聯光通","110/07/09","新光-台中",0,2,-2
"11143","4903聯光通","110/07/09","元大-太平",4,3,1
"11144","4903聯光通","110/07/09","玉山-城中",0,2,-2
"11145","4903聯光通","110/07/09","永豐金-嘉義",1,0,1
"11146","4903聯光通","110/07/09","中國信託-文心",0,1,-1
"11147","4903聯光通","110/07/09","大昌",0,0,0
"11148","4903聯光通","110/07/09","大昌",0,0,0
"11149","4903聯光通","110/07/09","中農",0,0,0
"11150","4903聯光通","110/07/09","中農",0,0,0
"11151","4903聯光通","110/07/09","",NA,NA,NA
"11152","4903聯光通","110/07/09","",NA,NA,NA
"11153","4903聯光通","110/07/09","",NA,NA,NA
"11154","4903聯光通","110/07/09","",NA,NA,NA
"11155","4903聯光通","110/07/09","",NA,NA,NA
"11156","4903聯光通","110/07/09","",NA,NA,NA
"11157","4903聯光通","110/07/09","",NA,NA,NA
"11158","4903聯光通","110/07/09","",NA,NA,NA
"11159","4903聯光通","110/07/09","",NA,NA,NA
"11160","4903聯光通","110/07/09","",NA,NA,NA
"11161","2929淘帝","110/07/09","台中銀-台北",110,0,110
"11162","2929淘帝","110/07/09","新光",2,82,-80
"11163","2929淘帝","110/07/09","華南永昌-頭份",72,0,72
"11164","2929淘帝","110/07/09","摩根大通",2,63,-61
"11165","2929淘帝","110/07/09","合庫-高雄",71,0,71
"11166","2929淘帝","110/07/09","第一金-路竹",0,50,-50
"11167","2929淘帝","110/07/09","高橋-龍潭",37,0,37
"11168","2929淘帝","110/07/09","港商麥格理",0,42,-42
"11169","2929淘帝","110/07/09","新光-台中",60,26,34
"11170","2929淘帝","110/07/09","陽信-石牌",0,40,-40
"11171","2929淘帝","110/07/09","元富-大裕",22,1,21
"11172","2929淘帝","110/07/09","台新-左楠",1,39,-38
"11173","2929淘帝","110/07/09","合庫-鳳山",20,0,20
"11174","2929淘帝","110/07/09","凱基-桃園",3,29,-26
"11175","2929淘帝","110/07/09","元大-員林",22,2,20
"11176","2929淘帝","110/07/09","兆豐-內湖",0,25,-25
"11177","2929淘帝","110/07/09","台新-建北",15,0,15
"11178","2929淘帝","110/07/09","元大-北港",0,20,-20
"11179","2929淘帝","110/07/09","兆豐-桃園",13,0,13
"11180","2929淘帝","110/07/09","富邦-北港",0,19,-19
"11181","2929淘帝","110/07/09","兆豐-忠孝",10,0,10
"11182","2929淘帝","110/07/09","富邦-花蓮",0,17,-17
"11183","2929淘帝","110/07/09","國票-敦北法人",10,0,10
"11184","2929淘帝","110/07/09","國泰-台中",2,17,-15
"11185","2929淘帝","110/07/09","永豐金-博愛",10,0,10
"11186","2929淘帝","110/07/09","群益金鼎-彰化",0,15,-15
"11187","2929淘帝","110/07/09","群益金鼎-潭子",8,0,8
"11188","2929淘帝","110/07/09","元大-博愛",0,14,-14
"11189","2929淘帝","110/07/09","富邦-南屯",8,0,8
"11190","2929淘帝","110/07/09","日盛-板橋",0,13,-13
"11191","5410國眾","110/07/09","元大-新盛",14,0,14
"11192","5410國眾","110/07/09","(牛牛牛)亞-鑫豐",1,41,-40
"11193","5410國眾","110/07/09","台灣企銀-民雄",10,0,10
"11194","5410國眾","110/07/09","元富-嘉義",0,25,-25
"11195","5410國眾","110/07/09","元富-虎尾",9,0,9
"11196","5410國眾","110/07/09","凱基-高美館",0,10,-10
"11197","5410國眾","110/07/09","摩根大通",10,1,9
"11198","5410國眾","110/07/09","凱基-城中",0,10,-10
"11199","5410國眾","110/07/09","兆豐-北高雄",7,0,7
"11200","5410國眾","110/07/09","元大-頭份",0,10,-10
"11201","5410國眾","110/07/09","凱基-台北",8,1,7
"11202","5410國眾","110/07/09","群益金鼎-丹鳳",0,7,-7
"11203","5410國眾","110/07/09","華南永昌-公誠",7,0,7
"11204","5410國眾","110/07/09","凱基-復興",0,7,-7
"11205","5410國眾","110/07/09","香港上海匯豐",6,0,6
"11206","5410國眾","110/07/09","元大-員林",0,7,-7
"11207","5410國眾","110/07/09","凱基-中壢",6,0,6
"11208","5410國眾","110/07/09","富邦-竹東",0,6,-6
"11209","5410國眾","110/07/09","華南永昌-南京",6,0,6
"11210","5410國眾","110/07/09","亞東-高雄",0,5,-5
"11211","5410國眾","110/07/09","統一-三重",5,0,5
"11212","5410國眾","110/07/09","大慶-中壢",1,6,-5
"11213","5410國眾","110/07/09","富邦-宜蘭",5,0,5
"11214","5410國眾","110/07/09","群益金鼎-中港",0,5,-5
"11215","5410國眾","110/07/09","元大-崇德",5,0,5
"11216","5410國眾","110/07/09","元大-八德",0,5,-5
"11217","5410國眾","110/07/09","元大-博愛",5,0,5
"11218","5410國眾","110/07/09","富邦-基隆",0,4,-4
"11219","5410國眾","110/07/09","元大-龍潭",5,0,5
"11220","5410國眾","110/07/09","臺銀-新竹",0,3,-3
"11221","2841台開","110/07/09","日盛-雙和",102,0,102
"11222","2841台開","110/07/09","港商野村",0,129,-129
"11223","2841台開","110/07/09","元大-館前",70,0,70
"11224","2841台開","110/07/09","兆豐-永和",0,100,-100
"11225","2841台開","110/07/09","凱基-文心",50,0,50
"11226","2841台開","110/07/09","台新證券",7,28,-21
"11227","2841台開","110/07/09","富邦-嘉義",40,0,40
"11228","2841台開","110/07/09","國票-北高雄",0,20,-20
"11229","2841台開","110/07/09","美商高盛",15,0,15
"11230","2841台開","110/07/09","永豐金-敦南",29,46,-17
"11231","2841台開","110/07/09","台中銀",15,0,15
"11232","2841台開","110/07/09","合庫-基隆",0,12,-12
"11233","2841台開","110/07/09","新光",11,0,11
"11234","2841台開","110/07/09","中國信託-松江",0,12,-12
"11235","2841台開","110/07/09","華南永昌-長虹",10,0,10
"11236","2841台開","110/07/09","兆豐-城中",0,12,-12
"11237","2841台開","110/07/09","永豐金-南投",10,0,10
"11238","2841台開","110/07/09","台中銀-豐原",0,10,-10
"11239","2841台開","110/07/09","合庫-桃園",7,0,7
"11240","2841台開","110/07/09","兆豐-景美",0,10,-10
"11241","2841台開","110/07/09","群益金鼎-古亭",7,0,7
"11242","2841台開","110/07/09","群益金鼎-基隆",0,10,-10
"11243","2841台開","110/07/09","國泰-敦南",6,0,6
"11244","2841台開","110/07/09","元大-北三重",0,10,-10
"11245","2841台開","110/07/09","凱基-桃園",8,2,6
"11246","2841台開","110/07/09","(牛牛牛)亞-網路",0,9,-9
"11247","2841台開","110/07/09","日盛證券",5,0,5
"11248","2841台開","110/07/09","台新-高雄",1,10,-9
"11249","2841台開","110/07/09","元富-文心",5,0,5
"11250","2841台開","110/07/09","凱基-台北",0,7,-7
"11251","6207雷科","110/07/09","群益金鼎-新竹",47,0,47
"11252","6207雷科","110/07/09","新光",7,24,-17
"11253","6207雷科","110/07/09","永豐金-三重",31,0,31
"11254","6207雷科","110/07/09","日盛-和美",0,15,-15
"11255","6207雷科","110/07/09","新加坡商瑞銀",33,5,28
"11256","6207雷科","110/07/09","國泰-台南",0,15,-15
"11257","6207雷科","110/07/09","元大-高雄",26,0,26
"11258","6207雷科","110/07/09","華南永昌-古亭",0,14,-14
"11259","6207雷科","110/07/09","統一-員林",22,0,22
"11260","6207雷科","110/07/09","土銀-白河",0,11,-11
"11261","6207雷科","110/07/09","台新-高雄",22,0,22
"11262","6207雷科","110/07/09","日盛-台南",0,10,-10
"11263","6207雷科","110/07/09","摩根大通",34,17,17
"11264","6207雷科","110/07/09","元富-林園",0,10,-10
"11265","6207雷科","110/07/09","元大-博愛",17,1,16
"11266","6207雷科","110/07/09","富邦-園區",0,10,-10
"11267","6207雷科","110/07/09","日茂-埔里",12,0,12
"11268","6207雷科","110/07/09","元大-上新莊",0,10,-10
"11269","6207雷科","110/07/09","國泰-台中",17,6,11
"11270","6207雷科","110/07/09","永豐金-南京",0,10,-10
"11271","6207雷科","110/07/09","富邦-三重",10,0,10
"11272","6207雷科","110/07/09","兆豐-小港",0,6,-6
"11273","6207雷科","110/07/09","元大-沙鹿",10,0,10
"11274","6207雷科","110/07/09","富邦-羅東",1,7,-6
"11275","6207雷科","110/07/09","元大-八德",10,0,10
"11276","6207雷科","110/07/09","元大-土城永寧",0,6,-6
"11277","6207雷科","110/07/09","第一金-路竹",11,2,9
"11278","6207雷科","110/07/09","永豐金-板盛",0,6,-6
"11279","6207雷科","110/07/09","統一-南京",5,0,5
"11280","6207雷科","110/07/09","日盛-板橋",0,5,-5
"11281","3679新至陞","110/07/09","元大-大天母",10,0,10
"11282","3679新至陞","110/07/09","第一金-光復",0,11,-11
"11283","3679新至陞","110/07/09","日盛-樹林",9,0,9
"11284","3679新至陞","110/07/09","瑞士信貸",0,8,-8
"11285","3679新至陞","110/07/09","凱基-台北",11,2,9
"11286","3679新至陞","110/07/09","大慶-苗栗",0,5,-5
"11287","3679新至陞","110/07/09","華南永昌-小港",8,0,8
"11288","3679新至陞","110/07/09","元大-永春",0,5,-5
"11289","3679新至陞","110/07/09","兆豐-來福",7,0,7
"11290","3679新至陞","110/07/09","日盛-和美",0,4,-4
"11291","3679新至陞","110/07/09","香港上海匯豐",5,0,5
"11292","3679新至陞","110/07/09","元大-雙和",0,3,-3
"11293","3679新至陞","110/07/09","台中銀-員林",3,0,3
"11294","3679新至陞","110/07/09","永豐金-屏東",0,3,-3
"11295","3679新至陞","110/07/09","新光",3,0,3
"11296","3679新至陞","110/07/09","彰銀",0,2,-2
"11297","3679新至陞","110/07/09","土銀-花蓮",2,0,2
"11298","3679新至陞","110/07/09","宏遠-館前",0,2,-2
"11299","3679新至陞","110/07/09","第一金-澎湖",2,0,2
"11300","3679新至陞","110/07/09","港商野村",0,2,-2
"11301","3679新至陞","110/07/09","摩根大通",2,0,2
"11302","3679新至陞","110/07/09","大昌-新店",0,2,-2
"11303","3679新至陞","110/07/09","國泰-敦南",2,0,2
"11304","3679新至陞","110/07/09","元大-新莊",0,2,-2
"11305","3679新至陞","110/07/09","元大-淡水",4,2,2
"11306","3679新至陞","110/07/09","元大-板橋",0,2,-2
"11307","3679新至陞","110/07/09","日盛-士林",1,0,1
"11308","3679新至陞","110/07/09","台灣摩根士丹利",0,1,-1
"11309","3679新至陞","110/07/09","日盛-信義",1,0,1
"11310","3679新至陞","110/07/09","第一金-高雄",0,1,-1
"11311","2727王品","110/07/09","台灣匯立證券",90,0,90
"11312","2727王品","110/07/09","台灣摩根士丹利",0,267,-267
"11313","2727王品","110/07/09","國泰-敦南",166,84,82
"11314","2727王品","110/07/09","富邦-台北",35,299,-264
"11315","2727王品","110/07/09","富邦-仁愛",56,12,44
"11316","2727王品","110/07/09","凱基-台北",174,296,-122
"11317","2727王品","110/07/09","台新證券",109,66,43
"11318","2727王品","110/07/09","第一金",2,102,-100
"11319","2727王品","110/07/09","新光",117,87,30
"11320","2727王品","110/07/09","群益金鼎-大安",0,80,-80
"11321","2727王品","110/07/09","臺銀-臺中",35,6,29
"11322","2727王品","110/07/09","兆豐-大安",7,60,-53
"11323","2727王品","110/07/09","元大-桃園",32,3,29
"11324","2727王品","110/07/09","永豐金-南投",0,50,-50
"11325","2727王品","110/07/09","元富-宜蘭",34,6,28
"11326","2727王品","110/07/09","新加坡商瑞銀",6,46,-40
"11327","2727王品","110/07/09","玉山-台中",34,8,26
"11328","2727王品","110/07/09","合庫-彰化",11,50,-39
"11329","2727王品","110/07/09","群益金鼎-宜蘭",30,4,26
"11330","2727王品","110/07/09","永豐金-萬盛",13,52,-39
"11331","2727王品","110/07/09","富邦-台中",42,16,26
"11332","2727王品","110/07/09","瑞士信貸",0,34,-34
"11333","2727王品","110/07/09","第一金-豐原",25,1,24
"11334","2727王品","110/07/09","元大-和平",4,35,-31
"11335","2727王品","110/07/09","臺銀",30,8,22
"11336","2727王品","110/07/09","美林",14,44,-30
"11337","2727王品","110/07/09","兆豐-來福",23,1,22
"11338","2727王品","110/07/09","元大-員林",9,38,-29
"11339","2727王品","110/07/09","玉山-士林",22,2,20
"11340","2727王品","110/07/09","元富-西松",4,31,-27
"11341","1570力肯","110/07/09","凱基-台北",30,1,29
"11342","1570力肯","110/07/09","群益金鼎-彰化",0,20,-20
"11343","1570力肯","110/07/09","新光-台南",20,0,20
"11344","1570力肯","110/07/09","元大-土城學府",0,20,-20
"11345","1570力肯","110/07/09","元大-高雄",20,0,20
"11346","1570力肯","110/07/09","元大-大統",0,16,-16
"11347","1570力肯","110/07/09","國票-中正",12,0,12
"11348","1570力肯","110/07/09","元大-新營",0,11,-11
"11349","1570力肯","110/07/09","日盛-高雄",6,0,6
"11350","1570力肯","110/07/09","元大-和平",0,10,-10
"11351","1570力肯","110/07/09","元富-緯城",6,0,6
"11352","1570力肯","110/07/09","元大-草屯",0,10,-10
"11353","1570力肯","110/07/09","群益金鼎-台南",6,0,6
"11354","1570力肯","110/07/09","元大-鹿港",0,9,-9
"11355","1570力肯","110/07/09","華南永昌-岡山",6,0,6
"11356","1570力肯","110/07/09","合庫-基隆",0,7,-7
"11357","1570力肯","110/07/09","統一-中壢",5,0,5
"11358","1570力肯","110/07/09","摩根大通",2,8,-6
"11359","1570力肯","110/07/09","凱基-三峽",5,0,5
"11360","1570力肯","110/07/09","台灣企銀-豐原",0,4,-4
"11361","1570力肯","110/07/09","大昌-樹林",4,0,4
"11362","1570力肯","110/07/09","日盛-桃園",0,4,-4
"11363","1570力肯","110/07/09","新光",3,0,3
"11364","1570力肯","110/07/09","國泰-高雄",0,3,-3
"11365","1570力肯","110/07/09","富邦-新竹華信",3,0,3
"11366","1570力肯","110/07/09","永豐金-敦南",0,3,-3
"11367","1570力肯","110/07/09","合庫-台中",2,0,2
"11368","1570力肯","110/07/09","土銀-彰化",0,2,-2
"11369","1570力肯","110/07/09","臺銀-臺中",2,0,2
"11370","1570力肯","110/07/09","臺銀-鳳山",0,2,-2
"11371","6180橘子","110/07/09","摩根大通",63,1,62
"11372","6180橘子","110/07/09","元大-南京",1,32,-31
"11373","6180橘子","110/07/09","富邦-陽明",73,33,40
"11374","6180橘子","110/07/09","群益金鼎-台北",0,25,-25
"11375","6180橘子","110/07/09","新加坡商瑞銀",31,0,31
"11376","6180橘子","110/07/09","兆豐-復興",0,21,-21
"11377","6180橘子","110/07/09","美商高盛",25,0,25
"11378","6180橘子","110/07/09","永豐金-嘉義",0,21,-21
"11379","6180橘子","110/07/09","凱基-台北",26,10,16
"11380","6180橘子","110/07/09","凱基-中壢",8,24,-16
"11381","6180橘子","110/07/09","華南永昌-楠梓",13,0,13
"11382","6180橘子","110/07/09","致和-崇德",0,15,-15
"11383","6180橘子","110/07/09","華南永昌-朴子",11,0,11
"11384","6180橘子","110/07/09","群益金鼎-屏東",0,15,-15
"11385","6180橘子","110/07/09","元大-北港",11,0,11
"11386","6180橘子","110/07/09","群益金鼎-中山",0,15,-15
"11387","6180橘子","110/07/09","元大-成功",10,1,9
"11388","6180橘子","110/07/09","瑞士信貸",1,15,-14
"11389","6180橘子","110/07/09","新光",26,18,8
"11390","6180橘子","110/07/09","日盛-二林",0,10,-10
"11391","6180橘子","110/07/09","統一-三重",6,0,6
"11392","6180橘子","110/07/09","凱基-東門",0,10,-10
"11393","6180橘子","110/07/09","群益金鼎-嘉義",6,0,6
"11394","6180橘子","110/07/09","華南永昌-三重",0,10,-10
"11395","6180橘子","110/07/09","元大-員林中山",6,0,6
"11396","6180橘子","110/07/09","元大-彰化民生",1,11,-10
"11397","6180橘子","110/07/09","合庫-鳳山",5,0,5
"11398","6180橘子","110/07/09","永豐金-新店",1,11,-10
"11399","6180橘子","110/07/09","富邦-建國",6,1,5
"11400","6180橘子","110/07/09","群益金鼎-丹鳳",0,8,-8
"11401","2390云辰","110/07/09","摩根大通",279,56,223
"11402","2390云辰","110/07/09","元大-天母",0,127,-127
"11403","2390云辰","110/07/09","日盛-鳳山",110,2,108
"11404","2390云辰","110/07/09","中國信託-文心",5,109,-104
"11405","2390云辰","110/07/09","宏遠證券",100,0,100
"11406","2390云辰","110/07/09","永豐金-復興",0,55,-55
"11407","2390云辰","110/07/09","元大-大里",63,6,57
"11408","2390云辰","110/07/09","凱基-台北",239,286,-47
"11409","2390云辰","110/07/09","凱基-八德",59,10,49
"11410","2390云辰","110/07/09","德信",2,32,-30
"11411","2390云辰","110/07/09","合庫-新竹",40,0,40
"11412","2390云辰","110/07/09","兆豐-桃鶯",2,32,-30
"11413","2390云辰","110/07/09","國票",40,1,39
"11414","2390云辰","110/07/09","致和-南京",0,30,-30
"11415","2390云辰","110/07/09","新加坡商瑞銀",49,13,36
"11416","2390云辰","110/07/09","富邦-虎尾",1,31,-30
"11417","2390云辰","110/07/09","統一-新台中",36,2,34
"11418","2390云辰","110/07/09","元大-善化",2,31,-29
"11419","2390云辰","110/07/09","國票-嘉義",31,0,31
"11420","2390云辰","110/07/09","富邦-板橋",0,27,-27
"11421","2390云辰","110/07/09","華南永昌",35,7,28
"11422","2390云辰","110/07/09","富邦-永和",3,28,-25
"11423","2390云辰","110/07/09","玉山-台中",49,22,27
"11424","2390云辰","110/07/09","第一金-自由",20,44,-24
"11425","2390云辰","110/07/09","華南永昌-敦南",25,0,25
"11426","2390云辰","110/07/09","凱基-內湖",0,24,-24
"11427","2390云辰","110/07/09","新光-高雄",27,4,23
"11428","2390云辰","110/07/09","元大-汐止",1,24,-23
"11429","2390云辰","110/07/09","台灣摩根士丹利",85,63,22
"11430","2390云辰","110/07/09","新光-台中",12,33,-21
"11431","4903聯光通","110/07/09","元大-敦南",10,0,10
"11432","4903聯光通","110/07/09","第一金-台中",0,12,-12
"11433","4903聯光通","110/07/09","凱基-士林",5,0,5
"11434","4903聯光通","110/07/09","日盛-忠孝",0,3,-3
"11435","4903聯光通","110/07/09","元大-苗栗",5,0,5
"11436","4903聯光通","110/07/09","群益金鼎-崇德",0,3,-3
"11437","4903聯光通","110/07/09","元大-屏南",3,0,3
"11438","4903聯光通","110/07/09","國票-內壢",0,2,-2
"11439","4903聯光通","110/07/09","中國信託-永康",1,0,1
"11440","4903聯光通","110/07/09","康和-南崁",0,2,-2
"11441","4903聯光通","110/07/09","玉山證券",1,0,1
"11442","4903聯光通","110/07/09","新光-台中",0,2,-2
"11443","4903聯光通","110/07/09","元大-太平",4,3,1
"11444","4903聯光通","110/07/09","玉山-城中",0,2,-2
"11445","4903聯光通","110/07/09","永豐金-嘉義",1,0,1
"11446","4903聯光通","110/07/09","中國信託-文心",0,1,-1
"11447","4903聯光通","110/07/09","大昌",0,0,0
"11448","4903聯光通","110/07/09","大昌",0,0,0
"11449","4903聯光通","110/07/09","中農",0,0,0
"11450","4903聯光通","110/07/09","中農",0,0,0
"11451","4903聯光通","110/07/09","",NA,NA,NA
"11452","4903聯光通","110/07/09","",NA,NA,NA
"11453","4903聯光通","110/07/09","",NA,NA,NA
"11454","4903聯光通","110/07/09","",NA,NA,NA
"11455","4903聯光通","110/07/09","",NA,NA,NA
"11456","4903聯光通","110/07/09","",NA,NA,NA
"11457","4903聯光通","110/07/09","",NA,NA,NA
"11458","4903聯光通","110/07/09","",NA,NA,NA
"11459","4903聯光通","110/07/09","",NA,NA,NA
"11460","4903聯光通","110/07/09","",NA,NA,NA
"11461","2929淘帝","110/07/09","台中銀-台北",110,0,110
"11462","2929淘帝","110/07/09","新光",2,82,-80
"11463","2929淘帝","110/07/09","華南永昌-頭份",72,0,72
"11464","2929淘帝","110/07/09","摩根大通",2,63,-61
"11465","2929淘帝","110/07/09","合庫-高雄",71,0,71
"11466","2929淘帝","110/07/09","第一金-路竹",0,50,-50
"11467","2929淘帝","110/07/09","高橋-龍潭",37,0,37
"11468","2929淘帝","110/07/09","港商麥格理",0,42,-42
"11469","2929淘帝","110/07/09","新光-台中",60,26,34
"11470","2929淘帝","110/07/09","陽信-石牌",0,40,-40
"11471","2929淘帝","110/07/09","元富-大裕",22,1,21
"11472","2929淘帝","110/07/09","台新-左楠",1,39,-38
"11473","2929淘帝","110/07/09","合庫-鳳山",20,0,20
"11474","2929淘帝","110/07/09","凱基-桃園",3,29,-26
"11475","2929淘帝","110/07/09","元大-員林",22,2,20
"11476","2929淘帝","110/07/09","兆豐-內湖",0,25,-25
"11477","2929淘帝","110/07/09","台新-建北",15,0,15
"11478","2929淘帝","110/07/09","元大-北港",0,20,-20
"11479","2929淘帝","110/07/09","兆豐-桃園",13,0,13
"11480","2929淘帝","110/07/09","富邦-北港",0,19,-19
"11481","2929淘帝","110/07/09","兆豐-忠孝",10,0,10
"11482","2929淘帝","110/07/09","富邦-花蓮",0,17,-17
"11483","2929淘帝","110/07/09","國票-敦北法人",10,0,10
"11484","2929淘帝","110/07/09","國泰-台中",2,17,-15
"11485","2929淘帝","110/07/09","永豐金-博愛",10,0,10
"11486","2929淘帝","110/07/09","群益金鼎-彰化",0,15,-15
"11487","2929淘帝","110/07/09","群益金鼎-潭子",8,0,8
"11488","2929淘帝","110/07/09","元大-博愛",0,14,-14
"11489","2929淘帝","110/07/09","富邦-南屯",8,0,8
"11490","2929淘帝","110/07/09","日盛-板橋",0,13,-13
"11491","5410國眾","110/07/09","元大-新盛",14,0,14
"11492","5410國眾","110/07/09","(牛牛牛)亞-鑫豐",1,41,-40
"11493","5410國眾","110/07/09","台灣企銀-民雄",10,0,10
"11494","5410國眾","110/07/09","元富-嘉義",0,25,-25
"11495","5410國眾","110/07/09","元富-虎尾",9,0,9
"11496","5410國眾","110/07/09","凱基-高美館",0,10,-10
"11497","5410國眾","110/07/09","摩根大通",10,1,9
"11498","5410國眾","110/07/09","凱基-城中",0,10,-10
"11499","5410國眾","110/07/09","兆豐-北高雄",7,0,7
"11500","5410國眾","110/07/09","元大-頭份",0,10,-10
"11501","5410國眾","110/07/09","凱基-台北",8,1,7
"11502","5410國眾","110/07/09","群益金鼎-丹鳳",0,7,-7
"11503","5410國眾","110/07/09","華南永昌-公誠",7,0,7
"11504","5410國眾","110/07/09","凱基-復興",0,7,-7
"11505","5410國眾","110/07/09","香港上海匯豐",6,0,6
"11506","5410國眾","110/07/09","元大-員林",0,7,-7
"11507","5410國眾","110/07/09","凱基-中壢",6,0,6
"11508","5410國眾","110/07/09","富邦-竹東",0,6,-6
"11509","5410國眾","110/07/09","華南永昌-南京",6,0,6
"11510","5410國眾","110/07/09","亞東-高雄",0,5,-5
"11511","5410國眾","110/07/09","統一-三重",5,0,5
"11512","5410國眾","110/07/09","大慶-中壢",1,6,-5
"11513","5410國眾","110/07/09","富邦-宜蘭",5,0,5
"11514","5410國眾","110/07/09","群益金鼎-中港",0,5,-5
"11515","5410國眾","110/07/09","元大-崇德",5,0,5
"11516","5410國眾","110/07/09","元大-八德",0,5,-5
"11517","5410國眾","110/07/09","元大-博愛",5,0,5
"11518","5410國眾","110/07/09","富邦-基隆",0,4,-4
"11519","5410國眾","110/07/09","元大-龍潭",5,0,5
"11520","5410國眾","110/07/09","臺銀-新竹",0,3,-3
"11521","2841台開","110/07/09","日盛-雙和",102,0,102
"11522","2841台開","110/07/09","港商野村",0,129,-129
"11523","2841台開","110/07/09","元大-館前",70,0,70
"11524","2841台開","110/07/09","兆豐-永和",0,100,-100
"11525","2841台開","110/07/09","凱基-文心",50,0,50
"11526","2841台開","110/07/09","台新證券",7,28,-21
"11527","2841台開","110/07/09","富邦-嘉義",40,0,40
"11528","2841台開","110/07/09","國票-北高雄",0,20,-20
"11529","2841台開","110/07/09","美商高盛",15,0,15
"11530","2841台開","110/07/09","永豐金-敦南",29,46,-17
"11531","2841台開","110/07/09","台中銀",15,0,15
"11532","2841台開","110/07/09","合庫-基隆",0,12,-12
"11533","2841台開","110/07/09","新光",11,0,11
"11534","2841台開","110/07/09","中國信託-松江",0,12,-12
"11535","2841台開","110/07/09","華南永昌-長虹",10,0,10
"11536","2841台開","110/07/09","兆豐-城中",0,12,-12
"11537","2841台開","110/07/09","永豐金-南投",10,0,10
"11538","2841台開","110/07/09","台中銀-豐原",0,10,-10
"11539","2841台開","110/07/09","合庫-桃園",7,0,7
"11540","2841台開","110/07/09","兆豐-景美",0,10,-10
"11541","2841台開","110/07/09","群益金鼎-古亭",7,0,7
"11542","2841台開","110/07/09","群益金鼎-基隆",0,10,-10
"11543","2841台開","110/07/09","國泰-敦南",6,0,6
"11544","2841台開","110/07/09","元大-北三重",0,10,-10
"11545","2841台開","110/07/09","凱基-桃園",8,2,6
"11546","2841台開","110/07/09","(牛牛牛)亞-網路",0,9,-9
"11547","2841台開","110/07/09","日盛證券",5,0,5
"11548","2841台開","110/07/09","台新-高雄",1,10,-9
"11549","2841台開","110/07/09","元富-文心",5,0,5
"11550","2841台開","110/07/09","凱基-台北",0,7,-7
"11551","6207雷科","110/07/09","群益金鼎-新竹",47,0,47
"11552","6207雷科","110/07/09","新光",7,24,-17
"11553","6207雷科","110/07/09","永豐金-三重",31,0,31
"11554","6207雷科","110/07/09","日盛-和美",0,15,-15
"11555","6207雷科","110/07/09","新加坡商瑞銀",33,5,28
"11556","6207雷科","110/07/09","國泰-台南",0,15,-15
"11557","6207雷科","110/07/09","元大-高雄",26,0,26
"11558","6207雷科","110/07/09","華南永昌-古亭",0,14,-14
"11559","6207雷科","110/07/09","統一-員林",22,0,22
"11560","6207雷科","110/07/09","土銀-白河",0,11,-11
"11561","6207雷科","110/07/09","台新-高雄",22,0,22
"11562","6207雷科","110/07/09","日盛-台南",0,10,-10
"11563","6207雷科","110/07/09","摩根大通",34,17,17
"11564","6207雷科","110/07/09","元富-林園",0,10,-10
"11565","6207雷科","110/07/09","元大-博愛",17,1,16
"11566","6207雷科","110/07/09","富邦-園區",0,10,-10
"11567","6207雷科","110/07/09","日茂-埔里",12,0,12
"11568","6207雷科","110/07/09","元大-上新莊",0,10,-10
"11569","6207雷科","110/07/09","國泰-台中",17,6,11
"11570","6207雷科","110/07/09","永豐金-南京",0,10,-10
"11571","6207雷科","110/07/09","富邦-三重",10,0,10
"11572","6207雷科","110/07/09","兆豐-小港",0,6,-6
"11573","6207雷科","110/07/09","元大-沙鹿",10,0,10
"11574","6207雷科","110/07/09","富邦-羅東",1,7,-6
"11575","6207雷科","110/07/09","元大-八德",10,0,10
"11576","6207雷科","110/07/09","元大-土城永寧",0,6,-6
"11577","6207雷科","110/07/09","第一金-路竹",11,2,9
"11578","6207雷科","110/07/09","永豐金-板盛",0,6,-6
"11579","6207雷科","110/07/09","統一-南京",5,0,5
"11580","6207雷科","110/07/09","日盛-板橋",0,5,-5
"11581","3679新至陞","110/07/09","元大-大天母",10,0,10
"11582","3679新至陞","110/07/09","第一金-光復",0,11,-11
"11583","3679新至陞","110/07/09","日盛-樹林",9,0,9
"11584","3679新至陞","110/07/09","瑞士信貸",0,8,-8
"11585","3679新至陞","110/07/09","凱基-台北",11,2,9
"11586","3679新至陞","110/07/09","大慶-苗栗",0,5,-5
"11587","3679新至陞","110/07/09","華南永昌-小港",8,0,8
"11588","3679新至陞","110/07/09","元大-永春",0,5,-5
"11589","3679新至陞","110/07/09","兆豐-來福",7,0,7
"11590","3679新至陞","110/07/09","日盛-和美",0,4,-4
"11591","3679新至陞","110/07/09","香港上海匯豐",5,0,5
"11592","3679新至陞","110/07/09","元大-雙和",0,3,-3
"11593","3679新至陞","110/07/09","台中銀-員林",3,0,3
"11594","3679新至陞","110/07/09","永豐金-屏東",0,3,-3
"11595","3679新至陞","110/07/09","新光",3,0,3
"11596","3679新至陞","110/07/09","彰銀",0,2,-2
"11597","3679新至陞","110/07/09","土銀-花蓮",2,0,2
"11598","3679新至陞","110/07/09","宏遠-館前",0,2,-2
"11599","3679新至陞","110/07/09","第一金-澎湖",2,0,2
"11600","3679新至陞","110/07/09","港商野村",0,2,-2
"11601","3679新至陞","110/07/09","摩根大通",2,0,2
"11602","3679新至陞","110/07/09","大昌-新店",0,2,-2
"11603","3679新至陞","110/07/09","國泰-敦南",2,0,2
"11604","3679新至陞","110/07/09","元大-新莊",0,2,-2
"11605","3679新至陞","110/07/09","元大-淡水",4,2,2
"11606","3679新至陞","110/07/09","元大-板橋",0,2,-2
"11607","3679新至陞","110/07/09","日盛-士林",1,0,1
"11608","3679新至陞","110/07/09","台灣摩根士丹利",0,1,-1
"11609","3679新至陞","110/07/09","日盛-信義",1,0,1
"11610","3679新至陞","110/07/09","第一金-高雄",0,1,-1
"11611","2727王品","110/07/09","台灣匯立證券",90,0,90
"11612","2727王品","110/07/09","台灣摩根士丹利",0,267,-267
"11613","2727王品","110/07/09","國泰-敦南",166,84,82
"11614","2727王品","110/07/09","富邦-台北",35,299,-264
"11615","2727王品","110/07/09","富邦-仁愛",56,12,44
"11616","2727王品","110/07/09","凱基-台北",174,296,-122
"11617","2727王品","110/07/09","台新證券",109,66,43
"11618","2727王品","110/07/09","第一金",2,102,-100
"11619","2727王品","110/07/09","新光",117,87,30
"11620","2727王品","110/07/09","群益金鼎-大安",0,80,-80
"11621","2727王品","110/07/09","臺銀-臺中",35,6,29
"11622","2727王品","110/07/09","兆豐-大安",7,60,-53
"11623","2727王品","110/07/09","元大-桃園",32,3,29
"11624","2727王品","110/07/09","永豐金-南投",0,50,-50
"11625","2727王品","110/07/09","元富-宜蘭",34,6,28
"11626","2727王品","110/07/09","新加坡商瑞銀",6,46,-40
"11627","2727王品","110/07/09","玉山-台中",34,8,26
"11628","2727王品","110/07/09","合庫-彰化",11,50,-39
"11629","2727王品","110/07/09","群益金鼎-宜蘭",30,4,26
"11630","2727王品","110/07/09","永豐金-萬盛",13,52,-39
"11631","2727王品","110/07/09","富邦-台中",42,16,26
"11632","2727王品","110/07/09","瑞士信貸",0,34,-34
"11633","2727王品","110/07/09","第一金-豐原",25,1,24
"11634","2727王品","110/07/09","元大-和平",4,35,-31
"11635","2727王品","110/07/09","臺銀",30,8,22
"11636","2727王品","110/07/09","美林",14,44,-30
"11637","2727王品","110/07/09","兆豐-來福",23,1,22
"11638","2727王品","110/07/09","元大-員林",9,38,-29
"11639","2727王品","110/07/09","玉山-士林",22,2,20
"11640","2727王品","110/07/09","元富-西松",4,31,-27
"11641","1570力肯","110/07/09","凱基-台北",30,1,29
"11642","1570力肯","110/07/09","群益金鼎-彰化",0,20,-20
"11643","1570力肯","110/07/09","新光-台南",20,0,20
"11644","1570力肯","110/07/09","元大-土城學府",0,20,-20
"11645","1570力肯","110/07/09","元大-高雄",20,0,20
"11646","1570力肯","110/07/09","元大-大統",0,16,-16
"11647","1570力肯","110/07/09","國票-中正",12,0,12
"11648","1570力肯","110/07/09","元大-新營",0,11,-11
"11649","1570力肯","110/07/09","日盛-高雄",6,0,6
"11650","1570力肯","110/07/09","元大-和平",0,10,-10
"11651","1570力肯","110/07/09","元富-緯城",6,0,6
"11652","1570力肯","110/07/09","元大-草屯",0,10,-10
"11653","1570力肯","110/07/09","群益金鼎-台南",6,0,6
"11654","1570力肯","110/07/09","元大-鹿港",0,9,-9
"11655","1570力肯","110/07/09","華南永昌-岡山",6,0,6
"11656","1570力肯","110/07/09","合庫-基隆",0,7,-7
"11657","1570力肯","110/07/09","統一-中壢",5,0,5
"11658","1570力肯","110/07/09","摩根大通",2,8,-6
"11659","1570力肯","110/07/09","凱基-三峽",5,0,5
"11660","1570力肯","110/07/09","台灣企銀-豐原",0,4,-4
"11661","1570力肯","110/07/09","大昌-樹林",4,0,4
"11662","1570力肯","110/07/09","日盛-桃園",0,4,-4
"11663","1570力肯","110/07/09","新光",3,0,3
"11664","1570力肯","110/07/09","國泰-高雄",0,3,-3
"11665","1570力肯","110/07/09","富邦-新竹華信",3,0,3
"11666","1570力肯","110/07/09","永豐金-敦南",0,3,-3
"11667","1570力肯","110/07/09","合庫-台中",2,0,2
"11668","1570力肯","110/07/09","土銀-彰化",0,2,-2
"11669","1570力肯","110/07/09","臺銀-臺中",2,0,2
"11670","1570力肯","110/07/09","臺銀-鳳山",0,2,-2
"11671","6180橘子","110/07/09","摩根大通",63,1,62
"11672","6180橘子","110/07/09","元大-南京",1,32,-31
"11673","6180橘子","110/07/09","富邦-陽明",73,33,40
"11674","6180橘子","110/07/09","群益金鼎-台北",0,25,-25
"11675","6180橘子","110/07/09","新加坡商瑞銀",31,0,31
"11676","6180橘子","110/07/09","兆豐-復興",0,21,-21
"11677","6180橘子","110/07/09","美商高盛",25,0,25
"11678","6180橘子","110/07/09","永豐金-嘉義",0,21,-21
"11679","6180橘子","110/07/09","凱基-台北",26,10,16
"11680","6180橘子","110/07/09","凱基-中壢",8,24,-16
"11681","6180橘子","110/07/09","華南永昌-楠梓",13,0,13
"11682","6180橘子","110/07/09","致和-崇德",0,15,-15
"11683","6180橘子","110/07/09","華南永昌-朴子",11,0,11
"11684","6180橘子","110/07/09","群益金鼎-屏東",0,15,-15
"11685","6180橘子","110/07/09","元大-北港",11,0,11
"11686","6180橘子","110/07/09","群益金鼎-中山",0,15,-15
"11687","6180橘子","110/07/09","元大-成功",10,1,9
"11688","6180橘子","110/07/09","瑞士信貸",1,15,-14
"11689","6180橘子","110/07/09","新光",26,18,8
"11690","6180橘子","110/07/09","日盛-二林",0,10,-10
"11691","6180橘子","110/07/09","統一-三重",6,0,6
"11692","6180橘子","110/07/09","凱基-東門",0,10,-10
"11693","6180橘子","110/07/09","群益金鼎-嘉義",6,0,6
"11694","6180橘子","110/07/09","華南永昌-三重",0,10,-10
"11695","6180橘子","110/07/09","元大-員林中山",6,0,6
"11696","6180橘子","110/07/09","元大-彰化民生",1,11,-10
"11697","6180橘子","110/07/09","合庫-鳳山",5,0,5
"11698","6180橘子","110/07/09","永豐金-新店",1,11,-10
"11699","6180橘子","110/07/09","富邦-建國",6,1,5
"11700","6180橘子","110/07/09","群益金鼎-丹鳳",0,8,-8
"11701","2390云辰","110/07/09","摩根大通",279,56,223
"11702","2390云辰","110/07/09","元大-天母",0,127,-127
"11703","2390云辰","110/07/09","日盛-鳳山",110,2,108
"11704","2390云辰","110/07/09","中國信託-文心",5,109,-104
"11705","2390云辰","110/07/09","宏遠證券",100,0,100
"11706","2390云辰","110/07/09","永豐金-復興",0,55,-55
"11707","2390云辰","110/07/09","元大-大里",63,6,57
"11708","2390云辰","110/07/09","凱基-台北",239,286,-47
"11709","2390云辰","110/07/09","凱基-八德",59,10,49
"11710","2390云辰","110/07/09","德信",2,32,-30
"11711","2390云辰","110/07/09","合庫-新竹",40,0,40
"11712","2390云辰","110/07/09","兆豐-桃鶯",2,32,-30
"11713","2390云辰","110/07/09","國票",40,1,39
"11714","2390云辰","110/07/09","致和-南京",0,30,-30
"11715","2390云辰","110/07/09","新加坡商瑞銀",49,13,36
"11716","2390云辰","110/07/09","富邦-虎尾",1,31,-30
"11717","2390云辰","110/07/09","統一-新台中",36,2,34
"11718","2390云辰","110/07/09","元大-善化",2,31,-29
"11719","2390云辰","110/07/09","國票-嘉義",31,0,31
"11720","2390云辰","110/07/09","富邦-板橋",0,27,-27
"11721","2390云辰","110/07/09","華南永昌",35,7,28
"11722","2390云辰","110/07/09","富邦-永和",3,28,-25
"11723","2390云辰","110/07/09","玉山-台中",49,22,27
"11724","2390云辰","110/07/09","第一金-自由",20,44,-24
"11725","2390云辰","110/07/09","華南永昌-敦南",25,0,25
"11726","2390云辰","110/07/09","凱基-內湖",0,24,-24
"11727","2390云辰","110/07/09","新光-高雄",27,4,23
"11728","2390云辰","110/07/09","元大-汐止",1,24,-23
"11729","2390云辰","110/07/09","台灣摩根士丹利",85,63,22
"11730","2390云辰","110/07/09","新光-台中",12,33,-21
"11731","4903聯光通","110/07/09","元大-敦南",10,0,10
"11732","4903聯光通","110/07/09","第一金-台中",0,12,-12
"11733","4903聯光通","110/07/09","凱基-士林",5,0,5
"11734","4903聯光通","110/07/09","日盛-忠孝",0,3,-3
"11735","4903聯光通","110/07/09","元大-苗栗",5,0,5
"11736","4903聯光通","110/07/09","群益金鼎-崇德",0,3,-3
"11737","4903聯光通","110/07/09","元大-屏南",3,0,3
"11738","4903聯光通","110/07/09","國票-內壢",0,2,-2
"11739","4903聯光通","110/07/09","中國信託-永康",1,0,1
"11740","4903聯光通","110/07/09","康和-南崁",0,2,-2
"11741","4903聯光通","110/07/09","玉山證券",1,0,1
"11742","4903聯光通","110/07/09","新光-台中",0,2,-2
"11743","4903聯光通","110/07/09","元大-太平",4,3,1
"11744","4903聯光通","110/07/09","玉山-城中",0,2,-2
"11745","4903聯光通","110/07/09","永豐金-嘉義",1,0,1
"11746","4903聯光通","110/07/09","中國信託-文心",0,1,-1
"11747","4903聯光通","110/07/09","大昌",0,0,0
"11748","4903聯光通","110/07/09","大昌",0,0,0
"11749","4903聯光通","110/07/09","中農",0,0,0
"11750","4903聯光通","110/07/09","中農",0,0,0
"11751","4903聯光通","110/07/09","",NA,NA,NA
"11752","4903聯光通","110/07/09","",NA,NA,NA
"11753","4903聯光通","110/07/09","",NA,NA,NA
"11754","4903聯光通","110/07/09","",NA,NA,NA
"11755","4903聯光通","110/07/09","",NA,NA,NA
"11756","4903聯光通","110/07/09","",NA,NA,NA
"11757","4903聯光通","110/07/09","",NA,NA,NA
"11758","4903聯光通","110/07/09","",NA,NA,NA
"11759","4903聯光通","110/07/09","",NA,NA,NA
"11760","4903聯光通","110/07/09","",NA,NA,NA
"11761","2929淘帝","110/07/09","台中銀-台北",110,0,110
"11762","2929淘帝","110/07/09","新光",2,82,-80
"11763","2929淘帝","110/07/09","華南永昌-頭份",72,0,72
"11764","2929淘帝","110/07/09","摩根大通",2,63,-61
"11765","2929淘帝","110/07/09","合庫-高雄",71,0,71
"11766","2929淘帝","110/07/09","第一金-路竹",0,50,-50
"11767","2929淘帝","110/07/09","高橋-龍潭",37,0,37
"11768","2929淘帝","110/07/09","港商麥格理",0,42,-42
"11769","2929淘帝","110/07/09","新光-台中",60,26,34
"11770","2929淘帝","110/07/09","陽信-石牌",0,40,-40
"11771","2929淘帝","110/07/09","元富-大裕",22,1,21
"11772","2929淘帝","110/07/09","台新-左楠",1,39,-38
"11773","2929淘帝","110/07/09","合庫-鳳山",20,0,20
"11774","2929淘帝","110/07/09","凱基-桃園",3,29,-26
"11775","2929淘帝","110/07/09","元大-員林",22,2,20
"11776","2929淘帝","110/07/09","兆豐-內湖",0,25,-25
"11777","2929淘帝","110/07/09","台新-建北",15,0,15
"11778","2929淘帝","110/07/09","元大-北港",0,20,-20
"11779","2929淘帝","110/07/09","兆豐-桃園",13,0,13
"11780","2929淘帝","110/07/09","富邦-北港",0,19,-19
"11781","2929淘帝","110/07/09","兆豐-忠孝",10,0,10
"11782","2929淘帝","110/07/09","富邦-花蓮",0,17,-17
"11783","2929淘帝","110/07/09","國票-敦北法人",10,0,10
"11784","2929淘帝","110/07/09","國泰-台中",2,17,-15
"11785","2929淘帝","110/07/09","永豐金-博愛",10,0,10
"11786","2929淘帝","110/07/09","群益金鼎-彰化",0,15,-15
"11787","2929淘帝","110/07/09","群益金鼎-潭子",8,0,8
"11788","2929淘帝","110/07/09","元大-博愛",0,14,-14
"11789","2929淘帝","110/07/09","富邦-南屯",8,0,8
"11790","2929淘帝","110/07/09","日盛-板橋",0,13,-13
"11791","5410國眾","110/07/09","元大-新盛",14,0,14
"11792","5410國眾","110/07/09","(牛牛牛)亞-鑫豐",1,41,-40
"11793","5410國眾","110/07/09","台灣企銀-民雄",10,0,10
"11794","5410國眾","110/07/09","元富-嘉義",0,25,-25
"11795","5410國眾","110/07/09","元富-虎尾",9,0,9
"11796","5410國眾","110/07/09","凱基-高美館",0,10,-10
"11797","5410國眾","110/07/09","摩根大通",10,1,9
"11798","5410國眾","110/07/09","凱基-城中",0,10,-10
"11799","5410國眾","110/07/09","兆豐-北高雄",7,0,7
"11800","5410國眾","110/07/09","元大-頭份",0,10,-10
"11801","5410國眾","110/07/09","凱基-台北",8,1,7
"11802","5410國眾","110/07/09","群益金鼎-丹鳳",0,7,-7
"11803","5410國眾","110/07/09","華南永昌-公誠",7,0,7
"11804","5410國眾","110/07/09","凱基-復興",0,7,-7
"11805","5410國眾","110/07/09","香港上海匯豐",6,0,6
"11806","5410國眾","110/07/09","元大-員林",0,7,-7
"11807","5410國眾","110/07/09","凱基-中壢",6,0,6
"11808","5410國眾","110/07/09","富邦-竹東",0,6,-6
"11809","5410國眾","110/07/09","華南永昌-南京",6,0,6
"11810","5410國眾","110/07/09","亞東-高雄",0,5,-5
"11811","5410國眾","110/07/09","統一-三重",5,0,5
"11812","5410國眾","110/07/09","大慶-中壢",1,6,-5
"11813","5410國眾","110/07/09","富邦-宜蘭",5,0,5
"11814","5410國眾","110/07/09","群益金鼎-中港",0,5,-5
"11815","5410國眾","110/07/09","元大-崇德",5,0,5
"11816","5410國眾","110/07/09","元大-八德",0,5,-5
"11817","5410國眾","110/07/09","元大-博愛",5,0,5
"11818","5410國眾","110/07/09","富邦-基隆",0,4,-4
"11819","5410國眾","110/07/09","元大-龍潭",5,0,5
"11820","5410國眾","110/07/09","臺銀-新竹",0,3,-3
"11821","2841台開","110/07/09","日盛-雙和",102,0,102
"11822","2841台開","110/07/09","港商野村",0,129,-129
"11823","2841台開","110/07/09","元大-館前",70,0,70
"11824","2841台開","110/07/09","兆豐-永和",0,100,-100
"11825","2841台開","110/07/09","凱基-文心",50,0,50
"11826","2841台開","110/07/09","台新證券",7,28,-21
"11827","2841台開","110/07/09","富邦-嘉義",40,0,40
"11828","2841台開","110/07/09","國票-北高雄",0,20,-20
"11829","2841台開","110/07/09","美商高盛",15,0,15
"11830","2841台開","110/07/09","永豐金-敦南",29,46,-17
"11831","2841台開","110/07/09","台中銀",15,0,15
"11832","2841台開","110/07/09","合庫-基隆",0,12,-12
"11833","2841台開","110/07/09","新光",11,0,11
"11834","2841台開","110/07/09","中國信託-松江",0,12,-12
"11835","2841台開","110/07/09","華南永昌-長虹",10,0,10
"11836","2841台開","110/07/09","兆豐-城中",0,12,-12
"11837","2841台開","110/07/09","永豐金-南投",10,0,10
"11838","2841台開","110/07/09","台中銀-豐原",0,10,-10
"11839","2841台開","110/07/09","合庫-桃園",7,0,7
"11840","2841台開","110/07/09","兆豐-景美",0,10,-10
"11841","2841台開","110/07/09","群益金鼎-古亭",7,0,7
"11842","2841台開","110/07/09","群益金鼎-基隆",0,10,-10
"11843","2841台開","110/07/09","國泰-敦南",6,0,6
"11844","2841台開","110/07/09","元大-北三重",0,10,-10
"11845","2841台開","110/07/09","凱基-桃園",8,2,6
"11846","2841台開","110/07/09","(牛牛牛)亞-網路",0,9,-9
"11847","2841台開","110/07/09","日盛證券",5,0,5
"11848","2841台開","110/07/09","台新-高雄",1,10,-9
"11849","2841台開","110/07/09","元富-文心",5,0,5
"11850","2841台開","110/07/09","凱基-台北",0,7,-7
"11851","6207雷科","110/07/09","群益金鼎-新竹",47,0,47
"11852","6207雷科","110/07/09","新光",7,24,-17
"11853","6207雷科","110/07/09","永豐金-三重",31,0,31
"11854","6207雷科","110/07/09","日盛-和美",0,15,-15
"11855","6207雷科","110/07/09","新加坡商瑞銀",33,5,28
"11856","6207雷科","110/07/09","國泰-台南",0,15,-15
"11857","6207雷科","110/07/09","元大-高雄",26,0,26
"11858","6207雷科","110/07/09","華南永昌-古亭",0,14,-14
"11859","6207雷科","110/07/09","統一-員林",22,0,22
"11860","6207雷科","110/07/09","土銀-白河",0,11,-11
"11861","6207雷科","110/07/09","台新-高雄",22,0,22
"11862","6207雷科","110/07/09","日盛-台南",0,10,-10
"11863","6207雷科","110/07/09","摩根大通",34,17,17
"11864","6207雷科","110/07/09","元富-林園",0,10,-10
"11865","6207雷科","110/07/09","元大-博愛",17,1,16
"11866","6207雷科","110/07/09","富邦-園區",0,10,-10
"11867","6207雷科","110/07/09","日茂-埔里",12,0,12
"11868","6207雷科","110/07/09","元大-上新莊",0,10,-10
"11869","6207雷科","110/07/09","國泰-台中",17,6,11
"11870","6207雷科","110/07/09","永豐金-南京",0,10,-10
"11871","6207雷科","110/07/09","富邦-三重",10,0,10
"11872","6207雷科","110/07/09","兆豐-小港",0,6,-6
"11873","6207雷科","110/07/09","元大-沙鹿",10,0,10
"11874","6207雷科","110/07/09","富邦-羅東",1,7,-6
"11875","6207雷科","110/07/09","元大-八德",10,0,10
"11876","6207雷科","110/07/09","元大-土城永寧",0,6,-6
"11877","6207雷科","110/07/09","第一金-路竹",11,2,9
"11878","6207雷科","110/07/09","永豐金-板盛",0,6,-6
"11879","6207雷科","110/07/09","統一-南京",5,0,5
"11880","6207雷科","110/07/09","日盛-板橋",0,5,-5
"11881","3679新至陞","110/07/09","元大-大天母",10,0,10
"11882","3679新至陞","110/07/09","第一金-光復",0,11,-11
"11883","3679新至陞","110/07/09","日盛-樹林",9,0,9
"11884","3679新至陞","110/07/09","瑞士信貸",0,8,-8
"11885","3679新至陞","110/07/09","凱基-台北",11,2,9
"11886","3679新至陞","110/07/09","大慶-苗栗",0,5,-5
"11887","3679新至陞","110/07/09","華南永昌-小港",8,0,8
"11888","3679新至陞","110/07/09","元大-永春",0,5,-5
"11889","3679新至陞","110/07/09","兆豐-來福",7,0,7
"11890","3679新至陞","110/07/09","日盛-和美",0,4,-4
"11891","3679新至陞","110/07/09","香港上海匯豐",5,0,5
"11892","3679新至陞","110/07/09","元大-雙和",0,3,-3
"11893","3679新至陞","110/07/09","台中銀-員林",3,0,3
"11894","3679新至陞","110/07/09","永豐金-屏東",0,3,-3
"11895","3679新至陞","110/07/09","新光",3,0,3
"11896","3679新至陞","110/07/09","彰銀",0,2,-2
"11897","3679新至陞","110/07/09","土銀-花蓮",2,0,2
"11898","3679新至陞","110/07/09","宏遠-館前",0,2,-2
"11899","3679新至陞","110/07/09","第一金-澎湖",2,0,2
"11900","3679新至陞","110/07/09","港商野村",0,2,-2
"11901","3679新至陞","110/07/09","摩根大通",2,0,2
"11902","3679新至陞","110/07/09","大昌-新店",0,2,-2
"11903","3679新至陞","110/07/09","國泰-敦南",2,0,2
"11904","3679新至陞","110/07/09","元大-新莊",0,2,-2
"11905","3679新至陞","110/07/09","元大-淡水",4,2,2
"11906","3679新至陞","110/07/09","元大-板橋",0,2,-2
"11907","3679新至陞","110/07/09","日盛-士林",1,0,1
"11908","3679新至陞","110/07/09","台灣摩根士丹利",0,1,-1
"11909","3679新至陞","110/07/09","日盛-信義",1,0,1
"11910","3679新至陞","110/07/09","第一金-高雄",0,1,-1
"11911","2727王品","110/07/09","台灣匯立證券",90,0,90
"11912","2727王品","110/07/09","台灣摩根士丹利",0,267,-267
"11913","2727王品","110/07/09","國泰-敦南",166,84,82
"11914","2727王品","110/07/09","富邦-台北",35,299,-264
"11915","2727王品","110/07/09","富邦-仁愛",56,12,44
"11916","2727王品","110/07/09","凱基-台北",174,296,-122
"11917","2727王品","110/07/09","台新證券",109,66,43
"11918","2727王品","110/07/09","第一金",2,102,-100
"11919","2727王品","110/07/09","新光",117,87,30
"11920","2727王品","110/07/09","群益金鼎-大安",0,80,-80
"11921","2727王品","110/07/09","臺銀-臺中",35,6,29
"11922","2727王品","110/07/09","兆豐-大安",7,60,-53
"11923","2727王品","110/07/09","元大-桃園",32,3,29
"11924","2727王品","110/07/09","永豐金-南投",0,50,-50
"11925","2727王品","110/07/09","元富-宜蘭",34,6,28
"11926","2727王品","110/07/09","新加坡商瑞銀",6,46,-40
"11927","2727王品","110/07/09","玉山-台中",34,8,26
"11928","2727王品","110/07/09","合庫-彰化",11,50,-39
"11929","2727王品","110/07/09","群益金鼎-宜蘭",30,4,26
"11930","2727王品","110/07/09","永豐金-萬盛",13,52,-39
"11931","2727王品","110/07/09","富邦-台中",42,16,26
"11932","2727王品","110/07/09","瑞士信貸",0,34,-34
"11933","2727王品","110/07/09","第一金-豐原",25,1,24
"11934","2727王品","110/07/09","元大-和平",4,35,-31
"11935","2727王品","110/07/09","臺銀",30,8,22
"11936","2727王品","110/07/09","美林",14,44,-30
"11937","2727王品","110/07/09","兆豐-來福",23,1,22
"11938","2727王品","110/07/09","元大-員林",9,38,-29
"11939","2727王品","110/07/09","玉山-士林",22,2,20
"11940","2727王品","110/07/09","元富-西松",4,31,-27
"11941","1570力肯","110/07/09","凱基-台北",30,1,29
"11942","1570力肯","110/07/09","群益金鼎-彰化",0,20,-20
"11943","1570力肯","110/07/09","新光-台南",20,0,20
"11944","1570力肯","110/07/09","元大-土城學府",0,20,-20
"11945","1570力肯","110/07/09","元大-高雄",20,0,20
"11946","1570力肯","110/07/09","元大-大統",0,16,-16
"11947","1570力肯","110/07/09","國票-中正",12,0,12
"11948","1570力肯","110/07/09","元大-新營",0,11,-11
"11949","1570力肯","110/07/09","日盛-高雄",6,0,6
"11950","1570力肯","110/07/09","元大-和平",0,10,-10
"11951","1570力肯","110/07/09","元富-緯城",6,0,6
"11952","1570力肯","110/07/09","元大-草屯",0,10,-10
"11953","1570力肯","110/07/09","群益金鼎-台南",6,0,6
"11954","1570力肯","110/07/09","元大-鹿港",0,9,-9
"11955","1570力肯","110/07/09","華南永昌-岡山",6,0,6
"11956","1570力肯","110/07/09","合庫-基隆",0,7,-7
"11957","1570力肯","110/07/09","統一-中壢",5,0,5
"11958","1570力肯","110/07/09","摩根大通",2,8,-6
"11959","1570力肯","110/07/09","凱基-三峽",5,0,5
"11960","1570力肯","110/07/09","台灣企銀-豐原",0,4,-4
"11961","1570力肯","110/07/09","大昌-樹林",4,0,4
"11962","1570力肯","110/07/09","日盛-桃園",0,4,-4
"11963","1570力肯","110/07/09","新光",3,0,3
"11964","1570力肯","110/07/09","國泰-高雄",0,3,-3
"11965","1570力肯","110/07/09","富邦-新竹華信",3,0,3
"11966","1570力肯","110/07/09","永豐金-敦南",0,3,-3
"11967","1570力肯","110/07/09","合庫-台中",2,0,2
"11968","1570力肯","110/07/09","土銀-彰化",0,2,-2
"11969","1570力肯","110/07/09","臺銀-臺中",2,0,2
"11970","1570力肯","110/07/09","臺銀-鳳山",0,2,-2
"11971","6180橘子","110/07/09","摩根大通",63,1,62
"11972","6180橘子","110/07/09","元大-南京",1,32,-31
"11973","6180橘子","110/07/09","富邦-陽明",73,33,40
"11974","6180橘子","110/07/09","群益金鼎-台北",0,25,-25
"11975","6180橘子","110/07/09","新加坡商瑞銀",31,0,31
"11976","6180橘子","110/07/09","兆豐-復興",0,21,-21
"11977","6180橘子","110/07/09","美商高盛",25,0,25
"11978","6180橘子","110/07/09","永豐金-嘉義",0,21,-21
"11979","6180橘子","110/07/09","凱基-台北",26,10,16
"11980","6180橘子","110/07/09","凱基-中壢",8,24,-16
"11981","6180橘子","110/07/09","華南永昌-楠梓",13,0,13
"11982","6180橘子","110/07/09","致和-崇德",0,15,-15
"11983","6180橘子","110/07/09","華南永昌-朴子",11,0,11
"11984","6180橘子","110/07/09","群益金鼎-屏東",0,15,-15
"11985","6180橘子","110/07/09","元大-北港",11,0,11
"11986","6180橘子","110/07/09","群益金鼎-中山",0,15,-15
"11987","6180橘子","110/07/09","元大-成功",10,1,9
"11988","6180橘子","110/07/09","瑞士信貸",1,15,-14
"11989","6180橘子","110/07/09","新光",26,18,8
"11990","6180橘子","110/07/09","日盛-二林",0,10,-10
"11991","6180橘子","110/07/09","統一-三重",6,0,6
"11992","6180橘子","110/07/09","凱基-東門",0,10,-10
"11993","6180橘子","110/07/09","群益金鼎-嘉義",6,0,6
"11994","6180橘子","110/07/09","華南永昌-三重",0,10,-10
"11995","6180橘子","110/07/09","元大-員林中山",6,0,6
"11996","6180橘子","110/07/09","元大-彰化民生",1,11,-10
"11997","6180橘子","110/07/09","合庫-鳳山",5,0,5
"11998","6180橘子","110/07/09","永豐金-新店",1,11,-10
"11999","6180橘子","110/07/09","富邦-建國",6,1,5
"12000","6180橘子","110/07/09","群益金鼎-丹鳳",0,8,-8
"12001","2390云辰","110/07/09","摩根大通",279,56,223
"12002","2390云辰","110/07/09","元大-天母",0,127,-127
"12003","2390云辰","110/07/09","日盛-鳳山",110,2,108
"12004","2390云辰","110/07/09","中國信託-文心",5,109,-104
"12005","2390云辰","110/07/09","宏遠證券",100,0,100
"12006","2390云辰","110/07/09","永豐金-復興",0,55,-55
"12007","2390云辰","110/07/09","元大-大里",63,6,57
"12008","2390云辰","110/07/09","凱基-台北",239,286,-47
"12009","2390云辰","110/07/09","凱基-八德",59,10,49
"12010","2390云辰","110/07/09","德信",2,32,-30
"12011","2390云辰","110/07/09","合庫-新竹",40,0,40
"12012","2390云辰","110/07/09","兆豐-桃鶯",2,32,-30
"12013","2390云辰","110/07/09","國票",40,1,39
"12014","2390云辰","110/07/09","致和-南京",0,30,-30
"12015","2390云辰","110/07/09","新加坡商瑞銀",49,13,36
"12016","2390云辰","110/07/09","富邦-虎尾",1,31,-30
"12017","2390云辰","110/07/09","統一-新台中",36,2,34
"12018","2390云辰","110/07/09","元大-善化",2,31,-29
"12019","2390云辰","110/07/09","國票-嘉義",31,0,31
"12020","2390云辰","110/07/09","富邦-板橋",0,27,-27
"12021","2390云辰","110/07/09","華南永昌",35,7,28
"12022","2390云辰","110/07/09","富邦-永和",3,28,-25
"12023","2390云辰","110/07/09","玉山-台中",49,22,27
"12024","2390云辰","110/07/09","第一金-自由",20,44,-24
"12025","2390云辰","110/07/09","華南永昌-敦南",25,0,25
"12026","2390云辰","110/07/09","凱基-內湖",0,24,-24
"12027","2390云辰","110/07/09","新光-高雄",27,4,23
"12028","2390云辰","110/07/09","元大-汐止",1,24,-23
"12029","2390云辰","110/07/09","台灣摩根士丹利",85,63,22
"12030","2390云辰","110/07/09","新光-台中",12,33,-21
"12031","4903聯光通","110/07/09","元大-敦南",10,0,10
"12032","4903聯光通","110/07/09","第一金-台中",0,12,-12
"12033","4903聯光通","110/07/09","凱基-士林",5,0,5
"12034","4903聯光通","110/07/09","日盛-忠孝",0,3,-3
"12035","4903聯光通","110/07/09","元大-苗栗",5,0,5
"12036","4903聯光通","110/07/09","群益金鼎-崇德",0,3,-3
"12037","4903聯光通","110/07/09","元大-屏南",3,0,3
"12038","4903聯光通","110/07/09","國票-內壢",0,2,-2
"12039","4903聯光通","110/07/09","中國信託-永康",1,0,1
"12040","4903聯光通","110/07/09","康和-南崁",0,2,-2
"12041","4903聯光通","110/07/09","玉山證券",1,0,1
"12042","4903聯光通","110/07/09","新光-台中",0,2,-2
"12043","4903聯光通","110/07/09","元大-太平",4,3,1
"12044","4903聯光通","110/07/09","玉山-城中",0,2,-2
"12045","4903聯光通","110/07/09","永豐金-嘉義",1,0,1
"12046","4903聯光通","110/07/09","中國信託-文心",0,1,-1
"12047","4903聯光通","110/07/09","大昌",0,0,0
"12048","4903聯光通","110/07/09","大昌",0,0,0
"12049","4903聯光通","110/07/09","中農",0,0,0
"12050","4903聯光通","110/07/09","中農",0,0,0
"12051","4903聯光通","110/07/09","",NA,NA,NA
"12052","4903聯光通","110/07/09","",NA,NA,NA
"12053","4903聯光通","110/07/09","",NA,NA,NA
"12054","4903聯光通","110/07/09","",NA,NA,NA
"12055","4903聯光通","110/07/09","",NA,NA,NA
"12056","4903聯光通","110/07/09","",NA,NA,NA
"12057","4903聯光通","110/07/09","",NA,NA,NA
"12058","4903聯光通","110/07/09","",NA,NA,NA
"12059","4903聯光通","110/07/09","",NA,NA,NA
"12060","4903聯光通","110/07/09","",NA,NA,NA
"12061","2929淘帝","110/07/09","台中銀-台北",110,0,110
"12062","2929淘帝","110/07/09","新光",2,82,-80
"12063","2929淘帝","110/07/09","華南永昌-頭份",72,0,72
"12064","2929淘帝","110/07/09","摩根大通",2,63,-61
"12065","2929淘帝","110/07/09","合庫-高雄",71,0,71
"12066","2929淘帝","110/07/09","第一金-路竹",0,50,-50
"12067","2929淘帝","110/07/09","高橋-龍潭",37,0,37
"12068","2929淘帝","110/07/09","港商麥格理",0,42,-42
"12069","2929淘帝","110/07/09","新光-台中",60,26,34
"12070","2929淘帝","110/07/09","陽信-石牌",0,40,-40
"12071","2929淘帝","110/07/09","元富-大裕",22,1,21
"12072","2929淘帝","110/07/09","台新-左楠",1,39,-38
"12073","2929淘帝","110/07/09","合庫-鳳山",20,0,20
"12074","2929淘帝","110/07/09","凱基-桃園",3,29,-26
"12075","2929淘帝","110/07/09","元大-員林",22,2,20
"12076","2929淘帝","110/07/09","兆豐-內湖",0,25,-25
"12077","2929淘帝","110/07/09","台新-建北",15,0,15
"12078","2929淘帝","110/07/09","元大-北港",0,20,-20
"12079","2929淘帝","110/07/09","兆豐-桃園",13,0,13
"12080","2929淘帝","110/07/09","富邦-北港",0,19,-19
"12081","2929淘帝","110/07/09","兆豐-忠孝",10,0,10
"12082","2929淘帝","110/07/09","富邦-花蓮",0,17,-17
"12083","2929淘帝","110/07/09","國票-敦北法人",10,0,10
"12084","2929淘帝","110/07/09","國泰-台中",2,17,-15
"12085","2929淘帝","110/07/09","永豐金-博愛",10,0,10
"12086","2929淘帝","110/07/09","群益金鼎-彰化",0,15,-15
"12087","2929淘帝","110/07/09","群益金鼎-潭子",8,0,8
"12088","2929淘帝","110/07/09","元大-博愛",0,14,-14
"12089","2929淘帝","110/07/09","富邦-南屯",8,0,8
"12090","2929淘帝","110/07/09","日盛-板橋",0,13,-13
"12091","5410國眾","110/07/09","元大-新盛",14,0,14
"12092","5410國眾","110/07/09","(牛牛牛)亞-鑫豐",1,41,-40
"12093","5410國眾","110/07/09","台灣企銀-民雄",10,0,10
"12094","5410國眾","110/07/09","元富-嘉義",0,25,-25
"12095","5410國眾","110/07/09","元富-虎尾",9,0,9
"12096","5410國眾","110/07/09","凱基-高美館",0,10,-10
"12097","5410國眾","110/07/09","摩根大通",10,1,9
"12098","5410國眾","110/07/09","凱基-城中",0,10,-10
"12099","5410國眾","110/07/09","兆豐-北高雄",7,0,7
"12100","5410國眾","110/07/09","元大-頭份",0,10,-10
"12101","5410國眾","110/07/09","凱基-台北",8,1,7
"12102","5410國眾","110/07/09","群益金鼎-丹鳳",0,7,-7
"12103","5410國眾","110/07/09","華南永昌-公誠",7,0,7
"12104","5410國眾","110/07/09","凱基-復興",0,7,-7
"12105","5410國眾","110/07/09","香港上海匯豐",6,0,6
"12106","5410國眾","110/07/09","元大-員林",0,7,-7
"12107","5410國眾","110/07/09","凱基-中壢",6,0,6
"12108","5410國眾","110/07/09","富邦-竹東",0,6,-6
"12109","5410國眾","110/07/09","華南永昌-南京",6,0,6
"12110","5410國眾","110/07/09","亞東-高雄",0,5,-5
"12111","5410國眾","110/07/09","統一-三重",5,0,5
"12112","5410國眾","110/07/09","大慶-中壢",1,6,-5
"12113","5410國眾","110/07/09","富邦-宜蘭",5,0,5
"12114","5410國眾","110/07/09","群益金鼎-中港",0,5,-5
"12115","5410國眾","110/07/09","元大-崇德",5,0,5
"12116","5410國眾","110/07/09","元大-八德",0,5,-5
"12117","5410國眾","110/07/09","元大-博愛",5,0,5
"12118","5410國眾","110/07/09","富邦-基隆",0,4,-4
"12119","5410國眾","110/07/09","元大-龍潭",5,0,5
"12120","5410國眾","110/07/09","臺銀-新竹",0,3,-3
"12121","2841台開","110/07/09","日盛-雙和",102,0,102
"12122","2841台開","110/07/09","港商野村",0,129,-129
"12123","2841台開","110/07/09","元大-館前",70,0,70
"12124","2841台開","110/07/09","兆豐-永和",0,100,-100
"12125","2841台開","110/07/09","凱基-文心",50,0,50
"12126","2841台開","110/07/09","台新證券",7,28,-21
"12127","2841台開","110/07/09","富邦-嘉義",40,0,40
"12128","2841台開","110/07/09","國票-北高雄",0,20,-20
"12129","2841台開","110/07/09","美商高盛",15,0,15
"12130","2841台開","110/07/09","永豐金-敦南",29,46,-17
"12131","2841台開","110/07/09","台中銀",15,0,15
"12132","2841台開","110/07/09","合庫-基隆",0,12,-12
"12133","2841台開","110/07/09","新光",11,0,11
"12134","2841台開","110/07/09","中國信託-松江",0,12,-12
"12135","2841台開","110/07/09","華南永昌-長虹",10,0,10
"12136","2841台開","110/07/09","兆豐-城中",0,12,-12
"12137","2841台開","110/07/09","永豐金-南投",10,0,10
"12138","2841台開","110/07/09","台中銀-豐原",0,10,-10
"12139","2841台開","110/07/09","合庫-桃園",7,0,7
"12140","2841台開","110/07/09","兆豐-景美",0,10,-10
"12141","2841台開","110/07/09","群益金鼎-古亭",7,0,7
"12142","2841台開","110/07/09","群益金鼎-基隆",0,10,-10
"12143","2841台開","110/07/09","國泰-敦南",6,0,6
"12144","2841台開","110/07/09","元大-北三重",0,10,-10
"12145","2841台開","110/07/09","凱基-桃園",8,2,6
"12146","2841台開","110/07/09","(牛牛牛)亞-網路",0,9,-9
"12147","2841台開","110/07/09","日盛證券",5,0,5
"12148","2841台開","110/07/09","台新-高雄",1,10,-9
"12149","2841台開","110/07/09","元富-文心",5,0,5
"12150","2841台開","110/07/09","凱基-台北",0,7,-7
"12151","6207雷科","110/07/09","群益金鼎-新竹",47,0,47
"12152","6207雷科","110/07/09","新光",7,24,-17
"12153","6207雷科","110/07/09","永豐金-三重",31,0,31
"12154","6207雷科","110/07/09","日盛-和美",0,15,-15
"12155","6207雷科","110/07/09","新加坡商瑞銀",33,5,28
"12156","6207雷科","110/07/09","國泰-台南",0,15,-15
"12157","6207雷科","110/07/09","元大-高雄",26,0,26
"12158","6207雷科","110/07/09","華南永昌-古亭",0,14,-14
"12159","6207雷科","110/07/09","統一-員林",22,0,22
"12160","6207雷科","110/07/09","土銀-白河",0,11,-11
"12161","6207雷科","110/07/09","台新-高雄",22,0,22
"12162","6207雷科","110/07/09","日盛-台南",0,10,-10
"12163","6207雷科","110/07/09","摩根大通",34,17,17
"12164","6207雷科","110/07/09","元富-林園",0,10,-10
"12165","6207雷科","110/07/09","元大-博愛",17,1,16
"12166","6207雷科","110/07/09","富邦-園區",0,10,-10
"12167","6207雷科","110/07/09","日茂-埔里",12,0,12
"12168","6207雷科","110/07/09","元大-上新莊",0,10,-10
"12169","6207雷科","110/07/09","國泰-台中",17,6,11
"12170","6207雷科","110/07/09","永豐金-南京",0,10,-10
"12171","6207雷科","110/07/09","富邦-三重",10,0,10
"12172","6207雷科","110/07/09","兆豐-小港",0,6,-6
"12173","6207雷科","110/07/09","元大-沙鹿",10,0,10
"12174","6207雷科","110/07/09","富邦-羅東",1,7,-6
"12175","6207雷科","110/07/09","元大-八德",10,0,10
"12176","6207雷科","110/07/09","元大-土城永寧",0,6,-6
"12177","6207雷科","110/07/09","第一金-路竹",11,2,9
"12178","6207雷科","110/07/09","永豐金-板盛",0,6,-6
"12179","6207雷科","110/07/09","統一-南京",5,0,5
"12180","6207雷科","110/07/09","日盛-板橋",0,5,-5
"12181","3679新至陞","110/07/09","元大-大天母",10,0,10
"12182","3679新至陞","110/07/09","第一金-光復",0,11,-11
"12183","3679新至陞","110/07/09","日盛-樹林",9,0,9
"12184","3679新至陞","110/07/09","瑞士信貸",0,8,-8
"12185","3679新至陞","110/07/09","凱基-台北",11,2,9
"12186","3679新至陞","110/07/09","大慶-苗栗",0,5,-5
"12187","3679新至陞","110/07/09","華南永昌-小港",8,0,8
"12188","3679新至陞","110/07/09","元大-永春",0,5,-5
"12189","3679新至陞","110/07/09","兆豐-來福",7,0,7
"12190","3679新至陞","110/07/09","日盛-和美",0,4,-4
"12191","3679新至陞","110/07/09","香港上海匯豐",5,0,5
"12192","3679新至陞","110/07/09","元大-雙和",0,3,-3
"12193","3679新至陞","110/07/09","台中銀-員林",3,0,3
"12194","3679新至陞","110/07/09","永豐金-屏東",0,3,-3
"12195","3679新至陞","110/07/09","新光",3,0,3
"12196","3679新至陞","110/07/09","彰銀",0,2,-2
"12197","3679新至陞","110/07/09","土銀-花蓮",2,0,2
"12198","3679新至陞","110/07/09","宏遠-館前",0,2,-2
"12199","3679新至陞","110/07/09","第一金-澎湖",2,0,2
"12200","3679新至陞","110/07/09","港商野村",0,2,-2
"12201","3679新至陞","110/07/09","摩根大通",2,0,2
"12202","3679新至陞","110/07/09","大昌-新店",0,2,-2
"12203","3679新至陞","110/07/09","國泰-敦南",2,0,2
"12204","3679新至陞","110/07/09","元大-新莊",0,2,-2
"12205","3679新至陞","110/07/09","元大-淡水",4,2,2
"12206","3679新至陞","110/07/09","元大-板橋",0,2,-2
"12207","3679新至陞","110/07/09","日盛-士林",1,0,1
"12208","3679新至陞","110/07/09","台灣摩根士丹利",0,1,-1
"12209","3679新至陞","110/07/09","日盛-信義",1,0,1
"12210","3679新至陞","110/07/09","第一金-高雄",0,1,-1
"12211","2727王品","110/07/09","台灣匯立證券",90,0,90
"12212","2727王品","110/07/09","台灣摩根士丹利",0,267,-267
"12213","2727王品","110/07/09","國泰-敦南",166,84,82
"12214","2727王品","110/07/09","富邦-台北",35,299,-264
"12215","2727王品","110/07/09","富邦-仁愛",56,12,44
"12216","2727王品","110/07/09","凱基-台北",174,296,-122
"12217","2727王品","110/07/09","台新證券",109,66,43
"12218","2727王品","110/07/09","第一金",2,102,-100
"12219","2727王品","110/07/09","新光",117,87,30
"12220","2727王品","110/07/09","群益金鼎-大安",0,80,-80
"12221","2727王品","110/07/09","臺銀-臺中",35,6,29
"12222","2727王品","110/07/09","兆豐-大安",7,60,-53
"12223","2727王品","110/07/09","元大-桃園",32,3,29
"12224","2727王品","110/07/09","永豐金-南投",0,50,-50
"12225","2727王品","110/07/09","元富-宜蘭",34,6,28
"12226","2727王品","110/07/09","新加坡商瑞銀",6,46,-40
"12227","2727王品","110/07/09","玉山-台中",34,8,26
"12228","2727王品","110/07/09","合庫-彰化",11,50,-39
"12229","2727王品","110/07/09","群益金鼎-宜蘭",30,4,26
"12230","2727王品","110/07/09","永豐金-萬盛",13,52,-39
"12231","2727王品","110/07/09","富邦-台中",42,16,26
"12232","2727王品","110/07/09","瑞士信貸",0,34,-34
"12233","2727王品","110/07/09","第一金-豐原",25,1,24
"12234","2727王品","110/07/09","元大-和平",4,35,-31
"12235","2727王品","110/07/09","臺銀",30,8,22
"12236","2727王品","110/07/09","美林",14,44,-30
"12237","2727王品","110/07/09","兆豐-來福",23,1,22
"12238","2727王品","110/07/09","元大-員林",9,38,-29
"12239","2727王品","110/07/09","玉山-士林",22,2,20
"12240","2727王品","110/07/09","元富-西松",4,31,-27
"12241","1570力肯","110/07/09","凱基-台北",30,1,29
"12242","1570力肯","110/07/09","群益金鼎-彰化",0,20,-20
"12243","1570力肯","110/07/09","新光-台南",20,0,20
"12244","1570力肯","110/07/09","元大-土城學府",0,20,-20
"12245","1570力肯","110/07/09","元大-高雄",20,0,20
"12246","1570力肯","110/07/09","元大-大統",0,16,-16
"12247","1570力肯","110/07/09","國票-中正",12,0,12
"12248","1570力肯","110/07/09","元大-新營",0,11,-11
"12249","1570力肯","110/07/09","日盛-高雄",6,0,6
"12250","1570力肯","110/07/09","元大-和平",0,10,-10
"12251","1570力肯","110/07/09","元富-緯城",6,0,6
"12252","1570力肯","110/07/09","元大-草屯",0,10,-10
"12253","1570力肯","110/07/09","群益金鼎-台南",6,0,6
"12254","1570力肯","110/07/09","元大-鹿港",0,9,-9
"12255","1570力肯","110/07/09","華南永昌-岡山",6,0,6
"12256","1570力肯","110/07/09","合庫-基隆",0,7,-7
"12257","1570力肯","110/07/09","統一-中壢",5,0,5
"12258","1570力肯","110/07/09","摩根大通",2,8,-6
"12259","1570力肯","110/07/09","凱基-三峽",5,0,5
"12260","1570力肯","110/07/09","台灣企銀-豐原",0,4,-4
"12261","1570力肯","110/07/09","大昌-樹林",4,0,4
"12262","1570力肯","110/07/09","日盛-桃園",0,4,-4
"12263","1570力肯","110/07/09","新光",3,0,3
"12264","1570力肯","110/07/09","國泰-高雄",0,3,-3
"12265","1570力肯","110/07/09","富邦-新竹華信",3,0,3
"12266","1570力肯","110/07/09","永豐金-敦南",0,3,-3
"12267","1570力肯","110/07/09","合庫-台中",2,0,2
"12268","1570力肯","110/07/09","土銀-彰化",0,2,-2
"12269","1570力肯","110/07/09","臺銀-臺中",2,0,2
"12270","1570力肯","110/07/09","臺銀-鳳山",0,2,-2
"12271","6180橘子","110/07/09","摩根大通",63,1,62
"12272","6180橘子","110/07/09","元大-南京",1,32,-31
"12273","6180橘子","110/07/09","富邦-陽明",73,33,40
"12274","6180橘子","110/07/09","群益金鼎-台北",0,25,-25
"12275","6180橘子","110/07/09","新加坡商瑞銀",31,0,31
"12276","6180橘子","110/07/09","兆豐-復興",0,21,-21
"12277","6180橘子","110/07/09","美商高盛",25,0,25
"12278","6180橘子","110/07/09","永豐金-嘉義",0,21,-21
"12279","6180橘子","110/07/09","凱基-台北",26,10,16
"12280","6180橘子","110/07/09","凱基-中壢",8,24,-16
"12281","6180橘子","110/07/09","華南永昌-楠梓",13,0,13
"12282","6180橘子","110/07/09","致和-崇德",0,15,-15
"12283","6180橘子","110/07/09","華南永昌-朴子",11,0,11
"12284","6180橘子","110/07/09","群益金鼎-屏東",0,15,-15
"12285","6180橘子","110/07/09","元大-北港",11,0,11
"12286","6180橘子","110/07/09","群益金鼎-中山",0,15,-15
"12287","6180橘子","110/07/09","元大-成功",10,1,9
"12288","6180橘子","110/07/09","瑞士信貸",1,15,-14
"12289","6180橘子","110/07/09","新光",26,18,8
"12290","6180橘子","110/07/09","日盛-二林",0,10,-10
"12291","6180橘子","110/07/09","統一-三重",6,0,6
"12292","6180橘子","110/07/09","凱基-東門",0,10,-10
"12293","6180橘子","110/07/09","群益金鼎-嘉義",6,0,6
"12294","6180橘子","110/07/09","華南永昌-三重",0,10,-10
"12295","6180橘子","110/07/09","元大-員林中山",6,0,6
"12296","6180橘子","110/07/09","元大-彰化民生",1,11,-10
"12297","6180橘子","110/07/09","合庫-鳳山",5,0,5
"12298","6180橘子","110/07/09","永豐金-新店",1,11,-10
"12299","6180橘子","110/07/09","富邦-建國",6,1,5
"12300","6180橘子","110/07/09","群益金鼎-丹鳳",0,8,-8
"12301","2390云辰","110/07/09","摩根大通",279,56,223
"12302","2390云辰","110/07/09","元大-天母",0,127,-127
"12303","2390云辰","110/07/09","日盛-鳳山",110,2,108
"12304","2390云辰","110/07/09","中國信託-文心",5,109,-104
"12305","2390云辰","110/07/09","宏遠證券",100,0,100
"12306","2390云辰","110/07/09","永豐金-復興",0,55,-55
"12307","2390云辰","110/07/09","元大-大里",63,6,57
"12308","2390云辰","110/07/09","凱基-台北",239,286,-47
"12309","2390云辰","110/07/09","凱基-八德",59,10,49
"12310","2390云辰","110/07/09","德信",2,32,-30
"12311","2390云辰","110/07/09","合庫-新竹",40,0,40
"12312","2390云辰","110/07/09","兆豐-桃鶯",2,32,-30
"12313","2390云辰","110/07/09","國票",40,1,39
"12314","2390云辰","110/07/09","致和-南京",0,30,-30
"12315","2390云辰","110/07/09","新加坡商瑞銀",49,13,36
"12316","2390云辰","110/07/09","富邦-虎尾",1,31,-30
"12317","2390云辰","110/07/09","統一-新台中",36,2,34
"12318","2390云辰","110/07/09","元大-善化",2,31,-29
"12319","2390云辰","110/07/09","國票-嘉義",31,0,31
"12320","2390云辰","110/07/09","富邦-板橋",0,27,-27
"12321","2390云辰","110/07/09","華南永昌",35,7,28
"12322","2390云辰","110/07/09","富邦-永和",3,28,-25
"12323","2390云辰","110/07/09","玉山-台中",49,22,27
"12324","2390云辰","110/07/09","第一金-自由",20,44,-24
"12325","2390云辰","110/07/09","華南永昌-敦南",25,0,25
"12326","2390云辰","110/07/09","凱基-內湖",0,24,-24
"12327","2390云辰","110/07/09","新光-高雄",27,4,23
"12328","2390云辰","110/07/09","元大-汐止",1,24,-23
"12329","2390云辰","110/07/09","台灣摩根士丹利",85,63,22
"12330","2390云辰","110/07/09","新光-台中",12,33,-21
"12331","4903聯光通","110/07/09","元大-敦南",10,0,10
"12332","4903聯光通","110/07/09","第一金-台中",0,12,-12
"12333","4903聯光通","110/07/09","凱基-士林",5,0,5
"12334","4903聯光通","110/07/09","日盛-忠孝",0,3,-3
"12335","4903聯光通","110/07/09","元大-苗栗",5,0,5
"12336","4903聯光通","110/07/09","群益金鼎-崇德",0,3,-3
"12337","4903聯光通","110/07/09","元大-屏南",3,0,3
"12338","4903聯光通","110/07/09","國票-內壢",0,2,-2
"12339","4903聯光通","110/07/09","中國信託-永康",1,0,1
"12340","4903聯光通","110/07/09","康和-南崁",0,2,-2
"12341","4903聯光通","110/07/09","玉山證券",1,0,1
"12342","4903聯光通","110/07/09","新光-台中",0,2,-2
"12343","4903聯光通","110/07/09","元大-太平",4,3,1
"12344","4903聯光通","110/07/09","玉山-城中",0,2,-2
"12345","4903聯光通","110/07/09","永豐金-嘉義",1,0,1
"12346","4903聯光通","110/07/09","中國信託-文心",0,1,-1
"12347","4903聯光通","110/07/09","大昌",0,0,0
"12348","4903聯光通","110/07/09","大昌",0,0,0
"12349","4903聯光通","110/07/09","中農",0,0,0
"12350","4903聯光通","110/07/09","中農",0,0,0
"12351","4903聯光通","110/07/09","",NA,NA,NA
"12352","4903聯光通","110/07/09","",NA,NA,NA
"12353","4903聯光通","110/07/09","",NA,NA,NA
"12354","4903聯光通","110/07/09","",NA,NA,NA
"12355","4903聯光通","110/07/09","",NA,NA,NA
"12356","4903聯光通","110/07/09","",NA,NA,NA
"12357","4903聯光通","110/07/09","",NA,NA,NA
"12358","4903聯光通","110/07/09","",NA,NA,NA
"12359","4903聯光通","110/07/09","",NA,NA,NA
"12360","4903聯光通","110/07/09","",NA,NA,NA
"12361","2929淘帝","110/07/09","台中銀-台北",110,0,110
"12362","2929淘帝","110/07/09","新光",2,82,-80
"12363","2929淘帝","110/07/09","華南永昌-頭份",72,0,72
"12364","2929淘帝","110/07/09","摩根大通",2,63,-61
"12365","2929淘帝","110/07/09","合庫-高雄",71,0,71
"12366","2929淘帝","110/07/09","第一金-路竹",0,50,-50
"12367","2929淘帝","110/07/09","高橋-龍潭",37,0,37
"12368","2929淘帝","110/07/09","港商麥格理",0,42,-42
"12369","2929淘帝","110/07/09","新光-台中",60,26,34
"12370","2929淘帝","110/07/09","陽信-石牌",0,40,-40
"12371","2929淘帝","110/07/09","元富-大裕",22,1,21
"12372","2929淘帝","110/07/09","台新-左楠",1,39,-38
"12373","2929淘帝","110/07/09","合庫-鳳山",20,0,20
"12374","2929淘帝","110/07/09","凱基-桃園",3,29,-26
"12375","2929淘帝","110/07/09","元大-員林",22,2,20
"12376","2929淘帝","110/07/09","兆豐-內湖",0,25,-25
"12377","2929淘帝","110/07/09","台新-建北",15,0,15
"12378","2929淘帝","110/07/09","元大-北港",0,20,-20
"12379","2929淘帝","110/07/09","兆豐-桃園",13,0,13
"12380","2929淘帝","110/07/09","富邦-北港",0,19,-19
"12381","2929淘帝","110/07/09","兆豐-忠孝",10,0,10
"12382","2929淘帝","110/07/09","富邦-花蓮",0,17,-17
"12383","2929淘帝","110/07/09","國票-敦北法人",10,0,10
"12384","2929淘帝","110/07/09","國泰-台中",2,17,-15
"12385","2929淘帝","110/07/09","永豐金-博愛",10,0,10
"12386","2929淘帝","110/07/09","群益金鼎-彰化",0,15,-15
"12387","2929淘帝","110/07/09","群益金鼎-潭子",8,0,8
"12388","2929淘帝","110/07/09","元大-博愛",0,14,-14
"12389","2929淘帝","110/07/09","富邦-南屯",8,0,8
"12390","2929淘帝","110/07/09","日盛-板橋",0,13,-13
"12391","5410國眾","110/07/09","元大-新盛",14,0,14
"12392","5410國眾","110/07/09","(牛牛牛)亞-鑫豐",1,41,-40
"12393","5410國眾","110/07/09","台灣企銀-民雄",10,0,10
"12394","5410國眾","110/07/09","元富-嘉義",0,25,-25
"12395","5410國眾","110/07/09","元富-虎尾",9,0,9
"12396","5410國眾","110/07/09","凱基-高美館",0,10,-10
"12397","5410國眾","110/07/09","摩根大通",10,1,9
"12398","5410國眾","110/07/09","凱基-城中",0,10,-10
"12399","5410國眾","110/07/09","兆豐-北高雄",7,0,7
"12400","5410國眾","110/07/09","元大-頭份",0,10,-10
"12401","5410國眾","110/07/09","凱基-台北",8,1,7
"12402","5410國眾","110/07/09","群益金鼎-丹鳳",0,7,-7
"12403","5410國眾","110/07/09","華南永昌-公誠",7,0,7
"12404","5410國眾","110/07/09","凱基-復興",0,7,-7
"12405","5410國眾","110/07/09","香港上海匯豐",6,0,6
"12406","5410國眾","110/07/09","元大-員林",0,7,-7
"12407","5410國眾","110/07/09","凱基-中壢",6,0,6
"12408","5410國眾","110/07/09","富邦-竹東",0,6,-6
"12409","5410國眾","110/07/09","華南永昌-南京",6,0,6
"12410","5410國眾","110/07/09","亞東-高雄",0,5,-5
"12411","5410國眾","110/07/09","統一-三重",5,0,5
"12412","5410國眾","110/07/09","大慶-中壢",1,6,-5
"12413","5410國眾","110/07/09","富邦-宜蘭",5,0,5
"12414","5410國眾","110/07/09","群益金鼎-中港",0,5,-5
"12415","5410國眾","110/07/09","元大-崇德",5,0,5
"12416","5410國眾","110/07/09","元大-八德",0,5,-5
"12417","5410國眾","110/07/09","元大-博愛",5,0,5
"12418","5410國眾","110/07/09","富邦-基隆",0,4,-4
"12419","5410國眾","110/07/09","元大-龍潭",5,0,5
"12420","5410國眾","110/07/09","臺銀-新竹",0,3,-3
"12421","2841台開","110/07/09","日盛-雙和",102,0,102
"12422","2841台開","110/07/09","港商野村",0,129,-129
"12423","2841台開","110/07/09","元大-館前",70,0,70
"12424","2841台開","110/07/09","兆豐-永和",0,100,-100
"12425","2841台開","110/07/09","凱基-文心",50,0,50
"12426","2841台開","110/07/09","台新證券",7,28,-21
"12427","2841台開","110/07/09","富邦-嘉義",40,0,40
"12428","2841台開","110/07/09","國票-北高雄",0,20,-20
"12429","2841台開","110/07/09","美商高盛",15,0,15
"12430","2841台開","110/07/09","永豐金-敦南",29,46,-17
"12431","2841台開","110/07/09","台中銀",15,0,15
"12432","2841台開","110/07/09","合庫-基隆",0,12,-12
"12433","2841台開","110/07/09","新光",11,0,11
"12434","2841台開","110/07/09","中國信託-松江",0,12,-12
"12435","2841台開","110/07/09","華南永昌-長虹",10,0,10
"12436","2841台開","110/07/09","兆豐-城中",0,12,-12
"12437","2841台開","110/07/09","永豐金-南投",10,0,10
"12438","2841台開","110/07/09","台中銀-豐原",0,10,-10
"12439","2841台開","110/07/09","合庫-桃園",7,0,7
"12440","2841台開","110/07/09","兆豐-景美",0,10,-10
"12441","2841台開","110/07/09","群益金鼎-古亭",7,0,7
"12442","2841台開","110/07/09","群益金鼎-基隆",0,10,-10
"12443","2841台開","110/07/09","國泰-敦南",6,0,6
"12444","2841台開","110/07/09","元大-北三重",0,10,-10
"12445","2841台開","110/07/09","凱基-桃園",8,2,6
"12446","2841台開","110/07/09","(牛牛牛)亞-網路",0,9,-9
"12447","2841台開","110/07/09","日盛證券",5,0,5
"12448","2841台開","110/07/09","台新-高雄",1,10,-9
"12449","2841台開","110/07/09","元富-文心",5,0,5
"12450","2841台開","110/07/09","凱基-台北",0,7,-7
"12451","6207雷科","110/07/09","群益金鼎-新竹",47,0,47
"12452","6207雷科","110/07/09","新光",7,24,-17
"12453","6207雷科","110/07/09","永豐金-三重",31,0,31
"12454","6207雷科","110/07/09","日盛-和美",0,15,-15
"12455","6207雷科","110/07/09","新加坡商瑞銀",33,5,28
"12456","6207雷科","110/07/09","國泰-台南",0,15,-15
"12457","6207雷科","110/07/09","元大-高雄",26,0,26
"12458","6207雷科","110/07/09","華南永昌-古亭",0,14,-14
"12459","6207雷科","110/07/09","統一-員林",22,0,22
"12460","6207雷科","110/07/09","土銀-白河",0,11,-11
"12461","6207雷科","110/07/09","台新-高雄",22,0,22
"12462","6207雷科","110/07/09","日盛-台南",0,10,-10
"12463","6207雷科","110/07/09","摩根大通",34,17,17
"12464","6207雷科","110/07/09","元富-林園",0,10,-10
"12465","6207雷科","110/07/09","元大-博愛",17,1,16
"12466","6207雷科","110/07/09","富邦-園區",0,10,-10
"12467","6207雷科","110/07/09","日茂-埔里",12,0,12
"12468","6207雷科","110/07/09","元大-上新莊",0,10,-10
"12469","6207雷科","110/07/09","國泰-台中",17,6,11
"12470","6207雷科","110/07/09","永豐金-南京",0,10,-10
"12471","6207雷科","110/07/09","富邦-三重",10,0,10
"12472","6207雷科","110/07/09","兆豐-小港",0,6,-6
"12473","6207雷科","110/07/09","元大-沙鹿",10,0,10
"12474","6207雷科","110/07/09","富邦-羅東",1,7,-6
"12475","6207雷科","110/07/09","元大-八德",10,0,10
"12476","6207雷科","110/07/09","元大-土城永寧",0,6,-6
"12477","6207雷科","110/07/09","第一金-路竹",11,2,9
"12478","6207雷科","110/07/09","永豐金-板盛",0,6,-6
"12479","6207雷科","110/07/09","統一-南京",5,0,5
"12480","6207雷科","110/07/09","日盛-板橋",0,5,-5
"12481","3679新至陞","110/07/09","元大-大天母",10,0,10
"12482","3679新至陞","110/07/09","第一金-光復",0,11,-11
"12483","3679新至陞","110/07/09","日盛-樹林",9,0,9
"12484","3679新至陞","110/07/09","瑞士信貸",0,8,-8
"12485","3679新至陞","110/07/09","凱基-台北",11,2,9
"12486","3679新至陞","110/07/09","大慶-苗栗",0,5,-5
"12487","3679新至陞","110/07/09","華南永昌-小港",8,0,8
"12488","3679新至陞","110/07/09","元大-永春",0,5,-5
"12489","3679新至陞","110/07/09","兆豐-來福",7,0,7
"12490","3679新至陞","110/07/09","日盛-和美",0,4,-4
"12491","3679新至陞","110/07/09","香港上海匯豐",5,0,5
"12492","3679新至陞","110/07/09","元大-雙和",0,3,-3
"12493","3679新至陞","110/07/09","台中銀-員林",3,0,3
"12494","3679新至陞","110/07/09","永豐金-屏東",0,3,-3
"12495","3679新至陞","110/07/09","新光",3,0,3
"12496","3679新至陞","110/07/09","彰銀",0,2,-2
"12497","3679新至陞","110/07/09","土銀-花蓮",2,0,2
"12498","3679新至陞","110/07/09","宏遠-館前",0,2,-2
"12499","3679新至陞","110/07/09","第一金-澎湖",2,0,2
"12500","3679新至陞","110/07/09","港商野村",0,2,-2
"12501","3679新至陞","110/07/09","摩根大通",2,0,2
"12502","3679新至陞","110/07/09","大昌-新店",0,2,-2
"12503","3679新至陞","110/07/09","國泰-敦南",2,0,2
"12504","3679新至陞","110/07/09","元大-新莊",0,2,-2
"12505","3679新至陞","110/07/09","元大-淡水",4,2,2
"12506","3679新至陞","110/07/09","元大-板橋",0,2,-2
"12507","3679新至陞","110/07/09","日盛-士林",1,0,1
"12508","3679新至陞","110/07/09","台灣摩根士丹利",0,1,-1
"12509","3679新至陞","110/07/09","日盛-信義",1,0,1
"12510","3679新至陞","110/07/09","第一金-高雄",0,1,-1
"12511","2727王品","110/07/09","台灣匯立證券",90,0,90
"12512","2727王品","110/07/09","台灣摩根士丹利",0,267,-267
"12513","2727王品","110/07/09","國泰-敦南",166,84,82
"12514","2727王品","110/07/09","富邦-台北",35,299,-264
"12515","2727王品","110/07/09","富邦-仁愛",56,12,44
"12516","2727王品","110/07/09","凱基-台北",174,296,-122
"12517","2727王品","110/07/09","台新證券",109,66,43
"12518","2727王品","110/07/09","第一金",2,102,-100
"12519","2727王品","110/07/09","新光",117,87,30
"12520","2727王品","110/07/09","群益金鼎-大安",0,80,-80
"12521","2727王品","110/07/09","臺銀-臺中",35,6,29
"12522","2727王品","110/07/09","兆豐-大安",7,60,-53
"12523","2727王品","110/07/09","元大-桃園",32,3,29
"12524","2727王品","110/07/09","永豐金-南投",0,50,-50
"12525","2727王品","110/07/09","元富-宜蘭",34,6,28
"12526","2727王品","110/07/09","新加坡商瑞銀",6,46,-40
"12527","2727王品","110/07/09","玉山-台中",34,8,26
"12528","2727王品","110/07/09","合庫-彰化",11,50,-39
"12529","2727王品","110/07/09","群益金鼎-宜蘭",30,4,26
"12530","2727王品","110/07/09","永豐金-萬盛",13,52,-39
"12531","2727王品","110/07/09","富邦-台中",42,16,26
"12532","2727王品","110/07/09","瑞士信貸",0,34,-34
"12533","2727王品","110/07/09","第一金-豐原",25,1,24
"12534","2727王品","110/07/09","元大-和平",4,35,-31
"12535","2727王品","110/07/09","臺銀",30,8,22
"12536","2727王品","110/07/09","美林",14,44,-30
"12537","2727王品","110/07/09","兆豐-來福",23,1,22
"12538","2727王品","110/07/09","元大-員林",9,38,-29
"12539","2727王品","110/07/09","玉山-士林",22,2,20
"12540","2727王品","110/07/09","元富-西松",4,31,-27
"12541","1570力肯","110/07/09","凱基-台北",30,1,29
"12542","1570力肯","110/07/09","群益金鼎-彰化",0,20,-20
"12543","1570力肯","110/07/09","新光-台南",20,0,20
"12544","1570力肯","110/07/09","元大-土城學府",0,20,-20
"12545","1570力肯","110/07/09","元大-高雄",20,0,20
"12546","1570力肯","110/07/09","元大-大統",0,16,-16
"12547","1570力肯","110/07/09","國票-中正",12,0,12
"12548","1570力肯","110/07/09","元大-新營",0,11,-11
"12549","1570力肯","110/07/09","日盛-高雄",6,0,6
"12550","1570力肯","110/07/09","元大-和平",0,10,-10
"12551","1570力肯","110/07/09","元富-緯城",6,0,6
"12552","1570力肯","110/07/09","元大-草屯",0,10,-10
"12553","1570力肯","110/07/09","群益金鼎-台南",6,0,6
"12554","1570力肯","110/07/09","元大-鹿港",0,9,-9
"12555","1570力肯","110/07/09","華南永昌-岡山",6,0,6
"12556","1570力肯","110/07/09","合庫-基隆",0,7,-7
"12557","1570力肯","110/07/09","統一-中壢",5,0,5
"12558","1570力肯","110/07/09","摩根大通",2,8,-6
"12559","1570力肯","110/07/09","凱基-三峽",5,0,5
"12560","1570力肯","110/07/09","台灣企銀-豐原",0,4,-4
"12561","1570力肯","110/07/09","大昌-樹林",4,0,4
"12562","1570力肯","110/07/09","日盛-桃園",0,4,-4
"12563","1570力肯","110/07/09","新光",3,0,3
"12564","1570力肯","110/07/09","國泰-高雄",0,3,-3
"12565","1570力肯","110/07/09","富邦-新竹華信",3,0,3
"12566","1570力肯","110/07/09","永豐金-敦南",0,3,-3
"12567","1570力肯","110/07/09","合庫-台中",2,0,2
"12568","1570力肯","110/07/09","土銀-彰化",0,2,-2
"12569","1570力肯","110/07/09","臺銀-臺中",2,0,2
"12570","1570力肯","110/07/09","臺銀-鳳山",0,2,-2
"12571","6180橘子","110/07/09","摩根大通",63,1,62
"12572","6180橘子","110/07/09","元大-南京",1,32,-31
"12573","6180橘子","110/07/09","富邦-陽明",73,33,40
"12574","6180橘子","110/07/09","群益金鼎-台北",0,25,-25
"12575","6180橘子","110/07/09","新加坡商瑞銀",31,0,31
"12576","6180橘子","110/07/09","兆豐-復興",0,21,-21
"12577","6180橘子","110/07/09","美商高盛",25,0,25
"12578","6180橘子","110/07/09","永豐金-嘉義",0,21,-21
"12579","6180橘子","110/07/09","凱基-台北",26,10,16
"12580","6180橘子","110/07/09","凱基-中壢",8,24,-16
"12581","6180橘子","110/07/09","華南永昌-楠梓",13,0,13
"12582","6180橘子","110/07/09","致和-崇德",0,15,-15
"12583","6180橘子","110/07/09","華南永昌-朴子",11,0,11
"12584","6180橘子","110/07/09","群益金鼎-屏東",0,15,-15
"12585","6180橘子","110/07/09","元大-北港",11,0,11
"12586","6180橘子","110/07/09","群益金鼎-中山",0,15,-15
"12587","6180橘子","110/07/09","元大-成功",10,1,9
"12588","6180橘子","110/07/09","瑞士信貸",1,15,-14
"12589","6180橘子","110/07/09","新光",26,18,8
"12590","6180橘子","110/07/09","日盛-二林",0,10,-10
"12591","6180橘子","110/07/09","統一-三重",6,0,6
"12592","6180橘子","110/07/09","凱基-東門",0,10,-10
"12593","6180橘子","110/07/09","群益金鼎-嘉義",6,0,6
"12594","6180橘子","110/07/09","華南永昌-三重",0,10,-10
"12595","6180橘子","110/07/09","元大-員林中山",6,0,6
"12596","6180橘子","110/07/09","元大-彰化民生",1,11,-10
"12597","6180橘子","110/07/09","合庫-鳳山",5,0,5
"12598","6180橘子","110/07/09","永豐金-新店",1,11,-10
"12599","6180橘子","110/07/09","富邦-建國",6,1,5
"12600","6180橘子","110/07/09","群益金鼎-丹鳳",0,8,-8
"12601","2390云辰","110/07/09","摩根大通",279,56,223
"12602","2390云辰","110/07/09","元大-天母",0,127,-127
"12603","2390云辰","110/07/09","日盛-鳳山",110,2,108
"12604","2390云辰","110/07/09","中國信託-文心",5,109,-104
"12605","2390云辰","110/07/09","宏遠證券",100,0,100
"12606","2390云辰","110/07/09","永豐金-復興",0,55,-55
"12607","2390云辰","110/07/09","元大-大里",63,6,57
"12608","2390云辰","110/07/09","凱基-台北",239,286,-47
"12609","2390云辰","110/07/09","凱基-八德",59,10,49
"12610","2390云辰","110/07/09","德信",2,32,-30
"12611","2390云辰","110/07/09","合庫-新竹",40,0,40
"12612","2390云辰","110/07/09","兆豐-桃鶯",2,32,-30
"12613","2390云辰","110/07/09","國票",40,1,39
"12614","2390云辰","110/07/09","致和-南京",0,30,-30
"12615","2390云辰","110/07/09","新加坡商瑞銀",49,13,36
"12616","2390云辰","110/07/09","富邦-虎尾",1,31,-30
"12617","2390云辰","110/07/09","統一-新台中",36,2,34
"12618","2390云辰","110/07/09","元大-善化",2,31,-29
"12619","2390云辰","110/07/09","國票-嘉義",31,0,31
"12620","2390云辰","110/07/09","富邦-板橋",0,27,-27
"12621","2390云辰","110/07/09","華南永昌",35,7,28
"12622","2390云辰","110/07/09","富邦-永和",3,28,-25
"12623","2390云辰","110/07/09","玉山-台中",49,22,27
"12624","2390云辰","110/07/09","第一金-自由",20,44,-24
"12625","2390云辰","110/07/09","華南永昌-敦南",25,0,25
"12626","2390云辰","110/07/09","凱基-內湖",0,24,-24
"12627","2390云辰","110/07/09","新光-高雄",27,4,23
"12628","2390云辰","110/07/09","元大-汐止",1,24,-23
"12629","2390云辰","110/07/09","台灣摩根士丹利",85,63,22
"12630","2390云辰","110/07/09","新光-台中",12,33,-21
"12631","4903聯光通","110/07/09","元大-敦南",10,0,10
"12632","4903聯光通","110/07/09","第一金-台中",0,12,-12
"12633","4903聯光通","110/07/09","凱基-士林",5,0,5
"12634","4903聯光通","110/07/09","日盛-忠孝",0,3,-3
"12635","4903聯光通","110/07/09","元大-苗栗",5,0,5
"12636","4903聯光通","110/07/09","群益金鼎-崇德",0,3,-3
"12637","4903聯光通","110/07/09","元大-屏南",3,0,3
"12638","4903聯光通","110/07/09","國票-內壢",0,2,-2
"12639","4903聯光通","110/07/09","中國信託-永康",1,0,1
"12640","4903聯光通","110/07/09","康和-南崁",0,2,-2
"12641","4903聯光通","110/07/09","玉山證券",1,0,1
"12642","4903聯光通","110/07/09","新光-台中",0,2,-2
"12643","4903聯光通","110/07/09","元大-太平",4,3,1
"12644","4903聯光通","110/07/09","玉山-城中",0,2,-2
"12645","4903聯光通","110/07/09","永豐金-嘉義",1,0,1
"12646","4903聯光通","110/07/09","中國信託-文心",0,1,-1
"12647","4903聯光通","110/07/09","大昌",0,0,0
"12648","4903聯光通","110/07/09","大昌",0,0,0
"12649","4903聯光通","110/07/09","中農",0,0,0
"12650","4903聯光通","110/07/09","中農",0,0,0
"12651","4903聯光通","110/07/09","",NA,NA,NA
"12652","4903聯光通","110/07/09","",NA,NA,NA
"12653","4903聯光通","110/07/09","",NA,NA,NA
"12654","4903聯光通","110/07/09","",NA,NA,NA
"12655","4903聯光通","110/07/09","",NA,NA,NA
"12656","4903聯光通","110/07/09","",NA,NA,NA
"12657","4903聯光通","110/07/09","",NA,NA,NA
"12658","4903聯光通","110/07/09","",NA,NA,NA
"12659","4903聯光通","110/07/09","",NA,NA,NA
"12660","4903聯光通","110/07/09","",NA,NA,NA
"12661","2929淘帝","110/07/09","台中銀-台北",110,0,110
"12662","2929淘帝","110/07/09","新光",2,82,-80
"12663","2929淘帝","110/07/09","華南永昌-頭份",72,0,72
"12664","2929淘帝","110/07/09","摩根大通",2,63,-61
"12665","2929淘帝","110/07/09","合庫-高雄",71,0,71
"12666","2929淘帝","110/07/09","第一金-路竹",0,50,-50
"12667","2929淘帝","110/07/09","高橋-龍潭",37,0,37
"12668","2929淘帝","110/07/09","港商麥格理",0,42,-42
"12669","2929淘帝","110/07/09","新光-台中",60,26,34
"12670","2929淘帝","110/07/09","陽信-石牌",0,40,-40
"12671","2929淘帝","110/07/09","元富-大裕",22,1,21
"12672","2929淘帝","110/07/09","台新-左楠",1,39,-38
"12673","2929淘帝","110/07/09","合庫-鳳山",20,0,20
"12674","2929淘帝","110/07/09","凱基-桃園",3,29,-26
"12675","2929淘帝","110/07/09","元大-員林",22,2,20
"12676","2929淘帝","110/07/09","兆豐-內湖",0,25,-25
"12677","2929淘帝","110/07/09","台新-建北",15,0,15
"12678","2929淘帝","110/07/09","元大-北港",0,20,-20
"12679","2929淘帝","110/07/09","兆豐-桃園",13,0,13
"12680","2929淘帝","110/07/09","富邦-北港",0,19,-19
"12681","2929淘帝","110/07/09","兆豐-忠孝",10,0,10
"12682","2929淘帝","110/07/09","富邦-花蓮",0,17,-17
"12683","2929淘帝","110/07/09","國票-敦北法人",10,0,10
"12684","2929淘帝","110/07/09","國泰-台中",2,17,-15
"12685","2929淘帝","110/07/09","永豐金-博愛",10,0,10
"12686","2929淘帝","110/07/09","群益金鼎-彰化",0,15,-15
"12687","2929淘帝","110/07/09","群益金鼎-潭子",8,0,8
"12688","2929淘帝","110/07/09","元大-博愛",0,14,-14
"12689","2929淘帝","110/07/09","富邦-南屯",8,0,8
"12690","2929淘帝","110/07/09","日盛-板橋",0,13,-13
"12691","5410國眾","110/07/09","元大-新盛",14,0,14
"12692","5410國眾","110/07/09","(牛牛牛)亞-鑫豐",1,41,-40
"12693","5410國眾","110/07/09","台灣企銀-民雄",10,0,10
"12694","5410國眾","110/07/09","元富-嘉義",0,25,-25
"12695","5410國眾","110/07/09","元富-虎尾",9,0,9
"12696","5410國眾","110/07/09","凱基-高美館",0,10,-10
"12697","5410國眾","110/07/09","摩根大通",10,1,9
"12698","5410國眾","110/07/09","凱基-城中",0,10,-10
"12699","5410國眾","110/07/09","兆豐-北高雄",7,0,7
"12700","5410國眾","110/07/09","元大-頭份",0,10,-10
"12701","5410國眾","110/07/09","凱基-台北",8,1,7
"12702","5410國眾","110/07/09","群益金鼎-丹鳳",0,7,-7
"12703","5410國眾","110/07/09","華南永昌-公誠",7,0,7
"12704","5410國眾","110/07/09","凱基-復興",0,7,-7
"12705","5410國眾","110/07/09","香港上海匯豐",6,0,6
"12706","5410國眾","110/07/09","元大-員林",0,7,-7
"12707","5410國眾","110/07/09","凱基-中壢",6,0,6
"12708","5410國眾","110/07/09","富邦-竹東",0,6,-6
"12709","5410國眾","110/07/09","華南永昌-南京",6,0,6
"12710","5410國眾","110/07/09","亞東-高雄",0,5,-5
"12711","5410國眾","110/07/09","統一-三重",5,0,5
"12712","5410國眾","110/07/09","大慶-中壢",1,6,-5
"12713","5410國眾","110/07/09","富邦-宜蘭",5,0,5
"12714","5410國眾","110/07/09","群益金鼎-中港",0,5,-5
"12715","5410國眾","110/07/09","元大-崇德",5,0,5
"12716","5410國眾","110/07/09","元大-八德",0,5,-5
"12717","5410國眾","110/07/09","元大-博愛",5,0,5
"12718","5410國眾","110/07/09","富邦-基隆",0,4,-4
"12719","5410國眾","110/07/09","元大-龍潭",5,0,5
"12720","5410國眾","110/07/09","臺銀-新竹",0,3,-3
"12721","2841台開","110/07/09","日盛-雙和",102,0,102
"12722","2841台開","110/07/09","港商野村",0,129,-129
"12723","2841台開","110/07/09","元大-館前",70,0,70
"12724","2841台開","110/07/09","兆豐-永和",0,100,-100
"12725","2841台開","110/07/09","凱基-文心",50,0,50
"12726","2841台開","110/07/09","台新證券",7,28,-21
"12727","2841台開","110/07/09","富邦-嘉義",40,0,40
"12728","2841台開","110/07/09","國票-北高雄",0,20,-20
"12729","2841台開","110/07/09","美商高盛",15,0,15
"12730","2841台開","110/07/09","永豐金-敦南",29,46,-17
"12731","2841台開","110/07/09","台中銀",15,0,15
"12732","2841台開","110/07/09","合庫-基隆",0,12,-12
"12733","2841台開","110/07/09","新光",11,0,11
"12734","2841台開","110/07/09","中國信託-松江",0,12,-12
"12735","2841台開","110/07/09","華南永昌-長虹",10,0,10
"12736","2841台開","110/07/09","兆豐-城中",0,12,-12
"12737","2841台開","110/07/09","永豐金-南投",10,0,10
"12738","2841台開","110/07/09","台中銀-豐原",0,10,-10
"12739","2841台開","110/07/09","合庫-桃園",7,0,7
"12740","2841台開","110/07/09","兆豐-景美",0,10,-10
"12741","2841台開","110/07/09","群益金鼎-古亭",7,0,7
"12742","2841台開","110/07/09","群益金鼎-基隆",0,10,-10
"12743","2841台開","110/07/09","國泰-敦南",6,0,6
"12744","2841台開","110/07/09","元大-北三重",0,10,-10
"12745","2841台開","110/07/09","凱基-桃園",8,2,6
"12746","2841台開","110/07/09","(牛牛牛)亞-網路",0,9,-9
"12747","2841台開","110/07/09","日盛證券",5,0,5
"12748","2841台開","110/07/09","台新-高雄",1,10,-9
"12749","2841台開","110/07/09","元富-文心",5,0,5
"12750","2841台開","110/07/09","凱基-台北",0,7,-7
"12751","6207雷科","110/07/09","群益金鼎-新竹",47,0,47
"12752","6207雷科","110/07/09","新光",7,24,-17
"12753","6207雷科","110/07/09","永豐金-三重",31,0,31
"12754","6207雷科","110/07/09","日盛-和美",0,15,-15
"12755","6207雷科","110/07/09","新加坡商瑞銀",33,5,28
"12756","6207雷科","110/07/09","國泰-台南",0,15,-15
"12757","6207雷科","110/07/09","元大-高雄",26,0,26
"12758","6207雷科","110/07/09","華南永昌-古亭",0,14,-14
"12759","6207雷科","110/07/09","統一-員林",22,0,22
"12760","6207雷科","110/07/09","土銀-白河",0,11,-11
"12761","6207雷科","110/07/09","台新-高雄",22,0,22
"12762","6207雷科","110/07/09","日盛-台南",0,10,-10
"12763","6207雷科","110/07/09","摩根大通",34,17,17
"12764","6207雷科","110/07/09","元富-林園",0,10,-10
"12765","6207雷科","110/07/09","元大-博愛",17,1,16
"12766","6207雷科","110/07/09","富邦-園區",0,10,-10
"12767","6207雷科","110/07/09","日茂-埔里",12,0,12
"12768","6207雷科","110/07/09","元大-上新莊",0,10,-10
"12769","6207雷科","110/07/09","國泰-台中",17,6,11
"12770","6207雷科","110/07/09","永豐金-南京",0,10,-10
"12771","6207雷科","110/07/09","富邦-三重",10,0,10
"12772","6207雷科","110/07/09","兆豐-小港",0,6,-6
"12773","6207雷科","110/07/09","元大-沙鹿",10,0,10
"12774","6207雷科","110/07/09","富邦-羅東",1,7,-6
"12775","6207雷科","110/07/09","元大-八德",10,0,10
"12776","6207雷科","110/07/09","元大-土城永寧",0,6,-6
"12777","6207雷科","110/07/09","第一金-路竹",11,2,9
"12778","6207雷科","110/07/09","永豐金-板盛",0,6,-6
"12779","6207雷科","110/07/09","統一-南京",5,0,5
"12780","6207雷科","110/07/09","日盛-板橋",0,5,-5
"12781","3679新至陞","110/07/09","元大-大天母",10,0,10
"12782","3679新至陞","110/07/09","第一金-光復",0,11,-11
"12783","3679新至陞","110/07/09","日盛-樹林",9,0,9
"12784","3679新至陞","110/07/09","瑞士信貸",0,8,-8
"12785","3679新至陞","110/07/09","凱基-台北",11,2,9
"12786","3679新至陞","110/07/09","大慶-苗栗",0,5,-5
"12787","3679新至陞","110/07/09","華南永昌-小港",8,0,8
"12788","3679新至陞","110/07/09","元大-永春",0,5,-5
"12789","3679新至陞","110/07/09","兆豐-來福",7,0,7
"12790","3679新至陞","110/07/09","日盛-和美",0,4,-4
"12791","3679新至陞","110/07/09","香港上海匯豐",5,0,5
"12792","3679新至陞","110/07/09","元大-雙和",0,3,-3
"12793","3679新至陞","110/07/09","台中銀-員林",3,0,3
"12794","3679新至陞","110/07/09","永豐金-屏東",0,3,-3
"12795","3679新至陞","110/07/09","新光",3,0,3
"12796","3679新至陞","110/07/09","彰銀",0,2,-2
"12797","3679新至陞","110/07/09","土銀-花蓮",2,0,2
"12798","3679新至陞","110/07/09","宏遠-館前",0,2,-2
"12799","3679新至陞","110/07/09","第一金-澎湖",2,0,2
"12800","3679新至陞","110/07/09","港商野村",0,2,-2
"12801","3679新至陞","110/07/09","摩根大通",2,0,2
"12802","3679新至陞","110/07/09","大昌-新店",0,2,-2
"12803","3679新至陞","110/07/09","國泰-敦南",2,0,2
"12804","3679新至陞","110/07/09","元大-新莊",0,2,-2
"12805","3679新至陞","110/07/09","元大-淡水",4,2,2
"12806","3679新至陞","110/07/09","元大-板橋",0,2,-2
"12807","3679新至陞","110/07/09","日盛-士林",1,0,1
"12808","3679新至陞","110/07/09","台灣摩根士丹利",0,1,-1
"12809","3679新至陞","110/07/09","日盛-信義",1,0,1
"12810","3679新至陞","110/07/09","第一金-高雄",0,1,-1
"12811","2727王品","110/07/09","台灣匯立證券",90,0,90
"12812","2727王品","110/07/09","台灣摩根士丹利",0,267,-267
"12813","2727王品","110/07/09","國泰-敦南",166,84,82
"12814","2727王品","110/07/09","富邦-台北",35,299,-264
"12815","2727王品","110/07/09","富邦-仁愛",56,12,44
"12816","2727王品","110/07/09","凱基-台北",174,296,-122
"12817","2727王品","110/07/09","台新證券",109,66,43
"12818","2727王品","110/07/09","第一金",2,102,-100
"12819","2727王品","110/07/09","新光",117,87,30
"12820","2727王品","110/07/09","群益金鼎-大安",0,80,-80
"12821","2727王品","110/07/09","臺銀-臺中",35,6,29
"12822","2727王品","110/07/09","兆豐-大安",7,60,-53
"12823","2727王品","110/07/09","元大-桃園",32,3,29
"12824","2727王品","110/07/09","永豐金-南投",0,50,-50
"12825","2727王品","110/07/09","元富-宜蘭",34,6,28
"12826","2727王品","110/07/09","新加坡商瑞銀",6,46,-40
"12827","2727王品","110/07/09","玉山-台中",34,8,26
"12828","2727王品","110/07/09","合庫-彰化",11,50,-39
"12829","2727王品","110/07/09","群益金鼎-宜蘭",30,4,26
"12830","2727王品","110/07/09","永豐金-萬盛",13,52,-39
"12831","2727王品","110/07/09","富邦-台中",42,16,26
"12832","2727王品","110/07/09","瑞士信貸",0,34,-34
"12833","2727王品","110/07/09","第一金-豐原",25,1,24
"12834","2727王品","110/07/09","元大-和平",4,35,-31
"12835","2727王品","110/07/09","臺銀",30,8,22
"12836","2727王品","110/07/09","美林",14,44,-30
"12837","2727王品","110/07/09","兆豐-來福",23,1,22
"12838","2727王品","110/07/09","元大-員林",9,38,-29
"12839","2727王品","110/07/09","玉山-士林",22,2,20
"12840","2727王品","110/07/09","元富-西松",4,31,-27
"12841","1570力肯","110/07/09","凱基-台北",30,1,29
"12842","1570力肯","110/07/09","群益金鼎-彰化",0,20,-20
"12843","1570力肯","110/07/09","新光-台南",20,0,20
"12844","1570力肯","110/07/09","元大-土城學府",0,20,-20
"12845","1570力肯","110/07/09","元大-高雄",20,0,20
"12846","1570力肯","110/07/09","元大-大統",0,16,-16
"12847","1570力肯","110/07/09","國票-中正",12,0,12
"12848","1570力肯","110/07/09","元大-新營",0,11,-11
"12849","1570力肯","110/07/09","日盛-高雄",6,0,6
"12850","1570力肯","110/07/09","元大-和平",0,10,-10
"12851","1570力肯","110/07/09","元富-緯城",6,0,6
"12852","1570力肯","110/07/09","元大-草屯",0,10,-10
"12853","1570力肯","110/07/09","群益金鼎-台南",6,0,6
"12854","1570力肯","110/07/09","元大-鹿港",0,9,-9
"12855","1570力肯","110/07/09","華南永昌-岡山",6,0,6
"12856","1570力肯","110/07/09","合庫-基隆",0,7,-7
"12857","1570力肯","110/07/09","統一-中壢",5,0,5
"12858","1570力肯","110/07/09","摩根大通",2,8,-6
"12859","1570力肯","110/07/09","凱基-三峽",5,0,5
"12860","1570力肯","110/07/09","台灣企銀-豐原",0,4,-4
"12861","1570力肯","110/07/09","大昌-樹林",4,0,4
"12862","1570力肯","110/07/09","日盛-桃園",0,4,-4
"12863","1570力肯","110/07/09","新光",3,0,3
"12864","1570力肯","110/07/09","國泰-高雄",0,3,-3
"12865","1570力肯","110/07/09","富邦-新竹華信",3,0,3
"12866","1570力肯","110/07/09","永豐金-敦南",0,3,-3
"12867","1570力肯","110/07/09","合庫-台中",2,0,2
"12868","1570力肯","110/07/09","土銀-彰化",0,2,-2
"12869","1570力肯","110/07/09","臺銀-臺中",2,0,2
"12870","1570力肯","110/07/09","臺銀-鳳山",0,2,-2
"12871","6180橘子","110/07/09","摩根大通",63,1,62
"12872","6180橘子","110/07/09","元大-南京",1,32,-31
"12873","6180橘子","110/07/09","富邦-陽明",73,33,40
"12874","6180橘子","110/07/09","群益金鼎-台北",0,25,-25
"12875","6180橘子","110/07/09","新加坡商瑞銀",31,0,31
"12876","6180橘子","110/07/09","兆豐-復興",0,21,-21
"12877","6180橘子","110/07/09","美商高盛",25,0,25
"12878","6180橘子","110/07/09","永豐金-嘉義",0,21,-21
"12879","6180橘子","110/07/09","凱基-台北",26,10,16
"12880","6180橘子","110/07/09","凱基-中壢",8,24,-16
"12881","6180橘子","110/07/09","華南永昌-楠梓",13,0,13
"12882","6180橘子","110/07/09","致和-崇德",0,15,-15
"12883","6180橘子","110/07/09","華南永昌-朴子",11,0,11
"12884","6180橘子","110/07/09","群益金鼎-屏東",0,15,-15
"12885","6180橘子","110/07/09","元大-北港",11,0,11
"12886","6180橘子","110/07/09","群益金鼎-中山",0,15,-15
"12887","6180橘子","110/07/09","元大-成功",10,1,9
"12888","6180橘子","110/07/09","瑞士信貸",1,15,-14
"12889","6180橘子","110/07/09","新光",26,18,8
"12890","6180橘子","110/07/09","日盛-二林",0,10,-10
"12891","6180橘子","110/07/09","統一-三重",6,0,6
"12892","6180橘子","110/07/09","凱基-東門",0,10,-10
"12893","6180橘子","110/07/09","群益金鼎-嘉義",6,0,6
"12894","6180橘子","110/07/09","華南永昌-三重",0,10,-10
"12895","6180橘子","110/07/09","元大-員林中山",6,0,6
"12896","6180橘子","110/07/09","元大-彰化民生",1,11,-10
"12897","6180橘子","110/07/09","合庫-鳳山",5,0,5
"12898","6180橘子","110/07/09","永豐金-新店",1,11,-10
"12899","6180橘子","110/07/09","富邦-建國",6,1,5
"12900","6180橘子","110/07/09","群益金鼎-丹鳳",0,8,-8
"12901","2390云辰","110/07/09","摩根大通",279,56,223
"12902","2390云辰","110/07/09","元大-天母",0,127,-127
"12903","2390云辰","110/07/09","日盛-鳳山",110,2,108
"12904","2390云辰","110/07/09","中國信託-文心",5,109,-104
"12905","2390云辰","110/07/09","宏遠證券",100,0,100
"12906","2390云辰","110/07/09","永豐金-復興",0,55,-55
"12907","2390云辰","110/07/09","元大-大里",63,6,57
"12908","2390云辰","110/07/09","凱基-台北",239,286,-47
"12909","2390云辰","110/07/09","凱基-八德",59,10,49
"12910","2390云辰","110/07/09","德信",2,32,-30
"12911","2390云辰","110/07/09","合庫-新竹",40,0,40
"12912","2390云辰","110/07/09","兆豐-桃鶯",2,32,-30
"12913","2390云辰","110/07/09","國票",40,1,39
"12914","2390云辰","110/07/09","致和-南京",0,30,-30
"12915","2390云辰","110/07/09","新加坡商瑞銀",49,13,36
"12916","2390云辰","110/07/09","富邦-虎尾",1,31,-30
"12917","2390云辰","110/07/09","統一-新台中",36,2,34
"12918","2390云辰","110/07/09","元大-善化",2,31,-29
"12919","2390云辰","110/07/09","國票-嘉義",31,0,31
"12920","2390云辰","110/07/09","富邦-板橋",0,27,-27
"12921","2390云辰","110/07/09","華南永昌",35,7,28
"12922","2390云辰","110/07/09","富邦-永和",3,28,-25
"12923","2390云辰","110/07/09","玉山-台中",49,22,27
"12924","2390云辰","110/07/09","第一金-自由",20,44,-24
"12925","2390云辰","110/07/09","華南永昌-敦南",25,0,25
"12926","2390云辰","110/07/09","凱基-內湖",0,24,-24
"12927","2390云辰","110/07/09","新光-高雄",27,4,23
"12928","2390云辰","110/07/09","元大-汐止",1,24,-23
"12929","2390云辰","110/07/09","台灣摩根士丹利",85,63,22
"12930","2390云辰","110/07/09","新光-台中",12,33,-21
"12931","4903聯光通","110/07/09","元大-敦南",10,0,10
"12932","4903聯光通","110/07/09","第一金-台中",0,12,-12
"12933","4903聯光通","110/07/09","凱基-士林",5,0,5
"12934","4903聯光通","110/07/09","日盛-忠孝",0,3,-3
"12935","4903聯光通","110/07/09","元大-苗栗",5,0,5
"12936","4903聯光通","110/07/09","群益金鼎-崇德",0,3,-3
"12937","4903聯光通","110/07/09","元大-屏南",3,0,3
"12938","4903聯光通","110/07/09","國票-內壢",0,2,-2
"12939","4903聯光通","110/07/09","中國信託-永康",1,0,1
"12940","4903聯光通","110/07/09","康和-南崁",0,2,-2
"12941","4903聯光通","110/07/09","玉山證券",1,0,1
"12942","4903聯光通","110/07/09","新光-台中",0,2,-2
"12943","4903聯光通","110/07/09","元大-太平",4,3,1
"12944","4903聯光通","110/07/09","玉山-城中",0,2,-2
"12945","4903聯光通","110/07/09","永豐金-嘉義",1,0,1
"12946","4903聯光通","110/07/09","中國信託-文心",0,1,-1
"12947","4903聯光通","110/07/09","大昌",0,0,0
"12948","4903聯光通","110/07/09","大昌",0,0,0
"12949","4903聯光通","110/07/09","中農",0,0,0
"12950","4903聯光通","110/07/09","中農",0,0,0
"12951","4903聯光通","110/07/09","",NA,NA,NA
"12952","4903聯光通","110/07/09","",NA,NA,NA
"12953","4903聯光通","110/07/09","",NA,NA,NA
"12954","4903聯光通","110/07/09","",NA,NA,NA
"12955","4903聯光通","110/07/09","",NA,NA,NA
"12956","4903聯光通","110/07/09","",NA,NA,NA
"12957","4903聯光通","110/07/09","",NA,NA,NA
"12958","4903聯光通","110/07/09","",NA,NA,NA
"12959","4903聯光通","110/07/09","",NA,NA,NA
"12960","4903聯光通","110/07/09","",NA,NA,NA
"12961","2929淘帝","110/07/09","台中銀-台北",110,0,110
"12962","2929淘帝","110/07/09","新光",2,82,-80
"12963","2929淘帝","110/07/09","華南永昌-頭份",72,0,72
"12964","2929淘帝","110/07/09","摩根大通",2,63,-61
"12965","2929淘帝","110/07/09","合庫-高雄",71,0,71
"12966","2929淘帝","110/07/09","第一金-路竹",0,50,-50
"12967","2929淘帝","110/07/09","高橋-龍潭",37,0,37
"12968","2929淘帝","110/07/09","港商麥格理",0,42,-42
"12969","2929淘帝","110/07/09","新光-台中",60,26,34
"12970","2929淘帝","110/07/09","陽信-石牌",0,40,-40
"12971","2929淘帝","110/07/09","元富-大裕",22,1,21
"12972","2929淘帝","110/07/09","台新-左楠",1,39,-38
"12973","2929淘帝","110/07/09","合庫-鳳山",20,0,20
"12974","2929淘帝","110/07/09","凱基-桃園",3,29,-26
"12975","2929淘帝","110/07/09","元大-員林",22,2,20
"12976","2929淘帝","110/07/09","兆豐-內湖",0,25,-25
"12977","2929淘帝","110/07/09","台新-建北",15,0,15
"12978","2929淘帝","110/07/09","元大-北港",0,20,-20
"12979","2929淘帝","110/07/09","兆豐-桃園",13,0,13
"12980","2929淘帝","110/07/09","富邦-北港",0,19,-19
"12981","2929淘帝","110/07/09","兆豐-忠孝",10,0,10
"12982","2929淘帝","110/07/09","富邦-花蓮",0,17,-17
"12983","2929淘帝","110/07/09","國票-敦北法人",10,0,10
"12984","2929淘帝","110/07/09","國泰-台中",2,17,-15
"12985","2929淘帝","110/07/09","永豐金-博愛",10,0,10
"12986","2929淘帝","110/07/09","群益金鼎-彰化",0,15,-15
"12987","2929淘帝","110/07/09","群益金鼎-潭子",8,0,8
"12988","2929淘帝","110/07/09","元大-博愛",0,14,-14
"12989","2929淘帝","110/07/09","富邦-南屯",8,0,8
"12990","2929淘帝","110/07/09","日盛-板橋",0,13,-13
"12991","5410國眾","110/07/09","元大-新盛",14,0,14
"12992","5410國眾","110/07/09","(牛牛牛)亞-鑫豐",1,41,-40
"12993","5410國眾","110/07/09","台灣企銀-民雄",10,0,10
"12994","5410國眾","110/07/09","元富-嘉義",0,25,-25
"12995","5410國眾","110/07/09","元富-虎尾",9,0,9
"12996","5410國眾","110/07/09","凱基-高美館",0,10,-10
"12997","5410國眾","110/07/09","摩根大通",10,1,9
"12998","5410國眾","110/07/09","凱基-城中",0,10,-10
"12999","5410國眾","110/07/09","兆豐-北高雄",7,0,7
"13000","5410國眾","110/07/09","元大-頭份",0,10,-10
"13001","5410國眾","110/07/09","凱基-台北",8,1,7
"13002","5410國眾","110/07/09","群益金鼎-丹鳳",0,7,-7
"13003","5410國眾","110/07/09","華南永昌-公誠",7,0,7
"13004","5410國眾","110/07/09","凱基-復興",0,7,-7
"13005","5410國眾","110/07/09","香港上海匯豐",6,0,6
"13006","5410國眾","110/07/09","元大-員林",0,7,-7
"13007","5410國眾","110/07/09","凱基-中壢",6,0,6
"13008","5410國眾","110/07/09","富邦-竹東",0,6,-6
"13009","5410國眾","110/07/09","華南永昌-南京",6,0,6
"13010","5410國眾","110/07/09","亞東-高雄",0,5,-5
"13011","5410國眾","110/07/09","統一-三重",5,0,5
"13012","5410國眾","110/07/09","大慶-中壢",1,6,-5
"13013","5410國眾","110/07/09","富邦-宜蘭",5,0,5
"13014","5410國眾","110/07/09","群益金鼎-中港",0,5,-5
"13015","5410國眾","110/07/09","元大-崇德",5,0,5
"13016","5410國眾","110/07/09","元大-八德",0,5,-5
"13017","5410國眾","110/07/09","元大-博愛",5,0,5
"13018","5410國眾","110/07/09","富邦-基隆",0,4,-4
"13019","5410國眾","110/07/09","元大-龍潭",5,0,5
"13020","5410國眾","110/07/09","臺銀-新竹",0,3,-3
"13021","2841台開","110/07/09","日盛-雙和",102,0,102
"13022","2841台開","110/07/09","港商野村",0,129,-129
"13023","2841台開","110/07/09","元大-館前",70,0,70
"13024","2841台開","110/07/09","兆豐-永和",0,100,-100
"13025","2841台開","110/07/09","凱基-文心",50,0,50
"13026","2841台開","110/07/09","台新證券",7,28,-21
"13027","2841台開","110/07/09","富邦-嘉義",40,0,40
"13028","2841台開","110/07/09","國票-北高雄",0,20,-20
"13029","2841台開","110/07/09","美商高盛",15,0,15
"13030","2841台開","110/07/09","永豐金-敦南",29,46,-17
"13031","2841台開","110/07/09","台中銀",15,0,15
"13032","2841台開","110/07/09","合庫-基隆",0,12,-12
"13033","2841台開","110/07/09","新光",11,0,11
"13034","2841台開","110/07/09","中國信託-松江",0,12,-12
"13035","2841台開","110/07/09","華南永昌-長虹",10,0,10
"13036","2841台開","110/07/09","兆豐-城中",0,12,-12
"13037","2841台開","110/07/09","永豐金-南投",10,0,10
"13038","2841台開","110/07/09","台中銀-豐原",0,10,-10
"13039","2841台開","110/07/09","合庫-桃園",7,0,7
"13040","2841台開","110/07/09","兆豐-景美",0,10,-10
"13041","2841台開","110/07/09","群益金鼎-古亭",7,0,7
"13042","2841台開","110/07/09","群益金鼎-基隆",0,10,-10
"13043","2841台開","110/07/09","國泰-敦南",6,0,6
"13044","2841台開","110/07/09","元大-北三重",0,10,-10
"13045","2841台開","110/07/09","凱基-桃園",8,2,6
"13046","2841台開","110/07/09","(牛牛牛)亞-網路",0,9,-9
"13047","2841台開","110/07/09","日盛證券",5,0,5
"13048","2841台開","110/07/09","台新-高雄",1,10,-9
"13049","2841台開","110/07/09","元富-文心",5,0,5
"13050","2841台開","110/07/09","凱基-台北",0,7,-7
"13051","6207雷科","110/07/09","群益金鼎-新竹",47,0,47
"13052","6207雷科","110/07/09","新光",7,24,-17
"13053","6207雷科","110/07/09","永豐金-三重",31,0,31
"13054","6207雷科","110/07/09","日盛-和美",0,15,-15
"13055","6207雷科","110/07/09","新加坡商瑞銀",33,5,28
"13056","6207雷科","110/07/09","國泰-台南",0,15,-15
"13057","6207雷科","110/07/09","元大-高雄",26,0,26
"13058","6207雷科","110/07/09","華南永昌-古亭",0,14,-14
"13059","6207雷科","110/07/09","統一-員林",22,0,22
"13060","6207雷科","110/07/09","土銀-白河",0,11,-11
"13061","6207雷科","110/07/09","台新-高雄",22,0,22
"13062","6207雷科","110/07/09","日盛-台南",0,10,-10
"13063","6207雷科","110/07/09","摩根大通",34,17,17
"13064","6207雷科","110/07/09","元富-林園",0,10,-10
"13065","6207雷科","110/07/09","元大-博愛",17,1,16
"13066","6207雷科","110/07/09","富邦-園區",0,10,-10
"13067","6207雷科","110/07/09","日茂-埔里",12,0,12
"13068","6207雷科","110/07/09","元大-上新莊",0,10,-10
"13069","6207雷科","110/07/09","國泰-台中",17,6,11
"13070","6207雷科","110/07/09","永豐金-南京",0,10,-10
"13071","6207雷科","110/07/09","富邦-三重",10,0,10
"13072","6207雷科","110/07/09","兆豐-小港",0,6,-6
"13073","6207雷科","110/07/09","元大-沙鹿",10,0,10
"13074","6207雷科","110/07/09","富邦-羅東",1,7,-6
"13075","6207雷科","110/07/09","元大-八德",10,0,10
"13076","6207雷科","110/07/09","元大-土城永寧",0,6,-6
"13077","6207雷科","110/07/09","第一金-路竹",11,2,9
"13078","6207雷科","110/07/09","永豐金-板盛",0,6,-6
"13079","6207雷科","110/07/09","統一-南京",5,0,5
"13080","6207雷科","110/07/09","日盛-板橋",0,5,-5
"13081","3679新至陞","110/07/09","元大-大天母",10,0,10
"13082","3679新至陞","110/07/09","第一金-光復",0,11,-11
"13083","3679新至陞","110/07/09","日盛-樹林",9,0,9
"13084","3679新至陞","110/07/09","瑞士信貸",0,8,-8
"13085","3679新至陞","110/07/09","凱基-台北",11,2,9
"13086","3679新至陞","110/07/09","大慶-苗栗",0,5,-5
"13087","3679新至陞","110/07/09","華南永昌-小港",8,0,8
"13088","3679新至陞","110/07/09","元大-永春",0,5,-5
"13089","3679新至陞","110/07/09","兆豐-來福",7,0,7
"13090","3679新至陞","110/07/09","日盛-和美",0,4,-4
"13091","3679新至陞","110/07/09","香港上海匯豐",5,0,5
"13092","3679新至陞","110/07/09","元大-雙和",0,3,-3
"13093","3679新至陞","110/07/09","台中銀-員林",3,0,3
"13094","3679新至陞","110/07/09","永豐金-屏東",0,3,-3
"13095","3679新至陞","110/07/09","新光",3,0,3
"13096","3679新至陞","110/07/09","彰銀",0,2,-2
"13097","3679新至陞","110/07/09","土銀-花蓮",2,0,2
"13098","3679新至陞","110/07/09","宏遠-館前",0,2,-2
"13099","3679新至陞","110/07/09","第一金-澎湖",2,0,2
"13100","3679新至陞","110/07/09","港商野村",0,2,-2
"13101","3679新至陞","110/07/09","摩根大通",2,0,2
"13102","3679新至陞","110/07/09","大昌-新店",0,2,-2
"13103","3679新至陞","110/07/09","國泰-敦南",2,0,2
"13104","3679新至陞","110/07/09","元大-新莊",0,2,-2
"13105","3679新至陞","110/07/09","元大-淡水",4,2,2
"13106","3679新至陞","110/07/09","元大-板橋",0,2,-2
"13107","3679新至陞","110/07/09","日盛-士林",1,0,1
"13108","3679新至陞","110/07/09","台灣摩根士丹利",0,1,-1
"13109","3679新至陞","110/07/09","日盛-信義",1,0,1
"13110","3679新至陞","110/07/09","第一金-高雄",0,1,-1
"13111","2727王品","110/07/09","台灣匯立證券",90,0,90
"13112","2727王品","110/07/09","台灣摩根士丹利",0,267,-267
"13113","2727王品","110/07/09","國泰-敦南",166,84,82
"13114","2727王品","110/07/09","富邦-台北",35,299,-264
"13115","2727王品","110/07/09","富邦-仁愛",56,12,44
"13116","2727王品","110/07/09","凱基-台北",174,296,-122
"13117","2727王品","110/07/09","台新證券",109,66,43
"13118","2727王品","110/07/09","第一金",2,102,-100
"13119","2727王品","110/07/09","新光",117,87,30
"13120","2727王品","110/07/09","群益金鼎-大安",0,80,-80
"13121","2727王品","110/07/09","臺銀-臺中",35,6,29
"13122","2727王品","110/07/09","兆豐-大安",7,60,-53
"13123","2727王品","110/07/09","元大-桃園",32,3,29
"13124","2727王品","110/07/09","永豐金-南投",0,50,-50
"13125","2727王品","110/07/09","元富-宜蘭",34,6,28
"13126","2727王品","110/07/09","新加坡商瑞銀",6,46,-40
"13127","2727王品","110/07/09","玉山-台中",34,8,26
"13128","2727王品","110/07/09","合庫-彰化",11,50,-39
"13129","2727王品","110/07/09","群益金鼎-宜蘭",30,4,26
"13130","2727王品","110/07/09","永豐金-萬盛",13,52,-39
"13131","2727王品","110/07/09","富邦-台中",42,16,26
"13132","2727王品","110/07/09","瑞士信貸",0,34,-34
"13133","2727王品","110/07/09","第一金-豐原",25,1,24
"13134","2727王品","110/07/09","元大-和平",4,35,-31
"13135","2727王品","110/07/09","臺銀",30,8,22
"13136","2727王品","110/07/09","美林",14,44,-30
"13137","2727王品","110/07/09","兆豐-來福",23,1,22
"13138","2727王品","110/07/09","元大-員林",9,38,-29
"13139","2727王品","110/07/09","玉山-士林",22,2,20
"13140","2727王品","110/07/09","元富-西松",4,31,-27
"13141","1570力肯","110/07/09","凱基-台北",30,1,29
"13142","1570力肯","110/07/09","群益金鼎-彰化",0,20,-20
"13143","1570力肯","110/07/09","新光-台南",20,0,20
"13144","1570力肯","110/07/09","元大-土城學府",0,20,-20
"13145","1570力肯","110/07/09","元大-高雄",20,0,20
"13146","1570力肯","110/07/09","元大-大統",0,16,-16
"13147","1570力肯","110/07/09","國票-中正",12,0,12
"13148","1570力肯","110/07/09","元大-新營",0,11,-11
"13149","1570力肯","110/07/09","日盛-高雄",6,0,6
"13150","1570力肯","110/07/09","元大-和平",0,10,-10
"13151","1570力肯","110/07/09","元富-緯城",6,0,6
"13152","1570力肯","110/07/09","元大-草屯",0,10,-10
"13153","1570力肯","110/07/09","群益金鼎-台南",6,0,6
"13154","1570力肯","110/07/09","元大-鹿港",0,9,-9
"13155","1570力肯","110/07/09","華南永昌-岡山",6,0,6
"13156","1570力肯","110/07/09","合庫-基隆",0,7,-7
"13157","1570力肯","110/07/09","統一-中壢",5,0,5
"13158","1570力肯","110/07/09","摩根大通",2,8,-6
"13159","1570力肯","110/07/09","凱基-三峽",5,0,5
"13160","1570力肯","110/07/09","台灣企銀-豐原",0,4,-4
"13161","1570力肯","110/07/09","大昌-樹林",4,0,4
"13162","1570力肯","110/07/09","日盛-桃園",0,4,-4
"13163","1570力肯","110/07/09","新光",3,0,3
"13164","1570力肯","110/07/09","國泰-高雄",0,3,-3
"13165","1570力肯","110/07/09","富邦-新竹華信",3,0,3
"13166","1570力肯","110/07/09","永豐金-敦南",0,3,-3
"13167","1570力肯","110/07/09","合庫-台中",2,0,2
"13168","1570力肯","110/07/09","土銀-彰化",0,2,-2
"13169","1570力肯","110/07/09","臺銀-臺中",2,0,2
"13170","1570力肯","110/07/09","臺銀-鳳山",0,2,-2
"13171","6180橘子","110/07/09","摩根大通",63,1,62
"13172","6180橘子","110/07/09","元大-南京",1,32,-31
"13173","6180橘子","110/07/09","富邦-陽明",73,33,40
"13174","6180橘子","110/07/09","群益金鼎-台北",0,25,-25
"13175","6180橘子","110/07/09","新加坡商瑞銀",31,0,31
"13176","6180橘子","110/07/09","兆豐-復興",0,21,-21
"13177","6180橘子","110/07/09","美商高盛",25,0,25
"13178","6180橘子","110/07/09","永豐金-嘉義",0,21,-21
"13179","6180橘子","110/07/09","凱基-台北",26,10,16
"13180","6180橘子","110/07/09","凱基-中壢",8,24,-16
"13181","6180橘子","110/07/09","華南永昌-楠梓",13,0,13
"13182","6180橘子","110/07/09","致和-崇德",0,15,-15
"13183","6180橘子","110/07/09","華南永昌-朴子",11,0,11
"13184","6180橘子","110/07/09","群益金鼎-屏東",0,15,-15
"13185","6180橘子","110/07/09","元大-北港",11,0,11
"13186","6180橘子","110/07/09","群益金鼎-中山",0,15,-15
"13187","6180橘子","110/07/09","元大-成功",10,1,9
"13188","6180橘子","110/07/09","瑞士信貸",1,15,-14
"13189","6180橘子","110/07/09","新光",26,18,8
"13190","6180橘子","110/07/09","日盛-二林",0,10,-10
"13191","6180橘子","110/07/09","統一-三重",6,0,6
"13192","6180橘子","110/07/09","凱基-東門",0,10,-10
"13193","6180橘子","110/07/09","群益金鼎-嘉義",6,0,6
"13194","6180橘子","110/07/09","華南永昌-三重",0,10,-10
"13195","6180橘子","110/07/09","元大-員林中山",6,0,6
"13196","6180橘子","110/07/09","元大-彰化民生",1,11,-10
"13197","6180橘子","110/07/09","合庫-鳳山",5,0,5
"13198","6180橘子","110/07/09","永豐金-新店",1,11,-10
"13199","6180橘子","110/07/09","富邦-建國",6,1,5
"13200","6180橘子","110/07/09","群益金鼎-丹鳳",0,8,-8
"13201","2390云辰","110/07/09","摩根大通",279,56,223
"13202","2390云辰","110/07/09","元大-天母",0,127,-127
"13203","2390云辰","110/07/09","日盛-鳳山",110,2,108
"13204","2390云辰","110/07/09","中國信託-文心",5,109,-104
"13205","2390云辰","110/07/09","宏遠證券",100,0,100
"13206","2390云辰","110/07/09","永豐金-復興",0,55,-55
"13207","2390云辰","110/07/09","元大-大里",63,6,57
"13208","2390云辰","110/07/09","凱基-台北",239,286,-47
"13209","2390云辰","110/07/09","凱基-八德",59,10,49
"13210","2390云辰","110/07/09","德信",2,32,-30
"13211","2390云辰","110/07/09","合庫-新竹",40,0,40
"13212","2390云辰","110/07/09","兆豐-桃鶯",2,32,-30
"13213","2390云辰","110/07/09","國票",40,1,39
"13214","2390云辰","110/07/09","致和-南京",0,30,-30
"13215","2390云辰","110/07/09","新加坡商瑞銀",49,13,36
"13216","2390云辰","110/07/09","富邦-虎尾",1,31,-30
"13217","2390云辰","110/07/09","統一-新台中",36,2,34
"13218","2390云辰","110/07/09","元大-善化",2,31,-29
"13219","2390云辰","110/07/09","國票-嘉義",31,0,31
"13220","2390云辰","110/07/09","富邦-板橋",0,27,-27
"13221","2390云辰","110/07/09","華南永昌",35,7,28
"13222","2390云辰","110/07/09","富邦-永和",3,28,-25
"13223","2390云辰","110/07/09","玉山-台中",49,22,27
"13224","2390云辰","110/07/09","第一金-自由",20,44,-24
"13225","2390云辰","110/07/09","華南永昌-敦南",25,0,25
"13226","2390云辰","110/07/09","凱基-內湖",0,24,-24
"13227","2390云辰","110/07/09","新光-高雄",27,4,23
"13228","2390云辰","110/07/09","元大-汐止",1,24,-23
"13229","2390云辰","110/07/09","台灣摩根士丹利",85,63,22
"13230","2390云辰","110/07/09","新光-台中",12,33,-21
"13231","4903聯光通","110/07/09","元大-敦南",10,0,10
"13232","4903聯光通","110/07/09","第一金-台中",0,12,-12
"13233","4903聯光通","110/07/09","凱基-士林",5,0,5
"13234","4903聯光通","110/07/09","日盛-忠孝",0,3,-3
"13235","4903聯光通","110/07/09","元大-苗栗",5,0,5
"13236","4903聯光通","110/07/09","群益金鼎-崇德",0,3,-3
"13237","4903聯光通","110/07/09","元大-屏南",3,0,3
"13238","4903聯光通","110/07/09","國票-內壢",0,2,-2
"13239","4903聯光通","110/07/09","中國信託-永康",1,0,1
"13240","4903聯光通","110/07/09","康和-南崁",0,2,-2
"13241","4903聯光通","110/07/09","玉山證券",1,0,1
"13242","4903聯光通","110/07/09","新光-台中",0,2,-2
"13243","4903聯光通","110/07/09","元大-太平",4,3,1
"13244","4903聯光通","110/07/09","玉山-城中",0,2,-2
"13245","4903聯光通","110/07/09","永豐金-嘉義",1,0,1
"13246","4903聯光通","110/07/09","中國信託-文心",0,1,-1
"13247","4903聯光通","110/07/09","大昌",0,0,0
"13248","4903聯光通","110/07/09","大昌",0,0,0
"13249","4903聯光通","110/07/09","中農",0,0,0
"13250","4903聯光通","110/07/09","中農",0,0,0
"13251","4903聯光通","110/07/09","",NA,NA,NA
"13252","4903聯光通","110/07/09","",NA,NA,NA
"13253","4903聯光通","110/07/09","",NA,NA,NA
"13254","4903聯光通","110/07/09","",NA,NA,NA
"13255","4903聯光通","110/07/09","",NA,NA,NA
"13256","4903聯光通","110/07/09","",NA,NA,NA
"13257","4903聯光通","110/07/09","",NA,NA,NA
"13258","4903聯光通","110/07/09","",NA,NA,NA
"13259","4903聯光通","110/07/09","",NA,NA,NA
"13260","4903聯光通","110/07/09","",NA,NA,NA
"13261","2929淘帝","110/07/09","台中銀-台北",110,0,110
"13262","2929淘帝","110/07/09","新光",2,82,-80
"13263","2929淘帝","110/07/09","華南永昌-頭份",72,0,72
"13264","2929淘帝","110/07/09","摩根大通",2,63,-61
"13265","2929淘帝","110/07/09","合庫-高雄",71,0,71
"13266","2929淘帝","110/07/09","第一金-路竹",0,50,-50
"13267","2929淘帝","110/07/09","高橋-龍潭",37,0,37
"13268","2929淘帝","110/07/09","港商麥格理",0,42,-42
"13269","2929淘帝","110/07/09","新光-台中",60,26,34
"13270","2929淘帝","110/07/09","陽信-石牌",0,40,-40
"13271","2929淘帝","110/07/09","元富-大裕",22,1,21
"13272","2929淘帝","110/07/09","台新-左楠",1,39,-38
"13273","2929淘帝","110/07/09","合庫-鳳山",20,0,20
"13274","2929淘帝","110/07/09","凱基-桃園",3,29,-26
"13275","2929淘帝","110/07/09","元大-員林",22,2,20
"13276","2929淘帝","110/07/09","兆豐-內湖",0,25,-25
"13277","2929淘帝","110/07/09","台新-建北",15,0,15
"13278","2929淘帝","110/07/09","元大-北港",0,20,-20
"13279","2929淘帝","110/07/09","兆豐-桃園",13,0,13
"13280","2929淘帝","110/07/09","富邦-北港",0,19,-19
"13281","2929淘帝","110/07/09","兆豐-忠孝",10,0,10
"13282","2929淘帝","110/07/09","富邦-花蓮",0,17,-17
"13283","2929淘帝","110/07/09","國票-敦北法人",10,0,10
"13284","2929淘帝","110/07/09","國泰-台中",2,17,-15
"13285","2929淘帝","110/07/09","永豐金-博愛",10,0,10
"13286","2929淘帝","110/07/09","群益金鼎-彰化",0,15,-15
"13287","2929淘帝","110/07/09","群益金鼎-潭子",8,0,8
"13288","2929淘帝","110/07/09","元大-博愛",0,14,-14
"13289","2929淘帝","110/07/09","富邦-南屯",8,0,8
"13290","2929淘帝","110/07/09","日盛-板橋",0,13,-13
"13291","5410國眾","110/07/09","元大-新盛",14,0,14
"13292","5410國眾","110/07/09","(牛牛牛)亞-鑫豐",1,41,-40
"13293","5410國眾","110/07/09","台灣企銀-民雄",10,0,10
"13294","5410國眾","110/07/09","元富-嘉義",0,25,-25
"13295","5410國眾","110/07/09","元富-虎尾",9,0,9
"13296","5410國眾","110/07/09","凱基-高美館",0,10,-10
"13297","5410國眾","110/07/09","摩根大通",10,1,9
"13298","5410國眾","110/07/09","凱基-城中",0,10,-10
"13299","5410國眾","110/07/09","兆豐-北高雄",7,0,7
"13300","5410國眾","110/07/09","元大-頭份",0,10,-10
"13301","5410國眾","110/07/09","凱基-台北",8,1,7
"13302","5410國眾","110/07/09","群益金鼎-丹鳳",0,7,-7
"13303","5410國眾","110/07/09","華南永昌-公誠",7,0,7
"13304","5410國眾","110/07/09","凱基-復興",0,7,-7
"13305","5410國眾","110/07/09","香港上海匯豐",6,0,6
"13306","5410國眾","110/07/09","元大-員林",0,7,-7
"13307","5410國眾","110/07/09","凱基-中壢",6,0,6
"13308","5410國眾","110/07/09","富邦-竹東",0,6,-6
"13309","5410國眾","110/07/09","華南永昌-南京",6,0,6
"13310","5410國眾","110/07/09","亞東-高雄",0,5,-5
"13311","5410國眾","110/07/09","統一-三重",5,0,5
"13312","5410國眾","110/07/09","大慶-中壢",1,6,-5
"13313","5410國眾","110/07/09","富邦-宜蘭",5,0,5
"13314","5410國眾","110/07/09","群益金鼎-中港",0,5,-5
"13315","5410國眾","110/07/09","元大-崇德",5,0,5
"13316","5410國眾","110/07/09","元大-八德",0,5,-5
"13317","5410國眾","110/07/09","元大-博愛",5,0,5
"13318","5410國眾","110/07/09","富邦-基隆",0,4,-4
"13319","5410國眾","110/07/09","元大-龍潭",5,0,5
"13320","5410國眾","110/07/09","臺銀-新竹",0,3,-3
"13321","2841台開","110/07/09","日盛-雙和",102,0,102
"13322","2841台開","110/07/09","港商野村",0,129,-129
"13323","2841台開","110/07/09","元大-館前",70,0,70
"13324","2841台開","110/07/09","兆豐-永和",0,100,-100
"13325","2841台開","110/07/09","凱基-文心",50,0,50
"13326","2841台開","110/07/09","台新證券",7,28,-21
"13327","2841台開","110/07/09","富邦-嘉義",40,0,40
"13328","2841台開","110/07/09","國票-北高雄",0,20,-20
"13329","2841台開","110/07/09","美商高盛",15,0,15
"13330","2841台開","110/07/09","永豐金-敦南",29,46,-17
"13331","2841台開","110/07/09","台中銀",15,0,15
"13332","2841台開","110/07/09","合庫-基隆",0,12,-12
"13333","2841台開","110/07/09","新光",11,0,11
"13334","2841台開","110/07/09","中國信託-松江",0,12,-12
"13335","2841台開","110/07/09","華南永昌-長虹",10,0,10
"13336","2841台開","110/07/09","兆豐-城中",0,12,-12
"13337","2841台開","110/07/09","永豐金-南投",10,0,10
"13338","2841台開","110/07/09","台中銀-豐原",0,10,-10
"13339","2841台開","110/07/09","合庫-桃園",7,0,7
"13340","2841台開","110/07/09","兆豐-景美",0,10,-10
"13341","2841台開","110/07/09","群益金鼎-古亭",7,0,7
"13342","2841台開","110/07/09","群益金鼎-基隆",0,10,-10
"13343","2841台開","110/07/09","國泰-敦南",6,0,6
"13344","2841台開","110/07/09","元大-北三重",0,10,-10
"13345","2841台開","110/07/09","凱基-桃園",8,2,6
"13346","2841台開","110/07/09","(牛牛牛)亞-網路",0,9,-9
"13347","2841台開","110/07/09","日盛證券",5,0,5
"13348","2841台開","110/07/09","台新-高雄",1,10,-9
"13349","2841台開","110/07/09","元富-文心",5,0,5
"13350","2841台開","110/07/09","凱基-台北",0,7,-7
"13351","6207雷科","110/07/09","群益金鼎-新竹",47,0,47
"13352","6207雷科","110/07/09","新光",7,24,-17
"13353","6207雷科","110/07/09","永豐金-三重",31,0,31
"13354","6207雷科","110/07/09","日盛-和美",0,15,-15
"13355","6207雷科","110/07/09","新加坡商瑞銀",33,5,28
"13356","6207雷科","110/07/09","國泰-台南",0,15,-15
"13357","6207雷科","110/07/09","元大-高雄",26,0,26
"13358","6207雷科","110/07/09","華南永昌-古亭",0,14,-14
"13359","6207雷科","110/07/09","統一-員林",22,0,22
"13360","6207雷科","110/07/09","土銀-白河",0,11,-11
"13361","6207雷科","110/07/09","台新-高雄",22,0,22
"13362","6207雷科","110/07/09","日盛-台南",0,10,-10
"13363","6207雷科","110/07/09","摩根大通",34,17,17
"13364","6207雷科","110/07/09","元富-林園",0,10,-10
"13365","6207雷科","110/07/09","元大-博愛",17,1,16
"13366","6207雷科","110/07/09","富邦-園區",0,10,-10
"13367","6207雷科","110/07/09","日茂-埔里",12,0,12
"13368","6207雷科","110/07/09","元大-上新莊",0,10,-10
"13369","6207雷科","110/07/09","國泰-台中",17,6,11
"13370","6207雷科","110/07/09","永豐金-南京",0,10,-10
"13371","6207雷科","110/07/09","富邦-三重",10,0,10
"13372","6207雷科","110/07/09","兆豐-小港",0,6,-6
"13373","6207雷科","110/07/09","元大-沙鹿",10,0,10
"13374","6207雷科","110/07/09","富邦-羅東",1,7,-6
"13375","6207雷科","110/07/09","元大-八德",10,0,10
"13376","6207雷科","110/07/09","元大-土城永寧",0,6,-6
"13377","6207雷科","110/07/09","第一金-路竹",11,2,9
"13378","6207雷科","110/07/09","永豐金-板盛",0,6,-6
"13379","6207雷科","110/07/09","統一-南京",5,0,5
"13380","6207雷科","110/07/09","日盛-板橋",0,5,-5
"13381","3679新至陞","110/07/09","元大-大天母",10,0,10
"13382","3679新至陞","110/07/09","第一金-光復",0,11,-11
"13383","3679新至陞","110/07/09","日盛-樹林",9,0,9
"13384","3679新至陞","110/07/09","瑞士信貸",0,8,-8
"13385","3679新至陞","110/07/09","凱基-台北",11,2,9
"13386","3679新至陞","110/07/09","大慶-苗栗",0,5,-5
"13387","3679新至陞","110/07/09","華南永昌-小港",8,0,8
"13388","3679新至陞","110/07/09","元大-永春",0,5,-5
"13389","3679新至陞","110/07/09","兆豐-來福",7,0,7
"13390","3679新至陞","110/07/09","日盛-和美",0,4,-4
"13391","3679新至陞","110/07/09","香港上海匯豐",5,0,5
"13392","3679新至陞","110/07/09","元大-雙和",0,3,-3
"13393","3679新至陞","110/07/09","台中銀-員林",3,0,3
"13394","3679新至陞","110/07/09","永豐金-屏東",0,3,-3
"13395","3679新至陞","110/07/09","新光",3,0,3
"13396","3679新至陞","110/07/09","彰銀",0,2,-2
"13397","3679新至陞","110/07/09","土銀-花蓮",2,0,2
"13398","3679新至陞","110/07/09","宏遠-館前",0,2,-2
"13399","3679新至陞","110/07/09","第一金-澎湖",2,0,2
"13400","3679新至陞","110/07/09","港商野村",0,2,-2
"13401","3679新至陞","110/07/09","摩根大通",2,0,2
"13402","3679新至陞","110/07/09","大昌-新店",0,2,-2
"13403","3679新至陞","110/07/09","國泰-敦南",2,0,2
"13404","3679新至陞","110/07/09","元大-新莊",0,2,-2
"13405","3679新至陞","110/07/09","元大-淡水",4,2,2
"13406","3679新至陞","110/07/09","元大-板橋",0,2,-2
"13407","3679新至陞","110/07/09","日盛-士林",1,0,1
"13408","3679新至陞","110/07/09","台灣摩根士丹利",0,1,-1
"13409","3679新至陞","110/07/09","日盛-信義",1,0,1
"13410","3679新至陞","110/07/09","第一金-高雄",0,1,-1
"13411","2727王品","110/07/09","台灣匯立證券",90,0,90
"13412","2727王品","110/07/09","台灣摩根士丹利",0,267,-267
"13413","2727王品","110/07/09","國泰-敦南",166,84,82
"13414","2727王品","110/07/09","富邦-台北",35,299,-264
"13415","2727王品","110/07/09","富邦-仁愛",56,12,44
"13416","2727王品","110/07/09","凱基-台北",174,296,-122
"13417","2727王品","110/07/09","台新證券",109,66,43
"13418","2727王品","110/07/09","第一金",2,102,-100
"13419","2727王品","110/07/09","新光",117,87,30
"13420","2727王品","110/07/09","群益金鼎-大安",0,80,-80
"13421","2727王品","110/07/09","臺銀-臺中",35,6,29
"13422","2727王品","110/07/09","兆豐-大安",7,60,-53
"13423","2727王品","110/07/09","元大-桃園",32,3,29
"13424","2727王品","110/07/09","永豐金-南投",0,50,-50
"13425","2727王品","110/07/09","元富-宜蘭",34,6,28
"13426","2727王品","110/07/09","新加坡商瑞銀",6,46,-40
"13427","2727王品","110/07/09","玉山-台中",34,8,26
"13428","2727王品","110/07/09","合庫-彰化",11,50,-39
"13429","2727王品","110/07/09","群益金鼎-宜蘭",30,4,26
"13430","2727王品","110/07/09","永豐金-萬盛",13,52,-39
"13431","2727王品","110/07/09","富邦-台中",42,16,26
"13432","2727王品","110/07/09","瑞士信貸",0,34,-34
"13433","2727王品","110/07/09","第一金-豐原",25,1,24
"13434","2727王品","110/07/09","元大-和平",4,35,-31
"13435","2727王品","110/07/09","臺銀",30,8,22
"13436","2727王品","110/07/09","美林",14,44,-30
"13437","2727王品","110/07/09","兆豐-來福",23,1,22
"13438","2727王品","110/07/09","元大-員林",9,38,-29
"13439","2727王品","110/07/09","玉山-士林",22,2,20
"13440","2727王品","110/07/09","元富-西松",4,31,-27
"13441","1570力肯","110/07/09","凱基-台北",30,1,29
"13442","1570力肯","110/07/09","群益金鼎-彰化",0,20,-20
"13443","1570力肯","110/07/09","新光-台南",20,0,20
"13444","1570力肯","110/07/09","元大-土城學府",0,20,-20
"13445","1570力肯","110/07/09","元大-高雄",20,0,20
"13446","1570力肯","110/07/09","元大-大統",0,16,-16
"13447","1570力肯","110/07/09","國票-中正",12,0,12
"13448","1570力肯","110/07/09","元大-新營",0,11,-11
"13449","1570力肯","110/07/09","日盛-高雄",6,0,6
"13450","1570力肯","110/07/09","元大-和平",0,10,-10
"13451","1570力肯","110/07/09","元富-緯城",6,0,6
"13452","1570力肯","110/07/09","元大-草屯",0,10,-10
"13453","1570力肯","110/07/09","群益金鼎-台南",6,0,6
"13454","1570力肯","110/07/09","元大-鹿港",0,9,-9
"13455","1570力肯","110/07/09","華南永昌-岡山",6,0,6
"13456","1570力肯","110/07/09","合庫-基隆",0,7,-7
"13457","1570力肯","110/07/09","統一-中壢",5,0,5
"13458","1570力肯","110/07/09","摩根大通",2,8,-6
"13459","1570力肯","110/07/09","凱基-三峽",5,0,5
"13460","1570力肯","110/07/09","台灣企銀-豐原",0,4,-4
"13461","1570力肯","110/07/09","大昌-樹林",4,0,4
"13462","1570力肯","110/07/09","日盛-桃園",0,4,-4
"13463","1570力肯","110/07/09","新光",3,0,3
"13464","1570力肯","110/07/09","國泰-高雄",0,3,-3
"13465","1570力肯","110/07/09","富邦-新竹華信",3,0,3
"13466","1570力肯","110/07/09","永豐金-敦南",0,3,-3
"13467","1570力肯","110/07/09","合庫-台中",2,0,2
"13468","1570力肯","110/07/09","土銀-彰化",0,2,-2
"13469","1570力肯","110/07/09","臺銀-臺中",2,0,2
"13470","1570力肯","110/07/09","臺銀-鳳山",0,2,-2
"13471","6180橘子","110/07/09","摩根大通",63,1,62
"13472","6180橘子","110/07/09","元大-南京",1,32,-31
"13473","6180橘子","110/07/09","富邦-陽明",73,33,40
"13474","6180橘子","110/07/09","群益金鼎-台北",0,25,-25
"13475","6180橘子","110/07/09","新加坡商瑞銀",31,0,31
"13476","6180橘子","110/07/09","兆豐-復興",0,21,-21
"13477","6180橘子","110/07/09","美商高盛",25,0,25
"13478","6180橘子","110/07/09","永豐金-嘉義",0,21,-21
"13479","6180橘子","110/07/09","凱基-台北",26,10,16
"13480","6180橘子","110/07/09","凱基-中壢",8,24,-16
"13481","6180橘子","110/07/09","華南永昌-楠梓",13,0,13
"13482","6180橘子","110/07/09","致和-崇德",0,15,-15
"13483","6180橘子","110/07/09","華南永昌-朴子",11,0,11
"13484","6180橘子","110/07/09","群益金鼎-屏東",0,15,-15
"13485","6180橘子","110/07/09","元大-北港",11,0,11
"13486","6180橘子","110/07/09","群益金鼎-中山",0,15,-15
"13487","6180橘子","110/07/09","元大-成功",10,1,9
"13488","6180橘子","110/07/09","瑞士信貸",1,15,-14
"13489","6180橘子","110/07/09","新光",26,18,8
"13490","6180橘子","110/07/09","日盛-二林",0,10,-10
"13491","6180橘子","110/07/09","統一-三重",6,0,6
"13492","6180橘子","110/07/09","凱基-東門",0,10,-10
"13493","6180橘子","110/07/09","群益金鼎-嘉義",6,0,6
"13494","6180橘子","110/07/09","華南永昌-三重",0,10,-10
"13495","6180橘子","110/07/09","元大-員林中山",6,0,6
"13496","6180橘子","110/07/09","元大-彰化民生",1,11,-10
"13497","6180橘子","110/07/09","合庫-鳳山",5,0,5
"13498","6180橘子","110/07/09","永豐金-新店",1,11,-10
"13499","6180橘子","110/07/09","富邦-建國",6,1,5
"13500","6180橘子","110/07/09","群益金鼎-丹鳳",0,8,-8
"13501","2390云辰","110/07/09","摩根大通",279,56,223
"13502","2390云辰","110/07/09","元大-天母",0,127,-127
"13503","2390云辰","110/07/09","日盛-鳳山",110,2,108
"13504","2390云辰","110/07/09","中國信託-文心",5,109,-104
"13505","2390云辰","110/07/09","宏遠證券",100,0,100
"13506","2390云辰","110/07/09","永豐金-復興",0,55,-55
"13507","2390云辰","110/07/09","元大-大里",63,6,57
"13508","2390云辰","110/07/09","凱基-台北",239,286,-47
"13509","2390云辰","110/07/09","凱基-八德",59,10,49
"13510","2390云辰","110/07/09","德信",2,32,-30
"13511","2390云辰","110/07/09","合庫-新竹",40,0,40
"13512","2390云辰","110/07/09","兆豐-桃鶯",2,32,-30
"13513","2390云辰","110/07/09","國票",40,1,39
"13514","2390云辰","110/07/09","致和-南京",0,30,-30
"13515","2390云辰","110/07/09","新加坡商瑞銀",49,13,36
"13516","2390云辰","110/07/09","富邦-虎尾",1,31,-30
"13517","2390云辰","110/07/09","統一-新台中",36,2,34
"13518","2390云辰","110/07/09","元大-善化",2,31,-29
"13519","2390云辰","110/07/09","國票-嘉義",31,0,31
"13520","2390云辰","110/07/09","富邦-板橋",0,27,-27
"13521","2390云辰","110/07/09","華南永昌",35,7,28
"13522","2390云辰","110/07/09","富邦-永和",3,28,-25
"13523","2390云辰","110/07/09","玉山-台中",49,22,27
"13524","2390云辰","110/07/09","第一金-自由",20,44,-24
"13525","2390云辰","110/07/09","華南永昌-敦南",25,0,25
"13526","2390云辰","110/07/09","凱基-內湖",0,24,-24
"13527","2390云辰","110/07/09","新光-高雄",27,4,23
"13528","2390云辰","110/07/09","元大-汐止",1,24,-23
"13529","2390云辰","110/07/09","台灣摩根士丹利",85,63,22
"13530","2390云辰","110/07/09","新光-台中",12,33,-21
"13531","4903聯光通","110/07/09","元大-敦南",10,0,10
"13532","4903聯光通","110/07/09","第一金-台中",0,12,-12
"13533","4903聯光通","110/07/09","凱基-士林",5,0,5
"13534","4903聯光通","110/07/09","日盛-忠孝",0,3,-3
"13535","4903聯光通","110/07/09","元大-苗栗",5,0,5
"13536","4903聯光通","110/07/09","群益金鼎-崇德",0,3,-3
"13537","4903聯光通","110/07/09","元大-屏南",3,0,3
"13538","4903聯光通","110/07/09","國票-內壢",0,2,-2
"13539","4903聯光通","110/07/09","中國信託-永康",1,0,1
"13540","4903聯光通","110/07/09","康和-南崁",0,2,-2
"13541","4903聯光通","110/07/09","玉山證券",1,0,1
"13542","4903聯光通","110/07/09","新光-台中",0,2,-2
"13543","4903聯光通","110/07/09","元大-太平",4,3,1
"13544","4903聯光通","110/07/09","玉山-城中",0,2,-2
"13545","4903聯光通","110/07/09","永豐金-嘉義",1,0,1
"13546","4903聯光通","110/07/09","中國信託-文心",0,1,-1
"13547","4903聯光通","110/07/09","大昌",0,0,0
"13548","4903聯光通","110/07/09","大昌",0,0,0
"13549","4903聯光通","110/07/09","中農",0,0,0
"13550","4903聯光通","110/07/09","中農",0,0,0
"13551","2929淘帝","110/07/09","台中銀-台北",110,0,110
"13552","2929淘帝","110/07/09","新光",2,82,-80
"13553","2929淘帝","110/07/09","華南永昌-頭份",72,0,72
"13554","2929淘帝","110/07/09","摩根大通",2,63,-61
"13555","2929淘帝","110/07/09","合庫-高雄",71,0,71
"13556","2929淘帝","110/07/09","第一金-路竹",0,50,-50
"13557","2929淘帝","110/07/09","高橋-龍潭",37,0,37
"13558","2929淘帝","110/07/09","港商麥格理",0,42,-42
"13559","2929淘帝","110/07/09","新光-台中",60,26,34
"13560","2929淘帝","110/07/09","陽信-石牌",0,40,-40
"13561","2929淘帝","110/07/09","元富-大裕",22,1,21
"13562","2929淘帝","110/07/09","台新-左楠",1,39,-38
"13563","2929淘帝","110/07/09","合庫-鳳山",20,0,20
"13564","2929淘帝","110/07/09","凱基-桃園",3,29,-26
"13565","2929淘帝","110/07/09","元大-員林",22,2,20
"13566","2929淘帝","110/07/09","兆豐-內湖",0,25,-25
"13567","2929淘帝","110/07/09","台新-建北",15,0,15
"13568","2929淘帝","110/07/09","元大-北港",0,20,-20
"13569","2929淘帝","110/07/09","兆豐-桃園",13,0,13
"13570","2929淘帝","110/07/09","富邦-北港",0,19,-19
"13571","2929淘帝","110/07/09","兆豐-忠孝",10,0,10
"13572","2929淘帝","110/07/09","富邦-花蓮",0,17,-17
"13573","2929淘帝","110/07/09","國票-敦北法人",10,0,10
"13574","2929淘帝","110/07/09","國泰-台中",2,17,-15
"13575","2929淘帝","110/07/09","永豐金-博愛",10,0,10
"13576","2929淘帝","110/07/09","群益金鼎-彰化",0,15,-15
"13577","2929淘帝","110/07/09","群益金鼎-潭子",8,0,8
"13578","2929淘帝","110/07/09","元大-博愛",0,14,-14
"13579","2929淘帝","110/07/09","富邦-南屯",8,0,8
"13580","2929淘帝","110/07/09","日盛-板橋",0,13,-13
"13581","5410國眾","110/07/09","元大-新盛",14,0,14
"13582","5410國眾","110/07/09","(牛牛牛)亞-鑫豐",1,41,-40
"13583","5410國眾","110/07/09","台灣企銀-民雄",10,0,10
"13584","5410國眾","110/07/09","元富-嘉義",0,25,-25
"13585","5410國眾","110/07/09","元富-虎尾",9,0,9
"13586","5410國眾","110/07/09","凱基-高美館",0,10,-10
"13587","5410國眾","110/07/09","摩根大通",10,1,9
"13588","5410國眾","110/07/09","凱基-城中",0,10,-10
"13589","5410國眾","110/07/09","兆豐-北高雄",7,0,7
"13590","5410國眾","110/07/09","元大-頭份",0,10,-10
"13591","5410國眾","110/07/09","凱基-台北",8,1,7
"13592","5410國眾","110/07/09","群益金鼎-丹鳳",0,7,-7
"13593","5410國眾","110/07/09","華南永昌-公誠",7,0,7
"13594","5410國眾","110/07/09","凱基-復興",0,7,-7
"13595","5410國眾","110/07/09","香港上海匯豐",6,0,6
"13596","5410國眾","110/07/09","元大-員林",0,7,-7
"13597","5410國眾","110/07/09","凱基-中壢",6,0,6
"13598","5410國眾","110/07/09","富邦-竹東",0,6,-6
"13599","5410國眾","110/07/09","華南永昌-南京",6,0,6
"13600","5410國眾","110/07/09","亞東-高雄",0,5,-5
"13601","5410國眾","110/07/09","統一-三重",5,0,5
"13602","5410國眾","110/07/09","大慶-中壢",1,6,-5
"13603","5410國眾","110/07/09","富邦-宜蘭",5,0,5
"13604","5410國眾","110/07/09","群益金鼎-中港",0,5,-5
"13605","5410國眾","110/07/09","元大-崇德",5,0,5
"13606","5410國眾","110/07/09","元大-八德",0,5,-5
"13607","5410國眾","110/07/09","元大-博愛",5,0,5
"13608","5410國眾","110/07/09","富邦-基隆",0,4,-4
"13609","5410國眾","110/07/09","元大-龍潭",5,0,5
"13610","5410國眾","110/07/09","臺銀-新竹",0,3,-3
"13611","2841台開","110/07/09","日盛-雙和",102,0,102
"13612","2841台開","110/07/09","港商野村",0,129,-129
"13613","2841台開","110/07/09","元大-館前",70,0,70
"13614","2841台開","110/07/09","兆豐-永和",0,100,-100
"13615","2841台開","110/07/09","凱基-文心",50,0,50
"13616","2841台開","110/07/09","台新證券",7,28,-21
"13617","2841台開","110/07/09","富邦-嘉義",40,0,40
"13618","2841台開","110/07/09","國票-北高雄",0,20,-20
"13619","2841台開","110/07/09","美商高盛",15,0,15
"13620","2841台開","110/07/09","永豐金-敦南",29,46,-17
"13621","2841台開","110/07/09","台中銀",15,0,15
"13622","2841台開","110/07/09","合庫-基隆",0,12,-12
"13623","2841台開","110/07/09","新光",11,0,11
"13624","2841台開","110/07/09","中國信託-松江",0,12,-12
"13625","2841台開","110/07/09","華南永昌-長虹",10,0,10
"13626","2841台開","110/07/09","兆豐-城中",0,12,-12
"13627","2841台開","110/07/09","永豐金-南投",10,0,10
"13628","2841台開","110/07/09","台中銀-豐原",0,10,-10
"13629","2841台開","110/07/09","合庫-桃園",7,0,7
"13630","2841台開","110/07/09","兆豐-景美",0,10,-10
"13631","2841台開","110/07/09","群益金鼎-古亭",7,0,7
"13632","2841台開","110/07/09","群益金鼎-基隆",0,10,-10
"13633","2841台開","110/07/09","國泰-敦南",6,0,6
"13634","2841台開","110/07/09","元大-北三重",0,10,-10
"13635","2841台開","110/07/09","凱基-桃園",8,2,6
"13636","2841台開","110/07/09","(牛牛牛)亞-網路",0,9,-9
"13637","2841台開","110/07/09","日盛證券",5,0,5
"13638","2841台開","110/07/09","台新-高雄",1,10,-9
"13639","2841台開","110/07/09","元富-文心",5,0,5
"13640","2841台開","110/07/09","凱基-台北",0,7,-7
"13641","6207雷科","110/07/09","群益金鼎-新竹",47,0,47
"13642","6207雷科","110/07/09","新光",7,24,-17
"13643","6207雷科","110/07/09","永豐金-三重",31,0,31
"13644","6207雷科","110/07/09","日盛-和美",0,15,-15
"13645","6207雷科","110/07/09","新加坡商瑞銀",33,5,28
"13646","6207雷科","110/07/09","國泰-台南",0,15,-15
"13647","6207雷科","110/07/09","元大-高雄",26,0,26
"13648","6207雷科","110/07/09","華南永昌-古亭",0,14,-14
"13649","6207雷科","110/07/09","統一-員林",22,0,22
"13650","6207雷科","110/07/09","土銀-白河",0,11,-11
"13651","6207雷科","110/07/09","台新-高雄",22,0,22
"13652","6207雷科","110/07/09","日盛-台南",0,10,-10
"13653","6207雷科","110/07/09","摩根大通",34,17,17
"13654","6207雷科","110/07/09","元富-林園",0,10,-10
"13655","6207雷科","110/07/09","元大-博愛",17,1,16
"13656","6207雷科","110/07/09","富邦-園區",0,10,-10
"13657","6207雷科","110/07/09","日茂-埔里",12,0,12
"13658","6207雷科","110/07/09","元大-上新莊",0,10,-10
"13659","6207雷科","110/07/09","國泰-台中",17,6,11
"13660","6207雷科","110/07/09","永豐金-南京",0,10,-10
"13661","6207雷科","110/07/09","富邦-三重",10,0,10
"13662","6207雷科","110/07/09","兆豐-小港",0,6,-6
"13663","6207雷科","110/07/09","元大-沙鹿",10,0,10
"13664","6207雷科","110/07/09","富邦-羅東",1,7,-6
"13665","6207雷科","110/07/09","元大-八德",10,0,10
"13666","6207雷科","110/07/09","元大-土城永寧",0,6,-6
"13667","6207雷科","110/07/09","第一金-路竹",11,2,9
"13668","6207雷科","110/07/09","永豐金-板盛",0,6,-6
"13669","6207雷科","110/07/09","統一-南京",5,0,5
"13670","6207雷科","110/07/09","日盛-板橋",0,5,-5
"13671","3679新至陞","110/07/09","元大-大天母",10,0,10
"13672","3679新至陞","110/07/09","第一金-光復",0,11,-11
"13673","3679新至陞","110/07/09","日盛-樹林",9,0,9
"13674","3679新至陞","110/07/09","瑞士信貸",0,8,-8
"13675","3679新至陞","110/07/09","凱基-台北",11,2,9
"13676","3679新至陞","110/07/09","大慶-苗栗",0,5,-5
"13677","3679新至陞","110/07/09","華南永昌-小港",8,0,8
"13678","3679新至陞","110/07/09","元大-永春",0,5,-5
"13679","3679新至陞","110/07/09","兆豐-來福",7,0,7
"13680","3679新至陞","110/07/09","日盛-和美",0,4,-4
"13681","3679新至陞","110/07/09","香港上海匯豐",5,0,5
"13682","3679新至陞","110/07/09","元大-雙和",0,3,-3
"13683","3679新至陞","110/07/09","台中銀-員林",3,0,3
"13684","3679新至陞","110/07/09","永豐金-屏東",0,3,-3
"13685","3679新至陞","110/07/09","新光",3,0,3
"13686","3679新至陞","110/07/09","彰銀",0,2,-2
"13687","3679新至陞","110/07/09","土銀-花蓮",2,0,2
"13688","3679新至陞","110/07/09","宏遠-館前",0,2,-2
"13689","3679新至陞","110/07/09","第一金-澎湖",2,0,2
"13690","3679新至陞","110/07/09","港商野村",0,2,-2
"13691","3679新至陞","110/07/09","摩根大通",2,0,2
"13692","3679新至陞","110/07/09","大昌-新店",0,2,-2
"13693","3679新至陞","110/07/09","國泰-敦南",2,0,2
"13694","3679新至陞","110/07/09","元大-新莊",0,2,-2
"13695","3679新至陞","110/07/09","元大-淡水",4,2,2
"13696","3679新至陞","110/07/09","元大-板橋",0,2,-2
"13697","3679新至陞","110/07/09","日盛-士林",1,0,1
"13698","3679新至陞","110/07/09","台灣摩根士丹利",0,1,-1
"13699","3679新至陞","110/07/09","日盛-信義",1,0,1
"13700","3679新至陞","110/07/09","第一金-高雄",0,1,-1
"13701","2727王品","110/07/09","台灣匯立證券",90,0,90
"13702","2727王品","110/07/09","台灣摩根士丹利",0,267,-267
"13703","2727王品","110/07/09","國泰-敦南",166,84,82
"13704","2727王品","110/07/09","富邦-台北",35,299,-264
"13705","2727王品","110/07/09","富邦-仁愛",56,12,44
"13706","2727王品","110/07/09","凱基-台北",174,296,-122
"13707","2727王品","110/07/09","台新證券",109,66,43
"13708","2727王品","110/07/09","第一金",2,102,-100
"13709","2727王品","110/07/09","新光",117,87,30
"13710","2727王品","110/07/09","群益金鼎-大安",0,80,-80
"13711","2727王品","110/07/09","臺銀-臺中",35,6,29
"13712","2727王品","110/07/09","兆豐-大安",7,60,-53
"13713","2727王品","110/07/09","元大-桃園",32,3,29
"13714","2727王品","110/07/09","永豐金-南投",0,50,-50
"13715","2727王品","110/07/09","元富-宜蘭",34,6,28
"13716","2727王品","110/07/09","新加坡商瑞銀",6,46,-40
"13717","2727王品","110/07/09","玉山-台中",34,8,26
"13718","2727王品","110/07/09","合庫-彰化",11,50,-39
"13719","2727王品","110/07/09","群益金鼎-宜蘭",30,4,26
"13720","2727王品","110/07/09","永豐金-萬盛",13,52,-39
"13721","2727王品","110/07/09","富邦-台中",42,16,26
"13722","2727王品","110/07/09","瑞士信貸",0,34,-34
"13723","2727王品","110/07/09","第一金-豐原",25,1,24
"13724","2727王品","110/07/09","元大-和平",4,35,-31
"13725","2727王品","110/07/09","臺銀",30,8,22
"13726","2727王品","110/07/09","美林",14,44,-30
"13727","2727王品","110/07/09","兆豐-來福",23,1,22
"13728","2727王品","110/07/09","元大-員林",9,38,-29
"13729","2727王品","110/07/09","玉山-士林",22,2,20
"13730","2727王品","110/07/09","元富-西松",4,31,-27
"13731","1570力肯","110/07/09","凱基-台北",30,1,29
"13732","1570力肯","110/07/09","群益金鼎-彰化",0,20,-20
"13733","1570力肯","110/07/09","新光-台南",20,0,20
"13734","1570力肯","110/07/09","元大-土城學府",0,20,-20
"13735","1570力肯","110/07/09","元大-高雄",20,0,20
"13736","1570力肯","110/07/09","元大-大統",0,16,-16
"13737","1570力肯","110/07/09","國票-中正",12,0,12
"13738","1570力肯","110/07/09","元大-新營",0,11,-11
"13739","1570力肯","110/07/09","日盛-高雄",6,0,6
"13740","1570力肯","110/07/09","元大-和平",0,10,-10
"13741","1570力肯","110/07/09","元富-緯城",6,0,6
"13742","1570力肯","110/07/09","元大-草屯",0,10,-10
"13743","1570力肯","110/07/09","群益金鼎-台南",6,0,6
"13744","1570力肯","110/07/09","元大-鹿港",0,9,-9
"13745","1570力肯","110/07/09","華南永昌-岡山",6,0,6
"13746","1570力肯","110/07/09","合庫-基隆",0,7,-7
"13747","1570力肯","110/07/09","統一-中壢",5,0,5
"13748","1570力肯","110/07/09","摩根大通",2,8,-6
"13749","1570力肯","110/07/09","凱基-三峽",5,0,5
"13750","1570力肯","110/07/09","台灣企銀-豐原",0,4,-4
"13751","1570力肯","110/07/09","大昌-樹林",4,0,4
"13752","1570力肯","110/07/09","日盛-桃園",0,4,-4
"13753","1570力肯","110/07/09","新光",3,0,3
"13754","1570力肯","110/07/09","國泰-高雄",0,3,-3
"13755","1570力肯","110/07/09","富邦-新竹華信",3,0,3
"13756","1570力肯","110/07/09","永豐金-敦南",0,3,-3
"13757","1570力肯","110/07/09","合庫-台中",2,0,2
"13758","1570力肯","110/07/09","土銀-彰化",0,2,-2
"13759","1570力肯","110/07/09","臺銀-臺中",2,0,2
"13760","1570力肯","110/07/09","臺銀-鳳山",0,2,-2
"13761","6180橘子","110/07/09","摩根大通",63,1,62
"13762","6180橘子","110/07/09","元大-南京",1,32,-31
"13763","6180橘子","110/07/09","富邦-陽明",73,33,40
"13764","6180橘子","110/07/09","群益金鼎-台北",0,25,-25
"13765","6180橘子","110/07/09","新加坡商瑞銀",31,0,31
"13766","6180橘子","110/07/09","兆豐-復興",0,21,-21
"13767","6180橘子","110/07/09","美商高盛",25,0,25
"13768","6180橘子","110/07/09","永豐金-嘉義",0,21,-21
"13769","6180橘子","110/07/09","凱基-台北",26,10,16
"13770","6180橘子","110/07/09","凱基-中壢",8,24,-16
"13771","6180橘子","110/07/09","華南永昌-楠梓",13,0,13
"13772","6180橘子","110/07/09","致和-崇德",0,15,-15
"13773","6180橘子","110/07/09","華南永昌-朴子",11,0,11
"13774","6180橘子","110/07/09","群益金鼎-屏東",0,15,-15
"13775","6180橘子","110/07/09","元大-北港",11,0,11
"13776","6180橘子","110/07/09","群益金鼎-中山",0,15,-15
"13777","6180橘子","110/07/09","元大-成功",10,1,9
"13778","6180橘子","110/07/09","瑞士信貸",1,15,-14
"13779","6180橘子","110/07/09","新光",26,18,8
"13780","6180橘子","110/07/09","日盛-二林",0,10,-10
"13781","6180橘子","110/07/09","統一-三重",6,0,6
"13782","6180橘子","110/07/09","凱基-東門",0,10,-10
"13783","6180橘子","110/07/09","群益金鼎-嘉義",6,0,6
"13784","6180橘子","110/07/09","華南永昌-三重",0,10,-10
"13785","6180橘子","110/07/09","元大-員林中山",6,0,6
"13786","6180橘子","110/07/09","元大-彰化民生",1,11,-10
"13787","6180橘子","110/07/09","合庫-鳳山",5,0,5
"13788","6180橘子","110/07/09","永豐金-新店",1,11,-10
"13789","6180橘子","110/07/09","富邦-建國",6,1,5
"13790","6180橘子","110/07/09","群益金鼎-丹鳳",0,8,-8
"13791","2390云辰","110/07/09","摩根大通",279,56,223
"13792","2390云辰","110/07/09","元大-天母",0,127,-127
"13793","2390云辰","110/07/09","日盛-鳳山",110,2,108
"13794","2390云辰","110/07/09","中國信託-文心",5,109,-104
"13795","2390云辰","110/07/09","宏遠證券",100,0,100
"13796","2390云辰","110/07/09","永豐金-復興",0,55,-55
"13797","2390云辰","110/07/09","元大-大里",63,6,57
"13798","2390云辰","110/07/09","凱基-台北",239,286,-47
"13799","2390云辰","110/07/09","凱基-八德",59,10,49
"13800","2390云辰","110/07/09","德信",2,32,-30
"13801","2390云辰","110/07/09","合庫-新竹",40,0,40
"13802","2390云辰","110/07/09","兆豐-桃鶯",2,32,-30
"13803","2390云辰","110/07/09","國票",40,1,39
"13804","2390云辰","110/07/09","致和-南京",0,30,-30
"13805","2390云辰","110/07/09","新加坡商瑞銀",49,13,36
"13806","2390云辰","110/07/09","富邦-虎尾",1,31,-30
"13807","2390云辰","110/07/09","統一-新台中",36,2,34
"13808","2390云辰","110/07/09","元大-善化",2,31,-29
"13809","2390云辰","110/07/09","國票-嘉義",31,0,31
"13810","2390云辰","110/07/09","富邦-板橋",0,27,-27
"13811","2390云辰","110/07/09","華南永昌",35,7,28
"13812","2390云辰","110/07/09","富邦-永和",3,28,-25
"13813","2390云辰","110/07/09","玉山-台中",49,22,27
"13814","2390云辰","110/07/09","第一金-自由",20,44,-24
"13815","2390云辰","110/07/09","華南永昌-敦南",25,0,25
"13816","2390云辰","110/07/09","凱基-內湖",0,24,-24
"13817","2390云辰","110/07/09","新光-高雄",27,4,23
"13818","2390云辰","110/07/09","元大-汐止",1,24,-23
"13819","2390云辰","110/07/09","台灣摩根士丹利",85,63,22
"13820","2390云辰","110/07/09","新光-台中",12,33,-21
"13821","4903聯光通","110/07/08","元富-新興",18,0,18
"13822","4903聯光通","110/07/08","中國信託-中壢",0,14,-14
"13823","4903聯光通","110/07/08","元大-苗栗",9,0,9
"13824","4903聯光通","110/07/08","彰銀",0,7,-7
"13825","4903聯光通","110/07/08","兆豐-鹿港",3,0,3
"13826","4903聯光通","110/07/08","中國信託-松江",0,5,-5
"13827","4903聯光通","110/07/08","群益金鼎-萬華",2,0,2
"13828","4903聯光通","110/07/08","光和",0,2,-2
"13829","4903聯光通","110/07/08","元大-屏南",1,0,1
"13830","4903聯光通","110/07/08","元大-鶯歌",0,2,-2
"13831","4903聯光通","110/07/08","華南永昌-新莊",0,0,0
"13832","4903聯光通","110/07/08","群益金鼎-館前",0,1,-1
"13833","4903聯光通","110/07/08","元大-羅東",0,0,0
"13834","4903聯光通","110/07/08","華南永昌",0,1,-1
"13835","4903聯光通","110/07/08","元大-太平",2,3,-1
"13836","4903聯光通","110/07/08","華南永昌-新莊",0,0,0
"13837","4903聯光通","110/07/08","元大-羅東",0,0,0
"13838","2929淘帝","110/07/08","日盛-園區",90,6,84
"13839","2929淘帝","110/07/08","元大-太平",1,111,-110
"13840","2929淘帝","110/07/08","華南永昌-頭份",54,0,54
"13841","2929淘帝","110/07/08","港商野村",31,106,-75
"13842","2929淘帝","110/07/08","美商高盛",50,0,50
"13843","2929淘帝","110/07/08","凱基-板橋",62,111,-49
"13844","2929淘帝","110/07/08","台中銀-台北",50,0,50
"13845","2929淘帝","110/07/08","新光-台中",30,78,-48
"13846","2929淘帝","110/07/08","臺銀-臺南",30,0,30
"13847","2929淘帝","110/07/08","元富-永和",1,41,-40
"13848","2929淘帝","110/07/08","永豐金-大園",42,12,30
"13849","2929淘帝","110/07/08","永豐金-鳳山",0,28,-28
"13850","2929淘帝","110/07/08","元富-三重",30,1,29
"13851","2929淘帝","110/07/08","元大-南崁",0,26,-26
"13852","2929淘帝","110/07/08","兆豐-桃鶯",29,0,29
"13853","2929淘帝","110/07/08","元大-花蓮",2,27,-25
"13854","2929淘帝","110/07/08","元大-承德",20,3,17
"13855","2929淘帝","110/07/08","元大-府城",0,24,-24
"13856","2929淘帝","110/07/08","新光-新竹",13,0,13
"13857","2929淘帝","110/07/08","新光",21,43,-22
"13858","2929淘帝","110/07/08","富邦-內湖",13,0,13
"13859","2929淘帝","110/07/08","臺銀-民權",0,20,-20
"13860","2929淘帝","110/07/08","國泰-板橋",13,1,12
"13861","2929淘帝","110/07/08","摩根大通",66,84,-18
"13862","2929淘帝","110/07/08","第一金-大稻埕",10,0,10
"13863","2929淘帝","110/07/08","凱基-台北",0,17,-17
"13864","2929淘帝","110/07/08","統一-汐止",10,0,10
"13865","2929淘帝","110/07/08","元大-博愛",6,23,-17
"13866","2929淘帝","110/07/08","元富-大裕",10,0,10
"13867","2929淘帝","110/07/08","永豐金-桃盛",0,16,-16
"13868","5410國眾","110/07/08","元大-新盛",15,0,15
"13869","5410國眾","110/07/08","元大-旗山",0,50,-50
"13870","5410國眾","110/07/08","元大-屏南",10,0,10
"13871","5410國眾","110/07/08","元大-頭份",0,14,-14
"13872","5410國眾","110/07/08","元大-成功",10,0,10
"13873","5410國眾","110/07/08","國泰-高雄",0,8,-8
"13874","5410國眾","110/07/08","元大-東泰",7,0,7
"13875","5410國眾","110/07/08","元大-小港",0,7,-7
"13876","5410國眾","110/07/08","富邦-陽明",6,0,6
"13877","5410國眾","110/07/08","統一-嘉義",0,5,-5
"13878","5410國眾","110/07/08","臺銀-金山",5,0,5
"13879","5410國眾","110/07/08","兆豐-台中港",0,5,-5
"13880","5410國眾","110/07/08","日盛-員林",5,0,5
"13881","5410國眾","110/07/08","凱基-屏東",0,5,-5
"13882","5410國眾","110/07/08","摩根大通",5,0,5
"13883","5410國眾","110/07/08","元大-八德",0,5,-5
"13884","5410國眾","110/07/08","富邦-桃園",5,0,5
"13885","5410國眾","110/07/08","元富-嘉義",0,4,-4
"13886","5410國眾","110/07/08","元富-大昌",4,0,4
"13887","5410國眾","110/07/08","玉山-雙和",0,4,-4
"13888","5410國眾","110/07/08","台新-台中",4,0,4
"13889","5410國眾","110/07/08","凱基-高美館",1,5,-4
"13890","5410國眾","110/07/08","華南永昌-小港",5,1,4
"13891","5410國眾","110/07/08","統一-員林",0,3,-3
"13892","5410國眾","110/07/08","元大-新竹",5,1,4
"13893","5410國眾","110/07/08","臺銀-鳳山",0,2,-2
"13894","5410國眾","110/07/08","元大-土城學府",4,0,4
"13895","5410國眾","110/07/08","亞東",0,2,-2
"13896","5410國眾","110/07/08","元大-新莊",4,0,4
"13897","5410國眾","110/07/08","新光",0,2,-2
"13898","2841台開","110/07/08","元大-樹林",653,0,653
"13899","2841台開","110/07/08","港商野村",0,868,-868
"13900","2841台開","110/07/08","台新證券",115,0,115
"13901","2841台開","110/07/08","群益金鼎-忠孝",0,100,-100
"13902","2841台開","110/07/08","永豐金-豐原",105,0,105
"13903","2841台開","110/07/08","宏遠-高雄",0,56,-56
"13904","2841台開","110/07/08","元富-新興",100,0,100
"13905","2841台開","110/07/08","新光",3,38,-35
"13906","2841台開","110/07/08","凱基-文心",50,0,50
"13907","2841台開","110/07/08","花旗環球",0,29,-29
"13908","2841台開","110/07/08","元大-八德",40,0,40
"13909","2841台開","110/07/08","富邦-仁愛",2,30,-28
"13910","2841台開","110/07/08","日盛-雙和",30,0,30
"13911","2841台開","110/07/08","元富-潮州",0,24,-24
"13912","2841台開","110/07/08","統一-竹南",30,0,30
"13913","2841台開","110/07/08","元大-沙鹿",0,20,-20
"13914","2841台開","110/07/08","凱基-台南",30,0,30
"13915","2841台開","110/07/08","元大-汐止",0,20,-20
"13916","2841台開","110/07/08","元大-福營",30,0,30
"13917","2841台開","110/07/08","合庫-嘉義",2,20,-18
"13918","2841台開","110/07/08","合庫-台中",22,0,22
"13919","2841台開","110/07/08","國泰-敦南",3,21,-18
"13920","2841台開","110/07/08","大昌-安康",28,10,18
"13921","2841台開","110/07/08","日盛-竹北",0,15,-15
"13922","2841台開","110/07/08","元大-斗信",15,0,15
"13923","2841台開","110/07/08","元大-三重",0,15,-15
"13924","2841台開","110/07/08","富邦-台北",13,0,13
"13925","2841台開","110/07/08","永豐金-敦南",45,60,-15
"13926","2841台開","110/07/08","合庫-桃園",10,0,10
"13927","2841台開","110/07/08","(牛牛牛)亞-網路",0,12,-12
"13928","6207雷科","110/07/08","台新-高雄",54,2,52
"13929","6207雷科","110/07/08","群益金鼎-丹鳳",0,60,-60
"13930","6207雷科","110/07/08","新光-台中",18,0,18
"13931","6207雷科","110/07/08","元大-頭份",1,56,-55
"13932","6207雷科","110/07/08","日盛-嘉義",16,0,16
"13933","6207雷科","110/07/08","國票-中和",0,30,-30
"13934","6207雷科","110/07/08","合庫-鳳山",15,0,15
"13935","6207雷科","110/07/08","凱基-台北",1,29,-28
"13936","6207雷科","110/07/08","臺銀-臺中",12,0,12
"13937","6207雷科","110/07/08","兆豐-板橋",0,25,-25
"13938","6207雷科","110/07/08","群益金鼎-土城",12,0,12
"13939","6207雷科","110/07/08","凱基-城中",4,25,-21
"13940","6207雷科","110/07/08","新光",25,14,11
"13941","6207雷科","110/07/08","日進",0,20,-20
"13942","6207雷科","110/07/08","凱基-中壢",11,0,11
"13943","6207雷科","110/07/08","台新證券",3,20,-17
"13944","6207雷科","110/07/08","台灣企銀",10,0,10
"13945","6207雷科","110/07/08","群益金鼎-中山",0,16,-16
"13946","6207雷科","110/07/08","第一金-新興",11,1,10
"13947","6207雷科","110/07/08","元大-東門",0,16,-16
"13948","6207雷科","110/07/08","元富-吉利",10,0,10
"13949","6207雷科","110/07/08","群益金鼎-大甲",0,13,-13
"13950","6207雷科","110/07/08","光和-和美",10,0,10
"13951","6207雷科","110/07/08","日盛-板橋",0,10,-10
"13952","6207雷科","110/07/08","永豐金-南京",10,0,10
"13953","6207雷科","110/07/08","日盛-中壢",0,10,-10
"13954","6207雷科","110/07/08","土銀",8,0,8
"13955","6207雷科","110/07/08","摩根大通",125,135,-10
"13956","6207雷科","110/07/08","中國信託-高雄",8,0,8
"13957","6207雷科","110/07/08","凱基-五股",0,10,-10
"13958","3679新至陞","110/07/08","華南永昌-台中",17,0,17
"13959","3679新至陞","110/07/08","大慶-蘆洲",0,10,-10
"13960","3679新至陞","110/07/08","國泰-桃園",6,0,6
"13961","3679新至陞","110/07/08","華南永昌-小港",0,7,-7
"13962","3679新至陞","110/07/08","元大-永春",6,0,6
"13963","3679新至陞","110/07/08","國泰-館前",0,3,-3
"13964","3679新至陞","110/07/08","香港上海匯豐",4,0,4
"13965","3679新至陞","110/07/08","元大-板橋",0,3,-3
"13966","3679新至陞","110/07/08","中國信託-新竹",3,0,3
"13967","3679新至陞","110/07/08","港商法國興業",0,2,-2
"13968","3679新至陞","110/07/08","國票-敦北法人",3,0,3
"13969","3679新至陞","110/07/08","第一金-忠孝",0,2,-2
"13970","3679新至陞","110/07/08","群益金鼎-台南",2,0,2
"13971","3679新至陞","110/07/08","元富-古亭",0,2,-2
"13972","3679新至陞","110/07/08","凱基",2,0,2
"13973","3679新至陞","110/07/08","摩根大通",1,3,-2
"13974","3679新至陞","110/07/08","凱基-台北",6,4,2
"13975","3679新至陞","110/07/08","富邦-板橋",0,2,-2
"13976","3679新至陞","110/07/08","日盛-信義",1,0,1
"13977","3679新至陞","110/07/08","元大-文心興安",0,2,-2
"13978","3679新至陞","110/07/08","日盛-新莊",1,0,1
"13979","3679新至陞","110/07/08","臺銀-高雄",0,1,-1
"13980","3679新至陞","110/07/08","大慶",1,0,1
"13981","3679新至陞","110/07/08","日盛-高雄",0,1,-1
"13982","3679新至陞","110/07/08","兆豐-三重",1,0,1
"13983","3679新至陞","110/07/08","日盛-文化",0,1,-1
"13984","3679新至陞","110/07/08","致和-東門",1,0,1
"13985","3679新至陞","110/07/08","美商高盛",0,1,-1
"13986","3679新至陞","110/07/08","台新證券",1,0,1
"13987","3679新至陞","110/07/08","瑞士信貸",0,1,-1
"13988","2727王品","110/07/08","群益金鼎-大安",80,0,80
"13989","2727王品","110/07/08","台灣摩根士丹利",1,300,-299
"13990","2727王品","110/07/08","富邦-台北",237,165,72
"13991","2727王品","110/07/08","元大證券",173,439,-266
"13992","2727王品","110/07/08","永豐金-萬盛",55,5,50
"13993","2727王品","110/07/08","統一",33,200,-167
"13994","2727王品","110/07/08","永豐金-南投",53,10,43
"13995","2727王品","110/07/08","凱基-台北",476,615,-139
"13996","2727王品","110/07/08","國泰-敦南",190,148,42
"13997","2727王品","110/07/08","永豐金-松山",8,138,-130
"13998","2727王品","110/07/08","台新-高雄",71,36,35
"13999","2727王品","110/07/08","新加坡商瑞銀",38,138,-100
"14000","2727王品","110/07/08","富邦-建國",62,27,35
"14001","2727王品","110/07/08","富邦-嘉義",84,182,-98
"14002","2727王品","110/07/08","永豐金證券",50,15,35
"14003","2727王品","110/07/08","元富-台南",4,99,-95
"14004","2727王品","110/07/08","港商野村",185,152,33
"14005","2727王品","110/07/08","凱基-永華",4,92,-88
"14006","2727王品","110/07/08","元大-嘉義",35,3,32
"14007","2727王品","110/07/08","凱基-大直",2,73,-71
"14008","2727王品","110/07/08","台新-三民",35,4,31
"14009","2727王品","110/07/08","美林",105,164,-59
"14010","2727王品","110/07/08","凱基-桃園",35,4,31
"14011","2727王品","110/07/08","第一金-台南",11,63,-52
"14012","2727王品","110/07/08","元大-和平",41,10,31
"14013","2727王品","110/07/08","摩根大通",216,259,-43
"14014","2727王品","110/07/08","兆豐-大安",33,5,28
"14015","2727王品","110/07/08","元大-員林",9,50,-41
"14016","2727王品","110/07/08","元大-新盛",33,6,27
"14017","2727王品","110/07/08","兆豐-虎尾",1,41,-40
"14018","1570力肯","110/07/08","群益金鼎-三重",20,0,20
"14019","1570力肯","110/07/08","中國信託-永康",0,26,-26
"14020","1570力肯","110/07/08","凱基-中壢",20,0,20
"14021","1570力肯","110/07/08","統一-敦南",0,12,-12
"14022","1570力肯","110/07/08","群益金鼎-台南",14,0,14
"14023","1570力肯","110/07/08","國票-博愛",0,10,-10
"14024","1570力肯","110/07/08","元富-緯城",10,0,10
"14025","1570力肯","110/07/08","元大-西門",0,10,-10
"14026","1570力肯","110/07/08","瑞士信貸",7,0,7
"14027","1570力肯","110/07/08","新光",0,9,-9
"14028","1570力肯","110/07/08","摩根大通",6,0,6
"14029","1570力肯","110/07/08","永豐金-大園",0,9,-9
"14030","1570力肯","110/07/08","土銀-白河",5,0,5
"14031","1570力肯","110/07/08","日盛-大墩",0,6,-6
"14032","1570力肯","110/07/08","台灣摩根士丹利",4,0,4
"14033","1570力肯","110/07/08","台新證券",0,6,-6
"14034","1570力肯","110/07/08","元大-新莊",3,0,3
"14035","1570力肯","110/07/08","永全",0,5,-5
"14036","1570力肯","110/07/08","永豐金-苓雅",3,0,3
"14037","1570力肯","110/07/08","元大-天母",0,5,-5
"14038","1570力肯","110/07/08","合庫-三重",2,0,2
"14039","1570力肯","110/07/08","元富-吉利",0,3,-3
"14040","1570力肯","110/07/08","(牛牛牛)亞-鑫豐",2,0,2
"14041","1570力肯","110/07/08","國泰-高雄",0,3,-3
"14042","1570力肯","110/07/08","玉山-大里",2,0,2
"14043","1570力肯","110/07/08","群益金鼎-北高雄",0,3,-3
"14044","1570力肯","110/07/08","國泰-敦南",2,0,2
"14045","1570力肯","110/07/08","群益金鼎-東門",0,2,-2
"14046","1570力肯","110/07/08","華南永昌-岡山",2,0,2
"14047","1570力肯","110/07/08","日盛-高雄",5,6,-1
"14048","6180橘子","110/07/08","新光",30,4,26
"14049","6180橘子","110/07/08","元大-土城學府",0,89,-89
"14050","6180橘子","110/07/08","康和-台南",22,0,22
"14051","6180橘子","110/07/08","凱基-東勢",1,66,-65
"14052","6180橘子","110/07/08","國泰-板橋",22,0,22
"14053","6180橘子","110/07/08","光和",0,64,-64
"14054","6180橘子","110/07/08","日盛-文化",21,0,21
"14055","6180橘子","110/07/08","中國信託-忠孝",0,50,-50
"14056","6180橘子","110/07/08","中國信託-文心",20,2,18
"14057","6180橘子","110/07/08","元富-大裕",0,25,-25
"14058","6180橘子","110/07/08","凱基-台北",39,24,15
"14059","6180橘子","110/07/08","統一-基隆",1,25,-24
"14060","6180橘子","110/07/08","元富-新店",14,0,14
"14061","6180橘子","110/07/08","美商高盛",1,21,-20
"14062","6180橘子","110/07/08","元大-土城永寧",11,0,11
"14063","6180橘子","110/07/08","元大證券",1,19,-18
"14064","6180橘子","110/07/08","永豐金-南京",11,0,11
"14065","6180橘子","110/07/08","元大-太平",2,20,-18
"14066","6180橘子","110/07/08","宏遠-館前",10,0,10
"14067","6180橘子","110/07/08","合庫證券",2,18,-16
"14068","6180橘子","110/07/08","國泰-新莊",10,0,10
"14069","6180橘子","110/07/08","台灣摩根士丹利",1,12,-11
"14070","6180橘子","110/07/08","群益金鼎",10,0,10
"14071","6180橘子","110/07/08","瑞士信貸",0,11,-11
"14072","6180橘子","110/07/08","凱基-高雄",10,0,10
"14073","6180橘子","110/07/08","元富-嘉義",0,11,-11
"14074","6180橘子","110/07/08","凱基-大安",10,0,10
"14075","6180橘子","110/07/08","新光-高雄",0,11,-11
"14076","6180橘子","110/07/08","富邦-仁愛",10,0,10
"14077","6180橘子","110/07/08","大慶-苗栗",0,10,-10
"14078","2390云辰","110/07/08","統一-新台中",126,1,125
"14079","2390云辰","110/07/08","摩根大通",62,661,-599
"14080","2390云辰","110/07/08","元大-員林",111,0,111
"14081","2390云辰","110/07/08","新加坡商瑞銀",0,173,-173
"14082","2390云辰","110/07/08","合庫-高雄",105,0,105
"14083","2390云辰","110/07/08","元大-天母",7,150,-143
"14084","2390云辰","110/07/08","凱基-台北",255,177,78
"14085","2390云辰","110/07/08","台灣摩根士丹利",0,134,-134
"14086","2390云辰","110/07/08","新光",71,17,54
"14087","2390云辰","110/07/08","玉山-台中",17,120,-103
"14088","2390云辰","110/07/08","國票-嘉義",53,0,53
"14089","2390云辰","110/07/08","美商高盛",0,78,-78
"14090","2390云辰","110/07/08","富邦-仁愛",53,4,49
"14091","2390云辰","110/07/08","美林",11,82,-71
"14092","2390云辰","110/07/08","兆豐-城中",48,0,48
"14093","2390云辰","110/07/08","群益金鼎-大興",35,106,-71
"14094","2390云辰","110/07/08","元大-新營",47,0,47
"14095","2390云辰","110/07/08","光和",11,71,-60
"14096","2390云辰","110/07/08","國泰-敦南",89,55,34
"14097","2390云辰","110/07/08","國泰-台中",28,70,-42
"14098","2390云辰","110/07/08","兆豐-台中",40,7,33
"14099","2390云辰","110/07/08","玉山-新莊",6,46,-40
"14100","2390云辰","110/07/08","永豐金-中正",36,6,30
"14101","2390云辰","110/07/08","富邦-台北",21,57,-36
"14102","2390云辰","110/07/08","中國信託-三重",29,0,29
"14103","2390云辰","110/07/08","土銀-台中",0,30,-30
"14104","2390云辰","110/07/08","富邦-陽明",33,5,28
"14105","2390云辰","110/07/08","兆豐-埔墘",1,31,-30
"14106","2390云辰","110/07/08","元富-桃園",27,0,27
"14107","2390云辰","110/07/08","玉山-南京東路",3,33,-30
"14108","4903聯光通","110/07/07","元大-太平",47,4,43
"14109","4903聯光通","110/07/07","日盛-板橋",0,15,-15
"14110","4903聯光通","110/07/07","華南永昌-桃園",10,0,10
"14111","4903聯光通","110/07/07","元大-八德",0,9,-9
"14112","4903聯光通","110/07/07","元大-南投",9,0,9
"14113","4903聯光通","110/07/07","宏遠證券",0,7,-7
"14114","4903聯光通","110/07/07","新光-台中",3,0,3
"14115","4903聯光通","110/07/07","大慶",0,7,-7
"14116","4903聯光通","110/07/07","國泰-敦南",1,0,1
"14117","4903聯光通","110/07/07","群益金鼎-館前",0,6,-6
"14118","4903聯光通","110/07/07","國票-中正",0,0,0
"14119","4903聯光通","110/07/07","元大-羅東",0,5,-5
"14120","4903聯光通","110/07/07","康和-內湖",0,0,0
"14121","4903聯光通","110/07/07","新光",8,12,-4
"14122","4903聯光通","110/07/07","凱基-站前",0,0,0
"14123","4903聯光通","110/07/07","國泰-高雄",0,3,-3
"14124","4903聯光通","110/07/07","華南永昌",1,1,0
"14125","4903聯光通","110/07/07","第一金-台中",0,3,-3
"14126","4903聯光通","110/07/07","華南永昌-新莊",0,0,0
"14127","4903聯光通","110/07/07","中農",0,1,-1
"14128","4903聯光通","110/07/07","臺灣企銀-桃園",0,1,-1
"14129","4903聯光通","110/07/07","台新-新營",0,1,-1
"14130","4903聯光通","110/07/07","元大-鶯歌",2,3,-1
"14131","4903聯光通","110/07/07","元大-永和",0,1,-1
"14132","4903聯光通","110/07/07","元大-苑裡",0,1,-1
"14133","2929淘帝","110/07/07","統一",163,0,163
"14134","2929淘帝","110/07/07","新光-台中",57,142,-85
"14135","2929淘帝","110/07/07","港商野村",323,181,142
"14136","2929淘帝","110/07/07","兆豐-忠孝",0,76,-76
"14137","2929淘帝","110/07/07","日盛-中壢",132,10,122
"14138","2929淘帝","110/07/07","台新-建北",0,53,-53
"14139","2929淘帝","110/07/07","新加坡商瑞銀",140,19,121
"14140","2929淘帝","110/07/07","臺銀-鳳山",0,44,-44
"14141","2929淘帝","110/07/07","日盛-嘉義",101,0,101
"14142","2929淘帝","110/07/07","元大-新盛",0,42,-42
"14143","2929淘帝","110/07/07","摩根大通",101,16,85
"14144","2929淘帝","110/07/07","富邦-建國",6,47,-41
"14145","2929淘帝","110/07/07","元大-太平",55,2,53
"14146","2929淘帝","110/07/07","日盛-園區",0,40,-40
"14147","2929淘帝","110/07/07","元富-松德",50,1,49
"14148","2929淘帝","110/07/07","新光-高雄",1,38,-37
"14149","2929淘帝","110/07/07","凱基-板橋",53,5,48
"14150","2929淘帝","110/07/07","永豐金-三重",1,34,-33
"14151","2929淘帝","110/07/07","美林",80,34,46
"14152","2929淘帝","110/07/07","元大-彰化",0,31,-31
"14153","2929淘帝","110/07/07","元富-台南",41,0,41
"14154","2929淘帝","110/07/07","第一金-大稻埕",0,30,-30
"14155","2929淘帝","110/07/07","兆豐-竹北",39,0,39
"14156","2929淘帝","110/07/07","國泰-敦南",3,33,-30
"14157","2929淘帝","110/07/07","元大-西門",36,0,36
"14158","2929淘帝","110/07/07","富邦-員林",0,30,-30
"14159","2929淘帝","110/07/07","華南永昌",39,4,35
"14160","2929淘帝","110/07/07","元大-蘆洲",1,30,-29
"14161","2929淘帝","110/07/07","日盛-板橋中山",30,0,30
"14162","2929淘帝","110/07/07","台新-台南",4,32,-28
"14163","5410國眾","110/07/07","兆豐-城中",66,0,66
"14164","5410國眾","110/07/07","富邦-仁愛",0,115,-115
"14165","5410國眾","110/07/07","摩根大通",21,0,21
"14166","5410國眾","110/07/07","亞東-板橋",0,38,-38
"14167","5410國眾","110/07/07","元大-北投",21,0,21
"14168","5410國眾","110/07/07","凱基-台北",2,24,-22
"14169","5410國眾","110/07/07","亞東-新竹",15,0,15
"14170","5410國眾","110/07/07","彰銀-七賢",0,10,-10
"14171","5410國眾","110/07/07","元大-福營",12,0,12
"14172","5410國眾","110/07/07","凱基-基隆",0,10,-10
"14173","5410國眾","110/07/07","新光-高雄",11,0,11
"14174","5410國眾","110/07/07","凱基-屏東",0,10,-10
"14175","5410國眾","110/07/07","華南永昌-小港",10,0,10
"14176","5410國眾","110/07/07","凱基-鳳山",0,10,-10
"14177","5410國眾","110/07/07","元大-大灣",10,0,10
"14178","5410國眾","110/07/07","永豐金-忠孝",0,10,-10
"14179","5410國眾","110/07/07","元大-莒光",10,0,10
"14180","5410國眾","110/07/07","日盛-板橋中山",0,9,-9
"14181","5410國眾","110/07/07","台中銀-豐原",9,0,9
"14182","5410國眾","110/07/07","統一-高雄",0,5,-5
"14183","5410國眾","110/07/07","元大-南屯",9,0,9
"14184","5410國眾","110/07/07","元大-斗六",0,5,-5
"14185","5410國眾","110/07/07","日盛-新莊",7,0,7
"14186","5410國眾","110/07/07","元大-大益",0,5,-5
"14187","5410國眾","110/07/07","元富-大昌",6,0,6
"14188","5410國眾","110/07/07","元大-南投",0,5,-5
"14189","5410國眾","110/07/07","新光-新竹",6,0,6
"14190","5410國眾","110/07/07","永豐金-員林",0,5,-5
"14191","5410國眾","110/07/07","臺銀-金山",5,0,5
"14192","5410國眾","110/07/07","華南永昌-楠梓",0,4,-4
"14193","2841台開","110/07/07","永豐金-豐原",268,0,268
"14194","2841台開","110/07/07","凱基-市政",0,200,-200
"14195","2841台開","110/07/07","永豐金-南投",200,0,200
"14196","2841台開","110/07/07","永豐金-彰化",0,100,-100
"14197","2841台開","110/07/07","新光",139,9,130
"14198","2841台開","110/07/07","元大-開元",1,93,-92
"14199","2841台開","110/07/07","中國信託-高雄",50,1,49
"14200","2841台開","110/07/07","港商野村",0,80,-80
"14201","2841台開","110/07/07","元大-歸仁",40,0,40
"14202","2841台開","110/07/07","凱基-台南",25,85,-60
"14203","2841台開","110/07/07","台中銀",35,0,35
"14204","2841台開","110/07/07","美商高盛",1,58,-57
"14205","2841台開","110/07/07","台新-新營",30,0,30
"14206","2841台開","110/07/07","統一-三重",0,55,-55
"14207","2841台開","110/07/07","富邦-台南",30,0,30
"14208","2841台開","110/07/07","台新證券",12,50,-38
"14209","2841台開","110/07/07","國泰-板橋",30,1,29
"14210","2841台開","110/07/07","陽信-石牌",0,31,-31
"14211","2841台開","110/07/07","凱基-文心",28,0,28
"14212","2841台開","110/07/07","元大-福營",0,31,-31
"14213","2841台開","110/07/07","凱基-站前",27,0,27
"14214","2841台開","110/07/07","第一金-澎湖",0,30,-30
"14215","2841台開","110/07/07","大昌-安康",38,16,22
"14216","2841台開","110/07/07","元大-新莊",0,30,-30
"14217","2841台開","110/07/07","合庫-台中",20,0,20
"14218","2841台開","110/07/07","國泰-館前",0,28,-28
"14219","2841台開","110/07/07","日盛-台南",20,0,20
"14220","2841台開","110/07/07","元大-竹科",0,25,-25
"14221","2841台開","110/07/07","台中銀-員林",20,0,20
"14222","2841台開","110/07/07","富邦-仁愛",1,22,-21
"14223","6207雷科","110/07/07","元大-大天母",21,0,21
"14224","6207雷科","110/07/07","元大-高雄",0,105,-105
"14225","6207雷科","110/07/07","元大-頭份",18,0,18
"14226","6207雷科","110/07/07","永豐金-中正",0,35,-35
"14227","6207雷科","110/07/07","第一金-新興",16,0,16
"14228","6207雷科","110/07/07","摩根大通",8,39,-31
"14229","6207雷科","110/07/07","富邦-虎尾",12,0,12
"14230","6207雷科","110/07/07","元大-林園",0,30,-30
"14231","6207雷科","110/07/07","兆豐-板橋",10,0,10
"14232","6207雷科","110/07/07","凱基-台北",0,19,-19
"14233","6207雷科","110/07/07","玉山-台大",10,0,10
"14234","6207雷科","110/07/07","國票-中和",13,25,-12
"14235","6207雷科","110/07/07","元大-四維",10,0,10
"14236","6207雷科","110/07/07","新加坡商瑞銀",0,9,-9
"14237","6207雷科","110/07/07","元大-鹿港",10,0,10
"14238","6207雷科","110/07/07","玉山-高雄",0,8,-8
"14239","6207雷科","110/07/07","元大-信義",10,0,10
"14240","6207雷科","110/07/07","玉山-台南",0,8,-8
"14241","6207雷科","110/07/07","台新-三民",8,0,8
"14242","6207雷科","110/07/07","宏遠-高雄",0,5,-5
"14243","6207雷科","110/07/07","元大-上新莊",8,0,8
"14244","6207雷科","110/07/07","元大-南海",0,5,-5
"14245","6207雷科","110/07/07","大昌-桃園",7,0,7
"14246","6207雷科","110/07/07","元大-莒光",0,4,-4
"14247","6207雷科","110/07/07","新光-台中",10,4,6
"14248","6207雷科","110/07/07","港商野村",0,3,-3
"14249","6207雷科","110/07/07","日盛-頭份",5,0,5
"14250","6207雷科","110/07/07","大慶-台南",0,3,-3
"14251","6207雷科","110/07/07","日茂-埔里",5,0,5
"14252","6207雷科","110/07/07","凱基-站前",0,3,-3
"14253","3679新至陞","110/07/07","永豐金證券",18,0,18
"14254","3679新至陞","110/07/07","美林",0,13,-13
"14255","3679新至陞","110/07/07","元大-文心興安",6,0,6
"14256","3679新至陞","110/07/07","兆豐-大安",0,10,-10
"14257","3679新至陞","110/07/07","中農",5,0,5
"14258","3679新至陞","110/07/07","國泰-桃園",0,4,-4
"14259","3679新至陞","110/07/07","台新證券",4,0,4
"14260","3679新至陞","110/07/07","永豐金-虎尾",0,4,-4
"14261","3679新至陞","110/07/07","華南永昌-小港",4,0,4
"14262","3679新至陞","110/07/07","台灣摩根士丹利",0,3,-3
"14263","3679新至陞","110/07/07","元大-天母",4,0,4
"14264","3679新至陞","110/07/07","瑞士信貸",0,3,-3
"14265","3679新至陞","110/07/07","台中銀-員林",4,1,3
"14266","3679新至陞","110/07/07","統一-新竹",0,3,-3
"14267","3679新至陞","110/07/07","摩根大通",4,1,3
"14268","3679新至陞","110/07/07","統一-三重",0,3,-3
"14269","3679新至陞","110/07/07","凱基-台北",7,4,3
"14270","3679新至陞","110/07/07","凱基-竹北",0,3,-3
"14271","3679新至陞","110/07/07","華南永昌-高雄",3,0,3
"14272","3679新至陞","110/07/07","元富-世貿",0,2,-2
"14273","3679新至陞","110/07/07","永豐金-潮州",2,0,2
"14274","3679新至陞","110/07/07","兆豐-鹿港",0,2,-2
"14275","3679新至陞","110/07/07","合庫-新竹",1,0,1
"14276","3679新至陞","110/07/07","玉山-台大",0,2,-2
"14277","3679新至陞","110/07/07","土銀-高雄",1,0,1
"14278","3679新至陞","110/07/07","國泰-館前",0,2,-2
"14279","3679新至陞","110/07/07","元富-新興",1,0,1
"14280","3679新至陞","110/07/07","群益金鼎-新莊",0,2,-2
"14281","3679新至陞","110/07/07","富邦-中壢",1,0,1
"14282","3679新至陞","110/07/07","元大-桃園",0,2,-2
"14283","2727王品","110/07/07","第一金",62,0,62
"14284","2727王品","110/07/07","台灣摩根士丹利",1,177,-176
"14285","2727王品","110/07/07","凱基-埔墘",40,0,40
"14286","2727王品","110/07/07","凱基-台北",49,151,-102
"14287","2727王品","110/07/07","中國信託-忠孝",40,1,39
"14288","2727王品","110/07/07","摩根大通",19,107,-88
"14289","2727王品","110/07/07","玉山-板橋",40,6,34
"14290","2727王品","110/07/07","美商高盛",2,86,-84
"14291","2727王品","110/07/07","亞東-新竹",31,1,30
"14292","2727王品","110/07/07","元大-北屯",1,52,-51
"14293","2727王品","110/07/07","群益金鼎-宜蘭",25,1,24
"14294","2727王品","110/07/07","國泰證券",1,47,-46
"14295","2727王品","110/07/07","富邦-竹北",23,0,23
"14296","2727王品","110/07/07","統一",3,33,-30
"14297","2727王品","110/07/07","元大-旗山",23,0,23
"14298","2727王品","110/07/07","第一金-台中",1,30,-29
"14299","2727王品","110/07/07","元富-宜蘭",21,0,21
"14300","2727王品","110/07/07","華南永昌-中正",4,29,-25
"14301","2727王品","110/07/07","國票-長城",20,0,20
"14302","2727王品","110/07/07","美林",0,23,-23
"14303","2727王品","110/07/07","台新證券",47,28,19
"14304","2727王品","110/07/07","群益金鼎-館前",0,20,-20
"14305","2727王品","110/07/07","富邦-新竹華信",18,1,17
"14306","2727王品","110/07/07","國票-內壢",0,16,-16
"14307","2727王品","110/07/07","永豐金-中正",18,1,17
"14308","2727王品","110/07/07","兆豐-新莊",0,15,-15
"14309","2727王品","110/07/07","華南永昌-麻豆",17,1,16
"14310","2727王品","110/07/07","港商野村",15,28,-13
"14311","2727王品","110/07/07","永豐金-潮州",15,0,15
"14312","2727王品","110/07/07","元大-善化",1,13,-12
"14313","1570力肯","110/07/07","台新證券",88,0,88
"14314","1570力肯","110/07/07","新光",0,54,-54
"14315","1570力肯","110/07/07","摩根大通",49,15,34
"14316","1570力肯","110/07/07","元大-高雄",0,40,-40
"14317","1570力肯","110/07/07","合庫-桃園",20,0,20
"14318","1570力肯","110/07/07","國票-北高雄",38,50,-12
"14319","1570力肯","110/07/07","元大-土城學府",20,0,20
"14320","1570力肯","110/07/07","群益金鼎-嘉義",0,10,-10
"14321","1570力肯","110/07/07","永豐金-板盛",18,0,18
"14322","1570力肯","110/07/07","元大-草屯",0,10,-10
"14323","1570力肯","110/07/07","永豐金-永康",18,0,18
"14324","1570力肯","110/07/07","日盛-高雄",0,9,-9
"14325","1570力肯","110/07/07","統一-員林",14,0,14
"14326","1570力肯","110/07/07","第一金-路竹",0,9,-9
"14327","1570力肯","110/07/07","元大-竹山",6,0,6
"14328","1570力肯","110/07/07","元大-古亭",0,9,-9
"14329","1570力肯","110/07/07","統一-敦南",5,0,5
"14330","1570力肯","110/07/07","國票-中正",0,8,-8
"14331","1570力肯","110/07/07","元大-永和",5,0,5
"14332","1570力肯","110/07/07","群益金鼎-鳳山",0,6,-6
"14333","1570力肯","110/07/07","元富-大裕",4,0,4
"14334","1570力肯","110/07/07","元大-土城永寧",0,6,-6
"14335","1570力肯","110/07/07","華南永昌-斗六",4,0,4
"14336","1570力肯","110/07/07","中國信託",0,5,-5
"14337","1570力肯","110/07/07","永豐金-松山",6,3,3
"14338","1570力肯","110/07/07","日盛-板橋",0,4,-4
"14339","1570力肯","110/07/07","永豐金-南投",4,1,3
"14340","1570力肯","110/07/07","日盛-木柵",0,4,-4
"14341","1570力肯","110/07/07","土銀-彰化",2,0,2
"14342","1570力肯","110/07/07","玉山-桃園",0,4,-4
"14343","6180橘子","110/07/07","臺銀-金山",27,0,27
"14344","6180橘子","110/07/07","凱基-台北",6,36,-30
"14345","6180橘子","110/07/07","元富-潮州",20,0,20
"14346","6180橘子","110/07/07","元大-天母",1,26,-25
"14347","6180橘子","110/07/07","凱基-中山",20,0,20
"14348","6180橘子","110/07/07","富邦-陽明",0,22,-22
"14349","6180橘子","110/07/07","元大-太平",23,4,19
"14350","6180橘子","110/07/07","日盛-頭份",0,20,-20
"14351","6180橘子","110/07/07","摩根大通",17,0,17
"14352","6180橘子","110/07/07","富邦-仁愛",0,20,-20
"14353","6180橘子","110/07/07","元大-草屯",20,3,17
"14354","6180橘子","110/07/07","永豐金-新莊",0,20,-20
"14355","6180橘子","110/07/07","華南永昌-楠梓",15,1,14
"14356","6180橘子","110/07/07","台灣摩根士丹利",0,18,-18
"14357","6180橘子","110/07/07","中國信託-永康",12,0,12
"14358","6180橘子","110/07/07","華南永昌-長虹",1,16,-15
"14359","6180橘子","110/07/07","日盛-文化",10,0,10
"14360","6180橘子","110/07/07","新光-新竹",0,12,-12
"14361","6180橘子","110/07/07","國泰-館前",10,0,10
"14362","6180橘子","110/07/07","凱基-中壢",0,12,-12
"14363","6180橘子","110/07/07","華南永昌-鶯歌",10,0,10
"14364","6180橘子","110/07/07","第一金-忠孝",0,11,-11
"14365","6180橘子","110/07/07","元大-豐原站前",10,0,10
"14366","6180橘子","110/07/07","元大-沙鹿",0,11,-11
"14367","6180橘子","110/07/07","元大-北屯",10,0,10
"14368","6180橘子","110/07/07","永豐金-羅東",0,11,-11
"14369","6180橘子","110/07/07","兆豐-台中",10,1,9
"14370","6180橘子","110/07/07","兆豐-埔墘",0,10,-10
"14371","6180橘子","110/07/07","群益金鼎-開元",9,0,9
"14372","6180橘子","110/07/07","華南永昌-台中",0,10,-10
"14373","2390云辰","110/07/07","元大-向上",144,0,144
"14374","2390云辰","110/07/07","摩根大通",18,674,-656
"14375","2390云辰","110/07/07","元富-中港",102,0,102
"14376","2390云辰","110/07/07","凱基-台北",141,625,-484
"14377","2390云辰","110/07/07","群益金鼎-民權",104,4,100
"14378","2390云辰","110/07/07","美林",32,261,-229
"14379","2390云辰","110/07/07","兆豐-忠孝",81,0,81
"14380","2390云辰","110/07/07","新加坡商瑞銀",50,149,-99
"14381","2390云辰","110/07/07","合庫-新竹",60,0,60
"14382","2390云辰","110/07/07","台灣摩根士丹利",7,87,-80
"14383","2390云辰","110/07/07","元大-土城學府",59,1,58
"14384","2390云辰","110/07/07","元大-金華",2,68,-66
"14385","2390云辰","110/07/07","玉山-大里",58,3,55
"14386","2390云辰","110/07/07","國票-新莊",13,65,-52
"14387","2390云辰","110/07/07","元大-東蘆",54,1,53
"14388","2390云辰","110/07/07","凱基-三重",12,56,-44
"14389","2390云辰","110/07/07","元富-三重",51,0,51
"14390","2390云辰","110/07/07","新光-台中",23,65,-42
"14391","2390云辰","110/07/07","元富-埔里",50,0,50
"14392","2390云辰","110/07/07","第一金-中壢",5,45,-40
"14393","2390云辰","110/07/07","中國信託-三重",52,3,49
"14394","2390云辰","110/07/07","華南永昌-斗六",0,40,-40
"14395","2390云辰","110/07/07","元大-彰化民生",64,15,49
"14396","2390云辰","110/07/07","富邦-新竹華信",25,61,-36
"14397","2390云辰","110/07/07","元大-潮州",50,5,45
"14398","2390云辰","110/07/07","玉山-新莊",2,32,-30
"14399","2390云辰","110/07/07","元富-高雄",57,14,43
"14400","2390云辰","110/07/07","凱基-新豐",17,47,-30
"14401","2390云辰","110/07/07","凱基-和平",40,0,40
"14402","2390云辰","110/07/07","統一-汐止",1,29,-28
"14403","4903聯光通","110/07/06","元大-苗栗",10,0,10
"14404","4903聯光通","110/07/06","宏遠證券",0,13,-13
"14405","4903聯光通","110/07/06","彰銀",5,0,5
"14406","4903聯光通","110/07/06","富邦-新營",0,4,-4
"14407","4903聯光通","110/07/06","元大-松山",5,0,5
"14408","4903聯光通","110/07/06","元富-草屯",0,3,-3
"14409","4903聯光通","110/07/06","新光",3,0,3
"14410","4903聯光通","110/07/06","元大-羅東",0,3,-3
"14411","4903聯光通","110/07/06","群益金鼎-館前",1,0,1
"14412","4903聯光通","110/07/06","元大-北三重",0,2,-2
"14413","4903聯光通","110/07/06","華南永昌-鶯歌",1,0,1
"14414","4903聯光通","110/07/06","國泰-敦南",0,1,-1
"14415","4903聯光通","110/07/06","永豐金-市政",1,0,1
"14416","4903聯光通","110/07/06","元富-板橋",0,0,0
"14417","4903聯光通","110/07/06","元富-板橋",0,0,0
"14418","4903聯光通","110/07/06","華南永昌",0,0,0
"14419","4903聯光通","110/07/06","華南永昌",0,0,0
"14420","4903聯光通","110/07/06","元大-太平",2,2,0
"14421","4903聯光通","110/07/06","元大-太平",2,2,0
"14422","2929淘帝","110/07/06","新光",204,85,119
"14423","2929淘帝","110/07/06","港商野村",62,282,-220
"14424","2929淘帝","110/07/06","日盛-中壢",94,0,94
"14425","2929淘帝","110/07/06","摩根大通",64,264,-200
"14426","2929淘帝","110/07/06","元富-城東",84,0,84
"14427","2929淘帝","110/07/06","統一",0,163,-163
"14428","2929淘帝","110/07/06","日盛-雙和",55,0,55
"14429","2929淘帝","110/07/06","香港上海匯豐",0,141,-141
"14430","2929淘帝","110/07/06","第一金-路竹",71,17,54
"14431","2929淘帝","110/07/06","新加坡商瑞銀",54,179,-125
"14432","2929淘帝","110/07/06","元大-花蓮",44,2,42
"14433","2929淘帝","110/07/06","合庫-高雄",3,122,-119
"14434","2929淘帝","110/07/06","永豐金-大園",73,33,40
"14435","2929淘帝","110/07/06","美林",34,118,-84
"14436","2929淘帝","110/07/06","元大-太平",44,6,38
"14437","2929淘帝","110/07/06","元大-員林",2,82,-80
"14438","2929淘帝","110/07/06","國泰-板橋",40,5,35
"14439","2929淘帝","110/07/06","元富-松德",26,75,-49
"14440","2929淘帝","110/07/06","兆豐-內湖",33,1,32
"14441","2929淘帝","110/07/06","臺銀-臺南",9,52,-43
"14442","2929淘帝","110/07/06","元大-博愛",43,11,32
"14443","2929淘帝","110/07/06","元大-北投",5,48,-43
"14444","2929淘帝","110/07/06","日盛-竹北",40,10,30
"14445","2929淘帝","110/07/06","臺銀-民權",1,41,-40
"14446","2929淘帝","110/07/06","元大-善化",52,22,30
"14447","2929淘帝","110/07/06","兆豐-忠孝",1,41,-40
"14448","2929淘帝","110/07/06","富邦-北港",29,0,29
"14449","2929淘帝","110/07/06","元大-西門",1,36,-35
"14450","2929淘帝","110/07/06","凱基-湖口",27,0,27
"14451","2929淘帝","110/07/06","玉山-嘉義",3,35,-32
"14452","5410國眾","110/07/06","兆豐-城中",28,0,28
"14453","5410國眾","110/07/06","凱基-高美館",1,18,-17
"14454","5410國眾","110/07/06","元大-小港",20,0,20
"14455","5410國眾","110/07/06","國泰-館前",0,15,-15
"14456","5410國眾","110/07/06","元大-新盛",18,0,18
"14457","5410國眾","110/07/06","國泰-板橋",2,17,-15
"14458","5410國眾","110/07/06","香港上海匯豐",15,0,15
"14459","5410國眾","110/07/06","新光",0,13,-13
"14460","5410國眾","110/07/06","華南永昌-小港",15,0,15
"14461","5410國眾","110/07/06","元富-緯城",0,10,-10
"14462","5410國眾","110/07/06","元富-大昌",13,0,13
"14463","5410國眾","110/07/06","中農",0,10,-10
"14464","5410國眾","110/07/06","臺銀-臺南",10,0,10
"14465","5410國眾","110/07/06","凱基-屏東",0,10,-10
"14466","5410國眾","110/07/06","元富-延平",8,0,8
"14467","5410國眾","110/07/06","新光-桃園",0,6,-6
"14468","5410國眾","110/07/06","元大-八德",17,9,8
"14469","5410國眾","110/07/06","高橋-龍潭",0,5,-5
"14470","5410國眾","110/07/06","摩根大通",7,0,7
"14471","5410國眾","110/07/06","元富-世貿",0,5,-5
"14472","5410國眾","110/07/06","凱基-桃園",7,0,7
"14473","5410國眾","110/07/06","群益金鼎-瑞豐",0,5,-5
"14474","5410國眾","110/07/06","永豐金-屏東",7,0,7
"14475","5410國眾","110/07/06","富邦-台中",0,5,-5
"14476","5410國眾","110/07/06","台新-左楠",5,0,5
"14477","5410國眾","110/07/06","永豐金-板橋",0,5,-5
"14478","5410國眾","110/07/06","富邦-竹東",5,0,5
"14479","5410國眾","110/07/06","富邦-台南",0,4,-4
"14480","5410國眾","110/07/06","元大-新莊",5,0,5
"14481","5410國眾","110/07/06","凱基-站前",0,3,-3
"14482","2841台開","110/07/06","群益金鼎-忠孝",100,0,100
"14483","2841台開","110/07/06","港商野村",0,295,-295
"14484","2841台開","110/07/06","台新證券",58,0,58
"14485","2841台開","110/07/06","元大-善化",0,50,-50
"14486","2841台開","110/07/06","台新-台中",58,0,58
"14487","2841台開","110/07/06","元大-四維",0,50,-50
"14488","2841台開","110/07/06","永豐金-敦南",50,0,50
"14489","2841台開","110/07/06","台新-新營",0,30,-30
"14490","2841台開","110/07/06","元大-台中",45,0,45
"14491","2841台開","110/07/06","群益金鼎-桃園",0,21,-21
"14492","2841台開","110/07/06","凱基-文心",43,0,43
"14493","2841台開","110/07/06","台中銀-員林",0,20,-20
"14494","2841台開","110/07/06","永豐金-潮州",30,0,30
"14495","2841台開","110/07/06","群益金鼎-延平",0,15,-15
"14496","2841台開","110/07/06","第一金-自由",25,0,25
"14497","2841台開","110/07/06","元大-三重",0,13,-13
"14498","2841台開","110/07/06","美商高盛",17,0,17
"14499","2841台開","110/07/06","元富-古亭",0,10,-10
"14500","2841台開","110/07/06","大昌-安康",39,22,17
"14501","2841台開","110/07/06","群益金鼎-北高雄",0,10,-10
"14502","2841台開","110/07/06","台中銀",15,0,15
"14503","2841台開","110/07/06","華南永昌-南京",0,10,-10
"14504","2841台開","110/07/06","玉山-嘉義",15,0,15
"14505","2841台開","110/07/06","富邦-花蓮",0,10,-10
"14506","2841台開","110/07/06","新光",11,0,11
"14507","2841台開","110/07/06","富邦-高雄",0,10,-10
"14508","2841台開","110/07/06","兆豐-永和",10,0,10
"14509","2841台開","110/07/06","元大-竹山",0,10,-10
"14510","2841台開","110/07/06","康和-內湖",10,0,10
"14511","2841台開","110/07/06","元大-屏東",0,10,-10
"14512","6207雷科","110/07/06","新光",45,4,41
"14513","6207雷科","110/07/06","凱基-高美館",1,104,-103
"14514","6207雷科","110/07/06","統一-基隆",30,0,30
"14515","6207雷科","110/07/06","摩根大通",11,45,-34
"14516","6207雷科","110/07/06","康和-南崁",13,0,13
"14517","6207雷科","110/07/06","群益金鼎-新竹",0,22,-22
"14518","6207雷科","110/07/06","宏遠-台南",10,0,10
"14519","6207雷科","110/07/06","港商野村",2,23,-21
"14520","6207雷科","110/07/06","國票-和平",10,0,10
"14521","6207雷科","110/07/06","凱基-台北",0,14,-14
"14522","6207雷科","110/07/06","永豐金-天母",10,0,10
"14523","6207雷科","110/07/06","台新-三民",0,12,-12
"14524","6207雷科","110/07/06","台新證券",10,1,9
"14525","6207雷科","110/07/06","群益金鼎-開元",1,11,-10
"14526","6207雷科","110/07/06","群益金鼎-士林",8,0,8
"14527","6207雷科","110/07/06","富邦-南屯",0,8,-8
"14528","6207雷科","110/07/06","群益金鼎-瑞豐",7,0,7
"14529","6207雷科","110/07/06","元大-善化",0,8,-8
"14530","6207雷科","110/07/06","元大-四維",7,0,7
"14531","6207雷科","110/07/06","日盛-頭份",0,5,-5
"14532","6207雷科","110/07/06","國票-中和",6,0,6
"14533","6207雷科","110/07/06","第一金-高雄",0,5,-5
"14534","6207雷科","110/07/06","台新-中壢",6,0,6
"14535","6207雷科","110/07/06","凱基-八德",0,5,-5
"14536","6207雷科","110/07/06","凱基-高雄",6,0,6
"14537","6207雷科","110/07/06","凱基-頭份",0,5,-5
"14538","6207雷科","110/07/06","富邦-彰化",6,0,6
"14539","6207雷科","110/07/06","合庫-新竹",0,4,-4
"14540","6207雷科","110/07/06","凱基-大安",5,0,5
"14541","6207雷科","110/07/06","新光-高雄",0,4,-4
"14542","3679新至陞","110/07/06","凱基",11,0,11
"14543","3679新至陞","110/07/06","摩根大通",0,22,-22
"14544","3679新至陞","110/07/06","台中銀-員林",11,1,10
"14545","3679新至陞","110/07/06","凱基-台北",6,21,-15
"14546","3679新至陞","110/07/06","安泰-大發",10,0,10
"14547","3679新至陞","110/07/06","瑞士信貸",0,13,-13
"14548","3679新至陞","110/07/06","香港上海匯豐",8,0,8
"14549","3679新至陞","110/07/06","富邦-苗栗",0,10,-10
"14550","3679新至陞","110/07/06","永豐金證券",8,2,6
"14551","3679新至陞","110/07/06","元大-永春",0,6,-6
"14552","3679新至陞","110/07/06","第一金-高雄",5,0,5
"14553","3679新至陞","110/07/06","凱基-興隆",0,5,-5
"14554","3679新至陞","110/07/06","群益金鼎-高盛",3,0,3
"14555","3679新至陞","110/07/06","國泰-桃園",0,3,-3
"14556","3679新至陞","110/07/06","元大-嘉義",3,0,3
"14557","3679新至陞","110/07/06","元大-萬華",2,5,-3
"14558","3679新至陞","110/07/06","臺銀-高雄",2,0,2
"14559","3679新至陞","110/07/06","美林",0,2,-2
"14560","3679新至陞","110/07/06","日盛-復興",2,0,2
"14561","3679新至陞","110/07/06","第一金-華江",0,2,-2
"14562","3679新至陞","110/07/06","日盛-樹林",4,2,2
"14563","3679新至陞","110/07/06","新光-台中",0,2,-2
"14564","3679新至陞","110/07/06","宏遠-館前",2,0,2
"14565","3679新至陞","110/07/06","華南永昌-民權",0,2,-2
"14566","3679新至陞","110/07/06","台新證券",2,0,2
"14567","3679新至陞","110/07/06","元大-板橋",0,2,-2
"14568","3679新至陞","110/07/06","康和-板橋",2,0,2
"14569","3679新至陞","110/07/06","日盛-板橋中山",0,1,-1
"14570","3679新至陞","110/07/06","群益金鼎-台南",2,0,2
"14571","3679新至陞","110/07/06","宏遠證券",0,1,-1
"14572","2727王品","110/07/06","元大證券",1033,729,304
"14573","2727王品","110/07/06","台灣摩根士丹利",35,184,-149
"14574","2727王品","110/07/06","富邦-台北",332,46,286
"14575","2727王品","110/07/06","元大-北屯",11,79,-68
"14576","2727王品","110/07/06","統一",252,43,209
"14577","2727王品","110/07/06","元富-敦南",4,70,-66
"14578","2727王品","110/07/06","永豐金-松山",147,14,133
"14579","2727王品","110/07/06","元大-基隆孝二",11,75,-64
"14580","2727王品","110/07/06","富邦-嘉義",301,198,103
"14581","2727王品","110/07/06","臺銀-臺南",9,69,-60
"14582","2727王品","110/07/06","新加坡商瑞銀",128,34,94
"14583","2727王品","110/07/06","中國信託-忠孝",5,48,-43
"14584","2727王品","110/07/06","元富-台南",97,6,91
"14585","2727王品","110/07/06","永豐金-市政",5,46,-41
"14586","2727王品","110/07/06","台新證券",169,105,64
"14587","2727王品","110/07/06","彰銀-台中",19,56,-37
"14588","2727王品","110/07/06","美林",115,58,57
"14589","2727王品","110/07/06","玉山證券",30,67,-37
"14590","2727王品","110/07/06","華南永昌",75,23,52
"14591","2727王品","110/07/06","凱基-埔墘",4,41,-37
"14592","2727王品","110/07/06","凱基-台北",445,398,47
"14593","2727王品","110/07/06","永豐金-大園",3,40,-37
"14594","2727王品","110/07/06","凱基-大直",48,7,41
"14595","2727王品","110/07/06","元富",2,37,-35
"14596","2727王品","110/07/06","凱基-林口",45,4,41
"14597","2727王品","110/07/06","富邦-仁愛",32,64,-32
"14598","2727王品","110/07/06","德信",40,1,39
"14599","2727王品","110/07/06","玉山-板橋",52,82,-30
"14600","2727王品","110/07/06","第一金",42,5,37
"14601","2727王品","110/07/06","中國信託-文心",10,39,-29
"14602","1570力肯","110/07/06","香港上海匯豐",47,0,47
"14603","1570力肯","110/07/06","新光",2,107,-105
"14604","1570力肯","110/07/06","元大-高雄",55,16,39
"14605","1570力肯","110/07/06","摩根大通",11,58,-47
"14606","1570力肯","110/07/06","元富-緯城",37,0,37
"14607","1570力肯","110/07/06","高橋",4,50,-46
"14608","1570力肯","110/07/06","台新-台南",16,0,16
"14609","1570力肯","110/07/06","合庫-桃園",0,20,-20
"14610","1570力肯","110/07/06","元大-新竹經國",14,0,14
"14611","1570力肯","110/07/06","永豐金-板盛",0,18,-18
"14612","1570力肯","110/07/06","富邦-左營",12,0,12
"14613","1570力肯","110/07/06","華南永昌-公誠",0,9,-9
"14614","1570力肯","110/07/06","國票-中正",12,2,10
"14615","1570力肯","110/07/06","凱基-台北",1,9,-8
"14616","1570力肯","110/07/06","國票-博愛",10,0,10
"14617","1570力肯","110/07/06","臺銀-臺中",0,6,-6
"14618","1570力肯","110/07/06","統一-敦南",12,5,7
"14619","1570力肯","110/07/06","台新-三民",0,5,-5
"14620","1570力肯","110/07/06","群益金鼎-三重",7,0,7
"14621","1570力肯","110/07/06","華南永昌-麻豆",0,5,-5
"14622","1570力肯","110/07/06","臺銀-臺南",6,0,6
"14623","1570力肯","110/07/06","合庫-台南",0,4,-4
"14624","1570力肯","110/07/06","大慶-蘆洲",6,0,6
"14625","1570力肯","110/07/06","統一-員林",0,4,-4
"14626","1570力肯","110/07/06","元富-新店",6,0,6
"14627","1570力肯","110/07/06","康和-澎湖",0,4,-4
"14628","1570力肯","110/07/06","玉山-雙和",7,1,6
"14629","1570力肯","110/07/06","華南永昌-斗六",0,4,-4
"14630","1570力肯","110/07/06","永豐金-敦南",9,3,6
"14631","1570力肯","110/07/06","元大-和平",0,4,-4
"14632","6180橘子","110/07/06","凱基-台北",72,12,60
"14633","6180橘子","110/07/06","臺銀-金山",5,105,-100
"14634","6180橘子","110/07/06","美林",29,0,29
"14635","6180橘子","110/07/06","元大-台中",0,100,-100
"14636","6180橘子","110/07/06","合庫-自強",21,0,21
"14637","6180橘子","110/07/06","康和-台南",3,50,-47
"14638","6180橘子","110/07/06","凱基-三峽",17,0,17
"14639","6180橘子","110/07/06","元大-中和",0,35,-35
"14640","6180橘子","110/07/06","富邦-虎尾",15,1,14
"14641","6180橘子","110/07/06","中國信託-忠孝",0,16,-16
"14642","6180橘子","110/07/06","元富-潮州",13,0,13
"14643","6180橘子","110/07/06","玉山-高雄",0,12,-12
"14644","6180橘子","110/07/06","中國信託-永康",13,0,13
"14645","6180橘子","110/07/06","港商野村",0,11,-11
"14646","6180橘子","110/07/06","元大-草屯",18,5,13
"14647","6180橘子","110/07/06","群益金鼎-松山",0,11,-11
"14648","6180橘子","110/07/06","臺銀",11,0,11
"14649","6180橘子","110/07/06","永豐金-豐原",0,11,-11
"14650","6180橘子","110/07/06","新光",15,4,11
"14651","6180橘子","110/07/06","元富-嘉義",5,15,-10
"14652","6180橘子","110/07/06","元大-竹東",11,0,11
"14653","6180橘子","110/07/06","玉山-士林",0,10,-10
"14654","6180橘子","110/07/06","宏遠-台中",10,0,10
"14655","6180橘子","110/07/06","凱基-北門",0,10,-10
"14656","6180橘子","110/07/06","第一金-台南",10,0,10
"14657","6180橘子","110/07/06","第一金-忠孝",0,9,-9
"14658","6180橘子","110/07/06","國泰-敦南",10,0,10
"14659","6180橘子","110/07/06","統一-基隆",0,9,-9
"14660","6180橘子","110/07/06","富邦-嘉義",10,0,10
"14661","6180橘子","110/07/06","安泰-大發",1,10,-9
"14662","2390云辰","110/07/06","元大-天母",975,276,699
"14663","2390云辰","110/07/06","台灣摩根士丹利",3,265,-262
"14664","2390云辰","110/07/06","摩根大通",688,312,376
"14665","2390云辰","110/07/06","群益金鼎-海山",3,166,-163
"14666","2390云辰","110/07/06","國泰-忠孝",164,3,161
"14667","2390云辰","110/07/06","國泰-敦南",188,339,-151
"14668","2390云辰","110/07/06","富邦-北港",140,7,133
"14669","2390云辰","110/07/06","元大-土城學府",12,119,-107
"14670","2390云辰","110/07/06","聯邦商銀",151,22,129
"14671","2390云辰","110/07/06","永豐金-高雄",4,103,-99
"14672","2390云辰","110/07/06","中國信託-文心",143,17,126
"14673","2390云辰","110/07/06","土銀-士林",0,94,-94
"14674","2390云辰","110/07/06","永豐金-中正",133,7,126
"14675","2390云辰","110/07/06","元大-佳里",11,91,-80
"14676","2390云辰","110/07/06","群益金鼎-大興",178,76,102
"14677","2390云辰","110/07/06","玉山-台中",10,86,-76
"14678","2390云辰","110/07/06","元富-中港",103,3,100
"14679","2390云辰","110/07/06","新光",251,324,-73
"14680","2390云辰","110/07/06","統一-新台中",104,12,92
"14681","2390云辰","110/07/06","富邦-敦南",29,101,-72
"14682","2390云辰","110/07/06","新加坡商瑞銀",211,120,91
"14683","2390云辰","110/07/06","兆豐-台中",0,58,-58
"14684","2390云辰","110/07/06","兆豐-忠孝",100,11,89
"14685","2390云辰","110/07/06","日盛證券",16,73,-57
"14686","2390云辰","110/07/06","凱基-林口",87,9,78
"14687","2390云辰","110/07/06","元大-東泰",5,61,-56
"14688","2390云辰","110/07/06","元富-西松",72,4,68
"14689","2390云辰","110/07/06","台新證券",136,190,-54
"14690","2390云辰","110/07/06","台新-左楠",66,9,57
"14691","2390云辰","110/07/06","元大-六合",10,63,-53
