"","stake","date","name","buy","sell","total"
"1","2834臺企銀","110/09/03","凱基-台北",6916,1284,5632
"2","2834臺企銀","110/09/03","新加坡商瑞銀",141,10693,-10552
"3","2834臺企銀","110/09/03","摩根大通",2831,187,2644
"4","2834臺企銀","110/09/03","新光-台中",69,1833,-1764
"5","2834臺企銀","110/09/03","花旗環球",1989,0,1989
"6","2834臺企銀","110/09/03","永豐金-彰化",0,1201,-1201
"7","2834臺企銀","110/09/03","港商法國興業",1852,0,1852
"8","2834臺企銀","110/09/03","元富-城東",0,1155,-1155
"9","2834臺企銀","110/09/03","港商野村",1704,220,1484
"10","2834臺企銀","110/09/03","台灣摩根士丹利",664,1433,-769
"11","2834臺企銀","110/09/03","日盛證券",1112,12,1100
"12","2834臺企銀","110/09/03","元大-蘆洲",92,716,-624
"13","2834臺企銀","110/09/03","美商高盛",724,77,647
"14","2834臺企銀","110/09/03","臺銀-臺南",11,630,-619
"15","2834臺企銀","110/09/03","元大-竹南",611,12,599
"16","2834臺企銀","110/09/03","華南永昌-麻豆",26,497,-471
"17","2834臺企銀","110/09/03","中國信託-文心",529,2,527
"18","2834臺企銀","110/09/03","統一-板橋",150,600,-450
"19","2834臺企銀","110/09/03","新光",758,240,518
"20","2834臺企銀","110/09/03","凱基-高美館",3,342,-339
"21","2834臺企銀","110/09/03","瑞士信貸",4566,4083,483
"22","2834臺企銀","110/09/03","日盛-新莊",0,306,-306
"23","2834臺企銀","110/09/03","元大-大里",564,106,458
"24","2834臺企銀","110/09/03","元富-松德",7,303,-296
"25","2834臺企銀","110/09/03","元富-虎尾",420,1,419
"26","2834臺企銀","110/09/03","第一金-忠孝",2,284,-282
"27","2834臺企銀","110/09/03","華南永昌-嘉義",402,0,402
"28","2834臺企銀","110/09/03","永豐金-中和",0,282,-282
"29","2834臺企銀","110/09/03","永豐金-埔里",406,21,385
"30","2834臺企銀","110/09/03","臺銀-民權",43,292,-249
"31","5511德昌","110/09/03","永豐金-內湖",35,0,35
"32","5511德昌","110/09/03","寶盛",0,30,-30
"33","5511德昌","110/09/03","華南永昌-忠孝",25,0,25
"34","5511德昌","110/09/03","第一金-台中",0,15,-15
"35","5511德昌","110/09/03","統一-士林",24,0,24
"36","5511德昌","110/09/03","康和-內湖",0,10,-10
"37","5511德昌","110/09/03","永豐金-市政",7,0,7
"38","5511德昌","110/09/03","玉山-台南",0,5,-5
"39","5511德昌","110/09/03","凱基-台北",5,0,5
"40","5511德昌","110/09/03","致和-崇德",0,5,-5
"41","5511德昌","110/09/03","兆豐-南京",3,0,3
"42","5511德昌","110/09/03","大昌",0,4,-4
"43","5511德昌","110/09/03","摩根大通",1,0,1
"44","5511德昌","110/09/03","凱基-復興",0,3,-3
"45","5511德昌","110/09/03","元大-清水",1,0,1
"46","5511德昌","110/09/03","永豐金-台南",0,3,-3
"47","5511德昌","110/09/03","元富-城中",0,0,0
"48","5511德昌","110/09/03","群益金鼎-海山",0,2,-2
"49","5511德昌","110/09/03","元富-中原",0,0,0
"50","5511德昌","110/09/03","富邦-建國",0,2,-2
"51","5511德昌","110/09/03","大昌-新竹",0,0,0
"52","5511德昌","110/09/03","元大-新盛",0,2,-2
"53","5511德昌","110/09/03","國票-南崁",0,0,0
"54","5511德昌","110/09/03","元大-新莊",0,2,-2
"55","5511德昌","110/09/03","台新-屏東",0,0,0
"56","5511德昌","110/09/03","永豐金-中壢",0,2,-2
"57","5511德昌","110/09/03","凱基-文心",0,0,0
"58","5511德昌","110/09/03","永豐金-三重",0,2,-2
"59","5511德昌","110/09/03","元大-沙鹿",0,0,0
"60","5511德昌","110/09/03","兆豐-城中",0,1,-1
"61","2489瑞軒","110/09/03","元大-豐原",137,0,137
"62","2489瑞軒","110/09/03","台新-高雄",1,155,-154
"63","2489瑞軒","110/09/03","瑞士信貸",136,0,136
"64","2489瑞軒","110/09/03","美商高盛",0,101,-101
"65","2489瑞軒","110/09/03","群益金鼎-大安",130,0,130
"66","2489瑞軒","110/09/03","兆豐-岡山",0,100,-100
"67","2489瑞軒","110/09/03","摩根大通",142,17,125
"68","2489瑞軒","110/09/03","合庫-桃園",0,60,-60
"69","2489瑞軒","110/09/03","美林",164,86,78
"70","2489瑞軒","110/09/03","元大-東泰",0,60,-60
"71","2489瑞軒","110/09/03","台灣摩根士丹利",74,13,61
"72","2489瑞軒","110/09/03","康和-台中",0,51,-51
"73","2489瑞軒","110/09/03","華南永昌-忠孝",60,0,60
"74","2489瑞軒","110/09/03","第一金-路竹",0,50,-50
"75","2489瑞軒","110/09/03","富邦-岡山",55,0,55
"76","2489瑞軒","110/09/03","元大-汐止",1,44,-43
"77","2489瑞軒","110/09/03","凱基-台北",152,104,48
"78","2489瑞軒","110/09/03","合庫-台南",0,30,-30
"79","2489瑞軒","110/09/03","花旗環球",46,0,46
"80","2489瑞軒","110/09/03","國票-南科",0,30,-30
"81","2489瑞軒","110/09/03","華南永昌-頭份",37,0,37
"82","2489瑞軒","110/09/03","凱基-中山",0,25,-25
"83","2489瑞軒","110/09/03","元大-歸仁",32,0,32
"84","2489瑞軒","110/09/03","國票-長城",0,24,-24
"85","2489瑞軒","110/09/03","富邦-陽明",30,1,29
"86","2489瑞軒","110/09/03","群益金鼎-民權",0,22,-22
"87","2489瑞軒","110/09/03","日盛-忠孝",25,0,25
"88","2489瑞軒","110/09/03","群益金鼎-潭子",0,22,-22
"89","2489瑞軒","110/09/03","永豐金-中正",28,5,23
"90","2489瑞軒","110/09/03","大慶-富順",0,21,-21
"91","2428興勤","110/09/03","美林",40,0,40
"92","2428興勤","110/09/03","港商麥格理",0,46,-46
"93","2428興勤","110/09/03","台灣摩根士丹利",32,2,30
"94","2428興勤","110/09/03","宏遠-桃園",0,25,-25
"95","2428興勤","110/09/03","摩根大通",31,4,27
"96","2428興勤","110/09/03","永豐金證券",0,12,-12
"97","2428興勤","110/09/03","美商高盛",26,0,26
"98","2428興勤","110/09/03","永豐金-天母",0,12,-12
"99","2428興勤","110/09/03","凱基-台北",27,3,24
"100","2428興勤","110/09/03","國泰證券",0,10,-10
"101","2428興勤","110/09/03","瑞士信貸",18,1,17
"102","2428興勤","110/09/03","凱基-桃園",0,10,-10
"103","2428興勤","110/09/03","新加坡商瑞銀",12,1,11
"104","2428興勤","110/09/03","元大-旗山",0,10,-10
"105","2428興勤","110/09/03","富邦-台南",10,0,10
"106","2428興勤","110/09/03","永豐金-市政",0,10,-10
"107","2428興勤","110/09/03","花旗環球",7,0,7
"108","2428興勤","110/09/03","日盛-花蓮",3,10,-7
"109","2428興勤","110/09/03","日盛-新竹",5,0,5
"110","2428興勤","110/09/03","中國信託",0,7,-7
"111","2428興勤","110/09/03","中國信託-高雄",5,0,5
"112","2428興勤","110/09/03","聯邦-富強",0,6,-6
"113","2428興勤","110/09/03","富邦-仁愛",5,0,5
"114","2428興勤","110/09/03","國票-安和",2,7,-5
"115","2428興勤","110/09/03","永興",4,0,4
"116","2428興勤","110/09/03","元大-鹿港",0,5,-5
"117","2428興勤","110/09/03","兆豐-公益",6,2,4
"118","2428興勤","110/09/03","大昌-桃園",0,4,-4
"119","2428興勤","110/09/03","凱基",3,0,3
"120","2428興勤","110/09/03","台新-台中",1,5,-4
"121","3176基亞","110/09/03","玉山-城中",44,0,44
"122","3176基亞","110/09/03","永豐金-南投",0,67,-67
"123","3176基亞","110/09/03","康和-板橋",25,0,25
"124","3176基亞","110/09/03","台中銀",0,55,-55
"125","3176基亞","110/09/03","第一金-路竹",20,0,20
"126","3176基亞","110/09/03","元大-虎尾",0,25,-25
"127","3176基亞","110/09/03","群益金鼎-板橋",20,0,20
"128","3176基亞","110/09/03","群益金鼎-中壢",0,18,-18
"129","3176基亞","110/09/03","元大-新竹經國",20,0,20
"130","3176基亞","110/09/03","群益金鼎-敦南",0,13,-13
"131","3176基亞","110/09/03","日盛-板橋",17,0,17
"132","3176基亞","110/09/03","日盛-南京",0,10,-10
"133","3176基亞","110/09/03","元富-高雄",12,0,12
"134","3176基亞","110/09/03","元大-南京",0,10,-10
"135","3176基亞","110/09/03","玉山-雙和",10,0,10
"136","3176基亞","110/09/03","富邦-台中",0,9,-9
"137","3176基亞","110/09/03","群益金鼎-大興",10,0,10
"138","3176基亞","110/09/03","宏遠-台南",0,8,-8
"139","3176基亞","110/09/03","日盛-高雄",8,0,8
"140","3176基亞","110/09/03","新光",9,16,-7
"141","3176基亞","110/09/03","富邦-台北",10,2,8
"142","3176基亞","110/09/03","國泰-台中",0,7,-7
"143","3176基亞","110/09/03","日盛-中壢",6,0,6
"144","3176基亞","110/09/03","台灣摩根士丹利",0,6,-6
"145","3176基亞","110/09/03","宏遠-光隆",6,0,6
"146","3176基亞","110/09/03","第一金-新竹",0,6,-6
"147","3176基亞","110/09/03","臺灣企銀-桃園",5,0,5
"148","3176基亞","110/09/03","華南永昌-林口",0,6,-6
"149","3176基亞","110/09/03","日盛-永康",5,0,5
"150","3176基亞","110/09/03","第一金-桃園",0,5,-5
"151","2409友達","110/09/03","永豐金證券",10515,756,9759
"152","2409友達","110/09/03","台灣摩根士丹利",3924,11957,-8033
"153","2409友達","110/09/03","摩根大通",6728,2458,4270
"154","2409友達","110/09/03","元大-前金",33,1976,-1943
"155","2409友達","110/09/03","合庫證券",2441,63,2378
"156","2409友達","110/09/03","港商野村",1517,2516,-999
"157","2409友達","110/09/03","凱基-台北",2289,1219,1070
"158","2409友達","110/09/03","美商高盛",1046,1706,-660
"159","2409友達","110/09/03","瑞士信貸",945,31,914
"160","2409友達","110/09/03","日盛證券",148,796,-648
"161","2409友達","110/09/03","花旗環球",830,0,830
"162","2409友達","110/09/03","華南永昌-忠孝",0,606,-606
"163","2409友達","110/09/03","元大-南屯",896,77,819
"164","2409友達","110/09/03","兆豐-南京",68,580,-512
"165","2409友達","110/09/03","康和-新竹",835,41,794
"166","2409友達","110/09/03","元富-城東",66,563,-497
"167","2409友達","110/09/03","凱基-中山",765,51,714
"168","2409友達","110/09/03","玉山-桃園",20,382,-362
"169","2409友達","110/09/03","元富-安南",705,23,682
"170","2409友達","110/09/03","日盛-永康",198,528,-330
"171","2409友達","110/09/03","宏遠-台中",618,1,617
"172","2409友達","110/09/03","富邦-建國",99,418,-319
"173","2409友達","110/09/03","華南永昌-南京",1042,532,510
"174","2409友達","110/09/03","新光-桃園",92,379,-287
"175","2409友達","110/09/03","玉山-雙和",579,129,450
"176","2409友達","110/09/03","國泰-台中",119,399,-280
"177","2409友達","110/09/03","元大-東泰",376,22,354
"178","2409友達","110/09/03","統一-三重",20,297,-277
"179","2409友達","110/09/03","玉山-高雄",773,437,336
"180","2409友達","110/09/03","國票-台中",14,270,-256
"181","1315達新","110/09/03","凱基-中港",16,0,16
"182","1315達新","110/09/03","摩根大通",3,15,-12
"183","1315達新","110/09/03","凱基",11,0,11
"184","1315達新","110/09/03","富邦-台北",0,7,-7
"185","1315達新","110/09/03","花旗環球",8,0,8
"186","1315達新","110/09/03","國泰-桃園",0,5,-5
"187","1315達新","110/09/03","豐農",8,0,8
"188","1315達新","110/09/03","元大-花蓮",0,4,-4
"189","1315達新","110/09/03","台灣摩根士丹利",5,0,5
"190","1315達新","110/09/03","土銀",0,3,-3
"191","1315達新","110/09/03","元大-文心興安",5,0,5
"192","1315達新","110/09/03","台灣企銀-台中",0,3,-3
"193","1315達新","110/09/03","美林",4,0,4
"194","1315達新","110/09/03","群益金鼎-彰化",0,3,-3
"195","1315達新","110/09/03","美商高盛",4,0,4
"196","1315達新","110/09/03","元大-博愛",0,3,-3
"197","1315達新","110/09/03","凱基-台北",4,1,3
"198","1315達新","110/09/03","臺灣企銀-桃園",0,2,-2
"199","1315達新","110/09/03","凱基-文心",3,0,3
"200","1315達新","110/09/03","統一",0,2,-2
"201","1315達新","110/09/03","亞東-板橋",2,0,2
"202","1315達新","110/09/03","國票-桃園",0,2,-2
"203","1315達新","110/09/03","元大-新店中正",2,0,2
"204","1315達新","110/09/03","台新證券",0,2,-2
"205","1315達新","110/09/03","新加坡商瑞銀",1,0,1
"206","1315達新","110/09/03","富邦-內湖",0,2,-2
"207","1315達新","110/09/03","元富-文心",1,0,1
"208","1315達新","110/09/03","富邦-宜蘭",0,2,-2
"209","1315達新","110/09/03","群益金鼎-板橋",1,0,1
"210","1315達新","110/09/03","元大-南屯",0,2,-2
"211","2609陽明","110/09/03","港商麥格理",610,0,610
"212","2609陽明","110/09/03","富邦證券",308,2406,-2098
"213","2609陽明","110/09/03","永豐金證券",610,65,545
"214","2609陽明","110/09/03","康和",42,2053,-2011
"215","2609陽明","110/09/03","元大-大天母",502,111,391
"216","2609陽明","110/09/03","美林",26,1612,-1586
"217","2609陽明","110/09/03","凱基-復興",2259,1887,372
"218","2609陽明","110/09/03","富邦-新竹",258,1413,-1155
"219","2609陽明","110/09/03","華南永昌-桃園",360,15,345
"220","2609陽明","110/09/03","日盛-雙和",67,1210,-1143
"221","2609陽明","110/09/03","兆豐-板橋",612,330,282
"222","2609陽明","110/09/03","統一",717,1794,-1077
"223","2609陽明","110/09/03","國泰-敦南",1931,1665,266
"224","2609陽明","110/09/03","富邦-虎尾",5084,5917,-833
"225","2609陽明","110/09/03","國票-桃園",277,35,242
"226","2609陽明","110/09/03","新加坡商瑞銀",1267,2013,-746
"227","2609陽明","110/09/03","華南永昌-竹北",1313,1073,240
"228","2609陽明","110/09/03","元富-緯城",140,829,-689
"229","2609陽明","110/09/03","玉山-新莊",419,182,237
"230","2609陽明","110/09/03","美商高盛",340,1019,-679
"231","2609陽明","110/09/03","台中銀",299,65,234
"232","2609陽明","110/09/03","凱基-台北",2120,2780,-660
"233","2609陽明","110/09/03","永豐金-竹科",381,155,226
"234","2609陽明","110/09/03","國泰證券",61,682,-621
"235","2609陽明","110/09/03","玉山-台大",267,47,220
"236","2609陽明","110/09/03","中國信託-新竹",161,673,-512
"237","2609陽明","110/09/03","國票-安和",420,201,219
"238","2609陽明","110/09/03","日盛-大墩",223,708,-485
"239","2609陽明","110/09/03","凱基-彰化",308,94,214
"240","2609陽明","110/09/03","兆豐-三民",109,565,-456
"241","2636台驊投控","110/09/03","摩根大通",610,329,281
"242","2636台驊投控","110/09/03","凱基-復興",33,624,-591
"243","2636台驊投控","110/09/03","統一-新台中",194,12,182
"244","2636台驊投控","110/09/03","富邦證券",0,512,-512
"245","2636台驊投控","110/09/03","第一金-桃園",148,24,124
"246","2636台驊投控","110/09/03","統一",86,544,-458
"247","2636台驊投控","110/09/03","新光",234,145,89
"248","2636台驊投控","110/09/03","元富-嘉義",4,227,-223
"249","2636台驊投控","110/09/03","宏遠-新化",79,1,78
"250","2636台驊投控","110/09/03","兆豐-中壢",2,200,-198
"251","2636台驊投控","110/09/03","國泰-敦南",258,184,74
"252","2636台驊投控","110/09/03","凱基-信義",5,178,-173
"253","2636台驊投控","110/09/03","大慶-中壢",91,18,73
"254","2636台驊投控","110/09/03","華南永昌-朴子",10,148,-138
"255","2636台驊投控","110/09/03","國泰-台中",113,52,61
"256","2636台驊投控","110/09/03","元大-南屯",8,137,-129
"257","2636台驊投控","110/09/03","永豐金-市政",109,52,57
"258","2636台驊投控","110/09/03","國票-安和",8,136,-128
"259","2636台驊投控","110/09/03","國泰-松江",64,8,56
"260","2636台驊投控","110/09/03","國票-南港",7,121,-114
"261","2636台驊投控","110/09/03","永豐金-豐原",67,11,56
"262","2636台驊投控","110/09/03","美林",235,339,-104
"263","2636台驊投控","110/09/03","玉山-南京東路",120,65,55
"264","2636台驊投控","110/09/03","中國信託",21,115,-94
"265","2636台驊投控","110/09/03","群益金鼎-竹南",46,1,45
"266","2636台驊投控","110/09/03","永豐金-嘉義",1,92,-91
"267","2636台驊投控","110/09/03","國泰-忠孝",106,62,44
"268","2636台驊投控","110/09/03","瑞士信貸",0,89,-89
"269","2636台驊投控","110/09/03","玉山-高雄",53,12,41
"270","2636台驊投控","110/09/03","統一-基隆",6,90,-84
"271","2867三商壽","110/09/03","美林",479,40,439
"272","2867三商壽","110/09/03","元大-桃園",30,800,-770
"273","2867三商壽","110/09/03","摩根大通",412,67,345
"274","2867三商壽","110/09/03","日盛-中和",0,301,-301
"275","2867三商壽","110/09/03","台新證券",261,7,254
"276","2867三商壽","110/09/03","新光",22,322,-300
"277","2867三商壽","110/09/03","元大-苑裡",220,0,220
"278","2867三商壽","110/09/03","日盛-頭份",0,100,-100
"279","2867三商壽","110/09/03","兆豐-東門",200,0,200
"280","2867三商壽","110/09/03","新光-新竹",0,100,-100
"281","2867三商壽","110/09/03","凱基",193,0,193
"282","2867三商壽","110/09/03","新光-台中",6,89,-83
"283","2867三商壽","110/09/03","凱基-台北",309,119,190
"284","2867三商壽","110/09/03","元大-永春",0,75,-75
"285","2867三商壽","110/09/03","統一-士林",180,0,180
"286","2867三商壽","110/09/03","玉山-板橋",0,72,-72
"287","2867三商壽","110/09/03","台灣摩根士丹利",183,5,178
"288","2867三商壽","110/09/03","宏遠-高雄",0,64,-64
"289","2867三商壽","110/09/03","花旗環球",142,0,142
"290","2867三商壽","110/09/03","兆豐-新營",0,59,-59
"291","2867三商壽","110/09/03","大展",134,1,133
"292","2867三商壽","110/09/03","群益金鼎-中港",0,51,-51
"293","2867三商壽","110/09/03","瑞士信貸",124,0,124
"294","2867三商壽","110/09/03","群益金鼎-開元",0,50,-50
"295","2867三商壽","110/09/03","台新-台中",102,2,100
"296","2867三商壽","110/09/03","凱基-林口",0,50,-50
"297","2867三商壽","110/09/03","新加坡商瑞銀",60,0,60
"298","2867三商壽","110/09/03","國泰-台中",5,53,-48
"299","2867三商壽","110/09/03","元大-前金",60,0,60
"300","2867三商壽","110/09/03","宏遠-台中",0,44,-44
"301","5521工信","110/09/03","摩根大通",434,12,422
"302","5521工信","110/09/03","元大-成功",0,185,-185
"303","5521工信","110/09/03","美林",175,1,174
"304","5521工信","110/09/03","光和-溪湖",5,155,-150
"305","5521工信","110/09/03","台新證券",175,29,146
"306","5521工信","110/09/03","富邦-員林",2,108,-106
"307","5521工信","110/09/03","康和-澎湖",110,0,110
"308","5521工信","110/09/03","日盛-板橋中山",0,103,-103
"309","5521工信","110/09/03","瑞士信貸",77,0,77
"310","5521工信","110/09/03","大慶",0,100,-100
"311","5521工信","110/09/03","美商高盛",72,0,72
"312","5521工信","110/09/03","富邦-南屯",0,100,-100
"313","5521工信","110/09/03","港商法國興業",72,0,72
"314","5521工信","110/09/03","國泰-高雄",7,100,-93
"315","5521工信","110/09/03","光和-花壇",60,0,60
"316","5521工信","110/09/03","凱基-台北",620,701,-81
"317","5521工信","110/09/03","第一金-豐原",50,0,50
"318","5521工信","110/09/03","凱基-斗六",0,73,-73
"319","5521工信","110/09/03","玉山-左營",50,2,48
"320","5521工信","110/09/03","元大-林森",1,68,-67
"321","5521工信","110/09/03","港商野村",45,0,45
"322","5521工信","110/09/03","元富-板橋",0,64,-64
"323","5521工信","110/09/03","富邦-台北",51,14,37
"324","5521工信","110/09/03","華南永昌-民權",0,50,-50
"325","5521工信","110/09/03","(牛牛牛)亞-鑫豐",45,13,32
"326","5521工信","110/09/03","元大證券",0,50,-50
"327","5521工信","110/09/03","群益金鼎-萬華",27,0,27
"328","5521工信","110/09/03","元大-大里德芳",0,50,-50
"329","5521工信","110/09/03","台灣摩根士丹利",39,16,23
"330","5521工信","110/09/03","兆豐-三民",0,43,-43
"331","1471首利","110/09/03","台新-松江",39,0,39
"332","1471首利","110/09/03","元大-路竹",0,121,-121
"333","1471首利","110/09/03","元大-西門",27,0,27
"334","1471首利","110/09/03","日盛-文化",0,50,-50
"335","1471首利","110/09/03","富邦-新竹",22,0,22
"336","1471首利","110/09/03","大慶-蘆洲",0,20,-20
"337","1471首利","110/09/03","日盛-景美",20,0,20
"338","1471首利","110/09/03","摩根大通",14,29,-15
"339","1471首利","110/09/03","日盛-大墩",18,0,18
"340","1471首利","110/09/03","聯邦-高雄",0,14,-14
"341","1471首利","110/09/03","元富-民權",15,0,15
"342","1471首利","110/09/03","臺銀",1,14,-13
"343","1471首利","110/09/03","群益金鼎-桃園",15,0,15
"344","1471首利","110/09/03","臺銀-臺中",0,11,-11
"345","1471首利","110/09/03","凱基-三多",15,0,15
"346","1471首利","110/09/03","兆豐-麻豆",0,10,-10
"347","1471首利","110/09/03","兆豐-桃園",14,0,14
"348","1471首利","110/09/03","兆豐-高雄",0,10,-10
"349","1471首利","110/09/03","統一-新台中",13,0,13
"350","1471首利","110/09/03","國票-嘉義",0,10,-10
"351","1471首利","110/09/03","花旗環球",11,0,11
"352","1471首利","110/09/03","聯邦-大業",0,10,-10
"353","1471首利","110/09/03","凱基-東勢",10,0,10
"354","1471首利","110/09/03","華南永昌-鳳山",0,10,-10
"355","1471首利","110/09/03","華南永昌-公誠",10,0,10
"356","1471首利","110/09/03","富邦-嘉義",0,10,-10
"357","1471首利","110/09/03","元大-鳳山",10,0,10
"358","1471首利","110/09/03","元大-楊梅",0,10,-10
"359","1471首利","110/09/03","國泰-敦南",12,3,9
"360","1471首利","110/09/03","元富-宜蘭",1,10,-9
"361","2883開發金","110/09/03","凱基-台北",2700,224,2476
"362","2883開發金","110/09/03","國泰證券",41,2505,-2464
"363","2883開發金","110/09/03","美商高盛",1463,120,1343
"364","2883開發金","110/09/03","台灣摩根士丹利",981,3375,-2394
"365","2883開發金","110/09/03","新加坡商瑞銀",1717,492,1225
"366","2883開發金","110/09/03","亞東-新竹",1,1198,-1197
"367","2883開發金","110/09/03","美林",1358,164,1194
"368","2883開發金","110/09/03","富邦-內湖",60,1193,-1133
"369","2883開發金","110/09/03","花旗環球",1093,0,1093
"370","2883開發金","110/09/03","華南永昌-竹北",0,859,-859
"371","2883開發金","110/09/03","元大-林森",805,1,804
"372","2883開發金","110/09/03","富邦-台北",24,613,-589
"373","2883開發金","110/09/03","摩根大通",941,308,633
"374","2883開發金","110/09/03","元大-四維",4,530,-526
"375","2883開發金","110/09/03","凱基-中壢",656,28,628
"376","2883開發金","110/09/03","第一金-豐原",12,404,-392
"377","2883開發金","110/09/03","玉山證券",706,97,609
"378","2883開發金","110/09/03","元大-苗栗",0,386,-386
"379","2883開發金","110/09/03","港商野村",757,239,518
"380","2883開發金","110/09/03","亞東-台中",0,321,-321
"381","2883開發金","110/09/03","永豐金-台南",447,10,437
"382","2883開發金","110/09/03","新光-台南",58,377,-319
"383","2883開發金","110/09/03","法銀巴黎",434,0,434
"384","2883開發金","110/09/03","康和-延平",1,300,-299
"385","2883開發金","110/09/03","元大-成功",475,46,429
"386","2883開發金","110/09/03","國泰-新莊",4,278,-274
"387","2883開發金","110/09/03","元大-民雄",310,3,307
"388","2883開發金","110/09/03","國泰-敦南",125,383,-258
"389","2883開發金","110/09/03","臺銀-鳳山",321,19,302
"390","2883開發金","110/09/03","國泰-館前",52,293,-241
"391","6205詮欣","110/09/03","元大-汐止",16,3,13
"392","6205詮欣","110/09/03","元大-中和",0,26,-26
"393","6205詮欣","110/09/03","美林",9,0,9
"394","6205詮欣","110/09/03","日盛-木柵",0,6,-6
"395","6205詮欣","110/09/03","摩根大通",8,0,8
"396","6205詮欣","110/09/03","元富-花蓮",0,5,-5
"397","6205詮欣","110/09/03","凱基-台北",6,0,6
"398","6205詮欣","110/09/03","華南永昌-東昇",0,5,-5
"399","6205詮欣","110/09/03","新光",5,0,5
"400","6205詮欣","110/09/03","元大-基隆孝二",0,5,-5
"401","6205詮欣","110/09/03","永豐金證券",5,0,5
"402","6205詮欣","110/09/03","富邦-板橋",0,4,-4
"403","6205詮欣","110/09/03","瑞士信貸",4,0,4
"404","6205詮欣","110/09/03","永豐金-新竹",0,4,-4
"405","6205詮欣","110/09/03","花旗環球",4,0,4
"406","6205詮欣","110/09/03","亞東",0,2,-2
"407","6205詮欣","110/09/03","玉山-城中",3,0,3
"408","6205詮欣","110/09/03","光和",0,2,-2
"409","6205詮欣","110/09/03","元大-崇德",3,0,3
"410","6205詮欣","110/09/03","兆豐-台中",0,2,-2
"411","6205詮欣","110/09/03","元大-新店中正",3,0,3
"412","6205詮欣","110/09/03","兆豐-岡山",0,2,-2
"413","6205詮欣","110/09/03","日盛-新莊",2,0,2
"414","6205詮欣","110/09/03","富邦-仁愛",0,2,-2
"415","6205詮欣","110/09/03","新光-桃園",3,1,2
"416","6205詮欣","110/09/03","第一金-新興",0,1,-1
"417","6205詮欣","110/09/03","凱基",2,0,2
"418","6205詮欣","110/09/03","元富-同大",0,1,-1
"419","6205詮欣","110/09/03","元大-大安",2,0,2
"420","6205詮欣","110/09/03","元富-桃園",0,1,-1
"421","1540喬福","110/09/03","國票-台南",6,0,6
"422","1540喬福","110/09/03","亞東-高雄",0,6,-6
"423","1540喬福","110/09/03","群益金鼎-館前",6,0,6
"424","1540喬福","110/09/03","元大-龍潭",0,6,-6
"425","1540喬福","110/09/03","凱基",6,0,6
"426","1540喬福","110/09/03","兆豐-鹿港",0,3,-3
"427","1540喬福","110/09/03","花旗環球",5,0,5
"428","1540喬福","110/09/03","群益金鼎-永和",0,2,-2
"429","1540喬福","110/09/03","元大-鳳中",1,0,1
"430","1540喬福","110/09/03","永豐金-忠孝",0,1,-1
"431","1540喬福","110/09/03","元大-土城永寧",1,0,1
"432","1540喬福","110/09/03","美林",0,1,-1
"433","1540喬福","110/09/03","日盛-土城",1,1,0
"434","1540喬福","110/09/03","元富",0,1,-1
"435","1540喬福","110/09/03","新光",0,0,0
"436","1540喬福","110/09/03","元富-虎尾",0,1,-1
"437","1540喬福","110/09/03","玉山-台中",0,0,0
"438","1540喬福","110/09/03","中國信託-新竹",0,1,-1
"439","1540喬福","110/09/03","國泰-敦南",0,0,0
"440","1540喬福","110/09/03","新光-新竹",0,1,-1
"441","1540喬福","110/09/03","群益金鼎-北高雄",0,0,0
"442","1540喬福","110/09/03","土銀-和平",0,1,-1
"443","1540喬福","110/09/03","華南永昌-高雄",0,0,0
"444","1540喬福","110/09/03","元大-台北",0,1,-1
"445","1540喬福","110/09/03","華南永昌-苗栗",0,0,0
"446","1540喬福","110/09/03","群益金鼎-台中",0,1,-1
"447","1540喬福","110/09/03","富邦-北港",0,0,0
"448","1540喬福","110/09/03","國泰-敦南",0,0,0
"449","1540喬福","110/09/03","元大-新竹經國",0,0,0
"450","1540喬福","110/09/03","元大-新竹經國",0,0,0
"451","2888新光金","110/09/03","元大-館前",4899,31,4868
"452","2888新光金","110/09/03","永豐金證券",17,2041,-2024
"453","2888新光金","110/09/03","摩根大通",2598,419,2179
"454","2888新光金","110/09/03","元大證券",32,1634,-1602
"455","2888新光金","110/09/03","美林",2132,22,2110
"456","2888新光金","110/09/03","瑞士信貸",706,1308,-602
"457","2888新光金","110/09/03","永豐金-板橋",2028,227,1801
"458","2888新光金","110/09/03","群益金鼎-台中",8,554,-546
"459","2888新光金","110/09/03","凱基-台北",2476,1063,1413
"460","2888新光金","110/09/03","元大-大甲",18,557,-539
"461","2888新光金","110/09/03","花旗環球",1073,0,1073
"462","2888新光金","110/09/03","宏遠-桃園",0,520,-520
"463","2888新光金","110/09/03","新加坡商瑞銀",936,0,936
"464","2888新光金","110/09/03","日盛-雙和",2,515,-513
"465","2888新光金","110/09/03","凱基",789,0,789
"466","2888新光金","110/09/03","統一-台中",101,595,-494
"467","2888新光金","110/09/03","元大-苑裡",512,1,511
"468","2888新光金","110/09/03","國票-嘉義",5,407,-402
"469","2888新光金","110/09/03","(牛牛牛)亞-鑫豐",570,231,339
"470","2888新光金","110/09/03","元大-景美",8,372,-364
"471","2888新光金","110/09/03","元大-彰化民生",413,104,309
"472","2888新光金","110/09/03","永全-南崁",0,361,-361
"473","2888新光金","110/09/03","台新-新營",318,13,305
"474","2888新光金","110/09/03","新光",273,603,-330
"475","2888新光金","110/09/03","法銀巴黎",300,0,300
"476","2888新光金","110/09/03","凱基-頭份",0,303,-303
"477","2888新光金","110/09/03","日進",300,8,292
"478","2888新光金","110/09/03","合庫證券",60,335,-275
"479","2888新光金","110/09/03","台灣摩根士丹利",494,257,237
"480","2888新光金","110/09/03","統一-板橋",112,361,-249
"481","1340勝悅","110/09/03","元大-前金",63,0,63
"482","1340勝悅","110/09/03","台中銀",0,26,-26
"483","1340勝悅","110/09/03","玉山-新竹",20,0,20
"484","1340勝悅","110/09/03","元大-忠孝鼎富",0,15,-15
"485","1340勝悅","110/09/03","摩根大通",13,3,10
"486","1340勝悅","110/09/03","統一-宜蘭",0,11,-11
"487","1340勝悅","110/09/03","花旗環球",7,0,7
"488","1340勝悅","110/09/03","合庫-西台中",0,10,-10
"489","1340勝悅","110/09/03","港商法國興業",6,0,6
"490","1340勝悅","110/09/03","大昌-新店",0,10,-10
"491","1340勝悅","110/09/03","瑞士信貸",4,0,4
"492","1340勝悅","110/09/03","宏遠-桃園",0,8,-8
"493","1340勝悅","110/09/03","凱基-台北",5,1,4
"494","1340勝悅","110/09/03","(牛牛牛)亞-鑫豐",0,7,-7
"495","1340勝悅","110/09/03","美商高盛",3,0,3
"496","1340勝悅","110/09/03","玉山-桃園",0,7,-7
"497","1340勝悅","110/09/03","大昌-樹林",3,0,3
"498","1340勝悅","110/09/03","凱基-北門",0,7,-7
"499","1340勝悅","110/09/03","凱基",3,0,3
"500","1340勝悅","110/09/03","新光",1,7,-6
"501","1340勝悅","110/09/03","元大-大雅",3,0,3
"502","1340勝悅","110/09/03","統一-城中",0,5,-5
"503","1340勝悅","110/09/03","元大-和平",3,0,3
"504","1340勝悅","110/09/03","富邦-陽明",0,4,-4
"505","1340勝悅","110/09/03","中國信託-文心",2,0,2
"506","1340勝悅","110/09/03","元大-敦南",0,4,-4
"507","1340勝悅","110/09/03","凱基-湖口",2,0,2
"508","1340勝悅","110/09/03","日盛-員林",1,4,-3
"509","1340勝悅","110/09/03","富邦-北港",2,0,2
"510","1340勝悅","110/09/03","國泰-敦南",1,4,-3
"511","6246臺龍","110/09/03","富邦-新竹",11,0,11
"512","6246臺龍","110/09/03","元富-新店",0,11,-11
"513","6246臺龍","110/09/03","統一-土城",9,1,8
"514","6246臺龍","110/09/03","大慶-苗栗",0,8,-8
"515","6246臺龍","110/09/03","群益金鼎-古亭",7,0,7
"516","6246臺龍","110/09/03","港商野村",1,8,-7
"517","6246臺龍","110/09/03","凱基-台北",5,0,5
"518","6246臺龍","110/09/03","華南永昌-彰化",0,6,-6
"519","6246臺龍","110/09/03","元富-屏東",4,0,4
"520","6246臺龍","110/09/03","群益金鼎-永和",0,5,-5
"521","6246臺龍","110/09/03","日盛-大墩",3,0,3
"522","6246臺龍","110/09/03","富邦-彰化",0,5,-5
"523","6246臺龍","110/09/03","元富-台中",3,0,3
"524","6246臺龍","110/09/03","華南永昌-楠梓",0,4,-4
"525","6246臺龍","110/09/03","元大-台中中港",3,0,3
"526","6246臺龍","110/09/03","中國信託-永康",0,2,-2
"527","6246臺龍","110/09/03","永豐金-苓雅",3,0,3
"528","6246臺龍","110/09/03","臺銀-金山",0,1,-1
"529","6246臺龍","110/09/03","日盛-中和",1,0,1
"530","6246臺龍","110/09/03","第一金-台南",0,1,-1
"531","6246臺龍","110/09/03","盈溢-楠梓",1,0,1
"532","6246臺龍","110/09/03","兆豐-岡山",0,1,-1
"533","6246臺龍","110/09/03","兆豐-新營",1,0,1
"534","6246臺龍","110/09/03","台新-台中",0,1,-1
"535","6246臺龍","110/09/03","台新-屏東",2,1,1
"536","6246臺龍","110/09/03","國泰-桃園",0,1,-1
"537","6246臺龍","110/09/03","玉山證券",1,0,1
"538","6246臺龍","110/09/03","群益金鼎-東門",0,1,-1
"539","6246臺龍","110/09/03","玉山-嘉義",1,0,1
"540","6246臺龍","110/09/03","華南永昌",0,1,-1
"541","00715L期街口布蘭特正2","110/09/03","元大證券",14101,122,13979
"542","00715L期街口布蘭特正2","110/09/03","第一金-台中",2,4435,-4433
"543","00715L期街口布蘭特正2","110/09/03","永豐金證券",6178,185,5993
"544","00715L期街口布蘭特正2","110/09/03","豐農",0,1100,-1100
"545","00715L期街口布蘭特正2","110/09/03","群益金鼎",4720,0,4720
"546","00715L期街口布蘭特正2","110/09/03","國泰-板橋",0,1068,-1068
"547","00715L期街口布蘭特正2","110/09/03","凱基-台北",3427,108,3319
"548","00715L期街口布蘭特正2","110/09/03","群益金鼎-士林",0,900,-900
"549","00715L期街口布蘭特正2","110/09/03","國票",2729,7,2722
"550","00715L期街口布蘭特正2","110/09/03","元大-復北",0,890,-890
"551","00715L期街口布蘭特正2","110/09/03","凱基-市政",2138,7,2131
"552","00715L期街口布蘭特正2","110/09/03","永豐金-羅東",0,734,-734
"553","00715L期街口布蘭特正2","110/09/03","富邦證券",1801,266,1535
"554","00715L期街口布蘭特正2","110/09/03","群益金鼎-板橋",0,720,-720
"555","00715L期街口布蘭特正2","110/09/03","永豐金-內湖",1500,0,1500
"556","00715L期街口布蘭特正2","110/09/03","群益金鼎-宜蘭",0,707,-707
"557","00715L期街口布蘭特正2","110/09/03","元富",1509,29,1480
"558","00715L期街口布蘭特正2","110/09/03","日盛-新莊",0,666,-666
"559","00715L期街口布蘭特正2","110/09/03","合庫證券",1190,9,1181
"560","00715L期街口布蘭特正2","110/09/03","群益金鼎-大甲",14,652,-638
"561","00715L期街口布蘭特正2","110/09/03","國票-中港",1000,40,960
"562","00715L期街口布蘭特正2","110/09/03","日盛-和美",6,616,-610
"563","00715L期街口布蘭特正2","110/09/03","康和",957,0,957
"564","00715L期街口布蘭特正2","110/09/03","元大-大灣",0,599,-599
"565","00715L期街口布蘭特正2","110/09/03","統一",720,9,711
"566","00715L期街口布蘭特正2","110/09/03","中國信託-新竹",0,460,-460
"567","00715L期街口布蘭特正2","110/09/03","永豐金-三重",625,1,624
"568","00715L期街口布蘭特正2","110/09/03","玉山-高雄",25,478,-453
"569","00715L期街口布蘭特正2","110/09/03","永豐金-博愛",500,20,480
"570","00715L期街口布蘭特正2","110/09/03","宏遠-光隆",0,435,-435
"571","8941關中","110/09/03","元大-士林",2,0,2
"572","8941關中","110/09/03","彰銀-台中",0,1,-1
"573","8941關中","110/09/03","國泰-新莊",1,0,1
"574","8941關中","110/09/03","玉山-桃園",0,1,-1
"575","8941關中","110/09/03","凱基-虎尾",1,0,1
"576","8941關中","110/09/03","元大-豐原",0,1,-1
"577","8941關中","110/09/03","國泰-高雄",0,0,0
"578","8941關中","110/09/03","元大-金華",0,1,-1
"579","8941關中","110/09/03","元大-斗信",0,0,0
"580","8941關中","110/09/03","國泰-高雄",0,0,0
"581","8941關中","110/09/03","元大-鹿港",0,0,0
"582","8941關中","110/09/03","元大-斗信",0,0,0
"583","8941關中","110/09/03","",NA,NA,NA
"584","8941關中","110/09/03","元大-鹿港",0,0,0
"585","8941關中","110/09/03","",NA,NA,NA
"586","8941關中","110/09/03","",NA,NA,NA
"587","8941關中","110/09/03","",NA,NA,NA
"588","8941關中","110/09/03","",NA,NA,NA
"589","8941關中","110/09/03","",NA,NA,NA
"590","8941關中","110/09/03","",NA,NA,NA
"591","8941關中","110/09/03","",NA,NA,NA
"592","8941關中","110/09/03","",NA,NA,NA
"593","8941關中","110/09/03","",NA,NA,NA
"594","8941關中","110/09/03","",NA,NA,NA
"595","8941關中","110/09/03","",NA,NA,NA
"596","8941關中","110/09/03","",NA,NA,NA
"597","8941關中","110/09/03","",NA,NA,NA
"598","8941關中","110/09/03","",NA,NA,NA
"599","8941關中","110/09/03","",NA,NA,NA
"600","8941關中","110/09/03","",NA,NA,NA
"601","8936國統","110/09/03","華南永昌-高雄",405,0,405
"602","8936國統","110/09/03","美商高盛",24,188,-164
"603","8936國統","110/09/03","凱基-台北",306,200,106
"604","8936國統","110/09/03","台新證券",8,165,-157
"605","8936國統","110/09/03","第一金-路竹",85,0,85
"606","8936國統","110/09/03","摩根大通",65,214,-149
"607","8936國統","110/09/03","凱基-信義",54,0,54
"608","8936國統","110/09/03","瑞士信貸",0,105,-105
"609","8936國統","110/09/03","康和-高雄",41,0,41
"610","8936國統","110/09/03","新加坡商瑞銀",115,216,-101
"611","8936國統","110/09/03","元大-東泰",61,24,37
"612","8936國統","110/09/03","合庫-自強",0,100,-100
"613","8936國統","110/09/03","日盛-北高雄",40,5,35
"614","8936國統","110/09/03","國泰-高雄",2,100,-98
"615","8936國統","110/09/03","台新-高雄",36,10,26
"616","8936國統","110/09/03","合庫-高雄",1,95,-94
"617","8936國統","110/09/03","統一-新台中",27,2,25
"618","8936國統","110/09/03","國票-北高雄",2,90,-88
"619","8936國統","110/09/03","永豐金-竹科",22,0,22
"620","8936國統","110/09/03","中國信託-高雄",13,100,-87
"621","8936國統","110/09/03","元大-博愛",22,1,21
"622","8936國統","110/09/03","港商野村",91,173,-82
"623","8936國統","110/09/03","元大-鳳山",22,1,21
"624","8936國統","110/09/03","元富-敦南",17,92,-75
"625","8936國統","110/09/03","統一-桃園",20,0,20
"626","8936國統","110/09/03","元大-高雄",2,50,-48
"627","8936國統","110/09/03","元富-林園",20,0,20
"628","8936國統","110/09/03","元大-莒光",2,49,-47
"629","8936國統","110/09/03","元富-緯城",25,5,20
"630","8936國統","110/09/03","光和-溪湖",3,44,-41
"631","6226光鼎","110/09/03","台新-台中",348,25,323
"632","6226光鼎","110/09/03","合庫-台中",0,229,-229
"633","6226光鼎","110/09/03","摩根大通",251,83,168
"634","6226光鼎","110/09/03","大展-台南",0,130,-130
"635","6226光鼎","110/09/03","美林",203,44,159
"636","6226光鼎","110/09/03","台新-左楠",0,110,-110
"637","6226光鼎","110/09/03","美商高盛",158,11,147
"638","6226光鼎","110/09/03","玉山-士林",8,62,-54
"639","6226光鼎","110/09/03","凱基-台北",141,41,100
"640","6226光鼎","110/09/03","群益金鼎-開元",31,83,-52
"641","6226光鼎","110/09/03","臺銀-新竹",72,1,71
"642","6226光鼎","110/09/03","群益金鼎-西松",1,50,-49
"643","6226光鼎","110/09/03","大慶-富順",60,0,60
"644","6226光鼎","110/09/03","元大-板橋三民",14,61,-47
"645","6226光鼎","110/09/03","凱基-岡山",60,1,59
"646","6226光鼎","110/09/03","統一-竹南",1,47,-46
"647","6226光鼎","110/09/03","第一金-桃園",52,0,52
"648","6226光鼎","110/09/03","日盛-新竹",1,41,-40
"649","6226光鼎","110/09/03","新加坡商瑞銀",59,9,50
"650","6226光鼎","110/09/03","元大-員林中山",12,47,-35
"651","6226光鼎","110/09/03","元大-中壢",70,24,46
"652","6226光鼎","110/09/03","國泰-館前",35,67,-32
"653","6226光鼎","110/09/03","元大-新營",46,4,42
"654","6226光鼎","110/09/03","元大-新莊",4,35,-31
"655","6226光鼎","110/09/03","華南永昌-世貿",42,1,41
"656","6226光鼎","110/09/03","元富-敦南",0,30,-30
"657","6226光鼎","110/09/03","群益金鼎-新竹",38,0,38
"658","6226光鼎","110/09/03","群益金鼎-台北",6,36,-30
"659","6226光鼎","110/09/03","元大-路竹",38,2,36
"660","6226光鼎","110/09/03","元大-大雅",5,34,-29
"661","2363矽統","110/09/03","凱基-松山",21948,12385,9563
"662","2363矽統","110/09/03","元大-前金",139,785,-646
"663","2363矽統","110/09/03","台灣摩根士丹利",5089,3,5086
"664","2363矽統","110/09/03","國泰-敦南",1244,1857,-613
"665","2363矽統","110/09/03","統一",4355,245,4110
"666","2363矽統","110/09/03","新光",893,1469,-576
"667","2363矽統","110/09/03","摩根大通",5484,2094,3390
"668","2363矽統","110/09/03","統一-南京",33,497,-464
"669","2363矽統","110/09/03","凱基-台北",5687,3262,2425
"670","2363矽統","110/09/03","永豐金-竹科",24,456,-432
"671","2363矽統","110/09/03","美商高盛",1980,496,1484
"672","2363矽統","110/09/03","元大-佳里",77,479,-402
"673","2363矽統","110/09/03","瑞士信貸",1319,12,1307
"674","2363矽統","110/09/03","群益金鼎-士林",103,503,-400
"675","2363矽統","110/09/03","統一-土城",1030,41,989
"676","2363矽統","110/09/03","富邦-彰化",33,393,-360
"677","2363矽統","110/09/03","日盛-文化",1068,94,974
"678","2363矽統","110/09/03","華南永昌-公誠",101,459,-358
"679","2363矽統","110/09/03","凱基-大直",1064,92,972
"680","2363矽統","110/09/03","台新-左楠",85,441,-356
"681","2363矽統","110/09/03","新加坡商瑞銀",1692,905,787
"682","2363矽統","110/09/03","日盛-和美",64,387,-323
"683","2363矽統","110/09/03","富邦-北港",921,155,766
"684","2363矽統","110/09/03","光和-和美",7,324,-317
"685","2363矽統","110/09/03","康和",1172,512,660
"686","2363矽統","110/09/03","富邦-新竹",198,503,-305
"687","2363矽統","110/09/03","美林",717,85,632
"688","2363矽統","110/09/03","凱基-士林",68,364,-296
"689","2363矽統","110/09/03","永豐金證券",1674,1126,548
"690","2363矽統","110/09/03","永豐金-南投",60,355,-295
"691","8112至上","110/09/03","凱基-台北",204,76,128
"692","8112至上","110/09/03","元大-信義",0,185,-185
"693","8112至上","110/09/03","美林",146,20,126
"694","8112至上","110/09/03","富邦-北港",0,70,-70
"695","8112至上","110/09/03","瑞士信貸",78,0,78
"696","8112至上","110/09/03","華南永昌-鳳山",0,54,-54
"697","8112至上","110/09/03","國票-南京",45,0,45
"698","8112至上","110/09/03","富邦-新竹",2,49,-47
"699","8112至上","110/09/03","永豐金-竹科",36,0,36
"700","8112至上","110/09/03","臺灣企銀-桃園",1,45,-44
"701","8112至上","110/09/03","群益金鼎-士林",25,0,25
"702","8112至上","110/09/03","元大-北港",8,48,-40
"703","8112至上","110/09/03","凱基-長庚",25,0,25
"704","8112至上","110/09/03","國票-九鼎",0,34,-34
"705","8112至上","110/09/03","美商高盛",23,1,22
"706","8112至上","110/09/03","摩根大通",85,119,-34
"707","8112至上","110/09/03","元富-古亭",20,0,20
"708","8112至上","110/09/03","中國信託",0,20,-20
"709","8112至上","110/09/03","凱基-文心",20,0,20
"710","8112至上","110/09/03","永全",0,20,-20
"711","8112至上","110/09/03","台新證券",19,0,19
"712","8112至上","110/09/03","富邦-南屯",0,20,-20
"713","8112至上","110/09/03","(牛牛牛)亞-鑫豐",18,2,16
"714","8112至上","110/09/03","中國信託-中壢",0,16,-16
"715","8112至上","110/09/03","凱基-市政",15,0,15
"716","8112至上","110/09/03","新光-桃園",0,15,-15
"717","8112至上","110/09/03","元大-善化",15,0,15
"718","8112至上","110/09/03","元大-林園",0,15,-15
"719","8112至上","110/09/03","元大-嘉義",15,0,15
"720","8112至上","110/09/03","宏遠-館前",0,13,-13
"721","1570力肯","110/09/03","大展",39,0,39
"722","1570力肯","110/09/03","元大-北成功",0,35,-35
"723","1570力肯","110/09/03","宏遠證券",35,0,35
"724","1570力肯","110/09/03","元大-新店中正",0,30,-30
"725","1570力肯","110/09/03","元大-北三重",16,0,16
"726","1570力肯","110/09/03","新光",20,43,-23
"727","1570力肯","110/09/03","元大-新竹經國",15,0,15
"728","1570力肯","110/09/03","兆豐-寶成",0,18,-18
"729","1570力肯","110/09/03","大昌",10,0,10
"730","1570力肯","110/09/03","兆豐-公益",0,15,-15
"731","1570力肯","110/09/03","兆豐-彰化",10,0,10
"732","1570力肯","110/09/03","兆豐-嘉義",0,14,-14
"733","1570力肯","110/09/03","凱基-永康",10,0,10
"734","1570力肯","110/09/03","國票-博愛",0,9,-9
"735","1570力肯","110/09/03","元大-內湖",10,0,10
"736","1570力肯","110/09/03","元大-東泰",0,9,-9
"737","1570力肯","110/09/03","瑞士信貸",8,0,8
"738","1570力肯","110/09/03","元大-竹南",0,9,-9
"739","1570力肯","110/09/03","國泰-台中",6,0,6
"740","1570力肯","110/09/03","永豐金-虎尾",0,7,-7
"741","1570力肯","110/09/03","康和-台中",5,0,5
"742","1570力肯","110/09/03","大慶-泰山",0,6,-6
"743","1570力肯","110/09/03","凱基-三峽",5,0,5
"744","1570力肯","110/09/03","元富-敦南",0,6,-6
"745","1570力肯","110/09/03","華南永昌-苑裡",5,0,5
"746","1570力肯","110/09/03","凱基-文心",0,6,-6
"747","1570力肯","110/09/03","元富-緯城",4,0,4
"748","1570力肯","110/09/03","合庫-台中",0,5,-5
"749","1570力肯","110/09/03","台新證券",5,1,4
"750","1570力肯","110/09/03","富邦-內湖",0,5,-5
"751","2929淘帝","110/09/03","摩根大通",27,0,27
"752","2929淘帝","110/09/03","兆豐-新營",0,11,-11
"753","2929淘帝","110/09/03","兆豐-大同",20,0,20
"754","2929淘帝","110/09/03","日盛-台南",0,10,-10
"755","2929淘帝","110/09/03","元大-前金",13,0,13
"756","2929淘帝","110/09/03","元富-基隆",0,10,-10
"757","2929淘帝","110/09/03","港商法國興業",6,0,6
"758","2929淘帝","110/09/03","日盛-中壢",0,9,-9
"759","2929淘帝","110/09/03","花旗環球",6,0,6
"760","2929淘帝","110/09/03","新光",0,8,-8
"761","2929淘帝","110/09/03","中國信託-高雄",5,0,5
"762","2929淘帝","110/09/03","玉山-士林",0,7,-7
"763","2929淘帝","110/09/03","美林",10,7,3
"764","2929淘帝","110/09/03","元大-潮州",0,7,-7
"765","2929淘帝","110/09/03","元富-世貿",3,0,3
"766","2929淘帝","110/09/03","第一金-忠孝",0,5,-5
"767","2929淘帝","110/09/03","新光-新竹",3,0,3
"768","2929淘帝","110/09/03","台新-台中",0,5,-5
"769","2929淘帝","110/09/03","陽信",3,0,3
"770","2929淘帝","110/09/03","富邦-新竹",0,5,-5
"771","2929淘帝","110/09/03","元富-文心",2,0,2
"772","2929淘帝","110/09/03","國泰-敦南",0,4,-4
"773","2929淘帝","110/09/03","台新-高雄",4,2,2
"774","2929淘帝","110/09/03","元富-大裕",0,3,-3
"775","2929淘帝","110/09/03","群益金鼎-三民",2,0,2
"776","2929淘帝","110/09/03","富邦-仁愛",0,3,-3
"777","2929淘帝","110/09/03","華南永昌-公誠",2,0,2
"778","2929淘帝","110/09/03","富邦-台北",0,2,-2
"779","2929淘帝","110/09/03","富邦-新店",1,0,1
"780","2929淘帝","110/09/03","元大-斗六",0,2,-2
"781","5410國眾","110/09/03","華南永昌-高雄",25,0,25
"782","5410國眾","110/09/03","群益金鼎-中壢",0,50,-50
"783","5410國眾","110/09/03","兆豐-嘉義",7,0,7
"784","5410國眾","110/09/03","永豐金-萬盛",0,17,-17
"785","5410國眾","110/09/03","凱基-中山",6,0,6
"786","5410國眾","110/09/03","日盛-屏東",0,6,-6
"787","5410國眾","110/09/03","國泰-台中",6,1,5
"788","5410國眾","110/09/03","新光-台中",0,6,-6
"789","5410國眾","110/09/03","群益金鼎-桃園",5,0,5
"790","5410國眾","110/09/03","德信-和平",0,5,-5
"791","5410國眾","110/09/03","富邦-台北",5,0,5
"792","5410國眾","110/09/03","兆豐-桃園",0,5,-5
"793","5410國眾","110/09/03","國票-北高雄",4,0,4
"794","5410國眾","110/09/03","凱基-永康",0,3,-3
"795","5410國眾","110/09/03","元大-和平",4,0,4
"796","5410國眾","110/09/03","華南永昌-內壢",0,3,-3
"797","5410國眾","110/09/03","宏遠-館前",3,0,3
"798","5410國眾","110/09/03","元大-板橋",0,3,-3
"799","5410國眾","110/09/03","國泰-敦南",3,0,3
"800","5410國眾","110/09/03","玉山-新莊",0,2,-2
"801","5410國眾","110/09/03","永豐金-桃園",3,0,3
"802","5410國眾","110/09/03","群益金鼎-宜蘭",0,2,-2
"803","5410國眾","110/09/03","臺銀-新竹",2,0,2
"804","5410國眾","110/09/03","永豐金-台南",0,2,-2
"805","5410國眾","110/09/03","台灣企銀-建成",2,0,2
"806","5410國眾","110/09/03","日盛-高雄",0,1,-1
"807","5410國眾","110/09/03","中國信託-新竹",2,0,2
"808","5410國眾","110/09/03","台新-建北",0,1,-1
"809","5410國眾","110/09/03","富邦-新店",2,0,2
"810","5410國眾","110/09/03","安泰",0,1,-1
"811","2841台開","110/09/03","群益金鼎-彰化",150,0,150
"812","2841台開","110/09/03","華南永昌-台南",1,96,-95
"813","2841台開","110/09/03","群益金鼎-海山",50,0,50
"814","2841台開","110/09/03","兆豐-北高雄",0,60,-60
"815","2841台開","110/09/03","元大-天母",40,0,40
"816","2841台開","110/09/03","統一-嘉義",0,50,-50
"817","2841台開","110/09/03","永豐金-板橋",35,0,35
"818","2841台開","110/09/03","富邦-新竹",0,50,-50
"819","2841台開","110/09/03","元大-福營",20,0,20
"820","2841台開","110/09/03","華南永昌-潮州",0,25,-25
"821","2841台開","110/09/03","宏遠-館前",16,0,16
"822","2841台開","110/09/03","元大-員林",0,11,-11
"823","2841台開","110/09/03","元大-歸仁",14,0,14
"824","2841台開","110/09/03","台新證券",0,10,-10
"825","2841台開","110/09/03","富邦-岡山",10,0,10
"826","2841台開","110/09/03","永豐金-敦南",65,75,-10
"827","2841台開","110/09/03","富邦-建國",6,0,6
"828","2841台開","110/09/03","日盛證券",5,13,-8
"829","2841台開","110/09/03","台中銀",5,0,5
"830","2841台開","110/09/03","永豐金-高雄",0,6,-6
"831","2841台開","110/09/03","台新-新營",3,0,3
"832","2841台開","110/09/03","大昌-安康",23,28,-5
"833","2841台開","110/09/03","群益金鼎-崇德",3,0,3
"834","2841台開","110/09/03","國泰-館前",0,5,-5
"835","2841台開","110/09/03","中國信託",2,0,2
"836","2841台開","110/09/03","新光-桃園",0,4,-4
"837","2841台開","110/09/03","中國信託-永康",2,0,2
"838","2841台開","110/09/03","永豐金-桃園",0,4,-4
"839","2841台開","110/09/03","國泰-台中",2,0,2
"840","2841台開","110/09/03","兆豐-三民",0,3,-3
"841","6207雷科","110/09/03","凱基-高美館",41,0,41
"842","6207雷科","110/09/03","(牛牛牛)亞-鑫豐",0,30,-30
"843","6207雷科","110/09/03","新加坡商瑞銀",33,4,29
"844","6207雷科","110/09/03","元大-北成功",0,15,-15
"845","6207雷科","110/09/03","摩根大通",26,6,20
"846","6207雷科","110/09/03","元富-板橋",0,10,-10
"847","6207雷科","110/09/03","美林",16,0,16
"848","6207雷科","110/09/03","光和-和美",0,10,-10
"849","6207雷科","110/09/03","凱基-中山",12,0,12
"850","6207雷科","110/09/03","康和-延平",0,10,-10
"851","6207雷科","110/09/03","元大-高雄",15,3,12
"852","6207雷科","110/09/03","元富-成功",0,9,-9
"853","6207雷科","110/09/03","元大-大里",15,4,11
"854","6207雷科","110/09/03","致和-金華",0,7,-7
"855","6207雷科","110/09/03","元大-大統",11,0,11
"856","6207雷科","110/09/03","凱基-南崁",0,7,-7
"857","6207雷科","110/09/03","凱基-台北",17,8,9
"858","6207雷科","110/09/03","新光-台中",0,6,-6
"859","6207雷科","110/09/03","美商高盛",8,1,7
"860","6207雷科","110/09/03","玉山-台南",0,6,-6
"861","6207雷科","110/09/03","宏遠-高雄",6,0,6
"862","6207雷科","110/09/03","國泰-敦南",0,6,-6
"863","6207雷科","110/09/03","富隆-長安",6,0,6
"864","6207雷科","110/09/03","富邦-中壢",0,6,-6
"865","6207雷科","110/09/03","統一-敦南",5,0,5
"866","6207雷科","110/09/03","富邦-彰化",0,6,-6
"867","6207雷科","110/09/03","元大-中壢",5,0,5
"868","6207雷科","110/09/03","永豐金-板新",0,6,-6
"869","6207雷科","110/09/03","群益金鼎-瑞豐",7,3,4
"870","6207雷科","110/09/03","元大-四維",0,5,-5
"871","3679新至陞","110/09/03","華南永昌-淡水",10,0,10
"872","3679新至陞","110/09/03","元大-民生",0,8,-8
"873","3679新至陞","110/09/03","花旗環球",4,0,4
"874","3679新至陞","110/09/03","瑞士信貸",2,8,-6
"875","3679新至陞","110/09/03","福邦-新竹",4,0,4
"876","3679新至陞","110/09/03","美林",0,3,-3
"877","3679新至陞","110/09/03","元大-大同",3,0,3
"878","3679新至陞","110/09/03","第一金-澎湖",0,3,-3
"879","3679新至陞","110/09/03","日盛-文化",2,0,2
"880","3679新至陞","110/09/03","元大-板橋",0,3,-3
"881","3679新至陞","110/09/03","國票-新莊",2,0,2
"882","3679新至陞","110/09/03","宏遠-光隆",0,2,-2
"883","3679新至陞","110/09/03","富邦-建國",2,0,2
"884","3679新至陞","110/09/03","港商野村",0,2,-2
"885","3679新至陞","110/09/03","元大-屏南",2,0,2
"886","3679新至陞","110/09/03","高橋",0,2,-2
"887","3679新至陞","110/09/03","日盛-三重",1,0,1
"888","3679新至陞","110/09/03","元大證券",0,2,-2
"889","3679新至陞","110/09/03","盈溢-楠梓",1,0,1
"890","3679新至陞","110/09/03","元大-永春",2,4,-2
"891","3679新至陞","110/09/03","元富-永和",1,0,1
"892","3679新至陞","110/09/03","日盛-內湖",0,1,-1
"893","3679新至陞","110/09/03","兆豐-西螺",1,0,1
"894","3679新至陞","110/09/03","第一金-新竹",0,1,-1
"895","3679新至陞","110/09/03","兆豐-彰化",1,0,1
"896","3679新至陞","110/09/03","元富-松德",0,1,-1
"897","3679新至陞","110/09/03","國泰-板橋",1,0,1
"898","3679新至陞","110/09/03","台新-松江",0,1,-1
"899","3679新至陞","110/09/03","群益金鼎-新莊",1,0,1
"900","3679新至陞","110/09/03","安泰-大發",0,1,-1
"901","2727王品","110/09/03","美商高盛",51,0,51
"902","2727王品","110/09/03","第一金-台中",0,14,-14
"903","2727王品","110/09/03","台灣摩根士丹利",37,6,31
"904","2727王品","110/09/03","富邦-仁愛",0,11,-11
"905","2727王品","110/09/03","港商野村",28,5,23
"906","2727王品","110/09/03","日茂-埔里",0,10,-10
"907","2727王品","110/09/03","凱基-台北",30,11,19
"908","2727王品","110/09/03","摩根大通",12,21,-9
"909","2727王品","110/09/03","美林",21,6,15
"910","2727王品","110/09/03","新光",4,13,-9
"911","2727王品","110/09/03","國泰-敦南",16,5,11
"912","2727王品","110/09/03","元大-博愛",0,7,-7
"913","2727王品","110/09/03","群益金鼎-士林",10,0,10
"914","2727王品","110/09/03","兆豐-台南",0,6,-6
"915","2727王品","110/09/03","玉山-板橋",10,2,8
"916","2727王品","110/09/03","華南永昌-合泰",0,6,-6
"917","2727王品","110/09/03","瑞士信貸",10,3,7
"918","2727王品","110/09/03","日盛-木柵",0,5,-5
"919","2727王品","110/09/03","永豐金-中盛",5,0,5
"920","2727王品","110/09/03","玉山-嘉義",0,5,-5
"921","2727王品","110/09/03","花旗環球",4,0,4
"922","2727王品","110/09/03","富邦-陽明",0,5,-5
"923","2727王品","110/09/03","元大-太平",4,0,4
"924","2727王品","110/09/03","富邦-中壢",1,6,-5
"925","2727王品","110/09/03","台新證券",4,1,3
"926","2727王品","110/09/03","康和",0,4,-4
"927","2727王品","110/09/03","國泰證券",3,0,3
"928","2727王品","110/09/03","凱基-竹東",0,4,-4
"929","2727王品","110/09/03","國泰-桃園",3,0,3
"930","2727王品","110/09/03","元大-大雅",0,4,-4
"931","1570力肯","110/09/03","大展",39,0,39
"932","1570力肯","110/09/03","元大-北成功",0,35,-35
"933","1570力肯","110/09/03","宏遠證券",35,0,35
"934","1570力肯","110/09/03","元大-新店中正",0,30,-30
"935","1570力肯","110/09/03","元大-北三重",16,0,16
"936","1570力肯","110/09/03","新光",20,43,-23
"937","1570力肯","110/09/03","元大-新竹經國",15,0,15
"938","1570力肯","110/09/03","兆豐-寶成",0,18,-18
"939","1570力肯","110/09/03","大昌",10,0,10
"940","1570力肯","110/09/03","兆豐-公益",0,15,-15
"941","1570力肯","110/09/03","兆豐-彰化",10,0,10
"942","1570力肯","110/09/03","兆豐-嘉義",0,14,-14
"943","1570力肯","110/09/03","凱基-永康",10,0,10
"944","1570力肯","110/09/03","國票-博愛",0,9,-9
"945","1570力肯","110/09/03","元大-內湖",10,0,10
"946","1570力肯","110/09/03","元大-東泰",0,9,-9
"947","1570力肯","110/09/03","瑞士信貸",8,0,8
"948","1570力肯","110/09/03","元大-竹南",0,9,-9
"949","1570力肯","110/09/03","國泰-台中",6,0,6
"950","1570力肯","110/09/03","永豐金-虎尾",0,7,-7
"951","1570力肯","110/09/03","康和-台中",5,0,5
"952","1570力肯","110/09/03","大慶-泰山",0,6,-6
"953","1570力肯","110/09/03","凱基-三峽",5,0,5
"954","1570力肯","110/09/03","元富-敦南",0,6,-6
"955","1570力肯","110/09/03","華南永昌-苑裡",5,0,5
"956","1570力肯","110/09/03","凱基-文心",0,6,-6
"957","1570力肯","110/09/03","元富-緯城",4,0,4
"958","1570力肯","110/09/03","合庫-台中",0,5,-5
"959","1570力肯","110/09/03","台新證券",5,1,4
"960","1570力肯","110/09/03","富邦-內湖",0,5,-5
"961","6180橘子","110/09/03","台灣摩根士丹利",93,9,84
"962","6180橘子","110/09/03","康和-澎湖",0,20,-20
"963","6180橘子","110/09/03","玉山-新莊",14,0,14
"964","6180橘子","110/09/03","美林",0,14,-14
"965","6180橘子","110/09/03","凱基-中壢",10,0,10
"966","6180橘子","110/09/03","凱基-科園",0,10,-10
"967","6180橘子","110/09/03","摩根大通",12,4,8
"968","6180橘子","110/09/03","華南永昌-內壢",0,10,-10
"969","6180橘子","110/09/03","大慶-苗栗",7,0,7
"970","6180橘子","110/09/03","元大-大雅",4,14,-10
"971","6180橘子","110/09/03","永豐金-大園",7,0,7
"972","6180橘子","110/09/03","統一-士林",0,9,-9
"973","6180橘子","110/09/03","日盛-桃園",5,0,5
"974","6180橘子","110/09/03","元大-新店中正",0,9,-9
"975","6180橘子","110/09/03","元富-彰化",5,0,5
"976","6180橘子","110/09/03","群益金鼎-嘉義",0,8,-8
"977","6180橘子","110/09/03","兆豐-高雄",5,0,5
"978","6180橘子","110/09/03","致和證券",0,7,-7
"979","6180橘子","110/09/03","國泰-敦南",7,2,5
"980","6180橘子","110/09/03","元大-竹山",0,7,-7
"981","6180橘子","110/09/03","群益金鼎-敦南",5,0,5
"982","6180橘子","110/09/03","第一金-台中",0,6,-6
"983","6180橘子","110/09/03","元大證券",5,0,5
"984","6180橘子","110/09/03","第一金-中壢",0,5,-5
"985","6180橘子","110/09/03","合庫-新竹",5,1,4
"986","6180橘子","110/09/03","第一金-安和",0,5,-5
"987","6180橘子","110/09/03","美商高盛",4,0,4
"988","6180橘子","110/09/03","台新證券",2,7,-5
"989","6180橘子","110/09/03","凱基-土城",4,0,4
"990","6180橘子","110/09/03","合庫-台中",0,4,-4
"991","2390云辰","110/09/03","摩根大通",667,46,621
"992","2390云辰","110/09/03","統一-新台中",2,442,-440
"993","2390云辰","110/09/03","新加坡商瑞銀",402,0,402
"994","2390云辰","110/09/03","元富-草屯",5,364,-359
"995","2390云辰","110/09/03","美商高盛",302,75,227
"996","2390云辰","110/09/03","凱基-台中",12,184,-172
"997","2390云辰","110/09/03","凱基-台北",256,86,170
"998","2390云辰","110/09/03","元大-忠孝",1,150,-149
"999","2390云辰","110/09/03","美林",116,9,107
"1000","2390云辰","110/09/03","日盛-新莊",29,174,-145
"1001","2390云辰","110/09/03","台灣摩根士丹利",156,73,83
"1002","2390云辰","110/09/03","國票-中和",10,120,-110
"1003","2390云辰","110/09/03","華南永昌-合泰",51,0,51
"1004","2390云辰","110/09/03","統一-新營",2,111,-109
"1005","2390云辰","110/09/03","元大-竹山",52,1,51
"1006","2390云辰","110/09/03","華南永昌-中正",91,173,-82
"1007","2390云辰","110/09/03","港商野村",98,51,47
"1008","2390云辰","110/09/03","元富-安南",2,72,-70
"1009","2390云辰","110/09/03","玉山-台中",46,2,44
"1010","2390云辰","110/09/03","群益金鼎-民權",2,71,-69
"1011","2390云辰","110/09/03","元大-小港",42,0,42
"1012","2390云辰","110/09/03","元大-內湖",3,53,-50
"1013","2390云辰","110/09/03","元富-林園",40,0,40
"1014","2390云辰","110/09/03","國泰-館前",7,56,-49
"1015","2390云辰","110/09/03","凱基-湖口",35,0,35
"1016","2390云辰","110/09/03","凱基-和平",0,46,-46
"1017","2390云辰","110/09/03","凱基-長庚",40,5,35
"1018","2390云辰","110/09/03","土銀-花蓮",0,39,-39
"1019","2390云辰","110/09/03","玉山-高雄",33,1,32
"1020","2390云辰","110/09/03","凱基-彰化",2,34,-32
