"","stake","date","name","buy","sell","total"
"1","2609陽明","110/08/17","兆豐-中壢",5227,708,4519
"2","2609陽明","110/08/17","康和",48,4865,-4817
"3","2609陽明","110/08/17","凱基-台北",5969,1780,4189
"4","2609陽明","110/08/17","永豐金-信義",84,2643,-2559
"5","2609陽明","110/08/17","兆豐-三民",2114,136,1978
"6","2609陽明","110/08/17","凱基-虎尾",487,2286,-1799
"7","2609陽明","110/08/17","兆豐-復興",3638,1682,1956
"8","2609陽明","110/08/17","港商野村",1127,2155,-1028
"9","2609陽明","110/08/17","台灣摩根士丹利",2505,858,1647
"10","2609陽明","110/08/17","兆豐-虎尾",1846,2756,-910
"11","2609陽明","110/08/17","日盛-板橋",1734,262,1472
"12","2609陽明","110/08/17","富邦-嘉義",7219,8100,-881
"13","2609陽明","110/08/17","美林",3468,2882,586
"14","2609陽明","110/08/17","元大-頭份",78,810,-732
"15","2609陽明","110/08/17","香港上海匯豐",593,100,493
"16","2609陽明","110/08/17","摩根大通",1422,2133,-711
"17","2609陽明","110/08/17","統一-土城",366,14,352
"18","2609陽明","110/08/17","元大-永春",281,971,-690
"19","2609陽明","110/08/17","統一-敦南",899,577,322
"20","2609陽明","110/08/17","宏遠證券",948,1614,-666
"21","2609陽明","110/08/17","富邦-桃園",413,123,290
"22","2609陽明","110/08/17","凱基-竹東",20,668,-648
"23","2609陽明","110/08/17","日盛-中壢",537,256,281
"24","2609陽明","110/08/17","元大證券",1377,2001,-624
"25","2609陽明","110/08/17","兆豐-板橋",545,318,227
"26","2609陽明","110/08/17","元富-新店",74,549,-475
"27","2609陽明","110/08/17","凱基-桃園",367,142,225
"28","2609陽明","110/08/17","華南永昌-楠梓",73,486,-413
"29","2609陽明","110/08/17","統一-城中",390,169,221
"30","2609陽明","110/08/17","臺銀",286,681,-395
"31","2636台驊投控","110/08/17","元富-文心",272,9,263
"32","2636台驊投控","110/08/17","凱基-彰化",0,689,-689
"33","2636台驊投控","110/08/17","日盛-大墩",185,19,166
"34","2636台驊投控","110/08/17","摩根大通",347,761,-414
"35","2636台驊投控","110/08/17","第一金-桃園",147,26,121
"36","2636台驊投控","110/08/17","富邦-花蓮",106,366,-260
"37","2636台驊投控","110/08/17","元富-大昌",84,15,69
"38","2636台驊投控","110/08/17","凱基-台北",395,566,-171
"39","2636台驊投控","110/08/17","新光",258,192,66
"40","2636台驊投控","110/08/17","大慶",15,175,-160
"41","2636台驊投控","110/08/17","統一-新台中",64,4,60
"42","2636台驊投控","110/08/17","統一",111,247,-136
"43","2636台驊投控","110/08/17","華南永昌-竹北",308,252,56
"44","2636台驊投控","110/08/17","富邦證券",0,134,-134
"45","2636台驊投控","110/08/17","日盛-木柵",60,8,52
"46","2636台驊投控","110/08/17","富邦-虎尾",294,414,-120
"47","2636台驊投控","110/08/17","國泰-敦南",335,283,52
"48","2636台驊投控","110/08/17","元大-士林",4,114,-110
"49","2636台驊投控","110/08/17","美商高盛",96,54,42
"50","2636台驊投控","110/08/17","美林",320,401,-81
"51","2636台驊投控","110/08/17","凱基-市政",60,22,38
"52","2636台驊投控","110/08/17","瑞士信貸",62,134,-72
"53","2636台驊投控","110/08/17","元大-龍潭",50,13,37
"54","2636台驊投控","110/08/17","兆豐-東門",70,140,-70
"55","2636台驊投控","110/08/17","國票-九鼎",50,16,34
"56","2636台驊投控","110/08/17","凱基-高美館",89,158,-69
"57","2636台驊投控","110/08/17","元大-東門",37,3,34
"58","2636台驊投控","110/08/17","日盛證券",103,170,-67
"59","2636台驊投控","110/08/17","富邦-三重",33,1,32
"60","2636台驊投控","110/08/17","宏遠-桃園",4,44,-40
"61","2867三商壽","110/08/17","摩根大通",670,119,551
"62","2867三商壽","110/08/17","玉山-左營",10,1173,-1163
"63","2867三商壽","110/08/17","元富-世貿",288,0,288
"64","2867三商壽","110/08/17","華南永昌",50,736,-686
"65","2867三商壽","110/08/17","日盛-中和",276,10,266
"66","2867三商壽","110/08/17","台灣摩根士丹利",37,195,-158
"67","2867三商壽","110/08/17","新光-台中",243,7,236
"68","2867三商壽","110/08/17","兆豐-北高雄",0,135,-135
"69","2867三商壽","110/08/17","台新-台中",198,1,197
"70","2867三商壽","110/08/17","宏遠證券",9,141,-132
"71","2867三商壽","110/08/17","華南永昌-長虹",136,0,136
"72","2867三商壽","110/08/17","永豐金-市政",0,115,-115
"73","2867三商壽","110/08/17","美林",137,2,135
"74","2867三商壽","110/08/17","兆豐-新竹",0,113,-113
"75","2867三商壽","110/08/17","元大-土城永寧",100,1,99
"76","2867三商壽","110/08/17","永豐金證券",0,82,-82
"77","2867三商壽","110/08/17","國泰-台中",99,2,97
"78","2867三商壽","110/08/17","元大-彰化民生",0,80,-80
"79","2867三商壽","110/08/17","元富-古亭",100,4,96
"80","2867三商壽","110/08/17","永豐金-中盛",4,77,-73
"81","2867三商壽","110/08/17","合庫-西台中",80,0,80
"82","2867三商壽","110/08/17","元富",0,70,-70
"83","2867三商壽","110/08/17","新加坡商瑞銀",83,4,79
"84","2867三商壽","110/08/17","宏遠-中和",10,57,-47
"85","2867三商壽","110/08/17","永豐金-埔里",64,5,59
"86","2867三商壽","110/08/17","富邦-嘉義",4,50,-46
"87","2867三商壽","110/08/17","元富-緯城",50,0,50
"88","2867三商壽","110/08/17","第一金-華江",0,30,-30
"89","2867三商壽","110/08/17","台新-建北",49,0,49
"90","2867三商壽","110/08/17","台新證券",2,32,-30
"91","5521工信","110/08/17","元大-沙鹿",60,0,60
"92","5521工信","110/08/17","摩根大通",75,227,-152
"93","5521工信","110/08/17","群益金鼎-萬華",46,0,46
"94","5521工信","110/08/17","凱基-台北",5,68,-63
"95","5521工信","110/08/17","台新證券",37,1,36
"96","5521工信","110/08/17","群益金鼎-敦南",0,60,-60
"97","5521工信","110/08/17","華南永昌-竹北",31,0,31
"98","5521工信","110/08/17","台灣摩根士丹利",5,64,-59
"99","5521工信","110/08/17","元大-北投",30,0,30
"100","5521工信","110/08/17","元富-古亭",0,40,-40
"101","5521工信","110/08/17","元富-屏東",24,0,24
"102","5521工信","110/08/17","台灣企銀-嘉義",0,35,-35
"103","5521工信","110/08/17","富邦-台北",23,0,23
"104","5521工信","110/08/17","美林",5,37,-32
"105","5521工信","110/08/17","元大-屏南",23,0,23
"106","5521工信","110/08/17","華南永昌",0,27,-27
"107","5521工信","110/08/17","國泰-敦南",40,18,22
"108","5521工信","110/08/17","華南永昌-潮州",0,25,-25
"109","5521工信","110/08/17","兆豐-中壢",20,0,20
"110","5521工信","110/08/17","台新-高雄",0,24,-24
"111","5521工信","110/08/17","新光-台南",20,0,20
"112","5521工信","110/08/17","大慶-楊梅",0,22,-22
"113","5521工信","110/08/17","臺銀-鳳山",19,0,19
"114","5521工信","110/08/17","凱基-桃園",0,20,-20
"115","5521工信","110/08/17","日進",18,0,18
"116","5521工信","110/08/17","元大-東蘆",0,20,-20
"117","5521工信","110/08/17","永豐金-鳳山",17,0,17
"118","5521工信","110/08/17","第一金-桃園",0,18,-18
"119","5521工信","110/08/17","玉山證券",14,0,14
"120","5521工信","110/08/17","新光-新竹",3,20,-17
"121","1471首利","110/08/17","摩根大通",110,14,96
"122","1471首利","110/08/17","元大-台南",0,54,-54
"123","1471首利","110/08/17","臺銀-臺中",40,0,40
"124","1471首利","110/08/17","高橋-龍潭",0,50,-50
"125","1471首利","110/08/17","瑞士信貸",33,0,33
"126","1471首利","110/08/17","元大-竹南",0,35,-35
"127","1471首利","110/08/17","凱基-台北",30,6,24
"128","1471首利","110/08/17","台新證券",1,31,-30
"129","1471首利","110/08/17","元大-竹山",23,0,23
"130","1471首利","110/08/17","國泰-敦南",7,33,-26
"131","1471首利","110/08/17","大慶-蘆洲",14,0,14
"132","1471首利","110/08/17","元大-西門",0,23,-23
"133","1471首利","110/08/17","兆豐-員林",13,1,12
"134","1471首利","110/08/17","元富-埔里",0,20,-20
"135","1471首利","110/08/17","致和-府前",11,0,11
"136","1471首利","110/08/17","富邦-台中",0,20,-20
"137","1471首利","110/08/17","國票-彰化",11,0,11
"138","1471首利","110/08/17","日茂",0,11,-11
"139","1471首利","110/08/17","元富-新莊",10,0,10
"140","1471首利","110/08/17","高橋",0,10,-10
"141","1471首利","110/08/17","國票",10,0,10
"142","1471首利","110/08/17","大昌-新店",0,10,-10
"143","1471首利","110/08/17","富邦-永和",10,0,10
"144","1471首利","110/08/17","元富-文心",1,10,-9
"145","1471首利","110/08/17","元大-新莊",10,0,10
"146","1471首利","110/08/17","凱基-雙和",0,8,-8
"147","1471首利","110/08/17","元大-鹿港",10,0,10
"148","1471首利","110/08/17","凱基-屏東",0,8,-8
"149","1471首利","110/08/17","元大-清水",11,2,9
"150","1471首利","110/08/17","日盛-永康",0,7,-7
"151","2883開發金","110/08/17","中國信託-文心",3524,26,3498
"152","2883開發金","110/08/17","新加坡商瑞銀",513,7792,-7279
"153","2883開發金","110/08/17","元大證券",1912,297,1615
"154","2883開發金","110/08/17","亞東-新竹",206,2692,-2486
"155","2883開發金","110/08/17","摩根大通",4110,2504,1606
"156","2883開發金","110/08/17","凱基-台北",2263,4277,-2014
"157","2883開發金","110/08/17","美林",2099,733,1366
"158","2883開發金","110/08/17","永豐金證券",103,1899,-1796
"159","2883開發金","110/08/17","日盛證券",2406,1218,1188
"160","2883開發金","110/08/17","華南永昌-苑裡",13,1229,-1216
"161","2883開發金","110/08/17","國泰-館前",942,128,814
"162","2883開發金","110/08/17","統一-新營",39,1202,-1163
"163","2883開發金","110/08/17","元富-城中",808,6,802
"164","2883開發金","110/08/17","兆豐-高雄",68,1153,-1085
"165","2883開發金","110/08/17","港商法國興業",764,0,764
"166","2883開發金","110/08/17","凱基-斗六",3,812,-809
"167","2883開發金","110/08/17","元大-南屯",759,75,684
"168","2883開發金","110/08/17","元大-四維",736,1467,-731
"169","2883開發金","110/08/17","康和-仁愛",514,10,504
"170","2883開發金","110/08/17","台新證券",682,1391,-709
"171","2883開發金","110/08/17","新光",1403,910,493
"172","2883開發金","110/08/17","凱基-豐中",7,617,-610
"173","2883開發金","110/08/17","統一-汐止",489,5,484
"174","2883開發金","110/08/17","土銀-嘉義",10,580,-570
"175","2883開發金","110/08/17","永豐金-忠孝",650,206,444
"176","2883開發金","110/08/17","港商麥格理",1131,1682,-551
"177","2883開發金","110/08/17","港商野村",2803,2361,442
"178","2883開發金","110/08/17","富邦-陽明",158,680,-522
"179","2883開發金","110/08/17","元富-大裕",454,22,432
"180","2883開發金","110/08/17","台灣摩根士丹利",2238,2750,-512
"181","6205詮欣","110/08/17","日盛-三重",15,0,15
"182","6205詮欣","110/08/17","元富-松德",0,10,-10
"183","6205詮欣","110/08/17","臺銀-民權",5,0,5
"184","6205詮欣","110/08/17","元富-安南",0,8,-8
"185","6205詮欣","110/08/17","華南永昌-長虹",5,0,5
"186","6205詮欣","110/08/17","元大-大雅",0,3,-3
"187","6205詮欣","110/08/17","德信-新營",4,0,4
"188","6205詮欣","110/08/17","兆豐-南門",0,3,-3
"189","6205詮欣","110/08/17","凱基-汐止",4,0,4
"190","6205詮欣","110/08/17","兆豐-南京",0,3,-3
"191","6205詮欣","110/08/17","富邦-陽明",4,0,4
"192","6205詮欣","110/08/17","元大-豐原",0,2,-2
"193","6205詮欣","110/08/17","元大-汐止",4,0,4
"194","6205詮欣","110/08/17","大昌",0,1,-1
"195","6205詮欣","110/08/17","華南永昌-古亭",3,0,3
"196","6205詮欣","110/08/17","永豐金-中正",0,1,-1
"197","6205詮欣","110/08/17","凱基-台北",1,0,1
"198","6205詮欣","110/08/17","大昌-安康",0,1,-1
"199","6205詮欣","110/08/17","元大-鑫永和",1,0,1
"200","6205詮欣","110/08/17","日盛-台中",0,1,-1
"201","6205詮欣","110/08/17","統一-士林",0,0,0
"202","6205詮欣","110/08/17","新百王",0,1,-1
"203","6205詮欣","110/08/17","統一-南京",0,0,0
"204","6205詮欣","110/08/17","元富-文心",0,1,-1
"205","6205詮欣","110/08/17","國泰證券",0,0,0
"206","6205詮欣","110/08/17","統一",0,1,-1
"207","6205詮欣","110/08/17","華南永昌-高雄",0,0,0
"208","6205詮欣","110/08/17","第一金-中壢",0,1,-1
"209","6205詮欣","110/08/17","永豐金-中和",1,1,0
"210","6205詮欣","110/08/17","大慶-基隆",0,1,-1
"211","1540喬福","110/08/17","元大-松山",20,0,20
"212","1540喬福","110/08/17","群益金鼎-館前",0,31,-31
"213","1540喬福","110/08/17","凱基-中壢",17,0,17
"214","1540喬福","110/08/17","日盛-文化",0,30,-30
"215","1540喬福","110/08/17","元大-左營",11,0,11
"216","1540喬福","110/08/17","兆豐-民生",0,17,-17
"217","1540喬福","110/08/17","元富-文心",10,0,10
"218","1540喬福","110/08/17","凱基-台北",0,5,-5
"219","1540喬福","110/08/17","元大-土城永寧",10,0,10
"220","1540喬福","110/08/17","國票-台中",0,3,-3
"221","1540喬福","110/08/17","元大-成功",10,0,10
"222","1540喬福","110/08/17","元大-大益",0,3,-3
"223","1540喬福","110/08/17","富邦-板橋",6,0,6
"224","1540喬福","110/08/17","致和-南京",0,2,-2
"225","1540喬福","110/08/17","新光",4,0,4
"226","1540喬福","110/08/17","國泰-館前",0,2,-2
"227","1540喬福","110/08/17","亞東",2,0,2
"228","1540喬福","110/08/17","富邦-陽明",0,2,-2
"229","1540喬福","110/08/17","群益金鼎-新店",2,0,2
"230","1540喬福","110/08/17","元大-龍潭",0,2,-2
"231","1540喬福","110/08/17","日盛-員林",1,0,1
"232","1540喬福","110/08/17","日盛-台中",0,1,-1
"233","1540喬福","110/08/17","日盛-鳳山",1,0,1
"234","1540喬福","110/08/17","美林",0,1,-1
"235","1540喬福","110/08/17","統一-屏東",1,0,1
"236","1540喬福","110/08/17","第一金-高雄",0,1,-1
"237","1540喬福","110/08/17","元富-大昌",1,0,1
"238","1540喬福","110/08/17","元富",1,2,-1
"239","1540喬福","110/08/17","台新-高雄",1,0,1
"240","1540喬福","110/08/17","新光-新竹",0,1,-1
"241","2888新光金","110/08/17","華南永昌-岡山",6623,36,6587
"242","2888新光金","110/08/17","元富-城東",11,13997,-13986
"243","2888新光金","110/08/17","元大-忠孝鼎富",4976,0,4976
"244","2888新光金","110/08/17","永豐金證券",19,2260,-2241
"245","2888新光金","110/08/17","永豐金-萬盛",3955,15,3940
"246","2888新光金","110/08/17","國票-博愛",0,2051,-2051
"247","2888新光金","110/08/17","摩根大通",3699,247,3452
"248","2888新光金","110/08/17","群益金鼎",0,1836,-1836
"249","2888新光金","110/08/17","瑞士信貸",3064,605,2459
"250","2888新光金","110/08/17","華南永昌",10,1624,-1614
"251","2888新光金","110/08/17","凱基-大安",2179,2,2177
"252","2888新光金","110/08/17","元大-大同",0,714,-714
"253","2888新光金","110/08/17","國票-台東",1935,23,1912
"254","2888新光金","110/08/17","安泰",0,598,-598
"255","2888新光金","110/08/17","永豐金-信義",1497,5,1492
"256","2888新光金","110/08/17","大昌",3,555,-552
"257","2888新光金","110/08/17","國票-北投",1304,0,1304
"258","2888新光金","110/08/17","福勝",3,510,-507
"259","2888新光金","110/08/17","兆豐-松德",1251,0,1251
"260","2888新光金","110/08/17","元大-太平",20,525,-505
"261","2888新光金","110/08/17","花旗環球",1101,147,954
"262","2888新光金","110/08/17","中國信託-三重",0,503,-503
"263","2888新光金","110/08/17","港商法國興業",1031,180,851
"264","2888新光金","110/08/17","台灣摩根士丹利",1136,1627,-491
"265","2888新光金","110/08/17","凱基-站前",788,13,775
"266","2888新光金","110/08/17","美林",141,604,-463
"267","2888新光金","110/08/17","台灣匯立證券",763,0,763
"268","2888新光金","110/08/17","群益金鼎-土城",0,415,-415
"269","2888新光金","110/08/17","群益金鼎-崇德",735,3,732
"270","2888新光金","110/08/17","凱基-台北",632,1033,-401
"271","1340勝悅","110/08/17","國泰-台中",12,0,12
"272","1340勝悅","110/08/17","永豐金-潮州",0,20,-20
"273","1340勝悅","110/08/17","新光-新竹",10,0,10
"274","1340勝悅","110/08/17","臺灣企銀-桃園",0,10,-10
"275","1340勝悅","110/08/17","元富-成功",8,0,8
"276","1340勝悅","110/08/17","瑞士信貸",0,6,-6
"277","1340勝悅","110/08/17","臺灣企銀-埔墘",5,0,5
"278","1340勝悅","110/08/17","玉山-桃園",0,5,-5
"279","1340勝悅","110/08/17","華南永昌-敦南",5,0,5
"280","1340勝悅","110/08/17","華南永昌-虎尾",0,5,-5
"281","1340勝悅","110/08/17","富邦-新店",11,6,5
"282","1340勝悅","110/08/17","永豐金-博愛",0,5,-5
"283","1340勝悅","110/08/17","美商高盛",4,0,4
"284","1340勝悅","110/08/17","日盛-永康",0,4,-4
"285","1340勝悅","110/08/17","新光-桃園",3,0,3
"286","1340勝悅","110/08/17","元富-世貿",0,4,-4
"287","1340勝悅","110/08/17","日盛-八德",2,0,2
"288","1340勝悅","110/08/17","摩根大通",2,6,-4
"289","1340勝悅","110/08/17","凱基-基隆",2,0,2
"290","1340勝悅","110/08/17","玉山-新莊",0,3,-3
"291","1340勝悅","110/08/17","元大-松江",2,0,2
"292","1340勝悅","110/08/17","國泰-敦南",5,8,-3
"293","1340勝悅","110/08/17","元大-崇德",2,0,2
"294","1340勝悅","110/08/17","富邦-桃園",0,3,-3
"295","1340勝悅","110/08/17","國泰-館前",1,0,1
"296","1340勝悅","110/08/17","元大-和平",0,3,-3
"297","1340勝悅","110/08/17","群益金鼎-民權",1,0,1
"298","1340勝悅","110/08/17","永豐金-南投",0,3,-3
"299","1340勝悅","110/08/17","華南永昌-大安",1,0,1
"300","1340勝悅","110/08/17","富邦-羅東",2,4,-2
"301","6246臺龍","110/08/17","台新-三民",90,0,90
"302","6246臺龍","110/08/17","日盛證券",0,52,-52
"303","6246臺龍","110/08/17","港商野村",63,28,35
"304","6246臺龍","110/08/17","凱基-幸福",0,10,-10
"305","6246臺龍","110/08/17","台新證券",20,0,20
"306","6246臺龍","110/08/17","元富-新店",0,9,-9
"307","6246臺龍","110/08/17","凱基-信義",7,0,7
"308","6246臺龍","110/08/17","凱基-科園",0,8,-8
"309","6246臺龍","110/08/17","凱基-站前",5,0,5
"310","6246臺龍","110/08/17","元富-世貿",0,7,-7
"311","6246臺龍","110/08/17","合庫-嘉義",5,1,4
"312","6246臺龍","110/08/17","兆豐-公益",0,7,-7
"313","6246臺龍","110/08/17","元大-林園",10,6,4
"314","6246臺龍","110/08/17","元大-東蘆",0,7,-7
"315","6246臺龍","110/08/17","元大-永康",4,0,4
"316","6246臺龍","110/08/17","群益金鼎-嘉義",0,6,-6
"317","6246臺龍","110/08/17","元大-基隆孝二",4,0,4
"318","6246臺龍","110/08/17","華南永昌-頭份",0,6,-6
"319","6246臺龍","110/08/17","日盛-斗六",3,0,3
"320","6246臺龍","110/08/17","元大-北港",0,5,-5
"321","6246臺龍","110/08/17","永全",3,0,3
"322","6246臺龍","110/08/17","日盛-和美",0,4,-4
"323","6246臺龍","110/08/17","兆豐-景美",3,0,3
"324","6246臺龍","110/08/17","國泰-敦南",1,5,-4
"325","6246臺龍","110/08/17","台新-台中",3,0,3
"326","6246臺龍","110/08/17","群益金鼎-新竹",0,4,-4
"327","6246臺龍","110/08/17","元大-雙和",3,0,3
"328","6246臺龍","110/08/17","凱基-台北",0,4,-4
"329","6246臺龍","110/08/17","土銀",2,0,2
"330","6246臺龍","110/08/17","元大-府城",0,4,-4
"331","00715L期街口布蘭特正2","110/08/17","華南永昌-長虹",860,0,860
"332","00715L期街口布蘭特正2","110/08/17","元大證券",78,4339,-4261
"333","00715L期街口布蘭特正2","110/08/17","永豐金-台中",823,20,803
"334","00715L期街口布蘭特正2","110/08/17","元富",2,3940,-3938
"335","00715L期街口布蘭特正2","110/08/17","日盛-和美",595,0,595
"336","00715L期街口布蘭特正2","110/08/17","永豐金證券",41,1048,-1007
"337","00715L期街口布蘭特正2","110/08/17","第一金-豐原",420,0,420
"338","00715L期街口布蘭特正2","110/08/17","統一-桃園",5,850,-845
"339","00715L期街口布蘭特正2","110/08/17","元大-前金",419,0,419
"340","00715L期街口布蘭特正2","110/08/17","富邦證券",258,1081,-823
"341","00715L期街口布蘭特正2","110/08/17","華南永昌-台中",419,5,414
"342","00715L期街口布蘭特正2","110/08/17","元大-台中",9,534,-525
"343","00715L期街口布蘭特正2","110/08/17","元大-北三重",403,0,403
"344","00715L期街口布蘭特正2","110/08/17","合庫-高雄",10,310,-300
"345","00715L期街口布蘭特正2","110/08/17","日盛-新莊",375,0,375
"346","00715L期街口布蘭特正2","110/08/17","港商野村",1,240,-239
"347","00715L期街口布蘭特正2","110/08/17","富邦-基隆",310,0,310
"348","00715L期街口布蘭特正2","110/08/17","群益金鼎-民權",2,208,-206
"349","00715L期街口布蘭特正2","110/08/17","臺銀-新竹",311,10,301
"350","00715L期街口布蘭特正2","110/08/17","元大-大里德芳",1,200,-199
"351","00715L期街口布蘭特正2","110/08/17","元富-中港",300,0,300
"352","00715L期街口布蘭特正2","110/08/17","元大-中和",1,187,-186
"353","00715L期街口布蘭特正2","110/08/17","新光",368,82,286
"354","00715L期街口布蘭特正2","110/08/17","康和",0,133,-133
"355","00715L期街口布蘭特正2","110/08/17","中國信託-新竹",263,0,263
"356","00715L期街口布蘭特正2","110/08/17","永豐金-板新",25,150,-125
"357","00715L期街口布蘭特正2","110/08/17","台中銀",253,0,253
"358","00715L期街口布蘭特正2","110/08/17","兆豐-桃鶯",6,110,-104
"359","00715L期街口布蘭特正2","110/08/17","統一-台中",230,0,230
"360","00715L期街口布蘭特正2","110/08/17","凱基-大直",2,100,-98
"361","8941關中","110/08/17","宏遠-館前",4,0,4
"362","8941關中","110/08/17","凱基-高美館",0,1,-1
"363","8941關中","110/08/17","",NA,NA,NA
"364","8941關中","110/08/17","凱基-台北",0,1,-1
"365","8941關中","110/08/17","",NA,NA,NA
"366","8941關中","110/08/17","元大-南投",0,1,-1
"367","8941關中","110/08/17","",NA,NA,NA
"368","8941關中","110/08/17","元大-華山",0,1,-1
"369","8941關中","110/08/17","",NA,NA,NA
"370","8941關中","110/08/17","",NA,NA,NA
"371","8941關中","110/08/17","",NA,NA,NA
"372","8941關中","110/08/17","",NA,NA,NA
"373","8941關中","110/08/17","",NA,NA,NA
"374","8941關中","110/08/17","",NA,NA,NA
"375","8941關中","110/08/17","",NA,NA,NA
"376","8941關中","110/08/17","",NA,NA,NA
"377","8941關中","110/08/17","",NA,NA,NA
"378","8941關中","110/08/17","",NA,NA,NA
"379","8941關中","110/08/17","",NA,NA,NA
"380","8941關中","110/08/17","",NA,NA,NA
"381","8941關中","110/08/17","",NA,NA,NA
"382","8941關中","110/08/17","",NA,NA,NA
"383","8941關中","110/08/17","",NA,NA,NA
"384","8941關中","110/08/17","",NA,NA,NA
"385","8941關中","110/08/17","",NA,NA,NA
"386","8941關中","110/08/17","",NA,NA,NA
"387","8941關中","110/08/17","",NA,NA,NA
"388","8941關中","110/08/17","",NA,NA,NA
"389","8941關中","110/08/17","",NA,NA,NA
"390","8941關中","110/08/17","",NA,NA,NA
"391","8936國統","110/08/17","台新-高雄",511,7,504
"392","8936國統","110/08/17","凱基-高美館",20,157,-137
"393","8936國統","110/08/17","美林",60,0,60
"394","8936國統","110/08/17","台灣摩根士丹利",7,56,-49
"395","8936國統","110/08/17","台中銀-高雄",33,0,33
"396","8936國統","110/08/17","永豐金-大園",5,52,-47
"397","8936國統","110/08/17","摩根大通",71,39,32
"398","8936國統","110/08/17","新光-台中",16,60,-44
"399","8936國統","110/08/17","元大-豐原站前",30,0,30
"400","8936國統","110/08/17","國泰-敦南",14,44,-30
"401","8936國統","110/08/17","第一金-新興",25,0,25
"402","8936國統","110/08/17","港商野村",41,64,-23
"403","8936國統","110/08/17","凱基-台北",45,24,21
"404","8936國統","110/08/17","凱基-站前",0,20,-20
"405","8936國統","110/08/17","日盛-忠孝",20,0,20
"406","8936國統","110/08/17","國泰-高雄",3,20,-17
"407","8936國統","110/08/17","日盛-高雄",15,0,15
"408","8936國統","110/08/17","富邦-嘉義",0,17,-17
"409","8936國統","110/08/17","新加坡商瑞銀",66,53,13
"410","8936國統","110/08/17","元大-敦化",0,17,-17
"411","8936國統","110/08/17","玉山-台南",14,3,11
"412","8936國統","110/08/17","統一-台中",0,15,-15
"413","8936國統","110/08/17","日盛-斗六",10,0,10
"414","8936國統","110/08/17","兆豐-高雄",0,15,-15
"415","8936國統","110/08/17","統一-新營",10,0,10
"416","8936國統","110/08/17","陽信-石牌",0,15,-15
"417","8936國統","110/08/17","元富-三重",15,5,10
"418","8936國統","110/08/17","元大-文心",0,15,-15
"419","8936國統","110/08/17","群益金鼎-台中",10,0,10
"420","8936國統","110/08/17","美商高盛",8,22,-14
"421","6226光鼎","110/08/17","國泰-台中",693,66,627
"422","6226光鼎","110/08/17","美商高盛",21,669,-648
"423","6226光鼎","110/08/17","摩根大通",453,306,147
"424","6226光鼎","110/08/17","凱基-台北",116,705,-589
"425","6226光鼎","110/08/17","日盛-員林",105,1,104
"426","6226光鼎","110/08/17","第一金-大稻埕",101,627,-526
"427","6226光鼎","110/08/17","永豐金-南投",80,0,80
"428","6226光鼎","110/08/17","瑞士信貸",0,356,-356
"429","6226光鼎","110/08/17","宏遠-光隆",60,0,60
"430","6226光鼎","110/08/17","美林",48,202,-154
"431","6226光鼎","110/08/17","元大-員林中山",52,0,52
"432","6226光鼎","110/08/17","新光",74,175,-101
"433","6226光鼎","110/08/17","合庫-鳳山",54,4,50
"434","6226光鼎","110/08/17","元大-北屯",1,101,-100
"435","6226光鼎","110/08/17","元大-福營",51,5,46
"436","6226光鼎","110/08/17","台新-屏東",0,70,-70
"437","6226光鼎","110/08/17","凱基-市府",46,4,42
"438","6226光鼎","110/08/17","永豐金-南京",6,74,-68
"439","6226光鼎","110/08/17","兆豐-永和",41,1,40
"440","6226光鼎","110/08/17","元大-西螺",2,55,-53
"441","6226光鼎","110/08/17","凱基-永和",40,1,39
"442","6226光鼎","110/08/17","統一-基隆",0,50,-50
"443","6226光鼎","110/08/17","元大-敦化",38,0,38
"444","6226光鼎","110/08/17","永豐金-板橋",2,46,-44
"445","6226光鼎","110/08/17","凱基-中山",42,5,37
"446","6226光鼎","110/08/17","元大-草屯",2,33,-31
"447","6226光鼎","110/08/17","國泰-桃園",131,97,34
"448","6226光鼎","110/08/17","元大-西門",0,28,-28
"449","6226光鼎","110/08/17","富邦-台北",55,21,34
"450","6226光鼎","110/08/17","凱基-屏東",1,27,-26
"451","2363矽統","110/08/17","第一金-高雄",356,4,352
"452","2363矽統","110/08/17","瑞士信貸",86,1495,-1409
"453","2363矽統","110/08/17","元富-永和",241,5,236
"454","2363矽統","110/08/17","凱基-台北",737,1867,-1130
"455","2363矽統","110/08/17","凱基-高美館",254,23,231
"456","2363矽統","110/08/17","台灣摩根士丹利",0,438,-438
"457","2363矽統","110/08/17","台新證券",511,295,216
"458","2363矽統","110/08/17","元富-城東",13,409,-396
"459","2363矽統","110/08/17","土銀-士林",189,0,189
"460","2363矽統","110/08/17","(牛牛牛)亞-鑫豐",24,247,-223
"461","2363矽統","110/08/17","永豐金-天母",155,0,155
"462","2363矽統","110/08/17","美林",97,274,-177
"463","2363矽統","110/08/17","玉山-台中",301,164,137
"464","2363矽統","110/08/17","凱基-長庚",11,134,-123
"465","2363矽統","110/08/17","凱基-竹北",122,5,117
"466","2363矽統","110/08/17","元富-新店",4,115,-111
"467","2363矽統","110/08/17","群益金鼎-三民",115,8,107
"468","2363矽統","110/08/17","元大-北成功",142,237,-95
"469","2363矽統","110/08/17","港商野村",1447,1350,97
"470","2363矽統","110/08/17","日盛-木柵",70,160,-90
"471","2363矽統","110/08/17","永豐金-新竹",105,20,85
"472","2363矽統","110/08/17","摩根大通",240,322,-82
"473","2363矽統","110/08/17","永豐金-松山",77,0,77
"474","2363矽統","110/08/17","第一金-新竹",266,342,-76
"475","2363矽統","110/08/17","富邦-宜蘭",84,11,73
"476","2363矽統","110/08/17","華南永昌-岡山",42,110,-68
"477","2363矽統","110/08/17","永豐金-南投",72,1,71
"478","2363矽統","110/08/17","康和",48,112,-64
"479","2363矽統","110/08/17","富邦-仁愛",90,22,68
"480","2363矽統","110/08/17","華南永昌-楠梓",30,90,-60
"481","8112至上","110/08/17","港商麥格理",158,0,158
"482","8112至上","110/08/17","瑞士信貸",0,249,-249
"483","8112至上","110/08/17","凱基-台北",177,49,128
"484","8112至上","110/08/17","摩根大通",56,233,-177
"485","8112至上","110/08/17","德信",120,0,120
"486","8112至上","110/08/17","新加坡商瑞銀",19,179,-160
"487","8112至上","110/08/17","台新證券",116,19,97
"488","8112至上","110/08/17","富邦-仁愛",13,141,-128
"489","8112至上","110/08/17","合庫-台中",75,2,73
"490","8112至上","110/08/17","凱基-復興",1,108,-107
"491","8112至上","110/08/17","美林",79,10,69
"492","8112至上","110/08/17","台灣摩根士丹利",0,101,-101
"493","8112至上","110/08/17","統一",46,0,46
"494","8112至上","110/08/17","香港上海匯豐",0,96,-96
"495","8112至上","110/08/17","群益金鼎-瑞豐",40,0,40
"496","8112至上","110/08/17","群益金鼎-基隆",1,70,-69
"497","8112至上","110/08/17","臺銀-金山",37,0,37
"498","8112至上","110/08/17","日盛-花蓮",0,52,-52
"499","8112至上","110/08/17","新光-高雄",37,4,33
"500","8112至上","110/08/17","國票-北高雄",0,50,-50
"501","8112至上","110/08/17","臺銀",41,15,26
"502","8112至上","110/08/17","永豐金-新竹",0,48,-48
"503","8112至上","110/08/17","元大證券",27,2,25
"504","8112至上","110/08/17","日進",0,45,-45
"505","8112至上","110/08/17","元大-內湖",24,0,24
"506","8112至上","110/08/17","大展",0,30,-30
"507","8112至上","110/08/17","國票-天祥",23,0,23
"508","8112至上","110/08/17","港商野村",30,52,-22
"509","8112至上","110/08/17","元大-土城永寧",23,0,23
"510","8112至上","110/08/17","凱基-市府",1,21,-20
"511","1570力肯","110/08/17","元大-南投",88,1,87
"512","1570力肯","110/08/17","富邦-仁愛",0,42,-42
"513","1570力肯","110/08/17","群益金鼎-高雄",51,10,41
"514","1570力肯","110/08/17","元富-新竹",0,30,-30
"515","1570力肯","110/08/17","凱基-台北",47,7,40
"516","1570力肯","110/08/17","元大-新盛",2,28,-26
"517","1570力肯","110/08/17","統一",29,4,25
"518","1570力肯","110/08/17","凱基-台南",0,20,-20
"519","1570力肯","110/08/17","元大-大雅",25,0,25
"520","1570力肯","110/08/17","日盛-復興",0,15,-15
"521","1570力肯","110/08/17","台新證券",24,10,14
"522","1570力肯","110/08/17","元大-前金",1,15,-14
"523","1570力肯","110/08/17","元大證券",14,0,14
"524","1570力肯","110/08/17","元大-北成功",0,14,-14
"525","1570力肯","110/08/17","日盛-板橋",12,0,12
"526","1570力肯","110/08/17","臺銀-臺南",0,11,-11
"527","1570力肯","110/08/17","元大-鑫永和",11,0,11
"528","1570力肯","110/08/17","凱基-彰化",0,11,-11
"529","1570力肯","110/08/17","富邦-內湖",10,0,10
"530","1570力肯","110/08/17","合庫-桃園",0,10,-10
"531","1570力肯","110/08/17","元富-緯城",10,1,9
"532","1570力肯","110/08/17","凱基-南崁",0,10,-10
"533","1570力肯","110/08/17","元大-開元",10,2,8
"534","1570力肯","110/08/17","凱基-台中",0,9,-9
"535","1570力肯","110/08/17","元大-桃興",8,1,7
"536","1570力肯","110/08/17","華南永昌-嘉義",0,8,-8
"537","1570力肯","110/08/17","日盛-員林",6,0,6
"538","1570力肯","110/08/17","元大-鹿港",1,9,-8
"539","1570力肯","110/08/17","陽信",5,0,5
"540","1570力肯","110/08/17","國票-中正",0,7,-7
"541","2929淘帝","110/08/17","元大-太平",48,0,48
"542","2929淘帝","110/08/17","華南永昌-苗栗",0,30,-30
"543","2929淘帝","110/08/17","永豐金-敦南",22,0,22
"544","2929淘帝","110/08/17","兆豐-復興",0,15,-15
"545","2929淘帝","110/08/17","永興",12,0,12
"546","2929淘帝","110/08/17","凱基-長庚",0,13,-13
"547","2929淘帝","110/08/17","日盛-復興",10,0,10
"548","2929淘帝","110/08/17","美林",1,13,-12
"549","2929淘帝","110/08/17","第一金-大稻埕",10,0,10
"550","2929淘帝","110/08/17","永豐金-豐原",0,10,-10
"551","2929淘帝","110/08/17","華南永昌-長虹",10,0,10
"552","2929淘帝","110/08/17","華南永昌-高雄",1,10,-9
"553","2929淘帝","110/08/17","元大-高雄",8,0,8
"554","2929淘帝","110/08/17","日盛-南京",0,8,-8
"555","2929淘帝","110/08/17","港商野村",12,5,7
"556","2929淘帝","110/08/17","兆豐-大同",0,7,-7
"557","2929淘帝","110/08/17","亞東-板橋",7,0,7
"558","2929淘帝","110/08/17","摩根大通",0,6,-6
"559","2929淘帝","110/08/17","國票-北高雄",6,0,6
"560","2929淘帝","110/08/17","凱基-台中",0,5,-5
"561","2929淘帝","110/08/17","國票-九鼎",6,0,6
"562","2929淘帝","110/08/17","元大-鶯歌",0,5,-5
"563","2929淘帝","110/08/17","亞東-新竹",5,0,5
"564","2929淘帝","110/08/17","元大-上新莊",0,5,-5
"565","2929淘帝","110/08/17","新加坡商瑞銀",4,0,4
"566","2929淘帝","110/08/17","元大-北三重",0,5,-5
"567","2929淘帝","110/08/17","凱基-中山",6,2,4
"568","2929淘帝","110/08/17","第一金-澎湖",4,8,-4
"569","2929淘帝","110/08/17","富邦-南屯",4,0,4
"570","2929淘帝","110/08/17","日進",1,5,-4
"571","5410國眾","110/08/17","元大-博愛",50,3,47
"572","5410國眾","110/08/17","瑞士信貸",0,61,-61
"573","5410國眾","110/08/17","土銀-嘉義",38,0,38
"574","5410國眾","110/08/17","新光",3,41,-38
"575","5410國眾","110/08/17","國票-北高雄",20,0,20
"576","5410國眾","110/08/17","凱基-台南",2,30,-28
"577","5410國眾","110/08/17","凱基-台北",37,22,15
"578","5410國眾","110/08/17","元富-基隆",0,21,-21
"579","5410國眾","110/08/17","兆豐-永和",14,0,14
"580","5410國眾","110/08/17","富邦-新竹",1,16,-15
"581","5410國眾","110/08/17","富邦-台北",22,10,12
"582","5410國眾","110/08/17","亞東-新竹",0,14,-14
"583","5410國眾","110/08/17","元大-中壢",12,0,12
"584","5410國眾","110/08/17","群益金鼎-新竹",1,15,-14
"585","5410國眾","110/08/17","摩根大通",25,14,11
"586","5410國眾","110/08/17","富邦-永和",1,14,-13
"587","5410國眾","110/08/17","日盛-花蓮",10,0,10
"588","5410國眾","110/08/17","元大-新竹經國",0,12,-12
"589","5410國眾","110/08/17","元富-同大",11,1,10
"590","5410國眾","110/08/17","群益金鼎-三民",0,11,-11
"591","5410國眾","110/08/17","凱基-科園",10,0,10
"592","5410國眾","110/08/17","寶盛",0,10,-10
"593","5410國眾","110/08/17","元大-潮州",10,0,10
"594","5410國眾","110/08/17","永豐金-板橋",0,10,-10
"595","5410國眾","110/08/17","台新-左楠",10,1,9
"596","5410國眾","110/08/17","永豐金-竹科",1,11,-10
"597","5410國眾","110/08/17","群益金鼎-古亭",14,5,9
"598","5410國眾","110/08/17","臺銀",1,9,-8
"599","5410國眾","110/08/17","永豐金-萬盛",9,0,9
"600","5410國眾","110/08/17","群益金鼎-南京",0,8,-8
"601","2841台開","110/08/17","宏遠-館前",169,2,167
"602","2841台開","110/08/17","光和-溪湖",0,120,-120
"603","2841台開","110/08/17","第一金",54,0,54
"604","2841台開","110/08/17","兆豐-台南",0,109,-109
"605","2841台開","110/08/17","台新-三民",50,0,50
"606","2841台開","110/08/17","永豐金-台南",0,50,-50
"607","2841台開","110/08/17","日盛證券",52,24,28
"608","2841台開","110/08/17","兆豐-高雄",0,38,-38
"609","2841台開","110/08/17","華南永昌-台中",20,0,20
"610","2841台開","110/08/17","元大-林園",0,30,-30
"611","2841台開","110/08/17","永豐金-中盛",17,0,17
"612","2841台開","110/08/17","兆豐-台中",0,20,-20
"613","2841台開","110/08/17","日盛-台中",15,0,15
"614","2841台開","110/08/17","元大-敦化",0,20,-20
"615","2841台開","110/08/17","日盛-園區",15,0,15
"616","2841台開","110/08/17","元大-彰化民生",2,21,-19
"617","2841台開","110/08/17","國泰-館前",15,0,15
"618","2841台開","110/08/17","凱基-彰化",1,14,-13
"619","2841台開","110/08/17","日盛-大墩",10,0,10
"620","2841台開","110/08/17","元大-大灣",0,13,-13
"621","2841台開","110/08/17","大慶-蘆洲",10,0,10
"622","2841台開","110/08/17","元大-鹿港",0,11,-11
"623","2841台開","110/08/17","凱基-員林",10,0,10
"624","2841台開","110/08/17","兆豐-公益",0,10,-10
"625","2841台開","110/08/17","富邦-基隆",10,0,10
"626","2841台開","110/08/17","元大-北三重",0,10,-10
"627","2841台開","110/08/17","元大-新竹經國",10,0,10
"628","2841台開","110/08/17","華南永昌-鳳山",0,7,-7
"629","2841台開","110/08/17","元富-成功",8,0,8
"630","2841台開","110/08/17","元大-南海",0,7,-7
"631","6207雷科","110/08/17","台新-高雄",82,2,80
"632","6207雷科","110/08/17","第一金-員林",0,60,-60
"633","6207雷科","110/08/17","凱基-台北",42,16,26
"634","6207雷科","110/08/17","元大-高雄",0,47,-47
"635","6207雷科","110/08/17","摩根大通",26,5,21
"636","6207雷科","110/08/17","凱基-復興",0,20,-20
"637","6207雷科","110/08/17","安泰",20,0,20
"638","6207雷科","110/08/17","元大-新盛",1,20,-19
"639","6207雷科","110/08/17","富邦-中壢",20,0,20
"640","6207雷科","110/08/17","元富-大昌",0,12,-12
"641","6207雷科","110/08/17","新加坡商瑞銀",23,6,17
"642","6207雷科","110/08/17","華南永昌-岡山",1,12,-11
"643","6207雷科","110/08/17","日盛-桃園",10,0,10
"644","6207雷科","110/08/17","日盛-板橋",0,10,-10
"645","6207雷科","110/08/17","兆豐-西螺",10,0,10
"646","6207雷科","110/08/17","凱基-中壢",0,10,-10
"647","6207雷科","110/08/17","中國信託-高雄",8,0,8
"648","6207雷科","110/08/17","港商野村",7,16,-9
"649","6207雷科","110/08/17","大昌-桃園",8,0,8
"650","6207雷科","110/08/17","凱基-三重",1,10,-9
"651","6207雷科","110/08/17","群益金鼎-士林",6,0,6
"652","6207雷科","110/08/17","台新-台中",0,8,-8
"653","6207雷科","110/08/17","美林",5,0,5
"654","6207雷科","110/08/17","富邦-板橋",0,8,-8
"655","6207雷科","110/08/17","中國信託-三重",5,0,5
"656","6207雷科","110/08/17","兆豐-公益",0,6,-6
"657","6207雷科","110/08/17","康和-內湖",5,0,5
"658","6207雷科","110/08/17","新光-桃園",0,6,-6
"659","6207雷科","110/08/17","新光",9,4,5
"660","6207雷科","110/08/17","凱基-大里",0,6,-6
"661","3679新至陞","110/08/17","台灣摩根士丹利",20,0,20
"662","3679新至陞","110/08/17","台新證券",1,31,-30
"663","3679新至陞","110/08/17","凱基-長庚",12,0,12
"664","3679新至陞","110/08/17","統一",0,27,-27
"665","3679新至陞","110/08/17","元大-大天母",12,0,12
"666","3679新至陞","110/08/17","國票-南科",0,20,-20
"667","3679新至陞","110/08/17","瑞士信貸",24,15,9
"668","3679新至陞","110/08/17","國泰-忠孝",0,7,-7
"669","3679新至陞","110/08/17","康和-板橋",6,0,6
"670","3679新至陞","110/08/17","美林",10,15,-5
"671","3679新至陞","110/08/17","元大-四維",6,0,6
"672","3679新至陞","110/08/17","國泰-桃園",0,5,-5
"673","3679新至陞","110/08/17","日盛-台中",5,0,5
"674","3679新至陞","110/08/17","凱基-頭份",0,4,-4
"675","3679新至陞","110/08/17","第一金-彰化",5,0,5
"676","3679新至陞","110/08/17","港商野村",1,4,-3
"677","3679新至陞","110/08/17","凱基-文心",5,1,4
"678","3679新至陞","110/08/17","凱基-台北",8,11,-3
"679","3679新至陞","110/08/17","元大-雙和",4,0,4
"680","3679新至陞","110/08/17","元大證券",1,4,-3
"681","3679新至陞","110/08/17","元大-草屯",4,0,4
"682","3679新至陞","110/08/17","元大-新莊",0,3,-3
"683","3679新至陞","110/08/17","合庫-彰化",2,0,2
"684","3679新至陞","110/08/17","港商法國興業",0,2,-2
"685","3679新至陞","110/08/17","臺銀-臺中",2,0,2
"686","3679新至陞","110/08/17","元富-板橋",0,2,-2
"687","3679新至陞","110/08/17","日盛-文化",3,1,2
"688","3679新至陞","110/08/17","康和-高雄",0,2,-2
"689","3679新至陞","110/08/17","永豐金-敦南",2,0,2
"690","3679新至陞","110/08/17","群益金鼎-三重",0,2,-2
"691","2727王品","110/08/17","凱基-台北",63,1,62
"692","2727王品","110/08/17","第一金-高雄",1,111,-110
"693","2727王品","110/08/17","台灣摩根士丹利",86,37,49
"694","2727王品","110/08/17","摩根大通",29,118,-89
"695","2727王品","110/08/17","瑞士信貸",32,0,32
"696","2727王品","110/08/17","永豐金證券",0,83,-83
"697","2727王品","110/08/17","元大-北屯",32,1,31
"698","2727王品","110/08/17","華南永昌",1,38,-37
"699","2727王品","110/08/17","美林",37,8,29
"700","2727王品","110/08/17","合庫-新竹",1,31,-30
"701","2727王品","110/08/17","凱基-市政",23,0,23
"702","2727王品","110/08/17","中國信託-新竹",1,23,-22
"703","2727王品","110/08/17","港商野村",74,54,20
"704","2727王品","110/08/17","玉山證券",16,33,-17
"705","2727王品","110/08/17","元大-板橋",20,0,20
"706","2727王品","110/08/17","富邦-台北",5,19,-14
"707","2727王品","110/08/17","元大-汐止",12,0,12
"708","2727王品","110/08/17","群益金鼎-中壢",1,14,-13
"709","2727王品","110/08/17","元大-龍潭",19,8,11
"710","2727王品","110/08/17","富邦證券",0,13,-13
"711","2727王品","110/08/17","元富",10,0,10
"712","2727王品","110/08/17","元大證券",9,22,-13
"713","2727王品","110/08/17","彰銀-台中",9,0,9
"714","2727王品","110/08/17","聯邦商銀",0,12,-12
"715","2727王品","110/08/17","中國信託",11,2,9
"716","2727王品","110/08/17","日盛-屏東",7,17,-10
"717","2727王品","110/08/17","群益金鼎-西松",10,1,9
"718","2727王品","110/08/17","康和-高雄",0,10,-10
"719","2727王品","110/08/17","第一金-自由",8,0,8
"720","2727王品","110/08/17","新光-高雄",1,11,-10
"721","1570力肯","110/08/17","元大-南投",88,1,87
"722","1570力肯","110/08/17","富邦-仁愛",0,42,-42
"723","1570力肯","110/08/17","群益金鼎-高雄",51,10,41
"724","1570力肯","110/08/17","元富-新竹",0,30,-30
"725","1570力肯","110/08/17","凱基-台北",47,7,40
"726","1570力肯","110/08/17","元大-新盛",2,28,-26
"727","1570力肯","110/08/17","統一",29,4,25
"728","1570力肯","110/08/17","凱基-台南",0,20,-20
"729","1570力肯","110/08/17","元大-大雅",25,0,25
"730","1570力肯","110/08/17","日盛-復興",0,15,-15
"731","1570力肯","110/08/17","台新證券",24,10,14
"732","1570力肯","110/08/17","元大-前金",1,15,-14
"733","1570力肯","110/08/17","元大證券",14,0,14
"734","1570力肯","110/08/17","元大-北成功",0,14,-14
"735","1570力肯","110/08/17","日盛-板橋",12,0,12
"736","1570力肯","110/08/17","臺銀-臺南",0,11,-11
"737","1570力肯","110/08/17","元大-鑫永和",11,0,11
"738","1570力肯","110/08/17","凱基-彰化",0,11,-11
"739","1570力肯","110/08/17","富邦-內湖",10,0,10
"740","1570力肯","110/08/17","合庫-桃園",0,10,-10
"741","1570力肯","110/08/17","元富-緯城",10,1,9
"742","1570力肯","110/08/17","凱基-南崁",0,10,-10
"743","1570力肯","110/08/17","元大-開元",10,2,8
"744","1570力肯","110/08/17","凱基-台中",0,9,-9
"745","1570力肯","110/08/17","元大-桃興",8,1,7
"746","1570力肯","110/08/17","華南永昌-嘉義",0,8,-8
"747","1570力肯","110/08/17","日盛-員林",6,0,6
"748","1570力肯","110/08/17","元大-鹿港",1,9,-8
"749","1570力肯","110/08/17","陽信",5,0,5
"750","1570力肯","110/08/17","國票-中正",0,7,-7
"751","6180橘子","110/08/17","摩根大通",107,25,82
"752","6180橘子","110/08/17","元大-高雄",0,50,-50
"753","6180橘子","110/08/17","美林",59,0,59
"754","6180橘子","110/08/17","第一金-新竹",1,30,-29
"755","6180橘子","110/08/17","美商高盛",31,0,31
"756","6180橘子","110/08/17","台新-建北",1,25,-24
"757","6180橘子","110/08/17","凱基-台北",32,6,26
"758","6180橘子","110/08/17","群益金鼎-大安",0,20,-20
"759","6180橘子","110/08/17","合庫-自強",10,0,10
"760","6180橘子","110/08/17","台灣摩根士丹利",37,54,-17
"761","6180橘子","110/08/17","元富-世貿",10,0,10
"762","6180橘子","110/08/17","玉山-台南",1,13,-12
"763","6180橘子","110/08/17","元大-台中中港",10,0,10
"764","6180橘子","110/08/17","富邦-基隆",0,11,-11
"765","6180橘子","110/08/17","臺銀-金山",11,2,9
"766","6180橘子","110/08/17","日盛-雙和",0,10,-10
"767","6180橘子","110/08/17","華南永昌-虎尾",8,0,8
"768","6180橘子","110/08/17","統一-台南",0,10,-10
"769","6180橘子","110/08/17","元大-彰化民生",7,0,7
"770","6180橘子","110/08/17","新光-桃園",0,10,-10
"771","6180橘子","110/08/17","群益金鼎-嘉義",6,0,6
"772","6180橘子","110/08/17","凱基-竹北",0,10,-10
"773","6180橘子","110/08/17","元大-太平",6,0,6
"774","6180橘子","110/08/17","元大-基隆孝二",0,10,-10
"775","6180橘子","110/08/17","永豐金-敦北",6,0,6
"776","6180橘子","110/08/17","永豐金-大園",0,10,-10
"777","6180橘子","110/08/17","華南永昌-台中",5,0,5
"778","6180橘子","110/08/17","第一金-中山",0,8,-8
"779","6180橘子","110/08/17","元大-永春",5,0,5
"780","6180橘子","110/08/17","台新證券",4,12,-8
"781","2390云辰","110/08/17","美林",601,355,246
"782","2390云辰","110/08/17","富邦-虎尾",786,1240,-454
"783","2390云辰","110/08/17","凱基-台北",999,859,140
"784","2390云辰","110/08/17","富隆-長安",2,262,-260
"785","2390云辰","110/08/17","新光",1508,1370,138
"786","2390云辰","110/08/17","摩根大通",2924,3174,-250
"787","2390云辰","110/08/17","國泰-敦南",1264,1133,131
"788","2390云辰","110/08/17","元大-木柵",204,419,-215
"789","2390云辰","110/08/17","富邦-內湖",143,18,125
"790","2390云辰","110/08/17","兆豐-埔墘",10,165,-155
"791","2390云辰","110/08/17","統一-新營",142,28,114
"792","2390云辰","110/08/17","美商高盛",332,483,-151
"793","2390云辰","110/08/17","兆豐-虎尾",107,5,102
"794","2390云辰","110/08/17","元大-大同",829,966,-137
"795","2390云辰","110/08/17","新加坡商瑞銀",274,177,97
"796","2390云辰","110/08/17","元大-土城學府",236,367,-131
"797","2390云辰","110/08/17","元大-上新莊",82,9,73
"798","2390云辰","110/08/17","富邦-花蓮",5,107,-102
"799","2390云辰","110/08/17","凱基-民權",145,78,67
"800","2390云辰","110/08/17","元大-台中",20,118,-98
"801","2390云辰","110/08/17","富邦-彰化",200,133,67
"802","2390云辰","110/08/17","群益金鼎-開元",70,150,-80
"803","2390云辰","110/08/17","宏遠-桃園",67,5,62
"804","2390云辰","110/08/17","永豐金-古亭",27,106,-79
"805","2390云辰","110/08/17","港商野村",2090,2030,60
"806","2390云辰","110/08/17","土銀-士林",0,78,-78
"807","2390云辰","110/08/17","永豐金-萬盛",76,17,59
"808","2390云辰","110/08/17","元富-高雄",94,166,-72
"809","2390云辰","110/08/17","元大-歸仁",85,34,51
"810","2390云辰","110/08/17","富邦-敦南",40,108,-68
