"","stake","date","name","buy","sell","total"
"1","1315達新","110/08/19","凱基-中港",16,0,16
"2","1315達新","110/08/19","永豐金證券",2,17,-15
"3","1315達新","110/08/19","元大-北屯",10,0,10
"4","1315達新","110/08/19","國泰-館前",0,10,-10
"5","1315達新","110/08/19","日盛-和美",6,0,6
"6","1315達新","110/08/19","元大-桃興",0,10,-10
"7","1315達新","110/08/19","元富-三重",5,0,5
"8","1315達新","110/08/19","日盛-台中",0,9,-9
"9","1315達新","110/08/19","康和-內湖",4,0,4
"10","1315達新","110/08/19","元大-文心興安",0,8,-8
"11","1315達新","110/08/19","元大-豐原",4,0,4
"12","1315達新","110/08/19","摩根大通",0,6,-6
"13","1315達新","110/08/19","元大-向上",3,0,3
"14","1315達新","110/08/19","美商高盛",0,5,-5
"15","1315達新","110/08/19","合庫-西台中",3,1,2
"16","1315達新","110/08/19","台灣摩根士丹利",0,2,-2
"17","1315達新","110/08/19","國票-桃園",2,0,2
"18","1315達新","110/08/19","瑞士信貸",0,2,-2
"19","1315達新","110/08/19","台新證券",3,1,2
"20","1315達新","110/08/19","新光",2,4,-2
"21","1315達新","110/08/19","群益金鼎-延平",2,0,2
"22","1315達新","110/08/19","元大-南投",0,2,-2
"23","1315達新","110/08/19","元大-台北",2,0,2
"24","1315達新","110/08/19","元大-中壢",0,2,-2
"25","1315達新","110/08/19","元大-桃園",2,0,2
"26","1315達新","110/08/19","永豐金-中盛",1,3,-2
"27","1315達新","110/08/19","元大-左營",2,0,2
"28","1315達新","110/08/19","港商法國興業",0,1,-1
"29","1315達新","110/08/19","新光-台中",1,0,1
"30","1315達新","110/08/19","永豐金-南投",0,1,-1
"31","2609陽明","110/08/19","美商高盛",2352,641,1711
"32","2609陽明","110/08/19","凱基-台北",2247,12187,-9940
"33","2609陽明","110/08/19","華南永昌-竹北",1335,536,799
"34","2609陽明","110/08/19","康和",1685,8746,-7061
"35","2609陽明","110/08/19","國泰-敦南",5999,5202,797
"36","2609陽明","110/08/19","富邦證券",159,6808,-6649
"37","2609陽明","110/08/19","日盛-雙和",967,217,750
"38","2609陽明","110/08/19","台灣摩根士丹利",66,2608,-2542
"39","2609陽明","110/08/19","國泰-館前",1665,1071,594
"40","2609陽明","110/08/19","兆豐-南京",144,2129,-1985
"41","2609陽明","110/08/19","台新證券",3672,3095,577
"42","2609陽明","110/08/19","兆豐-虎尾",7267,9058,-1791
"43","2609陽明","110/08/19","統一-三重",826,296,530
"44","2609陽明","110/08/19","美林",2631,4379,-1748
"45","2609陽明","110/08/19","玉山證券",1424,939,485
"46","2609陽明","110/08/19","永豐金-信義",140,1816,-1676
"47","2609陽明","110/08/19","富邦-建國",1115,663,452
"48","2609陽明","110/08/19","富邦-仁愛",873,2277,-1404
"49","2609陽明","110/08/19","統一-士林",809,391,418
"50","2609陽明","110/08/19","摩根大通",4652,6019,-1367
"51","2609陽明","110/08/19","凱基-城中",614,199,415
"52","2609陽明","110/08/19","凱基-斗六",3347,4638,-1291
"53","2609陽明","110/08/19","華南永昌-台中",863,449,414
"54","2609陽明","110/08/19","富邦-虎尾",11651,12857,-1206
"55","2609陽明","110/08/19","新光-新竹",1263,857,406
"56","2609陽明","110/08/19","元大證券",2875,3808,-933
"57","2609陽明","110/08/19","國泰-台中",1878,1503,375
"58","2609陽明","110/08/19","統一-仁愛",1484,2392,-908
"59","2609陽明","110/08/19","玉山-左營",623,251,372
"60","2609陽明","110/08/19","元大-頭份",315,1194,-879
"61","2636台驊投控","110/08/19","華南永昌-竹北",257,10,247
"62","2636台驊投控","110/08/19","富邦證券",8,1056,-1048
"63","2636台驊投控","110/08/19","國泰-敦南",483,306,177
"64","2636台驊投控","110/08/19","摩根大通",329,1288,-959
"65","2636台驊投控","110/08/19","新光-新竹",174,42,132
"66","2636台驊投控","110/08/19","台灣摩根士丹利",168,753,-585
"67","2636台驊投控","110/08/19","港商野村",2255,2136,119
"68","2636台驊投控","110/08/19","凱基-台北",574,996,-422
"69","2636台驊投控","110/08/19","台新證券",257,150,107
"70","2636台驊投控","110/08/19","瑞士信貸",75,421,-346
"71","2636台驊投控","110/08/19","新光",389,312,77
"72","2636台驊投控","110/08/19","統一",98,420,-322
"73","2636台驊投控","110/08/19","華南永昌-楠梓",98,27,71
"74","2636台驊投控","110/08/19","凱基",21,323,-302
"75","2636台驊投控","110/08/19","華南永昌-南京",104,40,64
"76","2636台驊投控","110/08/19","富邦-員林",377,670,-293
"77","2636台驊投控","110/08/19","富邦-苗栗",99,35,64
"78","2636台驊投控","110/08/19","日盛-台中",26,244,-218
"79","2636台驊投控","110/08/19","元大-竹北",79,16,63
"80","2636台驊投控","110/08/19","美商高盛",87,244,-157
"81","2636台驊投控","110/08/19","凱基-市政",265,203,62
"82","2636台驊投控","110/08/19","日盛-板橋",40,163,-123
"83","2636台驊投控","110/08/19","中國信託-文心",80,21,59
"84","2636台驊投控","110/08/19","大慶",2,120,-118
"85","2636台驊投控","110/08/19","大昌-安康",60,4,56
"86","2636台驊投控","110/08/19","日盛-大墩",73,184,-111
"87","2636台驊投控","110/08/19","日盛-宜蘭",53,0,53
"88","2636台驊投控","110/08/19","宏遠證券",60,152,-92
"89","2636台驊投控","110/08/19","元富-大昌",81,28,53
"90","2636台驊投控","110/08/19","新加坡商瑞銀",88,173,-85
"91","2867三商壽","110/08/19","美林",389,60,329
"92","2867三商壽","110/08/19","宏遠證券",0,969,-969
"93","2867三商壽","110/08/19","元大-土城永寧",252,2,250
"94","2867三商壽","110/08/19","摩根大通",111,691,-580
"95","2867三商壽","110/08/19","玉山-板橋",127,0,127
"96","2867三商壽","110/08/19","土銀-建國",0,240,-240
"97","2867三商壽","110/08/19","元大-大里德芳",110,0,110
"98","2867三商壽","110/08/19","日盛-中壢",0,122,-122
"99","2867三商壽","110/08/19","國泰-台中",103,1,102
"100","2867三商壽","110/08/19","台新-高雄",4,121,-117
"101","2867三商壽","110/08/19","新加坡商瑞銀",114,19,95
"102","2867三商壽","110/08/19","德信-中正",0,100,-100
"103","2867三商壽","110/08/19","玉山-城中",86,0,86
"104","2867三商壽","110/08/19","華南永昌-南京",0,100,-100
"105","2867三商壽","110/08/19","合庫-西台中",80,0,80
"106","2867三商壽","110/08/19","台新證券",15,101,-86
"107","2867三商壽","110/08/19","永豐金-竹科",80,1,79
"108","2867三商壽","110/08/19","凱基-台北",42,118,-76
"109","2867三商壽","110/08/19","玉山-台中",61,0,61
"110","2867三商壽","110/08/19","富邦-建國",1,71,-70
"111","2867三商壽","110/08/19","土銀-台中",60,0,60
"112","2867三商壽","110/08/19","元大-八德",0,70,-70
"113","2867三商壽","110/08/19","富邦-台南",60,0,60
"114","2867三商壽","110/08/19","凱基",0,68,-68
"115","2867三商壽","110/08/19","元大-中壢",56,0,56
"116","2867三商壽","110/08/19","富邦-三重",0,55,-55
"117","2867三商壽","110/08/19","群益金鼎-彰化",62,8,54
"118","2867三商壽","110/08/19","元大-彰化民生",0,50,-50
"119","2867三商壽","110/08/19","永豐金-埔里",67,13,54
"120","2867三商壽","110/08/19","亞東",0,45,-45
"121","5521工信","110/08/19","元大證券",232,28,204
"122","5521工信","110/08/19","凱基-台北",0,178,-178
"123","5521工信","110/08/19","中國信託-三重",70,0,70
"124","5521工信","110/08/19","福勝",0,80,-80
"125","5521工信","110/08/19","台新證券",37,0,37
"126","5521工信","110/08/19","新光-新竹",1,80,-79
"127","5521工信","110/08/19","日盛-高雄",27,0,27
"128","5521工信","110/08/19","港商法國興業",0,67,-67
"129","5521工信","110/08/19","元富-埔里",20,0,20
"130","5521工信","110/08/19","摩根大通",194,256,-62
"131","5521工信","110/08/19","玉山-雙和",20,0,20
"132","5521工信","110/08/19","群益金鼎-敦南",0,50,-50
"133","5521工信","110/08/19","富邦-台北",20,0,20
"134","5521工信","110/08/19","第一金-桃園",0,36,-36
"135","5521工信","110/08/19","永豐金-竹科",19,0,19
"136","5521工信","110/08/19","德信-中正",0,29,-29
"137","5521工信","110/08/19","臺銀-鳳山",18,0,18
"138","5521工信","110/08/19","元大-基隆孝二",0,28,-28
"139","5521工信","110/08/19","華南永昌-高雄",20,2,18
"140","5521工信","110/08/19","美林",1,27,-26
"141","5521工信","110/08/19","華南永昌-彰化",23,8,15
"142","5521工信","110/08/19","兆豐-員林",0,25,-25
"143","5521工信","110/08/19","元大-大天母",15,0,15
"144","5521工信","110/08/19","群益金鼎-土城",0,20,-20
"145","5521工信","110/08/19","富邦-宜蘭",14,0,14
"146","5521工信","110/08/19","元富-宜蘭",0,18,-18
"147","5521工信","110/08/19","台新-台中",12,0,12
"148","5521工信","110/08/19","富邦-高雄",1,15,-14
"149","5521工信","110/08/19","臺銀-高雄",11,0,11
"150","5521工信","110/08/19","元大-歸仁",2,16,-14
"151","1471首利","110/08/19","新光",35,0,35
"152","1471首利","110/08/19","摩根大通",42,206,-164
"153","1471首利","110/08/19","新光-台南",24,0,24
"154","1471首利","110/08/19","瑞士信貸",1,39,-38
"155","1471首利","110/08/19","元大-太平",20,2,18
"156","1471首利","110/08/19","凱基-五股",0,23,-23
"157","1471首利","110/08/19","土銀-花蓮",15,0,15
"158","1471首利","110/08/19","凱基-台北",6,29,-23
"159","1471首利","110/08/19","玉山-桃園",15,0,15
"160","1471首利","110/08/19","元大-虎尾",7,27,-20
"161","1471首利","110/08/19","元富-三重",13,0,13
"162","1471首利","110/08/19","光和",9,24,-15
"163","1471首利","110/08/19","台新證券",12,0,12
"164","1471首利","110/08/19","致和-府前",0,15,-15
"165","1471首利","110/08/19","元大-員林中山",11,0,11
"166","1471首利","110/08/19","兆豐-員林",0,12,-12
"167","1471首利","110/08/19","台灣企銀-屏東",10,0,10
"168","1471首利","110/08/19","凱基-新店",0,12,-12
"169","1471首利","110/08/19","兆豐-台中港",10,0,10
"170","1471首利","110/08/19","美林",0,11,-11
"171","1471首利","110/08/19","致和-崇德",10,0,10
"172","1471首利","110/08/19","凱基-頭份",0,10,-10
"173","1471首利","110/08/19","凱基-高美館",10,0,10
"174","1471首利","110/08/19","華南永昌-台中",0,10,-10
"175","1471首利","110/08/19","華南永昌-公誠",10,0,10
"176","1471首利","110/08/19","元大-大甲",0,9,-9
"177","1471首利","110/08/19","華南永昌-楠梓",10,0,10
"178","1471首利","110/08/19","凱基-三重",3,10,-7
"179","1471首利","110/08/19","富邦-南屯",10,0,10
"180","1471首利","110/08/19","永豐金-新店",0,7,-7
"181","2883開發金","110/08/19","香港上海匯豐",6827,846,5981
"182","2883開發金","110/08/19","凱基-台北",1722,11079,-9357
"183","2883開發金","110/08/19","中國信託-文心",4667,49,4618
"184","2883開發金","110/08/19","花旗環球",1244,7162,-5918
"185","2883開發金","110/08/19","新光",3917,1918,1999
"186","2883開發金","110/08/19","國泰證券",51,3659,-3608
"187","2883開發金","110/08/19","凱基",1952,0,1952
"188","2883開發金","110/08/19","台新證券",1038,4320,-3282
"189","2883開發金","110/08/19","玉山證券",2183,465,1718
"190","2883開發金","110/08/19","兆豐證券",7,1979,-1972
"191","2883開發金","110/08/19","元大-忠孝",1666,40,1626
"192","2883開發金","110/08/19","統一",51,1553,-1502
"193","2883開發金","110/08/19","國泰-敦南",2025,483,1542
"194","2883開發金","110/08/19","日盛證券",70,1356,-1286
"195","2883開發金","110/08/19","新加坡商瑞銀",5707,4366,1341
"196","2883開發金","110/08/19","合庫-彰化",31,1273,-1242
"197","2883開發金","110/08/19","瑞士信貸",1645,478,1167
"198","2883開發金","110/08/19","元大證券",2109,3261,-1152
"199","2883開發金","110/08/19","康和-仁愛",1143,1,1142
"200","2883開發金","110/08/19","宏遠證券",11,1083,-1072
"201","2883開發金","110/08/19","凱基-竹科",753,16,737
"202","2883開發金","110/08/19","富邦-北港",134,1188,-1054
"203","2883開發金","110/08/19","國泰-板橋",919,284,635
"204","2883開發金","110/08/19","元大-福營",55,1070,-1015
"205","2883開發金","110/08/19","新光-台南",757,132,625
"206","2883開發金","110/08/19","台灣企銀-民雄",23,1022,-999
"207","2883開發金","110/08/19","元大-萬華",559,62,497
"208","2883開發金","110/08/19","永豐金-南京",131,1128,-997
"209","2883開發金","110/08/19","元大-中壢",533,53,480
"210","2883開發金","110/08/19","群益金鼎-大安",38,965,-927
"211","6205詮欣","110/08/19","日盛-三重",23,0,23
"212","6205詮欣","110/08/19","高橋-內壢",0,20,-20
"213","6205詮欣","110/08/19","凱基-汐止",21,0,21
"214","6205詮欣","110/08/19","摩根大通",1,12,-11
"215","6205詮欣","110/08/19","日茂-埔里",10,0,10
"216","6205詮欣","110/08/19","福邦證券",0,10,-10
"217","6205詮欣","110/08/19","凱基-台北",3,0,3
"218","6205詮欣","110/08/19","元富-安南",0,6,-6
"219","6205詮欣","110/08/19","永豐金證券",3,0,3
"220","6205詮欣","110/08/19","永興-大墩",0,4,-4
"221","6205詮欣","110/08/19","元富-草屯",2,0,2
"222","6205詮欣","110/08/19","元大-豐原",0,2,-2
"223","6205詮欣","110/08/19","臺銀-臺中",1,0,1
"224","6205詮欣","110/08/19","統一-中壢",0,2,-2
"225","6205詮欣","110/08/19","兆豐-景美",1,0,1
"226","6205詮欣","110/08/19","中國信託-文心",0,2,-2
"227","6205詮欣","110/08/19","凱基-桃園",1,0,1
"228","6205詮欣","110/08/19","大慶-台南",0,1,-1
"229","6205詮欣","110/08/19","凱基-復興",1,0,1
"230","6205詮欣","110/08/19","元大-南投",0,1,-1
"231","6205詮欣","110/08/19","華南永昌-台南",1,0,1
"232","6205詮欣","110/08/19","華南永昌-虎尾",0,1,-1
"233","6205詮欣","110/08/19","華南永昌-新莊",0,0,0
"234","6205詮欣","110/08/19","凱基-和平",0,1,-1
"235","6205詮欣","110/08/19","元大-大里",0,0,0
"236","6205詮欣","110/08/19","豐農",0,1,-1
"237","6205詮欣","110/08/19","永豐金-中和",1,1,0
"238","6205詮欣","110/08/19","元富-文心",0,1,-1
"239","6205詮欣","110/08/19","",NA,NA,NA
"240","6205詮欣","110/08/19","美商高盛",0,1,-1
"241","1540喬福","110/08/19","日盛-台南",20,0,20
"242","1540喬福","110/08/19","兆豐-小港",0,30,-30
"243","1540喬福","110/08/19","元大-板橋三民",11,0,11
"244","1540喬福","110/08/19","富邦-台南",0,10,-10
"245","1540喬福","110/08/19","富邦-陽明",10,0,10
"246","1540喬福","110/08/19","元富-桃園",0,9,-9
"247","1540喬福","110/08/19","富邦-南屯",10,0,10
"248","1540喬福","110/08/19","元大-龍潭",0,9,-9
"249","1540喬福","110/08/19","元大-桃興",10,0,10
"250","1540喬福","110/08/19","元大-雙和",0,6,-6
"251","1540喬福","110/08/19","元大-成功",10,0,10
"252","1540喬福","110/08/19","元大-台南",0,5,-5
"253","1540喬福","110/08/19","(牛牛牛)亞-網路",7,0,7
"254","1540喬福","110/08/19","台中銀",0,4,-4
"255","1540喬福","110/08/19","凱基-中壢",3,0,3
"256","1540喬福","110/08/19","港商法國興業",0,3,-3
"257","1540喬福","110/08/19","臺銀-新竹",2,0,2
"258","1540喬福","110/08/19","富邦-員林",0,3,-3
"259","1540喬福","110/08/19","國票-南崁",2,0,2
"260","1540喬福","110/08/19","元富",0,2,-2
"261","1540喬福","110/08/19","摩根大通",5,3,2
"262","1540喬福","110/08/19","康和-板橋",0,2,-2
"263","1540喬福","110/08/19","華南永昌-高雄",2,0,2
"264","1540喬福","110/08/19","玉山-城中",0,2,-2
"265","1540喬福","110/08/19","台中銀-豐原",1,0,1
"266","1540喬福","110/08/19","元大-南崁",0,2,-2
"267","1540喬福","110/08/19","國票-桃園",1,0,1
"268","1540喬福","110/08/19","元大-敦南",0,2,-2
"269","1540喬福","110/08/19","玉山-新竹",1,0,1
"270","1540喬福","110/08/19","國票-台中",0,1,-1
"271","2888新光金","110/08/19","兆豐-公益",5003,799,4204
"272","2888新光金","110/08/19","摩根大通",1356,4583,-3227
"273","2888新光金","110/08/19","凱基-台北",4068,1621,2447
"274","2888新光金","110/08/19","凱基",0,3218,-3218
"275","2888新光金","110/08/19","福邦-新竹",982,0,982
"276","2888新光金","110/08/19","瑞士信貸",1,3126,-3125
"277","2888新光金","110/08/19","美商高盛",1215,342,873
"278","2888新光金","110/08/19","大昌-新竹",2,1424,-1422
"279","2888新光金","110/08/19","統一-板橋",650,15,635
"280","2888新光金","110/08/19","元富-虎尾",4,1276,-1272
"281","2888新光金","110/08/19","凱基-中山",634,3,631
"282","2888新光金","110/08/19","玉山-台南",134,1204,-1070
"283","2888新光金","110/08/19","永豐金-鳳山",569,12,557
"284","2888新光金","110/08/19","宏遠-光隆",25,1050,-1025
"285","2888新光金","110/08/19","新光",855,323,532
"286","2888新光金","110/08/19","玉山-板橋",106,841,-735
"287","2888新光金","110/08/19","統一-台中",558,30,528
"288","2888新光金","110/08/19","香港上海匯豐",0,728,-728
"289","2888新光金","110/08/19","凱基-鳳山",525,0,525
"290","2888新光金","110/08/19","台灣摩根士丹利",940,1609,-669
"291","2888新光金","110/08/19","統一",577,100,477
"292","2888新光金","110/08/19","中國信託",15,637,-622
"293","2888新光金","110/08/19","元大證券",1048,635,413
"294","2888新光金","110/08/19","元大-永和",20,600,-580
"295","2888新光金","110/08/19","美林",1075,740,335
"296","2888新光金","110/08/19","福勝",67,600,-533
"297","2888新光金","110/08/19","元大-嘉義",315,10,305
"298","2888新光金","110/08/19","凱基-中港",71,580,-509
"299","2888新光金","110/08/19","元大-大統",304,13,291
"300","2888新光金","110/08/19","群益金鼎",50,520,-470
"301","1340勝悅","110/08/19","國泰-台南",99,3,96
"302","1340勝悅","110/08/19","元大-成功",0,204,-204
"303","1340勝悅","110/08/19","台中銀",38,0,38
"304","1340勝悅","110/08/19","摩根大通",0,20,-20
"305","1340勝悅","110/08/19","國泰-板橋",13,0,13
"306","1340勝悅","110/08/19","瑞士信貸",0,12,-12
"307","1340勝悅","110/08/19","臺銀-金山",10,0,10
"308","1340勝悅","110/08/19","國票-敦北法人",0,12,-12
"309","1340勝悅","110/08/19","元富-中港",10,0,10
"310","1340勝悅","110/08/19","華南永昌-東昇",0,12,-12
"311","1340勝悅","110/08/19","國泰-敦南",13,3,10
"312","1340勝悅","110/08/19","永豐金-台南",0,12,-12
"313","1340勝悅","110/08/19","元富-新店",10,2,8
"314","1340勝悅","110/08/19","合庫-自強",0,11,-11
"315","1340勝悅","110/08/19","合庫-新竹",7,0,7
"316","1340勝悅","110/08/19","富邦-台中",0,5,-5
"317","1340勝悅","110/08/19","群益金鼎-館前",10,3,7
"318","1340勝悅","110/08/19","港商法國興業",0,4,-4
"319","1340勝悅","110/08/19","致和-東門",6,0,6
"320","1340勝悅","110/08/19","致和-金華",0,4,-4
"321","1340勝悅","110/08/19","元大-屏南",6,0,6
"322","1340勝悅","110/08/19","新光-台南",0,4,-4
"323","1340勝悅","110/08/19","臺灣企銀-埔墘",5,0,5
"324","1340勝悅","110/08/19","凱基-台北",1,5,-4
"325","1340勝悅","110/08/19","日盛-和美",5,0,5
"326","1340勝悅","110/08/19","土銀-南港",0,2,-2
"327","1340勝悅","110/08/19","第一金-新竹",5,0,5
"328","1340勝悅","110/08/19","元富-世貿",0,2,-2
"329","1340勝悅","110/08/19","新光-桃園",5,0,5
"330","1340勝悅","110/08/19","元大-信義",0,2,-2
"331","6246臺龍","110/08/19","新光-台中",18,1,17
"332","6246臺龍","110/08/19","日盛-和美",0,10,-10
"333","6246臺龍","110/08/19","台灣企銀-台南",10,0,10
"334","6246臺龍","110/08/19","元大-基隆孝二",0,9,-9
"335","6246臺龍","110/08/19","凱基-台北",8,2,6
"336","6246臺龍","110/08/19","港商野村",0,6,-6
"337","6246臺龍","110/08/19","華南永昌-彰化",5,0,5
"338","6246臺龍","110/08/19","臺銀-高雄",0,5,-5
"339","6246臺龍","110/08/19","元大-南投",5,0,5
"340","6246臺龍","110/08/19","兆豐-公益",0,5,-5
"341","6246臺龍","110/08/19","元大-林園",5,0,5
"342","6246臺龍","110/08/19","永豐金-三重",0,5,-5
"343","6246臺龍","110/08/19","日盛-斗六",4,0,4
"344","6246臺龍","110/08/19","中國信託",0,4,-4
"345","6246臺龍","110/08/19","兆豐-新營",4,0,4
"346","6246臺龍","110/08/19","元大-北成功",0,4,-4
"347","6246臺龍","110/08/19","(牛牛牛)亞-鑫豐",3,0,3
"348","6246臺龍","110/08/19","元大-台南",0,4,-4
"349","6246臺龍","110/08/19","台新-台中",3,0,3
"350","6246臺龍","110/08/19","元富-烏日",0,3,-3
"351","6246臺龍","110/08/19","元大-大統",3,0,3
"352","6246臺龍","110/08/19","玉山-城中",0,3,-3
"353","6246臺龍","110/08/19","臺銀-民權",2,0,2
"354","6246臺龍","110/08/19","元大-長庚",0,3,-3
"355","6246臺龍","110/08/19","第一金-大稻埕",2,0,2
"356","6246臺龍","110/08/19","元大-苑裡",0,3,-3
"357","6246臺龍","110/08/19","元富-大昌",2,0,2
"358","6246臺龍","110/08/19","永豐金-屏東",0,3,-3
"359","6246臺龍","110/08/19","國票-敦北法人",2,0,2
"360","6246臺龍","110/08/19","統一-永和",0,2,-2
"361","00715L期街口布蘭特正2","110/08/19","台新證券",1458,205,1253
"362","00715L期街口布蘭特正2","110/08/19","元大證券",4224,11178,-6954
"363","00715L期街口布蘭特正2","110/08/19","富邦-南屯",1119,14,1105
"364","00715L期街口布蘭特正2","110/08/19","合庫證券",266,2599,-2333
"365","00715L期街口布蘭特正2","110/08/19","元大-永康",1118,19,1099
"366","00715L期街口布蘭特正2","110/08/19","永豐金證券",8,2207,-2199
"367","00715L期街口布蘭特正2","110/08/19","豐農",1023,30,993
"368","00715L期街口布蘭特正2","110/08/19","元大-屏東民生",14,2200,-2186
"369","00715L期街口布蘭特正2","110/08/19","元大-復北",954,74,880
"370","00715L期街口布蘭特正2","110/08/19","凱基-台北",245,1890,-1645
"371","00715L期街口布蘭特正2","110/08/19","中國信託-新竹",840,0,840
"372","00715L期街口布蘭特正2","110/08/19","國票-博愛",10,1405,-1395
"373","00715L期街口布蘭特正2","110/08/19","富邦證券",2317,1629,688
"374","00715L期街口布蘭特正2","110/08/19","元富",10,1165,-1155
"375","00715L期街口布蘭特正2","110/08/19","第一金-台南",540,0,540
"376","00715L期街口布蘭特正2","110/08/19","新光",791,1810,-1019
"377","00715L期街口布蘭特正2","110/08/19","兆豐-台中港",523,30,493
"378","00715L期街口布蘭特正2","110/08/19","統一",3,978,-975
"379","00715L期街口布蘭特正2","110/08/19","兆豐-嘉義",465,110,355
"380","00715L期街口布蘭特正2","110/08/19","華南永昌-長虹",82,830,-748
"381","00715L期街口布蘭特正2","110/08/19","元大-大里德芳",323,0,323
"382","00715L期街口布蘭特正2","110/08/19","群益金鼎-宜蘭",20,737,-717
"383","00715L期街口布蘭特正2","110/08/19","富邦-基隆",336,20,316
"384","00715L期街口布蘭特正2","110/08/19","亞東",21,512,-491
"385","00715L期街口布蘭特正2","110/08/19","元大-草屯",434,124,310
"386","00715L期街口布蘭特正2","110/08/19","永豐金-板盛",6,420,-414
"387","00715L期街口布蘭特正2","110/08/19","國泰-敦南",552,280,272
"388","00715L期街口布蘭特正2","110/08/19","第一金-自由",28,419,-391
"389","00715L期街口布蘭特正2","110/08/19","永豐金-羅東",270,2,268
"390","00715L期街口布蘭特正2","110/08/19","元大-高雄",128,502,-374
"391","8941關中","110/08/19","宏遠-館前",2,0,2
"392","8941關中","110/08/19","富邦-台中",0,6,-6
"393","8941關中","110/08/19","元大-西門",2,0,2
"394","8941關中","110/08/19","兆豐-台中",0,2,-2
"395","8941關中","110/08/19","新光-台中",1,0,1
"396","8941關中","110/08/19","元大-金華",1,2,-1
"397","8941關中","110/08/19","玉山-桃園",1,0,1
"398","8941關中","110/08/19","兆豐-南京",0,0,0
"399","8941關中","110/08/19","國泰-忠孝",1,0,1
"400","8941關中","110/08/19","富邦-仁愛",0,0,0
"401","8941關中","110/08/19","元大-華山",1,0,1
"402","8941關中","110/08/19","元大-大雅",0,0,0
"403","8941關中","110/08/19","元大-桃興",1,0,1
"404","8941關中","110/08/19","永豐金-敦北",0,0,0
"405","8941關中","110/08/19","兆豐-南京",0,0,0
"406","8941關中","110/08/19","永豐金-南投",0,0,0
"407","8941關中","110/08/19","富邦-仁愛",0,0,0
"408","8941關中","110/08/19","",NA,NA,NA
"409","8941關中","110/08/19","元大-大雅",0,0,0
"410","8941關中","110/08/19","",NA,NA,NA
"411","8941關中","110/08/19","永豐金-敦北",0,0,0
"412","8941關中","110/08/19","",NA,NA,NA
"413","8941關中","110/08/19","永豐金-南投",0,0,0
"414","8941關中","110/08/19","",NA,NA,NA
"415","8941關中","110/08/19","",NA,NA,NA
"416","8941關中","110/08/19","",NA,NA,NA
"417","8941關中","110/08/19","",NA,NA,NA
"418","8941關中","110/08/19","",NA,NA,NA
"419","8941關中","110/08/19","",NA,NA,NA
"420","8941關中","110/08/19","",NA,NA,NA
"421","8936國統","110/08/19","宏遠-台南",211,0,211
"422","8936國統","110/08/19","元大-高雄",0,40,-40
"423","8936國統","110/08/19","康和-高雄",126,1,125
"424","8936國統","110/08/19","永豐金-苓雅",0,38,-38
"425","8936國統","110/08/19","凱基-台北",122,66,56
"426","8936國統","110/08/19","美商高盛",6,38,-32
"427","8936國統","110/08/19","美林",54,0,54
"428","8936國統","110/08/19","港商野村",17,38,-21
"429","8936國統","110/08/19","新加坡商瑞銀",46,20,26
"430","8936國統","110/08/19","日盛-頭份",0,20,-20
"431","8936國統","110/08/19","元富-緯城",25,0,25
"432","8936國統","110/08/19","兆豐-三重",0,20,-20
"433","8936國統","110/08/19","富邦-高雄",14,0,14
"434","8936國統","110/08/19","玉山-桃園",0,20,-20
"435","8936國統","110/08/19","日盛-復興",10,0,10
"436","8936國統","110/08/19","國泰-高雄",4,22,-18
"437","8936國統","110/08/19","宏遠-高雄",18,8,10
"438","8936國統","110/08/19","台灣摩根士丹利",0,17,-17
"439","8936國統","110/08/19","中國信託-高雄",20,12,8
"440","8936國統","110/08/19","凱基-竹科",0,16,-16
"441","8936國統","110/08/19","日盛-豐原",7,0,7
"442","8936國統","110/08/19","元大-大里德芳",0,16,-16
"443","8936國統","110/08/19","元富-三重",7,0,7
"444","8936國統","110/08/19","大昌-樹林",0,15,-15
"445","8936國統","110/08/19","台新-高雄",10,3,7
"446","8936國統","110/08/19","台新-屏東",0,12,-12
"447","8936國統","110/08/19","臺銀-高雄",6,0,6
"448","8936國統","110/08/19","中農",0,11,-11
"449","8936國統","110/08/19","第一金-路竹",6,0,6
"450","8936國統","110/08/19","臺銀-新竹",0,10,-10
"451","6226光鼎","110/08/19","富邦-左營",110,2,108
"452","6226光鼎","110/08/19","凱基-台北",177,732,-555
"453","6226光鼎","110/08/19","元大-北屯",151,50,101
"454","6226光鼎","110/08/19","摩根大通",28,396,-368
"455","6226光鼎","110/08/19","國泰-敦南",201,125,76
"456","6226光鼎","110/08/19","台灣摩根士丹利",0,254,-254
"457","6226光鼎","110/08/19","元大-敦化",56,4,52
"458","6226光鼎","110/08/19","元大-文心興安",1,230,-229
"459","6226光鼎","110/08/19","兆豐-中壢",50,1,49
"460","6226光鼎","110/08/19","美商高盛",33,233,-200
"461","6226光鼎","110/08/19","凱基-台中",44,2,42
"462","6226光鼎","110/08/19","富邦-台北",22,202,-180
"463","6226光鼎","110/08/19","新光",121,81,40
"464","6226光鼎","110/08/19","美林",72,160,-88
"465","6226光鼎","110/08/19","合庫-西台中",47,10,37
"466","6226光鼎","110/08/19","新加坡商瑞銀",138,225,-87
"467","6226光鼎","110/08/19","元大-龍潭",42,5,37
"468","6226光鼎","110/08/19","元大-南勢角",0,70,-70
"469","6226光鼎","110/08/19","兆豐-東門",36,0,36
"470","6226光鼎","110/08/19","臺銀-高雄",0,67,-67
"471","6226光鼎","110/08/19","新光-台中",83,48,35
"472","6226光鼎","110/08/19","港商野村",178,231,-53
"473","6226光鼎","110/08/19","玉山-桃園",39,4,35
"474","6226光鼎","110/08/19","永豐金-內湖",6,56,-50
"475","6226光鼎","110/08/19","元大-竹科",59,24,35
"476","6226光鼎","110/08/19","高橋-內壢",5,54,-49
"477","6226光鼎","110/08/19","第一金-台南",33,0,33
"478","6226光鼎","110/08/19","凱基-員林",7,53,-46
"479","6226光鼎","110/08/19","台新證券",66,33,33
"480","6226光鼎","110/08/19","台新-台中",28,65,-37
"481","2363矽統","110/08/19","日盛-樹林",300,12,288
"482","2363矽統","110/08/19","凱基-台北",560,1671,-1111
"483","2363矽統","110/08/19","永豐金-板盛",200,2,198
"484","2363矽統","110/08/19","摩根大通",3,713,-710
"485","2363矽統","110/08/19","凱基-三峽",134,18,116
"486","2363矽統","110/08/19","台新-三民",50,291,-241
"487","2363矽統","110/08/19","富邦-新竹",94,7,87
"488","2363矽統","110/08/19","台灣摩根士丹利",0,206,-206
"489","2363矽統","110/08/19","元大-汐止",75,8,67
"490","2363矽統","110/08/19","凱基-和平",1,132,-131
"491","2363矽統","110/08/19","元大-斗六",67,2,65
"492","2363矽統","110/08/19","永豐金證券",12,125,-113
"493","2363矽統","110/08/19","大慶-蘆洲",69,13,56
"494","2363矽統","110/08/19","石橋證券",50,155,-105
"495","2363矽統","110/08/19","永豐金-豐原",55,2,53
"496","2363矽統","110/08/19","港商野村",838,925,-87
"497","2363矽統","110/08/19","日盛-豐原",59,10,49
"498","2363矽統","110/08/19","新光-桃園",4,87,-83
"499","2363矽統","110/08/19","群益金鼎-中壢",54,7,47
"500","2363矽統","110/08/19","新光",212,282,-70
"501","2363矽統","110/08/19","元大-南投",58,12,46
"502","2363矽統","110/08/19","陽信-石牌",18,83,-65
"503","2363矽統","110/08/19","富邦-板橋",51,7,44
"504","2363矽統","110/08/19","美林",31,91,-60
"505","2363矽統","110/08/19","台新證券",117,74,43
"506","2363矽統","110/08/19","永豐金-新店",1,59,-58
"507","2363矽統","110/08/19","元大-東港",45,2,43
"508","2363矽統","110/08/19","台新-左楠",19,76,-57
"509","2363矽統","110/08/19","元大-旗山",47,5,42
"510","2363矽統","110/08/19","永全-南崁",7,53,-46
"511","8112至上","110/08/19","元大-敦化",60,0,60
"512","8112至上","110/08/19","港商野村",22,279,-257
"513","8112至上","110/08/19","玉山-城中",60,2,58
"514","8112至上","110/08/19","瑞士信貸",0,239,-239
"515","8112至上","110/08/19","永豐金-敦南",52,4,48
"516","8112至上","110/08/19","凱基-台北",101,275,-174
"517","8112至上","110/08/19","統一",41,0,41
"518","8112至上","110/08/19","摩根大通",161,332,-171
"519","8112至上","110/08/19","元大-竹東",36,0,36
"520","8112至上","110/08/19","凱基-市政",0,80,-80
"521","8112至上","110/08/19","凱基-嘉義",35,0,35
"522","8112至上","110/08/19","台灣摩根士丹利",6,75,-69
"523","8112至上","110/08/19","新光-台南",32,0,32
"524","8112至上","110/08/19","美商高盛",18,76,-58
"525","8112至上","110/08/19","永興-水湳",30,0,30
"526","8112至上","110/08/19","新加坡商瑞銀",22,76,-54
"527","8112至上","110/08/19","元大-永和",29,0,29
"528","8112至上","110/08/19","美林",9,61,-52
"529","8112至上","110/08/19","凱基-東勢",26,1,25
"530","8112至上","110/08/19","富邦-花蓮",1,51,-50
"531","8112至上","110/08/19","臺銀-臺南",28,4,24
"532","8112至上","110/08/19","元大-路竹",8,52,-44
"533","8112至上","110/08/19","富邦-中壢",29,5,24
"534","8112至上","110/08/19","(牛牛牛)亞-鑫豐",34,77,-43
"535","8112至上","110/08/19","第一金-桃園",24,1,23
"536","8112至上","110/08/19","台新-中壢",2,42,-40
"537","8112至上","110/08/19","國泰-敦南",27,4,23
"538","8112至上","110/08/19","國泰證券",0,40,-40
"539","8112至上","110/08/19","凱基-文心",23,0,23
"540","8112至上","110/08/19","永豐金-苓雅",0,40,-40
"541","1570力肯","110/08/19","國票-北高雄",37,0,37
"542","1570力肯","110/08/19","新光-台南",3,44,-41
"543","1570力肯","110/08/19","康和-台南",30,0,30
"544","1570力肯","110/08/19","元大-大統",0,20,-20
"545","1570力肯","110/08/19","國票-內壢",25,0,25
"546","1570力肯","110/08/19","元富-新店",0,18,-18
"547","1570力肯","110/08/19","元富-虎尾",20,0,20
"548","1570力肯","110/08/19","元大-民生",2,19,-17
"549","1570力肯","110/08/19","國票-博愛",17,0,17
"550","1570力肯","110/08/19","國泰-敦南",1,16,-15
"551","1570力肯","110/08/19","日盛-高雄",15,0,15
"552","1570力肯","110/08/19","富邦-敦南",0,15,-15
"553","1570力肯","110/08/19","元大-南投",15,0,15
"554","1570力肯","110/08/19","元大-大雅",10,25,-15
"555","1570力肯","110/08/19","富邦-嘉義",15,1,14
"556","1570力肯","110/08/19","日盛-板橋",2,16,-14
"557","1570力肯","110/08/19","元大-北投",13,0,13
"558","1570力肯","110/08/19","華南永昌-嘉義",0,12,-12
"559","1570力肯","110/08/19","元富-緯城",12,0,12
"560","1570力肯","110/08/19","凱基-台北",3,14,-11
"561","1570力肯","110/08/19","土銀-新竹",11,0,11
"562","1570力肯","110/08/19","元富-草屯",0,10,-10
"563","1570力肯","110/08/19","日盛-嘉義",11,0,11
"564","1570力肯","110/08/19","新光",7,17,-10
"565","1570力肯","110/08/19","富邦-羅東",11,0,11
"566","1570力肯","110/08/19","富邦-內湖",3,13,-10
"567","1570力肯","110/08/19","富邦-仁愛",10,0,10
"568","1570力肯","110/08/19","元大-福營",0,10,-10
"569","1570力肯","110/08/19","元大-羅東",10,0,10
"570","1570力肯","110/08/19","元大-松山",0,10,-10
"571","2929淘帝","110/08/19","元大-太平",54,0,54
"572","2929淘帝","110/08/19","摩根大通",0,58,-58
"573","2929淘帝","110/08/19","凱基-東門",32,0,32
"574","2929淘帝","110/08/19","宏遠-館前",0,35,-35
"575","2929淘帝","110/08/19","日盛-桃園",20,0,20
"576","2929淘帝","110/08/19","元富-台南",0,32,-32
"577","2929淘帝","110/08/19","富邦-高雄",16,0,16
"578","2929淘帝","110/08/19","日茂",0,20,-20
"579","2929淘帝","110/08/19","元大-員林",11,0,11
"580","2929淘帝","110/08/19","美商高盛",0,11,-11
"581","2929淘帝","110/08/19","凱基-中山",10,0,10
"582","2929淘帝","110/08/19","凱基-站前",0,10,-10
"583","2929淘帝","110/08/19","富邦-南屯",7,0,7
"584","2929淘帝","110/08/19","統一-三重",0,8,-8
"585","2929淘帝","110/08/19","日盛-雙和",6,0,6
"586","2929淘帝","110/08/19","群益金鼎",0,7,-7
"587","2929淘帝","110/08/19","亞東-新竹",6,0,6
"588","2929淘帝","110/08/19","凱基-八德",0,7,-7
"589","2929淘帝","110/08/19","兆豐-桃鶯",6,0,6
"590","2929淘帝","110/08/19","港商野村",3,9,-6
"591","2929淘帝","110/08/19","新光",6,0,6
"592","2929淘帝","110/08/19","安泰",0,5,-5
"593","2929淘帝","110/08/19","群益金鼎-三重",5,0,5
"594","2929淘帝","110/08/19","元大-金門",0,5,-5
"595","2929淘帝","110/08/19","元大-左營",5,0,5
"596","2929淘帝","110/08/19","永豐金-竹科",0,5,-5
"597","2929淘帝","110/08/19","台新-新莊",9,5,4
"598","2929淘帝","110/08/19","致和證券",0,4,-4
"599","2929淘帝","110/08/19","群益金鼎-新店",4,0,4
"600","2929淘帝","110/08/19","元大-苑裡",0,4,-4
"601","5410國眾","110/08/19","土銀-嘉義",14,0,14
"602","5410國眾","110/08/19","致和-台北",0,60,-60
"603","5410國眾","110/08/19","國票-北高雄",10,0,10
"604","5410國眾","110/08/19","凱基-台北",1,20,-19
"605","5410國眾","110/08/19","玉山-城中",10,0,10
"606","5410國眾","110/08/19","新加坡商瑞銀",0,14,-14
"607","5410國眾","110/08/19","元大-中壢",9,0,9
"608","5410國眾","110/08/19","亞東-新竹",0,14,-14
"609","5410國眾","110/08/19","台新證券",8,0,8
"610","5410國眾","110/08/19","富邦-永和",0,7,-7
"611","5410國眾","110/08/19","新光",7,1,6
"612","5410國眾","110/08/19","摩根大通",0,5,-5
"613","5410國眾","110/08/19","日盛-八德",5,0,5
"614","5410國眾","110/08/19","元大-南勢角",0,3,-3
"615","5410國眾","110/08/19","元大-旗山",5,0,5
"616","5410國眾","110/08/19","元大-板橋三民",0,3,-3
"617","5410國眾","110/08/19","元大-博愛",5,0,5
"618","5410國眾","110/08/19","元富-大昌",0,2,-2
"619","5410國眾","110/08/19","元大-左營",5,0,5
"620","5410國眾","110/08/19","台中銀-員林",0,2,-2
"621","5410國眾","110/08/19","臺銀-金山",6,2,4
"622","5410國眾","110/08/19","台新-左楠",0,2,-2
"623","5410國眾","110/08/19","統一-台中",4,0,4
"624","5410國眾","110/08/19","群益金鼎-東門",0,2,-2
"625","5410國眾","110/08/19","元大-開元",4,0,4
"626","5410國眾","110/08/19","凱基-汐止",0,2,-2
"627","5410國眾","110/08/19","日盛-園區",3,0,3
"628","5410國眾","110/08/19","華南永昌-小港",0,2,-2
"629","5410國眾","110/08/19","國泰-敦南",3,0,3
"630","5410國眾","110/08/19","富邦-新店",0,2,-2
"631","2841台開","110/08/19","宏遠-館前",360,0,360
"632","2841台開","110/08/19","元大證券",0,108,-108
"633","2841台開","110/08/19","第一金",104,0,104
"634","2841台開","110/08/19","國票-敦北法人",0,98,-98
"635","2841台開","110/08/19","日盛-台中",35,1,34
"636","2841台開","110/08/19","台中銀",0,93,-93
"637","2841台開","110/08/19","合庫證券",20,0,20
"638","2841台開","110/08/19","元大-府城",0,51,-51
"639","2841台開","110/08/19","第一金-台中",20,0,20
"640","2841台開","110/08/19","日盛-信義",0,50,-50
"641","2841台開","110/08/19","富邦-基隆",20,0,20
"642","2841台開","110/08/19","新光-台南",0,46,-46
"643","2841台開","110/08/19","富邦-三重",20,0,20
"644","2841台開","110/08/19","永豐金-桃園",0,41,-41
"645","2841台開","110/08/19","元大-六合",17,0,17
"646","2841台開","110/08/19","凱基-高美館",0,30,-30
"647","2841台開","110/08/19","國泰-館前",11,0,11
"648","2841台開","110/08/19","凱基-新豐",0,30,-30
"649","2841台開","110/08/19","統一-新台中",10,0,10
"650","2841台開","110/08/19","第一金-忠孝",0,20,-20
"651","2841台開","110/08/19","玉山證券",10,0,10
"652","2841台開","110/08/19","富邦-員林",0,20,-20
"653","2841台開","110/08/19","國泰-台中",10,0,10
"654","2841台開","110/08/19","日盛證券",22,38,-16
"655","2841台開","110/08/19","國泰-忠孝",10,0,10
"656","2841台開","110/08/19","國泰-敦南",3,19,-16
"657","2841台開","110/08/19","元大-東泰",10,0,10
"658","2841台開","110/08/19","中國信託-嘉義",0,15,-15
"659","2841台開","110/08/19","元大-高雄",10,0,10
"660","2841台開","110/08/19","永豐金-敦南",17,29,-12
"661","6207雷科","110/08/19","元大-高雄",76,0,76
"662","6207雷科","110/08/19","凱基-大安",0,50,-50
"663","6207雷科","110/08/19","光和-和美",53,0,53
"664","6207雷科","110/08/19","凱基-復興",2,30,-28
"665","6207雷科","110/08/19","日盛-桃園",10,0,10
"666","6207雷科","110/08/19","日盛-三重",0,23,-23
"667","6207雷科","110/08/19","元大-六合",10,0,10
"668","6207雷科","110/08/19","港商野村",8,30,-22
"669","6207雷科","110/08/19","凱基-台北",21,13,8
"670","6207雷科","110/08/19","新加坡商瑞銀",12,29,-17
"671","6207雷科","110/08/19","永豐金-高雄",8,0,8
"672","6207雷科","110/08/19","日茂-埔里",0,17,-17
"673","6207雷科","110/08/19","凱基-高雄",7,0,7
"674","6207雷科","110/08/19","摩根大通",7,21,-14
"675","6207雷科","110/08/19","元大-沙鹿",6,0,6
"676","6207雷科","110/08/19","群益金鼎-東門",0,12,-12
"677","6207雷科","110/08/19","元大-東門",6,0,6
"678","6207雷科","110/08/19","富邦-虎尾",0,10,-10
"679","6207雷科","110/08/19","元富-吉利",5,0,5
"680","6207雷科","110/08/19","凱基-高美館",5,14,-9
"681","6207雷科","110/08/19","大昌-桃園",5,0,5
"682","6207雷科","110/08/19","富邦-板橋",0,8,-8
"683","6207雷科","110/08/19","玉山-大里",5,0,5
"684","6207雷科","110/08/19","元富-潮州",0,7,-7
"685","6207雷科","110/08/19","元大-大益",5,0,5
"686","6207雷科","110/08/19","凱基-員林",0,7,-7
"687","6207雷科","110/08/19","元大-福營",4,0,4
"688","6207雷科","110/08/19","華南永昌-林口",0,7,-7
"689","6207雷科","110/08/19","臺銀-臺中",3,0,3
"690","6207雷科","110/08/19","日盛-八德",0,6,-6
"691","3679新至陞","110/08/19","台灣摩根士丹利",7,0,7
"692","3679新至陞","110/08/19","摩根大通",3,11,-8
"693","3679新至陞","110/08/19","元大-板橋",6,0,6
"694","3679新至陞","110/08/19","瑞士信貸",1,6,-5
"695","3679新至陞","110/08/19","美林",10,5,5
"696","3679新至陞","110/08/19","美商高盛",0,3,-3
"697","3679新至陞","110/08/19","日盛-土城",2,0,2
"698","3679新至陞","110/08/19","宏遠-館前",0,2,-2
"699","3679新至陞","110/08/19","富邦-新店",2,0,2
"700","3679新至陞","110/08/19","港商野村",0,2,-2
"701","3679新至陞","110/08/19","土銀-新竹",1,0,1
"702","3679新至陞","110/08/19","花旗環球",0,2,-2
"703","3679新至陞","110/08/19","臺銀-高雄",1,0,1
"704","3679新至陞","110/08/19","國泰-高雄",0,2,-2
"705","3679新至陞","110/08/19","(牛牛牛)亞-網路",1,0,1
"706","3679新至陞","110/08/19","元大證券",1,3,-2
"707","3679新至陞","110/08/19","中國信託-永康",1,0,1
"708","3679新至陞","110/08/19","元大-新店中正",0,2,-2
"709","3679新至陞","110/08/19","光和-溪湖",1,0,1
"710","3679新至陞","110/08/19","元大-成功",0,2,-2
"711","3679新至陞","110/08/19","兆豐證券",1,0,1
"712","3679新至陞","110/08/19","永豐金-板新",0,2,-2
"713","3679新至陞","110/08/19","國票-台東",1,0,1
"714","3679新至陞","110/08/19","土銀-和平",0,1,-1
"715","3679新至陞","110/08/19","玉山-新莊",1,0,1
"716","3679新至陞","110/08/19","新加坡商瑞銀",0,1,-1
"717","3679新至陞","110/08/19","玉山-嘉義",1,0,1
"718","3679新至陞","110/08/19","第一金-忠孝",0,1,-1
"719","3679新至陞","110/08/19","群益金鼎-高盛",1,0,1
"720","3679新至陞","110/08/19","凱基",0,1,-1
"721","2727王品","110/08/19","日盛-忠孝",36,0,36
"722","2727王品","110/08/19","宏遠證券",0,75,-75
"723","2727王品","110/08/19","中國信託-高雄",12,0,12
"724","2727王品","110/08/19","美林",0,49,-49
"725","2727王品","110/08/19","國泰-敦南",17,6,11
"726","2727王品","110/08/19","摩根大通",1,47,-46
"727","2727王品","110/08/19","群益金鼎-新店",10,0,10
"728","2727王品","110/08/19","永豐金證券",2,45,-43
"729","2727王品","110/08/19","富邦-羅東",10,0,10
"730","2727王品","110/08/19","美商高盛",2,39,-37
"731","2727王品","110/08/19","富邦-仁愛",9,0,9
"732","2727王品","110/08/19","凱基-台北",27,56,-29
"733","2727王品","110/08/19","國泰-台中",14,6,8
"734","2727王品","110/08/19","新光-台中",5,28,-23
"735","2727王品","110/08/19","元大-北屯",10,2,8
"736","2727王品","110/08/19","台灣摩根士丹利",1,21,-20
"737","2727王品","110/08/19","元富-大昌",7,0,7
"738","2727王品","110/08/19","凱基-東門",0,18,-18
"739","2727王品","110/08/19","台新-台中",9,2,7
"740","2727王品","110/08/19","統一",0,17,-17
"741","2727王品","110/08/19","新光-新竹",7,0,7
"742","2727王品","110/08/19","瑞士信貸",2,13,-11
"743","2727王品","110/08/19","凱基-基隆",7,0,7
"744","2727王品","110/08/19","新加坡商瑞銀",0,11,-11
"745","2727王品","110/08/19","宏遠-高雄",6,0,6
"746","2727王品","110/08/19","港商野村",18,28,-10
"747","2727王品","110/08/19","台新證券",6,0,6
"748","2727王品","110/08/19","富邦-新店",1,11,-10
"749","2727王品","110/08/19","玉山證券",6,0,6
"750","2727王品","110/08/19","元大-善化",0,10,-10
"751","1570力肯","110/08/19","國票-北高雄",37,0,37
"752","1570力肯","110/08/19","新光-台南",3,44,-41
"753","1570力肯","110/08/19","康和-台南",30,0,30
"754","1570力肯","110/08/19","元大-大統",0,20,-20
"755","1570力肯","110/08/19","國票-內壢",25,0,25
"756","1570力肯","110/08/19","元富-新店",0,18,-18
"757","1570力肯","110/08/19","元富-虎尾",20,0,20
"758","1570力肯","110/08/19","元大-民生",2,19,-17
"759","1570力肯","110/08/19","國票-博愛",17,0,17
"760","1570力肯","110/08/19","國泰-敦南",1,16,-15
"761","1570力肯","110/08/19","日盛-高雄",15,0,15
"762","1570力肯","110/08/19","富邦-敦南",0,15,-15
"763","1570力肯","110/08/19","元大-南投",15,0,15
"764","1570力肯","110/08/19","元大-大雅",10,25,-15
"765","1570力肯","110/08/19","富邦-嘉義",15,1,14
"766","1570力肯","110/08/19","日盛-板橋",2,16,-14
"767","1570力肯","110/08/19","元大-北投",13,0,13
"768","1570力肯","110/08/19","華南永昌-嘉義",0,12,-12
"769","1570力肯","110/08/19","元富-緯城",12,0,12
"770","1570力肯","110/08/19","凱基-台北",3,14,-11
"771","1570力肯","110/08/19","土銀-新竹",11,0,11
"772","1570力肯","110/08/19","元富-草屯",0,10,-10
"773","1570力肯","110/08/19","日盛-嘉義",11,0,11
"774","1570力肯","110/08/19","新光",7,17,-10
"775","1570力肯","110/08/19","富邦-羅東",11,0,11
"776","1570力肯","110/08/19","富邦-內湖",3,13,-10
"777","1570力肯","110/08/19","富邦-仁愛",10,0,10
"778","1570力肯","110/08/19","元大-福營",0,10,-10
"779","1570力肯","110/08/19","元大-羅東",10,0,10
"780","1570力肯","110/08/19","元大-松山",0,10,-10
"781","6180橘子","110/08/19","美林",29,0,29
"782","6180橘子","110/08/19","新光-台中",4,23,-19
"783","6180橘子","110/08/19","美商高盛",24,0,24
"784","6180橘子","110/08/19","元大-大甲",0,16,-16
"785","6180橘子","110/08/19","富邦-竹東",21,0,21
"786","6180橘子","110/08/19","元富-城東",1,13,-12
"787","6180橘子","110/08/19","第一金-新竹",20,0,20
"788","6180橘子","110/08/19","凱基-台北",2,13,-11
"789","6180橘子","110/08/19","富邦-永和",11,0,11
"790","6180橘子","110/08/19","凱基-竹科",1,12,-11
"791","6180橘子","110/08/19","合庫-自強",10,0,10
"792","6180橘子","110/08/19","元富-草屯",0,10,-10
"793","6180橘子","110/08/19","富邦-新竹",12,2,10
"794","6180橘子","110/08/19","新光",8,18,-10
"795","6180橘子","110/08/19","元大-中壢",10,1,9
"796","6180橘子","110/08/19","凱基-站前",0,10,-10
"797","6180橘子","110/08/19","國泰-板橋",7,1,6
"798","6180橘子","110/08/19","元大-文心興安",0,10,-10
"799","6180橘子","110/08/19","富隆-長安",5,0,5
"800","6180橘子","110/08/19","永豐金-新店",0,10,-10
"801","6180橘子","110/08/19","大慶-苗栗",5,0,5
"802","6180橘子","110/08/19","兆豐-新營",1,10,-9
"803","6180橘子","110/08/19","台新-屏東",5,0,5
"804","6180橘子","110/08/19","元大-北屯",1,10,-9
"805","6180橘子","110/08/19","元大-向上",5,0,5
"806","6180橘子","110/08/19","摩根大通",28,36,-8
"807","6180橘子","110/08/19","永豐金-竹科",5,0,5
"808","6180橘子","110/08/19","凱基-市政",0,7,-7
"809","6180橘子","110/08/19","土銀-新竹",4,0,4
"810","6180橘子","110/08/19","台灣摩根士丹利",11,17,-6
"811","2390云辰","110/08/19","富邦-花蓮",100,0,100
"812","2390云辰","110/08/19","摩根大通",96,805,-709
"813","2390云辰","110/08/19","統一-新台中",86,0,86
"814","2390云辰","110/08/19","美林",195,271,-76
"815","2390云辰","110/08/19","凱基-台北",335,254,81
"816","2390云辰","110/08/19","兆豐-桃園",15,90,-75
"817","2390云辰","110/08/19","國票-博愛",132,54,78
"818","2390云辰","110/08/19","大昌-新店",27,92,-65
"819","2390云辰","110/08/19","凱基-台中",77,1,76
"820","2390云辰","110/08/19","宏遠-桃園",1,63,-62
"821","2390云辰","110/08/19","凱基-和平",60,2,58
"822","2390云辰","110/08/19","華南永昌-公誠",53,110,-57
"823","2390云辰","110/08/19","國票-安和",53,10,43
"824","2390云辰","110/08/19","大慶-富順",11,67,-56
"825","2390云辰","110/08/19","元大-四維",46,10,36
"826","2390云辰","110/08/19","元大-歸仁",2,55,-53
"827","2390云辰","110/08/19","中農",55,20,35
"828","2390云辰","110/08/19","日茂",7,58,-51
"829","2390云辰","110/08/19","第一金-安和",55,22,33
"830","2390云辰","110/08/19","元大-大灣",10,60,-50
"831","2390云辰","110/08/19","元大-雙和",42,12,30
"832","2390云辰","110/08/19","凱基-三重",1,48,-47
"833","2390云辰","110/08/19","國泰-館前",77,48,29
"834","2390云辰","110/08/19","國票-台東",2,41,-39
"835","2390云辰","110/08/19","元大-文心興安",42,13,29
"836","2390云辰","110/08/19","豐農",7,41,-34
"837","2390云辰","110/08/19","(牛牛牛)亞-鑫豐",59,31,28
"838","2390云辰","110/08/19","凱基-中港",5,36,-31
"839","2390云辰","110/08/19","國泰-高雄",44,18,26
"840","2390云辰","110/08/19","永豐金-嘉義",3,32,-29
