"","stake","date","name","buy","sell","total"
"1","2609陽明","110/08/13","凱基-台北",10192,4911,5281
"2","2609陽明","110/08/13","兆豐-中壢",995,9892,-8897
"3","2609陽明","110/08/13","群益金鼎-三重",3617,1227,2390
"4","2609陽明","110/08/13","中國信託-松江",208,4801,-4593
"5","2609陽明","110/08/13","兆豐-三民",2480,256,2224
"6","2609陽明","110/08/13","富邦證券",5398,9750,-4352
"7","2609陽明","110/08/13","新光",6408,4476,1932
"8","2609陽明","110/08/13","康和",1128,5161,-4033
"9","2609陽明","110/08/13","日盛-大墩",2359,460,1899
"10","2609陽明","110/08/13","台灣摩根士丹利",841,4432,-3591
"11","2609陽明","110/08/13","元大-敦南",1851,295,1556
"12","2609陽明","110/08/13","永豐金-信義",131,2886,-2755
"13","2609陽明","110/08/13","元大-竹科",1588,557,1031
"14","2609陽明","110/08/13","華南永昌-竹北",296,2990,-2694
"15","2609陽明","110/08/13","花旗環球",1019,12,1007
"16","2609陽明","110/08/13","群益金鼎-新莊",413,2647,-2234
"17","2609陽明","110/08/13","新加坡商瑞銀",2546,1548,998
"18","2609陽明","110/08/13","富邦-嘉義",16745,18175,-1430
"19","2609陽明","110/08/13","永豐金-古亭",1337,340,997
"20","2609陽明","110/08/13","兆豐-虎尾",6649,8052,-1403
"21","2609陽明","110/08/13","日盛證券",2105,1310,795
"22","2609陽明","110/08/13","群益金鼎-大安",2299,3556,-1257
"23","2609陽明","110/08/13","凱基-城中",2027,1318,709
"24","2609陽明","110/08/13","美林",4551,5778,-1227
"25","2609陽明","110/08/13","台新-台南",1272,589,683
"26","2609陽明","110/08/13","瑞士信貸",1104,2131,-1027
"27","2609陽明","110/08/13","元大-信義",1086,414,672
"28","2609陽明","110/08/13","日盛-板橋",462,1430,-968
"29","2609陽明","110/08/13","康和-台北",698,59,639
"30","2609陽明","110/08/13","統一-仁愛",3991,4945,-954
"31","2636台驊投控","110/08/13","統一-新台中",245,3,242
"32","2636台驊投控","110/08/13","新光-新竹",61,469,-408
"33","2636台驊投控","110/08/13","日盛-台中",304,123,181
"34","2636台驊投控","110/08/13","華南永昌-竹北",2,291,-289
"35","2636台驊投控","110/08/13","日盛-板橋",177,17,160
"36","2636台驊投控","110/08/13","瑞士信貸",85,306,-221
"37","2636台驊投控","110/08/13","宏遠證券",122,29,93
"38","2636台驊投控","110/08/13","美林",262,460,-198
"39","2636台驊投控","110/08/13","兆豐證券",105,17,88
"40","2636台驊投控","110/08/13","摩根大通",180,378,-198
"41","2636台驊投控","110/08/13","永豐金-市政",92,17,75
"42","2636台驊投控","110/08/13","富邦-虎尾",174,303,-129
"43","2636台驊投控","110/08/13","新光",365,304,61
"44","2636台驊投控","110/08/13","凱基-台北",411,534,-123
"45","2636台驊投控","110/08/13","日盛證券",80,22,58
"46","2636台驊投控","110/08/13","元大-虎尾",17,76,-59
"47","2636台驊投控","110/08/13","台灣摩根士丹利",157,99,58
"48","2636台驊投控","110/08/13","第一金-新竹",22,78,-56
"49","2636台驊投控","110/08/13","國泰-敦南",232,183,49
"50","2636台驊投控","110/08/13","統一-城中",1,55,-54
"51","2636台驊投控","110/08/13","元大-淡水",42,6,36
"52","2636台驊投控","110/08/13","石橋證券",4,52,-48
"53","2636台驊投控","110/08/13","新光-桃園",66,37,29
"54","2636台驊投控","110/08/13","凱基-內湖",52,91,-39
"55","2636台驊投控","110/08/13","國泰-台中",108,82,26
"56","2636台驊投控","110/08/13","台新-台中",45,82,-37
"57","2636台驊投控","110/08/13","豐農",27,2,25
"58","2636台驊投控","110/08/13","台新-新營",11,47,-36
"59","2636台驊投控","110/08/13","國票-彰化",421,397,24
"60","2636台驊投控","110/08/13","元富-中壢",4,37,-33
"61","2867三商壽","110/08/13","美商高盛",295,16,279
"62","2867三商壽","110/08/13","摩根大通",109,286,-177
"63","2867三商壽","110/08/13","大慶-中壢",183,1,182
"64","2867三商壽","110/08/13","元大-佳里",0,113,-113
"65","2867三商壽","110/08/13","新加坡商瑞銀",121,0,121
"66","2867三商壽","110/08/13","元大-崇德",0,103,-103
"67","2867三商壽","110/08/13","凱基-五股",100,0,100
"68","2867三商壽","110/08/13","台灣摩根士丹利",9,83,-74
"69","2867三商壽","110/08/13","元大-桃園",100,1,99
"70","2867三商壽","110/08/13","國泰-台南",1,73,-72
"71","2867三商壽","110/08/13","凱基-虎尾",90,0,90
"72","2867三商壽","110/08/13","元大證券",1,62,-61
"73","2867三商壽","110/08/13","華南永昌-高雄",100,10,90
"74","2867三商壽","110/08/13","元大-台中",0,60,-60
"75","2867三商壽","110/08/13","兆豐-北高雄",81,2,79
"76","2867三商壽","110/08/13","元大-大同",0,53,-53
"77","2867三商壽","110/08/13","新光",105,39,66
"78","2867三商壽","110/08/13","兆豐-鹿港",0,50,-50
"79","2867三商壽","110/08/13","富邦-彰化",60,0,60
"80","2867三商壽","110/08/13","合庫-西台中",2,50,-48
"81","2867三商壽","110/08/13","富邦-台南",60,0,60
"82","2867三商壽","110/08/13","新光-台中",7,53,-46
"83","2867三商壽","110/08/13","玉山-板橋",60,1,59
"84","2867三商壽","110/08/13","元大-大益",0,44,-44
"85","2867三商壽","110/08/13","群益金鼎-新竹",56,0,56
"86","2867三商壽","110/08/13","亞東-板橋",0,36,-36
"87","2867三商壽","110/08/13","元大-大統",53,0,53
"88","2867三商壽","110/08/13","福邦證券",0,34,-34
"89","2867三商壽","110/08/13","瑞士信貸",55,3,52
"90","2867三商壽","110/08/13","元大-博愛",16,50,-34
"91","5521工信","110/08/13","日進",100,0,100
"92","5521工信","110/08/13","美林",1,87,-86
"93","5521工信","110/08/13","摩根大通",180,102,78
"94","5521工信","110/08/13","日盛-復興",1,70,-69
"95","5521工信","110/08/13","元大-鳳山",30,0,30
"96","5521工信","110/08/13","永豐金-鳳山",1,60,-59
"97","5521工信","110/08/13","(牛牛牛)亞-鑫豐",28,2,26
"98","5521工信","110/08/13","中國信託-三重",0,52,-52
"99","5521工信","110/08/13","新光",24,0,24
"100","5521工信","110/08/13","華南永昌-民權",0,50,-50
"101","5521工信","110/08/13","華南永昌-彰化",21,0,21
"102","5521工信","110/08/13","第一金-新竹",0,34,-34
"103","5521工信","110/08/13","台灣企銀-建成",20,0,20
"104","5521工信","110/08/13","凱基-台北",18,49,-31
"105","5521工信","110/08/13","大昌",20,0,20
"106","5521工信","110/08/13","元大-新莊",10,38,-28
"107","5521工信","110/08/13","兆豐-中壢",20,0,20
"108","5521工信","110/08/13","台灣摩根士丹利",2,28,-26
"109","5521工信","110/08/13","國票-和平",20,0,20
"110","5521工信","110/08/13","華南永昌",0,23,-23
"111","5521工信","110/08/13","元大-基隆孝二",20,0,20
"112","5521工信","110/08/13","統一-板橋",0,20,-20
"113","5521工信","110/08/13","日盛-中和",19,0,19
"114","5521工信","110/08/13","港商法國興業",0,17,-17
"115","5521工信","110/08/13","兆豐-小港",19,0,19
"116","5521工信","110/08/13","元大-府城",0,16,-16
"117","5521工信","110/08/13","富邦-高雄",17,0,17
"118","5521工信","110/08/13","元大-敦化",0,16,-16
"119","5521工信","110/08/13","統一-員林",15,0,15
"120","5521工信","110/08/13","新光-新竹",5,20,-15
"121","1471首利","110/08/13","聯邦-高雄",42,0,42
"122","1471首利","110/08/13","摩根大通",41,220,-179
"123","1471首利","110/08/13","元大-西門",40,0,40
"124","1471首利","110/08/13","元大-敦化",0,100,-100
"125","1471首利","110/08/13","元大-大灣",37,0,37
"126","1471首利","110/08/13","美林",0,69,-69
"127","1471首利","110/08/13","第一金-台南",30,0,30
"128","1471首利","110/08/13","瑞士信貸",5,65,-60
"129","1471首利","110/08/13","元富-大昌",25,0,25
"130","1471首利","110/08/13","美商高盛",0,51,-51
"131","1471首利","110/08/13","大慶-中壢",20,0,20
"132","1471首利","110/08/13","華南永昌-苗栗",5,30,-25
"133","1471首利","110/08/13","凱基-台南",20,0,20
"134","1471首利","110/08/13","玉山-台南",0,22,-22
"135","1471首利","110/08/13","新光",19,0,19
"136","1471首利","110/08/13","元富-民權",0,20,-20
"137","1471首利","110/08/13","凱基-羅東",17,0,17
"138","1471首利","110/08/13","中國信託",0,20,-20
"139","1471首利","110/08/13","永豐金-台南",20,4,16
"140","1471首利","110/08/13","凱基-五股",0,20,-20
"141","1471首利","110/08/13","元大-屏東",14,0,14
"142","1471首利","110/08/13","台灣摩根士丹利",0,17,-17
"143","1471首利","110/08/13","新光-台中",16,4,12
"144","1471首利","110/08/13","兆豐-員林",2,15,-13
"145","1471首利","110/08/13","元大-頭份",12,0,12
"146","1471首利","110/08/13","日盛-宜蘭",0,10,-10
"147","1471首利","110/08/13","凱基-三重",11,0,11
"148","1471首利","110/08/13","元富-緯城",1,10,-9
"149","1471首利","110/08/13","日盛-鳳山",10,0,10
"150","1471首利","110/08/13","國泰-台中",2,8,-6
"151","2883開發金","110/08/13","凱基-台北",23196,4416,18780
"152","2883開發金","110/08/13","永豐金-彰化",79,4793,-4714
"153","2883開發金","110/08/13","摩根大通",24818,6057,18761
"154","2883開發金","110/08/13","第一金-忠孝",55,4613,-4558
"155","2883開發金","110/08/13","新加坡商瑞銀",6645,205,6440
"156","2883開發金","110/08/13","台新證券",1316,5539,-4223
"157","2883開發金","110/08/13","中國信託-文心",4723,123,4600
"158","2883開發金","110/08/13","日盛證券",587,3754,-3167
"159","2883開發金","110/08/13","美林",6276,1780,4496
"160","2883開發金","110/08/13","群益金鼎-大甲",48,2429,-2381
"161","2883開發金","110/08/13","國泰證券",3682,17,3665
"162","2883開發金","110/08/13","永豐金證券",169,1849,-1680
"163","2883開發金","110/08/13","台灣摩根士丹利",3927,582,3345
"164","2883開發金","110/08/13","華南永昌-南京",169,1407,-1238
"165","2883開發金","110/08/13","群益金鼎",2401,367,2034
"166","2883開發金","110/08/13","凱基-台東",270,1494,-1224
"167","2883開發金","110/08/13","香港上海匯豐",2006,0,2006
"168","2883開發金","110/08/13","日盛-板橋",207,1398,-1191
"169","2883開發金","110/08/13","兆豐證券",1776,128,1648
"170","2883開發金","110/08/13","元大-萬華",78,1243,-1165
"171","2883開發金","110/08/13","瑞士信貸",3551,2174,1377
"172","2883開發金","110/08/13","富邦-台北",295,1428,-1133
"173","2883開發金","110/08/13","港商野村",7299,6088,1211
"174","2883開發金","110/08/13","元大-成功",216,1287,-1071
"175","2883開發金","110/08/13","美商高盛",1016,0,1016
"176","2883開發金","110/08/13","新光-台中",485,1519,-1034
"177","2883開發金","110/08/13","元大-大灣",1183,214,969
"178","2883開發金","110/08/13","國票",232,1261,-1029
"179","2883開發金","110/08/13","花旗環球",1104,284,820
"180","2883開發金","110/08/13","永豐金-桃園",141,1157,-1016
"181","6205詮欣","110/08/13","合庫-三重",15,0,15
"182","6205詮欣","110/08/13","摩根大通",3,17,-14
"183","6205詮欣","110/08/13","港商法國興業",11,0,11
"184","6205詮欣","110/08/13","元大-善化",0,10,-10
"185","6205詮欣","110/08/13","臺銀-民權",7,0,7
"186","6205詮欣","110/08/13","元大-台中中港",0,3,-3
"187","6205詮欣","110/08/13","日盛-三重",5,0,5
"188","6205詮欣","110/08/13","合庫-鳳山",0,2,-2
"189","6205詮欣","110/08/13","群益金鼎-屏東",5,0,5
"190","6205詮欣","110/08/13","元富-潮州",0,2,-2
"191","6205詮欣","110/08/13","德信-新營",3,0,3
"192","6205詮欣","110/08/13","兆豐-桃鶯",0,2,-2
"193","6205詮欣","110/08/13","美林",2,0,2
"194","6205詮欣","110/08/13","致和-台北",0,2,-2
"195","6205詮欣","110/08/13","兆豐-西螺",1,0,1
"196","6205詮欣","110/08/13","華南永昌-三重",0,2,-2
"197","6205詮欣","110/08/13","新光-台中",1,0,1
"198","6205詮欣","110/08/13","土銀-台中",0,1,-1
"199","6205詮欣","110/08/13","聯邦-嘉義",1,0,1
"200","6205詮欣","110/08/13","日盛-中壢",0,1,-1
"201","6205詮欣","110/08/13","玉山-南京東路",1,0,1
"202","6205詮欣","110/08/13","美商高盛",0,1,-1
"203","6205詮欣","110/08/13","群益金鼎-中港",1,0,1
"204","6205詮欣","110/08/13","大展-台南",0,1,-1
"205","6205詮欣","110/08/13","凱基-大安",1,0,1
"206","6205詮欣","110/08/13","第一金-彰化",0,1,-1
"207","6205詮欣","110/08/13","元大-仁愛",1,0,1
"208","6205詮欣","110/08/13","統一-三重",1,2,-1
"209","6205詮欣","110/08/13","元大-台南",1,0,1
"210","6205詮欣","110/08/13","元富-桃園",0,1,-1
"211","1540喬福","110/08/13","元富-中原",100,0,100
"212","1540喬福","110/08/13","日盛-文化",0,48,-48
"213","1540喬福","110/08/13","台新-台中",31,0,31
"214","1540喬福","110/08/13","凱基-台北",0,33,-33
"215","1540喬福","110/08/13","兆豐-北高雄",18,0,18
"216","1540喬福","110/08/13","元大-大安",0,32,-32
"217","1540喬福","110/08/13","元大-土城永寧",11,0,11
"218","1540喬福","110/08/13","合庫-台中",2,23,-21
"219","1540喬福","110/08/13","(牛牛牛)亞-鑫豐",10,0,10
"220","1540喬福","110/08/13","華南永昌-楠梓",0,20,-20
"221","1540喬福","110/08/13","凱基-中壢",7,0,7
"222","1540喬福","110/08/13","群益金鼎-館前",1,20,-19
"223","1540喬福","110/08/13","安泰",5,0,5
"224","1540喬福","110/08/13","富邦-花蓮",0,15,-15
"225","1540喬福","110/08/13","群益金鼎-古亭",5,0,5
"226","1540喬福","110/08/13","日盛-景美",0,10,-10
"227","1540喬福","110/08/13","元富-緯城",4,0,4
"228","1540喬福","110/08/13","台新-高雄",0,9,-9
"229","1540喬福","110/08/13","兆豐-南京",4,0,4
"230","1540喬福","110/08/13","玉山-大里",0,8,-8
"231","1540喬福","110/08/13","凱基-台中",4,0,4
"232","1540喬福","110/08/13","元大-斗信",0,8,-8
"233","1540喬福","110/08/13","凱基-台南",5,1,4
"234","1540喬福","110/08/13","新光-台南",0,6,-6
"235","1540喬福","110/08/13","元大-龍潭",4,0,4
"236","1540喬福","110/08/13","兆豐-板橋",0,5,-5
"237","1540喬福","110/08/13","兆豐-高雄",3,0,3
"238","1540喬福","110/08/13","富邦-彰化",0,5,-5
"239","1540喬福","110/08/13","兆豐-鹿港",3,0,3
"240","1540喬福","110/08/13","美林",0,4,-4
"241","2888新光金","110/08/13","永豐金-天母",2112,0,2112
"242","2888新光金","110/08/13","摩根大通",308,3587,-3279
"243","2888新光金","110/08/13","合庫-西台中",2116,5,2111
"244","2888新光金","110/08/13","玉山-嘉義",7,1514,-1507
"245","2888新光金","110/08/13","統一-新竹",1706,0,1706
"246","2888新光金","110/08/13","國票-台東",0,1500,-1500
"247","2888新光金","110/08/13","凱基-台北",3076,1640,1436
"248","2888新光金","110/08/13","台灣摩根士丹利",127,1148,-1021
"249","2888新光金","110/08/13","元大證券",1418,10,1408
"250","2888新光金","110/08/13","華南永昌-岡山",62,930,-868
"251","2888新光金","110/08/13","康和",761,2,759
"252","2888新光金","110/08/13","港商野村",47,827,-780
"253","2888新光金","110/08/13","富邦-仁愛",739,52,687
"254","2888新光金","110/08/13","美商高盛",697,1236,-539
"255","2888新光金","110/08/13","新加坡商瑞銀",716,121,595
"256","2888新光金","110/08/13","日盛-八德",88,572,-484
"257","2888新光金","110/08/13","富邦-彰化",588,12,576
"258","2888新光金","110/08/13","群益金鼎-三重",1,437,-436
"259","2888新光金","110/08/13","玉山證券",558,12,546
"260","2888新光金","110/08/13","永豐金-嘉義",52,472,-420
"261","2888新光金","110/08/13","群益金鼎-瑞豐",550,10,540
"262","2888新光金","110/08/13","元富-城東",7,390,-383
"263","2888新光金","110/08/13","元大-三重",523,0,523
"264","2888新光金","110/08/13","群益金鼎-高雄",6,387,-381
"265","2888新光金","110/08/13","永豐金-博愛",420,27,393
"266","2888新光金","110/08/13","凱基-宜蘭",9,379,-370
"267","2888新光金","110/08/13","第一金-豐原",364,20,344
"268","2888新光金","110/08/13","美林",938,1287,-349
"269","2888新光金","110/08/13","國票-九鼎",317,3,314
"270","2888新光金","110/08/13","華南永昌-台中",0,329,-329
"271","1340勝悅","110/08/13","元富-成功",72,0,72
"272","1340勝悅","110/08/13","元大-忠孝",0,36,-36
"273","1340勝悅","110/08/13","元大-博愛",10,0,10
"274","1340勝悅","110/08/13","新光",4,21,-17
"275","1340勝悅","110/08/13","臺灣企銀-埔墘",5,0,5
"276","1340勝悅","110/08/13","摩根大通",3,19,-16
"277","1340勝悅","110/08/13","元大-新莊",5,0,5
"278","1340勝悅","110/08/13","群益金鼎-三重",0,15,-15
"279","1340勝悅","110/08/13","美商高盛",4,0,4
"280","1340勝悅","110/08/13","日盛-永康",0,10,-10
"281","1340勝悅","110/08/13","國泰-敦南",6,2,4
"282","1340勝悅","110/08/13","華南永昌-合泰",0,10,-10
"283","1340勝悅","110/08/13","統一-城中",6,3,3
"284","1340勝悅","110/08/13","日盛-木柵",0,8,-8
"285","1340勝悅","110/08/13","元富-新店",3,0,3
"286","1340勝悅","110/08/13","港商法國興業",0,6,-6
"287","1340勝悅","110/08/13","玉山-士林",3,0,3
"288","1340勝悅","110/08/13","群益金鼎-中港",0,5,-5
"289","1340勝悅","110/08/13","群益金鼎-館前",4,1,3
"290","1340勝悅","110/08/13","第一金-自由",0,4,-4
"291","1340勝悅","110/08/13","元富-安南",2,0,2
"292","1340勝悅","110/08/13","兆豐-新營",0,4,-4
"293","1340勝悅","110/08/13","大昌-樹林",2,0,2
"294","1340勝悅","110/08/13","國泰-台中",1,5,-4
"295","1340勝悅","110/08/13","群益金鼎",2,0,2
"296","1340勝悅","110/08/13","元大-林園",0,4,-4
"297","1340勝悅","110/08/13","群益金鼎-北高雄",2,0,2
"298","1340勝悅","110/08/13","元大-四維",0,4,-4
"299","1340勝悅","110/08/13","華南永昌",2,0,2
"300","1340勝悅","110/08/13","美林",0,2,-2
"301","6246臺龍","110/08/13","華南永昌-彰化",31,0,31
"302","6246臺龍","110/08/13","永豐金-內湖",0,95,-95
"303","6246臺龍","110/08/13","合庫-台中",23,0,23
"304","6246臺龍","110/08/13","玉山-大里",0,21,-21
"305","6246臺龍","110/08/13","兆豐-忠孝",24,3,21
"306","6246臺龍","110/08/13","新光-新竹",0,20,-20
"307","6246臺龍","110/08/13","元大-台北",16,0,16
"308","6246臺龍","110/08/13","台新-台中",1,19,-18
"309","6246臺龍","110/08/13","元大-新莊",11,1,10
"310","6246臺龍","110/08/13","光和",2,17,-15
"311","6246臺龍","110/08/13","德信-新營",9,0,9
"312","6246臺龍","110/08/13","日盛-高雄",0,10,-10
"313","6246臺龍","110/08/13","凱基-永和",9,0,9
"314","6246臺龍","110/08/13","元富-世貿",0,10,-10
"315","6246臺龍","110/08/13","港商野村",20,12,8
"316","6246臺龍","110/08/13","(牛牛牛)亞-鑫豐",1,11,-10
"317","6246臺龍","110/08/13","富邦-建國",8,0,8
"318","6246臺龍","110/08/13","國泰-敦南",6,16,-10
"319","6246臺龍","110/08/13","群益金鼎-開元",12,5,7
"320","6246臺龍","110/08/13","永豐金-市政",1,10,-9
"321","6246臺龍","110/08/13","群益金鼎-古亭",7,0,7
"322","6246臺龍","110/08/13","華南永昌-嘉義",0,8,-8
"323","6246臺龍","110/08/13","凱基-高美館",7,0,7
"324","6246臺龍","110/08/13","富邦-敦南",4,11,-7
"325","6246臺龍","110/08/13","元大-東蘆",10,3,7
"326","6246臺龍","110/08/13","第一金-彰化",6,12,-6
"327","6246臺龍","110/08/13","元大-金華",8,1,7
"328","6246臺龍","110/08/13","新光-桃園",2,8,-6
"329","6246臺龍","110/08/13","永豐金-松山",7,0,7
"330","6246臺龍","110/08/13","凱基-竹科",0,6,-6
"331","00715L期街口布蘭特正2","110/08/13","元大證券",6162,789,5373
"332","00715L期街口布蘭特正2","110/08/13","元大-四維",2,1000,-998
"333","00715L期街口布蘭特正2","110/08/13","元富",1528,0,1528
"334","00715L期街口布蘭特正2","110/08/13","玉山-嘉義",20,1016,-996
"335","00715L期街口布蘭特正2","110/08/13","合庫證券",1153,0,1153
"336","00715L期街口布蘭特正2","110/08/13","群益金鼎-古亭",0,666,-666
"337","00715L期街口布蘭特正2","110/08/13","富邦證券",1029,290,739
"338","00715L期街口布蘭特正2","110/08/13","富邦-員林",9,489,-480
"339","00715L期街口布蘭特正2","110/08/13","台新-台中",284,9,275
"340","00715L期街口布蘭特正2","110/08/13","元大-嘉義",1,400,-399
"341","00715L期街口布蘭特正2","110/08/13","兆豐-台中",238,0,238
"342","00715L期街口布蘭特正2","110/08/13","臺銀-新竹",2,360,-358
"343","00715L期街口布蘭特正2","110/08/13","統一-桃園",283,80,203
"344","00715L期街口布蘭特正2","110/08/13","日盛-二林",0,300,-300
"345","00715L期街口布蘭特正2","110/08/13","群益金鼎-屏東",200,0,200
"346","00715L期街口布蘭特正2","110/08/13","群益金鼎-延平",100,400,-300
"347","00715L期街口布蘭特正2","110/08/13","元富-虎尾",172,0,172
"348","00715L期街口布蘭特正2","110/08/13","元大-中和",175,450,-275
"349","00715L期街口布蘭特正2","110/08/13","凱基-五股",163,0,163
"350","00715L期街口布蘭特正2","110/08/13","第一金-彰化",5,230,-225
"351","00715L期街口布蘭特正2","110/08/13","國泰-台南",155,19,136
"352","00715L期街口布蘭特正2","110/08/13","元大-大里",16,225,-209
"353","00715L期街口布蘭特正2","110/08/13","永豐金證券",482,350,132
"354","00715L期街口布蘭特正2","110/08/13","港商野村",7,212,-205
"355","00715L期街口布蘭特正2","110/08/13","元大-內湖",110,0,110
"356","00715L期街口布蘭特正2","110/08/13","合庫-新竹",1,199,-198
"357","00715L期街口布蘭特正2","110/08/13","兆豐-嘉義",103,0,103
"358","00715L期街口布蘭特正2","110/08/13","高橋",9,205,-196
"359","00715L期街口布蘭特正2","110/08/13","群益金鼎-土城",100,0,100
"360","00715L期街口布蘭特正2","110/08/13","國泰-敦南",78,271,-193
"361","8941關中","110/08/13","宏遠-館前",3,0,3
"362","8941關中","110/08/13","日盛-信義",0,2,-2
"363","8941關中","110/08/13","國泰-忠孝",1,0,1
"364","8941關中","110/08/13","宏遠-中和",0,1,-1
"365","8941關中","110/08/13","康和-板橋",0,0,0
"366","8941關中","110/08/13","康和-嘉義",0,1,-1
"367","8941關中","110/08/13","富邦-左營",0,0,0
"368","8941關中","110/08/13","康和-板橋",0,0,0
"369","8941關中","110/08/13","元大-松江",0,0,0
"370","8941關中","110/08/13","富邦-左營",0,0,0
"371","8941關中","110/08/13","元大-淡水",0,0,0
"372","8941關中","110/08/13","元大-松江",0,0,0
"373","8941關中","110/08/13","",NA,NA,NA
"374","8941關中","110/08/13","元大-淡水",0,0,0
"375","8941關中","110/08/13","",NA,NA,NA
"376","8941關中","110/08/13","",NA,NA,NA
"377","8941關中","110/08/13","",NA,NA,NA
"378","8941關中","110/08/13","",NA,NA,NA
"379","8941關中","110/08/13","",NA,NA,NA
"380","8941關中","110/08/13","",NA,NA,NA
"381","8941關中","110/08/13","",NA,NA,NA
"382","8941關中","110/08/13","",NA,NA,NA
"383","8941關中","110/08/13","",NA,NA,NA
"384","8941關中","110/08/13","",NA,NA,NA
"385","8941關中","110/08/13","",NA,NA,NA
"386","8941關中","110/08/13","",NA,NA,NA
"387","8941關中","110/08/13","",NA,NA,NA
"388","8941關中","110/08/13","",NA,NA,NA
"389","8941關中","110/08/13","",NA,NA,NA
"390","8941關中","110/08/13","",NA,NA,NA
"391","8936國統","110/08/13","台新-高雄",127,0,127
"392","8936國統","110/08/13","第一金-豐原",0,60,-60
"393","8936國統","110/08/13","美林",84,18,66
"394","8936國統","110/08/13","凱基-台北",1,50,-49
"395","8936國統","110/08/13","摩根大通",40,14,26
"396","8936國統","110/08/13","凱基-高美館",8,51,-43
"397","8936國統","110/08/13","凱基-台南",23,0,23
"398","8936國統","110/08/13","港商野村",8,39,-31
"399","8936國統","110/08/13","第一金-路竹",20,0,20
"400","8936國統","110/08/13","日盛-忠孝",0,25,-25
"401","8936國統","110/08/13","元大-敦化",17,0,17
"402","8936國統","110/08/13","群益金鼎-台中",0,20,-20
"403","8936國統","110/08/13","新光-台中",22,6,16
"404","8936國統","110/08/13","台新-台南",0,15,-15
"405","8936國統","110/08/13","元大-文心",15,0,15
"406","8936國統","110/08/13","元大-博愛",0,14,-14
"407","8936國統","110/08/13","元大-敦南",14,0,14
"408","8936國統","110/08/13","合庫-台南",0,10,-10
"409","8936國統","110/08/13","日盛-北高雄",12,0,12
"410","8936國統","110/08/13","新光-桃園",0,10,-10
"411","8936國統","110/08/13","元大-西螺",10,0,10
"412","8936國統","110/08/13","永豐金-南投",0,10,-10
"413","8936國統","110/08/13","彰銀",8,0,8
"414","8936國統","110/08/13","永豐金-竹科",0,10,-10
"415","8936國統","110/08/13","元富-大昌",8,0,8
"416","8936國統","110/08/13","富邦-竹北",0,8,-8
"417","8936國統","110/08/13","富邦-南屯",10,2,8
"418","8936國統","110/08/13","元大-大里德芳",5,13,-8
"419","8936國統","110/08/13","元大-天母",7,0,7
"420","8936國統","110/08/13","台新證券",0,7,-7
"421","6226光鼎","110/08/13","國泰-敦南",676,469,207
"422","6226光鼎","110/08/13","摩根大通",267,1531,-1264
"423","6226光鼎","110/08/13","元富-新竹",163,19,144
"424","6226光鼎","110/08/13","美商高盛",149,1352,-1203
"425","6226光鼎","110/08/13","合庫-台中",461,334,127
"426","6226光鼎","110/08/13","瑞士信貸",52,752,-700
"427","6226光鼎","110/08/13","國泰-台中",734,609,125
"428","6226光鼎","110/08/13","凱基-台北",84,488,-404
"429","6226光鼎","110/08/13","元大-小港",198,88,110
"430","6226光鼎","110/08/13","台新-中壢",2,226,-224
"431","6226光鼎","110/08/13","凱基-永和",91,0,91
"432","6226光鼎","110/08/13","元大-文心興安",44,216,-172
"433","6226光鼎","110/08/13","元大-西螺",82,5,77
"434","6226光鼎","110/08/13","美林",234,376,-142
"435","6226光鼎","110/08/13","永豐金-南京",78,1,77
"436","6226光鼎","110/08/13","凱基-嘉義",12,126,-114
"437","6226光鼎","110/08/13","群益金鼎-萬華",78,9,69
"438","6226光鼎","110/08/13","富邦-陽明",23,117,-94
"439","6226光鼎","110/08/13","日盛-八德",63,1,62
"440","6226光鼎","110/08/13","兆豐-大安",4,85,-81
"441","6226光鼎","110/08/13","凱基-桃園",88,27,61
"442","6226光鼎","110/08/13","永豐金-中盛",27,107,-80
"443","6226光鼎","110/08/13","凱基-岡山",62,1,61
"444","6226光鼎","110/08/13","元大證券",232,304,-72
"445","6226光鼎","110/08/13","臺銀-鳳山",110,52,58
"446","6226光鼎","110/08/13","凱基-台中",19,84,-65
"447","6226光鼎","110/08/13","元大-板橋三民",114,56,58
"448","6226光鼎","110/08/13","元大-士林",107,171,-64
"449","6226光鼎","110/08/13","凱基-板橋",195,140,55
"450","6226光鼎","110/08/13","富邦-高雄",15,69,-54
"451","2363矽統","110/08/13","美商高盛",416,10,406
"452","2363矽統","110/08/13","元大-佳里",319,1216,-897
"453","2363矽統","110/08/13","土銀",374,14,360
"454","2363矽統","110/08/13","瑞士信貸",0,836,-836
"455","2363矽統","110/08/13","玉山-台中",289,18,271
"456","2363矽統","110/08/13","永豐金-中正",22,676,-654
"457","2363矽統","110/08/13","大展",244,10,234
"458","2363矽統","110/08/13","台灣摩根士丹利",116,566,-450
"459","2363矽統","110/08/13","永豐金-板盛",172,22,150
"460","2363矽統","110/08/13","宏遠-桃園",11,359,-348
"461","2363矽統","110/08/13","富邦-仁愛",198,49,149
"462","2363矽統","110/08/13","國泰-敦南",671,911,-240
"463","2363矽統","110/08/13","日盛-北高雄",206,85,121
"464","2363矽統","110/08/13","元大證券",126,352,-226
"465","2363矽統","110/08/13","台新-三民",163,55,108
"466","2363矽統","110/08/13","花旗環球",0,223,-223
"467","2363矽統","110/08/13","元富-新店",130,23,107
"468","2363矽統","110/08/13","臺銀",48,259,-211
"469","2363矽統","110/08/13","永豐金-桃盛",108,5,103
"470","2363矽統","110/08/13","摩根大通",268,460,-192
"471","2363矽統","110/08/13","元大-復北",129,28,101
"472","2363矽統","110/08/13","國票",63,248,-185
"473","2363矽統","110/08/13","台新-屏東",116,18,98
"474","2363矽統","110/08/13","台新-高雄",91,263,-172
"475","2363矽統","110/08/13","華南永昌-虎尾",180,87,93
"476","2363矽統","110/08/13","合庫證券",18,177,-159
"477","2363矽統","110/08/13","元大-板橋",101,10,91
"478","2363矽統","110/08/13","第一金-華江",65,206,-141
"479","2363矽統","110/08/13","新光",343,260,83
"480","2363矽統","110/08/13","中國信託-忠孝",65,201,-136
"481","8112至上","110/08/13","合庫證券",160,5,155
"482","8112至上","110/08/13","摩根大通",123,818,-695
"483","8112至上","110/08/13","凱基-竹科",140,12,128
"484","8112至上","110/08/13","美林",22,299,-277
"485","8112至上","110/08/13","臺灣企銀-桃園",126,0,126
"486","8112至上","110/08/13","第一金-華江",4,158,-154
"487","8112至上","110/08/13","統一-中壢",79,1,78
"488","8112至上","110/08/13","群益金鼎-基隆",1,117,-116
"489","8112至上","110/08/13","港商麥格理",86,9,77
"490","8112至上","110/08/13","新光-桃園",2,100,-98
"491","8112至上","110/08/13","富邦-新竹",78,2,76
"492","8112至上","110/08/13","永興-水湳",0,95,-95
"493","8112至上","110/08/13","凱基-復興",67,0,67
"494","8112至上","110/08/13","凱基-新店",50,141,-91
"495","8112至上","110/08/13","合庫-西台中",62,2,60
"496","8112至上","110/08/13","元富-新興",3,91,-88
"497","8112至上","110/08/13","大慶",60,0,60
"498","8112至上","110/08/13","凱基-台北",60,148,-88
"499","8112至上","110/08/13","日盛-新竹",59,2,57
"500","8112至上","110/08/13","國票-中和",4,90,-86
"501","8112至上","110/08/13","元大-開元",53,0,53
"502","8112至上","110/08/13","新加坡商瑞銀",5,88,-83
"503","8112至上","110/08/13","富邦-中壢",51,4,47
"504","8112至上","110/08/13","宏遠-民生",2,52,-50
"505","8112至上","110/08/13","富邦-桃園",46,0,46
"506","8112至上","110/08/13","群益金鼎-竹南",0,50,-50
"507","8112至上","110/08/13","合庫-嘉義",44,0,44
"508","8112至上","110/08/13","新百王",2,50,-48
"509","8112至上","110/08/13","元大-府城",55,11,44
"510","8112至上","110/08/13","港商野村",13,60,-47
"511","1570力肯","110/08/13","新光",147,12,135
"512","1570力肯","110/08/13","(牛牛牛)亞-鑫豐",15,136,-121
"513","1570力肯","110/08/13","國票-北高雄",128,0,128
"514","1570力肯","110/08/13","富邦-台中",0,51,-51
"515","1570力肯","110/08/13","凱基-台北",80,24,56
"516","1570力肯","110/08/13","日盛-頭份",0,50,-50
"517","1570力肯","110/08/13","統一",54,0,54
"518","1570力肯","110/08/13","元富-高雄",0,40,-40
"519","1570力肯","110/08/13","國票-內壢",49,1,48
"520","1570力肯","110/08/13","凱基-高美館",2,41,-39
"521","1570力肯","110/08/13","美林",37,0,37
"522","1570力肯","110/08/13","日盛-忠孝",0,38,-38
"523","1570力肯","110/08/13","國票-天祥",45,8,37
"524","1570力肯","110/08/13","元大-羅東",0,20,-20
"525","1570力肯","110/08/13","摩根大通",67,45,22
"526","1570力肯","110/08/13","元大-大天母",0,20,-20
"527","1570力肯","110/08/13","永豐金-屏東",22,0,22
"528","1570力肯","110/08/13","永豐金-嘉義",0,20,-20
"529","1570力肯","110/08/13","元富-新店",20,0,20
"530","1570力肯","110/08/13","國泰-敦南",2,20,-18
"531","1570力肯","110/08/13","(牛牛牛)亞證券",20,0,20
"532","1570力肯","110/08/13","元大-沙鹿",1,18,-17
"533","1570力肯","110/08/13","凱基-台南",20,0,20
"534","1570力肯","110/08/13","元大-林森",0,16,-16
"535","1570力肯","110/08/13","元大-開元",20,0,20
"536","1570力肯","110/08/13","永豐金-市政",1,16,-15
"537","1570力肯","110/08/13","元大-花蓮",20,0,20
"538","1570力肯","110/08/13","統一-三重",5,19,-14
"539","1570力肯","110/08/13","元大-基隆",19,0,19
"540","1570力肯","110/08/13","國泰-新莊",1,15,-14
"541","2929淘帝","110/08/13","新光-新竹",488,287,201
"542","2929淘帝","110/08/13","美林",17,84,-67
"543","2929淘帝","110/08/13","元大-西門",38,1,37
"544","2929淘帝","110/08/13","摩根大通",0,63,-63
"545","2929淘帝","110/08/13","元富-文心",30,0,30
"546","2929淘帝","110/08/13","港商野村",14,69,-55
"547","2929淘帝","110/08/13","華南永昌-苗栗",30,0,30
"548","2929淘帝","110/08/13","玉山-新竹",0,50,-50
"549","2929淘帝","110/08/13","元大-豐原站前",31,1,30
"550","2929淘帝","110/08/13","臺銀-新竹",0,30,-30
"551","2929淘帝","110/08/13","元富-台南",22,0,22
"552","2929淘帝","110/08/13","元富-三重",23,52,-29
"553","2929淘帝","110/08/13","凱基-東門",20,0,20
"554","2929淘帝","110/08/13","新加坡商瑞銀",18,41,-23
"555","2929淘帝","110/08/13","永豐金-敦南",17,0,17
"556","2929淘帝","110/08/13","兆豐-大同",0,21,-21
"557","2929淘帝","110/08/13","新光",44,29,15
"558","2929淘帝","110/08/13","美商高盛",0,20,-20
"559","2929淘帝","110/08/13","元大-蘆洲",14,0,14
"560","2929淘帝","110/08/13","台新-左楠",6,25,-19
"561","2929淘帝","110/08/13","國票-博愛",12,0,12
"562","2929淘帝","110/08/13","港商法國興業",0,14,-14
"563","2929淘帝","110/08/13","合庫-自強",10,0,10
"564","2929淘帝","110/08/13","台新證券",7,21,-14
"565","2929淘帝","110/08/13","兆豐-桃園",10,0,10
"566","2929淘帝","110/08/13","元大-館前",0,14,-14
"567","2929淘帝","110/08/13","凱基-頭份",10,0,10
"568","2929淘帝","110/08/13","亞東-新竹",0,13,-13
"569","2929淘帝","110/08/13","華南永昌-大安",10,0,10
"570","2929淘帝","110/08/13","元大-永和",7,20,-13
"571","5410國眾","110/08/13","土銀-嘉義",21,0,21
"572","5410國眾","110/08/13","國泰-敦南",20,102,-82
"573","5410國眾","110/08/13","日盛-大墩",15,0,15
"574","5410國眾","110/08/13","元大-大雅",0,64,-64
"575","5410國眾","110/08/13","群益金鼎-民權",14,0,14
"576","5410國眾","110/08/13","大昌-新店",0,37,-37
"577","5410國眾","110/08/13","玉山-嘉義",12,0,12
"578","5410國眾","110/08/13","陽信-石牌",0,33,-33
"579","5410國眾","110/08/13","元大-新竹經國",12,0,12
"580","5410國眾","110/08/13","摩根大通",0,26,-26
"581","5410國眾","110/08/13","日盛-屏東",10,0,10
"582","5410國眾","110/08/13","瑞士信貸",0,18,-18
"583","5410國眾","110/08/13","富邦-竹北",10,0,10
"584","5410國眾","110/08/13","元大-北投",8,22,-14
"585","5410國眾","110/08/13","元富",10,1,9
"586","5410國眾","110/08/13","合庫-台中",0,10,-10
"587","5410國眾","110/08/13","凱基-八德",9,0,9
"588","5410國眾","110/08/13","合庫-新竹",0,10,-10
"589","5410國眾","110/08/13","富邦-台北",9,0,9
"590","5410國眾","110/08/13","元大-善化",0,10,-10
"591","5410國眾","110/08/13","富邦-新店",10,1,9
"592","5410國眾","110/08/13","大昌",0,9,-9
"593","5410國眾","110/08/13","元富-虎尾",8,0,8
"594","5410國眾","110/08/13","兆豐-三重",0,9,-9
"595","5410國眾","110/08/13","統一",7,0,7
"596","5410國眾","110/08/13","新光",17,25,-8
"597","5410國眾","110/08/13","日茂-南投",7,0,7
"598","5410國眾","110/08/13","亞東-新竹",0,5,-5
"599","5410國眾","110/08/13","元大-彰化",7,0,7
"600","5410國眾","110/08/13","兆豐-桃鶯",0,5,-5
"601","2841台開","110/08/13","宏遠-館前",181,0,181
"602","2841台開","110/08/13","永豐金-內湖",0,77,-77
"603","2841台開","110/08/13","日盛證券",70,1,69
"604","2841台開","110/08/13","富邦-岡山",0,72,-72
"605","2841台開","110/08/13","台新-三民",50,0,50
"606","2841台開","110/08/13","永豐金-屏東",0,50,-50
"607","2841台開","110/08/13","凱基-市政",18,0,18
"608","2841台開","110/08/13","港商野村",0,38,-38
"609","2841台開","110/08/13","新光",32,16,16
"610","2841台開","110/08/13","元大-林園",0,30,-30
"611","2841台開","110/08/13","兆豐-新營",15,0,15
"612","2841台開","110/08/13","永豐金-敦南",13,42,-29
"613","2841台開","110/08/13","日盛-內湖",12,0,12
"614","2841台開","110/08/13","臺銀-民權",0,20,-20
"615","2841台開","110/08/13","群益金鼎-基隆",11,0,11
"616","2841台開","110/08/13","元大-崇德",0,19,-19
"617","2841台開","110/08/13","富邦-台北",10,0,10
"618","2841台開","110/08/13","日盛-中壢",0,18,-18
"619","2841台開","110/08/13","元大-歸仁",10,0,10
"620","2841台開","110/08/13","兆豐-板橋",0,10,-10
"621","2841台開","110/08/13","凱基-台北",9,2,7
"622","2841台開","110/08/13","豐農",0,10,-10
"623","2841台開","110/08/13","元大-福營",10,3,7
"624","2841台開","110/08/13","元大-北三重",0,10,-10
"625","2841台開","110/08/13","元富-文心",5,0,5
"626","2841台開","110/08/13","台新證券",6,13,-7
"627","2841台開","110/08/13","凱基-東港",5,0,5
"628","2841台開","110/08/13","光和-嘉義",0,6,-6
"629","2841台開","110/08/13","元富-成功",3,0,3
"630","2841台開","110/08/13","中國信託-高雄",0,5,-5
"631","6207雷科","110/08/13","安泰",51,0,51
"632","6207雷科","110/08/13","摩根大通",12,80,-68
"633","6207雷科","110/08/13","永豐金證券",34,0,34
"634","6207雷科","110/08/13","美林",1,34,-33
"635","6207雷科","110/08/13","元大-潮州",32,0,32
"636","6207雷科","110/08/13","新加坡商瑞銀",18,45,-27
"637","6207雷科","110/08/13","元大-六合",30,0,30
"638","6207雷科","110/08/13","凱基-復興",0,20,-20
"639","6207雷科","110/08/13","富邦-中壢",20,0,20
"640","6207雷科","110/08/13","凱基-台北",15,31,-16
"641","6207雷科","110/08/13","統一-台中",10,0,10
"642","6207雷科","110/08/13","港商野村",1,13,-12
"643","6207雷科","110/08/13","凱基-岡山",10,0,10
"644","6207雷科","110/08/13","群益金鼎-東門",0,12,-12
"645","6207雷科","110/08/13","元大-東門",10,0,10
"646","6207雷科","110/08/13","凱基-三峽",4,15,-11
"647","6207雷科","110/08/13","元大-大天母",13,3,10
"648","6207雷科","110/08/13","兆豐-公益",0,9,-9
"649","6207雷科","110/08/13","元大-路竹",8,0,8
"650","6207雷科","110/08/13","元大-鳳山",0,8,-8
"651","6207雷科","110/08/13","富邦-敦南",7,0,7
"652","6207雷科","110/08/13","合庫-鳳山",0,6,-6
"653","6207雷科","110/08/13","兆豐-彰化",6,0,6
"654","6207雷科","110/08/13","凱基-三重",0,6,-6
"655","6207雷科","110/08/13","群益金鼎-土城",6,0,6
"656","6207雷科","110/08/13","凱基-幸福",0,6,-6
"657","6207雷科","110/08/13","玉山-台南",5,0,5
"658","6207雷科","110/08/13","富邦-基隆",0,6,-6
"659","6207雷科","110/08/13","凱基-湖口",5,0,5
"660","6207雷科","110/08/13","元大-清水",0,6,-6
"661","3679新至陞","110/08/13","元大-大天母",20,0,20
"662","3679新至陞","110/08/13","摩根大通",2,27,-25
"663","3679新至陞","110/08/13","台灣摩根士丹利",12,0,12
"664","3679新至陞","110/08/13","瑞士信貸",1,16,-15
"665","3679新至陞","110/08/13","元大-成功",10,0,10
"666","3679新至陞","110/08/13","美林",0,10,-10
"667","3679新至陞","110/08/13","兆豐-高雄",9,0,9
"668","3679新至陞","110/08/13","凱基-台北",11,16,-5
"669","3679新至陞","110/08/13","國泰-松江",4,0,4
"670","3679新至陞","110/08/13","元大-東蘆",0,5,-5
"671","3679新至陞","110/08/13","元大-大同",3,0,3
"672","3679新至陞","110/08/13","元大-北成功",0,4,-4
"673","3679新至陞","110/08/13","合庫-台中",2,0,2
"674","3679新至陞","110/08/13","富邦-中壢",0,3,-3
"675","3679新至陞","110/08/13","台中銀-員林",2,0,2
"676","3679新至陞","110/08/13","彰銀",0,2,-2
"677","3679新至陞","110/08/13","康和-板橋",2,0,2
"678","3679新至陞","110/08/13","凱基-大安",0,2,-2
"679","3679新至陞","110/08/13","新光-高雄",2,0,2
"680","3679新至陞","110/08/13","華南永昌-鶯歌",0,2,-2
"681","3679新至陞","110/08/13","凱基-文心",5,3,2
"682","3679新至陞","110/08/13","富邦-仁愛",0,2,-2
"683","3679新至陞","110/08/13","元大-景美",2,0,2
"684","3679新至陞","110/08/13","元大證券",1,3,-2
"685","3679新至陞","110/08/13","元大-土城永寧",2,0,2
"686","3679新至陞","110/08/13","元大-土城",0,2,-2
"687","3679新至陞","110/08/13","美商高盛",1,0,1
"688","3679新至陞","110/08/13","台灣企銀-民雄",0,1,-1
"689","3679新至陞","110/08/13","台新證券",1,0,1
"690","3679新至陞","110/08/13","日盛證券",0,1,-1
"691","2727王品","110/08/13","新光",27,6,21
"692","2727王品","110/08/13","摩根大通",1,53,-52
"693","2727王品","110/08/13","大慶-富順",20,0,20
"694","2727王品","110/08/13","土銀-南港",0,40,-40
"695","2727王品","110/08/13","兆豐-東門",17,0,17
"696","2727王品","110/08/13","港商麥格理",0,24,-24
"697","2727王品","110/08/13","新光-台中",19,2,17
"698","2727王品","110/08/13","新加坡商瑞銀",0,21,-21
"699","2727王品","110/08/13","元大-竹科",11,0,11
"700","2727王品","110/08/13","康和-台南",1,22,-21
"701","2727王品","110/08/13","日盛-屏東",10,0,10
"702","2727王品","110/08/13","富邦-員林",0,17,-17
"703","2727王品","110/08/13","彰銀-七賢",10,0,10
"704","2727王品","110/08/13","港商野村",3,18,-15
"705","2727王品","110/08/13","玉山-大里",10,0,10
"706","2727王品","110/08/13","富邦-新營",0,15,-15
"707","2727王品","110/08/13","富邦-台中",12,2,10
"708","2727王品","110/08/13","台灣企銀-竹北",3,17,-14
"709","2727王品","110/08/13","國泰-敦南",15,6,9
"710","2727王品","110/08/13","國泰-板橋",3,17,-14
"711","2727王品","110/08/13","臺銀",9,1,8
"712","2727王品","110/08/13","凱基-板橋",0,13,-13
"713","2727王品","110/08/13","元大-台中",8,0,8
"714","2727王品","110/08/13","日盛-中和",1,13,-12
"715","2727王品","110/08/13","國泰-台中",11,4,7
"716","2727王品","110/08/13","第一金-新竹",1,12,-11
"717","2727王品","110/08/13","永豐金-彰化",7,0,7
"718","2727王品","110/08/13","統一",1,12,-11
"719","2727王品","110/08/13","新光-桃園",6,0,6
"720","2727王品","110/08/13","統一-竹南",0,10,-10
"721","1570力肯","110/08/13","新光",147,12,135
"722","1570力肯","110/08/13","(牛牛牛)亞-鑫豐",15,136,-121
"723","1570力肯","110/08/13","國票-北高雄",128,0,128
"724","1570力肯","110/08/13","富邦-台中",0,51,-51
"725","1570力肯","110/08/13","凱基-台北",80,24,56
"726","1570力肯","110/08/13","日盛-頭份",0,50,-50
"727","1570力肯","110/08/13","統一",54,0,54
"728","1570力肯","110/08/13","元富-高雄",0,40,-40
"729","1570力肯","110/08/13","國票-內壢",49,1,48
"730","1570力肯","110/08/13","凱基-高美館",2,41,-39
"731","1570力肯","110/08/13","美林",37,0,37
"732","1570力肯","110/08/13","日盛-忠孝",0,38,-38
"733","1570力肯","110/08/13","國票-天祥",45,8,37
"734","1570力肯","110/08/13","元大-羅東",0,20,-20
"735","1570力肯","110/08/13","摩根大通",67,45,22
"736","1570力肯","110/08/13","元大-大天母",0,20,-20
"737","1570力肯","110/08/13","永豐金-屏東",22,0,22
"738","1570力肯","110/08/13","永豐金-嘉義",0,20,-20
"739","1570力肯","110/08/13","元富-新店",20,0,20
"740","1570力肯","110/08/13","國泰-敦南",2,20,-18
"741","1570力肯","110/08/13","(牛牛牛)亞證券",20,0,20
"742","1570力肯","110/08/13","元大-沙鹿",1,18,-17
"743","1570力肯","110/08/13","凱基-台南",20,0,20
"744","1570力肯","110/08/13","元大-林森",0,16,-16
"745","1570力肯","110/08/13","元大-開元",20,0,20
"746","1570力肯","110/08/13","永豐金-市政",1,16,-15
"747","1570力肯","110/08/13","元大-花蓮",20,0,20
"748","1570力肯","110/08/13","統一-三重",5,19,-14
"749","1570力肯","110/08/13","元大-基隆",19,0,19
"750","1570力肯","110/08/13","國泰-新莊",1,15,-14
"751","6180橘子","110/08/13","美商高盛",48,0,48
"752","6180橘子","110/08/13","玉山-桃園",1,30,-29
"753","6180橘子","110/08/13","美林",37,0,37
"754","6180橘子","110/08/13","元大-成功",0,22,-22
"755","6180橘子","110/08/13","凱基-台北",17,1,16
"756","6180橘子","110/08/13","群益金鼎",0,11,-11
"757","6180橘子","110/08/13","台新證券",15,1,14
"758","6180橘子","110/08/13","亞東-高雄",0,10,-10
"759","6180橘子","110/08/13","台灣摩根士丹利",13,0,13
"760","6180橘子","110/08/13","元大-北港",0,10,-10
"761","6180橘子","110/08/13","元大-北投",11,0,11
"762","6180橘子","110/08/13","統一-彰化",3,10,-7
"763","6180橘子","110/08/13","合庫-自強",10,0,10
"764","6180橘子","110/08/13","摩根大通",6,13,-7
"765","6180橘子","110/08/13","統一-台南",10,0,10
"766","6180橘子","110/08/13","群益金鼎-中山",1,8,-7
"767","6180橘子","110/08/13","兆豐-台中",10,0,10
"768","6180橘子","110/08/13","元大-敦南",0,7,-7
"769","6180橘子","110/08/13","群益金鼎-台中",10,0,10
"770","6180橘子","110/08/13","國泰-板橋",0,6,-6
"771","6180橘子","110/08/13","康和-台中",6,0,6
"772","6180橘子","110/08/13","富邦-宜蘭",0,6,-6
"773","6180橘子","110/08/13","凱基-汐止",5,0,5
"774","6180橘子","110/08/13","元大-台北",0,6,-6
"775","6180橘子","110/08/13","日盛-景美",6,2,4
"776","6180橘子","110/08/13","永豐金-板橋",0,6,-6
"777","6180橘子","110/08/13","新光-台中",4,0,4
"778","6180橘子","110/08/13","亞東",0,5,-5
"779","6180橘子","110/08/13","國泰-敦南",4,0,4
"780","6180橘子","110/08/13","兆豐-竹北",0,5,-5
"781","2390云辰","110/08/13","摩根大通",643,393,250
"782","2390云辰","110/08/13","元大-信義",0,202,-202
"783","2390云辰","110/08/13","美商高盛",269,138,131
"784","2390云辰","110/08/13","美林",169,289,-120
"785","2390云辰","110/08/13","凱基-台北",418,293,125
"786","2390云辰","110/08/13","元大-東港",9,102,-93
"787","2390云辰","110/08/13","元富-板橋",94,13,81
"788","2390云辰","110/08/13","元富-高雄",17,94,-77
"789","2390云辰","110/08/13","土銀-士林",78,0,78
"790","2390云辰","110/08/13","凱基-竹科",5,76,-71
"791","2390云辰","110/08/13","元大-前金",92,16,76
"792","2390云辰","110/08/13","國票-博愛",40,107,-67
"793","2390云辰","110/08/13","台新-台中",89,24,65
"794","2390云辰","110/08/13","群益金鼎-開元",26,90,-64
"795","2390云辰","110/08/13","光和-嘉義",73,10,63
"796","2390云辰","110/08/13","新加坡商瑞銀",4,61,-57
"797","2390云辰","110/08/13","富邦-敦南",59,0,59
"798","2390云辰","110/08/13","港商野村",277,333,-56
"799","2390云辰","110/08/13","富邦-彰化",69,11,58
"800","2390云辰","110/08/13","新光",144,197,-53
"801","2390云辰","110/08/13","元大-草屯",75,17,58
"802","2390云辰","110/08/13","統一",23,75,-52
"803","2390云辰","110/08/13","光和-溪湖",54,1,53
"804","2390云辰","110/08/13","元大-林園",0,51,-51
"805","2390云辰","110/08/13","元大-土城學府",263,210,53
"806","2390云辰","110/08/13","富邦-新營",1,48,-47
"807","2390云辰","110/08/13","元大-文心興安",64,11,53
"808","2390云辰","110/08/13","元大-新莊",33,80,-47
"809","2390云辰","110/08/13","國泰-忠孝",50,0,50
"810","2390云辰","110/08/13","日盛-園區",10,55,-45
