"","stake","date","name","buy","sell","total"
"1","2867三商壽","110/08/05","摩根大通",376,0,376
"2","2867三商壽","110/08/05","日盛-新莊",0,253,-253
"3","2867三商壽","110/08/05","玉山-大里",307,1,306
"4","2867三商壽","110/08/05","宏遠-高雄",0,156,-156
"5","2867三商壽","110/08/05","元大-土城永寧",250,0,250
"6","2867三商壽","110/08/05","康和-台中",0,135,-135
"7","2867三商壽","110/08/05","新加坡商瑞銀",137,0,137
"8","2867三商壽","110/08/05","台灣摩根士丹利",17,133,-116
"9","2867三商壽","110/08/05","大展",120,0,120
"10","2867三商壽","110/08/05","台灣企銀-竹北",0,100,-100
"11","2867三商壽","110/08/05","凱基-長庚",120,0,120
"12","2867三商壽","110/08/05","群益金鼎-桃園",1,100,-99
"13","2867三商壽","110/08/05","元大-大同",104,2,102
"14","2867三商壽","110/08/05","永豐金-高雄",10,101,-91
"15","2867三商壽","110/08/05","凱基-台北",98,30,68
"16","2867三商壽","110/08/05","元富",0,70,-70
"17","2867三商壽","110/08/05","華南永昌-朴子",60,0,60
"18","2867三商壽","110/08/05","富邦-花蓮",0,53,-53
"19","2867三商壽","110/08/05","永豐金-市政",50,0,50
"20","2867三商壽","110/08/05","日盛-台南",0,43,-43
"21","2867三商壽","110/08/05","富邦-台南",49,1,48
"22","2867三商壽","110/08/05","宏遠-台中",6,45,-39
"23","2867三商壽","110/08/05","永豐金-永康",30,0,30
"24","2867三商壽","110/08/05","瑞士信貸",0,32,-32
"25","2867三商壽","110/08/05","富邦-竹東",30,1,29
"26","2867三商壽","110/08/05","致和-高雄",0,31,-31
"27","2867三商壽","110/08/05","兆豐-高雄",30,10,20
"28","2867三商壽","110/08/05","國泰-台南",1,32,-31
"29","2867三商壽","110/08/05","群益金鼎-西松",20,0,20
"30","2867三商壽","110/08/05","元大-松山",1,31,-30
"31","5521工信","110/08/05","兆豐-桃園",72,0,72
"32","5521工信","110/08/05","美林",5,100,-95
"33","5521工信","110/08/05","(牛牛牛)亞-鑫豐",24,0,24
"34","5521工信","110/08/05","華南永昌-桃園",0,76,-76
"35","5521工信","110/08/05","富邦-建國",22,0,22
"36","5521工信","110/08/05","第一金-桃園",0,43,-43
"37","5521工信","110/08/05","日盛-雙和",16,0,16
"38","5521工信","110/08/05","凱基-台北",0,26,-26
"39","5521工信","110/08/05","元大-鳳山",16,0,16
"40","5521工信","110/08/05","台灣摩根士丹利",0,22,-22
"41","5521工信","110/08/05","元富-城東",12,0,12
"42","5521工信","110/08/05","富邦-竹北",0,20,-20
"43","5521工信","110/08/05","元大-東蘆",12,0,12
"44","5521工信","110/08/05","富邦-員林",0,20,-20
"45","5521工信","110/08/05","元大-路竹",11,0,11
"46","5521工信","110/08/05","元大-豐原",0,20,-20
"47","5521工信","110/08/05","元大-基隆孝二",11,0,11
"48","5521工信","110/08/05","港商野村",0,17,-17
"49","5521工信","110/08/05","日盛-園區",10,0,10
"50","5521工信","110/08/05","元大-大同",0,14,-14
"51","5521工信","110/08/05","玉山-台大",10,0,10
"52","5521工信","110/08/05","永豐金證券",0,14,-14
"53","5521工信","110/08/05","華南永昌-公誠",10,0,10
"54","5521工信","110/08/05","兆豐-高雄",0,10,-10
"55","5521工信","110/08/05","元大-斗六",10,0,10
"56","5521工信","110/08/05","群益金鼎-永和",0,10,-10
"57","5521工信","110/08/05","元大-屏東",10,0,10
"58","5521工信","110/08/05","永豐金-中和",0,10,-10
"59","5521工信","110/08/05","國泰-台中",9,0,9
"60","5521工信","110/08/05","第一金-高雄",0,7,-7
"61","1471首利","110/08/05","國票-北高雄",50,0,50
"62","1471首利","110/08/05","永豐金-板盛",0,129,-129
"63","1471首利","110/08/05","台灣摩根士丹利",49,0,49
"64","1471首利","110/08/05","元大-三重",0,50,-50
"65","1471首利","110/08/05","元大-太平",30,0,30
"66","1471首利","110/08/05","瑞士信貸",0,42,-42
"67","1471首利","110/08/05","國泰-敦南",24,0,24
"68","1471首利","110/08/05","美林",0,37,-37
"69","1471首利","110/08/05","玉山-桃園",21,0,21
"70","1471首利","110/08/05","元富-草屯",0,30,-30
"71","1471首利","110/08/05","宏遠-光隆",20,0,20
"72","1471首利","110/08/05","元富-民權",0,25,-25
"73","1471首利","110/08/05","富邦-嘉義",20,1,19
"74","1471首利","110/08/05","台中銀",0,23,-23
"75","1471首利","110/08/05","元大-博愛",30,13,17
"76","1471首利","110/08/05","元富-新興",0,20,-20
"77","1471首利","110/08/05","台新-高雄",16,0,16
"78","1471首利","110/08/05","摩根大通",17,33,-16
"79","1471首利","110/08/05","日盛-文化",15,0,15
"80","1471首利","110/08/05","日盛-鳳山",0,15,-15
"81","1471首利","110/08/05","群益金鼎-新莊",15,0,15
"82","1471首利","110/08/05","高橋",0,14,-14
"83","1471首利","110/08/05","凱基-科園",13,0,13
"84","1471首利","110/08/05","富邦-羅東",0,13,-13
"85","1471首利","110/08/05","元大-高雄",12,0,12
"86","1471首利","110/08/05","德信-中正",0,12,-12
"87","1471首利","110/08/05","第一金-桃園",11,0,11
"88","1471首利","110/08/05","群益金鼎-中港",5,17,-12
"89","1471首利","110/08/05","台灣企銀-太平",10,0,10
"90","1471首利","110/08/05","第一金-台南",0,10,-10
"91","2883開發金","110/08/05","元富",5268,0,5268
"92","2883開發金","110/08/05","新光-高雄",309,4909,-4600
"93","2883開發金","110/08/05","瑞士信貸",4963,0,4963
"94","2883開發金","110/08/05","富邦-竹東",594,3509,-2915
"95","2883開發金","110/08/05","富邦證券",3800,0,3800
"96","2883開發金","110/08/05","永豐金-南京",2,1915,-1913
"97","2883開發金","110/08/05","台灣摩根士丹利",3886,1250,2636
"98","2883開發金","110/08/05","第一金-自由",2,1894,-1892
"99","2883開發金","110/08/05","元富-城東",2119,68,2051
"100","2883開發金","110/08/05","康和-仁愛",0,1820,-1820
"101","2883開發金","110/08/05","港商野村",2397,395,2002
"102","2883開發金","110/08/05","兆豐-台中港",22,1522,-1500
"103","2883開發金","110/08/05","第一金-忠孝",2020,88,1932
"104","2883開發金","110/08/05","元大-大同",43,1010,-967
"105","2883開發金","110/08/05","國泰證券",1682,3,1679
"106","2883開發金","110/08/05","國票",53,645,-592
"107","2883開發金","110/08/05","大和國泰",1666,0,1666
"108","2883開發金","110/08/05","富邦-新竹",86,674,-588
"109","2883開發金","110/08/05","永豐金-板橋",1507,15,1492
"110","2883開發金","110/08/05","富邦-建國",39,560,-521
"111","2883開發金","110/08/05","台灣企銀-民雄",1002,0,1002
"112","2883開發金","110/08/05","日盛-台南",7,525,-518
"113","2883開發金","110/08/05","美林",1263,577,686
"114","2883開發金","110/08/05","凱基-基隆",1,510,-509
"115","2883開發金","110/08/05","康和",640,0,640
"116","2883開發金","110/08/05","元富-民權",0,500,-500
"117","2883開發金","110/08/05","凱基-台北",1262,679,583
"118","2883開發金","110/08/05","永豐金-松山",9,509,-500
"119","2883開發金","110/08/05","福邦證券",560,50,510
"120","2883開發金","110/08/05","華南永昌-中正",25,511,-486
"121","6205詮欣","110/08/05","富邦-高雄",27,0,27
"122","6205詮欣","110/08/05","臺銀-鳳山",0,31,-31
"123","6205詮欣","110/08/05","摩根大通",27,1,26
"124","6205詮欣","110/08/05","合庫-三重",0,15,-15
"125","6205詮欣","110/08/05","永豐金-敦南",14,0,14
"126","6205詮欣","110/08/05","臺銀-民權",11,21,-10
"127","6205詮欣","110/08/05","凱基-台北",14,1,13
"128","6205詮欣","110/08/05","日盛-中壢",0,10,-10
"129","6205詮欣","110/08/05","瑞士信貸",14,5,9
"130","6205詮欣","110/08/05","統一-松江",0,10,-10
"131","6205詮欣","110/08/05","凱基-湖口",9,0,9
"132","6205詮欣","110/08/05","台新-三民",0,9,-9
"133","6205詮欣","110/08/05","德信-新營",4,0,4
"134","6205詮欣","110/08/05","臺銀-新竹",1,9,-8
"135","6205詮欣","110/08/05","元大-東蘆",5,1,4
"136","6205詮欣","110/08/05","康和",0,5,-5
"137","6205詮欣","110/08/05","臺銀-高雄",3,0,3
"138","6205詮欣","110/08/05","元大-館前",0,4,-4
"139","6205詮欣","110/08/05","富邦-左營",3,0,3
"140","6205詮欣","110/08/05","宏遠-新化",0,3,-3
"141","6205詮欣","110/08/05","日盛-花蓮",2,0,2
"142","6205詮欣","110/08/05","新加坡商瑞銀",4,7,-3
"143","6205詮欣","110/08/05","元富-三重",2,0,2
"144","6205詮欣","110/08/05","致和-高雄",0,3,-3
"145","6205詮欣","110/08/05","北城證券",2,0,2
"146","6205詮欣","110/08/05","國票",0,3,-3
"147","6205詮欣","110/08/05","國票-南港",2,0,2
"148","6205詮欣","110/08/05","富邦-嘉義",0,3,-3
"149","6205詮欣","110/08/05","台新證券",2,0,2
"150","6205詮欣","110/08/05","統一-士林",0,2,-2
"151","1540喬福","110/08/05","元富-中原",24,0,24
"152","1540喬福","110/08/05","統一-新台中",0,21,-21
"153","1540喬福","110/08/05","台新-台南",10,0,10
"154","1540喬福","110/08/05","國泰-敦南",0,15,-15
"155","1540喬福","110/08/05","台新-台中",10,0,10
"156","1540喬福","110/08/05","華南永昌-南京",0,10,-10
"157","1540喬福","110/08/05","瑞士信貸",6,0,6
"158","1540喬福","110/08/05","元大-台中中港",0,10,-10
"159","1540喬福","110/08/05","台中銀-豐原",6,0,6
"160","1540喬福","110/08/05","德信-新營",0,8,-8
"161","1540喬福","110/08/05","凱基-台北",6,0,6
"162","1540喬福","110/08/05","新光-台南",0,4,-4
"163","1540喬福","110/08/05","凱基-台南",5,0,5
"164","1540喬福","110/08/05","元大-大天母",6,10,-4
"165","1540喬福","110/08/05","元大-士林",5,0,5
"166","1540喬福","110/08/05","康和-新竹",0,3,-3
"167","1540喬福","110/08/05","美林",2,0,2
"168","1540喬福","110/08/05","元大-龍潭",0,3,-3
"169","1540喬福","110/08/05","群益金鼎-崇德",2,0,2
"170","1540喬福","110/08/05","第一金-員林",0,1,-1
"171","1540喬福","110/08/05","凱基-苗栗",2,0,2
"172","1540喬福","110/08/05","第一金-豐原",0,1,-1
"173","1540喬福","110/08/05","凱基-中壢",2,0,2
"174","1540喬福","110/08/05","台新-高雄",0,1,-1
"175","1540喬福","110/08/05","土銀-士林",1,0,1
"176","1540喬福","110/08/05","元大-崇德",0,1,-1
"177","1540喬福","110/08/05","群益金鼎-丹鳳",1,0,1
"178","1540喬福","110/08/05","元大-中壢",0,1,-1
"179","1540喬福","110/08/05","元大-文心",1,0,1
"180","1540喬福","110/08/05","元大-斗信",0,1,-1
"181","2888新光金","110/08/05","華南永昌-南京",3753,8,3745
"182","2888新光金","110/08/05","第一金-高雄",0,5007,-5007
"183","2888新光金","110/08/05","玉山-城中",2004,28,1976
"184","2888新光金","110/08/05","美商高盛",12,1719,-1707
"185","2888新光金","110/08/05","元大-西門",906,18,888
"186","2888新光金","110/08/05","香港上海匯豐",0,1437,-1437
"187","2888新光金","110/08/05","日盛-和美",557,3,554
"188","2888新光金","110/08/05","凱基-台南",46,802,-756
"189","2888新光金","110/08/05","康和-台中",460,49,411
"190","2888新光金","110/08/05","美林",538,1140,-602
"191","2888新光金","110/08/05","元富-緯城",302,1,301
"192","2888新光金","110/08/05","凱基-台北",686,1280,-594
"193","2888新光金","110/08/05","彰銀",301,3,298
"194","2888新光金","110/08/05","法銀巴黎",0,562,-562
"195","2888新光金","110/08/05","花旗環球",356,84,272
"196","2888新光金","110/08/05","瑞士信貸",1350,1798,-448
"197","2888新光金","110/08/05","永全-南崁",240,0,240
"198","2888新光金","110/08/05","群益金鼎-丹鳳",4,303,-299
"199","2888新光金","110/08/05","永豐金-彰化",232,20,212
"200","2888新光金","110/08/05","安泰-大發",10,300,-290
"201","2888新光金","110/08/05","統一-新台中",214,7,207
"202","2888新光金","110/08/05","摩根大通",1159,1428,-269
"203","2888新光金","110/08/05","中國信託-永康",203,0,203
"204","2888新光金","110/08/05","兆豐-員林",4,260,-256
"205","2888新光金","110/08/05","日盛-景美",200,0,200
"206","2888新光金","110/08/05","日盛-大墩",0,250,-250
"207","2888新光金","110/08/05","元大-東泰",207,22,185
"208","2888新光金","110/08/05","元大-大里",31,243,-212
"209","2888新光金","110/08/05","合庫證券",181,2,179
"210","2888新光金","110/08/05","北城證券",25,230,-205
"211","1340勝悅","110/08/05","富邦-仁愛",20,0,20
"212","1340勝悅","110/08/05","中國信託",0,36,-36
"213","1340勝悅","110/08/05","華南永昌-忠孝",12,0,12
"214","1340勝悅","110/08/05","新光-新竹",0,18,-18
"215","1340勝悅","110/08/05","華南永昌-楠梓",10,0,10
"216","1340勝悅","110/08/05","永豐金-嘉義",0,15,-15
"217","1340勝悅","110/08/05","統一-城中",17,11,6
"218","1340勝悅","110/08/05","日茂",0,10,-10
"219","1340勝悅","110/08/05","臺灣企銀-埔墘",5,0,5
"220","1340勝悅","110/08/05","富邦-宜蘭",0,10,-10
"221","1340勝悅","110/08/05","國票-台東",5,0,5
"222","1340勝悅","110/08/05","元富-花蓮",0,9,-9
"223","1340勝悅","110/08/05","新光-高雄",5,0,5
"224","1340勝悅","110/08/05","永豐金-南京",0,7,-7
"225","1340勝悅","110/08/05","國泰-台中",6,1,5
"226","1340勝悅","110/08/05","統一",0,6,-6
"227","1340勝悅","110/08/05","富邦-陽明",5,0,5
"228","1340勝悅","110/08/05","合庫-西台中",0,3,-3
"229","1340勝悅","110/08/05","日盛-板橋",4,0,4
"230","1340勝悅","110/08/05","港商野村",0,3,-3
"231","1340勝悅","110/08/05","港商法國興業",4,0,4
"232","1340勝悅","110/08/05","兆豐-新竹",0,3,-3
"233","1340勝悅","110/08/05","臺銀-高雄",3,0,3
"234","1340勝悅","110/08/05","亞東-台中",0,2,-2
"235","1340勝悅","110/08/05","元富-新店",3,0,3
"236","1340勝悅","110/08/05","元大-歸仁",0,2,-2
"237","1340勝悅","110/08/05","康和-屏東",3,0,3
"238","1340勝悅","110/08/05","日盛-斗六",0,1,-1
"239","1340勝悅","110/08/05","群益金鼎-民權",3,0,3
"240","1340勝悅","110/08/05","日盛-中和",0,1,-1
"241","6246臺龍","110/08/05","元大-林森",200,0,200
"242","6246臺龍","110/08/05","統一",0,180,-180
"243","6246臺龍","110/08/05","元大證券",92,1,91
"244","6246臺龍","110/08/05","大慶-富順",0,114,-114
"245","6246臺龍","110/08/05","凱基-大直",99,19,80
"246","6246臺龍","110/08/05","台新-三民",0,77,-77
"247","6246臺龍","110/08/05","元大-北港",51,0,51
"248","6246臺龍","110/08/05","永興",0,48,-48
"249","6246臺龍","110/08/05","統一-南京",50,0,50
"250","6246臺龍","110/08/05","華南永昌-嘉義",1,26,-25
"251","6246臺龍","110/08/05","台灣企銀",40,0,40
"252","6246臺龍","110/08/05","宏遠-民生",0,20,-20
"253","6246臺龍","110/08/05","永豐金-虎尾",23,0,23
"254","6246臺龍","110/08/05","兆豐-大同",0,20,-20
"255","6246臺龍","110/08/05","凱基-台北",27,5,22
"256","6246臺龍","110/08/05","華南永昌-林口",0,20,-20
"257","6246臺龍","110/08/05","元富-新竹",20,0,20
"258","6246臺龍","110/08/05","元大-永春",0,20,-20
"259","6246臺龍","110/08/05","康和-石牌",20,0,20
"260","6246臺龍","110/08/05","元大-東泰",0,19,-19
"261","6246臺龍","110/08/05","聯邦-大業",20,0,20
"262","6246臺龍","110/08/05","德信-新營",0,18,-18
"263","6246臺龍","110/08/05","凱基-彰化",18,0,18
"264","6246臺龍","110/08/05","永豐金-松山",10,28,-18
"265","6246臺龍","110/08/05","永豐金-復興",17,1,16
"266","6246臺龍","110/08/05","台新-台中",4,20,-16
"267","6246臺龍","110/08/05","新光-台中",17,2,15
"268","6246臺龍","110/08/05","兆豐-竹北",5,20,-15
"269","6246臺龍","110/08/05","元大-路竹",15,1,14
"270","6246臺龍","110/08/05","兆豐-南京",1,14,-13
"271","00715L期街口布蘭特正2","110/08/05","(牛牛牛)亞-鑫豐",1195,20,1175
"272","00715L期街口布蘭特正2","110/08/05","元大證券",1735,21716,-19981
"273","00715L期街口布蘭特正2","110/08/05","元大-萬華",930,0,930
"274","00715L期街口布蘭特正2","110/08/05","凱基-台北",182,11686,-11504
"275","00715L期街口布蘭特正2","110/08/05","元大-永康",810,9,801
"276","00715L期街口布蘭特正2","110/08/05","元富",8,6852,-6844
"277","00715L期街口布蘭特正2","110/08/05","富邦-彰化",760,0,760
"278","00715L期街口布蘭特正2","110/08/05","台新證券",598,4522,-3924
"279","00715L期街口布蘭特正2","110/08/05","國泰-敦南",830,155,675
"280","00715L期街口布蘭特正2","110/08/05","凱基",0,3168,-3168
"281","00715L期街口布蘭特正2","110/08/05","新光-台中",698,33,665
"282","00715L期街口布蘭特正2","110/08/05","群益金鼎",0,1742,-1742
"283","00715L期街口布蘭特正2","110/08/05","富邦-南屯",621,5,616
"284","00715L期街口布蘭特正2","110/08/05","國票",22,1607,-1585
"285","00715L期街口布蘭特正2","110/08/05","群益金鼎-士林",620,40,580
"286","00715L期街口布蘭特正2","110/08/05","永豐金證券",91,1254,-1163
"287","00715L期街口布蘭特正2","110/08/05","兆豐-嘉義",510,0,510
"288","00715L期街口布蘭特正2","110/08/05","富邦證券",140,1095,-955
"289","00715L期街口布蘭特正2","110/08/05","統一-新竹",508,9,499
"290","00715L期街口布蘭特正2","110/08/05","元大-雙和",22,850,-828
"291","00715L期街口布蘭特正2","110/08/05","國泰-板橋",521,24,497
"292","00715L期街口布蘭特正2","110/08/05","國票-台中",25,805,-780
"293","00715L期街口布蘭特正2","110/08/05","元大-中和",481,3,478
"294","00715L期街口布蘭特正2","110/08/05","華南永昌-長虹",145,820,-675
"295","00715L期街口布蘭特正2","110/08/05","元大-羅東",470,0,470
"296","00715L期街口布蘭特正2","110/08/05","日盛-大墩",121,455,-334
"297","00715L期街口布蘭特正2","110/08/05","群益金鼎-嘉義",483,20,463
"298","00715L期街口布蘭特正2","110/08/05","華南永昌-斗六",52,380,-328
"299","00715L期街口布蘭特正2","110/08/05","群益金鼎-中壢",476,30,446
"300","00715L期街口布蘭特正2","110/08/05","康和",0,250,-250
"301","8941關中","110/08/05","第一金-台南",1,0,1
"302","8941關中","110/08/05","元富-宜蘭",0,2,-2
"303","8941關中","110/08/05","康和-嘉義",1,0,1
"304","8941關中","110/08/05","統一-南京",0,1,-1
"305","8941關中","110/08/05","群益金鼎-延平",1,0,1
"306","8941關中","110/08/05","合庫證券",0,0,0
"307","8941關中","110/08/05","合庫證券",0,0,0
"308","8941關中","110/08/05","(牛牛牛)亞-鑫豐",0,0,0
"309","8941關中","110/08/05","(牛牛牛)亞-鑫豐",0,0,0
"310","8941關中","110/08/05","富邦-北港",0,0,0
"311","8941關中","110/08/05","富邦-北港",0,0,0
"312","8941關中","110/08/05","",NA,NA,NA
"313","8941關中","110/08/05","",NA,NA,NA
"314","8941關中","110/08/05","",NA,NA,NA
"315","8941關中","110/08/05","",NA,NA,NA
"316","8941關中","110/08/05","",NA,NA,NA
"317","8941關中","110/08/05","",NA,NA,NA
"318","8941關中","110/08/05","",NA,NA,NA
"319","8941關中","110/08/05","",NA,NA,NA
"320","8941關中","110/08/05","",NA,NA,NA
"321","8941關中","110/08/05","",NA,NA,NA
"322","8941關中","110/08/05","",NA,NA,NA
"323","8941關中","110/08/05","",NA,NA,NA
"324","8941關中","110/08/05","",NA,NA,NA
"325","8941關中","110/08/05","",NA,NA,NA
"326","8941關中","110/08/05","",NA,NA,NA
"327","8941關中","110/08/05","",NA,NA,NA
"328","8941關中","110/08/05","",NA,NA,NA
"329","8941關中","110/08/05","",NA,NA,NA
"330","8941關中","110/08/05","",NA,NA,NA
"331","8936國統","110/08/05","國票-敦北法人",100,0,100
"332","8936國統","110/08/05","摩根大通",16,240,-224
"333","8936國統","110/08/05","第一金-光復",50,0,50
"334","8936國統","110/08/05","台新-松江",0,205,-205
"335","8936國統","110/08/05","元大-蘆洲",45,0,45
"336","8936國統","110/08/05","凱基-台北",1,177,-176
"337","8936國統","110/08/05","富邦-建國",34,0,34
"338","8936國統","110/08/05","新加坡商瑞銀",14,119,-105
"339","8936國統","110/08/05","富邦-高雄",33,1,32
"340","8936國統","110/08/05","凱基-市政",0,35,-35
"341","8936國統","110/08/05","元大-敦南",30,0,30
"342","8936國統","110/08/05","瑞士信貸",0,31,-31
"343","8936國統","110/08/05","元大-博愛",23,0,23
"344","8936國統","110/08/05","合庫-高雄",22,49,-27
"345","8936國統","110/08/05","國票-長城",20,0,20
"346","8936國統","110/08/05","港商野村",15,41,-26
"347","8936國統","110/08/05","凱基-岡山",20,0,20
"348","8936國統","110/08/05","富邦-陽明",1,24,-23
"349","8936國統","110/08/05","凱基-台南",20,0,20
"350","8936國統","110/08/05","合庫-新竹",0,22,-22
"351","8936國統","110/08/05","富邦-中壢",21,2,19
"352","8936國統","110/08/05","美商高盛",0,20,-20
"353","8936國統","110/08/05","永豐金-忠孝",17,0,17
"354","8936國統","110/08/05","元大-雙和",0,20,-20
"355","8936國統","110/08/05","玉山-台中",16,0,16
"356","8936國統","110/08/05","彰銀-七賢",0,18,-18
"357","8936國統","110/08/05","兆豐-景美",15,0,15
"358","8936國統","110/08/05","台灣企銀-台中",0,15,-15
"359","8936國統","110/08/05","富邦-南屯",15,0,15
"360","8936國統","110/08/05","兆豐-大同",0,15,-15
"361","6226光鼎","110/08/05","國泰-敦南",190,90,100
"362","6226光鼎","110/08/05","富邦-嘉義",590,964,-374
"363","6226光鼎","110/08/05","凱基-台中",98,2,96
"364","6226光鼎","110/08/05","日盛-員林",9,200,-191
"365","6226光鼎","110/08/05","華南永昌-大安",95,13,82
"366","6226光鼎","110/08/05","華南永昌",5,157,-152
"367","6226光鼎","110/08/05","凱基-豐中",68,2,66
"368","6226光鼎","110/08/05","國票-敦北法人",0,106,-106
"369","6226光鼎","110/08/05","元富-西松",76,15,61
"370","6226光鼎","110/08/05","元大-雙和",27,118,-91
"371","6226光鼎","110/08/05","群益金鼎-土城",61,0,61
"372","6226光鼎","110/08/05","華南永昌-南京",48,137,-89
"373","6226光鼎","110/08/05","新光-高雄",64,4,60
"374","6226光鼎","110/08/05","統一-新竹",37,124,-87
"375","6226光鼎","110/08/05","宏遠-台中",67,9,58
"376","6226光鼎","110/08/05","大昌",3,78,-75
"377","6226光鼎","110/08/05","元大-東港",53,0,53
"378","6226光鼎","110/08/05","凱基-台北",1,74,-73
"379","6226光鼎","110/08/05","群益金鼎-敦南",60,10,50
"380","6226光鼎","110/08/05","中國信託-文心",10,65,-55
"381","6226光鼎","110/08/05","日盛-高雄",53,7,46
"382","6226光鼎","110/08/05","台新-新莊",1,54,-53
"383","6226光鼎","110/08/05","台新-新營",49,4,45
"384","6226光鼎","110/08/05","台新-台中",84,135,-51
"385","6226光鼎","110/08/05","玉山-雙和",42,2,40
"386","6226光鼎","110/08/05","元大-嘉義",77,128,-51
"387","6226光鼎","110/08/05","永豐金-高雄",44,8,36
"388","6226光鼎","110/08/05","日盛-大墩",1,43,-42
"389","6226光鼎","110/08/05","元富-花蓮",42,7,35
"390","6226光鼎","110/08/05","日茂-埔里",0,41,-41
"391","2363矽統","110/08/05","瑞士信貸",3345,0,3345
"392","2363矽統","110/08/05","新加坡商瑞銀",1909,2622,-713
"393","2363矽統","110/08/05","台灣摩根士丹利",2917,53,2864
"394","2363矽統","110/08/05","統一-板橋",37,650,-613
"395","2363矽統","110/08/05","摩根大通",5124,3944,1180
"396","2363矽統","110/08/05","美商高盛",702,1245,-543
"397","2363矽統","110/08/05","康和-台中",911,292,619
"398","2363矽統","110/08/05","元富-西松",367,902,-535
"399","2363矽統","110/08/05","永豐金證券",951,339,612
"400","2363矽統","110/08/05","華南永昌-斗六",55,584,-529
"401","2363矽統","110/08/05","群益金鼎-三民",571,106,465
"402","2363矽統","110/08/05","美林",2987,3501,-514
"403","2363矽統","110/08/05","國票-敦北法人",484,51,433
"404","2363矽統","110/08/05","群益金鼎-館前",331,802,-471
"405","2363矽統","110/08/05","陽信-石牌",624,204,420
"406","2363矽統","110/08/05","永豐金-三重",138,571,-433
"407","2363矽統","110/08/05","合庫證券",520,118,402
"408","2363矽統","110/08/05","富邦-中壢",348,774,-426
"409","2363矽統","110/08/05","元大-承德",385,70,315
"410","2363矽統","110/08/05","北城證券",53,459,-406
"411","2363矽統","110/08/05","新光",2366,2079,287
"412","2363矽統","110/08/05","凱基-興隆",370,717,-347
"413","2363矽統","110/08/05","元大證券",601,329,272
"414","2363矽統","110/08/05","元大-屏南",132,464,-332
"415","2363矽統","110/08/05","國泰-敦南",4481,4216,265
"416","2363矽統","110/08/05","日盛-中和",208,531,-323
"417","2363矽統","110/08/05","元大-台中",562,349,213
"418","2363矽統","110/08/05","土銀",28,340,-312
"419","2363矽統","110/08/05","富邦-台北",584,380,204
"420","2363矽統","110/08/05","永豐金-嘉義",97,401,-304
"421","8112至上","110/08/05","元大-竹科",858,64,794
"422","8112至上","110/08/05","摩根大通",461,775,-314
"423","8112至上","110/08/05","港商野村",937,361,576
"424","8112至上","110/08/05","台灣摩根士丹利",16,272,-256
"425","8112至上","110/08/05","康和",484,0,484
"426","8112至上","110/08/05","高橋",3,183,-180
"427","8112至上","110/08/05","新加坡商瑞銀",514,58,456
"428","8112至上","110/08/05","合庫證券",19,162,-143
"429","8112至上","110/08/05","元大-屏南",391,4,387
"430","8112至上","110/08/05","元大-北屯",3,145,-142
"431","8112至上","110/08/05","國票-長城",427,142,285
"432","8112至上","110/08/05","元大-府城",14,154,-140
"433","8112至上","110/08/05","元大-萬華",246,12,234
"434","8112至上","110/08/05","群益金鼎-三重",0,138,-138
"435","8112至上","110/08/05","台灣匯立證券",210,0,210
"436","8112至上","110/08/05","富邦-台北",25,129,-104
"437","8112至上","110/08/05","凱基-敦北",200,4,196
"438","8112至上","110/08/05","元富-佳里",7,100,-93
"439","8112至上","110/08/05","元大-北成功",205,17,188
"440","8112至上","110/08/05","元富-台南",0,86,-86
"441","8112至上","110/08/05","元大-高雄",146,14,132
"442","8112至上","110/08/05","臺灣企銀-桃園",0,82,-82
"443","8112至上","110/08/05","美商高盛",161,47,114
"444","8112至上","110/08/05","玉山-嘉義",10,88,-78
"445","8112至上","110/08/05","花旗環球",102,0,102
"446","8112至上","110/08/05","凱基-復興",1,67,-66
"447","8112至上","110/08/05","統一-士林",108,8,100
"448","8112至上","110/08/05","富邦-中壢",23,89,-66
"449","8112至上","110/08/05","新光",244,159,85
"450","8112至上","110/08/05","元大-上新莊",1,67,-66
"451","1570力肯","110/08/05","國票",352,0,352
"452","1570力肯","110/08/05","國票-和平",7,402,-395
"453","1570力肯","110/08/05","台新證券",211,87,124
"454","1570力肯","110/08/05","摩根大通",46,335,-289
"455","1570力肯","110/08/05","國泰-敦南",206,125,81
"456","1570力肯","110/08/05","國票-北高雄",79,306,-227
"457","1570力肯","110/08/05","聯邦商銀",75,0,75
"458","1570力肯","110/08/05","統一",3,226,-223
"459","1570力肯","110/08/05","元大-東泰",61,4,57
"460","1570力肯","110/08/05","凱基-台北",184,366,-182
"461","1570力肯","110/08/05","元大-桃興",113,66,47
"462","1570力肯","110/08/05","統一-土城",89,161,-72
"463","1570力肯","110/08/05","國泰-板橋",96,50,46
"464","1570力肯","110/08/05","統一-屏東",0,64,-64
"465","1570力肯","110/08/05","合庫-桃園",92,48,44
"466","1570力肯","110/08/05","大昌-新店",9,61,-52
"467","1570力肯","110/08/05","華南永昌-高雄",53,12,41
"468","1570力肯","110/08/05","群益金鼎-忠孝",11,60,-49
"469","1570力肯","110/08/05","國泰-高雄",50,14,36
"470","1570力肯","110/08/05","臺銀-臺南",12,52,-40
"471","1570力肯","110/08/05","國泰-台中",60,25,35
"472","1570力肯","110/08/05","凱基-岡山",28,68,-40
"473","1570力肯","110/08/05","富邦-仁愛",52,17,35
"474","1570力肯","110/08/05","元大-蘆洲",8,44,-36
"475","1570力肯","110/08/05","中國信託-忠孝",37,3,34
"476","1570力肯","110/08/05","統一-仁愛",25,60,-35
"477","1570力肯","110/08/05","元大-中壢",44,10,34
"478","1570力肯","110/08/05","富邦-高雄",8,43,-35
"479","1570力肯","110/08/05","日盛-新竹",30,0,30
"480","1570力肯","110/08/05","大慶-蘆洲",110,142,-32
"481","2929淘帝","110/08/05","國泰-松江",60,0,60
"482","2929淘帝","110/08/05","摩根大通",4,87,-83
"483","2929淘帝","110/08/05","美林",79,30,49
"484","2929淘帝","110/08/05","日盛-南京",0,80,-80
"485","2929淘帝","110/08/05","港商野村",87,45,42
"486","2929淘帝","110/08/05","華南永昌-頭份",0,80,-80
"487","2929淘帝","110/08/05","兆豐-忠孝",40,0,40
"488","2929淘帝","110/08/05","日盛-雙和",2,57,-55
"489","2929淘帝","110/08/05","新光-新竹",41,2,39
"490","2929淘帝","110/08/05","台新-台中",2,33,-31
"491","2929淘帝","110/08/05","元大-民生",31,0,31
"492","2929淘帝","110/08/05","群益金鼎-新竹",0,30,-30
"493","2929淘帝","110/08/05","元富-中港",28,0,28
"494","2929淘帝","110/08/05","元大-北成功",0,30,-30
"495","2929淘帝","110/08/05","凱基-台北",66,41,25
"496","2929淘帝","110/08/05","元大-天母",5,30,-25
"497","2929淘帝","110/08/05","富邦-新店",20,0,20
"498","2929淘帝","110/08/05","元大-北港",0,25,-25
"499","2929淘帝","110/08/05","康和-台中",15,0,15
"500","2929淘帝","110/08/05","兆豐-彰化",0,24,-24
"501","2929淘帝","110/08/05","華南永昌-古亭",15,0,15
"502","2929淘帝","110/08/05","國泰-台中",1,25,-24
"503","2929淘帝","110/08/05","日盛-景美",11,0,11
"504","2929淘帝","110/08/05","華南永昌-大安",0,22,-22
"505","2929淘帝","110/08/05","台新證券",11,0,11
"506","2929淘帝","110/08/05","國泰-館前",10,31,-21
"507","2929淘帝","110/08/05","凱基-三重",11,0,11
"508","2929淘帝","110/08/05","元富-安南",0,20,-20
"509","2929淘帝","110/08/05","華南永昌-竹北",11,0,11
"510","2929淘帝","110/08/05","元大-屏南",10,30,-20
"511","5410國眾","110/08/05","凱基-市政",40,0,40
"512","5410國眾","110/08/05","元富-台南",0,27,-27
"513","5410國眾","110/08/05","安泰",16,0,16
"514","5410國眾","110/08/05","群益金鼎-內湖",0,16,-16
"515","5410國眾","110/08/05","元大-善化",12,0,12
"516","5410國眾","110/08/05","中農",0,15,-15
"517","5410國眾","110/08/05","元富-同大",10,0,10
"518","5410國眾","110/08/05","新光-台南",0,15,-15
"519","5410國眾","110/08/05","中國信託-新竹",10,0,10
"520","5410國眾","110/08/05","統一-平鎮",0,13,-13
"521","5410國眾","110/08/05","元大-敦南",10,0,10
"522","5410國眾","110/08/05","臺銀",0,11,-11
"523","5410國眾","110/08/05","台灣企銀-太平",8,0,8
"524","5410國眾","110/08/05","凱基-城中",0,10,-10
"525","5410國眾","110/08/05","瑞士信貸",7,0,7
"526","5410國眾","110/08/05","元大-崇德",0,10,-10
"527","5410國眾","110/08/05","元富-烏日",6,0,6
"528","5410國眾","110/08/05","元大-和平",0,10,-10
"529","5410國眾","110/08/05","摩根大通",7,1,6
"530","5410國眾","110/08/05","新光-台中",1,9,-8
"531","5410國眾","110/08/05","元富-三重",11,6,5
"532","5410國眾","110/08/05","富邦-板橋",0,6,-6
"533","5410國眾","110/08/05","中國信託-忠孝",5,0,5
"534","5410國眾","110/08/05","新百王",0,5,-5
"535","5410國眾","110/08/05","凱基-復興",5,0,5
"536","5410國眾","110/08/05","元大-大益",0,5,-5
"537","5410國眾","110/08/05","永豐金-台中",4,0,4
"538","5410國眾","110/08/05","永豐金-板橋",0,5,-5
"539","5410國眾","110/08/05","元富-板橋",3,0,3
"540","5410國眾","110/08/05","台新-中壢",0,4,-4
"541","2841台開","110/08/05","日盛證券",201,0,201
"542","2841台開","110/08/05","第一金-自由",0,272,-272
"543","2841台開","110/08/05","永豐金-敦南",202,1,201
"544","2841台開","110/08/05","瑞士信貸",0,149,-149
"545","2841台開","110/08/05","元大-大天母",200,0,200
"546","2841台開","110/08/05","玉山-新竹",0,131,-131
"547","2841台開","110/08/05","永豐金-鳳山",100,0,100
"548","2841台開","110/08/05","元富-板橋",0,125,-125
"549","2841台開","110/08/05","台新-三民",100,1,99
"550","2841台開","110/08/05","元大-台中中港",0,109,-109
"551","2841台開","110/08/05","凱基-竹科",67,0,67
"552","2841台開","110/08/05","兆豐-東門",0,100,-100
"553","2841台開","110/08/05","國泰-敦南",44,5,39
"554","2841台開","110/08/05","(牛牛牛)亞-鑫豐",0,97,-97
"555","2841台開","110/08/05","元大-中壢",35,0,35
"556","2841台開","110/08/05","元富-嘉義",0,50,-50
"557","2841台開","110/08/05","國泰-忠孝",33,0,33
"558","2841台開","110/08/05","新光",20,67,-47
"559","2841台開","110/08/05","元大-新竹經國",30,0,30
"560","2841台開","110/08/05","永豐金-豐原",3,50,-47
"561","2841台開","110/08/05","日盛-內湖",24,0,24
"562","2841台開","110/08/05","統一-士林",0,31,-31
"563","2841台開","110/08/05","新光-高雄",21,0,21
"564","2841台開","110/08/05","元大-龍潭",0,30,-30
"565","2841台開","110/08/05","元大-林園",20,0,20
"566","2841台開","110/08/05","新光-台南",0,27,-27
"567","2841台開","110/08/05","元大-仁愛",20,0,20
"568","2841台開","110/08/05","台新-台中",0,22,-22
"569","2841台開","110/08/05","群益金鼎-崇德",18,0,18
"570","2841台開","110/08/05","大昌-安康",0,20,-20
"571","6207雷科","110/08/05","摩根大通",313,64,249
"572","6207雷科","110/08/05","日盛-忠孝",2,93,-91
"573","6207雷科","110/08/05","新加坡商瑞銀",141,6,135
"574","6207雷科","110/08/05","凱基-復興",0,90,-90
"575","6207雷科","110/08/05","凱基-台北",142,20,122
"576","6207雷科","110/08/05","群益金鼎-敦南",0,67,-67
"577","6207雷科","110/08/05","台新-高雄",111,0,111
"578","6207雷科","110/08/05","元大-鳳山",11,73,-62
"579","6207雷科","110/08/05","瑞士信貸",58,0,58
"580","6207雷科","110/08/05","群益金鼎-東門",0,56,-56
"581","6207雷科","110/08/05","美林",45,0,45
"582","6207雷科","110/08/05","元富-同大",1,41,-40
"583","6207雷科","110/08/05","凱基-板橋",46,1,45
"584","6207雷科","110/08/05","群益金鼎-屏東",1,41,-40
"585","6207雷科","110/08/05","美商高盛",37,0,37
"586","6207雷科","110/08/05","群益金鼎-延平",0,40,-40
"587","6207雷科","110/08/05","凱基-三多",30,0,30
"588","6207雷科","110/08/05","群益金鼎-瑞豐",1,33,-32
"589","6207雷科","110/08/05","永豐金-虎尾",29,0,29
"590","6207雷科","110/08/05","日盛證券",0,30,-30
"591","6207雷科","110/08/05","第一金-中山",21,1,20
"592","6207雷科","110/08/05","臺銀",1,30,-29
"593","6207雷科","110/08/05","華南永昌-林口",20,0,20
"594","6207雷科","110/08/05","群益金鼎-古亭",0,26,-26
"595","6207雷科","110/08/05","兆豐-公益",18,0,18
"596","6207雷科","110/08/05","凱基-高雄",4,30,-26
"597","6207雷科","110/08/05","港商野村",62,46,16
"598","6207雷科","110/08/05","富邦-竹東",0,25,-25
"599","6207雷科","110/08/05","華南永昌-南京",16,0,16
"600","6207雷科","110/08/05","元大-台中中港",2,25,-23
"601","3679新至陞","110/08/05","新光",13,0,13
"602","3679新至陞","110/08/05","凱基-台北",1,13,-12
"603","3679新至陞","110/08/05","華南永昌-麻豆",3,0,3
"604","3679新至陞","110/08/05","台灣摩根士丹利",0,5,-5
"605","3679新至陞","110/08/05","臺灣企銀-埔墘",2,0,2
"606","3679新至陞","110/08/05","元大-成功",0,5,-5
"607","3679新至陞","110/08/05","彰銀",2,0,2
"608","3679新至陞","110/08/05","元大證券",0,3,-3
"609","3679新至陞","110/08/05","永全-南崁",2,0,2
"610","3679新至陞","110/08/05","新加坡商瑞銀",0,2,-2
"611","3679新至陞","110/08/05","群益金鼎",2,0,2
"612","3679新至陞","110/08/05","摩根大通",0,2,-2
"613","3679新至陞","110/08/05","富邦-三重",2,0,2
"614","3679新至陞","110/08/05","國泰-館前",0,2,-2
"615","3679新至陞","110/08/05","永豐金-敦北",2,0,2
"616","3679新至陞","110/08/05","凱基-東港",0,2,-2
"617","3679新至陞","110/08/05","臺銀-新竹",1,0,1
"618","3679新至陞","110/08/05","元大-竹北",0,2,-2
"619","3679新至陞","110/08/05","第一金-新興",1,0,1
"620","3679新至陞","110/08/05","日盛-嘉義",0,1,-1
"621","3679新至陞","110/08/05","統一-宜蘭",1,0,1
"622","3679新至陞","110/08/05","美商高盛",1,2,-1
"623","3679新至陞","110/08/05","元富-同大",1,0,1
"624","3679新至陞","110/08/05","港商野村",0,1,-1
"625","3679新至陞","110/08/05","中國信託-新竹",1,0,1
"626","3679新至陞","110/08/05","第一金-員林",0,1,-1
"627","3679新至陞","110/08/05","兆豐-民生",1,0,1
"628","3679新至陞","110/08/05","統一-中壢",0,1,-1
"629","3679新至陞","110/08/05","國泰-新莊",1,0,1
"630","3679新至陞","110/08/05","統一-新竹",0,1,-1
"631","2727王品","110/08/05","港商野村",68,43,25
"632","2727王品","110/08/05","元富-宜蘭",6,96,-90
"633","2727王品","110/08/05","花旗環球",24,0,24
"634","2727王品","110/08/05","凱基-市政",1,89,-88
"635","2727王品","110/08/05","新光",42,19,23
"636","2727王品","110/08/05","群益金鼎-宜蘭",4,89,-85
"637","2727王品","110/08/05","永豐金-忠孝",21,0,21
"638","2727王品","110/08/05","永豐金-大園",4,66,-62
"639","2727王品","110/08/05","凱基-埔墘",15,0,15
"640","2727王品","110/08/05","康和-澎湖",1,60,-59
"641","2727王品","110/08/05","新光-桃園",17,3,14
"642","2727王品","110/08/05","日盛-八德",1,33,-32
"643","2727王品","110/08/05","日盛-忠孝",16,3,13
"644","2727王品","110/08/05","元大-桃園",0,29,-29
"645","2727王品","110/08/05","統一",28,15,13
"646","2727王品","110/08/05","凱基-竹科",4,31,-27
"647","2727王品","110/08/05","富邦-員林",15,2,13
"648","2727王品","110/08/05","富邦-新店",2,29,-27
"649","2727王品","110/08/05","永豐金-桃盛",16,3,13
"650","2727王品","110/08/05","兆豐-小港",2,26,-24
"651","2727王品","110/08/05","元富-屏東",12,0,12
"652","2727王品","110/08/05","華南永昌",6,25,-19
"653","2727王品","110/08/05","凱基-台北",52,40,12
"654","2727王品","110/08/05","台灣摩根士丹利",15,32,-17
"655","2727王品","110/08/05","永豐金-彰化",12,0,12
"656","2727王品","110/08/05","凱基-天母",0,15,-15
"657","2727王品","110/08/05","美林",11,0,11
"658","2727王品","110/08/05","富邦證券",0,15,-15
"659","2727王品","110/08/05","群益金鼎-崇德",10,0,10
"660","2727王品","110/08/05","永豐金證券",1,13,-12
"661","1570力肯","110/08/05","國票",352,0,352
"662","1570力肯","110/08/05","國票-和平",7,402,-395
"663","1570力肯","110/08/05","台新證券",211,87,124
"664","1570力肯","110/08/05","摩根大通",46,335,-289
"665","1570力肯","110/08/05","國泰-敦南",206,125,81
"666","1570力肯","110/08/05","國票-北高雄",79,306,-227
"667","1570力肯","110/08/05","聯邦商銀",75,0,75
"668","1570力肯","110/08/05","統一",3,226,-223
"669","1570力肯","110/08/05","元大-東泰",61,4,57
"670","1570力肯","110/08/05","凱基-台北",184,366,-182
"671","1570力肯","110/08/05","元大-桃興",113,66,47
"672","1570力肯","110/08/05","統一-土城",89,161,-72
"673","1570力肯","110/08/05","國泰-板橋",96,50,46
"674","1570力肯","110/08/05","統一-屏東",0,64,-64
"675","1570力肯","110/08/05","合庫-桃園",92,48,44
"676","1570力肯","110/08/05","大昌-新店",9,61,-52
"677","1570力肯","110/08/05","華南永昌-高雄",53,12,41
"678","1570力肯","110/08/05","群益金鼎-忠孝",11,60,-49
"679","1570力肯","110/08/05","國泰-高雄",50,14,36
"680","1570力肯","110/08/05","臺銀-臺南",12,52,-40
"681","1570力肯","110/08/05","國泰-台中",60,25,35
"682","1570力肯","110/08/05","凱基-岡山",28,68,-40
"683","1570力肯","110/08/05","富邦-仁愛",52,17,35
"684","1570力肯","110/08/05","元大-蘆洲",8,44,-36
"685","1570力肯","110/08/05","中國信託-忠孝",37,3,34
"686","1570力肯","110/08/05","統一-仁愛",25,60,-35
"687","1570力肯","110/08/05","元大-中壢",44,10,34
"688","1570力肯","110/08/05","富邦-高雄",8,43,-35
"689","1570力肯","110/08/05","日盛-新竹",30,0,30
"690","1570力肯","110/08/05","大慶-蘆洲",110,142,-32
"691","6180橘子","110/08/05","永豐金-松山",51,0,51
"692","6180橘子","110/08/05","凱基-板橋",0,80,-80
"693","6180橘子","110/08/05","新光",40,2,38
"694","6180橘子","110/08/05","康和-高雄",0,40,-40
"695","6180橘子","110/08/05","兆豐證券",33,0,33
"696","6180橘子","110/08/05","合庫-鳳山",0,32,-32
"697","6180橘子","110/08/05","中國信託-文心",15,0,15
"698","6180橘子","110/08/05","日盛-頭份",1,24,-23
"699","6180橘子","110/08/05","富邦-陽明",15,0,15
"700","6180橘子","110/08/05","兆豐-新營",0,22,-22
"701","6180橘子","110/08/05","元大-龍潭",11,0,11
"702","6180橘子","110/08/05","元大-福營",0,20,-20
"703","6180橘子","110/08/05","日盛-新竹",10,0,10
"704","6180橘子","110/08/05","新加坡商瑞銀",0,19,-19
"705","6180橘子","110/08/05","凱基-汐止",10,0,10
"706","6180橘子","110/08/05","永豐金-新竹",0,17,-17
"707","6180橘子","110/08/05","元大-中壢",10,1,9
"708","6180橘子","110/08/05","第一金-新興",1,16,-15
"709","6180橘子","110/08/05","元富-潮州",8,0,8
"710","6180橘子","110/08/05","凱基-中壢",0,12,-12
"711","6180橘子","110/08/05","大慶",7,0,7
"712","6180橘子","110/08/05","光和",0,10,-10
"713","6180橘子","110/08/05","台新證券",7,0,7
"714","6180橘子","110/08/05","統一-中壢",0,9,-9
"715","6180橘子","110/08/05","聯邦-雙和",7,0,7
"716","6180橘子","110/08/05","富邦-基隆",0,9,-9
"717","6180橘子","110/08/05","元大證券",7,0,7
"718","6180橘子","110/08/05","台灣摩根士丹利",0,8,-8
"719","6180橘子","110/08/05","國泰-新莊",6,0,6
"720","6180橘子","110/08/05","康和-仁愛",0,8,-8
"721","2390云辰","110/08/05","日盛證券",100,0,100
"722","2390云辰","110/08/05","摩根大通",45,525,-480
"723","2390云辰","110/08/05","兆豐-岡山",63,0,63
"724","2390云辰","110/08/05","統一-新台中",62,177,-115
"725","2390云辰","110/08/05","凱基-基隆",65,10,55
"726","2390云辰","110/08/05","富邦-中壢",0,81,-81
"727","2390云辰","110/08/05","凱基-中壢",52,3,49
"728","2390云辰","110/08/05","元大-大甲",3,73,-70
"729","2390云辰","110/08/05","台新-左楠",30,0,30
"730","2390云辰","110/08/05","元大-樹林",16,53,-37
"731","2390云辰","110/08/05","富邦-台北",33,6,27
"732","2390云辰","110/08/05","元富-大裕",17,46,-29
"733","2390云辰","110/08/05","統一-中壢",27,1,26
"734","2390云辰","110/08/05","凱基-台中",1,30,-29
"735","2390云辰","110/08/05","元大-和平",47,22,25
"736","2390云辰","110/08/05","大慶-蘆洲",2,30,-28
"737","2390云辰","110/08/05","統一-士林",26,2,24
"738","2390云辰","110/08/05","元大-大統",3,31,-28
"739","2390云辰","110/08/05","富邦-新營",23,0,23
"740","2390云辰","110/08/05","臺銀-金山",1,27,-26
"741","2390云辰","110/08/05","元大-景美",22,1,21
"742","2390云辰","110/08/05","國泰-台中",0,23,-23
"743","2390云辰","110/08/05","合庫-嘉義",20,0,20
"744","2390云辰","110/08/05","富邦-岡山",0,23,-23
"745","2390云辰","110/08/05","台灣企銀-嘉義",20,0,20
"746","2390云辰","110/08/05","元大-土城學府",24,47,-23
"747","2390云辰","110/08/05","日盛-板橋",21,1,20
"748","2390云辰","110/08/05","台新-台中",28,50,-22
"749","2390云辰","110/08/05","凱基-竹科",28,8,20
"750","2390云辰","110/08/05","群益金鼎-鳳山",0,21,-21
