"","stake","date","name","buy","sell","total"
"1","1471首利","110/07/29","宏遠-光隆",35,0,35
"2","1471首利","110/07/29","摩根大通",24,132,-108
"3","1471首利","110/07/29","玉山-桃園",33,3,30
"4","1471首利","110/07/29","台灣企銀-太平",0,60,-60
"5","1471首利","110/07/29","富邦-台南",30,0,30
"6","1471首利","110/07/29","元大-斗六",0,40,-40
"7","1471首利","110/07/29","臺灣企銀-桃園",25,0,25
"8","1471首利","110/07/29","元大-歸仁",0,23,-23
"9","1471首利","110/07/29","元富-草屯",15,0,15
"10","1471首利","110/07/29","日盛-永康",0,20,-20
"11","1471首利","110/07/29","新光-桃園",15,0,15
"12","1471首利","110/07/29","台中銀-員林",0,20,-20
"13","1471首利","110/07/29","元大-博愛",15,2,13
"14","1471首利","110/07/29","凱基-東門",0,14,-14
"15","1471首利","110/07/29","臺銀-鳳山",12,0,12
"16","1471首利","110/07/29","元大-草屯",1,15,-14
"17","1471首利","110/07/29","元富-新莊",11,0,11
"18","1471首利","110/07/29","元大-新竹經國",0,13,-13
"19","1471首利","110/07/29","兆豐-來福",11,0,11
"20","1471首利","110/07/29","日盛-土城",0,10,-10
"21","1471首利","110/07/29","統一-新營",10,0,10
"22","1471首利","110/07/29","美林",0,10,-10
"23","1471首利","110/07/29","光和-溪湖",10,0,10
"24","1471首利","110/07/29","永興-水湳",0,10,-10
"25","1471首利","110/07/29","台新-左楠",10,0,10
"26","1471首利","110/07/29","玉山證券",0,10,-10
"27","1471首利","110/07/29","群益金鼎-台中",10,0,10
"28","1471首利","110/07/29","群益金鼎-海山",2,12,-10
"29","1471首利","110/07/29","凱基-內埔",10,0,10
"30","1471首利","110/07/29","凱基-羅東",0,10,-10
"31","2883開發金","110/07/29","國泰證券",2782,3,2779
"32","2883開發金","110/07/29","永豐金證券",223,3618,-3395
"33","2883開發金","110/07/29","凱基-台北",2299,284,2015
"34","2883開發金","110/07/29","摩根大通",411,2625,-2214
"35","2883開發金","110/07/29","第一金",1539,7,1532
"36","2883開發金","110/07/29","台灣企銀",5,1717,-1712
"37","2883開發金","110/07/29","港商野村",1983,585,1398
"38","2883開發金","110/07/29","新加坡商瑞銀",843,2324,-1481
"39","2883開發金","110/07/29","元富",1805,427,1378
"40","2883開發金","110/07/29","港商麥格理",0,1129,-1129
"41","2883開發金","110/07/29","台灣摩根士丹利",1634,398,1236
"42","2883開發金","110/07/29","元大-學甲",1,953,-952
"43","2883開發金","110/07/29","花旗環球",932,0,932
"44","2883開發金","110/07/29","國票-博愛",100,1025,-925
"45","2883開發金","110/07/29","凱基-敦北",590,5,585
"46","2883開發金","110/07/29","國泰-館前",220,944,-724
"47","2883開發金","110/07/29","國票-長城",506,4,502
"48","2883開發金","110/07/29","兆豐-高雄",33,650,-617
"49","2883開發金","110/07/29","港商法國興業",506,18,488
"50","2883開發金","110/07/29","元富-緯城",1,513,-512
"51","2883開發金","110/07/29","台新證券",753,287,466
"52","2883開發金","110/07/29","美林",232,698,-466
"53","2883開發金","110/07/29","元大-鳳中",495,71,424
"54","2883開發金","110/07/29","元富-城中",50,513,-463
"55","2883開發金","110/07/29","日茂",374,3,371
"56","2883開發金","110/07/29","致和-崇德",0,404,-404
"57","2883開發金","110/07/29","大和國泰",368,0,368
"58","2883開發金","110/07/29","永豐金-板橋",123,506,-383
"59","2883開發金","110/07/29","新光",603,243,360
"60","2883開發金","110/07/29","中國信託-忠孝",100,423,-323
"61","6205詮欣","110/07/29","臺銀-鳳山",31,0,31
"62","6205詮欣","110/07/29","永豐金-敦南",0,53,-53
"63","6205詮欣","110/07/29","摩根大通",16,2,14
"64","6205詮欣","110/07/29","元大-土城學府",2,16,-14
"65","6205詮欣","110/07/29","臺銀",10,0,10
"66","6205詮欣","110/07/29","元富-潮州",0,11,-11
"67","6205詮欣","110/07/29","日盛證券",10,0,10
"68","6205詮欣","110/07/29","元大-清水",0,10,-10
"69","6205詮欣","110/07/29","兆豐-新莊",10,0,10
"70","6205詮欣","110/07/29","日盛-三重",0,7,-7
"71","6205詮欣","110/07/29","元大-南屯",10,0,10
"72","6205詮欣","110/07/29","日盛-屏東",0,6,-6
"73","6205詮欣","110/07/29","富邦-建國",4,0,4
"74","6205詮欣","110/07/29","華南永昌-公誠",0,5,-5
"75","6205詮欣","110/07/29","富邦-南屯",4,0,4
"76","6205詮欣","110/07/29","元大-南京",0,5,-5
"77","6205詮欣","110/07/29","臺銀-臺中",3,0,3
"78","6205詮欣","110/07/29","瑞士信貸",0,4,-4
"79","6205詮欣","110/07/29","日盛-和美",3,0,3
"80","6205詮欣","110/07/29","凱基-大安",0,4,-4
"81","6205詮欣","110/07/29","德信-新營",3,0,3
"82","6205詮欣","110/07/29","元大-大里德芳",0,4,-4
"83","6205詮欣","110/07/29","兆豐-景美",3,0,3
"84","6205詮欣","110/07/29","合庫-基隆",0,2,-2
"85","6205詮欣","110/07/29","國票",3,0,3
"86","6205詮欣","110/07/29","中國信託-永康",0,2,-2
"87","6205詮欣","110/07/29","國票-南崁",3,0,3
"88","6205詮欣","110/07/29","兆豐-小港",0,2,-2
"89","6205詮欣","110/07/29","元大-蘆洲",3,0,3
"90","6205詮欣","110/07/29","康和-台中",0,2,-2
"91","1540喬福","110/07/29","高橋-龍潭",10,0,10
"92","1540喬福","110/07/29","統一-新台中",0,19,-19
"93","1540喬福","110/07/29","富邦-南屯",10,0,10
"94","1540喬福","110/07/29","元富-大昌",0,10,-10
"95","1540喬福","110/07/29","元大-斗六",5,0,5
"96","1540喬福","110/07/29","大昌-新店",0,6,-6
"97","1540喬福","110/07/29","兆豐-北高雄",3,0,3
"98","1540喬福","110/07/29","凱基-台北",0,3,-3
"99","1540喬福","110/07/29","元大-大安",3,0,3
"100","1540喬福","110/07/29","台新-台中",0,2,-2
"101","1540喬福","110/07/29","永豐金-台中",3,0,3
"102","1540喬福","110/07/29","群益金鼎-嘉義",0,2,-2
"103","1540喬福","110/07/29","臺銀-金山",2,0,2
"104","1540喬福","110/07/29","凱基-天母",0,2,-2
"105","1540喬福","110/07/29","日盛-士林",2,0,2
"106","1540喬福","110/07/29","花旗環球",0,1,-1
"107","1540喬福","110/07/29","元大-土城學府",2,0,2
"108","1540喬福","110/07/29","第一金-大稻埕",0,1,-1
"109","1540喬福","110/07/29","元大-南京",2,0,2
"110","1540喬福","110/07/29","統一-嘉義",0,1,-1
"111","1540喬福","110/07/29","臺銀-臺南",1,0,1
"112","1540喬福","110/07/29","元富-中港",0,1,-1
"113","1540喬福","110/07/29","第一金-台南",1,0,1
"114","1540喬福","110/07/29","(牛牛牛)亞-網路",0,1,-1
"115","1540喬福","110/07/29","台中銀-豐原",1,0,1
"116","1540喬福","110/07/29","玉山-高雄",0,1,-1
"117","1540喬福","110/07/29","中國信託-高雄",1,0,1
"118","1540喬福","110/07/29","群益金鼎-台南",0,1,-1
"119","1540喬福","110/07/29","兆豐-台中港",1,0,1
"120","1540喬福","110/07/29","凱基-鳳山",0,1,-1
"121","2888新光金","110/07/29","美商高盛",6409,110,6299
"122","2888新光金","110/07/29","元大-忠孝鼎富",0,6714,-6714
"123","2888新光金","110/07/29","台灣摩根士丹利",4583,443,4140
"124","2888新光金","110/07/29","凱基-台北",5855,11898,-6043
"125","2888新光金","110/07/29","元富-草屯",2193,2,2191
"126","2888新光金","110/07/29","瑞士信貸",161,6090,-5929
"127","2888新光金","110/07/29","華南永昌-南京",2059,21,2038
"128","2888新光金","110/07/29","永豐金-萬盛",124,3599,-3475
"129","2888新光金","110/07/29","凱基-市政",1558,0,1558
"130","2888新光金","110/07/29","群益金鼎-大安",2,3306,-3304
"131","2888新光金","110/07/29","法銀巴黎",1234,0,1234
"132","2888新光金","110/07/29","凱基-復興",15,3015,-3000
"133","2888新光金","110/07/29","永豐金-台中",1166,49,1117
"134","2888新光金","110/07/29","新加坡商瑞銀",1429,4265,-2836
"135","2888新光金","110/07/29","群益金鼎-崇德",1083,10,1073
"136","2888新光金","110/07/29","凱基-大安",10,2564,-2554
"137","2888新光金","110/07/29","兆豐-竹北",1002,29,973
"138","2888新光金","110/07/29","中國信託",46,2012,-1966
"139","2888新光金","110/07/29","美林",1767,804,963
"140","2888新光金","110/07/29","群益金鼎-台北",10,1875,-1865
"141","2888新光金","110/07/29","元大-三重",882,0,882
"142","2888新光金","110/07/29","元富-城東",142,1856,-1714
"143","2888新光金","110/07/29","元大-豐原站前",983,114,869
"144","2888新光金","110/07/29","華南永昌-忠孝",10,1600,-1590
"145","2888新光金","110/07/29","元大-北港",868,5,863
"146","2888新光金","110/07/29","永豐金-信義",10,1497,-1487
"147","2888新光金","110/07/29","合庫-台中",891,54,837
"148","2888新光金","110/07/29","富邦-建國",350,1736,-1386
"149","2888新光金","110/07/29","統一-汐止",725,14,711
"150","2888新光金","110/07/29","富邦-新營",60,1402,-1342
"151","1340勝悅","110/07/29","新光-新竹",18,0,18
"152","1340勝悅","110/07/29","瑞士信貸",0,8,-8
"153","1340勝悅","110/07/29","華南永昌-彰化",5,0,5
"154","1340勝悅","110/07/29","台新證券",0,7,-7
"155","1340勝悅","110/07/29","元大-六合",5,0,5
"156","1340勝悅","110/07/29","元富-緯城",0,5,-5
"157","1340勝悅","110/07/29","第一金-自由",4,0,4
"158","1340勝悅","110/07/29","兆豐-南京",0,5,-5
"159","1340勝悅","110/07/29","新光",4,0,4
"160","1340勝悅","110/07/29","富邦-南屯",0,5,-5
"161","1340勝悅","110/07/29","美商高盛",3,0,3
"162","1340勝悅","110/07/29","元富-安南",0,4,-4
"163","1340勝悅","110/07/29","元富-彰化",3,0,3
"164","1340勝悅","110/07/29","兆豐-三民",0,4,-4
"165","1340勝悅","110/07/29","大昌",2,0,2
"166","1340勝悅","110/07/29","兆豐-松德",0,4,-4
"167","1340勝悅","110/07/29","兆豐-大安",2,0,2
"168","1340勝悅","110/07/29","國票-台中",0,4,-4
"169","1340勝悅","110/07/29","摩根大通",2,0,2
"170","1340勝悅","110/07/29","第一金-路竹",0,3,-3
"171","1340勝悅","110/07/29","新光-台中",2,0,2
"172","1340勝悅","110/07/29","統一-城中",2,4,-2
"173","1340勝悅","110/07/29","凱基-八德",2,0,2
"174","1340勝悅","110/07/29","元富-同大",0,2,-2
"175","1340勝悅","110/07/29","合庫-高雄",1,0,1
"176","1340勝悅","110/07/29","台新-高雄",0,2,-2
"177","1340勝悅","110/07/29","日進",1,0,1
"178","1340勝悅","110/07/29","凱基-北門",0,2,-2
"179","1340勝悅","110/07/29","新光-台南",1,0,1
"180","1340勝悅","110/07/29","元大-汐止",0,2,-2
"181","6246臺龍","110/07/29","港商野村",38,1,37
"182","6246臺龍","110/07/29","玉山-台南",0,27,-27
"183","6246臺龍","110/07/29","凱基-幸福",25,0,25
"184","6246臺龍","110/07/29","國泰-忠孝",0,25,-25
"185","6246臺龍","110/07/29","亞東-板橋",16,0,16
"186","6246臺龍","110/07/29","光和",0,21,-21
"187","6246臺龍","110/07/29","元大-台中",10,0,10
"188","6246臺龍","110/07/29","第一金-安和",0,20,-20
"189","6246臺龍","110/07/29","兆豐-松德",9,0,9
"190","6246臺龍","110/07/29","兆豐-竹北",5,25,-20
"191","6246臺龍","110/07/29","兆豐-公益",8,0,8
"192","6246臺龍","110/07/29","元大-大里",0,20,-20
"193","6246臺龍","110/07/29","華南永昌",7,0,7
"194","6246臺龍","110/07/29","台新-台南",0,15,-15
"195","6246臺龍","110/07/29","日盛-斗六",6,0,6
"196","6246臺龍","110/07/29","永豐金-羅東",2,15,-13
"197","6246臺龍","110/07/29","元富-中港",6,0,6
"198","6246臺龍","110/07/29","元大-博愛",1,10,-9
"199","6246臺龍","110/07/29","台新證券",8,2,6
"200","6246臺龍","110/07/29","宏遠-台中",0,5,-5
"201","6246臺龍","110/07/29","臺銀-臺中",5,0,5
"202","6246臺龍","110/07/29","台新-左楠",0,5,-5
"203","6246臺龍","110/07/29","元富-宜蘭",5,0,5
"204","6246臺龍","110/07/29","中農",0,5,-5
"205","6246臺龍","110/07/29","德信-新營",5,0,5
"206","6246臺龍","110/07/29","群益金鼎-竹南",0,5,-5
"207","6246臺龍","110/07/29","新光-新竹",5,0,5
"208","6246臺龍","110/07/29","凱基-科園",0,5,-5
"209","6246臺龍","110/07/29","國泰-敦南",10,5,5
"210","6246臺龍","110/07/29","日盛-宜蘭",1,5,-4
"211","00715L期街口布蘭特正2","110/07/29","永豐金證券",2129,2,2127
"212","00715L期街口布蘭特正2","110/07/29","國票-博愛",55,702,-647
"213","00715L期街口布蘭特正2","110/07/29","元大證券",1918,115,1803
"214","00715L期街口布蘭特正2","110/07/29","富邦-彰化",0,605,-605
"215","00715L期街口布蘭特正2","110/07/29","統一",1050,313,737
"216","00715L期街口布蘭特正2","110/07/29","元大-前金",0,440,-440
"217","00715L期街口布蘭特正2","110/07/29","港商野村",821,263,558
"218","00715L期街口布蘭特正2","110/07/29","群益金鼎-崇德",0,340,-340
"219","00715L期街口布蘭特正2","110/07/29","永豐金-內湖",500,0,500
"220","00715L期街口布蘭特正2","110/07/29","元富-板橋",7,330,-323
"221","00715L期街口布蘭特正2","110/07/29","元富-大裕",505,23,482
"222","00715L期街口布蘭特正2","110/07/29","元大-三重",3,200,-197
"223","00715L期街口布蘭特正2","110/07/29","國票-台中",276,0,276
"224","00715L期街口布蘭特正2","110/07/29","凱基-東勢",5,194,-189
"225","00715L期街口布蘭特正2","110/07/29","統一-高雄",300,118,182
"226","00715L期街口布蘭特正2","110/07/29","富邦-台北",0,181,-181
"227","00715L期街口布蘭特正2","110/07/29","群益金鼎-瑞豐",180,0,180
"228","00715L期街口布蘭特正2","110/07/29","大慶-中和",0,174,-174
"229","00715L期街口布蘭特正2","110/07/29","元大-南崁",128,0,128
"230","00715L期街口布蘭特正2","110/07/29","永豐金-萬盛",0,153,-153
"231","00715L期街口布蘭特正2","110/07/29","大慶-蘆洲",106,0,106
"232","00715L期街口布蘭特正2","110/07/29","元大-開元",0,151,-151
"233","00715L期街口布蘭特正2","110/07/29","統一-中壢",100,0,100
"234","00715L期街口布蘭特正2","110/07/29","日盛-新竹",0,126,-126
"235","00715L期街口布蘭特正2","110/07/29","第一金-自由",100,2,98
"236","00715L期街口布蘭特正2","110/07/29","凱基-豐中",0,123,-123
"237","00715L期街口布蘭特正2","110/07/29","華南永昌-內壢",100,2,98
"238","00715L期街口布蘭特正2","110/07/29","元大-東泰",0,122,-122
"239","00715L期街口布蘭特正2","110/07/29","永豐金-板橋",98,0,98
"240","00715L期街口布蘭特正2","110/07/29","台新-高雄",0,121,-121
"241","8941關中","110/07/29","富邦-仁愛",1,0,1
"242","8941關中","110/07/29","富邦-員林",0,1,-1
"243","8941關中","110/07/29","康和-板橋",0,0,0
"244","8941關中","110/07/29","康和-板橋",0,0,0
"245","8941關中","110/07/29","玉山證券",0,0,0
"246","8941關中","110/07/29","玉山證券",0,0,0
"247","8941關中","110/07/29","玉山-數位",0,0,0
"248","8941關中","110/07/29","玉山-數位",0,0,0
"249","8941關中","110/07/29","凱基-市府",0,0,0
"250","8941關中","110/07/29","凱基-市府",0,0,0
"251","8941關中","110/07/29","元大-鶯歌",0,0,0
"252","8941關中","110/07/29","元大-鶯歌",0,0,0
"253","8941關中","110/07/29","元大-花蓮",0,0,0
"254","8941關中","110/07/29","元大-花蓮",0,0,0
"255","8941關中","110/07/29","",NA,NA,NA
"256","8941關中","110/07/29","",NA,NA,NA
"257","8941關中","110/07/29","",NA,NA,NA
"258","8941關中","110/07/29","",NA,NA,NA
"259","8941關中","110/07/29","",NA,NA,NA
"260","8941關中","110/07/29","",NA,NA,NA
"261","8941關中","110/07/29","",NA,NA,NA
"262","8941關中","110/07/29","",NA,NA,NA
"263","8941關中","110/07/29","",NA,NA,NA
"264","8941關中","110/07/29","",NA,NA,NA
"265","8941關中","110/07/29","",NA,NA,NA
"266","8941關中","110/07/29","",NA,NA,NA
"267","8941關中","110/07/29","",NA,NA,NA
"268","8941關中","110/07/29","",NA,NA,NA
"269","8941關中","110/07/29","",NA,NA,NA
"270","8941關中","110/07/29","",NA,NA,NA
"271","8936國統","110/07/29","新加坡商瑞銀",89,19,70
"272","8936國統","110/07/29","日盛-忠孝",11,135,-124
"273","8936國統","110/07/29","瑞士信貸",55,3,52
"274","8936國統","110/07/29","元富-敦南",0,80,-80
"275","8936國統","110/07/29","凱基-台北",48,3,45
"276","8936國統","110/07/29","康和",0,20,-20
"277","8936國統","110/07/29","摩根大通",97,60,37
"278","8936國統","110/07/29","元大-竹科",0,20,-20
"279","8936國統","110/07/29","美林",27,2,25
"280","8936國統","110/07/29","永豐金-桃園",0,19,-19
"281","8936國統","110/07/29","凱基-三多",25,0,25
"282","8936國統","110/07/29","群益金鼎-高盛",0,14,-14
"283","8936國統","110/07/29","凱基-北門",27,2,25
"284","8936國統","110/07/29","元富-安南",2,15,-13
"285","8936國統","110/07/29","兆豐-桃鶯",30,10,20
"286","8936國統","110/07/29","富邦-內湖",2,15,-13
"287","8936國統","110/07/29","永豐金-台中",20,0,20
"288","8936國統","110/07/29","元大-復北",0,11,-11
"289","8936國統","110/07/29","台灣摩根士丹利",30,12,18
"290","8936國統","110/07/29","合庫-鳳山",0,10,-10
"291","8936國統","110/07/29","兆豐-大同",15,0,15
"292","8936國統","110/07/29","元富-潮州",0,10,-10
"293","8936國統","110/07/29","新光-台中",39,24,15
"294","8936國統","110/07/29","群益金鼎-台北",0,10,-10
"295","8936國統","110/07/29","兆豐-新營",10,0,10
"296","8936國統","110/07/29","凱基-高雄",20,30,-10
"297","8936國統","110/07/29","台新-高雄",10,0,10
"298","8936國統","110/07/29","富邦-桃園",0,10,-10
"299","8936國統","110/07/29","玉山-士林",10,0,10
"300","8936國統","110/07/29","新光",1,10,-9
"301","6226光鼎","110/07/29","台新-台中",396,46,350
"302","6226光鼎","110/07/29","群益金鼎-東大",11,309,-298
"303","6226光鼎","110/07/29","元富-永和",242,0,242
"304","6226光鼎","110/07/29","日盛證券",2,176,-174
"305","6226光鼎","110/07/29","永豐金-古亭",200,0,200
"306","6226光鼎","110/07/29","國泰-敦南",90,197,-107
"307","6226光鼎","110/07/29","華南永昌",216,46,170
"308","6226光鼎","110/07/29","元大-雙和",16,111,-95
"309","6226光鼎","110/07/29","國票-北高雄",188,36,152
"310","6226光鼎","110/07/29","元大-大統",2,94,-92
"311","6226光鼎","110/07/29","國票-台南",120,4,116
"312","6226光鼎","110/07/29","元大-板橋",5,78,-73
"313","6226光鼎","110/07/29","永豐金證券",101,3,98
"314","6226光鼎","110/07/29","群益金鼎-萬華",46,111,-65
"315","6226光鼎","110/07/29","富邦-建國",125,28,97
"316","6226光鼎","110/07/29","華南永昌-竹北",1,60,-59
"317","6226光鼎","110/07/29","群益金鼎-土城",94,9,85
"318","6226光鼎","110/07/29","玉山證券",28,86,-58
"319","6226光鼎","110/07/29","元富-四維",82,4,78
"320","6226光鼎","110/07/29","元大-土城學府",13,68,-55
"321","6226光鼎","110/07/29","元大-鳳中",69,15,54
"322","6226光鼎","110/07/29","元大-豐原",5,59,-54
"323","6226光鼎","110/07/29","台新-新莊",54,1,53
"324","6226光鼎","110/07/29","統一",56,107,-51
"325","6226光鼎","110/07/29","中國信託-新竹",63,13,50
"326","6226光鼎","110/07/29","統一-內湖",0,48,-48
"327","6226光鼎","110/07/29","群益金鼎-士林",50,0,50
"328","6226光鼎","110/07/29","元大-東港",2,50,-48
"329","6226光鼎","110/07/29","台新-高雄",125,80,45
"330","6226光鼎","110/07/29","元大-太平",1,46,-45
"331","2363矽統","110/07/29","凱基-台北",2235,1238,997
"332","2363矽統","110/07/29","康和-台中",10,437,-427
"333","2363矽統","110/07/29","摩根大通",1784,793,991
"334","2363矽統","110/07/29","第一金-新興",11,310,-299
"335","2363矽統","110/07/29","港商野村",1833,1300,533
"336","2363矽統","110/07/29","瑞士信貸",9,190,-181
"337","2363矽統","110/07/29","美林",652,288,364
"338","2363矽統","110/07/29","台新證券",659,808,-149
"339","2363矽統","110/07/29","元大-台中",376,38,338
"340","2363矽統","110/07/29","元大-萬華",42,189,-147
"341","2363矽統","110/07/29","新加坡商瑞銀",748,474,274
"342","2363矽統","110/07/29","台新-左楠",26,171,-145
"343","2363矽統","110/07/29","國泰-敦南",566,333,233
"344","2363矽統","110/07/29","華南永昌-鳳山",116,241,-125
"345","2363矽統","110/07/29","元大-旗山",299,66,233
"346","2363矽統","110/07/29","永全-南崁",0,117,-117
"347","2363矽統","110/07/29","美商高盛",600,433,167
"348","2363矽統","110/07/29","群益金鼎-桃園",25,131,-106
"349","2363矽統","110/07/29","元大-永和",146,12,134
"350","2363矽統","110/07/29","宏遠-新化",3,103,-100
"351","2363矽統","110/07/29","元大證券",137,9,128
"352","2363矽統","110/07/29","新光",331,429,-98
"353","2363矽統","110/07/29","永豐金-彰化",135,10,125
"354","2363矽統","110/07/29","中國信託-忠孝",101,188,-87
"355","2363矽統","110/07/29","北城證券",139,19,120
"356","2363矽統","110/07/29","群益金鼎-建成",11,95,-84
"357","2363矽統","110/07/29","富邦-高雄",153,34,119
"358","2363矽統","110/07/29","群益金鼎-三民",23,105,-82
"359","2363矽統","110/07/29","元大-蘆洲",120,19,101
"360","2363矽統","110/07/29","元大-豐原",104,186,-82
"361","8112至上","110/07/29","合庫證券",194,1,193
"362","8112至上","110/07/29","摩根大通",4,424,-420
"363","8112至上","110/07/29","美商高盛",154,5,149
"364","8112至上","110/07/29","日盛-高雄",2,400,-398
"365","8112至上","110/07/29","永豐金證券",144,0,144
"366","8112至上","110/07/29","港商法國興業",0,374,-374
"367","8112至上","110/07/29","新光-台中",123,12,111
"368","8112至上","110/07/29","凱基-台北",50,312,-262
"369","8112至上","110/07/29","新加坡商瑞銀",189,83,106
"370","8112至上","110/07/29","美林",69,232,-163
"371","8112至上","110/07/29","華南永昌-新莊",73,0,73
"372","8112至上","110/07/29","兆豐-公益",0,120,-120
"373","8112至上","110/07/29","新光",108,49,59
"374","8112至上","110/07/29","瑞士信貸",1,109,-108
"375","8112至上","110/07/29","元富-文心",45,3,42
"376","8112至上","110/07/29","華南永昌-小港",4,30,-26
"377","8112至上","110/07/29","華南永昌-林口",41,0,41
"378","8112至上","110/07/29","富邦-中壢",1,24,-23
"379","8112至上","110/07/29","港商野村",146,112,34
"380","8112至上","110/07/29","元大-歸仁",2,24,-22
"381","8112至上","110/07/29","臺銀-高雄",30,0,30
"382","8112至上","110/07/29","華南永昌-麻豆",0,21,-21
"383","8112至上","110/07/29","元富-佳里",30,0,30
"384","8112至上","110/07/29","台新-松江",0,20,-20
"385","8112至上","110/07/29","永豐金-內湖",30,1,29
"386","8112至上","110/07/29","元大-新莊",1,20,-19
"387","8112至上","110/07/29","台新-新營",31,3,28
"388","8112至上","110/07/29","華南永昌-岡山",1,19,-18
"389","8112至上","110/07/29","永豐金-彰化",27,0,27
"390","8112至上","110/07/29","元大-崇德",3,20,-17
"391","1570力肯","110/07/29","群益金鼎-高雄",20,0,20
"392","1570力肯","110/07/29","聯邦-興中",0,17,-17
"393","1570力肯","110/07/29","群益金鼎-板橋",16,0,16
"394","1570力肯","110/07/29","富邦-建國",0,10,-10
"395","1570力肯","110/07/29","統一-敦南",5,0,5
"396","1570力肯","110/07/29","凱基-站前",0,5,-5
"397","1570力肯","110/07/29","元富-松德",4,0,4
"398","1570力肯","110/07/29","國泰-板橋",0,4,-4
"399","1570力肯","110/07/29","元大-和平",4,0,4
"400","1570力肯","110/07/29","統一-土城",0,3,-3
"401","1570力肯","110/07/29","凱基-幸福",3,0,3
"402","1570力肯","110/07/29","凱基-大里",0,3,-3
"403","1570力肯","110/07/29","華南永昌-鳳山",3,0,3
"404","1570力肯","110/07/29","凱基-台北",0,3,-3
"405","1570力肯","110/07/29","元大-北港",4,2,2
"406","1570力肯","110/07/29","元大-屏東民生",0,3,-3
"407","1570力肯","110/07/29","美林",1,0,1
"408","1570力肯","110/07/29","元富-緯城",0,2,-2
"409","1570力肯","110/07/29","國泰-台南",1,0,1
"410","1570力肯","110/07/29","台新-高雄",0,2,-2
"411","1570力肯","110/07/29","元大-歸仁",1,0,1
"412","1570力肯","110/07/29","華南永昌-楠梓",0,2,-2
"413","1570力肯","110/07/29","元大-松山",1,0,1
"414","1570力肯","110/07/29","元大-北成功",0,2,-2
"415","1570力肯","110/07/29","元大-文心興安",1,0,1
"416","1570力肯","110/07/29","元大-板橋",0,2,-2
"417","1570力肯","110/07/29","元大-東蘆",1,0,1
"418","1570力肯","110/07/29","統一-台南",0,1,-1
"419","1570力肯","110/07/29","群益金鼎-鳳山",0,0,0
"420","1570力肯","110/07/29","台新證券",0,1,-1
"421","2929淘帝","110/07/29","新光-新竹",118,13,105
"422","2929淘帝","110/07/29","元富-敦南",0,91,-91
"423","2929淘帝","110/07/29","新加坡商瑞銀",56,0,56
"424","2929淘帝","110/07/29","日盛-板橋中山",0,38,-38
"425","2929淘帝","110/07/29","凱基-台北",39,4,35
"426","2929淘帝","110/07/29","群益金鼎-士林",0,20,-20
"427","2929淘帝","110/07/29","元大-民生",29,0,29
"428","2929淘帝","110/07/29","華南永昌-敦南",0,20,-20
"429","2929淘帝","110/07/29","美林",37,9,28
"430","2929淘帝","110/07/29","高橋-龍潭",3,20,-17
"431","2929淘帝","110/07/29","元大-承德",15,0,15
"432","2929淘帝","110/07/29","凱基-中山",4,19,-15
"433","2929淘帝","110/07/29","第一金-台南",10,0,10
"434","2929淘帝","110/07/29","富邦-台北",0,15,-15
"435","2929淘帝","110/07/29","富邦-桃園",9,0,9
"436","2929淘帝","110/07/29","元富-台中",0,14,-14
"437","2929淘帝","110/07/29","港商野村",17,10,7
"438","2929淘帝","110/07/29","台新-建北",0,13,-13
"439","2929淘帝","110/07/29","台中銀-豐原",6,0,6
"440","2929淘帝","110/07/29","永豐金-敦南",0,12,-12
"441","2929淘帝","110/07/29","元大-文心興安",6,0,6
"442","2929淘帝","110/07/29","新光-台南",0,11,-11
"443","2929淘帝","110/07/29","德信-新營",5,0,5
"444","2929淘帝","110/07/29","宏遠-光隆",0,10,-10
"445","2929淘帝","110/07/29","元大-博愛",5,0,5
"446","2929淘帝","110/07/29","元大-嘉義",0,6,-6
"447","2929淘帝","110/07/29","元大-員林",5,0,5
"448","2929淘帝","110/07/29","日茂-南投",0,5,-5
"449","2929淘帝","110/07/29","富邦-中壢",4,0,4
"450","2929淘帝","110/07/29","新光",0,5,-5
"451","5410國眾","110/07/29","兆豐-城中",32,0,32
"452","5410國眾","110/07/29","第一金-台南",0,51,-51
"453","5410國眾","110/07/29","新加坡商瑞銀",19,0,19
"454","5410國眾","110/07/29","元富-大昌",0,13,-13
"455","5410國眾","110/07/29","華南永昌-新莊",16,0,16
"456","5410國眾","110/07/29","臺銀-臺南",0,12,-12
"457","5410國眾","110/07/29","元大-小港",11,0,11
"458","5410國眾","110/07/29","日盛-木柵",0,10,-10
"459","5410國眾","110/07/29","臺銀",10,0,10
"460","5410國眾","110/07/29","元富-安南",0,10,-10
"461","5410國眾","110/07/29","臺銀-臺中",10,0,10
"462","5410國眾","110/07/29","新光",4,13,-9
"463","5410國眾","110/07/29","宏遠-館前",10,0,10
"464","5410國眾","110/07/29","永豐金-屏東",0,5,-5
"465","5410國眾","110/07/29","台新-中壢",10,0,10
"466","5410國眾","110/07/29","永豐金-苓雅",0,5,-5
"467","5410國眾","110/07/29","摩根大通",10,1,9
"468","5410國眾","110/07/29","國票-台南",0,4,-4
"469","5410國眾","110/07/29","元大-北投",9,0,9
"470","5410國眾","110/07/29","永豐金-埔里",0,4,-4
"471","5410國眾","110/07/29","台新證券",7,1,6
"472","5410國眾","110/07/29","光和",0,3,-3
"473","5410國眾","110/07/29","元富-新竹",5,0,5
"474","5410國眾","110/07/29","凱基-汐止",0,3,-3
"475","5410國眾","110/07/29","凱基-竹北",5,0,5
"476","5410國眾","110/07/29","元大-善化",0,3,-3
"477","5410國眾","110/07/29","永豐金-敦南",5,1,4
"478","5410國眾","110/07/29","元大-員林",0,3,-3
"479","5410國眾","110/07/29","美林",4,1,3
"480","5410國眾","110/07/29","永豐金-台南",0,3,-3
"481","2841台開","110/07/29","兆豐-台南",237,0,237
"482","2841台開","110/07/29","元大-四維",0,184,-184
"483","2841台開","110/07/29","永豐金-敦南",60,10,50
"484","2841台開","110/07/29","玉山-新竹",0,145,-145
"485","2841台開","110/07/29","永豐金-板新",50,0,50
"486","2841台開","110/07/29","港商野村",0,124,-124
"487","2841台開","110/07/29","華南永昌-南京",45,2,43
"488","2841台開","110/07/29","永豐金-台南",0,32,-32
"489","2841台開","110/07/29","群益金鼎-崇德",23,0,23
"490","2841台開","110/07/29","華南永昌-公誠",0,23,-23
"491","2841台開","110/07/29","日盛-園區",20,0,20
"492","2841台開","110/07/29","元大-善化",0,22,-22
"493","2841台開","110/07/29","台新-台中",20,0,20
"494","2841台開","110/07/29","元大-豐原",0,20,-20
"495","2841台開","110/07/29","華南永昌-新莊",20,0,20
"496","2841台開","110/07/29","凱基-台北",0,15,-15
"497","2841台開","110/07/29","富邦-仁愛",20,0,20
"498","2841台開","110/07/29","富邦-台北",0,15,-15
"499","2841台開","110/07/29","新光",15,0,15
"500","2841台開","110/07/29","臺銀",0,10,-10
"501","2841台開","110/07/29","華南永昌-台中",15,0,15
"502","2841台開","110/07/29","元富-三重",0,10,-10
"503","2841台開","110/07/29","凱基-彰化",13,0,13
"504","2841台開","110/07/29","元大-林森",0,10,-10
"505","2841台開","110/07/29","兆豐-台中",10,0,10
"506","2841台開","110/07/29","光和-花壇",0,9,-9
"507","2841台開","110/07/29","永豐金-松山",10,0,10
"508","2841台開","110/07/29","國泰-桃園",1,10,-9
"509","2841台開","110/07/29","國泰-館前",9,0,9
"510","2841台開","110/07/29","玉山-嘉義",0,8,-8
"511","6207雷科","110/07/29","永豐金-古亭",100,0,100
"512","6207雷科","110/07/29","摩根大通",59,151,-92
"513","6207雷科","110/07/29","國泰-館前",52,6,46
"514","6207雷科","110/07/29","凱基-高雄",0,82,-82
"515","6207雷科","110/07/29","新加坡商瑞銀",41,12,29
"516","6207雷科","110/07/29","元大-松江",0,25,-25
"517","6207雷科","110/07/29","大慶-蘆洲",29,6,23
"518","6207雷科","110/07/29","元大-雙和",2,25,-23
"519","6207雷科","110/07/29","永豐金-羅東",21,0,21
"520","6207雷科","110/07/29","港商野村",16,36,-20
"521","6207雷科","110/07/29","統一-南京",16,0,16
"522","6207雷科","110/07/29","盈溢-楠梓",0,20,-20
"523","6207雷科","110/07/29","凱基-台北",45,29,16
"524","6207雷科","110/07/29","統一",2,20,-18
"525","6207雷科","110/07/29","富邦-敦南",16,0,16
"526","6207雷科","110/07/29","日盛-新竹",1,16,-15
"527","6207雷科","110/07/29","統一-高雄",15,0,15
"528","6207雷科","110/07/29","康和-台中",0,15,-15
"529","6207雷科","110/07/29","台新-中壢",11,0,11
"530","6207雷科","110/07/29","凱基-竹科",0,13,-13
"531","6207雷科","110/07/29","台灣企銀-竹北",10,0,10
"532","6207雷科","110/07/29","元大-鳳中",0,12,-12
"533","6207雷科","110/07/29","宏遠證券",10,0,10
"534","6207雷科","110/07/29","元大-土城",0,12,-12
"535","6207雷科","110/07/29","中國信託-忠孝",10,0,10
"536","6207雷科","110/07/29","華南永昌-高雄",0,11,-11
"537","6207雷科","110/07/29","大昌-桃園",11,1,10
"538","6207雷科","110/07/29","元大-木柵",0,10,-10
"539","6207雷科","110/07/29","玉山-城中",11,1,10
"540","6207雷科","110/07/29","日盛-板橋",1,10,-9
"541","3679新至陞","110/07/29","華南永昌-淡水",5,0,5
"542","3679新至陞","110/07/29","元富-板橋",0,16,-16
"543","3679新至陞","110/07/29","富邦-新竹華信",5,0,5
"544","3679新至陞","110/07/29","凱基-台北",0,8,-8
"545","3679新至陞","110/07/29","永豐金-中和",5,0,5
"546","3679新至陞","110/07/29","摩根大通",1,6,-5
"547","3679新至陞","110/07/29","富邦-台北",4,0,4
"548","3679新至陞","110/07/29","美林",0,4,-4
"549","3679新至陞","110/07/29","元富-彰化",2,0,2
"550","3679新至陞","110/07/29","瑞士信貸",0,4,-4
"551","3679新至陞","110/07/29","兆豐-台中港",2,0,2
"552","3679新至陞","110/07/29","元大-成功",0,3,-3
"553","3679新至陞","110/07/29","富邦-三重",2,0,2
"554","3679新至陞","110/07/29","統一-台南",0,2,-2
"555","3679新至陞","110/07/29","元大-沙鹿",2,0,2
"556","3679新至陞","110/07/29","元富-新興",0,2,-2
"557","3679新至陞","110/07/29","元大-福營",2,0,2
"558","3679新至陞","110/07/29","凱基-竹科",0,2,-2
"559","3679新至陞","110/07/29","元大-花蓮",2,0,2
"560","3679新至陞","110/07/29","元大證券",0,2,-2
"561","3679新至陞","110/07/29","元大-板橋",2,0,2
"562","3679新至陞","110/07/29","日盛-北高雄",0,1,-1
"563","3679新至陞","110/07/29","永豐金-台南",2,0,2
"564","3679新至陞","110/07/29","宏遠-高雄",0,1,-1
"565","3679新至陞","110/07/29","合庫-彰化",1,0,1
"566","3679新至陞","110/07/29","花旗環球",0,1,-1
"567","3679新至陞","110/07/29","臺銀-臺南",1,0,1
"568","3679新至陞","110/07/29","華南永昌-岡山",0,1,-1
"569","3679新至陞","110/07/29","永興-水湳",1,0,1
"570","3679新至陞","110/07/29","元大-佳里",0,1,-1
"571","2727王品","110/07/29","第一金",30,0,30
"572","2727王品","110/07/29","元大-高雄",1,93,-92
"573","2727王品","110/07/29","港商麥格理",22,0,22
"574","2727王品","110/07/29","新加坡商瑞銀",5,82,-77
"575","2727王品","110/07/29","國票-北高雄",24,2,22
"576","2727王品","110/07/29","美林",0,27,-27
"577","2727王品","110/07/29","日盛-忠孝",21,0,21
"578","2727王品","110/07/29","港商野村",21,48,-27
"579","2727王品","110/07/29","新光",22,3,19
"580","2727王品","110/07/29","凱基-台北",43,61,-18
"581","2727王品","110/07/29","國泰-敦南",18,7,11
"582","2727王品","110/07/29","華南永昌-麻豆",0,18,-18
"583","2727王品","110/07/29","凱基-五股",11,0,11
"584","2727王品","110/07/29","國泰-台中",2,17,-15
"585","2727王品","110/07/29","兆豐-鹿港",12,2,10
"586","2727王品","110/07/29","永豐金-桃盛",0,15,-15
"587","2727王品","110/07/29","凱基-埔墘",10,0,10
"588","2727王品","110/07/29","美商高盛",1,15,-14
"589","2727王品","110/07/29","永豐金-潮州",10,0,10
"590","2727王品","110/07/29","玉山證券",4,15,-11
"591","2727王品","110/07/29","統一",12,4,8
"592","2727王品","110/07/29","摩根大通",12,22,-10
"593","2727王品","110/07/29","國泰-板橋",7,0,7
"594","2727王品","110/07/29","元大-四維",2,12,-10
"595","2727王品","110/07/29","彰銀-台中",7,1,6
"596","2727王品","110/07/29","凱基-興隆",0,9,-9
"597","2727王品","110/07/29","新光-高雄",12,6,6
"598","2727王品","110/07/29","瑞士信貸",0,8,-8
"599","2727王品","110/07/29","玉山-數位",6,0,6
"600","2727王品","110/07/29","大昌-桃園",0,7,-7
"601","1570力肯","110/07/29","群益金鼎-高雄",20,0,20
"602","1570力肯","110/07/29","聯邦-興中",0,17,-17
"603","1570力肯","110/07/29","群益金鼎-板橋",16,0,16
"604","1570力肯","110/07/29","富邦-建國",0,10,-10
"605","1570力肯","110/07/29","統一-敦南",5,0,5
"606","1570力肯","110/07/29","凱基-站前",0,5,-5
"607","1570力肯","110/07/29","元富-松德",4,0,4
"608","1570力肯","110/07/29","國泰-板橋",0,4,-4
"609","1570力肯","110/07/29","元大-和平",4,0,4
"610","1570力肯","110/07/29","統一-土城",0,3,-3
"611","1570力肯","110/07/29","凱基-幸福",3,0,3
"612","1570力肯","110/07/29","凱基-大里",0,3,-3
"613","1570力肯","110/07/29","華南永昌-鳳山",3,0,3
"614","1570力肯","110/07/29","凱基-台北",0,3,-3
"615","1570力肯","110/07/29","元大-北港",4,2,2
"616","1570力肯","110/07/29","元大-屏東民生",0,3,-3
"617","1570力肯","110/07/29","美林",1,0,1
"618","1570力肯","110/07/29","元富-緯城",0,2,-2
"619","1570力肯","110/07/29","國泰-台南",1,0,1
"620","1570力肯","110/07/29","台新-高雄",0,2,-2
"621","1570力肯","110/07/29","元大-歸仁",1,0,1
"622","1570力肯","110/07/29","華南永昌-楠梓",0,2,-2
"623","1570力肯","110/07/29","元大-松山",1,0,1
"624","1570力肯","110/07/29","元大-北成功",0,2,-2
"625","1570力肯","110/07/29","元大-文心興安",1,0,1
"626","1570力肯","110/07/29","元大-板橋",0,2,-2
"627","1570力肯","110/07/29","元大-東蘆",1,0,1
"628","1570力肯","110/07/29","統一-台南",0,1,-1
"629","1570力肯","110/07/29","群益金鼎-鳳山",0,0,0
"630","1570力肯","110/07/29","台新證券",0,1,-1
"631","6180橘子","110/07/29","凱基-台北",50,4,46
"632","6180橘子","110/07/29","兆豐證券",0,95,-95
"633","6180橘子","110/07/29","花旗環球",25,0,25
"634","6180橘子","110/07/29","香港上海匯豐",0,74,-74
"635","6180橘子","110/07/29","瑞士信貸",26,2,24
"636","6180橘子","110/07/29","福勝",0,24,-24
"637","6180橘子","110/07/29","兆豐-大同",20,0,20
"638","6180橘子","110/07/29","第一金-安和",0,20,-20
"639","6180橘子","110/07/29","新光-台中",17,0,17
"640","6180橘子","110/07/29","永豐金-敦北",0,18,-18
"641","6180橘子","110/07/29","元大-南屯",15,0,15
"642","6180橘子","110/07/29","致和-崇德",0,10,-10
"643","6180橘子","110/07/29","摩根大通",54,40,14
"644","6180橘子","110/07/29","玉山-台大",0,10,-10
"645","6180橘子","110/07/29","玉山-桃園",10,0,10
"646","6180橘子","110/07/29","元大-四維",0,10,-10
"647","6180橘子","110/07/29","永豐金-中正",10,0,10
"648","6180橘子","110/07/29","元大-小港",0,8,-8
"649","6180橘子","110/07/29","元富-三重",8,0,8
"650","6180橘子","110/07/29","台灣摩根士丹利",7,13,-6
"651","6180橘子","110/07/29","國泰-新莊",9,1,8
"652","6180橘子","110/07/29","群益金鼎-丹鳳",0,6,-6
"653","6180橘子","110/07/29","元大-木柵",8,0,8
"654","6180橘子","110/07/29","永豐金-南京",2,8,-6
"655","6180橘子","110/07/29","國票-敦北法人",7,0,7
"656","6180橘子","110/07/29","日盛-頭份",5,10,-5
"657","6180橘子","110/07/29","元大證券",7,0,7
"658","6180橘子","110/07/29","宏遠-高雄",0,5,-5
"659","6180橘子","110/07/29","高橋",6,0,6
"660","6180橘子","110/07/29","第一金-中山",1,5,-4
"661","2390云辰","110/07/29","元大-永和",561,61,500
"662","2390云辰","110/07/29","摩根大通",152,377,-225
"663","2390云辰","110/07/29","台灣摩根士丹利",163,1,162
"664","2390云辰","110/07/29","元富-同大",3,139,-136
"665","2390云辰","110/07/29","元大-善化",87,0,87
"666","2390云辰","110/07/29","豐農",3,128,-125
"667","2390云辰","110/07/29","元大-草屯",89,6,83
"668","2390云辰","110/07/29","美商高盛",6,88,-82
"669","2390云辰","110/07/29","富邦-羅東",74,10,64
"670","2390云辰","110/07/29","美林",43,112,-69
"671","2390云辰","110/07/29","元大-鑫永和",61,1,60
"672","2390云辰","110/07/29","元大-發財",4,61,-57
"673","2390云辰","110/07/29","元富-高雄",93,40,53
"674","2390云辰","110/07/29","大慶-泰山",0,51,-51
"675","2390云辰","110/07/29","台新-左楠",43,1,42
"676","2390云辰","110/07/29","群益金鼎",5,49,-44
"677","2390云辰","110/07/29","日盛-永康",35,2,33
"678","2390云辰","110/07/29","元大-松江",0,40,-40
"679","2390云辰","110/07/29","玉山-板橋",37,5,32
"680","2390云辰","110/07/29","統一-新台中",123,161,-38
"681","2390云辰","110/07/29","日盛-板橋中山",45,15,30
"682","2390云辰","110/07/29","兆豐-員林",0,35,-35
"683","2390云辰","110/07/29","元大-大統",30,0,30
"684","2390云辰","110/07/29","第一金-新竹",1,35,-34
"685","2390云辰","110/07/29","元大-竹北",30,1,29
"686","2390云辰","110/07/29","日盛-員林",3,33,-30
"687","2390云辰","110/07/29","元大-北屯",26,0,26
"688","2390云辰","110/07/29","新光",40,70,-30
"689","2390云辰","110/07/29","元大-林園",25,0,25
"690","2390云辰","110/07/29","永豐金-松山",21,49,-28
"691","1471首利","110/07/28","美林",138,26,112
"692","1471首利","110/07/28","玉山-台大",0,234,-234
"693","1471首利","110/07/28","摩根大通",164,80,84
"694","1471首利","110/07/28","國票-九鼎",0,149,-149
"695","1471首利","110/07/28","(牛牛牛)亞-鑫豐",65,0,65
"696","1471首利","110/07/28","台中銀",0,69,-69
"697","1471首利","110/07/28","大昌-新店",44,0,44
"698","1471首利","110/07/28","元大-博愛",0,32,-32
"699","1471首利","110/07/28","玉山-桃園",69,30,39
"700","1471首利","110/07/28","凱基-竹北",0,30,-30
"701","1471首利","110/07/28","兆豐-鹿港",28,0,28
"702","1471首利","110/07/28","富邦-苗栗",0,30,-30
"703","1471首利","110/07/28","聯邦-高雄",21,0,21
"704","1471首利","110/07/28","港商法國興業",0,22,-22
"705","1471首利","110/07/28","永豐金-中正",21,0,21
"706","1471首利","110/07/28","國票-安和",0,20,-20
"707","1471首利","110/07/28","第一金-高雄",16,0,16
"708","1471首利","110/07/28","華南永昌-苑裡",0,15,-15
"709","1471首利","110/07/28","統一-桃園",13,0,13
"710","1471首利","110/07/28","日盛-中壢",0,13,-13
"711","1471首利","110/07/28","新光-台中",19,6,13
"712","1471首利","110/07/28","玉山-台南",0,13,-13
"713","1471首利","110/07/28","彰銀-七賢",11,0,11
"714","1471首利","110/07/28","凱基-桃園",0,12,-12
"715","1471首利","110/07/28","第一金-台南",11,0,11
"716","1471首利","110/07/28","聯邦-雙和",0,11,-11
"717","1471首利","110/07/28","台新證券",11,0,11
"718","1471首利","110/07/28","統一-新營",0,10,-10
"719","1471首利","110/07/28","凱基-東勢",11,0,11
"720","1471首利","110/07/28","凱基-城中",0,10,-10
"721","2883開發金","110/07/28","摩根大通",5171,647,4524
"722","2883開發金","110/07/28","台灣摩根士丹利",921,11451,-10530
"723","2883開發金","110/07/28","瑞士信貸",4234,62,4172
"724","2883開發金","110/07/28","美商高盛",522,3615,-3093
"725","2883開發金","110/07/28","國泰證券",2247,28,2219
"726","2883開發金","110/07/28","(牛牛牛)亞證券",0,3000,-3000
"727","2883開發金","110/07/28","元大證券",2306,91,2215
"728","2883開發金","110/07/28","康和-仁愛",17,3004,-2987
"729","2883開發金","110/07/28","元富-城東",2203,113,2090
"730","2883開發金","110/07/28","第一金",18,2301,-2283
"731","2883開發金","110/07/28","新加坡商瑞銀",1840,81,1759
"732","2883開發金","110/07/28","凱基-台北",3735,5169,-1434
"733","2883開發金","110/07/28","永豐金-彰化",1682,27,1655
"734","2883開發金","110/07/28","宏遠-高雄",4,1420,-1416
"735","2883開發金","110/07/28","日盛證券",1637,9,1628
"736","2883開發金","110/07/28","亞東-板橋",507,1722,-1215
"737","2883開發金","110/07/28","元大-彰化",1183,11,1172
"738","2883開發金","110/07/28","凱基-豐中",32,1127,-1095
"739","2883開發金","110/07/28","美林",2507,1378,1129
"740","2883開發金","110/07/28","群益金鼎-三重",65,993,-928
"741","2883開發金","110/07/28","華南永昌",1204,239,965
"742","2883開發金","110/07/28","元大-羅東",30,872,-842
"743","2883開發金","110/07/28","日盛-台南",816,6,810
"744","2883開發金","110/07/28","花旗環球",188,1004,-816
"745","2883開發金","110/07/28","台新-松江",722,40,682
"746","2883開發金","110/07/28","華南永昌-朴子",33,716,-683
"747","2883開發金","110/07/28","新光-台中",858,231,627
"748","2883開發金","110/07/28","元大-永和",31,700,-669
"749","2883開發金","110/07/28","凱基-員林",634,25,609
"750","2883開發金","110/07/28","玉山-台南",97,738,-641
"751","6205詮欣","110/07/28","臺銀",30,0,30
"752","6205詮欣","110/07/28","台灣摩根士丹利",0,59,-59
"753","6205詮欣","110/07/28","元大-善化",30,0,30
"754","6205詮欣","110/07/28","凱基-大安",0,50,-50
"755","6205詮欣","110/07/28","日盛證券",16,0,16
"756","6205詮欣","110/07/28","元大-板橋",0,20,-20
"757","6205詮欣","110/07/28","元大-土城學府",15,3,12
"758","6205詮欣","110/07/28","摩根大通",17,30,-13
"759","6205詮欣","110/07/28","臺銀-民權",10,0,10
"760","6205詮欣","110/07/28","凱基-台北",0,11,-11
"761","6205詮欣","110/07/28","德信-新營",10,0,10
"762","6205詮欣","110/07/28","新加坡商瑞銀",0,10,-10
"763","6205詮欣","110/07/28","福勝",10,0,10
"764","6205詮欣","110/07/28","第一金-新竹",0,10,-10
"765","6205詮欣","110/07/28","元大-清水",10,0,10
"766","6205詮欣","110/07/28","台新-高雄",0,6,-6
"767","6205詮欣","110/07/28","新光",9,0,9
"768","6205詮欣","110/07/28","凱基-三多",0,6,-6
"769","6205詮欣","110/07/28","群益金鼎-屏東",7,0,7
"770","6205詮欣","110/07/28","美林",2,7,-5
"771","6205詮欣","110/07/28","元大-汐止",6,0,6
"772","6205詮欣","110/07/28","瑞士信貸",0,5,-5
"773","6205詮欣","110/07/28","統一-屏東",5,0,5
"774","6205詮欣","110/07/28","中國信託-三重",0,5,-5
"775","6205詮欣","110/07/28","日盛-三重",4,0,4
"776","6205詮欣","110/07/28","日盛-雙和",0,4,-4
"777","6205詮欣","110/07/28","亞東-板橋",4,0,4
"778","6205詮欣","110/07/28","宏遠-光隆",0,4,-4
"779","6205詮欣","110/07/28","台中銀",4,0,4
"780","6205詮欣","110/07/28","兆豐-新莊",0,4,-4
"781","1540喬福","110/07/28","兆豐-北高雄",48,0,48
"782","1540喬福","110/07/28","合庫-台中",1,60,-59
"783","1540喬福","110/07/28","兆豐-台中港",33,0,33
"784","1540喬福","110/07/28","凱基-台北",0,44,-44
"785","1540喬福","110/07/28","大慶-中壢",19,0,19
"786","1540喬福","110/07/28","元大-學甲",0,35,-35
"787","1540喬福","110/07/28","富邦-員林",18,0,18
"788","1540喬福","110/07/28","統一-新台中",0,26,-26
"789","1540喬福","110/07/28","(牛牛牛)亞-鑫豐",12,0,12
"790","1540喬福","110/07/28","新光-新竹",0,21,-21
"791","1540喬福","110/07/28","元富-文心",10,0,10
"792","1540喬福","110/07/28","富邦-台北",0,20,-20
"793","1540喬福","110/07/28","光和-和美",10,0,10
"794","1540喬福","110/07/28","富邦-南屯",0,20,-20
"795","1540喬福","110/07/28","永豐金-三重",9,0,9
"796","1540喬福","110/07/28","元大-鶯歌",0,10,-10
"797","1540喬福","110/07/28","臺銀-鳳山",8,0,8
"798","1540喬福","110/07/28","元大-豐原",0,7,-7
"799","1540喬福","110/07/28","元大-斗六",7,0,7
"800","1540喬福","110/07/28","大昌-樹林",0,6,-6
"801","1540喬福","110/07/28","台新-台中",6,0,6
"802","1540喬福","110/07/28","新光-桃園",0,5,-5
"803","1540喬福","110/07/28","華南永昌-中正",6,0,6
"804","1540喬福","110/07/28","凱基-站前",0,5,-5
"805","1540喬福","110/07/28","永豐金-台中",6,0,6
"806","1540喬福","110/07/28","臺銀",0,4,-4
"807","1540喬福","110/07/28","臺銀-民權",5,0,5
"808","1540喬福","110/07/28","台新證券",0,3,-3
"809","1540喬福","110/07/28","元富-中原",5,0,5
"810","1540喬福","110/07/28","台新-高雄",0,3,-3
"811","2888新光金","110/07/28","臺銀-高雄",3050,3,3047
"812","2888新光金","110/07/28","摩根大通",2543,11316,-8773
"813","2888新光金","110/07/28","元富-城東",2019,129,1890
"814","2888新光金","110/07/28","香港上海匯豐",120,7576,-7456
"815","2888新光金","110/07/28","元大證券",2106,407,1699
"816","2888新光金","110/07/28","凱基-台北",1641,5238,-3597
"817","2888新光金","110/07/28","凱基-台南",1068,33,1035
"818","2888新光金","110/07/28","新加坡商瑞銀",0,3572,-3572
"819","2888新光金","110/07/28","彰銀-台中",1098,75,1023
"820","2888新光金","110/07/28","台灣摩根士丹利",4358,7129,-2771
"821","2888新光金","110/07/28","元富-城中",1003,0,1003
"822","2888新光金","110/07/28","元大-大統",103,2853,-2750
"823","2888新光金","110/07/28","元大-大天母",1113,119,994
"824","2888新光金","110/07/28","光和",204,2235,-2031
"825","2888新光金","110/07/28","元大-仁愛",761,1,760
"826","2888新光金","110/07/28","兆豐-鹿港",80,1755,-1675
"827","2888新光金","110/07/28","日盛-雙和",927,179,748
"828","2888新光金","110/07/28","凱基-市政",17,1447,-1430
"829","2888新光金","110/07/28","元大-大里",648,0,648
"830","2888新光金","110/07/28","華南永昌-敦南",66,1320,-1254
"831","2888新光金","110/07/28","凱基-竹科",2665,2026,639
"832","2888新光金","110/07/28","法銀巴黎",195,1423,-1228
"833","2888新光金","110/07/28","日盛-高雄",619,11,608
"834","2888新光金","110/07/28","臺銀",123,1343,-1220
"835","2888新光金","110/07/28","群益金鼎-海山",710,151,559
"836","2888新光金","110/07/28","花旗環球",0,865,-865
"837","2888新光金","110/07/28","台新證券",855,305,550
"838","2888新光金","110/07/28","元大-鹿港",46,848,-802
"839","2888新光金","110/07/28","國泰-敦南",774,237,537
"840","2888新光金","110/07/28","合庫-台中",121,800,-679
"841","1340勝悅","110/07/28","新光-台南",50,0,50
"842","1340勝悅","110/07/28","兆豐-南京",0,25,-25
"843","1340勝悅","110/07/28","臺銀-臺中",6,0,6
"844","1340勝悅","110/07/28","凱基-台北",0,22,-22
"845","1340勝悅","110/07/28","新光",6,0,6
"846","1340勝悅","110/07/28","美林",0,12,-12
"847","1340勝悅","110/07/28","臺灣企銀-埔墘",5,0,5
"848","1340勝悅","110/07/28","群益金鼎-台中",0,11,-11
"849","1340勝悅","110/07/28","國票-敦北法人",5,0,5
"850","1340勝悅","110/07/28","合庫-西台中",1,10,-9
"851","1340勝悅","110/07/28","國泰-高雄",5,0,5
"852","1340勝悅","110/07/28","元大-基隆孝二",0,8,-8
"853","1340勝悅","110/07/28","國泰-台中",5,0,5
"854","1340勝悅","110/07/28","統一-城中",0,7,-7
"855","1340勝悅","110/07/28","群益金鼎-館前",5,0,5
"856","1340勝悅","110/07/28","凱基-幸福",0,7,-7
"857","1340勝悅","110/07/28","中國信託-文心",3,0,3
"858","1340勝悅","110/07/28","臺銀-新竹",0,5,-5
"859","1340勝悅","110/07/28","群益金鼎-崇德",3,0,3
"860","1340勝悅","110/07/28","港商法國興業",0,5,-5
"861","1340勝悅","110/07/28","元大-永春",3,0,3
"862","1340勝悅","110/07/28","元大-新竹經國",0,5,-5
"863","1340勝悅","110/07/28","永豐金-松山",3,0,3
"864","1340勝悅","110/07/28","台新證券",0,4,-4
"865","1340勝悅","110/07/28","永豐金-嘉義",3,0,3
"866","1340勝悅","110/07/28","港商野村",0,3,-3
"867","1340勝悅","110/07/28","日盛-木柵",2,0,2
"868","1340勝悅","110/07/28","摩根大通",0,3,-3
"869","1340勝悅","110/07/28","台新-台中",2,0,2
"870","1340勝悅","110/07/28","富邦-台北",0,3,-3
"871","6246臺龍","110/07/28","元大-基隆孝二",32,0,32
"872","6246臺龍","110/07/28","永豐金-桃園",4,135,-131
"873","6246臺龍","110/07/28","合庫-台中",30,0,30
"874","6246臺龍","110/07/28","港商野村",5,93,-88
"875","6246臺龍","110/07/28","元大-木柵",30,0,30
"876","6246臺龍","110/07/28","凱基-台北",9,65,-56
"877","6246臺龍","110/07/28","光和",21,0,21
"878","6246臺龍","110/07/28","元大-西螺",0,31,-31
"879","6246臺龍","110/07/28","宏遠-民生",20,0,20
"880","6246臺龍","110/07/28","群益金鼎-鳳山",0,27,-27
"881","6246臺龍","110/07/28","第一金-安和",20,0,20
"882","6246臺龍","110/07/28","元大-西屯",0,25,-25
"883","6246臺龍","110/07/28","兆豐-竹北",24,4,20
"884","6246臺龍","110/07/28","永豐金-虎尾",6,27,-21
"885","6246臺龍","110/07/28","凱基-幸福",20,0,20
"886","6246臺龍","110/07/28","日盛-台中",1,20,-19
"887","6246臺龍","110/07/28","德信-新營",19,0,19
"888","6246臺龍","110/07/28","統一",0,16,-16
"889","6246臺龍","110/07/28","台新證券",21,4,17
"890","6246臺龍","110/07/28","群益金鼎-土城",0,16,-16
"891","6246臺龍","110/07/28","華南永昌-公誠",17,0,17
"892","6246臺龍","110/07/28","元大-員林",0,15,-15
"893","6246臺龍","110/07/28","中國信託-文心",15,0,15
"894","6246臺龍","110/07/28","華南永昌-長虹",0,11,-11
"895","6246臺龍","110/07/28","群益金鼎-崇德",15,0,15
"896","6246臺龍","110/07/28","日盛-中壢",0,10,-10
"897","6246臺龍","110/07/28","兆豐-公益",12,0,12
"898","6246臺龍","110/07/28","第一金-彰化",0,10,-10
"899","6246臺龍","110/07/28","國票",12,0,12
"900","6246臺龍","110/07/28","元富-中原",0,10,-10
"901","00715L期街口布蘭特正2","110/07/28","永豐金證券",5725,30,5695
"902","00715L期街口布蘭特正2","110/07/28","元大-四維",0,2013,-2013
"903","00715L期街口布蘭特正2","110/07/28","元大證券",5235,705,4530
"904","00715L期街口布蘭特正2","110/07/28","凱基-豐中",0,1536,-1536
"905","00715L期街口布蘭特正2","110/07/28","國票",2733,11,2722
"906","00715L期街口布蘭特正2","110/07/28","華南永昌-東昇",0,1010,-1010
"907","00715L期街口布蘭特正2","110/07/28","富邦證券",2340,417,1923
"908","00715L期街口布蘭特正2","110/07/28","兆豐-三民",0,1004,-1004
"909","00715L期街口布蘭特正2","110/07/28","凱基-台北",2241,325,1916
"910","00715L期街口布蘭特正2","110/07/28","元富-古亭",0,600,-600
"911","00715L期街口布蘭特正2","110/07/28","統一",1635,132,1503
"912","00715L期街口布蘭特正2","110/07/28","台新-新營",20,558,-538
"913","00715L期街口布蘭特正2","110/07/28","國票-中港",1500,0,1500
"914","00715L期街口布蘭特正2","110/07/28","富邦-台北",0,453,-453
"915","00715L期街口布蘭特正2","110/07/28","兆豐-台中",525,6,519
"916","00715L期街口布蘭特正2","110/07/28","港商野村",71,519,-448
"917","00715L期街口布蘭特正2","110/07/28","合庫證券",1008,500,508
"918","00715L期街口布蘭特正2","110/07/28","第一金-自由",10,405,-395
"919","00715L期街口布蘭特正2","110/07/28","永豐金-三重",500,0,500
"920","00715L期街口布蘭特正2","110/07/28","玉山-高雄",17,387,-370
"921","00715L期街口布蘭特正2","110/07/28","凱基-市政",500,1,499
"922","00715L期街口布蘭特正2","110/07/28","統一-桃園",0,331,-331
"923","00715L期街口布蘭特正2","110/07/28","元富-大裕",500,8,492
"924","00715L期街口布蘭特正2","110/07/28","元富-中壢",0,309,-309
"925","00715L期街口布蘭特正2","110/07/28","永豐金-內湖",503,18,485
"926","00715L期街口布蘭特正2","110/07/28","台新證券",21,329,-308
"927","00715L期街口布蘭特正2","110/07/28","元富-吉利",280,0,280
"928","00715L期街口布蘭特正2","110/07/28","國票-台中",0,275,-275
"929","00715L期街口布蘭特正2","110/07/28","國票-博愛",200,0,200
"930","00715L期街口布蘭特正2","110/07/28","日盛-木柵",0,268,-268
"931","8941關中","110/07/28","第一金-台南",2,0,2
"932","8941關中","110/07/28","聯邦-富強",0,3,-3
"933","8941關中","110/07/28","元大-西屯",2,0,2
"934","8941關中","110/07/28","富邦-員林",0,3,-3
"935","8941關中","110/07/28","玉山證券",1,0,1
"936","8941關中","110/07/28","第一金-安和",0,2,-2
"937","8941關中","110/07/28","國泰-忠孝",1,0,1
"938","8941關中","110/07/28","第一金-台中",0,1,-1
"939","8941關中","110/07/28","凱基-岡山",1,0,1
"940","8941關中","110/07/28","玉山-台中",0,0,0
"941","8941關中","110/07/28","富邦-羅東",1,0,1
"942","8941關中","110/07/28","元大-新竹經國",0,0,0
"943","8941關中","110/07/28","永豐金-敦南",1,0,1
"944","8941關中","110/07/28","元大-桃興",1,1,0
"945","8941關中","110/07/28","玉山-台中",0,0,0
"946","8941關中","110/07/28","",NA,NA,NA
"947","8941關中","110/07/28","元大-新竹經國",0,0,0
"948","8941關中","110/07/28","",NA,NA,NA
"949","8941關中","110/07/28","元大-桃興",1,1,0
"950","8941關中","110/07/28","",NA,NA,NA
"951","8941關中","110/07/28","",NA,NA,NA
"952","8941關中","110/07/28","",NA,NA,NA
"953","8941關中","110/07/28","",NA,NA,NA
"954","8941關中","110/07/28","",NA,NA,NA
"955","8941關中","110/07/28","",NA,NA,NA
"956","8941關中","110/07/28","",NA,NA,NA
"957","8941關中","110/07/28","",NA,NA,NA
"958","8941關中","110/07/28","",NA,NA,NA
"959","8941關中","110/07/28","",NA,NA,NA
"960","8941關中","110/07/28","",NA,NA,NA
"961","8936國統","110/07/28","宏遠-高雄",141,1,140
"962","8936國統","110/07/28","摩根大通",82,517,-435
"963","8936國統","110/07/28","日盛-景美",100,0,100
"964","8936國統","110/07/28","凱基-台北",5,290,-285
"965","8936國統","110/07/28","永豐金-苓雅",67,0,67
"966","8936國統","110/07/28","瑞士信貸",0,245,-245
"967","8936國統","110/07/28","玉山-台南",64,0,64
"968","8936國統","110/07/28","台灣摩根士丹利",16,176,-160
"969","8936國統","110/07/28","國票-北高雄",61,1,60
"970","8936國統","110/07/28","凱基-市政",11,110,-99
"971","8936國統","110/07/28","玉山-高雄",49,0,49
"972","8936國統","110/07/28","元大-東蘆",0,82,-82
"973","8936國統","110/07/28","元大-小港",47,0,47
"974","8936國統","110/07/28","新加坡商瑞銀",128,205,-77
"975","8936國統","110/07/28","元大-台中",40,0,40
"976","8936國統","110/07/28","元大-歸仁",30,75,-45
"977","8936國統","110/07/28","新光-台中",41,7,34
"978","8936國統","110/07/28","台新-台中",17,55,-38
"979","8936國統","110/07/28","元大-豐原站前",32,0,32
"980","8936國統","110/07/28","康和",20,58,-38
"981","8936國統","110/07/28","玉山-台中",31,0,31
"982","8936國統","110/07/28","第一金-新興",0,31,-31
"983","8936國統","110/07/28","富邦-高雄",26,0,26
"984","8936國統","110/07/28","元富-松德",0,30,-30
"985","8936國統","110/07/28","元大-鳳中",30,5,25
"986","8936國統","110/07/28","元大-中和",2,30,-28
"987","8936國統","110/07/28","元富-林園",20,0,20
"988","8936國統","110/07/28","兆豐-嘉義",0,22,-22
"989","8936國統","110/07/28","兆豐-北高雄",20,0,20
"990","8936國統","110/07/28","美林",11,32,-21
"991","6226光鼎","110/07/28","群益金鼎-萬華",147,14,133
"992","6226光鼎","110/07/28","群益金鼎-敦南",5,282,-277
"993","6226光鼎","110/07/28","台新-台中",227,114,113
"994","6226光鼎","110/07/28","華南永昌",19,142,-123
"995","6226光鼎","110/07/28","摩根大通",109,0,109
"996","6226光鼎","110/07/28","康和-台北",0,100,-100
"997","6226光鼎","110/07/28","統一",107,0,107
"998","6226光鼎","110/07/28","臺銀-民權",4,100,-96
"999","6226光鼎","110/07/28","凱基-台北",103,1,102
"1000","6226光鼎","110/07/28","元大-潮州",11,102,-91
"1001","6226光鼎","110/07/28","台灣摩根士丹利",104,7,97
"1002","6226光鼎","110/07/28","華南永昌-嘉義",50,130,-80
"1003","6226光鼎","110/07/28","群益金鼎-館前",97,0,97
"1004","6226光鼎","110/07/28","台新證券",79,153,-74
"1005","6226光鼎","110/07/28","國泰-台中",97,20,77
"1006","6226光鼎","110/07/28","玉山-台南",4,74,-70
"1007","6226光鼎","110/07/28","元大-嘉義",83,16,67
"1008","6226光鼎","110/07/28","臺銀-臺中",6,65,-59
"1009","6226光鼎","110/07/28","新光-桃園",69,8,61
"1010","6226光鼎","110/07/28","富邦-仁愛",6,63,-57
"1011","6226光鼎","110/07/28","群益金鼎-三重",59,2,57
"1012","6226光鼎","110/07/28","凱基-大里",0,51,-51
"1013","6226光鼎","110/07/28","日盛-員林",63,12,51
"1014","6226光鼎","110/07/28","國泰-敦南",116,166,-50
"1015","6226光鼎","110/07/28","永豐金-松山",66,20,46
"1016","6226光鼎","110/07/28","元富-中港",2,51,-49
"1017","6226光鼎","110/07/28","統一-內湖",48,7,41
"1018","6226光鼎","110/07/28","群益金鼎-延平",0,49,-49
"1019","6226光鼎","110/07/28","凱基-高美館",51,10,41
"1020","6226光鼎","110/07/28","元大-新竹經國",5,53,-48
"1021","2363矽統","110/07/28","摩根大通",809,282,527
"1022","2363矽統","110/07/28","國泰-敦南",145,861,-716
"1023","2363矽統","110/07/28","美商高盛",532,264,268
"1024","2363矽統","110/07/28","元大-台中",18,384,-366
"1025","2363矽統","110/07/28","台新-三民",263,18,245
"1026","2363矽統","110/07/28","新光",197,525,-328
"1027","2363矽統","110/07/28","台新證券",929,703,226
"1028","2363矽統","110/07/28","群益金鼎-三民",24,266,-242
"1029","2363矽統","110/07/28","第一金-嘉義",154,0,154
"1030","2363矽統","110/07/28","凱基-斗六",0,187,-187
"1031","2363矽統","110/07/28","凱基-台北",1039,889,150
"1032","2363矽統","110/07/28","元大-上新莊",3,134,-131
"1033","2363矽統","110/07/28","永豐金-竹科",132,11,121
"1034","2363矽統","110/07/28","永豐金-彰化",5,134,-129
"1035","2363矽統","110/07/28","華南永昌-鳳山",146,34,112
"1036","2363矽統","110/07/28","日盛-二林",15,142,-127
"1037","2363矽統","110/07/28","第一金-新興",108,1,107
"1038","2363矽統","110/07/28","元大證券",18,125,-107
"1039","2363矽統","110/07/28","港商野村",673,568,105
"1040","2363矽統","110/07/28","新光-台南",25,129,-104
"1041","2363矽統","110/07/28","群益金鼎-桃園",111,11,100
"1042","2363矽統","110/07/28","統一",7,109,-102
"1043","2363矽統","110/07/28","台新-左楠",94,15,79
"1044","2363矽統","110/07/28","康和-南崁",11,108,-97
"1045","2363矽統","110/07/28","新加坡商瑞銀",789,711,78
"1046","2363矽統","110/07/28","國票",25,121,-96
"1047","2363矽統","110/07/28","國票-九鼎",99,26,73
"1048","2363矽統","110/07/28","群益金鼎-敦南",11,107,-96
"1049","2363矽統","110/07/28","兆豐-埔墘",62,0,62
"1050","2363矽統","110/07/28","兆豐-寶成",2,79,-77
"1051","8112至上","110/07/28","摩根大通",630,183,447
"1052","8112至上","110/07/28","永豐金-永康",0,242,-242
"1053","8112至上","110/07/28","合庫證券",317,21,296
"1054","8112至上","110/07/28","高橋",3,222,-219
"1055","8112至上","110/07/28","新加坡商瑞銀",417,132,285
"1056","8112至上","110/07/28","玉山證券",2,206,-204
"1057","8112至上","110/07/28","台灣摩根士丹利",253,58,195
"1058","8112至上","110/07/28","新光",50,206,-156
"1059","8112至上","110/07/28","港商野村",350,164,186
"1060","8112至上","110/07/28","永豐金-苓雅",2,102,-100
"1061","8112至上","110/07/28","美商高盛",184,7,177
"1062","8112至上","110/07/28","凱基-永和",0,80,-80
"1063","8112至上","110/07/28","美林",213,53,160
"1064","8112至上","110/07/28","華南永昌-新莊",60,134,-74
"1065","8112至上","110/07/28","花旗環球",86,16,70
"1066","8112至上","110/07/28","台新-松江",27,90,-63
"1067","8112至上","110/07/28","玉山-板橋",82,17,65
"1068","8112至上","110/07/28","宏遠證券",1,50,-49
"1069","8112至上","110/07/28","凱基-竹科",67,3,64
"1070","8112至上","110/07/28","元大-苑裡",23,72,-49
"1071","8112至上","110/07/28","元大-府城",56,0,56
"1072","8112至上","110/07/28","元大-基隆孝二",5,53,-48
"1073","8112至上","110/07/28","永豐金-內湖",37,0,37
"1074","8112至上","110/07/28","康和-仁愛",5,51,-46
"1075","8112至上","110/07/28","瑞士信貸",58,26,32
"1076","8112至上","110/07/28","台新證券",31,73,-42
"1077","8112至上","110/07/28","元大證券",60,29,31
"1078","8112至上","110/07/28","兆豐-公益",0,40,-40
"1079","8112至上","110/07/28","元富-新店",35,5,30
"1080","8112至上","110/07/28","中國信託-忠孝",1,37,-36
"1081","1570力肯","110/07/28","國泰-敦南",50,0,50
"1082","1570力肯","110/07/28","元大-高雄",0,42,-42
"1083","1570力肯","110/07/28","群益金鼎-高雄",31,0,31
"1084","1570力肯","110/07/28","國票-新莊",0,14,-14
"1085","1570力肯","110/07/28","元富-延平",15,0,15
"1086","1570力肯","110/07/28","凱基-站前",0,10,-10
"1087","1570力肯","110/07/28","(牛牛牛)亞-鑫豐",10,0,10
"1088","1570力肯","110/07/28","凱基-台北",0,10,-10
"1089","1570力肯","110/07/28","元富-緯城",6,0,6
"1090","1570力肯","110/07/28","元大-忠孝",0,10,-10
"1091","1570力肯","110/07/28","合庫-自強",5,0,5
"1092","1570力肯","110/07/28","台灣摩根士丹利",0,9,-9
"1093","1570力肯","110/07/28","臺銀-臺南",4,0,4
"1094","1570力肯","110/07/28","群益金鼎-板橋",0,8,-8
"1095","1570力肯","110/07/28","兆豐-台中港",3,0,3
"1096","1570力肯","110/07/28","永豐金-大園",0,7,-7
"1097","1570力肯","110/07/28","日盛-板橋",2,0,2
"1098","1570力肯","110/07/28","元大-台南",0,5,-5
"1099","1570力肯","110/07/28","統一-松江",2,0,2
"1100","1570力肯","110/07/28","合庫-台中",0,4,-4
"1101","1570力肯","110/07/28","台新-三民",2,0,2
"1102","1570力肯","110/07/28","富邦-板橋",0,3,-3
"1103","1570力肯","110/07/28","群益金鼎-土城",2,0,2
"1104","1570力肯","110/07/28","元大-板橋",0,3,-3
"1105","1570力肯","110/07/28","元大-和平",2,0,2
"1106","1570力肯","110/07/28","統一-桃園",0,2,-2
"1107","1570力肯","110/07/28","元大-土城永寧",2,0,2
"1108","1570力肯","110/07/28","凱基-三多",0,2,-2
"1109","1570力肯","110/07/28","大昌-樹林",1,0,1
"1110","1570力肯","110/07/28","華南永昌-高雄",0,2,-2
"1111","2929淘帝","110/07/28","日盛-八德",40,0,40
"1112","2929淘帝","110/07/28","凱基-林口",0,150,-150
"1113","2929淘帝","110/07/28","玉山-新竹",30,0,30
"1114","2929淘帝","110/07/28","日盛-台中",0,35,-35
"1115","2929淘帝","110/07/28","國泰-松江",33,3,30
"1116","2929淘帝","110/07/28","永豐金-永康",0,21,-21
"1117","2929淘帝","110/07/28","元大-民生",28,0,28
"1118","2929淘帝","110/07/28","新加坡商瑞銀",13,32,-19
"1119","2929淘帝","110/07/28","合庫-高雄",21,0,21
"1120","2929淘帝","110/07/28","國泰-敦南",2,20,-18
"1121","2929淘帝","110/07/28","華南永昌",20,0,20
"1122","2929淘帝","110/07/28","臺銀",2,17,-15
"1123","2929淘帝","110/07/28","台新證券",12,0,12
"1124","2929淘帝","110/07/28","群益金鼎-敦南",0,13,-13
"1125","2929淘帝","110/07/28","第一金-大稻埕",10,0,10
"1126","2929淘帝","110/07/28","富邦-建國",1,13,-12
"1127","2929淘帝","110/07/28","華南永昌-台中",10,0,10
"1128","2929淘帝","110/07/28","元富-城東",0,10,-10
"1129","2929淘帝","110/07/28","元大-士林",10,0,10
"1130","2929淘帝","110/07/28","兆豐-景美",0,8,-8
"1131","2929淘帝","110/07/28","元大-屏南",10,0,10
"1132","2929淘帝","110/07/28","美林",3,10,-7
"1133","2929淘帝","110/07/28","元大-員林",10,0,10
"1134","2929淘帝","110/07/28","元富-彰化",0,7,-7
"1135","2929淘帝","110/07/28","新光-桃園",9,0,9
"1136","2929淘帝","110/07/28","港商法國興業",0,6,-6
"1137","2929淘帝","110/07/28","日盛-景美",7,0,7
"1138","2929淘帝","110/07/28","新光-高雄",0,6,-6
"1139","2929淘帝","110/07/28","玉山證券",7,0,7
"1140","2929淘帝","110/07/28","港商野村",3,8,-5
"1141","5410國眾","110/07/28","兆豐-城中",38,0,38
"1142","5410國眾","110/07/28","兆豐-南門",3,80,-77
"1143","5410國眾","110/07/28","大展",20,0,20
"1144","5410國眾","110/07/28","摩根大通",12,56,-44
"1145","5410國眾","110/07/28","新光-桃園",20,0,20
"1146","5410國眾","110/07/28","凱基-台北",0,28,-28
"1147","5410國眾","110/07/28","凱基-竹北",20,0,20
"1148","5410國眾","110/07/28","亞東-板橋",0,20,-20
"1149","5410國眾","110/07/28","元大-新莊",17,0,17
"1150","5410國眾","110/07/28","統一-新台中",0,20,-20
"1151","5410國眾","110/07/28","新光",20,8,12
"1152","5410國眾","110/07/28","瑞士信貸",0,16,-16
"1153","5410國眾","110/07/28","國泰-敦南",11,0,11
"1154","5410國眾","110/07/28","新加坡商瑞銀",0,15,-15
"1155","5410國眾","110/07/28","日盛-內湖",10,0,10
"1156","5410國眾","110/07/28","統一-金門",0,15,-15
"1157","5410國眾","110/07/28","元富-新竹",10,0,10
"1158","5410國眾","110/07/28","元大-北投",0,12,-12
"1159","5410國眾","110/07/28","群益金鼎-永和",10,0,10
"1160","5410國眾","110/07/28","新百王",0,10,-10
"1161","5410國眾","110/07/28","華南永昌-中正",10,0,10
"1162","5410國眾","110/07/28","元大-館前",0,10,-10
"1163","5410國眾","110/07/28","元大-旗山",10,0,10
"1164","5410國眾","110/07/28","元富-安南",0,9,-9
"1165","5410國眾","110/07/28","元大-大天母",10,0,10
"1166","5410國眾","110/07/28","元大-龍潭",1,10,-9
"1167","5410國眾","110/07/28","大昌",9,0,9
"1168","5410國眾","110/07/28","港商野村",1,7,-6
"1169","5410國眾","110/07/28","臺銀-鳳山",8,0,8
"1170","5410國眾","110/07/28","元大-東泰",0,6,-6
"1171","2841台開","110/07/28","台新-台中",36,0,36
"1172","2841台開","110/07/28","元大-大雅",0,90,-90
"1173","2841台開","110/07/28","群益金鼎-大甲",24,0,24
"1174","2841台開","110/07/28","凱基-台北",0,73,-73
"1175","2841台開","110/07/28","永豐金-敦南",29,8,21
"1176","2841台開","110/07/28","港商野村",0,27,-27
"1177","2841台開","110/07/28","第一金-台中",20,0,20
"1178","2841台開","110/07/28","大慶-富順",0,20,-20
"1179","2841台開","110/07/28","元富-烏日",20,0,20
"1180","2841台開","110/07/28","豐農",0,17,-17
"1181","2841台開","110/07/28","元大-歸仁",20,0,20
"1182","2841台開","110/07/28","元大-大里德芳",0,15,-15
"1183","2841台開","110/07/28","永豐金-豐原",20,0,20
"1184","2841台開","110/07/28","日盛-大墩",0,10,-10
"1185","2841台開","110/07/28","日盛-花蓮",15,0,15
"1186","2841台開","110/07/28","元大-博愛",0,10,-10
"1187","2841台開","110/07/28","大昌-安康",18,3,15
"1188","2841台開","110/07/28","元大-豐原站前",0,10,-10
"1189","2841台開","110/07/28","陽信-石牌",13,0,13
"1190","2841台開","110/07/28","台新證券",6,13,-7
"1191","2841台開","110/07/28","台灣摩根士丹利",10,0,10
"1192","2841台開","110/07/28","台中銀",0,5,-5
"1193","2841台開","110/07/28","台新-高雄",10,0,10
"1194","2841台開","110/07/28","中國信託-中壢",0,5,-5
"1195","2841台開","110/07/28","國泰-忠孝",10,0,10
"1196","2841台開","110/07/28","元大-大同",0,5,-5
"1197","2841台開","110/07/28","元大-竹南",10,0,10
"1198","2841台開","110/07/28","元大-大益",0,4,-4
"1199","2841台開","110/07/28","元大-屏南",9,0,9
"1200","2841台開","110/07/28","元富-松德",0,3,-3
"1201","6207雷科","110/07/28","新加坡商瑞銀",153,44,109
"1202","6207雷科","110/07/28","康和-延平",0,48,-48
"1203","6207雷科","110/07/28","摩根大通",219,131,88
"1204","6207雷科","110/07/28","元富-大昌",0,33,-33
"1205","6207雷科","110/07/28","康和-台中",70,0,70
"1206","6207雷科","110/07/28","聯邦商銀",0,30,-30
"1207","6207雷科","110/07/28","凱基-台北",112,49,63
"1208","6207雷科","110/07/28","兆豐-三民",1,30,-29
"1209","6207雷科","110/07/28","凱基-復興",63,3,60
"1210","6207雷科","110/07/28","元大-龍潭",0,25,-25
"1211","6207雷科","110/07/28","群益金鼎-三民",59,8,51
"1212","6207雷科","110/07/28","宏遠證券",0,23,-23
"1213","6207雷科","110/07/28","永豐金-羅東",50,0,50
"1214","6207雷科","110/07/28","大昌-桃園",15,36,-21
"1215","6207雷科","110/07/28","美林",46,3,43
"1216","6207雷科","110/07/28","國泰-桃園",0,21,-21
"1217","6207雷科","110/07/28","群益金鼎-敦南",51,16,35
"1218","6207雷科","110/07/28","凱基-中壢",0,21,-21
"1219","6207雷科","110/07/28","日盛-忠孝",31,0,31
"1220","6207雷科","110/07/28","富邦-台北",4,24,-20
"1221","6207雷科","110/07/28","港商野村",32,8,24
"1222","6207雷科","110/07/28","臺銀-臺南",0,19,-19
"1223","6207雷科","110/07/28","群益金鼎-東門",22,0,22
"1224","6207雷科","110/07/28","新光",5,24,-19
"1225","6207雷科","110/07/28","統一-高雄",41,20,21
"1226","6207雷科","110/07/28","群益金鼎-大甲",1,20,-19
"1227","6207雷科","110/07/28","群益金鼎-延平",21,0,21
"1228","6207雷科","110/07/28","元大-中壢",10,28,-18
"1229","6207雷科","110/07/28","彰銀-台中",20,0,20
"1230","6207雷科","110/07/28","永豐金-北高雄",3,20,-17
"1231","3679新至陞","110/07/28","華南永昌-淡水",10,0,10
"1232","3679新至陞","110/07/28","瑞士信貸",0,25,-25
"1233","3679新至陞","110/07/28","富邦-嘉義",10,0,10
"1234","3679新至陞","110/07/28","凱基-台北",6,14,-8
"1235","3679新至陞","110/07/28","台中銀-員林",11,2,9
"1236","3679新至陞","110/07/28","美林",5,12,-7
"1237","3679新至陞","110/07/28","大昌-樹林",7,0,7
"1238","3679新至陞","110/07/28","摩根大通",5,11,-6
"1239","3679新至陞","110/07/28","康和-澎湖",5,0,5
"1240","3679新至陞","110/07/28","兆豐-新莊",0,5,-5
"1241","3679新至陞","110/07/28","富邦-台北",5,0,5
"1242","3679新至陞","110/07/28","群益金鼎-新莊",0,5,-5
"1243","3679新至陞","110/07/28","元大-成功",5,0,5
"1244","3679新至陞","110/07/28","台灣摩根士丹利",0,4,-4
"1245","3679新至陞","110/07/28","新加坡商瑞銀",3,0,3
"1246","3679新至陞","110/07/28","日盛-新竹",0,3,-3
"1247","3679新至陞","110/07/28","中國信託-新竹",3,0,3
"1248","3679新至陞","110/07/28","群益金鼎-東門",0,3,-3
"1249","3679新至陞","110/07/28","元大-新莊",3,0,3
"1250","3679新至陞","110/07/28","元大證券",0,3,-3
"1251","3679新至陞","110/07/28","宏遠-光隆",2,0,2
"1252","3679新至陞","110/07/28","元大-忠孝",0,3,-3
"1253","3679新至陞","110/07/28","大慶-蘆洲",2,0,2
"1254","3679新至陞","110/07/28","合庫-西台中",0,2,-2
"1255","3679新至陞","110/07/28","台新-左楠",2,0,2
"1256","3679新至陞","110/07/28","日盛-板橋",0,2,-2
"1257","3679新至陞","110/07/28","群益金鼎-三重",2,0,2
"1258","3679新至陞","110/07/28","國票-桃園",0,2,-2
"1259","3679新至陞","110/07/28","華南永昌-高雄",2,0,2
"1260","3679新至陞","110/07/28","台新-台南",0,2,-2
"1261","2727王品","110/07/28","凱基-台北",139,50,89
"1262","2727王品","110/07/28","新光-台中",9,68,-59
"1263","2727王品","110/07/28","美林",77,10,67
"1264","2727王品","110/07/28","瑞士信貸",16,54,-38
"1265","2727王品","110/07/28","港商野村",118,64,54
"1266","2727王品","110/07/28","華南永昌",4,41,-37
"1267","2727王品","110/07/28","國泰-敦南",51,30,21
"1268","2727王品","110/07/28","美商高盛",2,30,-28
"1269","2727王品","110/07/28","新加坡商瑞銀",58,38,20
"1270","2727王品","110/07/28","富邦-板橋",17,38,-21
"1271","2727王品","110/07/28","永豐金-中盛",24,4,20
"1272","2727王品","110/07/28","富邦-竹北",0,20,-20
"1273","2727王品","110/07/28","元大-南崁",20,2,18
"1274","2727王品","110/07/28","元大-小港",1,21,-20
"1275","2727王品","110/07/28","摩根大通",48,32,16
"1276","2727王品","110/07/28","凱基",0,18,-18
"1277","2727王品","110/07/28","臺銀-高雄",14,0,14
"1278","2727王品","110/07/28","統一",15,31,-16
"1279","2727王品","110/07/28","永豐金-桃盛",19,5,14
"1280","2727王品","110/07/28","國泰-台中",12,28,-16
"1281","2727王品","110/07/28","凱基-內湖",13,0,13
"1282","2727王品","110/07/28","元大-台中",7,22,-15
"1283","2727王品","110/07/28","永豐金-中正",15,2,13
"1284","2727王品","110/07/28","華南永昌-麻豆",0,14,-14
"1285","2727王品","110/07/28","富邦-建國",18,7,11
"1286","2727王品","110/07/28","永豐金-豐原",1,15,-14
"1287","2727王品","110/07/28","富邦-陽明",15,5,10
"1288","2727王品","110/07/28","國票-內壢",1,14,-13
"1289","2727王品","110/07/28","元大-南京",10,0,10
"1290","2727王品","110/07/28","永豐金證券",2,15,-13
"1291","1570力肯","110/07/28","國泰-敦南",50,0,50
"1292","1570力肯","110/07/28","元大-高雄",0,42,-42
"1293","1570力肯","110/07/28","群益金鼎-高雄",31,0,31
"1294","1570力肯","110/07/28","國票-新莊",0,14,-14
"1295","1570力肯","110/07/28","元富-延平",15,0,15
"1296","1570力肯","110/07/28","凱基-站前",0,10,-10
"1297","1570力肯","110/07/28","(牛牛牛)亞-鑫豐",10,0,10
"1298","1570力肯","110/07/28","凱基-台北",0,10,-10
"1299","1570力肯","110/07/28","元富-緯城",6,0,6
"1300","1570力肯","110/07/28","元大-忠孝",0,10,-10
"1301","1570力肯","110/07/28","合庫-自強",5,0,5
"1302","1570力肯","110/07/28","台灣摩根士丹利",0,9,-9
"1303","1570力肯","110/07/28","臺銀-臺南",4,0,4
"1304","1570力肯","110/07/28","群益金鼎-板橋",0,8,-8
"1305","1570力肯","110/07/28","兆豐-台中港",3,0,3
"1306","1570力肯","110/07/28","永豐金-大園",0,7,-7
"1307","1570力肯","110/07/28","日盛-板橋",2,0,2
"1308","1570力肯","110/07/28","元大-台南",0,5,-5
"1309","1570力肯","110/07/28","統一-松江",2,0,2
"1310","1570力肯","110/07/28","合庫-台中",0,4,-4
"1311","1570力肯","110/07/28","台新-三民",2,0,2
"1312","1570力肯","110/07/28","富邦-板橋",0,3,-3
"1313","1570力肯","110/07/28","群益金鼎-土城",2,0,2
"1314","1570力肯","110/07/28","元大-板橋",0,3,-3
"1315","1570力肯","110/07/28","元大-和平",2,0,2
"1316","1570力肯","110/07/28","統一-桃園",0,2,-2
"1317","1570力肯","110/07/28","元大-土城永寧",2,0,2
"1318","1570力肯","110/07/28","凱基-三多",0,2,-2
"1319","1570力肯","110/07/28","大昌-樹林",1,0,1
"1320","1570力肯","110/07/28","華南永昌-高雄",0,2,-2
"1321","6180橘子","110/07/28","凱基-台北",152,85,67
"1322","6180橘子","110/07/28","摩根大通",20,92,-72
"1323","6180橘子","110/07/28","新光",57,18,39
"1324","6180橘子","110/07/28","大慶-台中",0,33,-33
"1325","6180橘子","110/07/28","美商高盛",49,12,37
"1326","6180橘子","110/07/28","兆豐證券",0,25,-25
"1327","6180橘子","110/07/28","第一金-安和",20,0,20
"1328","6180橘子","110/07/28","元大-上新莊",0,22,-22
"1329","6180橘子","110/07/28","元富-桃園",20,0,20
"1330","6180橘子","110/07/28","新加坡商瑞銀",23,44,-21
"1331","6180橘子","110/07/28","第一金-員林",19,0,19
"1332","6180橘子","110/07/28","富邦-內湖",0,21,-21
"1333","6180橘子","110/07/28","富邦-嘉義",22,4,18
"1334","6180橘子","110/07/28","第一金-新興",0,20,-20
"1335","6180橘子","110/07/28","統一-嘉義",16,0,16
"1336","6180橘子","110/07/28","臺銀-臺南",5,22,-17
"1337","6180橘子","110/07/28","國票-九鼎",15,0,15
"1338","6180橘子","110/07/28","第一金-忠孝",0,10,-10
"1339","6180橘子","110/07/28","華南永昌-朴子",14,0,14
"1340","6180橘子","110/07/28","元富-屏東",0,10,-10
"1341","6180橘子","110/07/28","群益金鼎-台南",13,0,13
"1342","6180橘子","110/07/28","凱基-八德",1,11,-10
"1343","6180橘子","110/07/28","富邦-建國",13,1,12
"1344","6180橘子","110/07/28","元大-和平",1,11,-10
"1345","6180橘子","110/07/28","富邦-板橋",16,5,11
"1346","6180橘子","110/07/28","元大-台中中港",0,10,-10
"1347","6180橘子","110/07/28","元富-新店",10,0,10
"1348","6180橘子","110/07/28","元大-南屯",0,9,-9
"1349","6180橘子","110/07/28","元大-台南",10,0,10
"1350","6180橘子","110/07/28","永豐金-屏東",0,9,-9
"1351","2390云辰","110/07/28","摩根大通",1589,780,809
"1352","2390云辰","110/07/28","華南永昌-鳳山",34,290,-256
"1353","2390云辰","110/07/28","凱基-台北",457,300,157
"1354","2390云辰","110/07/28","凱基-基隆",0,224,-224
"1355","2390云辰","110/07/28","美林",330,206,124
"1356","2390云辰","110/07/28","元富-高雄",56,177,-121
"1357","2390云辰","110/07/28","元富-同大",159,35,124
"1358","2390云辰","110/07/28","元富-中港",1,100,-99
"1359","2390云辰","110/07/28","台灣摩根士丹利",193,71,122
"1360","2390云辰","110/07/28","兆豐-公益",4,100,-96
"1361","2390云辰","110/07/28","元大-前金",150,49,101
"1362","2390云辰","110/07/28","統一-新台中",180,274,-94
"1363","2390云辰","110/07/28","永豐金-鳳山",110,18,92
"1364","2390云辰","110/07/28","日盛-新莊",4,76,-72
"1365","2390云辰","110/07/28","元大-林園",99,11,88
"1366","2390云辰","110/07/28","永豐金-新店",0,57,-57
"1367","2390云辰","110/07/28","元大-信義",121,35,86
"1368","2390云辰","110/07/28","華南永昌-內壢",0,56,-56
"1369","2390云辰","110/07/28","美商高盛",206,123,83
"1370","2390云辰","110/07/28","第一金-豐原",9,63,-54
"1371","2390云辰","110/07/28","統一-城中",101,37,64
"1372","2390云辰","110/07/28","華南永昌-中正",13,67,-54
"1373","2390云辰","110/07/28","元大-竹山",75,20,55
"1374","2390云辰","110/07/28","元大-大益",7,59,-52
"1375","2390云辰","110/07/28","豐農",79,25,54
"1376","2390云辰","110/07/28","大慶",0,50,-50
"1377","2390云辰","110/07/28","新加坡商瑞銀",68,15,53
"1378","2390云辰","110/07/28","凱基-豐中",3,49,-46
"1379","2390云辰","110/07/28","統一-屏東",54,5,49
"1380","2390云辰","110/07/28","元大-彰化民生",7,51,-44
"1381","1471首利","110/07/27","永全-八德",50,0,50
"1382","1471首利","110/07/27","國票-九鼎",0,306,-306
"1383","1471首利","110/07/27","中國信託-松江",48,0,48
"1384","1471首利","110/07/27","兆豐-天母",1,115,-114
"1385","1471首利","110/07/27","富邦-嘉義",40,0,40
"1386","1471首利","110/07/27","美林",0,42,-42
"1387","1471首利","110/07/27","富邦-台南",33,0,33
"1388","1471首利","110/07/27","摩根大通",45,75,-30
"1389","1471首利","110/07/27","(牛牛牛)亞-鑫豐",32,0,32
"1390","1471首利","110/07/27","凱基-八德",0,30,-30
"1391","1471首利","110/07/27","台灣企銀-太平",25,0,25
"1392","1471首利","110/07/27","中國信託-高雄",0,25,-25
"1393","1471首利","110/07/27","群益金鼎-台中",23,0,23
"1394","1471首利","110/07/27","統一-新台中",0,24,-24
"1395","1471首利","110/07/27","元富-潮州",20,0,20
"1396","1471首利","110/07/27","聯邦-高雄",0,21,-21
"1397","1471首利","110/07/27","凱基-信義",20,0,20
"1398","1471首利","110/07/27","德信-中正",0,20,-20
"1399","1471首利","110/07/27","富邦-基隆",26,8,18
"1400","1471首利","110/07/27","元大-福營",3,20,-17
"1401","1471首利","110/07/27","日盛-高雄",17,0,17
"1402","1471首利","110/07/27","凱基-宜蘭",0,16,-16
"1403","1471首利","110/07/27","國泰-敦南",16,2,14
"1404","1471首利","110/07/27","凱基-天母",0,15,-15
"1405","1471首利","110/07/27","元大-大甲",13,0,13
"1406","1471首利","110/07/27","第一金-高雄",6,20,-14
"1407","1471首利","110/07/27","合庫-鳳山",12,0,12
"1408","1471首利","110/07/27","元大-中壢",0,13,-13
"1409","1471首利","110/07/27","日盛-大墩",12,0,12
"1410","1471首利","110/07/27","元富-安南",0,12,-12
"1411","2883開發金","110/07/27","元富",1762,67,1695
"1412","2883開發金","110/07/27","美林",0,11931,-11931
"1413","2883開發金","110/07/27","福邦證券",1450,0,1450
"1414","2883開發金","110/07/27","新加坡商瑞銀",1513,8370,-6857
"1415","2883開發金","110/07/27","凱基",1422,0,1422
"1416","2883開發金","110/07/27","凱基-台北",1081,5265,-4184
"1417","2883開發金","110/07/27","瑞士信貸",2044,731,1313
"1418","2883開發金","110/07/27","摩根大通",612,3392,-2780
"1419","2883開發金","110/07/27","台灣摩根士丹利",2112,921,1191
"1420","2883開發金","110/07/27","統一-仁愛",31,2002,-1971
"1421","2883開發金","110/07/27","新光",1474,461,1013
"1422","2883開發金","110/07/27","兆豐證券",192,1910,-1718
"1423","2883開發金","110/07/27","國票-長城",1003,20,983
"1424","2883開發金","110/07/27","(牛牛牛)亞-鑫豐",276,1815,-1539
"1425","2883開發金","110/07/27","台新證券",1207,362,845
"1426","2883開發金","110/07/27","永豐金-板橋",197,1610,-1413
"1427","2883開發金","110/07/27","港商野村",2209,1498,711
"1428","2883開發金","110/07/27","美商高盛",16,1337,-1321
"1429","2883開發金","110/07/27","永豐金-彰化",680,26,654
"1430","2883開發金","110/07/27","兆豐-北高雄",60,1360,-1300
"1431","2883開發金","110/07/27","台新-高雄",918,265,653
"1432","2883開發金","110/07/27","兆豐-景美",26,1070,-1044
"1433","2883開發金","110/07/27","國泰-敦南",1273,634,639
"1434","2883開發金","110/07/27","亞東-新竹",7,1001,-994
"1435","2883開發金","110/07/27","元大證券",876,246,630
"1436","2883開發金","110/07/27","富邦-羅東",201,1098,-897
"1437","2883開發金","110/07/27","致和證券",684,92,592
"1438","2883開發金","110/07/27","統一",159,811,-652
"1439","2883開發金","110/07/27","元大-民生",550,2,548
"1440","2883開發金","110/07/27","香港上海匯豐",0,584,-584
"1441","6205詮欣","110/07/27","土銀-和平",20,0,20
"1442","6205詮欣","110/07/27","摩根大通",3,22,-19
"1443","6205詮欣","110/07/27","臺銀-民權",20,6,14
"1444","6205詮欣","110/07/27","瑞士信貸",5,16,-11
"1445","6205詮欣","110/07/27","台新證券",5,0,5
"1446","6205詮欣","110/07/27","臺銀-鳳山",0,6,-6
"1447","6205詮欣","110/07/27","華南永昌-小港",5,0,5
"1448","6205詮欣","110/07/27","臺銀-新竹",0,5,-5
"1449","6205詮欣","110/07/27","日盛-新莊",4,0,4
"1450","6205詮欣","110/07/27","國票-和平",0,4,-4
"1451","6205詮欣","110/07/27","元富-三重",4,0,4
"1452","6205詮欣","110/07/27","凱基-東門",0,4,-4
"1453","6205詮欣","110/07/27","致和-佳里",4,1,3
"1454","6205詮欣","110/07/27","富邦-花蓮",0,3,-3
"1455","6205詮欣","110/07/27","華南永昌-岡山",3,0,3
"1456","6205詮欣","110/07/27","元大-北投",0,3,-3
"1457","6205詮欣","110/07/27","元大-成功",3,0,3
"1458","6205詮欣","110/07/27","元大-民生",2,5,-3
"1459","6205詮欣","110/07/27","土銀-嘉義",2,0,2
"1460","6205詮欣","110/07/27","日盛-三重",0,2,-2
"1461","6205詮欣","110/07/27","第一金-光復",2,0,2
"1462","6205詮欣","110/07/27","日盛-北高雄",0,2,-2
"1463","6205詮欣","110/07/27","統一-屏東",2,0,2
"1464","6205詮欣","110/07/27","港商野村",0,2,-2
"1465","6205詮欣","110/07/27","元富-新莊",2,0,2
"1466","6205詮欣","110/07/27","統一-彰化",0,2,-2
"1467","6205詮欣","110/07/27","兆豐-竹北",2,0,2
"1468","6205詮欣","110/07/27","永全",0,2,-2
"1469","6205詮欣","110/07/27","新光",2,0,2
"1470","6205詮欣","110/07/27","兆豐-西螺",0,2,-2
"1471","1540喬福","110/07/27","富邦-員林",10,0,10
"1472","1540喬福","110/07/27","合庫-台中",0,26,-26
"1473","1540喬福","110/07/27","元大-中壢",10,0,10
"1474","1540喬福","110/07/27","統一-新台中",0,25,-25
"1475","1540喬福","110/07/27","凱基-台中",8,0,8
"1476","1540喬福","110/07/27","元大-斗六",0,10,-10
"1477","1540喬福","110/07/27","大慶-中壢",5,0,5
"1478","1540喬福","110/07/27","凱基-中港",0,9,-9
"1479","1540喬福","110/07/27","兆豐-北高雄",5,0,5
"1480","1540喬福","110/07/27","國票-中正",0,8,-8
"1481","1540喬福","110/07/27","兆豐-三民",5,0,5
"1482","1540喬福","110/07/27","臺銀-臺中",0,5,-5
"1483","1540喬福","110/07/27","台新-台中",5,0,5
"1484","1540喬福","110/07/27","元富-中原",0,5,-5
"1485","1540喬福","110/07/27","國票-九鼎",4,0,4
"1486","1540喬福","110/07/27","新光-桃園",0,5,-5
"1487","1540喬福","110/07/27","富邦-高雄",5,1,4
"1488","1540喬福","110/07/27","大昌-新竹",0,4,-4
"1489","1540喬福","110/07/27","永豐金-羅東",4,0,4
"1490","1540喬福","110/07/27","元大-員林中山",0,4,-4
"1491","1540喬福","110/07/27","台新證券",3,0,3
"1492","1540喬福","110/07/27","群益金鼎-瑞豐",0,3,-3
"1493","1540喬福","110/07/27","華南永昌-台中",3,0,3
"1494","1540喬福","110/07/27","凱基-台北",0,3,-3
"1495","1540喬福","110/07/27","富邦-台東",3,0,3
"1496","1540喬福","110/07/27","富邦-建國",0,3,-3
"1497","1540喬福","110/07/27","元大-台中中港",3,0,3
"1498","1540喬福","110/07/27","國票-北投",0,2,-2
"1499","1540喬福","110/07/27","亞東",2,0,2
"1500","1540喬福","110/07/27","元大-鳳山",0,2,-2
"1501","2888新光金","110/07/27","台灣摩根士丹利",11737,746,10991
"1502","2888新光金","110/07/27","玉山-城中",112,6002,-5890
"1503","2888新光金","110/07/27","美林",3692,417,3275
"1504","2888新光金","110/07/27","新加坡商瑞銀",120,5935,-5815
"1505","2888新光金","110/07/27","凱基-台北",4378,2713,1665
"1506","2888新光金","110/07/27","摩根大通",1586,7187,-5601
"1507","2888新光金","110/07/27","凱基-台南",1551,3,1548
"1508","2888新光金","110/07/27","富邦-建國",298,5641,-5343
"1509","2888新光金","110/07/27","台新證券",1494,124,1370
"1510","2888新光金","110/07/27","第一金-高雄",81,5014,-4933
"1511","2888新光金","110/07/27","新光",2434,1212,1222
"1512","2888新光金","110/07/27","瑞士信貸",191,4524,-4333
"1513","2888新光金","110/07/27","元大-四維",1246,25,1221
"1514","2888新光金","110/07/27","兆豐-鹿港",45,2632,-2587
"1515","2888新光金","110/07/27","富隆-長安",1070,0,1070
"1516","2888新光金","110/07/27","國票-彰化",3,1803,-1800
"1517","2888新光金","110/07/27","永豐金-萬盛",1052,0,1052
"1518","2888新光金","110/07/27","港商野村",0,1434,-1434
"1519","2888新光金","110/07/27","法銀巴黎",1116,120,996
"1520","2888新光金","110/07/27","統一-高雄",173,1511,-1338
"1521","2888新光金","110/07/27","凱基-竹科",853,4,849
"1522","2888新光金","110/07/27","群益金鼎-古亭",40,1202,-1162
"1523","2888新光金","110/07/27","元大-斗信",874,50,824
"1524","2888新光金","110/07/27","日盛-樹林",34,1034,-1000
"1525","2888新光金","110/07/27","日盛-景美",811,119,692
"1526","2888新光金","110/07/27","統一-土城",18,1000,-982
"1527","2888新光金","110/07/27","元富-世貿",568,2,566
"1528","2888新光金","110/07/27","元大-鹿港",125,1057,-932
"1529","2888新光金","110/07/27","日盛-雙和",567,2,565
"1530","2888新光金","110/07/27","新光-桃園",91,993,-902
"1531","1340勝悅","110/07/27","亞東-台中",15,0,15
"1532","1340勝悅","110/07/27","凱基-岡山",0,25,-25
"1533","1340勝悅","110/07/27","元大-路竹",15,0,15
"1534","1340勝悅","110/07/27","合庫-嘉義",0,14,-14
"1535","1340勝悅","110/07/27","臺銀-臺中",7,0,7
"1536","1340勝悅","110/07/27","元大-北港",0,14,-14
"1537","1340勝悅","110/07/27","台新-台中",7,0,7
"1538","1340勝悅","110/07/27","凱基-台北",0,12,-12
"1539","1340勝悅","110/07/27","元大-屏南",6,0,6
"1540","1340勝悅","110/07/27","兆豐-三民",0,7,-7
"1541","1340勝悅","110/07/27","臺灣企銀-埔墘",5,0,5
"1542","1340勝悅","110/07/27","華南永昌-台中",1,7,-6
"1543","1340勝悅","110/07/27","日盛-板橋",5,0,5
"1544","1340勝悅","110/07/27","日盛-信義",0,5,-5
"1545","1340勝悅","110/07/27","日盛-新莊",5,0,5
"1546","1340勝悅","110/07/27","德信-和平",0,5,-5
"1547","1340勝悅","110/07/27","臺銀-鳳山",4,0,4
"1548","1340勝悅","110/07/27","台新證券",0,5,-5
"1549","1340勝悅","110/07/27","玉山-城中",4,0,4
"1550","1340勝悅","110/07/27","新光-高雄",0,4,-4
"1551","1340勝悅","110/07/27","美商高盛",3,0,3
"1552","1340勝悅","110/07/27","瑞士信貸",0,2,-2
"1553","1340勝悅","110/07/27","(牛牛牛)亞-鑫豐",3,0,3
"1554","1340勝悅","110/07/27","港商野村",0,2,-2
"1555","1340勝悅","110/07/27","國票-長城",2,0,2
"1556","1340勝悅","110/07/27","台新-高雄",1,3,-2
"1557","1340勝悅","110/07/27","新光",2,0,2
"1558","1340勝悅","110/07/27","玉山證券",0,2,-2
"1559","1340勝悅","110/07/27","群益金鼎-館前",2,0,2
"1560","1340勝悅","110/07/27","玉山-南京東路",0,2,-2
"1561","6246臺龍","110/07/27","永豐金-桃園",135,0,135
"1562","6246臺龍","110/07/27","元大-木柵",0,59,-59
"1563","6246臺龍","110/07/27","港商野村",111,30,81
"1564","6246臺龍","110/07/27","日盛-景美",0,52,-52
"1565","6246臺龍","110/07/27","元大-西螺",31,0,31
"1566","6246臺龍","110/07/27","華南永昌-彰化",0,46,-46
"1567","6246臺龍","110/07/27","群益金鼎-鳳山",27,0,27
"1568","6246臺龍","110/07/27","兆豐-松德",0,43,-43
"1569","6246臺龍","110/07/27","永豐金-虎尾",27,0,27
"1570","6246臺龍","110/07/27","華南永昌-公誠",5,35,-30
"1571","6246臺龍","110/07/27","玉山-台南",28,2,26
"1572","6246臺龍","110/07/27","凱基-幸福",0,28,-28
"1573","6246臺龍","110/07/27","元大-西屯",25,0,25
"1574","6246臺龍","110/07/27","元富-安南",0,22,-22
"1575","6246臺龍","110/07/27","國泰-忠孝",23,0,23
"1576","6246臺龍","110/07/27","日盛-文化",0,20,-20
"1577","6246臺龍","110/07/27","元大-大里",21,0,21
"1578","6246臺龍","110/07/27","兆豐-寶成",0,20,-20
"1579","6246臺龍","110/07/27","兆豐-竹北",20,0,20
"1580","6246臺龍","110/07/27","華南永昌-虎尾",0,20,-20
"1581","6246臺龍","110/07/27","元大-員林",20,0,20
"1582","6246臺龍","110/07/27","永豐金-埔里",0,19,-19
"1583","6246臺龍","110/07/27","永豐金-敦南",20,0,20
"1584","6246臺龍","110/07/27","兆豐-新營",2,20,-18
"1585","6246臺龍","110/07/27","永豐金-羅東",23,5,18
"1586","6246臺龍","110/07/27","新光-台中",3,20,-17
"1587","6246臺龍","110/07/27","永豐金-桃盛",18,0,18
"1588","6246臺龍","110/07/27","凱基-市政",0,17,-17
"1589","6246臺龍","110/07/27","統一",16,0,16
"1590","6246臺龍","110/07/27","元大-蘆洲",0,16,-16
"1591","00715L期街口布蘭特正2","110/07/27","元大證券",10436,28,10408
"1592","00715L期街口布蘭特正2","110/07/27","元大-萬華",0,751,-751
"1593","00715L期街口布蘭特正2","110/07/27","凱基-台北",4269,129,4140
"1594","00715L期街口布蘭特正2","110/07/27","元大-大里德芳",0,734,-734
"1595","00715L期街口布蘭特正2","110/07/27","群益金鼎",3798,0,3798
"1596","00715L期街口布蘭特正2","110/07/27","新光",380,1105,-725
"1597","00715L期街口布蘭特正2","110/07/27","永豐金證券",2610,22,2588
"1598","00715L期街口布蘭特正2","110/07/27","(牛牛牛)亞-網路",10,697,-687
"1599","00715L期街口布蘭特正2","110/07/27","國票",2605,21,2584
"1600","00715L期街口布蘭特正2","110/07/27","日盛-新莊",5,550,-545
"1601","00715L期街口布蘭特正2","110/07/27","富邦證券",1522,0,1522
"1602","00715L期街口布蘭特正2","110/07/27","玉山-高雄",7,494,-487
"1603","00715L期街口布蘭特正2","110/07/27","合庫證券",1507,239,1268
"1604","00715L期街口布蘭特正2","110/07/27","華南永昌",1,471,-470
"1605","00715L期街口布蘭特正2","110/07/27","元富",1102,0,1102
"1606","00715L期街口布蘭特正2","110/07/27","華南永昌-竹北",0,469,-469
"1607","00715L期街口布蘭特正2","110/07/27","凱基",980,0,980
"1608","00715L期街口布蘭特正2","110/07/27","兆豐-嘉義",0,420,-420
"1609","00715L期街口布蘭特正2","110/07/27","國票-博愛",702,0,702
"1610","00715L期街口布蘭特正2","110/07/27","國票-九鼎",0,409,-409
"1611","00715L期街口布蘭特正2","110/07/27","統一",796,117,679
"1612","00715L期街口布蘭特正2","110/07/27","統一-高雄",0,405,-405
"1613","00715L期街口布蘭特正2","110/07/27","華南永昌-長虹",810,185,625
"1614","00715L期街口布蘭特正2","110/07/27","富邦-彰化",0,402,-402
"1615","00715L期街口布蘭特正2","110/07/27","港商野村",1076,494,582
"1616","00715L期街口布蘭特正2","110/07/27","元大-羅東",0,400,-400
"1617","00715L期街口布蘭特正2","110/07/27","永豐金-三重",500,16,484
"1618","00715L期街口布蘭特正2","110/07/27","富邦-高雄",0,398,-398
"1619","00715L期街口布蘭特正2","110/07/27","元大-敦化",420,0,420
"1620","00715L期街口布蘭特正2","110/07/27","新光-台中",17,391,-374
"1621","8941關中","110/07/27","富邦-仁愛",4,0,4
"1622","8941關中","110/07/27","光和-溪湖",0,2,-2
"1623","8941關中","110/07/27","日盛-新莊",1,0,1
"1624","8941關中","110/07/27","富邦-園區",0,2,-2
"1625","8941關中","110/07/27","台新-高雄",1,0,1
"1626","8941關中","110/07/27","合庫-高雄",0,1,-1
"1627","8941關中","110/07/27","元大-金華",1,0,1
"1628","8941關中","110/07/27","凱基-台北",0,1,-1
"1629","8941關中","110/07/27","臺銀-鳳山",0,0,0
"1630","8941關中","110/07/27","富邦-台東",0,1,-1
"1631","8941關中","110/07/27","日盛-花蓮",0,0,0
"1632","8941關中","110/07/27","臺銀-鳳山",0,0,0
"1633","8941關中","110/07/27","康和-板橋",0,0,0
"1634","8941關中","110/07/27","日盛-花蓮",0,0,0
"1635","8941關中","110/07/27","富邦-宜蘭",0,0,0
"1636","8941關中","110/07/27","康和-板橋",0,0,0
"1637","8941關中","110/07/27","元大-新竹經國",0,0,0
"1638","8941關中","110/07/27","富邦-宜蘭",0,0,0
"1639","8941關中","110/07/27","永豐金-萬盛",0,0,0
"1640","8941關中","110/07/27","元大-新竹經國",0,0,0
"1641","8941關中","110/07/27","永豐金-桃盛",0,0,0
"1642","8941關中","110/07/27","永豐金-萬盛",0,0,0
"1643","8941關中","110/07/27","",NA,NA,NA
"1644","8941關中","110/07/27","永豐金-桃盛",0,0,0
"1645","8941關中","110/07/27","",NA,NA,NA
"1646","8941關中","110/07/27","",NA,NA,NA
"1647","8941關中","110/07/27","",NA,NA,NA
"1648","8941關中","110/07/27","",NA,NA,NA
"1649","8941關中","110/07/27","",NA,NA,NA
"1650","8941關中","110/07/27","",NA,NA,NA
"1651","8936國統","110/07/27","日盛-景美",100,0,100
"1652","8936國統","110/07/27","摩根大通",115,220,-105
"1653","8936國統","110/07/27","大慶-蘆洲",90,0,90
"1654","8936國統","110/07/27","玉山-桃園",0,75,-75
"1655","8936國統","110/07/27","台新-建北",60,0,60
"1656","8936國統","110/07/27","凱基-台北",13,77,-64
"1657","8936國統","110/07/27","日盛-忠孝",40,1,39
"1658","8936國統","110/07/27","元富-大昌",2,50,-48
"1659","8936國統","110/07/27","新加坡商瑞銀",109,71,38
"1660","8936國統","110/07/27","華南永昌-台中",4,45,-41
"1661","8936國統","110/07/27","華南永昌",30,0,30
"1662","8936國統","110/07/27","新光-台中",26,66,-40
"1663","8936國統","110/07/27","兆豐-來福",29,0,29
"1664","8936國統","110/07/27","台灣摩根士丹利",20,54,-34
"1665","8936國統","110/07/27","元大-旗山",28,0,28
"1666","8936國統","110/07/27","元大-東蘆",0,34,-34
"1667","8936國統","110/07/27","元大-松江",27,0,27
"1668","8936國統","110/07/27","富邦-仁愛",1,34,-33
"1669","8936國統","110/07/27","新光",41,19,22
"1670","8936國統","110/07/27","凱基-板橋",0,31,-31
"1671","8936國統","110/07/27","元富-林園",20,0,20
"1672","8936國統","110/07/27","凱基-信義",0,30,-30
"1673","8936國統","110/07/27","玉山-高雄",20,0,20
"1674","8936國統","110/07/27","瑞士信貸",1,30,-29
"1675","8936國統","110/07/27","凱基-桃園",23,3,20
"1676","8936國統","110/07/27","元大-花蓮",2,24,-22
"1677","8936國統","110/07/27","永豐金-永康",20,0,20
"1678","8936國統","110/07/27","元富-緯城",0,20,-20
"1679","8936國統","110/07/27","日盛-屏東",23,4,19
"1680","8936國統","110/07/27","群益金鼎-宜蘭",0,20,-20
"1681","6226光鼎","110/07/27","第一金-忠孝",405,4,401
"1682","6226光鼎","110/07/27","華南永昌-台南",5,240,-235
"1683","6226光鼎","110/07/27","台新-台中",272,75,197
"1684","6226光鼎","110/07/27","大慶-泰山",0,201,-201
"1685","6226光鼎","110/07/27","凱基-和平",155,7,148
"1686","6226光鼎","110/07/27","富邦-員林",2,151,-149
"1687","6226光鼎","110/07/27","新加坡商瑞銀",133,0,133
"1688","6226光鼎","110/07/27","群益金鼎-東大",23,165,-142
"1689","6226光鼎","110/07/27","統一-敦南",126,3,123
"1690","6226光鼎","110/07/27","元大-景美",3,132,-129
"1691","6226光鼎","110/07/27","台灣摩根士丹利",129,8,121
"1692","6226光鼎","110/07/27","台新-高雄",84,186,-102
"1693","6226光鼎","110/07/27","統一-新竹",117,1,116
"1694","6226光鼎","110/07/27","合庫證券",27,121,-94
"1695","6226光鼎","110/07/27","日盛證券",122,13,109
"1696","6226光鼎","110/07/27","致和-佳里",5,81,-76
"1697","6226光鼎","110/07/27","元大-潮州",101,1,100
"1698","6226光鼎","110/07/27","永豐金-南投",3,77,-74
"1699","6226光鼎","110/07/27","國泰-敦南",232,145,87
"1700","6226光鼎","110/07/27","台新-新莊",1,57,-56
"1701","6226光鼎","110/07/27","摩根大通",86,0,86
"1702","6226光鼎","110/07/27","日盛-中壢",11,64,-53
"1703","6226光鼎","110/07/27","元富",80,0,80
"1704","6226光鼎","110/07/27","日進",11,63,-52
"1705","6226光鼎","110/07/27","華南永昌-嘉義",80,1,79
"1706","6226光鼎","110/07/27","高橋",13,64,-51
"1707","6226光鼎","110/07/27","元大-高雄",70,3,67
"1708","6226光鼎","110/07/27","元大-土城",1,52,-51
"1709","6226光鼎","110/07/27","華南永昌",82,21,61
"1710","6226光鼎","110/07/27","華南永昌-林口",11,60,-49
"1711","2363矽統","110/07/27","國泰-敦南",541,118,423
"1712","2363矽統","110/07/27","摩根大通",317,1405,-1088
"1713","2363矽統","110/07/27","台新證券",564,333,231
"1714","2363矽統","110/07/27","美林",210,1095,-885
"1715","2363矽統","110/07/27","元大-沙鹿",196,9,187
"1716","2363矽統","110/07/27","港商野村",275,1065,-790
"1717","2363矽統","110/07/27","新光",300,151,149
"1718","2363矽統","110/07/27","凱基-台北",518,1192,-674
"1719","2363矽統","110/07/27","華南永昌-台南",108,3,105
"1720","2363矽統","110/07/27","新加坡商瑞銀",213,703,-490
"1721","2363矽統","110/07/27","華南永昌-朴子",140,43,97
"1722","2363矽統","110/07/27","富邦-南屯",6,272,-266
"1723","2363矽統","110/07/27","華南永昌-公誠",109,13,96
"1724","2363矽統","110/07/27","美商高盛",31,233,-202
"1725","2363矽統","110/07/27","元富-松德",95,1,94
"1726","2363矽統","110/07/27","元大證券",38,235,-197
"1727","2363矽統","110/07/27","中國信託-永康",102,8,94
"1728","2363矽統","110/07/27","永豐金證券",15,201,-186
"1729","2363矽統","110/07/27","台新-三民",111,21,90
"1730","2363矽統","110/07/27","亞東",46,206,-160
"1731","2363矽統","110/07/27","凱基-中港",85,3,82
"1732","2363矽統","110/07/27","群益金鼎",21,169,-148
"1733","2363矽統","110/07/27","元富-烏日",87,6,81
"1734","2363矽統","110/07/27","第一金-嘉義",0,100,-100
"1735","2363矽統","110/07/27","富邦-台北",135,56,79
"1736","2363矽統","110/07/27","凱基-彰化",9,100,-91
"1737","2363矽統","110/07/27","元大-復北",81,12,69
"1738","2363矽統","110/07/27","元富-佳里",27,97,-70
"1739","2363矽統","110/07/27","中國信託-忠孝",94,26,68
"1740","2363矽統","110/07/27","合庫-桃園",8,76,-68
"1741","8112至上","110/07/27","凱基-竹科",300,10,290
"1742","8112至上","110/07/27","凱基-三重",1,501,-500
"1743","8112至上","110/07/27","台灣摩根士丹利",271,49,222
"1744","8112至上","110/07/27","美林",21,339,-318
"1745","8112至上","110/07/27","摩根大通",488,427,61
"1746","8112至上","110/07/27","凱基-台北",423,615,-192
"1747","8112至上","110/07/27","香港上海匯豐",61,0,61
"1748","8112至上","110/07/27","港商野村",83,183,-100
"1749","8112至上","110/07/27","日盛證券",62,4,58
"1750","8112至上","110/07/27","永豐金-台南",2,79,-77
"1751","8112至上","110/07/27","元大-基隆孝二",52,0,52
"1752","8112至上","110/07/27","福邦證券",0,71,-71
"1753","8112至上","110/07/27","永豐金-中正",59,7,52
"1754","8112至上","110/07/27","兆豐-天母",0,50,-50
"1755","8112至上","110/07/27","群益金鼎-高盛",47,0,47
"1756","8112至上","110/07/27","元富-林園",3,52,-49
"1757","8112至上","110/07/27","永豐金-內湖",47,0,47
"1758","8112至上","110/07/27","永豐金-苓雅",1,50,-49
"1759","8112至上","110/07/27","富邦-台北",45,5,40
"1760","8112至上","110/07/27","元大-新莊",9,53,-44
"1761","8112至上","110/07/27","台新證券",78,39,39
"1762","8112至上","110/07/27","第一金-路竹",20,57,-37
"1763","8112至上","110/07/27","新光-台中",44,7,37
"1764","8112至上","110/07/27","新光-桃園",2,36,-34
"1765","8112至上","110/07/27","元大-羅東",38,1,37
"1766","8112至上","110/07/27","元大-東港",0,27,-27
"1767","8112至上","110/07/27","新光",101,65,36
"1768","8112至上","110/07/27","國泰-松江",2,28,-26
"1769","8112至上","110/07/27","元大-新竹",63,28,35
"1770","8112至上","110/07/27","群益金鼎-潭子",2,28,-26
"1771","1570力肯","110/07/27","國票-北高雄",7,0,7
"1772","1570力肯","110/07/27","元大-高雄",0,16,-16
"1773","1570力肯","110/07/27","富邦-陽明",5,0,5
"1774","1570力肯","110/07/27","國票-新莊",0,5,-5
"1775","1570力肯","110/07/27","元大-民雄",3,0,3
"1776","1570力肯","110/07/27","凱基-台北",0,5,-5
"1777","1570力肯","110/07/27","凱基-大里",3,0,3
"1778","1570力肯","110/07/27","美林",0,2,-2
"1779","1570力肯","110/07/27","凱基-長庚",3,0,3
"1780","1570力肯","110/07/27","富邦-南屯",0,2,-2
"1781","1570力肯","110/07/27","元大-新莊",2,0,2
"1782","1570力肯","110/07/27","元大-南崁",0,2,-2
"1783","1570力肯","110/07/27","大昌-樹林",2,0,2
"1784","1570力肯","110/07/27","元大-板橋",0,2,-2
"1785","1570力肯","110/07/27","台新-台中",2,0,2
"1786","1570力肯","110/07/27","新光",0,1,-1
"1787","1570力肯","110/07/27","新光-新竹",2,0,2
"1788","1570力肯","110/07/27","國泰-板橋",0,1,-1
"1789","1570力肯","110/07/27","富邦-左營",2,0,2
"1790","1570力肯","110/07/27","凱基-鳳山",0,1,-1
"1791","1570力肯","110/07/27","群益金鼎-土城",1,0,1
"1792","1570力肯","110/07/27","(牛牛牛)亞-鑫豐",2,2,0
"1793","1570力肯","110/07/27","凱基-竹東",1,0,1
"1794","1570力肯","110/07/27","元大-新盛",1,1,0
"1795","1570力肯","110/07/27","日盛-員林",1,0,1
"1796","1570力肯","110/07/27","",NA,NA,NA
"1797","1570力肯","110/07/27","玉山-板橋",1,0,1
"1798","1570力肯","110/07/27","",NA,NA,NA
"1799","1570力肯","110/07/27","元富-同大",1,0,1
"1800","1570力肯","110/07/27","",NA,NA,NA
"1801","2929淘帝","110/07/27","元大-民生",28,0,28
"1802","2929淘帝","110/07/27","元大-鳳山",0,20,-20
"1803","2929淘帝","110/07/27","臺銀-民權",18,0,18
"1804","2929淘帝","110/07/27","港商野村",1,18,-17
"1805","2929淘帝","110/07/27","合庫-高雄",13,0,13
"1806","2929淘帝","110/07/27","玉山-板橋",0,15,-15
"1807","2929淘帝","110/07/27","永興-水湳",10,0,10
"1808","2929淘帝","110/07/27","美林",0,10,-10
"1809","2929淘帝","110/07/27","富邦-陽明",10,0,10
"1810","2929淘帝","110/07/27","凱基-八德",0,10,-10
"1811","2929淘帝","110/07/27","元大-中和",10,0,10
"1812","2929淘帝","110/07/27","永豐金證券",0,9,-9
"1813","2929淘帝","110/07/27","國泰-館前",6,0,6
"1814","2929淘帝","110/07/27","新加坡商瑞銀",10,18,-8
"1815","2929淘帝","110/07/27","富邦-內湖",6,0,6
"1816","2929淘帝","110/07/27","富邦-台北",0,8,-8
"1817","2929淘帝","110/07/27","合庫-台南",5,0,5
"1818","2929淘帝","110/07/27","宏遠-台中",0,7,-7
"1819","2929淘帝","110/07/27","凱基-東門",5,0,5
"1820","2929淘帝","110/07/27","元富-潮州",0,7,-7
"1821","2929淘帝","110/07/27","元大-大益",5,0,5
"1822","2929淘帝","110/07/27","群益金鼎-延平",0,6,-6
"1823","2929淘帝","110/07/27","元大-屏南",5,0,5
"1824","2929淘帝","110/07/27","元大-文心",0,6,-6
"1825","2929淘帝","110/07/27","永豐金-板盛",5,0,5
"1826","2929淘帝","110/07/27","永豐金-中壢",0,6,-6
"1827","2929淘帝","110/07/27","臺銀",4,0,4
"1828","2929淘帝","110/07/27","美商高盛",0,5,-5
"1829","2929淘帝","110/07/27","永豐金-市政",4,0,4
"1830","2929淘帝","110/07/27","兆豐-南門",0,5,-5
"1831","5410國眾","110/07/27","摩根大通",47,0,47
"1832","5410國眾","110/07/27","元富-嘉義",0,48,-48
"1833","5410國眾","110/07/27","兆豐-城中",43,0,43
"1834","5410國眾","110/07/27","統一-平鎮",0,20,-20
"1835","5410國眾","110/07/27","香港上海匯豐",36,0,36
"1836","5410國眾","110/07/27","元大-大益",0,18,-18
"1837","5410國眾","110/07/27","港商麥格理",26,0,26
"1838","5410國眾","110/07/27","凱基-台北",0,16,-16
"1839","5410國眾","110/07/27","元富-大昌",21,0,21
"1840","5410國眾","110/07/27","凱基-站前",0,15,-15
"1841","5410國眾","110/07/27","元富-四維",20,0,20
"1842","5410國眾","110/07/27","元大-南勢角",0,13,-13
"1843","5410國眾","110/07/27","新光-台中",20,0,20
"1844","5410國眾","110/07/27","日盛-忠孝",0,11,-11
"1845","5410國眾","110/07/27","統一-金門",15,0,15
"1846","5410國眾","110/07/27","玉山-板橋",0,11,-11
"1847","5410國眾","110/07/27","玉山-高雄",15,0,15
"1848","5410國眾","110/07/27","元大-崇德",0,11,-11
"1849","5410國眾","110/07/27","凱基-竹北",15,0,15
"1850","5410國眾","110/07/27","元大-大天母",0,11,-11
"1851","5410國眾","110/07/27","元大-新莊",14,1,13
"1852","5410國眾","110/07/27","元富-松德",0,10,-10
"1853","5410國眾","110/07/27","華南永昌-中正",14,4,10
"1854","5410國眾","110/07/27","豐農",0,10,-10
"1855","5410國眾","110/07/27","元大-屏南",10,0,10
"1856","5410國眾","110/07/27","新光-新竹",0,10,-10
"1857","5410國眾","110/07/27","元大-中和",10,0,10
"1858","5410國眾","110/07/27","凱基-虎尾",0,10,-10
"1859","5410國眾","110/07/27","台新證券",10,1,9
"1860","5410國眾","110/07/27","元大-善化",0,10,-10
"1861","2841台開","110/07/27","日盛證券",620,0,620
"1862","2841台開","110/07/27","玉山-新竹",0,312,-312
"1863","2841台開","110/07/27","永豐金-豐原",65,0,65
"1864","2841台開","110/07/27","港商野村",0,216,-216
"1865","2841台開","110/07/27","元大-南投",50,0,50
"1866","2841台開","110/07/27","永興-水湳",0,90,-90
"1867","2841台開","110/07/27","台灣摩根士丹利",40,0,40
"1868","2841台開","110/07/27","凱基-興隆",0,64,-64
"1869","2841台開","110/07/27","玉山-高雄",29,0,29
"1870","2841台開","110/07/27","美林",0,30,-30
"1871","2841台開","110/07/27","第一金-台中",20,0,20
"1872","2841台開","110/07/27","國泰-松江",5,35,-30
"1873","2841台開","110/07/27","凱基-市政",20,0,20
"1874","2841台開","110/07/27","台新-左楠",0,25,-25
"1875","2841台開","110/07/27","群益金鼎-大甲",18,1,17
"1876","2841台開","110/07/27","大昌-樹林",0,20,-20
"1877","2841台開","110/07/27","台中銀",16,1,15
"1878","2841台開","110/07/27","富邦-仁愛",0,20,-20
"1879","2841台開","110/07/27","國泰-板橋",12,0,12
"1880","2841台開","110/07/27","致和-南京",0,16,-16
"1881","2841台開","110/07/27","群益金鼎-基隆",10,0,10
"1882","2841台開","110/07/27","凱基-台北",2,16,-14
"1883","2841台開","110/07/27","華南永昌-新莊",10,0,10
"1884","2841台開","110/07/27","日盛-台南",0,10,-10
"1885","2841台開","110/07/27","元大-福營",10,0,10
"1886","2841台開","110/07/27","國票-台東",0,10,-10
"1887","2841台開","110/07/27","元大-歸仁",10,0,10
"1888","2841台開","110/07/27","台新-台中",5,15,-10
"1889","2841台開","110/07/27","中國信託-文心",5,0,5
"1890","2841台開","110/07/27","凱基-台中",0,10,-10
"1891","6207雷科","110/07/27","摩根大通",249,119,130
"1892","6207雷科","110/07/27","永豐金-台南",2,82,-80
"1893","6207雷科","110/07/27","群益金鼎-丹鳳",70,0,70
"1894","6207雷科","110/07/27","永豐金-內湖",39,109,-70
"1895","6207雷科","110/07/27","群益金鼎-東門",42,0,42
"1896","6207雷科","110/07/27","新加坡商瑞銀",22,76,-54
"1897","6207雷科","110/07/27","永豐金-敦南",38,4,34
"1898","6207雷科","110/07/27","新光-高雄",4,57,-53
"1899","6207雷科","110/07/27","凱基-復興",30,0,30
"1900","6207雷科","110/07/27","瑞士信貸",0,40,-40
"1901","6207雷科","110/07/27","元大-東門",30,0,30
"1902","6207雷科","110/07/27","凱基-高雄",4,43,-39
"1903","6207雷科","110/07/27","大昌-桃園",33,8,25
"1904","6207雷科","110/07/27","華南永昌-高雄",4,40,-36
"1905","6207雷科","110/07/27","富邦-虎尾",24,0,24
"1906","6207雷科","110/07/27","新光",11,44,-33
"1907","6207雷科","110/07/27","凱基-羅東",24,2,22
"1908","6207雷科","110/07/27","日盛-板橋中山",0,29,-29
"1909","6207雷科","110/07/27","群益金鼎-延平",21,0,21
"1910","6207雷科","110/07/27","元大-六合",3,30,-27
"1911","6207雷科","110/07/27","群益金鼎-屏東",20,0,20
"1912","6207雷科","110/07/27","中國信託-新竹",7,33,-26
"1913","6207雷科","110/07/27","永豐金-埔里",20,0,20
"1914","6207雷科","110/07/27","元富-城中",0,23,-23
"1915","6207雷科","110/07/27","康和-延平",21,3,18
"1916","6207雷科","110/07/27","元大-大雅",2,20,-18
"1917","6207雷科","110/07/27","群益金鼎-中壢",20,2,18
"1918","6207雷科","110/07/27","永豐金-新莊",2,20,-18
"1919","6207雷科","110/07/27","宏遠證券",31,15,16
"1920","6207雷科","110/07/27","富邦-台中",5,21,-16
"1921","3679新至陞","110/07/27","凱基-市政",25,0,25
"1922","3679新至陞","110/07/27","瑞士信貸",0,13,-13
"1923","3679新至陞","110/07/27","兆豐-高雄",10,0,10
"1924","3679新至陞","110/07/27","元大-天母",0,9,-9
"1925","3679新至陞","110/07/27","光和-溪湖",8,0,8
"1926","3679新至陞","110/07/27","元大-彰化民生",0,6,-6
"1927","3679新至陞","110/07/27","臺銀-新竹",7,0,7
"1928","3679新至陞","110/07/27","康和-澎湖",2,7,-5
"1929","3679新至陞","110/07/27","新加坡商瑞銀",7,0,7
"1930","3679新至陞","110/07/27","聯邦-大業",0,5,-5
"1931","3679新至陞","110/07/27","永豐金-板橋",6,0,6
"1932","3679新至陞","110/07/27","元大-成功",0,5,-5
"1933","3679新至陞","110/07/27","宏遠-光隆",5,0,5
"1934","3679新至陞","110/07/27","康和-板橋",0,4,-4
"1935","3679新至陞","110/07/27","統一",5,0,5
"1936","3679新至陞","110/07/27","凱基-新豐",0,4,-4
"1937","3679新至陞","110/07/27","統一-新竹",5,0,5
"1938","3679新至陞","110/07/27","統一-高雄",0,3,-3
"1939","3679新至陞","110/07/27","元富-松德",5,0,5
"1940","3679新至陞","110/07/27","統一-新台中",0,3,-3
"1941","3679新至陞","110/07/27","元大-淡水",5,0,5
"1942","3679新至陞","110/07/27","元富-安南",0,3,-3
"1943","3679新至陞","110/07/27","日盛證券",4,0,4
"1944","3679新至陞","110/07/27","國票-北高雄",0,3,-3
"1945","3679新至陞","110/07/27","國泰-板橋",4,0,4
"1946","3679新至陞","110/07/27","玉山-新莊",0,3,-3
"1947","3679新至陞","110/07/27","(牛牛牛)亞-網路",3,0,3
"1948","3679新至陞","110/07/27","凱基-屏東",0,3,-3
"1949","3679新至陞","110/07/27","國票-九鼎",3,0,3
"1950","3679新至陞","110/07/27","台灣摩根士丹利",0,2,-2
"1951","2727王品","110/07/27","台灣摩根士丹利",103,12,91
"1952","2727王品","110/07/27","元大-彰化民生",11,420,-409
"1953","2727王品","110/07/27","華南永昌-麻豆",33,0,33
"1954","2727王品","110/07/27","美商高盛",0,247,-247
"1955","2727王品","110/07/27","元大-龍潭",31,1,30
"1956","2727王品","110/07/27","華南永昌",7,193,-186
"1957","2727王品","110/07/27","國泰-敦南",38,11,27
"1958","2727王品","110/07/27","花旗環球",0,86,-86
"1959","2727王品","110/07/27","群益金鼎-基隆",27,1,26
"1960","2727王品","110/07/27","凱基-台北",81,139,-58
"1961","2727王品","110/07/27","富邦-台中",26,0,26
"1962","2727王品","110/07/27","元大證券",23,64,-41
"1963","2727王品","110/07/27","元富",31,6,25
"1964","2727王品","110/07/27","瑞士信貸",0,37,-37
"1965","2727王品","110/07/27","元大-桃園",25,0,25
"1966","2727王品","110/07/27","富邦-建國",8,35,-27
"1967","2727王品","110/07/27","凱基-大直",21,1,20
"1968","2727王品","110/07/27","凱基-埔墘",6,29,-23
"1969","2727王品","110/07/27","日盛-士林",16,0,16
"1970","2727王品","110/07/27","美林",5,26,-21
"1971","2727王品","110/07/27","國票-敦北法人",17,1,16
"1972","2727王品","110/07/27","港商野村",12,30,-18
"1973","2727王品","110/07/27","群益金鼎-高雄",16,0,16
"1974","2727王品","110/07/27","華南永昌-林口",3,21,-18
"1975","2727王品","110/07/27","永豐金-忠孝",18,2,16
"1976","2727王品","110/07/27","彰銀-台中",4,20,-16
"1977","2727王品","110/07/27","臺銀-高雄",16,1,15
"1978","2727王品","110/07/27","統一",3,17,-14
"1979","2727王品","110/07/27","台新-台中",18,3,15
"1980","2727王品","110/07/27","富邦-新竹華信",2,15,-13
"1981","1570力肯","110/07/27","國票-北高雄",7,0,7
"1982","1570力肯","110/07/27","元大-高雄",0,16,-16
"1983","1570力肯","110/07/27","富邦-陽明",5,0,5
"1984","1570力肯","110/07/27","國票-新莊",0,5,-5
"1985","1570力肯","110/07/27","元大-民雄",3,0,3
"1986","1570力肯","110/07/27","凱基-台北",0,5,-5
"1987","1570力肯","110/07/27","凱基-大里",3,0,3
"1988","1570力肯","110/07/27","美林",0,2,-2
"1989","1570力肯","110/07/27","凱基-長庚",3,0,3
"1990","1570力肯","110/07/27","富邦-南屯",0,2,-2
"1991","1570力肯","110/07/27","元大-新莊",2,0,2
"1992","1570力肯","110/07/27","元大-南崁",0,2,-2
"1993","1570力肯","110/07/27","大昌-樹林",2,0,2
"1994","1570力肯","110/07/27","元大-板橋",0,2,-2
"1995","1570力肯","110/07/27","台新-台中",2,0,2
"1996","1570力肯","110/07/27","新光",0,1,-1
"1997","1570力肯","110/07/27","新光-新竹",2,0,2
"1998","1570力肯","110/07/27","國泰-板橋",0,1,-1
"1999","1570力肯","110/07/27","富邦-左營",2,0,2
"2000","1570力肯","110/07/27","凱基-鳳山",0,1,-1
"2001","1570力肯","110/07/27","群益金鼎-土城",1,0,1
"2002","1570力肯","110/07/27","(牛牛牛)亞-鑫豐",2,2,0
"2003","1570力肯","110/07/27","凱基-竹東",1,0,1
"2004","1570力肯","110/07/27","元大-新盛",1,1,0
"2005","1570力肯","110/07/27","日盛-員林",1,0,1
"2006","1570力肯","110/07/27","",NA,NA,NA
"2007","1570力肯","110/07/27","玉山-板橋",1,0,1
"2008","1570力肯","110/07/27","",NA,NA,NA
"2009","1570力肯","110/07/27","元富-同大",1,0,1
"2010","1570力肯","110/07/27","",NA,NA,NA
"2011","6180橘子","110/07/27","新加坡商瑞銀",166,24,142
"2012","6180橘子","110/07/27","花旗環球",31,87,-56
"2013","6180橘子","110/07/27","彰銀-台中",50,1,49
"2014","6180橘子","110/07/27","凱基-台北",53,108,-55
"2015","6180橘子","110/07/27","日盛-文化",48,8,40
"2016","6180橘子","110/07/27","新光",39,81,-42
"2017","6180橘子","110/07/27","美林",39,0,39
"2018","6180橘子","110/07/27","富邦-台北",1,25,-24
"2019","6180橘子","110/07/27","元大-草屯",54,17,37
"2020","6180橘子","110/07/27","第一金-員林",0,22,-22
"2021","6180橘子","110/07/27","美商高盛",35,1,34
"2022","6180橘子","110/07/27","富邦-新竹華信",7,28,-21
"2023","6180橘子","110/07/27","元大-上新莊",32,0,32
"2024","6180橘子","110/07/27","凱基-中山",5,24,-19
"2025","6180橘子","110/07/27","台灣摩根士丹利",30,0,30
"2026","6180橘子","110/07/27","國泰-敦南",22,37,-15
"2027","6180橘子","110/07/27","摩根大通",49,21,28
"2028","6180橘子","110/07/27","合庫-自強",2,16,-14
"2029","6180橘子","110/07/27","兆豐-大同",30,4,26
"2030","6180橘子","110/07/27","大昌-安康",1,14,-13
"2031","6180橘子","110/07/27","元大-羅東",21,0,21
"2032","6180橘子","110/07/27","高橋",0,11,-11
"2033","6180橘子","110/07/27","日盛-頭份",16,0,16
"2034","6180橘子","110/07/27","土銀-新竹",0,10,-10
"2035","6180橘子","110/07/27","瑞士信貸",24,8,16
"2036","6180橘子","110/07/27","兆豐-麻豆",0,10,-10
"2037","6180橘子","110/07/27","群益金鼎-士林",15,0,15
"2038","6180橘子","110/07/27","康和-永和",0,10,-10
"2039","6180橘子","110/07/27","永豐金-南京",15,1,14
"2040","6180橘子","110/07/27","永豐金-竹科",2,12,-10
"2041","2390云辰","110/07/27","凱基-基隆",207,3,204
"2042","2390云辰","110/07/27","凱基-台北",248,732,-484
"2043","2390云辰","110/07/27","摩根大通",730,560,170
"2044","2390云辰","110/07/27","美林",17,218,-201
"2045","2390云辰","110/07/27","華南永昌-中正",182,43,139
"2046","2390云辰","110/07/27","港商野村",85,277,-192
"2047","2390云辰","110/07/27","兆豐-北高雄",124,1,123
"2048","2390云辰","110/07/27","玉山-新莊",4,87,-83
"2049","2390云辰","110/07/27","元大-信義",108,5,103
"2050","2390云辰","110/07/27","新光",96,163,-67
"2051","2390云辰","110/07/27","富邦-陽明",94,22,72
"2052","2390云辰","110/07/27","新光-新竹",7,74,-67
"2053","2390云辰","110/07/27","日盛證券",140,71,69
"2054","2390云辰","110/07/27","富邦-左營",46,107,-61
"2055","2390云辰","110/07/27","第一金-豐原",56,0,56
"2056","2390云辰","110/07/27","大昌-新店",9,64,-55
"2057","2390云辰","110/07/27","統一-新台中",67,22,45
"2058","2390云辰","110/07/27","日盛-和美",28,81,-53
"2059","2390云辰","110/07/27","元大-復北",47,2,45
"2060","2390云辰","110/07/27","元大-台南",3,54,-51
"2061","2390云辰","110/07/27","富邦-建國",54,10,44
"2062","2390云辰","110/07/27","元富-世貿",10,60,-50
"2063","2390云辰","110/07/27","兆豐-桃鶯",46,5,41
"2064","2390云辰","110/07/27","華南永昌-鳳山",41,90,-49
"2065","2390云辰","110/07/27","富邦-中壢",45,4,41
"2066","2390云辰","110/07/27","聯邦商銀",6,52,-46
"2067","2390云辰","110/07/27","富邦-新竹華信",46,11,35
"2068","2390云辰","110/07/27","合庫-高雄",7,50,-43
"2069","2390云辰","110/07/27","第一金-華江",30,2,28
"2070","2390云辰","110/07/27","瑞士信貸",0,42,-42
"2071","2363矽統","110/07/26","凱基-台北",1994,468,1526
"2072","2363矽統","110/07/26","富邦-南屯",5,375,-370
"2073","2363矽統","110/07/26","新加坡商瑞銀",1537,208,1329
"2074","2363矽統","110/07/26","聯邦-興中",0,203,-203
"2075","2363矽統","110/07/26","摩根大通",2033,997,1036
"2076","2363矽統","110/07/26","台新證券",427,622,-195
"2077","2363矽統","110/07/26","瑞士信貸",930,0,930
"2078","2363矽統","110/07/26","元大-鳳中",10,203,-193
"2079","2363矽統","110/07/26","美林",985,76,909
"2080","2363矽統","110/07/26","國泰-板橋",69,209,-140
"2081","2363矽統","110/07/26","港商野村",1072,282,790
"2082","2363矽統","110/07/26","北城證券",6,132,-126
"2083","2363矽統","110/07/26","美商高盛",711,7,704
"2084","2363矽統","110/07/26","華南永昌-朴子",30,152,-122
"2085","2363矽統","110/07/26","新光",570,278,292
"2086","2363矽統","110/07/26","台新-台中",27,145,-118
"2087","2363矽統","110/07/26","台新-台南",244,39,205
"2088","2363矽統","110/07/26","群益金鼎-萬華",13,128,-115
"2089","2363矽統","110/07/26","元大證券",243,52,191
"2090","2363矽統","110/07/26","日盛-樹林",7,116,-109
"2091","2363矽統","110/07/26","永豐金證券",189,27,162
"2092","2363矽統","110/07/26","群益金鼎-屏東",200,303,-103
"2093","2363矽統","110/07/26","元大-楊梅",177,16,161
"2094","2363矽統","110/07/26","元大-潮州",6,102,-96
"2095","2363矽統","110/07/26","群益金鼎",158,21,137
"2096","2363矽統","110/07/26","新光-桃園",22,117,-95
"2097","2363矽統","110/07/26","元富-城東",107,8,99
"2098","2363矽統","110/07/26","凱基-和平",45,140,-95
"2099","2363矽統","110/07/26","日盛-雙和",109,14,95
"2100","2363矽統","110/07/26","合庫-台南",5,95,-90
"2101","8112至上","110/07/26","摩根大通",1728,41,1687
"2102","8112至上","110/07/26","玉山-左營",3,600,-597
"2103","8112至上","110/07/26","台灣摩根士丹利",408,10,398
"2104","8112至上","110/07/26","凱基-三重",1,527,-526
"2105","8112至上","110/07/26","凱基-台北",693,311,382
"2106","8112至上","110/07/26","中國信託-忠孝",0,103,-103
"2107","8112至上","110/07/26","港商法國興業",376,1,375
"2108","8112至上","110/07/26","凱基-站前",7,105,-98
"2109","8112至上","110/07/26","美商高盛",172,26,146
"2110","8112至上","110/07/26","國票-中港",0,96,-96
"2111","8112至上","110/07/26","新加坡商瑞銀",201,69,132
"2112","8112至上","110/07/26","兆豐-公益",3,84,-81
"2113","8112至上","110/07/26","美林",192,62,130
"2114","8112至上","110/07/26","玉山證券",2,65,-63
"2115","8112至上","110/07/26","港商野村",142,58,84
"2116","8112至上","110/07/26","統一-台中",1,62,-61
"2117","8112至上","110/07/26","凱基-永和",75,0,75
"2118","8112至上","110/07/26","富邦-陽明",3,60,-57
"2119","8112至上","110/07/26","凱基-竹科",65,2,63
"2120","8112至上","110/07/26","新光-新竹",86,141,-55
"2121","8112至上","110/07/26","華南永昌-敦南",63,1,62
"2122","8112至上","110/07/26","富邦-台北",2,57,-55
"2123","8112至上","110/07/26","兆豐-天母",50,0,50
"2124","8112至上","110/07/26","玉山-板橋",2,51,-49
"2125","8112至上","110/07/26","新光-桃園",57,11,46
"2126","8112至上","110/07/26","台新-新營",6,47,-41
"2127","8112至上","110/07/26","光和",35,1,34
"2128","8112至上","110/07/26","元大-虎尾",4,42,-38
"2129","8112至上","110/07/26","華南永昌-新莊",31,3,28
"2130","8112至上","110/07/26","日盛-新竹",1,38,-37
"2131","1570力肯","110/07/26","元大-民雄",10,0,10
"2132","1570力肯","110/07/26","元大-高雄",0,33,-33
"2133","1570力肯","110/07/26","新光-台中",10,1,9
"2134","1570力肯","110/07/26","日盛-宜蘭",0,8,-8
"2135","1570力肯","110/07/26","富邦-陽明",9,0,9
"2136","1570力肯","110/07/26","美林",0,5,-5
"2137","1570力肯","110/07/26","大慶-蘆洲",8,0,8
"2138","1570力肯","110/07/26","凱基-永康",0,5,-5
"2139","1570力肯","110/07/26","福勝",8,0,8
"2140","1570力肯","110/07/26","台新證券",0,4,-4
"2141","1570力肯","110/07/26","凱基-桃園",7,0,7
"2142","1570力肯","110/07/26","元大-汐止",0,4,-4
"2143","1570力肯","110/07/26","中國信託-永康",3,0,3
"2144","1570力肯","110/07/26","元大-桃興",0,3,-3
"2145","1570力肯","110/07/26","兆豐-台中港",3,0,3
"2146","1570力肯","110/07/26","元富-吉利",0,2,-2
"2147","1570力肯","110/07/26","國票-北高雄",3,0,3
"2148","1570力肯","110/07/26","國泰-板橋",0,2,-2
"2149","1570力肯","110/07/26","富邦-員林",3,0,3
"2150","1570力肯","110/07/26","元大-台中",0,2,-2
"2151","1570力肯","110/07/26","瑞士信貸",2,0,2
"2152","1570力肯","110/07/26","元大-西螺",0,2,-2
"2153","1570力肯","110/07/26","大昌-樹林",2,0,2
"2154","1570力肯","110/07/26","元大-苑裡",0,2,-2
"2155","1570力肯","110/07/26","兆豐-忠孝",2,0,2
"2156","1570力肯","110/07/26","合庫-三重",0,1,-1
"2157","1570力肯","110/07/26","新光",2,0,2
"2158","1570力肯","110/07/26","臺銀-臺南",0,1,-1
"2159","1570力肯","110/07/26","凱基-台北",2,0,2
"2160","1570力肯","110/07/26","元富-永和",0,1,-1
"2161","2929淘帝","110/07/26","合庫-高雄",47,0,47
"2162","2929淘帝","110/07/26","港商野村",11,42,-31
"2163","2929淘帝","110/07/26","元大-民生",28,0,28
"2164","2929淘帝","110/07/26","凱基-林口",0,30,-30
"2165","2929淘帝","110/07/26","臺銀-鳳山",10,0,10
"2166","2929淘帝","110/07/26","美林",1,28,-27
"2167","2929淘帝","110/07/26","華南永昌-鶯歌",10,0,10
"2168","2929淘帝","110/07/26","富邦-竹北",0,20,-20
"2169","2929淘帝","110/07/26","元大-永和",10,0,10
"2170","2929淘帝","110/07/26","凱基-台北",0,12,-12
"2171","2929淘帝","110/07/26","永豐金證券",8,0,8
"2172","2929淘帝","110/07/26","中國信託-永康",0,10,-10
"2173","2929淘帝","110/07/26","元大-太平",8,1,7
"2174","2929淘帝","110/07/26","摩根大通",0,10,-10
"2175","2929淘帝","110/07/26","德信-和平",6,0,6
"2176","2929淘帝","110/07/26","群益金鼎-高雄",0,10,-10
"2177","2929淘帝","110/07/26","兆豐-南門",6,0,6
"2178","2929淘帝","110/07/26","富邦-宜蘭",0,10,-10
"2179","2929淘帝","110/07/26","元大-新竹經國",6,0,6
"2180","2929淘帝","110/07/26","新加坡商瑞銀",4,13,-9
"2181","2929淘帝","110/07/26","合庫-台南",5,0,5
"2182","2929淘帝","110/07/26","元富-敦南",0,7,-7
"2183","2929淘帝","110/07/26","第一金-新興",5,0,5
"2184","2929淘帝","110/07/26","元大-基隆",0,6,-6
"2185","2929淘帝","110/07/26","玉山-新竹",5,0,5
"2186","2929淘帝","110/07/26","新光-台中",1,6,-5
"2187","2929淘帝","110/07/26","元大-金門",5,0,5
"2188","2929淘帝","110/07/26","華南永昌",0,5,-5
"2189","2929淘帝","110/07/26","台新-台中",4,0,4
"2190","2929淘帝","110/07/26","永豐金-中和",0,5,-5
"2191","5410國眾","110/07/26","摩根大通",71,0,71
"2192","5410國眾","110/07/26","日盛-忠孝",0,142,-142
"2193","5410國眾","110/07/26","凱基-台北",67,4,63
"2194","5410國眾","110/07/26","元富-嘉義",0,55,-55
"2195","5410國眾","110/07/26","兆豐-城中",47,0,47
"2196","5410國眾","110/07/26","國泰-敦南",2,30,-28
"2197","5410國眾","110/07/26","永豐金-內湖",45,0,45
"2198","5410國眾","110/07/26","群益金鼎-板橋",0,15,-15
"2199","5410國眾","110/07/26","元大-新莊",26,0,26
"2200","5410國眾","110/07/26","華南永昌-三重",0,11,-11
"2201","5410國眾","110/07/26","兆豐-麻豆",10,0,10
"2202","5410國眾","110/07/26","永全-南崁",0,10,-10
"2203","5410國眾","110/07/26","新光-台中",10,0,10
"2204","5410國眾","110/07/26","台新-建北",1,11,-10
"2205","5410國眾","110/07/26","元大-屏南",10,0,10
"2206","5410國眾","110/07/26","臺銀-臺南",0,8,-8
"2207","5410國眾","110/07/26","港商野村",9,0,9
"2208","5410國眾","110/07/26","群益金鼎-東大",0,7,-7
"2209","5410國眾","110/07/26","新光",13,4,9
"2210","5410國眾","110/07/26","永豐金-中正",0,7,-7
"2211","5410國眾","110/07/26","華南永昌-小港",7,0,7
"2212","5410國眾","110/07/26","永豐金-桃園",0,7,-7
"2213","5410國眾","110/07/26","玉山-左營",6,0,6
"2214","5410國眾","110/07/26","第一金-高雄",0,6,-6
"2215","5410國眾","110/07/26","土銀-台南",5,0,5
"2216","5410國眾","110/07/26","台中銀-豐原",0,6,-6
"2217","5410國眾","110/07/26","新加坡商瑞銀",5,0,5
"2218","5410國眾","110/07/26","亞東-高雄",0,5,-5
"2219","5410國眾","110/07/26","元富-三重",8,3,5
"2220","5410國眾","110/07/26","國票-北高雄",0,5,-5
"2221","2841台開","110/07/26","台新-台中",282,5,277
"2222","2841台開","110/07/26","港商野村",0,128,-128
"2223","2841台開","110/07/26","凱基-台北",41,0,41
"2224","2841台開","110/07/26","富邦-仁愛",0,70,-70
"2225","2841台開","110/07/26","台灣摩根士丹利",40,0,40
"2226","2841台開","110/07/26","元大-彰化",0,60,-60
"2227","2841台開","110/07/26","元富-緯城",40,0,40
"2228","2841台開","110/07/26","永興-水湳",0,30,-30
"2229","2841台開","110/07/26","玉山-高雄",38,0,38
"2230","2841台開","110/07/26","富邦-新竹華信",0,23,-23
"2231","2841台開","110/07/26","日盛-樹林",21,0,21
"2232","2841台開","110/07/26","宏遠-光隆",0,20,-20
"2233","2841台開","110/07/26","元大-松江",20,0,20
"2234","2841台開","110/07/26","玉山證券",0,20,-20
"2235","2841台開","110/07/26","元大-歸仁",20,0,20
"2236","2841台開","110/07/26","富邦-板橋",0,20,-20
"2237","2841台開","110/07/26","國泰-桃園",20,3,17
"2238","2841台開","110/07/26","元大-台中中港",0,19,-19
"2239","2841台開","110/07/26","新光-台中",15,0,15
"2240","2841台開","110/07/26","臺銀-臺南",0,18,-18
"2241","2841台開","110/07/26","群益金鼎-東門",11,0,11
"2242","2841台開","110/07/26","永豐金-敦南",3,19,-16
"2243","2841台開","110/07/26","華南永昌-內壢",11,0,11
"2244","2841台開","110/07/26","統一-桃園",0,13,-13
"2245","2841台開","110/07/26","元富-烏日",10,0,10
"2246","2841台開","110/07/26","國泰-台中",0,11,-11
"2247","2841台開","110/07/26","國泰-忠孝",10,2,8
"2248","2841台開","110/07/26","元大-福營",0,11,-11
"2249","2841台開","110/07/26","元大-潮州",6,0,6
"2250","2841台開","110/07/26","凱基-站前",0,10,-10
"2251","6207雷科","110/07/26","元大-向上",70,0,70
"2252","6207雷科","110/07/26","摩根大通",45,241,-196
"2253","6207雷科","110/07/26","國票-中和",67,5,62
"2254","6207雷科","110/07/26","華南永昌-台中",16,180,-164
"2255","6207雷科","110/07/26","永豐金-台南",63,2,61
"2256","6207雷科","110/07/26","瑞士信貸",4,69,-65
"2257","6207雷科","110/07/26","國泰-板橋",32,0,32
"2258","6207雷科","110/07/26","國票-天祥",11,76,-65
"2259","6207雷科","110/07/26","華南永昌-朴子",24,0,24
"2260","6207雷科","110/07/26","新加坡商瑞銀",15,78,-63
"2261","6207雷科","110/07/26","台新證券",35,12,23
"2262","6207雷科","110/07/26","凱基-台北",86,134,-48
"2263","6207雷科","110/07/26","永豐金-板盛",24,1,23
"2264","6207雷科","110/07/26","富邦-台中",58,100,-42
"2265","6207雷科","110/07/26","康和-台中",24,2,22
"2266","6207雷科","110/07/26","兆豐-大安",0,41,-41
"2267","6207雷科","110/07/26","台新-台南",22,2,20
"2268","6207雷科","110/07/26","群益金鼎-館前",0,40,-40
"2269","6207雷科","110/07/26","元大-大統",22,2,20
"2270","6207雷科","110/07/26","富邦-羅東",2,39,-37
"2271","6207雷科","110/07/26","元富-桃園",19,0,19
"2272","6207雷科","110/07/26","國票-台東",0,30,-30
"2273","6207雷科","110/07/26","高橋",17,0,17
"2274","6207雷科","110/07/26","凱基-士林",1,30,-29
"2275","6207雷科","110/07/26","元富-同大",30,13,17
"2276","6207雷科","110/07/26","元大-南京",3,31,-28
"2277","6207雷科","110/07/26","元大-內湖",17,0,17
"2278","6207雷科","110/07/26","宏遠-桃園",0,24,-24
"2279","6207雷科","110/07/26","永豐金-內湖",19,2,17
"2280","6207雷科","110/07/26","國票-和平",0,23,-23
"2281","3679新至陞","110/07/26","元富-板橋",16,0,16
"2282","3679新至陞","110/07/26","台新-台中",0,19,-19
"2283","3679新至陞","110/07/26","華南永昌-淡水",10,0,10
"2284","3679新至陞","110/07/26","元大-成功",0,10,-10
"2285","3679新至陞","110/07/26","光和-溪湖",8,0,8
"2286","3679新至陞","110/07/26","日進",0,9,-9
"2287","3679新至陞","110/07/26","宏遠-光隆",6,0,6
"2288","3679新至陞","110/07/26","臺銀-臺中",0,5,-5
"2289","3679新至陞","110/07/26","玉山-嘉義",5,0,5
"2290","3679新至陞","110/07/26","港商法國興業",0,4,-4
"2291","3679新至陞","110/07/26","元富-安南",3,0,3
"2292","3679新至陞","110/07/26","統一-新台中",0,3,-3
"2293","3679新至陞","110/07/26","摩根大通",4,1,3
"2294","3679新至陞","110/07/26","大慶-苗栗",1,3,-2
"2295","3679新至陞","110/07/26","凱基-台北",5,2,3
"2296","3679新至陞","110/07/26","元富-松德",0,2,-2
"2297","3679新至陞","110/07/26","凱基-站前",2,0,2
"2298","3679新至陞","110/07/26","富邦-仁愛",0,2,-2
"2299","3679新至陞","110/07/26","華南永昌",2,0,2
"2300","3679新至陞","110/07/26","元大-文心興安",0,2,-2
"2301","3679新至陞","110/07/26","元大-上新莊",2,0,2
"2302","3679新至陞","110/07/26","永豐金證券",0,2,-2
"2303","3679新至陞","110/07/26","美林",4,3,1
"2304","3679新至陞","110/07/26","臺銀-高雄",0,1,-1
"2305","3679新至陞","110/07/26","台灣摩根士丹利",2,1,1
"2306","3679新至陞","110/07/26","台灣企銀-屏東",0,1,-1
"2307","3679新至陞","110/07/26","美商高盛",1,0,1
"2308","3679新至陞","110/07/26","大慶-富順",0,1,-1
"2309","3679新至陞","110/07/26","富邦-台北",1,0,1
"2310","3679新至陞","110/07/26","統一-彰化",0,1,-1
"2311","2727王品","110/07/26","兆豐-南京",300,0,300
"2312","2727王品","110/07/26","元富-安南",0,62,-62
"2313","2727王品","110/07/26","凱基-台北",74,29,45
"2314","2727王品","110/07/26","瑞士信貸",0,44,-44
"2315","2727王品","110/07/26","富邦-建國",25,2,23
"2316","2727王品","110/07/26","新加坡商瑞銀",0,44,-44
"2317","2727王品","110/07/26","台灣摩根士丹利",22,0,22
"2318","2727王品","110/07/26","統一",11,54,-43
"2319","2727王品","110/07/26","永豐金-屏東",14,1,13
"2320","2727王品","110/07/26","美林",4,39,-35
"2321","2727王品","110/07/26","富邦-桃園",12,1,11
"2322","2727王品","110/07/26","第一金",0,30,-30
"2323","2727王品","110/07/26","日盛-鳳山",11,1,10
"2324","2727王品","110/07/26","康和-台中",0,30,-30
"2325","2727王品","110/07/26","元富-城中",10,0,10
"2326","2727王品","110/07/26","國泰證券",1,31,-30
"2327","2727王品","110/07/26","元大-龍潭",11,1,10
"2328","2727王品","110/07/26","元大證券",37,67,-30
"2329","2727王品","110/07/26","新光-台中",15,6,9
"2330","2727王品","110/07/26","康和",1,29,-28
"2331","2727王品","110/07/26","富邦-台中",10,1,9
"2332","2727王品","110/07/26","永豐金證券",0,27,-27
"2333","2727王品","110/07/26","元大-基隆孝二",10,1,9
"2334","2727王品","110/07/26","安泰",1,26,-25
"2335","2727王品","110/07/26","臺銀-臺中",10,2,8
"2336","2727王品","110/07/26","永豐金-古亭",2,20,-18
"2337","2727王品","110/07/26","元大-花蓮",8,0,8
"2338","2727王品","110/07/26","國票-天祥",0,16,-16
"2339","2727王品","110/07/26","元大-斗信",9,1,8
"2340","2727王品","110/07/26","摩根大通",17,33,-16
"2341","1570力肯","110/07/26","元大-民雄",10,0,10
"2342","1570力肯","110/07/26","元大-高雄",0,33,-33
"2343","1570力肯","110/07/26","新光-台中",10,1,9
"2344","1570力肯","110/07/26","日盛-宜蘭",0,8,-8
"2345","1570力肯","110/07/26","富邦-陽明",9,0,9
"2346","1570力肯","110/07/26","美林",0,5,-5
"2347","1570力肯","110/07/26","大慶-蘆洲",8,0,8
"2348","1570力肯","110/07/26","凱基-永康",0,5,-5
"2349","1570力肯","110/07/26","福勝",8,0,8
"2350","1570力肯","110/07/26","台新證券",0,4,-4
"2351","1570力肯","110/07/26","凱基-桃園",7,0,7
"2352","1570力肯","110/07/26","元大-汐止",0,4,-4
"2353","1570力肯","110/07/26","中國信託-永康",3,0,3
"2354","1570力肯","110/07/26","元大-桃興",0,3,-3
"2355","1570力肯","110/07/26","兆豐-台中港",3,0,3
"2356","1570力肯","110/07/26","元富-吉利",0,2,-2
"2357","1570力肯","110/07/26","國票-北高雄",3,0,3
"2358","1570力肯","110/07/26","國泰-板橋",0,2,-2
"2359","1570力肯","110/07/26","富邦-員林",3,0,3
"2360","1570力肯","110/07/26","元大-台中",0,2,-2
"2361","1570力肯","110/07/26","瑞士信貸",2,0,2
"2362","1570力肯","110/07/26","元大-西螺",0,2,-2
"2363","1570力肯","110/07/26","大昌-樹林",2,0,2
"2364","1570力肯","110/07/26","元大-苑裡",0,2,-2
"2365","1570力肯","110/07/26","兆豐-忠孝",2,0,2
"2366","1570力肯","110/07/26","合庫-三重",0,1,-1
"2367","1570力肯","110/07/26","新光",2,0,2
"2368","1570力肯","110/07/26","臺銀-臺南",0,1,-1
"2369","1570力肯","110/07/26","凱基-台北",2,0,2
"2370","1570力肯","110/07/26","元富-永和",0,1,-1
"2371","6180橘子","110/07/26","凱基-台北",121,1,120
"2372","6180橘子","110/07/26","元大-竹山",0,35,-35
"2373","6180橘子","110/07/26","新加坡商瑞銀",71,2,69
"2374","6180橘子","110/07/26","元大-和平",0,30,-30
"2375","6180橘子","110/07/26","摩根大通",70,4,66
"2376","6180橘子","110/07/26","元大-草屯",3,27,-24
"2377","6180橘子","110/07/26","美林",33,0,33
"2378","6180橘子","110/07/26","華南永昌-高雄",0,21,-21
"2379","6180橘子","110/07/26","台灣摩根士丹利",20,4,16
"2380","6180橘子","110/07/26","兆豐-埔墘",0,18,-18
"2381","6180橘子","110/07/26","合庫-高雄",11,0,11
"2382","6180橘子","110/07/26","元富-林園",0,17,-17
"2383","6180橘子","110/07/26","港商野村",10,0,10
"2384","6180橘子","110/07/26","元富-成功",0,16,-16
"2385","6180橘子","110/07/26","富邦-宜蘭",10,0,10
"2386","6180橘子","110/07/26","群益金鼎-台南",0,13,-13
"2387","6180橘子","110/07/26","統一-彰化",10,1,9
"2388","6180橘子","110/07/26","元大-開元",0,13,-13
"2389","6180橘子","110/07/26","兆豐-北高雄",9,1,8
"2390","6180橘子","110/07/26","富邦-台中",0,12,-12
"2391","6180橘子","110/07/26","元大-新店中正",10,2,8
"2392","6180橘子","110/07/26","(牛牛牛)亞-鑫豐",1,12,-11
"2393","6180橘子","110/07/26","國泰-敦南",10,3,7
"2394","6180橘子","110/07/26","台新-台南",0,11,-11
"2395","6180橘子","110/07/26","合庫-自強",5,0,5
"2396","6180橘子","110/07/26","聯邦-興中",0,11,-11
"2397","6180橘子","110/07/26","大慶-蘆洲",5,0,5
"2398","6180橘子","110/07/26","日盛-中和",0,10,-10
"2399","6180橘子","110/07/26","統一-中壢",5,0,5
"2400","6180橘子","110/07/26","康和-台北",0,10,-10
"2401","2390云辰","110/07/26","元大-大同",311,3,308
"2402","2390云辰","110/07/26","摩根大通",139,570,-431
"2403","2390云辰","110/07/26","華南永昌-鳳山",276,4,272
"2404","2390云辰","110/07/26","美林",103,243,-140
"2405","2390云辰","110/07/26","永豐金-竹北",201,6,195
"2406","2390云辰","110/07/26","元大-彰化民生",0,117,-117
"2407","2390云辰","110/07/26","富邦-左營",107,17,90
"2408","2390云辰","110/07/26","元富-中港",0,102,-102
"2409","2390云辰","110/07/26","元富-高雄",82,5,77
"2410","2390云辰","110/07/26","凱基-台北",161,249,-88
"2411","2390云辰","110/07/26","元大-太平",75,10,65
"2412","2390云辰","110/07/26","國票-新莊",15,78,-63
"2413","2390云辰","110/07/26","元大-大益",63,13,50
"2414","2390云辰","110/07/26","第一金-豐原",1,59,-58
"2415","2390云辰","110/07/26","元富-新竹",41,1,40
"2416","2390云辰","110/07/26","統一-竹南",5,48,-43
"2417","2390云辰","110/07/26","日盛-永康",42,4,38
"2418","2390云辰","110/07/26","第一金-台南",28,62,-34
"2419","2390云辰","110/07/26","群益金鼎-中壢",50,12,38
"2420","2390云辰","110/07/26","台灣摩根士丹利",38,70,-32
"2421","2390云辰","110/07/26","元大-鑫永和",54,18,36
"2422","2390云辰","110/07/26","群益金鼎-士林",20,52,-32
"2423","2390云辰","110/07/26","元富-同大",34,1,33
"2424","2390云辰","110/07/26","群益金鼎-延平",2,31,-29
"2425","2390云辰","110/07/26","致和-崇德",52,21,31
"2426","2390云辰","110/07/26","凱基-豐中",12,40,-28
"2427","2390云辰","110/07/26","永豐金-松山",32,2,30
"2428","2390云辰","110/07/26","富邦-中壢",19,47,-28
"2429","2390云辰","110/07/26","凱基-三重",36,8,28
"2430","2390云辰","110/07/26","統一-基隆",2,27,-25
"2431","2363矽統","110/07/20","第一金-忠孝",400,115,285
"2432","2363矽統","110/07/20","國票-長城",3,452,-449
"2433","2363矽統","110/07/20","第一金-高雄",188,0,188
"2434","2363矽統","110/07/20","美林",158,531,-373
"2435","2363矽統","110/07/20","凱基-高美館",199,14,185
"2436","2363矽統","110/07/20","台新-左楠",13,310,-297
"2437","2363矽統","110/07/20","凱基-台北",434,326,108
"2438","2363矽統","110/07/20","玉山-台大",4,228,-224
"2439","2363矽統","110/07/20","元富-松德",105,0,105
"2440","2363矽統","110/07/20","群益金鼎-大甲",11,227,-216
"2441","2363矽統","110/07/20","元大-竹科",109,7,102
"2442","2363矽統","110/07/20","群益金鼎-中港",2,111,-109
"2443","2363矽統","110/07/20","元大-成功",102,2,100
"2444","2363矽統","110/07/20","元大-大天母",0,109,-109
"2445","2363矽統","110/07/20","富邦-仁愛",116,17,99
"2446","2363矽統","110/07/20","國泰-敦南",114,218,-104
"2447","2363矽統","110/07/20","元大-上新莊",102,16,86
"2448","2363矽統","110/07/20","港商野村",250,350,-100
"2449","2363矽統","110/07/20","台新證券",286,208,78
"2450","2363矽統","110/07/20","康和-澎湖",0,90,-90
"2451","2363矽統","110/07/20","元大-新營",81,9,72
"2452","2363矽統","110/07/20","凱基-中壢",15,99,-84
"2453","2363矽統","110/07/20","華南永昌-鳳山",76,5,71
"2454","2363矽統","110/07/20","元大-學甲",0,81,-81
"2455","2363矽統","110/07/20","富邦-員林",65,2,63
"2456","2363矽統","110/07/20","凱基-三重",22,91,-69
"2457","2363矽統","110/07/20","元富-成功",67,6,61
"2458","2363矽統","110/07/20","永豐金-嘉義",24,92,-68
"2459","2363矽統","110/07/20","新光-新竹",62,1,61
"2460","2363矽統","110/07/20","大慶-蘆洲",23,89,-66
"2461","8112至上","110/07/20","摩根大通",1226,293,933
"2462","8112至上","110/07/20","凱基-三重",27,502,-475
"2463","8112至上","110/07/20","新加坡商瑞銀",358,83,275
"2464","8112至上","110/07/20","宏遠證券",0,418,-418
"2465","8112至上","110/07/20","台灣摩根士丹利",159,9,150
"2466","8112至上","110/07/20","台新-台中",11,291,-280
"2467","8112至上","110/07/20","統一-新竹",115,5,110
"2468","8112至上","110/07/20","美林",44,194,-150
"2469","8112至上","110/07/20","新光",233,126,107
"2470","8112至上","110/07/20","凱基-新莊",0,100,-100
"2471","8112至上","110/07/20","凱基-台北",367,260,107
"2472","8112至上","110/07/20","富邦-永和",14,104,-90
"2473","8112至上","110/07/20","兆豐-西螺",104,10,94
"2474","8112至上","110/07/20","國票-敦北法人",4,88,-84
"2475","8112至上","110/07/20","永豐金-中正",87,6,81
"2476","8112至上","110/07/20","凱基-市政",3,80,-77
"2477","8112至上","110/07/20","富邦-新店",102,24,78
"2478","8112至上","110/07/20","台新證券",68,142,-74
"2479","8112至上","110/07/20","元大-大同",83,5,78
"2480","8112至上","110/07/20","永豐金-中壢",11,80,-69
"2481","8112至上","110/07/20","富邦-園區",64,2,62
"2482","8112至上","110/07/20","永豐金-台南",22,91,-69
"2483","8112至上","110/07/20","新光-台南",73,14,59
"2484","8112至上","110/07/20","元大-大雅",22,87,-65
"2485","8112至上","110/07/20","統一-台中",60,2,58
"2486","8112至上","110/07/20","光和",10,67,-57
"2487","8112至上","110/07/20","元大-北成功",58,4,54
"2488","8112至上","110/07/20","元大-竹科",27,74,-47
"2489","8112至上","110/07/20","元富-林園",53,0,53
"2490","8112至上","110/07/20","兆豐-公益",1,47,-46
"2491","1570力肯","110/07/20","國票-北高雄",36,0,36
"2492","1570力肯","110/07/20","國泰-敦南",0,19,-19
"2493","1570力肯","110/07/20","群益金鼎-高雄",16,0,16
"2494","1570力肯","110/07/20","中國信託-永康",0,12,-12
"2495","1570力肯","110/07/20","臺銀-鳳山",10,0,10
"2496","1570力肯","110/07/20","第一金-路竹",0,10,-10
"2497","1570力肯","110/07/20","群益金鼎-新竹",6,0,6
"2498","1570力肯","110/07/20","福勝",0,10,-10
"2499","1570力肯","110/07/20","大昌-樹林",5,0,5
"2500","1570力肯","110/07/20","群益金鼎-板橋",0,10,-10
"2501","1570力肯","110/07/20","華南永昌-楠梓",5,0,5
"2502","1570力肯","110/07/20","日盛-鳳山",0,8,-8
"2503","1570力肯","110/07/20","元大-基隆孝二",5,0,5
"2504","1570力肯","110/07/20","永豐金-新竹",6,14,-8
"2505","1570力肯","110/07/20","元大-新竹經國",4,0,4
"2506","1570力肯","110/07/20","第一金-彰化",0,7,-7
"2507","1570力肯","110/07/20","土銀-高雄",2,0,2
"2508","1570力肯","110/07/20","元富-吉利",0,7,-7
"2509","1570力肯","110/07/20","台灣企銀-太平",2,0,2
"2510","1570力肯","110/07/20","台中銀-員林",0,7,-7
"2511","1570力肯","110/07/20","兆豐-忠孝",2,0,2
"2512","1570力肯","110/07/20","玉山證券",1,8,-7
"2513","1570力肯","110/07/20","玉山-城中",2,0,2
"2514","1570力肯","110/07/20","統一-三重",0,5,-5
"2515","1570力肯","110/07/20","國泰-板橋",2,0,2
"2516","1570力肯","110/07/20","光和-溪湖",0,3,-3
"2517","1570力肯","110/07/20","凱基-台北",2,0,2
"2518","1570力肯","110/07/20","康和-澎湖",0,3,-3
"2519","1570力肯","110/07/20","華南永昌-高雄",2,0,2
"2520","1570力肯","110/07/20","摩根大通",0,2,-2
"2521","2929淘帝","110/07/20","玉山-新竹",59,0,59
"2522","2929淘帝","110/07/20","臺銀",0,45,-45
"2523","2929淘帝","110/07/20","兆豐-新莊",50,0,50
"2524","2929淘帝","110/07/20","光和-嘉義",0,29,-29
"2525","2929淘帝","110/07/20","元大-大甲",30,0,30
"2526","2929淘帝","110/07/20","新加坡商瑞銀",27,55,-28
"2527","2929淘帝","110/07/20","元大-民生",29,0,29
"2528","2929淘帝","110/07/20","華南永昌-潮州",0,20,-20
"2529","2929淘帝","110/07/20","元大-員林",20,0,20
"2530","2929淘帝","110/07/20","玉山-高雄",0,14,-14
"2531","2929淘帝","110/07/20","元富-台南",18,0,18
"2532","2929淘帝","110/07/20","富邦-南屯",2,13,-11
"2533","2929淘帝","110/07/20","港商野村",63,50,13
"2534","2929淘帝","110/07/20","高橋-龍潭",0,10,-10
"2535","2929淘帝","110/07/20","高橋",10,0,10
"2536","2929淘帝","110/07/20","台新-建北",0,10,-10
"2537","2929淘帝","110/07/20","元富-林園",10,0,10
"2538","2929淘帝","110/07/20","群益金鼎-台中",0,10,-10
"2539","2929淘帝","110/07/20","玉山-台南",10,0,10
"2540","2929淘帝","110/07/20","華南永昌-苗栗",0,10,-10
"2541","2929淘帝","110/07/20","群益金鼎-士林",10,0,10
"2542","2929淘帝","110/07/20","群益金鼎-西松",0,9,-9
"2543","2929淘帝","110/07/20","凱基-台北",16,6,10
"2544","2929淘帝","110/07/20","台新-三民",0,8,-8
"2545","2929淘帝","110/07/20","合庫證券",9,0,9
"2546","2929淘帝","110/07/20","群益金鼎",0,8,-8
"2547","2929淘帝","110/07/20","永豐金證券",9,2,7
"2548","2929淘帝","110/07/20","富邦-永和",0,7,-7
"2549","2929淘帝","110/07/20","凱基-基隆",6,0,6
"2550","2929淘帝","110/07/20","國泰-台中",6,12,-6
"2551","5410國眾","110/07/20","日盛-內湖",27,0,27
"2552","5410國眾","110/07/20","永豐金-內湖",0,23,-23
"2553","5410國眾","110/07/20","富邦-新營",20,0,20
"2554","5410國眾","110/07/20","兆豐-台中港",0,20,-20
"2555","5410國眾","110/07/20","大昌",17,0,17
"2556","5410國眾","110/07/20","元富-嘉義",0,15,-15
"2557","5410國眾","110/07/20","永豐金-台南",17,0,17
"2558","5410國眾","110/07/20","元富-吉利",0,11,-11
"2559","5410國眾","110/07/20","凱基-站前",15,0,15
"2560","5410國眾","110/07/20","凱基-長庚",0,10,-10
"2561","5410國眾","110/07/20","凱基-竹北",11,0,11
"2562","5410國眾","110/07/20","元大-八德",0,10,-10
"2563","5410國眾","110/07/20","元富-民權",9,0,9
"2564","5410國眾","110/07/20","元大-天母",0,10,-10
"2565","5410國眾","110/07/20","群益金鼎-嘉義",6,0,6
"2566","5410國眾","110/07/20","國泰-桃園",0,9,-9
"2567","5410國眾","110/07/20","元大-土城學府",6,0,6
"2568","5410國眾","110/07/20","新光",5,12,-7
"2569","5410國眾","110/07/20","第一金-豐原",5,0,5
"2570","5410國眾","110/07/20","玉山-桃園",0,7,-7
"2571","5410國眾","110/07/20","華南永昌-林口",5,0,5
"2572","5410國眾","110/07/20","玉山-雙和",0,6,-6
"2573","5410國眾","110/07/20","元大-博愛",5,0,5
"2574","5410國眾","110/07/20","臺銀-臺南",0,5,-5
"2575","5410國眾","110/07/20","元大-竹南",5,0,5
"2576","5410國眾","110/07/20","彰銀-七賢",0,5,-5
"2577","5410國眾","110/07/20","元大-新店中正",5,0,5
"2578","5410國眾","110/07/20","宏遠證券",0,5,-5
"2579","5410國眾","110/07/20","元富-烏日",4,0,4
"2580","5410國眾","110/07/20","摩根大通",0,5,-5
"2581","2841台開","110/07/20","中國信託-忠孝",145,0,145
"2582","2841台開","110/07/20","凱基-松山",0,100,-100
"2583","2841台開","110/07/20","第一金-台中",68,0,68
"2584","2841台開","110/07/20","第一金-自由",0,33,-33
"2585","2841台開","110/07/20","美商高盛",37,0,37
"2586","2841台開","110/07/20","港商野村",0,29,-29
"2587","2841台開","110/07/20","台中銀",32,0,32
"2588","2841台開","110/07/20","國泰-敦南",11,31,-20
"2589","2841台開","110/07/20","台新-台中",20,0,20
"2590","2841台開","110/07/20","華南永昌-台中",0,20,-20
"2591","2841台開","110/07/20","凱基-東港",10,0,10
"2592","2841台開","110/07/20","元大-發財",0,15,-15
"2593","2841台開","110/07/20","大昌-安康",10,3,7
"2594","2841台開","110/07/20","元大-福營",9,23,-14
"2595","2841台開","110/07/20","豐農",7,0,7
"2596","2841台開","110/07/20","永豐金-敦南",5,18,-13
"2597","2841台開","110/07/20","元大-歸仁",7,0,7
"2598","2841台開","110/07/20","統一-城中",0,11,-11
"2599","2841台開","110/07/20","日盛-木柵",5,0,5
"2600","2841台開","110/07/20","日盛-台南",0,10,-10
"2601","2841台開","110/07/20","台新-台南",4,0,4
"2602","2841台開","110/07/20","兆豐-寶成",0,10,-10
"2603","2841台開","110/07/20","日盛證券",3,0,3
"2604","2841台開","110/07/20","國票-中港",0,10,-10
"2605","2841台開","110/07/20","台新證券",8,5,3
"2606","2841台開","110/07/20","群益金鼎",0,10,-10
"2607","2841台開","110/07/20","元大-沙鹿",3,0,3
"2608","2841台開","110/07/20","玉山證券",1,10,-9
"2609","2841台開","110/07/20","國泰-台中",2,0,2
"2610","2841台開","110/07/20","大昌-新店",0,6,-6
"2611","6207雷科","110/07/20","元大-西門",100,4,96
"2612","6207雷科","110/07/20","永豐金-內湖",0,109,-109
"2613","6207雷科","110/07/20","凱基-復興",50,0,50
"2614","6207雷科","110/07/20","國泰證券",0,90,-90
"2615","6207雷科","110/07/20","凱基-台北",47,1,46
"2616","6207雷科","110/07/20","元大-頭份",0,55,-55
"2617","6207雷科","110/07/20","玉山-城中",43,1,42
"2618","6207雷科","110/07/20","永豐金-虎尾",0,50,-50
"2619","6207雷科","110/07/20","華南永昌-長虹",44,5,39
"2620","6207雷科","110/07/20","元富-世貿",0,33,-33
"2621","6207雷科","110/07/20","凱基-板橋",38,1,37
"2622","6207雷科","110/07/20","元大-南崁",0,22,-22
"2623","6207雷科","110/07/20","元富-信義",39,3,36
"2624","6207雷科","110/07/20","永豐金-鳳山",0,21,-21
"2625","6207雷科","110/07/20","元富-彰化",35,0,35
"2626","6207雷科","110/07/20","永豐金-三重",6,27,-21
"2627","6207雷科","110/07/20","凱基-高美館",34,0,34
"2628","6207雷科","110/07/20","第一金-澎湖",0,20,-20
"2629","6207雷科","110/07/20","富邦-中壢",26,2,24
"2630","6207雷科","110/07/20","群益金鼎-東大",0,20,-20
"2631","6207雷科","110/07/20","大昌-桃園",23,0,23
"2632","6207雷科","110/07/20","兆豐-民生",0,19,-19
"2633","6207雷科","110/07/20","元大-四維",39,17,22
"2634","6207雷科","110/07/20","元大-北成功",1,20,-19
"2635","6207雷科","110/07/20","台灣摩根士丹利",18,0,18
"2636","6207雷科","110/07/20","元大-虎尾",1,18,-17
"2637","6207雷科","110/07/20","國票-中和",16,0,16
"2638","6207雷科","110/07/20","元大-文心興安",0,15,-15
"2639","6207雷科","110/07/20","永豐金-大園",16,0,16
"2640","6207雷科","110/07/20","瑞士信貸",0,14,-14
"2641","3679新至陞","110/07/20","國票-敦北法人",18,0,18
"2642","3679新至陞","110/07/20","華南永昌-台中",0,32,-32
"2643","3679新至陞","110/07/20","台中銀-員林",17,3,14
"2644","3679新至陞","110/07/20","凱基-台北",12,32,-20
"2645","3679新至陞","110/07/20","群益金鼎-高盛",13,0,13
"2646","3679新至陞","110/07/20","摩根大通",2,14,-12
"2647","3679新至陞","110/07/20","康和-澎湖",8,0,8
"2648","3679新至陞","110/07/20","國泰-桃園",0,11,-11
"2649","3679新至陞","110/07/20","台新證券",6,0,6
"2650","3679新至陞","110/07/20","群益金鼎-台南",0,10,-10
"2651","3679新至陞","110/07/20","宏遠-光隆",4,0,4
"2652","3679新至陞","110/07/20","群益金鼎-大安",0,10,-10
"2653","3679新至陞","110/07/20","玉山-大里",4,0,4
"2654","3679新至陞","110/07/20","永豐金證券",4,14,-10
"2655","3679新至陞","110/07/20","台中銀-豐原",3,0,3
"2656","3679新至陞","110/07/20","兆豐-大同",1,6,-5
"2657","3679新至陞","110/07/20","玉山-新莊",3,0,3
"2658","3679新至陞","110/07/20","群益金鼎-館前",0,4,-4
"2659","3679新至陞","110/07/20","凱基-中山",3,0,3
"2660","3679新至陞","110/07/20","富邦-南屯",0,4,-4
"2661","3679新至陞","110/07/20","富邦-台北",3,0,3
"2662","3679新至陞","110/07/20","瑞士信貸",3,6,-3
"2663","3679新至陞","110/07/20","元大-板橋",3,0,3
"2664","3679新至陞","110/07/20","國泰-板橋",0,3,-3
"2665","3679新至陞","110/07/20","日盛-八德",2,0,2
"2666","3679新至陞","110/07/20","富邦-中壢",1,4,-3
"2667","3679新至陞","110/07/20","日盛-復興",2,0,2
"2668","3679新至陞","110/07/20","台灣企銀",0,2,-2
"2669","3679新至陞","110/07/20","康和-板橋",2,0,2
"2670","3679新至陞","110/07/20","日盛-大墩",0,2,-2
"2671","2727王品","110/07/20","兆豐-南京",200,0,200
"2672","2727王品","110/07/20","凱基-市政",1,75,-74
"2673","2727王品","110/07/20","富邦證券",88,0,88
"2674","2727王品","110/07/20","美商高盛",6,38,-32
"2675","2727王品","110/07/20","台新證券",142,55,87
"2676","2727王品","110/07/20","富邦-陽明",7,38,-31
"2677","2727王品","110/07/20","瑞士信貸",50,0,50
"2678","2727王品","110/07/20","永豐金-中正",3,34,-31
"2679","2727王品","110/07/20","港商野村",106,57,49
"2680","2727王品","110/07/20","永豐金-潮州",0,31,-31
"2681","2727王品","110/07/20","凱基-台北",67,27,40
"2682","2727王品","110/07/20","兆豐-大安",0,30,-30
"2683","2727王品","110/07/20","永豐金-大園",29,2,27
"2684","2727王品","110/07/20","摩根大通",50,73,-23
"2685","2727王品","110/07/20","康和-高雄",20,0,20
"2686","2727王品","110/07/20","日盛證券",4,24,-20
"2687","2727王品","110/07/20","第一金-高雄",20,3,17
"2688","2727王品","110/07/20","凱基-大里",0,20,-20
"2689","2727王品","110/07/20","富邦-板橋",21,4,17
"2690","2727王品","110/07/20","群益金鼎-大甲",0,18,-18
"2691","2727王品","110/07/20","永豐金-桃盛",15,0,15
"2692","2727王品","110/07/20","統一",18,29,-11
"2693","2727王品","110/07/20","凱基",13,0,13
"2694","2727王品","110/07/20","國泰-台中",12,23,-11
"2695","2727王品","110/07/20","新加坡商瑞銀",23,11,12
"2696","2727王品","110/07/20","元大-彰化",0,11,-11
"2697","2727王品","110/07/20","亞東",10,0,10
"2698","2727王品","110/07/20","國泰-館前",4,14,-10
"2699","2727王品","110/07/20","康和-台中",13,4,9
"2700","2727王品","110/07/20","元大-學甲",0,10,-10
"2701","1570力肯","110/07/20","國票-北高雄",36,0,36
"2702","1570力肯","110/07/20","國泰-敦南",0,19,-19
"2703","1570力肯","110/07/20","群益金鼎-高雄",16,0,16
"2704","1570力肯","110/07/20","中國信託-永康",0,12,-12
"2705","1570力肯","110/07/20","臺銀-鳳山",10,0,10
"2706","1570力肯","110/07/20","第一金-路竹",0,10,-10
"2707","1570力肯","110/07/20","群益金鼎-新竹",6,0,6
"2708","1570力肯","110/07/20","福勝",0,10,-10
"2709","1570力肯","110/07/20","大昌-樹林",5,0,5
"2710","1570力肯","110/07/20","群益金鼎-板橋",0,10,-10
"2711","1570力肯","110/07/20","華南永昌-楠梓",5,0,5
"2712","1570力肯","110/07/20","日盛-鳳山",0,8,-8
"2713","1570力肯","110/07/20","元大-基隆孝二",5,0,5
"2714","1570力肯","110/07/20","永豐金-新竹",6,14,-8
"2715","1570力肯","110/07/20","元大-新竹經國",4,0,4
"2716","1570力肯","110/07/20","第一金-彰化",0,7,-7
"2717","1570力肯","110/07/20","土銀-高雄",2,0,2
"2718","1570力肯","110/07/20","元富-吉利",0,7,-7
"2719","1570力肯","110/07/20","台灣企銀-太平",2,0,2
"2720","1570力肯","110/07/20","台中銀-員林",0,7,-7
"2721","1570力肯","110/07/20","兆豐-忠孝",2,0,2
"2722","1570力肯","110/07/20","玉山證券",1,8,-7
"2723","1570力肯","110/07/20","玉山-城中",2,0,2
"2724","1570力肯","110/07/20","統一-三重",0,5,-5
"2725","1570力肯","110/07/20","國泰-板橋",2,0,2
"2726","1570力肯","110/07/20","光和-溪湖",0,3,-3
"2727","1570力肯","110/07/20","凱基-台北",2,0,2
"2728","1570力肯","110/07/20","康和-澎湖",0,3,-3
"2729","1570力肯","110/07/20","華南永昌-高雄",2,0,2
"2730","1570力肯","110/07/20","摩根大通",0,2,-2
"2731","6180橘子","110/07/20","摩根大通",89,31,58
"2732","6180橘子","110/07/20","群益金鼎-中山",0,80,-80
"2733","6180橘子","110/07/20","美商高盛",27,0,27
"2734","6180橘子","110/07/20","台中銀-台北",0,30,-30
"2735","6180橘子","110/07/20","新加坡商瑞銀",28,1,27
"2736","6180橘子","110/07/20","日盛-新莊",1,22,-21
"2737","6180橘子","110/07/20","新光",41,16,25
"2738","6180橘子","110/07/20","元富-緯城",2,20,-18
"2739","6180橘子","110/07/20","日盛-文化",21,0,21
"2740","6180橘子","110/07/20","日盛-新竹",2,15,-13
"2741","6180橘子","110/07/20","元富-潮州",20,0,20
"2742","6180橘子","110/07/20","元大-汐止",0,12,-12
"2743","6180橘子","110/07/20","凱基-台北",31,11,20
"2744","6180橘子","110/07/20","元大-豐原站前",0,12,-12
"2745","6180橘子","110/07/20","元大-草屯",18,0,18
"2746","6180橘子","110/07/20","德信-中正",0,10,-10
"2747","6180橘子","110/07/20","花旗環球",13,0,13
"2748","6180橘子","110/07/20","新光-台南",0,10,-10
"2749","6180橘子","110/07/20","元大-桃園",12,0,12
"2750","6180橘子","110/07/20","玉山-雙和",0,10,-10
"2751","6180橘子","110/07/20","群益金鼎",10,0,10
"2752","6180橘子","110/07/20","元大-四維",0,10,-10
"2753","6180橘子","110/07/20","元大-高雄",10,0,10
"2754","6180橘子","110/07/20","元大-永春",2,12,-10
"2755","6180橘子","110/07/20","群益金鼎-嘉義",9,0,9
"2756","6180橘子","110/07/20","凱基-高美館",0,8,-8
"2757","6180橘子","110/07/20","富邦-嘉義",9,0,9
"2758","6180橘子","110/07/20","華南永昌",2,10,-8
"2759","6180橘子","110/07/20","元富-草屯",10,2,8
"2760","6180橘子","110/07/20","富邦-台北",0,8,-8
"2761","2390云辰","110/07/20","元大證券",6043,11,6032
"2762","2390云辰","110/07/20","華南永昌-鳳山",2,312,-310
"2763","2390云辰","110/07/20","兆豐-復興",998,0,998
"2764","2390云辰","110/07/20","台灣摩根士丹利",0,247,-247
"2765","2390云辰","110/07/20","富邦-嘉義",775,7,768
"2766","2390云辰","110/07/20","元大-復北",4,239,-235
"2767","2390云辰","110/07/20","統一-台中",350,6,344
"2768","2390云辰","110/07/20","富邦-建國",25,236,-211
"2769","2390云辰","110/07/20","兆豐-城中",240,0,240
"2770","2390云辰","110/07/20","元富-中港",0,202,-202
"2771","2390云辰","110/07/20","群益金鼎-館前",204,2,202
"2772","2390云辰","110/07/20","國泰-敦南",20,194,-174
"2773","2390云辰","110/07/20","凱基-大直",187,0,187
"2774","2390云辰","110/07/20","元大-土城學府",10,156,-146
"2775","2390云辰","110/07/20","永豐金證券",160,10,150
"2776","2390云辰","110/07/20","中國信託-松江",0,130,-130
"2777","2390云辰","110/07/20","日盛-高雄",104,2,102
"2778","2390云辰","110/07/20","凱基-基隆",0,130,-130
"2779","2390云辰","110/07/20","凱基-中山",100,3,97
"2780","2390云辰","110/07/20","永豐金-中正",1,117,-116
"2781","2390云辰","110/07/20","元大-基隆",85,7,78
"2782","2390云辰","110/07/20","富邦-陽明",1,94,-93
"2783","2390云辰","110/07/20","群益金鼎-東大",64,2,62
"2784","2390云辰","110/07/20","元大-潮州",20,112,-92
"2785","2390云辰","110/07/20","元大-前金",60,1,59
"2786","2390云辰","110/07/20","宏遠證券",0,89,-89
"2787","2390云辰","110/07/20","國票-北高雄",63,14,49
"2788","2390云辰","110/07/20","兆豐-台中",0,75,-75
"2789","2390云辰","110/07/20","群益金鼎-三重",40,6,34
"2790","2390云辰","110/07/20","新光",8,82,-74
"2791","2363矽統","110/07/19","第一金-忠孝",210,0,210
"2792","2363矽統","110/07/19","富邦-仁愛",32,575,-543
"2793","2363矽統","110/07/19","中國信託-文心",191,9,182
"2794","2363矽統","110/07/19","新加坡商瑞銀",53,486,-433
"2795","2363矽統","110/07/19","華南永昌-鳳山",116,1,115
"2796","2363矽統","110/07/19","摩根大通",42,320,-278
"2797","2363矽統","110/07/19","元大-新竹",113,12,101
"2798","2363矽統","110/07/19","元大-竹科",3,201,-198
"2799","2363矽統","110/07/19","凱基-中山",89,1,88
"2800","2363矽統","110/07/19","元大-成功",7,183,-176
"2801","2363矽統","110/07/19","永豐金-嘉義",82,7,75
"2802","2363矽統","110/07/19","凱基-大里",0,150,-150
"2803","2363矽統","110/07/19","凱基-台南",72,4,68
"2804","2363矽統","110/07/19","瑞士信貸",80,215,-135
"2805","2363矽統","110/07/19","元富-城東",84,17,67
"2806","2363矽統","110/07/19","日盛-新莊",4,135,-131
"2807","2363矽統","110/07/19","群益金鼎-東湖",61,0,61
"2808","2363矽統","110/07/19","宏遠-桃園",20,150,-130
"2809","2363矽統","110/07/19","兆豐-中壢",55,0,55
"2810","2363矽統","110/07/19","凱基-三重",7,107,-100
"2811","2363矽統","110/07/19","康和-內湖",55,1,54
"2812","2363矽統","110/07/19","凱基-台北",384,476,-92
"2813","2363矽統","110/07/19","群益金鼎-桃園",55,2,53
"2814","2363矽統","110/07/19","合庫-台中",3,84,-81
"2815","2363矽統","110/07/19","群益金鼎-大興",50,0,50
"2816","2363矽統","110/07/19","致和-金華",1,80,-79
"2817","2363矽統","110/07/19","台新-台中",81,32,49
"2818","2363矽統","110/07/19","凱基-員林",5,77,-72
"2819","2363矽統","110/07/19","北城證券",58,10,48
"2820","2363矽統","110/07/19","華南永昌-合泰",2,70,-68
"2821","8112至上","110/07/19","摩根大通",1413,144,1269
"2822","8112至上","110/07/19","凱基-三重",3,600,-597
"2823","8112至上","110/07/19","凱基-台北",1053,266,787
"2824","8112至上","110/07/19","元大-府城",0,165,-165
"2825","8112至上","110/07/19","新加坡商瑞銀",523,2,521
"2826","8112至上","110/07/19","台灣企銀-台中",0,150,-150
"2827","8112至上","110/07/19","台灣摩根士丹利",487,8,479
"2828","8112至上","110/07/19","(牛牛牛)亞-鑫豐",26,119,-93
"2829","8112至上","110/07/19","美林",529,93,436
"2830","8112至上","110/07/19","永豐金-台南",15,95,-80
"2831","8112至上","110/07/19","港商野村",358,36,322
"2832","8112至上","110/07/19","亞東-板橋",2,81,-79
"2833","8112至上","110/07/19","美商高盛",276,3,273
"2834","8112至上","110/07/19","陽信",0,70,-70
"2835","8112至上","110/07/19","兆豐-公益",180,7,173
"2836","8112至上","110/07/19","元富-佳里",0,69,-69
"2837","8112至上","110/07/19","國泰-板橋",116,15,101
"2838","8112至上","110/07/19","臺銀-鳳山",7,72,-65
"2839","8112至上","110/07/19","凱基-新莊",100,1,99
"2840","8112至上","110/07/19","兆豐-竹北",4,65,-61
"2841","8112至上","110/07/19","凱基-市政",89,0,89
"2842","8112至上","110/07/19","國泰-新莊",2,62,-60
"2843","8112至上","110/07/19","玉山證券",73,7,66
"2844","8112至上","110/07/19","元富-大裕",2,60,-58
"2845","8112至上","110/07/19","花旗環球",64,0,64
"2846","8112至上","110/07/19","臺灣企銀-桃園",0,55,-55
"2847","8112至上","110/07/19","合庫-台中",55,3,52
"2848","8112至上","110/07/19","康和-台南",4,59,-55
"2849","8112至上","110/07/19","永豐金-中壢",50,1,49
"2850","8112至上","110/07/19","第一金-華江",3,55,-52
"2851","1570力肯","110/07/19","國票-北高雄",34,0,34
"2852","1570力肯","110/07/19","合庫-三重",0,8,-8
"2853","1570力肯","110/07/19","新光",30,3,27
"2854","1570力肯","110/07/19","元大-高雄",0,8,-8
"2855","1570力肯","110/07/19","凱基-台北",24,1,23
"2856","1570力肯","110/07/19","合庫-台中",0,7,-7
"2857","1570力肯","110/07/19","台灣摩根士丹利",7,0,7
"2858","1570力肯","110/07/19","臺銀-臺中",0,6,-6
"2859","1570力肯","110/07/19","元大-林森",5,0,5
"2860","1570力肯","110/07/19","摩根大通",6,11,-5
"2861","1570力肯","110/07/19","元大-士林",4,0,4
"2862","1570力肯","110/07/19","元富-緯城",0,4,-4
"2863","1570力肯","110/07/19","玉山證券",8,5,3
"2864","1570力肯","110/07/19","玉山-台大",0,4,-4
"2865","1570力肯","110/07/19","統一-城中",2,0,2
"2866","1570力肯","110/07/19","群益金鼎-三重",0,4,-4
"2867","1570力肯","110/07/19","元大-基隆孝二",2,0,2
"2868","1570力肯","110/07/19","凱基-鳳山",1,5,-4
"2869","1570力肯","110/07/19","土銀-建國",1,0,1
"2870","1570力肯","110/07/19","元大-板橋",0,4,-4
"2871","1570力肯","110/07/19","日盛-復興",1,0,1
"2872","1570力肯","110/07/19","日盛-和美",0,3,-3
"2873","1570力肯","110/07/19","瑞士信貸",1,0,1
"2874","1570力肯","110/07/19","元富-新店",2,5,-3
"2875","1570力肯","110/07/19","元富-四維",1,0,1
"2876","1570力肯","110/07/19","元大-新莊",0,3,-3
"2877","1570力肯","110/07/19","群益金鼎-北高雄",1,0,1
"2878","1570力肯","110/07/19","永豐金-敦南",0,3,-3
"2879","1570力肯","110/07/19","凱基-高美館",1,0,1
"2880","1570力肯","110/07/19","永豐金-台中",0,3,-3
"2881","2929淘帝","110/07/19","元大-民生",28,0,28
"2882","2929淘帝","110/07/19","元大-六合",0,40,-40
"2883","2929淘帝","110/07/19","宏遠-光隆",25,0,25
"2884","2929淘帝","110/07/19","新光-新竹",0,35,-35
"2885","2929淘帝","110/07/19","華南永昌-苗栗",20,0,20
"2886","2929淘帝","110/07/19","新加坡商瑞銀",1,30,-29
"2887","2929淘帝","110/07/19","元大-員林",20,0,20
"2888","2929淘帝","110/07/19","永豐金-永康",0,27,-27
"2889","2929淘帝","110/07/19","合庫-高雄",18,0,18
"2890","2929淘帝","110/07/19","凱基-復興",0,24,-24
"2891","2929淘帝","110/07/19","臺銀-鳳山",18,0,18
"2892","2929淘帝","110/07/19","日盛-豐原",0,22,-22
"2893","2929淘帝","110/07/19","日盛-雙和",17,0,17
"2894","2929淘帝","110/07/19","富邦-南屯",1,22,-21
"2895","2929淘帝","110/07/19","華南永昌-林口",15,0,15
"2896","2929淘帝","110/07/19","新光",1,21,-20
"2897","2929淘帝","110/07/19","元大-屏南",15,0,15
"2898","2929淘帝","110/07/19","華南永昌",0,20,-20
"2899","2929淘帝","110/07/19","台新-中壢",12,0,12
"2900","2929淘帝","110/07/19","富邦-竹東",2,22,-20
"2901","2929淘帝","110/07/19","新光-台中",11,0,11
"2902","2929淘帝","110/07/19","凱基-士林",0,16,-16
"2903","2929淘帝","110/07/19","凱基-台北",20,9,11
"2904","2929淘帝","110/07/19","福勝",0,15,-15
"2905","2929淘帝","110/07/19","富邦-台北",11,0,11
"2906","2929淘帝","110/07/19","港商野村",25,37,-12
"2907","2929淘帝","110/07/19","合庫-自強",10,0,10
"2908","2929淘帝","110/07/19","群益金鼎-建成",0,11,-11
"2909","2929淘帝","110/07/19","凱基-豐中",10,0,10
"2910","2929淘帝","110/07/19","華南永昌-朴子",0,11,-11
"2911","5410國眾","110/07/19","香港上海匯豐",28,0,28
"2912","5410國眾","110/07/19","群益金鼎-內湖",0,80,-80
"2913","5410國眾","110/07/19","大昌",26,0,26
"2914","5410國眾","110/07/19","永豐金-屏東",0,14,-14
"2915","5410國眾","110/07/19","兆豐-公益",20,0,20
"2916","5410國眾","110/07/19","永豐金-南京",0,10,-10
"2917","5410國眾","110/07/19","合庫-嘉義",10,0,10
"2918","5410國眾","110/07/19","元大-內湖",0,9,-9
"2919","5410國眾","110/07/19","台新-左楠",20,10,10
"2920","5410國眾","110/07/19","富邦-永和",0,8,-8
"2921","5410國眾","110/07/19","摩根大通",15,6,9
"2922","5410國眾","110/07/19","日盛-景美",0,6,-6
"2923","5410國眾","110/07/19","台灣企銀-民雄",8,0,8
"2924","5410國眾","110/07/19","光和",1,7,-6
"2925","5410國眾","110/07/19","元大-竹科",8,0,8
"2926","5410國眾","110/07/19","元大-士林",0,6,-6
"2927","5410國眾","110/07/19","凱基-台北",9,3,6
"2928","5410國眾","110/07/19","新光-台中",0,5,-5
"2929","5410國眾","110/07/19","元大-博愛",6,0,6
"2930","5410國眾","110/07/19","元大-景美",0,5,-5
"2931","5410國眾","110/07/19","台新-三民",5,0,5
"2932","5410國眾","110/07/19","大慶-蘆洲",0,4,-4
"2933","5410國眾","110/07/19","群益金鼎-中壢",5,0,5
"2934","5410國眾","110/07/19","中國信託-新竹",0,4,-4
"2935","5410國眾","110/07/19","群益金鼎-嘉義",5,0,5
"2936","5410國眾","110/07/19","新光",6,10,-4
"2937","5410國眾","110/07/19","日盛證券",4,0,4
"2938","5410國眾","110/07/19","元大-基隆孝二",0,4,-4
"2939","5410國眾","110/07/19","群益金鼎-新店",4,0,4
"2940","5410國眾","110/07/19","土銀-台中",0,3,-3
"2941","2841台開","110/07/19","元富-城東",150,0,150
"2942","2841台開","110/07/19","日進",0,80,-80
"2943","2841台開","110/07/19","中國信託-忠孝",80,0,80
"2944","2841台開","110/07/19","港商野村",0,77,-77
"2945","2841台開","110/07/19","凱基-台北",52,0,52
"2946","2841台開","110/07/19","摩根大通",0,41,-41
"2947","2841台開","110/07/19","美商高盛",48,0,48
"2948","2841台開","110/07/19","元大-三重",1,38,-37
"2949","2841台開","110/07/19","台中銀",43,0,43
"2950","2841台開","110/07/19","元大-福營",0,30,-30
"2951","2841台開","110/07/19","永豐金-豐原",32,0,32
"2952","2841台開","110/07/19","新光",4,28,-24
"2953","2841台開","110/07/19","豐農",20,0,20
"2954","2841台開","110/07/19","元大-竹科",0,22,-22
"2955","2841台開","110/07/19","台新-台中",30,10,20
"2956","2841台開","110/07/19","永豐金-敦南",33,55,-22
"2957","2841台開","110/07/19","華南永昌-新莊",20,0,20
"2958","2841台開","110/07/19","日盛-二林",0,15,-15
"2959","2841台開","110/07/19","第一金-台中",12,0,12
"2960","2841台開","110/07/19","元富-虎尾",0,15,-15
"2961","2841台開","110/07/19","國泰-台中",12,0,12
"2962","2841台開","110/07/19","華南永昌-世貿",0,15,-15
"2963","2841台開","110/07/19","日茂",10,0,10
"2964","2841台開","110/07/19","統一-三多",0,12,-12
"2965","2841台開","110/07/19","凱基-埔墘",10,0,10
"2966","2841台開","110/07/19","台中銀-豐原",0,10,-10
"2967","2841台開","110/07/19","永豐金-內湖",8,0,8
"2968","2841台開","110/07/19","元大-頭份",0,10,-10
"2969","2841台開","110/07/19","合庫-台中",7,0,7
"2970","2841台開","110/07/19","合庫-台南",0,8,-8
"2971","6207雷科","110/07/19","元富-信義",92,0,92
"2972","6207雷科","110/07/19","新加坡商瑞銀",5,104,-99
"2973","6207雷科","110/07/19","國泰證券",90,0,90
"2974","6207雷科","110/07/19","富邦-彰化",2,97,-95
"2975","6207雷科","110/07/19","元富-城中",80,4,76
"2976","6207雷科","110/07/19","永豐金-內湖",6,85,-79
"2977","6207雷科","110/07/19","元大-福營",71,5,66
"2978","6207雷科","110/07/19","摩根大通",102,164,-62
"2979","6207雷科","110/07/19","凱基-復興",60,0,60
"2980","6207雷科","110/07/19","瑞士信貸",0,51,-51
"2981","6207雷科","110/07/19","凱基-台北",91,46,45
"2982","6207雷科","110/07/19","凱基-板橋",10,55,-45
"2983","6207雷科","110/07/19","玉山-城中",42,0,42
"2984","6207雷科","110/07/19","華南永昌-大安",0,40,-40
"2985","6207雷科","110/07/19","華南永昌-長虹",40,0,40
"2986","6207雷科","110/07/19","群益金鼎-東大",1,40,-39
"2987","6207雷科","110/07/19","永豐金-羅東",38,0,38
"2988","6207雷科","110/07/19","台新-高雄",15,47,-32
"2989","6207雷科","110/07/19","日盛-忠孝",36,2,34
"2990","6207雷科","110/07/19","玉山-嘉義",1,32,-31
"2991","6207雷科","110/07/19","凱基-羅東",37,3,34
"2992","6207雷科","110/07/19","凱基-中港",0,30,-30
"2993","6207雷科","110/07/19","第一金-新竹",30,0,30
"2994","6207雷科","110/07/19","元大-六合",7,36,-29
"2995","6207雷科","110/07/19","玉山-數位",27,1,26
"2996","6207雷科","110/07/19","元富-花蓮",0,28,-28
"2997","6207雷科","110/07/19","凱基-長庚",22,0,22
"2998","6207雷科","110/07/19","群益金鼎-瑞豐",6,34,-28
"2999","6207雷科","110/07/19","台灣企銀-北高雄",20,0,20
"3000","6207雷科","110/07/19","新百王",0,26,-26
"3001","3679新至陞","110/07/19","元大-成功",7,0,7
"3002","3679新至陞","110/07/19","群益金鼎-大安",0,15,-15
"3003","3679新至陞","110/07/19","美商高盛",6,0,6
"3004","3679新至陞","110/07/19","凱基-民權",0,10,-10
"3005","3679新至陞","110/07/19","台新-高雄",5,0,5
"3006","3679新至陞","110/07/19","元大-西門",0,10,-10
"3007","3679新至陞","110/07/19","凱基-松山",5,0,5
"3008","3679新至陞","110/07/19","瑞士信貸",0,6,-6
"3009","3679新至陞","110/07/19","日盛-員林",4,0,4
"3010","3679新至陞","110/07/19","兆豐-高雄",0,6,-6
"3011","3679新至陞","110/07/19","台中銀-員林",4,0,4
"3012","3679新至陞","110/07/19","群益金鼎",0,5,-5
"3013","3679新至陞","110/07/19","(牛牛牛)亞-網路",3,0,3
"3014","3679新至陞","110/07/19","元大-永春",0,4,-4
"3015","3679新至陞","110/07/19","大昌-新店",3,0,3
"3016","3679新至陞","110/07/19","凱基-台北",2,5,-3
"3017","3679新至陞","110/07/19","凱基-埔墘",3,0,3
"3018","3679新至陞","110/07/19","港商法國興業",0,2,-2
"3019","3679新至陞","110/07/19","元大-板橋",3,0,3
"3020","3679新至陞","110/07/19","摩根大通",2,4,-2
"3021","3679新至陞","110/07/19","臺銀-金山",2,0,2
"3022","3679新至陞","110/07/19","元大-金門",0,2,-2
"3023","3679新至陞","110/07/19","日盛-樹林",2,0,2
"3024","3679新至陞","110/07/19","元大-土城",0,2,-2
"3025","3679新至陞","110/07/19","致和-東門",2,0,2
"3026","3679新至陞","110/07/19","日盛-鳳山",0,1,-1
"3027","3679新至陞","110/07/19","國票-敦北法人",2,0,2
"3028","3679新至陞","110/07/19","美林",1,2,-1
"3029","3679新至陞","110/07/19","台新證券",2,0,2
"3030","3679新至陞","110/07/19","第一金",0,1,-1
"3031","2727王品","110/07/19","台新證券",374,33,341
"3032","2727王品","110/07/19","台灣摩根士丹利",25,188,-163
"3033","2727王品","110/07/19","瑞士信貸",217,1,216
"3034","2727王品","110/07/19","港商野村",74,198,-124
"3035","2727王品","110/07/19","兆豐-南京",200,0,200
"3036","2727王品","110/07/19","統一",6,80,-74
"3037","2727王品","110/07/19","第一金",70,1,69
"3038","2727王品","110/07/19","合庫-台中",8,79,-71
"3039","2727王品","110/07/19","元大-小港",59,1,58
"3040","2727王品","110/07/19","凱基-台北",178,231,-53
"3041","2727王品","110/07/19","玉山-桃園",42,6,36
"3042","2727王品","110/07/19","富邦-中壢",3,52,-49
"3043","2727王品","110/07/19","永豐金-大園",31,0,31
"3044","2727王品","110/07/19","凱基-永華",0,43,-43
"3045","2727王品","110/07/19","兆豐-大安",30,0,30
"3046","2727王品","110/07/19","土銀-台中",0,36,-36
"3047","2727王品","110/07/19","美商高盛",38,15,23
"3048","2727王品","110/07/19","美林",8,41,-33
"3049","2727王品","110/07/19","康和-澎湖",23,1,22
"3050","2727王品","110/07/19","中國信託-忠孝",1,33,-32
"3051","2727王品","110/07/19","第一金-高雄",21,0,21
"3052","2727王品","110/07/19","新光",31,61,-30
"3053","2727王品","110/07/19","國票-內壢",21,0,21
"3054","2727王品","110/07/19","第一金-豐原",0,26,-26
"3055","2727王品","110/07/19","元大-桃興",19,3,16
"3056","2727王品","110/07/19","富邦-彰化",0,26,-26
"3057","2727王品","110/07/19","凱基-三重",16,1,15
"3058","2727王品","110/07/19","摩根大通",78,97,-19
"3059","2727王品","110/07/19","永豐金-南投",16,1,15
"3060","2727王品","110/07/19","國泰證券",2,21,-19
"3061","1570力肯","110/07/19","國票-北高雄",34,0,34
"3062","1570力肯","110/07/19","合庫-三重",0,8,-8
"3063","1570力肯","110/07/19","新光",30,3,27
"3064","1570力肯","110/07/19","元大-高雄",0,8,-8
"3065","1570力肯","110/07/19","凱基-台北",24,1,23
"3066","1570力肯","110/07/19","合庫-台中",0,7,-7
"3067","1570力肯","110/07/19","台灣摩根士丹利",7,0,7
"3068","1570力肯","110/07/19","臺銀-臺中",0,6,-6
"3069","1570力肯","110/07/19","元大-林森",5,0,5
"3070","1570力肯","110/07/19","摩根大通",6,11,-5
"3071","1570力肯","110/07/19","元大-士林",4,0,4
"3072","1570力肯","110/07/19","元富-緯城",0,4,-4
"3073","1570力肯","110/07/19","玉山證券",8,5,3
"3074","1570力肯","110/07/19","玉山-台大",0,4,-4
"3075","1570力肯","110/07/19","統一-城中",2,0,2
"3076","1570力肯","110/07/19","群益金鼎-三重",0,4,-4
"3077","1570力肯","110/07/19","元大-基隆孝二",2,0,2
"3078","1570力肯","110/07/19","凱基-鳳山",1,5,-4
"3079","1570力肯","110/07/19","土銀-建國",1,0,1
"3080","1570力肯","110/07/19","元大-板橋",0,4,-4
"3081","1570力肯","110/07/19","日盛-復興",1,0,1
"3082","1570力肯","110/07/19","日盛-和美",0,3,-3
"3083","1570力肯","110/07/19","瑞士信貸",1,0,1
"3084","1570力肯","110/07/19","元富-新店",2,5,-3
"3085","1570力肯","110/07/19","元富-四維",1,0,1
"3086","1570力肯","110/07/19","元大-新莊",0,3,-3
"3087","1570力肯","110/07/19","群益金鼎-北高雄",1,0,1
"3088","1570力肯","110/07/19","永豐金-敦南",0,3,-3
"3089","1570力肯","110/07/19","凱基-高美館",1,0,1
"3090","1570力肯","110/07/19","永豐金-台中",0,3,-3
"3091","6180橘子","110/07/19","兆豐證券",55,0,55
"3092","6180橘子","110/07/19","石橋證券",0,80,-80
"3093","6180橘子","110/07/19","凱基-台北",89,35,54
"3094","6180橘子","110/07/19","永豐金-大園",2,50,-48
"3095","6180橘子","110/07/19","合庫-自強",36,0,36
"3096","6180橘子","110/07/19","群益金鼎-屏東",0,40,-40
"3097","6180橘子","110/07/19","新光",50,25,25
"3098","6180橘子","110/07/19","國泰-敦南",0,19,-19
"3099","6180橘子","110/07/19","日盛-龍潭",20,0,20
"3100","6180橘子","110/07/19","日盛-新竹",2,20,-18
"3101","6180橘子","110/07/19","元大-斗信",16,1,15
"3102","6180橘子","110/07/19","摩根大通",17,35,-18
"3103","6180橘子","110/07/19","康和-台中",12,0,12
"3104","6180橘子","110/07/19","富邦-陽明",0,17,-17
"3105","6180橘子","110/07/19","國泰-台中",14,2,12
"3106","6180橘子","110/07/19","美商高盛",11,27,-16
"3107","6180橘子","110/07/19","富邦-嘉義",12,0,12
"3108","6180橘子","110/07/19","統一-宜蘭",0,14,-14
"3109","6180橘子","110/07/19","元大-草屯",12,0,12
"3110","6180橘子","110/07/19","凱基-興隆",0,12,-12
"3111","6180橘子","110/07/19","元富-桃園",11,0,11
"3112","6180橘子","110/07/19","台中銀-豐原",1,11,-10
"3113","6180橘子","110/07/19","兆豐-城中",10,0,10
"3114","6180橘子","110/07/19","永豐金-豐原",0,10,-10
"3115","6180橘子","110/07/19","元大-旗山",10,0,10
"3116","6180橘子","110/07/19","永豐金-竹科",0,10,-10
"3117","6180橘子","110/07/19","元大-大安",10,0,10
"3118","6180橘子","110/07/19","臺銀-鳳山",1,10,-9
"3119","6180橘子","110/07/19","大昌-新店",9,0,9
"3120","6180橘子","110/07/19","群益金鼎-台南",0,9,-9
"3121","2390云辰","110/07/19","摩根大通",1135,266,869
"3122","2390云辰","110/07/19","元富-成功",15,119,-104
"3123","2390云辰","110/07/19","台灣摩根士丹利",232,40,192
"3124","2390云辰","110/07/19","元富-中港",5,101,-96
"3125","2390云辰","110/07/19","凱基-台北",669,504,165
"3126","2390云辰","110/07/19","元富-嘉義",5,85,-80
"3127","2390云辰","110/07/19","美林",290,159,131
"3128","2390云辰","110/07/19","美商高盛",11,62,-51
"3129","2390云辰","110/07/19","統一",111,8,103
"3130","2390云辰","110/07/19","群益金鼎-西松",4,54,-50
"3131","2390云辰","110/07/19","元富-埔里",102,0,102
"3132","2390云辰","110/07/19","聯邦商銀",0,48,-48
"3133","2390云辰","110/07/19","華南永昌-台中",126,26,100
"3134","2390云辰","110/07/19","元大-萬華",15,57,-42
"3135","2390云辰","110/07/19","永豐金-豐原",100,32,68
"3136","2390云辰","110/07/19","群益金鼎-高雄",2,42,-40
"3137","2390云辰","110/07/19","台新-台南",87,25,62
"3138","2390云辰","110/07/19","國泰-敦南",117,154,-37
"3139","2390云辰","110/07/19","台新-左楠",67,11,56
"3140","2390云辰","110/07/19","中國信託-文心",5,40,-35
"3141","2390云辰","110/07/19","國泰-忠孝",52,0,52
"3142","2390云辰","110/07/19","凱基-城中",16,51,-35
"3143","2390云辰","110/07/19","台新證券",105,54,51
"3144","2390云辰","110/07/19","瑞士信貸",0,31,-31
"3145","2390云辰","110/07/19","華南永昌-頭份",53,3,50
"3146","2390云辰","110/07/19","中國信託-永康",1,32,-31
"3147","2390云辰","110/07/19","新光-台南",44,0,44
"3148","2390云辰","110/07/19","統一-彰化",2,32,-30
"3149","2390云辰","110/07/19","合庫-西台中",50,8,42
"3150","2390云辰","110/07/19","元大-館前",7,37,-30
"3151","2363矽統","110/07/16","國票-長城",461,21,440
"3152","2363矽統","110/07/16","新加坡商瑞銀",155,482,-327
"3153","2363矽統","110/07/16","凱基-豐中",201,3,198
"3154","2363矽統","110/07/16","港商野村",253,546,-293
"3155","2363矽統","110/07/16","凱基-土城",132,9,123
"3156","2363矽統","110/07/16","摩根大通",116,401,-285
"3157","2363矽統","110/07/16","台新證券",199,78,121
"3158","2363矽統","110/07/16","瑞士信貸",291,533,-242
"3159","2363矽統","110/07/16","日盛-中和",74,0,74
"3160","2363矽統","110/07/16","日盛-竹北",19,248,-229
"3161","2363矽統","110/07/16","日盛-員林",66,3,63
"3162","2363矽統","110/07/16","臺銀-金山",4,211,-207
"3163","2363矽統","110/07/16","國票-中和",60,3,57
"3164","2363矽統","110/07/16","元大-大統",13,138,-125
"3165","2363矽統","110/07/16","新光",240,184,56
"3166","2363矽統","110/07/16","永豐金證券",11,125,-114
"3167","2363矽統","110/07/16","富邦-竹東",65,9,56
"3168","2363矽統","110/07/16","兆豐-民生",2,101,-99
"3169","2363矽統","110/07/16","華南永昌-鳳山",56,1,55
"3170","2363矽統","110/07/16","群益金鼎-松山",2,100,-98
"3171","2363矽統","110/07/16","凱基-台北",520,466,54
"3172","2363矽統","110/07/16","元大-花蓮",8,99,-91
"3173","2363矽統","110/07/16","元富-城東",63,12,51
"3174","2363矽統","110/07/16","華南永昌-虎尾",68,154,-86
"3175","2363矽統","110/07/16","群益金鼎-桃園",56,5,51
"3176","2363矽統","110/07/16","富邦-新竹華信",7,89,-82
"3177","2363矽統","110/07/16","北城證券",60,10,50
"3178","2363矽統","110/07/16","元大-佳里",3,81,-78
"3179","2363矽統","110/07/16","國票-九鼎",57,7,50
"3180","2363矽統","110/07/16","玉山-南京東路",0,73,-73
"3181","8112至上","110/07/16","宏遠證券",551,6,545
"3182","8112至上","110/07/16","玉山-桃園",42,318,-276
"3183","8112至上","110/07/16","台灣摩根士丹利",317,11,306
"3184","8112至上","110/07/16","美林",64,305,-241
"3185","8112至上","110/07/16","新加坡商瑞銀",378,73,305
"3186","8112至上","110/07/16","宏遠-館前",16,212,-196
"3187","8112至上","110/07/16","凱基-台北",758,553,205
"3188","8112至上","110/07/16","玉山-嘉義",19,95,-76
"3189","8112至上","110/07/16","富邦證券",127,0,127
"3190","8112至上","110/07/16","群益金鼎-三民",7,82,-75
"3191","8112至上","110/07/16","台新證券",129,30,99
"3192","8112至上","110/07/16","日盛-二林",1,73,-72
"3193","8112至上","110/07/16","花旗環球",97,0,97
"3194","8112至上","110/07/16","玉山-台大",8,76,-68
"3195","8112至上","110/07/16","永豐金-台南",97,8,89
"3196","8112至上","110/07/16","元富-台南",1,68,-67
"3197","8112至上","110/07/16","元大-大天母",93,15,78
"3198","8112至上","110/07/16","玉山-板橋",4,71,-67
"3199","8112至上","110/07/16","亞東-板橋",72,2,70
"3200","8112至上","110/07/16","臺灣企銀-埔墘",0,60,-60
"3201","8112至上","110/07/16","永豐金-中正",64,9,55
"3202","8112至上","110/07/16","華南永昌-鶯歌",11,64,-53
"3203","8112至上","110/07/16","大昌-樹林",53,2,51
"3204","8112至上","110/07/16","元大-士林",7,59,-52
"3205","8112至上","110/07/16","凱基-永和",56,5,51
"3206","8112至上","110/07/16","元富-新店",8,57,-49
"3207","8112至上","110/07/16","兆豐-竹北",53,3,50
"3208","8112至上","110/07/16","富邦-陽明",9,58,-49
"3209","8112至上","110/07/16","日盛-豐原",48,0,48
"3210","8112至上","110/07/16","元大-發財",0,49,-49
"3211","1570力肯","110/07/16","新光",71,6,65
"3212","1570力肯","110/07/16","元大-高雄",0,23,-23
"3213","1570力肯","110/07/16","國票-北高雄",21,0,21
"3214","1570力肯","110/07/16","合庫-台南",0,20,-20
"3215","1570力肯","110/07/16","凱基-台北",17,1,16
"3216","1570力肯","110/07/16","元富-新店",0,15,-15
"3217","1570力肯","110/07/16","群益金鼎-高雄",15,0,15
"3218","1570力肯","110/07/16","元大-東港",0,10,-10
"3219","1570力肯","110/07/16","富邦-建國",10,0,10
"3220","1570力肯","110/07/16","中國信託",0,7,-7
"3221","1570力肯","110/07/16","元大-士林",5,0,5
"3222","1570力肯","110/07/16","台新證券",0,6,-6
"3223","1570力肯","110/07/16","瑞士信貸",3,0,3
"3224","1570力肯","110/07/16","日盛-信義",0,5,-5
"3225","1570力肯","110/07/16","臺銀-高雄",2,0,2
"3226","1570力肯","110/07/16","宏遠-館前",0,5,-5
"3227","1570力肯","110/07/16","華南永昌",2,0,2
"3228","1570力肯","110/07/16","國泰-館前",0,5,-5
"3229","1570力肯","110/07/16","元富-同大",1,0,1
"3230","1570力肯","110/07/16","富邦-園區",0,5,-5
"3231","1570力肯","110/07/16","兆豐-麻豆",1,0,1
"3232","1570力肯","110/07/16","永豐金-中正",0,5,-5
"3233","1570力肯","110/07/16","國泰-板橋",1,0,1
"3234","1570力肯","110/07/16","(牛牛牛)亞-鑫豐",0,4,-4
"3235","1570力肯","110/07/16","群益金鼎-東湖",1,0,1
"3236","1570力肯","110/07/16","台中銀-員林",0,3,-3
"3237","1570力肯","110/07/16","元大-東泰",1,0,1
"3238","1570力肯","110/07/16","玉山-新莊",0,3,-3
"3239","1570力肯","110/07/16","元大-南勢角",1,0,1
"3240","1570力肯","110/07/16","凱基-長庚",0,3,-3
"3241","2929淘帝","110/07/16","元大-民生",28,0,28
"3242","2929淘帝","110/07/16","玉山-新竹",0,30,-30
"3243","2929淘帝","110/07/16","元大-員林",20,0,20
"3244","2929淘帝","110/07/16","合庫證券",0,20,-20
"3245","2929淘帝","110/07/16","兆豐-桃鶯",12,0,12
"3246","2929淘帝","110/07/16","元大-六合",0,20,-20
"3247","2929淘帝","110/07/16","元大-大統",10,0,10
"3248","2929淘帝","110/07/16","摩根大通",0,12,-12
"3249","2929淘帝","110/07/16","新加坡商瑞銀",9,0,9
"3250","2929淘帝","110/07/16","永興",0,6,-6
"3251","2929淘帝","110/07/16","凱基-基隆",6,0,6
"3252","2929淘帝","110/07/16","凱基-長庚",0,5,-5
"3253","2929淘帝","110/07/16","合庫-高雄",5,0,5
"3254","2929淘帝","110/07/16","群益金鼎-潭子",0,4,-4
"3255","2929淘帝","110/07/16","台新-台中",6,1,5
"3256","2929淘帝","110/07/16","華南永昌-小港",2,6,-4
"3257","2929淘帝","110/07/16","元大-承德",5,0,5
"3258","2929淘帝","110/07/16","華南永昌-虎尾",0,4,-4
"3259","2929淘帝","110/07/16","元大-沙鹿",5,0,5
"3260","2929淘帝","110/07/16","日盛-和美",0,3,-3
"3261","2929淘帝","110/07/16","大慶-苗栗",5,1,4
"3262","2929淘帝","110/07/16","彰銀",0,3,-3
"3263","2929淘帝","110/07/16","台新-新營",4,0,4
"3264","2929淘帝","110/07/16","港商野村",7,10,-3
"3265","2929淘帝","110/07/16","凱基-台北",6,2,4
"3266","2929淘帝","110/07/16","群益金鼎-中山",1,4,-3
"3267","2929淘帝","110/07/16","兆豐-台中港",3,0,3
"3268","2929淘帝","110/07/16","凱基-嘉義",0,3,-3
"3269","2929淘帝","110/07/16","國票-北高雄",3,0,3
"3270","2929淘帝","110/07/16","元大-斗信",0,3,-3
"3271","5410國眾","110/07/16","盈溢-籬子內",49,0,49
"3272","5410國眾","110/07/16","元大-博愛",0,41,-41
"3273","5410國眾","110/07/16","香港上海匯豐",31,0,31
"3274","5410國眾","110/07/16","元富-嘉義",0,20,-20
"3275","5410國眾","110/07/16","元大-東泰",30,0,30
"3276","5410國眾","110/07/16","國泰-桃園",0,18,-18
"3277","5410國眾","110/07/16","兆豐-台中港",20,0,20
"3278","5410國眾","110/07/16","元富",0,17,-17
"3279","5410國眾","110/07/16","臺銀-臺南",11,0,11
"3280","5410國眾","110/07/16","元大-新竹",0,14,-14
"3281","5410國眾","110/07/16","富邦-新竹華信",11,0,11
"3282","5410國眾","110/07/16","安泰-大發",0,11,-11
"3283","5410國眾","110/07/16","臺銀",10,0,10
"3284","5410國眾","110/07/16","大昌-樹林",0,10,-10
"3285","5410國眾","110/07/16","凱基-台北",8,1,7
"3286","5410國眾","110/07/16","群益金鼎-內湖",0,10,-10
"3287","5410國眾","110/07/16","日盛-士林",5,0,5
"3288","5410國眾","110/07/16","元大-樹林",0,10,-10
"3289","5410國眾","110/07/16","新光-桃園",5,0,5
"3290","5410國眾","110/07/16","元大-內湖",0,9,-9
"3291","5410國眾","110/07/16","國泰-台南",5,0,5
"3292","5410國眾","110/07/16","群益金鼎-永和",0,5,-5
"3293","5410國眾","110/07/16","群益金鼎-嘉義",5,0,5
"3294","5410國眾","110/07/16","凱基-屏東",0,5,-5
"3295","5410國眾","110/07/16","元大-屏南",5,0,5
"3296","5410國眾","110/07/16","統一-員林",0,4,-4
"3297","5410國眾","110/07/16","日盛-員林",3,0,3
"3298","5410國眾","110/07/16","國泰-松江",0,4,-4
"3299","5410國眾","110/07/16","瑞士信貸",3,0,3
"3300","5410國眾","110/07/16","凱基-台南",0,4,-4
"3301","2841台開","110/07/16","日盛證券",250,0,250
"3302","2841台開","110/07/16","元大-歸仁",0,590,-590
"3303","2841台開","110/07/16","凱基-文心",204,0,204
"3304","2841台開","110/07/16","摩根大通",0,245,-245
"3305","2841台開","110/07/16","國泰-館前",114,0,114
"3306","2841台開","110/07/16","日盛-信義",0,145,-145
"3307","2841台開","110/07/16","永豐金-豐原",75,0,75
"3308","2841台開","110/07/16","港商野村",0,103,-103
"3309","2841台開","110/07/16","台新-台中",76,10,66
"3310","2841台開","110/07/16","玉山-嘉義",5,54,-49
"3311","2841台開","110/07/16","中國信託-文心",51,5,46
"3312","2841台開","110/07/16","台新證券",22,63,-41
"3313","2841台開","110/07/16","華南永昌-新莊",41,10,31
"3314","2841台開","110/07/16","美商高盛",0,39,-39
"3315","2841台開","110/07/16","富邦-嘉義",30,0,30
"3316","2841台開","110/07/16","亞東-板橋",0,30,-30
"3317","2841台開","110/07/16","新光",26,0,26
"3318","2841台開","110/07/16","永豐金-北高雄",0,30,-30
"3319","2841台開","110/07/16","富邦-板橋",25,0,25
"3320","2841台開","110/07/16","日盛-忠孝",0,20,-20
"3321","2841台開","110/07/16","新光-台中",22,0,22
"3322","2841台開","110/07/16","元富-草屯",0,15,-15
"3323","2841台開","110/07/16","元大-承德",22,0,22
"3324","2841台開","110/07/16","永豐金-板新",0,12,-12
"3325","2841台開","110/07/16","日盛-三重",20,0,20
"3326","2841台開","110/07/16","第一金-華江",0,10,-10
"3327","2841台開","110/07/16","日盛-新莊",20,0,20
"3328","2841台開","110/07/16","兆豐-南京",0,10,-10
"3329","2841台開","110/07/16","凱基-台南",20,0,20
"3330","2841台開","110/07/16","國票-中港",0,10,-10
"3331","6207雷科","110/07/16","統一-平鎮",215,4,211
"3332","6207雷科","110/07/16","凱基-台北",344,628,-284
"3333","6207雷科","110/07/16","凱基-復興",166,6,160
"3334","6207雷科","110/07/16","新加坡商瑞銀",104,370,-266
"3335","6207雷科","110/07/16","永豐金-南京",141,3,138
"3336","6207雷科","110/07/16","摩根大通",193,430,-237
"3337","6207雷科","110/07/16","永豐金-內湖",117,1,116
"3338","6207雷科","110/07/16","富邦證券",0,150,-150
"3339","6207雷科","110/07/16","日盛證券",104,2,102
"3340","6207雷科","110/07/16","華南永昌-中正",26,169,-143
"3341","6207雷科","110/07/16","群益金鼎-古亭",74,2,72
"3342","6207雷科","110/07/16","凱基-敦北",1,142,-141
"3343","6207雷科","110/07/16","群益金鼎-東門",76,12,64
"3344","6207雷科","110/07/16","凱基-板橋",0,120,-120
"3345","6207雷科","110/07/16","日盛-板橋",78,25,53
"3346","6207雷科","110/07/16","元富-大昌",30,136,-106
"3347","6207雷科","110/07/16","元大-斗六",57,6,51
"3348","6207雷科","110/07/16","元大-北成功",26,97,-71
"3349","6207雷科","110/07/16","元大-頭份",53,3,50
"3350","6207雷科","110/07/16","新光-桃園",29,93,-64
"3351","6207雷科","110/07/16","群益金鼎-東大",56,11,45
"3352","6207雷科","110/07/16","新百王",27,90,-63
"3353","6207雷科","110/07/16","永豐金-虎尾",50,8,42
"3354","6207雷科","110/07/16","玉山-左營",16,72,-56
"3355","6207雷科","110/07/16","元大-西門",39,1,38
"3356","6207雷科","110/07/16","群益金鼎-中壢",3,54,-51
"3357","6207雷科","110/07/16","凱基-竹科",38,1,37
"3358","6207雷科","110/07/16","元富-中原",21,67,-46
"3359","6207雷科","110/07/16","元富-世貿",50,15,35
"3360","6207雷科","110/07/16","大昌-桃園",26,70,-44
"3361","3679新至陞","110/07/16","元大-成功",17,1,16
"3362","3679新至陞","110/07/16","國票-桃園",0,11,-11
"3363","3679新至陞","110/07/16","玉山-台大",5,0,5
"3364","3679新至陞","110/07/16","富邦-台北",0,10,-10
"3365","3679新至陞","110/07/16","日盛-員林",4,0,4
"3366","3679新至陞","110/07/16","富邦-苗栗",0,10,-10
"3367","3679新至陞","110/07/16","凱基-台北",6,2,4
"3368","3679新至陞","110/07/16","元大-永春",0,6,-6
"3369","3679新至陞","110/07/16","台灣摩根士丹利",3,0,3
"3370","3679新至陞","110/07/16","美林",0,5,-5
"3371","3679新至陞","110/07/16","凱基-中山",3,0,3
"3372","3679新至陞","110/07/16","瑞士信貸",3,7,-4
"3373","3679新至陞","110/07/16","元大-承德",3,0,3
"3374","3679新至陞","110/07/16","宏遠-館前",0,3,-3
"3375","3679新至陞","110/07/16","元大-汐止",4,1,3
"3376","3679新至陞","110/07/16","元大-東港",0,3,-3
"3377","3679新至陞","110/07/16","日盛-大墩",2,0,2
"3378","3679新至陞","110/07/16","元大證券",0,2,-2
"3379","3679新至陞","110/07/16","玉山-城中",2,0,2
"3380","3679新至陞","110/07/16","永豐金-板新",0,2,-2
"3381","3679新至陞","110/07/16","華南永昌-內壢",2,0,2
"3382","3679新至陞","110/07/16","臺銀-民權",0,1,-1
"3383","3679新至陞","110/07/16","元大-台南",2,0,2
"3384","3679新至陞","110/07/16","日盛-台中",0,1,-1
"3385","3679新至陞","110/07/16","元大-大同",2,0,2
"3386","3679新至陞","110/07/16","日盛-鳳山",0,1,-1
"3387","3679新至陞","110/07/16","臺銀-高雄",1,0,1
"3388","3679新至陞","110/07/16","元富-古亭",0,1,-1
"3389","3679新至陞","110/07/16","日盛-樹林",1,0,1
"3390","3679新至陞","110/07/16","元富-新興",0,1,-1
"3391","2727王品","110/07/16","富邦證券",570,0,570
"3392","2727王品","110/07/16","台新證券",27,77,-50
"3393","2727王品","110/07/16","兆豐-南京",200,0,200
"3394","2727王品","110/07/16","台灣摩根士丹利",4,47,-43
"3395","2727王品","110/07/16","瑞士信貸",133,2,131
"3396","2727王品","110/07/16","永豐金-大園",0,33,-33
"3397","2727王品","110/07/16","美林",121,26,95
"3398","2727王品","110/07/16","元大-北屯",0,32,-32
"3399","2727王品","110/07/16","統一",103,43,60
"3400","2727王品","110/07/16","富邦-南屯",1,30,-29
"3401","2727王品","110/07/16","中國信託-忠孝",36,2,34
"3402","2727王品","110/07/16","元大-基隆孝二",0,29,-29
"3403","2727王品","110/07/16","元大證券",68,45,23
"3404","2727王品","110/07/16","日盛-忠孝",4,30,-26
"3405","2727王品","110/07/16","合庫-彰化",22,1,21
"3406","2727王品","110/07/16","新光-新竹",1,21,-20
"3407","2727王品","110/07/16","港商野村",126,105,21
"3408","2727王品","110/07/16","凱基-台北",94,113,-19
"3409","2727王品","110/07/16","元富-板橋",22,1,21
"3410","2727王品","110/07/16","富邦-虎尾",1,19,-18
"3411","2727王品","110/07/16","新加坡商瑞銀",36,18,18
"3412","2727王品","110/07/16","元大-南京",0,17,-17
"3413","2727王品","110/07/16","國泰證券",20,5,15
"3414","2727王品","110/07/16","日盛-鳳山",2,18,-16
"3415","2727王品","110/07/16","日盛-桃園",13,1,12
"3416","2727王品","110/07/16","新光",34,50,-16
"3417","2727王品","110/07/16","凱基-市政",12,1,11
"3418","2727王品","110/07/16","富邦-台北",2,18,-16
"3419","2727王品","110/07/16","元大-嘉義",14,3,11
"3420","2727王品","110/07/16","國票-內壢",1,15,-14
"3421","1570力肯","110/07/16","新光",71,6,65
"3422","1570力肯","110/07/16","元大-高雄",0,23,-23
"3423","1570力肯","110/07/16","國票-北高雄",21,0,21
"3424","1570力肯","110/07/16","合庫-台南",0,20,-20
"3425","1570力肯","110/07/16","凱基-台北",17,1,16
"3426","1570力肯","110/07/16","元富-新店",0,15,-15
"3427","1570力肯","110/07/16","群益金鼎-高雄",15,0,15
"3428","1570力肯","110/07/16","元大-東港",0,10,-10
"3429","1570力肯","110/07/16","富邦-建國",10,0,10
"3430","1570力肯","110/07/16","中國信託",0,7,-7
"3431","1570力肯","110/07/16","元大-士林",5,0,5
"3432","1570力肯","110/07/16","台新證券",0,6,-6
"3433","1570力肯","110/07/16","瑞士信貸",3,0,3
"3434","1570力肯","110/07/16","日盛-信義",0,5,-5
"3435","1570力肯","110/07/16","臺銀-高雄",2,0,2
"3436","1570力肯","110/07/16","宏遠-館前",0,5,-5
"3437","1570力肯","110/07/16","華南永昌",2,0,2
"3438","1570力肯","110/07/16","國泰-館前",0,5,-5
"3439","1570力肯","110/07/16","元富-同大",1,0,1
"3440","1570力肯","110/07/16","富邦-園區",0,5,-5
"3441","1570力肯","110/07/16","兆豐-麻豆",1,0,1
"3442","1570力肯","110/07/16","永豐金-中正",0,5,-5
"3443","1570力肯","110/07/16","國泰-板橋",1,0,1
"3444","1570力肯","110/07/16","(牛牛牛)亞-鑫豐",0,4,-4
"3445","1570力肯","110/07/16","群益金鼎-東湖",1,0,1
"3446","1570力肯","110/07/16","台中銀-員林",0,3,-3
"3447","1570力肯","110/07/16","元大-東泰",1,0,1
"3448","1570力肯","110/07/16","玉山-新莊",0,3,-3
"3449","1570力肯","110/07/16","元大-南勢角",1,0,1
"3450","1570力肯","110/07/16","凱基-長庚",0,3,-3
"3451","6180橘子","110/07/16","日盛-文化",71,5,66
"3452","6180橘子","110/07/16","凱基-台北",110,238,-128
"3453","6180橘子","110/07/16","新加坡商瑞銀",75,19,56
"3454","6180橘子","110/07/16","摩根大通",77,161,-84
"3455","6180橘子","110/07/16","瑞士信貸",51,0,51
"3456","6180橘子","110/07/16","元富-高雄",0,62,-62
"3457","6180橘子","110/07/16","台灣企銀-屏東",50,0,50
"3458","6180橘子","110/07/16","美商高盛",0,40,-40
"3459","6180橘子","110/07/16","元大-桃園",52,2,50
"3460","6180橘子","110/07/16","合庫-自強",0,37,-37
"3461","6180橘子","110/07/16","康和-台北",51,10,41
"3462","6180橘子","110/07/16","美林",15,48,-33
"3463","6180橘子","110/07/16","群益金鼎-屏東",61,20,41
"3464","6180橘子","110/07/16","元富-四維",0,32,-32
"3465","6180橘子","110/07/16","元大-彰化",33,2,31
"3466","6180橘子","110/07/16","新光",63,92,-29
"3467","6180橘子","110/07/16","台中銀-台北",30,0,30
"3468","6180橘子","110/07/16","新光-台南",6,28,-22
"3469","6180橘子","110/07/16","福勝",29,3,26
"3470","6180橘子","110/07/16","港商野村",28,49,-21
"3471","6180橘子","110/07/16","兆豐證券",21,0,21
"3472","6180橘子","110/07/16","統一",2,23,-21
"3473","6180橘子","110/07/16","華南永昌-頭份",20,0,20
"3474","6180橘子","110/07/16","元大-豐原站前",3,21,-18
"3475","6180橘子","110/07/16","富邦-台北",25,5,20
"3476","6180橘子","110/07/16","豐農",3,20,-17
"3477","6180橘子","110/07/16","富邦-員林",23,4,19
"3478","6180橘子","110/07/16","安泰-大發",0,17,-17
"3479","6180橘子","110/07/16","台新-新莊",20,2,18
"3480","6180橘子","110/07/16","群益金鼎",2,19,-17
"3481","2390云辰","110/07/16","兆豐-天母",642,7,635
"3482","2390云辰","110/07/16","凱基",0,5007,-5007
"3483","2390云辰","110/07/16","華南永昌-鳳山",339,35,304
"3484","2390云辰","110/07/16","凱基-台北",1224,2306,-1082
"3485","2390云辰","110/07/16","第一金-大稻埕",269,13,256
"3486","2390云辰","110/07/16","元大證券",206,1177,-971
"3487","2390云辰","110/07/16","國泰-敦南",665,427,238
"3488","2390云辰","110/07/16","摩根大通",1073,1967,-894
"3489","2390云辰","110/07/16","富邦-建國",272,50,222
"3490","2390云辰","110/07/16","台灣摩根士丹利",232,671,-439
"3491","2390云辰","110/07/16","元大-信義",180,15,165
"3492","2390云辰","110/07/16","美林",187,496,-309
"3493","2390云辰","110/07/16","瑞士信貸",155,0,155
"3494","2390云辰","110/07/16","港商野村",680,950,-270
"3495","2390云辰","110/07/16","台新證券",461,317,144
"3496","2390云辰","110/07/16","永豐金-中正",18,170,-152
"3497","2390云辰","110/07/16","兆豐-公益",148,11,137
"3498","2390云辰","110/07/16","元富-板橋",30,169,-139
"3499","2390云辰","110/07/16","元大-土城學府",197,61,136
"3500","2390云辰","110/07/16","新加坡商瑞銀",61,175,-114
"3501","2390云辰","110/07/16","元大-天母",232,122,110
"3502","2390云辰","110/07/16","聯邦商銀",54,167,-113
"3503","2390云辰","110/07/16","凱基-基隆",109,2,107
"3504","2390云辰","110/07/16","群益金鼎-大甲",13,111,-98
"3505","2390云辰","110/07/16","元富-成功",110,5,105
"3506","2390云辰","110/07/16","統一-屏東",4,92,-88
"3507","2390云辰","110/07/16","統一-新營",118,14,104
"3508","2390云辰","110/07/16","凱基-大直",3,80,-77
"3509","2390云辰","110/07/16","國泰-板橋",268,170,98
"3510","2390云辰","110/07/16","元大-桃興",46,117,-71
"3511","2363矽統","110/07/15","康和-台中",626,61,565
"3512","2363矽統","110/07/15","新加坡商瑞銀",202,838,-636
"3513","2363矽統","110/07/15","摩根大通",1271,932,339
"3514","2363矽統","110/07/15","美林",185,720,-535
"3515","2363矽統","110/07/15","瑞士信貸",530,230,300
"3516","2363矽統","110/07/15","富邦-仁愛",60,583,-523
"3517","2363矽統","110/07/15","宏遠-桃園",281,0,281
"3518","2363矽統","110/07/15","元大-板橋",35,368,-333
"3519","2363矽統","110/07/15","大展",252,19,233
"3520","2363矽統","110/07/15","花旗環球",0,308,-308
"3521","2363矽統","110/07/15","凱基-台北",683,498,185
"3522","2363矽統","110/07/15","元富-成功",2,113,-111
"3523","2363矽統","110/07/15","永豐金證券",166,11,155
"3524","2363矽統","110/07/15","富邦-新營",23,132,-109
"3525","2363矽統","110/07/15","群益金鼎",157,5,152
"3526","2363矽統","110/07/15","臺銀-金山",197,304,-107
"3527","2363矽統","110/07/15","新光",333,229,104
"3528","2363矽統","110/07/15","日盛-二林",13,116,-103
"3529","2363矽統","110/07/15","永豐金-台南",130,26,104
"3530","2363矽統","110/07/15","台新-左楠",40,126,-86
"3531","2363矽統","110/07/15","國票-南京",100,0,100
"3532","2363矽統","110/07/15","康和-南崁",15,100,-85
"3533","2363矽統","110/07/15","群益金鼎-松山",150,50,100
"3534","2363矽統","110/07/15","永豐金-員林",9,91,-82
"3535","2363矽統","110/07/15","中國信託-松江",103,5,98
"3536","2363矽統","110/07/15","光和-嘉義",5,78,-73
"3537","2363矽統","110/07/15","國票-新莊",187,92,95
"3538","2363矽統","110/07/15","日盛-板橋中山",3,73,-70
"3539","2363矽統","110/07/15","北城證券",216,126,90
"3540","2363矽統","110/07/15","元大證券",10,75,-65
"3541","8112至上","110/07/15","凱基-台北",535,32,503
"3542","8112至上","110/07/15","群益金鼎-台南",0,116,-116
"3543","8112至上","110/07/15","摩根大通",362,16,346
"3544","8112至上","110/07/15","華南永昌-高雄",2,112,-110
"3545","8112至上","110/07/15","台灣摩根士丹利",254,0,254
"3546","8112至上","110/07/15","永豐金-台南",27,128,-101
"3547","8112至上","110/07/15","花旗環球",159,0,159
"3548","8112至上","110/07/15","元大-東蘆",2,73,-71
"3549","8112至上","110/07/15","新加坡商瑞銀",95,2,93
"3550","8112至上","110/07/15","美林",3,66,-63
"3551","8112至上","110/07/15","玉山-嘉義",84,0,84
"3552","8112至上","110/07/15","元大-館前",0,62,-62
"3553","8112至上","110/07/15","新光",82,6,76
"3554","8112至上","110/07/15","元富-信義",0,50,-50
"3555","8112至上","110/07/15","瑞士信貸",80,7,73
"3556","8112至上","110/07/15","台新證券",35,82,-47
"3557","8112至上","110/07/15","美商高盛",64,0,64
"3558","8112至上","110/07/15","大慶-蘆洲",7,53,-46
"3559","8112至上","110/07/15","兆豐-小港",56,0,56
"3560","8112至上","110/07/15","國票-天祥",0,45,-45
"3561","8112至上","110/07/15","永豐金-內湖",60,11,49
"3562","8112至上","110/07/15","凱基-中山",1,45,-44
"3563","8112至上","110/07/15","永豐金-南投",46,1,45
"3564","8112至上","110/07/15","元大-士林",0,43,-43
"3565","8112至上","110/07/15","凱基-三重",40,0,40
"3566","8112至上","110/07/15","玉山-城中",4,44,-40
"3567","8112至上","110/07/15","台灣企銀",29,0,29
"3568","8112至上","110/07/15","凱基-彰化",0,39,-39
"3569","8112至上","110/07/15","元大-府城",42,14,28
"3570","8112至上","110/07/15","元富-花蓮",2,40,-38
"3571","1570力肯","110/07/15","群益金鼎-高雄",40,0,40
"3572","1570力肯","110/07/15","元大-高雄",0,12,-12
"3573","1570力肯","110/07/15","新光",40,8,32
"3574","1570力肯","110/07/15","永豐金-中正",0,10,-10
"3575","1570力肯","110/07/15","凱基-台北",20,2,18
"3576","1570力肯","110/07/15","國泰-松江",0,9,-9
"3577","1570力肯","110/07/15","凱基-天母",6,0,6
"3578","1570力肯","110/07/15","台新證券",0,8,-8
"3579","1570力肯","110/07/15","元富-新店",5,0,5
"3580","1570力肯","110/07/15","玉山證券",0,7,-7
"3581","1570力肯","110/07/15","凱基-中港",5,0,5
"3582","1570力肯","110/07/15","元大-府城",0,7,-7
"3583","1570力肯","110/07/15","富邦-園區",5,0,5
"3584","1570力肯","110/07/15","元大-板橋",0,6,-6
"3585","1570力肯","110/07/15","瑞士信貸",4,0,4
"3586","1570力肯","110/07/15","日盛-信義",0,5,-5
"3587","1570力肯","110/07/15","第一金-路竹",3,0,3
"3588","1570力肯","110/07/15","國票-和平",0,5,-5
"3589","1570力肯","110/07/15","摩根大通",3,0,3
"3590","1570力肯","110/07/15","元大-民雄",0,5,-5
"3591","1570力肯","110/07/15","凱基-桃園",3,0,3
"3592","1570力肯","110/07/15","統一-台中",0,4,-4
"3593","1570力肯","110/07/15","永豐金-苓雅",3,0,3
"3594","1570力肯","110/07/15","玉山-雙和",0,4,-4
"3595","1570力肯","110/07/15","統一-員林",2,0,2
"3596","1570力肯","110/07/15","凱基-敦北",0,4,-4
"3597","1570力肯","110/07/15","元大-永春",2,0,2
"3598","1570力肯","110/07/15","富邦-新店",0,4,-4
"3599","1570力肯","110/07/15","元大-土城永寧",2,0,2
"3600","1570力肯","110/07/15","日盛-板橋",0,3,-3
"3601","2929淘帝","110/07/15","港商野村",58,4,54
"3602","2929淘帝","110/07/15","日盛-園區",0,25,-25
"3603","2929淘帝","110/07/15","元大-民生",29,0,29
"3604","2929淘帝","110/07/15","兆豐-南京",0,20,-20
"3605","2929淘帝","110/07/15","新加坡商瑞銀",22,1,21
"3606","2929淘帝","110/07/15","玉山-高雄",0,18,-18
"3607","2929淘帝","110/07/15","凱基-台北",20,2,18
"3608","2929淘帝","110/07/15","富邦-南屯",1,15,-14
"3609","2929淘帝","110/07/15","大慶-中壢",15,1,14
"3610","2929淘帝","110/07/15","富邦-員林",0,13,-13
"3611","2929淘帝","110/07/15","日盛-和美",10,0,10
"3612","2929淘帝","110/07/15","凱基-站前",0,10,-10
"3613","2929淘帝","110/07/15","元大-員林",10,0,10
"3614","2929淘帝","110/07/15","元大-台中",0,10,-10
"3615","2929淘帝","110/07/15","凱基-基隆",6,0,6
"3616","2929淘帝","110/07/15","美林",10,19,-9
"3617","2929淘帝","110/07/15","臺銀-鳳山",5,0,5
"3618","2929淘帝","110/07/15","元大-新盛",0,8,-8
"3619","2929淘帝","110/07/15","第一金-路竹",5,0,5
"3620","2929淘帝","110/07/15","台新-台南",0,7,-7
"3621","2929淘帝","110/07/15","元富-大裕",5,0,5
"3622","2929淘帝","110/07/15","元大-大天母",0,7,-7
"3623","2929淘帝","110/07/15","玉山-大里",5,0,5
"3624","2929淘帝","110/07/15","華南永昌-虎尾",0,6,-6
"3625","2929淘帝","110/07/15","元大-博愛",5,0,5
"3626","2929淘帝","110/07/15","永豐金證券",0,6,-6
"3627","2929淘帝","110/07/15","永豐金-新莊",5,0,5
"3628","2929淘帝","110/07/15","兆豐-竹北",0,5,-5
"3629","2929淘帝","110/07/15","元大-南崁",4,0,4
"3630","2929淘帝","110/07/15","元大-文心興安",0,5,-5
"3631","5410國眾","110/07/15","香港上海匯豐",18,0,18
"3632","5410國眾","110/07/15","元大-南屯",0,18,-18
"3633","5410國眾","110/07/15","摩根大通",15,0,15
"3634","5410國眾","110/07/15","亞東-新竹",0,15,-15
"3635","5410國眾","110/07/15","日盛-士林",10,0,10
"3636","5410國眾","110/07/15","兆豐-台中港",0,15,-15
"3637","5410國眾","110/07/15","群益金鼎-嘉義",10,0,10
"3638","5410國眾","110/07/15","日盛-板橋",0,12,-12
"3639","5410國眾","110/07/15","元大-高雄",10,0,10
"3640","5410國眾","110/07/15","台中銀-豐原",0,9,-9
"3641","5410國眾","110/07/15","元大-東港",10,0,10
"3642","5410國眾","110/07/15","臺銀-臺南",3,10,-7
"3643","5410國眾","110/07/15","臺銀",10,5,5
"3644","5410國眾","110/07/15","瑞士信貸",0,5,-5
"3645","5410國眾","110/07/15","台新-新營",5,0,5
"3646","5410國眾","110/07/15","統一-員林",0,5,-5
"3647","5410國眾","110/07/15","富邦-台北",5,0,5
"3648","5410國眾","110/07/15","大昌-樹林",0,5,-5
"3649","5410國眾","110/07/15","日盛-屏東",4,0,4
"3650","5410國眾","110/07/15","兆豐-來福",0,5,-5
"3651","5410國眾","110/07/15","高橋",5,1,4
"3652","5410國眾","110/07/15","豐農",0,5,-5
"3653","5410國眾","110/07/15","中國信託-新竹",4,1,3
"3654","5410國眾","110/07/15","元大-大里",0,5,-5
"3655","5410國眾","110/07/15","富邦-建國",3,0,3
"3656","5410國眾","110/07/15","港商野村",0,3,-3
"3657","5410國眾","110/07/15","永豐金-桃園",3,0,3
"3658","5410國眾","110/07/15","中農",0,3,-3
"3659","5410國眾","110/07/15","大展",2,0,2
"3660","5410國眾","110/07/15","國泰-忠孝",0,3,-3
"3661","2841台開","110/07/15","日盛證券",310,0,310
"3662","2841台開","110/07/15","港商野村",0,97,-97
"3663","2841台開","110/07/15","元富-城東",100,0,100
"3664","2841台開","110/07/15","元大-員林",0,77,-77
"3665","2841台開","110/07/15","凱基-文心",30,0,30
"3666","2841台開","110/07/15","新光",3,73,-70
"3667","2841台開","110/07/15","日盛-雙和",24,0,24
"3668","2841台開","110/07/15","永豐金-北高雄",0,30,-30
"3669","2841台開","110/07/15","第一金-台中",20,0,20
"3670","2841台開","110/07/15","華南永昌",0,25,-25
"3671","2841台開","110/07/15","豐農",20,0,20
"3672","2841台開","110/07/15","日盛-台南",0,20,-20
"3673","2841台開","110/07/15","華南永昌-新莊",19,0,19
"3674","2841台開","110/07/15","致和-佳里",0,20,-20
"3675","2841台開","110/07/15","玉山-大里",12,0,12
"3676","2841台開","110/07/15","國票-中港",0,20,-20
"3677","2841台開","110/07/15","元富-安南",10,0,10
"3678","2841台開","110/07/15","元大-歸仁",0,20,-20
"3679","2841台開","110/07/15","凱基-市政",10,0,10
"3680","2841台開","110/07/15","統一-三多",0,19,-19
"3681","2841台開","110/07/15","凱基-竹科",10,0,10
"3682","2841台開","110/07/15","凱基-城中",0,18,-18
"3683","2841台開","110/07/15","國泰-板橋",10,1,9
"3684","2841台開","110/07/15","國票-中和",0,15,-15
"3685","2841台開","110/07/15","凱基-台北",9,0,9
"3686","2841台開","110/07/15","元大-彰化",0,15,-15
"3687","2841台開","110/07/15","合庫證券",6,0,6
"3688","2841台開","110/07/15","元大-復北",0,15,-15
"3689","2841台開","110/07/15","台中銀",6,0,6
"3690","2841台開","110/07/15","土銀-花蓮",0,14,-14
"3691","6207雷科","110/07/15","凱基-板橋",210,45,165
"3692","6207雷科","110/07/15","群益金鼎-台北",20,80,-60
"3693","6207雷科","110/07/15","富邦證券",150,0,150
"3694","6207雷科","110/07/15","元大-大天母",1,56,-55
"3695","6207雷科","110/07/15","凱基-復興",140,0,140
"3696","6207雷科","110/07/15","大慶-中壢",2,50,-48
"3697","6207雷科","110/07/15","華南永昌-中正",140,0,140
"3698","6207雷科","110/07/15","元富-林園",0,47,-47
"3699","6207雷科","110/07/15","永豐金-內湖",92,10,82
"3700","6207雷科","110/07/15","元大-東門",0,40,-40
"3701","6207雷科","110/07/15","富邦-彰化",81,11,70
"3702","6207雷科","110/07/15","第一金-安和",0,37,-37
"3703","6207雷科","110/07/15","(牛牛牛)亞-網路",67,0,67
"3704","6207雷科","110/07/15","凱基-台北",61,97,-36
"3705","6207雷科","110/07/15","台新證券",60,8,52
"3706","6207雷科","110/07/15","國票-南科",0,32,-32
"3707","6207雷科","110/07/15","華南永昌",50,3,47
"3708","6207雷科","110/07/15","元大-四維",0,32,-32
"3709","6207雷科","110/07/15","新加坡商瑞銀",68,26,42
"3710","6207雷科","110/07/15","元大-板橋",0,30,-30
"3711","6207雷科","110/07/15","日盛-景美",40,0,40
"3712","6207雷科","110/07/15","元大-南崁",1,30,-29
"3713","6207雷科","110/07/15","元富-大昌",40,0,40
"3714","6207雷科","110/07/15","凱基-岡山",0,27,-27
"3715","6207雷科","110/07/15","統一-高雄",38,5,33
"3716","6207雷科","110/07/15","統一-新竹",0,26,-26
"3717","6207雷科","110/07/15","日盛證券",32,0,32
"3718","6207雷科","110/07/15","群益金鼎-三民",1,27,-26
"3719","6207雷科","110/07/15","華南永昌-頭份",31,0,31
"3720","6207雷科","110/07/15","國票-台中",0,25,-25
"3721","3679新至陞","110/07/15","群益金鼎-大安",25,0,25
"3722","3679新至陞","110/07/15","元大-成功",0,10,-10
"3723","3679新至陞","110/07/15","元大-彰化",13,0,13
"3724","3679新至陞","110/07/15","群益金鼎-東大",0,8,-8
"3725","3679新至陞","110/07/15","國票-桃園",10,0,10
"3726","3679新至陞","110/07/15","凱基-台北",4,12,-8
"3727","3679新至陞","110/07/15","群益金鼎-台南",10,0,10
"3728","3679新至陞","110/07/15","第一金-華江",0,5,-5
"3729","3679新至陞","110/07/15","華南永昌-台中",10,0,10
"3730","3679新至陞","110/07/15","兆豐-來福",0,5,-5
"3731","3679新至陞","110/07/15","港商野村",9,0,9
"3732","3679新至陞","110/07/15","元大-北三重",0,5,-5
"3733","3679新至陞","110/07/15","元大-永春",6,0,6
"3734","3679新至陞","110/07/15","瑞士信貸",0,4,-4
"3735","3679新至陞","110/07/15","(牛牛牛)亞-網路",5,0,5
"3736","3679新至陞","110/07/15","新加坡商瑞銀",0,4,-4
"3737","3679新至陞","110/07/15","凱基-高雄",5,0,5
"3738","3679新至陞","110/07/15","元大-汐止",0,4,-4
"3739","3679新至陞","110/07/15","美商高盛",6,2,4
"3740","3679新至陞","110/07/15","台中銀-員林",0,3,-3
"3741","3679新至陞","110/07/15","台新證券",3,1,2
"3742","3679新至陞","110/07/15","兆豐-忠孝",0,3,-3
"3743","3679新至陞","110/07/15","群益金鼎-大興",2,0,2
"3744","3679新至陞","110/07/15","玉山-新莊",0,3,-3
"3745","3679新至陞","110/07/15","元大-六合",2,0,2
"3746","3679新至陞","110/07/15","永豐金-屏東",0,3,-3
"3747","3679新至陞","110/07/15","彰銀",1,0,1
"3748","3679新至陞","110/07/15","永豐金-敦南",0,3,-3
"3749","3679新至陞","110/07/15","美林",2,1,1
"3750","3679新至陞","110/07/15","永豐金-萬盛",0,3,-3
"3751","2727王品","110/07/15","兆豐-南京",101,0,101
"3752","2727王品","110/07/15","富邦-左營",0,102,-102
"3753","2727王品","110/07/15","港商野村",166,73,93
"3754","2727王品","110/07/15","日盛-忠孝",2,32,-30
"3755","2727王品","110/07/15","瑞士信貸",97,8,89
"3756","2727王品","110/07/15","群益金鼎-古亭",2,24,-22
"3757","2727王品","110/07/15","玉山證券",56,12,44
"3758","2727王品","110/07/15","日盛-八德",0,21,-21
"3759","2727王品","110/07/15","第一金-高雄",43,1,42
"3760","2727王品","110/07/15","元大-新盛",2,23,-21
"3761","2727王品","110/07/15","台新證券",74,45,29
"3762","2727王品","110/07/15","摩根大通",53,72,-19
"3763","2727王品","110/07/15","康和-澎湖",27,0,27
"3764","2727王品","110/07/15","富邦-彰化",8,26,-18
"3765","2727王品","110/07/15","富邦-陽明",31,4,27
"3766","2727王品","110/07/15","富邦-台中",7,24,-17
"3767","2727王品","110/07/15","國票-北高雄",27,1,26
"3768","2727王品","110/07/15","新加坡商瑞銀",13,29,-16
"3769","2727王品","110/07/15","國泰-板橋",38,12,26
"3770","2727王品","110/07/15","國泰-敦南",35,50,-15
"3771","2727王品","110/07/15","凱基-興隆",23,0,23
"3772","2727王品","110/07/15","元大-龍潭",0,14,-14
"3773","2727王品","110/07/15","凱基-板橋",29,7,22
"3774","2727王品","110/07/15","中國信託-文心",8,21,-13
"3775","2727王品","110/07/15","合庫-彰化",21,0,21
"3776","2727王品","110/07/15","永豐金-竹科",2,15,-13
"3777","2727王品","110/07/15","土銀-南港",20,0,20
"3778","2727王品","110/07/15","臺銀-臺南",2,14,-12
"3779","2727王品","110/07/15","美林",37,18,19
"3780","2727王品","110/07/15","凱基-台北",56,68,-12
"3781","1570力肯","110/07/15","群益金鼎-高雄",40,0,40
"3782","1570力肯","110/07/15","元大-高雄",0,12,-12
"3783","1570力肯","110/07/15","新光",40,8,32
"3784","1570力肯","110/07/15","永豐金-中正",0,10,-10
"3785","1570力肯","110/07/15","凱基-台北",20,2,18
"3786","1570力肯","110/07/15","國泰-松江",0,9,-9
"3787","1570力肯","110/07/15","凱基-天母",6,0,6
"3788","1570力肯","110/07/15","台新證券",0,8,-8
"3789","1570力肯","110/07/15","元富-新店",5,0,5
"3790","1570力肯","110/07/15","玉山證券",0,7,-7
"3791","1570力肯","110/07/15","凱基-中港",5,0,5
"3792","1570力肯","110/07/15","元大-府城",0,7,-7
"3793","1570力肯","110/07/15","富邦-園區",5,0,5
"3794","1570力肯","110/07/15","元大-板橋",0,6,-6
"3795","1570力肯","110/07/15","瑞士信貸",4,0,4
"3796","1570力肯","110/07/15","日盛-信義",0,5,-5
"3797","1570力肯","110/07/15","第一金-路竹",3,0,3
"3798","1570力肯","110/07/15","國票-和平",0,5,-5
"3799","1570力肯","110/07/15","摩根大通",3,0,3
"3800","1570力肯","110/07/15","元大-民雄",0,5,-5
"3801","1570力肯","110/07/15","凱基-桃園",3,0,3
"3802","1570力肯","110/07/15","統一-台中",0,4,-4
"3803","1570力肯","110/07/15","永豐金-苓雅",3,0,3
"3804","1570力肯","110/07/15","玉山-雙和",0,4,-4
"3805","1570力肯","110/07/15","統一-員林",2,0,2
"3806","1570力肯","110/07/15","凱基-敦北",0,4,-4
"3807","1570力肯","110/07/15","元大-永春",2,0,2
"3808","1570力肯","110/07/15","富邦-新店",0,4,-4
"3809","1570力肯","110/07/15","元大-土城永寧",2,0,2
"3810","1570力肯","110/07/15","日盛-板橋",0,3,-3
"3811","6180橘子","110/07/15","兆豐證券",130,0,130
"3812","6180橘子","110/07/15","港商野村",21,137,-116
"3813","6180橘子","110/07/15","摩根大通",111,0,111
"3814","6180橘子","110/07/15","高橋",0,40,-40
"3815","6180橘子","110/07/15","石橋證券",80,0,80
"3816","6180橘子","110/07/15","臺銀",1,40,-39
"3817","6180橘子","110/07/15","凱基-台北",78,26,52
"3818","6180橘子","110/07/15","玉山-桃園",0,35,-35
"3819","6180橘子","110/07/15","新加坡商瑞銀",38,1,37
"3820","6180橘子","110/07/15","玉山-台南",2,33,-31
"3821","6180橘子","110/07/15","富邦-員林",32,0,32
"3822","6180橘子","110/07/15","統一-南京",0,30,-30
"3823","6180橘子","110/07/15","日盛-文化",23,0,23
"3824","6180橘子","110/07/15","康和-台南",0,25,-25
"3825","6180橘子","110/07/15","元富-新店",20,0,20
"3826","6180橘子","110/07/15","大昌-樹林",0,22,-22
"3827","6180橘子","110/07/15","美林",15,0,15
"3828","6180橘子","110/07/15","康和-新竹",0,20,-20
"3829","6180橘子","110/07/15","新光-新竹",17,2,15
"3830","6180橘子","110/07/15","群益金鼎-台中",0,20,-20
"3831","6180橘子","110/07/15","富邦-嘉義",12,0,12
"3832","6180橘子","110/07/15","元大-彰化民生",0,18,-18
"3833","6180橘子","110/07/15","花旗環球",11,0,11
"3834","6180橘子","110/07/15","元大-草屯",0,16,-16
"3835","6180橘子","110/07/15","第一金-新興",11,0,11
"3836","6180橘子","110/07/15","元富-潮州",0,13,-13
"3837","6180橘子","110/07/15","第一金-桃園",10,0,10
"3838","6180橘子","110/07/15","宏遠-台南",0,11,-11
"3839","6180橘子","110/07/15","永興",10,0,10
"3840","6180橘子","110/07/15","大慶-泰山",0,10,-10
"3841","2390云辰","110/07/15","凱基",5007,0,5007
"3842","2390云辰","110/07/15","凱基-台北",382,616,-234
"3843","2390云辰","110/07/15","元大證券",1006,25,981
"3844","2390云辰","110/07/15","富邦-陽明",69,265,-196
"3845","2390云辰","110/07/15","元大-天母",456,20,436
"3846","2390云辰","110/07/15","永豐金-桃園",63,255,-192
"3847","2390云辰","110/07/15","港商野村",975,675,300
"3848","2390云辰","110/07/15","富邦-仁愛",17,187,-170
"3849","2390云辰","110/07/15","摩根大通",1318,1040,278
"3850","2390云辰","110/07/15","日盛-和美",2,165,-163
"3851","2390云辰","110/07/15","國票-博愛",184,7,177
"3852","2390云辰","110/07/15","國泰-敦南",142,290,-148
"3853","2390云辰","110/07/15","群益金鼎-大甲",113,13,100
"3854","2390云辰","110/07/15","台灣摩根士丹利",51,197,-146
"3855","2390云辰","110/07/15","凱基-大直",89,2,87
"3856","2390云辰","110/07/15","國票-嘉義",4,148,-144
"3857","2390云辰","110/07/15","玉山-台中",77,8,69
"3858","2390云辰","110/07/15","台中銀",8,139,-131
"3859","2390云辰","110/07/15","聯邦商銀",70,4,66
"3860","2390云辰","110/07/15","元大-彰化民生",7,138,-131
"3861","2390云辰","110/07/15","元大-大里",88,25,63
"3862","2390云辰","110/07/15","元富-成功",2,111,-109
"3863","2390云辰","110/07/15","富邦-嘉義",542,480,62
"3864","2390云辰","110/07/15","元大-東泰",3,106,-103
"3865","2390云辰","110/07/15","新加坡商瑞銀",158,97,61
"3866","2390云辰","110/07/15","合庫-三重",1,102,-101
"3867","2390云辰","110/07/15","華南永昌-台中",86,35,51
"3868","2390云辰","110/07/15","元富-大裕",4,87,-83
"3869","2390云辰","110/07/15","群益金鼎",51,6,45
"3870","2390云辰","110/07/15","凱基-和平",17,96,-79
"3871","2363矽統","110/07/14","台灣摩根士丹利",463,0,463
"3872","2363矽統","110/07/14","新加坡商瑞銀",568,1321,-753
"3873","2363矽統","110/07/14","台新證券",750,342,408
"3874","2363矽統","110/07/14","瑞士信貸",149,864,-715
"3875","2363矽統","110/07/14","玉山-台中",363,51,312
"3876","2363矽統","110/07/14","台新-屏東",115,380,-265
"3877","2363矽統","110/07/14","元大-斗六",223,25,198
"3878","2363矽統","110/07/14","永豐金證券",16,265,-249
"3879","2363矽統","110/07/14","華南永昌-朴子",208,38,170
"3880","2363矽統","110/07/14","美林",462,701,-239
"3881","2363矽統","110/07/14","元富-西松",169,12,157
"3882","2363矽統","110/07/14","宏遠-桃園",269,500,-231
"3883","2363矽統","110/07/14","永豐金-大園",146,6,140
"3884","2363矽統","110/07/14","凱基-竹北",36,254,-218
"3885","2363矽統","110/07/14","土銀-和平",134,0,134
"3886","2363矽統","110/07/14","港商法國興業",0,214,-214
"3887","2363矽統","110/07/14","富邦-新營",130,13,117
"3888","2363矽統","110/07/14","港商野村",835,1044,-209
"3889","2363矽統","110/07/14","元富-成功",118,11,107
"3890","2363矽統","110/07/14","北城證券",212,411,-199
"3891","2363矽統","110/07/14","元富-烏日",121,18,103
"3892","2363矽統","110/07/14","(牛牛牛)亞-鑫豐",51,241,-190
"3893","2363矽統","110/07/14","日盛-二林",120,18,102
"3894","2363矽統","110/07/14","國票-博愛",24,213,-189
"3895","2363矽統","110/07/14","兆豐-忠孝",98,2,96
"3896","2363矽統","110/07/14","大慶-蘆洲",134,316,-182
"3897","2363矽統","110/07/14","大慶-楊梅",92,3,89
"3898","2363矽統","110/07/14","彰銀-台中",15,193,-178
"3899","2363矽統","110/07/14","元富-三重",120,33,87
"3900","2363矽統","110/07/14","日盛-和美",18,185,-167
"3901","8112至上","110/07/14","新加坡商瑞銀",223,17,206
"3902","8112至上","110/07/14","瑞士信貸",8,170,-162
"3903","8112至上","110/07/14","摩根大通",285,129,156
"3904","8112至上","110/07/14","美林",55,202,-147
"3905","8112至上","110/07/14","花旗環球",124,0,124
"3906","8112至上","110/07/14","凱基-台北",325,436,-111
"3907","8112至上","110/07/14","兆豐-公益",117,4,113
"3908","8112至上","110/07/14","台中銀-台北",0,98,-98
"3909","8112至上","110/07/14","香港上海匯豐",111,0,111
"3910","8112至上","110/07/14","玉山-台大",17,107,-90
"3911","8112至上","110/07/14","永豐金-內湖",117,21,96
"3912","8112至上","110/07/14","康和-內湖",1,90,-89
"3913","8112至上","110/07/14","台灣摩根士丹利",108,16,92
"3914","8112至上","110/07/14","港商野村",21,84,-63
"3915","8112至上","110/07/14","元大-東蘆",77,0,77
"3916","8112至上","110/07/14","兆豐-北高雄",1,60,-59
"3917","8112至上","110/07/14","新光",108,48,60
"3918","8112至上","110/07/14","群益金鼎-海山",1,52,-51
"3919","8112至上","110/07/14","大慶-蘆洲",59,0,59
"3920","8112至上","110/07/14","群益金鼎-大安",0,50,-50
"3921","8112至上","110/07/14","華南永昌-台中",56,3,53
"3922","8112至上","110/07/14","富邦-仁愛",2,49,-47
"3923","8112至上","110/07/14","土銀-嘉義",52,2,50
"3924","8112至上","110/07/14","元大-金華",0,42,-42
"3925","8112至上","110/07/14","美商高盛",40,0,40
"3926","8112至上","110/07/14","元大-內湖",4,43,-39
"3927","8112至上","110/07/14","臺銀",63,29,34
"3928","8112至上","110/07/14","第一金-華江",2,37,-35
"3929","8112至上","110/07/14","元富-嘉義",31,0,31
"3930","8112至上","110/07/14","永豐金-苓雅",2,34,-32
"3931","1570力肯","110/07/14","國票-北高雄",68,0,68
"3932","1570力肯","110/07/14","摩根大通",0,21,-21
"3933","1570力肯","110/07/14","日盛-八德",30,1,29
"3934","1570力肯","110/07/14","新光",1,19,-18
"3935","1570力肯","110/07/14","玉山-高雄",7,0,7
"3936","1570力肯","110/07/14","(牛牛牛)亞-鑫豐",0,17,-17
"3937","1570力肯","110/07/14","臺銀-臺南",5,0,5
"3938","1570力肯","110/07/14","日盛-士林",0,10,-10
"3939","1570力肯","110/07/14","凱基-三峽",5,0,5
"3940","1570力肯","110/07/14","統一-員林",0,10,-10
"3941","1570力肯","110/07/14","元大-和平",5,0,5
"3942","1570力肯","110/07/14","國票-新莊",0,10,-10
"3943","1570力肯","110/07/14","合庫-三重",4,0,4
"3944","1570力肯","110/07/14","凱基-高美館",0,10,-10
"3945","1570力肯","110/07/14","瑞士信貸",4,0,4
"3946","1570力肯","110/07/14","元大-屏東民生",0,5,-5
"3947","1570力肯","110/07/14","統一-三多",4,0,4
"3948","1570力肯","110/07/14","元大-古亭",0,5,-5
"3949","1570力肯","110/07/14","華南永昌-古亭",4,0,4
"3950","1570力肯","110/07/14","日盛-木柵",0,4,-4
"3951","1570力肯","110/07/14","元大-高雄",3,0,3
"3952","1570力肯","110/07/14","大昌",0,4,-4
"3953","1570力肯","110/07/14","兆豐-忠孝",2,0,2
"3954","1570力肯","110/07/14","群益金鼎-東大",0,4,-4
"3955","1570力肯","110/07/14","富邦-陽明",2,0,2
"3956","1570力肯","110/07/14","凱基-台北",0,4,-4
"3957","1570力肯","110/07/14","元大-松山",2,0,2
"3958","1570力肯","110/07/14","元大-板橋",0,4,-4
"3959","1570力肯","110/07/14","元大-忠孝",2,0,2
"3960","1570力肯","110/07/14","第一金-中山",0,3,-3
"3961","2929淘帝","110/07/14","華南永昌-林口",60,0,60
"3962","2929淘帝","110/07/14","群益金鼎",25,540,-515
"3963","2929淘帝","110/07/14","美林",87,31,56
"3964","2929淘帝","110/07/14","國泰-台南",1,30,-29
"3965","2929淘帝","110/07/14","元富-台南",40,0,40
"3966","2929淘帝","110/07/14","宏遠-桃園",0,20,-20
"3967","2929淘帝","110/07/14","元大-民生",39,0,39
"3968","2929淘帝","110/07/14","摩根大通",11,31,-20
"3969","2929淘帝","110/07/14","臺銀-鳳山",34,0,34
"3970","2929淘帝","110/07/14","台新-建北",5,20,-15
"3971","2929淘帝","110/07/14","合庫-高雄",34,1,33
"3972","2929淘帝","110/07/14","新光",1,16,-15
"3973","2929淘帝","110/07/14","華南永昌-鶯歌",28,0,28
"3974","2929淘帝","110/07/14","玉山-板橋",0,15,-15
"3975","2929淘帝","110/07/14","永興",25,0,25
"3976","2929淘帝","110/07/14","凱基-羅東",0,15,-15
"3977","2929淘帝","110/07/14","元大-新盛",25,1,24
"3978","2929淘帝","110/07/14","元大-頭份",0,15,-15
"3979","2929淘帝","110/07/14","日盛-南京",23,0,23
"3980","2929淘帝","110/07/14","第一金-台南",0,13,-13
"3981","2929淘帝","110/07/14","日茂",20,0,20
"3982","2929淘帝","110/07/14","富邦-基隆",0,12,-12
"3983","2929淘帝","110/07/14","台新-台中",20,0,20
"3984","2929淘帝","110/07/14","日茂-南投",1,12,-11
"3985","2929淘帝","110/07/14","華南永昌",20,0,20
"3986","2929淘帝","110/07/14","元大-豐原站前",0,11,-11
"3987","2929淘帝","110/07/14","福勝",15,0,15
"3988","2929淘帝","110/07/14","玉山-士林",0,10,-10
"3989","2929淘帝","110/07/14","富邦-南屯",15,0,15
"3990","2929淘帝","110/07/14","富邦-台北",0,10,-10
"3991","5410國眾","110/07/14","兆豐-城中",35,0,35
"3992","5410國眾","110/07/14","瑞士信貸",0,29,-29
"3993","5410國眾","110/07/14","新光",21,1,20
"3994","5410國眾","110/07/14","國泰-板橋",1,30,-29
"3995","5410國眾","110/07/14","國泰-敦南",21,1,20
"3996","5410國眾","110/07/14","日盛-高雄",0,20,-20
"3997","5410國眾","110/07/14","國泰-台中",20,1,19
"3998","5410國眾","110/07/14","台新-左楠",1,20,-19
"3999","5410國眾","110/07/14","元大-崇德",19,0,19
"4000","5410國眾","110/07/14","元富-大昌",1,18,-17
"4001","5410國眾","110/07/14","土銀-士林",18,0,18
"4002","5410國眾","110/07/14","富邦-建國",0,15,-15
"4003","5410國眾","110/07/14","元大-新盛",20,2,18
"4004","5410國眾","110/07/14","元富-嘉義",0,12,-12
"4005","5410國眾","110/07/14","兆豐-高雄",15,0,15
"4006","5410國眾","110/07/14","永全-南崁",0,12,-12
"4007","5410國眾","110/07/14","宏遠-中和",10,0,10
"4008","5410國眾","110/07/14","元大-員林",0,11,-11
"4009","5410國眾","110/07/14","新光-桃園",10,0,10
"4010","5410國眾","110/07/14","高橋",0,10,-10
"4011","5410國眾","110/07/14","國泰-台南",10,0,10
"4012","5410國眾","110/07/14","永興",0,10,-10
"4013","5410國眾","110/07/14","元大-復北",10,0,10
"4014","5410國眾","110/07/14","華南永昌-三重",0,10,-10
"4015","5410國眾","110/07/14","元大-竹科",8,0,8
"4016","5410國眾","110/07/14","元大-苑裡",0,7,-7
"4017","5410國眾","110/07/14","台新-新營",6,0,6
"4018","5410國眾","110/07/14","港商野村",0,6,-6
"4019","5410國眾","110/07/14","日盛-士林",5,0,5
"4020","5410國眾","110/07/14","摩根大通",5,11,-6
"4021","2841台開","110/07/14","凱基-文心",73,0,73
"4022","2841台開","110/07/14","國泰-敦南",0,50,-50
"4023","2841台開","110/07/14","元富-潮州",30,0,30
"4024","2841台開","110/07/14","凱基-中壢",0,40,-40
"4025","2841台開","110/07/14","第一金-台中",20,0,20
"4026","2841台開","110/07/14","統一-新竹",0,24,-24
"4027","2841台開","110/07/14","華南永昌-新莊",20,0,20
"4028","2841台開","110/07/14","元富-草屯",0,20,-20
"4029","2841台開","110/07/14","永豐金-豐原",20,0,20
"4030","2841台開","110/07/14","台新-台南",0,20,-20
"4031","2841台開","110/07/14","國泰-館前",15,0,15
"4032","2841台開","110/07/14","永豐金-敦南",45,63,-18
"4033","2841台開","110/07/14","群益金鼎-基隆",12,0,12
"4034","2841台開","110/07/14","國票-北高雄",0,13,-13
"4035","2841台開","110/07/14","日盛-信義",10,0,10
"4036","2841台開","110/07/14","凱基-松山",0,10,-10
"4037","2841台開","110/07/14","台新-台中",10,0,10
"4038","2841台開","110/07/14","元大證券",0,10,-10
"4039","2841台開","110/07/14","新光",10,1,9
"4040","2841台開","110/07/14","元大-中壢",0,10,-10
"4041","2841台開","110/07/14","凱基-新店",8,0,8
"4042","2841台開","110/07/14","富邦-陽明",1,10,-9
"4043","2841台開","110/07/14","元大-斗信",7,0,7
"4044","2841台開","110/07/14","富邦-建國",0,9,-9
"4045","2841台開","110/07/14","元大-三重",6,0,6
"4046","2841台開","110/07/14","富邦-台南",0,8,-8
"4047","2841台開","110/07/14","永豐金-中和",6,0,6
"4048","2841台開","110/07/14","康和-澎湖",0,7,-7
"4049","2841台開","110/07/14","元富-成功",5,0,5
"4050","2841台開","110/07/14","日盛-斗六",0,6,-6
"4051","6207雷科","110/07/14","群益金鼎-台北",60,0,60
"4052","6207雷科","110/07/14","新加坡商瑞銀",10,56,-46
"4053","6207雷科","110/07/14","台新-高雄",43,3,40
"4054","6207雷科","110/07/14","國票-中和",0,41,-41
"4055","6207雷科","110/07/14","元大-高雄",19,0,19
"4056","6207雷科","110/07/14","元大-復北",0,33,-33
"4057","6207雷科","110/07/14","福勝",15,0,15
"4058","6207雷科","110/07/14","光和-和美",0,20,-20
"4059","6207雷科","110/07/14","群益金鼎-中山",15,0,15
"4060","6207雷科","110/07/14","群益金鼎-丹鳳",0,20,-20
"4061","6207雷科","110/07/14","元大-林園",15,0,15
"4062","6207雷科","110/07/14","第一金-路竹",0,10,-10
"4063","6207雷科","110/07/14","新光",12,0,12
"4064","6207雷科","110/07/14","元大-歸仁",0,10,-10
"4065","6207雷科","110/07/14","元大-大天母",10,0,10
"4066","6207雷科","110/07/14","宏遠-館前",0,9,-9
"4067","6207雷科","110/07/14","永豐金-忠孝",9,0,9
"4068","6207雷科","110/07/14","凱基-台北",12,20,-8
"4069","6207雷科","110/07/14","永豐金-新店",7,0,7
"4070","6207雷科","110/07/14","美林",0,7,-7
"4071","6207雷科","110/07/14","玉山-嘉義",6,0,6
"4072","6207雷科","110/07/14","摩根大通",16,23,-7
"4073","6207雷科","110/07/14","元大-屏東",6,0,6
"4074","6207雷科","110/07/14","凱基-高雄",1,7,-6
"4075","6207雷科","110/07/14","凱基-大安",5,0,5
"4076","6207雷科","110/07/14","台中銀-豐原",0,5,-5
"4077","6207雷科","110/07/14","富邦-台南",5,0,5
"4078","6207雷科","110/07/14","元大-新竹經國",0,5,-5
"4079","6207雷科","110/07/14","元大-成功",5,0,5
"4080","6207雷科","110/07/14","光和-田中",0,4,-4
"4081","3679新至陞","110/07/14","凱基-台北",31,6,25
"4082","3679新至陞","110/07/14","群益金鼎-東大",0,15,-15
"4083","3679新至陞","110/07/14","華南永昌-新莊",10,0,10
"4084","3679新至陞","110/07/14","瑞士信貸",0,12,-12
"4085","3679新至陞","110/07/14","新加坡商瑞銀",11,3,8
"4086","3679新至陞","110/07/14","群益金鼎-永和",0,10,-10
"4087","3679新至陞","110/07/14","美商高盛",6,0,6
"4088","3679新至陞","110/07/14","元大-成功",5,15,-10
"4089","3679新至陞","110/07/14","第一金-中壢",6,0,6
"4090","3679新至陞","110/07/14","統一-板橋",1,10,-9
"4091","3679新至陞","110/07/14","(牛牛牛)亞-網路",4,0,4
"4092","3679新至陞","110/07/14","玉山-左營",0,5,-5
"4093","3679新至陞","110/07/14","元大-六合",3,0,3
"4094","3679新至陞","110/07/14","群益金鼎-三民",0,4,-4
"4095","3679新至陞","110/07/14","合庫-自強",2,0,2
"4096","3679新至陞","110/07/14","富邦-宜蘭",0,4,-4
"4097","3679新至陞","110/07/14","高橋-內壢",2,0,2
"4098","3679新至陞","110/07/14","永豐金-苓雅",0,3,-3
"4099","3679新至陞","110/07/14","台中銀-員林",2,0,2
"4100","3679新至陞","110/07/14","摩根大通",5,7,-2
"4101","3679新至陞","110/07/14","凱基-高美館",2,0,2
"4102","3679新至陞","110/07/14","元大-板橋三民",0,2,-2
"4103","3679新至陞","110/07/14","元大-福營",2,0,2
"4104","3679新至陞","110/07/14","宏遠-中和",0,1,-1
"4105","3679新至陞","110/07/14","永豐金-松山",2,0,2
"4106","3679新至陞","110/07/14","元富-佳里",0,1,-1
"4107","3679新至陞","110/07/14","永豐金-萬盛",2,0,2
"4108","3679新至陞","110/07/14","(牛牛牛)亞-鑫豐",0,1,-1
"4109","3679新至陞","110/07/14","元富-松德",1,0,1
"4110","3679新至陞","110/07/14","中國信託-中壢",0,1,-1
"4111","2727王品","110/07/14","富邦-左營",102,1,101
"4112","2727王品","110/07/14","統一-城中",100,234,-134
"4113","2727王品","110/07/14","國泰-板橋",105,11,94
"4114","2727王品","110/07/14","富邦-台北",1,125,-124
"4115","2727王品","110/07/14","港商野村",149,72,77
"4116","2727王品","110/07/14","台灣摩根士丹利",1,48,-47
"4117","2727王品","110/07/14","合庫-台中",66,2,64
"4118","2727王品","110/07/14","國票-新莊",0,40,-40
"4119","2727王品","110/07/14","臺銀-金山",63,8,55
"4120","2727王品","110/07/14","永豐金-忠孝",2,39,-37
"4121","2727王品","110/07/14","摩根大通",83,39,44
"4122","2727王品","110/07/14","富邦-彰化",1,34,-33
"4123","2727王品","110/07/14","凱基-台北",84,42,42
"4124","2727王品","110/07/14","康和-高雄",0,30,-30
"4125","2727王品","110/07/14","土銀-台中",35,1,34
"4126","2727王品","110/07/14","安泰",0,26,-26
"4127","2727王品","110/07/14","華南永昌-麻豆",32,1,31
"4128","2727王品","110/07/14","富邦-新竹華信",0,21,-21
"4129","2727王品","110/07/14","元大證券",85,55,30
"4130","2727王品","110/07/14","元大-南崁",1,22,-21
"4131","2727王品","110/07/14","新加坡商瑞銀",40,15,25
"4132","2727王品","110/07/14","彰銀-台中",0,18,-18
"4133","2727王品","110/07/14","日盛-八德",19,0,19
"4134","2727王品","110/07/14","元富-同大",2,20,-18
"4135","2727王品","110/07/14","統一",35,17,18
"4136","2727王品","110/07/14","玉山-嘉義",1,17,-16
"4137","2727王品","110/07/14","元富-大昌",18,1,17
"4138","2727王品","110/07/14","國泰-館前",4,20,-16
"4139","2727王品","110/07/14","玉山-板橋",15,1,14
"4140","2727王品","110/07/14","第一金-嘉義",1,13,-12
"4141","1570力肯","110/07/14","國票-北高雄",68,0,68
"4142","1570力肯","110/07/14","摩根大通",0,21,-21
"4143","1570力肯","110/07/14","日盛-八德",30,1,29
"4144","1570力肯","110/07/14","新光",1,19,-18
"4145","1570力肯","110/07/14","玉山-高雄",7,0,7
"4146","1570力肯","110/07/14","(牛牛牛)亞-鑫豐",0,17,-17
"4147","1570力肯","110/07/14","臺銀-臺南",5,0,5
"4148","1570力肯","110/07/14","日盛-士林",0,10,-10
"4149","1570力肯","110/07/14","凱基-三峽",5,0,5
"4150","1570力肯","110/07/14","統一-員林",0,10,-10
"4151","1570力肯","110/07/14","元大-和平",5,0,5
"4152","1570力肯","110/07/14","國票-新莊",0,10,-10
"4153","1570力肯","110/07/14","合庫-三重",4,0,4
"4154","1570力肯","110/07/14","凱基-高美館",0,10,-10
"4155","1570力肯","110/07/14","瑞士信貸",4,0,4
"4156","1570力肯","110/07/14","元大-屏東民生",0,5,-5
"4157","1570力肯","110/07/14","統一-三多",4,0,4
"4158","1570力肯","110/07/14","元大-古亭",0,5,-5
"4159","1570力肯","110/07/14","華南永昌-古亭",4,0,4
"4160","1570力肯","110/07/14","日盛-木柵",0,4,-4
"4161","1570力肯","110/07/14","元大-高雄",3,0,3
"4162","1570力肯","110/07/14","大昌",0,4,-4
"4163","1570力肯","110/07/14","兆豐-忠孝",2,0,2
"4164","1570力肯","110/07/14","群益金鼎-東大",0,4,-4
"4165","1570力肯","110/07/14","富邦-陽明",2,0,2
"4166","1570力肯","110/07/14","凱基-台北",0,4,-4
"4167","1570力肯","110/07/14","元大-松山",2,0,2
"4168","1570力肯","110/07/14","元大-板橋",0,4,-4
"4169","1570力肯","110/07/14","元大-忠孝",2,0,2
"4170","1570力肯","110/07/14","第一金-中山",0,3,-3
"4171","6180橘子","110/07/14","新加坡商瑞銀",84,28,56
"4172","6180橘子","110/07/14","凱基-台北",4,37,-33
"4173","6180橘子","110/07/14","日盛-信義",29,1,28
"4174","6180橘子","110/07/14","玉山-台南",1,22,-21
"4175","6180橘子","110/07/14","豐農",28,4,24
"4176","6180橘子","110/07/14","日盛-新竹",1,21,-20
"4177","6180橘子","110/07/14","新光-新竹",24,1,23
"4178","6180橘子","110/07/14","元富-潮州",0,19,-19
"4179","6180橘子","110/07/14","華南永昌-高雄",20,0,20
"4180","6180橘子","110/07/14","元大-信義",0,17,-17
"4181","6180橘子","110/07/14","元大-羅東",20,0,20
"4182","6180橘子","110/07/14","台灣企銀-台中",1,16,-15
"4183","6180橘子","110/07/14","元大-台中中港",20,0,20
"4184","6180橘子","110/07/14","元大-北港",0,15,-15
"4185","6180橘子","110/07/14","富邦-嘉義",24,5,19
"4186","6180橘子","110/07/14","富邦-高雄",0,14,-14
"4187","6180橘子","110/07/14","富邦-仁愛",15,0,15
"4188","6180橘子","110/07/14","兆豐-埔墘",0,13,-13
"4189","6180橘子","110/07/14","國票-九鼎",13,0,13
"4190","6180橘子","110/07/14","第一金-中山",0,10,-10
"4191","6180橘子","110/07/14","日盛-木柵",12,0,12
"4192","6180橘子","110/07/14","元大-彰化民生",0,10,-10
"4193","6180橘子","110/07/14","元大-成功",10,0,10
"4194","6180橘子","110/07/14","福勝",1,10,-9
"4195","6180橘子","110/07/14","港商野村",10,2,8
"4196","6180橘子","110/07/14","群益金鼎-丹鳳",1,10,-9
"4197","6180橘子","110/07/14","玉山-左營",8,0,8
"4198","6180橘子","110/07/14","群益金鼎-板橋",0,8,-8
"4199","6180橘子","110/07/14","富邦-陽明",16,8,8
"4200","6180橘子","110/07/14","合庫-鳳山",0,7,-7
"4201","2390云辰","110/07/14","摩根大通",995,198,797
"4202","2390云辰","110/07/14","新加坡商瑞銀",28,399,-371
"4203","2390云辰","110/07/14","美林",383,22,361
"4204","2390云辰","110/07/14","凱基-新豐",3,198,-195
"4205","2390云辰","110/07/14","台灣摩根士丹利",684,358,326
"4206","2390云辰","110/07/14","元大-士林",1,152,-151
"4207","2390云辰","110/07/14","凱基-台北",656,402,254
"4208","2390云辰","110/07/14","元大-竹山",80,181,-101
"4209","2390云辰","110/07/14","日盛-和美",110,5,105
"4210","2390云辰","110/07/14","群益金鼎-開元",19,95,-76
"4211","2390云辰","110/07/14","元大-天母",72,0,72
"4212","2390云辰","110/07/14","新光",77,150,-73
"4213","2390云辰","110/07/14","永豐金-松山",57,0,57
"4214","2390云辰","110/07/14","元富-高雄",0,71,-71
"4215","2390云辰","110/07/14","統一-屏東",53,0,53
"4216","2390云辰","110/07/14","元大-土城學府",130,201,-71
"4217","2390云辰","110/07/14","港商野村",486,450,36
"4218","2390云辰","110/07/14","元大-善化",12,76,-64
"4219","2390云辰","110/07/14","致和-崇德",30,0,30
"4220","2390云辰","110/07/14","華南永昌-岡山",23,81,-58
"4221","2390云辰","110/07/14","富邦-台北",40,14,26
"4222","2390云辰","110/07/14","群益金鼎-大興",82,125,-43
"4223","2390云辰","110/07/14","台新-高雄",38,13,25
"4224","2390云辰","110/07/14","大慶-中壢",0,41,-41
"4225","2390云辰","110/07/14","富邦-板橋",32,7,25
"4226","2390云辰","110/07/14","玉山-板橋",6,47,-41
"4227","2390云辰","110/07/14","陽信-石牌",24,0,24
"4228","2390云辰","110/07/14","富邦-台東",2,42,-40
"4229","2390云辰","110/07/14","凱基-屏東",32,8,24
"4230","2390云辰","110/07/14","元大-新營",3,42,-39
"4231","2363矽統","110/07/14","台灣摩根士丹利",463,0,463
"4232","2363矽統","110/07/14","新加坡商瑞銀",568,1321,-753
"4233","2363矽統","110/07/14","台新證券",750,342,408
"4234","2363矽統","110/07/14","瑞士信貸",149,864,-715
"4235","2363矽統","110/07/14","玉山-台中",363,51,312
"4236","2363矽統","110/07/14","台新-屏東",115,380,-265
"4237","2363矽統","110/07/14","元大-斗六",223,25,198
"4238","2363矽統","110/07/14","永豐金證券",16,265,-249
"4239","2363矽統","110/07/14","華南永昌-朴子",208,38,170
"4240","2363矽統","110/07/14","美林",462,701,-239
"4241","2363矽統","110/07/14","元富-西松",169,12,157
"4242","2363矽統","110/07/14","宏遠-桃園",269,500,-231
"4243","2363矽統","110/07/14","永豐金-大園",146,6,140
"4244","2363矽統","110/07/14","凱基-竹北",36,254,-218
"4245","2363矽統","110/07/14","土銀-和平",134,0,134
"4246","2363矽統","110/07/14","港商法國興業",0,214,-214
"4247","2363矽統","110/07/14","富邦-新營",130,13,117
"4248","2363矽統","110/07/14","港商野村",835,1044,-209
"4249","2363矽統","110/07/14","元富-成功",118,11,107
"4250","2363矽統","110/07/14","北城證券",212,411,-199
"4251","2363矽統","110/07/14","元富-烏日",121,18,103
"4252","2363矽統","110/07/14","(牛牛牛)亞-鑫豐",51,241,-190
"4253","2363矽統","110/07/14","日盛-二林",120,18,102
"4254","2363矽統","110/07/14","國票-博愛",24,213,-189
"4255","2363矽統","110/07/14","兆豐-忠孝",98,2,96
"4256","2363矽統","110/07/14","大慶-蘆洲",134,316,-182
"4257","2363矽統","110/07/14","大慶-楊梅",92,3,89
"4258","2363矽統","110/07/14","彰銀-台中",15,193,-178
"4259","2363矽統","110/07/14","元富-三重",120,33,87
"4260","2363矽統","110/07/14","日盛-和美",18,185,-167
"4261","8112至上","110/07/14","新加坡商瑞銀",223,17,206
"4262","8112至上","110/07/14","瑞士信貸",8,170,-162
"4263","8112至上","110/07/14","摩根大通",285,129,156
"4264","8112至上","110/07/14","美林",55,202,-147
"4265","8112至上","110/07/14","花旗環球",124,0,124
"4266","8112至上","110/07/14","凱基-台北",325,436,-111
"4267","8112至上","110/07/14","兆豐-公益",117,4,113
"4268","8112至上","110/07/14","台中銀-台北",0,98,-98
"4269","8112至上","110/07/14","香港上海匯豐",111,0,111
"4270","8112至上","110/07/14","玉山-台大",17,107,-90
"4271","8112至上","110/07/14","永豐金-內湖",117,21,96
"4272","8112至上","110/07/14","康和-內湖",1,90,-89
"4273","8112至上","110/07/14","台灣摩根士丹利",108,16,92
"4274","8112至上","110/07/14","港商野村",21,84,-63
"4275","8112至上","110/07/14","元大-東蘆",77,0,77
"4276","8112至上","110/07/14","兆豐-北高雄",1,60,-59
"4277","8112至上","110/07/14","新光",108,48,60
"4278","8112至上","110/07/14","群益金鼎-海山",1,52,-51
"4279","8112至上","110/07/14","大慶-蘆洲",59,0,59
"4280","8112至上","110/07/14","群益金鼎-大安",0,50,-50
"4281","8112至上","110/07/14","華南永昌-台中",56,3,53
"4282","8112至上","110/07/14","富邦-仁愛",2,49,-47
"4283","8112至上","110/07/14","土銀-嘉義",52,2,50
"4284","8112至上","110/07/14","元大-金華",0,42,-42
"4285","8112至上","110/07/14","美商高盛",40,0,40
"4286","8112至上","110/07/14","元大-內湖",4,43,-39
"4287","8112至上","110/07/14","臺銀",63,29,34
"4288","8112至上","110/07/14","第一金-華江",2,37,-35
"4289","8112至上","110/07/14","元富-嘉義",31,0,31
"4290","8112至上","110/07/14","永豐金-苓雅",2,34,-32
"4291","1570力肯","110/07/14","國票-北高雄",68,0,68
"4292","1570力肯","110/07/14","摩根大通",0,21,-21
"4293","1570力肯","110/07/14","日盛-八德",30,1,29
"4294","1570力肯","110/07/14","新光",1,19,-18
"4295","1570力肯","110/07/14","玉山-高雄",7,0,7
"4296","1570力肯","110/07/14","(牛牛牛)亞-鑫豐",0,17,-17
"4297","1570力肯","110/07/14","臺銀-臺南",5,0,5
"4298","1570力肯","110/07/14","日盛-士林",0,10,-10
"4299","1570力肯","110/07/14","凱基-三峽",5,0,5
"4300","1570力肯","110/07/14","統一-員林",0,10,-10
"4301","1570力肯","110/07/14","元大-和平",5,0,5
"4302","1570力肯","110/07/14","國票-新莊",0,10,-10
"4303","1570力肯","110/07/14","合庫-三重",4,0,4
"4304","1570力肯","110/07/14","凱基-高美館",0,10,-10
"4305","1570力肯","110/07/14","瑞士信貸",4,0,4
"4306","1570力肯","110/07/14","元大-屏東民生",0,5,-5
"4307","1570力肯","110/07/14","統一-三多",4,0,4
"4308","1570力肯","110/07/14","元大-古亭",0,5,-5
"4309","1570力肯","110/07/14","華南永昌-古亭",4,0,4
"4310","1570力肯","110/07/14","日盛-木柵",0,4,-4
"4311","1570力肯","110/07/14","元大-高雄",3,0,3
"4312","1570力肯","110/07/14","大昌",0,4,-4
"4313","1570力肯","110/07/14","兆豐-忠孝",2,0,2
"4314","1570力肯","110/07/14","群益金鼎-東大",0,4,-4
"4315","1570力肯","110/07/14","富邦-陽明",2,0,2
"4316","1570力肯","110/07/14","凱基-台北",0,4,-4
"4317","1570力肯","110/07/14","元大-松山",2,0,2
"4318","1570力肯","110/07/14","元大-板橋",0,4,-4
"4319","1570力肯","110/07/14","元大-忠孝",2,0,2
"4320","1570力肯","110/07/14","第一金-中山",0,3,-3
"4321","2929淘帝","110/07/14","華南永昌-林口",60,0,60
"4322","2929淘帝","110/07/14","群益金鼎",25,540,-515
"4323","2929淘帝","110/07/14","美林",87,31,56
"4324","2929淘帝","110/07/14","國泰-台南",1,30,-29
"4325","2929淘帝","110/07/14","元富-台南",40,0,40
"4326","2929淘帝","110/07/14","宏遠-桃園",0,20,-20
"4327","2929淘帝","110/07/14","元大-民生",39,0,39
"4328","2929淘帝","110/07/14","摩根大通",11,31,-20
"4329","2929淘帝","110/07/14","臺銀-鳳山",34,0,34
"4330","2929淘帝","110/07/14","台新-建北",5,20,-15
"4331","2929淘帝","110/07/14","合庫-高雄",34,1,33
"4332","2929淘帝","110/07/14","新光",1,16,-15
"4333","2929淘帝","110/07/14","華南永昌-鶯歌",28,0,28
"4334","2929淘帝","110/07/14","玉山-板橋",0,15,-15
"4335","2929淘帝","110/07/14","永興",25,0,25
"4336","2929淘帝","110/07/14","凱基-羅東",0,15,-15
"4337","2929淘帝","110/07/14","元大-新盛",25,1,24
"4338","2929淘帝","110/07/14","元大-頭份",0,15,-15
"4339","2929淘帝","110/07/14","日盛-南京",23,0,23
"4340","2929淘帝","110/07/14","第一金-台南",0,13,-13
"4341","2929淘帝","110/07/14","日茂",20,0,20
"4342","2929淘帝","110/07/14","富邦-基隆",0,12,-12
"4343","2929淘帝","110/07/14","台新-台中",20,0,20
"4344","2929淘帝","110/07/14","日茂-南投",1,12,-11
"4345","2929淘帝","110/07/14","華南永昌",20,0,20
"4346","2929淘帝","110/07/14","元大-豐原站前",0,11,-11
"4347","2929淘帝","110/07/14","福勝",15,0,15
"4348","2929淘帝","110/07/14","玉山-士林",0,10,-10
"4349","2929淘帝","110/07/14","富邦-南屯",15,0,15
"4350","2929淘帝","110/07/14","富邦-台北",0,10,-10
"4351","5410國眾","110/07/14","兆豐-城中",35,0,35
"4352","5410國眾","110/07/14","瑞士信貸",0,29,-29
"4353","5410國眾","110/07/14","新光",21,1,20
"4354","5410國眾","110/07/14","國泰-板橋",1,30,-29
"4355","5410國眾","110/07/14","國泰-敦南",21,1,20
"4356","5410國眾","110/07/14","日盛-高雄",0,20,-20
"4357","5410國眾","110/07/14","國泰-台中",20,1,19
"4358","5410國眾","110/07/14","台新-左楠",1,20,-19
"4359","5410國眾","110/07/14","元大-崇德",19,0,19
"4360","5410國眾","110/07/14","元富-大昌",1,18,-17
"4361","5410國眾","110/07/14","土銀-士林",18,0,18
"4362","5410國眾","110/07/14","富邦-建國",0,15,-15
"4363","5410國眾","110/07/14","元大-新盛",20,2,18
"4364","5410國眾","110/07/14","元富-嘉義",0,12,-12
"4365","5410國眾","110/07/14","兆豐-高雄",15,0,15
"4366","5410國眾","110/07/14","永全-南崁",0,12,-12
"4367","5410國眾","110/07/14","宏遠-中和",10,0,10
"4368","5410國眾","110/07/14","元大-員林",0,11,-11
"4369","5410國眾","110/07/14","新光-桃園",10,0,10
"4370","5410國眾","110/07/14","高橋",0,10,-10
"4371","5410國眾","110/07/14","國泰-台南",10,0,10
"4372","5410國眾","110/07/14","永興",0,10,-10
"4373","5410國眾","110/07/14","元大-復北",10,0,10
"4374","5410國眾","110/07/14","華南永昌-三重",0,10,-10
"4375","5410國眾","110/07/14","元大-竹科",8,0,8
"4376","5410國眾","110/07/14","元大-苑裡",0,7,-7
"4377","5410國眾","110/07/14","台新-新營",6,0,6
"4378","5410國眾","110/07/14","港商野村",0,6,-6
"4379","5410國眾","110/07/14","日盛-士林",5,0,5
"4380","5410國眾","110/07/14","摩根大通",5,11,-6
"4381","2841台開","110/07/14","凱基-文心",73,0,73
"4382","2841台開","110/07/14","國泰-敦南",0,50,-50
"4383","2841台開","110/07/14","元富-潮州",30,0,30
"4384","2841台開","110/07/14","凱基-中壢",0,40,-40
"4385","2841台開","110/07/14","第一金-台中",20,0,20
"4386","2841台開","110/07/14","統一-新竹",0,24,-24
"4387","2841台開","110/07/14","華南永昌-新莊",20,0,20
"4388","2841台開","110/07/14","元富-草屯",0,20,-20
"4389","2841台開","110/07/14","永豐金-豐原",20,0,20
"4390","2841台開","110/07/14","台新-台南",0,20,-20
"4391","2841台開","110/07/14","國泰-館前",15,0,15
"4392","2841台開","110/07/14","永豐金-敦南",45,63,-18
"4393","2841台開","110/07/14","群益金鼎-基隆",12,0,12
"4394","2841台開","110/07/14","國票-北高雄",0,13,-13
"4395","2841台開","110/07/14","日盛-信義",10,0,10
"4396","2841台開","110/07/14","凱基-松山",0,10,-10
"4397","2841台開","110/07/14","台新-台中",10,0,10
"4398","2841台開","110/07/14","元大證券",0,10,-10
"4399","2841台開","110/07/14","新光",10,1,9
"4400","2841台開","110/07/14","元大-中壢",0,10,-10
"4401","2841台開","110/07/14","凱基-新店",8,0,8
"4402","2841台開","110/07/14","富邦-陽明",1,10,-9
"4403","2841台開","110/07/14","元大-斗信",7,0,7
"4404","2841台開","110/07/14","富邦-建國",0,9,-9
"4405","2841台開","110/07/14","元大-三重",6,0,6
"4406","2841台開","110/07/14","富邦-台南",0,8,-8
"4407","2841台開","110/07/14","永豐金-中和",6,0,6
"4408","2841台開","110/07/14","康和-澎湖",0,7,-7
"4409","2841台開","110/07/14","元富-成功",5,0,5
"4410","2841台開","110/07/14","日盛-斗六",0,6,-6
"4411","6207雷科","110/07/14","群益金鼎-台北",60,0,60
"4412","6207雷科","110/07/14","新加坡商瑞銀",10,56,-46
"4413","6207雷科","110/07/14","台新-高雄",43,3,40
"4414","6207雷科","110/07/14","國票-中和",0,41,-41
"4415","6207雷科","110/07/14","元大-高雄",19,0,19
"4416","6207雷科","110/07/14","元大-復北",0,33,-33
"4417","6207雷科","110/07/14","福勝",15,0,15
"4418","6207雷科","110/07/14","光和-和美",0,20,-20
"4419","6207雷科","110/07/14","群益金鼎-中山",15,0,15
"4420","6207雷科","110/07/14","群益金鼎-丹鳳",0,20,-20
"4421","6207雷科","110/07/14","元大-林園",15,0,15
"4422","6207雷科","110/07/14","第一金-路竹",0,10,-10
"4423","6207雷科","110/07/14","新光",12,0,12
"4424","6207雷科","110/07/14","元大-歸仁",0,10,-10
"4425","6207雷科","110/07/14","元大-大天母",10,0,10
"4426","6207雷科","110/07/14","宏遠-館前",0,9,-9
"4427","6207雷科","110/07/14","永豐金-忠孝",9,0,9
"4428","6207雷科","110/07/14","凱基-台北",12,20,-8
"4429","6207雷科","110/07/14","永豐金-新店",7,0,7
"4430","6207雷科","110/07/14","美林",0,7,-7
"4431","6207雷科","110/07/14","玉山-嘉義",6,0,6
"4432","6207雷科","110/07/14","摩根大通",16,23,-7
"4433","6207雷科","110/07/14","元大-屏東",6,0,6
"4434","6207雷科","110/07/14","凱基-高雄",1,7,-6
"4435","6207雷科","110/07/14","凱基-大安",5,0,5
"4436","6207雷科","110/07/14","台中銀-豐原",0,5,-5
"4437","6207雷科","110/07/14","富邦-台南",5,0,5
"4438","6207雷科","110/07/14","元大-新竹經國",0,5,-5
"4439","6207雷科","110/07/14","元大-成功",5,0,5
"4440","6207雷科","110/07/14","光和-田中",0,4,-4
"4441","3679新至陞","110/07/14","凱基-台北",31,6,25
"4442","3679新至陞","110/07/14","群益金鼎-東大",0,15,-15
"4443","3679新至陞","110/07/14","華南永昌-新莊",10,0,10
"4444","3679新至陞","110/07/14","瑞士信貸",0,12,-12
"4445","3679新至陞","110/07/14","新加坡商瑞銀",11,3,8
"4446","3679新至陞","110/07/14","群益金鼎-永和",0,10,-10
"4447","3679新至陞","110/07/14","美商高盛",6,0,6
"4448","3679新至陞","110/07/14","元大-成功",5,15,-10
"4449","3679新至陞","110/07/14","第一金-中壢",6,0,6
"4450","3679新至陞","110/07/14","統一-板橋",1,10,-9
"4451","3679新至陞","110/07/14","(牛牛牛)亞-網路",4,0,4
"4452","3679新至陞","110/07/14","玉山-左營",0,5,-5
"4453","3679新至陞","110/07/14","元大-六合",3,0,3
"4454","3679新至陞","110/07/14","群益金鼎-三民",0,4,-4
"4455","3679新至陞","110/07/14","合庫-自強",2,0,2
"4456","3679新至陞","110/07/14","富邦-宜蘭",0,4,-4
"4457","3679新至陞","110/07/14","高橋-內壢",2,0,2
"4458","3679新至陞","110/07/14","永豐金-苓雅",0,3,-3
"4459","3679新至陞","110/07/14","台中銀-員林",2,0,2
"4460","3679新至陞","110/07/14","摩根大通",5,7,-2
"4461","3679新至陞","110/07/14","凱基-高美館",2,0,2
"4462","3679新至陞","110/07/14","元大-板橋三民",0,2,-2
"4463","3679新至陞","110/07/14","元大-福營",2,0,2
"4464","3679新至陞","110/07/14","宏遠-中和",0,1,-1
"4465","3679新至陞","110/07/14","永豐金-松山",2,0,2
"4466","3679新至陞","110/07/14","元富-佳里",0,1,-1
"4467","3679新至陞","110/07/14","永豐金-萬盛",2,0,2
"4468","3679新至陞","110/07/14","(牛牛牛)亞-鑫豐",0,1,-1
"4469","3679新至陞","110/07/14","元富-松德",1,0,1
"4470","3679新至陞","110/07/14","中國信託-中壢",0,1,-1
"4471","2727王品","110/07/14","富邦-左營",102,1,101
"4472","2727王品","110/07/14","統一-城中",100,234,-134
"4473","2727王品","110/07/14","國泰-板橋",105,11,94
"4474","2727王品","110/07/14","富邦-台北",1,125,-124
"4475","2727王品","110/07/14","港商野村",149,72,77
"4476","2727王品","110/07/14","台灣摩根士丹利",1,48,-47
"4477","2727王品","110/07/14","合庫-台中",66,2,64
"4478","2727王品","110/07/14","國票-新莊",0,40,-40
"4479","2727王品","110/07/14","臺銀-金山",63,8,55
"4480","2727王品","110/07/14","永豐金-忠孝",2,39,-37
"4481","2727王品","110/07/14","摩根大通",83,39,44
"4482","2727王品","110/07/14","富邦-彰化",1,34,-33
"4483","2727王品","110/07/14","凱基-台北",84,42,42
"4484","2727王品","110/07/14","康和-高雄",0,30,-30
"4485","2727王品","110/07/14","土銀-台中",35,1,34
"4486","2727王品","110/07/14","安泰",0,26,-26
"4487","2727王品","110/07/14","華南永昌-麻豆",32,1,31
"4488","2727王品","110/07/14","富邦-新竹華信",0,21,-21
"4489","2727王品","110/07/14","元大證券",85,55,30
"4490","2727王品","110/07/14","元大-南崁",1,22,-21
"4491","2727王品","110/07/14","新加坡商瑞銀",40,15,25
"4492","2727王品","110/07/14","彰銀-台中",0,18,-18
"4493","2727王品","110/07/14","日盛-八德",19,0,19
"4494","2727王品","110/07/14","元富-同大",2,20,-18
"4495","2727王品","110/07/14","統一",35,17,18
"4496","2727王品","110/07/14","玉山-嘉義",1,17,-16
"4497","2727王品","110/07/14","元富-大昌",18,1,17
"4498","2727王品","110/07/14","國泰-館前",4,20,-16
"4499","2727王品","110/07/14","玉山-板橋",15,1,14
"4500","2727王品","110/07/14","第一金-嘉義",1,13,-12
"4501","1570力肯","110/07/14","國票-北高雄",68,0,68
"4502","1570力肯","110/07/14","摩根大通",0,21,-21
"4503","1570力肯","110/07/14","日盛-八德",30,1,29
"4504","1570力肯","110/07/14","新光",1,19,-18
"4505","1570力肯","110/07/14","玉山-高雄",7,0,7
"4506","1570力肯","110/07/14","(牛牛牛)亞-鑫豐",0,17,-17
"4507","1570力肯","110/07/14","臺銀-臺南",5,0,5
"4508","1570力肯","110/07/14","日盛-士林",0,10,-10
"4509","1570力肯","110/07/14","凱基-三峽",5,0,5
"4510","1570力肯","110/07/14","統一-員林",0,10,-10
"4511","1570力肯","110/07/14","元大-和平",5,0,5
"4512","1570力肯","110/07/14","國票-新莊",0,10,-10
"4513","1570力肯","110/07/14","合庫-三重",4,0,4
"4514","1570力肯","110/07/14","凱基-高美館",0,10,-10
"4515","1570力肯","110/07/14","瑞士信貸",4,0,4
"4516","1570力肯","110/07/14","元大-屏東民生",0,5,-5
"4517","1570力肯","110/07/14","統一-三多",4,0,4
"4518","1570力肯","110/07/14","元大-古亭",0,5,-5
"4519","1570力肯","110/07/14","華南永昌-古亭",4,0,4
"4520","1570力肯","110/07/14","日盛-木柵",0,4,-4
"4521","1570力肯","110/07/14","元大-高雄",3,0,3
"4522","1570力肯","110/07/14","大昌",0,4,-4
"4523","1570力肯","110/07/14","兆豐-忠孝",2,0,2
"4524","1570力肯","110/07/14","群益金鼎-東大",0,4,-4
"4525","1570力肯","110/07/14","富邦-陽明",2,0,2
"4526","1570力肯","110/07/14","凱基-台北",0,4,-4
"4527","1570力肯","110/07/14","元大-松山",2,0,2
"4528","1570力肯","110/07/14","元大-板橋",0,4,-4
"4529","1570力肯","110/07/14","元大-忠孝",2,0,2
"4530","1570力肯","110/07/14","第一金-中山",0,3,-3
"4531","6180橘子","110/07/14","新加坡商瑞銀",84,28,56
"4532","6180橘子","110/07/14","凱基-台北",4,37,-33
"4533","6180橘子","110/07/14","日盛-信義",29,1,28
"4534","6180橘子","110/07/14","玉山-台南",1,22,-21
"4535","6180橘子","110/07/14","豐農",28,4,24
"4536","6180橘子","110/07/14","日盛-新竹",1,21,-20
"4537","6180橘子","110/07/14","新光-新竹",24,1,23
"4538","6180橘子","110/07/14","元富-潮州",0,19,-19
"4539","6180橘子","110/07/14","華南永昌-高雄",20,0,20
"4540","6180橘子","110/07/14","元大-信義",0,17,-17
"4541","6180橘子","110/07/14","元大-羅東",20,0,20
"4542","6180橘子","110/07/14","台灣企銀-台中",1,16,-15
"4543","6180橘子","110/07/14","元大-台中中港",20,0,20
"4544","6180橘子","110/07/14","元大-北港",0,15,-15
"4545","6180橘子","110/07/14","富邦-嘉義",24,5,19
"4546","6180橘子","110/07/14","富邦-高雄",0,14,-14
"4547","6180橘子","110/07/14","富邦-仁愛",15,0,15
"4548","6180橘子","110/07/14","兆豐-埔墘",0,13,-13
"4549","6180橘子","110/07/14","國票-九鼎",13,0,13
"4550","6180橘子","110/07/14","第一金-中山",0,10,-10
"4551","6180橘子","110/07/14","日盛-木柵",12,0,12
"4552","6180橘子","110/07/14","元大-彰化民生",0,10,-10
"4553","6180橘子","110/07/14","元大-成功",10,0,10
"4554","6180橘子","110/07/14","福勝",1,10,-9
"4555","6180橘子","110/07/14","港商野村",10,2,8
"4556","6180橘子","110/07/14","群益金鼎-丹鳳",1,10,-9
"4557","6180橘子","110/07/14","玉山-左營",8,0,8
"4558","6180橘子","110/07/14","群益金鼎-板橋",0,8,-8
"4559","6180橘子","110/07/14","富邦-陽明",16,8,8
"4560","6180橘子","110/07/14","合庫-鳳山",0,7,-7
"4561","2390云辰","110/07/14","摩根大通",995,198,797
"4562","2390云辰","110/07/14","新加坡商瑞銀",28,399,-371
"4563","2390云辰","110/07/14","美林",383,22,361
"4564","2390云辰","110/07/14","凱基-新豐",3,198,-195
"4565","2390云辰","110/07/14","台灣摩根士丹利",684,358,326
"4566","2390云辰","110/07/14","元大-士林",1,152,-151
"4567","2390云辰","110/07/14","凱基-台北",656,402,254
"4568","2390云辰","110/07/14","元大-竹山",80,181,-101
"4569","2390云辰","110/07/14","日盛-和美",110,5,105
"4570","2390云辰","110/07/14","群益金鼎-開元",19,95,-76
"4571","2390云辰","110/07/14","元大-天母",72,0,72
"4572","2390云辰","110/07/14","新光",77,150,-73
"4573","2390云辰","110/07/14","永豐金-松山",57,0,57
"4574","2390云辰","110/07/14","元富-高雄",0,71,-71
"4575","2390云辰","110/07/14","統一-屏東",53,0,53
"4576","2390云辰","110/07/14","元大-土城學府",130,201,-71
"4577","2390云辰","110/07/14","港商野村",486,450,36
"4578","2390云辰","110/07/14","元大-善化",12,76,-64
"4579","2390云辰","110/07/14","致和-崇德",30,0,30
"4580","2390云辰","110/07/14","華南永昌-岡山",23,81,-58
"4581","2390云辰","110/07/14","富邦-台北",40,14,26
"4582","2390云辰","110/07/14","群益金鼎-大興",82,125,-43
"4583","2390云辰","110/07/14","台新-高雄",38,13,25
"4584","2390云辰","110/07/14","大慶-中壢",0,41,-41
"4585","2390云辰","110/07/14","富邦-板橋",32,7,25
"4586","2390云辰","110/07/14","玉山-板橋",6,47,-41
"4587","2390云辰","110/07/14","陽信-石牌",24,0,24
"4588","2390云辰","110/07/14","富邦-台東",2,42,-40
"4589","2390云辰","110/07/14","凱基-屏東",32,8,24
"4590","2390云辰","110/07/14","元大-新營",3,42,-39
"4591","2363矽統","110/07/14","台灣摩根士丹利",463,0,463
"4592","2363矽統","110/07/14","新加坡商瑞銀",568,1321,-753
"4593","2363矽統","110/07/14","台新證券",750,342,408
"4594","2363矽統","110/07/14","瑞士信貸",149,864,-715
"4595","2363矽統","110/07/14","玉山-台中",363,51,312
"4596","2363矽統","110/07/14","台新-屏東",115,380,-265
"4597","2363矽統","110/07/14","元大-斗六",223,25,198
"4598","2363矽統","110/07/14","永豐金證券",16,265,-249
"4599","2363矽統","110/07/14","華南永昌-朴子",208,38,170
"4600","2363矽統","110/07/14","美林",462,701,-239
"4601","2363矽統","110/07/14","元富-西松",169,12,157
"4602","2363矽統","110/07/14","宏遠-桃園",269,500,-231
"4603","2363矽統","110/07/14","永豐金-大園",146,6,140
"4604","2363矽統","110/07/14","凱基-竹北",36,254,-218
"4605","2363矽統","110/07/14","土銀-和平",134,0,134
"4606","2363矽統","110/07/14","港商法國興業",0,214,-214
"4607","2363矽統","110/07/14","富邦-新營",130,13,117
"4608","2363矽統","110/07/14","港商野村",835,1044,-209
"4609","2363矽統","110/07/14","元富-成功",118,11,107
"4610","2363矽統","110/07/14","北城證券",212,411,-199
"4611","2363矽統","110/07/14","元富-烏日",121,18,103
"4612","2363矽統","110/07/14","(牛牛牛)亞-鑫豐",51,241,-190
"4613","2363矽統","110/07/14","日盛-二林",120,18,102
"4614","2363矽統","110/07/14","國票-博愛",24,213,-189
"4615","2363矽統","110/07/14","兆豐-忠孝",98,2,96
"4616","2363矽統","110/07/14","大慶-蘆洲",134,316,-182
"4617","2363矽統","110/07/14","大慶-楊梅",92,3,89
"4618","2363矽統","110/07/14","彰銀-台中",15,193,-178
"4619","2363矽統","110/07/14","元富-三重",120,33,87
"4620","2363矽統","110/07/14","日盛-和美",18,185,-167
"4621","8112至上","110/07/14","新加坡商瑞銀",223,17,206
"4622","8112至上","110/07/14","瑞士信貸",8,170,-162
"4623","8112至上","110/07/14","摩根大通",285,129,156
"4624","8112至上","110/07/14","美林",55,202,-147
"4625","8112至上","110/07/14","花旗環球",124,0,124
"4626","8112至上","110/07/14","凱基-台北",325,436,-111
"4627","8112至上","110/07/14","兆豐-公益",117,4,113
"4628","8112至上","110/07/14","台中銀-台北",0,98,-98
"4629","8112至上","110/07/14","香港上海匯豐",111,0,111
"4630","8112至上","110/07/14","玉山-台大",17,107,-90
"4631","8112至上","110/07/14","永豐金-內湖",117,21,96
"4632","8112至上","110/07/14","康和-內湖",1,90,-89
"4633","8112至上","110/07/14","台灣摩根士丹利",108,16,92
"4634","8112至上","110/07/14","港商野村",21,84,-63
"4635","8112至上","110/07/14","元大-東蘆",77,0,77
"4636","8112至上","110/07/14","兆豐-北高雄",1,60,-59
"4637","8112至上","110/07/14","新光",108,48,60
"4638","8112至上","110/07/14","群益金鼎-海山",1,52,-51
"4639","8112至上","110/07/14","大慶-蘆洲",59,0,59
"4640","8112至上","110/07/14","群益金鼎-大安",0,50,-50
"4641","8112至上","110/07/14","華南永昌-台中",56,3,53
"4642","8112至上","110/07/14","富邦-仁愛",2,49,-47
"4643","8112至上","110/07/14","土銀-嘉義",52,2,50
"4644","8112至上","110/07/14","元大-金華",0,42,-42
"4645","8112至上","110/07/14","美商高盛",40,0,40
"4646","8112至上","110/07/14","元大-內湖",4,43,-39
"4647","8112至上","110/07/14","臺銀",63,29,34
"4648","8112至上","110/07/14","第一金-華江",2,37,-35
"4649","8112至上","110/07/14","元富-嘉義",31,0,31
"4650","8112至上","110/07/14","永豐金-苓雅",2,34,-32
"4651","1570力肯","110/07/14","國票-北高雄",68,0,68
"4652","1570力肯","110/07/14","摩根大通",0,21,-21
"4653","1570力肯","110/07/14","日盛-八德",30,1,29
"4654","1570力肯","110/07/14","新光",1,19,-18
"4655","1570力肯","110/07/14","玉山-高雄",7,0,7
"4656","1570力肯","110/07/14","(牛牛牛)亞-鑫豐",0,17,-17
"4657","1570力肯","110/07/14","臺銀-臺南",5,0,5
"4658","1570力肯","110/07/14","日盛-士林",0,10,-10
"4659","1570力肯","110/07/14","凱基-三峽",5,0,5
"4660","1570力肯","110/07/14","統一-員林",0,10,-10
"4661","1570力肯","110/07/14","元大-和平",5,0,5
"4662","1570力肯","110/07/14","國票-新莊",0,10,-10
"4663","1570力肯","110/07/14","合庫-三重",4,0,4
"4664","1570力肯","110/07/14","凱基-高美館",0,10,-10
"4665","1570力肯","110/07/14","瑞士信貸",4,0,4
"4666","1570力肯","110/07/14","元大-屏東民生",0,5,-5
"4667","1570力肯","110/07/14","統一-三多",4,0,4
"4668","1570力肯","110/07/14","元大-古亭",0,5,-5
"4669","1570力肯","110/07/14","華南永昌-古亭",4,0,4
"4670","1570力肯","110/07/14","日盛-木柵",0,4,-4
"4671","1570力肯","110/07/14","元大-高雄",3,0,3
"4672","1570力肯","110/07/14","大昌",0,4,-4
"4673","1570力肯","110/07/14","兆豐-忠孝",2,0,2
"4674","1570力肯","110/07/14","群益金鼎-東大",0,4,-4
"4675","1570力肯","110/07/14","富邦-陽明",2,0,2
"4676","1570力肯","110/07/14","凱基-台北",0,4,-4
"4677","1570力肯","110/07/14","元大-松山",2,0,2
"4678","1570力肯","110/07/14","元大-板橋",0,4,-4
"4679","1570力肯","110/07/14","元大-忠孝",2,0,2
"4680","1570力肯","110/07/14","第一金-中山",0,3,-3
"4681","2929淘帝","110/07/14","華南永昌-林口",60,0,60
"4682","2929淘帝","110/07/14","群益金鼎",25,540,-515
"4683","2929淘帝","110/07/14","美林",87,31,56
"4684","2929淘帝","110/07/14","國泰-台南",1,30,-29
"4685","2929淘帝","110/07/14","元富-台南",40,0,40
"4686","2929淘帝","110/07/14","宏遠-桃園",0,20,-20
"4687","2929淘帝","110/07/14","元大-民生",39,0,39
"4688","2929淘帝","110/07/14","摩根大通",11,31,-20
"4689","2929淘帝","110/07/14","臺銀-鳳山",34,0,34
"4690","2929淘帝","110/07/14","台新-建北",5,20,-15
"4691","2929淘帝","110/07/14","合庫-高雄",34,1,33
"4692","2929淘帝","110/07/14","新光",1,16,-15
"4693","2929淘帝","110/07/14","華南永昌-鶯歌",28,0,28
"4694","2929淘帝","110/07/14","玉山-板橋",0,15,-15
"4695","2929淘帝","110/07/14","永興",25,0,25
"4696","2929淘帝","110/07/14","凱基-羅東",0,15,-15
"4697","2929淘帝","110/07/14","元大-新盛",25,1,24
"4698","2929淘帝","110/07/14","元大-頭份",0,15,-15
"4699","2929淘帝","110/07/14","日盛-南京",23,0,23
"4700","2929淘帝","110/07/14","第一金-台南",0,13,-13
"4701","2929淘帝","110/07/14","日茂",20,0,20
"4702","2929淘帝","110/07/14","富邦-基隆",0,12,-12
"4703","2929淘帝","110/07/14","台新-台中",20,0,20
"4704","2929淘帝","110/07/14","日茂-南投",1,12,-11
"4705","2929淘帝","110/07/14","華南永昌",20,0,20
"4706","2929淘帝","110/07/14","元大-豐原站前",0,11,-11
"4707","2929淘帝","110/07/14","福勝",15,0,15
"4708","2929淘帝","110/07/14","玉山-士林",0,10,-10
"4709","2929淘帝","110/07/14","富邦-南屯",15,0,15
"4710","2929淘帝","110/07/14","富邦-台北",0,10,-10
"4711","5410國眾","110/07/14","兆豐-城中",35,0,35
"4712","5410國眾","110/07/14","瑞士信貸",0,29,-29
"4713","5410國眾","110/07/14","新光",21,1,20
"4714","5410國眾","110/07/14","國泰-板橋",1,30,-29
"4715","5410國眾","110/07/14","國泰-敦南",21,1,20
"4716","5410國眾","110/07/14","日盛-高雄",0,20,-20
"4717","5410國眾","110/07/14","國泰-台中",20,1,19
"4718","5410國眾","110/07/14","台新-左楠",1,20,-19
"4719","5410國眾","110/07/14","元大-崇德",19,0,19
"4720","5410國眾","110/07/14","元富-大昌",1,18,-17
"4721","5410國眾","110/07/14","土銀-士林",18,0,18
"4722","5410國眾","110/07/14","富邦-建國",0,15,-15
"4723","5410國眾","110/07/14","元大-新盛",20,2,18
"4724","5410國眾","110/07/14","元富-嘉義",0,12,-12
"4725","5410國眾","110/07/14","兆豐-高雄",15,0,15
"4726","5410國眾","110/07/14","永全-南崁",0,12,-12
"4727","5410國眾","110/07/14","宏遠-中和",10,0,10
"4728","5410國眾","110/07/14","元大-員林",0,11,-11
"4729","5410國眾","110/07/14","新光-桃園",10,0,10
"4730","5410國眾","110/07/14","高橋",0,10,-10
"4731","5410國眾","110/07/14","國泰-台南",10,0,10
"4732","5410國眾","110/07/14","永興",0,10,-10
"4733","5410國眾","110/07/14","元大-復北",10,0,10
"4734","5410國眾","110/07/14","華南永昌-三重",0,10,-10
"4735","5410國眾","110/07/14","元大-竹科",8,0,8
"4736","5410國眾","110/07/14","元大-苑裡",0,7,-7
"4737","5410國眾","110/07/14","台新-新營",6,0,6
"4738","5410國眾","110/07/14","港商野村",0,6,-6
"4739","5410國眾","110/07/14","日盛-士林",5,0,5
"4740","5410國眾","110/07/14","摩根大通",5,11,-6
"4741","2841台開","110/07/14","凱基-文心",73,0,73
"4742","2841台開","110/07/14","國泰-敦南",0,50,-50
"4743","2841台開","110/07/14","元富-潮州",30,0,30
"4744","2841台開","110/07/14","凱基-中壢",0,40,-40
"4745","2841台開","110/07/14","第一金-台中",20,0,20
"4746","2841台開","110/07/14","統一-新竹",0,24,-24
"4747","2841台開","110/07/14","華南永昌-新莊",20,0,20
"4748","2841台開","110/07/14","元富-草屯",0,20,-20
"4749","2841台開","110/07/14","永豐金-豐原",20,0,20
"4750","2841台開","110/07/14","台新-台南",0,20,-20
"4751","2841台開","110/07/14","國泰-館前",15,0,15
"4752","2841台開","110/07/14","永豐金-敦南",45,63,-18
"4753","2841台開","110/07/14","群益金鼎-基隆",12,0,12
"4754","2841台開","110/07/14","國票-北高雄",0,13,-13
"4755","2841台開","110/07/14","日盛-信義",10,0,10
"4756","2841台開","110/07/14","凱基-松山",0,10,-10
"4757","2841台開","110/07/14","台新-台中",10,0,10
"4758","2841台開","110/07/14","元大證券",0,10,-10
"4759","2841台開","110/07/14","新光",10,1,9
"4760","2841台開","110/07/14","元大-中壢",0,10,-10
"4761","2841台開","110/07/14","凱基-新店",8,0,8
"4762","2841台開","110/07/14","富邦-陽明",1,10,-9
"4763","2841台開","110/07/14","元大-斗信",7,0,7
"4764","2841台開","110/07/14","富邦-建國",0,9,-9
"4765","2841台開","110/07/14","元大-三重",6,0,6
"4766","2841台開","110/07/14","富邦-台南",0,8,-8
"4767","2841台開","110/07/14","永豐金-中和",6,0,6
"4768","2841台開","110/07/14","康和-澎湖",0,7,-7
"4769","2841台開","110/07/14","元富-成功",5,0,5
"4770","2841台開","110/07/14","日盛-斗六",0,6,-6
"4771","6207雷科","110/07/14","群益金鼎-台北",60,0,60
"4772","6207雷科","110/07/14","新加坡商瑞銀",10,56,-46
"4773","6207雷科","110/07/14","台新-高雄",43,3,40
"4774","6207雷科","110/07/14","國票-中和",0,41,-41
"4775","6207雷科","110/07/14","元大-高雄",19,0,19
"4776","6207雷科","110/07/14","元大-復北",0,33,-33
"4777","6207雷科","110/07/14","福勝",15,0,15
"4778","6207雷科","110/07/14","光和-和美",0,20,-20
"4779","6207雷科","110/07/14","群益金鼎-中山",15,0,15
"4780","6207雷科","110/07/14","群益金鼎-丹鳳",0,20,-20
"4781","6207雷科","110/07/14","元大-林園",15,0,15
"4782","6207雷科","110/07/14","第一金-路竹",0,10,-10
"4783","6207雷科","110/07/14","新光",12,0,12
"4784","6207雷科","110/07/14","元大-歸仁",0,10,-10
"4785","6207雷科","110/07/14","元大-大天母",10,0,10
"4786","6207雷科","110/07/14","宏遠-館前",0,9,-9
"4787","6207雷科","110/07/14","永豐金-忠孝",9,0,9
"4788","6207雷科","110/07/14","凱基-台北",12,20,-8
"4789","6207雷科","110/07/14","永豐金-新店",7,0,7
"4790","6207雷科","110/07/14","美林",0,7,-7
"4791","6207雷科","110/07/14","玉山-嘉義",6,0,6
"4792","6207雷科","110/07/14","摩根大通",16,23,-7
"4793","6207雷科","110/07/14","元大-屏東",6,0,6
"4794","6207雷科","110/07/14","凱基-高雄",1,7,-6
"4795","6207雷科","110/07/14","凱基-大安",5,0,5
"4796","6207雷科","110/07/14","台中銀-豐原",0,5,-5
"4797","6207雷科","110/07/14","富邦-台南",5,0,5
"4798","6207雷科","110/07/14","元大-新竹經國",0,5,-5
"4799","6207雷科","110/07/14","元大-成功",5,0,5
"4800","6207雷科","110/07/14","光和-田中",0,4,-4
"4801","3679新至陞","110/07/14","凱基-台北",31,6,25
"4802","3679新至陞","110/07/14","群益金鼎-東大",0,15,-15
"4803","3679新至陞","110/07/14","華南永昌-新莊",10,0,10
"4804","3679新至陞","110/07/14","瑞士信貸",0,12,-12
"4805","3679新至陞","110/07/14","新加坡商瑞銀",11,3,8
"4806","3679新至陞","110/07/14","群益金鼎-永和",0,10,-10
"4807","3679新至陞","110/07/14","美商高盛",6,0,6
"4808","3679新至陞","110/07/14","元大-成功",5,15,-10
"4809","3679新至陞","110/07/14","第一金-中壢",6,0,6
"4810","3679新至陞","110/07/14","統一-板橋",1,10,-9
"4811","3679新至陞","110/07/14","(牛牛牛)亞-網路",4,0,4
"4812","3679新至陞","110/07/14","玉山-左營",0,5,-5
"4813","3679新至陞","110/07/14","元大-六合",3,0,3
"4814","3679新至陞","110/07/14","群益金鼎-三民",0,4,-4
"4815","3679新至陞","110/07/14","合庫-自強",2,0,2
"4816","3679新至陞","110/07/14","富邦-宜蘭",0,4,-4
"4817","3679新至陞","110/07/14","高橋-內壢",2,0,2
"4818","3679新至陞","110/07/14","永豐金-苓雅",0,3,-3
"4819","3679新至陞","110/07/14","台中銀-員林",2,0,2
"4820","3679新至陞","110/07/14","摩根大通",5,7,-2
"4821","3679新至陞","110/07/14","凱基-高美館",2,0,2
"4822","3679新至陞","110/07/14","元大-板橋三民",0,2,-2
"4823","3679新至陞","110/07/14","元大-福營",2,0,2
"4824","3679新至陞","110/07/14","宏遠-中和",0,1,-1
"4825","3679新至陞","110/07/14","永豐金-松山",2,0,2
"4826","3679新至陞","110/07/14","元富-佳里",0,1,-1
"4827","3679新至陞","110/07/14","永豐金-萬盛",2,0,2
"4828","3679新至陞","110/07/14","(牛牛牛)亞-鑫豐",0,1,-1
"4829","3679新至陞","110/07/14","元富-松德",1,0,1
"4830","3679新至陞","110/07/14","中國信託-中壢",0,1,-1
"4831","2727王品","110/07/14","富邦-左營",102,1,101
"4832","2727王品","110/07/14","統一-城中",100,234,-134
"4833","2727王品","110/07/14","國泰-板橋",105,11,94
"4834","2727王品","110/07/14","富邦-台北",1,125,-124
"4835","2727王品","110/07/14","港商野村",149,72,77
"4836","2727王品","110/07/14","台灣摩根士丹利",1,48,-47
"4837","2727王品","110/07/14","合庫-台中",66,2,64
"4838","2727王品","110/07/14","國票-新莊",0,40,-40
"4839","2727王品","110/07/14","臺銀-金山",63,8,55
"4840","2727王品","110/07/14","永豐金-忠孝",2,39,-37
"4841","2727王品","110/07/14","摩根大通",83,39,44
"4842","2727王品","110/07/14","富邦-彰化",1,34,-33
"4843","2727王品","110/07/14","凱基-台北",84,42,42
"4844","2727王品","110/07/14","康和-高雄",0,30,-30
"4845","2727王品","110/07/14","土銀-台中",35,1,34
"4846","2727王品","110/07/14","安泰",0,26,-26
"4847","2727王品","110/07/14","華南永昌-麻豆",32,1,31
"4848","2727王品","110/07/14","富邦-新竹華信",0,21,-21
"4849","2727王品","110/07/14","元大證券",85,55,30
"4850","2727王品","110/07/14","元大-南崁",1,22,-21
"4851","2727王品","110/07/14","新加坡商瑞銀",40,15,25
"4852","2727王品","110/07/14","彰銀-台中",0,18,-18
"4853","2727王品","110/07/14","日盛-八德",19,0,19
"4854","2727王品","110/07/14","元富-同大",2,20,-18
"4855","2727王品","110/07/14","統一",35,17,18
"4856","2727王品","110/07/14","玉山-嘉義",1,17,-16
"4857","2727王品","110/07/14","元富-大昌",18,1,17
"4858","2727王品","110/07/14","國泰-館前",4,20,-16
"4859","2727王品","110/07/14","玉山-板橋",15,1,14
"4860","2727王品","110/07/14","第一金-嘉義",1,13,-12
"4861","1570力肯","110/07/14","國票-北高雄",68,0,68
"4862","1570力肯","110/07/14","摩根大通",0,21,-21
"4863","1570力肯","110/07/14","日盛-八德",30,1,29
"4864","1570力肯","110/07/14","新光",1,19,-18
"4865","1570力肯","110/07/14","玉山-高雄",7,0,7
"4866","1570力肯","110/07/14","(牛牛牛)亞-鑫豐",0,17,-17
"4867","1570力肯","110/07/14","臺銀-臺南",5,0,5
"4868","1570力肯","110/07/14","日盛-士林",0,10,-10
"4869","1570力肯","110/07/14","凱基-三峽",5,0,5
"4870","1570力肯","110/07/14","統一-員林",0,10,-10
"4871","1570力肯","110/07/14","元大-和平",5,0,5
"4872","1570力肯","110/07/14","國票-新莊",0,10,-10
"4873","1570力肯","110/07/14","合庫-三重",4,0,4
"4874","1570力肯","110/07/14","凱基-高美館",0,10,-10
"4875","1570力肯","110/07/14","瑞士信貸",4,0,4
"4876","1570力肯","110/07/14","元大-屏東民生",0,5,-5
"4877","1570力肯","110/07/14","統一-三多",4,0,4
"4878","1570力肯","110/07/14","元大-古亭",0,5,-5
"4879","1570力肯","110/07/14","華南永昌-古亭",4,0,4
"4880","1570力肯","110/07/14","日盛-木柵",0,4,-4
"4881","1570力肯","110/07/14","元大-高雄",3,0,3
"4882","1570力肯","110/07/14","大昌",0,4,-4
"4883","1570力肯","110/07/14","兆豐-忠孝",2,0,2
"4884","1570力肯","110/07/14","群益金鼎-東大",0,4,-4
"4885","1570力肯","110/07/14","富邦-陽明",2,0,2
"4886","1570力肯","110/07/14","凱基-台北",0,4,-4
"4887","1570力肯","110/07/14","元大-松山",2,0,2
"4888","1570力肯","110/07/14","元大-板橋",0,4,-4
"4889","1570力肯","110/07/14","元大-忠孝",2,0,2
"4890","1570力肯","110/07/14","第一金-中山",0,3,-3
"4891","6180橘子","110/07/14","新加坡商瑞銀",84,28,56
"4892","6180橘子","110/07/14","凱基-台北",4,37,-33
"4893","6180橘子","110/07/14","日盛-信義",29,1,28
"4894","6180橘子","110/07/14","玉山-台南",1,22,-21
"4895","6180橘子","110/07/14","豐農",28,4,24
"4896","6180橘子","110/07/14","日盛-新竹",1,21,-20
"4897","6180橘子","110/07/14","新光-新竹",24,1,23
"4898","6180橘子","110/07/14","元富-潮州",0,19,-19
"4899","6180橘子","110/07/14","華南永昌-高雄",20,0,20
"4900","6180橘子","110/07/14","元大-信義",0,17,-17
"4901","6180橘子","110/07/14","元大-羅東",20,0,20
"4902","6180橘子","110/07/14","台灣企銀-台中",1,16,-15
"4903","6180橘子","110/07/14","元大-台中中港",20,0,20
"4904","6180橘子","110/07/14","元大-北港",0,15,-15
"4905","6180橘子","110/07/14","富邦-嘉義",24,5,19
"4906","6180橘子","110/07/14","富邦-高雄",0,14,-14
"4907","6180橘子","110/07/14","富邦-仁愛",15,0,15
"4908","6180橘子","110/07/14","兆豐-埔墘",0,13,-13
"4909","6180橘子","110/07/14","國票-九鼎",13,0,13
"4910","6180橘子","110/07/14","第一金-中山",0,10,-10
"4911","6180橘子","110/07/14","日盛-木柵",12,0,12
"4912","6180橘子","110/07/14","元大-彰化民生",0,10,-10
"4913","6180橘子","110/07/14","元大-成功",10,0,10
"4914","6180橘子","110/07/14","福勝",1,10,-9
"4915","6180橘子","110/07/14","港商野村",10,2,8
"4916","6180橘子","110/07/14","群益金鼎-丹鳳",1,10,-9
"4917","6180橘子","110/07/14","玉山-左營",8,0,8
"4918","6180橘子","110/07/14","群益金鼎-板橋",0,8,-8
"4919","6180橘子","110/07/14","富邦-陽明",16,8,8
"4920","6180橘子","110/07/14","合庫-鳳山",0,7,-7
"4921","2390云辰","110/07/14","摩根大通",995,198,797
"4922","2390云辰","110/07/14","新加坡商瑞銀",28,399,-371
"4923","2390云辰","110/07/14","美林",383,22,361
"4924","2390云辰","110/07/14","凱基-新豐",3,198,-195
"4925","2390云辰","110/07/14","台灣摩根士丹利",684,358,326
"4926","2390云辰","110/07/14","元大-士林",1,152,-151
"4927","2390云辰","110/07/14","凱基-台北",656,402,254
"4928","2390云辰","110/07/14","元大-竹山",80,181,-101
"4929","2390云辰","110/07/14","日盛-和美",110,5,105
"4930","2390云辰","110/07/14","群益金鼎-開元",19,95,-76
"4931","2390云辰","110/07/14","元大-天母",72,0,72
"4932","2390云辰","110/07/14","新光",77,150,-73
"4933","2390云辰","110/07/14","永豐金-松山",57,0,57
"4934","2390云辰","110/07/14","元富-高雄",0,71,-71
"4935","2390云辰","110/07/14","統一-屏東",53,0,53
"4936","2390云辰","110/07/14","元大-土城學府",130,201,-71
"4937","2390云辰","110/07/14","港商野村",486,450,36
"4938","2390云辰","110/07/14","元大-善化",12,76,-64
"4939","2390云辰","110/07/14","致和-崇德",30,0,30
"4940","2390云辰","110/07/14","華南永昌-岡山",23,81,-58
"4941","2390云辰","110/07/14","富邦-台北",40,14,26
"4942","2390云辰","110/07/14","群益金鼎-大興",82,125,-43
"4943","2390云辰","110/07/14","台新-高雄",38,13,25
"4944","2390云辰","110/07/14","大慶-中壢",0,41,-41
"4945","2390云辰","110/07/14","富邦-板橋",32,7,25
"4946","2390云辰","110/07/14","玉山-板橋",6,47,-41
"4947","2390云辰","110/07/14","陽信-石牌",24,0,24
"4948","2390云辰","110/07/14","富邦-台東",2,42,-40
"4949","2390云辰","110/07/14","凱基-屏東",32,8,24
"4950","2390云辰","110/07/14","元大-新營",3,42,-39
"4951","2363矽統","110/07/14","台灣摩根士丹利",463,0,463
"4952","2363矽統","110/07/14","新加坡商瑞銀",568,1321,-753
"4953","2363矽統","110/07/14","台新證券",750,342,408
"4954","2363矽統","110/07/14","瑞士信貸",149,864,-715
"4955","2363矽統","110/07/14","玉山-台中",363,51,312
"4956","2363矽統","110/07/14","台新-屏東",115,380,-265
"4957","2363矽統","110/07/14","元大-斗六",223,25,198
"4958","2363矽統","110/07/14","永豐金證券",16,265,-249
"4959","2363矽統","110/07/14","華南永昌-朴子",208,38,170
"4960","2363矽統","110/07/14","美林",462,701,-239
"4961","2363矽統","110/07/14","元富-西松",169,12,157
"4962","2363矽統","110/07/14","宏遠-桃園",269,500,-231
"4963","2363矽統","110/07/14","永豐金-大園",146,6,140
"4964","2363矽統","110/07/14","凱基-竹北",36,254,-218
"4965","2363矽統","110/07/14","土銀-和平",134,0,134
"4966","2363矽統","110/07/14","港商法國興業",0,214,-214
"4967","2363矽統","110/07/14","富邦-新營",130,13,117
"4968","2363矽統","110/07/14","港商野村",835,1044,-209
"4969","2363矽統","110/07/14","元富-成功",118,11,107
"4970","2363矽統","110/07/14","北城證券",212,411,-199
"4971","2363矽統","110/07/14","元富-烏日",121,18,103
"4972","2363矽統","110/07/14","(牛牛牛)亞-鑫豐",51,241,-190
"4973","2363矽統","110/07/14","日盛-二林",120,18,102
"4974","2363矽統","110/07/14","國票-博愛",24,213,-189
"4975","2363矽統","110/07/14","兆豐-忠孝",98,2,96
"4976","2363矽統","110/07/14","大慶-蘆洲",134,316,-182
"4977","2363矽統","110/07/14","大慶-楊梅",92,3,89
"4978","2363矽統","110/07/14","彰銀-台中",15,193,-178
"4979","2363矽統","110/07/14","元富-三重",120,33,87
"4980","2363矽統","110/07/14","日盛-和美",18,185,-167
"4981","8112至上","110/07/14","新加坡商瑞銀",223,17,206
"4982","8112至上","110/07/14","瑞士信貸",8,170,-162
"4983","8112至上","110/07/14","摩根大通",285,129,156
"4984","8112至上","110/07/14","美林",55,202,-147
"4985","8112至上","110/07/14","花旗環球",124,0,124
"4986","8112至上","110/07/14","凱基-台北",325,436,-111
"4987","8112至上","110/07/14","兆豐-公益",117,4,113
"4988","8112至上","110/07/14","台中銀-台北",0,98,-98
"4989","8112至上","110/07/14","香港上海匯豐",111,0,111
"4990","8112至上","110/07/14","玉山-台大",17,107,-90
"4991","8112至上","110/07/14","永豐金-內湖",117,21,96
"4992","8112至上","110/07/14","康和-內湖",1,90,-89
"4993","8112至上","110/07/14","台灣摩根士丹利",108,16,92
"4994","8112至上","110/07/14","港商野村",21,84,-63
"4995","8112至上","110/07/14","元大-東蘆",77,0,77
"4996","8112至上","110/07/14","兆豐-北高雄",1,60,-59
"4997","8112至上","110/07/14","新光",108,48,60
"4998","8112至上","110/07/14","群益金鼎-海山",1,52,-51
"4999","8112至上","110/07/14","大慶-蘆洲",59,0,59
"5000","8112至上","110/07/14","群益金鼎-大安",0,50,-50
"5001","8112至上","110/07/14","華南永昌-台中",56,3,53
"5002","8112至上","110/07/14","富邦-仁愛",2,49,-47
"5003","8112至上","110/07/14","土銀-嘉義",52,2,50
"5004","8112至上","110/07/14","元大-金華",0,42,-42
"5005","8112至上","110/07/14","美商高盛",40,0,40
"5006","8112至上","110/07/14","元大-內湖",4,43,-39
"5007","8112至上","110/07/14","臺銀",63,29,34
"5008","8112至上","110/07/14","第一金-華江",2,37,-35
"5009","8112至上","110/07/14","元富-嘉義",31,0,31
"5010","8112至上","110/07/14","永豐金-苓雅",2,34,-32
"5011","1570力肯","110/07/14","國票-北高雄",68,0,68
"5012","1570力肯","110/07/14","摩根大通",0,21,-21
"5013","1570力肯","110/07/14","日盛-八德",30,1,29
"5014","1570力肯","110/07/14","新光",1,19,-18
"5015","1570力肯","110/07/14","玉山-高雄",7,0,7
"5016","1570力肯","110/07/14","(牛牛牛)亞-鑫豐",0,17,-17
"5017","1570力肯","110/07/14","臺銀-臺南",5,0,5
"5018","1570力肯","110/07/14","日盛-士林",0,10,-10
"5019","1570力肯","110/07/14","凱基-三峽",5,0,5
"5020","1570力肯","110/07/14","統一-員林",0,10,-10
"5021","1570力肯","110/07/14","元大-和平",5,0,5
"5022","1570力肯","110/07/14","國票-新莊",0,10,-10
"5023","1570力肯","110/07/14","合庫-三重",4,0,4
"5024","1570力肯","110/07/14","凱基-高美館",0,10,-10
"5025","1570力肯","110/07/14","瑞士信貸",4,0,4
"5026","1570力肯","110/07/14","元大-屏東民生",0,5,-5
"5027","1570力肯","110/07/14","統一-三多",4,0,4
"5028","1570力肯","110/07/14","元大-古亭",0,5,-5
"5029","1570力肯","110/07/14","華南永昌-古亭",4,0,4
"5030","1570力肯","110/07/14","日盛-木柵",0,4,-4
"5031","1570力肯","110/07/14","元大-高雄",3,0,3
"5032","1570力肯","110/07/14","大昌",0,4,-4
"5033","1570力肯","110/07/14","兆豐-忠孝",2,0,2
"5034","1570力肯","110/07/14","群益金鼎-東大",0,4,-4
"5035","1570力肯","110/07/14","富邦-陽明",2,0,2
"5036","1570力肯","110/07/14","凱基-台北",0,4,-4
"5037","1570力肯","110/07/14","元大-松山",2,0,2
"5038","1570力肯","110/07/14","元大-板橋",0,4,-4
"5039","1570力肯","110/07/14","元大-忠孝",2,0,2
"5040","1570力肯","110/07/14","第一金-中山",0,3,-3
"5041","2929淘帝","110/07/14","華南永昌-林口",60,0,60
"5042","2929淘帝","110/07/14","群益金鼎",25,540,-515
"5043","2929淘帝","110/07/14","美林",87,31,56
"5044","2929淘帝","110/07/14","國泰-台南",1,30,-29
"5045","2929淘帝","110/07/14","元富-台南",40,0,40
"5046","2929淘帝","110/07/14","宏遠-桃園",0,20,-20
"5047","2929淘帝","110/07/14","元大-民生",39,0,39
"5048","2929淘帝","110/07/14","摩根大通",11,31,-20
"5049","2929淘帝","110/07/14","臺銀-鳳山",34,0,34
"5050","2929淘帝","110/07/14","台新-建北",5,20,-15
"5051","2929淘帝","110/07/14","合庫-高雄",34,1,33
"5052","2929淘帝","110/07/14","新光",1,16,-15
"5053","2929淘帝","110/07/14","華南永昌-鶯歌",28,0,28
"5054","2929淘帝","110/07/14","玉山-板橋",0,15,-15
"5055","2929淘帝","110/07/14","永興",25,0,25
"5056","2929淘帝","110/07/14","凱基-羅東",0,15,-15
"5057","2929淘帝","110/07/14","元大-新盛",25,1,24
"5058","2929淘帝","110/07/14","元大-頭份",0,15,-15
"5059","2929淘帝","110/07/14","日盛-南京",23,0,23
"5060","2929淘帝","110/07/14","第一金-台南",0,13,-13
"5061","2929淘帝","110/07/14","日茂",20,0,20
"5062","2929淘帝","110/07/14","富邦-基隆",0,12,-12
"5063","2929淘帝","110/07/14","台新-台中",20,0,20
"5064","2929淘帝","110/07/14","日茂-南投",1,12,-11
"5065","2929淘帝","110/07/14","華南永昌",20,0,20
"5066","2929淘帝","110/07/14","元大-豐原站前",0,11,-11
"5067","2929淘帝","110/07/14","福勝",15,0,15
"5068","2929淘帝","110/07/14","玉山-士林",0,10,-10
"5069","2929淘帝","110/07/14","富邦-南屯",15,0,15
"5070","2929淘帝","110/07/14","富邦-台北",0,10,-10
"5071","5410國眾","110/07/14","兆豐-城中",35,0,35
"5072","5410國眾","110/07/14","瑞士信貸",0,29,-29
"5073","5410國眾","110/07/14","新光",21,1,20
"5074","5410國眾","110/07/14","國泰-板橋",1,30,-29
"5075","5410國眾","110/07/14","國泰-敦南",21,1,20
"5076","5410國眾","110/07/14","日盛-高雄",0,20,-20
"5077","5410國眾","110/07/14","國泰-台中",20,1,19
"5078","5410國眾","110/07/14","台新-左楠",1,20,-19
"5079","5410國眾","110/07/14","元大-崇德",19,0,19
"5080","5410國眾","110/07/14","元富-大昌",1,18,-17
"5081","5410國眾","110/07/14","土銀-士林",18,0,18
"5082","5410國眾","110/07/14","富邦-建國",0,15,-15
"5083","5410國眾","110/07/14","元大-新盛",20,2,18
"5084","5410國眾","110/07/14","元富-嘉義",0,12,-12
"5085","5410國眾","110/07/14","兆豐-高雄",15,0,15
"5086","5410國眾","110/07/14","永全-南崁",0,12,-12
"5087","5410國眾","110/07/14","宏遠-中和",10,0,10
"5088","5410國眾","110/07/14","元大-員林",0,11,-11
"5089","5410國眾","110/07/14","新光-桃園",10,0,10
"5090","5410國眾","110/07/14","高橋",0,10,-10
"5091","5410國眾","110/07/14","國泰-台南",10,0,10
"5092","5410國眾","110/07/14","永興",0,10,-10
"5093","5410國眾","110/07/14","元大-復北",10,0,10
"5094","5410國眾","110/07/14","華南永昌-三重",0,10,-10
"5095","5410國眾","110/07/14","元大-竹科",8,0,8
"5096","5410國眾","110/07/14","元大-苑裡",0,7,-7
"5097","5410國眾","110/07/14","台新-新營",6,0,6
"5098","5410國眾","110/07/14","港商野村",0,6,-6
"5099","5410國眾","110/07/14","日盛-士林",5,0,5
"5100","5410國眾","110/07/14","摩根大通",5,11,-6
"5101","2841台開","110/07/14","凱基-文心",73,0,73
"5102","2841台開","110/07/14","國泰-敦南",0,50,-50
"5103","2841台開","110/07/14","元富-潮州",30,0,30
"5104","2841台開","110/07/14","凱基-中壢",0,40,-40
"5105","2841台開","110/07/14","第一金-台中",20,0,20
"5106","2841台開","110/07/14","統一-新竹",0,24,-24
"5107","2841台開","110/07/14","華南永昌-新莊",20,0,20
"5108","2841台開","110/07/14","元富-草屯",0,20,-20
"5109","2841台開","110/07/14","永豐金-豐原",20,0,20
"5110","2841台開","110/07/14","台新-台南",0,20,-20
"5111","2841台開","110/07/14","國泰-館前",15,0,15
"5112","2841台開","110/07/14","永豐金-敦南",45,63,-18
"5113","2841台開","110/07/14","群益金鼎-基隆",12,0,12
"5114","2841台開","110/07/14","國票-北高雄",0,13,-13
"5115","2841台開","110/07/14","日盛-信義",10,0,10
"5116","2841台開","110/07/14","凱基-松山",0,10,-10
"5117","2841台開","110/07/14","台新-台中",10,0,10
"5118","2841台開","110/07/14","元大證券",0,10,-10
"5119","2841台開","110/07/14","新光",10,1,9
"5120","2841台開","110/07/14","元大-中壢",0,10,-10
"5121","2841台開","110/07/14","凱基-新店",8,0,8
"5122","2841台開","110/07/14","富邦-陽明",1,10,-9
"5123","2841台開","110/07/14","元大-斗信",7,0,7
"5124","2841台開","110/07/14","富邦-建國",0,9,-9
"5125","2841台開","110/07/14","元大-三重",6,0,6
"5126","2841台開","110/07/14","富邦-台南",0,8,-8
"5127","2841台開","110/07/14","永豐金-中和",6,0,6
"5128","2841台開","110/07/14","康和-澎湖",0,7,-7
"5129","2841台開","110/07/14","元富-成功",5,0,5
"5130","2841台開","110/07/14","日盛-斗六",0,6,-6
"5131","6207雷科","110/07/14","群益金鼎-台北",60,0,60
"5132","6207雷科","110/07/14","新加坡商瑞銀",10,56,-46
"5133","6207雷科","110/07/14","台新-高雄",43,3,40
"5134","6207雷科","110/07/14","國票-中和",0,41,-41
"5135","6207雷科","110/07/14","元大-高雄",19,0,19
"5136","6207雷科","110/07/14","元大-復北",0,33,-33
"5137","6207雷科","110/07/14","福勝",15,0,15
"5138","6207雷科","110/07/14","光和-和美",0,20,-20
"5139","6207雷科","110/07/14","群益金鼎-中山",15,0,15
"5140","6207雷科","110/07/14","群益金鼎-丹鳳",0,20,-20
"5141","6207雷科","110/07/14","元大-林園",15,0,15
"5142","6207雷科","110/07/14","第一金-路竹",0,10,-10
"5143","6207雷科","110/07/14","新光",12,0,12
"5144","6207雷科","110/07/14","元大-歸仁",0,10,-10
"5145","6207雷科","110/07/14","元大-大天母",10,0,10
"5146","6207雷科","110/07/14","宏遠-館前",0,9,-9
"5147","6207雷科","110/07/14","永豐金-忠孝",9,0,9
"5148","6207雷科","110/07/14","凱基-台北",12,20,-8
"5149","6207雷科","110/07/14","永豐金-新店",7,0,7
"5150","6207雷科","110/07/14","美林",0,7,-7
"5151","6207雷科","110/07/14","玉山-嘉義",6,0,6
"5152","6207雷科","110/07/14","摩根大通",16,23,-7
"5153","6207雷科","110/07/14","元大-屏東",6,0,6
"5154","6207雷科","110/07/14","凱基-高雄",1,7,-6
"5155","6207雷科","110/07/14","凱基-大安",5,0,5
"5156","6207雷科","110/07/14","台中銀-豐原",0,5,-5
"5157","6207雷科","110/07/14","富邦-台南",5,0,5
"5158","6207雷科","110/07/14","元大-新竹經國",0,5,-5
"5159","6207雷科","110/07/14","元大-成功",5,0,5
"5160","6207雷科","110/07/14","光和-田中",0,4,-4
"5161","3679新至陞","110/07/14","凱基-台北",31,6,25
"5162","3679新至陞","110/07/14","群益金鼎-東大",0,15,-15
"5163","3679新至陞","110/07/14","華南永昌-新莊",10,0,10
"5164","3679新至陞","110/07/14","瑞士信貸",0,12,-12
"5165","3679新至陞","110/07/14","新加坡商瑞銀",11,3,8
"5166","3679新至陞","110/07/14","群益金鼎-永和",0,10,-10
"5167","3679新至陞","110/07/14","美商高盛",6,0,6
"5168","3679新至陞","110/07/14","元大-成功",5,15,-10
"5169","3679新至陞","110/07/14","第一金-中壢",6,0,6
"5170","3679新至陞","110/07/14","統一-板橋",1,10,-9
"5171","3679新至陞","110/07/14","(牛牛牛)亞-網路",4,0,4
"5172","3679新至陞","110/07/14","玉山-左營",0,5,-5
"5173","3679新至陞","110/07/14","元大-六合",3,0,3
"5174","3679新至陞","110/07/14","群益金鼎-三民",0,4,-4
"5175","3679新至陞","110/07/14","合庫-自強",2,0,2
"5176","3679新至陞","110/07/14","富邦-宜蘭",0,4,-4
"5177","3679新至陞","110/07/14","高橋-內壢",2,0,2
"5178","3679新至陞","110/07/14","永豐金-苓雅",0,3,-3
"5179","3679新至陞","110/07/14","台中銀-員林",2,0,2
"5180","3679新至陞","110/07/14","摩根大通",5,7,-2
"5181","3679新至陞","110/07/14","凱基-高美館",2,0,2
"5182","3679新至陞","110/07/14","元大-板橋三民",0,2,-2
"5183","3679新至陞","110/07/14","元大-福營",2,0,2
"5184","3679新至陞","110/07/14","宏遠-中和",0,1,-1
"5185","3679新至陞","110/07/14","永豐金-松山",2,0,2
"5186","3679新至陞","110/07/14","元富-佳里",0,1,-1
"5187","3679新至陞","110/07/14","永豐金-萬盛",2,0,2
"5188","3679新至陞","110/07/14","(牛牛牛)亞-鑫豐",0,1,-1
"5189","3679新至陞","110/07/14","元富-松德",1,0,1
"5190","3679新至陞","110/07/14","中國信託-中壢",0,1,-1
"5191","2727王品","110/07/14","富邦-左營",102,1,101
"5192","2727王品","110/07/14","統一-城中",100,234,-134
"5193","2727王品","110/07/14","國泰-板橋",105,11,94
"5194","2727王品","110/07/14","富邦-台北",1,125,-124
"5195","2727王品","110/07/14","港商野村",149,72,77
"5196","2727王品","110/07/14","台灣摩根士丹利",1,48,-47
"5197","2727王品","110/07/14","合庫-台中",66,2,64
"5198","2727王品","110/07/14","國票-新莊",0,40,-40
"5199","2727王品","110/07/14","臺銀-金山",63,8,55
"5200","2727王品","110/07/14","永豐金-忠孝",2,39,-37
"5201","2727王品","110/07/14","摩根大通",83,39,44
"5202","2727王品","110/07/14","富邦-彰化",1,34,-33
"5203","2727王品","110/07/14","凱基-台北",84,42,42
"5204","2727王品","110/07/14","康和-高雄",0,30,-30
"5205","2727王品","110/07/14","土銀-台中",35,1,34
"5206","2727王品","110/07/14","安泰",0,26,-26
"5207","2727王品","110/07/14","華南永昌-麻豆",32,1,31
"5208","2727王品","110/07/14","富邦-新竹華信",0,21,-21
"5209","2727王品","110/07/14","元大證券",85,55,30
"5210","2727王品","110/07/14","元大-南崁",1,22,-21
"5211","2727王品","110/07/14","新加坡商瑞銀",40,15,25
"5212","2727王品","110/07/14","彰銀-台中",0,18,-18
"5213","2727王品","110/07/14","日盛-八德",19,0,19
"5214","2727王品","110/07/14","元富-同大",2,20,-18
"5215","2727王品","110/07/14","統一",35,17,18
"5216","2727王品","110/07/14","玉山-嘉義",1,17,-16
"5217","2727王品","110/07/14","元富-大昌",18,1,17
"5218","2727王品","110/07/14","國泰-館前",4,20,-16
"5219","2727王品","110/07/14","玉山-板橋",15,1,14
"5220","2727王品","110/07/14","第一金-嘉義",1,13,-12
"5221","1570力肯","110/07/14","國票-北高雄",68,0,68
"5222","1570力肯","110/07/14","摩根大通",0,21,-21
"5223","1570力肯","110/07/14","日盛-八德",30,1,29
"5224","1570力肯","110/07/14","新光",1,19,-18
"5225","1570力肯","110/07/14","玉山-高雄",7,0,7
"5226","1570力肯","110/07/14","(牛牛牛)亞-鑫豐",0,17,-17
"5227","1570力肯","110/07/14","臺銀-臺南",5,0,5
"5228","1570力肯","110/07/14","日盛-士林",0,10,-10
"5229","1570力肯","110/07/14","凱基-三峽",5,0,5
"5230","1570力肯","110/07/14","統一-員林",0,10,-10
"5231","1570力肯","110/07/14","元大-和平",5,0,5
"5232","1570力肯","110/07/14","國票-新莊",0,10,-10
"5233","1570力肯","110/07/14","合庫-三重",4,0,4
"5234","1570力肯","110/07/14","凱基-高美館",0,10,-10
"5235","1570力肯","110/07/14","瑞士信貸",4,0,4
"5236","1570力肯","110/07/14","元大-屏東民生",0,5,-5
"5237","1570力肯","110/07/14","統一-三多",4,0,4
"5238","1570力肯","110/07/14","元大-古亭",0,5,-5
"5239","1570力肯","110/07/14","華南永昌-古亭",4,0,4
"5240","1570力肯","110/07/14","日盛-木柵",0,4,-4
"5241","1570力肯","110/07/14","元大-高雄",3,0,3
"5242","1570力肯","110/07/14","大昌",0,4,-4
"5243","1570力肯","110/07/14","兆豐-忠孝",2,0,2
"5244","1570力肯","110/07/14","群益金鼎-東大",0,4,-4
"5245","1570力肯","110/07/14","富邦-陽明",2,0,2
"5246","1570力肯","110/07/14","凱基-台北",0,4,-4
"5247","1570力肯","110/07/14","元大-松山",2,0,2
"5248","1570力肯","110/07/14","元大-板橋",0,4,-4
"5249","1570力肯","110/07/14","元大-忠孝",2,0,2
"5250","1570力肯","110/07/14","第一金-中山",0,3,-3
"5251","6180橘子","110/07/14","新加坡商瑞銀",84,28,56
"5252","6180橘子","110/07/14","凱基-台北",4,37,-33
"5253","6180橘子","110/07/14","日盛-信義",29,1,28
"5254","6180橘子","110/07/14","玉山-台南",1,22,-21
"5255","6180橘子","110/07/14","豐農",28,4,24
"5256","6180橘子","110/07/14","日盛-新竹",1,21,-20
"5257","6180橘子","110/07/14","新光-新竹",24,1,23
"5258","6180橘子","110/07/14","元富-潮州",0,19,-19
"5259","6180橘子","110/07/14","華南永昌-高雄",20,0,20
"5260","6180橘子","110/07/14","元大-信義",0,17,-17
"5261","6180橘子","110/07/14","元大-羅東",20,0,20
"5262","6180橘子","110/07/14","台灣企銀-台中",1,16,-15
"5263","6180橘子","110/07/14","元大-台中中港",20,0,20
"5264","6180橘子","110/07/14","元大-北港",0,15,-15
"5265","6180橘子","110/07/14","富邦-嘉義",24,5,19
"5266","6180橘子","110/07/14","富邦-高雄",0,14,-14
"5267","6180橘子","110/07/14","富邦-仁愛",15,0,15
"5268","6180橘子","110/07/14","兆豐-埔墘",0,13,-13
"5269","6180橘子","110/07/14","國票-九鼎",13,0,13
"5270","6180橘子","110/07/14","第一金-中山",0,10,-10
"5271","6180橘子","110/07/14","日盛-木柵",12,0,12
"5272","6180橘子","110/07/14","元大-彰化民生",0,10,-10
"5273","6180橘子","110/07/14","元大-成功",10,0,10
"5274","6180橘子","110/07/14","福勝",1,10,-9
"5275","6180橘子","110/07/14","港商野村",10,2,8
"5276","6180橘子","110/07/14","群益金鼎-丹鳳",1,10,-9
"5277","6180橘子","110/07/14","玉山-左營",8,0,8
"5278","6180橘子","110/07/14","群益金鼎-板橋",0,8,-8
"5279","6180橘子","110/07/14","富邦-陽明",16,8,8
"5280","6180橘子","110/07/14","合庫-鳳山",0,7,-7
"5281","2390云辰","110/07/14","摩根大通",995,198,797
"5282","2390云辰","110/07/14","新加坡商瑞銀",28,399,-371
"5283","2390云辰","110/07/14","美林",383,22,361
"5284","2390云辰","110/07/14","凱基-新豐",3,198,-195
"5285","2390云辰","110/07/14","台灣摩根士丹利",684,358,326
"5286","2390云辰","110/07/14","元大-士林",1,152,-151
"5287","2390云辰","110/07/14","凱基-台北",656,402,254
"5288","2390云辰","110/07/14","元大-竹山",80,181,-101
"5289","2390云辰","110/07/14","日盛-和美",110,5,105
"5290","2390云辰","110/07/14","群益金鼎-開元",19,95,-76
"5291","2390云辰","110/07/14","元大-天母",72,0,72
"5292","2390云辰","110/07/14","新光",77,150,-73
"5293","2390云辰","110/07/14","永豐金-松山",57,0,57
"5294","2390云辰","110/07/14","元富-高雄",0,71,-71
"5295","2390云辰","110/07/14","統一-屏東",53,0,53
"5296","2390云辰","110/07/14","元大-土城學府",130,201,-71
"5297","2390云辰","110/07/14","港商野村",486,450,36
"5298","2390云辰","110/07/14","元大-善化",12,76,-64
"5299","2390云辰","110/07/14","致和-崇德",30,0,30
"5300","2390云辰","110/07/14","華南永昌-岡山",23,81,-58
"5301","2390云辰","110/07/14","富邦-台北",40,14,26
"5302","2390云辰","110/07/14","群益金鼎-大興",82,125,-43
"5303","2390云辰","110/07/14","台新-高雄",38,13,25
"5304","2390云辰","110/07/14","大慶-中壢",0,41,-41
"5305","2390云辰","110/07/14","富邦-板橋",32,7,25
"5306","2390云辰","110/07/14","玉山-板橋",6,47,-41
"5307","2390云辰","110/07/14","陽信-石牌",24,0,24
"5308","2390云辰","110/07/14","富邦-台東",2,42,-40
"5309","2390云辰","110/07/14","凱基-屏東",32,8,24
"5310","2390云辰","110/07/14","元大-新營",3,42,-39
"5311","2363矽統","110/07/14","台灣摩根士丹利",463,0,463
"5312","2363矽統","110/07/14","新加坡商瑞銀",568,1321,-753
"5313","2363矽統","110/07/14","台新證券",750,342,408
"5314","2363矽統","110/07/14","瑞士信貸",149,864,-715
"5315","2363矽統","110/07/14","玉山-台中",363,51,312
"5316","2363矽統","110/07/14","台新-屏東",115,380,-265
"5317","2363矽統","110/07/14","元大-斗六",223,25,198
"5318","2363矽統","110/07/14","永豐金證券",16,265,-249
"5319","2363矽統","110/07/14","華南永昌-朴子",208,38,170
"5320","2363矽統","110/07/14","美林",462,701,-239
"5321","2363矽統","110/07/14","元富-西松",169,12,157
"5322","2363矽統","110/07/14","宏遠-桃園",269,500,-231
"5323","2363矽統","110/07/14","永豐金-大園",146,6,140
"5324","2363矽統","110/07/14","凱基-竹北",36,254,-218
"5325","2363矽統","110/07/14","土銀-和平",134,0,134
"5326","2363矽統","110/07/14","港商法國興業",0,214,-214
"5327","2363矽統","110/07/14","富邦-新營",130,13,117
"5328","2363矽統","110/07/14","港商野村",835,1044,-209
"5329","2363矽統","110/07/14","元富-成功",118,11,107
"5330","2363矽統","110/07/14","北城證券",212,411,-199
"5331","2363矽統","110/07/14","元富-烏日",121,18,103
"5332","2363矽統","110/07/14","(牛牛牛)亞-鑫豐",51,241,-190
"5333","2363矽統","110/07/14","日盛-二林",120,18,102
"5334","2363矽統","110/07/14","國票-博愛",24,213,-189
"5335","2363矽統","110/07/14","兆豐-忠孝",98,2,96
"5336","2363矽統","110/07/14","大慶-蘆洲",134,316,-182
"5337","2363矽統","110/07/14","大慶-楊梅",92,3,89
"5338","2363矽統","110/07/14","彰銀-台中",15,193,-178
"5339","2363矽統","110/07/14","元富-三重",120,33,87
"5340","2363矽統","110/07/14","日盛-和美",18,185,-167
"5341","8112至上","110/07/14","新加坡商瑞銀",223,17,206
"5342","8112至上","110/07/14","瑞士信貸",8,170,-162
"5343","8112至上","110/07/14","摩根大通",285,129,156
"5344","8112至上","110/07/14","美林",55,202,-147
"5345","8112至上","110/07/14","花旗環球",124,0,124
"5346","8112至上","110/07/14","凱基-台北",325,436,-111
"5347","8112至上","110/07/14","兆豐-公益",117,4,113
"5348","8112至上","110/07/14","台中銀-台北",0,98,-98
"5349","8112至上","110/07/14","香港上海匯豐",111,0,111
"5350","8112至上","110/07/14","玉山-台大",17,107,-90
"5351","8112至上","110/07/14","永豐金-內湖",117,21,96
"5352","8112至上","110/07/14","康和-內湖",1,90,-89
"5353","8112至上","110/07/14","台灣摩根士丹利",108,16,92
"5354","8112至上","110/07/14","港商野村",21,84,-63
"5355","8112至上","110/07/14","元大-東蘆",77,0,77
"5356","8112至上","110/07/14","兆豐-北高雄",1,60,-59
"5357","8112至上","110/07/14","新光",108,48,60
"5358","8112至上","110/07/14","群益金鼎-海山",1,52,-51
"5359","8112至上","110/07/14","大慶-蘆洲",59,0,59
"5360","8112至上","110/07/14","群益金鼎-大安",0,50,-50
"5361","8112至上","110/07/14","華南永昌-台中",56,3,53
"5362","8112至上","110/07/14","富邦-仁愛",2,49,-47
"5363","8112至上","110/07/14","土銀-嘉義",52,2,50
"5364","8112至上","110/07/14","元大-金華",0,42,-42
"5365","8112至上","110/07/14","美商高盛",40,0,40
"5366","8112至上","110/07/14","元大-內湖",4,43,-39
"5367","8112至上","110/07/14","臺銀",63,29,34
"5368","8112至上","110/07/14","第一金-華江",2,37,-35
"5369","8112至上","110/07/14","元富-嘉義",31,0,31
"5370","8112至上","110/07/14","永豐金-苓雅",2,34,-32
"5371","1570力肯","110/07/14","國票-北高雄",68,0,68
"5372","1570力肯","110/07/14","摩根大通",0,21,-21
"5373","1570力肯","110/07/14","日盛-八德",30,1,29
"5374","1570力肯","110/07/14","新光",1,19,-18
"5375","1570力肯","110/07/14","玉山-高雄",7,0,7
"5376","1570力肯","110/07/14","(牛牛牛)亞-鑫豐",0,17,-17
"5377","1570力肯","110/07/14","臺銀-臺南",5,0,5
"5378","1570力肯","110/07/14","日盛-士林",0,10,-10
"5379","1570力肯","110/07/14","凱基-三峽",5,0,5
"5380","1570力肯","110/07/14","統一-員林",0,10,-10
"5381","1570力肯","110/07/14","元大-和平",5,0,5
"5382","1570力肯","110/07/14","國票-新莊",0,10,-10
"5383","1570力肯","110/07/14","合庫-三重",4,0,4
"5384","1570力肯","110/07/14","凱基-高美館",0,10,-10
"5385","1570力肯","110/07/14","瑞士信貸",4,0,4
"5386","1570力肯","110/07/14","元大-屏東民生",0,5,-5
"5387","1570力肯","110/07/14","統一-三多",4,0,4
"5388","1570力肯","110/07/14","元大-古亭",0,5,-5
"5389","1570力肯","110/07/14","華南永昌-古亭",4,0,4
"5390","1570力肯","110/07/14","日盛-木柵",0,4,-4
"5391","1570力肯","110/07/14","元大-高雄",3,0,3
"5392","1570力肯","110/07/14","大昌",0,4,-4
"5393","1570力肯","110/07/14","兆豐-忠孝",2,0,2
"5394","1570力肯","110/07/14","群益金鼎-東大",0,4,-4
"5395","1570力肯","110/07/14","富邦-陽明",2,0,2
"5396","1570力肯","110/07/14","凱基-台北",0,4,-4
"5397","1570力肯","110/07/14","元大-松山",2,0,2
"5398","1570力肯","110/07/14","元大-板橋",0,4,-4
"5399","1570力肯","110/07/14","元大-忠孝",2,0,2
"5400","1570力肯","110/07/14","第一金-中山",0,3,-3
"5401","2929淘帝","110/07/14","華南永昌-林口",60,0,60
"5402","2929淘帝","110/07/14","群益金鼎",25,540,-515
"5403","2929淘帝","110/07/14","美林",87,31,56
"5404","2929淘帝","110/07/14","國泰-台南",1,30,-29
"5405","2929淘帝","110/07/14","元富-台南",40,0,40
"5406","2929淘帝","110/07/14","宏遠-桃園",0,20,-20
"5407","2929淘帝","110/07/14","元大-民生",39,0,39
"5408","2929淘帝","110/07/14","摩根大通",11,31,-20
"5409","2929淘帝","110/07/14","臺銀-鳳山",34,0,34
"5410","2929淘帝","110/07/14","台新-建北",5,20,-15
"5411","2929淘帝","110/07/14","合庫-高雄",34,1,33
"5412","2929淘帝","110/07/14","新光",1,16,-15
"5413","2929淘帝","110/07/14","華南永昌-鶯歌",28,0,28
"5414","2929淘帝","110/07/14","玉山-板橋",0,15,-15
"5415","2929淘帝","110/07/14","永興",25,0,25
"5416","2929淘帝","110/07/14","凱基-羅東",0,15,-15
"5417","2929淘帝","110/07/14","元大-新盛",25,1,24
"5418","2929淘帝","110/07/14","元大-頭份",0,15,-15
"5419","2929淘帝","110/07/14","日盛-南京",23,0,23
"5420","2929淘帝","110/07/14","第一金-台南",0,13,-13
"5421","2929淘帝","110/07/14","日茂",20,0,20
"5422","2929淘帝","110/07/14","富邦-基隆",0,12,-12
"5423","2929淘帝","110/07/14","台新-台中",20,0,20
"5424","2929淘帝","110/07/14","日茂-南投",1,12,-11
"5425","2929淘帝","110/07/14","華南永昌",20,0,20
"5426","2929淘帝","110/07/14","元大-豐原站前",0,11,-11
"5427","2929淘帝","110/07/14","福勝",15,0,15
"5428","2929淘帝","110/07/14","玉山-士林",0,10,-10
"5429","2929淘帝","110/07/14","富邦-南屯",15,0,15
"5430","2929淘帝","110/07/14","富邦-台北",0,10,-10
"5431","5410國眾","110/07/14","兆豐-城中",35,0,35
"5432","5410國眾","110/07/14","瑞士信貸",0,29,-29
"5433","5410國眾","110/07/14","新光",21,1,20
"5434","5410國眾","110/07/14","國泰-板橋",1,30,-29
"5435","5410國眾","110/07/14","國泰-敦南",21,1,20
"5436","5410國眾","110/07/14","日盛-高雄",0,20,-20
"5437","5410國眾","110/07/14","國泰-台中",20,1,19
"5438","5410國眾","110/07/14","台新-左楠",1,20,-19
"5439","5410國眾","110/07/14","元大-崇德",19,0,19
"5440","5410國眾","110/07/14","元富-大昌",1,18,-17
"5441","5410國眾","110/07/14","土銀-士林",18,0,18
"5442","5410國眾","110/07/14","富邦-建國",0,15,-15
"5443","5410國眾","110/07/14","元大-新盛",20,2,18
"5444","5410國眾","110/07/14","元富-嘉義",0,12,-12
"5445","5410國眾","110/07/14","兆豐-高雄",15,0,15
"5446","5410國眾","110/07/14","永全-南崁",0,12,-12
"5447","5410國眾","110/07/14","宏遠-中和",10,0,10
"5448","5410國眾","110/07/14","元大-員林",0,11,-11
"5449","5410國眾","110/07/14","新光-桃園",10,0,10
"5450","5410國眾","110/07/14","高橋",0,10,-10
"5451","5410國眾","110/07/14","國泰-台南",10,0,10
"5452","5410國眾","110/07/14","永興",0,10,-10
"5453","5410國眾","110/07/14","元大-復北",10,0,10
"5454","5410國眾","110/07/14","華南永昌-三重",0,10,-10
"5455","5410國眾","110/07/14","元大-竹科",8,0,8
"5456","5410國眾","110/07/14","元大-苑裡",0,7,-7
"5457","5410國眾","110/07/14","台新-新營",6,0,6
"5458","5410國眾","110/07/14","港商野村",0,6,-6
"5459","5410國眾","110/07/14","日盛-士林",5,0,5
"5460","5410國眾","110/07/14","摩根大通",5,11,-6
"5461","2841台開","110/07/14","凱基-文心",73,0,73
"5462","2841台開","110/07/14","國泰-敦南",0,50,-50
"5463","2841台開","110/07/14","元富-潮州",30,0,30
"5464","2841台開","110/07/14","凱基-中壢",0,40,-40
"5465","2841台開","110/07/14","第一金-台中",20,0,20
"5466","2841台開","110/07/14","統一-新竹",0,24,-24
"5467","2841台開","110/07/14","華南永昌-新莊",20,0,20
"5468","2841台開","110/07/14","元富-草屯",0,20,-20
"5469","2841台開","110/07/14","永豐金-豐原",20,0,20
"5470","2841台開","110/07/14","台新-台南",0,20,-20
"5471","2841台開","110/07/14","國泰-館前",15,0,15
"5472","2841台開","110/07/14","永豐金-敦南",45,63,-18
"5473","2841台開","110/07/14","群益金鼎-基隆",12,0,12
"5474","2841台開","110/07/14","國票-北高雄",0,13,-13
"5475","2841台開","110/07/14","日盛-信義",10,0,10
"5476","2841台開","110/07/14","凱基-松山",0,10,-10
"5477","2841台開","110/07/14","台新-台中",10,0,10
"5478","2841台開","110/07/14","元大證券",0,10,-10
"5479","2841台開","110/07/14","新光",10,1,9
"5480","2841台開","110/07/14","元大-中壢",0,10,-10
"5481","2841台開","110/07/14","凱基-新店",8,0,8
"5482","2841台開","110/07/14","富邦-陽明",1,10,-9
"5483","2841台開","110/07/14","元大-斗信",7,0,7
"5484","2841台開","110/07/14","富邦-建國",0,9,-9
"5485","2841台開","110/07/14","元大-三重",6,0,6
"5486","2841台開","110/07/14","富邦-台南",0,8,-8
"5487","2841台開","110/07/14","永豐金-中和",6,0,6
"5488","2841台開","110/07/14","康和-澎湖",0,7,-7
"5489","2841台開","110/07/14","元富-成功",5,0,5
"5490","2841台開","110/07/14","日盛-斗六",0,6,-6
"5491","6207雷科","110/07/14","群益金鼎-台北",60,0,60
"5492","6207雷科","110/07/14","新加坡商瑞銀",10,56,-46
"5493","6207雷科","110/07/14","台新-高雄",43,3,40
"5494","6207雷科","110/07/14","國票-中和",0,41,-41
"5495","6207雷科","110/07/14","元大-高雄",19,0,19
"5496","6207雷科","110/07/14","元大-復北",0,33,-33
"5497","6207雷科","110/07/14","福勝",15,0,15
"5498","6207雷科","110/07/14","光和-和美",0,20,-20
"5499","6207雷科","110/07/14","群益金鼎-中山",15,0,15
"5500","6207雷科","110/07/14","群益金鼎-丹鳳",0,20,-20
"5501","6207雷科","110/07/14","元大-林園",15,0,15
"5502","6207雷科","110/07/14","第一金-路竹",0,10,-10
"5503","6207雷科","110/07/14","新光",12,0,12
"5504","6207雷科","110/07/14","元大-歸仁",0,10,-10
"5505","6207雷科","110/07/14","元大-大天母",10,0,10
"5506","6207雷科","110/07/14","宏遠-館前",0,9,-9
"5507","6207雷科","110/07/14","永豐金-忠孝",9,0,9
"5508","6207雷科","110/07/14","凱基-台北",12,20,-8
"5509","6207雷科","110/07/14","永豐金-新店",7,0,7
"5510","6207雷科","110/07/14","美林",0,7,-7
"5511","6207雷科","110/07/14","玉山-嘉義",6,0,6
"5512","6207雷科","110/07/14","摩根大通",16,23,-7
"5513","6207雷科","110/07/14","元大-屏東",6,0,6
"5514","6207雷科","110/07/14","凱基-高雄",1,7,-6
"5515","6207雷科","110/07/14","凱基-大安",5,0,5
"5516","6207雷科","110/07/14","台中銀-豐原",0,5,-5
"5517","6207雷科","110/07/14","富邦-台南",5,0,5
"5518","6207雷科","110/07/14","元大-新竹經國",0,5,-5
"5519","6207雷科","110/07/14","元大-成功",5,0,5
"5520","6207雷科","110/07/14","光和-田中",0,4,-4
"5521","3679新至陞","110/07/14","凱基-台北",31,6,25
"5522","3679新至陞","110/07/14","群益金鼎-東大",0,15,-15
"5523","3679新至陞","110/07/14","華南永昌-新莊",10,0,10
"5524","3679新至陞","110/07/14","瑞士信貸",0,12,-12
"5525","3679新至陞","110/07/14","新加坡商瑞銀",11,3,8
"5526","3679新至陞","110/07/14","群益金鼎-永和",0,10,-10
"5527","3679新至陞","110/07/14","美商高盛",6,0,6
"5528","3679新至陞","110/07/14","元大-成功",5,15,-10
"5529","3679新至陞","110/07/14","第一金-中壢",6,0,6
"5530","3679新至陞","110/07/14","統一-板橋",1,10,-9
"5531","3679新至陞","110/07/14","(牛牛牛)亞-網路",4,0,4
"5532","3679新至陞","110/07/14","玉山-左營",0,5,-5
"5533","3679新至陞","110/07/14","元大-六合",3,0,3
"5534","3679新至陞","110/07/14","群益金鼎-三民",0,4,-4
"5535","3679新至陞","110/07/14","合庫-自強",2,0,2
"5536","3679新至陞","110/07/14","富邦-宜蘭",0,4,-4
"5537","3679新至陞","110/07/14","高橋-內壢",2,0,2
"5538","3679新至陞","110/07/14","永豐金-苓雅",0,3,-3
"5539","3679新至陞","110/07/14","台中銀-員林",2,0,2
"5540","3679新至陞","110/07/14","摩根大通",5,7,-2
"5541","3679新至陞","110/07/14","凱基-高美館",2,0,2
"5542","3679新至陞","110/07/14","元大-板橋三民",0,2,-2
"5543","3679新至陞","110/07/14","元大-福營",2,0,2
"5544","3679新至陞","110/07/14","宏遠-中和",0,1,-1
"5545","3679新至陞","110/07/14","永豐金-松山",2,0,2
"5546","3679新至陞","110/07/14","元富-佳里",0,1,-1
"5547","3679新至陞","110/07/14","永豐金-萬盛",2,0,2
"5548","3679新至陞","110/07/14","(牛牛牛)亞-鑫豐",0,1,-1
"5549","3679新至陞","110/07/14","元富-松德",1,0,1
"5550","3679新至陞","110/07/14","中國信託-中壢",0,1,-1
"5551","2727王品","110/07/14","富邦-左營",102,1,101
"5552","2727王品","110/07/14","統一-城中",100,234,-134
"5553","2727王品","110/07/14","國泰-板橋",105,11,94
"5554","2727王品","110/07/14","富邦-台北",1,125,-124
"5555","2727王品","110/07/14","港商野村",149,72,77
"5556","2727王品","110/07/14","台灣摩根士丹利",1,48,-47
"5557","2727王品","110/07/14","合庫-台中",66,2,64
"5558","2727王品","110/07/14","國票-新莊",0,40,-40
"5559","2727王品","110/07/14","臺銀-金山",63,8,55
"5560","2727王品","110/07/14","永豐金-忠孝",2,39,-37
"5561","2727王品","110/07/14","摩根大通",83,39,44
"5562","2727王品","110/07/14","富邦-彰化",1,34,-33
"5563","2727王品","110/07/14","凱基-台北",84,42,42
"5564","2727王品","110/07/14","康和-高雄",0,30,-30
"5565","2727王品","110/07/14","土銀-台中",35,1,34
"5566","2727王品","110/07/14","安泰",0,26,-26
"5567","2727王品","110/07/14","華南永昌-麻豆",32,1,31
"5568","2727王品","110/07/14","富邦-新竹華信",0,21,-21
"5569","2727王品","110/07/14","元大證券",85,55,30
"5570","2727王品","110/07/14","元大-南崁",1,22,-21
"5571","2727王品","110/07/14","新加坡商瑞銀",40,15,25
"5572","2727王品","110/07/14","彰銀-台中",0,18,-18
"5573","2727王品","110/07/14","日盛-八德",19,0,19
"5574","2727王品","110/07/14","元富-同大",2,20,-18
"5575","2727王品","110/07/14","統一",35,17,18
"5576","2727王品","110/07/14","玉山-嘉義",1,17,-16
"5577","2727王品","110/07/14","元富-大昌",18,1,17
"5578","2727王品","110/07/14","國泰-館前",4,20,-16
"5579","2727王品","110/07/14","玉山-板橋",15,1,14
"5580","2727王品","110/07/14","第一金-嘉義",1,13,-12
"5581","1570力肯","110/07/14","國票-北高雄",68,0,68
"5582","1570力肯","110/07/14","摩根大通",0,21,-21
"5583","1570力肯","110/07/14","日盛-八德",30,1,29
"5584","1570力肯","110/07/14","新光",1,19,-18
"5585","1570力肯","110/07/14","玉山-高雄",7,0,7
"5586","1570力肯","110/07/14","(牛牛牛)亞-鑫豐",0,17,-17
"5587","1570力肯","110/07/14","臺銀-臺南",5,0,5
"5588","1570力肯","110/07/14","日盛-士林",0,10,-10
"5589","1570力肯","110/07/14","凱基-三峽",5,0,5
"5590","1570力肯","110/07/14","統一-員林",0,10,-10
"5591","1570力肯","110/07/14","元大-和平",5,0,5
"5592","1570力肯","110/07/14","國票-新莊",0,10,-10
"5593","1570力肯","110/07/14","合庫-三重",4,0,4
"5594","1570力肯","110/07/14","凱基-高美館",0,10,-10
"5595","1570力肯","110/07/14","瑞士信貸",4,0,4
"5596","1570力肯","110/07/14","元大-屏東民生",0,5,-5
"5597","1570力肯","110/07/14","統一-三多",4,0,4
"5598","1570力肯","110/07/14","元大-古亭",0,5,-5
"5599","1570力肯","110/07/14","華南永昌-古亭",4,0,4
"5600","1570力肯","110/07/14","日盛-木柵",0,4,-4
"5601","1570力肯","110/07/14","元大-高雄",3,0,3
"5602","1570力肯","110/07/14","大昌",0,4,-4
"5603","1570力肯","110/07/14","兆豐-忠孝",2,0,2
"5604","1570力肯","110/07/14","群益金鼎-東大",0,4,-4
"5605","1570力肯","110/07/14","富邦-陽明",2,0,2
"5606","1570力肯","110/07/14","凱基-台北",0,4,-4
"5607","1570力肯","110/07/14","元大-松山",2,0,2
"5608","1570力肯","110/07/14","元大-板橋",0,4,-4
"5609","1570力肯","110/07/14","元大-忠孝",2,0,2
"5610","1570力肯","110/07/14","第一金-中山",0,3,-3
"5611","6180橘子","110/07/14","新加坡商瑞銀",84,28,56
"5612","6180橘子","110/07/14","凱基-台北",4,37,-33
"5613","6180橘子","110/07/14","日盛-信義",29,1,28
"5614","6180橘子","110/07/14","玉山-台南",1,22,-21
"5615","6180橘子","110/07/14","豐農",28,4,24
"5616","6180橘子","110/07/14","日盛-新竹",1,21,-20
"5617","6180橘子","110/07/14","新光-新竹",24,1,23
"5618","6180橘子","110/07/14","元富-潮州",0,19,-19
"5619","6180橘子","110/07/14","華南永昌-高雄",20,0,20
"5620","6180橘子","110/07/14","元大-信義",0,17,-17
"5621","6180橘子","110/07/14","元大-羅東",20,0,20
"5622","6180橘子","110/07/14","台灣企銀-台中",1,16,-15
"5623","6180橘子","110/07/14","元大-台中中港",20,0,20
"5624","6180橘子","110/07/14","元大-北港",0,15,-15
"5625","6180橘子","110/07/14","富邦-嘉義",24,5,19
"5626","6180橘子","110/07/14","富邦-高雄",0,14,-14
"5627","6180橘子","110/07/14","富邦-仁愛",15,0,15
"5628","6180橘子","110/07/14","兆豐-埔墘",0,13,-13
"5629","6180橘子","110/07/14","國票-九鼎",13,0,13
"5630","6180橘子","110/07/14","第一金-中山",0,10,-10
"5631","6180橘子","110/07/14","日盛-木柵",12,0,12
"5632","6180橘子","110/07/14","元大-彰化民生",0,10,-10
"5633","6180橘子","110/07/14","元大-成功",10,0,10
"5634","6180橘子","110/07/14","福勝",1,10,-9
"5635","6180橘子","110/07/14","港商野村",10,2,8
"5636","6180橘子","110/07/14","群益金鼎-丹鳳",1,10,-9
"5637","6180橘子","110/07/14","玉山-左營",8,0,8
"5638","6180橘子","110/07/14","群益金鼎-板橋",0,8,-8
"5639","6180橘子","110/07/14","富邦-陽明",16,8,8
"5640","6180橘子","110/07/14","合庫-鳳山",0,7,-7
"5641","2390云辰","110/07/14","摩根大通",995,198,797
"5642","2390云辰","110/07/14","新加坡商瑞銀",28,399,-371
"5643","2390云辰","110/07/14","美林",383,22,361
"5644","2390云辰","110/07/14","凱基-新豐",3,198,-195
"5645","2390云辰","110/07/14","台灣摩根士丹利",684,358,326
"5646","2390云辰","110/07/14","元大-士林",1,152,-151
"5647","2390云辰","110/07/14","凱基-台北",656,402,254
"5648","2390云辰","110/07/14","元大-竹山",80,181,-101
"5649","2390云辰","110/07/14","日盛-和美",110,5,105
"5650","2390云辰","110/07/14","群益金鼎-開元",19,95,-76
"5651","2390云辰","110/07/14","元大-天母",72,0,72
"5652","2390云辰","110/07/14","新光",77,150,-73
"5653","2390云辰","110/07/14","永豐金-松山",57,0,57
"5654","2390云辰","110/07/14","元富-高雄",0,71,-71
"5655","2390云辰","110/07/14","統一-屏東",53,0,53
"5656","2390云辰","110/07/14","元大-土城學府",130,201,-71
"5657","2390云辰","110/07/14","港商野村",486,450,36
"5658","2390云辰","110/07/14","元大-善化",12,76,-64
"5659","2390云辰","110/07/14","致和-崇德",30,0,30
"5660","2390云辰","110/07/14","華南永昌-岡山",23,81,-58
"5661","2390云辰","110/07/14","富邦-台北",40,14,26
"5662","2390云辰","110/07/14","群益金鼎-大興",82,125,-43
"5663","2390云辰","110/07/14","台新-高雄",38,13,25
"5664","2390云辰","110/07/14","大慶-中壢",0,41,-41
"5665","2390云辰","110/07/14","富邦-板橋",32,7,25
"5666","2390云辰","110/07/14","玉山-板橋",6,47,-41
"5667","2390云辰","110/07/14","陽信-石牌",24,0,24
"5668","2390云辰","110/07/14","富邦-台東",2,42,-40
"5669","2390云辰","110/07/14","凱基-屏東",32,8,24
"5670","2390云辰","110/07/14","元大-新營",3,42,-39
"5671","2363矽統","110/07/14","台灣摩根士丹利",463,0,463
"5672","2363矽統","110/07/14","新加坡商瑞銀",568,1321,-753
"5673","2363矽統","110/07/14","台新證券",750,342,408
"5674","2363矽統","110/07/14","瑞士信貸",149,864,-715
"5675","2363矽統","110/07/14","玉山-台中",363,51,312
"5676","2363矽統","110/07/14","台新-屏東",115,380,-265
"5677","2363矽統","110/07/14","元大-斗六",223,25,198
"5678","2363矽統","110/07/14","永豐金證券",16,265,-249
"5679","2363矽統","110/07/14","華南永昌-朴子",208,38,170
"5680","2363矽統","110/07/14","美林",462,701,-239
"5681","2363矽統","110/07/14","元富-西松",169,12,157
"5682","2363矽統","110/07/14","宏遠-桃園",269,500,-231
"5683","2363矽統","110/07/14","永豐金-大園",146,6,140
"5684","2363矽統","110/07/14","凱基-竹北",36,254,-218
"5685","2363矽統","110/07/14","土銀-和平",134,0,134
"5686","2363矽統","110/07/14","港商法國興業",0,214,-214
"5687","2363矽統","110/07/14","富邦-新營",130,13,117
"5688","2363矽統","110/07/14","港商野村",835,1044,-209
"5689","2363矽統","110/07/14","元富-成功",118,11,107
"5690","2363矽統","110/07/14","北城證券",212,411,-199
"5691","2363矽統","110/07/14","元富-烏日",121,18,103
"5692","2363矽統","110/07/14","(牛牛牛)亞-鑫豐",51,241,-190
"5693","2363矽統","110/07/14","日盛-二林",120,18,102
"5694","2363矽統","110/07/14","國票-博愛",24,213,-189
"5695","2363矽統","110/07/14","兆豐-忠孝",98,2,96
"5696","2363矽統","110/07/14","大慶-蘆洲",134,316,-182
"5697","2363矽統","110/07/14","大慶-楊梅",92,3,89
"5698","2363矽統","110/07/14","彰銀-台中",15,193,-178
"5699","2363矽統","110/07/14","元富-三重",120,33,87
"5700","2363矽統","110/07/14","日盛-和美",18,185,-167
"5701","8112至上","110/07/14","新加坡商瑞銀",223,17,206
"5702","8112至上","110/07/14","瑞士信貸",8,170,-162
"5703","8112至上","110/07/14","摩根大通",285,129,156
"5704","8112至上","110/07/14","美林",55,202,-147
"5705","8112至上","110/07/14","花旗環球",124,0,124
"5706","8112至上","110/07/14","凱基-台北",325,436,-111
"5707","8112至上","110/07/14","兆豐-公益",117,4,113
"5708","8112至上","110/07/14","台中銀-台北",0,98,-98
"5709","8112至上","110/07/14","香港上海匯豐",111,0,111
"5710","8112至上","110/07/14","玉山-台大",17,107,-90
"5711","8112至上","110/07/14","永豐金-內湖",117,21,96
"5712","8112至上","110/07/14","康和-內湖",1,90,-89
"5713","8112至上","110/07/14","台灣摩根士丹利",108,16,92
"5714","8112至上","110/07/14","港商野村",21,84,-63
"5715","8112至上","110/07/14","元大-東蘆",77,0,77
"5716","8112至上","110/07/14","兆豐-北高雄",1,60,-59
"5717","8112至上","110/07/14","新光",108,48,60
"5718","8112至上","110/07/14","群益金鼎-海山",1,52,-51
"5719","8112至上","110/07/14","大慶-蘆洲",59,0,59
"5720","8112至上","110/07/14","群益金鼎-大安",0,50,-50
"5721","8112至上","110/07/14","華南永昌-台中",56,3,53
"5722","8112至上","110/07/14","富邦-仁愛",2,49,-47
"5723","8112至上","110/07/14","土銀-嘉義",52,2,50
"5724","8112至上","110/07/14","元大-金華",0,42,-42
"5725","8112至上","110/07/14","美商高盛",40,0,40
"5726","8112至上","110/07/14","元大-內湖",4,43,-39
"5727","8112至上","110/07/14","臺銀",63,29,34
"5728","8112至上","110/07/14","第一金-華江",2,37,-35
"5729","8112至上","110/07/14","元富-嘉義",31,0,31
"5730","8112至上","110/07/14","永豐金-苓雅",2,34,-32
"5731","1570力肯","110/07/14","國票-北高雄",68,0,68
"5732","1570力肯","110/07/14","摩根大通",0,21,-21
"5733","1570力肯","110/07/14","日盛-八德",30,1,29
"5734","1570力肯","110/07/14","新光",1,19,-18
"5735","1570力肯","110/07/14","玉山-高雄",7,0,7
"5736","1570力肯","110/07/14","(牛牛牛)亞-鑫豐",0,17,-17
"5737","1570力肯","110/07/14","臺銀-臺南",5,0,5
"5738","1570力肯","110/07/14","日盛-士林",0,10,-10
"5739","1570力肯","110/07/14","凱基-三峽",5,0,5
"5740","1570力肯","110/07/14","統一-員林",0,10,-10
"5741","1570力肯","110/07/14","元大-和平",5,0,5
"5742","1570力肯","110/07/14","國票-新莊",0,10,-10
"5743","1570力肯","110/07/14","合庫-三重",4,0,4
"5744","1570力肯","110/07/14","凱基-高美館",0,10,-10
"5745","1570力肯","110/07/14","瑞士信貸",4,0,4
"5746","1570力肯","110/07/14","元大-屏東民生",0,5,-5
"5747","1570力肯","110/07/14","統一-三多",4,0,4
"5748","1570力肯","110/07/14","元大-古亭",0,5,-5
"5749","1570力肯","110/07/14","華南永昌-古亭",4,0,4
"5750","1570力肯","110/07/14","日盛-木柵",0,4,-4
"5751","1570力肯","110/07/14","元大-高雄",3,0,3
"5752","1570力肯","110/07/14","大昌",0,4,-4
"5753","1570力肯","110/07/14","兆豐-忠孝",2,0,2
"5754","1570力肯","110/07/14","群益金鼎-東大",0,4,-4
"5755","1570力肯","110/07/14","富邦-陽明",2,0,2
"5756","1570力肯","110/07/14","凱基-台北",0,4,-4
"5757","1570力肯","110/07/14","元大-松山",2,0,2
"5758","1570力肯","110/07/14","元大-板橋",0,4,-4
"5759","1570力肯","110/07/14","元大-忠孝",2,0,2
"5760","1570力肯","110/07/14","第一金-中山",0,3,-3
"5761","2929淘帝","110/07/14","華南永昌-林口",60,0,60
"5762","2929淘帝","110/07/14","群益金鼎",25,540,-515
"5763","2929淘帝","110/07/14","美林",87,31,56
"5764","2929淘帝","110/07/14","國泰-台南",1,30,-29
"5765","2929淘帝","110/07/14","元富-台南",40,0,40
"5766","2929淘帝","110/07/14","宏遠-桃園",0,20,-20
"5767","2929淘帝","110/07/14","元大-民生",39,0,39
"5768","2929淘帝","110/07/14","摩根大通",11,31,-20
"5769","2929淘帝","110/07/14","臺銀-鳳山",34,0,34
"5770","2929淘帝","110/07/14","台新-建北",5,20,-15
"5771","2929淘帝","110/07/14","合庫-高雄",34,1,33
"5772","2929淘帝","110/07/14","新光",1,16,-15
"5773","2929淘帝","110/07/14","華南永昌-鶯歌",28,0,28
"5774","2929淘帝","110/07/14","玉山-板橋",0,15,-15
"5775","2929淘帝","110/07/14","永興",25,0,25
"5776","2929淘帝","110/07/14","凱基-羅東",0,15,-15
"5777","2929淘帝","110/07/14","元大-新盛",25,1,24
"5778","2929淘帝","110/07/14","元大-頭份",0,15,-15
"5779","2929淘帝","110/07/14","日盛-南京",23,0,23
"5780","2929淘帝","110/07/14","第一金-台南",0,13,-13
"5781","2929淘帝","110/07/14","日茂",20,0,20
"5782","2929淘帝","110/07/14","富邦-基隆",0,12,-12
"5783","2929淘帝","110/07/14","台新-台中",20,0,20
"5784","2929淘帝","110/07/14","日茂-南投",1,12,-11
"5785","2929淘帝","110/07/14","華南永昌",20,0,20
"5786","2929淘帝","110/07/14","元大-豐原站前",0,11,-11
"5787","2929淘帝","110/07/14","福勝",15,0,15
"5788","2929淘帝","110/07/14","玉山-士林",0,10,-10
"5789","2929淘帝","110/07/14","富邦-南屯",15,0,15
"5790","2929淘帝","110/07/14","富邦-台北",0,10,-10
"5791","5410國眾","110/07/14","兆豐-城中",35,0,35
"5792","5410國眾","110/07/14","瑞士信貸",0,29,-29
"5793","5410國眾","110/07/14","新光",21,1,20
"5794","5410國眾","110/07/14","國泰-板橋",1,30,-29
"5795","5410國眾","110/07/14","國泰-敦南",21,1,20
"5796","5410國眾","110/07/14","日盛-高雄",0,20,-20
"5797","5410國眾","110/07/14","國泰-台中",20,1,19
"5798","5410國眾","110/07/14","台新-左楠",1,20,-19
"5799","5410國眾","110/07/14","元大-崇德",19,0,19
"5800","5410國眾","110/07/14","元富-大昌",1,18,-17
"5801","5410國眾","110/07/14","土銀-士林",18,0,18
"5802","5410國眾","110/07/14","富邦-建國",0,15,-15
"5803","5410國眾","110/07/14","元大-新盛",20,2,18
"5804","5410國眾","110/07/14","元富-嘉義",0,12,-12
"5805","5410國眾","110/07/14","兆豐-高雄",15,0,15
"5806","5410國眾","110/07/14","永全-南崁",0,12,-12
"5807","5410國眾","110/07/14","宏遠-中和",10,0,10
"5808","5410國眾","110/07/14","元大-員林",0,11,-11
"5809","5410國眾","110/07/14","新光-桃園",10,0,10
"5810","5410國眾","110/07/14","高橋",0,10,-10
"5811","5410國眾","110/07/14","國泰-台南",10,0,10
"5812","5410國眾","110/07/14","永興",0,10,-10
"5813","5410國眾","110/07/14","元大-復北",10,0,10
"5814","5410國眾","110/07/14","華南永昌-三重",0,10,-10
"5815","5410國眾","110/07/14","元大-竹科",8,0,8
"5816","5410國眾","110/07/14","元大-苑裡",0,7,-7
"5817","5410國眾","110/07/14","台新-新營",6,0,6
"5818","5410國眾","110/07/14","港商野村",0,6,-6
"5819","5410國眾","110/07/14","日盛-士林",5,0,5
"5820","5410國眾","110/07/14","摩根大通",5,11,-6
"5821","2841台開","110/07/14","凱基-文心",73,0,73
"5822","2841台開","110/07/14","國泰-敦南",0,50,-50
"5823","2841台開","110/07/14","元富-潮州",30,0,30
"5824","2841台開","110/07/14","凱基-中壢",0,40,-40
"5825","2841台開","110/07/14","第一金-台中",20,0,20
"5826","2841台開","110/07/14","統一-新竹",0,24,-24
"5827","2841台開","110/07/14","華南永昌-新莊",20,0,20
"5828","2841台開","110/07/14","元富-草屯",0,20,-20
"5829","2841台開","110/07/14","永豐金-豐原",20,0,20
"5830","2841台開","110/07/14","台新-台南",0,20,-20
"5831","2841台開","110/07/14","國泰-館前",15,0,15
"5832","2841台開","110/07/14","永豐金-敦南",45,63,-18
"5833","2841台開","110/07/14","群益金鼎-基隆",12,0,12
"5834","2841台開","110/07/14","國票-北高雄",0,13,-13
"5835","2841台開","110/07/14","日盛-信義",10,0,10
"5836","2841台開","110/07/14","凱基-松山",0,10,-10
"5837","2841台開","110/07/14","台新-台中",10,0,10
"5838","2841台開","110/07/14","元大證券",0,10,-10
"5839","2841台開","110/07/14","新光",10,1,9
"5840","2841台開","110/07/14","元大-中壢",0,10,-10
"5841","2841台開","110/07/14","凱基-新店",8,0,8
"5842","2841台開","110/07/14","富邦-陽明",1,10,-9
"5843","2841台開","110/07/14","元大-斗信",7,0,7
"5844","2841台開","110/07/14","富邦-建國",0,9,-9
"5845","2841台開","110/07/14","元大-三重",6,0,6
"5846","2841台開","110/07/14","富邦-台南",0,8,-8
"5847","2841台開","110/07/14","永豐金-中和",6,0,6
"5848","2841台開","110/07/14","康和-澎湖",0,7,-7
"5849","2841台開","110/07/14","元富-成功",5,0,5
"5850","2841台開","110/07/14","日盛-斗六",0,6,-6
"5851","6207雷科","110/07/14","群益金鼎-台北",60,0,60
"5852","6207雷科","110/07/14","新加坡商瑞銀",10,56,-46
"5853","6207雷科","110/07/14","台新-高雄",43,3,40
"5854","6207雷科","110/07/14","國票-中和",0,41,-41
"5855","6207雷科","110/07/14","元大-高雄",19,0,19
"5856","6207雷科","110/07/14","元大-復北",0,33,-33
"5857","6207雷科","110/07/14","福勝",15,0,15
"5858","6207雷科","110/07/14","光和-和美",0,20,-20
"5859","6207雷科","110/07/14","群益金鼎-中山",15,0,15
"5860","6207雷科","110/07/14","群益金鼎-丹鳳",0,20,-20
"5861","6207雷科","110/07/14","元大-林園",15,0,15
"5862","6207雷科","110/07/14","第一金-路竹",0,10,-10
"5863","6207雷科","110/07/14","新光",12,0,12
"5864","6207雷科","110/07/14","元大-歸仁",0,10,-10
"5865","6207雷科","110/07/14","元大-大天母",10,0,10
"5866","6207雷科","110/07/14","宏遠-館前",0,9,-9
"5867","6207雷科","110/07/14","永豐金-忠孝",9,0,9
"5868","6207雷科","110/07/14","凱基-台北",12,20,-8
"5869","6207雷科","110/07/14","永豐金-新店",7,0,7
"5870","6207雷科","110/07/14","美林",0,7,-7
"5871","6207雷科","110/07/14","玉山-嘉義",6,0,6
"5872","6207雷科","110/07/14","摩根大通",16,23,-7
"5873","6207雷科","110/07/14","元大-屏東",6,0,6
"5874","6207雷科","110/07/14","凱基-高雄",1,7,-6
"5875","6207雷科","110/07/14","凱基-大安",5,0,5
"5876","6207雷科","110/07/14","台中銀-豐原",0,5,-5
"5877","6207雷科","110/07/14","富邦-台南",5,0,5
"5878","6207雷科","110/07/14","元大-新竹經國",0,5,-5
"5879","6207雷科","110/07/14","元大-成功",5,0,5
"5880","6207雷科","110/07/14","光和-田中",0,4,-4
"5881","3679新至陞","110/07/14","凱基-台北",31,6,25
"5882","3679新至陞","110/07/14","群益金鼎-東大",0,15,-15
"5883","3679新至陞","110/07/14","華南永昌-新莊",10,0,10
"5884","3679新至陞","110/07/14","瑞士信貸",0,12,-12
"5885","3679新至陞","110/07/14","新加坡商瑞銀",11,3,8
"5886","3679新至陞","110/07/14","群益金鼎-永和",0,10,-10
"5887","3679新至陞","110/07/14","美商高盛",6,0,6
"5888","3679新至陞","110/07/14","元大-成功",5,15,-10
"5889","3679新至陞","110/07/14","第一金-中壢",6,0,6
"5890","3679新至陞","110/07/14","統一-板橋",1,10,-9
"5891","3679新至陞","110/07/14","(牛牛牛)亞-網路",4,0,4
"5892","3679新至陞","110/07/14","玉山-左營",0,5,-5
"5893","3679新至陞","110/07/14","元大-六合",3,0,3
"5894","3679新至陞","110/07/14","群益金鼎-三民",0,4,-4
"5895","3679新至陞","110/07/14","合庫-自強",2,0,2
"5896","3679新至陞","110/07/14","富邦-宜蘭",0,4,-4
"5897","3679新至陞","110/07/14","高橋-內壢",2,0,2
"5898","3679新至陞","110/07/14","永豐金-苓雅",0,3,-3
"5899","3679新至陞","110/07/14","台中銀-員林",2,0,2
"5900","3679新至陞","110/07/14","摩根大通",5,7,-2
"5901","3679新至陞","110/07/14","凱基-高美館",2,0,2
"5902","3679新至陞","110/07/14","元大-板橋三民",0,2,-2
"5903","3679新至陞","110/07/14","元大-福營",2,0,2
"5904","3679新至陞","110/07/14","宏遠-中和",0,1,-1
"5905","3679新至陞","110/07/14","永豐金-松山",2,0,2
"5906","3679新至陞","110/07/14","元富-佳里",0,1,-1
"5907","3679新至陞","110/07/14","永豐金-萬盛",2,0,2
"5908","3679新至陞","110/07/14","(牛牛牛)亞-鑫豐",0,1,-1
"5909","3679新至陞","110/07/14","元富-松德",1,0,1
"5910","3679新至陞","110/07/14","中國信託-中壢",0,1,-1
"5911","2727王品","110/07/14","富邦-左營",102,1,101
"5912","2727王品","110/07/14","統一-城中",100,234,-134
"5913","2727王品","110/07/14","國泰-板橋",105,11,94
"5914","2727王品","110/07/14","富邦-台北",1,125,-124
"5915","2727王品","110/07/14","港商野村",149,72,77
"5916","2727王品","110/07/14","台灣摩根士丹利",1,48,-47
"5917","2727王品","110/07/14","合庫-台中",66,2,64
"5918","2727王品","110/07/14","國票-新莊",0,40,-40
"5919","2727王品","110/07/14","臺銀-金山",63,8,55
"5920","2727王品","110/07/14","永豐金-忠孝",2,39,-37
"5921","2727王品","110/07/14","摩根大通",83,39,44
"5922","2727王品","110/07/14","富邦-彰化",1,34,-33
"5923","2727王品","110/07/14","凱基-台北",84,42,42
"5924","2727王品","110/07/14","康和-高雄",0,30,-30
"5925","2727王品","110/07/14","土銀-台中",35,1,34
"5926","2727王品","110/07/14","安泰",0,26,-26
"5927","2727王品","110/07/14","華南永昌-麻豆",32,1,31
"5928","2727王品","110/07/14","富邦-新竹華信",0,21,-21
"5929","2727王品","110/07/14","元大證券",85,55,30
"5930","2727王品","110/07/14","元大-南崁",1,22,-21
"5931","2727王品","110/07/14","新加坡商瑞銀",40,15,25
"5932","2727王品","110/07/14","彰銀-台中",0,18,-18
"5933","2727王品","110/07/14","日盛-八德",19,0,19
"5934","2727王品","110/07/14","元富-同大",2,20,-18
"5935","2727王品","110/07/14","統一",35,17,18
"5936","2727王品","110/07/14","玉山-嘉義",1,17,-16
"5937","2727王品","110/07/14","元富-大昌",18,1,17
"5938","2727王品","110/07/14","國泰-館前",4,20,-16
"5939","2727王品","110/07/14","玉山-板橋",15,1,14
"5940","2727王品","110/07/14","第一金-嘉義",1,13,-12
"5941","1570力肯","110/07/14","國票-北高雄",68,0,68
"5942","1570力肯","110/07/14","摩根大通",0,21,-21
"5943","1570力肯","110/07/14","日盛-八德",30,1,29
"5944","1570力肯","110/07/14","新光",1,19,-18
"5945","1570力肯","110/07/14","玉山-高雄",7,0,7
"5946","1570力肯","110/07/14","(牛牛牛)亞-鑫豐",0,17,-17
"5947","1570力肯","110/07/14","臺銀-臺南",5,0,5
"5948","1570力肯","110/07/14","日盛-士林",0,10,-10
"5949","1570力肯","110/07/14","凱基-三峽",5,0,5
"5950","1570力肯","110/07/14","統一-員林",0,10,-10
"5951","1570力肯","110/07/14","元大-和平",5,0,5
"5952","1570力肯","110/07/14","國票-新莊",0,10,-10
"5953","1570力肯","110/07/14","合庫-三重",4,0,4
"5954","1570力肯","110/07/14","凱基-高美館",0,10,-10
"5955","1570力肯","110/07/14","瑞士信貸",4,0,4
"5956","1570力肯","110/07/14","元大-屏東民生",0,5,-5
"5957","1570力肯","110/07/14","統一-三多",4,0,4
"5958","1570力肯","110/07/14","元大-古亭",0,5,-5
"5959","1570力肯","110/07/14","華南永昌-古亭",4,0,4
"5960","1570力肯","110/07/14","日盛-木柵",0,4,-4
"5961","1570力肯","110/07/14","元大-高雄",3,0,3
"5962","1570力肯","110/07/14","大昌",0,4,-4
"5963","1570力肯","110/07/14","兆豐-忠孝",2,0,2
"5964","1570力肯","110/07/14","群益金鼎-東大",0,4,-4
"5965","1570力肯","110/07/14","富邦-陽明",2,0,2
"5966","1570力肯","110/07/14","凱基-台北",0,4,-4
"5967","1570力肯","110/07/14","元大-松山",2,0,2
"5968","1570力肯","110/07/14","元大-板橋",0,4,-4
"5969","1570力肯","110/07/14","元大-忠孝",2,0,2
"5970","1570力肯","110/07/14","第一金-中山",0,3,-3
"5971","6180橘子","110/07/14","新加坡商瑞銀",84,28,56
"5972","6180橘子","110/07/14","凱基-台北",4,37,-33
"5973","6180橘子","110/07/14","日盛-信義",29,1,28
"5974","6180橘子","110/07/14","玉山-台南",1,22,-21
"5975","6180橘子","110/07/14","豐農",28,4,24
"5976","6180橘子","110/07/14","日盛-新竹",1,21,-20
"5977","6180橘子","110/07/14","新光-新竹",24,1,23
"5978","6180橘子","110/07/14","元富-潮州",0,19,-19
"5979","6180橘子","110/07/14","華南永昌-高雄",20,0,20
"5980","6180橘子","110/07/14","元大-信義",0,17,-17
"5981","6180橘子","110/07/14","元大-羅東",20,0,20
"5982","6180橘子","110/07/14","台灣企銀-台中",1,16,-15
"5983","6180橘子","110/07/14","元大-台中中港",20,0,20
"5984","6180橘子","110/07/14","元大-北港",0,15,-15
"5985","6180橘子","110/07/14","富邦-嘉義",24,5,19
"5986","6180橘子","110/07/14","富邦-高雄",0,14,-14
"5987","6180橘子","110/07/14","富邦-仁愛",15,0,15
"5988","6180橘子","110/07/14","兆豐-埔墘",0,13,-13
"5989","6180橘子","110/07/14","國票-九鼎",13,0,13
"5990","6180橘子","110/07/14","第一金-中山",0,10,-10
"5991","6180橘子","110/07/14","日盛-木柵",12,0,12
"5992","6180橘子","110/07/14","元大-彰化民生",0,10,-10
"5993","6180橘子","110/07/14","元大-成功",10,0,10
"5994","6180橘子","110/07/14","福勝",1,10,-9
"5995","6180橘子","110/07/14","港商野村",10,2,8
"5996","6180橘子","110/07/14","群益金鼎-丹鳳",1,10,-9
"5997","6180橘子","110/07/14","玉山-左營",8,0,8
"5998","6180橘子","110/07/14","群益金鼎-板橋",0,8,-8
"5999","6180橘子","110/07/14","富邦-陽明",16,8,8
"6000","6180橘子","110/07/14","合庫-鳳山",0,7,-7
"6001","2390云辰","110/07/14","摩根大通",995,198,797
"6002","2390云辰","110/07/14","新加坡商瑞銀",28,399,-371
"6003","2390云辰","110/07/14","美林",383,22,361
"6004","2390云辰","110/07/14","凱基-新豐",3,198,-195
"6005","2390云辰","110/07/14","台灣摩根士丹利",684,358,326
"6006","2390云辰","110/07/14","元大-士林",1,152,-151
"6007","2390云辰","110/07/14","凱基-台北",656,402,254
"6008","2390云辰","110/07/14","元大-竹山",80,181,-101
"6009","2390云辰","110/07/14","日盛-和美",110,5,105
"6010","2390云辰","110/07/14","群益金鼎-開元",19,95,-76
"6011","2390云辰","110/07/14","元大-天母",72,0,72
"6012","2390云辰","110/07/14","新光",77,150,-73
"6013","2390云辰","110/07/14","永豐金-松山",57,0,57
"6014","2390云辰","110/07/14","元富-高雄",0,71,-71
"6015","2390云辰","110/07/14","統一-屏東",53,0,53
"6016","2390云辰","110/07/14","元大-土城學府",130,201,-71
"6017","2390云辰","110/07/14","港商野村",486,450,36
"6018","2390云辰","110/07/14","元大-善化",12,76,-64
"6019","2390云辰","110/07/14","致和-崇德",30,0,30
"6020","2390云辰","110/07/14","華南永昌-岡山",23,81,-58
"6021","2390云辰","110/07/14","富邦-台北",40,14,26
"6022","2390云辰","110/07/14","群益金鼎-大興",82,125,-43
"6023","2390云辰","110/07/14","台新-高雄",38,13,25
"6024","2390云辰","110/07/14","大慶-中壢",0,41,-41
"6025","2390云辰","110/07/14","富邦-板橋",32,7,25
"6026","2390云辰","110/07/14","玉山-板橋",6,47,-41
"6027","2390云辰","110/07/14","陽信-石牌",24,0,24
"6028","2390云辰","110/07/14","富邦-台東",2,42,-40
"6029","2390云辰","110/07/14","凱基-屏東",32,8,24
"6030","2390云辰","110/07/14","元大-新營",3,42,-39
"6031","2363矽統","110/07/13","凱基-南崁",2133,63,2070
"6032","2363矽統","110/07/13","凱基-幸福",36,4048,-4012
"6033","2363矽統","110/07/13","國泰-敦南",2195,1617,578
"6034","2363矽統","110/07/13","統一",192,3325,-3133
"6035","2363矽統","110/07/13","中農",670,139,531
"6036","2363矽統","110/07/13","新加坡商瑞銀",1000,2747,-1747
"6037","2363矽統","110/07/13","康和-台中",638,154,484
"6038","2363矽統","110/07/13","凱基-台北",5359,6609,-1250
"6039","2363矽統","110/07/13","群益金鼎-三民",577,137,440
"6040","2363矽統","110/07/13","摩根大通",1930,2858,-928
"6041","2363矽統","110/07/13","台新-屏東",510,88,422
"6042","2363矽統","110/07/13","港商野村",960,1679,-719
"6043","2363矽統","110/07/13","德信-中正",455,67,388
"6044","2363矽統","110/07/13","兆豐-復興",25,705,-680
"6045","2363矽統","110/07/13","日盛-竹北",365,70,295
"6046","2363矽統","110/07/13","統一-仁愛",114,755,-641
"6047","2363矽統","110/07/13","元大-佳里",452,189,263
"6048","2363矽統","110/07/13","統一-敦南",29,638,-609
"6049","2363矽統","110/07/13","國票-博愛",296,38,258
"6050","2363矽統","110/07/13","統一-土城",100,704,-604
"6051","2363矽統","110/07/13","元大-萬華",340,95,245
"6052","2363矽統","110/07/13","統一-城中",116,676,-560
"6053","2363矽統","110/07/13","新光",1259,1031,228
"6054","2363矽統","110/07/13","永豐金證券",306,859,-553
"6055","2363矽統","110/07/13","元富-成功",323,96,227
"6056","2363矽統","110/07/13","元富",54,567,-513
"6057","2363矽統","110/07/13","豐農",228,23,205
"6058","2363矽統","110/07/13","瑞士信貸",202,666,-464
"6059","2363矽統","110/07/13","台灣企銀-岡山",186,4,182
"6060","2363矽統","110/07/13","永豐金-嘉義",67,468,-401
"6061","8112至上","110/07/13","摩根大通",688,296,392
"6062","8112至上","110/07/13","國票-中和",0,401,-401
"6063","8112至上","110/07/13","港商野村",344,145,199
"6064","8112至上","110/07/13","永豐金-板盛",0,205,-205
"6065","8112至上","110/07/13","兆豐-公益",195,5,190
"6066","8112至上","110/07/13","凱基-五股",43,155,-112
"6067","8112至上","110/07/13","台灣摩根士丹利",183,0,183
"6068","8112至上","110/07/13","凱基-市政",0,100,-100
"6069","8112至上","110/07/13","群益金鼎-敦南",153,2,151
"6070","8112至上","110/07/13","元大-大里德芳",1,92,-91
"6071","8112至上","110/07/13","臺銀-金山",146,26,120
"6072","8112至上","110/07/13","玉山-桃園",26,110,-84
"6073","8112至上","110/07/13","臺銀",133,19,114
"6074","8112至上","110/07/13","兆豐-天母",0,81,-81
"6075","8112至上","110/07/13","合庫-台中",115,6,109
"6076","8112至上","110/07/13","凱基-城中",3,84,-81
"6077","8112至上","110/07/13","亞東-板橋",134,26,108
"6078","8112至上","110/07/13","日盛-新莊",9,85,-76
"6079","8112至上","110/07/13","凱基-台北",414,326,88
"6080","8112至上","110/07/13","日盛-台中",2,64,-62
"6081","8112至上","110/07/13","新加坡商瑞銀",181,100,81
"6082","8112至上","110/07/13","日盛-中壢",3,64,-61
"6083","8112至上","110/07/13","國泰-敦南",108,31,77
"6084","8112至上","110/07/13","元大-台中",2,59,-57
"6085","8112至上","110/07/13","第一金-華江",77,4,73
"6086","8112至上","110/07/13","元大-雙和",7,64,-57
"6087","8112至上","110/07/13","永豐金-內湖",73,1,72
"6088","8112至上","110/07/13","元大-高雄",8,62,-54
"6089","8112至上","110/07/13","元大-永和",68,1,67
"6090","8112至上","110/07/13","元大-館前",2,55,-53
"6091","1570力肯","110/07/13","新光",115,11,104
"6092","1570力肯","110/07/13","元大-北三重",0,162,-162
"6093","1570力肯","110/07/13","群益金鼎-高雄",54,0,54
"6094","1570力肯","110/07/13","元大-大灣",0,25,-25
"6095","1570力肯","110/07/13","國票-新莊",22,0,22
"6096","1570力肯","110/07/13","永豐金-苓雅",0,22,-22
"6097","1570力肯","110/07/13","日盛-桃園",12,0,12
"6098","1570力肯","110/07/13","永豐金-永康",0,19,-19
"6099","1570力肯","110/07/13","元大-高雄",12,0,12
"6100","1570力肯","110/07/13","富邦-員林",0,15,-15
"6101","1570力肯","110/07/13","合庫-自強",11,0,11
"6102","1570力肯","110/07/13","凱基-台南",0,11,-11
"6103","1570力肯","110/07/13","摩根大通",26,15,11
"6104","1570力肯","110/07/13","日盛-竹北",0,10,-10
"6105","1570力肯","110/07/13","永豐金-中盛",11,0,11
"6106","1570力肯","110/07/13","國票-九鼎",0,10,-10
"6107","1570力肯","110/07/13","兆豐-台中港",10,0,10
"6108","1570力肯","110/07/13","凱基-桃園",0,10,-10
"6109","1570力肯","110/07/13","國泰-松江",9,0,9
"6110","1570力肯","110/07/13","凱基-新豐",0,10,-10
"6111","1570力肯","110/07/13","元大-新盛",9,0,9
"6112","1570力肯","110/07/13","元大-學甲",0,10,-10
"6113","1570力肯","110/07/13","元富-緯城",6,0,6
"6114","1570力肯","110/07/13","群益金鼎-東湖",1,10,-9
"6115","1570力肯","110/07/13","統一-三重",5,0,5
"6116","1570力肯","110/07/13","大昌",0,6,-6
"6117","1570力肯","110/07/13","元大-前金",5,0,5
"6118","1570力肯","110/07/13","元大-土城學府",0,6,-6
"6119","1570力肯","110/07/13","永豐金證券",5,0,5
"6120","1570力肯","110/07/13","統一",0,5,-5
"6121","2929淘帝","110/07/13","玉山-新竹",130,0,130
"6122","2929淘帝","110/07/13","美商高盛",0,177,-177
"6123","2929淘帝","110/07/13","臺銀-民權",60,0,60
"6124","2929淘帝","110/07/13","凱基-台北",6,80,-74
"6125","2929淘帝","110/07/13","新百王",31,0,31
"6126","2929淘帝","110/07/13","元富-大裕",0,49,-49
"6127","2929淘帝","110/07/13","日盛-園區",30,0,30
"6128","2929淘帝","110/07/13","國泰-館前",3,51,-48
"6129","2929淘帝","110/07/13","元大-南投",31,1,30
"6130","2929淘帝","110/07/13","凱基-中壢",0,41,-41
"6131","2929淘帝","110/07/13","兆豐-忠孝",28,0,28
"6132","2929淘帝","110/07/13","港商野村",21,55,-34
"6133","2929淘帝","110/07/13","元大-民生",28,0,28
"6134","2929淘帝","110/07/13","華南永昌-南京",2,34,-32
"6135","2929淘帝","110/07/13","合庫-高雄",27,0,27
"6136","2929淘帝","110/07/13","群益金鼎-土城",0,30,-30
"6137","2929淘帝","110/07/13","凱基-豐中",27,0,27
"6138","2929淘帝","110/07/13","富邦-南屯",0,22,-22
"6139","2929淘帝","110/07/13","新光",21,4,17
"6140","2929淘帝","110/07/13","第一金-豐原",0,20,-20
"6141","2929淘帝","110/07/13","元大-天母",17,0,17
"6142","2929淘帝","110/07/13","元大-屏南",6,26,-20
"6143","2929淘帝","110/07/13","永興",14,0,14
"6144","2929淘帝","110/07/13","永豐金-敦南",1,21,-20
"6145","2929淘帝","110/07/13","富邦-台北",12,0,12
"6146","2929淘帝","110/07/13","凱基-三重",2,21,-19
"6147","2929淘帝","110/07/13","元大-永和",12,0,12
"6148","2929淘帝","110/07/13","富邦-仁愛",7,25,-18
"6149","2929淘帝","110/07/13","國票-天祥",11,0,11
"6150","2929淘帝","110/07/13","元大-北投",0,16,-16
"6151","5410國眾","110/07/13","兆豐-城中",274,0,274
"6152","5410國眾","110/07/13","元富-嘉義",0,103,-103
"6153","5410國眾","110/07/13","新光",50,4,46
"6154","5410國眾","110/07/13","凱基-台北",0,50,-50
"6155","5410國眾","110/07/13","國泰-台中",26,0,26
"6156","5410國眾","110/07/13","瑞士信貸",0,31,-31
"6157","5410國眾","110/07/13","新加坡商瑞銀",22,0,22
"6158","5410國眾","110/07/13","台新-新莊",0,27,-27
"6159","5410國眾","110/07/13","光和-嘉義",20,0,20
"6160","5410國眾","110/07/13","元大-汐止",0,20,-20
"6161","5410國眾","110/07/13","凱基-竹北",17,0,17
"6162","5410國眾","110/07/13","亞東-新竹",0,17,-17
"6163","5410國眾","110/07/13","新光-桃園",15,0,15
"6164","5410國眾","110/07/13","元大-南勢角",0,13,-13
"6165","5410國眾","110/07/13","凱基-台東",14,0,14
"6166","5410國眾","110/07/13","台新-台南",0,12,-12
"6167","5410國眾","110/07/13","富邦-竹北",11,0,11
"6168","5410國眾","110/07/13","中國信託",0,11,-11
"6169","5410國眾","110/07/13","元富-同大",10,0,10
"6170","5410國眾","110/07/13","華南永昌",0,11,-11
"6171","5410國眾","110/07/13","國泰-敦南",24,15,9
"6172","5410國眾","110/07/13","臺銀-臺南",0,10,-10
"6173","5410國眾","110/07/13","日盛-內湖",7,0,7
"6174","5410國眾","110/07/13","台灣企銀-民雄",0,10,-10
"6175","5410國眾","110/07/13","台新-左楠",7,0,7
"6176","5410國眾","110/07/13","高橋",0,10,-10
"6177","5410國眾","110/07/13","元大-新盛",18,12,6
"6178","5410國眾","110/07/13","康和-嘉義",0,10,-10
"6179","5410國眾","110/07/13","統一",5,0,5
"6180","5410國眾","110/07/13","凱基-基隆",0,10,-10
"6181","2841台開","110/07/13","中國信託-高雄",251,50,201
"6182","2841台開","110/07/13","兆豐-公益",0,177,-177
"6183","2841台開","110/07/13","日盛證券",210,13,197
"6184","2841台開","110/07/13","日進",0,152,-152
"6185","2841台開","110/07/13","第一金-台中",55,0,55
"6186","2841台開","110/07/13","港商野村",0,109,-109
"6187","2841台開","110/07/13","國泰-板橋",46,0,46
"6188","2841台開","110/07/13","日盛-信義",0,103,-103
"6189","2841台開","110/07/13","國泰-館前",48,3,45
"6190","2841台開","110/07/13","國泰-敦南",11,75,-64
"6191","2841台開","110/07/13","華南永昌-新莊",45,0,45
"6192","2841台開","110/07/13","永興",0,50,-50
"6193","2841台開","110/07/13","日盛-園區",42,0,42
"6194","2841台開","110/07/13","永豐金-敦南",61,104,-43
"6195","2841台開","110/07/13","台新證券",32,0,32
"6196","2841台開","110/07/13","富邦-台南",0,42,-42
"6197","2841台開","110/07/13","台新-高雄",32,2,30
"6198","2841台開","110/07/13","國票-安和",0,30,-30
"6199","2841台開","110/07/13","豐農",23,0,23
"6200","2841台開","110/07/13","元大-桃園",0,25,-25
"6201","2841台開","110/07/13","合庫-嘉義",20,0,20
"6202","2841台開","110/07/13","新光",8,32,-24
"6203","2841台開","110/07/13","華南永昌-高雄",20,0,20
"6204","2841台開","110/07/13","元大-仁愛",0,24,-24
"6205","2841台開","110/07/13","元大-樹林",16,0,16
"6206","2841台開","110/07/13","日盛-中和",0,20,-20
"6207","2841台開","110/07/13","第一金-華江",15,2,13
"6208","2841台開","110/07/13","元富",0,20,-20
"6209","2841台開","110/07/13","美商高盛",12,0,12
"6210","2841台開","110/07/13","富邦-宜蘭",0,20,-20
"6211","6207雷科","110/07/13","元大-高雄",121,0,121
"6212","6207雷科","110/07/13","華南永昌-朴子",1,60,-59
"6213","6207雷科","110/07/13","第一金-新興",20,0,20
"6214","6207雷科","110/07/13","元大-南海",0,36,-36
"6215","6207雷科","110/07/13","元富-三重",20,0,20
"6216","6207雷科","110/07/13","凱基-土城",0,35,-35
"6217","6207雷科","110/07/13","元大-林園",15,0,15
"6218","6207雷科","110/07/13","台灣企銀",0,20,-20
"6219","6207雷科","110/07/13","元大-金華",16,1,15
"6220","6207雷科","110/07/13","群益金鼎-丹鳳",0,20,-20
"6221","6207雷科","110/07/13","日盛證券",10,0,10
"6222","6207雷科","110/07/13","元大-博愛",0,17,-17
"6223","6207雷科","110/07/13","統一-台中",10,0,10
"6224","6207雷科","110/07/13","元大-北港",0,13,-13
"6225","6207雷科","110/07/13","群益金鼎-土城",10,0,10
"6226","6207雷科","110/07/13","新加坡商瑞銀",0,12,-12
"6227","6207雷科","110/07/13","群益金鼎-桃園",10,0,10
"6228","6207雷科","110/07/13","凱基-台北",4,16,-12
"6229","6207雷科","110/07/13","永豐金-新莊",10,0,10
"6230","6207雷科","110/07/13","日茂-埔里",0,11,-11
"6231","6207雷科","110/07/13","永豐金-新店",10,0,10
"6232","6207雷科","110/07/13","元大-莒光",0,11,-11
"6233","6207雷科","110/07/13","元大證券",9,0,9
"6234","6207雷科","110/07/13","統一-新竹",0,10,-10
"6235","6207雷科","110/07/13","日盛-木柵",9,1,8
"6236","6207雷科","110/07/13","元大-西螺",0,10,-10
"6237","6207雷科","110/07/13","兆豐-來福",8,0,8
"6238","6207雷科","110/07/13","康和-台中",0,8,-8
"6239","6207雷科","110/07/13","新光",7,0,7
"6240","6207雷科","110/07/13","兆豐-高雄",0,6,-6
"6241","3679新至陞","110/07/13","永豐金證券",50,0,50
"6242","3679新至陞","110/07/13","摩根大通",2,25,-23
"6243","3679新至陞","110/07/13","國泰-桃園",22,0,22
"6244","3679新至陞","110/07/13","元大-成功",0,22,-22
"6245","3679新至陞","110/07/13","台中銀-員林",11,0,11
"6246","3679新至陞","110/07/13","富邦-板橋",1,19,-18
"6247","3679新至陞","110/07/13","元大-文心興安",8,0,8
"6248","3679新至陞","110/07/13","日盛-新莊",0,10,-10
"6249","3679新至陞","110/07/13","美商高盛",6,0,6
"6250","3679新至陞","110/07/13","台新-台中",0,10,-10
"6251","3679新至陞","110/07/13","台新-高雄",6,0,6
"6252","3679新至陞","110/07/13","永豐金-新竹",0,8,-8
"6253","3679新至陞","110/07/13","凱基-台北",18,12,6
"6254","3679新至陞","110/07/13","瑞士信貸",12,19,-7
"6255","3679新至陞","110/07/13","日盛-復興",5,0,5
"6256","3679新至陞","110/07/13","統一-南京",0,7,-7
"6257","3679新至陞","110/07/13","(牛牛牛)亞-鑫豐",4,0,4
"6258","3679新至陞","110/07/13","凱基-新莊",0,7,-7
"6259","3679新至陞","110/07/13","元富-大昌",3,0,3
"6260","3679新至陞","110/07/13","新加坡商瑞銀",0,6,-6
"6261","3679新至陞","110/07/13","富邦-台北",3,0,3
"6262","3679新至陞","110/07/13","合庫-自強",0,5,-5
"6263","3679新至陞","110/07/13","日盛-樹林",2,0,2
"6264","3679新至陞","110/07/13","富邦-桃園",0,5,-5
"6265","3679新至陞","110/07/13","宏遠-光隆",2,0,2
"6266","3679新至陞","110/07/13","永豐金-潮州",0,4,-4
"6267","3679新至陞","110/07/13","美林",3,1,2
"6268","3679新至陞","110/07/13","臺銀-臺南",0,3,-3
"6269","3679新至陞","110/07/13","第一金-中壢",2,0,2
"6270","3679新至陞","110/07/13","元大-六合",0,3,-3
"6271","2727王品","110/07/13","富邦-台北",43,3,40
"6272","2727王品","110/07/13","台灣摩根士丹利",15,97,-82
"6273","2727王品","110/07/13","元大-基隆孝二",40,0,40
"6274","2727王品","110/07/13","玉山-台南",5,57,-52
"6275","2727王品","110/07/13","國票-新莊",40,1,39
"6276","2727王品","110/07/13","新加坡商瑞銀",0,48,-48
"6277","2727王品","110/07/13","第一金-豐原",66,42,24
"6278","2727王品","110/07/13","凱基-台北",41,77,-36
"6279","2727王品","110/07/13","永豐金-大園",34,10,24
"6280","2727王品","110/07/13","永豐金-永康",0,22,-22
"6281","2727王品","110/07/13","元大-北屯",22,0,22
"6282","2727王品","110/07/13","統一-台中",2,22,-20
"6283","2727王品","110/07/13","元大-東蘆",26,7,19
"6284","2727王品","110/07/13","國泰-台中",21,39,-18
"6285","2727王品","110/07/13","永豐金-萬盛",13,1,12
"6286","2727王品","110/07/13","合庫-彰化",3,20,-17
"6287","2727王品","110/07/13","日盛-嘉義",11,0,11
"6288","2727王品","110/07/13","港商野村",13,30,-17
"6289","2727王品","110/07/13","日盛-八德",11,0,11
"6290","2727王品","110/07/13","元大-楊梅",1,16,-15
"6291","2727王品","110/07/13","統一-竹南",11,0,11
"6292","2727王品","110/07/13","凱基-高美館",2,15,-13
"6293","2727王品","110/07/13","日盛-士林",12,2,10
"6294","2727王品","110/07/13","美商高盛",2,14,-12
"6295","2727王品","110/07/13","統一-敦南",10,0,10
"6296","2727王品","110/07/13","統一-平鎮",1,13,-12
"6297","2727王品","110/07/13","中國信託",15,5,10
"6298","2727王品","110/07/13","兆豐-台中港",4,16,-12
"6299","2727王品","110/07/13","兆豐-竹北",13,3,10
"6300","2727王品","110/07/13","凱基-八德",1,13,-12
"6301","1570力肯","110/07/13","新光",115,11,104
"6302","1570力肯","110/07/13","元大-北三重",0,162,-162
"6303","1570力肯","110/07/13","群益金鼎-高雄",54,0,54
"6304","1570力肯","110/07/13","元大-大灣",0,25,-25
"6305","1570力肯","110/07/13","國票-新莊",22,0,22
"6306","1570力肯","110/07/13","永豐金-苓雅",0,22,-22
"6307","1570力肯","110/07/13","日盛-桃園",12,0,12
"6308","1570力肯","110/07/13","永豐金-永康",0,19,-19
"6309","1570力肯","110/07/13","元大-高雄",12,0,12
"6310","1570力肯","110/07/13","富邦-員林",0,15,-15
"6311","1570力肯","110/07/13","合庫-自強",11,0,11
"6312","1570力肯","110/07/13","凱基-台南",0,11,-11
"6313","1570力肯","110/07/13","摩根大通",26,15,11
"6314","1570力肯","110/07/13","日盛-竹北",0,10,-10
"6315","1570力肯","110/07/13","永豐金-中盛",11,0,11
"6316","1570力肯","110/07/13","國票-九鼎",0,10,-10
"6317","1570力肯","110/07/13","兆豐-台中港",10,0,10
"6318","1570力肯","110/07/13","凱基-桃園",0,10,-10
"6319","1570力肯","110/07/13","國泰-松江",9,0,9
"6320","1570力肯","110/07/13","凱基-新豐",0,10,-10
"6321","1570力肯","110/07/13","元大-新盛",9,0,9
"6322","1570力肯","110/07/13","元大-學甲",0,10,-10
"6323","1570力肯","110/07/13","元富-緯城",6,0,6
"6324","1570力肯","110/07/13","群益金鼎-東湖",1,10,-9
"6325","1570力肯","110/07/13","統一-三重",5,0,5
"6326","1570力肯","110/07/13","大昌",0,6,-6
"6327","1570力肯","110/07/13","元大-前金",5,0,5
"6328","1570力肯","110/07/13","元大-土城學府",0,6,-6
"6329","1570力肯","110/07/13","永豐金證券",5,0,5
"6330","1570力肯","110/07/13","統一",0,5,-5
"6331","6180橘子","110/07/13","摩根大通",119,0,119
"6332","6180橘子","110/07/13","元大-崇德",2,61,-59
"6333","6180橘子","110/07/13","美商高盛",96,0,96
"6334","6180橘子","110/07/13","康和-台中",0,51,-51
"6335","6180橘子","110/07/13","新加坡商瑞銀",86,7,79
"6336","6180橘子","110/07/13","康和-台北",0,50,-50
"6337","6180橘子","110/07/13","元大-和平",40,0,40
"6338","6180橘子","110/07/13","元富-潮州",0,40,-40
"6339","6180橘子","110/07/13","凱基-台北",83,47,36
"6340","6180橘子","110/07/13","日盛-永康",0,26,-26
"6341","6180橘子","110/07/13","美林",39,5,34
"6342","6180橘子","110/07/13","永豐金-中正",0,24,-24
"6343","6180橘子","110/07/13","富邦-新竹華信",31,2,29
"6344","6180橘子","110/07/13","國泰-板橋",2,25,-23
"6345","6180橘子","110/07/13","統一-南京",21,0,21
"6346","6180橘子","110/07/13","日盛-大墩",0,20,-20
"6347","6180橘子","110/07/13","富邦-陽明",24,3,21
"6348","6180橘子","110/07/13","元大-草屯",13,32,-19
"6349","6180橘子","110/07/13","大昌-樹林",21,1,20
"6350","6180橘子","110/07/13","元富-林園",1,18,-17
"6351","6180橘子","110/07/13","花旗環球",19,0,19
"6352","6180橘子","110/07/13","新光-新竹",1,18,-17
"6353","6180橘子","110/07/13","華南永昌-台南",19,0,19
"6354","6180橘子","110/07/13","元大-土城永寧",0,17,-17
"6355","6180橘子","110/07/13","福勝",14,0,14
"6356","6180橘子","110/07/13","國泰-新莊",3,19,-16
"6357","6180橘子","110/07/13","富邦-嘉義",12,1,11
"6358","6180橘子","110/07/13","中國信託-永康",6,21,-15
"6359","6180橘子","110/07/13","元大-板橋三民",11,0,11
"6360","6180橘子","110/07/13","凱基-東港",1,15,-14
"6361","2390云辰","110/07/13","新加坡商瑞銀",562,75,487
"6362","2390云辰","110/07/13","大展-台南",0,532,-532
"6363","2390云辰","110/07/13","台灣摩根士丹利",330,155,175
"6364","2390云辰","110/07/13","凱基-台北",668,854,-186
"6365","2390云辰","110/07/13","兆豐-公益",126,25,101
"6366","2390云辰","110/07/13","凱基-三重",12,172,-160
"6367","2390云辰","110/07/13","元富-中港",100,2,98
"6368","2390云辰","110/07/13","兆豐-忠孝",4,161,-157
"6369","2390云辰","110/07/13","統一-新台中",106,9,97
"6370","2390云辰","110/07/13","元大-士林",19,170,-151
"6371","2390云辰","110/07/13","中國信託-松江",81,11,70
"6372","2390云辰","110/07/13","臺銀-新竹",14,117,-103
"6373","2390云辰","110/07/13","日盛-板橋",72,3,69
"6374","2390云辰","110/07/13","國票-台中",4,102,-98
"6375","2390云辰","110/07/13","日盛-和美",57,0,57
"6376","2390云辰","110/07/13","新光",147,232,-85
"6377","2390云辰","110/07/13","永豐金-桃園",88,36,52
"6378","2390云辰","110/07/13","致和-崇德",2,70,-68
"6379","2390云辰","110/07/13","玉山-士林",54,4,50
"6380","2390云辰","110/07/13","群益金鼎-屏東",2,70,-68
"6381","2390云辰","110/07/13","富邦-仁愛",56,6,50
"6382","2390云辰","110/07/13","元大-大里",35,98,-63
"6383","2390云辰","110/07/13","第一金-豐原",50,1,49
"6384","2390云辰","110/07/13","元大-萬華",35,94,-59
"6385","2390云辰","110/07/13","摩根大通",502,453,49
"6386","2390云辰","110/07/13","元富-吉利",2,60,-58
"6387","2390云辰","110/07/13","凱基-松山",61,13,48
"6388","2390云辰","110/07/13","兆豐-新竹",3,53,-50
"6389","2390云辰","110/07/13","大昌",64,22,42
"6390","2390云辰","110/07/13","富邦-嘉義",65,108,-43
"6391","2363矽統","110/07/13","凱基-南崁",2133,63,2070
"6392","2363矽統","110/07/13","凱基-幸福",36,4048,-4012
"6393","2363矽統","110/07/13","國泰-敦南",2195,1617,578
"6394","2363矽統","110/07/13","統一",192,3325,-3133
"6395","2363矽統","110/07/13","中農",670,139,531
"6396","2363矽統","110/07/13","新加坡商瑞銀",1000,2747,-1747
"6397","2363矽統","110/07/13","康和-台中",638,154,484
"6398","2363矽統","110/07/13","凱基-台北",5359,6609,-1250
"6399","2363矽統","110/07/13","群益金鼎-三民",577,137,440
"6400","2363矽統","110/07/13","摩根大通",1930,2858,-928
"6401","2363矽統","110/07/13","台新-屏東",510,88,422
"6402","2363矽統","110/07/13","港商野村",960,1679,-719
"6403","2363矽統","110/07/13","德信-中正",455,67,388
"6404","2363矽統","110/07/13","兆豐-復興",25,705,-680
"6405","2363矽統","110/07/13","日盛-竹北",365,70,295
"6406","2363矽統","110/07/13","統一-仁愛",114,755,-641
"6407","2363矽統","110/07/13","元大-佳里",452,189,263
"6408","2363矽統","110/07/13","統一-敦南",29,638,-609
"6409","2363矽統","110/07/13","國票-博愛",296,38,258
"6410","2363矽統","110/07/13","統一-土城",100,704,-604
"6411","2363矽統","110/07/13","元大-萬華",340,95,245
"6412","2363矽統","110/07/13","統一-城中",116,676,-560
"6413","2363矽統","110/07/13","新光",1259,1031,228
"6414","2363矽統","110/07/13","永豐金證券",306,859,-553
"6415","2363矽統","110/07/13","元富-成功",323,96,227
"6416","2363矽統","110/07/13","元富",54,567,-513
"6417","2363矽統","110/07/13","豐農",228,23,205
"6418","2363矽統","110/07/13","瑞士信貸",202,666,-464
"6419","2363矽統","110/07/13","台灣企銀-岡山",186,4,182
"6420","2363矽統","110/07/13","永豐金-嘉義",67,468,-401
"6421","8112至上","110/07/13","摩根大通",688,296,392
"6422","8112至上","110/07/13","國票-中和",0,401,-401
"6423","8112至上","110/07/13","港商野村",344,145,199
"6424","8112至上","110/07/13","永豐金-板盛",0,205,-205
"6425","8112至上","110/07/13","兆豐-公益",195,5,190
"6426","8112至上","110/07/13","凱基-五股",43,155,-112
"6427","8112至上","110/07/13","台灣摩根士丹利",183,0,183
"6428","8112至上","110/07/13","凱基-市政",0,100,-100
"6429","8112至上","110/07/13","群益金鼎-敦南",153,2,151
"6430","8112至上","110/07/13","元大-大里德芳",1,92,-91
"6431","8112至上","110/07/13","臺銀-金山",146,26,120
"6432","8112至上","110/07/13","玉山-桃園",26,110,-84
"6433","8112至上","110/07/13","臺銀",133,19,114
"6434","8112至上","110/07/13","兆豐-天母",0,81,-81
"6435","8112至上","110/07/13","合庫-台中",115,6,109
"6436","8112至上","110/07/13","凱基-城中",3,84,-81
"6437","8112至上","110/07/13","亞東-板橋",134,26,108
"6438","8112至上","110/07/13","日盛-新莊",9,85,-76
"6439","8112至上","110/07/13","凱基-台北",414,326,88
"6440","8112至上","110/07/13","日盛-台中",2,64,-62
"6441","8112至上","110/07/13","新加坡商瑞銀",181,100,81
"6442","8112至上","110/07/13","日盛-中壢",3,64,-61
"6443","8112至上","110/07/13","國泰-敦南",108,31,77
"6444","8112至上","110/07/13","元大-台中",2,59,-57
"6445","8112至上","110/07/13","第一金-華江",77,4,73
"6446","8112至上","110/07/13","元大-雙和",7,64,-57
"6447","8112至上","110/07/13","永豐金-內湖",73,1,72
"6448","8112至上","110/07/13","元大-高雄",8,62,-54
"6449","8112至上","110/07/13","元大-永和",68,1,67
"6450","8112至上","110/07/13","元大-館前",2,55,-53
"6451","1570力肯","110/07/13","新光",115,11,104
"6452","1570力肯","110/07/13","元大-北三重",0,162,-162
"6453","1570力肯","110/07/13","群益金鼎-高雄",54,0,54
"6454","1570力肯","110/07/13","元大-大灣",0,25,-25
"6455","1570力肯","110/07/13","國票-新莊",22,0,22
"6456","1570力肯","110/07/13","永豐金-苓雅",0,22,-22
"6457","1570力肯","110/07/13","日盛-桃園",12,0,12
"6458","1570力肯","110/07/13","永豐金-永康",0,19,-19
"6459","1570力肯","110/07/13","元大-高雄",12,0,12
"6460","1570力肯","110/07/13","富邦-員林",0,15,-15
"6461","1570力肯","110/07/13","合庫-自強",11,0,11
"6462","1570力肯","110/07/13","凱基-台南",0,11,-11
"6463","1570力肯","110/07/13","摩根大通",26,15,11
"6464","1570力肯","110/07/13","日盛-竹北",0,10,-10
"6465","1570力肯","110/07/13","永豐金-中盛",11,0,11
"6466","1570力肯","110/07/13","國票-九鼎",0,10,-10
"6467","1570力肯","110/07/13","兆豐-台中港",10,0,10
"6468","1570力肯","110/07/13","凱基-桃園",0,10,-10
"6469","1570力肯","110/07/13","國泰-松江",9,0,9
"6470","1570力肯","110/07/13","凱基-新豐",0,10,-10
"6471","1570力肯","110/07/13","元大-新盛",9,0,9
"6472","1570力肯","110/07/13","元大-學甲",0,10,-10
"6473","1570力肯","110/07/13","元富-緯城",6,0,6
"6474","1570力肯","110/07/13","群益金鼎-東湖",1,10,-9
"6475","1570力肯","110/07/13","統一-三重",5,0,5
"6476","1570力肯","110/07/13","大昌",0,6,-6
"6477","1570力肯","110/07/13","元大-前金",5,0,5
"6478","1570力肯","110/07/13","元大-土城學府",0,6,-6
"6479","1570力肯","110/07/13","永豐金證券",5,0,5
"6480","1570力肯","110/07/13","統一",0,5,-5
"6481","2929淘帝","110/07/13","玉山-新竹",130,0,130
"6482","2929淘帝","110/07/13","美商高盛",0,177,-177
"6483","2929淘帝","110/07/13","臺銀-民權",60,0,60
"6484","2929淘帝","110/07/13","凱基-台北",6,80,-74
"6485","2929淘帝","110/07/13","新百王",31,0,31
"6486","2929淘帝","110/07/13","元富-大裕",0,49,-49
"6487","2929淘帝","110/07/13","日盛-園區",30,0,30
"6488","2929淘帝","110/07/13","國泰-館前",3,51,-48
"6489","2929淘帝","110/07/13","元大-南投",31,1,30
"6490","2929淘帝","110/07/13","凱基-中壢",0,41,-41
"6491","2929淘帝","110/07/13","兆豐-忠孝",28,0,28
"6492","2929淘帝","110/07/13","港商野村",21,55,-34
"6493","2929淘帝","110/07/13","元大-民生",28,0,28
"6494","2929淘帝","110/07/13","華南永昌-南京",2,34,-32
"6495","2929淘帝","110/07/13","合庫-高雄",27,0,27
"6496","2929淘帝","110/07/13","群益金鼎-土城",0,30,-30
"6497","2929淘帝","110/07/13","凱基-豐中",27,0,27
"6498","2929淘帝","110/07/13","富邦-南屯",0,22,-22
"6499","2929淘帝","110/07/13","新光",21,4,17
"6500","2929淘帝","110/07/13","第一金-豐原",0,20,-20
"6501","2929淘帝","110/07/13","元大-天母",17,0,17
"6502","2929淘帝","110/07/13","元大-屏南",6,26,-20
"6503","2929淘帝","110/07/13","永興",14,0,14
"6504","2929淘帝","110/07/13","永豐金-敦南",1,21,-20
"6505","2929淘帝","110/07/13","富邦-台北",12,0,12
"6506","2929淘帝","110/07/13","凱基-三重",2,21,-19
"6507","2929淘帝","110/07/13","元大-永和",12,0,12
"6508","2929淘帝","110/07/13","富邦-仁愛",7,25,-18
"6509","2929淘帝","110/07/13","國票-天祥",11,0,11
"6510","2929淘帝","110/07/13","元大-北投",0,16,-16
"6511","5410國眾","110/07/13","兆豐-城中",274,0,274
"6512","5410國眾","110/07/13","元富-嘉義",0,103,-103
"6513","5410國眾","110/07/13","新光",50,4,46
"6514","5410國眾","110/07/13","凱基-台北",0,50,-50
"6515","5410國眾","110/07/13","國泰-台中",26,0,26
"6516","5410國眾","110/07/13","瑞士信貸",0,31,-31
"6517","5410國眾","110/07/13","新加坡商瑞銀",22,0,22
"6518","5410國眾","110/07/13","台新-新莊",0,27,-27
"6519","5410國眾","110/07/13","光和-嘉義",20,0,20
"6520","5410國眾","110/07/13","元大-汐止",0,20,-20
"6521","5410國眾","110/07/13","凱基-竹北",17,0,17
"6522","5410國眾","110/07/13","亞東-新竹",0,17,-17
"6523","5410國眾","110/07/13","新光-桃園",15,0,15
"6524","5410國眾","110/07/13","元大-南勢角",0,13,-13
"6525","5410國眾","110/07/13","凱基-台東",14,0,14
"6526","5410國眾","110/07/13","台新-台南",0,12,-12
"6527","5410國眾","110/07/13","富邦-竹北",11,0,11
"6528","5410國眾","110/07/13","中國信託",0,11,-11
"6529","5410國眾","110/07/13","元富-同大",10,0,10
"6530","5410國眾","110/07/13","華南永昌",0,11,-11
"6531","5410國眾","110/07/13","國泰-敦南",24,15,9
"6532","5410國眾","110/07/13","臺銀-臺南",0,10,-10
"6533","5410國眾","110/07/13","日盛-內湖",7,0,7
"6534","5410國眾","110/07/13","台灣企銀-民雄",0,10,-10
"6535","5410國眾","110/07/13","台新-左楠",7,0,7
"6536","5410國眾","110/07/13","高橋",0,10,-10
"6537","5410國眾","110/07/13","元大-新盛",18,12,6
"6538","5410國眾","110/07/13","康和-嘉義",0,10,-10
"6539","5410國眾","110/07/13","統一",5,0,5
"6540","5410國眾","110/07/13","凱基-基隆",0,10,-10
"6541","2841台開","110/07/13","中國信託-高雄",251,50,201
"6542","2841台開","110/07/13","兆豐-公益",0,177,-177
"6543","2841台開","110/07/13","日盛證券",210,13,197
"6544","2841台開","110/07/13","日進",0,152,-152
"6545","2841台開","110/07/13","第一金-台中",55,0,55
"6546","2841台開","110/07/13","港商野村",0,109,-109
"6547","2841台開","110/07/13","國泰-板橋",46,0,46
"6548","2841台開","110/07/13","日盛-信義",0,103,-103
"6549","2841台開","110/07/13","國泰-館前",48,3,45
"6550","2841台開","110/07/13","國泰-敦南",11,75,-64
"6551","2841台開","110/07/13","華南永昌-新莊",45,0,45
"6552","2841台開","110/07/13","永興",0,50,-50
"6553","2841台開","110/07/13","日盛-園區",42,0,42
"6554","2841台開","110/07/13","永豐金-敦南",61,104,-43
"6555","2841台開","110/07/13","台新證券",32,0,32
"6556","2841台開","110/07/13","富邦-台南",0,42,-42
"6557","2841台開","110/07/13","台新-高雄",32,2,30
"6558","2841台開","110/07/13","國票-安和",0,30,-30
"6559","2841台開","110/07/13","豐農",23,0,23
"6560","2841台開","110/07/13","元大-桃園",0,25,-25
"6561","2841台開","110/07/13","合庫-嘉義",20,0,20
"6562","2841台開","110/07/13","新光",8,32,-24
"6563","2841台開","110/07/13","華南永昌-高雄",20,0,20
"6564","2841台開","110/07/13","元大-仁愛",0,24,-24
"6565","2841台開","110/07/13","元大-樹林",16,0,16
"6566","2841台開","110/07/13","日盛-中和",0,20,-20
"6567","2841台開","110/07/13","第一金-華江",15,2,13
"6568","2841台開","110/07/13","元富",0,20,-20
"6569","2841台開","110/07/13","美商高盛",12,0,12
"6570","2841台開","110/07/13","富邦-宜蘭",0,20,-20
"6571","6207雷科","110/07/13","元大-高雄",121,0,121
"6572","6207雷科","110/07/13","華南永昌-朴子",1,60,-59
"6573","6207雷科","110/07/13","第一金-新興",20,0,20
"6574","6207雷科","110/07/13","元大-南海",0,36,-36
"6575","6207雷科","110/07/13","元富-三重",20,0,20
"6576","6207雷科","110/07/13","凱基-土城",0,35,-35
"6577","6207雷科","110/07/13","元大-林園",15,0,15
"6578","6207雷科","110/07/13","台灣企銀",0,20,-20
"6579","6207雷科","110/07/13","元大-金華",16,1,15
"6580","6207雷科","110/07/13","群益金鼎-丹鳳",0,20,-20
"6581","6207雷科","110/07/13","日盛證券",10,0,10
"6582","6207雷科","110/07/13","元大-博愛",0,17,-17
"6583","6207雷科","110/07/13","統一-台中",10,0,10
"6584","6207雷科","110/07/13","元大-北港",0,13,-13
"6585","6207雷科","110/07/13","群益金鼎-土城",10,0,10
"6586","6207雷科","110/07/13","新加坡商瑞銀",0,12,-12
"6587","6207雷科","110/07/13","群益金鼎-桃園",10,0,10
"6588","6207雷科","110/07/13","凱基-台北",4,16,-12
"6589","6207雷科","110/07/13","永豐金-新莊",10,0,10
"6590","6207雷科","110/07/13","日茂-埔里",0,11,-11
"6591","6207雷科","110/07/13","永豐金-新店",10,0,10
"6592","6207雷科","110/07/13","元大-莒光",0,11,-11
"6593","6207雷科","110/07/13","元大證券",9,0,9
"6594","6207雷科","110/07/13","統一-新竹",0,10,-10
"6595","6207雷科","110/07/13","日盛-木柵",9,1,8
"6596","6207雷科","110/07/13","元大-西螺",0,10,-10
"6597","6207雷科","110/07/13","兆豐-來福",8,0,8
"6598","6207雷科","110/07/13","康和-台中",0,8,-8
"6599","6207雷科","110/07/13","新光",7,0,7
"6600","6207雷科","110/07/13","兆豐-高雄",0,6,-6
"6601","3679新至陞","110/07/13","永豐金證券",50,0,50
"6602","3679新至陞","110/07/13","摩根大通",2,25,-23
"6603","3679新至陞","110/07/13","國泰-桃園",22,0,22
"6604","3679新至陞","110/07/13","元大-成功",0,22,-22
"6605","3679新至陞","110/07/13","台中銀-員林",11,0,11
"6606","3679新至陞","110/07/13","富邦-板橋",1,19,-18
"6607","3679新至陞","110/07/13","元大-文心興安",8,0,8
"6608","3679新至陞","110/07/13","日盛-新莊",0,10,-10
"6609","3679新至陞","110/07/13","美商高盛",6,0,6
"6610","3679新至陞","110/07/13","台新-台中",0,10,-10
"6611","3679新至陞","110/07/13","台新-高雄",6,0,6
"6612","3679新至陞","110/07/13","永豐金-新竹",0,8,-8
"6613","3679新至陞","110/07/13","凱基-台北",18,12,6
"6614","3679新至陞","110/07/13","瑞士信貸",12,19,-7
"6615","3679新至陞","110/07/13","日盛-復興",5,0,5
"6616","3679新至陞","110/07/13","統一-南京",0,7,-7
"6617","3679新至陞","110/07/13","(牛牛牛)亞-鑫豐",4,0,4
"6618","3679新至陞","110/07/13","凱基-新莊",0,7,-7
"6619","3679新至陞","110/07/13","元富-大昌",3,0,3
"6620","3679新至陞","110/07/13","新加坡商瑞銀",0,6,-6
"6621","3679新至陞","110/07/13","富邦-台北",3,0,3
"6622","3679新至陞","110/07/13","合庫-自強",0,5,-5
"6623","3679新至陞","110/07/13","日盛-樹林",2,0,2
"6624","3679新至陞","110/07/13","富邦-桃園",0,5,-5
"6625","3679新至陞","110/07/13","宏遠-光隆",2,0,2
"6626","3679新至陞","110/07/13","永豐金-潮州",0,4,-4
"6627","3679新至陞","110/07/13","美林",3,1,2
"6628","3679新至陞","110/07/13","臺銀-臺南",0,3,-3
"6629","3679新至陞","110/07/13","第一金-中壢",2,0,2
"6630","3679新至陞","110/07/13","元大-六合",0,3,-3
"6631","2727王品","110/07/13","富邦-台北",43,3,40
"6632","2727王品","110/07/13","台灣摩根士丹利",15,97,-82
"6633","2727王品","110/07/13","元大-基隆孝二",40,0,40
"6634","2727王品","110/07/13","玉山-台南",5,57,-52
"6635","2727王品","110/07/13","國票-新莊",40,1,39
"6636","2727王品","110/07/13","新加坡商瑞銀",0,48,-48
"6637","2727王品","110/07/13","第一金-豐原",66,42,24
"6638","2727王品","110/07/13","凱基-台北",41,77,-36
"6639","2727王品","110/07/13","永豐金-大園",34,10,24
"6640","2727王品","110/07/13","永豐金-永康",0,22,-22
"6641","2727王品","110/07/13","元大-北屯",22,0,22
"6642","2727王品","110/07/13","統一-台中",2,22,-20
"6643","2727王品","110/07/13","元大-東蘆",26,7,19
"6644","2727王品","110/07/13","國泰-台中",21,39,-18
"6645","2727王品","110/07/13","永豐金-萬盛",13,1,12
"6646","2727王品","110/07/13","合庫-彰化",3,20,-17
"6647","2727王品","110/07/13","日盛-嘉義",11,0,11
"6648","2727王品","110/07/13","港商野村",13,30,-17
"6649","2727王品","110/07/13","日盛-八德",11,0,11
"6650","2727王品","110/07/13","元大-楊梅",1,16,-15
"6651","2727王品","110/07/13","統一-竹南",11,0,11
"6652","2727王品","110/07/13","凱基-高美館",2,15,-13
"6653","2727王品","110/07/13","日盛-士林",12,2,10
"6654","2727王品","110/07/13","美商高盛",2,14,-12
"6655","2727王品","110/07/13","統一-敦南",10,0,10
"6656","2727王品","110/07/13","統一-平鎮",1,13,-12
"6657","2727王品","110/07/13","中國信託",15,5,10
"6658","2727王品","110/07/13","兆豐-台中港",4,16,-12
"6659","2727王品","110/07/13","兆豐-竹北",13,3,10
"6660","2727王品","110/07/13","凱基-八德",1,13,-12
"6661","1570力肯","110/07/13","新光",115,11,104
"6662","1570力肯","110/07/13","元大-北三重",0,162,-162
"6663","1570力肯","110/07/13","群益金鼎-高雄",54,0,54
"6664","1570力肯","110/07/13","元大-大灣",0,25,-25
"6665","1570力肯","110/07/13","國票-新莊",22,0,22
"6666","1570力肯","110/07/13","永豐金-苓雅",0,22,-22
"6667","1570力肯","110/07/13","日盛-桃園",12,0,12
"6668","1570力肯","110/07/13","永豐金-永康",0,19,-19
"6669","1570力肯","110/07/13","元大-高雄",12,0,12
"6670","1570力肯","110/07/13","富邦-員林",0,15,-15
"6671","1570力肯","110/07/13","合庫-自強",11,0,11
"6672","1570力肯","110/07/13","凱基-台南",0,11,-11
"6673","1570力肯","110/07/13","摩根大通",26,15,11
"6674","1570力肯","110/07/13","日盛-竹北",0,10,-10
"6675","1570力肯","110/07/13","永豐金-中盛",11,0,11
"6676","1570力肯","110/07/13","國票-九鼎",0,10,-10
"6677","1570力肯","110/07/13","兆豐-台中港",10,0,10
"6678","1570力肯","110/07/13","凱基-桃園",0,10,-10
"6679","1570力肯","110/07/13","國泰-松江",9,0,9
"6680","1570力肯","110/07/13","凱基-新豐",0,10,-10
"6681","1570力肯","110/07/13","元大-新盛",9,0,9
"6682","1570力肯","110/07/13","元大-學甲",0,10,-10
"6683","1570力肯","110/07/13","元富-緯城",6,0,6
"6684","1570力肯","110/07/13","群益金鼎-東湖",1,10,-9
"6685","1570力肯","110/07/13","統一-三重",5,0,5
"6686","1570力肯","110/07/13","大昌",0,6,-6
"6687","1570力肯","110/07/13","元大-前金",5,0,5
"6688","1570力肯","110/07/13","元大-土城學府",0,6,-6
"6689","1570力肯","110/07/13","永豐金證券",5,0,5
"6690","1570力肯","110/07/13","統一",0,5,-5
"6691","6180橘子","110/07/13","摩根大通",119,0,119
"6692","6180橘子","110/07/13","元大-崇德",2,61,-59
"6693","6180橘子","110/07/13","美商高盛",96,0,96
"6694","6180橘子","110/07/13","康和-台中",0,51,-51
"6695","6180橘子","110/07/13","新加坡商瑞銀",86,7,79
"6696","6180橘子","110/07/13","康和-台北",0,50,-50
"6697","6180橘子","110/07/13","元大-和平",40,0,40
"6698","6180橘子","110/07/13","元富-潮州",0,40,-40
"6699","6180橘子","110/07/13","凱基-台北",83,47,36
"6700","6180橘子","110/07/13","日盛-永康",0,26,-26
"6701","6180橘子","110/07/13","美林",39,5,34
"6702","6180橘子","110/07/13","永豐金-中正",0,24,-24
"6703","6180橘子","110/07/13","富邦-新竹華信",31,2,29
"6704","6180橘子","110/07/13","國泰-板橋",2,25,-23
"6705","6180橘子","110/07/13","統一-南京",21,0,21
"6706","6180橘子","110/07/13","日盛-大墩",0,20,-20
"6707","6180橘子","110/07/13","富邦-陽明",24,3,21
"6708","6180橘子","110/07/13","元大-草屯",13,32,-19
"6709","6180橘子","110/07/13","大昌-樹林",21,1,20
"6710","6180橘子","110/07/13","元富-林園",1,18,-17
"6711","6180橘子","110/07/13","花旗環球",19,0,19
"6712","6180橘子","110/07/13","新光-新竹",1,18,-17
"6713","6180橘子","110/07/13","華南永昌-台南",19,0,19
"6714","6180橘子","110/07/13","元大-土城永寧",0,17,-17
"6715","6180橘子","110/07/13","福勝",14,0,14
"6716","6180橘子","110/07/13","國泰-新莊",3,19,-16
"6717","6180橘子","110/07/13","富邦-嘉義",12,1,11
"6718","6180橘子","110/07/13","中國信託-永康",6,21,-15
"6719","6180橘子","110/07/13","元大-板橋三民",11,0,11
"6720","6180橘子","110/07/13","凱基-東港",1,15,-14
"6721","2390云辰","110/07/13","新加坡商瑞銀",562,75,487
"6722","2390云辰","110/07/13","大展-台南",0,532,-532
"6723","2390云辰","110/07/13","台灣摩根士丹利",330,155,175
"6724","2390云辰","110/07/13","凱基-台北",668,854,-186
"6725","2390云辰","110/07/13","兆豐-公益",126,25,101
"6726","2390云辰","110/07/13","凱基-三重",12,172,-160
"6727","2390云辰","110/07/13","元富-中港",100,2,98
"6728","2390云辰","110/07/13","兆豐-忠孝",4,161,-157
"6729","2390云辰","110/07/13","統一-新台中",106,9,97
"6730","2390云辰","110/07/13","元大-士林",19,170,-151
"6731","2390云辰","110/07/13","中國信託-松江",81,11,70
"6732","2390云辰","110/07/13","臺銀-新竹",14,117,-103
"6733","2390云辰","110/07/13","日盛-板橋",72,3,69
"6734","2390云辰","110/07/13","國票-台中",4,102,-98
"6735","2390云辰","110/07/13","日盛-和美",57,0,57
"6736","2390云辰","110/07/13","新光",147,232,-85
"6737","2390云辰","110/07/13","永豐金-桃園",88,36,52
"6738","2390云辰","110/07/13","致和-崇德",2,70,-68
"6739","2390云辰","110/07/13","玉山-士林",54,4,50
"6740","2390云辰","110/07/13","群益金鼎-屏東",2,70,-68
"6741","2390云辰","110/07/13","富邦-仁愛",56,6,50
"6742","2390云辰","110/07/13","元大-大里",35,98,-63
"6743","2390云辰","110/07/13","第一金-豐原",50,1,49
"6744","2390云辰","110/07/13","元大-萬華",35,94,-59
"6745","2390云辰","110/07/13","摩根大通",502,453,49
"6746","2390云辰","110/07/13","元富-吉利",2,60,-58
"6747","2390云辰","110/07/13","凱基-松山",61,13,48
"6748","2390云辰","110/07/13","兆豐-新竹",3,53,-50
"6749","2390云辰","110/07/13","大昌",64,22,42
"6750","2390云辰","110/07/13","富邦-嘉義",65,108,-43
"6751","2363矽統","110/07/13","凱基-南崁",2133,63,2070
"6752","2363矽統","110/07/13","凱基-幸福",36,4048,-4012
"6753","2363矽統","110/07/13","國泰-敦南",2195,1617,578
"6754","2363矽統","110/07/13","統一",192,3325,-3133
"6755","2363矽統","110/07/13","中農",670,139,531
"6756","2363矽統","110/07/13","新加坡商瑞銀",1000,2747,-1747
"6757","2363矽統","110/07/13","康和-台中",638,154,484
"6758","2363矽統","110/07/13","凱基-台北",5359,6609,-1250
"6759","2363矽統","110/07/13","群益金鼎-三民",577,137,440
"6760","2363矽統","110/07/13","摩根大通",1930,2858,-928
"6761","2363矽統","110/07/13","台新-屏東",510,88,422
"6762","2363矽統","110/07/13","港商野村",960,1679,-719
"6763","2363矽統","110/07/13","德信-中正",455,67,388
"6764","2363矽統","110/07/13","兆豐-復興",25,705,-680
"6765","2363矽統","110/07/13","日盛-竹北",365,70,295
"6766","2363矽統","110/07/13","統一-仁愛",114,755,-641
"6767","2363矽統","110/07/13","元大-佳里",452,189,263
"6768","2363矽統","110/07/13","統一-敦南",29,638,-609
"6769","2363矽統","110/07/13","國票-博愛",296,38,258
"6770","2363矽統","110/07/13","統一-土城",100,704,-604
"6771","2363矽統","110/07/13","元大-萬華",340,95,245
"6772","2363矽統","110/07/13","統一-城中",116,676,-560
"6773","2363矽統","110/07/13","新光",1259,1031,228
"6774","2363矽統","110/07/13","永豐金證券",306,859,-553
"6775","2363矽統","110/07/13","元富-成功",323,96,227
"6776","2363矽統","110/07/13","元富",54,567,-513
"6777","2363矽統","110/07/13","豐農",228,23,205
"6778","2363矽統","110/07/13","瑞士信貸",202,666,-464
"6779","2363矽統","110/07/13","台灣企銀-岡山",186,4,182
"6780","2363矽統","110/07/13","永豐金-嘉義",67,468,-401
"6781","2363矽統","110/07/13","凱基-南崁",2133,63,2070
"6782","2363矽統","110/07/13","凱基-幸福",36,4048,-4012
"6783","2363矽統","110/07/13","國泰-敦南",2195,1617,578
"6784","2363矽統","110/07/13","統一",192,3325,-3133
"6785","2363矽統","110/07/13","中農",670,139,531
"6786","2363矽統","110/07/13","新加坡商瑞銀",1000,2747,-1747
"6787","2363矽統","110/07/13","康和-台中",638,154,484
"6788","2363矽統","110/07/13","凱基-台北",5359,6609,-1250
"6789","2363矽統","110/07/13","群益金鼎-三民",577,137,440
"6790","2363矽統","110/07/13","摩根大通",1930,2858,-928
"6791","2363矽統","110/07/13","台新-屏東",510,88,422
"6792","2363矽統","110/07/13","港商野村",960,1679,-719
"6793","2363矽統","110/07/13","德信-中正",455,67,388
"6794","2363矽統","110/07/13","兆豐-復興",25,705,-680
"6795","2363矽統","110/07/13","日盛-竹北",365,70,295
"6796","2363矽統","110/07/13","統一-仁愛",114,755,-641
"6797","2363矽統","110/07/13","元大-佳里",452,189,263
"6798","2363矽統","110/07/13","統一-敦南",29,638,-609
"6799","2363矽統","110/07/13","國票-博愛",296,38,258
"6800","2363矽統","110/07/13","統一-土城",100,704,-604
"6801","2363矽統","110/07/13","元大-萬華",340,95,245
"6802","2363矽統","110/07/13","統一-城中",116,676,-560
"6803","2363矽統","110/07/13","新光",1259,1031,228
"6804","2363矽統","110/07/13","永豐金證券",306,859,-553
"6805","2363矽統","110/07/13","元富-成功",323,96,227
"6806","2363矽統","110/07/13","元富",54,567,-513
"6807","2363矽統","110/07/13","豐農",228,23,205
"6808","2363矽統","110/07/13","瑞士信貸",202,666,-464
"6809","2363矽統","110/07/13","台灣企銀-岡山",186,4,182
"6810","2363矽統","110/07/13","永豐金-嘉義",67,468,-401
"6811","2363矽統","110/07/13","凱基-南崁",2133,63,2070
"6812","2363矽統","110/07/13","凱基-幸福",36,4048,-4012
"6813","2363矽統","110/07/13","國泰-敦南",2195,1617,578
"6814","2363矽統","110/07/13","統一",192,3325,-3133
"6815","2363矽統","110/07/13","中農",670,139,531
"6816","2363矽統","110/07/13","新加坡商瑞銀",1000,2747,-1747
"6817","2363矽統","110/07/13","康和-台中",638,154,484
"6818","2363矽統","110/07/13","凱基-台北",5359,6609,-1250
"6819","2363矽統","110/07/13","群益金鼎-三民",577,137,440
"6820","2363矽統","110/07/13","摩根大通",1930,2858,-928
"6821","2363矽統","110/07/13","台新-屏東",510,88,422
"6822","2363矽統","110/07/13","港商野村",960,1679,-719
"6823","2363矽統","110/07/13","德信-中正",455,67,388
"6824","2363矽統","110/07/13","兆豐-復興",25,705,-680
"6825","2363矽統","110/07/13","日盛-竹北",365,70,295
"6826","2363矽統","110/07/13","統一-仁愛",114,755,-641
"6827","2363矽統","110/07/13","元大-佳里",452,189,263
"6828","2363矽統","110/07/13","統一-敦南",29,638,-609
"6829","2363矽統","110/07/13","國票-博愛",296,38,258
"6830","2363矽統","110/07/13","統一-土城",100,704,-604
"6831","2363矽統","110/07/13","元大-萬華",340,95,245
"6832","2363矽統","110/07/13","統一-城中",116,676,-560
"6833","2363矽統","110/07/13","新光",1259,1031,228
"6834","2363矽統","110/07/13","永豐金證券",306,859,-553
"6835","2363矽統","110/07/13","元富-成功",323,96,227
"6836","2363矽統","110/07/13","元富",54,567,-513
"6837","2363矽統","110/07/13","豐農",228,23,205
"6838","2363矽統","110/07/13","瑞士信貸",202,666,-464
"6839","2363矽統","110/07/13","台灣企銀-岡山",186,4,182
"6840","2363矽統","110/07/13","永豐金-嘉義",67,468,-401
"6841","1570力肯","110/07/13","新光",115,11,104
"6842","1570力肯","110/07/13","元大-北三重",0,162,-162
"6843","1570力肯","110/07/13","群益金鼎-高雄",54,0,54
"6844","1570力肯","110/07/13","元大-大灣",0,25,-25
"6845","1570力肯","110/07/13","國票-新莊",22,0,22
"6846","1570力肯","110/07/13","永豐金-苓雅",0,22,-22
"6847","1570力肯","110/07/13","日盛-桃園",12,0,12
"6848","1570力肯","110/07/13","永豐金-永康",0,19,-19
"6849","1570力肯","110/07/13","元大-高雄",12,0,12
"6850","1570力肯","110/07/13","富邦-員林",0,15,-15
"6851","1570力肯","110/07/13","合庫-自強",11,0,11
"6852","1570力肯","110/07/13","凱基-台南",0,11,-11
"6853","1570力肯","110/07/13","摩根大通",26,15,11
"6854","1570力肯","110/07/13","日盛-竹北",0,10,-10
"6855","1570力肯","110/07/13","永豐金-中盛",11,0,11
"6856","1570力肯","110/07/13","國票-九鼎",0,10,-10
"6857","1570力肯","110/07/13","兆豐-台中港",10,0,10
"6858","1570力肯","110/07/13","凱基-桃園",0,10,-10
"6859","1570力肯","110/07/13","國泰-松江",9,0,9
"6860","1570力肯","110/07/13","凱基-新豐",0,10,-10
"6861","1570力肯","110/07/13","元大-新盛",9,0,9
"6862","1570力肯","110/07/13","元大-學甲",0,10,-10
"6863","1570力肯","110/07/13","元富-緯城",6,0,6
"6864","1570力肯","110/07/13","群益金鼎-東湖",1,10,-9
"6865","1570力肯","110/07/13","統一-三重",5,0,5
"6866","1570力肯","110/07/13","大昌",0,6,-6
"6867","1570力肯","110/07/13","元大-前金",5,0,5
"6868","1570力肯","110/07/13","元大-土城學府",0,6,-6
"6869","1570力肯","110/07/13","永豐金證券",5,0,5
"6870","1570力肯","110/07/13","統一",0,5,-5
"6871","1570力肯","110/07/13","新光",115,11,104
"6872","1570力肯","110/07/13","元大-北三重",0,162,-162
"6873","1570力肯","110/07/13","群益金鼎-高雄",54,0,54
"6874","1570力肯","110/07/13","元大-大灣",0,25,-25
"6875","1570力肯","110/07/13","國票-新莊",22,0,22
"6876","1570力肯","110/07/13","永豐金-苓雅",0,22,-22
"6877","1570力肯","110/07/13","日盛-桃園",12,0,12
"6878","1570力肯","110/07/13","永豐金-永康",0,19,-19
"6879","1570力肯","110/07/13","元大-高雄",12,0,12
"6880","1570力肯","110/07/13","富邦-員林",0,15,-15
"6881","1570力肯","110/07/13","合庫-自強",11,0,11
"6882","1570力肯","110/07/13","凱基-台南",0,11,-11
"6883","1570力肯","110/07/13","摩根大通",26,15,11
"6884","1570力肯","110/07/13","日盛-竹北",0,10,-10
"6885","1570力肯","110/07/13","永豐金-中盛",11,0,11
"6886","1570力肯","110/07/13","國票-九鼎",0,10,-10
"6887","1570力肯","110/07/13","兆豐-台中港",10,0,10
"6888","1570力肯","110/07/13","凱基-桃園",0,10,-10
"6889","1570力肯","110/07/13","國泰-松江",9,0,9
"6890","1570力肯","110/07/13","凱基-新豐",0,10,-10
"6891","1570力肯","110/07/13","元大-新盛",9,0,9
"6892","1570力肯","110/07/13","元大-學甲",0,10,-10
"6893","1570力肯","110/07/13","元富-緯城",6,0,6
"6894","1570力肯","110/07/13","群益金鼎-東湖",1,10,-9
"6895","1570力肯","110/07/13","統一-三重",5,0,5
"6896","1570力肯","110/07/13","大昌",0,6,-6
"6897","1570力肯","110/07/13","元大-前金",5,0,5
"6898","1570力肯","110/07/13","元大-土城學府",0,6,-6
"6899","1570力肯","110/07/13","永豐金證券",5,0,5
"6900","1570力肯","110/07/13","統一",0,5,-5
"6901","6180橘子","110/07/13","摩根大通",119,0,119
"6902","6180橘子","110/07/13","元大-崇德",2,61,-59
"6903","6180橘子","110/07/13","美商高盛",96,0,96
"6904","6180橘子","110/07/13","康和-台中",0,51,-51
"6905","6180橘子","110/07/13","新加坡商瑞銀",86,7,79
"6906","6180橘子","110/07/13","康和-台北",0,50,-50
"6907","6180橘子","110/07/13","元大-和平",40,0,40
"6908","6180橘子","110/07/13","元富-潮州",0,40,-40
"6909","6180橘子","110/07/13","凱基-台北",83,47,36
"6910","6180橘子","110/07/13","日盛-永康",0,26,-26
"6911","6180橘子","110/07/13","美林",39,5,34
"6912","6180橘子","110/07/13","永豐金-中正",0,24,-24
"6913","6180橘子","110/07/13","富邦-新竹華信",31,2,29
"6914","6180橘子","110/07/13","國泰-板橋",2,25,-23
"6915","6180橘子","110/07/13","統一-南京",21,0,21
"6916","6180橘子","110/07/13","日盛-大墩",0,20,-20
"6917","6180橘子","110/07/13","富邦-陽明",24,3,21
"6918","6180橘子","110/07/13","元大-草屯",13,32,-19
"6919","6180橘子","110/07/13","大昌-樹林",21,1,20
"6920","6180橘子","110/07/13","元富-林園",1,18,-17
"6921","6180橘子","110/07/13","花旗環球",19,0,19
"6922","6180橘子","110/07/13","新光-新竹",1,18,-17
"6923","6180橘子","110/07/13","華南永昌-台南",19,0,19
"6924","6180橘子","110/07/13","元大-土城永寧",0,17,-17
"6925","6180橘子","110/07/13","福勝",14,0,14
"6926","6180橘子","110/07/13","國泰-新莊",3,19,-16
"6927","6180橘子","110/07/13","富邦-嘉義",12,1,11
"6928","6180橘子","110/07/13","中國信託-永康",6,21,-15
"6929","6180橘子","110/07/13","元大-板橋三民",11,0,11
"6930","6180橘子","110/07/13","凱基-東港",1,15,-14
"6931","1570力肯","110/07/13","新光",115,11,104
"6932","1570力肯","110/07/13","元大-北三重",0,162,-162
"6933","1570力肯","110/07/13","群益金鼎-高雄",54,0,54
"6934","1570力肯","110/07/13","元大-大灣",0,25,-25
"6935","1570力肯","110/07/13","國票-新莊",22,0,22
"6936","1570力肯","110/07/13","永豐金-苓雅",0,22,-22
"6937","1570力肯","110/07/13","日盛-桃園",12,0,12
"6938","1570力肯","110/07/13","永豐金-永康",0,19,-19
"6939","1570力肯","110/07/13","元大-高雄",12,0,12
"6940","1570力肯","110/07/13","富邦-員林",0,15,-15
"6941","1570力肯","110/07/13","合庫-自強",11,0,11
"6942","1570力肯","110/07/13","凱基-台南",0,11,-11
"6943","1570力肯","110/07/13","摩根大通",26,15,11
"6944","1570力肯","110/07/13","日盛-竹北",0,10,-10
"6945","1570力肯","110/07/13","永豐金-中盛",11,0,11
"6946","1570力肯","110/07/13","國票-九鼎",0,10,-10
"6947","1570力肯","110/07/13","兆豐-台中港",10,0,10
"6948","1570力肯","110/07/13","凱基-桃園",0,10,-10
"6949","1570力肯","110/07/13","國泰-松江",9,0,9
"6950","1570力肯","110/07/13","凱基-新豐",0,10,-10
"6951","1570力肯","110/07/13","元大-新盛",9,0,9
"6952","1570力肯","110/07/13","元大-學甲",0,10,-10
"6953","1570力肯","110/07/13","元富-緯城",6,0,6
"6954","1570力肯","110/07/13","群益金鼎-東湖",1,10,-9
"6955","1570力肯","110/07/13","統一-三重",5,0,5
"6956","1570力肯","110/07/13","大昌",0,6,-6
"6957","1570力肯","110/07/13","元大-前金",5,0,5
"6958","1570力肯","110/07/13","元大-土城學府",0,6,-6
"6959","1570力肯","110/07/13","永豐金證券",5,0,5
"6960","1570力肯","110/07/13","統一",0,5,-5
"6961","6180橘子","110/07/13","摩根大通",119,0,119
"6962","6180橘子","110/07/13","元大-崇德",2,61,-59
"6963","6180橘子","110/07/13","美商高盛",96,0,96
"6964","6180橘子","110/07/13","康和-台中",0,51,-51
"6965","6180橘子","110/07/13","新加坡商瑞銀",86,7,79
"6966","6180橘子","110/07/13","康和-台北",0,50,-50
"6967","6180橘子","110/07/13","元大-和平",40,0,40
"6968","6180橘子","110/07/13","元富-潮州",0,40,-40
"6969","6180橘子","110/07/13","凱基-台北",83,47,36
"6970","6180橘子","110/07/13","日盛-永康",0,26,-26
"6971","6180橘子","110/07/13","美林",39,5,34
"6972","6180橘子","110/07/13","永豐金-中正",0,24,-24
"6973","6180橘子","110/07/13","富邦-新竹華信",31,2,29
"6974","6180橘子","110/07/13","國泰-板橋",2,25,-23
"6975","6180橘子","110/07/13","統一-南京",21,0,21
"6976","6180橘子","110/07/13","日盛-大墩",0,20,-20
"6977","6180橘子","110/07/13","富邦-陽明",24,3,21
"6978","6180橘子","110/07/13","元大-草屯",13,32,-19
"6979","6180橘子","110/07/13","大昌-樹林",21,1,20
"6980","6180橘子","110/07/13","元富-林園",1,18,-17
"6981","6180橘子","110/07/13","花旗環球",19,0,19
"6982","6180橘子","110/07/13","新光-新竹",1,18,-17
"6983","6180橘子","110/07/13","華南永昌-台南",19,0,19
"6984","6180橘子","110/07/13","元大-土城永寧",0,17,-17
"6985","6180橘子","110/07/13","福勝",14,0,14
"6986","6180橘子","110/07/13","國泰-新莊",3,19,-16
"6987","6180橘子","110/07/13","富邦-嘉義",12,1,11
"6988","6180橘子","110/07/13","中國信託-永康",6,21,-15
"6989","6180橘子","110/07/13","元大-板橋三民",11,0,11
"6990","6180橘子","110/07/13","凱基-東港",1,15,-14
"6991","2390云辰","110/07/13","新加坡商瑞銀",562,75,487
"6992","2390云辰","110/07/13","大展-台南",0,532,-532
"6993","2390云辰","110/07/13","台灣摩根士丹利",330,155,175
"6994","2390云辰","110/07/13","凱基-台北",668,854,-186
"6995","2390云辰","110/07/13","兆豐-公益",126,25,101
"6996","2390云辰","110/07/13","凱基-三重",12,172,-160
"6997","2390云辰","110/07/13","元富-中港",100,2,98
"6998","2390云辰","110/07/13","兆豐-忠孝",4,161,-157
"6999","2390云辰","110/07/13","統一-新台中",106,9,97
"7000","2390云辰","110/07/13","元大-士林",19,170,-151
"7001","2390云辰","110/07/13","中國信託-松江",81,11,70
"7002","2390云辰","110/07/13","臺銀-新竹",14,117,-103
"7003","2390云辰","110/07/13","日盛-板橋",72,3,69
"7004","2390云辰","110/07/13","國票-台中",4,102,-98
"7005","2390云辰","110/07/13","日盛-和美",57,0,57
"7006","2390云辰","110/07/13","新光",147,232,-85
"7007","2390云辰","110/07/13","永豐金-桃園",88,36,52
"7008","2390云辰","110/07/13","致和-崇德",2,70,-68
"7009","2390云辰","110/07/13","玉山-士林",54,4,50
"7010","2390云辰","110/07/13","群益金鼎-屏東",2,70,-68
"7011","2390云辰","110/07/13","富邦-仁愛",56,6,50
"7012","2390云辰","110/07/13","元大-大里",35,98,-63
"7013","2390云辰","110/07/13","第一金-豐原",50,1,49
"7014","2390云辰","110/07/13","元大-萬華",35,94,-59
"7015","2390云辰","110/07/13","摩根大通",502,453,49
"7016","2390云辰","110/07/13","元富-吉利",2,60,-58
"7017","2390云辰","110/07/13","凱基-松山",61,13,48
"7018","2390云辰","110/07/13","兆豐-新竹",3,53,-50
"7019","2390云辰","110/07/13","大昌",64,22,42
"7020","2390云辰","110/07/13","富邦-嘉義",65,108,-43
"7021","2363矽統","110/07/13","凱基-南崁",2133,63,2070
"7022","2363矽統","110/07/13","凱基-幸福",36,4048,-4012
"7023","2363矽統","110/07/13","國泰-敦南",2195,1617,578
"7024","2363矽統","110/07/13","統一",192,3325,-3133
"7025","2363矽統","110/07/13","中農",670,139,531
"7026","2363矽統","110/07/13","新加坡商瑞銀",1000,2747,-1747
"7027","2363矽統","110/07/13","康和-台中",638,154,484
"7028","2363矽統","110/07/13","凱基-台北",5359,6609,-1250
"7029","2363矽統","110/07/13","群益金鼎-三民",577,137,440
"7030","2363矽統","110/07/13","摩根大通",1930,2858,-928
"7031","2363矽統","110/07/13","台新-屏東",510,88,422
"7032","2363矽統","110/07/13","港商野村",960,1679,-719
"7033","2363矽統","110/07/13","德信-中正",455,67,388
"7034","2363矽統","110/07/13","兆豐-復興",25,705,-680
"7035","2363矽統","110/07/13","日盛-竹北",365,70,295
"7036","2363矽統","110/07/13","統一-仁愛",114,755,-641
"7037","2363矽統","110/07/13","元大-佳里",452,189,263
"7038","2363矽統","110/07/13","統一-敦南",29,638,-609
"7039","2363矽統","110/07/13","國票-博愛",296,38,258
"7040","2363矽統","110/07/13","統一-土城",100,704,-604
"7041","2363矽統","110/07/13","元大-萬華",340,95,245
"7042","2363矽統","110/07/13","統一-城中",116,676,-560
"7043","2363矽統","110/07/13","新光",1259,1031,228
"7044","2363矽統","110/07/13","永豐金證券",306,859,-553
"7045","2363矽統","110/07/13","元富-成功",323,96,227
"7046","2363矽統","110/07/13","元富",54,567,-513
"7047","2363矽統","110/07/13","豐農",228,23,205
"7048","2363矽統","110/07/13","瑞士信貸",202,666,-464
"7049","2363矽統","110/07/13","台灣企銀-岡山",186,4,182
"7050","2363矽統","110/07/13","永豐金-嘉義",67,468,-401
"7051","8112至上","110/07/13","摩根大通",688,296,392
"7052","8112至上","110/07/13","國票-中和",0,401,-401
"7053","8112至上","110/07/13","港商野村",344,145,199
"7054","8112至上","110/07/13","永豐金-板盛",0,205,-205
"7055","8112至上","110/07/13","兆豐-公益",195,5,190
"7056","8112至上","110/07/13","凱基-五股",43,155,-112
"7057","8112至上","110/07/13","台灣摩根士丹利",183,0,183
"7058","8112至上","110/07/13","凱基-市政",0,100,-100
"7059","8112至上","110/07/13","群益金鼎-敦南",153,2,151
"7060","8112至上","110/07/13","元大-大里德芳",1,92,-91
"7061","8112至上","110/07/13","臺銀-金山",146,26,120
"7062","8112至上","110/07/13","玉山-桃園",26,110,-84
"7063","8112至上","110/07/13","臺銀",133,19,114
"7064","8112至上","110/07/13","兆豐-天母",0,81,-81
"7065","8112至上","110/07/13","合庫-台中",115,6,109
"7066","8112至上","110/07/13","凱基-城中",3,84,-81
"7067","8112至上","110/07/13","亞東-板橋",134,26,108
"7068","8112至上","110/07/13","日盛-新莊",9,85,-76
"7069","8112至上","110/07/13","凱基-台北",414,326,88
"7070","8112至上","110/07/13","日盛-台中",2,64,-62
"7071","8112至上","110/07/13","新加坡商瑞銀",181,100,81
"7072","8112至上","110/07/13","日盛-中壢",3,64,-61
"7073","8112至上","110/07/13","國泰-敦南",108,31,77
"7074","8112至上","110/07/13","元大-台中",2,59,-57
"7075","8112至上","110/07/13","第一金-華江",77,4,73
"7076","8112至上","110/07/13","元大-雙和",7,64,-57
"7077","8112至上","110/07/13","永豐金-內湖",73,1,72
"7078","8112至上","110/07/13","元大-高雄",8,62,-54
"7079","8112至上","110/07/13","元大-永和",68,1,67
"7080","8112至上","110/07/13","元大-館前",2,55,-53
"7081","2929淘帝","110/07/13","玉山-新竹",130,0,130
"7082","2929淘帝","110/07/13","美商高盛",0,177,-177
"7083","2929淘帝","110/07/13","臺銀-民權",60,0,60
"7084","2929淘帝","110/07/13","凱基-台北",6,80,-74
"7085","2929淘帝","110/07/13","新百王",31,0,31
"7086","2929淘帝","110/07/13","元富-大裕",0,49,-49
"7087","2929淘帝","110/07/13","日盛-園區",30,0,30
"7088","2929淘帝","110/07/13","國泰-館前",3,51,-48
"7089","2929淘帝","110/07/13","元大-南投",31,1,30
"7090","2929淘帝","110/07/13","凱基-中壢",0,41,-41
"7091","2929淘帝","110/07/13","兆豐-忠孝",28,0,28
"7092","2929淘帝","110/07/13","港商野村",21,55,-34
"7093","2929淘帝","110/07/13","元大-民生",28,0,28
"7094","2929淘帝","110/07/13","華南永昌-南京",2,34,-32
"7095","2929淘帝","110/07/13","合庫-高雄",27,0,27
"7096","2929淘帝","110/07/13","群益金鼎-土城",0,30,-30
"7097","2929淘帝","110/07/13","凱基-豐中",27,0,27
"7098","2929淘帝","110/07/13","富邦-南屯",0,22,-22
"7099","2929淘帝","110/07/13","新光",21,4,17
"7100","2929淘帝","110/07/13","第一金-豐原",0,20,-20
"7101","2929淘帝","110/07/13","元大-天母",17,0,17
"7102","2929淘帝","110/07/13","元大-屏南",6,26,-20
"7103","2929淘帝","110/07/13","永興",14,0,14
"7104","2929淘帝","110/07/13","永豐金-敦南",1,21,-20
"7105","2929淘帝","110/07/13","富邦-台北",12,0,12
"7106","2929淘帝","110/07/13","凱基-三重",2,21,-19
"7107","2929淘帝","110/07/13","元大-永和",12,0,12
"7108","2929淘帝","110/07/13","富邦-仁愛",7,25,-18
"7109","2929淘帝","110/07/13","國票-天祥",11,0,11
"7110","2929淘帝","110/07/13","元大-北投",0,16,-16
"7111","2841台開","110/07/13","中國信託-高雄",251,50,201
"7112","2841台開","110/07/13","兆豐-公益",0,177,-177
"7113","2841台開","110/07/13","日盛證券",210,13,197
"7114","2841台開","110/07/13","日進",0,152,-152
"7115","2841台開","110/07/13","第一金-台中",55,0,55
"7116","2841台開","110/07/13","港商野村",0,109,-109
"7117","2841台開","110/07/13","國泰-板橋",46,0,46
"7118","2841台開","110/07/13","日盛-信義",0,103,-103
"7119","2841台開","110/07/13","國泰-館前",48,3,45
"7120","2841台開","110/07/13","國泰-敦南",11,75,-64
"7121","2841台開","110/07/13","華南永昌-新莊",45,0,45
"7122","2841台開","110/07/13","永興",0,50,-50
"7123","2841台開","110/07/13","日盛-園區",42,0,42
"7124","2841台開","110/07/13","永豐金-敦南",61,104,-43
"7125","2841台開","110/07/13","台新證券",32,0,32
"7126","2841台開","110/07/13","富邦-台南",0,42,-42
"7127","2841台開","110/07/13","台新-高雄",32,2,30
"7128","2841台開","110/07/13","國票-安和",0,30,-30
"7129","2841台開","110/07/13","豐農",23,0,23
"7130","2841台開","110/07/13","元大-桃園",0,25,-25
"7131","2841台開","110/07/13","合庫-嘉義",20,0,20
"7132","2841台開","110/07/13","新光",8,32,-24
"7133","2841台開","110/07/13","華南永昌-高雄",20,0,20
"7134","2841台開","110/07/13","元大-仁愛",0,24,-24
"7135","2841台開","110/07/13","元大-樹林",16,0,16
"7136","2841台開","110/07/13","日盛-中和",0,20,-20
"7137","2841台開","110/07/13","第一金-華江",15,2,13
"7138","2841台開","110/07/13","元富",0,20,-20
"7139","2841台開","110/07/13","美商高盛",12,0,12
"7140","2841台開","110/07/13","富邦-宜蘭",0,20,-20
"7141","6207雷科","110/07/13","元大-高雄",121,0,121
"7142","6207雷科","110/07/13","華南永昌-朴子",1,60,-59
"7143","6207雷科","110/07/13","第一金-新興",20,0,20
"7144","6207雷科","110/07/13","元大-南海",0,36,-36
"7145","6207雷科","110/07/13","元富-三重",20,0,20
"7146","6207雷科","110/07/13","凱基-土城",0,35,-35
"7147","6207雷科","110/07/13","元大-林園",15,0,15
"7148","6207雷科","110/07/13","台灣企銀",0,20,-20
"7149","6207雷科","110/07/13","元大-金華",16,1,15
"7150","6207雷科","110/07/13","群益金鼎-丹鳳",0,20,-20
"7151","6207雷科","110/07/13","日盛證券",10,0,10
"7152","6207雷科","110/07/13","元大-博愛",0,17,-17
"7153","6207雷科","110/07/13","統一-台中",10,0,10
"7154","6207雷科","110/07/13","元大-北港",0,13,-13
"7155","6207雷科","110/07/13","群益金鼎-土城",10,0,10
"7156","6207雷科","110/07/13","新加坡商瑞銀",0,12,-12
"7157","6207雷科","110/07/13","群益金鼎-桃園",10,0,10
"7158","6207雷科","110/07/13","凱基-台北",4,16,-12
"7159","6207雷科","110/07/13","永豐金-新莊",10,0,10
"7160","6207雷科","110/07/13","日茂-埔里",0,11,-11
"7161","6207雷科","110/07/13","永豐金-新店",10,0,10
"7162","6207雷科","110/07/13","元大-莒光",0,11,-11
"7163","6207雷科","110/07/13","元大證券",9,0,9
"7164","6207雷科","110/07/13","統一-新竹",0,10,-10
"7165","6207雷科","110/07/13","日盛-木柵",9,1,8
"7166","6207雷科","110/07/13","元大-西螺",0,10,-10
"7167","6207雷科","110/07/13","兆豐-來福",8,0,8
"7168","6207雷科","110/07/13","康和-台中",0,8,-8
"7169","6207雷科","110/07/13","新光",7,0,7
"7170","6207雷科","110/07/13","兆豐-高雄",0,6,-6
"7171","3679新至陞","110/07/13","永豐金證券",50,0,50
"7172","3679新至陞","110/07/13","摩根大通",2,25,-23
"7173","3679新至陞","110/07/13","國泰-桃園",22,0,22
"7174","3679新至陞","110/07/13","元大-成功",0,22,-22
"7175","3679新至陞","110/07/13","台中銀-員林",11,0,11
"7176","3679新至陞","110/07/13","富邦-板橋",1,19,-18
"7177","3679新至陞","110/07/13","元大-文心興安",8,0,8
"7178","3679新至陞","110/07/13","日盛-新莊",0,10,-10
"7179","3679新至陞","110/07/13","美商高盛",6,0,6
"7180","3679新至陞","110/07/13","台新-台中",0,10,-10
"7181","3679新至陞","110/07/13","台新-高雄",6,0,6
"7182","3679新至陞","110/07/13","永豐金-新竹",0,8,-8
"7183","3679新至陞","110/07/13","凱基-台北",18,12,6
"7184","3679新至陞","110/07/13","瑞士信貸",12,19,-7
"7185","3679新至陞","110/07/13","日盛-復興",5,0,5
"7186","3679新至陞","110/07/13","統一-南京",0,7,-7
"7187","3679新至陞","110/07/13","(牛牛牛)亞-鑫豐",4,0,4
"7188","3679新至陞","110/07/13","凱基-新莊",0,7,-7
"7189","3679新至陞","110/07/13","元富-大昌",3,0,3
"7190","3679新至陞","110/07/13","新加坡商瑞銀",0,6,-6
"7191","3679新至陞","110/07/13","富邦-台北",3,0,3
"7192","3679新至陞","110/07/13","合庫-自強",0,5,-5
"7193","3679新至陞","110/07/13","日盛-樹林",2,0,2
"7194","3679新至陞","110/07/13","富邦-桃園",0,5,-5
"7195","3679新至陞","110/07/13","宏遠-光隆",2,0,2
"7196","3679新至陞","110/07/13","永豐金-潮州",0,4,-4
"7197","3679新至陞","110/07/13","美林",3,1,2
"7198","3679新至陞","110/07/13","臺銀-臺南",0,3,-3
"7199","3679新至陞","110/07/13","第一金-中壢",2,0,2
"7200","3679新至陞","110/07/13","元大-六合",0,3,-3
"7201","2727王品","110/07/13","富邦-台北",43,3,40
"7202","2727王品","110/07/13","台灣摩根士丹利",15,97,-82
"7203","2727王品","110/07/13","元大-基隆孝二",40,0,40
"7204","2727王品","110/07/13","玉山-台南",5,57,-52
"7205","2727王品","110/07/13","國票-新莊",40,1,39
"7206","2727王品","110/07/13","新加坡商瑞銀",0,48,-48
"7207","2727王品","110/07/13","第一金-豐原",66,42,24
"7208","2727王品","110/07/13","凱基-台北",41,77,-36
"7209","2727王品","110/07/13","永豐金-大園",34,10,24
"7210","2727王品","110/07/13","永豐金-永康",0,22,-22
"7211","2727王品","110/07/13","元大-北屯",22,0,22
"7212","2727王品","110/07/13","統一-台中",2,22,-20
"7213","2727王品","110/07/13","元大-東蘆",26,7,19
"7214","2727王品","110/07/13","國泰-台中",21,39,-18
"7215","2727王品","110/07/13","永豐金-萬盛",13,1,12
"7216","2727王品","110/07/13","合庫-彰化",3,20,-17
"7217","2727王品","110/07/13","日盛-嘉義",11,0,11
"7218","2727王品","110/07/13","港商野村",13,30,-17
"7219","2727王品","110/07/13","日盛-八德",11,0,11
"7220","2727王品","110/07/13","元大-楊梅",1,16,-15
"7221","2727王品","110/07/13","統一-竹南",11,0,11
"7222","2727王品","110/07/13","凱基-高美館",2,15,-13
"7223","2727王品","110/07/13","日盛-士林",12,2,10
"7224","2727王品","110/07/13","美商高盛",2,14,-12
"7225","2727王品","110/07/13","統一-敦南",10,0,10
"7226","2727王品","110/07/13","統一-平鎮",1,13,-12
"7227","2727王品","110/07/13","中國信託",15,5,10
"7228","2727王品","110/07/13","兆豐-台中港",4,16,-12
"7229","2727王品","110/07/13","兆豐-竹北",13,3,10
"7230","2727王品","110/07/13","凱基-八德",1,13,-12
"7231","1570力肯","110/07/13","新光",115,11,104
"7232","1570力肯","110/07/13","元大-北三重",0,162,-162
"7233","1570力肯","110/07/13","群益金鼎-高雄",54,0,54
"7234","1570力肯","110/07/13","元大-大灣",0,25,-25
"7235","1570力肯","110/07/13","國票-新莊",22,0,22
"7236","1570力肯","110/07/13","永豐金-苓雅",0,22,-22
"7237","1570力肯","110/07/13","日盛-桃園",12,0,12
"7238","1570力肯","110/07/13","永豐金-永康",0,19,-19
"7239","1570力肯","110/07/13","元大-高雄",12,0,12
"7240","1570力肯","110/07/13","富邦-員林",0,15,-15
"7241","1570力肯","110/07/13","合庫-自強",11,0,11
"7242","1570力肯","110/07/13","凱基-台南",0,11,-11
"7243","1570力肯","110/07/13","摩根大通",26,15,11
"7244","1570力肯","110/07/13","日盛-竹北",0,10,-10
"7245","1570力肯","110/07/13","永豐金-中盛",11,0,11
"7246","1570力肯","110/07/13","國票-九鼎",0,10,-10
"7247","1570力肯","110/07/13","兆豐-台中港",10,0,10
"7248","1570力肯","110/07/13","凱基-桃園",0,10,-10
"7249","1570力肯","110/07/13","國泰-松江",9,0,9
"7250","1570力肯","110/07/13","凱基-新豐",0,10,-10
"7251","1570力肯","110/07/13","元大-新盛",9,0,9
"7252","1570力肯","110/07/13","元大-學甲",0,10,-10
"7253","1570力肯","110/07/13","元富-緯城",6,0,6
"7254","1570力肯","110/07/13","群益金鼎-東湖",1,10,-9
"7255","1570力肯","110/07/13","統一-三重",5,0,5
"7256","1570力肯","110/07/13","大昌",0,6,-6
"7257","1570力肯","110/07/13","元大-前金",5,0,5
"7258","1570力肯","110/07/13","元大-土城學府",0,6,-6
"7259","1570力肯","110/07/13","永豐金證券",5,0,5
"7260","1570力肯","110/07/13","統一",0,5,-5
"7261","6180橘子","110/07/13","摩根大通",119,0,119
"7262","6180橘子","110/07/13","元大-崇德",2,61,-59
"7263","6180橘子","110/07/13","美商高盛",96,0,96
"7264","6180橘子","110/07/13","康和-台中",0,51,-51
"7265","6180橘子","110/07/13","新加坡商瑞銀",86,7,79
"7266","6180橘子","110/07/13","康和-台北",0,50,-50
"7267","6180橘子","110/07/13","元大-和平",40,0,40
"7268","6180橘子","110/07/13","元富-潮州",0,40,-40
"7269","6180橘子","110/07/13","凱基-台北",83,47,36
"7270","6180橘子","110/07/13","日盛-永康",0,26,-26
"7271","6180橘子","110/07/13","美林",39,5,34
"7272","6180橘子","110/07/13","永豐金-中正",0,24,-24
"7273","6180橘子","110/07/13","富邦-新竹華信",31,2,29
"7274","6180橘子","110/07/13","國泰-板橋",2,25,-23
"7275","6180橘子","110/07/13","統一-南京",21,0,21
"7276","6180橘子","110/07/13","日盛-大墩",0,20,-20
"7277","6180橘子","110/07/13","富邦-陽明",24,3,21
"7278","6180橘子","110/07/13","元大-草屯",13,32,-19
"7279","6180橘子","110/07/13","大昌-樹林",21,1,20
"7280","6180橘子","110/07/13","元富-林園",1,18,-17
"7281","6180橘子","110/07/13","花旗環球",19,0,19
"7282","6180橘子","110/07/13","新光-新竹",1,18,-17
"7283","6180橘子","110/07/13","華南永昌-台南",19,0,19
"7284","6180橘子","110/07/13","元大-土城永寧",0,17,-17
"7285","6180橘子","110/07/13","福勝",14,0,14
"7286","6180橘子","110/07/13","國泰-新莊",3,19,-16
"7287","6180橘子","110/07/13","富邦-嘉義",12,1,11
"7288","6180橘子","110/07/13","中國信託-永康",6,21,-15
"7289","6180橘子","110/07/13","元大-板橋三民",11,0,11
"7290","6180橘子","110/07/13","凱基-東港",1,15,-14
"7291","2390云辰","110/07/13","新加坡商瑞銀",562,75,487
"7292","2390云辰","110/07/13","大展-台南",0,532,-532
"7293","2390云辰","110/07/13","台灣摩根士丹利",330,155,175
"7294","2390云辰","110/07/13","凱基-台北",668,854,-186
"7295","2390云辰","110/07/13","兆豐-公益",126,25,101
"7296","2390云辰","110/07/13","凱基-三重",12,172,-160
"7297","2390云辰","110/07/13","元富-中港",100,2,98
"7298","2390云辰","110/07/13","兆豐-忠孝",4,161,-157
"7299","2390云辰","110/07/13","統一-新台中",106,9,97
"7300","2390云辰","110/07/13","元大-士林",19,170,-151
"7301","2390云辰","110/07/13","中國信託-松江",81,11,70
"7302","2390云辰","110/07/13","臺銀-新竹",14,117,-103
"7303","2390云辰","110/07/13","日盛-板橋",72,3,69
"7304","2390云辰","110/07/13","國票-台中",4,102,-98
"7305","2390云辰","110/07/13","日盛-和美",57,0,57
"7306","2390云辰","110/07/13","新光",147,232,-85
"7307","2390云辰","110/07/13","永豐金-桃園",88,36,52
"7308","2390云辰","110/07/13","致和-崇德",2,70,-68
"7309","2390云辰","110/07/13","玉山-士林",54,4,50
"7310","2390云辰","110/07/13","群益金鼎-屏東",2,70,-68
"7311","2390云辰","110/07/13","富邦-仁愛",56,6,50
"7312","2390云辰","110/07/13","元大-大里",35,98,-63
"7313","2390云辰","110/07/13","第一金-豐原",50,1,49
"7314","2390云辰","110/07/13","元大-萬華",35,94,-59
"7315","2390云辰","110/07/13","摩根大通",502,453,49
"7316","2390云辰","110/07/13","元富-吉利",2,60,-58
"7317","2390云辰","110/07/13","凱基-松山",61,13,48
"7318","2390云辰","110/07/13","兆豐-新竹",3,53,-50
"7319","2390云辰","110/07/13","大昌",64,22,42
"7320","2390云辰","110/07/13","富邦-嘉義",65,108,-43
"7321","2363矽統","110/07/13","凱基-南崁",2133,63,2070
"7322","2363矽統","110/07/13","凱基-幸福",36,4048,-4012
"7323","2363矽統","110/07/13","國泰-敦南",2195,1617,578
"7324","2363矽統","110/07/13","統一",192,3325,-3133
"7325","2363矽統","110/07/13","中農",670,139,531
"7326","2363矽統","110/07/13","新加坡商瑞銀",1000,2747,-1747
"7327","2363矽統","110/07/13","康和-台中",638,154,484
"7328","2363矽統","110/07/13","凱基-台北",5359,6609,-1250
"7329","2363矽統","110/07/13","群益金鼎-三民",577,137,440
"7330","2363矽統","110/07/13","摩根大通",1930,2858,-928
"7331","2363矽統","110/07/13","台新-屏東",510,88,422
"7332","2363矽統","110/07/13","港商野村",960,1679,-719
"7333","2363矽統","110/07/13","德信-中正",455,67,388
"7334","2363矽統","110/07/13","兆豐-復興",25,705,-680
"7335","2363矽統","110/07/13","日盛-竹北",365,70,295
"7336","2363矽統","110/07/13","統一-仁愛",114,755,-641
"7337","2363矽統","110/07/13","元大-佳里",452,189,263
"7338","2363矽統","110/07/13","統一-敦南",29,638,-609
"7339","2363矽統","110/07/13","國票-博愛",296,38,258
"7340","2363矽統","110/07/13","統一-土城",100,704,-604
"7341","2363矽統","110/07/13","元大-萬華",340,95,245
"7342","2363矽統","110/07/13","統一-城中",116,676,-560
"7343","2363矽統","110/07/13","新光",1259,1031,228
"7344","2363矽統","110/07/13","永豐金證券",306,859,-553
"7345","2363矽統","110/07/13","元富-成功",323,96,227
"7346","2363矽統","110/07/13","元富",54,567,-513
"7347","2363矽統","110/07/13","豐農",228,23,205
"7348","2363矽統","110/07/13","瑞士信貸",202,666,-464
"7349","2363矽統","110/07/13","台灣企銀-岡山",186,4,182
"7350","2363矽統","110/07/13","永豐金-嘉義",67,468,-401
"7351","8112至上","110/07/13","摩根大通",688,296,392
"7352","8112至上","110/07/13","國票-中和",0,401,-401
"7353","8112至上","110/07/13","港商野村",344,145,199
"7354","8112至上","110/07/13","永豐金-板盛",0,205,-205
"7355","8112至上","110/07/13","兆豐-公益",195,5,190
"7356","8112至上","110/07/13","凱基-五股",43,155,-112
"7357","8112至上","110/07/13","台灣摩根士丹利",183,0,183
"7358","8112至上","110/07/13","凱基-市政",0,100,-100
"7359","8112至上","110/07/13","群益金鼎-敦南",153,2,151
"7360","8112至上","110/07/13","元大-大里德芳",1,92,-91
"7361","8112至上","110/07/13","臺銀-金山",146,26,120
"7362","8112至上","110/07/13","玉山-桃園",26,110,-84
"7363","8112至上","110/07/13","臺銀",133,19,114
"7364","8112至上","110/07/13","兆豐-天母",0,81,-81
"7365","8112至上","110/07/13","合庫-台中",115,6,109
"7366","8112至上","110/07/13","凱基-城中",3,84,-81
"7367","8112至上","110/07/13","亞東-板橋",134,26,108
"7368","8112至上","110/07/13","日盛-新莊",9,85,-76
"7369","8112至上","110/07/13","凱基-台北",414,326,88
"7370","8112至上","110/07/13","日盛-台中",2,64,-62
"7371","8112至上","110/07/13","新加坡商瑞銀",181,100,81
"7372","8112至上","110/07/13","日盛-中壢",3,64,-61
"7373","8112至上","110/07/13","國泰-敦南",108,31,77
"7374","8112至上","110/07/13","元大-台中",2,59,-57
"7375","8112至上","110/07/13","第一金-華江",77,4,73
"7376","8112至上","110/07/13","元大-雙和",7,64,-57
"7377","8112至上","110/07/13","永豐金-內湖",73,1,72
"7378","8112至上","110/07/13","元大-高雄",8,62,-54
"7379","8112至上","110/07/13","元大-永和",68,1,67
"7380","8112至上","110/07/13","元大-館前",2,55,-53
"7381","2929淘帝","110/07/13","玉山-新竹",130,0,130
"7382","2929淘帝","110/07/13","美商高盛",0,177,-177
"7383","2929淘帝","110/07/13","臺銀-民權",60,0,60
"7384","2929淘帝","110/07/13","凱基-台北",6,80,-74
"7385","2929淘帝","110/07/13","新百王",31,0,31
"7386","2929淘帝","110/07/13","元富-大裕",0,49,-49
"7387","2929淘帝","110/07/13","日盛-園區",30,0,30
"7388","2929淘帝","110/07/13","國泰-館前",3,51,-48
"7389","2929淘帝","110/07/13","元大-南投",31,1,30
"7390","2929淘帝","110/07/13","凱基-中壢",0,41,-41
"7391","2929淘帝","110/07/13","兆豐-忠孝",28,0,28
"7392","2929淘帝","110/07/13","港商野村",21,55,-34
"7393","2929淘帝","110/07/13","元大-民生",28,0,28
"7394","2929淘帝","110/07/13","華南永昌-南京",2,34,-32
"7395","2929淘帝","110/07/13","合庫-高雄",27,0,27
"7396","2929淘帝","110/07/13","群益金鼎-土城",0,30,-30
"7397","2929淘帝","110/07/13","凱基-豐中",27,0,27
"7398","2929淘帝","110/07/13","富邦-南屯",0,22,-22
"7399","2929淘帝","110/07/13","新光",21,4,17
"7400","2929淘帝","110/07/13","第一金-豐原",0,20,-20
"7401","2929淘帝","110/07/13","元大-天母",17,0,17
"7402","2929淘帝","110/07/13","元大-屏南",6,26,-20
"7403","2929淘帝","110/07/13","永興",14,0,14
"7404","2929淘帝","110/07/13","永豐金-敦南",1,21,-20
"7405","2929淘帝","110/07/13","富邦-台北",12,0,12
"7406","2929淘帝","110/07/13","凱基-三重",2,21,-19
"7407","2929淘帝","110/07/13","元大-永和",12,0,12
"7408","2929淘帝","110/07/13","富邦-仁愛",7,25,-18
"7409","2929淘帝","110/07/13","國票-天祥",11,0,11
"7410","2929淘帝","110/07/13","元大-北投",0,16,-16
"7411","5410國眾","110/07/13","兆豐-城中",274,0,274
"7412","5410國眾","110/07/13","元富-嘉義",0,103,-103
"7413","5410國眾","110/07/13","新光",50,4,46
"7414","5410國眾","110/07/13","凱基-台北",0,50,-50
"7415","5410國眾","110/07/13","國泰-台中",26,0,26
"7416","5410國眾","110/07/13","瑞士信貸",0,31,-31
"7417","5410國眾","110/07/13","新加坡商瑞銀",22,0,22
"7418","5410國眾","110/07/13","台新-新莊",0,27,-27
"7419","5410國眾","110/07/13","光和-嘉義",20,0,20
"7420","5410國眾","110/07/13","元大-汐止",0,20,-20
"7421","5410國眾","110/07/13","凱基-竹北",17,0,17
"7422","5410國眾","110/07/13","亞東-新竹",0,17,-17
"7423","5410國眾","110/07/13","新光-桃園",15,0,15
"7424","5410國眾","110/07/13","元大-南勢角",0,13,-13
"7425","5410國眾","110/07/13","凱基-台東",14,0,14
"7426","5410國眾","110/07/13","台新-台南",0,12,-12
"7427","5410國眾","110/07/13","富邦-竹北",11,0,11
"7428","5410國眾","110/07/13","中國信託",0,11,-11
"7429","5410國眾","110/07/13","元富-同大",10,0,10
"7430","5410國眾","110/07/13","華南永昌",0,11,-11
"7431","5410國眾","110/07/13","國泰-敦南",24,15,9
"7432","5410國眾","110/07/13","臺銀-臺南",0,10,-10
"7433","5410國眾","110/07/13","日盛-內湖",7,0,7
"7434","5410國眾","110/07/13","台灣企銀-民雄",0,10,-10
"7435","5410國眾","110/07/13","台新-左楠",7,0,7
"7436","5410國眾","110/07/13","高橋",0,10,-10
"7437","5410國眾","110/07/13","元大-新盛",18,12,6
"7438","5410國眾","110/07/13","康和-嘉義",0,10,-10
"7439","5410國眾","110/07/13","統一",5,0,5
"7440","5410國眾","110/07/13","凱基-基隆",0,10,-10
"7441","2841台開","110/07/13","中國信託-高雄",251,50,201
"7442","2841台開","110/07/13","兆豐-公益",0,177,-177
"7443","2841台開","110/07/13","日盛證券",210,13,197
"7444","2841台開","110/07/13","日進",0,152,-152
"7445","2841台開","110/07/13","第一金-台中",55,0,55
"7446","2841台開","110/07/13","港商野村",0,109,-109
"7447","2841台開","110/07/13","國泰-板橋",46,0,46
"7448","2841台開","110/07/13","日盛-信義",0,103,-103
"7449","2841台開","110/07/13","國泰-館前",48,3,45
"7450","2841台開","110/07/13","國泰-敦南",11,75,-64
"7451","2841台開","110/07/13","華南永昌-新莊",45,0,45
"7452","2841台開","110/07/13","永興",0,50,-50
"7453","2841台開","110/07/13","日盛-園區",42,0,42
"7454","2841台開","110/07/13","永豐金-敦南",61,104,-43
"7455","2841台開","110/07/13","台新證券",32,0,32
"7456","2841台開","110/07/13","富邦-台南",0,42,-42
"7457","2841台開","110/07/13","台新-高雄",32,2,30
"7458","2841台開","110/07/13","國票-安和",0,30,-30
"7459","2841台開","110/07/13","豐農",23,0,23
"7460","2841台開","110/07/13","元大-桃園",0,25,-25
"7461","2841台開","110/07/13","合庫-嘉義",20,0,20
"7462","2841台開","110/07/13","新光",8,32,-24
"7463","2841台開","110/07/13","華南永昌-高雄",20,0,20
"7464","2841台開","110/07/13","元大-仁愛",0,24,-24
"7465","2841台開","110/07/13","元大-樹林",16,0,16
"7466","2841台開","110/07/13","日盛-中和",0,20,-20
"7467","2841台開","110/07/13","第一金-華江",15,2,13
"7468","2841台開","110/07/13","元富",0,20,-20
"7469","2841台開","110/07/13","美商高盛",12,0,12
"7470","2841台開","110/07/13","富邦-宜蘭",0,20,-20
"7471","6207雷科","110/07/13","元大-高雄",121,0,121
"7472","6207雷科","110/07/13","華南永昌-朴子",1,60,-59
"7473","6207雷科","110/07/13","第一金-新興",20,0,20
"7474","6207雷科","110/07/13","元大-南海",0,36,-36
"7475","6207雷科","110/07/13","元富-三重",20,0,20
"7476","6207雷科","110/07/13","凱基-土城",0,35,-35
"7477","6207雷科","110/07/13","元大-林園",15,0,15
"7478","6207雷科","110/07/13","台灣企銀",0,20,-20
"7479","6207雷科","110/07/13","元大-金華",16,1,15
"7480","6207雷科","110/07/13","群益金鼎-丹鳳",0,20,-20
"7481","6207雷科","110/07/13","日盛證券",10,0,10
"7482","6207雷科","110/07/13","元大-博愛",0,17,-17
"7483","6207雷科","110/07/13","統一-台中",10,0,10
"7484","6207雷科","110/07/13","元大-北港",0,13,-13
"7485","6207雷科","110/07/13","群益金鼎-土城",10,0,10
"7486","6207雷科","110/07/13","新加坡商瑞銀",0,12,-12
"7487","6207雷科","110/07/13","群益金鼎-桃園",10,0,10
"7488","6207雷科","110/07/13","凱基-台北",4,16,-12
"7489","6207雷科","110/07/13","永豐金-新莊",10,0,10
"7490","6207雷科","110/07/13","日茂-埔里",0,11,-11
"7491","6207雷科","110/07/13","永豐金-新店",10,0,10
"7492","6207雷科","110/07/13","元大-莒光",0,11,-11
"7493","6207雷科","110/07/13","元大證券",9,0,9
"7494","6207雷科","110/07/13","統一-新竹",0,10,-10
"7495","6207雷科","110/07/13","日盛-木柵",9,1,8
"7496","6207雷科","110/07/13","元大-西螺",0,10,-10
"7497","6207雷科","110/07/13","兆豐-來福",8,0,8
"7498","6207雷科","110/07/13","康和-台中",0,8,-8
"7499","6207雷科","110/07/13","新光",7,0,7
"7500","6207雷科","110/07/13","兆豐-高雄",0,6,-6
"7501","3679新至陞","110/07/13","永豐金證券",50,0,50
"7502","3679新至陞","110/07/13","摩根大通",2,25,-23
"7503","3679新至陞","110/07/13","國泰-桃園",22,0,22
"7504","3679新至陞","110/07/13","元大-成功",0,22,-22
"7505","3679新至陞","110/07/13","台中銀-員林",11,0,11
"7506","3679新至陞","110/07/13","富邦-板橋",1,19,-18
"7507","3679新至陞","110/07/13","元大-文心興安",8,0,8
"7508","3679新至陞","110/07/13","日盛-新莊",0,10,-10
"7509","3679新至陞","110/07/13","美商高盛",6,0,6
"7510","3679新至陞","110/07/13","台新-台中",0,10,-10
"7511","3679新至陞","110/07/13","台新-高雄",6,0,6
"7512","3679新至陞","110/07/13","永豐金-新竹",0,8,-8
"7513","3679新至陞","110/07/13","凱基-台北",18,12,6
"7514","3679新至陞","110/07/13","瑞士信貸",12,19,-7
"7515","3679新至陞","110/07/13","日盛-復興",5,0,5
"7516","3679新至陞","110/07/13","統一-南京",0,7,-7
"7517","3679新至陞","110/07/13","(牛牛牛)亞-鑫豐",4,0,4
"7518","3679新至陞","110/07/13","凱基-新莊",0,7,-7
"7519","3679新至陞","110/07/13","元富-大昌",3,0,3
"7520","3679新至陞","110/07/13","新加坡商瑞銀",0,6,-6
"7521","3679新至陞","110/07/13","富邦-台北",3,0,3
"7522","3679新至陞","110/07/13","合庫-自強",0,5,-5
"7523","3679新至陞","110/07/13","日盛-樹林",2,0,2
"7524","3679新至陞","110/07/13","富邦-桃園",0,5,-5
"7525","3679新至陞","110/07/13","宏遠-光隆",2,0,2
"7526","3679新至陞","110/07/13","永豐金-潮州",0,4,-4
"7527","3679新至陞","110/07/13","美林",3,1,2
"7528","3679新至陞","110/07/13","臺銀-臺南",0,3,-3
"7529","3679新至陞","110/07/13","第一金-中壢",2,0,2
"7530","3679新至陞","110/07/13","元大-六合",0,3,-3
"7531","2727王品","110/07/13","富邦-台北",43,3,40
"7532","2727王品","110/07/13","台灣摩根士丹利",15,97,-82
"7533","2727王品","110/07/13","元大-基隆孝二",40,0,40
"7534","2727王品","110/07/13","玉山-台南",5,57,-52
"7535","2727王品","110/07/13","國票-新莊",40,1,39
"7536","2727王品","110/07/13","新加坡商瑞銀",0,48,-48
"7537","2727王品","110/07/13","第一金-豐原",66,42,24
"7538","2727王品","110/07/13","凱基-台北",41,77,-36
"7539","2727王品","110/07/13","永豐金-大園",34,10,24
"7540","2727王品","110/07/13","永豐金-永康",0,22,-22
"7541","2727王品","110/07/13","元大-北屯",22,0,22
"7542","2727王品","110/07/13","統一-台中",2,22,-20
"7543","2727王品","110/07/13","元大-東蘆",26,7,19
"7544","2727王品","110/07/13","國泰-台中",21,39,-18
"7545","2727王品","110/07/13","永豐金-萬盛",13,1,12
"7546","2727王品","110/07/13","合庫-彰化",3,20,-17
"7547","2727王品","110/07/13","日盛-嘉義",11,0,11
"7548","2727王品","110/07/13","港商野村",13,30,-17
"7549","2727王品","110/07/13","日盛-八德",11,0,11
"7550","2727王品","110/07/13","元大-楊梅",1,16,-15
"7551","2727王品","110/07/13","統一-竹南",11,0,11
"7552","2727王品","110/07/13","凱基-高美館",2,15,-13
"7553","2727王品","110/07/13","日盛-士林",12,2,10
"7554","2727王品","110/07/13","美商高盛",2,14,-12
"7555","2727王品","110/07/13","統一-敦南",10,0,10
"7556","2727王品","110/07/13","統一-平鎮",1,13,-12
"7557","2727王品","110/07/13","中國信託",15,5,10
"7558","2727王品","110/07/13","兆豐-台中港",4,16,-12
"7559","2727王品","110/07/13","兆豐-竹北",13,3,10
"7560","2727王品","110/07/13","凱基-八德",1,13,-12
"7561","1570力肯","110/07/13","新光",115,11,104
"7562","1570力肯","110/07/13","元大-北三重",0,162,-162
"7563","1570力肯","110/07/13","群益金鼎-高雄",54,0,54
"7564","1570力肯","110/07/13","元大-大灣",0,25,-25
"7565","1570力肯","110/07/13","國票-新莊",22,0,22
"7566","1570力肯","110/07/13","永豐金-苓雅",0,22,-22
"7567","1570力肯","110/07/13","日盛-桃園",12,0,12
"7568","1570力肯","110/07/13","永豐金-永康",0,19,-19
"7569","1570力肯","110/07/13","元大-高雄",12,0,12
"7570","1570力肯","110/07/13","富邦-員林",0,15,-15
"7571","1570力肯","110/07/13","合庫-自強",11,0,11
"7572","1570力肯","110/07/13","凱基-台南",0,11,-11
"7573","1570力肯","110/07/13","摩根大通",26,15,11
"7574","1570力肯","110/07/13","日盛-竹北",0,10,-10
"7575","1570力肯","110/07/13","永豐金-中盛",11,0,11
"7576","1570力肯","110/07/13","國票-九鼎",0,10,-10
"7577","1570力肯","110/07/13","兆豐-台中港",10,0,10
"7578","1570力肯","110/07/13","凱基-桃園",0,10,-10
"7579","1570力肯","110/07/13","國泰-松江",9,0,9
"7580","1570力肯","110/07/13","凱基-新豐",0,10,-10
"7581","1570力肯","110/07/13","元大-新盛",9,0,9
"7582","1570力肯","110/07/13","元大-學甲",0,10,-10
"7583","1570力肯","110/07/13","元富-緯城",6,0,6
"7584","1570力肯","110/07/13","群益金鼎-東湖",1,10,-9
"7585","1570力肯","110/07/13","統一-三重",5,0,5
"7586","1570力肯","110/07/13","大昌",0,6,-6
"7587","1570力肯","110/07/13","元大-前金",5,0,5
"7588","1570力肯","110/07/13","元大-土城學府",0,6,-6
"7589","1570力肯","110/07/13","永豐金證券",5,0,5
"7590","1570力肯","110/07/13","統一",0,5,-5
"7591","6180橘子","110/07/13","摩根大通",119,0,119
"7592","6180橘子","110/07/13","元大-崇德",2,61,-59
"7593","6180橘子","110/07/13","美商高盛",96,0,96
"7594","6180橘子","110/07/13","康和-台中",0,51,-51
"7595","6180橘子","110/07/13","新加坡商瑞銀",86,7,79
"7596","6180橘子","110/07/13","康和-台北",0,50,-50
"7597","6180橘子","110/07/13","元大-和平",40,0,40
"7598","6180橘子","110/07/13","元富-潮州",0,40,-40
"7599","6180橘子","110/07/13","凱基-台北",83,47,36
"7600","6180橘子","110/07/13","日盛-永康",0,26,-26
"7601","6180橘子","110/07/13","美林",39,5,34
"7602","6180橘子","110/07/13","永豐金-中正",0,24,-24
"7603","6180橘子","110/07/13","富邦-新竹華信",31,2,29
"7604","6180橘子","110/07/13","國泰-板橋",2,25,-23
"7605","6180橘子","110/07/13","統一-南京",21,0,21
"7606","6180橘子","110/07/13","日盛-大墩",0,20,-20
"7607","6180橘子","110/07/13","富邦-陽明",24,3,21
"7608","6180橘子","110/07/13","元大-草屯",13,32,-19
"7609","6180橘子","110/07/13","大昌-樹林",21,1,20
"7610","6180橘子","110/07/13","元富-林園",1,18,-17
"7611","6180橘子","110/07/13","花旗環球",19,0,19
"7612","6180橘子","110/07/13","新光-新竹",1,18,-17
"7613","6180橘子","110/07/13","華南永昌-台南",19,0,19
"7614","6180橘子","110/07/13","元大-土城永寧",0,17,-17
"7615","6180橘子","110/07/13","福勝",14,0,14
"7616","6180橘子","110/07/13","國泰-新莊",3,19,-16
"7617","6180橘子","110/07/13","富邦-嘉義",12,1,11
"7618","6180橘子","110/07/13","中國信託-永康",6,21,-15
"7619","6180橘子","110/07/13","元大-板橋三民",11,0,11
"7620","6180橘子","110/07/13","凱基-東港",1,15,-14
"7621","2390云辰","110/07/13","新加坡商瑞銀",562,75,487
"7622","2390云辰","110/07/13","大展-台南",0,532,-532
"7623","2390云辰","110/07/13","台灣摩根士丹利",330,155,175
"7624","2390云辰","110/07/13","凱基-台北",668,854,-186
"7625","2390云辰","110/07/13","兆豐-公益",126,25,101
"7626","2390云辰","110/07/13","凱基-三重",12,172,-160
"7627","2390云辰","110/07/13","元富-中港",100,2,98
"7628","2390云辰","110/07/13","兆豐-忠孝",4,161,-157
"7629","2390云辰","110/07/13","統一-新台中",106,9,97
"7630","2390云辰","110/07/13","元大-士林",19,170,-151
"7631","2390云辰","110/07/13","中國信託-松江",81,11,70
"7632","2390云辰","110/07/13","臺銀-新竹",14,117,-103
"7633","2390云辰","110/07/13","日盛-板橋",72,3,69
"7634","2390云辰","110/07/13","國票-台中",4,102,-98
"7635","2390云辰","110/07/13","日盛-和美",57,0,57
"7636","2390云辰","110/07/13","新光",147,232,-85
"7637","2390云辰","110/07/13","永豐金-桃園",88,36,52
"7638","2390云辰","110/07/13","致和-崇德",2,70,-68
"7639","2390云辰","110/07/13","玉山-士林",54,4,50
"7640","2390云辰","110/07/13","群益金鼎-屏東",2,70,-68
"7641","2390云辰","110/07/13","富邦-仁愛",56,6,50
"7642","2390云辰","110/07/13","元大-大里",35,98,-63
"7643","2390云辰","110/07/13","第一金-豐原",50,1,49
"7644","2390云辰","110/07/13","元大-萬華",35,94,-59
"7645","2390云辰","110/07/13","摩根大通",502,453,49
"7646","2390云辰","110/07/13","元富-吉利",2,60,-58
"7647","2390云辰","110/07/13","凱基-松山",61,13,48
"7648","2390云辰","110/07/13","兆豐-新竹",3,53,-50
"7649","2390云辰","110/07/13","大昌",64,22,42
"7650","2390云辰","110/07/13","富邦-嘉義",65,108,-43
"7651","2363矽統","110/07/13","凱基-南崁",2133,63,2070
"7652","2363矽統","110/07/13","凱基-幸福",36,4048,-4012
"7653","2363矽統","110/07/13","國泰-敦南",2195,1617,578
"7654","2363矽統","110/07/13","統一",192,3325,-3133
"7655","2363矽統","110/07/13","中農",670,139,531
"7656","2363矽統","110/07/13","新加坡商瑞銀",1000,2747,-1747
"7657","2363矽統","110/07/13","康和-台中",638,154,484
"7658","2363矽統","110/07/13","凱基-台北",5359,6609,-1250
"7659","2363矽統","110/07/13","群益金鼎-三民",577,137,440
"7660","2363矽統","110/07/13","摩根大通",1930,2858,-928
"7661","2363矽統","110/07/13","台新-屏東",510,88,422
"7662","2363矽統","110/07/13","港商野村",960,1679,-719
"7663","2363矽統","110/07/13","德信-中正",455,67,388
"7664","2363矽統","110/07/13","兆豐-復興",25,705,-680
"7665","2363矽統","110/07/13","日盛-竹北",365,70,295
"7666","2363矽統","110/07/13","統一-仁愛",114,755,-641
"7667","2363矽統","110/07/13","元大-佳里",452,189,263
"7668","2363矽統","110/07/13","統一-敦南",29,638,-609
"7669","2363矽統","110/07/13","國票-博愛",296,38,258
"7670","2363矽統","110/07/13","統一-土城",100,704,-604
"7671","2363矽統","110/07/13","元大-萬華",340,95,245
"7672","2363矽統","110/07/13","統一-城中",116,676,-560
"7673","2363矽統","110/07/13","新光",1259,1031,228
"7674","2363矽統","110/07/13","永豐金證券",306,859,-553
"7675","2363矽統","110/07/13","元富-成功",323,96,227
"7676","2363矽統","110/07/13","元富",54,567,-513
"7677","2363矽統","110/07/13","豐農",228,23,205
"7678","2363矽統","110/07/13","瑞士信貸",202,666,-464
"7679","2363矽統","110/07/13","台灣企銀-岡山",186,4,182
"7680","2363矽統","110/07/13","永豐金-嘉義",67,468,-401
"7681","8112至上","110/07/13","摩根大通",688,296,392
"7682","8112至上","110/07/13","國票-中和",0,401,-401
"7683","8112至上","110/07/13","港商野村",344,145,199
"7684","8112至上","110/07/13","永豐金-板盛",0,205,-205
"7685","8112至上","110/07/13","兆豐-公益",195,5,190
"7686","8112至上","110/07/13","凱基-五股",43,155,-112
"7687","8112至上","110/07/13","台灣摩根士丹利",183,0,183
"7688","8112至上","110/07/13","凱基-市政",0,100,-100
"7689","8112至上","110/07/13","群益金鼎-敦南",153,2,151
"7690","8112至上","110/07/13","元大-大里德芳",1,92,-91
"7691","8112至上","110/07/13","臺銀-金山",146,26,120
"7692","8112至上","110/07/13","玉山-桃園",26,110,-84
"7693","8112至上","110/07/13","臺銀",133,19,114
"7694","8112至上","110/07/13","兆豐-天母",0,81,-81
"7695","8112至上","110/07/13","合庫-台中",115,6,109
"7696","8112至上","110/07/13","凱基-城中",3,84,-81
"7697","8112至上","110/07/13","亞東-板橋",134,26,108
"7698","8112至上","110/07/13","日盛-新莊",9,85,-76
"7699","8112至上","110/07/13","凱基-台北",414,326,88
"7700","8112至上","110/07/13","日盛-台中",2,64,-62
"7701","8112至上","110/07/13","新加坡商瑞銀",181,100,81
"7702","8112至上","110/07/13","日盛-中壢",3,64,-61
"7703","8112至上","110/07/13","國泰-敦南",108,31,77
"7704","8112至上","110/07/13","元大-台中",2,59,-57
"7705","8112至上","110/07/13","第一金-華江",77,4,73
"7706","8112至上","110/07/13","元大-雙和",7,64,-57
"7707","8112至上","110/07/13","永豐金-內湖",73,1,72
"7708","8112至上","110/07/13","元大-高雄",8,62,-54
"7709","8112至上","110/07/13","元大-永和",68,1,67
"7710","8112至上","110/07/13","元大-館前",2,55,-53
"7711","2929淘帝","110/07/13","玉山-新竹",130,0,130
"7712","2929淘帝","110/07/13","美商高盛",0,177,-177
"7713","2929淘帝","110/07/13","臺銀-民權",60,0,60
"7714","2929淘帝","110/07/13","凱基-台北",6,80,-74
"7715","2929淘帝","110/07/13","新百王",31,0,31
"7716","2929淘帝","110/07/13","元富-大裕",0,49,-49
"7717","2929淘帝","110/07/13","日盛-園區",30,0,30
"7718","2929淘帝","110/07/13","國泰-館前",3,51,-48
"7719","2929淘帝","110/07/13","元大-南投",31,1,30
"7720","2929淘帝","110/07/13","凱基-中壢",0,41,-41
"7721","2929淘帝","110/07/13","兆豐-忠孝",28,0,28
"7722","2929淘帝","110/07/13","港商野村",21,55,-34
"7723","2929淘帝","110/07/13","元大-民生",28,0,28
"7724","2929淘帝","110/07/13","華南永昌-南京",2,34,-32
"7725","2929淘帝","110/07/13","合庫-高雄",27,0,27
"7726","2929淘帝","110/07/13","群益金鼎-土城",0,30,-30
"7727","2929淘帝","110/07/13","凱基-豐中",27,0,27
"7728","2929淘帝","110/07/13","富邦-南屯",0,22,-22
"7729","2929淘帝","110/07/13","新光",21,4,17
"7730","2929淘帝","110/07/13","第一金-豐原",0,20,-20
"7731","2929淘帝","110/07/13","元大-天母",17,0,17
"7732","2929淘帝","110/07/13","元大-屏南",6,26,-20
"7733","2929淘帝","110/07/13","永興",14,0,14
"7734","2929淘帝","110/07/13","永豐金-敦南",1,21,-20
"7735","2929淘帝","110/07/13","富邦-台北",12,0,12
"7736","2929淘帝","110/07/13","凱基-三重",2,21,-19
"7737","2929淘帝","110/07/13","元大-永和",12,0,12
"7738","2929淘帝","110/07/13","富邦-仁愛",7,25,-18
"7739","2929淘帝","110/07/13","國票-天祥",11,0,11
"7740","2929淘帝","110/07/13","元大-北投",0,16,-16
"7741","5410國眾","110/07/13","兆豐-城中",274,0,274
"7742","5410國眾","110/07/13","元富-嘉義",0,103,-103
"7743","5410國眾","110/07/13","新光",50,4,46
"7744","5410國眾","110/07/13","凱基-台北",0,50,-50
"7745","5410國眾","110/07/13","國泰-台中",26,0,26
"7746","5410國眾","110/07/13","瑞士信貸",0,31,-31
"7747","5410國眾","110/07/13","新加坡商瑞銀",22,0,22
"7748","5410國眾","110/07/13","台新-新莊",0,27,-27
"7749","5410國眾","110/07/13","光和-嘉義",20,0,20
"7750","5410國眾","110/07/13","元大-汐止",0,20,-20
"7751","5410國眾","110/07/13","凱基-竹北",17,0,17
"7752","5410國眾","110/07/13","亞東-新竹",0,17,-17
"7753","5410國眾","110/07/13","新光-桃園",15,0,15
"7754","5410國眾","110/07/13","元大-南勢角",0,13,-13
"7755","5410國眾","110/07/13","凱基-台東",14,0,14
"7756","5410國眾","110/07/13","台新-台南",0,12,-12
"7757","5410國眾","110/07/13","富邦-竹北",11,0,11
"7758","5410國眾","110/07/13","中國信託",0,11,-11
"7759","5410國眾","110/07/13","元富-同大",10,0,10
"7760","5410國眾","110/07/13","華南永昌",0,11,-11
"7761","5410國眾","110/07/13","國泰-敦南",24,15,9
"7762","5410國眾","110/07/13","臺銀-臺南",0,10,-10
"7763","5410國眾","110/07/13","日盛-內湖",7,0,7
"7764","5410國眾","110/07/13","台灣企銀-民雄",0,10,-10
"7765","5410國眾","110/07/13","台新-左楠",7,0,7
"7766","5410國眾","110/07/13","高橋",0,10,-10
"7767","5410國眾","110/07/13","元大-新盛",18,12,6
"7768","5410國眾","110/07/13","康和-嘉義",0,10,-10
"7769","5410國眾","110/07/13","統一",5,0,5
"7770","5410國眾","110/07/13","凱基-基隆",0,10,-10
"7771","2841台開","110/07/13","中國信託-高雄",251,50,201
"7772","2841台開","110/07/13","兆豐-公益",0,177,-177
"7773","2841台開","110/07/13","日盛證券",210,13,197
"7774","2841台開","110/07/13","日進",0,152,-152
"7775","2841台開","110/07/13","第一金-台中",55,0,55
"7776","2841台開","110/07/13","港商野村",0,109,-109
"7777","2841台開","110/07/13","國泰-板橋",46,0,46
"7778","2841台開","110/07/13","日盛-信義",0,103,-103
"7779","2841台開","110/07/13","國泰-館前",48,3,45
"7780","2841台開","110/07/13","國泰-敦南",11,75,-64
"7781","2841台開","110/07/13","華南永昌-新莊",45,0,45
"7782","2841台開","110/07/13","永興",0,50,-50
"7783","2841台開","110/07/13","日盛-園區",42,0,42
"7784","2841台開","110/07/13","永豐金-敦南",61,104,-43
"7785","2841台開","110/07/13","台新證券",32,0,32
"7786","2841台開","110/07/13","富邦-台南",0,42,-42
"7787","2841台開","110/07/13","台新-高雄",32,2,30
"7788","2841台開","110/07/13","國票-安和",0,30,-30
"7789","2841台開","110/07/13","豐農",23,0,23
"7790","2841台開","110/07/13","元大-桃園",0,25,-25
"7791","2841台開","110/07/13","合庫-嘉義",20,0,20
"7792","2841台開","110/07/13","新光",8,32,-24
"7793","2841台開","110/07/13","華南永昌-高雄",20,0,20
"7794","2841台開","110/07/13","元大-仁愛",0,24,-24
"7795","2841台開","110/07/13","元大-樹林",16,0,16
"7796","2841台開","110/07/13","日盛-中和",0,20,-20
"7797","2841台開","110/07/13","第一金-華江",15,2,13
"7798","2841台開","110/07/13","元富",0,20,-20
"7799","2841台開","110/07/13","美商高盛",12,0,12
"7800","2841台開","110/07/13","富邦-宜蘭",0,20,-20
"7801","6207雷科","110/07/13","元大-高雄",121,0,121
"7802","6207雷科","110/07/13","華南永昌-朴子",1,60,-59
"7803","6207雷科","110/07/13","第一金-新興",20,0,20
"7804","6207雷科","110/07/13","元大-南海",0,36,-36
"7805","6207雷科","110/07/13","元富-三重",20,0,20
"7806","6207雷科","110/07/13","凱基-土城",0,35,-35
"7807","6207雷科","110/07/13","元大-林園",15,0,15
"7808","6207雷科","110/07/13","台灣企銀",0,20,-20
"7809","6207雷科","110/07/13","元大-金華",16,1,15
"7810","6207雷科","110/07/13","群益金鼎-丹鳳",0,20,-20
"7811","6207雷科","110/07/13","日盛證券",10,0,10
"7812","6207雷科","110/07/13","元大-博愛",0,17,-17
"7813","6207雷科","110/07/13","統一-台中",10,0,10
"7814","6207雷科","110/07/13","元大-北港",0,13,-13
"7815","6207雷科","110/07/13","群益金鼎-土城",10,0,10
"7816","6207雷科","110/07/13","新加坡商瑞銀",0,12,-12
"7817","6207雷科","110/07/13","群益金鼎-桃園",10,0,10
"7818","6207雷科","110/07/13","凱基-台北",4,16,-12
"7819","6207雷科","110/07/13","永豐金-新莊",10,0,10
"7820","6207雷科","110/07/13","日茂-埔里",0,11,-11
"7821","6207雷科","110/07/13","永豐金-新店",10,0,10
"7822","6207雷科","110/07/13","元大-莒光",0,11,-11
"7823","6207雷科","110/07/13","元大證券",9,0,9
"7824","6207雷科","110/07/13","統一-新竹",0,10,-10
"7825","6207雷科","110/07/13","日盛-木柵",9,1,8
"7826","6207雷科","110/07/13","元大-西螺",0,10,-10
"7827","6207雷科","110/07/13","兆豐-來福",8,0,8
"7828","6207雷科","110/07/13","康和-台中",0,8,-8
"7829","6207雷科","110/07/13","新光",7,0,7
"7830","6207雷科","110/07/13","兆豐-高雄",0,6,-6
"7831","3679新至陞","110/07/13","永豐金證券",50,0,50
"7832","3679新至陞","110/07/13","摩根大通",2,25,-23
"7833","3679新至陞","110/07/13","國泰-桃園",22,0,22
"7834","3679新至陞","110/07/13","元大-成功",0,22,-22
"7835","3679新至陞","110/07/13","台中銀-員林",11,0,11
"7836","3679新至陞","110/07/13","富邦-板橋",1,19,-18
"7837","3679新至陞","110/07/13","元大-文心興安",8,0,8
"7838","3679新至陞","110/07/13","日盛-新莊",0,10,-10
"7839","3679新至陞","110/07/13","美商高盛",6,0,6
"7840","3679新至陞","110/07/13","台新-台中",0,10,-10
"7841","3679新至陞","110/07/13","台新-高雄",6,0,6
"7842","3679新至陞","110/07/13","永豐金-新竹",0,8,-8
"7843","3679新至陞","110/07/13","凱基-台北",18,12,6
"7844","3679新至陞","110/07/13","瑞士信貸",12,19,-7
"7845","3679新至陞","110/07/13","日盛-復興",5,0,5
"7846","3679新至陞","110/07/13","統一-南京",0,7,-7
"7847","3679新至陞","110/07/13","(牛牛牛)亞-鑫豐",4,0,4
"7848","3679新至陞","110/07/13","凱基-新莊",0,7,-7
"7849","3679新至陞","110/07/13","元富-大昌",3,0,3
"7850","3679新至陞","110/07/13","新加坡商瑞銀",0,6,-6
"7851","3679新至陞","110/07/13","富邦-台北",3,0,3
"7852","3679新至陞","110/07/13","合庫-自強",0,5,-5
"7853","3679新至陞","110/07/13","日盛-樹林",2,0,2
"7854","3679新至陞","110/07/13","富邦-桃園",0,5,-5
"7855","3679新至陞","110/07/13","宏遠-光隆",2,0,2
"7856","3679新至陞","110/07/13","永豐金-潮州",0,4,-4
"7857","3679新至陞","110/07/13","美林",3,1,2
"7858","3679新至陞","110/07/13","臺銀-臺南",0,3,-3
"7859","3679新至陞","110/07/13","第一金-中壢",2,0,2
"7860","3679新至陞","110/07/13","元大-六合",0,3,-3
"7861","2727王品","110/07/13","富邦-台北",43,3,40
"7862","2727王品","110/07/13","台灣摩根士丹利",15,97,-82
"7863","2727王品","110/07/13","元大-基隆孝二",40,0,40
"7864","2727王品","110/07/13","玉山-台南",5,57,-52
"7865","2727王品","110/07/13","國票-新莊",40,1,39
"7866","2727王品","110/07/13","新加坡商瑞銀",0,48,-48
"7867","2727王品","110/07/13","第一金-豐原",66,42,24
"7868","2727王品","110/07/13","凱基-台北",41,77,-36
"7869","2727王品","110/07/13","永豐金-大園",34,10,24
"7870","2727王品","110/07/13","永豐金-永康",0,22,-22
"7871","2727王品","110/07/13","元大-北屯",22,0,22
"7872","2727王品","110/07/13","統一-台中",2,22,-20
"7873","2727王品","110/07/13","元大-東蘆",26,7,19
"7874","2727王品","110/07/13","國泰-台中",21,39,-18
"7875","2727王品","110/07/13","永豐金-萬盛",13,1,12
"7876","2727王品","110/07/13","合庫-彰化",3,20,-17
"7877","2727王品","110/07/13","日盛-嘉義",11,0,11
"7878","2727王品","110/07/13","港商野村",13,30,-17
"7879","2727王品","110/07/13","日盛-八德",11,0,11
"7880","2727王品","110/07/13","元大-楊梅",1,16,-15
"7881","2727王品","110/07/13","統一-竹南",11,0,11
"7882","2727王品","110/07/13","凱基-高美館",2,15,-13
"7883","2727王品","110/07/13","日盛-士林",12,2,10
"7884","2727王品","110/07/13","美商高盛",2,14,-12
"7885","2727王品","110/07/13","統一-敦南",10,0,10
"7886","2727王品","110/07/13","統一-平鎮",1,13,-12
"7887","2727王品","110/07/13","中國信託",15,5,10
"7888","2727王品","110/07/13","兆豐-台中港",4,16,-12
"7889","2727王品","110/07/13","兆豐-竹北",13,3,10
"7890","2727王品","110/07/13","凱基-八德",1,13,-12
"7891","1570力肯","110/07/13","新光",115,11,104
"7892","1570力肯","110/07/13","元大-北三重",0,162,-162
"7893","1570力肯","110/07/13","群益金鼎-高雄",54,0,54
"7894","1570力肯","110/07/13","元大-大灣",0,25,-25
"7895","1570力肯","110/07/13","國票-新莊",22,0,22
"7896","1570力肯","110/07/13","永豐金-苓雅",0,22,-22
"7897","1570力肯","110/07/13","日盛-桃園",12,0,12
"7898","1570力肯","110/07/13","永豐金-永康",0,19,-19
"7899","1570力肯","110/07/13","元大-高雄",12,0,12
"7900","1570力肯","110/07/13","富邦-員林",0,15,-15
"7901","1570力肯","110/07/13","合庫-自強",11,0,11
"7902","1570力肯","110/07/13","凱基-台南",0,11,-11
"7903","1570力肯","110/07/13","摩根大通",26,15,11
"7904","1570力肯","110/07/13","日盛-竹北",0,10,-10
"7905","1570力肯","110/07/13","永豐金-中盛",11,0,11
"7906","1570力肯","110/07/13","國票-九鼎",0,10,-10
"7907","1570力肯","110/07/13","兆豐-台中港",10,0,10
"7908","1570力肯","110/07/13","凱基-桃園",0,10,-10
"7909","1570力肯","110/07/13","國泰-松江",9,0,9
"7910","1570力肯","110/07/13","凱基-新豐",0,10,-10
"7911","1570力肯","110/07/13","元大-新盛",9,0,9
"7912","1570力肯","110/07/13","元大-學甲",0,10,-10
"7913","1570力肯","110/07/13","元富-緯城",6,0,6
"7914","1570力肯","110/07/13","群益金鼎-東湖",1,10,-9
"7915","1570力肯","110/07/13","統一-三重",5,0,5
"7916","1570力肯","110/07/13","大昌",0,6,-6
"7917","1570力肯","110/07/13","元大-前金",5,0,5
"7918","1570力肯","110/07/13","元大-土城學府",0,6,-6
"7919","1570力肯","110/07/13","永豐金證券",5,0,5
"7920","1570力肯","110/07/13","統一",0,5,-5
"7921","6180橘子","110/07/13","摩根大通",119,0,119
"7922","6180橘子","110/07/13","元大-崇德",2,61,-59
"7923","6180橘子","110/07/13","美商高盛",96,0,96
"7924","6180橘子","110/07/13","康和-台中",0,51,-51
"7925","6180橘子","110/07/13","新加坡商瑞銀",86,7,79
"7926","6180橘子","110/07/13","康和-台北",0,50,-50
"7927","6180橘子","110/07/13","元大-和平",40,0,40
"7928","6180橘子","110/07/13","元富-潮州",0,40,-40
"7929","6180橘子","110/07/13","凱基-台北",83,47,36
"7930","6180橘子","110/07/13","日盛-永康",0,26,-26
"7931","6180橘子","110/07/13","美林",39,5,34
"7932","6180橘子","110/07/13","永豐金-中正",0,24,-24
"7933","6180橘子","110/07/13","富邦-新竹華信",31,2,29
"7934","6180橘子","110/07/13","國泰-板橋",2,25,-23
"7935","6180橘子","110/07/13","統一-南京",21,0,21
"7936","6180橘子","110/07/13","日盛-大墩",0,20,-20
"7937","6180橘子","110/07/13","富邦-陽明",24,3,21
"7938","6180橘子","110/07/13","元大-草屯",13,32,-19
"7939","6180橘子","110/07/13","大昌-樹林",21,1,20
"7940","6180橘子","110/07/13","元富-林園",1,18,-17
"7941","6180橘子","110/07/13","花旗環球",19,0,19
"7942","6180橘子","110/07/13","新光-新竹",1,18,-17
"7943","6180橘子","110/07/13","華南永昌-台南",19,0,19
"7944","6180橘子","110/07/13","元大-土城永寧",0,17,-17
"7945","6180橘子","110/07/13","福勝",14,0,14
"7946","6180橘子","110/07/13","國泰-新莊",3,19,-16
"7947","6180橘子","110/07/13","富邦-嘉義",12,1,11
"7948","6180橘子","110/07/13","中國信託-永康",6,21,-15
"7949","6180橘子","110/07/13","元大-板橋三民",11,0,11
"7950","6180橘子","110/07/13","凱基-東港",1,15,-14
"7951","2390云辰","110/07/13","新加坡商瑞銀",562,75,487
"7952","2390云辰","110/07/13","大展-台南",0,532,-532
"7953","2390云辰","110/07/13","台灣摩根士丹利",330,155,175
"7954","2390云辰","110/07/13","凱基-台北",668,854,-186
"7955","2390云辰","110/07/13","兆豐-公益",126,25,101
"7956","2390云辰","110/07/13","凱基-三重",12,172,-160
"7957","2390云辰","110/07/13","元富-中港",100,2,98
"7958","2390云辰","110/07/13","兆豐-忠孝",4,161,-157
"7959","2390云辰","110/07/13","統一-新台中",106,9,97
"7960","2390云辰","110/07/13","元大-士林",19,170,-151
"7961","2390云辰","110/07/13","中國信託-松江",81,11,70
"7962","2390云辰","110/07/13","臺銀-新竹",14,117,-103
"7963","2390云辰","110/07/13","日盛-板橋",72,3,69
"7964","2390云辰","110/07/13","國票-台中",4,102,-98
"7965","2390云辰","110/07/13","日盛-和美",57,0,57
"7966","2390云辰","110/07/13","新光",147,232,-85
"7967","2390云辰","110/07/13","永豐金-桃園",88,36,52
"7968","2390云辰","110/07/13","致和-崇德",2,70,-68
"7969","2390云辰","110/07/13","玉山-士林",54,4,50
"7970","2390云辰","110/07/13","群益金鼎-屏東",2,70,-68
"7971","2390云辰","110/07/13","富邦-仁愛",56,6,50
"7972","2390云辰","110/07/13","元大-大里",35,98,-63
"7973","2390云辰","110/07/13","第一金-豐原",50,1,49
"7974","2390云辰","110/07/13","元大-萬華",35,94,-59
"7975","2390云辰","110/07/13","摩根大通",502,453,49
"7976","2390云辰","110/07/13","元富-吉利",2,60,-58
"7977","2390云辰","110/07/13","凱基-松山",61,13,48
"7978","2390云辰","110/07/13","兆豐-新竹",3,53,-50
"7979","2390云辰","110/07/13","大昌",64,22,42
"7980","2390云辰","110/07/13","富邦-嘉義",65,108,-43
"7981","2363矽統","110/07/13","凱基-南崁",2133,63,2070
"7982","2363矽統","110/07/13","凱基-幸福",36,4048,-4012
"7983","2363矽統","110/07/13","國泰-敦南",2195,1617,578
"7984","2363矽統","110/07/13","統一",192,3325,-3133
"7985","2363矽統","110/07/13","中農",670,139,531
"7986","2363矽統","110/07/13","新加坡商瑞銀",1000,2747,-1747
"7987","2363矽統","110/07/13","康和-台中",638,154,484
"7988","2363矽統","110/07/13","凱基-台北",5359,6609,-1250
"7989","2363矽統","110/07/13","群益金鼎-三民",577,137,440
"7990","2363矽統","110/07/13","摩根大通",1930,2858,-928
"7991","2363矽統","110/07/13","台新-屏東",510,88,422
"7992","2363矽統","110/07/13","港商野村",960,1679,-719
"7993","2363矽統","110/07/13","德信-中正",455,67,388
"7994","2363矽統","110/07/13","兆豐-復興",25,705,-680
"7995","2363矽統","110/07/13","日盛-竹北",365,70,295
"7996","2363矽統","110/07/13","統一-仁愛",114,755,-641
"7997","2363矽統","110/07/13","元大-佳里",452,189,263
"7998","2363矽統","110/07/13","統一-敦南",29,638,-609
"7999","2363矽統","110/07/13","國票-博愛",296,38,258
"8000","2363矽統","110/07/13","統一-土城",100,704,-604
"8001","2363矽統","110/07/13","元大-萬華",340,95,245
"8002","2363矽統","110/07/13","統一-城中",116,676,-560
"8003","2363矽統","110/07/13","新光",1259,1031,228
"8004","2363矽統","110/07/13","永豐金證券",306,859,-553
"8005","2363矽統","110/07/13","元富-成功",323,96,227
"8006","2363矽統","110/07/13","元富",54,567,-513
"8007","2363矽統","110/07/13","豐農",228,23,205
"8008","2363矽統","110/07/13","瑞士信貸",202,666,-464
"8009","2363矽統","110/07/13","台灣企銀-岡山",186,4,182
"8010","2363矽統","110/07/13","永豐金-嘉義",67,468,-401
"8011","8112至上","110/07/13","摩根大通",688,296,392
"8012","8112至上","110/07/13","國票-中和",0,401,-401
"8013","8112至上","110/07/13","港商野村",344,145,199
"8014","8112至上","110/07/13","永豐金-板盛",0,205,-205
"8015","8112至上","110/07/13","兆豐-公益",195,5,190
"8016","8112至上","110/07/13","凱基-五股",43,155,-112
"8017","8112至上","110/07/13","台灣摩根士丹利",183,0,183
"8018","8112至上","110/07/13","凱基-市政",0,100,-100
"8019","8112至上","110/07/13","群益金鼎-敦南",153,2,151
"8020","8112至上","110/07/13","元大-大里德芳",1,92,-91
"8021","8112至上","110/07/13","臺銀-金山",146,26,120
"8022","8112至上","110/07/13","玉山-桃園",26,110,-84
"8023","8112至上","110/07/13","臺銀",133,19,114
"8024","8112至上","110/07/13","兆豐-天母",0,81,-81
"8025","8112至上","110/07/13","合庫-台中",115,6,109
"8026","8112至上","110/07/13","凱基-城中",3,84,-81
"8027","8112至上","110/07/13","亞東-板橋",134,26,108
"8028","8112至上","110/07/13","日盛-新莊",9,85,-76
"8029","8112至上","110/07/13","凱基-台北",414,326,88
"8030","8112至上","110/07/13","日盛-台中",2,64,-62
"8031","8112至上","110/07/13","新加坡商瑞銀",181,100,81
"8032","8112至上","110/07/13","日盛-中壢",3,64,-61
"8033","8112至上","110/07/13","國泰-敦南",108,31,77
"8034","8112至上","110/07/13","元大-台中",2,59,-57
"8035","8112至上","110/07/13","第一金-華江",77,4,73
"8036","8112至上","110/07/13","元大-雙和",7,64,-57
"8037","8112至上","110/07/13","永豐金-內湖",73,1,72
"8038","8112至上","110/07/13","元大-高雄",8,62,-54
"8039","8112至上","110/07/13","元大-永和",68,1,67
"8040","8112至上","110/07/13","元大-館前",2,55,-53
"8041","4903聯光通","110/07/13","台灣企銀-太平",56,0,56
"8042","4903聯光通","110/07/13","土銀",0,32,-32
"8043","4903聯光通","110/07/13","元富-新興",23,0,23
"8044","4903聯光通","110/07/13","元大-樹林",0,19,-19
"8045","4903聯光通","110/07/13","日盛-樹林",22,0,22
"8046","4903聯光通","110/07/13","凱基-士林",0,17,-17
"8047","4903聯光通","110/07/13","兆豐-天母",20,0,20
"8048","4903聯光通","110/07/13","國票-博愛",0,14,-14
"8049","4903聯光通","110/07/13","華南永昌-桃園",20,0,20
"8050","4903聯光通","110/07/13","元富",0,10,-10
"8051","4903聯光通","110/07/13","富邦-新店",10,0,10
"8052","4903聯光通","110/07/13","新光",0,10,-10
"8053","4903聯光通","110/07/13","新光-台中",5,0,5
"8054","4903聯光通","110/07/13","玉山-南京東路",0,10,-10
"8055","4903聯光通","110/07/13","華南永昌-台中",5,0,5
"8056","4903聯光通","110/07/13","富邦-陽明",0,10,-10
"8057","4903聯光通","110/07/13","元大-崇德",5,0,5
"8058","4903聯光通","110/07/13","元大-大甲",0,8,-8
"8059","4903聯光通","110/07/13","元大-草屯",5,0,5
"8060","4903聯光通","110/07/13","富邦-台中",0,7,-7
"8061","4903聯光通","110/07/13","元富-草屯",4,0,4
"8062","4903聯光通","110/07/13","凱基-中壢",0,6,-6
"8063","4903聯光通","110/07/13","元大-清水",4,0,4
"8064","4903聯光通","110/07/13","臺銀-民權",0,5,-5
"8065","4903聯光通","110/07/13","元大-東泰",4,0,4
"8066","4903聯光通","110/07/13","日盛-板橋",0,5,-5
"8067","4903聯光通","110/07/13","元大-佳里",2,0,2
"8068","4903聯光通","110/07/13","中國信託-忠孝",0,5,-5
"8069","4903聯光通","110/07/13","永豐金-板橋",2,0,2
"8070","4903聯光通","110/07/13","永豐金-鳳山",0,5,-5
"8071","2929淘帝","110/07/13","玉山-新竹",130,0,130
"8072","2929淘帝","110/07/13","美商高盛",0,177,-177
"8073","2929淘帝","110/07/13","臺銀-民權",60,0,60
"8074","2929淘帝","110/07/13","凱基-台北",6,80,-74
"8075","2929淘帝","110/07/13","新百王",31,0,31
"8076","2929淘帝","110/07/13","元富-大裕",0,49,-49
"8077","2929淘帝","110/07/13","日盛-園區",30,0,30
"8078","2929淘帝","110/07/13","國泰-館前",3,51,-48
"8079","2929淘帝","110/07/13","元大-南投",31,1,30
"8080","2929淘帝","110/07/13","凱基-中壢",0,41,-41
"8081","2929淘帝","110/07/13","兆豐-忠孝",28,0,28
"8082","2929淘帝","110/07/13","港商野村",21,55,-34
"8083","2929淘帝","110/07/13","元大-民生",28,0,28
"8084","2929淘帝","110/07/13","華南永昌-南京",2,34,-32
"8085","2929淘帝","110/07/13","合庫-高雄",27,0,27
"8086","2929淘帝","110/07/13","群益金鼎-土城",0,30,-30
"8087","2929淘帝","110/07/13","凱基-豐中",27,0,27
"8088","2929淘帝","110/07/13","富邦-南屯",0,22,-22
"8089","2929淘帝","110/07/13","新光",21,4,17
"8090","2929淘帝","110/07/13","第一金-豐原",0,20,-20
"8091","2929淘帝","110/07/13","元大-天母",17,0,17
"8092","2929淘帝","110/07/13","元大-屏南",6,26,-20
"8093","2929淘帝","110/07/13","永興",14,0,14
"8094","2929淘帝","110/07/13","永豐金-敦南",1,21,-20
"8095","2929淘帝","110/07/13","富邦-台北",12,0,12
"8096","2929淘帝","110/07/13","凱基-三重",2,21,-19
"8097","2929淘帝","110/07/13","元大-永和",12,0,12
"8098","2929淘帝","110/07/13","富邦-仁愛",7,25,-18
"8099","2929淘帝","110/07/13","國票-天祥",11,0,11
"8100","2929淘帝","110/07/13","元大-北投",0,16,-16
"8101","5410國眾","110/07/13","兆豐-城中",274,0,274
"8102","5410國眾","110/07/13","元富-嘉義",0,103,-103
"8103","5410國眾","110/07/13","新光",50,4,46
"8104","5410國眾","110/07/13","凱基-台北",0,50,-50
"8105","5410國眾","110/07/13","國泰-台中",26,0,26
"8106","5410國眾","110/07/13","瑞士信貸",0,31,-31
"8107","5410國眾","110/07/13","新加坡商瑞銀",22,0,22
"8108","5410國眾","110/07/13","台新-新莊",0,27,-27
"8109","5410國眾","110/07/13","光和-嘉義",20,0,20
"8110","5410國眾","110/07/13","元大-汐止",0,20,-20
"8111","5410國眾","110/07/13","凱基-竹北",17,0,17
"8112","5410國眾","110/07/13","亞東-新竹",0,17,-17
"8113","5410國眾","110/07/13","新光-桃園",15,0,15
"8114","5410國眾","110/07/13","元大-南勢角",0,13,-13
"8115","5410國眾","110/07/13","凱基-台東",14,0,14
"8116","5410國眾","110/07/13","台新-台南",0,12,-12
"8117","5410國眾","110/07/13","富邦-竹北",11,0,11
"8118","5410國眾","110/07/13","中國信託",0,11,-11
"8119","5410國眾","110/07/13","元富-同大",10,0,10
"8120","5410國眾","110/07/13","華南永昌",0,11,-11
"8121","5410國眾","110/07/13","國泰-敦南",24,15,9
"8122","5410國眾","110/07/13","臺銀-臺南",0,10,-10
"8123","5410國眾","110/07/13","日盛-內湖",7,0,7
"8124","5410國眾","110/07/13","台灣企銀-民雄",0,10,-10
"8125","5410國眾","110/07/13","台新-左楠",7,0,7
"8126","5410國眾","110/07/13","高橋",0,10,-10
"8127","5410國眾","110/07/13","元大-新盛",18,12,6
"8128","5410國眾","110/07/13","康和-嘉義",0,10,-10
"8129","5410國眾","110/07/13","統一",5,0,5
"8130","5410國眾","110/07/13","凱基-基隆",0,10,-10
"8131","2841台開","110/07/13","中國信託-高雄",251,50,201
"8132","2841台開","110/07/13","兆豐-公益",0,177,-177
"8133","2841台開","110/07/13","日盛證券",210,13,197
"8134","2841台開","110/07/13","日進",0,152,-152
"8135","2841台開","110/07/13","第一金-台中",55,0,55
"8136","2841台開","110/07/13","港商野村",0,109,-109
"8137","2841台開","110/07/13","國泰-板橋",46,0,46
"8138","2841台開","110/07/13","日盛-信義",0,103,-103
"8139","2841台開","110/07/13","國泰-館前",48,3,45
"8140","2841台開","110/07/13","國泰-敦南",11,75,-64
"8141","2841台開","110/07/13","華南永昌-新莊",45,0,45
"8142","2841台開","110/07/13","永興",0,50,-50
"8143","2841台開","110/07/13","日盛-園區",42,0,42
"8144","2841台開","110/07/13","永豐金-敦南",61,104,-43
"8145","2841台開","110/07/13","台新證券",32,0,32
"8146","2841台開","110/07/13","富邦-台南",0,42,-42
"8147","2841台開","110/07/13","台新-高雄",32,2,30
"8148","2841台開","110/07/13","國票-安和",0,30,-30
"8149","2841台開","110/07/13","豐農",23,0,23
"8150","2841台開","110/07/13","元大-桃園",0,25,-25
"8151","2841台開","110/07/13","合庫-嘉義",20,0,20
"8152","2841台開","110/07/13","新光",8,32,-24
"8153","2841台開","110/07/13","華南永昌-高雄",20,0,20
"8154","2841台開","110/07/13","元大-仁愛",0,24,-24
"8155","2841台開","110/07/13","元大-樹林",16,0,16
"8156","2841台開","110/07/13","日盛-中和",0,20,-20
"8157","2841台開","110/07/13","第一金-華江",15,2,13
"8158","2841台開","110/07/13","元富",0,20,-20
"8159","2841台開","110/07/13","美商高盛",12,0,12
"8160","2841台開","110/07/13","富邦-宜蘭",0,20,-20
"8161","6207雷科","110/07/13","元大-高雄",121,0,121
"8162","6207雷科","110/07/13","華南永昌-朴子",1,60,-59
"8163","6207雷科","110/07/13","第一金-新興",20,0,20
"8164","6207雷科","110/07/13","元大-南海",0,36,-36
"8165","6207雷科","110/07/13","元富-三重",20,0,20
"8166","6207雷科","110/07/13","凱基-土城",0,35,-35
"8167","6207雷科","110/07/13","元大-林園",15,0,15
"8168","6207雷科","110/07/13","台灣企銀",0,20,-20
"8169","6207雷科","110/07/13","元大-金華",16,1,15
"8170","6207雷科","110/07/13","群益金鼎-丹鳳",0,20,-20
"8171","6207雷科","110/07/13","日盛證券",10,0,10
"8172","6207雷科","110/07/13","元大-博愛",0,17,-17
"8173","6207雷科","110/07/13","統一-台中",10,0,10
"8174","6207雷科","110/07/13","元大-北港",0,13,-13
"8175","6207雷科","110/07/13","群益金鼎-土城",10,0,10
"8176","6207雷科","110/07/13","新加坡商瑞銀",0,12,-12
"8177","6207雷科","110/07/13","群益金鼎-桃園",10,0,10
"8178","6207雷科","110/07/13","凱基-台北",4,16,-12
"8179","6207雷科","110/07/13","永豐金-新莊",10,0,10
"8180","6207雷科","110/07/13","日茂-埔里",0,11,-11
"8181","6207雷科","110/07/13","永豐金-新店",10,0,10
"8182","6207雷科","110/07/13","元大-莒光",0,11,-11
"8183","6207雷科","110/07/13","元大證券",9,0,9
"8184","6207雷科","110/07/13","統一-新竹",0,10,-10
"8185","6207雷科","110/07/13","日盛-木柵",9,1,8
"8186","6207雷科","110/07/13","元大-西螺",0,10,-10
"8187","6207雷科","110/07/13","兆豐-來福",8,0,8
"8188","6207雷科","110/07/13","康和-台中",0,8,-8
"8189","6207雷科","110/07/13","新光",7,0,7
"8190","6207雷科","110/07/13","兆豐-高雄",0,6,-6
"8191","3679新至陞","110/07/13","永豐金證券",50,0,50
"8192","3679新至陞","110/07/13","摩根大通",2,25,-23
"8193","3679新至陞","110/07/13","國泰-桃園",22,0,22
"8194","3679新至陞","110/07/13","元大-成功",0,22,-22
"8195","3679新至陞","110/07/13","台中銀-員林",11,0,11
"8196","3679新至陞","110/07/13","富邦-板橋",1,19,-18
"8197","3679新至陞","110/07/13","元大-文心興安",8,0,8
"8198","3679新至陞","110/07/13","日盛-新莊",0,10,-10
"8199","3679新至陞","110/07/13","美商高盛",6,0,6
"8200","3679新至陞","110/07/13","台新-台中",0,10,-10
"8201","3679新至陞","110/07/13","台新-高雄",6,0,6
"8202","3679新至陞","110/07/13","永豐金-新竹",0,8,-8
"8203","3679新至陞","110/07/13","凱基-台北",18,12,6
"8204","3679新至陞","110/07/13","瑞士信貸",12,19,-7
"8205","3679新至陞","110/07/13","日盛-復興",5,0,5
"8206","3679新至陞","110/07/13","統一-南京",0,7,-7
"8207","3679新至陞","110/07/13","(牛牛牛)亞-鑫豐",4,0,4
"8208","3679新至陞","110/07/13","凱基-新莊",0,7,-7
"8209","3679新至陞","110/07/13","元富-大昌",3,0,3
"8210","3679新至陞","110/07/13","新加坡商瑞銀",0,6,-6
"8211","3679新至陞","110/07/13","富邦-台北",3,0,3
"8212","3679新至陞","110/07/13","合庫-自強",0,5,-5
"8213","3679新至陞","110/07/13","日盛-樹林",2,0,2
"8214","3679新至陞","110/07/13","富邦-桃園",0,5,-5
"8215","3679新至陞","110/07/13","宏遠-光隆",2,0,2
"8216","3679新至陞","110/07/13","永豐金-潮州",0,4,-4
"8217","3679新至陞","110/07/13","美林",3,1,2
"8218","3679新至陞","110/07/13","臺銀-臺南",0,3,-3
"8219","3679新至陞","110/07/13","第一金-中壢",2,0,2
"8220","3679新至陞","110/07/13","元大-六合",0,3,-3
"8221","2727王品","110/07/13","富邦-台北",43,3,40
"8222","2727王品","110/07/13","台灣摩根士丹利",15,97,-82
"8223","2727王品","110/07/13","元大-基隆孝二",40,0,40
"8224","2727王品","110/07/13","玉山-台南",5,57,-52
"8225","2727王品","110/07/13","國票-新莊",40,1,39
"8226","2727王品","110/07/13","新加坡商瑞銀",0,48,-48
"8227","2727王品","110/07/13","第一金-豐原",66,42,24
"8228","2727王品","110/07/13","凱基-台北",41,77,-36
"8229","2727王品","110/07/13","永豐金-大園",34,10,24
"8230","2727王品","110/07/13","永豐金-永康",0,22,-22
"8231","2727王品","110/07/13","元大-北屯",22,0,22
"8232","2727王品","110/07/13","統一-台中",2,22,-20
"8233","2727王品","110/07/13","元大-東蘆",26,7,19
"8234","2727王品","110/07/13","國泰-台中",21,39,-18
"8235","2727王品","110/07/13","永豐金-萬盛",13,1,12
"8236","2727王品","110/07/13","合庫-彰化",3,20,-17
"8237","2727王品","110/07/13","日盛-嘉義",11,0,11
"8238","2727王品","110/07/13","港商野村",13,30,-17
"8239","2727王品","110/07/13","日盛-八德",11,0,11
"8240","2727王品","110/07/13","元大-楊梅",1,16,-15
"8241","2727王品","110/07/13","統一-竹南",11,0,11
"8242","2727王品","110/07/13","凱基-高美館",2,15,-13
"8243","2727王品","110/07/13","日盛-士林",12,2,10
"8244","2727王品","110/07/13","美商高盛",2,14,-12
"8245","2727王品","110/07/13","統一-敦南",10,0,10
"8246","2727王品","110/07/13","統一-平鎮",1,13,-12
"8247","2727王品","110/07/13","中國信託",15,5,10
"8248","2727王品","110/07/13","兆豐-台中港",4,16,-12
"8249","2727王品","110/07/13","兆豐-竹北",13,3,10
"8250","2727王品","110/07/13","凱基-八德",1,13,-12
"8251","1570力肯","110/07/13","新光",115,11,104
"8252","1570力肯","110/07/13","元大-北三重",0,162,-162
"8253","1570力肯","110/07/13","群益金鼎-高雄",54,0,54
"8254","1570力肯","110/07/13","元大-大灣",0,25,-25
"8255","1570力肯","110/07/13","國票-新莊",22,0,22
"8256","1570力肯","110/07/13","永豐金-苓雅",0,22,-22
"8257","1570力肯","110/07/13","日盛-桃園",12,0,12
"8258","1570力肯","110/07/13","永豐金-永康",0,19,-19
"8259","1570力肯","110/07/13","元大-高雄",12,0,12
"8260","1570力肯","110/07/13","富邦-員林",0,15,-15
"8261","1570力肯","110/07/13","合庫-自強",11,0,11
"8262","1570力肯","110/07/13","凱基-台南",0,11,-11
"8263","1570力肯","110/07/13","摩根大通",26,15,11
"8264","1570力肯","110/07/13","日盛-竹北",0,10,-10
"8265","1570力肯","110/07/13","永豐金-中盛",11,0,11
"8266","1570力肯","110/07/13","國票-九鼎",0,10,-10
"8267","1570力肯","110/07/13","兆豐-台中港",10,0,10
"8268","1570力肯","110/07/13","凱基-桃園",0,10,-10
"8269","1570力肯","110/07/13","國泰-松江",9,0,9
"8270","1570力肯","110/07/13","凱基-新豐",0,10,-10
"8271","1570力肯","110/07/13","元大-新盛",9,0,9
"8272","1570力肯","110/07/13","元大-學甲",0,10,-10
"8273","1570力肯","110/07/13","元富-緯城",6,0,6
"8274","1570力肯","110/07/13","群益金鼎-東湖",1,10,-9
"8275","1570力肯","110/07/13","統一-三重",5,0,5
"8276","1570力肯","110/07/13","大昌",0,6,-6
"8277","1570力肯","110/07/13","元大-前金",5,0,5
"8278","1570力肯","110/07/13","元大-土城學府",0,6,-6
"8279","1570力肯","110/07/13","永豐金證券",5,0,5
"8280","1570力肯","110/07/13","統一",0,5,-5
"8281","6180橘子","110/07/13","摩根大通",119,0,119
"8282","6180橘子","110/07/13","元大-崇德",2,61,-59
"8283","6180橘子","110/07/13","美商高盛",96,0,96
"8284","6180橘子","110/07/13","康和-台中",0,51,-51
"8285","6180橘子","110/07/13","新加坡商瑞銀",86,7,79
"8286","6180橘子","110/07/13","康和-台北",0,50,-50
"8287","6180橘子","110/07/13","元大-和平",40,0,40
"8288","6180橘子","110/07/13","元富-潮州",0,40,-40
"8289","6180橘子","110/07/13","凱基-台北",83,47,36
"8290","6180橘子","110/07/13","日盛-永康",0,26,-26
"8291","6180橘子","110/07/13","美林",39,5,34
"8292","6180橘子","110/07/13","永豐金-中正",0,24,-24
"8293","6180橘子","110/07/13","富邦-新竹華信",31,2,29
"8294","6180橘子","110/07/13","國泰-板橋",2,25,-23
"8295","6180橘子","110/07/13","統一-南京",21,0,21
"8296","6180橘子","110/07/13","日盛-大墩",0,20,-20
"8297","6180橘子","110/07/13","富邦-陽明",24,3,21
"8298","6180橘子","110/07/13","元大-草屯",13,32,-19
"8299","6180橘子","110/07/13","大昌-樹林",21,1,20
"8300","6180橘子","110/07/13","元富-林園",1,18,-17
"8301","6180橘子","110/07/13","花旗環球",19,0,19
"8302","6180橘子","110/07/13","新光-新竹",1,18,-17
"8303","6180橘子","110/07/13","華南永昌-台南",19,0,19
"8304","6180橘子","110/07/13","元大-土城永寧",0,17,-17
"8305","6180橘子","110/07/13","福勝",14,0,14
"8306","6180橘子","110/07/13","國泰-新莊",3,19,-16
"8307","6180橘子","110/07/13","富邦-嘉義",12,1,11
"8308","6180橘子","110/07/13","中國信託-永康",6,21,-15
"8309","6180橘子","110/07/13","元大-板橋三民",11,0,11
"8310","6180橘子","110/07/13","凱基-東港",1,15,-14
"8311","2390云辰","110/07/13","新加坡商瑞銀",562,75,487
"8312","2390云辰","110/07/13","大展-台南",0,532,-532
"8313","2390云辰","110/07/13","台灣摩根士丹利",330,155,175
"8314","2390云辰","110/07/13","凱基-台北",668,854,-186
"8315","2390云辰","110/07/13","兆豐-公益",126,25,101
"8316","2390云辰","110/07/13","凱基-三重",12,172,-160
"8317","2390云辰","110/07/13","元富-中港",100,2,98
"8318","2390云辰","110/07/13","兆豐-忠孝",4,161,-157
"8319","2390云辰","110/07/13","統一-新台中",106,9,97
"8320","2390云辰","110/07/13","元大-士林",19,170,-151
"8321","2390云辰","110/07/13","中國信託-松江",81,11,70
"8322","2390云辰","110/07/13","臺銀-新竹",14,117,-103
"8323","2390云辰","110/07/13","日盛-板橋",72,3,69
"8324","2390云辰","110/07/13","國票-台中",4,102,-98
"8325","2390云辰","110/07/13","日盛-和美",57,0,57
"8326","2390云辰","110/07/13","新光",147,232,-85
"8327","2390云辰","110/07/13","永豐金-桃園",88,36,52
"8328","2390云辰","110/07/13","致和-崇德",2,70,-68
"8329","2390云辰","110/07/13","玉山-士林",54,4,50
"8330","2390云辰","110/07/13","群益金鼎-屏東",2,70,-68
"8331","2390云辰","110/07/13","富邦-仁愛",56,6,50
"8332","2390云辰","110/07/13","元大-大里",35,98,-63
"8333","2390云辰","110/07/13","第一金-豐原",50,1,49
"8334","2390云辰","110/07/13","元大-萬華",35,94,-59
"8335","2390云辰","110/07/13","摩根大通",502,453,49
"8336","2390云辰","110/07/13","元富-吉利",2,60,-58
"8337","2390云辰","110/07/13","凱基-松山",61,13,48
"8338","2390云辰","110/07/13","兆豐-新竹",3,53,-50
"8339","2390云辰","110/07/13","大昌",64,22,42
"8340","2390云辰","110/07/13","富邦-嘉義",65,108,-43
"8341","2363矽統","110/07/13","凱基-南崁",2133,63,2070
"8342","2363矽統","110/07/13","凱基-幸福",36,4048,-4012
"8343","2363矽統","110/07/13","國泰-敦南",2195,1617,578
"8344","2363矽統","110/07/13","統一",192,3325,-3133
"8345","2363矽統","110/07/13","中農",670,139,531
"8346","2363矽統","110/07/13","新加坡商瑞銀",1000,2747,-1747
"8347","2363矽統","110/07/13","康和-台中",638,154,484
"8348","2363矽統","110/07/13","凱基-台北",5359,6609,-1250
"8349","2363矽統","110/07/13","群益金鼎-三民",577,137,440
"8350","2363矽統","110/07/13","摩根大通",1930,2858,-928
"8351","2363矽統","110/07/13","台新-屏東",510,88,422
"8352","2363矽統","110/07/13","港商野村",960,1679,-719
"8353","2363矽統","110/07/13","德信-中正",455,67,388
"8354","2363矽統","110/07/13","兆豐-復興",25,705,-680
"8355","2363矽統","110/07/13","日盛-竹北",365,70,295
"8356","2363矽統","110/07/13","統一-仁愛",114,755,-641
"8357","2363矽統","110/07/13","元大-佳里",452,189,263
"8358","2363矽統","110/07/13","統一-敦南",29,638,-609
"8359","2363矽統","110/07/13","國票-博愛",296,38,258
"8360","2363矽統","110/07/13","統一-土城",100,704,-604
"8361","2363矽統","110/07/13","元大-萬華",340,95,245
"8362","2363矽統","110/07/13","統一-城中",116,676,-560
"8363","2363矽統","110/07/13","新光",1259,1031,228
"8364","2363矽統","110/07/13","永豐金證券",306,859,-553
"8365","2363矽統","110/07/13","元富-成功",323,96,227
"8366","2363矽統","110/07/13","元富",54,567,-513
"8367","2363矽統","110/07/13","豐農",228,23,205
"8368","2363矽統","110/07/13","瑞士信貸",202,666,-464
"8369","2363矽統","110/07/13","台灣企銀-岡山",186,4,182
"8370","2363矽統","110/07/13","永豐金-嘉義",67,468,-401
"8371","8112至上","110/07/13","摩根大通",688,296,392
"8372","8112至上","110/07/13","國票-中和",0,401,-401
"8373","8112至上","110/07/13","港商野村",344,145,199
"8374","8112至上","110/07/13","永豐金-板盛",0,205,-205
"8375","8112至上","110/07/13","兆豐-公益",195,5,190
"8376","8112至上","110/07/13","凱基-五股",43,155,-112
"8377","8112至上","110/07/13","台灣摩根士丹利",183,0,183
"8378","8112至上","110/07/13","凱基-市政",0,100,-100
"8379","8112至上","110/07/13","群益金鼎-敦南",153,2,151
"8380","8112至上","110/07/13","元大-大里德芳",1,92,-91
"8381","8112至上","110/07/13","臺銀-金山",146,26,120
"8382","8112至上","110/07/13","玉山-桃園",26,110,-84
"8383","8112至上","110/07/13","臺銀",133,19,114
"8384","8112至上","110/07/13","兆豐-天母",0,81,-81
"8385","8112至上","110/07/13","合庫-台中",115,6,109
"8386","8112至上","110/07/13","凱基-城中",3,84,-81
"8387","8112至上","110/07/13","亞東-板橋",134,26,108
"8388","8112至上","110/07/13","日盛-新莊",9,85,-76
"8389","8112至上","110/07/13","凱基-台北",414,326,88
"8390","8112至上","110/07/13","日盛-台中",2,64,-62
"8391","8112至上","110/07/13","新加坡商瑞銀",181,100,81
"8392","8112至上","110/07/13","日盛-中壢",3,64,-61
"8393","8112至上","110/07/13","國泰-敦南",108,31,77
"8394","8112至上","110/07/13","元大-台中",2,59,-57
"8395","8112至上","110/07/13","第一金-華江",77,4,73
"8396","8112至上","110/07/13","元大-雙和",7,64,-57
"8397","8112至上","110/07/13","永豐金-內湖",73,1,72
"8398","8112至上","110/07/13","元大-高雄",8,62,-54
"8399","8112至上","110/07/13","元大-永和",68,1,67
"8400","8112至上","110/07/13","元大-館前",2,55,-53
"8401","4903聯光通","110/07/13","台灣企銀-太平",56,0,56
"8402","4903聯光通","110/07/13","土銀",0,32,-32
"8403","4903聯光通","110/07/13","元富-新興",23,0,23
"8404","4903聯光通","110/07/13","元大-樹林",0,19,-19
"8405","4903聯光通","110/07/13","日盛-樹林",22,0,22
"8406","4903聯光通","110/07/13","凱基-士林",0,17,-17
"8407","4903聯光通","110/07/13","兆豐-天母",20,0,20
"8408","4903聯光通","110/07/13","國票-博愛",0,14,-14
"8409","4903聯光通","110/07/13","華南永昌-桃園",20,0,20
"8410","4903聯光通","110/07/13","元富",0,10,-10
"8411","4903聯光通","110/07/13","富邦-新店",10,0,10
"8412","4903聯光通","110/07/13","新光",0,10,-10
"8413","4903聯光通","110/07/13","新光-台中",5,0,5
"8414","4903聯光通","110/07/13","玉山-南京東路",0,10,-10
"8415","4903聯光通","110/07/13","華南永昌-台中",5,0,5
"8416","4903聯光通","110/07/13","富邦-陽明",0,10,-10
"8417","4903聯光通","110/07/13","元大-崇德",5,0,5
"8418","4903聯光通","110/07/13","元大-大甲",0,8,-8
"8419","4903聯光通","110/07/13","元大-草屯",5,0,5
"8420","4903聯光通","110/07/13","富邦-台中",0,7,-7
"8421","4903聯光通","110/07/13","元富-草屯",4,0,4
"8422","4903聯光通","110/07/13","凱基-中壢",0,6,-6
"8423","4903聯光通","110/07/13","元大-清水",4,0,4
"8424","4903聯光通","110/07/13","臺銀-民權",0,5,-5
"8425","4903聯光通","110/07/13","元大-東泰",4,0,4
"8426","4903聯光通","110/07/13","日盛-板橋",0,5,-5
"8427","4903聯光通","110/07/13","元大-佳里",2,0,2
"8428","4903聯光通","110/07/13","中國信託-忠孝",0,5,-5
"8429","4903聯光通","110/07/13","永豐金-板橋",2,0,2
"8430","4903聯光通","110/07/13","永豐金-鳳山",0,5,-5
"8431","2929淘帝","110/07/13","玉山-新竹",130,0,130
"8432","2929淘帝","110/07/13","美商高盛",0,177,-177
"8433","2929淘帝","110/07/13","臺銀-民權",60,0,60
"8434","2929淘帝","110/07/13","凱基-台北",6,80,-74
"8435","2929淘帝","110/07/13","新百王",31,0,31
"8436","2929淘帝","110/07/13","元富-大裕",0,49,-49
"8437","2929淘帝","110/07/13","日盛-園區",30,0,30
"8438","2929淘帝","110/07/13","國泰-館前",3,51,-48
"8439","2929淘帝","110/07/13","元大-南投",31,1,30
"8440","2929淘帝","110/07/13","凱基-中壢",0,41,-41
"8441","2929淘帝","110/07/13","兆豐-忠孝",28,0,28
"8442","2929淘帝","110/07/13","港商野村",21,55,-34
"8443","2929淘帝","110/07/13","元大-民生",28,0,28
"8444","2929淘帝","110/07/13","華南永昌-南京",2,34,-32
"8445","2929淘帝","110/07/13","合庫-高雄",27,0,27
"8446","2929淘帝","110/07/13","群益金鼎-土城",0,30,-30
"8447","2929淘帝","110/07/13","凱基-豐中",27,0,27
"8448","2929淘帝","110/07/13","富邦-南屯",0,22,-22
"8449","2929淘帝","110/07/13","新光",21,4,17
"8450","2929淘帝","110/07/13","第一金-豐原",0,20,-20
"8451","2929淘帝","110/07/13","元大-天母",17,0,17
"8452","2929淘帝","110/07/13","元大-屏南",6,26,-20
"8453","2929淘帝","110/07/13","永興",14,0,14
"8454","2929淘帝","110/07/13","永豐金-敦南",1,21,-20
"8455","2929淘帝","110/07/13","富邦-台北",12,0,12
"8456","2929淘帝","110/07/13","凱基-三重",2,21,-19
"8457","2929淘帝","110/07/13","元大-永和",12,0,12
"8458","2929淘帝","110/07/13","富邦-仁愛",7,25,-18
"8459","2929淘帝","110/07/13","國票-天祥",11,0,11
"8460","2929淘帝","110/07/13","元大-北投",0,16,-16
"8461","5410國眾","110/07/13","兆豐-城中",274,0,274
"8462","5410國眾","110/07/13","元富-嘉義",0,103,-103
"8463","5410國眾","110/07/13","新光",50,4,46
"8464","5410國眾","110/07/13","凱基-台北",0,50,-50
"8465","5410國眾","110/07/13","國泰-台中",26,0,26
"8466","5410國眾","110/07/13","瑞士信貸",0,31,-31
"8467","5410國眾","110/07/13","新加坡商瑞銀",22,0,22
"8468","5410國眾","110/07/13","台新-新莊",0,27,-27
"8469","5410國眾","110/07/13","光和-嘉義",20,0,20
"8470","5410國眾","110/07/13","元大-汐止",0,20,-20
"8471","5410國眾","110/07/13","凱基-竹北",17,0,17
"8472","5410國眾","110/07/13","亞東-新竹",0,17,-17
"8473","5410國眾","110/07/13","新光-桃園",15,0,15
"8474","5410國眾","110/07/13","元大-南勢角",0,13,-13
"8475","5410國眾","110/07/13","凱基-台東",14,0,14
"8476","5410國眾","110/07/13","台新-台南",0,12,-12
"8477","5410國眾","110/07/13","富邦-竹北",11,0,11
"8478","5410國眾","110/07/13","中國信託",0,11,-11
"8479","5410國眾","110/07/13","元富-同大",10,0,10
"8480","5410國眾","110/07/13","華南永昌",0,11,-11
"8481","5410國眾","110/07/13","國泰-敦南",24,15,9
"8482","5410國眾","110/07/13","臺銀-臺南",0,10,-10
"8483","5410國眾","110/07/13","日盛-內湖",7,0,7
"8484","5410國眾","110/07/13","台灣企銀-民雄",0,10,-10
"8485","5410國眾","110/07/13","台新-左楠",7,0,7
"8486","5410國眾","110/07/13","高橋",0,10,-10
"8487","5410國眾","110/07/13","元大-新盛",18,12,6
"8488","5410國眾","110/07/13","康和-嘉義",0,10,-10
"8489","5410國眾","110/07/13","統一",5,0,5
"8490","5410國眾","110/07/13","凱基-基隆",0,10,-10
"8491","2841台開","110/07/13","中國信託-高雄",251,50,201
"8492","2841台開","110/07/13","兆豐-公益",0,177,-177
"8493","2841台開","110/07/13","日盛證券",210,13,197
"8494","2841台開","110/07/13","日進",0,152,-152
"8495","2841台開","110/07/13","第一金-台中",55,0,55
"8496","2841台開","110/07/13","港商野村",0,109,-109
"8497","2841台開","110/07/13","國泰-板橋",46,0,46
"8498","2841台開","110/07/13","日盛-信義",0,103,-103
"8499","2841台開","110/07/13","國泰-館前",48,3,45
"8500","2841台開","110/07/13","國泰-敦南",11,75,-64
"8501","2841台開","110/07/13","華南永昌-新莊",45,0,45
"8502","2841台開","110/07/13","永興",0,50,-50
"8503","2841台開","110/07/13","日盛-園區",42,0,42
"8504","2841台開","110/07/13","永豐金-敦南",61,104,-43
"8505","2841台開","110/07/13","台新證券",32,0,32
"8506","2841台開","110/07/13","富邦-台南",0,42,-42
"8507","2841台開","110/07/13","台新-高雄",32,2,30
"8508","2841台開","110/07/13","國票-安和",0,30,-30
"8509","2841台開","110/07/13","豐農",23,0,23
"8510","2841台開","110/07/13","元大-桃園",0,25,-25
"8511","2841台開","110/07/13","合庫-嘉義",20,0,20
"8512","2841台開","110/07/13","新光",8,32,-24
"8513","2841台開","110/07/13","華南永昌-高雄",20,0,20
"8514","2841台開","110/07/13","元大-仁愛",0,24,-24
"8515","2841台開","110/07/13","元大-樹林",16,0,16
"8516","2841台開","110/07/13","日盛-中和",0,20,-20
"8517","2841台開","110/07/13","第一金-華江",15,2,13
"8518","2841台開","110/07/13","元富",0,20,-20
"8519","2841台開","110/07/13","美商高盛",12,0,12
"8520","2841台開","110/07/13","富邦-宜蘭",0,20,-20
"8521","6207雷科","110/07/13","元大-高雄",121,0,121
"8522","6207雷科","110/07/13","華南永昌-朴子",1,60,-59
"8523","6207雷科","110/07/13","第一金-新興",20,0,20
"8524","6207雷科","110/07/13","元大-南海",0,36,-36
"8525","6207雷科","110/07/13","元富-三重",20,0,20
"8526","6207雷科","110/07/13","凱基-土城",0,35,-35
"8527","6207雷科","110/07/13","元大-林園",15,0,15
"8528","6207雷科","110/07/13","台灣企銀",0,20,-20
"8529","6207雷科","110/07/13","元大-金華",16,1,15
"8530","6207雷科","110/07/13","群益金鼎-丹鳳",0,20,-20
"8531","6207雷科","110/07/13","日盛證券",10,0,10
"8532","6207雷科","110/07/13","元大-博愛",0,17,-17
"8533","6207雷科","110/07/13","統一-台中",10,0,10
"8534","6207雷科","110/07/13","元大-北港",0,13,-13
"8535","6207雷科","110/07/13","群益金鼎-土城",10,0,10
"8536","6207雷科","110/07/13","新加坡商瑞銀",0,12,-12
"8537","6207雷科","110/07/13","群益金鼎-桃園",10,0,10
"8538","6207雷科","110/07/13","凱基-台北",4,16,-12
"8539","6207雷科","110/07/13","永豐金-新莊",10,0,10
"8540","6207雷科","110/07/13","日茂-埔里",0,11,-11
"8541","6207雷科","110/07/13","永豐金-新店",10,0,10
"8542","6207雷科","110/07/13","元大-莒光",0,11,-11
"8543","6207雷科","110/07/13","元大證券",9,0,9
"8544","6207雷科","110/07/13","統一-新竹",0,10,-10
"8545","6207雷科","110/07/13","日盛-木柵",9,1,8
"8546","6207雷科","110/07/13","元大-西螺",0,10,-10
"8547","6207雷科","110/07/13","兆豐-來福",8,0,8
"8548","6207雷科","110/07/13","康和-台中",0,8,-8
"8549","6207雷科","110/07/13","新光",7,0,7
"8550","6207雷科","110/07/13","兆豐-高雄",0,6,-6
"8551","3679新至陞","110/07/13","永豐金證券",50,0,50
"8552","3679新至陞","110/07/13","摩根大通",2,25,-23
"8553","3679新至陞","110/07/13","國泰-桃園",22,0,22
"8554","3679新至陞","110/07/13","元大-成功",0,22,-22
"8555","3679新至陞","110/07/13","台中銀-員林",11,0,11
"8556","3679新至陞","110/07/13","富邦-板橋",1,19,-18
"8557","3679新至陞","110/07/13","元大-文心興安",8,0,8
"8558","3679新至陞","110/07/13","日盛-新莊",0,10,-10
"8559","3679新至陞","110/07/13","美商高盛",6,0,6
"8560","3679新至陞","110/07/13","台新-台中",0,10,-10
"8561","3679新至陞","110/07/13","台新-高雄",6,0,6
"8562","3679新至陞","110/07/13","永豐金-新竹",0,8,-8
"8563","3679新至陞","110/07/13","凱基-台北",18,12,6
"8564","3679新至陞","110/07/13","瑞士信貸",12,19,-7
"8565","3679新至陞","110/07/13","日盛-復興",5,0,5
"8566","3679新至陞","110/07/13","統一-南京",0,7,-7
"8567","3679新至陞","110/07/13","(牛牛牛)亞-鑫豐",4,0,4
"8568","3679新至陞","110/07/13","凱基-新莊",0,7,-7
"8569","3679新至陞","110/07/13","元富-大昌",3,0,3
"8570","3679新至陞","110/07/13","新加坡商瑞銀",0,6,-6
"8571","3679新至陞","110/07/13","富邦-台北",3,0,3
"8572","3679新至陞","110/07/13","合庫-自強",0,5,-5
"8573","3679新至陞","110/07/13","日盛-樹林",2,0,2
"8574","3679新至陞","110/07/13","富邦-桃園",0,5,-5
"8575","3679新至陞","110/07/13","宏遠-光隆",2,0,2
"8576","3679新至陞","110/07/13","永豐金-潮州",0,4,-4
"8577","3679新至陞","110/07/13","美林",3,1,2
"8578","3679新至陞","110/07/13","臺銀-臺南",0,3,-3
"8579","3679新至陞","110/07/13","第一金-中壢",2,0,2
"8580","3679新至陞","110/07/13","元大-六合",0,3,-3
"8581","2727王品","110/07/13","富邦-台北",43,3,40
"8582","2727王品","110/07/13","台灣摩根士丹利",15,97,-82
"8583","2727王品","110/07/13","元大-基隆孝二",40,0,40
"8584","2727王品","110/07/13","玉山-台南",5,57,-52
"8585","2727王品","110/07/13","國票-新莊",40,1,39
"8586","2727王品","110/07/13","新加坡商瑞銀",0,48,-48
"8587","2727王品","110/07/13","第一金-豐原",66,42,24
"8588","2727王品","110/07/13","凱基-台北",41,77,-36
"8589","2727王品","110/07/13","永豐金-大園",34,10,24
"8590","2727王品","110/07/13","永豐金-永康",0,22,-22
"8591","2727王品","110/07/13","元大-北屯",22,0,22
"8592","2727王品","110/07/13","統一-台中",2,22,-20
"8593","2727王品","110/07/13","元大-東蘆",26,7,19
"8594","2727王品","110/07/13","國泰-台中",21,39,-18
"8595","2727王品","110/07/13","永豐金-萬盛",13,1,12
"8596","2727王品","110/07/13","合庫-彰化",3,20,-17
"8597","2727王品","110/07/13","日盛-嘉義",11,0,11
"8598","2727王品","110/07/13","港商野村",13,30,-17
"8599","2727王品","110/07/13","日盛-八德",11,0,11
"8600","2727王品","110/07/13","元大-楊梅",1,16,-15
"8601","2727王品","110/07/13","統一-竹南",11,0,11
"8602","2727王品","110/07/13","凱基-高美館",2,15,-13
"8603","2727王品","110/07/13","日盛-士林",12,2,10
"8604","2727王品","110/07/13","美商高盛",2,14,-12
"8605","2727王品","110/07/13","統一-敦南",10,0,10
"8606","2727王品","110/07/13","統一-平鎮",1,13,-12
"8607","2727王品","110/07/13","中國信託",15,5,10
"8608","2727王品","110/07/13","兆豐-台中港",4,16,-12
"8609","2727王品","110/07/13","兆豐-竹北",13,3,10
"8610","2727王品","110/07/13","凱基-八德",1,13,-12
"8611","1570力肯","110/07/13","新光",115,11,104
"8612","1570力肯","110/07/13","元大-北三重",0,162,-162
"8613","1570力肯","110/07/13","群益金鼎-高雄",54,0,54
"8614","1570力肯","110/07/13","元大-大灣",0,25,-25
"8615","1570力肯","110/07/13","國票-新莊",22,0,22
"8616","1570力肯","110/07/13","永豐金-苓雅",0,22,-22
"8617","1570力肯","110/07/13","日盛-桃園",12,0,12
"8618","1570力肯","110/07/13","永豐金-永康",0,19,-19
"8619","1570力肯","110/07/13","元大-高雄",12,0,12
"8620","1570力肯","110/07/13","富邦-員林",0,15,-15
"8621","1570力肯","110/07/13","合庫-自強",11,0,11
"8622","1570力肯","110/07/13","凱基-台南",0,11,-11
"8623","1570力肯","110/07/13","摩根大通",26,15,11
"8624","1570力肯","110/07/13","日盛-竹北",0,10,-10
"8625","1570力肯","110/07/13","永豐金-中盛",11,0,11
"8626","1570力肯","110/07/13","國票-九鼎",0,10,-10
"8627","1570力肯","110/07/13","兆豐-台中港",10,0,10
"8628","1570力肯","110/07/13","凱基-桃園",0,10,-10
"8629","1570力肯","110/07/13","國泰-松江",9,0,9
"8630","1570力肯","110/07/13","凱基-新豐",0,10,-10
"8631","1570力肯","110/07/13","元大-新盛",9,0,9
"8632","1570力肯","110/07/13","元大-學甲",0,10,-10
"8633","1570力肯","110/07/13","元富-緯城",6,0,6
"8634","1570力肯","110/07/13","群益金鼎-東湖",1,10,-9
"8635","1570力肯","110/07/13","統一-三重",5,0,5
"8636","1570力肯","110/07/13","大昌",0,6,-6
"8637","1570力肯","110/07/13","元大-前金",5,0,5
"8638","1570力肯","110/07/13","元大-土城學府",0,6,-6
"8639","1570力肯","110/07/13","永豐金證券",5,0,5
"8640","1570力肯","110/07/13","統一",0,5,-5
"8641","6180橘子","110/07/13","摩根大通",119,0,119
"8642","6180橘子","110/07/13","元大-崇德",2,61,-59
"8643","6180橘子","110/07/13","美商高盛",96,0,96
"8644","6180橘子","110/07/13","康和-台中",0,51,-51
"8645","6180橘子","110/07/13","新加坡商瑞銀",86,7,79
"8646","6180橘子","110/07/13","康和-台北",0,50,-50
"8647","6180橘子","110/07/13","元大-和平",40,0,40
"8648","6180橘子","110/07/13","元富-潮州",0,40,-40
"8649","6180橘子","110/07/13","凱基-台北",83,47,36
"8650","6180橘子","110/07/13","日盛-永康",0,26,-26
"8651","6180橘子","110/07/13","美林",39,5,34
"8652","6180橘子","110/07/13","永豐金-中正",0,24,-24
"8653","6180橘子","110/07/13","富邦-新竹華信",31,2,29
"8654","6180橘子","110/07/13","國泰-板橋",2,25,-23
"8655","6180橘子","110/07/13","統一-南京",21,0,21
"8656","6180橘子","110/07/13","日盛-大墩",0,20,-20
"8657","6180橘子","110/07/13","富邦-陽明",24,3,21
"8658","6180橘子","110/07/13","元大-草屯",13,32,-19
"8659","6180橘子","110/07/13","大昌-樹林",21,1,20
"8660","6180橘子","110/07/13","元富-林園",1,18,-17
"8661","6180橘子","110/07/13","花旗環球",19,0,19
"8662","6180橘子","110/07/13","新光-新竹",1,18,-17
"8663","6180橘子","110/07/13","華南永昌-台南",19,0,19
"8664","6180橘子","110/07/13","元大-土城永寧",0,17,-17
"8665","6180橘子","110/07/13","福勝",14,0,14
"8666","6180橘子","110/07/13","國泰-新莊",3,19,-16
"8667","6180橘子","110/07/13","富邦-嘉義",12,1,11
"8668","6180橘子","110/07/13","中國信託-永康",6,21,-15
"8669","6180橘子","110/07/13","元大-板橋三民",11,0,11
"8670","6180橘子","110/07/13","凱基-東港",1,15,-14
"8671","2390云辰","110/07/13","新加坡商瑞銀",562,75,487
"8672","2390云辰","110/07/13","大展-台南",0,532,-532
"8673","2390云辰","110/07/13","台灣摩根士丹利",330,155,175
"8674","2390云辰","110/07/13","凱基-台北",668,854,-186
"8675","2390云辰","110/07/13","兆豐-公益",126,25,101
"8676","2390云辰","110/07/13","凱基-三重",12,172,-160
"8677","2390云辰","110/07/13","元富-中港",100,2,98
"8678","2390云辰","110/07/13","兆豐-忠孝",4,161,-157
"8679","2390云辰","110/07/13","統一-新台中",106,9,97
"8680","2390云辰","110/07/13","元大-士林",19,170,-151
"8681","2390云辰","110/07/13","中國信託-松江",81,11,70
"8682","2390云辰","110/07/13","臺銀-新竹",14,117,-103
"8683","2390云辰","110/07/13","日盛-板橋",72,3,69
"8684","2390云辰","110/07/13","國票-台中",4,102,-98
"8685","2390云辰","110/07/13","日盛-和美",57,0,57
"8686","2390云辰","110/07/13","新光",147,232,-85
"8687","2390云辰","110/07/13","永豐金-桃園",88,36,52
"8688","2390云辰","110/07/13","致和-崇德",2,70,-68
"8689","2390云辰","110/07/13","玉山-士林",54,4,50
"8690","2390云辰","110/07/13","群益金鼎-屏東",2,70,-68
"8691","2390云辰","110/07/13","富邦-仁愛",56,6,50
"8692","2390云辰","110/07/13","元大-大里",35,98,-63
"8693","2390云辰","110/07/13","第一金-豐原",50,1,49
"8694","2390云辰","110/07/13","元大-萬華",35,94,-59
"8695","2390云辰","110/07/13","摩根大通",502,453,49
"8696","2390云辰","110/07/13","元富-吉利",2,60,-58
"8697","2390云辰","110/07/13","凱基-松山",61,13,48
"8698","2390云辰","110/07/13","兆豐-新竹",3,53,-50
"8699","2390云辰","110/07/13","大昌",64,22,42
"8700","2390云辰","110/07/13","富邦-嘉義",65,108,-43
"8701","2363矽統","110/07/13","凱基-南崁",2133,63,2070
"8702","2363矽統","110/07/13","凱基-幸福",36,4048,-4012
"8703","2363矽統","110/07/13","國泰-敦南",2195,1617,578
"8704","2363矽統","110/07/13","統一",192,3325,-3133
"8705","2363矽統","110/07/13","中農",670,139,531
"8706","2363矽統","110/07/13","新加坡商瑞銀",1000,2747,-1747
"8707","2363矽統","110/07/13","康和-台中",638,154,484
"8708","2363矽統","110/07/13","凱基-台北",5359,6609,-1250
"8709","2363矽統","110/07/13","群益金鼎-三民",577,137,440
"8710","2363矽統","110/07/13","摩根大通",1930,2858,-928
"8711","2363矽統","110/07/13","台新-屏東",510,88,422
"8712","2363矽統","110/07/13","港商野村",960,1679,-719
"8713","2363矽統","110/07/13","德信-中正",455,67,388
"8714","2363矽統","110/07/13","兆豐-復興",25,705,-680
"8715","2363矽統","110/07/13","日盛-竹北",365,70,295
"8716","2363矽統","110/07/13","統一-仁愛",114,755,-641
"8717","2363矽統","110/07/13","元大-佳里",452,189,263
"8718","2363矽統","110/07/13","統一-敦南",29,638,-609
"8719","2363矽統","110/07/13","國票-博愛",296,38,258
"8720","2363矽統","110/07/13","統一-土城",100,704,-604
"8721","2363矽統","110/07/13","元大-萬華",340,95,245
"8722","2363矽統","110/07/13","統一-城中",116,676,-560
"8723","2363矽統","110/07/13","新光",1259,1031,228
"8724","2363矽統","110/07/13","永豐金證券",306,859,-553
"8725","2363矽統","110/07/13","元富-成功",323,96,227
"8726","2363矽統","110/07/13","元富",54,567,-513
"8727","2363矽統","110/07/13","豐農",228,23,205
"8728","2363矽統","110/07/13","瑞士信貸",202,666,-464
"8729","2363矽統","110/07/13","台灣企銀-岡山",186,4,182
"8730","2363矽統","110/07/13","永豐金-嘉義",67,468,-401
"8731","8112至上","110/07/13","摩根大通",688,296,392
"8732","8112至上","110/07/13","國票-中和",0,401,-401
"8733","8112至上","110/07/13","港商野村",344,145,199
"8734","8112至上","110/07/13","永豐金-板盛",0,205,-205
"8735","8112至上","110/07/13","兆豐-公益",195,5,190
"8736","8112至上","110/07/13","凱基-五股",43,155,-112
"8737","8112至上","110/07/13","台灣摩根士丹利",183,0,183
"8738","8112至上","110/07/13","凱基-市政",0,100,-100
"8739","8112至上","110/07/13","群益金鼎-敦南",153,2,151
"8740","8112至上","110/07/13","元大-大里德芳",1,92,-91
"8741","8112至上","110/07/13","臺銀-金山",146,26,120
"8742","8112至上","110/07/13","玉山-桃園",26,110,-84
"8743","8112至上","110/07/13","臺銀",133,19,114
"8744","8112至上","110/07/13","兆豐-天母",0,81,-81
"8745","8112至上","110/07/13","合庫-台中",115,6,109
"8746","8112至上","110/07/13","凱基-城中",3,84,-81
"8747","8112至上","110/07/13","亞東-板橋",134,26,108
"8748","8112至上","110/07/13","日盛-新莊",9,85,-76
"8749","8112至上","110/07/13","凱基-台北",414,326,88
"8750","8112至上","110/07/13","日盛-台中",2,64,-62
"8751","8112至上","110/07/13","新加坡商瑞銀",181,100,81
"8752","8112至上","110/07/13","日盛-中壢",3,64,-61
"8753","8112至上","110/07/13","國泰-敦南",108,31,77
"8754","8112至上","110/07/13","元大-台中",2,59,-57
"8755","8112至上","110/07/13","第一金-華江",77,4,73
"8756","8112至上","110/07/13","元大-雙和",7,64,-57
"8757","8112至上","110/07/13","永豐金-內湖",73,1,72
"8758","8112至上","110/07/13","元大-高雄",8,62,-54
"8759","8112至上","110/07/13","元大-永和",68,1,67
"8760","8112至上","110/07/13","元大-館前",2,55,-53
"8761","4903聯光通","110/07/13","台灣企銀-太平",56,0,56
"8762","4903聯光通","110/07/13","土銀",0,32,-32
"8763","4903聯光通","110/07/13","元富-新興",23,0,23
"8764","4903聯光通","110/07/13","元大-樹林",0,19,-19
"8765","4903聯光通","110/07/13","日盛-樹林",22,0,22
"8766","4903聯光通","110/07/13","凱基-士林",0,17,-17
"8767","4903聯光通","110/07/13","兆豐-天母",20,0,20
"8768","4903聯光通","110/07/13","國票-博愛",0,14,-14
"8769","4903聯光通","110/07/13","華南永昌-桃園",20,0,20
"8770","4903聯光通","110/07/13","元富",0,10,-10
"8771","4903聯光通","110/07/13","富邦-新店",10,0,10
"8772","4903聯光通","110/07/13","新光",0,10,-10
"8773","4903聯光通","110/07/13","新光-台中",5,0,5
"8774","4903聯光通","110/07/13","玉山-南京東路",0,10,-10
"8775","4903聯光通","110/07/13","華南永昌-台中",5,0,5
"8776","4903聯光通","110/07/13","富邦-陽明",0,10,-10
"8777","4903聯光通","110/07/13","元大-崇德",5,0,5
"8778","4903聯光通","110/07/13","元大-大甲",0,8,-8
"8779","4903聯光通","110/07/13","元大-草屯",5,0,5
"8780","4903聯光通","110/07/13","富邦-台中",0,7,-7
"8781","4903聯光通","110/07/13","元富-草屯",4,0,4
"8782","4903聯光通","110/07/13","凱基-中壢",0,6,-6
"8783","4903聯光通","110/07/13","元大-清水",4,0,4
"8784","4903聯光通","110/07/13","臺銀-民權",0,5,-5
"8785","4903聯光通","110/07/13","元大-東泰",4,0,4
"8786","4903聯光通","110/07/13","日盛-板橋",0,5,-5
"8787","4903聯光通","110/07/13","元大-佳里",2,0,2
"8788","4903聯光通","110/07/13","中國信託-忠孝",0,5,-5
"8789","4903聯光通","110/07/13","永豐金-板橋",2,0,2
"8790","4903聯光通","110/07/13","永豐金-鳳山",0,5,-5
"8791","2929淘帝","110/07/13","玉山-新竹",130,0,130
"8792","2929淘帝","110/07/13","美商高盛",0,177,-177
"8793","2929淘帝","110/07/13","臺銀-民權",60,0,60
"8794","2929淘帝","110/07/13","凱基-台北",6,80,-74
"8795","2929淘帝","110/07/13","新百王",31,0,31
"8796","2929淘帝","110/07/13","元富-大裕",0,49,-49
"8797","2929淘帝","110/07/13","日盛-園區",30,0,30
"8798","2929淘帝","110/07/13","國泰-館前",3,51,-48
"8799","2929淘帝","110/07/13","元大-南投",31,1,30
"8800","2929淘帝","110/07/13","凱基-中壢",0,41,-41
"8801","2929淘帝","110/07/13","兆豐-忠孝",28,0,28
"8802","2929淘帝","110/07/13","港商野村",21,55,-34
"8803","2929淘帝","110/07/13","元大-民生",28,0,28
"8804","2929淘帝","110/07/13","華南永昌-南京",2,34,-32
"8805","2929淘帝","110/07/13","合庫-高雄",27,0,27
"8806","2929淘帝","110/07/13","群益金鼎-土城",0,30,-30
"8807","2929淘帝","110/07/13","凱基-豐中",27,0,27
"8808","2929淘帝","110/07/13","富邦-南屯",0,22,-22
"8809","2929淘帝","110/07/13","新光",21,4,17
"8810","2929淘帝","110/07/13","第一金-豐原",0,20,-20
"8811","2929淘帝","110/07/13","元大-天母",17,0,17
"8812","2929淘帝","110/07/13","元大-屏南",6,26,-20
"8813","2929淘帝","110/07/13","永興",14,0,14
"8814","2929淘帝","110/07/13","永豐金-敦南",1,21,-20
"8815","2929淘帝","110/07/13","富邦-台北",12,0,12
"8816","2929淘帝","110/07/13","凱基-三重",2,21,-19
"8817","2929淘帝","110/07/13","元大-永和",12,0,12
"8818","2929淘帝","110/07/13","富邦-仁愛",7,25,-18
"8819","2929淘帝","110/07/13","國票-天祥",11,0,11
"8820","2929淘帝","110/07/13","元大-北投",0,16,-16
"8821","5410國眾","110/07/13","兆豐-城中",274,0,274
"8822","5410國眾","110/07/13","元富-嘉義",0,103,-103
"8823","5410國眾","110/07/13","新光",50,4,46
"8824","5410國眾","110/07/13","凱基-台北",0,50,-50
"8825","5410國眾","110/07/13","國泰-台中",26,0,26
"8826","5410國眾","110/07/13","瑞士信貸",0,31,-31
"8827","5410國眾","110/07/13","新加坡商瑞銀",22,0,22
"8828","5410國眾","110/07/13","台新-新莊",0,27,-27
"8829","5410國眾","110/07/13","光和-嘉義",20,0,20
"8830","5410國眾","110/07/13","元大-汐止",0,20,-20
"8831","5410國眾","110/07/13","凱基-竹北",17,0,17
"8832","5410國眾","110/07/13","亞東-新竹",0,17,-17
"8833","5410國眾","110/07/13","新光-桃園",15,0,15
"8834","5410國眾","110/07/13","元大-南勢角",0,13,-13
"8835","5410國眾","110/07/13","凱基-台東",14,0,14
"8836","5410國眾","110/07/13","台新-台南",0,12,-12
"8837","5410國眾","110/07/13","富邦-竹北",11,0,11
"8838","5410國眾","110/07/13","中國信託",0,11,-11
"8839","5410國眾","110/07/13","元富-同大",10,0,10
"8840","5410國眾","110/07/13","華南永昌",0,11,-11
"8841","5410國眾","110/07/13","國泰-敦南",24,15,9
"8842","5410國眾","110/07/13","臺銀-臺南",0,10,-10
"8843","5410國眾","110/07/13","日盛-內湖",7,0,7
"8844","5410國眾","110/07/13","台灣企銀-民雄",0,10,-10
"8845","5410國眾","110/07/13","台新-左楠",7,0,7
"8846","5410國眾","110/07/13","高橋",0,10,-10
"8847","5410國眾","110/07/13","元大-新盛",18,12,6
"8848","5410國眾","110/07/13","康和-嘉義",0,10,-10
"8849","5410國眾","110/07/13","統一",5,0,5
"8850","5410國眾","110/07/13","凱基-基隆",0,10,-10
"8851","2841台開","110/07/13","中國信託-高雄",251,50,201
"8852","2841台開","110/07/13","兆豐-公益",0,177,-177
"8853","2841台開","110/07/13","日盛證券",210,13,197
"8854","2841台開","110/07/13","日進",0,152,-152
"8855","2841台開","110/07/13","第一金-台中",55,0,55
"8856","2841台開","110/07/13","港商野村",0,109,-109
"8857","2841台開","110/07/13","國泰-板橋",46,0,46
"8858","2841台開","110/07/13","日盛-信義",0,103,-103
"8859","2841台開","110/07/13","國泰-館前",48,3,45
"8860","2841台開","110/07/13","國泰-敦南",11,75,-64
"8861","2841台開","110/07/13","華南永昌-新莊",45,0,45
"8862","2841台開","110/07/13","永興",0,50,-50
"8863","2841台開","110/07/13","日盛-園區",42,0,42
"8864","2841台開","110/07/13","永豐金-敦南",61,104,-43
"8865","2841台開","110/07/13","台新證券",32,0,32
"8866","2841台開","110/07/13","富邦-台南",0,42,-42
"8867","2841台開","110/07/13","台新-高雄",32,2,30
"8868","2841台開","110/07/13","國票-安和",0,30,-30
"8869","2841台開","110/07/13","豐農",23,0,23
"8870","2841台開","110/07/13","元大-桃園",0,25,-25
"8871","2841台開","110/07/13","合庫-嘉義",20,0,20
"8872","2841台開","110/07/13","新光",8,32,-24
"8873","2841台開","110/07/13","華南永昌-高雄",20,0,20
"8874","2841台開","110/07/13","元大-仁愛",0,24,-24
"8875","2841台開","110/07/13","元大-樹林",16,0,16
"8876","2841台開","110/07/13","日盛-中和",0,20,-20
"8877","2841台開","110/07/13","第一金-華江",15,2,13
"8878","2841台開","110/07/13","元富",0,20,-20
"8879","2841台開","110/07/13","美商高盛",12,0,12
"8880","2841台開","110/07/13","富邦-宜蘭",0,20,-20
"8881","6207雷科","110/07/13","元大-高雄",121,0,121
"8882","6207雷科","110/07/13","華南永昌-朴子",1,60,-59
"8883","6207雷科","110/07/13","第一金-新興",20,0,20
"8884","6207雷科","110/07/13","元大-南海",0,36,-36
"8885","6207雷科","110/07/13","元富-三重",20,0,20
"8886","6207雷科","110/07/13","凱基-土城",0,35,-35
"8887","6207雷科","110/07/13","元大-林園",15,0,15
"8888","6207雷科","110/07/13","台灣企銀",0,20,-20
"8889","6207雷科","110/07/13","元大-金華",16,1,15
"8890","6207雷科","110/07/13","群益金鼎-丹鳳",0,20,-20
"8891","6207雷科","110/07/13","日盛證券",10,0,10
"8892","6207雷科","110/07/13","元大-博愛",0,17,-17
"8893","6207雷科","110/07/13","統一-台中",10,0,10
"8894","6207雷科","110/07/13","元大-北港",0,13,-13
"8895","6207雷科","110/07/13","群益金鼎-土城",10,0,10
"8896","6207雷科","110/07/13","新加坡商瑞銀",0,12,-12
"8897","6207雷科","110/07/13","群益金鼎-桃園",10,0,10
"8898","6207雷科","110/07/13","凱基-台北",4,16,-12
"8899","6207雷科","110/07/13","永豐金-新莊",10,0,10
"8900","6207雷科","110/07/13","日茂-埔里",0,11,-11
"8901","6207雷科","110/07/13","永豐金-新店",10,0,10
"8902","6207雷科","110/07/13","元大-莒光",0,11,-11
"8903","6207雷科","110/07/13","元大證券",9,0,9
"8904","6207雷科","110/07/13","統一-新竹",0,10,-10
"8905","6207雷科","110/07/13","日盛-木柵",9,1,8
"8906","6207雷科","110/07/13","元大-西螺",0,10,-10
"8907","6207雷科","110/07/13","兆豐-來福",8,0,8
"8908","6207雷科","110/07/13","康和-台中",0,8,-8
"8909","6207雷科","110/07/13","新光",7,0,7
"8910","6207雷科","110/07/13","兆豐-高雄",0,6,-6
"8911","3679新至陞","110/07/13","永豐金證券",50,0,50
"8912","3679新至陞","110/07/13","摩根大通",2,25,-23
"8913","3679新至陞","110/07/13","國泰-桃園",22,0,22
"8914","3679新至陞","110/07/13","元大-成功",0,22,-22
"8915","3679新至陞","110/07/13","台中銀-員林",11,0,11
"8916","3679新至陞","110/07/13","富邦-板橋",1,19,-18
"8917","3679新至陞","110/07/13","元大-文心興安",8,0,8
"8918","3679新至陞","110/07/13","日盛-新莊",0,10,-10
"8919","3679新至陞","110/07/13","美商高盛",6,0,6
"8920","3679新至陞","110/07/13","台新-台中",0,10,-10
"8921","3679新至陞","110/07/13","台新-高雄",6,0,6
"8922","3679新至陞","110/07/13","永豐金-新竹",0,8,-8
"8923","3679新至陞","110/07/13","凱基-台北",18,12,6
"8924","3679新至陞","110/07/13","瑞士信貸",12,19,-7
"8925","3679新至陞","110/07/13","日盛-復興",5,0,5
"8926","3679新至陞","110/07/13","統一-南京",0,7,-7
"8927","3679新至陞","110/07/13","(牛牛牛)亞-鑫豐",4,0,4
"8928","3679新至陞","110/07/13","凱基-新莊",0,7,-7
"8929","3679新至陞","110/07/13","元富-大昌",3,0,3
"8930","3679新至陞","110/07/13","新加坡商瑞銀",0,6,-6
"8931","3679新至陞","110/07/13","富邦-台北",3,0,3
"8932","3679新至陞","110/07/13","合庫-自強",0,5,-5
"8933","3679新至陞","110/07/13","日盛-樹林",2,0,2
"8934","3679新至陞","110/07/13","富邦-桃園",0,5,-5
"8935","3679新至陞","110/07/13","宏遠-光隆",2,0,2
"8936","3679新至陞","110/07/13","永豐金-潮州",0,4,-4
"8937","3679新至陞","110/07/13","美林",3,1,2
"8938","3679新至陞","110/07/13","臺銀-臺南",0,3,-3
"8939","3679新至陞","110/07/13","第一金-中壢",2,0,2
"8940","3679新至陞","110/07/13","元大-六合",0,3,-3
"8941","2727王品","110/07/13","富邦-台北",43,3,40
"8942","2727王品","110/07/13","台灣摩根士丹利",15,97,-82
"8943","2727王品","110/07/13","元大-基隆孝二",40,0,40
"8944","2727王品","110/07/13","玉山-台南",5,57,-52
"8945","2727王品","110/07/13","國票-新莊",40,1,39
"8946","2727王品","110/07/13","新加坡商瑞銀",0,48,-48
"8947","2727王品","110/07/13","第一金-豐原",66,42,24
"8948","2727王品","110/07/13","凱基-台北",41,77,-36
"8949","2727王品","110/07/13","永豐金-大園",34,10,24
"8950","2727王品","110/07/13","永豐金-永康",0,22,-22
"8951","2727王品","110/07/13","元大-北屯",22,0,22
"8952","2727王品","110/07/13","統一-台中",2,22,-20
"8953","2727王品","110/07/13","元大-東蘆",26,7,19
"8954","2727王品","110/07/13","國泰-台中",21,39,-18
"8955","2727王品","110/07/13","永豐金-萬盛",13,1,12
"8956","2727王品","110/07/13","合庫-彰化",3,20,-17
"8957","2727王品","110/07/13","日盛-嘉義",11,0,11
"8958","2727王品","110/07/13","港商野村",13,30,-17
"8959","2727王品","110/07/13","日盛-八德",11,0,11
"8960","2727王品","110/07/13","元大-楊梅",1,16,-15
"8961","2727王品","110/07/13","統一-竹南",11,0,11
"8962","2727王品","110/07/13","凱基-高美館",2,15,-13
"8963","2727王品","110/07/13","日盛-士林",12,2,10
"8964","2727王品","110/07/13","美商高盛",2,14,-12
"8965","2727王品","110/07/13","統一-敦南",10,0,10
"8966","2727王品","110/07/13","統一-平鎮",1,13,-12
"8967","2727王品","110/07/13","中國信託",15,5,10
"8968","2727王品","110/07/13","兆豐-台中港",4,16,-12
"8969","2727王品","110/07/13","兆豐-竹北",13,3,10
"8970","2727王品","110/07/13","凱基-八德",1,13,-12
"8971","1570力肯","110/07/13","新光",115,11,104
"8972","1570力肯","110/07/13","元大-北三重",0,162,-162
"8973","1570力肯","110/07/13","群益金鼎-高雄",54,0,54
"8974","1570力肯","110/07/13","元大-大灣",0,25,-25
"8975","1570力肯","110/07/13","國票-新莊",22,0,22
"8976","1570力肯","110/07/13","永豐金-苓雅",0,22,-22
"8977","1570力肯","110/07/13","日盛-桃園",12,0,12
"8978","1570力肯","110/07/13","永豐金-永康",0,19,-19
"8979","1570力肯","110/07/13","元大-高雄",12,0,12
"8980","1570力肯","110/07/13","富邦-員林",0,15,-15
"8981","1570力肯","110/07/13","合庫-自強",11,0,11
"8982","1570力肯","110/07/13","凱基-台南",0,11,-11
"8983","1570力肯","110/07/13","摩根大通",26,15,11
"8984","1570力肯","110/07/13","日盛-竹北",0,10,-10
"8985","1570力肯","110/07/13","永豐金-中盛",11,0,11
"8986","1570力肯","110/07/13","國票-九鼎",0,10,-10
"8987","1570力肯","110/07/13","兆豐-台中港",10,0,10
"8988","1570力肯","110/07/13","凱基-桃園",0,10,-10
"8989","1570力肯","110/07/13","國泰-松江",9,0,9
"8990","1570力肯","110/07/13","凱基-新豐",0,10,-10
"8991","1570力肯","110/07/13","元大-新盛",9,0,9
"8992","1570力肯","110/07/13","元大-學甲",0,10,-10
"8993","1570力肯","110/07/13","元富-緯城",6,0,6
"8994","1570力肯","110/07/13","群益金鼎-東湖",1,10,-9
"8995","1570力肯","110/07/13","統一-三重",5,0,5
"8996","1570力肯","110/07/13","大昌",0,6,-6
"8997","1570力肯","110/07/13","元大-前金",5,0,5
"8998","1570力肯","110/07/13","元大-土城學府",0,6,-6
"8999","1570力肯","110/07/13","永豐金證券",5,0,5
"9000","1570力肯","110/07/13","統一",0,5,-5
"9001","6180橘子","110/07/13","摩根大通",119,0,119
"9002","6180橘子","110/07/13","元大-崇德",2,61,-59
"9003","6180橘子","110/07/13","美商高盛",96,0,96
"9004","6180橘子","110/07/13","康和-台中",0,51,-51
"9005","6180橘子","110/07/13","新加坡商瑞銀",86,7,79
"9006","6180橘子","110/07/13","康和-台北",0,50,-50
"9007","6180橘子","110/07/13","元大-和平",40,0,40
"9008","6180橘子","110/07/13","元富-潮州",0,40,-40
"9009","6180橘子","110/07/13","凱基-台北",83,47,36
"9010","6180橘子","110/07/13","日盛-永康",0,26,-26
"9011","6180橘子","110/07/13","美林",39,5,34
"9012","6180橘子","110/07/13","永豐金-中正",0,24,-24
"9013","6180橘子","110/07/13","富邦-新竹華信",31,2,29
"9014","6180橘子","110/07/13","國泰-板橋",2,25,-23
"9015","6180橘子","110/07/13","統一-南京",21,0,21
"9016","6180橘子","110/07/13","日盛-大墩",0,20,-20
"9017","6180橘子","110/07/13","富邦-陽明",24,3,21
"9018","6180橘子","110/07/13","元大-草屯",13,32,-19
"9019","6180橘子","110/07/13","大昌-樹林",21,1,20
"9020","6180橘子","110/07/13","元富-林園",1,18,-17
"9021","6180橘子","110/07/13","花旗環球",19,0,19
"9022","6180橘子","110/07/13","新光-新竹",1,18,-17
"9023","6180橘子","110/07/13","華南永昌-台南",19,0,19
"9024","6180橘子","110/07/13","元大-土城永寧",0,17,-17
"9025","6180橘子","110/07/13","福勝",14,0,14
"9026","6180橘子","110/07/13","國泰-新莊",3,19,-16
"9027","6180橘子","110/07/13","富邦-嘉義",12,1,11
"9028","6180橘子","110/07/13","中國信託-永康",6,21,-15
"9029","6180橘子","110/07/13","元大-板橋三民",11,0,11
"9030","6180橘子","110/07/13","凱基-東港",1,15,-14
"9031","2390云辰","110/07/13","新加坡商瑞銀",562,75,487
"9032","2390云辰","110/07/13","大展-台南",0,532,-532
"9033","2390云辰","110/07/13","台灣摩根士丹利",330,155,175
"9034","2390云辰","110/07/13","凱基-台北",668,854,-186
"9035","2390云辰","110/07/13","兆豐-公益",126,25,101
"9036","2390云辰","110/07/13","凱基-三重",12,172,-160
"9037","2390云辰","110/07/13","元富-中港",100,2,98
"9038","2390云辰","110/07/13","兆豐-忠孝",4,161,-157
"9039","2390云辰","110/07/13","統一-新台中",106,9,97
"9040","2390云辰","110/07/13","元大-士林",19,170,-151
"9041","2390云辰","110/07/13","中國信託-松江",81,11,70
"9042","2390云辰","110/07/13","臺銀-新竹",14,117,-103
"9043","2390云辰","110/07/13","日盛-板橋",72,3,69
"9044","2390云辰","110/07/13","國票-台中",4,102,-98
"9045","2390云辰","110/07/13","日盛-和美",57,0,57
"9046","2390云辰","110/07/13","新光",147,232,-85
"9047","2390云辰","110/07/13","永豐金-桃園",88,36,52
"9048","2390云辰","110/07/13","致和-崇德",2,70,-68
"9049","2390云辰","110/07/13","玉山-士林",54,4,50
"9050","2390云辰","110/07/13","群益金鼎-屏東",2,70,-68
"9051","2390云辰","110/07/13","富邦-仁愛",56,6,50
"9052","2390云辰","110/07/13","元大-大里",35,98,-63
"9053","2390云辰","110/07/13","第一金-豐原",50,1,49
"9054","2390云辰","110/07/13","元大-萬華",35,94,-59
"9055","2390云辰","110/07/13","摩根大通",502,453,49
"9056","2390云辰","110/07/13","元富-吉利",2,60,-58
"9057","2390云辰","110/07/13","凱基-松山",61,13,48
"9058","2390云辰","110/07/13","兆豐-新竹",3,53,-50
"9059","2390云辰","110/07/13","大昌",64,22,42
"9060","2390云辰","110/07/13","富邦-嘉義",65,108,-43
"9061","2363矽統","110/07/13","凱基-南崁",2133,63,2070
"9062","2363矽統","110/07/13","凱基-幸福",36,4048,-4012
"9063","2363矽統","110/07/13","國泰-敦南",2195,1617,578
"9064","2363矽統","110/07/13","統一",192,3325,-3133
"9065","2363矽統","110/07/13","中農",670,139,531
"9066","2363矽統","110/07/13","新加坡商瑞銀",1000,2747,-1747
"9067","2363矽統","110/07/13","康和-台中",638,154,484
"9068","2363矽統","110/07/13","凱基-台北",5359,6609,-1250
"9069","2363矽統","110/07/13","群益金鼎-三民",577,137,440
"9070","2363矽統","110/07/13","摩根大通",1930,2858,-928
"9071","2363矽統","110/07/13","台新-屏東",510,88,422
"9072","2363矽統","110/07/13","港商野村",960,1679,-719
"9073","2363矽統","110/07/13","德信-中正",455,67,388
"9074","2363矽統","110/07/13","兆豐-復興",25,705,-680
"9075","2363矽統","110/07/13","日盛-竹北",365,70,295
"9076","2363矽統","110/07/13","統一-仁愛",114,755,-641
"9077","2363矽統","110/07/13","元大-佳里",452,189,263
"9078","2363矽統","110/07/13","統一-敦南",29,638,-609
"9079","2363矽統","110/07/13","國票-博愛",296,38,258
"9080","2363矽統","110/07/13","統一-土城",100,704,-604
"9081","2363矽統","110/07/13","元大-萬華",340,95,245
"9082","2363矽統","110/07/13","統一-城中",116,676,-560
"9083","2363矽統","110/07/13","新光",1259,1031,228
"9084","2363矽統","110/07/13","永豐金證券",306,859,-553
"9085","2363矽統","110/07/13","元富-成功",323,96,227
"9086","2363矽統","110/07/13","元富",54,567,-513
"9087","2363矽統","110/07/13","豐農",228,23,205
"9088","2363矽統","110/07/13","瑞士信貸",202,666,-464
"9089","2363矽統","110/07/13","台灣企銀-岡山",186,4,182
"9090","2363矽統","110/07/13","永豐金-嘉義",67,468,-401
"9091","8112至上","110/07/13","摩根大通",688,296,392
"9092","8112至上","110/07/13","國票-中和",0,401,-401
"9093","8112至上","110/07/13","港商野村",344,145,199
"9094","8112至上","110/07/13","永豐金-板盛",0,205,-205
"9095","8112至上","110/07/13","兆豐-公益",195,5,190
"9096","8112至上","110/07/13","凱基-五股",43,155,-112
"9097","8112至上","110/07/13","台灣摩根士丹利",183,0,183
"9098","8112至上","110/07/13","凱基-市政",0,100,-100
"9099","8112至上","110/07/13","群益金鼎-敦南",153,2,151
"9100","8112至上","110/07/13","元大-大里德芳",1,92,-91
"9101","8112至上","110/07/13","臺銀-金山",146,26,120
"9102","8112至上","110/07/13","玉山-桃園",26,110,-84
"9103","8112至上","110/07/13","臺銀",133,19,114
"9104","8112至上","110/07/13","兆豐-天母",0,81,-81
"9105","8112至上","110/07/13","合庫-台中",115,6,109
"9106","8112至上","110/07/13","凱基-城中",3,84,-81
"9107","8112至上","110/07/13","亞東-板橋",134,26,108
"9108","8112至上","110/07/13","日盛-新莊",9,85,-76
"9109","8112至上","110/07/13","凱基-台北",414,326,88
"9110","8112至上","110/07/13","日盛-台中",2,64,-62
"9111","8112至上","110/07/13","新加坡商瑞銀",181,100,81
"9112","8112至上","110/07/13","日盛-中壢",3,64,-61
"9113","8112至上","110/07/13","國泰-敦南",108,31,77
"9114","8112至上","110/07/13","元大-台中",2,59,-57
"9115","8112至上","110/07/13","第一金-華江",77,4,73
"9116","8112至上","110/07/13","元大-雙和",7,64,-57
"9117","8112至上","110/07/13","永豐金-內湖",73,1,72
"9118","8112至上","110/07/13","元大-高雄",8,62,-54
"9119","8112至上","110/07/13","元大-永和",68,1,67
"9120","8112至上","110/07/13","元大-館前",2,55,-53
"9121","4903聯光通","110/07/13","台灣企銀-太平",56,0,56
"9122","4903聯光通","110/07/13","土銀",0,32,-32
"9123","4903聯光通","110/07/13","元富-新興",23,0,23
"9124","4903聯光通","110/07/13","元大-樹林",0,19,-19
"9125","4903聯光通","110/07/13","日盛-樹林",22,0,22
"9126","4903聯光通","110/07/13","凱基-士林",0,17,-17
"9127","4903聯光通","110/07/13","兆豐-天母",20,0,20
"9128","4903聯光通","110/07/13","國票-博愛",0,14,-14
"9129","4903聯光通","110/07/13","華南永昌-桃園",20,0,20
"9130","4903聯光通","110/07/13","元富",0,10,-10
"9131","4903聯光通","110/07/13","富邦-新店",10,0,10
"9132","4903聯光通","110/07/13","新光",0,10,-10
"9133","4903聯光通","110/07/13","新光-台中",5,0,5
"9134","4903聯光通","110/07/13","玉山-南京東路",0,10,-10
"9135","4903聯光通","110/07/13","華南永昌-台中",5,0,5
"9136","4903聯光通","110/07/13","富邦-陽明",0,10,-10
"9137","4903聯光通","110/07/13","元大-崇德",5,0,5
"9138","4903聯光通","110/07/13","元大-大甲",0,8,-8
"9139","4903聯光通","110/07/13","元大-草屯",5,0,5
"9140","4903聯光通","110/07/13","富邦-台中",0,7,-7
"9141","4903聯光通","110/07/13","元富-草屯",4,0,4
"9142","4903聯光通","110/07/13","凱基-中壢",0,6,-6
"9143","4903聯光通","110/07/13","元大-清水",4,0,4
"9144","4903聯光通","110/07/13","臺銀-民權",0,5,-5
"9145","4903聯光通","110/07/13","元大-東泰",4,0,4
"9146","4903聯光通","110/07/13","日盛-板橋",0,5,-5
"9147","4903聯光通","110/07/13","元大-佳里",2,0,2
"9148","4903聯光通","110/07/13","中國信託-忠孝",0,5,-5
"9149","4903聯光通","110/07/13","永豐金-板橋",2,0,2
"9150","4903聯光通","110/07/13","永豐金-鳳山",0,5,-5
"9151","2929淘帝","110/07/13","玉山-新竹",130,0,130
"9152","2929淘帝","110/07/13","美商高盛",0,177,-177
"9153","2929淘帝","110/07/13","臺銀-民權",60,0,60
"9154","2929淘帝","110/07/13","凱基-台北",6,80,-74
"9155","2929淘帝","110/07/13","新百王",31,0,31
"9156","2929淘帝","110/07/13","元富-大裕",0,49,-49
"9157","2929淘帝","110/07/13","日盛-園區",30,0,30
"9158","2929淘帝","110/07/13","國泰-館前",3,51,-48
"9159","2929淘帝","110/07/13","元大-南投",31,1,30
"9160","2929淘帝","110/07/13","凱基-中壢",0,41,-41
"9161","2929淘帝","110/07/13","兆豐-忠孝",28,0,28
"9162","2929淘帝","110/07/13","港商野村",21,55,-34
"9163","2929淘帝","110/07/13","元大-民生",28,0,28
"9164","2929淘帝","110/07/13","華南永昌-南京",2,34,-32
"9165","2929淘帝","110/07/13","合庫-高雄",27,0,27
"9166","2929淘帝","110/07/13","群益金鼎-土城",0,30,-30
"9167","2929淘帝","110/07/13","凱基-豐中",27,0,27
"9168","2929淘帝","110/07/13","富邦-南屯",0,22,-22
"9169","2929淘帝","110/07/13","新光",21,4,17
"9170","2929淘帝","110/07/13","第一金-豐原",0,20,-20
"9171","2929淘帝","110/07/13","元大-天母",17,0,17
"9172","2929淘帝","110/07/13","元大-屏南",6,26,-20
"9173","2929淘帝","110/07/13","永興",14,0,14
"9174","2929淘帝","110/07/13","永豐金-敦南",1,21,-20
"9175","2929淘帝","110/07/13","富邦-台北",12,0,12
"9176","2929淘帝","110/07/13","凱基-三重",2,21,-19
"9177","2929淘帝","110/07/13","元大-永和",12,0,12
"9178","2929淘帝","110/07/13","富邦-仁愛",7,25,-18
"9179","2929淘帝","110/07/13","國票-天祥",11,0,11
"9180","2929淘帝","110/07/13","元大-北投",0,16,-16
"9181","5410國眾","110/07/13","兆豐-城中",274,0,274
"9182","5410國眾","110/07/13","元富-嘉義",0,103,-103
"9183","5410國眾","110/07/13","新光",50,4,46
"9184","5410國眾","110/07/13","凱基-台北",0,50,-50
"9185","5410國眾","110/07/13","國泰-台中",26,0,26
"9186","5410國眾","110/07/13","瑞士信貸",0,31,-31
"9187","5410國眾","110/07/13","新加坡商瑞銀",22,0,22
"9188","5410國眾","110/07/13","台新-新莊",0,27,-27
"9189","5410國眾","110/07/13","光和-嘉義",20,0,20
"9190","5410國眾","110/07/13","元大-汐止",0,20,-20
"9191","5410國眾","110/07/13","凱基-竹北",17,0,17
"9192","5410國眾","110/07/13","亞東-新竹",0,17,-17
"9193","5410國眾","110/07/13","新光-桃園",15,0,15
"9194","5410國眾","110/07/13","元大-南勢角",0,13,-13
"9195","5410國眾","110/07/13","凱基-台東",14,0,14
"9196","5410國眾","110/07/13","台新-台南",0,12,-12
"9197","5410國眾","110/07/13","富邦-竹北",11,0,11
"9198","5410國眾","110/07/13","中國信託",0,11,-11
"9199","5410國眾","110/07/13","元富-同大",10,0,10
"9200","5410國眾","110/07/13","華南永昌",0,11,-11
"9201","5410國眾","110/07/13","國泰-敦南",24,15,9
"9202","5410國眾","110/07/13","臺銀-臺南",0,10,-10
"9203","5410國眾","110/07/13","日盛-內湖",7,0,7
"9204","5410國眾","110/07/13","台灣企銀-民雄",0,10,-10
"9205","5410國眾","110/07/13","台新-左楠",7,0,7
"9206","5410國眾","110/07/13","高橋",0,10,-10
"9207","5410國眾","110/07/13","元大-新盛",18,12,6
"9208","5410國眾","110/07/13","康和-嘉義",0,10,-10
"9209","5410國眾","110/07/13","統一",5,0,5
"9210","5410國眾","110/07/13","凱基-基隆",0,10,-10
"9211","2841台開","110/07/13","中國信託-高雄",251,50,201
"9212","2841台開","110/07/13","兆豐-公益",0,177,-177
"9213","2841台開","110/07/13","日盛證券",210,13,197
"9214","2841台開","110/07/13","日進",0,152,-152
"9215","2841台開","110/07/13","第一金-台中",55,0,55
"9216","2841台開","110/07/13","港商野村",0,109,-109
"9217","2841台開","110/07/13","國泰-板橋",46,0,46
"9218","2841台開","110/07/13","日盛-信義",0,103,-103
"9219","2841台開","110/07/13","國泰-館前",48,3,45
"9220","2841台開","110/07/13","國泰-敦南",11,75,-64
"9221","2841台開","110/07/13","華南永昌-新莊",45,0,45
"9222","2841台開","110/07/13","永興",0,50,-50
"9223","2841台開","110/07/13","日盛-園區",42,0,42
"9224","2841台開","110/07/13","永豐金-敦南",61,104,-43
"9225","2841台開","110/07/13","台新證券",32,0,32
"9226","2841台開","110/07/13","富邦-台南",0,42,-42
"9227","2841台開","110/07/13","台新-高雄",32,2,30
"9228","2841台開","110/07/13","國票-安和",0,30,-30
"9229","2841台開","110/07/13","豐農",23,0,23
"9230","2841台開","110/07/13","元大-桃園",0,25,-25
"9231","2841台開","110/07/13","合庫-嘉義",20,0,20
"9232","2841台開","110/07/13","新光",8,32,-24
"9233","2841台開","110/07/13","華南永昌-高雄",20,0,20
"9234","2841台開","110/07/13","元大-仁愛",0,24,-24
"9235","2841台開","110/07/13","元大-樹林",16,0,16
"9236","2841台開","110/07/13","日盛-中和",0,20,-20
"9237","2841台開","110/07/13","第一金-華江",15,2,13
"9238","2841台開","110/07/13","元富",0,20,-20
"9239","2841台開","110/07/13","美商高盛",12,0,12
"9240","2841台開","110/07/13","富邦-宜蘭",0,20,-20
"9241","6207雷科","110/07/13","元大-高雄",121,0,121
"9242","6207雷科","110/07/13","華南永昌-朴子",1,60,-59
"9243","6207雷科","110/07/13","第一金-新興",20,0,20
"9244","6207雷科","110/07/13","元大-南海",0,36,-36
"9245","6207雷科","110/07/13","元富-三重",20,0,20
"9246","6207雷科","110/07/13","凱基-土城",0,35,-35
"9247","6207雷科","110/07/13","元大-林園",15,0,15
"9248","6207雷科","110/07/13","台灣企銀",0,20,-20
"9249","6207雷科","110/07/13","元大-金華",16,1,15
"9250","6207雷科","110/07/13","群益金鼎-丹鳳",0,20,-20
"9251","6207雷科","110/07/13","日盛證券",10,0,10
"9252","6207雷科","110/07/13","元大-博愛",0,17,-17
"9253","6207雷科","110/07/13","統一-台中",10,0,10
"9254","6207雷科","110/07/13","元大-北港",0,13,-13
"9255","6207雷科","110/07/13","群益金鼎-土城",10,0,10
"9256","6207雷科","110/07/13","新加坡商瑞銀",0,12,-12
"9257","6207雷科","110/07/13","群益金鼎-桃園",10,0,10
"9258","6207雷科","110/07/13","凱基-台北",4,16,-12
"9259","6207雷科","110/07/13","永豐金-新莊",10,0,10
"9260","6207雷科","110/07/13","日茂-埔里",0,11,-11
"9261","6207雷科","110/07/13","永豐金-新店",10,0,10
"9262","6207雷科","110/07/13","元大-莒光",0,11,-11
"9263","6207雷科","110/07/13","元大證券",9,0,9
"9264","6207雷科","110/07/13","統一-新竹",0,10,-10
"9265","6207雷科","110/07/13","日盛-木柵",9,1,8
"9266","6207雷科","110/07/13","元大-西螺",0,10,-10
"9267","6207雷科","110/07/13","兆豐-來福",8,0,8
"9268","6207雷科","110/07/13","康和-台中",0,8,-8
"9269","6207雷科","110/07/13","新光",7,0,7
"9270","6207雷科","110/07/13","兆豐-高雄",0,6,-6
"9271","3679新至陞","110/07/13","永豐金證券",50,0,50
"9272","3679新至陞","110/07/13","摩根大通",2,25,-23
"9273","3679新至陞","110/07/13","國泰-桃園",22,0,22
"9274","3679新至陞","110/07/13","元大-成功",0,22,-22
"9275","3679新至陞","110/07/13","台中銀-員林",11,0,11
"9276","3679新至陞","110/07/13","富邦-板橋",1,19,-18
"9277","3679新至陞","110/07/13","元大-文心興安",8,0,8
"9278","3679新至陞","110/07/13","日盛-新莊",0,10,-10
"9279","3679新至陞","110/07/13","美商高盛",6,0,6
"9280","3679新至陞","110/07/13","台新-台中",0,10,-10
"9281","3679新至陞","110/07/13","台新-高雄",6,0,6
"9282","3679新至陞","110/07/13","永豐金-新竹",0,8,-8
"9283","3679新至陞","110/07/13","凱基-台北",18,12,6
"9284","3679新至陞","110/07/13","瑞士信貸",12,19,-7
"9285","3679新至陞","110/07/13","日盛-復興",5,0,5
"9286","3679新至陞","110/07/13","統一-南京",0,7,-7
"9287","3679新至陞","110/07/13","(牛牛牛)亞-鑫豐",4,0,4
"9288","3679新至陞","110/07/13","凱基-新莊",0,7,-7
"9289","3679新至陞","110/07/13","元富-大昌",3,0,3
"9290","3679新至陞","110/07/13","新加坡商瑞銀",0,6,-6
"9291","3679新至陞","110/07/13","富邦-台北",3,0,3
"9292","3679新至陞","110/07/13","合庫-自強",0,5,-5
"9293","3679新至陞","110/07/13","日盛-樹林",2,0,2
"9294","3679新至陞","110/07/13","富邦-桃園",0,5,-5
"9295","3679新至陞","110/07/13","宏遠-光隆",2,0,2
"9296","3679新至陞","110/07/13","永豐金-潮州",0,4,-4
"9297","3679新至陞","110/07/13","美林",3,1,2
"9298","3679新至陞","110/07/13","臺銀-臺南",0,3,-3
"9299","3679新至陞","110/07/13","第一金-中壢",2,0,2
"9300","3679新至陞","110/07/13","元大-六合",0,3,-3
"9301","2727王品","110/07/13","富邦-台北",43,3,40
"9302","2727王品","110/07/13","台灣摩根士丹利",15,97,-82
"9303","2727王品","110/07/13","元大-基隆孝二",40,0,40
"9304","2727王品","110/07/13","玉山-台南",5,57,-52
"9305","2727王品","110/07/13","國票-新莊",40,1,39
"9306","2727王品","110/07/13","新加坡商瑞銀",0,48,-48
"9307","2727王品","110/07/13","第一金-豐原",66,42,24
"9308","2727王品","110/07/13","凱基-台北",41,77,-36
"9309","2727王品","110/07/13","永豐金-大園",34,10,24
"9310","2727王品","110/07/13","永豐金-永康",0,22,-22
"9311","2727王品","110/07/13","元大-北屯",22,0,22
"9312","2727王品","110/07/13","統一-台中",2,22,-20
"9313","2727王品","110/07/13","元大-東蘆",26,7,19
"9314","2727王品","110/07/13","國泰-台中",21,39,-18
"9315","2727王品","110/07/13","永豐金-萬盛",13,1,12
"9316","2727王品","110/07/13","合庫-彰化",3,20,-17
"9317","2727王品","110/07/13","日盛-嘉義",11,0,11
"9318","2727王品","110/07/13","港商野村",13,30,-17
"9319","2727王品","110/07/13","日盛-八德",11,0,11
"9320","2727王品","110/07/13","元大-楊梅",1,16,-15
"9321","2727王品","110/07/13","統一-竹南",11,0,11
"9322","2727王品","110/07/13","凱基-高美館",2,15,-13
"9323","2727王品","110/07/13","日盛-士林",12,2,10
"9324","2727王品","110/07/13","美商高盛",2,14,-12
"9325","2727王品","110/07/13","統一-敦南",10,0,10
"9326","2727王品","110/07/13","統一-平鎮",1,13,-12
"9327","2727王品","110/07/13","中國信託",15,5,10
"9328","2727王品","110/07/13","兆豐-台中港",4,16,-12
"9329","2727王品","110/07/13","兆豐-竹北",13,3,10
"9330","2727王品","110/07/13","凱基-八德",1,13,-12
"9331","1570力肯","110/07/13","新光",115,11,104
"9332","1570力肯","110/07/13","元大-北三重",0,162,-162
"9333","1570力肯","110/07/13","群益金鼎-高雄",54,0,54
"9334","1570力肯","110/07/13","元大-大灣",0,25,-25
"9335","1570力肯","110/07/13","國票-新莊",22,0,22
"9336","1570力肯","110/07/13","永豐金-苓雅",0,22,-22
"9337","1570力肯","110/07/13","日盛-桃園",12,0,12
"9338","1570力肯","110/07/13","永豐金-永康",0,19,-19
"9339","1570力肯","110/07/13","元大-高雄",12,0,12
"9340","1570力肯","110/07/13","富邦-員林",0,15,-15
"9341","1570力肯","110/07/13","合庫-自強",11,0,11
"9342","1570力肯","110/07/13","凱基-台南",0,11,-11
"9343","1570力肯","110/07/13","摩根大通",26,15,11
"9344","1570力肯","110/07/13","日盛-竹北",0,10,-10
"9345","1570力肯","110/07/13","永豐金-中盛",11,0,11
"9346","1570力肯","110/07/13","國票-九鼎",0,10,-10
"9347","1570力肯","110/07/13","兆豐-台中港",10,0,10
"9348","1570力肯","110/07/13","凱基-桃園",0,10,-10
"9349","1570力肯","110/07/13","國泰-松江",9,0,9
"9350","1570力肯","110/07/13","凱基-新豐",0,10,-10
"9351","1570力肯","110/07/13","元大-新盛",9,0,9
"9352","1570力肯","110/07/13","元大-學甲",0,10,-10
"9353","1570力肯","110/07/13","元富-緯城",6,0,6
"9354","1570力肯","110/07/13","群益金鼎-東湖",1,10,-9
"9355","1570力肯","110/07/13","統一-三重",5,0,5
"9356","1570力肯","110/07/13","大昌",0,6,-6
"9357","1570力肯","110/07/13","元大-前金",5,0,5
"9358","1570力肯","110/07/13","元大-土城學府",0,6,-6
"9359","1570力肯","110/07/13","永豐金證券",5,0,5
"9360","1570力肯","110/07/13","統一",0,5,-5
"9361","6180橘子","110/07/13","摩根大通",119,0,119
"9362","6180橘子","110/07/13","元大-崇德",2,61,-59
"9363","6180橘子","110/07/13","美商高盛",96,0,96
"9364","6180橘子","110/07/13","康和-台中",0,51,-51
"9365","6180橘子","110/07/13","新加坡商瑞銀",86,7,79
"9366","6180橘子","110/07/13","康和-台北",0,50,-50
"9367","6180橘子","110/07/13","元大-和平",40,0,40
"9368","6180橘子","110/07/13","元富-潮州",0,40,-40
"9369","6180橘子","110/07/13","凱基-台北",83,47,36
"9370","6180橘子","110/07/13","日盛-永康",0,26,-26
"9371","6180橘子","110/07/13","美林",39,5,34
"9372","6180橘子","110/07/13","永豐金-中正",0,24,-24
"9373","6180橘子","110/07/13","富邦-新竹華信",31,2,29
"9374","6180橘子","110/07/13","國泰-板橋",2,25,-23
"9375","6180橘子","110/07/13","統一-南京",21,0,21
"9376","6180橘子","110/07/13","日盛-大墩",0,20,-20
"9377","6180橘子","110/07/13","富邦-陽明",24,3,21
"9378","6180橘子","110/07/13","元大-草屯",13,32,-19
"9379","6180橘子","110/07/13","大昌-樹林",21,1,20
"9380","6180橘子","110/07/13","元富-林園",1,18,-17
"9381","6180橘子","110/07/13","花旗環球",19,0,19
"9382","6180橘子","110/07/13","新光-新竹",1,18,-17
"9383","6180橘子","110/07/13","華南永昌-台南",19,0,19
"9384","6180橘子","110/07/13","元大-土城永寧",0,17,-17
"9385","6180橘子","110/07/13","福勝",14,0,14
"9386","6180橘子","110/07/13","國泰-新莊",3,19,-16
"9387","6180橘子","110/07/13","富邦-嘉義",12,1,11
"9388","6180橘子","110/07/13","中國信託-永康",6,21,-15
"9389","6180橘子","110/07/13","元大-板橋三民",11,0,11
"9390","6180橘子","110/07/13","凱基-東港",1,15,-14
"9391","2390云辰","110/07/13","新加坡商瑞銀",562,75,487
"9392","2390云辰","110/07/13","大展-台南",0,532,-532
"9393","2390云辰","110/07/13","台灣摩根士丹利",330,155,175
"9394","2390云辰","110/07/13","凱基-台北",668,854,-186
"9395","2390云辰","110/07/13","兆豐-公益",126,25,101
"9396","2390云辰","110/07/13","凱基-三重",12,172,-160
"9397","2390云辰","110/07/13","元富-中港",100,2,98
"9398","2390云辰","110/07/13","兆豐-忠孝",4,161,-157
"9399","2390云辰","110/07/13","統一-新台中",106,9,97
"9400","2390云辰","110/07/13","元大-士林",19,170,-151
"9401","2390云辰","110/07/13","中國信託-松江",81,11,70
"9402","2390云辰","110/07/13","臺銀-新竹",14,117,-103
"9403","2390云辰","110/07/13","日盛-板橋",72,3,69
"9404","2390云辰","110/07/13","國票-台中",4,102,-98
"9405","2390云辰","110/07/13","日盛-和美",57,0,57
"9406","2390云辰","110/07/13","新光",147,232,-85
"9407","2390云辰","110/07/13","永豐金-桃園",88,36,52
"9408","2390云辰","110/07/13","致和-崇德",2,70,-68
"9409","2390云辰","110/07/13","玉山-士林",54,4,50
"9410","2390云辰","110/07/13","群益金鼎-屏東",2,70,-68
"9411","2390云辰","110/07/13","富邦-仁愛",56,6,50
"9412","2390云辰","110/07/13","元大-大里",35,98,-63
"9413","2390云辰","110/07/13","第一金-豐原",50,1,49
"9414","2390云辰","110/07/13","元大-萬華",35,94,-59
"9415","2390云辰","110/07/13","摩根大通",502,453,49
"9416","2390云辰","110/07/13","元富-吉利",2,60,-58
"9417","2390云辰","110/07/13","凱基-松山",61,13,48
"9418","2390云辰","110/07/13","兆豐-新竹",3,53,-50
"9419","2390云辰","110/07/13","大昌",64,22,42
"9420","2390云辰","110/07/13","富邦-嘉義",65,108,-43
"9421","2363矽統","110/07/13","凱基-南崁",2133,63,2070
"9422","2363矽統","110/07/13","凱基-幸福",36,4048,-4012
"9423","2363矽統","110/07/13","國泰-敦南",2195,1617,578
"9424","2363矽統","110/07/13","統一",192,3325,-3133
"9425","2363矽統","110/07/13","中農",670,139,531
"9426","2363矽統","110/07/13","新加坡商瑞銀",1000,2747,-1747
"9427","2363矽統","110/07/13","康和-台中",638,154,484
"9428","2363矽統","110/07/13","凱基-台北",5359,6609,-1250
"9429","2363矽統","110/07/13","群益金鼎-三民",577,137,440
"9430","2363矽統","110/07/13","摩根大通",1930,2858,-928
"9431","2363矽統","110/07/13","台新-屏東",510,88,422
"9432","2363矽統","110/07/13","港商野村",960,1679,-719
"9433","2363矽統","110/07/13","德信-中正",455,67,388
"9434","2363矽統","110/07/13","兆豐-復興",25,705,-680
"9435","2363矽統","110/07/13","日盛-竹北",365,70,295
"9436","2363矽統","110/07/13","統一-仁愛",114,755,-641
"9437","2363矽統","110/07/13","元大-佳里",452,189,263
"9438","2363矽統","110/07/13","統一-敦南",29,638,-609
"9439","2363矽統","110/07/13","國票-博愛",296,38,258
"9440","2363矽統","110/07/13","統一-土城",100,704,-604
"9441","2363矽統","110/07/13","元大-萬華",340,95,245
"9442","2363矽統","110/07/13","統一-城中",116,676,-560
"9443","2363矽統","110/07/13","新光",1259,1031,228
"9444","2363矽統","110/07/13","永豐金證券",306,859,-553
"9445","2363矽統","110/07/13","元富-成功",323,96,227
"9446","2363矽統","110/07/13","元富",54,567,-513
"9447","2363矽統","110/07/13","豐農",228,23,205
"9448","2363矽統","110/07/13","瑞士信貸",202,666,-464
"9449","2363矽統","110/07/13","台灣企銀-岡山",186,4,182
"9450","2363矽統","110/07/13","永豐金-嘉義",67,468,-401
"9451","8112至上","110/07/13","摩根大通",688,296,392
"9452","8112至上","110/07/13","國票-中和",0,401,-401
"9453","8112至上","110/07/13","港商野村",344,145,199
"9454","8112至上","110/07/13","永豐金-板盛",0,205,-205
"9455","8112至上","110/07/13","兆豐-公益",195,5,190
"9456","8112至上","110/07/13","凱基-五股",43,155,-112
"9457","8112至上","110/07/13","台灣摩根士丹利",183,0,183
"9458","8112至上","110/07/13","凱基-市政",0,100,-100
"9459","8112至上","110/07/13","群益金鼎-敦南",153,2,151
"9460","8112至上","110/07/13","元大-大里德芳",1,92,-91
"9461","8112至上","110/07/13","臺銀-金山",146,26,120
"9462","8112至上","110/07/13","玉山-桃園",26,110,-84
"9463","8112至上","110/07/13","臺銀",133,19,114
"9464","8112至上","110/07/13","兆豐-天母",0,81,-81
"9465","8112至上","110/07/13","合庫-台中",115,6,109
"9466","8112至上","110/07/13","凱基-城中",3,84,-81
"9467","8112至上","110/07/13","亞東-板橋",134,26,108
"9468","8112至上","110/07/13","日盛-新莊",9,85,-76
"9469","8112至上","110/07/13","凱基-台北",414,326,88
"9470","8112至上","110/07/13","日盛-台中",2,64,-62
"9471","8112至上","110/07/13","新加坡商瑞銀",181,100,81
"9472","8112至上","110/07/13","日盛-中壢",3,64,-61
"9473","8112至上","110/07/13","國泰-敦南",108,31,77
"9474","8112至上","110/07/13","元大-台中",2,59,-57
"9475","8112至上","110/07/13","第一金-華江",77,4,73
"9476","8112至上","110/07/13","元大-雙和",7,64,-57
"9477","8112至上","110/07/13","永豐金-內湖",73,1,72
"9478","8112至上","110/07/13","元大-高雄",8,62,-54
"9479","8112至上","110/07/13","元大-永和",68,1,67
"9480","8112至上","110/07/13","元大-館前",2,55,-53
"9481","4903聯光通","110/07/13","台灣企銀-太平",56,0,56
"9482","4903聯光通","110/07/13","土銀",0,32,-32
"9483","4903聯光通","110/07/13","元富-新興",23,0,23
"9484","4903聯光通","110/07/13","元大-樹林",0,19,-19
"9485","4903聯光通","110/07/13","日盛-樹林",22,0,22
"9486","4903聯光通","110/07/13","凱基-士林",0,17,-17
"9487","4903聯光通","110/07/13","兆豐-天母",20,0,20
"9488","4903聯光通","110/07/13","國票-博愛",0,14,-14
"9489","4903聯光通","110/07/13","華南永昌-桃園",20,0,20
"9490","4903聯光通","110/07/13","元富",0,10,-10
"9491","4903聯光通","110/07/13","富邦-新店",10,0,10
"9492","4903聯光通","110/07/13","新光",0,10,-10
"9493","4903聯光通","110/07/13","新光-台中",5,0,5
"9494","4903聯光通","110/07/13","玉山-南京東路",0,10,-10
"9495","4903聯光通","110/07/13","華南永昌-台中",5,0,5
"9496","4903聯光通","110/07/13","富邦-陽明",0,10,-10
"9497","4903聯光通","110/07/13","元大-崇德",5,0,5
"9498","4903聯光通","110/07/13","元大-大甲",0,8,-8
"9499","4903聯光通","110/07/13","元大-草屯",5,0,5
"9500","4903聯光通","110/07/13","富邦-台中",0,7,-7
"9501","4903聯光通","110/07/13","元富-草屯",4,0,4
"9502","4903聯光通","110/07/13","凱基-中壢",0,6,-6
"9503","4903聯光通","110/07/13","元大-清水",4,0,4
"9504","4903聯光通","110/07/13","臺銀-民權",0,5,-5
"9505","4903聯光通","110/07/13","元大-東泰",4,0,4
"9506","4903聯光通","110/07/13","日盛-板橋",0,5,-5
"9507","4903聯光通","110/07/13","元大-佳里",2,0,2
"9508","4903聯光通","110/07/13","中國信託-忠孝",0,5,-5
"9509","4903聯光通","110/07/13","永豐金-板橋",2,0,2
"9510","4903聯光通","110/07/13","永豐金-鳳山",0,5,-5
"9511","2929淘帝","110/07/13","玉山-新竹",130,0,130
"9512","2929淘帝","110/07/13","美商高盛",0,177,-177
"9513","2929淘帝","110/07/13","臺銀-民權",60,0,60
"9514","2929淘帝","110/07/13","凱基-台北",6,80,-74
"9515","2929淘帝","110/07/13","新百王",31,0,31
"9516","2929淘帝","110/07/13","元富-大裕",0,49,-49
"9517","2929淘帝","110/07/13","日盛-園區",30,0,30
"9518","2929淘帝","110/07/13","國泰-館前",3,51,-48
"9519","2929淘帝","110/07/13","元大-南投",31,1,30
"9520","2929淘帝","110/07/13","凱基-中壢",0,41,-41
"9521","2929淘帝","110/07/13","兆豐-忠孝",28,0,28
"9522","2929淘帝","110/07/13","港商野村",21,55,-34
"9523","2929淘帝","110/07/13","元大-民生",28,0,28
"9524","2929淘帝","110/07/13","華南永昌-南京",2,34,-32
"9525","2929淘帝","110/07/13","合庫-高雄",27,0,27
"9526","2929淘帝","110/07/13","群益金鼎-土城",0,30,-30
"9527","2929淘帝","110/07/13","凱基-豐中",27,0,27
"9528","2929淘帝","110/07/13","富邦-南屯",0,22,-22
"9529","2929淘帝","110/07/13","新光",21,4,17
"9530","2929淘帝","110/07/13","第一金-豐原",0,20,-20
"9531","2929淘帝","110/07/13","元大-天母",17,0,17
"9532","2929淘帝","110/07/13","元大-屏南",6,26,-20
"9533","2929淘帝","110/07/13","永興",14,0,14
"9534","2929淘帝","110/07/13","永豐金-敦南",1,21,-20
"9535","2929淘帝","110/07/13","富邦-台北",12,0,12
"9536","2929淘帝","110/07/13","凱基-三重",2,21,-19
"9537","2929淘帝","110/07/13","元大-永和",12,0,12
"9538","2929淘帝","110/07/13","富邦-仁愛",7,25,-18
"9539","2929淘帝","110/07/13","國票-天祥",11,0,11
"9540","2929淘帝","110/07/13","元大-北投",0,16,-16
"9541","5410國眾","110/07/13","兆豐-城中",274,0,274
"9542","5410國眾","110/07/13","元富-嘉義",0,103,-103
"9543","5410國眾","110/07/13","新光",50,4,46
"9544","5410國眾","110/07/13","凱基-台北",0,50,-50
"9545","5410國眾","110/07/13","國泰-台中",26,0,26
"9546","5410國眾","110/07/13","瑞士信貸",0,31,-31
"9547","5410國眾","110/07/13","新加坡商瑞銀",22,0,22
"9548","5410國眾","110/07/13","台新-新莊",0,27,-27
"9549","5410國眾","110/07/13","光和-嘉義",20,0,20
"9550","5410國眾","110/07/13","元大-汐止",0,20,-20
"9551","5410國眾","110/07/13","凱基-竹北",17,0,17
"9552","5410國眾","110/07/13","亞東-新竹",0,17,-17
"9553","5410國眾","110/07/13","新光-桃園",15,0,15
"9554","5410國眾","110/07/13","元大-南勢角",0,13,-13
"9555","5410國眾","110/07/13","凱基-台東",14,0,14
"9556","5410國眾","110/07/13","台新-台南",0,12,-12
"9557","5410國眾","110/07/13","富邦-竹北",11,0,11
"9558","5410國眾","110/07/13","中國信託",0,11,-11
"9559","5410國眾","110/07/13","元富-同大",10,0,10
"9560","5410國眾","110/07/13","華南永昌",0,11,-11
"9561","5410國眾","110/07/13","國泰-敦南",24,15,9
"9562","5410國眾","110/07/13","臺銀-臺南",0,10,-10
"9563","5410國眾","110/07/13","日盛-內湖",7,0,7
"9564","5410國眾","110/07/13","台灣企銀-民雄",0,10,-10
"9565","5410國眾","110/07/13","台新-左楠",7,0,7
"9566","5410國眾","110/07/13","高橋",0,10,-10
"9567","5410國眾","110/07/13","元大-新盛",18,12,6
"9568","5410國眾","110/07/13","康和-嘉義",0,10,-10
"9569","5410國眾","110/07/13","統一",5,0,5
"9570","5410國眾","110/07/13","凱基-基隆",0,10,-10
"9571","2841台開","110/07/13","中國信託-高雄",251,50,201
"9572","2841台開","110/07/13","兆豐-公益",0,177,-177
"9573","2841台開","110/07/13","日盛證券",210,13,197
"9574","2841台開","110/07/13","日進",0,152,-152
"9575","2841台開","110/07/13","第一金-台中",55,0,55
"9576","2841台開","110/07/13","港商野村",0,109,-109
"9577","2841台開","110/07/13","國泰-板橋",46,0,46
"9578","2841台開","110/07/13","日盛-信義",0,103,-103
"9579","2841台開","110/07/13","國泰-館前",48,3,45
"9580","2841台開","110/07/13","國泰-敦南",11,75,-64
"9581","2841台開","110/07/13","華南永昌-新莊",45,0,45
"9582","2841台開","110/07/13","永興",0,50,-50
"9583","2841台開","110/07/13","日盛-園區",42,0,42
"9584","2841台開","110/07/13","永豐金-敦南",61,104,-43
"9585","2841台開","110/07/13","台新證券",32,0,32
"9586","2841台開","110/07/13","富邦-台南",0,42,-42
"9587","2841台開","110/07/13","台新-高雄",32,2,30
"9588","2841台開","110/07/13","國票-安和",0,30,-30
"9589","2841台開","110/07/13","豐農",23,0,23
"9590","2841台開","110/07/13","元大-桃園",0,25,-25
"9591","2841台開","110/07/13","合庫-嘉義",20,0,20
"9592","2841台開","110/07/13","新光",8,32,-24
"9593","2841台開","110/07/13","華南永昌-高雄",20,0,20
"9594","2841台開","110/07/13","元大-仁愛",0,24,-24
"9595","2841台開","110/07/13","元大-樹林",16,0,16
"9596","2841台開","110/07/13","日盛-中和",0,20,-20
"9597","2841台開","110/07/13","第一金-華江",15,2,13
"9598","2841台開","110/07/13","元富",0,20,-20
"9599","2841台開","110/07/13","美商高盛",12,0,12
"9600","2841台開","110/07/13","富邦-宜蘭",0,20,-20
"9601","6207雷科","110/07/13","元大-高雄",121,0,121
"9602","6207雷科","110/07/13","華南永昌-朴子",1,60,-59
"9603","6207雷科","110/07/13","第一金-新興",20,0,20
"9604","6207雷科","110/07/13","元大-南海",0,36,-36
"9605","6207雷科","110/07/13","元富-三重",20,0,20
"9606","6207雷科","110/07/13","凱基-土城",0,35,-35
"9607","6207雷科","110/07/13","元大-林園",15,0,15
"9608","6207雷科","110/07/13","台灣企銀",0,20,-20
"9609","6207雷科","110/07/13","元大-金華",16,1,15
"9610","6207雷科","110/07/13","群益金鼎-丹鳳",0,20,-20
"9611","6207雷科","110/07/13","日盛證券",10,0,10
"9612","6207雷科","110/07/13","元大-博愛",0,17,-17
"9613","6207雷科","110/07/13","統一-台中",10,0,10
"9614","6207雷科","110/07/13","元大-北港",0,13,-13
"9615","6207雷科","110/07/13","群益金鼎-土城",10,0,10
"9616","6207雷科","110/07/13","新加坡商瑞銀",0,12,-12
"9617","6207雷科","110/07/13","群益金鼎-桃園",10,0,10
"9618","6207雷科","110/07/13","凱基-台北",4,16,-12
"9619","6207雷科","110/07/13","永豐金-新莊",10,0,10
"9620","6207雷科","110/07/13","日茂-埔里",0,11,-11
"9621","6207雷科","110/07/13","永豐金-新店",10,0,10
"9622","6207雷科","110/07/13","元大-莒光",0,11,-11
"9623","6207雷科","110/07/13","元大證券",9,0,9
"9624","6207雷科","110/07/13","統一-新竹",0,10,-10
"9625","6207雷科","110/07/13","日盛-木柵",9,1,8
"9626","6207雷科","110/07/13","元大-西螺",0,10,-10
"9627","6207雷科","110/07/13","兆豐-來福",8,0,8
"9628","6207雷科","110/07/13","康和-台中",0,8,-8
"9629","6207雷科","110/07/13","新光",7,0,7
"9630","6207雷科","110/07/13","兆豐-高雄",0,6,-6
"9631","3679新至陞","110/07/13","永豐金證券",50,0,50
"9632","3679新至陞","110/07/13","摩根大通",2,25,-23
"9633","3679新至陞","110/07/13","國泰-桃園",22,0,22
"9634","3679新至陞","110/07/13","元大-成功",0,22,-22
"9635","3679新至陞","110/07/13","台中銀-員林",11,0,11
"9636","3679新至陞","110/07/13","富邦-板橋",1,19,-18
"9637","3679新至陞","110/07/13","元大-文心興安",8,0,8
"9638","3679新至陞","110/07/13","日盛-新莊",0,10,-10
"9639","3679新至陞","110/07/13","美商高盛",6,0,6
"9640","3679新至陞","110/07/13","台新-台中",0,10,-10
"9641","3679新至陞","110/07/13","台新-高雄",6,0,6
"9642","3679新至陞","110/07/13","永豐金-新竹",0,8,-8
"9643","3679新至陞","110/07/13","凱基-台北",18,12,6
"9644","3679新至陞","110/07/13","瑞士信貸",12,19,-7
"9645","3679新至陞","110/07/13","日盛-復興",5,0,5
"9646","3679新至陞","110/07/13","統一-南京",0,7,-7
"9647","3679新至陞","110/07/13","(牛牛牛)亞-鑫豐",4,0,4
"9648","3679新至陞","110/07/13","凱基-新莊",0,7,-7
"9649","3679新至陞","110/07/13","元富-大昌",3,0,3
"9650","3679新至陞","110/07/13","新加坡商瑞銀",0,6,-6
"9651","3679新至陞","110/07/13","富邦-台北",3,0,3
"9652","3679新至陞","110/07/13","合庫-自強",0,5,-5
"9653","3679新至陞","110/07/13","日盛-樹林",2,0,2
"9654","3679新至陞","110/07/13","富邦-桃園",0,5,-5
"9655","3679新至陞","110/07/13","宏遠-光隆",2,0,2
"9656","3679新至陞","110/07/13","永豐金-潮州",0,4,-4
"9657","3679新至陞","110/07/13","美林",3,1,2
"9658","3679新至陞","110/07/13","臺銀-臺南",0,3,-3
"9659","3679新至陞","110/07/13","第一金-中壢",2,0,2
"9660","3679新至陞","110/07/13","元大-六合",0,3,-3
"9661","2727王品","110/07/13","富邦-台北",43,3,40
"9662","2727王品","110/07/13","台灣摩根士丹利",15,97,-82
"9663","2727王品","110/07/13","元大-基隆孝二",40,0,40
"9664","2727王品","110/07/13","玉山-台南",5,57,-52
"9665","2727王品","110/07/13","國票-新莊",40,1,39
"9666","2727王品","110/07/13","新加坡商瑞銀",0,48,-48
"9667","2727王品","110/07/13","第一金-豐原",66,42,24
"9668","2727王品","110/07/13","凱基-台北",41,77,-36
"9669","2727王品","110/07/13","永豐金-大園",34,10,24
"9670","2727王品","110/07/13","永豐金-永康",0,22,-22
"9671","2727王品","110/07/13","元大-北屯",22,0,22
"9672","2727王品","110/07/13","統一-台中",2,22,-20
"9673","2727王品","110/07/13","元大-東蘆",26,7,19
"9674","2727王品","110/07/13","國泰-台中",21,39,-18
"9675","2727王品","110/07/13","永豐金-萬盛",13,1,12
"9676","2727王品","110/07/13","合庫-彰化",3,20,-17
"9677","2727王品","110/07/13","日盛-嘉義",11,0,11
"9678","2727王品","110/07/13","港商野村",13,30,-17
"9679","2727王品","110/07/13","日盛-八德",11,0,11
"9680","2727王品","110/07/13","元大-楊梅",1,16,-15
"9681","2727王品","110/07/13","統一-竹南",11,0,11
"9682","2727王品","110/07/13","凱基-高美館",2,15,-13
"9683","2727王品","110/07/13","日盛-士林",12,2,10
"9684","2727王品","110/07/13","美商高盛",2,14,-12
"9685","2727王品","110/07/13","統一-敦南",10,0,10
"9686","2727王品","110/07/13","統一-平鎮",1,13,-12
"9687","2727王品","110/07/13","中國信託",15,5,10
"9688","2727王品","110/07/13","兆豐-台中港",4,16,-12
"9689","2727王品","110/07/13","兆豐-竹北",13,3,10
"9690","2727王品","110/07/13","凱基-八德",1,13,-12
"9691","1570力肯","110/07/13","新光",115,11,104
"9692","1570力肯","110/07/13","元大-北三重",0,162,-162
"9693","1570力肯","110/07/13","群益金鼎-高雄",54,0,54
"9694","1570力肯","110/07/13","元大-大灣",0,25,-25
"9695","1570力肯","110/07/13","國票-新莊",22,0,22
"9696","1570力肯","110/07/13","永豐金-苓雅",0,22,-22
"9697","1570力肯","110/07/13","日盛-桃園",12,0,12
"9698","1570力肯","110/07/13","永豐金-永康",0,19,-19
"9699","1570力肯","110/07/13","元大-高雄",12,0,12
"9700","1570力肯","110/07/13","富邦-員林",0,15,-15
"9701","1570力肯","110/07/13","合庫-自強",11,0,11
"9702","1570力肯","110/07/13","凱基-台南",0,11,-11
"9703","1570力肯","110/07/13","摩根大通",26,15,11
"9704","1570力肯","110/07/13","日盛-竹北",0,10,-10
"9705","1570力肯","110/07/13","永豐金-中盛",11,0,11
"9706","1570力肯","110/07/13","國票-九鼎",0,10,-10
"9707","1570力肯","110/07/13","兆豐-台中港",10,0,10
"9708","1570力肯","110/07/13","凱基-桃園",0,10,-10
"9709","1570力肯","110/07/13","國泰-松江",9,0,9
"9710","1570力肯","110/07/13","凱基-新豐",0,10,-10
"9711","1570力肯","110/07/13","元大-新盛",9,0,9
"9712","1570力肯","110/07/13","元大-學甲",0,10,-10
"9713","1570力肯","110/07/13","元富-緯城",6,0,6
"9714","1570力肯","110/07/13","群益金鼎-東湖",1,10,-9
"9715","1570力肯","110/07/13","統一-三重",5,0,5
"9716","1570力肯","110/07/13","大昌",0,6,-6
"9717","1570力肯","110/07/13","元大-前金",5,0,5
"9718","1570力肯","110/07/13","元大-土城學府",0,6,-6
"9719","1570力肯","110/07/13","永豐金證券",5,0,5
"9720","1570力肯","110/07/13","統一",0,5,-5
"9721","6180橘子","110/07/13","摩根大通",119,0,119
"9722","6180橘子","110/07/13","元大-崇德",2,61,-59
"9723","6180橘子","110/07/13","美商高盛",96,0,96
"9724","6180橘子","110/07/13","康和-台中",0,51,-51
"9725","6180橘子","110/07/13","新加坡商瑞銀",86,7,79
"9726","6180橘子","110/07/13","康和-台北",0,50,-50
"9727","6180橘子","110/07/13","元大-和平",40,0,40
"9728","6180橘子","110/07/13","元富-潮州",0,40,-40
"9729","6180橘子","110/07/13","凱基-台北",83,47,36
"9730","6180橘子","110/07/13","日盛-永康",0,26,-26
"9731","6180橘子","110/07/13","美林",39,5,34
"9732","6180橘子","110/07/13","永豐金-中正",0,24,-24
"9733","6180橘子","110/07/13","富邦-新竹華信",31,2,29
"9734","6180橘子","110/07/13","國泰-板橋",2,25,-23
"9735","6180橘子","110/07/13","統一-南京",21,0,21
"9736","6180橘子","110/07/13","日盛-大墩",0,20,-20
"9737","6180橘子","110/07/13","富邦-陽明",24,3,21
"9738","6180橘子","110/07/13","元大-草屯",13,32,-19
"9739","6180橘子","110/07/13","大昌-樹林",21,1,20
"9740","6180橘子","110/07/13","元富-林園",1,18,-17
"9741","6180橘子","110/07/13","花旗環球",19,0,19
"9742","6180橘子","110/07/13","新光-新竹",1,18,-17
"9743","6180橘子","110/07/13","華南永昌-台南",19,0,19
"9744","6180橘子","110/07/13","元大-土城永寧",0,17,-17
"9745","6180橘子","110/07/13","福勝",14,0,14
"9746","6180橘子","110/07/13","國泰-新莊",3,19,-16
"9747","6180橘子","110/07/13","富邦-嘉義",12,1,11
"9748","6180橘子","110/07/13","中國信託-永康",6,21,-15
"9749","6180橘子","110/07/13","元大-板橋三民",11,0,11
"9750","6180橘子","110/07/13","凱基-東港",1,15,-14
"9751","2390云辰","110/07/13","新加坡商瑞銀",562,75,487
"9752","2390云辰","110/07/13","大展-台南",0,532,-532
"9753","2390云辰","110/07/13","台灣摩根士丹利",330,155,175
"9754","2390云辰","110/07/13","凱基-台北",668,854,-186
"9755","2390云辰","110/07/13","兆豐-公益",126,25,101
"9756","2390云辰","110/07/13","凱基-三重",12,172,-160
"9757","2390云辰","110/07/13","元富-中港",100,2,98
"9758","2390云辰","110/07/13","兆豐-忠孝",4,161,-157
"9759","2390云辰","110/07/13","統一-新台中",106,9,97
"9760","2390云辰","110/07/13","元大-士林",19,170,-151
"9761","2390云辰","110/07/13","中國信託-松江",81,11,70
"9762","2390云辰","110/07/13","臺銀-新竹",14,117,-103
"9763","2390云辰","110/07/13","日盛-板橋",72,3,69
"9764","2390云辰","110/07/13","國票-台中",4,102,-98
"9765","2390云辰","110/07/13","日盛-和美",57,0,57
"9766","2390云辰","110/07/13","新光",147,232,-85
"9767","2390云辰","110/07/13","永豐金-桃園",88,36,52
"9768","2390云辰","110/07/13","致和-崇德",2,70,-68
"9769","2390云辰","110/07/13","玉山-士林",54,4,50
"9770","2390云辰","110/07/13","群益金鼎-屏東",2,70,-68
"9771","2390云辰","110/07/13","富邦-仁愛",56,6,50
"9772","2390云辰","110/07/13","元大-大里",35,98,-63
"9773","2390云辰","110/07/13","第一金-豐原",50,1,49
"9774","2390云辰","110/07/13","元大-萬華",35,94,-59
"9775","2390云辰","110/07/13","摩根大通",502,453,49
"9776","2390云辰","110/07/13","元富-吉利",2,60,-58
"9777","2390云辰","110/07/13","凱基-松山",61,13,48
"9778","2390云辰","110/07/13","兆豐-新竹",3,53,-50
"9779","2390云辰","110/07/13","大昌",64,22,42
"9780","2390云辰","110/07/13","富邦-嘉義",65,108,-43
"9781","2363矽統","110/07/12","凱基-幸福",4046,31,4015
"9782","2363矽統","110/07/12","台新證券",478,2105,-1627
"9783","2363矽統","110/07/12","統一",3504,120,3384
"9784","2363矽統","110/07/12","第一金-忠孝",4,1068,-1064
"9785","2363矽統","110/07/12","摩根大通",3006,2149,857
"9786","2363矽統","110/07/12","台新-台中",381,1003,-622
"9787","2363矽統","110/07/12","永豐金證券",1428,610,818
"9788","2363矽統","110/07/12","新光",1295,1822,-527
"9789","2363矽統","110/07/12","兆豐-復興",1936,1233,703
"9790","2363矽統","110/07/12","大昌-樹林",54,537,-483
"9791","2363矽統","110/07/12","台灣摩根士丹利",701,0,701
"9792","2363矽統","110/07/12","華南永昌-台中",90,549,-459
"9793","2363矽統","110/07/12","永豐金-南投",803,145,658
"9794","2363矽統","110/07/12","玉山-高雄",167,612,-445
"9795","2363矽統","110/07/12","統一-仁愛",1214,586,628
"9796","2363矽統","110/07/12","元富-同大",201,540,-339
"9797","2363矽統","110/07/12","統一-土城",688,75,613
"9798","2363矽統","110/07/12","華南永昌-東勢",31,367,-336
"9799","2363矽統","110/07/12","統一-城中",711,131,580
"9800","2363矽統","110/07/12","土銀-花蓮",9,333,-324
"9801","2363矽統","110/07/12","統一-敦南",632,54,578
"9802","2363矽統","110/07/12","凱基-豐中",120,434,-314
"9803","2363矽統","110/07/12","新加坡商瑞銀",1232,731,501
"9804","2363矽統","110/07/12","永豐金-竹科",54,323,-269
"9805","2363矽統","110/07/12","元富",2640,2142,498
"9806","2363矽統","110/07/12","元大-斗六",53,300,-247
"9807","2363矽統","110/07/12","凱基-永和",460,31,429
"9808","2363矽統","110/07/12","華南永昌-朴子",47,278,-231
"9809","2363矽統","110/07/12","第一金",380,22,358
"9810","2363矽統","110/07/12","永豐金-彰化",22,228,-206
"9811","8112至上","110/07/12","摩根大通",1167,290,877
"9812","8112至上","110/07/12","群益金鼎-新莊",1,156,-155
"9813","8112至上","110/07/12","凱基-台北",983,546,437
"9814","8112至上","110/07/12","國票-中港",0,131,-131
"9815","8112至上","110/07/12","新加坡商瑞銀",429,12,417
"9816","8112至上","110/07/12","元大證券",10,136,-126
"9817","8112至上","110/07/12","元大-屏南",360,2,358
"9818","8112至上","110/07/12","元大-中壢",11,135,-124
"9819","8112至上","110/07/12","美林",323,15,308
"9820","8112至上","110/07/12","合庫-基隆",0,122,-122
"9821","8112至上","110/07/12","台灣摩根士丹利",299,0,299
"9822","8112至上","110/07/12","群益金鼎-高盛",4,103,-99
"9823","8112至上","110/07/12","港商野村",267,28,239
"9824","8112至上","110/07/12","新光",110,202,-92
"9825","8112至上","110/07/12","大慶",165,3,162
"9826","8112至上","110/07/12","元大-府城",2,94,-92
"9827","8112至上","110/07/12","永豐金-台南",170,29,141
"9828","8112至上","110/07/12","富邦-板橋",5,92,-87
"9829","8112至上","110/07/12","華南永昌-長虹",128,2,126
"9830","8112至上","110/07/12","元大-土城",8,89,-81
"9831","8112至上","110/07/12","富邦-仁愛",157,51,106
"9832","8112至上","110/07/12","日盛-頭份",40,117,-77
"9833","8112至上","110/07/12","瑞士信貸",104,0,104
"9834","8112至上","110/07/12","玉山-嘉義",3,80,-77
"9835","8112至上","110/07/12","凱基-站前",100,11,89
"9836","8112至上","110/07/12","永豐金-松山",4,79,-75
"9837","8112至上","110/07/12","富邦-北港",90,3,87
"9838","8112至上","110/07/12","元大-敦南",3,75,-72
"9839","8112至上","110/07/12","元大-北港",101,20,81
"9840","8112至上","110/07/12","元富-大裕",6,77,-71
"9841","4903聯光通","110/07/12","台灣企銀-太平",19,0,19
"9842","4903聯光通","110/07/12","玉山-南京東路",0,16,-16
"9843","4903聯光通","110/07/12","統一-土城",17,0,17
"9844","4903聯光通","110/07/12","新光",0,14,-14
"9845","4903聯光通","110/07/12","國票-博愛",14,0,14
"9846","4903聯光通","110/07/12","兆豐-彰化",0,10,-10
"9847","4903聯光通","110/07/12","新光-台中",15,2,13
"9848","4903聯光通","110/07/12","國票",0,10,-10
"9849","4903聯光通","110/07/12","元大-彰化",11,0,11
"9850","4903聯光通","110/07/12","富邦-敦南",0,10,-10
"9851","4903聯光通","110/07/12","華南永昌-林口",10,0,10
"9852","4903聯光通","110/07/12","元大-前金",0,9,-9
"9853","4903聯光通","110/07/12","永豐金-南投",9,0,9
"9854","4903聯光通","110/07/12","日盛-頭份",0,8,-8
"9855","4903聯光通","110/07/12","元大-清水",8,0,8
"9856","4903聯光通","110/07/12","元大-太平",0,8,-8
"9857","4903聯光通","110/07/12","元大-博愛",8,0,8
"9858","4903聯光通","110/07/12","兆豐-埔墘",0,7,-7
"9859","4903聯光通","110/07/12","玉山-新莊",5,0,5
"9860","4903聯光通","110/07/12","臺銀-民權",0,5,-5
"9861","4903聯光通","110/07/12","凱基-士林",10,5,5
"9862","4903聯光通","110/07/12","富邦-板橋",0,5,-5
"9863","4903聯光通","110/07/12","元大-斗六",4,0,4
"9864","4903聯光通","110/07/12","元大-土城永寧",0,5,-5
"9865","4903聯光通","110/07/12","永豐金-羅東",4,0,4
"9866","4903聯光通","110/07/12","台新證券",0,4,-4
"9867","4903聯光通","110/07/12","日盛-樹林",3,0,3
"9868","4903聯光通","110/07/12","凱基-中壢",0,4,-4
"9869","4903聯光通","110/07/12","華南永昌-鶯歌",2,0,2
"9870","4903聯光通","110/07/12","元大-羅東",0,4,-4
"9871","2929淘帝","110/07/12","新光-台中",95,36,59
"9872","2929淘帝","110/07/12","華南永昌-林口",7,208,-201
"9873","2929淘帝","110/07/12","富邦-板橋",62,5,57
"9874","2929淘帝","110/07/12","富邦-台北",6,200,-194
"9875","2929淘帝","110/07/12","合庫-高雄",56,6,50
"9876","2929淘帝","110/07/12","元富-大裕",11,200,-189
"9877","2929淘帝","110/07/12","永興",41,0,41
"9878","2929淘帝","110/07/12","台中銀-台北",0,160,-160
"9879","2929淘帝","110/07/12","兆豐-忠孝",58,18,40
"9880","2929淘帝","110/07/12","日盛-園區",1,111,-110
"9881","2929淘帝","110/07/12","新光-高雄",39,3,36
"9882","2929淘帝","110/07/12","日盛-八德",0,88,-88
"9883","2929淘帝","110/07/12","凱基-豐中",36,0,36
"9884","2929淘帝","110/07/12","玉山-新竹",32,110,-78
"9885","2929淘帝","110/07/12","元大-民生",35,0,35
"9886","2929淘帝","110/07/12","元大-前金",0,72,-72
"9887","2929淘帝","110/07/12","臺銀-臺南",32,1,31
"9888","2929淘帝","110/07/12","元大-館前",12,83,-71
"9889","2929淘帝","110/07/12","台新證券",44,13,31
"9890","2929淘帝","110/07/12","華南永昌",1,57,-56
"9891","2929淘帝","110/07/12","新百王",30,0,30
"9892","2929淘帝","110/07/12","元大-南崁",4,59,-55
"9893","2929淘帝","110/07/12","群益金鼎-大興",30,0,30
"9894","2929淘帝","110/07/12","元大-嘉義",0,51,-51
"9895","2929淘帝","110/07/12","凱基-台北",32,5,27
"9896","2929淘帝","110/07/12","日茂",1,50,-49
"9897","2929淘帝","110/07/12","元富-城東",26,0,26
"9898","2929淘帝","110/07/12","新光",35,83,-48
"9899","2929淘帝","110/07/12","國泰-松江",26,0,26
"9900","2929淘帝","110/07/12","日盛-新竹",1,48,-47
"9901","5410國眾","110/07/12","群益金鼎-中壢",68,0,68
"9902","5410國眾","110/07/12","摩根大通",6,67,-61
"9903","5410國眾","110/07/12","凱基-市政",40,0,40
"9904","5410國眾","110/07/12","元富-嘉義",0,60,-60
"9905","5410國眾","110/07/12","凱基-竹北",38,0,38
"9906","5410國眾","110/07/12","凱基-台北",0,51,-51
"9907","5410國眾","110/07/12","華南永昌-三重",30,0,30
"9908","5410國眾","110/07/12","元富-大裕",0,33,-33
"9909","5410國眾","110/07/12","永興",20,0,20
"9910","5410國眾","110/07/12","日盛-木柵",0,15,-15
"9911","5410國眾","110/07/12","統一-新台中",20,0,20
"9912","5410國眾","110/07/12","群益金鼎-民權",0,15,-15
"9913","5410國眾","110/07/12","兆豐-三重",20,0,20
"9914","5410國眾","110/07/12","元富-緯城",0,14,-14
"9915","5410國眾","110/07/12","富邦-台中",20,0,20
"9916","5410國眾","110/07/12","元大-大同",0,12,-12
"9917","5410國眾","110/07/12","臺銀",15,0,15
"9918","5410國眾","110/07/12","元大-莒光",0,10,-10
"9919","5410國眾","110/07/12","新光-桃園",20,6,14
"9920","5410國眾","110/07/12","元大-博愛",0,10,-10
"9921","5410國眾","110/07/12","元大-員林",12,0,12
"9922","5410國眾","110/07/12","日盛-永康",0,8,-8
"9923","5410國眾","110/07/12","日盛-員林",10,0,10
"9924","5410國眾","110/07/12","元大-四維",5,13,-8
"9925","5410國眾","110/07/12","元大-新盛",10,0,10
"9926","5410國眾","110/07/12","新加坡商瑞銀",0,7,-7
"9927","5410國眾","110/07/12","永豐金-台南",10,0,10
"9928","5410國眾","110/07/12","致和-金華",0,7,-7
"9929","5410國眾","110/07/12","元富-新莊",8,0,8
"9930","5410國眾","110/07/12","新光-新竹",0,7,-7
"9931","2841台開","110/07/12","永豐金-敦南",139,26,113
"9932","2841台開","110/07/12","華南永昌-朴子",0,528,-528
"9933","2841台開","110/07/12","日盛-雙和",68,0,68
"9934","2841台開","110/07/12","元大-苑裡",2,50,-48
"9935","2841台開","110/07/12","台新證券",62,4,58
"9936","2841台開","110/07/12","群益金鼎-東湖",0,40,-40
"9937","2841台開","110/07/12","凱基-文心",50,0,50
"9938","2841台開","110/07/12","第一金-員林",0,30,-30
"9939","2841台開","110/07/12","第一金-台中",45,0,45
"9940","2841台開","110/07/12","德信-中正",0,20,-20
"9941","2841台開","110/07/12","富邦-嘉義",40,0,40
"9942","2841台開","110/07/12","兆豐-嘉義",0,20,-20
"9943","2841台開","110/07/12","日盛-木柵",30,0,30
"9944","2841台開","110/07/12","彰銀-七賢",0,15,-15
"9945","2841台開","110/07/12","中國信託-文心",31,3,28
"9946","2841台開","110/07/12","元大-承德",0,14,-14
"9947","2841台開","110/07/12","元大-福營",30,7,23
"9948","2841台開","110/07/12","元富",0,12,-12
"9949","2841台開","110/07/12","台中銀",20,0,20
"9950","2841台開","110/07/12","富邦-陽明",0,11,-11
"9951","2841台開","110/07/12","國泰-板橋",20,0,20
"9952","2841台開","110/07/12","元大證券",0,11,-11
"9953","2841台開","110/07/12","元大-前金",20,0,20
"9954","2841台開","110/07/12","元大-大甲",0,10,-10
"9955","2841台開","110/07/12","中國信託-高雄",16,1,15
"9956","2841台開","110/07/12","日盛-新竹",0,8,-8
"9957","2841台開","110/07/12","陽信-石牌",15,0,15
"9958","2841台開","110/07/12","元富-城東",0,8,-8
"9959","2841台開","110/07/12","永豐金-南投",15,0,15
"9960","2841台開","110/07/12","玉山-台南",2,10,-8
"9961","6207雷科","110/07/12","元大-高雄",34,0,34
"9962","6207雷科","110/07/12","永豐金-三重",1,32,-31
"9963","6207雷科","110/07/12","華南永昌-林口",16,1,15
"9964","6207雷科","110/07/12","永全-八德",0,30,-30
"9965","6207雷科","110/07/12","摩根大通",19,6,13
"9966","6207雷科","110/07/12","國泰-台中",0,14,-14
"9967","6207雷科","110/07/12","元富-埔里",10,0,10
"9968","6207雷科","110/07/12","第一金-澎湖",0,10,-10
"9969","6207雷科","110/07/12","凱基-台南",10,0,10
"9970","6207雷科","110/07/12","元富-林園",0,10,-10
"9971","6207雷科","110/07/12","新加坡商瑞銀",9,0,9
"9972","6207雷科","110/07/12","元大-東門",0,10,-10
"9973","6207雷科","110/07/12","瑞士信貸",8,0,8
"9974","6207雷科","110/07/12","兆豐-嘉義",0,4,-4
"9975","6207雷科","110/07/12","中國信託-高雄",9,1,8
"9976","6207雷科","110/07/12","新光",0,4,-4
"9977","6207雷科","110/07/12","凱基-高雄",6,0,6
"9978","6207雷科","110/07/12","新光-台中",0,4,-4
"9979","6207雷科","110/07/12","元大-六合",6,0,6
"9980","6207雷科","110/07/12","群益金鼎-開元",0,4,-4
"9981","6207雷科","110/07/12","永豐金-信義",6,0,6
"9982","6207雷科","110/07/12","凱基-桃園",0,4,-4
"9983","6207雷科","110/07/12","群益金鼎-土城",5,0,5
"9984","6207雷科","110/07/12","凱基-民權",0,4,-4
"9985","6207雷科","110/07/12","群益金鼎-竹南",5,0,5
"9986","6207雷科","110/07/12","玉山-新莊",0,3,-3
"9987","6207雷科","110/07/12","元大-大灣",5,1,4
"9988","6207雷科","110/07/12","國泰-松江",0,3,-3
"9989","6207雷科","110/07/12","永興",3,0,3
"9990","6207雷科","110/07/12","富邦-羅東",0,3,-3
"9991","3679新至陞","110/07/12","富邦-新竹華信",40,2,38
"9992","3679新至陞","110/07/12","瑞士信貸",0,45,-45
"9993","3679新至陞","110/07/12","台中銀-員林",28,2,26
"9994","3679新至陞","110/07/12","永豐金-天母",0,39,-39
"9995","3679新至陞","110/07/12","聯邦-大業",24,0,24
"9996","3679新至陞","110/07/12","摩根大通",7,35,-28
"9997","3679新至陞","110/07/12","永豐金證券",20,0,20
"9998","3679新至陞","110/07/12","凱基-台北",8,36,-28
"9999","3679新至陞","110/07/12","港商法國興業",14,0,14
"10000","3679新至陞","110/07/12","華南永昌-小港",1,23,-22
"10001","3679新至陞","110/07/12","日盛-樹林",13,1,12
"10002","3679新至陞","110/07/12","台新-台中",0,15,-15
"10003","3679新至陞","110/07/12","國泰-桃園",9,0,9
"10004","3679新至陞","110/07/12","統一-台中",0,12,-12
"10005","3679新至陞","110/07/12","宏遠-館前",8,0,8
"10006","3679新至陞","110/07/12","元大-成功",1,12,-11
"10007","3679新至陞","110/07/12","凱基",10,2,8
"10008","3679新至陞","110/07/12","康和-澎湖",0,8,-8
"10009","3679新至陞","110/07/12","(牛牛牛)亞-網路",7,0,7
"10010","3679新至陞","110/07/12","新加坡商瑞銀",0,7,-7
"10011","3679新至陞","110/07/12","兆豐-員林",7,0,7
"10012","3679新至陞","110/07/12","兆豐-來福",0,7,-7
"10013","3679新至陞","110/07/12","大慶-蘆洲",5,0,5
"10014","3679新至陞","110/07/12","元大-佳里",0,6,-6
"10015","3679新至陞","110/07/12","土銀-花蓮",4,0,4
"10016","3679新至陞","110/07/12","美商高盛",0,5,-5
"10017","3679新至陞","110/07/12","台新-高雄",5,1,4
"10018","3679新至陞","110/07/12","國票-新莊",0,5,-5
"10019","3679新至陞","110/07/12","元大-天母",4,0,4
"10020","3679新至陞","110/07/12","台新-屏東",0,5,-5
"10021","2727王品","110/07/12","凱基-台北",354,198,156
"10022","2727王品","110/07/12","台灣摩根士丹利",5,386,-381
"10023","2727王品","110/07/12","統一-城中",159,22,137
"10024","2727王品","110/07/12","元大-嘉義",4,60,-56
"10025","2727王品","110/07/12","日盛-忠孝",60,0,60
"10026","2727王品","110/07/12","元大-大同",2,44,-42
"10027","2727王品","110/07/12","永豐金-忠孝",45,5,40
"10028","2727王品","110/07/12","國泰-台中",32,73,-41
"10029","2727王品","110/07/12","合庫-新竹",31,0,31
"10030","2727王品","110/07/12","元大證券",127,163,-36
"10031","2727王品","110/07/12","富邦-台中",31,3,28
"10032","2727王品","110/07/12","凱基",1,33,-32
"10033","2727王品","110/07/12","元大-桃園",35,10,25
"10034","2727王品","110/07/12","永全-南崁",1,31,-30
"10035","2727王品","110/07/12","新加坡商瑞銀",28,4,24
"10036","2727王品","110/07/12","凱基-和平",2,32,-30
"10037","2727王品","110/07/12","群益金鼎-古亭",25,2,23
"10038","2727王品","110/07/12","永豐金-大園",8,38,-30
"10039","2727王品","110/07/12","元大-龍潭",29,7,22
"10040","2727王品","110/07/12","瑞士信貸",0,28,-28
"10041","2727王品","110/07/12","永豐金-永康",25,3,22
"10042","2727王品","110/07/12","元富",17,44,-27
"10043","2727王品","110/07/12","富邦-竹北",24,3,21
"10044","2727王品","110/07/12","元大-北屯",5,32,-27
"10045","2727王品","110/07/12","群益金鼎-松山",20,0,20
"10046","2727王品","110/07/12","華南永昌",3,28,-25
"10047","2727王品","110/07/12","元大-八德",20,0,20
"10048","2727王品","110/07/12","統一-竹南",1,23,-22
"10049","2727王品","110/07/12","元大-南京",25,6,19
"10050","2727王品","110/07/12","永豐金證券",4,26,-22
"10051","1570力肯","110/07/12","國票-北高雄",40,0,40
"10052","1570力肯","110/07/12","日盛-竹北",0,40,-40
"10053","1570力肯","110/07/12","摩根大通",16,0,16
"10054","1570力肯","110/07/12","第一金-華江",1,38,-37
"10055","1570力肯","110/07/12","新光",31,19,12
"10056","1570力肯","110/07/12","元大-永春",0,26,-26
"10057","1570力肯","110/07/12","元大-台中中港",12,0,12
"10058","1570力肯","110/07/12","元大-古亭",1,20,-19
"10059","1570力肯","110/07/12","日盛-高雄",10,0,10
"10060","1570力肯","110/07/12","國泰-松江",0,16,-16
"10061","1570力肯","110/07/12","第一金-路竹",10,0,10
"10062","1570力肯","110/07/12","台新-台南",0,15,-15
"10063","1570力肯","110/07/12","台新-新莊",10,0,10
"10064","1570力肯","110/07/12","康和-石牌",0,15,-15
"10065","1570力肯","110/07/12","元大-新盛",9,0,9
"10066","1570力肯","110/07/12","國泰-板橋",0,11,-11
"10067","1570力肯","110/07/12","凱基-台北",8,0,8
"10068","1570力肯","110/07/12","元大-高雄",0,11,-11
"10069","1570力肯","110/07/12","彰銀-七賢",6,0,6
"10070","1570力肯","110/07/12","兆豐-桃園",0,10,-10
"10071","1570力肯","110/07/12","元富-緯城",6,0,6
"10072","1570力肯","110/07/12","元大-大益",0,10,-10
"10073","1570力肯","110/07/12","華南永昌-古亭",6,0,6
"10074","1570力肯","110/07/12","中國信託-文心",0,5,-5
"10075","1570力肯","110/07/12","富邦-陽明",6,0,6
"10076","1570力肯","110/07/12","光和",0,5,-5
"10077","1570力肯","110/07/12","臺銀-臺南",5,0,5
"10078","1570力肯","110/07/12","陽信-石牌",0,5,-5
"10079","1570力肯","110/07/12","宏遠-館前",5,0,5
"10080","1570力肯","110/07/12","國泰-高雄",0,5,-5
"10081","6180橘子","110/07/12","康和-台中",32,2,30
"10082","6180橘子","110/07/12","新百王",1,40,-39
"10083","6180橘子","110/07/12","美林",32,3,29
"10084","6180橘子","110/07/12","富邦-陽明",4,42,-38
"10085","6180橘子","110/07/12","元大-羅東",21,0,21
"10086","6180橘子","110/07/12","新光",3,32,-29
"10087","6180橘子","110/07/12","兆豐-埔墘",16,0,16
"10088","6180橘子","110/07/12","日盛-文化",4,20,-16
"10089","6180橘子","110/07/12","元大-雙和",12,0,12
"10090","6180橘子","110/07/12","華南永昌-鶯歌",0,15,-15
"10091","6180橘子","110/07/12","美商高盛",18,7,11
"10092","6180橘子","110/07/12","中國信託-忠孝",7,20,-13
"10093","6180橘子","110/07/12","台新證券",14,3,11
"10094","6180橘子","110/07/12","凱基-台北",5,17,-12
"10095","6180橘子","110/07/12","元大-中壢",12,1,11
"10096","6180橘子","110/07/12","凱基-高雄",0,11,-11
"10097","6180橘子","110/07/12","統一-南京",10,0,10
"10098","6180橘子","110/07/12","凱基-大安",0,10,-10
"10099","6180橘子","110/07/12","致和-崇德",10,0,10
"10100","6180橘子","110/07/12","元大-北屯",0,10,-10
"10101","6180橘子","110/07/12","玉山-板橋",10,0,10
"10102","6180橘子","110/07/12","元大-南京",0,9,-9
"10103","6180橘子","110/07/12","富邦-仁愛",10,0,10
"10104","6180橘子","110/07/12","元大-台南",1,10,-9
"10105","6180橘子","110/07/12","摩根大通",10,1,9
"10106","6180橘子","110/07/12","康和-澎湖",0,8,-8
"10107","6180橘子","110/07/12","元富-林園",8,0,8
"10108","6180橘子","110/07/12","第一金-台中",0,7,-7
"10109","6180橘子","110/07/12","大慶-富順",7,0,7
"10110","6180橘子","110/07/12","台新-台南",1,8,-7
"10111","2390云辰","110/07/12","統一-新台中",170,0,170
"10112","2390云辰","110/07/12","元大-天母",2,450,-448
"10113","2390云辰","110/07/12","華南永昌-麻豆",137,2,135
"10114","2390云辰","110/07/12","國泰-忠孝",1,143,-142
"10115","2390云辰","110/07/12","元富-成功",103,14,89
"10116","2390云辰","110/07/12","摩根大通",377,512,-135
"10117","2390云辰","110/07/12","元大-土城學府",146,69,77
"10118","2390云辰","110/07/12","台灣摩根士丹利",0,91,-91
"10119","2390云辰","110/07/12","永豐金-永康",76,4,72
"10120","2390云辰","110/07/12","美林",84,146,-62
"10121","2390云辰","110/07/12","台中銀",73,2,71
"10122","2390云辰","110/07/12","華南永昌-嘉義",2,61,-59
"10123","2390云辰","110/07/12","大昌",63,3,60
"10124","2390云辰","110/07/12","永豐金-羅東",0,49,-49
"10125","2390云辰","110/07/12","合庫-三重",50,0,50
"10126","2390云辰","110/07/12","玉山-台中",6,53,-47
"10127","2390云辰","110/07/12","元富-高雄",93,50,43
"10128","2390云辰","110/07/12","玉山-新莊",2,48,-46
"10129","2390云辰","110/07/12","元大-館前",40,4,36
"10130","2390云辰","110/07/12","元大-大里",7,52,-45
"10131","2390云辰","110/07/12","港商野村",143,109,34
"10132","2390云辰","110/07/12","元大-內湖",3,48,-45
"10133","2390云辰","110/07/12","元大-雙和",34,0,34
"10134","2390云辰","110/07/12","永豐金-市政",1,42,-41
"10135","2390云辰","110/07/12","群益金鼎-民權",33,2,31
"10136","2390云辰","110/07/12","元大-學甲",1,41,-40
"10137","2390云辰","110/07/12","日盛-八德",40,10,30
"10138","2390云辰","110/07/12","兆豐-高雄",2,41,-39
"10139","2390云辰","110/07/12","國票-嘉義",30,0,30
"10140","2390云辰","110/07/12","新加坡商瑞銀",21,59,-38
"10141","4903聯光通","110/07/12","台灣企銀-太平",19,0,19
"10142","4903聯光通","110/07/12","玉山-南京東路",0,16,-16
"10143","4903聯光通","110/07/12","統一-土城",17,0,17
"10144","4903聯光通","110/07/12","新光",0,14,-14
"10145","4903聯光通","110/07/12","國票-博愛",14,0,14
"10146","4903聯光通","110/07/12","兆豐-彰化",0,10,-10
"10147","4903聯光通","110/07/12","新光-台中",15,2,13
"10148","4903聯光通","110/07/12","國票",0,10,-10
"10149","4903聯光通","110/07/12","元大-彰化",11,0,11
"10150","4903聯光通","110/07/12","富邦-敦南",0,10,-10
"10151","4903聯光通","110/07/12","華南永昌-林口",10,0,10
"10152","4903聯光通","110/07/12","元大-前金",0,9,-9
"10153","4903聯光通","110/07/12","永豐金-南投",9,0,9
"10154","4903聯光通","110/07/12","日盛-頭份",0,8,-8
"10155","4903聯光通","110/07/12","元大-清水",8,0,8
"10156","4903聯光通","110/07/12","元大-太平",0,8,-8
"10157","4903聯光通","110/07/12","元大-博愛",8,0,8
"10158","4903聯光通","110/07/12","兆豐-埔墘",0,7,-7
"10159","4903聯光通","110/07/12","玉山-新莊",5,0,5
"10160","4903聯光通","110/07/12","臺銀-民權",0,5,-5
"10161","4903聯光通","110/07/12","凱基-士林",10,5,5
"10162","4903聯光通","110/07/12","富邦-板橋",0,5,-5
"10163","4903聯光通","110/07/12","元大-斗六",4,0,4
"10164","4903聯光通","110/07/12","元大-土城永寧",0,5,-5
"10165","4903聯光通","110/07/12","永豐金-羅東",4,0,4
"10166","4903聯光通","110/07/12","台新證券",0,4,-4
"10167","4903聯光通","110/07/12","日盛-樹林",3,0,3
"10168","4903聯光通","110/07/12","凱基-中壢",0,4,-4
"10169","4903聯光通","110/07/12","華南永昌-鶯歌",2,0,2
"10170","4903聯光通","110/07/12","元大-羅東",0,4,-4
"10171","2929淘帝","110/07/12","新光-台中",95,36,59
"10172","2929淘帝","110/07/12","華南永昌-林口",7,208,-201
"10173","2929淘帝","110/07/12","富邦-板橋",62,5,57
"10174","2929淘帝","110/07/12","富邦-台北",6,200,-194
"10175","2929淘帝","110/07/12","合庫-高雄",56,6,50
"10176","2929淘帝","110/07/12","元富-大裕",11,200,-189
"10177","2929淘帝","110/07/12","永興",41,0,41
"10178","2929淘帝","110/07/12","台中銀-台北",0,160,-160
"10179","2929淘帝","110/07/12","兆豐-忠孝",58,18,40
"10180","2929淘帝","110/07/12","日盛-園區",1,111,-110
"10181","2929淘帝","110/07/12","新光-高雄",39,3,36
"10182","2929淘帝","110/07/12","日盛-八德",0,88,-88
"10183","2929淘帝","110/07/12","凱基-豐中",36,0,36
"10184","2929淘帝","110/07/12","玉山-新竹",32,110,-78
"10185","2929淘帝","110/07/12","元大-民生",35,0,35
"10186","2929淘帝","110/07/12","元大-前金",0,72,-72
"10187","2929淘帝","110/07/12","臺銀-臺南",32,1,31
"10188","2929淘帝","110/07/12","元大-館前",12,83,-71
"10189","2929淘帝","110/07/12","台新證券",44,13,31
"10190","2929淘帝","110/07/12","華南永昌",1,57,-56
"10191","2929淘帝","110/07/12","新百王",30,0,30
"10192","2929淘帝","110/07/12","元大-南崁",4,59,-55
"10193","2929淘帝","110/07/12","群益金鼎-大興",30,0,30
"10194","2929淘帝","110/07/12","元大-嘉義",0,51,-51
"10195","2929淘帝","110/07/12","凱基-台北",32,5,27
"10196","2929淘帝","110/07/12","日茂",1,50,-49
"10197","2929淘帝","110/07/12","元富-城東",26,0,26
"10198","2929淘帝","110/07/12","新光",35,83,-48
"10199","2929淘帝","110/07/12","國泰-松江",26,0,26
"10200","2929淘帝","110/07/12","日盛-新竹",1,48,-47
"10201","5410國眾","110/07/12","群益金鼎-中壢",68,0,68
"10202","5410國眾","110/07/12","摩根大通",6,67,-61
"10203","5410國眾","110/07/12","凱基-市政",40,0,40
"10204","5410國眾","110/07/12","元富-嘉義",0,60,-60
"10205","5410國眾","110/07/12","凱基-竹北",38,0,38
"10206","5410國眾","110/07/12","凱基-台北",0,51,-51
"10207","5410國眾","110/07/12","華南永昌-三重",30,0,30
"10208","5410國眾","110/07/12","元富-大裕",0,33,-33
"10209","5410國眾","110/07/12","永興",20,0,20
"10210","5410國眾","110/07/12","日盛-木柵",0,15,-15
"10211","5410國眾","110/07/12","統一-新台中",20,0,20
"10212","5410國眾","110/07/12","群益金鼎-民權",0,15,-15
"10213","5410國眾","110/07/12","兆豐-三重",20,0,20
"10214","5410國眾","110/07/12","元富-緯城",0,14,-14
"10215","5410國眾","110/07/12","富邦-台中",20,0,20
"10216","5410國眾","110/07/12","元大-大同",0,12,-12
"10217","5410國眾","110/07/12","臺銀",15,0,15
"10218","5410國眾","110/07/12","元大-莒光",0,10,-10
"10219","5410國眾","110/07/12","新光-桃園",20,6,14
"10220","5410國眾","110/07/12","元大-博愛",0,10,-10
"10221","5410國眾","110/07/12","元大-員林",12,0,12
"10222","5410國眾","110/07/12","日盛-永康",0,8,-8
"10223","5410國眾","110/07/12","日盛-員林",10,0,10
"10224","5410國眾","110/07/12","元大-四維",5,13,-8
"10225","5410國眾","110/07/12","元大-新盛",10,0,10
"10226","5410國眾","110/07/12","新加坡商瑞銀",0,7,-7
"10227","5410國眾","110/07/12","永豐金-台南",10,0,10
"10228","5410國眾","110/07/12","致和-金華",0,7,-7
"10229","5410國眾","110/07/12","元富-新莊",8,0,8
"10230","5410國眾","110/07/12","新光-新竹",0,7,-7
"10231","2841台開","110/07/12","永豐金-敦南",139,26,113
"10232","2841台開","110/07/12","華南永昌-朴子",0,528,-528
"10233","2841台開","110/07/12","日盛-雙和",68,0,68
"10234","2841台開","110/07/12","元大-苑裡",2,50,-48
"10235","2841台開","110/07/12","台新證券",62,4,58
"10236","2841台開","110/07/12","群益金鼎-東湖",0,40,-40
"10237","2841台開","110/07/12","凱基-文心",50,0,50
"10238","2841台開","110/07/12","第一金-員林",0,30,-30
"10239","2841台開","110/07/12","第一金-台中",45,0,45
"10240","2841台開","110/07/12","德信-中正",0,20,-20
"10241","2841台開","110/07/12","富邦-嘉義",40,0,40
"10242","2841台開","110/07/12","兆豐-嘉義",0,20,-20
"10243","2841台開","110/07/12","日盛-木柵",30,0,30
"10244","2841台開","110/07/12","彰銀-七賢",0,15,-15
"10245","2841台開","110/07/12","中國信託-文心",31,3,28
"10246","2841台開","110/07/12","元大-承德",0,14,-14
"10247","2841台開","110/07/12","元大-福營",30,7,23
"10248","2841台開","110/07/12","元富",0,12,-12
"10249","2841台開","110/07/12","台中銀",20,0,20
"10250","2841台開","110/07/12","富邦-陽明",0,11,-11
"10251","2841台開","110/07/12","國泰-板橋",20,0,20
"10252","2841台開","110/07/12","元大證券",0,11,-11
"10253","2841台開","110/07/12","元大-前金",20,0,20
"10254","2841台開","110/07/12","元大-大甲",0,10,-10
"10255","2841台開","110/07/12","中國信託-高雄",16,1,15
"10256","2841台開","110/07/12","日盛-新竹",0,8,-8
"10257","2841台開","110/07/12","陽信-石牌",15,0,15
"10258","2841台開","110/07/12","元富-城東",0,8,-8
"10259","2841台開","110/07/12","永豐金-南投",15,0,15
"10260","2841台開","110/07/12","玉山-台南",2,10,-8
"10261","6207雷科","110/07/12","元大-高雄",34,0,34
"10262","6207雷科","110/07/12","永豐金-三重",1,32,-31
"10263","6207雷科","110/07/12","華南永昌-林口",16,1,15
"10264","6207雷科","110/07/12","永全-八德",0,30,-30
"10265","6207雷科","110/07/12","摩根大通",19,6,13
"10266","6207雷科","110/07/12","國泰-台中",0,14,-14
"10267","6207雷科","110/07/12","元富-埔里",10,0,10
"10268","6207雷科","110/07/12","第一金-澎湖",0,10,-10
"10269","6207雷科","110/07/12","凱基-台南",10,0,10
"10270","6207雷科","110/07/12","元富-林園",0,10,-10
"10271","6207雷科","110/07/12","新加坡商瑞銀",9,0,9
"10272","6207雷科","110/07/12","元大-東門",0,10,-10
"10273","6207雷科","110/07/12","瑞士信貸",8,0,8
"10274","6207雷科","110/07/12","兆豐-嘉義",0,4,-4
"10275","6207雷科","110/07/12","中國信託-高雄",9,1,8
"10276","6207雷科","110/07/12","新光",0,4,-4
"10277","6207雷科","110/07/12","凱基-高雄",6,0,6
"10278","6207雷科","110/07/12","新光-台中",0,4,-4
"10279","6207雷科","110/07/12","元大-六合",6,0,6
"10280","6207雷科","110/07/12","群益金鼎-開元",0,4,-4
"10281","6207雷科","110/07/12","永豐金-信義",6,0,6
"10282","6207雷科","110/07/12","凱基-桃園",0,4,-4
"10283","6207雷科","110/07/12","群益金鼎-土城",5,0,5
"10284","6207雷科","110/07/12","凱基-民權",0,4,-4
"10285","6207雷科","110/07/12","群益金鼎-竹南",5,0,5
"10286","6207雷科","110/07/12","玉山-新莊",0,3,-3
"10287","6207雷科","110/07/12","元大-大灣",5,1,4
"10288","6207雷科","110/07/12","國泰-松江",0,3,-3
"10289","6207雷科","110/07/12","永興",3,0,3
"10290","6207雷科","110/07/12","富邦-羅東",0,3,-3
"10291","3679新至陞","110/07/12","富邦-新竹華信",40,2,38
"10292","3679新至陞","110/07/12","瑞士信貸",0,45,-45
"10293","3679新至陞","110/07/12","台中銀-員林",28,2,26
"10294","3679新至陞","110/07/12","永豐金-天母",0,39,-39
"10295","3679新至陞","110/07/12","聯邦-大業",24,0,24
"10296","3679新至陞","110/07/12","摩根大通",7,35,-28
"10297","3679新至陞","110/07/12","永豐金證券",20,0,20
"10298","3679新至陞","110/07/12","凱基-台北",8,36,-28
"10299","3679新至陞","110/07/12","港商法國興業",14,0,14
"10300","3679新至陞","110/07/12","華南永昌-小港",1,23,-22
"10301","3679新至陞","110/07/12","日盛-樹林",13,1,12
"10302","3679新至陞","110/07/12","台新-台中",0,15,-15
"10303","3679新至陞","110/07/12","國泰-桃園",9,0,9
"10304","3679新至陞","110/07/12","統一-台中",0,12,-12
"10305","3679新至陞","110/07/12","宏遠-館前",8,0,8
"10306","3679新至陞","110/07/12","元大-成功",1,12,-11
"10307","3679新至陞","110/07/12","凱基",10,2,8
"10308","3679新至陞","110/07/12","康和-澎湖",0,8,-8
"10309","3679新至陞","110/07/12","(牛牛牛)亞-網路",7,0,7
"10310","3679新至陞","110/07/12","新加坡商瑞銀",0,7,-7
"10311","3679新至陞","110/07/12","兆豐-員林",7,0,7
"10312","3679新至陞","110/07/12","兆豐-來福",0,7,-7
"10313","3679新至陞","110/07/12","大慶-蘆洲",5,0,5
"10314","3679新至陞","110/07/12","元大-佳里",0,6,-6
"10315","3679新至陞","110/07/12","土銀-花蓮",4,0,4
"10316","3679新至陞","110/07/12","美商高盛",0,5,-5
"10317","3679新至陞","110/07/12","台新-高雄",5,1,4
"10318","3679新至陞","110/07/12","國票-新莊",0,5,-5
"10319","3679新至陞","110/07/12","元大-天母",4,0,4
"10320","3679新至陞","110/07/12","台新-屏東",0,5,-5
"10321","2727王品","110/07/12","凱基-台北",354,198,156
"10322","2727王品","110/07/12","台灣摩根士丹利",5,386,-381
"10323","2727王品","110/07/12","統一-城中",159,22,137
"10324","2727王品","110/07/12","元大-嘉義",4,60,-56
"10325","2727王品","110/07/12","日盛-忠孝",60,0,60
"10326","2727王品","110/07/12","元大-大同",2,44,-42
"10327","2727王品","110/07/12","永豐金-忠孝",45,5,40
"10328","2727王品","110/07/12","國泰-台中",32,73,-41
"10329","2727王品","110/07/12","合庫-新竹",31,0,31
"10330","2727王品","110/07/12","元大證券",127,163,-36
"10331","2727王品","110/07/12","富邦-台中",31,3,28
"10332","2727王品","110/07/12","凱基",1,33,-32
"10333","2727王品","110/07/12","元大-桃園",35,10,25
"10334","2727王品","110/07/12","永全-南崁",1,31,-30
"10335","2727王品","110/07/12","新加坡商瑞銀",28,4,24
"10336","2727王品","110/07/12","凱基-和平",2,32,-30
"10337","2727王品","110/07/12","群益金鼎-古亭",25,2,23
"10338","2727王品","110/07/12","永豐金-大園",8,38,-30
"10339","2727王品","110/07/12","元大-龍潭",29,7,22
"10340","2727王品","110/07/12","瑞士信貸",0,28,-28
"10341","2727王品","110/07/12","永豐金-永康",25,3,22
"10342","2727王品","110/07/12","元富",17,44,-27
"10343","2727王品","110/07/12","富邦-竹北",24,3,21
"10344","2727王品","110/07/12","元大-北屯",5,32,-27
"10345","2727王品","110/07/12","群益金鼎-松山",20,0,20
"10346","2727王品","110/07/12","華南永昌",3,28,-25
"10347","2727王品","110/07/12","元大-八德",20,0,20
"10348","2727王品","110/07/12","統一-竹南",1,23,-22
"10349","2727王品","110/07/12","元大-南京",25,6,19
"10350","2727王品","110/07/12","永豐金證券",4,26,-22
"10351","1570力肯","110/07/12","國票-北高雄",40,0,40
"10352","1570力肯","110/07/12","日盛-竹北",0,40,-40
"10353","1570力肯","110/07/12","摩根大通",16,0,16
"10354","1570力肯","110/07/12","第一金-華江",1,38,-37
"10355","1570力肯","110/07/12","新光",31,19,12
"10356","1570力肯","110/07/12","元大-永春",0,26,-26
"10357","1570力肯","110/07/12","元大-台中中港",12,0,12
"10358","1570力肯","110/07/12","元大-古亭",1,20,-19
"10359","1570力肯","110/07/12","日盛-高雄",10,0,10
"10360","1570力肯","110/07/12","國泰-松江",0,16,-16
"10361","1570力肯","110/07/12","第一金-路竹",10,0,10
"10362","1570力肯","110/07/12","台新-台南",0,15,-15
"10363","1570力肯","110/07/12","台新-新莊",10,0,10
"10364","1570力肯","110/07/12","康和-石牌",0,15,-15
"10365","1570力肯","110/07/12","元大-新盛",9,0,9
"10366","1570力肯","110/07/12","國泰-板橋",0,11,-11
"10367","1570力肯","110/07/12","凱基-台北",8,0,8
"10368","1570力肯","110/07/12","元大-高雄",0,11,-11
"10369","1570力肯","110/07/12","彰銀-七賢",6,0,6
"10370","1570力肯","110/07/12","兆豐-桃園",0,10,-10
"10371","1570力肯","110/07/12","元富-緯城",6,0,6
"10372","1570力肯","110/07/12","元大-大益",0,10,-10
"10373","1570力肯","110/07/12","華南永昌-古亭",6,0,6
"10374","1570力肯","110/07/12","中國信託-文心",0,5,-5
"10375","1570力肯","110/07/12","富邦-陽明",6,0,6
"10376","1570力肯","110/07/12","光和",0,5,-5
"10377","1570力肯","110/07/12","臺銀-臺南",5,0,5
"10378","1570力肯","110/07/12","陽信-石牌",0,5,-5
"10379","1570力肯","110/07/12","宏遠-館前",5,0,5
"10380","1570力肯","110/07/12","國泰-高雄",0,5,-5
"10381","6180橘子","110/07/12","康和-台中",32,2,30
"10382","6180橘子","110/07/12","新百王",1,40,-39
"10383","6180橘子","110/07/12","美林",32,3,29
"10384","6180橘子","110/07/12","富邦-陽明",4,42,-38
"10385","6180橘子","110/07/12","元大-羅東",21,0,21
"10386","6180橘子","110/07/12","新光",3,32,-29
"10387","6180橘子","110/07/12","兆豐-埔墘",16,0,16
"10388","6180橘子","110/07/12","日盛-文化",4,20,-16
"10389","6180橘子","110/07/12","元大-雙和",12,0,12
"10390","6180橘子","110/07/12","華南永昌-鶯歌",0,15,-15
"10391","6180橘子","110/07/12","美商高盛",18,7,11
"10392","6180橘子","110/07/12","中國信託-忠孝",7,20,-13
"10393","6180橘子","110/07/12","台新證券",14,3,11
"10394","6180橘子","110/07/12","凱基-台北",5,17,-12
"10395","6180橘子","110/07/12","元大-中壢",12,1,11
"10396","6180橘子","110/07/12","凱基-高雄",0,11,-11
"10397","6180橘子","110/07/12","統一-南京",10,0,10
"10398","6180橘子","110/07/12","凱基-大安",0,10,-10
"10399","6180橘子","110/07/12","致和-崇德",10,0,10
"10400","6180橘子","110/07/12","元大-北屯",0,10,-10
"10401","6180橘子","110/07/12","玉山-板橋",10,0,10
"10402","6180橘子","110/07/12","元大-南京",0,9,-9
"10403","6180橘子","110/07/12","富邦-仁愛",10,0,10
"10404","6180橘子","110/07/12","元大-台南",1,10,-9
"10405","6180橘子","110/07/12","摩根大通",10,1,9
"10406","6180橘子","110/07/12","康和-澎湖",0,8,-8
"10407","6180橘子","110/07/12","元富-林園",8,0,8
"10408","6180橘子","110/07/12","第一金-台中",0,7,-7
"10409","6180橘子","110/07/12","大慶-富順",7,0,7
"10410","6180橘子","110/07/12","台新-台南",1,8,-7
"10411","2390云辰","110/07/12","統一-新台中",170,0,170
"10412","2390云辰","110/07/12","元大-天母",2,450,-448
"10413","2390云辰","110/07/12","華南永昌-麻豆",137,2,135
"10414","2390云辰","110/07/12","國泰-忠孝",1,143,-142
"10415","2390云辰","110/07/12","元富-成功",103,14,89
"10416","2390云辰","110/07/12","摩根大通",377,512,-135
"10417","2390云辰","110/07/12","元大-土城學府",146,69,77
"10418","2390云辰","110/07/12","台灣摩根士丹利",0,91,-91
"10419","2390云辰","110/07/12","永豐金-永康",76,4,72
"10420","2390云辰","110/07/12","美林",84,146,-62
"10421","2390云辰","110/07/12","台中銀",73,2,71
"10422","2390云辰","110/07/12","華南永昌-嘉義",2,61,-59
"10423","2390云辰","110/07/12","大昌",63,3,60
"10424","2390云辰","110/07/12","永豐金-羅東",0,49,-49
"10425","2390云辰","110/07/12","合庫-三重",50,0,50
"10426","2390云辰","110/07/12","玉山-台中",6,53,-47
"10427","2390云辰","110/07/12","元富-高雄",93,50,43
"10428","2390云辰","110/07/12","玉山-新莊",2,48,-46
"10429","2390云辰","110/07/12","元大-館前",40,4,36
"10430","2390云辰","110/07/12","元大-大里",7,52,-45
"10431","2390云辰","110/07/12","港商野村",143,109,34
"10432","2390云辰","110/07/12","元大-內湖",3,48,-45
"10433","2390云辰","110/07/12","元大-雙和",34,0,34
"10434","2390云辰","110/07/12","永豐金-市政",1,42,-41
"10435","2390云辰","110/07/12","群益金鼎-民權",33,2,31
"10436","2390云辰","110/07/12","元大-學甲",1,41,-40
"10437","2390云辰","110/07/12","日盛-八德",40,10,30
"10438","2390云辰","110/07/12","兆豐-高雄",2,41,-39
"10439","2390云辰","110/07/12","國票-嘉義",30,0,30
"10440","2390云辰","110/07/12","新加坡商瑞銀",21,59,-38
"10441","4903聯光通","110/07/09","元大-敦南",10,0,10
"10442","4903聯光通","110/07/09","第一金-台中",0,12,-12
"10443","4903聯光通","110/07/09","凱基-士林",5,0,5
"10444","4903聯光通","110/07/09","日盛-忠孝",0,3,-3
"10445","4903聯光通","110/07/09","元大-苗栗",5,0,5
"10446","4903聯光通","110/07/09","群益金鼎-崇德",0,3,-3
"10447","4903聯光通","110/07/09","元大-屏南",3,0,3
"10448","4903聯光通","110/07/09","國票-內壢",0,2,-2
"10449","4903聯光通","110/07/09","中國信託-永康",1,0,1
"10450","4903聯光通","110/07/09","康和-南崁",0,2,-2
"10451","4903聯光通","110/07/09","玉山證券",1,0,1
"10452","4903聯光通","110/07/09","新光-台中",0,2,-2
"10453","4903聯光通","110/07/09","元大-太平",4,3,1
"10454","4903聯光通","110/07/09","玉山-城中",0,2,-2
"10455","4903聯光通","110/07/09","永豐金-嘉義",1,0,1
"10456","4903聯光通","110/07/09","中國信託-文心",0,1,-1
"10457","4903聯光通","110/07/09","大昌",0,0,0
"10458","4903聯光通","110/07/09","大昌",0,0,0
"10459","4903聯光通","110/07/09","中農",0,0,0
"10460","4903聯光通","110/07/09","中農",0,0,0
"10461","4903聯光通","110/07/09","",NA,NA,NA
"10462","4903聯光通","110/07/09","",NA,NA,NA
"10463","4903聯光通","110/07/09","",NA,NA,NA
"10464","4903聯光通","110/07/09","",NA,NA,NA
"10465","4903聯光通","110/07/09","",NA,NA,NA
"10466","4903聯光通","110/07/09","",NA,NA,NA
"10467","4903聯光通","110/07/09","",NA,NA,NA
"10468","4903聯光通","110/07/09","",NA,NA,NA
"10469","4903聯光通","110/07/09","",NA,NA,NA
"10470","4903聯光通","110/07/09","",NA,NA,NA
"10471","2929淘帝","110/07/09","台中銀-台北",110,0,110
"10472","2929淘帝","110/07/09","新光",2,82,-80
"10473","2929淘帝","110/07/09","華南永昌-頭份",72,0,72
"10474","2929淘帝","110/07/09","摩根大通",2,63,-61
"10475","2929淘帝","110/07/09","合庫-高雄",71,0,71
"10476","2929淘帝","110/07/09","第一金-路竹",0,50,-50
"10477","2929淘帝","110/07/09","高橋-龍潭",37,0,37
"10478","2929淘帝","110/07/09","港商麥格理",0,42,-42
"10479","2929淘帝","110/07/09","新光-台中",60,26,34
"10480","2929淘帝","110/07/09","陽信-石牌",0,40,-40
"10481","2929淘帝","110/07/09","元富-大裕",22,1,21
"10482","2929淘帝","110/07/09","台新-左楠",1,39,-38
"10483","2929淘帝","110/07/09","合庫-鳳山",20,0,20
"10484","2929淘帝","110/07/09","凱基-桃園",3,29,-26
"10485","2929淘帝","110/07/09","元大-員林",22,2,20
"10486","2929淘帝","110/07/09","兆豐-內湖",0,25,-25
"10487","2929淘帝","110/07/09","台新-建北",15,0,15
"10488","2929淘帝","110/07/09","元大-北港",0,20,-20
"10489","2929淘帝","110/07/09","兆豐-桃園",13,0,13
"10490","2929淘帝","110/07/09","富邦-北港",0,19,-19
"10491","2929淘帝","110/07/09","兆豐-忠孝",10,0,10
"10492","2929淘帝","110/07/09","富邦-花蓮",0,17,-17
"10493","2929淘帝","110/07/09","國票-敦北法人",10,0,10
"10494","2929淘帝","110/07/09","國泰-台中",2,17,-15
"10495","2929淘帝","110/07/09","永豐金-博愛",10,0,10
"10496","2929淘帝","110/07/09","群益金鼎-彰化",0,15,-15
"10497","2929淘帝","110/07/09","群益金鼎-潭子",8,0,8
"10498","2929淘帝","110/07/09","元大-博愛",0,14,-14
"10499","2929淘帝","110/07/09","富邦-南屯",8,0,8
"10500","2929淘帝","110/07/09","日盛-板橋",0,13,-13
"10501","5410國眾","110/07/09","元大-新盛",14,0,14
"10502","5410國眾","110/07/09","(牛牛牛)亞-鑫豐",1,41,-40
"10503","5410國眾","110/07/09","台灣企銀-民雄",10,0,10
"10504","5410國眾","110/07/09","元富-嘉義",0,25,-25
"10505","5410國眾","110/07/09","元富-虎尾",9,0,9
"10506","5410國眾","110/07/09","凱基-高美館",0,10,-10
"10507","5410國眾","110/07/09","摩根大通",10,1,9
"10508","5410國眾","110/07/09","凱基-城中",0,10,-10
"10509","5410國眾","110/07/09","兆豐-北高雄",7,0,7
"10510","5410國眾","110/07/09","元大-頭份",0,10,-10
"10511","5410國眾","110/07/09","凱基-台北",8,1,7
"10512","5410國眾","110/07/09","群益金鼎-丹鳳",0,7,-7
"10513","5410國眾","110/07/09","華南永昌-公誠",7,0,7
"10514","5410國眾","110/07/09","凱基-復興",0,7,-7
"10515","5410國眾","110/07/09","香港上海匯豐",6,0,6
"10516","5410國眾","110/07/09","元大-員林",0,7,-7
"10517","5410國眾","110/07/09","凱基-中壢",6,0,6
"10518","5410國眾","110/07/09","富邦-竹東",0,6,-6
"10519","5410國眾","110/07/09","華南永昌-南京",6,0,6
"10520","5410國眾","110/07/09","亞東-高雄",0,5,-5
"10521","5410國眾","110/07/09","統一-三重",5,0,5
"10522","5410國眾","110/07/09","大慶-中壢",1,6,-5
"10523","5410國眾","110/07/09","富邦-宜蘭",5,0,5
"10524","5410國眾","110/07/09","群益金鼎-中港",0,5,-5
"10525","5410國眾","110/07/09","元大-崇德",5,0,5
"10526","5410國眾","110/07/09","元大-八德",0,5,-5
"10527","5410國眾","110/07/09","元大-博愛",5,0,5
"10528","5410國眾","110/07/09","富邦-基隆",0,4,-4
"10529","5410國眾","110/07/09","元大-龍潭",5,0,5
"10530","5410國眾","110/07/09","臺銀-新竹",0,3,-3
"10531","2841台開","110/07/09","日盛-雙和",102,0,102
"10532","2841台開","110/07/09","港商野村",0,129,-129
"10533","2841台開","110/07/09","元大-館前",70,0,70
"10534","2841台開","110/07/09","兆豐-永和",0,100,-100
"10535","2841台開","110/07/09","凱基-文心",50,0,50
"10536","2841台開","110/07/09","台新證券",7,28,-21
"10537","2841台開","110/07/09","富邦-嘉義",40,0,40
"10538","2841台開","110/07/09","國票-北高雄",0,20,-20
"10539","2841台開","110/07/09","美商高盛",15,0,15
"10540","2841台開","110/07/09","永豐金-敦南",29,46,-17
"10541","2841台開","110/07/09","台中銀",15,0,15
"10542","2841台開","110/07/09","合庫-基隆",0,12,-12
"10543","2841台開","110/07/09","新光",11,0,11
"10544","2841台開","110/07/09","中國信託-松江",0,12,-12
"10545","2841台開","110/07/09","華南永昌-長虹",10,0,10
"10546","2841台開","110/07/09","兆豐-城中",0,12,-12
"10547","2841台開","110/07/09","永豐金-南投",10,0,10
"10548","2841台開","110/07/09","台中銀-豐原",0,10,-10
"10549","2841台開","110/07/09","合庫-桃園",7,0,7
"10550","2841台開","110/07/09","兆豐-景美",0,10,-10
"10551","2841台開","110/07/09","群益金鼎-古亭",7,0,7
"10552","2841台開","110/07/09","群益金鼎-基隆",0,10,-10
"10553","2841台開","110/07/09","國泰-敦南",6,0,6
"10554","2841台開","110/07/09","元大-北三重",0,10,-10
"10555","2841台開","110/07/09","凱基-桃園",8,2,6
"10556","2841台開","110/07/09","(牛牛牛)亞-網路",0,9,-9
"10557","2841台開","110/07/09","日盛證券",5,0,5
"10558","2841台開","110/07/09","台新-高雄",1,10,-9
"10559","2841台開","110/07/09","元富-文心",5,0,5
"10560","2841台開","110/07/09","凱基-台北",0,7,-7
"10561","6207雷科","110/07/09","群益金鼎-新竹",47,0,47
"10562","6207雷科","110/07/09","新光",7,24,-17
"10563","6207雷科","110/07/09","永豐金-三重",31,0,31
"10564","6207雷科","110/07/09","日盛-和美",0,15,-15
"10565","6207雷科","110/07/09","新加坡商瑞銀",33,5,28
"10566","6207雷科","110/07/09","國泰-台南",0,15,-15
"10567","6207雷科","110/07/09","元大-高雄",26,0,26
"10568","6207雷科","110/07/09","華南永昌-古亭",0,14,-14
"10569","6207雷科","110/07/09","統一-員林",22,0,22
"10570","6207雷科","110/07/09","土銀-白河",0,11,-11
"10571","6207雷科","110/07/09","台新-高雄",22,0,22
"10572","6207雷科","110/07/09","日盛-台南",0,10,-10
"10573","6207雷科","110/07/09","摩根大通",34,17,17
"10574","6207雷科","110/07/09","元富-林園",0,10,-10
"10575","6207雷科","110/07/09","元大-博愛",17,1,16
"10576","6207雷科","110/07/09","富邦-園區",0,10,-10
"10577","6207雷科","110/07/09","日茂-埔里",12,0,12
"10578","6207雷科","110/07/09","元大-上新莊",0,10,-10
"10579","6207雷科","110/07/09","國泰-台中",17,6,11
"10580","6207雷科","110/07/09","永豐金-南京",0,10,-10
"10581","6207雷科","110/07/09","富邦-三重",10,0,10
"10582","6207雷科","110/07/09","兆豐-小港",0,6,-6
"10583","6207雷科","110/07/09","元大-沙鹿",10,0,10
"10584","6207雷科","110/07/09","富邦-羅東",1,7,-6
"10585","6207雷科","110/07/09","元大-八德",10,0,10
"10586","6207雷科","110/07/09","元大-土城永寧",0,6,-6
"10587","6207雷科","110/07/09","第一金-路竹",11,2,9
"10588","6207雷科","110/07/09","永豐金-板盛",0,6,-6
"10589","6207雷科","110/07/09","統一-南京",5,0,5
"10590","6207雷科","110/07/09","日盛-板橋",0,5,-5
"10591","3679新至陞","110/07/09","元大-大天母",10,0,10
"10592","3679新至陞","110/07/09","第一金-光復",0,11,-11
"10593","3679新至陞","110/07/09","日盛-樹林",9,0,9
"10594","3679新至陞","110/07/09","瑞士信貸",0,8,-8
"10595","3679新至陞","110/07/09","凱基-台北",11,2,9
"10596","3679新至陞","110/07/09","大慶-苗栗",0,5,-5
"10597","3679新至陞","110/07/09","華南永昌-小港",8,0,8
"10598","3679新至陞","110/07/09","元大-永春",0,5,-5
"10599","3679新至陞","110/07/09","兆豐-來福",7,0,7
"10600","3679新至陞","110/07/09","日盛-和美",0,4,-4
"10601","3679新至陞","110/07/09","香港上海匯豐",5,0,5
"10602","3679新至陞","110/07/09","元大-雙和",0,3,-3
"10603","3679新至陞","110/07/09","台中銀-員林",3,0,3
"10604","3679新至陞","110/07/09","永豐金-屏東",0,3,-3
"10605","3679新至陞","110/07/09","新光",3,0,3
"10606","3679新至陞","110/07/09","彰銀",0,2,-2
"10607","3679新至陞","110/07/09","土銀-花蓮",2,0,2
"10608","3679新至陞","110/07/09","宏遠-館前",0,2,-2
"10609","3679新至陞","110/07/09","第一金-澎湖",2,0,2
"10610","3679新至陞","110/07/09","港商野村",0,2,-2
"10611","3679新至陞","110/07/09","摩根大通",2,0,2
"10612","3679新至陞","110/07/09","大昌-新店",0,2,-2
"10613","3679新至陞","110/07/09","國泰-敦南",2,0,2
"10614","3679新至陞","110/07/09","元大-新莊",0,2,-2
"10615","3679新至陞","110/07/09","元大-淡水",4,2,2
"10616","3679新至陞","110/07/09","元大-板橋",0,2,-2
"10617","3679新至陞","110/07/09","日盛-士林",1,0,1
"10618","3679新至陞","110/07/09","台灣摩根士丹利",0,1,-1
"10619","3679新至陞","110/07/09","日盛-信義",1,0,1
"10620","3679新至陞","110/07/09","第一金-高雄",0,1,-1
"10621","2727王品","110/07/09","台灣匯立證券",90,0,90
"10622","2727王品","110/07/09","台灣摩根士丹利",0,267,-267
"10623","2727王品","110/07/09","國泰-敦南",166,84,82
"10624","2727王品","110/07/09","富邦-台北",35,299,-264
"10625","2727王品","110/07/09","富邦-仁愛",56,12,44
"10626","2727王品","110/07/09","凱基-台北",174,296,-122
"10627","2727王品","110/07/09","台新證券",109,66,43
"10628","2727王品","110/07/09","第一金",2,102,-100
"10629","2727王品","110/07/09","新光",117,87,30
"10630","2727王品","110/07/09","群益金鼎-大安",0,80,-80
"10631","2727王品","110/07/09","臺銀-臺中",35,6,29
"10632","2727王品","110/07/09","兆豐-大安",7,60,-53
"10633","2727王品","110/07/09","元大-桃園",32,3,29
"10634","2727王品","110/07/09","永豐金-南投",0,50,-50
"10635","2727王品","110/07/09","元富-宜蘭",34,6,28
"10636","2727王品","110/07/09","新加坡商瑞銀",6,46,-40
"10637","2727王品","110/07/09","玉山-台中",34,8,26
"10638","2727王品","110/07/09","合庫-彰化",11,50,-39
"10639","2727王品","110/07/09","群益金鼎-宜蘭",30,4,26
"10640","2727王品","110/07/09","永豐金-萬盛",13,52,-39
"10641","2727王品","110/07/09","富邦-台中",42,16,26
"10642","2727王品","110/07/09","瑞士信貸",0,34,-34
"10643","2727王品","110/07/09","第一金-豐原",25,1,24
"10644","2727王品","110/07/09","元大-和平",4,35,-31
"10645","2727王品","110/07/09","臺銀",30,8,22
"10646","2727王品","110/07/09","美林",14,44,-30
"10647","2727王品","110/07/09","兆豐-來福",23,1,22
"10648","2727王品","110/07/09","元大-員林",9,38,-29
"10649","2727王品","110/07/09","玉山-士林",22,2,20
"10650","2727王品","110/07/09","元富-西松",4,31,-27
"10651","1570力肯","110/07/09","凱基-台北",30,1,29
"10652","1570力肯","110/07/09","群益金鼎-彰化",0,20,-20
"10653","1570力肯","110/07/09","新光-台南",20,0,20
"10654","1570力肯","110/07/09","元大-土城學府",0,20,-20
"10655","1570力肯","110/07/09","元大-高雄",20,0,20
"10656","1570力肯","110/07/09","元大-大統",0,16,-16
"10657","1570力肯","110/07/09","國票-中正",12,0,12
"10658","1570力肯","110/07/09","元大-新營",0,11,-11
"10659","1570力肯","110/07/09","日盛-高雄",6,0,6
"10660","1570力肯","110/07/09","元大-和平",0,10,-10
"10661","1570力肯","110/07/09","元富-緯城",6,0,6
"10662","1570力肯","110/07/09","元大-草屯",0,10,-10
"10663","1570力肯","110/07/09","群益金鼎-台南",6,0,6
"10664","1570力肯","110/07/09","元大-鹿港",0,9,-9
"10665","1570力肯","110/07/09","華南永昌-岡山",6,0,6
"10666","1570力肯","110/07/09","合庫-基隆",0,7,-7
"10667","1570力肯","110/07/09","統一-中壢",5,0,5
"10668","1570力肯","110/07/09","摩根大通",2,8,-6
"10669","1570力肯","110/07/09","凱基-三峽",5,0,5
"10670","1570力肯","110/07/09","台灣企銀-豐原",0,4,-4
"10671","1570力肯","110/07/09","大昌-樹林",4,0,4
"10672","1570力肯","110/07/09","日盛-桃園",0,4,-4
"10673","1570力肯","110/07/09","新光",3,0,3
"10674","1570力肯","110/07/09","國泰-高雄",0,3,-3
"10675","1570力肯","110/07/09","富邦-新竹華信",3,0,3
"10676","1570力肯","110/07/09","永豐金-敦南",0,3,-3
"10677","1570力肯","110/07/09","合庫-台中",2,0,2
"10678","1570力肯","110/07/09","土銀-彰化",0,2,-2
"10679","1570力肯","110/07/09","臺銀-臺中",2,0,2
"10680","1570力肯","110/07/09","臺銀-鳳山",0,2,-2
"10681","6180橘子","110/07/09","摩根大通",63,1,62
"10682","6180橘子","110/07/09","元大-南京",1,32,-31
"10683","6180橘子","110/07/09","富邦-陽明",73,33,40
"10684","6180橘子","110/07/09","群益金鼎-台北",0,25,-25
"10685","6180橘子","110/07/09","新加坡商瑞銀",31,0,31
"10686","6180橘子","110/07/09","兆豐-復興",0,21,-21
"10687","6180橘子","110/07/09","美商高盛",25,0,25
"10688","6180橘子","110/07/09","永豐金-嘉義",0,21,-21
"10689","6180橘子","110/07/09","凱基-台北",26,10,16
"10690","6180橘子","110/07/09","凱基-中壢",8,24,-16
"10691","6180橘子","110/07/09","華南永昌-楠梓",13,0,13
"10692","6180橘子","110/07/09","致和-崇德",0,15,-15
"10693","6180橘子","110/07/09","華南永昌-朴子",11,0,11
"10694","6180橘子","110/07/09","群益金鼎-屏東",0,15,-15
"10695","6180橘子","110/07/09","元大-北港",11,0,11
"10696","6180橘子","110/07/09","群益金鼎-中山",0,15,-15
"10697","6180橘子","110/07/09","元大-成功",10,1,9
"10698","6180橘子","110/07/09","瑞士信貸",1,15,-14
"10699","6180橘子","110/07/09","新光",26,18,8
"10700","6180橘子","110/07/09","日盛-二林",0,10,-10
"10701","6180橘子","110/07/09","統一-三重",6,0,6
"10702","6180橘子","110/07/09","凱基-東門",0,10,-10
"10703","6180橘子","110/07/09","群益金鼎-嘉義",6,0,6
"10704","6180橘子","110/07/09","華南永昌-三重",0,10,-10
"10705","6180橘子","110/07/09","元大-員林中山",6,0,6
"10706","6180橘子","110/07/09","元大-彰化民生",1,11,-10
"10707","6180橘子","110/07/09","合庫-鳳山",5,0,5
"10708","6180橘子","110/07/09","永豐金-新店",1,11,-10
"10709","6180橘子","110/07/09","富邦-建國",6,1,5
"10710","6180橘子","110/07/09","群益金鼎-丹鳳",0,8,-8
"10711","2390云辰","110/07/09","摩根大通",279,56,223
"10712","2390云辰","110/07/09","元大-天母",0,127,-127
"10713","2390云辰","110/07/09","日盛-鳳山",110,2,108
"10714","2390云辰","110/07/09","中國信託-文心",5,109,-104
"10715","2390云辰","110/07/09","宏遠證券",100,0,100
"10716","2390云辰","110/07/09","永豐金-復興",0,55,-55
"10717","2390云辰","110/07/09","元大-大里",63,6,57
"10718","2390云辰","110/07/09","凱基-台北",239,286,-47
"10719","2390云辰","110/07/09","凱基-八德",59,10,49
"10720","2390云辰","110/07/09","德信",2,32,-30
"10721","2390云辰","110/07/09","合庫-新竹",40,0,40
"10722","2390云辰","110/07/09","兆豐-桃鶯",2,32,-30
"10723","2390云辰","110/07/09","國票",40,1,39
"10724","2390云辰","110/07/09","致和-南京",0,30,-30
"10725","2390云辰","110/07/09","新加坡商瑞銀",49,13,36
"10726","2390云辰","110/07/09","富邦-虎尾",1,31,-30
"10727","2390云辰","110/07/09","統一-新台中",36,2,34
"10728","2390云辰","110/07/09","元大-善化",2,31,-29
"10729","2390云辰","110/07/09","國票-嘉義",31,0,31
"10730","2390云辰","110/07/09","富邦-板橋",0,27,-27
"10731","2390云辰","110/07/09","華南永昌",35,7,28
"10732","2390云辰","110/07/09","富邦-永和",3,28,-25
"10733","2390云辰","110/07/09","玉山-台中",49,22,27
"10734","2390云辰","110/07/09","第一金-自由",20,44,-24
"10735","2390云辰","110/07/09","華南永昌-敦南",25,0,25
"10736","2390云辰","110/07/09","凱基-內湖",0,24,-24
"10737","2390云辰","110/07/09","新光-高雄",27,4,23
"10738","2390云辰","110/07/09","元大-汐止",1,24,-23
"10739","2390云辰","110/07/09","台灣摩根士丹利",85,63,22
"10740","2390云辰","110/07/09","新光-台中",12,33,-21
"10741","4903聯光通","110/07/09","元大-敦南",10,0,10
"10742","4903聯光通","110/07/09","第一金-台中",0,12,-12
"10743","4903聯光通","110/07/09","凱基-士林",5,0,5
"10744","4903聯光通","110/07/09","日盛-忠孝",0,3,-3
"10745","4903聯光通","110/07/09","元大-苗栗",5,0,5
"10746","4903聯光通","110/07/09","群益金鼎-崇德",0,3,-3
"10747","4903聯光通","110/07/09","元大-屏南",3,0,3
"10748","4903聯光通","110/07/09","國票-內壢",0,2,-2
"10749","4903聯光通","110/07/09","中國信託-永康",1,0,1
"10750","4903聯光通","110/07/09","康和-南崁",0,2,-2
"10751","4903聯光通","110/07/09","玉山證券",1,0,1
"10752","4903聯光通","110/07/09","新光-台中",0,2,-2
"10753","4903聯光通","110/07/09","元大-太平",4,3,1
"10754","4903聯光通","110/07/09","玉山-城中",0,2,-2
"10755","4903聯光通","110/07/09","永豐金-嘉義",1,0,1
"10756","4903聯光通","110/07/09","中國信託-文心",0,1,-1
"10757","4903聯光通","110/07/09","大昌",0,0,0
"10758","4903聯光通","110/07/09","大昌",0,0,0
"10759","4903聯光通","110/07/09","中農",0,0,0
"10760","4903聯光通","110/07/09","中農",0,0,0
"10761","4903聯光通","110/07/09","",NA,NA,NA
"10762","4903聯光通","110/07/09","",NA,NA,NA
"10763","4903聯光通","110/07/09","",NA,NA,NA
"10764","4903聯光通","110/07/09","",NA,NA,NA
"10765","4903聯光通","110/07/09","",NA,NA,NA
"10766","4903聯光通","110/07/09","",NA,NA,NA
"10767","4903聯光通","110/07/09","",NA,NA,NA
"10768","4903聯光通","110/07/09","",NA,NA,NA
"10769","4903聯光通","110/07/09","",NA,NA,NA
"10770","4903聯光通","110/07/09","",NA,NA,NA
"10771","2929淘帝","110/07/09","台中銀-台北",110,0,110
"10772","2929淘帝","110/07/09","新光",2,82,-80
"10773","2929淘帝","110/07/09","華南永昌-頭份",72,0,72
"10774","2929淘帝","110/07/09","摩根大通",2,63,-61
"10775","2929淘帝","110/07/09","合庫-高雄",71,0,71
"10776","2929淘帝","110/07/09","第一金-路竹",0,50,-50
"10777","2929淘帝","110/07/09","高橋-龍潭",37,0,37
"10778","2929淘帝","110/07/09","港商麥格理",0,42,-42
"10779","2929淘帝","110/07/09","新光-台中",60,26,34
"10780","2929淘帝","110/07/09","陽信-石牌",0,40,-40
"10781","2929淘帝","110/07/09","元富-大裕",22,1,21
"10782","2929淘帝","110/07/09","台新-左楠",1,39,-38
"10783","2929淘帝","110/07/09","合庫-鳳山",20,0,20
"10784","2929淘帝","110/07/09","凱基-桃園",3,29,-26
"10785","2929淘帝","110/07/09","元大-員林",22,2,20
"10786","2929淘帝","110/07/09","兆豐-內湖",0,25,-25
"10787","2929淘帝","110/07/09","台新-建北",15,0,15
"10788","2929淘帝","110/07/09","元大-北港",0,20,-20
"10789","2929淘帝","110/07/09","兆豐-桃園",13,0,13
"10790","2929淘帝","110/07/09","富邦-北港",0,19,-19
"10791","2929淘帝","110/07/09","兆豐-忠孝",10,0,10
"10792","2929淘帝","110/07/09","富邦-花蓮",0,17,-17
"10793","2929淘帝","110/07/09","國票-敦北法人",10,0,10
"10794","2929淘帝","110/07/09","國泰-台中",2,17,-15
"10795","2929淘帝","110/07/09","永豐金-博愛",10,0,10
"10796","2929淘帝","110/07/09","群益金鼎-彰化",0,15,-15
"10797","2929淘帝","110/07/09","群益金鼎-潭子",8,0,8
"10798","2929淘帝","110/07/09","元大-博愛",0,14,-14
"10799","2929淘帝","110/07/09","富邦-南屯",8,0,8
"10800","2929淘帝","110/07/09","日盛-板橋",0,13,-13
"10801","5410國眾","110/07/09","元大-新盛",14,0,14
"10802","5410國眾","110/07/09","(牛牛牛)亞-鑫豐",1,41,-40
"10803","5410國眾","110/07/09","台灣企銀-民雄",10,0,10
"10804","5410國眾","110/07/09","元富-嘉義",0,25,-25
"10805","5410國眾","110/07/09","元富-虎尾",9,0,9
"10806","5410國眾","110/07/09","凱基-高美館",0,10,-10
"10807","5410國眾","110/07/09","摩根大通",10,1,9
"10808","5410國眾","110/07/09","凱基-城中",0,10,-10
"10809","5410國眾","110/07/09","兆豐-北高雄",7,0,7
"10810","5410國眾","110/07/09","元大-頭份",0,10,-10
"10811","5410國眾","110/07/09","凱基-台北",8,1,7
"10812","5410國眾","110/07/09","群益金鼎-丹鳳",0,7,-7
"10813","5410國眾","110/07/09","華南永昌-公誠",7,0,7
"10814","5410國眾","110/07/09","凱基-復興",0,7,-7
"10815","5410國眾","110/07/09","香港上海匯豐",6,0,6
"10816","5410國眾","110/07/09","元大-員林",0,7,-7
"10817","5410國眾","110/07/09","凱基-中壢",6,0,6
"10818","5410國眾","110/07/09","富邦-竹東",0,6,-6
"10819","5410國眾","110/07/09","華南永昌-南京",6,0,6
"10820","5410國眾","110/07/09","亞東-高雄",0,5,-5
"10821","5410國眾","110/07/09","統一-三重",5,0,5
"10822","5410國眾","110/07/09","大慶-中壢",1,6,-5
"10823","5410國眾","110/07/09","富邦-宜蘭",5,0,5
"10824","5410國眾","110/07/09","群益金鼎-中港",0,5,-5
"10825","5410國眾","110/07/09","元大-崇德",5,0,5
"10826","5410國眾","110/07/09","元大-八德",0,5,-5
"10827","5410國眾","110/07/09","元大-博愛",5,0,5
"10828","5410國眾","110/07/09","富邦-基隆",0,4,-4
"10829","5410國眾","110/07/09","元大-龍潭",5,0,5
"10830","5410國眾","110/07/09","臺銀-新竹",0,3,-3
"10831","2841台開","110/07/09","日盛-雙和",102,0,102
"10832","2841台開","110/07/09","港商野村",0,129,-129
"10833","2841台開","110/07/09","元大-館前",70,0,70
"10834","2841台開","110/07/09","兆豐-永和",0,100,-100
"10835","2841台開","110/07/09","凱基-文心",50,0,50
"10836","2841台開","110/07/09","台新證券",7,28,-21
"10837","2841台開","110/07/09","富邦-嘉義",40,0,40
"10838","2841台開","110/07/09","國票-北高雄",0,20,-20
"10839","2841台開","110/07/09","美商高盛",15,0,15
"10840","2841台開","110/07/09","永豐金-敦南",29,46,-17
"10841","2841台開","110/07/09","台中銀",15,0,15
"10842","2841台開","110/07/09","合庫-基隆",0,12,-12
"10843","2841台開","110/07/09","新光",11,0,11
"10844","2841台開","110/07/09","中國信託-松江",0,12,-12
"10845","2841台開","110/07/09","華南永昌-長虹",10,0,10
"10846","2841台開","110/07/09","兆豐-城中",0,12,-12
"10847","2841台開","110/07/09","永豐金-南投",10,0,10
"10848","2841台開","110/07/09","台中銀-豐原",0,10,-10
"10849","2841台開","110/07/09","合庫-桃園",7,0,7
"10850","2841台開","110/07/09","兆豐-景美",0,10,-10
"10851","2841台開","110/07/09","群益金鼎-古亭",7,0,7
"10852","2841台開","110/07/09","群益金鼎-基隆",0,10,-10
"10853","2841台開","110/07/09","國泰-敦南",6,0,6
"10854","2841台開","110/07/09","元大-北三重",0,10,-10
"10855","2841台開","110/07/09","凱基-桃園",8,2,6
"10856","2841台開","110/07/09","(牛牛牛)亞-網路",0,9,-9
"10857","2841台開","110/07/09","日盛證券",5,0,5
"10858","2841台開","110/07/09","台新-高雄",1,10,-9
"10859","2841台開","110/07/09","元富-文心",5,0,5
"10860","2841台開","110/07/09","凱基-台北",0,7,-7
"10861","6207雷科","110/07/09","群益金鼎-新竹",47,0,47
"10862","6207雷科","110/07/09","新光",7,24,-17
"10863","6207雷科","110/07/09","永豐金-三重",31,0,31
"10864","6207雷科","110/07/09","日盛-和美",0,15,-15
"10865","6207雷科","110/07/09","新加坡商瑞銀",33,5,28
"10866","6207雷科","110/07/09","國泰-台南",0,15,-15
"10867","6207雷科","110/07/09","元大-高雄",26,0,26
"10868","6207雷科","110/07/09","華南永昌-古亭",0,14,-14
"10869","6207雷科","110/07/09","統一-員林",22,0,22
"10870","6207雷科","110/07/09","土銀-白河",0,11,-11
"10871","6207雷科","110/07/09","台新-高雄",22,0,22
"10872","6207雷科","110/07/09","日盛-台南",0,10,-10
"10873","6207雷科","110/07/09","摩根大通",34,17,17
"10874","6207雷科","110/07/09","元富-林園",0,10,-10
"10875","6207雷科","110/07/09","元大-博愛",17,1,16
"10876","6207雷科","110/07/09","富邦-園區",0,10,-10
"10877","6207雷科","110/07/09","日茂-埔里",12,0,12
"10878","6207雷科","110/07/09","元大-上新莊",0,10,-10
"10879","6207雷科","110/07/09","國泰-台中",17,6,11
"10880","6207雷科","110/07/09","永豐金-南京",0,10,-10
"10881","6207雷科","110/07/09","富邦-三重",10,0,10
"10882","6207雷科","110/07/09","兆豐-小港",0,6,-6
"10883","6207雷科","110/07/09","元大-沙鹿",10,0,10
"10884","6207雷科","110/07/09","富邦-羅東",1,7,-6
"10885","6207雷科","110/07/09","元大-八德",10,0,10
"10886","6207雷科","110/07/09","元大-土城永寧",0,6,-6
"10887","6207雷科","110/07/09","第一金-路竹",11,2,9
"10888","6207雷科","110/07/09","永豐金-板盛",0,6,-6
"10889","6207雷科","110/07/09","統一-南京",5,0,5
"10890","6207雷科","110/07/09","日盛-板橋",0,5,-5
"10891","3679新至陞","110/07/09","元大-大天母",10,0,10
"10892","3679新至陞","110/07/09","第一金-光復",0,11,-11
"10893","3679新至陞","110/07/09","日盛-樹林",9,0,9
"10894","3679新至陞","110/07/09","瑞士信貸",0,8,-8
"10895","3679新至陞","110/07/09","凱基-台北",11,2,9
"10896","3679新至陞","110/07/09","大慶-苗栗",0,5,-5
"10897","3679新至陞","110/07/09","華南永昌-小港",8,0,8
"10898","3679新至陞","110/07/09","元大-永春",0,5,-5
"10899","3679新至陞","110/07/09","兆豐-來福",7,0,7
"10900","3679新至陞","110/07/09","日盛-和美",0,4,-4
"10901","3679新至陞","110/07/09","香港上海匯豐",5,0,5
"10902","3679新至陞","110/07/09","元大-雙和",0,3,-3
"10903","3679新至陞","110/07/09","台中銀-員林",3,0,3
"10904","3679新至陞","110/07/09","永豐金-屏東",0,3,-3
"10905","3679新至陞","110/07/09","新光",3,0,3
"10906","3679新至陞","110/07/09","彰銀",0,2,-2
"10907","3679新至陞","110/07/09","土銀-花蓮",2,0,2
"10908","3679新至陞","110/07/09","宏遠-館前",0,2,-2
"10909","3679新至陞","110/07/09","第一金-澎湖",2,0,2
"10910","3679新至陞","110/07/09","港商野村",0,2,-2
"10911","3679新至陞","110/07/09","摩根大通",2,0,2
"10912","3679新至陞","110/07/09","大昌-新店",0,2,-2
"10913","3679新至陞","110/07/09","國泰-敦南",2,0,2
"10914","3679新至陞","110/07/09","元大-新莊",0,2,-2
"10915","3679新至陞","110/07/09","元大-淡水",4,2,2
"10916","3679新至陞","110/07/09","元大-板橋",0,2,-2
"10917","3679新至陞","110/07/09","日盛-士林",1,0,1
"10918","3679新至陞","110/07/09","台灣摩根士丹利",0,1,-1
"10919","3679新至陞","110/07/09","日盛-信義",1,0,1
"10920","3679新至陞","110/07/09","第一金-高雄",0,1,-1
"10921","2727王品","110/07/09","台灣匯立證券",90,0,90
"10922","2727王品","110/07/09","台灣摩根士丹利",0,267,-267
"10923","2727王品","110/07/09","國泰-敦南",166,84,82
"10924","2727王品","110/07/09","富邦-台北",35,299,-264
"10925","2727王品","110/07/09","富邦-仁愛",56,12,44
"10926","2727王品","110/07/09","凱基-台北",174,296,-122
"10927","2727王品","110/07/09","台新證券",109,66,43
"10928","2727王品","110/07/09","第一金",2,102,-100
"10929","2727王品","110/07/09","新光",117,87,30
"10930","2727王品","110/07/09","群益金鼎-大安",0,80,-80
"10931","2727王品","110/07/09","臺銀-臺中",35,6,29
"10932","2727王品","110/07/09","兆豐-大安",7,60,-53
"10933","2727王品","110/07/09","元大-桃園",32,3,29
"10934","2727王品","110/07/09","永豐金-南投",0,50,-50
"10935","2727王品","110/07/09","元富-宜蘭",34,6,28
"10936","2727王品","110/07/09","新加坡商瑞銀",6,46,-40
"10937","2727王品","110/07/09","玉山-台中",34,8,26
"10938","2727王品","110/07/09","合庫-彰化",11,50,-39
"10939","2727王品","110/07/09","群益金鼎-宜蘭",30,4,26
"10940","2727王品","110/07/09","永豐金-萬盛",13,52,-39
"10941","2727王品","110/07/09","富邦-台中",42,16,26
"10942","2727王品","110/07/09","瑞士信貸",0,34,-34
"10943","2727王品","110/07/09","第一金-豐原",25,1,24
"10944","2727王品","110/07/09","元大-和平",4,35,-31
"10945","2727王品","110/07/09","臺銀",30,8,22
"10946","2727王品","110/07/09","美林",14,44,-30
"10947","2727王品","110/07/09","兆豐-來福",23,1,22
"10948","2727王品","110/07/09","元大-員林",9,38,-29
"10949","2727王品","110/07/09","玉山-士林",22,2,20
"10950","2727王品","110/07/09","元富-西松",4,31,-27
"10951","1570力肯","110/07/09","凱基-台北",30,1,29
"10952","1570力肯","110/07/09","群益金鼎-彰化",0,20,-20
"10953","1570力肯","110/07/09","新光-台南",20,0,20
"10954","1570力肯","110/07/09","元大-土城學府",0,20,-20
"10955","1570力肯","110/07/09","元大-高雄",20,0,20
"10956","1570力肯","110/07/09","元大-大統",0,16,-16
"10957","1570力肯","110/07/09","國票-中正",12,0,12
"10958","1570力肯","110/07/09","元大-新營",0,11,-11
"10959","1570力肯","110/07/09","日盛-高雄",6,0,6
"10960","1570力肯","110/07/09","元大-和平",0,10,-10
"10961","1570力肯","110/07/09","元富-緯城",6,0,6
"10962","1570力肯","110/07/09","元大-草屯",0,10,-10
"10963","1570力肯","110/07/09","群益金鼎-台南",6,0,6
"10964","1570力肯","110/07/09","元大-鹿港",0,9,-9
"10965","1570力肯","110/07/09","華南永昌-岡山",6,0,6
"10966","1570力肯","110/07/09","合庫-基隆",0,7,-7
"10967","1570力肯","110/07/09","統一-中壢",5,0,5
"10968","1570力肯","110/07/09","摩根大通",2,8,-6
"10969","1570力肯","110/07/09","凱基-三峽",5,0,5
"10970","1570力肯","110/07/09","台灣企銀-豐原",0,4,-4
"10971","1570力肯","110/07/09","大昌-樹林",4,0,4
"10972","1570力肯","110/07/09","日盛-桃園",0,4,-4
"10973","1570力肯","110/07/09","新光",3,0,3
"10974","1570力肯","110/07/09","國泰-高雄",0,3,-3
"10975","1570力肯","110/07/09","富邦-新竹華信",3,0,3
"10976","1570力肯","110/07/09","永豐金-敦南",0,3,-3
"10977","1570力肯","110/07/09","合庫-台中",2,0,2
"10978","1570力肯","110/07/09","土銀-彰化",0,2,-2
"10979","1570力肯","110/07/09","臺銀-臺中",2,0,2
"10980","1570力肯","110/07/09","臺銀-鳳山",0,2,-2
"10981","6180橘子","110/07/09","摩根大通",63,1,62
"10982","6180橘子","110/07/09","元大-南京",1,32,-31
"10983","6180橘子","110/07/09","富邦-陽明",73,33,40
"10984","6180橘子","110/07/09","群益金鼎-台北",0,25,-25
"10985","6180橘子","110/07/09","新加坡商瑞銀",31,0,31
"10986","6180橘子","110/07/09","兆豐-復興",0,21,-21
"10987","6180橘子","110/07/09","美商高盛",25,0,25
"10988","6180橘子","110/07/09","永豐金-嘉義",0,21,-21
"10989","6180橘子","110/07/09","凱基-台北",26,10,16
"10990","6180橘子","110/07/09","凱基-中壢",8,24,-16
"10991","6180橘子","110/07/09","華南永昌-楠梓",13,0,13
"10992","6180橘子","110/07/09","致和-崇德",0,15,-15
"10993","6180橘子","110/07/09","華南永昌-朴子",11,0,11
"10994","6180橘子","110/07/09","群益金鼎-屏東",0,15,-15
"10995","6180橘子","110/07/09","元大-北港",11,0,11
"10996","6180橘子","110/07/09","群益金鼎-中山",0,15,-15
"10997","6180橘子","110/07/09","元大-成功",10,1,9
"10998","6180橘子","110/07/09","瑞士信貸",1,15,-14
"10999","6180橘子","110/07/09","新光",26,18,8
"11000","6180橘子","110/07/09","日盛-二林",0,10,-10
"11001","6180橘子","110/07/09","統一-三重",6,0,6
"11002","6180橘子","110/07/09","凱基-東門",0,10,-10
"11003","6180橘子","110/07/09","群益金鼎-嘉義",6,0,6
"11004","6180橘子","110/07/09","華南永昌-三重",0,10,-10
"11005","6180橘子","110/07/09","元大-員林中山",6,0,6
"11006","6180橘子","110/07/09","元大-彰化民生",1,11,-10
"11007","6180橘子","110/07/09","合庫-鳳山",5,0,5
"11008","6180橘子","110/07/09","永豐金-新店",1,11,-10
"11009","6180橘子","110/07/09","富邦-建國",6,1,5
"11010","6180橘子","110/07/09","群益金鼎-丹鳳",0,8,-8
"11011","2390云辰","110/07/09","摩根大通",279,56,223
"11012","2390云辰","110/07/09","元大-天母",0,127,-127
"11013","2390云辰","110/07/09","日盛-鳳山",110,2,108
"11014","2390云辰","110/07/09","中國信託-文心",5,109,-104
"11015","2390云辰","110/07/09","宏遠證券",100,0,100
"11016","2390云辰","110/07/09","永豐金-復興",0,55,-55
"11017","2390云辰","110/07/09","元大-大里",63,6,57
"11018","2390云辰","110/07/09","凱基-台北",239,286,-47
"11019","2390云辰","110/07/09","凱基-八德",59,10,49
"11020","2390云辰","110/07/09","德信",2,32,-30
"11021","2390云辰","110/07/09","合庫-新竹",40,0,40
"11022","2390云辰","110/07/09","兆豐-桃鶯",2,32,-30
"11023","2390云辰","110/07/09","國票",40,1,39
"11024","2390云辰","110/07/09","致和-南京",0,30,-30
"11025","2390云辰","110/07/09","新加坡商瑞銀",49,13,36
"11026","2390云辰","110/07/09","富邦-虎尾",1,31,-30
"11027","2390云辰","110/07/09","統一-新台中",36,2,34
"11028","2390云辰","110/07/09","元大-善化",2,31,-29
"11029","2390云辰","110/07/09","國票-嘉義",31,0,31
"11030","2390云辰","110/07/09","富邦-板橋",0,27,-27
"11031","2390云辰","110/07/09","華南永昌",35,7,28
"11032","2390云辰","110/07/09","富邦-永和",3,28,-25
"11033","2390云辰","110/07/09","玉山-台中",49,22,27
"11034","2390云辰","110/07/09","第一金-自由",20,44,-24
"11035","2390云辰","110/07/09","華南永昌-敦南",25,0,25
"11036","2390云辰","110/07/09","凱基-內湖",0,24,-24
"11037","2390云辰","110/07/09","新光-高雄",27,4,23
"11038","2390云辰","110/07/09","元大-汐止",1,24,-23
"11039","2390云辰","110/07/09","台灣摩根士丹利",85,63,22
"11040","2390云辰","110/07/09","新光-台中",12,33,-21
"11041","4903聯光通","110/07/09","元大-敦南",10,0,10
"11042","4903聯光通","110/07/09","第一金-台中",0,12,-12
"11043","4903聯光通","110/07/09","凱基-士林",5,0,5
"11044","4903聯光通","110/07/09","日盛-忠孝",0,3,-3
"11045","4903聯光通","110/07/09","元大-苗栗",5,0,5
"11046","4903聯光通","110/07/09","群益金鼎-崇德",0,3,-3
"11047","4903聯光通","110/07/09","元大-屏南",3,0,3
"11048","4903聯光通","110/07/09","國票-內壢",0,2,-2
"11049","4903聯光通","110/07/09","中國信託-永康",1,0,1
"11050","4903聯光通","110/07/09","康和-南崁",0,2,-2
"11051","4903聯光通","110/07/09","玉山證券",1,0,1
"11052","4903聯光通","110/07/09","新光-台中",0,2,-2
"11053","4903聯光通","110/07/09","元大-太平",4,3,1
"11054","4903聯光通","110/07/09","玉山-城中",0,2,-2
"11055","4903聯光通","110/07/09","永豐金-嘉義",1,0,1
"11056","4903聯光通","110/07/09","中國信託-文心",0,1,-1
"11057","4903聯光通","110/07/09","大昌",0,0,0
"11058","4903聯光通","110/07/09","大昌",0,0,0
"11059","4903聯光通","110/07/09","中農",0,0,0
"11060","4903聯光通","110/07/09","中農",0,0,0
"11061","4903聯光通","110/07/09","",NA,NA,NA
"11062","4903聯光通","110/07/09","",NA,NA,NA
"11063","4903聯光通","110/07/09","",NA,NA,NA
"11064","4903聯光通","110/07/09","",NA,NA,NA
"11065","4903聯光通","110/07/09","",NA,NA,NA
"11066","4903聯光通","110/07/09","",NA,NA,NA
"11067","4903聯光通","110/07/09","",NA,NA,NA
"11068","4903聯光通","110/07/09","",NA,NA,NA
"11069","4903聯光通","110/07/09","",NA,NA,NA
"11070","4903聯光通","110/07/09","",NA,NA,NA
"11071","2929淘帝","110/07/09","台中銀-台北",110,0,110
"11072","2929淘帝","110/07/09","新光",2,82,-80
"11073","2929淘帝","110/07/09","華南永昌-頭份",72,0,72
"11074","2929淘帝","110/07/09","摩根大通",2,63,-61
"11075","2929淘帝","110/07/09","合庫-高雄",71,0,71
"11076","2929淘帝","110/07/09","第一金-路竹",0,50,-50
"11077","2929淘帝","110/07/09","高橋-龍潭",37,0,37
"11078","2929淘帝","110/07/09","港商麥格理",0,42,-42
"11079","2929淘帝","110/07/09","新光-台中",60,26,34
"11080","2929淘帝","110/07/09","陽信-石牌",0,40,-40
"11081","2929淘帝","110/07/09","元富-大裕",22,1,21
"11082","2929淘帝","110/07/09","台新-左楠",1,39,-38
"11083","2929淘帝","110/07/09","合庫-鳳山",20,0,20
"11084","2929淘帝","110/07/09","凱基-桃園",3,29,-26
"11085","2929淘帝","110/07/09","元大-員林",22,2,20
"11086","2929淘帝","110/07/09","兆豐-內湖",0,25,-25
"11087","2929淘帝","110/07/09","台新-建北",15,0,15
"11088","2929淘帝","110/07/09","元大-北港",0,20,-20
"11089","2929淘帝","110/07/09","兆豐-桃園",13,0,13
"11090","2929淘帝","110/07/09","富邦-北港",0,19,-19
"11091","2929淘帝","110/07/09","兆豐-忠孝",10,0,10
"11092","2929淘帝","110/07/09","富邦-花蓮",0,17,-17
"11093","2929淘帝","110/07/09","國票-敦北法人",10,0,10
"11094","2929淘帝","110/07/09","國泰-台中",2,17,-15
"11095","2929淘帝","110/07/09","永豐金-博愛",10,0,10
"11096","2929淘帝","110/07/09","群益金鼎-彰化",0,15,-15
"11097","2929淘帝","110/07/09","群益金鼎-潭子",8,0,8
"11098","2929淘帝","110/07/09","元大-博愛",0,14,-14
"11099","2929淘帝","110/07/09","富邦-南屯",8,0,8
"11100","2929淘帝","110/07/09","日盛-板橋",0,13,-13
"11101","5410國眾","110/07/09","元大-新盛",14,0,14
"11102","5410國眾","110/07/09","(牛牛牛)亞-鑫豐",1,41,-40
"11103","5410國眾","110/07/09","台灣企銀-民雄",10,0,10
"11104","5410國眾","110/07/09","元富-嘉義",0,25,-25
"11105","5410國眾","110/07/09","元富-虎尾",9,0,9
"11106","5410國眾","110/07/09","凱基-高美館",0,10,-10
"11107","5410國眾","110/07/09","摩根大通",10,1,9
"11108","5410國眾","110/07/09","凱基-城中",0,10,-10
"11109","5410國眾","110/07/09","兆豐-北高雄",7,0,7
"11110","5410國眾","110/07/09","元大-頭份",0,10,-10
"11111","5410國眾","110/07/09","凱基-台北",8,1,7
"11112","5410國眾","110/07/09","群益金鼎-丹鳳",0,7,-7
"11113","5410國眾","110/07/09","華南永昌-公誠",7,0,7
"11114","5410國眾","110/07/09","凱基-復興",0,7,-7
"11115","5410國眾","110/07/09","香港上海匯豐",6,0,6
"11116","5410國眾","110/07/09","元大-員林",0,7,-7
"11117","5410國眾","110/07/09","凱基-中壢",6,0,6
"11118","5410國眾","110/07/09","富邦-竹東",0,6,-6
"11119","5410國眾","110/07/09","華南永昌-南京",6,0,6
"11120","5410國眾","110/07/09","亞東-高雄",0,5,-5
"11121","5410國眾","110/07/09","統一-三重",5,0,5
"11122","5410國眾","110/07/09","大慶-中壢",1,6,-5
"11123","5410國眾","110/07/09","富邦-宜蘭",5,0,5
"11124","5410國眾","110/07/09","群益金鼎-中港",0,5,-5
"11125","5410國眾","110/07/09","元大-崇德",5,0,5
"11126","5410國眾","110/07/09","元大-八德",0,5,-5
"11127","5410國眾","110/07/09","元大-博愛",5,0,5
"11128","5410國眾","110/07/09","富邦-基隆",0,4,-4
"11129","5410國眾","110/07/09","元大-龍潭",5,0,5
"11130","5410國眾","110/07/09","臺銀-新竹",0,3,-3
"11131","2841台開","110/07/09","日盛-雙和",102,0,102
"11132","2841台開","110/07/09","港商野村",0,129,-129
"11133","2841台開","110/07/09","元大-館前",70,0,70
"11134","2841台開","110/07/09","兆豐-永和",0,100,-100
"11135","2841台開","110/07/09","凱基-文心",50,0,50
"11136","2841台開","110/07/09","台新證券",7,28,-21
"11137","2841台開","110/07/09","富邦-嘉義",40,0,40
"11138","2841台開","110/07/09","國票-北高雄",0,20,-20
"11139","2841台開","110/07/09","美商高盛",15,0,15
"11140","2841台開","110/07/09","永豐金-敦南",29,46,-17
"11141","2841台開","110/07/09","台中銀",15,0,15
"11142","2841台開","110/07/09","合庫-基隆",0,12,-12
"11143","2841台開","110/07/09","新光",11,0,11
"11144","2841台開","110/07/09","中國信託-松江",0,12,-12
"11145","2841台開","110/07/09","華南永昌-長虹",10,0,10
"11146","2841台開","110/07/09","兆豐-城中",0,12,-12
"11147","2841台開","110/07/09","永豐金-南投",10,0,10
"11148","2841台開","110/07/09","台中銀-豐原",0,10,-10
"11149","2841台開","110/07/09","合庫-桃園",7,0,7
"11150","2841台開","110/07/09","兆豐-景美",0,10,-10
"11151","2841台開","110/07/09","群益金鼎-古亭",7,0,7
"11152","2841台開","110/07/09","群益金鼎-基隆",0,10,-10
"11153","2841台開","110/07/09","國泰-敦南",6,0,6
"11154","2841台開","110/07/09","元大-北三重",0,10,-10
"11155","2841台開","110/07/09","凱基-桃園",8,2,6
"11156","2841台開","110/07/09","(牛牛牛)亞-網路",0,9,-9
"11157","2841台開","110/07/09","日盛證券",5,0,5
"11158","2841台開","110/07/09","台新-高雄",1,10,-9
"11159","2841台開","110/07/09","元富-文心",5,0,5
"11160","2841台開","110/07/09","凱基-台北",0,7,-7
"11161","6207雷科","110/07/09","群益金鼎-新竹",47,0,47
"11162","6207雷科","110/07/09","新光",7,24,-17
"11163","6207雷科","110/07/09","永豐金-三重",31,0,31
"11164","6207雷科","110/07/09","日盛-和美",0,15,-15
"11165","6207雷科","110/07/09","新加坡商瑞銀",33,5,28
"11166","6207雷科","110/07/09","國泰-台南",0,15,-15
"11167","6207雷科","110/07/09","元大-高雄",26,0,26
"11168","6207雷科","110/07/09","華南永昌-古亭",0,14,-14
"11169","6207雷科","110/07/09","統一-員林",22,0,22
"11170","6207雷科","110/07/09","土銀-白河",0,11,-11
"11171","6207雷科","110/07/09","台新-高雄",22,0,22
"11172","6207雷科","110/07/09","日盛-台南",0,10,-10
"11173","6207雷科","110/07/09","摩根大通",34,17,17
"11174","6207雷科","110/07/09","元富-林園",0,10,-10
"11175","6207雷科","110/07/09","元大-博愛",17,1,16
"11176","6207雷科","110/07/09","富邦-園區",0,10,-10
"11177","6207雷科","110/07/09","日茂-埔里",12,0,12
"11178","6207雷科","110/07/09","元大-上新莊",0,10,-10
"11179","6207雷科","110/07/09","國泰-台中",17,6,11
"11180","6207雷科","110/07/09","永豐金-南京",0,10,-10
"11181","6207雷科","110/07/09","富邦-三重",10,0,10
"11182","6207雷科","110/07/09","兆豐-小港",0,6,-6
"11183","6207雷科","110/07/09","元大-沙鹿",10,0,10
"11184","6207雷科","110/07/09","富邦-羅東",1,7,-6
"11185","6207雷科","110/07/09","元大-八德",10,0,10
"11186","6207雷科","110/07/09","元大-土城永寧",0,6,-6
"11187","6207雷科","110/07/09","第一金-路竹",11,2,9
"11188","6207雷科","110/07/09","永豐金-板盛",0,6,-6
"11189","6207雷科","110/07/09","統一-南京",5,0,5
"11190","6207雷科","110/07/09","日盛-板橋",0,5,-5
"11191","3679新至陞","110/07/09","元大-大天母",10,0,10
"11192","3679新至陞","110/07/09","第一金-光復",0,11,-11
"11193","3679新至陞","110/07/09","日盛-樹林",9,0,9
"11194","3679新至陞","110/07/09","瑞士信貸",0,8,-8
"11195","3679新至陞","110/07/09","凱基-台北",11,2,9
"11196","3679新至陞","110/07/09","大慶-苗栗",0,5,-5
"11197","3679新至陞","110/07/09","華南永昌-小港",8,0,8
"11198","3679新至陞","110/07/09","元大-永春",0,5,-5
"11199","3679新至陞","110/07/09","兆豐-來福",7,0,7
"11200","3679新至陞","110/07/09","日盛-和美",0,4,-4
"11201","3679新至陞","110/07/09","香港上海匯豐",5,0,5
"11202","3679新至陞","110/07/09","元大-雙和",0,3,-3
"11203","3679新至陞","110/07/09","台中銀-員林",3,0,3
"11204","3679新至陞","110/07/09","永豐金-屏東",0,3,-3
"11205","3679新至陞","110/07/09","新光",3,0,3
"11206","3679新至陞","110/07/09","彰銀",0,2,-2
"11207","3679新至陞","110/07/09","土銀-花蓮",2,0,2
"11208","3679新至陞","110/07/09","宏遠-館前",0,2,-2
"11209","3679新至陞","110/07/09","第一金-澎湖",2,0,2
"11210","3679新至陞","110/07/09","港商野村",0,2,-2
"11211","3679新至陞","110/07/09","摩根大通",2,0,2
"11212","3679新至陞","110/07/09","大昌-新店",0,2,-2
"11213","3679新至陞","110/07/09","國泰-敦南",2,0,2
"11214","3679新至陞","110/07/09","元大-新莊",0,2,-2
"11215","3679新至陞","110/07/09","元大-淡水",4,2,2
"11216","3679新至陞","110/07/09","元大-板橋",0,2,-2
"11217","3679新至陞","110/07/09","日盛-士林",1,0,1
"11218","3679新至陞","110/07/09","台灣摩根士丹利",0,1,-1
"11219","3679新至陞","110/07/09","日盛-信義",1,0,1
"11220","3679新至陞","110/07/09","第一金-高雄",0,1,-1
"11221","2727王品","110/07/09","台灣匯立證券",90,0,90
"11222","2727王品","110/07/09","台灣摩根士丹利",0,267,-267
"11223","2727王品","110/07/09","國泰-敦南",166,84,82
"11224","2727王品","110/07/09","富邦-台北",35,299,-264
"11225","2727王品","110/07/09","富邦-仁愛",56,12,44
"11226","2727王品","110/07/09","凱基-台北",174,296,-122
"11227","2727王品","110/07/09","台新證券",109,66,43
"11228","2727王品","110/07/09","第一金",2,102,-100
"11229","2727王品","110/07/09","新光",117,87,30
"11230","2727王品","110/07/09","群益金鼎-大安",0,80,-80
"11231","2727王品","110/07/09","臺銀-臺中",35,6,29
"11232","2727王品","110/07/09","兆豐-大安",7,60,-53
"11233","2727王品","110/07/09","元大-桃園",32,3,29
"11234","2727王品","110/07/09","永豐金-南投",0,50,-50
"11235","2727王品","110/07/09","元富-宜蘭",34,6,28
"11236","2727王品","110/07/09","新加坡商瑞銀",6,46,-40
"11237","2727王品","110/07/09","玉山-台中",34,8,26
"11238","2727王品","110/07/09","合庫-彰化",11,50,-39
"11239","2727王品","110/07/09","群益金鼎-宜蘭",30,4,26
"11240","2727王品","110/07/09","永豐金-萬盛",13,52,-39
"11241","2727王品","110/07/09","富邦-台中",42,16,26
"11242","2727王品","110/07/09","瑞士信貸",0,34,-34
"11243","2727王品","110/07/09","第一金-豐原",25,1,24
"11244","2727王品","110/07/09","元大-和平",4,35,-31
"11245","2727王品","110/07/09","臺銀",30,8,22
"11246","2727王品","110/07/09","美林",14,44,-30
"11247","2727王品","110/07/09","兆豐-來福",23,1,22
"11248","2727王品","110/07/09","元大-員林",9,38,-29
"11249","2727王品","110/07/09","玉山-士林",22,2,20
"11250","2727王品","110/07/09","元富-西松",4,31,-27
"11251","1570力肯","110/07/09","凱基-台北",30,1,29
"11252","1570力肯","110/07/09","群益金鼎-彰化",0,20,-20
"11253","1570力肯","110/07/09","新光-台南",20,0,20
"11254","1570力肯","110/07/09","元大-土城學府",0,20,-20
"11255","1570力肯","110/07/09","元大-高雄",20,0,20
"11256","1570力肯","110/07/09","元大-大統",0,16,-16
"11257","1570力肯","110/07/09","國票-中正",12,0,12
"11258","1570力肯","110/07/09","元大-新營",0,11,-11
"11259","1570力肯","110/07/09","日盛-高雄",6,0,6
"11260","1570力肯","110/07/09","元大-和平",0,10,-10
"11261","1570力肯","110/07/09","元富-緯城",6,0,6
"11262","1570力肯","110/07/09","元大-草屯",0,10,-10
"11263","1570力肯","110/07/09","群益金鼎-台南",6,0,6
"11264","1570力肯","110/07/09","元大-鹿港",0,9,-9
"11265","1570力肯","110/07/09","華南永昌-岡山",6,0,6
"11266","1570力肯","110/07/09","合庫-基隆",0,7,-7
"11267","1570力肯","110/07/09","統一-中壢",5,0,5
"11268","1570力肯","110/07/09","摩根大通",2,8,-6
"11269","1570力肯","110/07/09","凱基-三峽",5,0,5
"11270","1570力肯","110/07/09","台灣企銀-豐原",0,4,-4
"11271","1570力肯","110/07/09","大昌-樹林",4,0,4
"11272","1570力肯","110/07/09","日盛-桃園",0,4,-4
"11273","1570力肯","110/07/09","新光",3,0,3
"11274","1570力肯","110/07/09","國泰-高雄",0,3,-3
"11275","1570力肯","110/07/09","富邦-新竹華信",3,0,3
"11276","1570力肯","110/07/09","永豐金-敦南",0,3,-3
"11277","1570力肯","110/07/09","合庫-台中",2,0,2
"11278","1570力肯","110/07/09","土銀-彰化",0,2,-2
"11279","1570力肯","110/07/09","臺銀-臺中",2,0,2
"11280","1570力肯","110/07/09","臺銀-鳳山",0,2,-2
"11281","6180橘子","110/07/09","摩根大通",63,1,62
"11282","6180橘子","110/07/09","元大-南京",1,32,-31
"11283","6180橘子","110/07/09","富邦-陽明",73,33,40
"11284","6180橘子","110/07/09","群益金鼎-台北",0,25,-25
"11285","6180橘子","110/07/09","新加坡商瑞銀",31,0,31
"11286","6180橘子","110/07/09","兆豐-復興",0,21,-21
"11287","6180橘子","110/07/09","美商高盛",25,0,25
"11288","6180橘子","110/07/09","永豐金-嘉義",0,21,-21
"11289","6180橘子","110/07/09","凱基-台北",26,10,16
"11290","6180橘子","110/07/09","凱基-中壢",8,24,-16
"11291","6180橘子","110/07/09","華南永昌-楠梓",13,0,13
"11292","6180橘子","110/07/09","致和-崇德",0,15,-15
"11293","6180橘子","110/07/09","華南永昌-朴子",11,0,11
"11294","6180橘子","110/07/09","群益金鼎-屏東",0,15,-15
"11295","6180橘子","110/07/09","元大-北港",11,0,11
"11296","6180橘子","110/07/09","群益金鼎-中山",0,15,-15
"11297","6180橘子","110/07/09","元大-成功",10,1,9
"11298","6180橘子","110/07/09","瑞士信貸",1,15,-14
"11299","6180橘子","110/07/09","新光",26,18,8
"11300","6180橘子","110/07/09","日盛-二林",0,10,-10
"11301","6180橘子","110/07/09","統一-三重",6,0,6
"11302","6180橘子","110/07/09","凱基-東門",0,10,-10
"11303","6180橘子","110/07/09","群益金鼎-嘉義",6,0,6
"11304","6180橘子","110/07/09","華南永昌-三重",0,10,-10
"11305","6180橘子","110/07/09","元大-員林中山",6,0,6
"11306","6180橘子","110/07/09","元大-彰化民生",1,11,-10
"11307","6180橘子","110/07/09","合庫-鳳山",5,0,5
"11308","6180橘子","110/07/09","永豐金-新店",1,11,-10
"11309","6180橘子","110/07/09","富邦-建國",6,1,5
"11310","6180橘子","110/07/09","群益金鼎-丹鳳",0,8,-8
"11311","2390云辰","110/07/09","摩根大通",279,56,223
"11312","2390云辰","110/07/09","元大-天母",0,127,-127
"11313","2390云辰","110/07/09","日盛-鳳山",110,2,108
"11314","2390云辰","110/07/09","中國信託-文心",5,109,-104
"11315","2390云辰","110/07/09","宏遠證券",100,0,100
"11316","2390云辰","110/07/09","永豐金-復興",0,55,-55
"11317","2390云辰","110/07/09","元大-大里",63,6,57
"11318","2390云辰","110/07/09","凱基-台北",239,286,-47
"11319","2390云辰","110/07/09","凱基-八德",59,10,49
"11320","2390云辰","110/07/09","德信",2,32,-30
"11321","2390云辰","110/07/09","合庫-新竹",40,0,40
"11322","2390云辰","110/07/09","兆豐-桃鶯",2,32,-30
"11323","2390云辰","110/07/09","國票",40,1,39
"11324","2390云辰","110/07/09","致和-南京",0,30,-30
"11325","2390云辰","110/07/09","新加坡商瑞銀",49,13,36
"11326","2390云辰","110/07/09","富邦-虎尾",1,31,-30
"11327","2390云辰","110/07/09","統一-新台中",36,2,34
"11328","2390云辰","110/07/09","元大-善化",2,31,-29
"11329","2390云辰","110/07/09","國票-嘉義",31,0,31
"11330","2390云辰","110/07/09","富邦-板橋",0,27,-27
"11331","2390云辰","110/07/09","華南永昌",35,7,28
"11332","2390云辰","110/07/09","富邦-永和",3,28,-25
"11333","2390云辰","110/07/09","玉山-台中",49,22,27
"11334","2390云辰","110/07/09","第一金-自由",20,44,-24
"11335","2390云辰","110/07/09","華南永昌-敦南",25,0,25
"11336","2390云辰","110/07/09","凱基-內湖",0,24,-24
"11337","2390云辰","110/07/09","新光-高雄",27,4,23
"11338","2390云辰","110/07/09","元大-汐止",1,24,-23
"11339","2390云辰","110/07/09","台灣摩根士丹利",85,63,22
"11340","2390云辰","110/07/09","新光-台中",12,33,-21
"11341","4903聯光通","110/07/09","元大-敦南",10,0,10
"11342","4903聯光通","110/07/09","第一金-台中",0,12,-12
"11343","4903聯光通","110/07/09","凱基-士林",5,0,5
"11344","4903聯光通","110/07/09","日盛-忠孝",0,3,-3
"11345","4903聯光通","110/07/09","元大-苗栗",5,0,5
"11346","4903聯光通","110/07/09","群益金鼎-崇德",0,3,-3
"11347","4903聯光通","110/07/09","元大-屏南",3,0,3
"11348","4903聯光通","110/07/09","國票-內壢",0,2,-2
"11349","4903聯光通","110/07/09","中國信託-永康",1,0,1
"11350","4903聯光通","110/07/09","康和-南崁",0,2,-2
"11351","4903聯光通","110/07/09","玉山證券",1,0,1
"11352","4903聯光通","110/07/09","新光-台中",0,2,-2
"11353","4903聯光通","110/07/09","元大-太平",4,3,1
"11354","4903聯光通","110/07/09","玉山-城中",0,2,-2
"11355","4903聯光通","110/07/09","永豐金-嘉義",1,0,1
"11356","4903聯光通","110/07/09","中國信託-文心",0,1,-1
"11357","4903聯光通","110/07/09","大昌",0,0,0
"11358","4903聯光通","110/07/09","大昌",0,0,0
"11359","4903聯光通","110/07/09","中農",0,0,0
"11360","4903聯光通","110/07/09","中農",0,0,0
"11361","4903聯光通","110/07/09","",NA,NA,NA
"11362","4903聯光通","110/07/09","",NA,NA,NA
"11363","4903聯光通","110/07/09","",NA,NA,NA
"11364","4903聯光通","110/07/09","",NA,NA,NA
"11365","4903聯光通","110/07/09","",NA,NA,NA
"11366","4903聯光通","110/07/09","",NA,NA,NA
"11367","4903聯光通","110/07/09","",NA,NA,NA
"11368","4903聯光通","110/07/09","",NA,NA,NA
"11369","4903聯光通","110/07/09","",NA,NA,NA
"11370","4903聯光通","110/07/09","",NA,NA,NA
"11371","2929淘帝","110/07/09","台中銀-台北",110,0,110
"11372","2929淘帝","110/07/09","新光",2,82,-80
"11373","2929淘帝","110/07/09","華南永昌-頭份",72,0,72
"11374","2929淘帝","110/07/09","摩根大通",2,63,-61
"11375","2929淘帝","110/07/09","合庫-高雄",71,0,71
"11376","2929淘帝","110/07/09","第一金-路竹",0,50,-50
"11377","2929淘帝","110/07/09","高橋-龍潭",37,0,37
"11378","2929淘帝","110/07/09","港商麥格理",0,42,-42
"11379","2929淘帝","110/07/09","新光-台中",60,26,34
"11380","2929淘帝","110/07/09","陽信-石牌",0,40,-40
"11381","2929淘帝","110/07/09","元富-大裕",22,1,21
"11382","2929淘帝","110/07/09","台新-左楠",1,39,-38
"11383","2929淘帝","110/07/09","合庫-鳳山",20,0,20
"11384","2929淘帝","110/07/09","凱基-桃園",3,29,-26
"11385","2929淘帝","110/07/09","元大-員林",22,2,20
"11386","2929淘帝","110/07/09","兆豐-內湖",0,25,-25
"11387","2929淘帝","110/07/09","台新-建北",15,0,15
"11388","2929淘帝","110/07/09","元大-北港",0,20,-20
"11389","2929淘帝","110/07/09","兆豐-桃園",13,0,13
"11390","2929淘帝","110/07/09","富邦-北港",0,19,-19
"11391","2929淘帝","110/07/09","兆豐-忠孝",10,0,10
"11392","2929淘帝","110/07/09","富邦-花蓮",0,17,-17
"11393","2929淘帝","110/07/09","國票-敦北法人",10,0,10
"11394","2929淘帝","110/07/09","國泰-台中",2,17,-15
"11395","2929淘帝","110/07/09","永豐金-博愛",10,0,10
"11396","2929淘帝","110/07/09","群益金鼎-彰化",0,15,-15
"11397","2929淘帝","110/07/09","群益金鼎-潭子",8,0,8
"11398","2929淘帝","110/07/09","元大-博愛",0,14,-14
"11399","2929淘帝","110/07/09","富邦-南屯",8,0,8
"11400","2929淘帝","110/07/09","日盛-板橋",0,13,-13
"11401","5410國眾","110/07/09","元大-新盛",14,0,14
"11402","5410國眾","110/07/09","(牛牛牛)亞-鑫豐",1,41,-40
"11403","5410國眾","110/07/09","台灣企銀-民雄",10,0,10
"11404","5410國眾","110/07/09","元富-嘉義",0,25,-25
"11405","5410國眾","110/07/09","元富-虎尾",9,0,9
"11406","5410國眾","110/07/09","凱基-高美館",0,10,-10
"11407","5410國眾","110/07/09","摩根大通",10,1,9
"11408","5410國眾","110/07/09","凱基-城中",0,10,-10
"11409","5410國眾","110/07/09","兆豐-北高雄",7,0,7
"11410","5410國眾","110/07/09","元大-頭份",0,10,-10
"11411","5410國眾","110/07/09","凱基-台北",8,1,7
"11412","5410國眾","110/07/09","群益金鼎-丹鳳",0,7,-7
"11413","5410國眾","110/07/09","華南永昌-公誠",7,0,7
"11414","5410國眾","110/07/09","凱基-復興",0,7,-7
"11415","5410國眾","110/07/09","香港上海匯豐",6,0,6
"11416","5410國眾","110/07/09","元大-員林",0,7,-7
"11417","5410國眾","110/07/09","凱基-中壢",6,0,6
"11418","5410國眾","110/07/09","富邦-竹東",0,6,-6
"11419","5410國眾","110/07/09","華南永昌-南京",6,0,6
"11420","5410國眾","110/07/09","亞東-高雄",0,5,-5
"11421","5410國眾","110/07/09","統一-三重",5,0,5
"11422","5410國眾","110/07/09","大慶-中壢",1,6,-5
"11423","5410國眾","110/07/09","富邦-宜蘭",5,0,5
"11424","5410國眾","110/07/09","群益金鼎-中港",0,5,-5
"11425","5410國眾","110/07/09","元大-崇德",5,0,5
"11426","5410國眾","110/07/09","元大-八德",0,5,-5
"11427","5410國眾","110/07/09","元大-博愛",5,0,5
"11428","5410國眾","110/07/09","富邦-基隆",0,4,-4
"11429","5410國眾","110/07/09","元大-龍潭",5,0,5
"11430","5410國眾","110/07/09","臺銀-新竹",0,3,-3
"11431","2841台開","110/07/09","日盛-雙和",102,0,102
"11432","2841台開","110/07/09","港商野村",0,129,-129
"11433","2841台開","110/07/09","元大-館前",70,0,70
"11434","2841台開","110/07/09","兆豐-永和",0,100,-100
"11435","2841台開","110/07/09","凱基-文心",50,0,50
"11436","2841台開","110/07/09","台新證券",7,28,-21
"11437","2841台開","110/07/09","富邦-嘉義",40,0,40
"11438","2841台開","110/07/09","國票-北高雄",0,20,-20
"11439","2841台開","110/07/09","美商高盛",15,0,15
"11440","2841台開","110/07/09","永豐金-敦南",29,46,-17
"11441","2841台開","110/07/09","台中銀",15,0,15
"11442","2841台開","110/07/09","合庫-基隆",0,12,-12
"11443","2841台開","110/07/09","新光",11,0,11
"11444","2841台開","110/07/09","中國信託-松江",0,12,-12
"11445","2841台開","110/07/09","華南永昌-長虹",10,0,10
"11446","2841台開","110/07/09","兆豐-城中",0,12,-12
"11447","2841台開","110/07/09","永豐金-南投",10,0,10
"11448","2841台開","110/07/09","台中銀-豐原",0,10,-10
"11449","2841台開","110/07/09","合庫-桃園",7,0,7
"11450","2841台開","110/07/09","兆豐-景美",0,10,-10
"11451","2841台開","110/07/09","群益金鼎-古亭",7,0,7
"11452","2841台開","110/07/09","群益金鼎-基隆",0,10,-10
"11453","2841台開","110/07/09","國泰-敦南",6,0,6
"11454","2841台開","110/07/09","元大-北三重",0,10,-10
"11455","2841台開","110/07/09","凱基-桃園",8,2,6
"11456","2841台開","110/07/09","(牛牛牛)亞-網路",0,9,-9
"11457","2841台開","110/07/09","日盛證券",5,0,5
"11458","2841台開","110/07/09","台新-高雄",1,10,-9
"11459","2841台開","110/07/09","元富-文心",5,0,5
"11460","2841台開","110/07/09","凱基-台北",0,7,-7
"11461","6207雷科","110/07/09","群益金鼎-新竹",47,0,47
"11462","6207雷科","110/07/09","新光",7,24,-17
"11463","6207雷科","110/07/09","永豐金-三重",31,0,31
"11464","6207雷科","110/07/09","日盛-和美",0,15,-15
"11465","6207雷科","110/07/09","新加坡商瑞銀",33,5,28
"11466","6207雷科","110/07/09","國泰-台南",0,15,-15
"11467","6207雷科","110/07/09","元大-高雄",26,0,26
"11468","6207雷科","110/07/09","華南永昌-古亭",0,14,-14
"11469","6207雷科","110/07/09","統一-員林",22,0,22
"11470","6207雷科","110/07/09","土銀-白河",0,11,-11
"11471","6207雷科","110/07/09","台新-高雄",22,0,22
"11472","6207雷科","110/07/09","日盛-台南",0,10,-10
"11473","6207雷科","110/07/09","摩根大通",34,17,17
"11474","6207雷科","110/07/09","元富-林園",0,10,-10
"11475","6207雷科","110/07/09","元大-博愛",17,1,16
"11476","6207雷科","110/07/09","富邦-園區",0,10,-10
"11477","6207雷科","110/07/09","日茂-埔里",12,0,12
"11478","6207雷科","110/07/09","元大-上新莊",0,10,-10
"11479","6207雷科","110/07/09","國泰-台中",17,6,11
"11480","6207雷科","110/07/09","永豐金-南京",0,10,-10
"11481","6207雷科","110/07/09","富邦-三重",10,0,10
"11482","6207雷科","110/07/09","兆豐-小港",0,6,-6
"11483","6207雷科","110/07/09","元大-沙鹿",10,0,10
"11484","6207雷科","110/07/09","富邦-羅東",1,7,-6
"11485","6207雷科","110/07/09","元大-八德",10,0,10
"11486","6207雷科","110/07/09","元大-土城永寧",0,6,-6
"11487","6207雷科","110/07/09","第一金-路竹",11,2,9
"11488","6207雷科","110/07/09","永豐金-板盛",0,6,-6
"11489","6207雷科","110/07/09","統一-南京",5,0,5
"11490","6207雷科","110/07/09","日盛-板橋",0,5,-5
"11491","3679新至陞","110/07/09","元大-大天母",10,0,10
"11492","3679新至陞","110/07/09","第一金-光復",0,11,-11
"11493","3679新至陞","110/07/09","日盛-樹林",9,0,9
"11494","3679新至陞","110/07/09","瑞士信貸",0,8,-8
"11495","3679新至陞","110/07/09","凱基-台北",11,2,9
"11496","3679新至陞","110/07/09","大慶-苗栗",0,5,-5
"11497","3679新至陞","110/07/09","華南永昌-小港",8,0,8
"11498","3679新至陞","110/07/09","元大-永春",0,5,-5
"11499","3679新至陞","110/07/09","兆豐-來福",7,0,7
"11500","3679新至陞","110/07/09","日盛-和美",0,4,-4
"11501","3679新至陞","110/07/09","香港上海匯豐",5,0,5
"11502","3679新至陞","110/07/09","元大-雙和",0,3,-3
"11503","3679新至陞","110/07/09","台中銀-員林",3,0,3
"11504","3679新至陞","110/07/09","永豐金-屏東",0,3,-3
"11505","3679新至陞","110/07/09","新光",3,0,3
"11506","3679新至陞","110/07/09","彰銀",0,2,-2
"11507","3679新至陞","110/07/09","土銀-花蓮",2,0,2
"11508","3679新至陞","110/07/09","宏遠-館前",0,2,-2
"11509","3679新至陞","110/07/09","第一金-澎湖",2,0,2
"11510","3679新至陞","110/07/09","港商野村",0,2,-2
"11511","3679新至陞","110/07/09","摩根大通",2,0,2
"11512","3679新至陞","110/07/09","大昌-新店",0,2,-2
"11513","3679新至陞","110/07/09","國泰-敦南",2,0,2
"11514","3679新至陞","110/07/09","元大-新莊",0,2,-2
"11515","3679新至陞","110/07/09","元大-淡水",4,2,2
"11516","3679新至陞","110/07/09","元大-板橋",0,2,-2
"11517","3679新至陞","110/07/09","日盛-士林",1,0,1
"11518","3679新至陞","110/07/09","台灣摩根士丹利",0,1,-1
"11519","3679新至陞","110/07/09","日盛-信義",1,0,1
"11520","3679新至陞","110/07/09","第一金-高雄",0,1,-1
"11521","2727王品","110/07/09","台灣匯立證券",90,0,90
"11522","2727王品","110/07/09","台灣摩根士丹利",0,267,-267
"11523","2727王品","110/07/09","國泰-敦南",166,84,82
"11524","2727王品","110/07/09","富邦-台北",35,299,-264
"11525","2727王品","110/07/09","富邦-仁愛",56,12,44
"11526","2727王品","110/07/09","凱基-台北",174,296,-122
"11527","2727王品","110/07/09","台新證券",109,66,43
"11528","2727王品","110/07/09","第一金",2,102,-100
"11529","2727王品","110/07/09","新光",117,87,30
"11530","2727王品","110/07/09","群益金鼎-大安",0,80,-80
"11531","2727王品","110/07/09","臺銀-臺中",35,6,29
"11532","2727王品","110/07/09","兆豐-大安",7,60,-53
"11533","2727王品","110/07/09","元大-桃園",32,3,29
"11534","2727王品","110/07/09","永豐金-南投",0,50,-50
"11535","2727王品","110/07/09","元富-宜蘭",34,6,28
"11536","2727王品","110/07/09","新加坡商瑞銀",6,46,-40
"11537","2727王品","110/07/09","玉山-台中",34,8,26
"11538","2727王品","110/07/09","合庫-彰化",11,50,-39
"11539","2727王品","110/07/09","群益金鼎-宜蘭",30,4,26
"11540","2727王品","110/07/09","永豐金-萬盛",13,52,-39
"11541","2727王品","110/07/09","富邦-台中",42,16,26
"11542","2727王品","110/07/09","瑞士信貸",0,34,-34
"11543","2727王品","110/07/09","第一金-豐原",25,1,24
"11544","2727王品","110/07/09","元大-和平",4,35,-31
"11545","2727王品","110/07/09","臺銀",30,8,22
"11546","2727王品","110/07/09","美林",14,44,-30
"11547","2727王品","110/07/09","兆豐-來福",23,1,22
"11548","2727王品","110/07/09","元大-員林",9,38,-29
"11549","2727王品","110/07/09","玉山-士林",22,2,20
"11550","2727王品","110/07/09","元富-西松",4,31,-27
"11551","1570力肯","110/07/09","凱基-台北",30,1,29
"11552","1570力肯","110/07/09","群益金鼎-彰化",0,20,-20
"11553","1570力肯","110/07/09","新光-台南",20,0,20
"11554","1570力肯","110/07/09","元大-土城學府",0,20,-20
"11555","1570力肯","110/07/09","元大-高雄",20,0,20
"11556","1570力肯","110/07/09","元大-大統",0,16,-16
"11557","1570力肯","110/07/09","國票-中正",12,0,12
"11558","1570力肯","110/07/09","元大-新營",0,11,-11
"11559","1570力肯","110/07/09","日盛-高雄",6,0,6
"11560","1570力肯","110/07/09","元大-和平",0,10,-10
"11561","1570力肯","110/07/09","元富-緯城",6,0,6
"11562","1570力肯","110/07/09","元大-草屯",0,10,-10
"11563","1570力肯","110/07/09","群益金鼎-台南",6,0,6
"11564","1570力肯","110/07/09","元大-鹿港",0,9,-9
"11565","1570力肯","110/07/09","華南永昌-岡山",6,0,6
"11566","1570力肯","110/07/09","合庫-基隆",0,7,-7
"11567","1570力肯","110/07/09","統一-中壢",5,0,5
"11568","1570力肯","110/07/09","摩根大通",2,8,-6
"11569","1570力肯","110/07/09","凱基-三峽",5,0,5
"11570","1570力肯","110/07/09","台灣企銀-豐原",0,4,-4
"11571","1570力肯","110/07/09","大昌-樹林",4,0,4
"11572","1570力肯","110/07/09","日盛-桃園",0,4,-4
"11573","1570力肯","110/07/09","新光",3,0,3
"11574","1570力肯","110/07/09","國泰-高雄",0,3,-3
"11575","1570力肯","110/07/09","富邦-新竹華信",3,0,3
"11576","1570力肯","110/07/09","永豐金-敦南",0,3,-3
"11577","1570力肯","110/07/09","合庫-台中",2,0,2
"11578","1570力肯","110/07/09","土銀-彰化",0,2,-2
"11579","1570力肯","110/07/09","臺銀-臺中",2,0,2
"11580","1570力肯","110/07/09","臺銀-鳳山",0,2,-2
"11581","6180橘子","110/07/09","摩根大通",63,1,62
"11582","6180橘子","110/07/09","元大-南京",1,32,-31
"11583","6180橘子","110/07/09","富邦-陽明",73,33,40
"11584","6180橘子","110/07/09","群益金鼎-台北",0,25,-25
"11585","6180橘子","110/07/09","新加坡商瑞銀",31,0,31
"11586","6180橘子","110/07/09","兆豐-復興",0,21,-21
"11587","6180橘子","110/07/09","美商高盛",25,0,25
"11588","6180橘子","110/07/09","永豐金-嘉義",0,21,-21
"11589","6180橘子","110/07/09","凱基-台北",26,10,16
"11590","6180橘子","110/07/09","凱基-中壢",8,24,-16
"11591","6180橘子","110/07/09","華南永昌-楠梓",13,0,13
"11592","6180橘子","110/07/09","致和-崇德",0,15,-15
"11593","6180橘子","110/07/09","華南永昌-朴子",11,0,11
"11594","6180橘子","110/07/09","群益金鼎-屏東",0,15,-15
"11595","6180橘子","110/07/09","元大-北港",11,0,11
"11596","6180橘子","110/07/09","群益金鼎-中山",0,15,-15
"11597","6180橘子","110/07/09","元大-成功",10,1,9
"11598","6180橘子","110/07/09","瑞士信貸",1,15,-14
"11599","6180橘子","110/07/09","新光",26,18,8
"11600","6180橘子","110/07/09","日盛-二林",0,10,-10
"11601","6180橘子","110/07/09","統一-三重",6,0,6
"11602","6180橘子","110/07/09","凱基-東門",0,10,-10
"11603","6180橘子","110/07/09","群益金鼎-嘉義",6,0,6
"11604","6180橘子","110/07/09","華南永昌-三重",0,10,-10
"11605","6180橘子","110/07/09","元大-員林中山",6,0,6
"11606","6180橘子","110/07/09","元大-彰化民生",1,11,-10
"11607","6180橘子","110/07/09","合庫-鳳山",5,0,5
"11608","6180橘子","110/07/09","永豐金-新店",1,11,-10
"11609","6180橘子","110/07/09","富邦-建國",6,1,5
"11610","6180橘子","110/07/09","群益金鼎-丹鳳",0,8,-8
"11611","2390云辰","110/07/09","摩根大通",279,56,223
"11612","2390云辰","110/07/09","元大-天母",0,127,-127
"11613","2390云辰","110/07/09","日盛-鳳山",110,2,108
"11614","2390云辰","110/07/09","中國信託-文心",5,109,-104
"11615","2390云辰","110/07/09","宏遠證券",100,0,100
"11616","2390云辰","110/07/09","永豐金-復興",0,55,-55
"11617","2390云辰","110/07/09","元大-大里",63,6,57
"11618","2390云辰","110/07/09","凱基-台北",239,286,-47
"11619","2390云辰","110/07/09","凱基-八德",59,10,49
"11620","2390云辰","110/07/09","德信",2,32,-30
"11621","2390云辰","110/07/09","合庫-新竹",40,0,40
"11622","2390云辰","110/07/09","兆豐-桃鶯",2,32,-30
"11623","2390云辰","110/07/09","國票",40,1,39
"11624","2390云辰","110/07/09","致和-南京",0,30,-30
"11625","2390云辰","110/07/09","新加坡商瑞銀",49,13,36
"11626","2390云辰","110/07/09","富邦-虎尾",1,31,-30
"11627","2390云辰","110/07/09","統一-新台中",36,2,34
"11628","2390云辰","110/07/09","元大-善化",2,31,-29
"11629","2390云辰","110/07/09","國票-嘉義",31,0,31
"11630","2390云辰","110/07/09","富邦-板橋",0,27,-27
"11631","2390云辰","110/07/09","華南永昌",35,7,28
"11632","2390云辰","110/07/09","富邦-永和",3,28,-25
"11633","2390云辰","110/07/09","玉山-台中",49,22,27
"11634","2390云辰","110/07/09","第一金-自由",20,44,-24
"11635","2390云辰","110/07/09","華南永昌-敦南",25,0,25
"11636","2390云辰","110/07/09","凱基-內湖",0,24,-24
"11637","2390云辰","110/07/09","新光-高雄",27,4,23
"11638","2390云辰","110/07/09","元大-汐止",1,24,-23
"11639","2390云辰","110/07/09","台灣摩根士丹利",85,63,22
"11640","2390云辰","110/07/09","新光-台中",12,33,-21
"11641","4903聯光通","110/07/09","元大-敦南",10,0,10
"11642","4903聯光通","110/07/09","第一金-台中",0,12,-12
"11643","4903聯光通","110/07/09","凱基-士林",5,0,5
"11644","4903聯光通","110/07/09","日盛-忠孝",0,3,-3
"11645","4903聯光通","110/07/09","元大-苗栗",5,0,5
"11646","4903聯光通","110/07/09","群益金鼎-崇德",0,3,-3
"11647","4903聯光通","110/07/09","元大-屏南",3,0,3
"11648","4903聯光通","110/07/09","國票-內壢",0,2,-2
"11649","4903聯光通","110/07/09","中國信託-永康",1,0,1
"11650","4903聯光通","110/07/09","康和-南崁",0,2,-2
"11651","4903聯光通","110/07/09","玉山證券",1,0,1
"11652","4903聯光通","110/07/09","新光-台中",0,2,-2
"11653","4903聯光通","110/07/09","元大-太平",4,3,1
"11654","4903聯光通","110/07/09","玉山-城中",0,2,-2
"11655","4903聯光通","110/07/09","永豐金-嘉義",1,0,1
"11656","4903聯光通","110/07/09","中國信託-文心",0,1,-1
"11657","4903聯光通","110/07/09","大昌",0,0,0
"11658","4903聯光通","110/07/09","大昌",0,0,0
"11659","4903聯光通","110/07/09","中農",0,0,0
"11660","4903聯光通","110/07/09","中農",0,0,0
"11661","4903聯光通","110/07/09","",NA,NA,NA
"11662","4903聯光通","110/07/09","",NA,NA,NA
"11663","4903聯光通","110/07/09","",NA,NA,NA
"11664","4903聯光通","110/07/09","",NA,NA,NA
"11665","4903聯光通","110/07/09","",NA,NA,NA
"11666","4903聯光通","110/07/09","",NA,NA,NA
"11667","4903聯光通","110/07/09","",NA,NA,NA
"11668","4903聯光通","110/07/09","",NA,NA,NA
"11669","4903聯光通","110/07/09","",NA,NA,NA
"11670","4903聯光通","110/07/09","",NA,NA,NA
"11671","2929淘帝","110/07/09","台中銀-台北",110,0,110
"11672","2929淘帝","110/07/09","新光",2,82,-80
"11673","2929淘帝","110/07/09","華南永昌-頭份",72,0,72
"11674","2929淘帝","110/07/09","摩根大通",2,63,-61
"11675","2929淘帝","110/07/09","合庫-高雄",71,0,71
"11676","2929淘帝","110/07/09","第一金-路竹",0,50,-50
"11677","2929淘帝","110/07/09","高橋-龍潭",37,0,37
"11678","2929淘帝","110/07/09","港商麥格理",0,42,-42
"11679","2929淘帝","110/07/09","新光-台中",60,26,34
"11680","2929淘帝","110/07/09","陽信-石牌",0,40,-40
"11681","2929淘帝","110/07/09","元富-大裕",22,1,21
"11682","2929淘帝","110/07/09","台新-左楠",1,39,-38
"11683","2929淘帝","110/07/09","合庫-鳳山",20,0,20
"11684","2929淘帝","110/07/09","凱基-桃園",3,29,-26
"11685","2929淘帝","110/07/09","元大-員林",22,2,20
"11686","2929淘帝","110/07/09","兆豐-內湖",0,25,-25
"11687","2929淘帝","110/07/09","台新-建北",15,0,15
"11688","2929淘帝","110/07/09","元大-北港",0,20,-20
"11689","2929淘帝","110/07/09","兆豐-桃園",13,0,13
"11690","2929淘帝","110/07/09","富邦-北港",0,19,-19
"11691","2929淘帝","110/07/09","兆豐-忠孝",10,0,10
"11692","2929淘帝","110/07/09","富邦-花蓮",0,17,-17
"11693","2929淘帝","110/07/09","國票-敦北法人",10,0,10
"11694","2929淘帝","110/07/09","國泰-台中",2,17,-15
"11695","2929淘帝","110/07/09","永豐金-博愛",10,0,10
"11696","2929淘帝","110/07/09","群益金鼎-彰化",0,15,-15
"11697","2929淘帝","110/07/09","群益金鼎-潭子",8,0,8
"11698","2929淘帝","110/07/09","元大-博愛",0,14,-14
"11699","2929淘帝","110/07/09","富邦-南屯",8,0,8
"11700","2929淘帝","110/07/09","日盛-板橋",0,13,-13
"11701","5410國眾","110/07/09","元大-新盛",14,0,14
"11702","5410國眾","110/07/09","(牛牛牛)亞-鑫豐",1,41,-40
"11703","5410國眾","110/07/09","台灣企銀-民雄",10,0,10
"11704","5410國眾","110/07/09","元富-嘉義",0,25,-25
"11705","5410國眾","110/07/09","元富-虎尾",9,0,9
"11706","5410國眾","110/07/09","凱基-高美館",0,10,-10
"11707","5410國眾","110/07/09","摩根大通",10,1,9
"11708","5410國眾","110/07/09","凱基-城中",0,10,-10
"11709","5410國眾","110/07/09","兆豐-北高雄",7,0,7
"11710","5410國眾","110/07/09","元大-頭份",0,10,-10
"11711","5410國眾","110/07/09","凱基-台北",8,1,7
"11712","5410國眾","110/07/09","群益金鼎-丹鳳",0,7,-7
"11713","5410國眾","110/07/09","華南永昌-公誠",7,0,7
"11714","5410國眾","110/07/09","凱基-復興",0,7,-7
"11715","5410國眾","110/07/09","香港上海匯豐",6,0,6
"11716","5410國眾","110/07/09","元大-員林",0,7,-7
"11717","5410國眾","110/07/09","凱基-中壢",6,0,6
"11718","5410國眾","110/07/09","富邦-竹東",0,6,-6
"11719","5410國眾","110/07/09","華南永昌-南京",6,0,6
"11720","5410國眾","110/07/09","亞東-高雄",0,5,-5
"11721","5410國眾","110/07/09","統一-三重",5,0,5
"11722","5410國眾","110/07/09","大慶-中壢",1,6,-5
"11723","5410國眾","110/07/09","富邦-宜蘭",5,0,5
"11724","5410國眾","110/07/09","群益金鼎-中港",0,5,-5
"11725","5410國眾","110/07/09","元大-崇德",5,0,5
"11726","5410國眾","110/07/09","元大-八德",0,5,-5
"11727","5410國眾","110/07/09","元大-博愛",5,0,5
"11728","5410國眾","110/07/09","富邦-基隆",0,4,-4
"11729","5410國眾","110/07/09","元大-龍潭",5,0,5
"11730","5410國眾","110/07/09","臺銀-新竹",0,3,-3
"11731","2841台開","110/07/09","日盛-雙和",102,0,102
"11732","2841台開","110/07/09","港商野村",0,129,-129
"11733","2841台開","110/07/09","元大-館前",70,0,70
"11734","2841台開","110/07/09","兆豐-永和",0,100,-100
"11735","2841台開","110/07/09","凱基-文心",50,0,50
"11736","2841台開","110/07/09","台新證券",7,28,-21
"11737","2841台開","110/07/09","富邦-嘉義",40,0,40
"11738","2841台開","110/07/09","國票-北高雄",0,20,-20
"11739","2841台開","110/07/09","美商高盛",15,0,15
"11740","2841台開","110/07/09","永豐金-敦南",29,46,-17
"11741","2841台開","110/07/09","台中銀",15,0,15
"11742","2841台開","110/07/09","合庫-基隆",0,12,-12
"11743","2841台開","110/07/09","新光",11,0,11
"11744","2841台開","110/07/09","中國信託-松江",0,12,-12
"11745","2841台開","110/07/09","華南永昌-長虹",10,0,10
"11746","2841台開","110/07/09","兆豐-城中",0,12,-12
"11747","2841台開","110/07/09","永豐金-南投",10,0,10
"11748","2841台開","110/07/09","台中銀-豐原",0,10,-10
"11749","2841台開","110/07/09","合庫-桃園",7,0,7
"11750","2841台開","110/07/09","兆豐-景美",0,10,-10
"11751","2841台開","110/07/09","群益金鼎-古亭",7,0,7
"11752","2841台開","110/07/09","群益金鼎-基隆",0,10,-10
"11753","2841台開","110/07/09","國泰-敦南",6,0,6
"11754","2841台開","110/07/09","元大-北三重",0,10,-10
"11755","2841台開","110/07/09","凱基-桃園",8,2,6
"11756","2841台開","110/07/09","(牛牛牛)亞-網路",0,9,-9
"11757","2841台開","110/07/09","日盛證券",5,0,5
"11758","2841台開","110/07/09","台新-高雄",1,10,-9
"11759","2841台開","110/07/09","元富-文心",5,0,5
"11760","2841台開","110/07/09","凱基-台北",0,7,-7
"11761","6207雷科","110/07/09","群益金鼎-新竹",47,0,47
"11762","6207雷科","110/07/09","新光",7,24,-17
"11763","6207雷科","110/07/09","永豐金-三重",31,0,31
"11764","6207雷科","110/07/09","日盛-和美",0,15,-15
"11765","6207雷科","110/07/09","新加坡商瑞銀",33,5,28
"11766","6207雷科","110/07/09","國泰-台南",0,15,-15
"11767","6207雷科","110/07/09","元大-高雄",26,0,26
"11768","6207雷科","110/07/09","華南永昌-古亭",0,14,-14
"11769","6207雷科","110/07/09","統一-員林",22,0,22
"11770","6207雷科","110/07/09","土銀-白河",0,11,-11
"11771","6207雷科","110/07/09","台新-高雄",22,0,22
"11772","6207雷科","110/07/09","日盛-台南",0,10,-10
"11773","6207雷科","110/07/09","摩根大通",34,17,17
"11774","6207雷科","110/07/09","元富-林園",0,10,-10
"11775","6207雷科","110/07/09","元大-博愛",17,1,16
"11776","6207雷科","110/07/09","富邦-園區",0,10,-10
"11777","6207雷科","110/07/09","日茂-埔里",12,0,12
"11778","6207雷科","110/07/09","元大-上新莊",0,10,-10
"11779","6207雷科","110/07/09","國泰-台中",17,6,11
"11780","6207雷科","110/07/09","永豐金-南京",0,10,-10
"11781","6207雷科","110/07/09","富邦-三重",10,0,10
"11782","6207雷科","110/07/09","兆豐-小港",0,6,-6
"11783","6207雷科","110/07/09","元大-沙鹿",10,0,10
"11784","6207雷科","110/07/09","富邦-羅東",1,7,-6
"11785","6207雷科","110/07/09","元大-八德",10,0,10
"11786","6207雷科","110/07/09","元大-土城永寧",0,6,-6
"11787","6207雷科","110/07/09","第一金-路竹",11,2,9
"11788","6207雷科","110/07/09","永豐金-板盛",0,6,-6
"11789","6207雷科","110/07/09","統一-南京",5,0,5
"11790","6207雷科","110/07/09","日盛-板橋",0,5,-5
"11791","3679新至陞","110/07/09","元大-大天母",10,0,10
"11792","3679新至陞","110/07/09","第一金-光復",0,11,-11
"11793","3679新至陞","110/07/09","日盛-樹林",9,0,9
"11794","3679新至陞","110/07/09","瑞士信貸",0,8,-8
"11795","3679新至陞","110/07/09","凱基-台北",11,2,9
"11796","3679新至陞","110/07/09","大慶-苗栗",0,5,-5
"11797","3679新至陞","110/07/09","華南永昌-小港",8,0,8
"11798","3679新至陞","110/07/09","元大-永春",0,5,-5
"11799","3679新至陞","110/07/09","兆豐-來福",7,0,7
"11800","3679新至陞","110/07/09","日盛-和美",0,4,-4
"11801","3679新至陞","110/07/09","香港上海匯豐",5,0,5
"11802","3679新至陞","110/07/09","元大-雙和",0,3,-3
"11803","3679新至陞","110/07/09","台中銀-員林",3,0,3
"11804","3679新至陞","110/07/09","永豐金-屏東",0,3,-3
"11805","3679新至陞","110/07/09","新光",3,0,3
"11806","3679新至陞","110/07/09","彰銀",0,2,-2
"11807","3679新至陞","110/07/09","土銀-花蓮",2,0,2
"11808","3679新至陞","110/07/09","宏遠-館前",0,2,-2
"11809","3679新至陞","110/07/09","第一金-澎湖",2,0,2
"11810","3679新至陞","110/07/09","港商野村",0,2,-2
"11811","3679新至陞","110/07/09","摩根大通",2,0,2
"11812","3679新至陞","110/07/09","大昌-新店",0,2,-2
"11813","3679新至陞","110/07/09","國泰-敦南",2,0,2
"11814","3679新至陞","110/07/09","元大-新莊",0,2,-2
"11815","3679新至陞","110/07/09","元大-淡水",4,2,2
"11816","3679新至陞","110/07/09","元大-板橋",0,2,-2
"11817","3679新至陞","110/07/09","日盛-士林",1,0,1
"11818","3679新至陞","110/07/09","台灣摩根士丹利",0,1,-1
"11819","3679新至陞","110/07/09","日盛-信義",1,0,1
"11820","3679新至陞","110/07/09","第一金-高雄",0,1,-1
"11821","2727王品","110/07/09","台灣匯立證券",90,0,90
"11822","2727王品","110/07/09","台灣摩根士丹利",0,267,-267
"11823","2727王品","110/07/09","國泰-敦南",166,84,82
"11824","2727王品","110/07/09","富邦-台北",35,299,-264
"11825","2727王品","110/07/09","富邦-仁愛",56,12,44
"11826","2727王品","110/07/09","凱基-台北",174,296,-122
"11827","2727王品","110/07/09","台新證券",109,66,43
"11828","2727王品","110/07/09","第一金",2,102,-100
"11829","2727王品","110/07/09","新光",117,87,30
"11830","2727王品","110/07/09","群益金鼎-大安",0,80,-80
"11831","2727王品","110/07/09","臺銀-臺中",35,6,29
"11832","2727王品","110/07/09","兆豐-大安",7,60,-53
"11833","2727王品","110/07/09","元大-桃園",32,3,29
"11834","2727王品","110/07/09","永豐金-南投",0,50,-50
"11835","2727王品","110/07/09","元富-宜蘭",34,6,28
"11836","2727王品","110/07/09","新加坡商瑞銀",6,46,-40
"11837","2727王品","110/07/09","玉山-台中",34,8,26
"11838","2727王品","110/07/09","合庫-彰化",11,50,-39
"11839","2727王品","110/07/09","群益金鼎-宜蘭",30,4,26
"11840","2727王品","110/07/09","永豐金-萬盛",13,52,-39
"11841","2727王品","110/07/09","富邦-台中",42,16,26
"11842","2727王品","110/07/09","瑞士信貸",0,34,-34
"11843","2727王品","110/07/09","第一金-豐原",25,1,24
"11844","2727王品","110/07/09","元大-和平",4,35,-31
"11845","2727王品","110/07/09","臺銀",30,8,22
"11846","2727王品","110/07/09","美林",14,44,-30
"11847","2727王品","110/07/09","兆豐-來福",23,1,22
"11848","2727王品","110/07/09","元大-員林",9,38,-29
"11849","2727王品","110/07/09","玉山-士林",22,2,20
"11850","2727王品","110/07/09","元富-西松",4,31,-27
"11851","1570力肯","110/07/09","凱基-台北",30,1,29
"11852","1570力肯","110/07/09","群益金鼎-彰化",0,20,-20
"11853","1570力肯","110/07/09","新光-台南",20,0,20
"11854","1570力肯","110/07/09","元大-土城學府",0,20,-20
"11855","1570力肯","110/07/09","元大-高雄",20,0,20
"11856","1570力肯","110/07/09","元大-大統",0,16,-16
"11857","1570力肯","110/07/09","國票-中正",12,0,12
"11858","1570力肯","110/07/09","元大-新營",0,11,-11
"11859","1570力肯","110/07/09","日盛-高雄",6,0,6
"11860","1570力肯","110/07/09","元大-和平",0,10,-10
"11861","1570力肯","110/07/09","元富-緯城",6,0,6
"11862","1570力肯","110/07/09","元大-草屯",0,10,-10
"11863","1570力肯","110/07/09","群益金鼎-台南",6,0,6
"11864","1570力肯","110/07/09","元大-鹿港",0,9,-9
"11865","1570力肯","110/07/09","華南永昌-岡山",6,0,6
"11866","1570力肯","110/07/09","合庫-基隆",0,7,-7
"11867","1570力肯","110/07/09","統一-中壢",5,0,5
"11868","1570力肯","110/07/09","摩根大通",2,8,-6
"11869","1570力肯","110/07/09","凱基-三峽",5,0,5
"11870","1570力肯","110/07/09","台灣企銀-豐原",0,4,-4
"11871","1570力肯","110/07/09","大昌-樹林",4,0,4
"11872","1570力肯","110/07/09","日盛-桃園",0,4,-4
"11873","1570力肯","110/07/09","新光",3,0,3
"11874","1570力肯","110/07/09","國泰-高雄",0,3,-3
"11875","1570力肯","110/07/09","富邦-新竹華信",3,0,3
"11876","1570力肯","110/07/09","永豐金-敦南",0,3,-3
"11877","1570力肯","110/07/09","合庫-台中",2,0,2
"11878","1570力肯","110/07/09","土銀-彰化",0,2,-2
"11879","1570力肯","110/07/09","臺銀-臺中",2,0,2
"11880","1570力肯","110/07/09","臺銀-鳳山",0,2,-2
"11881","6180橘子","110/07/09","摩根大通",63,1,62
"11882","6180橘子","110/07/09","元大-南京",1,32,-31
"11883","6180橘子","110/07/09","富邦-陽明",73,33,40
"11884","6180橘子","110/07/09","群益金鼎-台北",0,25,-25
"11885","6180橘子","110/07/09","新加坡商瑞銀",31,0,31
"11886","6180橘子","110/07/09","兆豐-復興",0,21,-21
"11887","6180橘子","110/07/09","美商高盛",25,0,25
"11888","6180橘子","110/07/09","永豐金-嘉義",0,21,-21
"11889","6180橘子","110/07/09","凱基-台北",26,10,16
"11890","6180橘子","110/07/09","凱基-中壢",8,24,-16
"11891","6180橘子","110/07/09","華南永昌-楠梓",13,0,13
"11892","6180橘子","110/07/09","致和-崇德",0,15,-15
"11893","6180橘子","110/07/09","華南永昌-朴子",11,0,11
"11894","6180橘子","110/07/09","群益金鼎-屏東",0,15,-15
"11895","6180橘子","110/07/09","元大-北港",11,0,11
"11896","6180橘子","110/07/09","群益金鼎-中山",0,15,-15
"11897","6180橘子","110/07/09","元大-成功",10,1,9
"11898","6180橘子","110/07/09","瑞士信貸",1,15,-14
"11899","6180橘子","110/07/09","新光",26,18,8
"11900","6180橘子","110/07/09","日盛-二林",0,10,-10
"11901","6180橘子","110/07/09","統一-三重",6,0,6
"11902","6180橘子","110/07/09","凱基-東門",0,10,-10
"11903","6180橘子","110/07/09","群益金鼎-嘉義",6,0,6
"11904","6180橘子","110/07/09","華南永昌-三重",0,10,-10
"11905","6180橘子","110/07/09","元大-員林中山",6,0,6
"11906","6180橘子","110/07/09","元大-彰化民生",1,11,-10
"11907","6180橘子","110/07/09","合庫-鳳山",5,0,5
"11908","6180橘子","110/07/09","永豐金-新店",1,11,-10
"11909","6180橘子","110/07/09","富邦-建國",6,1,5
"11910","6180橘子","110/07/09","群益金鼎-丹鳳",0,8,-8
"11911","2390云辰","110/07/09","摩根大通",279,56,223
"11912","2390云辰","110/07/09","元大-天母",0,127,-127
"11913","2390云辰","110/07/09","日盛-鳳山",110,2,108
"11914","2390云辰","110/07/09","中國信託-文心",5,109,-104
"11915","2390云辰","110/07/09","宏遠證券",100,0,100
"11916","2390云辰","110/07/09","永豐金-復興",0,55,-55
"11917","2390云辰","110/07/09","元大-大里",63,6,57
"11918","2390云辰","110/07/09","凱基-台北",239,286,-47
"11919","2390云辰","110/07/09","凱基-八德",59,10,49
"11920","2390云辰","110/07/09","德信",2,32,-30
"11921","2390云辰","110/07/09","合庫-新竹",40,0,40
"11922","2390云辰","110/07/09","兆豐-桃鶯",2,32,-30
"11923","2390云辰","110/07/09","國票",40,1,39
"11924","2390云辰","110/07/09","致和-南京",0,30,-30
"11925","2390云辰","110/07/09","新加坡商瑞銀",49,13,36
"11926","2390云辰","110/07/09","富邦-虎尾",1,31,-30
"11927","2390云辰","110/07/09","統一-新台中",36,2,34
"11928","2390云辰","110/07/09","元大-善化",2,31,-29
"11929","2390云辰","110/07/09","國票-嘉義",31,0,31
"11930","2390云辰","110/07/09","富邦-板橋",0,27,-27
"11931","2390云辰","110/07/09","華南永昌",35,7,28
"11932","2390云辰","110/07/09","富邦-永和",3,28,-25
"11933","2390云辰","110/07/09","玉山-台中",49,22,27
"11934","2390云辰","110/07/09","第一金-自由",20,44,-24
"11935","2390云辰","110/07/09","華南永昌-敦南",25,0,25
"11936","2390云辰","110/07/09","凱基-內湖",0,24,-24
"11937","2390云辰","110/07/09","新光-高雄",27,4,23
"11938","2390云辰","110/07/09","元大-汐止",1,24,-23
"11939","2390云辰","110/07/09","台灣摩根士丹利",85,63,22
"11940","2390云辰","110/07/09","新光-台中",12,33,-21
"11941","4903聯光通","110/07/09","元大-敦南",10,0,10
"11942","4903聯光通","110/07/09","第一金-台中",0,12,-12
"11943","4903聯光通","110/07/09","凱基-士林",5,0,5
"11944","4903聯光通","110/07/09","日盛-忠孝",0,3,-3
"11945","4903聯光通","110/07/09","元大-苗栗",5,0,5
"11946","4903聯光通","110/07/09","群益金鼎-崇德",0,3,-3
"11947","4903聯光通","110/07/09","元大-屏南",3,0,3
"11948","4903聯光通","110/07/09","國票-內壢",0,2,-2
"11949","4903聯光通","110/07/09","中國信託-永康",1,0,1
"11950","4903聯光通","110/07/09","康和-南崁",0,2,-2
"11951","4903聯光通","110/07/09","玉山證券",1,0,1
"11952","4903聯光通","110/07/09","新光-台中",0,2,-2
"11953","4903聯光通","110/07/09","元大-太平",4,3,1
"11954","4903聯光通","110/07/09","玉山-城中",0,2,-2
"11955","4903聯光通","110/07/09","永豐金-嘉義",1,0,1
"11956","4903聯光通","110/07/09","中國信託-文心",0,1,-1
"11957","4903聯光通","110/07/09","大昌",0,0,0
"11958","4903聯光通","110/07/09","大昌",0,0,0
"11959","4903聯光通","110/07/09","中農",0,0,0
"11960","4903聯光通","110/07/09","中農",0,0,0
"11961","4903聯光通","110/07/09","",NA,NA,NA
"11962","4903聯光通","110/07/09","",NA,NA,NA
"11963","4903聯光通","110/07/09","",NA,NA,NA
"11964","4903聯光通","110/07/09","",NA,NA,NA
"11965","4903聯光通","110/07/09","",NA,NA,NA
"11966","4903聯光通","110/07/09","",NA,NA,NA
"11967","4903聯光通","110/07/09","",NA,NA,NA
"11968","4903聯光通","110/07/09","",NA,NA,NA
"11969","4903聯光通","110/07/09","",NA,NA,NA
"11970","4903聯光通","110/07/09","",NA,NA,NA
"11971","2929淘帝","110/07/09","台中銀-台北",110,0,110
"11972","2929淘帝","110/07/09","新光",2,82,-80
"11973","2929淘帝","110/07/09","華南永昌-頭份",72,0,72
"11974","2929淘帝","110/07/09","摩根大通",2,63,-61
"11975","2929淘帝","110/07/09","合庫-高雄",71,0,71
"11976","2929淘帝","110/07/09","第一金-路竹",0,50,-50
"11977","2929淘帝","110/07/09","高橋-龍潭",37,0,37
"11978","2929淘帝","110/07/09","港商麥格理",0,42,-42
"11979","2929淘帝","110/07/09","新光-台中",60,26,34
"11980","2929淘帝","110/07/09","陽信-石牌",0,40,-40
"11981","2929淘帝","110/07/09","元富-大裕",22,1,21
"11982","2929淘帝","110/07/09","台新-左楠",1,39,-38
"11983","2929淘帝","110/07/09","合庫-鳳山",20,0,20
"11984","2929淘帝","110/07/09","凱基-桃園",3,29,-26
"11985","2929淘帝","110/07/09","元大-員林",22,2,20
"11986","2929淘帝","110/07/09","兆豐-內湖",0,25,-25
"11987","2929淘帝","110/07/09","台新-建北",15,0,15
"11988","2929淘帝","110/07/09","元大-北港",0,20,-20
"11989","2929淘帝","110/07/09","兆豐-桃園",13,0,13
"11990","2929淘帝","110/07/09","富邦-北港",0,19,-19
"11991","2929淘帝","110/07/09","兆豐-忠孝",10,0,10
"11992","2929淘帝","110/07/09","富邦-花蓮",0,17,-17
"11993","2929淘帝","110/07/09","國票-敦北法人",10,0,10
"11994","2929淘帝","110/07/09","國泰-台中",2,17,-15
"11995","2929淘帝","110/07/09","永豐金-博愛",10,0,10
"11996","2929淘帝","110/07/09","群益金鼎-彰化",0,15,-15
"11997","2929淘帝","110/07/09","群益金鼎-潭子",8,0,8
"11998","2929淘帝","110/07/09","元大-博愛",0,14,-14
"11999","2929淘帝","110/07/09","富邦-南屯",8,0,8
"12000","2929淘帝","110/07/09","日盛-板橋",0,13,-13
"12001","5410國眾","110/07/09","元大-新盛",14,0,14
"12002","5410國眾","110/07/09","(牛牛牛)亞-鑫豐",1,41,-40
"12003","5410國眾","110/07/09","台灣企銀-民雄",10,0,10
"12004","5410國眾","110/07/09","元富-嘉義",0,25,-25
"12005","5410國眾","110/07/09","元富-虎尾",9,0,9
"12006","5410國眾","110/07/09","凱基-高美館",0,10,-10
"12007","5410國眾","110/07/09","摩根大通",10,1,9
"12008","5410國眾","110/07/09","凱基-城中",0,10,-10
"12009","5410國眾","110/07/09","兆豐-北高雄",7,0,7
"12010","5410國眾","110/07/09","元大-頭份",0,10,-10
"12011","5410國眾","110/07/09","凱基-台北",8,1,7
"12012","5410國眾","110/07/09","群益金鼎-丹鳳",0,7,-7
"12013","5410國眾","110/07/09","華南永昌-公誠",7,0,7
"12014","5410國眾","110/07/09","凱基-復興",0,7,-7
"12015","5410國眾","110/07/09","香港上海匯豐",6,0,6
"12016","5410國眾","110/07/09","元大-員林",0,7,-7
"12017","5410國眾","110/07/09","凱基-中壢",6,0,6
"12018","5410國眾","110/07/09","富邦-竹東",0,6,-6
"12019","5410國眾","110/07/09","華南永昌-南京",6,0,6
"12020","5410國眾","110/07/09","亞東-高雄",0,5,-5
"12021","5410國眾","110/07/09","統一-三重",5,0,5
"12022","5410國眾","110/07/09","大慶-中壢",1,6,-5
"12023","5410國眾","110/07/09","富邦-宜蘭",5,0,5
"12024","5410國眾","110/07/09","群益金鼎-中港",0,5,-5
"12025","5410國眾","110/07/09","元大-崇德",5,0,5
"12026","5410國眾","110/07/09","元大-八德",0,5,-5
"12027","5410國眾","110/07/09","元大-博愛",5,0,5
"12028","5410國眾","110/07/09","富邦-基隆",0,4,-4
"12029","5410國眾","110/07/09","元大-龍潭",5,0,5
"12030","5410國眾","110/07/09","臺銀-新竹",0,3,-3
"12031","2841台開","110/07/09","日盛-雙和",102,0,102
"12032","2841台開","110/07/09","港商野村",0,129,-129
"12033","2841台開","110/07/09","元大-館前",70,0,70
"12034","2841台開","110/07/09","兆豐-永和",0,100,-100
"12035","2841台開","110/07/09","凱基-文心",50,0,50
"12036","2841台開","110/07/09","台新證券",7,28,-21
"12037","2841台開","110/07/09","富邦-嘉義",40,0,40
"12038","2841台開","110/07/09","國票-北高雄",0,20,-20
"12039","2841台開","110/07/09","美商高盛",15,0,15
"12040","2841台開","110/07/09","永豐金-敦南",29,46,-17
"12041","2841台開","110/07/09","台中銀",15,0,15
"12042","2841台開","110/07/09","合庫-基隆",0,12,-12
"12043","2841台開","110/07/09","新光",11,0,11
"12044","2841台開","110/07/09","中國信託-松江",0,12,-12
"12045","2841台開","110/07/09","華南永昌-長虹",10,0,10
"12046","2841台開","110/07/09","兆豐-城中",0,12,-12
"12047","2841台開","110/07/09","永豐金-南投",10,0,10
"12048","2841台開","110/07/09","台中銀-豐原",0,10,-10
"12049","2841台開","110/07/09","合庫-桃園",7,0,7
"12050","2841台開","110/07/09","兆豐-景美",0,10,-10
"12051","2841台開","110/07/09","群益金鼎-古亭",7,0,7
"12052","2841台開","110/07/09","群益金鼎-基隆",0,10,-10
"12053","2841台開","110/07/09","國泰-敦南",6,0,6
"12054","2841台開","110/07/09","元大-北三重",0,10,-10
"12055","2841台開","110/07/09","凱基-桃園",8,2,6
"12056","2841台開","110/07/09","(牛牛牛)亞-網路",0,9,-9
"12057","2841台開","110/07/09","日盛證券",5,0,5
"12058","2841台開","110/07/09","台新-高雄",1,10,-9
"12059","2841台開","110/07/09","元富-文心",5,0,5
"12060","2841台開","110/07/09","凱基-台北",0,7,-7
"12061","6207雷科","110/07/09","群益金鼎-新竹",47,0,47
"12062","6207雷科","110/07/09","新光",7,24,-17
"12063","6207雷科","110/07/09","永豐金-三重",31,0,31
"12064","6207雷科","110/07/09","日盛-和美",0,15,-15
"12065","6207雷科","110/07/09","新加坡商瑞銀",33,5,28
"12066","6207雷科","110/07/09","國泰-台南",0,15,-15
"12067","6207雷科","110/07/09","元大-高雄",26,0,26
"12068","6207雷科","110/07/09","華南永昌-古亭",0,14,-14
"12069","6207雷科","110/07/09","統一-員林",22,0,22
"12070","6207雷科","110/07/09","土銀-白河",0,11,-11
"12071","6207雷科","110/07/09","台新-高雄",22,0,22
"12072","6207雷科","110/07/09","日盛-台南",0,10,-10
"12073","6207雷科","110/07/09","摩根大通",34,17,17
"12074","6207雷科","110/07/09","元富-林園",0,10,-10
"12075","6207雷科","110/07/09","元大-博愛",17,1,16
"12076","6207雷科","110/07/09","富邦-園區",0,10,-10
"12077","6207雷科","110/07/09","日茂-埔里",12,0,12
"12078","6207雷科","110/07/09","元大-上新莊",0,10,-10
"12079","6207雷科","110/07/09","國泰-台中",17,6,11
"12080","6207雷科","110/07/09","永豐金-南京",0,10,-10
"12081","6207雷科","110/07/09","富邦-三重",10,0,10
"12082","6207雷科","110/07/09","兆豐-小港",0,6,-6
"12083","6207雷科","110/07/09","元大-沙鹿",10,0,10
"12084","6207雷科","110/07/09","富邦-羅東",1,7,-6
"12085","6207雷科","110/07/09","元大-八德",10,0,10
"12086","6207雷科","110/07/09","元大-土城永寧",0,6,-6
"12087","6207雷科","110/07/09","第一金-路竹",11,2,9
"12088","6207雷科","110/07/09","永豐金-板盛",0,6,-6
"12089","6207雷科","110/07/09","統一-南京",5,0,5
"12090","6207雷科","110/07/09","日盛-板橋",0,5,-5
"12091","3679新至陞","110/07/09","元大-大天母",10,0,10
"12092","3679新至陞","110/07/09","第一金-光復",0,11,-11
"12093","3679新至陞","110/07/09","日盛-樹林",9,0,9
"12094","3679新至陞","110/07/09","瑞士信貸",0,8,-8
"12095","3679新至陞","110/07/09","凱基-台北",11,2,9
"12096","3679新至陞","110/07/09","大慶-苗栗",0,5,-5
"12097","3679新至陞","110/07/09","華南永昌-小港",8,0,8
"12098","3679新至陞","110/07/09","元大-永春",0,5,-5
"12099","3679新至陞","110/07/09","兆豐-來福",7,0,7
"12100","3679新至陞","110/07/09","日盛-和美",0,4,-4
"12101","3679新至陞","110/07/09","香港上海匯豐",5,0,5
"12102","3679新至陞","110/07/09","元大-雙和",0,3,-3
"12103","3679新至陞","110/07/09","台中銀-員林",3,0,3
"12104","3679新至陞","110/07/09","永豐金-屏東",0,3,-3
"12105","3679新至陞","110/07/09","新光",3,0,3
"12106","3679新至陞","110/07/09","彰銀",0,2,-2
"12107","3679新至陞","110/07/09","土銀-花蓮",2,0,2
"12108","3679新至陞","110/07/09","宏遠-館前",0,2,-2
"12109","3679新至陞","110/07/09","第一金-澎湖",2,0,2
"12110","3679新至陞","110/07/09","港商野村",0,2,-2
"12111","3679新至陞","110/07/09","摩根大通",2,0,2
"12112","3679新至陞","110/07/09","大昌-新店",0,2,-2
"12113","3679新至陞","110/07/09","國泰-敦南",2,0,2
"12114","3679新至陞","110/07/09","元大-新莊",0,2,-2
"12115","3679新至陞","110/07/09","元大-淡水",4,2,2
"12116","3679新至陞","110/07/09","元大-板橋",0,2,-2
"12117","3679新至陞","110/07/09","日盛-士林",1,0,1
"12118","3679新至陞","110/07/09","台灣摩根士丹利",0,1,-1
"12119","3679新至陞","110/07/09","日盛-信義",1,0,1
"12120","3679新至陞","110/07/09","第一金-高雄",0,1,-1
"12121","2727王品","110/07/09","台灣匯立證券",90,0,90
"12122","2727王品","110/07/09","台灣摩根士丹利",0,267,-267
"12123","2727王品","110/07/09","國泰-敦南",166,84,82
"12124","2727王品","110/07/09","富邦-台北",35,299,-264
"12125","2727王品","110/07/09","富邦-仁愛",56,12,44
"12126","2727王品","110/07/09","凱基-台北",174,296,-122
"12127","2727王品","110/07/09","台新證券",109,66,43
"12128","2727王品","110/07/09","第一金",2,102,-100
"12129","2727王品","110/07/09","新光",117,87,30
"12130","2727王品","110/07/09","群益金鼎-大安",0,80,-80
"12131","2727王品","110/07/09","臺銀-臺中",35,6,29
"12132","2727王品","110/07/09","兆豐-大安",7,60,-53
"12133","2727王品","110/07/09","元大-桃園",32,3,29
"12134","2727王品","110/07/09","永豐金-南投",0,50,-50
"12135","2727王品","110/07/09","元富-宜蘭",34,6,28
"12136","2727王品","110/07/09","新加坡商瑞銀",6,46,-40
"12137","2727王品","110/07/09","玉山-台中",34,8,26
"12138","2727王品","110/07/09","合庫-彰化",11,50,-39
"12139","2727王品","110/07/09","群益金鼎-宜蘭",30,4,26
"12140","2727王品","110/07/09","永豐金-萬盛",13,52,-39
"12141","2727王品","110/07/09","富邦-台中",42,16,26
"12142","2727王品","110/07/09","瑞士信貸",0,34,-34
"12143","2727王品","110/07/09","第一金-豐原",25,1,24
"12144","2727王品","110/07/09","元大-和平",4,35,-31
"12145","2727王品","110/07/09","臺銀",30,8,22
"12146","2727王品","110/07/09","美林",14,44,-30
"12147","2727王品","110/07/09","兆豐-來福",23,1,22
"12148","2727王品","110/07/09","元大-員林",9,38,-29
"12149","2727王品","110/07/09","玉山-士林",22,2,20
"12150","2727王品","110/07/09","元富-西松",4,31,-27
"12151","1570力肯","110/07/09","凱基-台北",30,1,29
"12152","1570力肯","110/07/09","群益金鼎-彰化",0,20,-20
"12153","1570力肯","110/07/09","新光-台南",20,0,20
"12154","1570力肯","110/07/09","元大-土城學府",0,20,-20
"12155","1570力肯","110/07/09","元大-高雄",20,0,20
"12156","1570力肯","110/07/09","元大-大統",0,16,-16
"12157","1570力肯","110/07/09","國票-中正",12,0,12
"12158","1570力肯","110/07/09","元大-新營",0,11,-11
"12159","1570力肯","110/07/09","日盛-高雄",6,0,6
"12160","1570力肯","110/07/09","元大-和平",0,10,-10
"12161","1570力肯","110/07/09","元富-緯城",6,0,6
"12162","1570力肯","110/07/09","元大-草屯",0,10,-10
"12163","1570力肯","110/07/09","群益金鼎-台南",6,0,6
"12164","1570力肯","110/07/09","元大-鹿港",0,9,-9
"12165","1570力肯","110/07/09","華南永昌-岡山",6,0,6
"12166","1570力肯","110/07/09","合庫-基隆",0,7,-7
"12167","1570力肯","110/07/09","統一-中壢",5,0,5
"12168","1570力肯","110/07/09","摩根大通",2,8,-6
"12169","1570力肯","110/07/09","凱基-三峽",5,0,5
"12170","1570力肯","110/07/09","台灣企銀-豐原",0,4,-4
"12171","1570力肯","110/07/09","大昌-樹林",4,0,4
"12172","1570力肯","110/07/09","日盛-桃園",0,4,-4
"12173","1570力肯","110/07/09","新光",3,0,3
"12174","1570力肯","110/07/09","國泰-高雄",0,3,-3
"12175","1570力肯","110/07/09","富邦-新竹華信",3,0,3
"12176","1570力肯","110/07/09","永豐金-敦南",0,3,-3
"12177","1570力肯","110/07/09","合庫-台中",2,0,2
"12178","1570力肯","110/07/09","土銀-彰化",0,2,-2
"12179","1570力肯","110/07/09","臺銀-臺中",2,0,2
"12180","1570力肯","110/07/09","臺銀-鳳山",0,2,-2
"12181","6180橘子","110/07/09","摩根大通",63,1,62
"12182","6180橘子","110/07/09","元大-南京",1,32,-31
"12183","6180橘子","110/07/09","富邦-陽明",73,33,40
"12184","6180橘子","110/07/09","群益金鼎-台北",0,25,-25
"12185","6180橘子","110/07/09","新加坡商瑞銀",31,0,31
"12186","6180橘子","110/07/09","兆豐-復興",0,21,-21
"12187","6180橘子","110/07/09","美商高盛",25,0,25
"12188","6180橘子","110/07/09","永豐金-嘉義",0,21,-21
"12189","6180橘子","110/07/09","凱基-台北",26,10,16
"12190","6180橘子","110/07/09","凱基-中壢",8,24,-16
"12191","6180橘子","110/07/09","華南永昌-楠梓",13,0,13
"12192","6180橘子","110/07/09","致和-崇德",0,15,-15
"12193","6180橘子","110/07/09","華南永昌-朴子",11,0,11
"12194","6180橘子","110/07/09","群益金鼎-屏東",0,15,-15
"12195","6180橘子","110/07/09","元大-北港",11,0,11
"12196","6180橘子","110/07/09","群益金鼎-中山",0,15,-15
"12197","6180橘子","110/07/09","元大-成功",10,1,9
"12198","6180橘子","110/07/09","瑞士信貸",1,15,-14
"12199","6180橘子","110/07/09","新光",26,18,8
"12200","6180橘子","110/07/09","日盛-二林",0,10,-10
"12201","6180橘子","110/07/09","統一-三重",6,0,6
"12202","6180橘子","110/07/09","凱基-東門",0,10,-10
"12203","6180橘子","110/07/09","群益金鼎-嘉義",6,0,6
"12204","6180橘子","110/07/09","華南永昌-三重",0,10,-10
"12205","6180橘子","110/07/09","元大-員林中山",6,0,6
"12206","6180橘子","110/07/09","元大-彰化民生",1,11,-10
"12207","6180橘子","110/07/09","合庫-鳳山",5,0,5
"12208","6180橘子","110/07/09","永豐金-新店",1,11,-10
"12209","6180橘子","110/07/09","富邦-建國",6,1,5
"12210","6180橘子","110/07/09","群益金鼎-丹鳳",0,8,-8
"12211","2390云辰","110/07/09","摩根大通",279,56,223
"12212","2390云辰","110/07/09","元大-天母",0,127,-127
"12213","2390云辰","110/07/09","日盛-鳳山",110,2,108
"12214","2390云辰","110/07/09","中國信託-文心",5,109,-104
"12215","2390云辰","110/07/09","宏遠證券",100,0,100
"12216","2390云辰","110/07/09","永豐金-復興",0,55,-55
"12217","2390云辰","110/07/09","元大-大里",63,6,57
"12218","2390云辰","110/07/09","凱基-台北",239,286,-47
"12219","2390云辰","110/07/09","凱基-八德",59,10,49
"12220","2390云辰","110/07/09","德信",2,32,-30
"12221","2390云辰","110/07/09","合庫-新竹",40,0,40
"12222","2390云辰","110/07/09","兆豐-桃鶯",2,32,-30
"12223","2390云辰","110/07/09","國票",40,1,39
"12224","2390云辰","110/07/09","致和-南京",0,30,-30
"12225","2390云辰","110/07/09","新加坡商瑞銀",49,13,36
"12226","2390云辰","110/07/09","富邦-虎尾",1,31,-30
"12227","2390云辰","110/07/09","統一-新台中",36,2,34
"12228","2390云辰","110/07/09","元大-善化",2,31,-29
"12229","2390云辰","110/07/09","國票-嘉義",31,0,31
"12230","2390云辰","110/07/09","富邦-板橋",0,27,-27
"12231","2390云辰","110/07/09","華南永昌",35,7,28
"12232","2390云辰","110/07/09","富邦-永和",3,28,-25
"12233","2390云辰","110/07/09","玉山-台中",49,22,27
"12234","2390云辰","110/07/09","第一金-自由",20,44,-24
"12235","2390云辰","110/07/09","華南永昌-敦南",25,0,25
"12236","2390云辰","110/07/09","凱基-內湖",0,24,-24
"12237","2390云辰","110/07/09","新光-高雄",27,4,23
"12238","2390云辰","110/07/09","元大-汐止",1,24,-23
"12239","2390云辰","110/07/09","台灣摩根士丹利",85,63,22
"12240","2390云辰","110/07/09","新光-台中",12,33,-21
"12241","4903聯光通","110/07/09","元大-敦南",10,0,10
"12242","4903聯光通","110/07/09","第一金-台中",0,12,-12
"12243","4903聯光通","110/07/09","凱基-士林",5,0,5
"12244","4903聯光通","110/07/09","日盛-忠孝",0,3,-3
"12245","4903聯光通","110/07/09","元大-苗栗",5,0,5
"12246","4903聯光通","110/07/09","群益金鼎-崇德",0,3,-3
"12247","4903聯光通","110/07/09","元大-屏南",3,0,3
"12248","4903聯光通","110/07/09","國票-內壢",0,2,-2
"12249","4903聯光通","110/07/09","中國信託-永康",1,0,1
"12250","4903聯光通","110/07/09","康和-南崁",0,2,-2
"12251","4903聯光通","110/07/09","玉山證券",1,0,1
"12252","4903聯光通","110/07/09","新光-台中",0,2,-2
"12253","4903聯光通","110/07/09","元大-太平",4,3,1
"12254","4903聯光通","110/07/09","玉山-城中",0,2,-2
"12255","4903聯光通","110/07/09","永豐金-嘉義",1,0,1
"12256","4903聯光通","110/07/09","中國信託-文心",0,1,-1
"12257","4903聯光通","110/07/09","大昌",0,0,0
"12258","4903聯光通","110/07/09","大昌",0,0,0
"12259","4903聯光通","110/07/09","中農",0,0,0
"12260","4903聯光通","110/07/09","中農",0,0,0
"12261","4903聯光通","110/07/09","",NA,NA,NA
"12262","4903聯光通","110/07/09","",NA,NA,NA
"12263","4903聯光通","110/07/09","",NA,NA,NA
"12264","4903聯光通","110/07/09","",NA,NA,NA
"12265","4903聯光通","110/07/09","",NA,NA,NA
"12266","4903聯光通","110/07/09","",NA,NA,NA
"12267","4903聯光通","110/07/09","",NA,NA,NA
"12268","4903聯光通","110/07/09","",NA,NA,NA
"12269","4903聯光通","110/07/09","",NA,NA,NA
"12270","4903聯光通","110/07/09","",NA,NA,NA
"12271","2929淘帝","110/07/09","台中銀-台北",110,0,110
"12272","2929淘帝","110/07/09","新光",2,82,-80
"12273","2929淘帝","110/07/09","華南永昌-頭份",72,0,72
"12274","2929淘帝","110/07/09","摩根大通",2,63,-61
"12275","2929淘帝","110/07/09","合庫-高雄",71,0,71
"12276","2929淘帝","110/07/09","第一金-路竹",0,50,-50
"12277","2929淘帝","110/07/09","高橋-龍潭",37,0,37
"12278","2929淘帝","110/07/09","港商麥格理",0,42,-42
"12279","2929淘帝","110/07/09","新光-台中",60,26,34
"12280","2929淘帝","110/07/09","陽信-石牌",0,40,-40
"12281","2929淘帝","110/07/09","元富-大裕",22,1,21
"12282","2929淘帝","110/07/09","台新-左楠",1,39,-38
"12283","2929淘帝","110/07/09","合庫-鳳山",20,0,20
"12284","2929淘帝","110/07/09","凱基-桃園",3,29,-26
"12285","2929淘帝","110/07/09","元大-員林",22,2,20
"12286","2929淘帝","110/07/09","兆豐-內湖",0,25,-25
"12287","2929淘帝","110/07/09","台新-建北",15,0,15
"12288","2929淘帝","110/07/09","元大-北港",0,20,-20
"12289","2929淘帝","110/07/09","兆豐-桃園",13,0,13
"12290","2929淘帝","110/07/09","富邦-北港",0,19,-19
"12291","2929淘帝","110/07/09","兆豐-忠孝",10,0,10
"12292","2929淘帝","110/07/09","富邦-花蓮",0,17,-17
"12293","2929淘帝","110/07/09","國票-敦北法人",10,0,10
"12294","2929淘帝","110/07/09","國泰-台中",2,17,-15
"12295","2929淘帝","110/07/09","永豐金-博愛",10,0,10
"12296","2929淘帝","110/07/09","群益金鼎-彰化",0,15,-15
"12297","2929淘帝","110/07/09","群益金鼎-潭子",8,0,8
"12298","2929淘帝","110/07/09","元大-博愛",0,14,-14
"12299","2929淘帝","110/07/09","富邦-南屯",8,0,8
"12300","2929淘帝","110/07/09","日盛-板橋",0,13,-13
"12301","5410國眾","110/07/09","元大-新盛",14,0,14
"12302","5410國眾","110/07/09","(牛牛牛)亞-鑫豐",1,41,-40
"12303","5410國眾","110/07/09","台灣企銀-民雄",10,0,10
"12304","5410國眾","110/07/09","元富-嘉義",0,25,-25
"12305","5410國眾","110/07/09","元富-虎尾",9,0,9
"12306","5410國眾","110/07/09","凱基-高美館",0,10,-10
"12307","5410國眾","110/07/09","摩根大通",10,1,9
"12308","5410國眾","110/07/09","凱基-城中",0,10,-10
"12309","5410國眾","110/07/09","兆豐-北高雄",7,0,7
"12310","5410國眾","110/07/09","元大-頭份",0,10,-10
"12311","5410國眾","110/07/09","凱基-台北",8,1,7
"12312","5410國眾","110/07/09","群益金鼎-丹鳳",0,7,-7
"12313","5410國眾","110/07/09","華南永昌-公誠",7,0,7
"12314","5410國眾","110/07/09","凱基-復興",0,7,-7
"12315","5410國眾","110/07/09","香港上海匯豐",6,0,6
"12316","5410國眾","110/07/09","元大-員林",0,7,-7
"12317","5410國眾","110/07/09","凱基-中壢",6,0,6
"12318","5410國眾","110/07/09","富邦-竹東",0,6,-6
"12319","5410國眾","110/07/09","華南永昌-南京",6,0,6
"12320","5410國眾","110/07/09","亞東-高雄",0,5,-5
"12321","5410國眾","110/07/09","統一-三重",5,0,5
"12322","5410國眾","110/07/09","大慶-中壢",1,6,-5
"12323","5410國眾","110/07/09","富邦-宜蘭",5,0,5
"12324","5410國眾","110/07/09","群益金鼎-中港",0,5,-5
"12325","5410國眾","110/07/09","元大-崇德",5,0,5
"12326","5410國眾","110/07/09","元大-八德",0,5,-5
"12327","5410國眾","110/07/09","元大-博愛",5,0,5
"12328","5410國眾","110/07/09","富邦-基隆",0,4,-4
"12329","5410國眾","110/07/09","元大-龍潭",5,0,5
"12330","5410國眾","110/07/09","臺銀-新竹",0,3,-3
"12331","2841台開","110/07/09","日盛-雙和",102,0,102
"12332","2841台開","110/07/09","港商野村",0,129,-129
"12333","2841台開","110/07/09","元大-館前",70,0,70
"12334","2841台開","110/07/09","兆豐-永和",0,100,-100
"12335","2841台開","110/07/09","凱基-文心",50,0,50
"12336","2841台開","110/07/09","台新證券",7,28,-21
"12337","2841台開","110/07/09","富邦-嘉義",40,0,40
"12338","2841台開","110/07/09","國票-北高雄",0,20,-20
"12339","2841台開","110/07/09","美商高盛",15,0,15
"12340","2841台開","110/07/09","永豐金-敦南",29,46,-17
"12341","2841台開","110/07/09","台中銀",15,0,15
"12342","2841台開","110/07/09","合庫-基隆",0,12,-12
"12343","2841台開","110/07/09","新光",11,0,11
"12344","2841台開","110/07/09","中國信託-松江",0,12,-12
"12345","2841台開","110/07/09","華南永昌-長虹",10,0,10
"12346","2841台開","110/07/09","兆豐-城中",0,12,-12
"12347","2841台開","110/07/09","永豐金-南投",10,0,10
"12348","2841台開","110/07/09","台中銀-豐原",0,10,-10
"12349","2841台開","110/07/09","合庫-桃園",7,0,7
"12350","2841台開","110/07/09","兆豐-景美",0,10,-10
"12351","2841台開","110/07/09","群益金鼎-古亭",7,0,7
"12352","2841台開","110/07/09","群益金鼎-基隆",0,10,-10
"12353","2841台開","110/07/09","國泰-敦南",6,0,6
"12354","2841台開","110/07/09","元大-北三重",0,10,-10
"12355","2841台開","110/07/09","凱基-桃園",8,2,6
"12356","2841台開","110/07/09","(牛牛牛)亞-網路",0,9,-9
"12357","2841台開","110/07/09","日盛證券",5,0,5
"12358","2841台開","110/07/09","台新-高雄",1,10,-9
"12359","2841台開","110/07/09","元富-文心",5,0,5
"12360","2841台開","110/07/09","凱基-台北",0,7,-7
"12361","6207雷科","110/07/09","群益金鼎-新竹",47,0,47
"12362","6207雷科","110/07/09","新光",7,24,-17
"12363","6207雷科","110/07/09","永豐金-三重",31,0,31
"12364","6207雷科","110/07/09","日盛-和美",0,15,-15
"12365","6207雷科","110/07/09","新加坡商瑞銀",33,5,28
"12366","6207雷科","110/07/09","國泰-台南",0,15,-15
"12367","6207雷科","110/07/09","元大-高雄",26,0,26
"12368","6207雷科","110/07/09","華南永昌-古亭",0,14,-14
"12369","6207雷科","110/07/09","統一-員林",22,0,22
"12370","6207雷科","110/07/09","土銀-白河",0,11,-11
"12371","6207雷科","110/07/09","台新-高雄",22,0,22
"12372","6207雷科","110/07/09","日盛-台南",0,10,-10
"12373","6207雷科","110/07/09","摩根大通",34,17,17
"12374","6207雷科","110/07/09","元富-林園",0,10,-10
"12375","6207雷科","110/07/09","元大-博愛",17,1,16
"12376","6207雷科","110/07/09","富邦-園區",0,10,-10
"12377","6207雷科","110/07/09","日茂-埔里",12,0,12
"12378","6207雷科","110/07/09","元大-上新莊",0,10,-10
"12379","6207雷科","110/07/09","國泰-台中",17,6,11
"12380","6207雷科","110/07/09","永豐金-南京",0,10,-10
"12381","6207雷科","110/07/09","富邦-三重",10,0,10
"12382","6207雷科","110/07/09","兆豐-小港",0,6,-6
"12383","6207雷科","110/07/09","元大-沙鹿",10,0,10
"12384","6207雷科","110/07/09","富邦-羅東",1,7,-6
"12385","6207雷科","110/07/09","元大-八德",10,0,10
"12386","6207雷科","110/07/09","元大-土城永寧",0,6,-6
"12387","6207雷科","110/07/09","第一金-路竹",11,2,9
"12388","6207雷科","110/07/09","永豐金-板盛",0,6,-6
"12389","6207雷科","110/07/09","統一-南京",5,0,5
"12390","6207雷科","110/07/09","日盛-板橋",0,5,-5
"12391","3679新至陞","110/07/09","元大-大天母",10,0,10
"12392","3679新至陞","110/07/09","第一金-光復",0,11,-11
"12393","3679新至陞","110/07/09","日盛-樹林",9,0,9
"12394","3679新至陞","110/07/09","瑞士信貸",0,8,-8
"12395","3679新至陞","110/07/09","凱基-台北",11,2,9
"12396","3679新至陞","110/07/09","大慶-苗栗",0,5,-5
"12397","3679新至陞","110/07/09","華南永昌-小港",8,0,8
"12398","3679新至陞","110/07/09","元大-永春",0,5,-5
"12399","3679新至陞","110/07/09","兆豐-來福",7,0,7
"12400","3679新至陞","110/07/09","日盛-和美",0,4,-4
"12401","3679新至陞","110/07/09","香港上海匯豐",5,0,5
"12402","3679新至陞","110/07/09","元大-雙和",0,3,-3
"12403","3679新至陞","110/07/09","台中銀-員林",3,0,3
"12404","3679新至陞","110/07/09","永豐金-屏東",0,3,-3
"12405","3679新至陞","110/07/09","新光",3,0,3
"12406","3679新至陞","110/07/09","彰銀",0,2,-2
"12407","3679新至陞","110/07/09","土銀-花蓮",2,0,2
"12408","3679新至陞","110/07/09","宏遠-館前",0,2,-2
"12409","3679新至陞","110/07/09","第一金-澎湖",2,0,2
"12410","3679新至陞","110/07/09","港商野村",0,2,-2
"12411","3679新至陞","110/07/09","摩根大通",2,0,2
"12412","3679新至陞","110/07/09","大昌-新店",0,2,-2
"12413","3679新至陞","110/07/09","國泰-敦南",2,0,2
"12414","3679新至陞","110/07/09","元大-新莊",0,2,-2
"12415","3679新至陞","110/07/09","元大-淡水",4,2,2
"12416","3679新至陞","110/07/09","元大-板橋",0,2,-2
"12417","3679新至陞","110/07/09","日盛-士林",1,0,1
"12418","3679新至陞","110/07/09","台灣摩根士丹利",0,1,-1
"12419","3679新至陞","110/07/09","日盛-信義",1,0,1
"12420","3679新至陞","110/07/09","第一金-高雄",0,1,-1
"12421","2727王品","110/07/09","台灣匯立證券",90,0,90
"12422","2727王品","110/07/09","台灣摩根士丹利",0,267,-267
"12423","2727王品","110/07/09","國泰-敦南",166,84,82
"12424","2727王品","110/07/09","富邦-台北",35,299,-264
"12425","2727王品","110/07/09","富邦-仁愛",56,12,44
"12426","2727王品","110/07/09","凱基-台北",174,296,-122
"12427","2727王品","110/07/09","台新證券",109,66,43
"12428","2727王品","110/07/09","第一金",2,102,-100
"12429","2727王品","110/07/09","新光",117,87,30
"12430","2727王品","110/07/09","群益金鼎-大安",0,80,-80
"12431","2727王品","110/07/09","臺銀-臺中",35,6,29
"12432","2727王品","110/07/09","兆豐-大安",7,60,-53
"12433","2727王品","110/07/09","元大-桃園",32,3,29
"12434","2727王品","110/07/09","永豐金-南投",0,50,-50
"12435","2727王品","110/07/09","元富-宜蘭",34,6,28
"12436","2727王品","110/07/09","新加坡商瑞銀",6,46,-40
"12437","2727王品","110/07/09","玉山-台中",34,8,26
"12438","2727王品","110/07/09","合庫-彰化",11,50,-39
"12439","2727王品","110/07/09","群益金鼎-宜蘭",30,4,26
"12440","2727王品","110/07/09","永豐金-萬盛",13,52,-39
"12441","2727王品","110/07/09","富邦-台中",42,16,26
"12442","2727王品","110/07/09","瑞士信貸",0,34,-34
"12443","2727王品","110/07/09","第一金-豐原",25,1,24
"12444","2727王品","110/07/09","元大-和平",4,35,-31
"12445","2727王品","110/07/09","臺銀",30,8,22
"12446","2727王品","110/07/09","美林",14,44,-30
"12447","2727王品","110/07/09","兆豐-來福",23,1,22
"12448","2727王品","110/07/09","元大-員林",9,38,-29
"12449","2727王品","110/07/09","玉山-士林",22,2,20
"12450","2727王品","110/07/09","元富-西松",4,31,-27
"12451","1570力肯","110/07/09","凱基-台北",30,1,29
"12452","1570力肯","110/07/09","群益金鼎-彰化",0,20,-20
"12453","1570力肯","110/07/09","新光-台南",20,0,20
"12454","1570力肯","110/07/09","元大-土城學府",0,20,-20
"12455","1570力肯","110/07/09","元大-高雄",20,0,20
"12456","1570力肯","110/07/09","元大-大統",0,16,-16
"12457","1570力肯","110/07/09","國票-中正",12,0,12
"12458","1570力肯","110/07/09","元大-新營",0,11,-11
"12459","1570力肯","110/07/09","日盛-高雄",6,0,6
"12460","1570力肯","110/07/09","元大-和平",0,10,-10
"12461","1570力肯","110/07/09","元富-緯城",6,0,6
"12462","1570力肯","110/07/09","元大-草屯",0,10,-10
"12463","1570力肯","110/07/09","群益金鼎-台南",6,0,6
"12464","1570力肯","110/07/09","元大-鹿港",0,9,-9
"12465","1570力肯","110/07/09","華南永昌-岡山",6,0,6
"12466","1570力肯","110/07/09","合庫-基隆",0,7,-7
"12467","1570力肯","110/07/09","統一-中壢",5,0,5
"12468","1570力肯","110/07/09","摩根大通",2,8,-6
"12469","1570力肯","110/07/09","凱基-三峽",5,0,5
"12470","1570力肯","110/07/09","台灣企銀-豐原",0,4,-4
"12471","1570力肯","110/07/09","大昌-樹林",4,0,4
"12472","1570力肯","110/07/09","日盛-桃園",0,4,-4
"12473","1570力肯","110/07/09","新光",3,0,3
"12474","1570力肯","110/07/09","國泰-高雄",0,3,-3
"12475","1570力肯","110/07/09","富邦-新竹華信",3,0,3
"12476","1570力肯","110/07/09","永豐金-敦南",0,3,-3
"12477","1570力肯","110/07/09","合庫-台中",2,0,2
"12478","1570力肯","110/07/09","土銀-彰化",0,2,-2
"12479","1570力肯","110/07/09","臺銀-臺中",2,0,2
"12480","1570力肯","110/07/09","臺銀-鳳山",0,2,-2
"12481","6180橘子","110/07/09","摩根大通",63,1,62
"12482","6180橘子","110/07/09","元大-南京",1,32,-31
"12483","6180橘子","110/07/09","富邦-陽明",73,33,40
"12484","6180橘子","110/07/09","群益金鼎-台北",0,25,-25
"12485","6180橘子","110/07/09","新加坡商瑞銀",31,0,31
"12486","6180橘子","110/07/09","兆豐-復興",0,21,-21
"12487","6180橘子","110/07/09","美商高盛",25,0,25
"12488","6180橘子","110/07/09","永豐金-嘉義",0,21,-21
"12489","6180橘子","110/07/09","凱基-台北",26,10,16
"12490","6180橘子","110/07/09","凱基-中壢",8,24,-16
"12491","6180橘子","110/07/09","華南永昌-楠梓",13,0,13
"12492","6180橘子","110/07/09","致和-崇德",0,15,-15
"12493","6180橘子","110/07/09","華南永昌-朴子",11,0,11
"12494","6180橘子","110/07/09","群益金鼎-屏東",0,15,-15
"12495","6180橘子","110/07/09","元大-北港",11,0,11
"12496","6180橘子","110/07/09","群益金鼎-中山",0,15,-15
"12497","6180橘子","110/07/09","元大-成功",10,1,9
"12498","6180橘子","110/07/09","瑞士信貸",1,15,-14
"12499","6180橘子","110/07/09","新光",26,18,8
"12500","6180橘子","110/07/09","日盛-二林",0,10,-10
"12501","6180橘子","110/07/09","統一-三重",6,0,6
"12502","6180橘子","110/07/09","凱基-東門",0,10,-10
"12503","6180橘子","110/07/09","群益金鼎-嘉義",6,0,6
"12504","6180橘子","110/07/09","華南永昌-三重",0,10,-10
"12505","6180橘子","110/07/09","元大-員林中山",6,0,6
"12506","6180橘子","110/07/09","元大-彰化民生",1,11,-10
"12507","6180橘子","110/07/09","合庫-鳳山",5,0,5
"12508","6180橘子","110/07/09","永豐金-新店",1,11,-10
"12509","6180橘子","110/07/09","富邦-建國",6,1,5
"12510","6180橘子","110/07/09","群益金鼎-丹鳳",0,8,-8
"12511","2390云辰","110/07/09","摩根大通",279,56,223
"12512","2390云辰","110/07/09","元大-天母",0,127,-127
"12513","2390云辰","110/07/09","日盛-鳳山",110,2,108
"12514","2390云辰","110/07/09","中國信託-文心",5,109,-104
"12515","2390云辰","110/07/09","宏遠證券",100,0,100
"12516","2390云辰","110/07/09","永豐金-復興",0,55,-55
"12517","2390云辰","110/07/09","元大-大里",63,6,57
"12518","2390云辰","110/07/09","凱基-台北",239,286,-47
"12519","2390云辰","110/07/09","凱基-八德",59,10,49
"12520","2390云辰","110/07/09","德信",2,32,-30
"12521","2390云辰","110/07/09","合庫-新竹",40,0,40
"12522","2390云辰","110/07/09","兆豐-桃鶯",2,32,-30
"12523","2390云辰","110/07/09","國票",40,1,39
"12524","2390云辰","110/07/09","致和-南京",0,30,-30
"12525","2390云辰","110/07/09","新加坡商瑞銀",49,13,36
"12526","2390云辰","110/07/09","富邦-虎尾",1,31,-30
"12527","2390云辰","110/07/09","統一-新台中",36,2,34
"12528","2390云辰","110/07/09","元大-善化",2,31,-29
"12529","2390云辰","110/07/09","國票-嘉義",31,0,31
"12530","2390云辰","110/07/09","富邦-板橋",0,27,-27
"12531","2390云辰","110/07/09","華南永昌",35,7,28
"12532","2390云辰","110/07/09","富邦-永和",3,28,-25
"12533","2390云辰","110/07/09","玉山-台中",49,22,27
"12534","2390云辰","110/07/09","第一金-自由",20,44,-24
"12535","2390云辰","110/07/09","華南永昌-敦南",25,0,25
"12536","2390云辰","110/07/09","凱基-內湖",0,24,-24
"12537","2390云辰","110/07/09","新光-高雄",27,4,23
"12538","2390云辰","110/07/09","元大-汐止",1,24,-23
"12539","2390云辰","110/07/09","台灣摩根士丹利",85,63,22
"12540","2390云辰","110/07/09","新光-台中",12,33,-21
"12541","4903聯光通","110/07/09","元大-敦南",10,0,10
"12542","4903聯光通","110/07/09","第一金-台中",0,12,-12
"12543","4903聯光通","110/07/09","凱基-士林",5,0,5
"12544","4903聯光通","110/07/09","日盛-忠孝",0,3,-3
"12545","4903聯光通","110/07/09","元大-苗栗",5,0,5
"12546","4903聯光通","110/07/09","群益金鼎-崇德",0,3,-3
"12547","4903聯光通","110/07/09","元大-屏南",3,0,3
"12548","4903聯光通","110/07/09","國票-內壢",0,2,-2
"12549","4903聯光通","110/07/09","中國信託-永康",1,0,1
"12550","4903聯光通","110/07/09","康和-南崁",0,2,-2
"12551","4903聯光通","110/07/09","玉山證券",1,0,1
"12552","4903聯光通","110/07/09","新光-台中",0,2,-2
"12553","4903聯光通","110/07/09","元大-太平",4,3,1
"12554","4903聯光通","110/07/09","玉山-城中",0,2,-2
"12555","4903聯光通","110/07/09","永豐金-嘉義",1,0,1
"12556","4903聯光通","110/07/09","中國信託-文心",0,1,-1
"12557","4903聯光通","110/07/09","大昌",0,0,0
"12558","4903聯光通","110/07/09","大昌",0,0,0
"12559","4903聯光通","110/07/09","中農",0,0,0
"12560","4903聯光通","110/07/09","中農",0,0,0
"12561","4903聯光通","110/07/09","",NA,NA,NA
"12562","4903聯光通","110/07/09","",NA,NA,NA
"12563","4903聯光通","110/07/09","",NA,NA,NA
"12564","4903聯光通","110/07/09","",NA,NA,NA
"12565","4903聯光通","110/07/09","",NA,NA,NA
"12566","4903聯光通","110/07/09","",NA,NA,NA
"12567","4903聯光通","110/07/09","",NA,NA,NA
"12568","4903聯光通","110/07/09","",NA,NA,NA
"12569","4903聯光通","110/07/09","",NA,NA,NA
"12570","4903聯光通","110/07/09","",NA,NA,NA
"12571","2929淘帝","110/07/09","台中銀-台北",110,0,110
"12572","2929淘帝","110/07/09","新光",2,82,-80
"12573","2929淘帝","110/07/09","華南永昌-頭份",72,0,72
"12574","2929淘帝","110/07/09","摩根大通",2,63,-61
"12575","2929淘帝","110/07/09","合庫-高雄",71,0,71
"12576","2929淘帝","110/07/09","第一金-路竹",0,50,-50
"12577","2929淘帝","110/07/09","高橋-龍潭",37,0,37
"12578","2929淘帝","110/07/09","港商麥格理",0,42,-42
"12579","2929淘帝","110/07/09","新光-台中",60,26,34
"12580","2929淘帝","110/07/09","陽信-石牌",0,40,-40
"12581","2929淘帝","110/07/09","元富-大裕",22,1,21
"12582","2929淘帝","110/07/09","台新-左楠",1,39,-38
"12583","2929淘帝","110/07/09","合庫-鳳山",20,0,20
"12584","2929淘帝","110/07/09","凱基-桃園",3,29,-26
"12585","2929淘帝","110/07/09","元大-員林",22,2,20
"12586","2929淘帝","110/07/09","兆豐-內湖",0,25,-25
"12587","2929淘帝","110/07/09","台新-建北",15,0,15
"12588","2929淘帝","110/07/09","元大-北港",0,20,-20
"12589","2929淘帝","110/07/09","兆豐-桃園",13,0,13
"12590","2929淘帝","110/07/09","富邦-北港",0,19,-19
"12591","2929淘帝","110/07/09","兆豐-忠孝",10,0,10
"12592","2929淘帝","110/07/09","富邦-花蓮",0,17,-17
"12593","2929淘帝","110/07/09","國票-敦北法人",10,0,10
"12594","2929淘帝","110/07/09","國泰-台中",2,17,-15
"12595","2929淘帝","110/07/09","永豐金-博愛",10,0,10
"12596","2929淘帝","110/07/09","群益金鼎-彰化",0,15,-15
"12597","2929淘帝","110/07/09","群益金鼎-潭子",8,0,8
"12598","2929淘帝","110/07/09","元大-博愛",0,14,-14
"12599","2929淘帝","110/07/09","富邦-南屯",8,0,8
"12600","2929淘帝","110/07/09","日盛-板橋",0,13,-13
"12601","5410國眾","110/07/09","元大-新盛",14,0,14
"12602","5410國眾","110/07/09","(牛牛牛)亞-鑫豐",1,41,-40
"12603","5410國眾","110/07/09","台灣企銀-民雄",10,0,10
"12604","5410國眾","110/07/09","元富-嘉義",0,25,-25
"12605","5410國眾","110/07/09","元富-虎尾",9,0,9
"12606","5410國眾","110/07/09","凱基-高美館",0,10,-10
"12607","5410國眾","110/07/09","摩根大通",10,1,9
"12608","5410國眾","110/07/09","凱基-城中",0,10,-10
"12609","5410國眾","110/07/09","兆豐-北高雄",7,0,7
"12610","5410國眾","110/07/09","元大-頭份",0,10,-10
"12611","5410國眾","110/07/09","凱基-台北",8,1,7
"12612","5410國眾","110/07/09","群益金鼎-丹鳳",0,7,-7
"12613","5410國眾","110/07/09","華南永昌-公誠",7,0,7
"12614","5410國眾","110/07/09","凱基-復興",0,7,-7
"12615","5410國眾","110/07/09","香港上海匯豐",6,0,6
"12616","5410國眾","110/07/09","元大-員林",0,7,-7
"12617","5410國眾","110/07/09","凱基-中壢",6,0,6
"12618","5410國眾","110/07/09","富邦-竹東",0,6,-6
"12619","5410國眾","110/07/09","華南永昌-南京",6,0,6
"12620","5410國眾","110/07/09","亞東-高雄",0,5,-5
"12621","5410國眾","110/07/09","統一-三重",5,0,5
"12622","5410國眾","110/07/09","大慶-中壢",1,6,-5
"12623","5410國眾","110/07/09","富邦-宜蘭",5,0,5
"12624","5410國眾","110/07/09","群益金鼎-中港",0,5,-5
"12625","5410國眾","110/07/09","元大-崇德",5,0,5
"12626","5410國眾","110/07/09","元大-八德",0,5,-5
"12627","5410國眾","110/07/09","元大-博愛",5,0,5
"12628","5410國眾","110/07/09","富邦-基隆",0,4,-4
"12629","5410國眾","110/07/09","元大-龍潭",5,0,5
"12630","5410國眾","110/07/09","臺銀-新竹",0,3,-3
"12631","2841台開","110/07/09","日盛-雙和",102,0,102
"12632","2841台開","110/07/09","港商野村",0,129,-129
"12633","2841台開","110/07/09","元大-館前",70,0,70
"12634","2841台開","110/07/09","兆豐-永和",0,100,-100
"12635","2841台開","110/07/09","凱基-文心",50,0,50
"12636","2841台開","110/07/09","台新證券",7,28,-21
"12637","2841台開","110/07/09","富邦-嘉義",40,0,40
"12638","2841台開","110/07/09","國票-北高雄",0,20,-20
"12639","2841台開","110/07/09","美商高盛",15,0,15
"12640","2841台開","110/07/09","永豐金-敦南",29,46,-17
"12641","2841台開","110/07/09","台中銀",15,0,15
"12642","2841台開","110/07/09","合庫-基隆",0,12,-12
"12643","2841台開","110/07/09","新光",11,0,11
"12644","2841台開","110/07/09","中國信託-松江",0,12,-12
"12645","2841台開","110/07/09","華南永昌-長虹",10,0,10
"12646","2841台開","110/07/09","兆豐-城中",0,12,-12
"12647","2841台開","110/07/09","永豐金-南投",10,0,10
"12648","2841台開","110/07/09","台中銀-豐原",0,10,-10
"12649","2841台開","110/07/09","合庫-桃園",7,0,7
"12650","2841台開","110/07/09","兆豐-景美",0,10,-10
"12651","2841台開","110/07/09","群益金鼎-古亭",7,0,7
"12652","2841台開","110/07/09","群益金鼎-基隆",0,10,-10
"12653","2841台開","110/07/09","國泰-敦南",6,0,6
"12654","2841台開","110/07/09","元大-北三重",0,10,-10
"12655","2841台開","110/07/09","凱基-桃園",8,2,6
"12656","2841台開","110/07/09","(牛牛牛)亞-網路",0,9,-9
"12657","2841台開","110/07/09","日盛證券",5,0,5
"12658","2841台開","110/07/09","台新-高雄",1,10,-9
"12659","2841台開","110/07/09","元富-文心",5,0,5
"12660","2841台開","110/07/09","凱基-台北",0,7,-7
"12661","6207雷科","110/07/09","群益金鼎-新竹",47,0,47
"12662","6207雷科","110/07/09","新光",7,24,-17
"12663","6207雷科","110/07/09","永豐金-三重",31,0,31
"12664","6207雷科","110/07/09","日盛-和美",0,15,-15
"12665","6207雷科","110/07/09","新加坡商瑞銀",33,5,28
"12666","6207雷科","110/07/09","國泰-台南",0,15,-15
"12667","6207雷科","110/07/09","元大-高雄",26,0,26
"12668","6207雷科","110/07/09","華南永昌-古亭",0,14,-14
"12669","6207雷科","110/07/09","統一-員林",22,0,22
"12670","6207雷科","110/07/09","土銀-白河",0,11,-11
"12671","6207雷科","110/07/09","台新-高雄",22,0,22
"12672","6207雷科","110/07/09","日盛-台南",0,10,-10
"12673","6207雷科","110/07/09","摩根大通",34,17,17
"12674","6207雷科","110/07/09","元富-林園",0,10,-10
"12675","6207雷科","110/07/09","元大-博愛",17,1,16
"12676","6207雷科","110/07/09","富邦-園區",0,10,-10
"12677","6207雷科","110/07/09","日茂-埔里",12,0,12
"12678","6207雷科","110/07/09","元大-上新莊",0,10,-10
"12679","6207雷科","110/07/09","國泰-台中",17,6,11
"12680","6207雷科","110/07/09","永豐金-南京",0,10,-10
"12681","6207雷科","110/07/09","富邦-三重",10,0,10
"12682","6207雷科","110/07/09","兆豐-小港",0,6,-6
"12683","6207雷科","110/07/09","元大-沙鹿",10,0,10
"12684","6207雷科","110/07/09","富邦-羅東",1,7,-6
"12685","6207雷科","110/07/09","元大-八德",10,0,10
"12686","6207雷科","110/07/09","元大-土城永寧",0,6,-6
"12687","6207雷科","110/07/09","第一金-路竹",11,2,9
"12688","6207雷科","110/07/09","永豐金-板盛",0,6,-6
"12689","6207雷科","110/07/09","統一-南京",5,0,5
"12690","6207雷科","110/07/09","日盛-板橋",0,5,-5
"12691","3679新至陞","110/07/09","元大-大天母",10,0,10
"12692","3679新至陞","110/07/09","第一金-光復",0,11,-11
"12693","3679新至陞","110/07/09","日盛-樹林",9,0,9
"12694","3679新至陞","110/07/09","瑞士信貸",0,8,-8
"12695","3679新至陞","110/07/09","凱基-台北",11,2,9
"12696","3679新至陞","110/07/09","大慶-苗栗",0,5,-5
"12697","3679新至陞","110/07/09","華南永昌-小港",8,0,8
"12698","3679新至陞","110/07/09","元大-永春",0,5,-5
"12699","3679新至陞","110/07/09","兆豐-來福",7,0,7
"12700","3679新至陞","110/07/09","日盛-和美",0,4,-4
"12701","3679新至陞","110/07/09","香港上海匯豐",5,0,5
"12702","3679新至陞","110/07/09","元大-雙和",0,3,-3
"12703","3679新至陞","110/07/09","台中銀-員林",3,0,3
"12704","3679新至陞","110/07/09","永豐金-屏東",0,3,-3
"12705","3679新至陞","110/07/09","新光",3,0,3
"12706","3679新至陞","110/07/09","彰銀",0,2,-2
"12707","3679新至陞","110/07/09","土銀-花蓮",2,0,2
"12708","3679新至陞","110/07/09","宏遠-館前",0,2,-2
"12709","3679新至陞","110/07/09","第一金-澎湖",2,0,2
"12710","3679新至陞","110/07/09","港商野村",0,2,-2
"12711","3679新至陞","110/07/09","摩根大通",2,0,2
"12712","3679新至陞","110/07/09","大昌-新店",0,2,-2
"12713","3679新至陞","110/07/09","國泰-敦南",2,0,2
"12714","3679新至陞","110/07/09","元大-新莊",0,2,-2
"12715","3679新至陞","110/07/09","元大-淡水",4,2,2
"12716","3679新至陞","110/07/09","元大-板橋",0,2,-2
"12717","3679新至陞","110/07/09","日盛-士林",1,0,1
"12718","3679新至陞","110/07/09","台灣摩根士丹利",0,1,-1
"12719","3679新至陞","110/07/09","日盛-信義",1,0,1
"12720","3679新至陞","110/07/09","第一金-高雄",0,1,-1
"12721","2727王品","110/07/09","台灣匯立證券",90,0,90
"12722","2727王品","110/07/09","台灣摩根士丹利",0,267,-267
"12723","2727王品","110/07/09","國泰-敦南",166,84,82
"12724","2727王品","110/07/09","富邦-台北",35,299,-264
"12725","2727王品","110/07/09","富邦-仁愛",56,12,44
"12726","2727王品","110/07/09","凱基-台北",174,296,-122
"12727","2727王品","110/07/09","台新證券",109,66,43
"12728","2727王品","110/07/09","第一金",2,102,-100
"12729","2727王品","110/07/09","新光",117,87,30
"12730","2727王品","110/07/09","群益金鼎-大安",0,80,-80
"12731","2727王品","110/07/09","臺銀-臺中",35,6,29
"12732","2727王品","110/07/09","兆豐-大安",7,60,-53
"12733","2727王品","110/07/09","元大-桃園",32,3,29
"12734","2727王品","110/07/09","永豐金-南投",0,50,-50
"12735","2727王品","110/07/09","元富-宜蘭",34,6,28
"12736","2727王品","110/07/09","新加坡商瑞銀",6,46,-40
"12737","2727王品","110/07/09","玉山-台中",34,8,26
"12738","2727王品","110/07/09","合庫-彰化",11,50,-39
"12739","2727王品","110/07/09","群益金鼎-宜蘭",30,4,26
"12740","2727王品","110/07/09","永豐金-萬盛",13,52,-39
"12741","2727王品","110/07/09","富邦-台中",42,16,26
"12742","2727王品","110/07/09","瑞士信貸",0,34,-34
"12743","2727王品","110/07/09","第一金-豐原",25,1,24
"12744","2727王品","110/07/09","元大-和平",4,35,-31
"12745","2727王品","110/07/09","臺銀",30,8,22
"12746","2727王品","110/07/09","美林",14,44,-30
"12747","2727王品","110/07/09","兆豐-來福",23,1,22
"12748","2727王品","110/07/09","元大-員林",9,38,-29
"12749","2727王品","110/07/09","玉山-士林",22,2,20
"12750","2727王品","110/07/09","元富-西松",4,31,-27
"12751","1570力肯","110/07/09","凱基-台北",30,1,29
"12752","1570力肯","110/07/09","群益金鼎-彰化",0,20,-20
"12753","1570力肯","110/07/09","新光-台南",20,0,20
"12754","1570力肯","110/07/09","元大-土城學府",0,20,-20
"12755","1570力肯","110/07/09","元大-高雄",20,0,20
"12756","1570力肯","110/07/09","元大-大統",0,16,-16
"12757","1570力肯","110/07/09","國票-中正",12,0,12
"12758","1570力肯","110/07/09","元大-新營",0,11,-11
"12759","1570力肯","110/07/09","日盛-高雄",6,0,6
"12760","1570力肯","110/07/09","元大-和平",0,10,-10
"12761","1570力肯","110/07/09","元富-緯城",6,0,6
"12762","1570力肯","110/07/09","元大-草屯",0,10,-10
"12763","1570力肯","110/07/09","群益金鼎-台南",6,0,6
"12764","1570力肯","110/07/09","元大-鹿港",0,9,-9
"12765","1570力肯","110/07/09","華南永昌-岡山",6,0,6
"12766","1570力肯","110/07/09","合庫-基隆",0,7,-7
"12767","1570力肯","110/07/09","統一-中壢",5,0,5
"12768","1570力肯","110/07/09","摩根大通",2,8,-6
"12769","1570力肯","110/07/09","凱基-三峽",5,0,5
"12770","1570力肯","110/07/09","台灣企銀-豐原",0,4,-4
"12771","1570力肯","110/07/09","大昌-樹林",4,0,4
"12772","1570力肯","110/07/09","日盛-桃園",0,4,-4
"12773","1570力肯","110/07/09","新光",3,0,3
"12774","1570力肯","110/07/09","國泰-高雄",0,3,-3
"12775","1570力肯","110/07/09","富邦-新竹華信",3,0,3
"12776","1570力肯","110/07/09","永豐金-敦南",0,3,-3
"12777","1570力肯","110/07/09","合庫-台中",2,0,2
"12778","1570力肯","110/07/09","土銀-彰化",0,2,-2
"12779","1570力肯","110/07/09","臺銀-臺中",2,0,2
"12780","1570力肯","110/07/09","臺銀-鳳山",0,2,-2
"12781","6180橘子","110/07/09","摩根大通",63,1,62
"12782","6180橘子","110/07/09","元大-南京",1,32,-31
"12783","6180橘子","110/07/09","富邦-陽明",73,33,40
"12784","6180橘子","110/07/09","群益金鼎-台北",0,25,-25
"12785","6180橘子","110/07/09","新加坡商瑞銀",31,0,31
"12786","6180橘子","110/07/09","兆豐-復興",0,21,-21
"12787","6180橘子","110/07/09","美商高盛",25,0,25
"12788","6180橘子","110/07/09","永豐金-嘉義",0,21,-21
"12789","6180橘子","110/07/09","凱基-台北",26,10,16
"12790","6180橘子","110/07/09","凱基-中壢",8,24,-16
"12791","6180橘子","110/07/09","華南永昌-楠梓",13,0,13
"12792","6180橘子","110/07/09","致和-崇德",0,15,-15
"12793","6180橘子","110/07/09","華南永昌-朴子",11,0,11
"12794","6180橘子","110/07/09","群益金鼎-屏東",0,15,-15
"12795","6180橘子","110/07/09","元大-北港",11,0,11
"12796","6180橘子","110/07/09","群益金鼎-中山",0,15,-15
"12797","6180橘子","110/07/09","元大-成功",10,1,9
"12798","6180橘子","110/07/09","瑞士信貸",1,15,-14
"12799","6180橘子","110/07/09","新光",26,18,8
"12800","6180橘子","110/07/09","日盛-二林",0,10,-10
"12801","6180橘子","110/07/09","統一-三重",6,0,6
"12802","6180橘子","110/07/09","凱基-東門",0,10,-10
"12803","6180橘子","110/07/09","群益金鼎-嘉義",6,0,6
"12804","6180橘子","110/07/09","華南永昌-三重",0,10,-10
"12805","6180橘子","110/07/09","元大-員林中山",6,0,6
"12806","6180橘子","110/07/09","元大-彰化民生",1,11,-10
"12807","6180橘子","110/07/09","合庫-鳳山",5,0,5
"12808","6180橘子","110/07/09","永豐金-新店",1,11,-10
"12809","6180橘子","110/07/09","富邦-建國",6,1,5
"12810","6180橘子","110/07/09","群益金鼎-丹鳳",0,8,-8
"12811","2390云辰","110/07/09","摩根大通",279,56,223
"12812","2390云辰","110/07/09","元大-天母",0,127,-127
"12813","2390云辰","110/07/09","日盛-鳳山",110,2,108
"12814","2390云辰","110/07/09","中國信託-文心",5,109,-104
"12815","2390云辰","110/07/09","宏遠證券",100,0,100
"12816","2390云辰","110/07/09","永豐金-復興",0,55,-55
"12817","2390云辰","110/07/09","元大-大里",63,6,57
"12818","2390云辰","110/07/09","凱基-台北",239,286,-47
"12819","2390云辰","110/07/09","凱基-八德",59,10,49
"12820","2390云辰","110/07/09","德信",2,32,-30
"12821","2390云辰","110/07/09","合庫-新竹",40,0,40
"12822","2390云辰","110/07/09","兆豐-桃鶯",2,32,-30
"12823","2390云辰","110/07/09","國票",40,1,39
"12824","2390云辰","110/07/09","致和-南京",0,30,-30
"12825","2390云辰","110/07/09","新加坡商瑞銀",49,13,36
"12826","2390云辰","110/07/09","富邦-虎尾",1,31,-30
"12827","2390云辰","110/07/09","統一-新台中",36,2,34
"12828","2390云辰","110/07/09","元大-善化",2,31,-29
"12829","2390云辰","110/07/09","國票-嘉義",31,0,31
"12830","2390云辰","110/07/09","富邦-板橋",0,27,-27
"12831","2390云辰","110/07/09","華南永昌",35,7,28
"12832","2390云辰","110/07/09","富邦-永和",3,28,-25
"12833","2390云辰","110/07/09","玉山-台中",49,22,27
"12834","2390云辰","110/07/09","第一金-自由",20,44,-24
"12835","2390云辰","110/07/09","華南永昌-敦南",25,0,25
"12836","2390云辰","110/07/09","凱基-內湖",0,24,-24
"12837","2390云辰","110/07/09","新光-高雄",27,4,23
"12838","2390云辰","110/07/09","元大-汐止",1,24,-23
"12839","2390云辰","110/07/09","台灣摩根士丹利",85,63,22
"12840","2390云辰","110/07/09","新光-台中",12,33,-21
"12841","4903聯光通","110/07/09","元大-敦南",10,0,10
"12842","4903聯光通","110/07/09","第一金-台中",0,12,-12
"12843","4903聯光通","110/07/09","凱基-士林",5,0,5
"12844","4903聯光通","110/07/09","日盛-忠孝",0,3,-3
"12845","4903聯光通","110/07/09","元大-苗栗",5,0,5
"12846","4903聯光通","110/07/09","群益金鼎-崇德",0,3,-3
"12847","4903聯光通","110/07/09","元大-屏南",3,0,3
"12848","4903聯光通","110/07/09","國票-內壢",0,2,-2
"12849","4903聯光通","110/07/09","中國信託-永康",1,0,1
"12850","4903聯光通","110/07/09","康和-南崁",0,2,-2
"12851","4903聯光通","110/07/09","玉山證券",1,0,1
"12852","4903聯光通","110/07/09","新光-台中",0,2,-2
"12853","4903聯光通","110/07/09","元大-太平",4,3,1
"12854","4903聯光通","110/07/09","玉山-城中",0,2,-2
"12855","4903聯光通","110/07/09","永豐金-嘉義",1,0,1
"12856","4903聯光通","110/07/09","中國信託-文心",0,1,-1
"12857","4903聯光通","110/07/09","大昌",0,0,0
"12858","4903聯光通","110/07/09","大昌",0,0,0
"12859","4903聯光通","110/07/09","中農",0,0,0
"12860","4903聯光通","110/07/09","中農",0,0,0
"12861","2929淘帝","110/07/09","台中銀-台北",110,0,110
"12862","2929淘帝","110/07/09","新光",2,82,-80
"12863","2929淘帝","110/07/09","華南永昌-頭份",72,0,72
"12864","2929淘帝","110/07/09","摩根大通",2,63,-61
"12865","2929淘帝","110/07/09","合庫-高雄",71,0,71
"12866","2929淘帝","110/07/09","第一金-路竹",0,50,-50
"12867","2929淘帝","110/07/09","高橋-龍潭",37,0,37
"12868","2929淘帝","110/07/09","港商麥格理",0,42,-42
"12869","2929淘帝","110/07/09","新光-台中",60,26,34
"12870","2929淘帝","110/07/09","陽信-石牌",0,40,-40
"12871","2929淘帝","110/07/09","元富-大裕",22,1,21
"12872","2929淘帝","110/07/09","台新-左楠",1,39,-38
"12873","2929淘帝","110/07/09","合庫-鳳山",20,0,20
"12874","2929淘帝","110/07/09","凱基-桃園",3,29,-26
"12875","2929淘帝","110/07/09","元大-員林",22,2,20
"12876","2929淘帝","110/07/09","兆豐-內湖",0,25,-25
"12877","2929淘帝","110/07/09","台新-建北",15,0,15
"12878","2929淘帝","110/07/09","元大-北港",0,20,-20
"12879","2929淘帝","110/07/09","兆豐-桃園",13,0,13
"12880","2929淘帝","110/07/09","富邦-北港",0,19,-19
"12881","2929淘帝","110/07/09","兆豐-忠孝",10,0,10
"12882","2929淘帝","110/07/09","富邦-花蓮",0,17,-17
"12883","2929淘帝","110/07/09","國票-敦北法人",10,0,10
"12884","2929淘帝","110/07/09","國泰-台中",2,17,-15
"12885","2929淘帝","110/07/09","永豐金-博愛",10,0,10
"12886","2929淘帝","110/07/09","群益金鼎-彰化",0,15,-15
"12887","2929淘帝","110/07/09","群益金鼎-潭子",8,0,8
"12888","2929淘帝","110/07/09","元大-博愛",0,14,-14
"12889","2929淘帝","110/07/09","富邦-南屯",8,0,8
"12890","2929淘帝","110/07/09","日盛-板橋",0,13,-13
"12891","5410國眾","110/07/09","元大-新盛",14,0,14
"12892","5410國眾","110/07/09","(牛牛牛)亞-鑫豐",1,41,-40
"12893","5410國眾","110/07/09","台灣企銀-民雄",10,0,10
"12894","5410國眾","110/07/09","元富-嘉義",0,25,-25
"12895","5410國眾","110/07/09","元富-虎尾",9,0,9
"12896","5410國眾","110/07/09","凱基-高美館",0,10,-10
"12897","5410國眾","110/07/09","摩根大通",10,1,9
"12898","5410國眾","110/07/09","凱基-城中",0,10,-10
"12899","5410國眾","110/07/09","兆豐-北高雄",7,0,7
"12900","5410國眾","110/07/09","元大-頭份",0,10,-10
"12901","5410國眾","110/07/09","凱基-台北",8,1,7
"12902","5410國眾","110/07/09","群益金鼎-丹鳳",0,7,-7
"12903","5410國眾","110/07/09","華南永昌-公誠",7,0,7
"12904","5410國眾","110/07/09","凱基-復興",0,7,-7
"12905","5410國眾","110/07/09","香港上海匯豐",6,0,6
"12906","5410國眾","110/07/09","元大-員林",0,7,-7
"12907","5410國眾","110/07/09","凱基-中壢",6,0,6
"12908","5410國眾","110/07/09","富邦-竹東",0,6,-6
"12909","5410國眾","110/07/09","華南永昌-南京",6,0,6
"12910","5410國眾","110/07/09","亞東-高雄",0,5,-5
"12911","5410國眾","110/07/09","統一-三重",5,0,5
"12912","5410國眾","110/07/09","大慶-中壢",1,6,-5
"12913","5410國眾","110/07/09","富邦-宜蘭",5,0,5
"12914","5410國眾","110/07/09","群益金鼎-中港",0,5,-5
"12915","5410國眾","110/07/09","元大-崇德",5,0,5
"12916","5410國眾","110/07/09","元大-八德",0,5,-5
"12917","5410國眾","110/07/09","元大-博愛",5,0,5
"12918","5410國眾","110/07/09","富邦-基隆",0,4,-4
"12919","5410國眾","110/07/09","元大-龍潭",5,0,5
"12920","5410國眾","110/07/09","臺銀-新竹",0,3,-3
"12921","2841台開","110/07/09","日盛-雙和",102,0,102
"12922","2841台開","110/07/09","港商野村",0,129,-129
"12923","2841台開","110/07/09","元大-館前",70,0,70
"12924","2841台開","110/07/09","兆豐-永和",0,100,-100
"12925","2841台開","110/07/09","凱基-文心",50,0,50
"12926","2841台開","110/07/09","台新證券",7,28,-21
"12927","2841台開","110/07/09","富邦-嘉義",40,0,40
"12928","2841台開","110/07/09","國票-北高雄",0,20,-20
"12929","2841台開","110/07/09","美商高盛",15,0,15
"12930","2841台開","110/07/09","永豐金-敦南",29,46,-17
"12931","2841台開","110/07/09","台中銀",15,0,15
"12932","2841台開","110/07/09","合庫-基隆",0,12,-12
"12933","2841台開","110/07/09","新光",11,0,11
"12934","2841台開","110/07/09","中國信託-松江",0,12,-12
"12935","2841台開","110/07/09","華南永昌-長虹",10,0,10
"12936","2841台開","110/07/09","兆豐-城中",0,12,-12
"12937","2841台開","110/07/09","永豐金-南投",10,0,10
"12938","2841台開","110/07/09","台中銀-豐原",0,10,-10
"12939","2841台開","110/07/09","合庫-桃園",7,0,7
"12940","2841台開","110/07/09","兆豐-景美",0,10,-10
"12941","2841台開","110/07/09","群益金鼎-古亭",7,0,7
"12942","2841台開","110/07/09","群益金鼎-基隆",0,10,-10
"12943","2841台開","110/07/09","國泰-敦南",6,0,6
"12944","2841台開","110/07/09","元大-北三重",0,10,-10
"12945","2841台開","110/07/09","凱基-桃園",8,2,6
"12946","2841台開","110/07/09","(牛牛牛)亞-網路",0,9,-9
"12947","2841台開","110/07/09","日盛證券",5,0,5
"12948","2841台開","110/07/09","台新-高雄",1,10,-9
"12949","2841台開","110/07/09","元富-文心",5,0,5
"12950","2841台開","110/07/09","凱基-台北",0,7,-7
"12951","6207雷科","110/07/09","群益金鼎-新竹",47,0,47
"12952","6207雷科","110/07/09","新光",7,24,-17
"12953","6207雷科","110/07/09","永豐金-三重",31,0,31
"12954","6207雷科","110/07/09","日盛-和美",0,15,-15
"12955","6207雷科","110/07/09","新加坡商瑞銀",33,5,28
"12956","6207雷科","110/07/09","國泰-台南",0,15,-15
"12957","6207雷科","110/07/09","元大-高雄",26,0,26
"12958","6207雷科","110/07/09","華南永昌-古亭",0,14,-14
"12959","6207雷科","110/07/09","統一-員林",22,0,22
"12960","6207雷科","110/07/09","土銀-白河",0,11,-11
"12961","6207雷科","110/07/09","台新-高雄",22,0,22
"12962","6207雷科","110/07/09","日盛-台南",0,10,-10
"12963","6207雷科","110/07/09","摩根大通",34,17,17
"12964","6207雷科","110/07/09","元富-林園",0,10,-10
"12965","6207雷科","110/07/09","元大-博愛",17,1,16
"12966","6207雷科","110/07/09","富邦-園區",0,10,-10
"12967","6207雷科","110/07/09","日茂-埔里",12,0,12
"12968","6207雷科","110/07/09","元大-上新莊",0,10,-10
"12969","6207雷科","110/07/09","國泰-台中",17,6,11
"12970","6207雷科","110/07/09","永豐金-南京",0,10,-10
"12971","6207雷科","110/07/09","富邦-三重",10,0,10
"12972","6207雷科","110/07/09","兆豐-小港",0,6,-6
"12973","6207雷科","110/07/09","元大-沙鹿",10,0,10
"12974","6207雷科","110/07/09","富邦-羅東",1,7,-6
"12975","6207雷科","110/07/09","元大-八德",10,0,10
"12976","6207雷科","110/07/09","元大-土城永寧",0,6,-6
"12977","6207雷科","110/07/09","第一金-路竹",11,2,9
"12978","6207雷科","110/07/09","永豐金-板盛",0,6,-6
"12979","6207雷科","110/07/09","統一-南京",5,0,5
"12980","6207雷科","110/07/09","日盛-板橋",0,5,-5
"12981","3679新至陞","110/07/09","元大-大天母",10,0,10
"12982","3679新至陞","110/07/09","第一金-光復",0,11,-11
"12983","3679新至陞","110/07/09","日盛-樹林",9,0,9
"12984","3679新至陞","110/07/09","瑞士信貸",0,8,-8
"12985","3679新至陞","110/07/09","凱基-台北",11,2,9
"12986","3679新至陞","110/07/09","大慶-苗栗",0,5,-5
"12987","3679新至陞","110/07/09","華南永昌-小港",8,0,8
"12988","3679新至陞","110/07/09","元大-永春",0,5,-5
"12989","3679新至陞","110/07/09","兆豐-來福",7,0,7
"12990","3679新至陞","110/07/09","日盛-和美",0,4,-4
"12991","3679新至陞","110/07/09","香港上海匯豐",5,0,5
"12992","3679新至陞","110/07/09","元大-雙和",0,3,-3
"12993","3679新至陞","110/07/09","台中銀-員林",3,0,3
"12994","3679新至陞","110/07/09","永豐金-屏東",0,3,-3
"12995","3679新至陞","110/07/09","新光",3,0,3
"12996","3679新至陞","110/07/09","彰銀",0,2,-2
"12997","3679新至陞","110/07/09","土銀-花蓮",2,0,2
"12998","3679新至陞","110/07/09","宏遠-館前",0,2,-2
"12999","3679新至陞","110/07/09","第一金-澎湖",2,0,2
"13000","3679新至陞","110/07/09","港商野村",0,2,-2
"13001","3679新至陞","110/07/09","摩根大通",2,0,2
"13002","3679新至陞","110/07/09","大昌-新店",0,2,-2
"13003","3679新至陞","110/07/09","國泰-敦南",2,0,2
"13004","3679新至陞","110/07/09","元大-新莊",0,2,-2
"13005","3679新至陞","110/07/09","元大-淡水",4,2,2
"13006","3679新至陞","110/07/09","元大-板橋",0,2,-2
"13007","3679新至陞","110/07/09","日盛-士林",1,0,1
"13008","3679新至陞","110/07/09","台灣摩根士丹利",0,1,-1
"13009","3679新至陞","110/07/09","日盛-信義",1,0,1
"13010","3679新至陞","110/07/09","第一金-高雄",0,1,-1
"13011","2727王品","110/07/09","台灣匯立證券",90,0,90
"13012","2727王品","110/07/09","台灣摩根士丹利",0,267,-267
"13013","2727王品","110/07/09","國泰-敦南",166,84,82
"13014","2727王品","110/07/09","富邦-台北",35,299,-264
"13015","2727王品","110/07/09","富邦-仁愛",56,12,44
"13016","2727王品","110/07/09","凱基-台北",174,296,-122
"13017","2727王品","110/07/09","台新證券",109,66,43
"13018","2727王品","110/07/09","第一金",2,102,-100
"13019","2727王品","110/07/09","新光",117,87,30
"13020","2727王品","110/07/09","群益金鼎-大安",0,80,-80
"13021","2727王品","110/07/09","臺銀-臺中",35,6,29
"13022","2727王品","110/07/09","兆豐-大安",7,60,-53
"13023","2727王品","110/07/09","元大-桃園",32,3,29
"13024","2727王品","110/07/09","永豐金-南投",0,50,-50
"13025","2727王品","110/07/09","元富-宜蘭",34,6,28
"13026","2727王品","110/07/09","新加坡商瑞銀",6,46,-40
"13027","2727王品","110/07/09","玉山-台中",34,8,26
"13028","2727王品","110/07/09","合庫-彰化",11,50,-39
"13029","2727王品","110/07/09","群益金鼎-宜蘭",30,4,26
"13030","2727王品","110/07/09","永豐金-萬盛",13,52,-39
"13031","2727王品","110/07/09","富邦-台中",42,16,26
"13032","2727王品","110/07/09","瑞士信貸",0,34,-34
"13033","2727王品","110/07/09","第一金-豐原",25,1,24
"13034","2727王品","110/07/09","元大-和平",4,35,-31
"13035","2727王品","110/07/09","臺銀",30,8,22
"13036","2727王品","110/07/09","美林",14,44,-30
"13037","2727王品","110/07/09","兆豐-來福",23,1,22
"13038","2727王品","110/07/09","元大-員林",9,38,-29
"13039","2727王品","110/07/09","玉山-士林",22,2,20
"13040","2727王品","110/07/09","元富-西松",4,31,-27
"13041","1570力肯","110/07/09","凱基-台北",30,1,29
"13042","1570力肯","110/07/09","群益金鼎-彰化",0,20,-20
"13043","1570力肯","110/07/09","新光-台南",20,0,20
"13044","1570力肯","110/07/09","元大-土城學府",0,20,-20
"13045","1570力肯","110/07/09","元大-高雄",20,0,20
"13046","1570力肯","110/07/09","元大-大統",0,16,-16
"13047","1570力肯","110/07/09","國票-中正",12,0,12
"13048","1570力肯","110/07/09","元大-新營",0,11,-11
"13049","1570力肯","110/07/09","日盛-高雄",6,0,6
"13050","1570力肯","110/07/09","元大-和平",0,10,-10
"13051","1570力肯","110/07/09","元富-緯城",6,0,6
"13052","1570力肯","110/07/09","元大-草屯",0,10,-10
"13053","1570力肯","110/07/09","群益金鼎-台南",6,0,6
"13054","1570力肯","110/07/09","元大-鹿港",0,9,-9
"13055","1570力肯","110/07/09","華南永昌-岡山",6,0,6
"13056","1570力肯","110/07/09","合庫-基隆",0,7,-7
"13057","1570力肯","110/07/09","統一-中壢",5,0,5
"13058","1570力肯","110/07/09","摩根大通",2,8,-6
"13059","1570力肯","110/07/09","凱基-三峽",5,0,5
"13060","1570力肯","110/07/09","台灣企銀-豐原",0,4,-4
"13061","1570力肯","110/07/09","大昌-樹林",4,0,4
"13062","1570力肯","110/07/09","日盛-桃園",0,4,-4
"13063","1570力肯","110/07/09","新光",3,0,3
"13064","1570力肯","110/07/09","國泰-高雄",0,3,-3
"13065","1570力肯","110/07/09","富邦-新竹華信",3,0,3
"13066","1570力肯","110/07/09","永豐金-敦南",0,3,-3
"13067","1570力肯","110/07/09","合庫-台中",2,0,2
"13068","1570力肯","110/07/09","土銀-彰化",0,2,-2
"13069","1570力肯","110/07/09","臺銀-臺中",2,0,2
"13070","1570力肯","110/07/09","臺銀-鳳山",0,2,-2
"13071","6180橘子","110/07/09","摩根大通",63,1,62
"13072","6180橘子","110/07/09","元大-南京",1,32,-31
"13073","6180橘子","110/07/09","富邦-陽明",73,33,40
"13074","6180橘子","110/07/09","群益金鼎-台北",0,25,-25
"13075","6180橘子","110/07/09","新加坡商瑞銀",31,0,31
"13076","6180橘子","110/07/09","兆豐-復興",0,21,-21
"13077","6180橘子","110/07/09","美商高盛",25,0,25
"13078","6180橘子","110/07/09","永豐金-嘉義",0,21,-21
"13079","6180橘子","110/07/09","凱基-台北",26,10,16
"13080","6180橘子","110/07/09","凱基-中壢",8,24,-16
"13081","6180橘子","110/07/09","華南永昌-楠梓",13,0,13
"13082","6180橘子","110/07/09","致和-崇德",0,15,-15
"13083","6180橘子","110/07/09","華南永昌-朴子",11,0,11
"13084","6180橘子","110/07/09","群益金鼎-屏東",0,15,-15
"13085","6180橘子","110/07/09","元大-北港",11,0,11
"13086","6180橘子","110/07/09","群益金鼎-中山",0,15,-15
"13087","6180橘子","110/07/09","元大-成功",10,1,9
"13088","6180橘子","110/07/09","瑞士信貸",1,15,-14
"13089","6180橘子","110/07/09","新光",26,18,8
"13090","6180橘子","110/07/09","日盛-二林",0,10,-10
"13091","6180橘子","110/07/09","統一-三重",6,0,6
"13092","6180橘子","110/07/09","凱基-東門",0,10,-10
"13093","6180橘子","110/07/09","群益金鼎-嘉義",6,0,6
"13094","6180橘子","110/07/09","華南永昌-三重",0,10,-10
"13095","6180橘子","110/07/09","元大-員林中山",6,0,6
"13096","6180橘子","110/07/09","元大-彰化民生",1,11,-10
"13097","6180橘子","110/07/09","合庫-鳳山",5,0,5
"13098","6180橘子","110/07/09","永豐金-新店",1,11,-10
"13099","6180橘子","110/07/09","富邦-建國",6,1,5
"13100","6180橘子","110/07/09","群益金鼎-丹鳳",0,8,-8
"13101","2390云辰","110/07/09","摩根大通",279,56,223
"13102","2390云辰","110/07/09","元大-天母",0,127,-127
"13103","2390云辰","110/07/09","日盛-鳳山",110,2,108
"13104","2390云辰","110/07/09","中國信託-文心",5,109,-104
"13105","2390云辰","110/07/09","宏遠證券",100,0,100
"13106","2390云辰","110/07/09","永豐金-復興",0,55,-55
"13107","2390云辰","110/07/09","元大-大里",63,6,57
"13108","2390云辰","110/07/09","凱基-台北",239,286,-47
"13109","2390云辰","110/07/09","凱基-八德",59,10,49
"13110","2390云辰","110/07/09","德信",2,32,-30
"13111","2390云辰","110/07/09","合庫-新竹",40,0,40
"13112","2390云辰","110/07/09","兆豐-桃鶯",2,32,-30
"13113","2390云辰","110/07/09","國票",40,1,39
"13114","2390云辰","110/07/09","致和-南京",0,30,-30
"13115","2390云辰","110/07/09","新加坡商瑞銀",49,13,36
"13116","2390云辰","110/07/09","富邦-虎尾",1,31,-30
"13117","2390云辰","110/07/09","統一-新台中",36,2,34
"13118","2390云辰","110/07/09","元大-善化",2,31,-29
"13119","2390云辰","110/07/09","國票-嘉義",31,0,31
"13120","2390云辰","110/07/09","富邦-板橋",0,27,-27
"13121","2390云辰","110/07/09","華南永昌",35,7,28
"13122","2390云辰","110/07/09","富邦-永和",3,28,-25
"13123","2390云辰","110/07/09","玉山-台中",49,22,27
"13124","2390云辰","110/07/09","第一金-自由",20,44,-24
"13125","2390云辰","110/07/09","華南永昌-敦南",25,0,25
"13126","2390云辰","110/07/09","凱基-內湖",0,24,-24
"13127","2390云辰","110/07/09","新光-高雄",27,4,23
"13128","2390云辰","110/07/09","元大-汐止",1,24,-23
"13129","2390云辰","110/07/09","台灣摩根士丹利",85,63,22
"13130","2390云辰","110/07/09","新光-台中",12,33,-21
"13131","4903聯光通","110/07/08","元富-新興",18,0,18
"13132","4903聯光通","110/07/08","中國信託-中壢",0,14,-14
"13133","4903聯光通","110/07/08","元大-苗栗",9,0,9
"13134","4903聯光通","110/07/08","彰銀",0,7,-7
"13135","4903聯光通","110/07/08","兆豐-鹿港",3,0,3
"13136","4903聯光通","110/07/08","中國信託-松江",0,5,-5
"13137","4903聯光通","110/07/08","群益金鼎-萬華",2,0,2
"13138","4903聯光通","110/07/08","光和",0,2,-2
"13139","4903聯光通","110/07/08","元大-屏南",1,0,1
"13140","4903聯光通","110/07/08","元大-鶯歌",0,2,-2
"13141","4903聯光通","110/07/08","華南永昌-新莊",0,0,0
"13142","4903聯光通","110/07/08","群益金鼎-館前",0,1,-1
"13143","4903聯光通","110/07/08","元大-羅東",0,0,0
"13144","4903聯光通","110/07/08","華南永昌",0,1,-1
"13145","4903聯光通","110/07/08","元大-太平",2,3,-1
"13146","4903聯光通","110/07/08","華南永昌-新莊",0,0,0
"13147","4903聯光通","110/07/08","元大-羅東",0,0,0
"13148","2929淘帝","110/07/08","日盛-園區",90,6,84
"13149","2929淘帝","110/07/08","元大-太平",1,111,-110
"13150","2929淘帝","110/07/08","華南永昌-頭份",54,0,54
"13151","2929淘帝","110/07/08","港商野村",31,106,-75
"13152","2929淘帝","110/07/08","美商高盛",50,0,50
"13153","2929淘帝","110/07/08","凱基-板橋",62,111,-49
"13154","2929淘帝","110/07/08","台中銀-台北",50,0,50
"13155","2929淘帝","110/07/08","新光-台中",30,78,-48
"13156","2929淘帝","110/07/08","臺銀-臺南",30,0,30
"13157","2929淘帝","110/07/08","元富-永和",1,41,-40
"13158","2929淘帝","110/07/08","永豐金-大園",42,12,30
"13159","2929淘帝","110/07/08","永豐金-鳳山",0,28,-28
"13160","2929淘帝","110/07/08","元富-三重",30,1,29
"13161","2929淘帝","110/07/08","元大-南崁",0,26,-26
"13162","2929淘帝","110/07/08","兆豐-桃鶯",29,0,29
"13163","2929淘帝","110/07/08","元大-花蓮",2,27,-25
"13164","2929淘帝","110/07/08","元大-承德",20,3,17
"13165","2929淘帝","110/07/08","元大-府城",0,24,-24
"13166","2929淘帝","110/07/08","新光-新竹",13,0,13
"13167","2929淘帝","110/07/08","新光",21,43,-22
"13168","2929淘帝","110/07/08","富邦-內湖",13,0,13
"13169","2929淘帝","110/07/08","臺銀-民權",0,20,-20
"13170","2929淘帝","110/07/08","國泰-板橋",13,1,12
"13171","2929淘帝","110/07/08","摩根大通",66,84,-18
"13172","2929淘帝","110/07/08","第一金-大稻埕",10,0,10
"13173","2929淘帝","110/07/08","凱基-台北",0,17,-17
"13174","2929淘帝","110/07/08","統一-汐止",10,0,10
"13175","2929淘帝","110/07/08","元大-博愛",6,23,-17
"13176","2929淘帝","110/07/08","元富-大裕",10,0,10
"13177","2929淘帝","110/07/08","永豐金-桃盛",0,16,-16
"13178","5410國眾","110/07/08","元大-新盛",15,0,15
"13179","5410國眾","110/07/08","元大-旗山",0,50,-50
"13180","5410國眾","110/07/08","元大-屏南",10,0,10
"13181","5410國眾","110/07/08","元大-頭份",0,14,-14
"13182","5410國眾","110/07/08","元大-成功",10,0,10
"13183","5410國眾","110/07/08","國泰-高雄",0,8,-8
"13184","5410國眾","110/07/08","元大-東泰",7,0,7
"13185","5410國眾","110/07/08","元大-小港",0,7,-7
"13186","5410國眾","110/07/08","富邦-陽明",6,0,6
"13187","5410國眾","110/07/08","統一-嘉義",0,5,-5
"13188","5410國眾","110/07/08","臺銀-金山",5,0,5
"13189","5410國眾","110/07/08","兆豐-台中港",0,5,-5
"13190","5410國眾","110/07/08","日盛-員林",5,0,5
"13191","5410國眾","110/07/08","凱基-屏東",0,5,-5
"13192","5410國眾","110/07/08","摩根大通",5,0,5
"13193","5410國眾","110/07/08","元大-八德",0,5,-5
"13194","5410國眾","110/07/08","富邦-桃園",5,0,5
"13195","5410國眾","110/07/08","元富-嘉義",0,4,-4
"13196","5410國眾","110/07/08","元富-大昌",4,0,4
"13197","5410國眾","110/07/08","玉山-雙和",0,4,-4
"13198","5410國眾","110/07/08","台新-台中",4,0,4
"13199","5410國眾","110/07/08","凱基-高美館",1,5,-4
"13200","5410國眾","110/07/08","華南永昌-小港",5,1,4
"13201","5410國眾","110/07/08","統一-員林",0,3,-3
"13202","5410國眾","110/07/08","元大-新竹",5,1,4
"13203","5410國眾","110/07/08","臺銀-鳳山",0,2,-2
"13204","5410國眾","110/07/08","元大-土城學府",4,0,4
"13205","5410國眾","110/07/08","亞東",0,2,-2
"13206","5410國眾","110/07/08","元大-新莊",4,0,4
"13207","5410國眾","110/07/08","新光",0,2,-2
"13208","2841台開","110/07/08","元大-樹林",653,0,653
"13209","2841台開","110/07/08","港商野村",0,868,-868
"13210","2841台開","110/07/08","台新證券",115,0,115
"13211","2841台開","110/07/08","群益金鼎-忠孝",0,100,-100
"13212","2841台開","110/07/08","永豐金-豐原",105,0,105
"13213","2841台開","110/07/08","宏遠-高雄",0,56,-56
"13214","2841台開","110/07/08","元富-新興",100,0,100
"13215","2841台開","110/07/08","新光",3,38,-35
"13216","2841台開","110/07/08","凱基-文心",50,0,50
"13217","2841台開","110/07/08","花旗環球",0,29,-29
"13218","2841台開","110/07/08","元大-八德",40,0,40
"13219","2841台開","110/07/08","富邦-仁愛",2,30,-28
"13220","2841台開","110/07/08","日盛-雙和",30,0,30
"13221","2841台開","110/07/08","元富-潮州",0,24,-24
"13222","2841台開","110/07/08","統一-竹南",30,0,30
"13223","2841台開","110/07/08","元大-沙鹿",0,20,-20
"13224","2841台開","110/07/08","凱基-台南",30,0,30
"13225","2841台開","110/07/08","元大-汐止",0,20,-20
"13226","2841台開","110/07/08","元大-福營",30,0,30
"13227","2841台開","110/07/08","合庫-嘉義",2,20,-18
"13228","2841台開","110/07/08","合庫-台中",22,0,22
"13229","2841台開","110/07/08","國泰-敦南",3,21,-18
"13230","2841台開","110/07/08","大昌-安康",28,10,18
"13231","2841台開","110/07/08","日盛-竹北",0,15,-15
"13232","2841台開","110/07/08","元大-斗信",15,0,15
"13233","2841台開","110/07/08","元大-三重",0,15,-15
"13234","2841台開","110/07/08","富邦-台北",13,0,13
"13235","2841台開","110/07/08","永豐金-敦南",45,60,-15
"13236","2841台開","110/07/08","合庫-桃園",10,0,10
"13237","2841台開","110/07/08","(牛牛牛)亞-網路",0,12,-12
"13238","6207雷科","110/07/08","台新-高雄",54,2,52
"13239","6207雷科","110/07/08","群益金鼎-丹鳳",0,60,-60
"13240","6207雷科","110/07/08","新光-台中",18,0,18
"13241","6207雷科","110/07/08","元大-頭份",1,56,-55
"13242","6207雷科","110/07/08","日盛-嘉義",16,0,16
"13243","6207雷科","110/07/08","國票-中和",0,30,-30
"13244","6207雷科","110/07/08","合庫-鳳山",15,0,15
"13245","6207雷科","110/07/08","凱基-台北",1,29,-28
"13246","6207雷科","110/07/08","臺銀-臺中",12,0,12
"13247","6207雷科","110/07/08","兆豐-板橋",0,25,-25
"13248","6207雷科","110/07/08","群益金鼎-土城",12,0,12
"13249","6207雷科","110/07/08","凱基-城中",4,25,-21
"13250","6207雷科","110/07/08","新光",25,14,11
"13251","6207雷科","110/07/08","日進",0,20,-20
"13252","6207雷科","110/07/08","凱基-中壢",11,0,11
"13253","6207雷科","110/07/08","台新證券",3,20,-17
"13254","6207雷科","110/07/08","台灣企銀",10,0,10
"13255","6207雷科","110/07/08","群益金鼎-中山",0,16,-16
"13256","6207雷科","110/07/08","第一金-新興",11,1,10
"13257","6207雷科","110/07/08","元大-東門",0,16,-16
"13258","6207雷科","110/07/08","元富-吉利",10,0,10
"13259","6207雷科","110/07/08","群益金鼎-大甲",0,13,-13
"13260","6207雷科","110/07/08","光和-和美",10,0,10
"13261","6207雷科","110/07/08","日盛-板橋",0,10,-10
"13262","6207雷科","110/07/08","永豐金-南京",10,0,10
"13263","6207雷科","110/07/08","日盛-中壢",0,10,-10
"13264","6207雷科","110/07/08","土銀",8,0,8
"13265","6207雷科","110/07/08","摩根大通",125,135,-10
"13266","6207雷科","110/07/08","中國信託-高雄",8,0,8
"13267","6207雷科","110/07/08","凱基-五股",0,10,-10
"13268","3679新至陞","110/07/08","華南永昌-台中",17,0,17
"13269","3679新至陞","110/07/08","大慶-蘆洲",0,10,-10
"13270","3679新至陞","110/07/08","國泰-桃園",6,0,6
"13271","3679新至陞","110/07/08","華南永昌-小港",0,7,-7
"13272","3679新至陞","110/07/08","元大-永春",6,0,6
"13273","3679新至陞","110/07/08","國泰-館前",0,3,-3
"13274","3679新至陞","110/07/08","香港上海匯豐",4,0,4
"13275","3679新至陞","110/07/08","元大-板橋",0,3,-3
"13276","3679新至陞","110/07/08","中國信託-新竹",3,0,3
"13277","3679新至陞","110/07/08","港商法國興業",0,2,-2
"13278","3679新至陞","110/07/08","國票-敦北法人",3,0,3
"13279","3679新至陞","110/07/08","第一金-忠孝",0,2,-2
"13280","3679新至陞","110/07/08","群益金鼎-台南",2,0,2
"13281","3679新至陞","110/07/08","元富-古亭",0,2,-2
"13282","3679新至陞","110/07/08","凱基",2,0,2
"13283","3679新至陞","110/07/08","摩根大通",1,3,-2
"13284","3679新至陞","110/07/08","凱基-台北",6,4,2
"13285","3679新至陞","110/07/08","富邦-板橋",0,2,-2
"13286","3679新至陞","110/07/08","日盛-信義",1,0,1
"13287","3679新至陞","110/07/08","元大-文心興安",0,2,-2
"13288","3679新至陞","110/07/08","日盛-新莊",1,0,1
"13289","3679新至陞","110/07/08","臺銀-高雄",0,1,-1
"13290","3679新至陞","110/07/08","大慶",1,0,1
"13291","3679新至陞","110/07/08","日盛-高雄",0,1,-1
"13292","3679新至陞","110/07/08","兆豐-三重",1,0,1
"13293","3679新至陞","110/07/08","日盛-文化",0,1,-1
"13294","3679新至陞","110/07/08","致和-東門",1,0,1
"13295","3679新至陞","110/07/08","美商高盛",0,1,-1
"13296","3679新至陞","110/07/08","台新證券",1,0,1
"13297","3679新至陞","110/07/08","瑞士信貸",0,1,-1
"13298","2727王品","110/07/08","群益金鼎-大安",80,0,80
"13299","2727王品","110/07/08","台灣摩根士丹利",1,300,-299
"13300","2727王品","110/07/08","富邦-台北",237,165,72
"13301","2727王品","110/07/08","元大證券",173,439,-266
"13302","2727王品","110/07/08","永豐金-萬盛",55,5,50
"13303","2727王品","110/07/08","統一",33,200,-167
"13304","2727王品","110/07/08","永豐金-南投",53,10,43
"13305","2727王品","110/07/08","凱基-台北",476,615,-139
"13306","2727王品","110/07/08","國泰-敦南",190,148,42
"13307","2727王品","110/07/08","永豐金-松山",8,138,-130
"13308","2727王品","110/07/08","台新-高雄",71,36,35
"13309","2727王品","110/07/08","新加坡商瑞銀",38,138,-100
"13310","2727王品","110/07/08","富邦-建國",62,27,35
"13311","2727王品","110/07/08","富邦-嘉義",84,182,-98
"13312","2727王品","110/07/08","永豐金證券",50,15,35
"13313","2727王品","110/07/08","元富-台南",4,99,-95
"13314","2727王品","110/07/08","港商野村",185,152,33
"13315","2727王品","110/07/08","凱基-永華",4,92,-88
"13316","2727王品","110/07/08","元大-嘉義",35,3,32
"13317","2727王品","110/07/08","凱基-大直",2,73,-71
"13318","2727王品","110/07/08","台新-三民",35,4,31
"13319","2727王品","110/07/08","美林",105,164,-59
"13320","2727王品","110/07/08","凱基-桃園",35,4,31
"13321","2727王品","110/07/08","第一金-台南",11,63,-52
"13322","2727王品","110/07/08","元大-和平",41,10,31
"13323","2727王品","110/07/08","摩根大通",216,259,-43
"13324","2727王品","110/07/08","兆豐-大安",33,5,28
"13325","2727王品","110/07/08","元大-員林",9,50,-41
"13326","2727王品","110/07/08","元大-新盛",33,6,27
"13327","2727王品","110/07/08","兆豐-虎尾",1,41,-40
"13328","1570力肯","110/07/08","群益金鼎-三重",20,0,20
"13329","1570力肯","110/07/08","中國信託-永康",0,26,-26
"13330","1570力肯","110/07/08","凱基-中壢",20,0,20
"13331","1570力肯","110/07/08","統一-敦南",0,12,-12
"13332","1570力肯","110/07/08","群益金鼎-台南",14,0,14
"13333","1570力肯","110/07/08","國票-博愛",0,10,-10
"13334","1570力肯","110/07/08","元富-緯城",10,0,10
"13335","1570力肯","110/07/08","元大-西門",0,10,-10
"13336","1570力肯","110/07/08","瑞士信貸",7,0,7
"13337","1570力肯","110/07/08","新光",0,9,-9
"13338","1570力肯","110/07/08","摩根大通",6,0,6
"13339","1570力肯","110/07/08","永豐金-大園",0,9,-9
"13340","1570力肯","110/07/08","土銀-白河",5,0,5
"13341","1570力肯","110/07/08","日盛-大墩",0,6,-6
"13342","1570力肯","110/07/08","台灣摩根士丹利",4,0,4
"13343","1570力肯","110/07/08","台新證券",0,6,-6
"13344","1570力肯","110/07/08","元大-新莊",3,0,3
"13345","1570力肯","110/07/08","永全",0,5,-5
"13346","1570力肯","110/07/08","永豐金-苓雅",3,0,3
"13347","1570力肯","110/07/08","元大-天母",0,5,-5
"13348","1570力肯","110/07/08","合庫-三重",2,0,2
"13349","1570力肯","110/07/08","元富-吉利",0,3,-3
"13350","1570力肯","110/07/08","(牛牛牛)亞-鑫豐",2,0,2
"13351","1570力肯","110/07/08","國泰-高雄",0,3,-3
"13352","1570力肯","110/07/08","玉山-大里",2,0,2
"13353","1570力肯","110/07/08","群益金鼎-北高雄",0,3,-3
"13354","1570力肯","110/07/08","國泰-敦南",2,0,2
"13355","1570力肯","110/07/08","群益金鼎-東門",0,2,-2
"13356","1570力肯","110/07/08","華南永昌-岡山",2,0,2
"13357","1570力肯","110/07/08","日盛-高雄",5,6,-1
"13358","6180橘子","110/07/08","新光",30,4,26
"13359","6180橘子","110/07/08","元大-土城學府",0,89,-89
"13360","6180橘子","110/07/08","康和-台南",22,0,22
"13361","6180橘子","110/07/08","凱基-東勢",1,66,-65
"13362","6180橘子","110/07/08","國泰-板橋",22,0,22
"13363","6180橘子","110/07/08","光和",0,64,-64
"13364","6180橘子","110/07/08","日盛-文化",21,0,21
"13365","6180橘子","110/07/08","中國信託-忠孝",0,50,-50
"13366","6180橘子","110/07/08","中國信託-文心",20,2,18
"13367","6180橘子","110/07/08","元富-大裕",0,25,-25
"13368","6180橘子","110/07/08","凱基-台北",39,24,15
"13369","6180橘子","110/07/08","統一-基隆",1,25,-24
"13370","6180橘子","110/07/08","元富-新店",14,0,14
"13371","6180橘子","110/07/08","美商高盛",1,21,-20
"13372","6180橘子","110/07/08","元大-土城永寧",11,0,11
"13373","6180橘子","110/07/08","元大證券",1,19,-18
"13374","6180橘子","110/07/08","永豐金-南京",11,0,11
"13375","6180橘子","110/07/08","元大-太平",2,20,-18
"13376","6180橘子","110/07/08","宏遠-館前",10,0,10
"13377","6180橘子","110/07/08","合庫證券",2,18,-16
"13378","6180橘子","110/07/08","國泰-新莊",10,0,10
"13379","6180橘子","110/07/08","台灣摩根士丹利",1,12,-11
"13380","6180橘子","110/07/08","群益金鼎",10,0,10
"13381","6180橘子","110/07/08","瑞士信貸",0,11,-11
"13382","6180橘子","110/07/08","凱基-高雄",10,0,10
"13383","6180橘子","110/07/08","元富-嘉義",0,11,-11
"13384","6180橘子","110/07/08","凱基-大安",10,0,10
"13385","6180橘子","110/07/08","新光-高雄",0,11,-11
"13386","6180橘子","110/07/08","富邦-仁愛",10,0,10
"13387","6180橘子","110/07/08","大慶-苗栗",0,10,-10
"13388","2390云辰","110/07/08","統一-新台中",126,1,125
"13389","2390云辰","110/07/08","摩根大通",62,661,-599
"13390","2390云辰","110/07/08","元大-員林",111,0,111
"13391","2390云辰","110/07/08","新加坡商瑞銀",0,173,-173
"13392","2390云辰","110/07/08","合庫-高雄",105,0,105
"13393","2390云辰","110/07/08","元大-天母",7,150,-143
"13394","2390云辰","110/07/08","凱基-台北",255,177,78
"13395","2390云辰","110/07/08","台灣摩根士丹利",0,134,-134
"13396","2390云辰","110/07/08","新光",71,17,54
"13397","2390云辰","110/07/08","玉山-台中",17,120,-103
"13398","2390云辰","110/07/08","國票-嘉義",53,0,53
"13399","2390云辰","110/07/08","美商高盛",0,78,-78
"13400","2390云辰","110/07/08","富邦-仁愛",53,4,49
"13401","2390云辰","110/07/08","美林",11,82,-71
"13402","2390云辰","110/07/08","兆豐-城中",48,0,48
"13403","2390云辰","110/07/08","群益金鼎-大興",35,106,-71
"13404","2390云辰","110/07/08","元大-新營",47,0,47
"13405","2390云辰","110/07/08","光和",11,71,-60
"13406","2390云辰","110/07/08","國泰-敦南",89,55,34
"13407","2390云辰","110/07/08","國泰-台中",28,70,-42
"13408","2390云辰","110/07/08","兆豐-台中",40,7,33
"13409","2390云辰","110/07/08","玉山-新莊",6,46,-40
"13410","2390云辰","110/07/08","永豐金-中正",36,6,30
"13411","2390云辰","110/07/08","富邦-台北",21,57,-36
"13412","2390云辰","110/07/08","中國信託-三重",29,0,29
"13413","2390云辰","110/07/08","土銀-台中",0,30,-30
"13414","2390云辰","110/07/08","富邦-陽明",33,5,28
"13415","2390云辰","110/07/08","兆豐-埔墘",1,31,-30
"13416","2390云辰","110/07/08","元富-桃園",27,0,27
"13417","2390云辰","110/07/08","玉山-南京東路",3,33,-30
"13418","4903聯光通","110/07/07","元大-太平",47,4,43
"13419","4903聯光通","110/07/07","日盛-板橋",0,15,-15
"13420","4903聯光通","110/07/07","華南永昌-桃園",10,0,10
"13421","4903聯光通","110/07/07","元大-八德",0,9,-9
"13422","4903聯光通","110/07/07","元大-南投",9,0,9
"13423","4903聯光通","110/07/07","宏遠證券",0,7,-7
"13424","4903聯光通","110/07/07","新光-台中",3,0,3
"13425","4903聯光通","110/07/07","大慶",0,7,-7
"13426","4903聯光通","110/07/07","國泰-敦南",1,0,1
"13427","4903聯光通","110/07/07","群益金鼎-館前",0,6,-6
"13428","4903聯光通","110/07/07","國票-中正",0,0,0
"13429","4903聯光通","110/07/07","元大-羅東",0,5,-5
"13430","4903聯光通","110/07/07","康和-內湖",0,0,0
"13431","4903聯光通","110/07/07","新光",8,12,-4
"13432","4903聯光通","110/07/07","凱基-站前",0,0,0
"13433","4903聯光通","110/07/07","國泰-高雄",0,3,-3
"13434","4903聯光通","110/07/07","華南永昌",1,1,0
"13435","4903聯光通","110/07/07","第一金-台中",0,3,-3
"13436","4903聯光通","110/07/07","華南永昌-新莊",0,0,0
"13437","4903聯光通","110/07/07","中農",0,1,-1
"13438","4903聯光通","110/07/07","臺灣企銀-桃園",0,1,-1
"13439","4903聯光通","110/07/07","台新-新營",0,1,-1
"13440","4903聯光通","110/07/07","元大-鶯歌",2,3,-1
"13441","4903聯光通","110/07/07","元大-永和",0,1,-1
"13442","4903聯光通","110/07/07","元大-苑裡",0,1,-1
"13443","2929淘帝","110/07/07","統一",163,0,163
"13444","2929淘帝","110/07/07","新光-台中",57,142,-85
"13445","2929淘帝","110/07/07","港商野村",323,181,142
"13446","2929淘帝","110/07/07","兆豐-忠孝",0,76,-76
"13447","2929淘帝","110/07/07","日盛-中壢",132,10,122
"13448","2929淘帝","110/07/07","台新-建北",0,53,-53
"13449","2929淘帝","110/07/07","新加坡商瑞銀",140,19,121
"13450","2929淘帝","110/07/07","臺銀-鳳山",0,44,-44
"13451","2929淘帝","110/07/07","日盛-嘉義",101,0,101
"13452","2929淘帝","110/07/07","元大-新盛",0,42,-42
"13453","2929淘帝","110/07/07","摩根大通",101,16,85
"13454","2929淘帝","110/07/07","富邦-建國",6,47,-41
"13455","2929淘帝","110/07/07","元大-太平",55,2,53
"13456","2929淘帝","110/07/07","日盛-園區",0,40,-40
"13457","2929淘帝","110/07/07","元富-松德",50,1,49
"13458","2929淘帝","110/07/07","新光-高雄",1,38,-37
"13459","2929淘帝","110/07/07","凱基-板橋",53,5,48
"13460","2929淘帝","110/07/07","永豐金-三重",1,34,-33
"13461","2929淘帝","110/07/07","美林",80,34,46
"13462","2929淘帝","110/07/07","元大-彰化",0,31,-31
"13463","2929淘帝","110/07/07","元富-台南",41,0,41
"13464","2929淘帝","110/07/07","第一金-大稻埕",0,30,-30
"13465","2929淘帝","110/07/07","兆豐-竹北",39,0,39
"13466","2929淘帝","110/07/07","國泰-敦南",3,33,-30
"13467","2929淘帝","110/07/07","元大-西門",36,0,36
"13468","2929淘帝","110/07/07","富邦-員林",0,30,-30
"13469","2929淘帝","110/07/07","華南永昌",39,4,35
"13470","2929淘帝","110/07/07","元大-蘆洲",1,30,-29
"13471","2929淘帝","110/07/07","日盛-板橋中山",30,0,30
"13472","2929淘帝","110/07/07","台新-台南",4,32,-28
"13473","5410國眾","110/07/07","兆豐-城中",66,0,66
"13474","5410國眾","110/07/07","富邦-仁愛",0,115,-115
"13475","5410國眾","110/07/07","摩根大通",21,0,21
"13476","5410國眾","110/07/07","亞東-板橋",0,38,-38
"13477","5410國眾","110/07/07","元大-北投",21,0,21
"13478","5410國眾","110/07/07","凱基-台北",2,24,-22
"13479","5410國眾","110/07/07","亞東-新竹",15,0,15
"13480","5410國眾","110/07/07","彰銀-七賢",0,10,-10
"13481","5410國眾","110/07/07","元大-福營",12,0,12
"13482","5410國眾","110/07/07","凱基-基隆",0,10,-10
"13483","5410國眾","110/07/07","新光-高雄",11,0,11
"13484","5410國眾","110/07/07","凱基-屏東",0,10,-10
"13485","5410國眾","110/07/07","華南永昌-小港",10,0,10
"13486","5410國眾","110/07/07","凱基-鳳山",0,10,-10
"13487","5410國眾","110/07/07","元大-大灣",10,0,10
"13488","5410國眾","110/07/07","永豐金-忠孝",0,10,-10
"13489","5410國眾","110/07/07","元大-莒光",10,0,10
"13490","5410國眾","110/07/07","日盛-板橋中山",0,9,-9
"13491","5410國眾","110/07/07","台中銀-豐原",9,0,9
"13492","5410國眾","110/07/07","統一-高雄",0,5,-5
"13493","5410國眾","110/07/07","元大-南屯",9,0,9
"13494","5410國眾","110/07/07","元大-斗六",0,5,-5
"13495","5410國眾","110/07/07","日盛-新莊",7,0,7
"13496","5410國眾","110/07/07","元大-大益",0,5,-5
"13497","5410國眾","110/07/07","元富-大昌",6,0,6
"13498","5410國眾","110/07/07","元大-南投",0,5,-5
"13499","5410國眾","110/07/07","新光-新竹",6,0,6
"13500","5410國眾","110/07/07","永豐金-員林",0,5,-5
"13501","5410國眾","110/07/07","臺銀-金山",5,0,5
"13502","5410國眾","110/07/07","華南永昌-楠梓",0,4,-4
"13503","2841台開","110/07/07","永豐金-豐原",268,0,268
"13504","2841台開","110/07/07","凱基-市政",0,200,-200
"13505","2841台開","110/07/07","永豐金-南投",200,0,200
"13506","2841台開","110/07/07","永豐金-彰化",0,100,-100
"13507","2841台開","110/07/07","新光",139,9,130
"13508","2841台開","110/07/07","元大-開元",1,93,-92
"13509","2841台開","110/07/07","中國信託-高雄",50,1,49
"13510","2841台開","110/07/07","港商野村",0,80,-80
"13511","2841台開","110/07/07","元大-歸仁",40,0,40
"13512","2841台開","110/07/07","凱基-台南",25,85,-60
"13513","2841台開","110/07/07","台中銀",35,0,35
"13514","2841台開","110/07/07","美商高盛",1,58,-57
"13515","2841台開","110/07/07","台新-新營",30,0,30
"13516","2841台開","110/07/07","統一-三重",0,55,-55
"13517","2841台開","110/07/07","富邦-台南",30,0,30
"13518","2841台開","110/07/07","台新證券",12,50,-38
"13519","2841台開","110/07/07","國泰-板橋",30,1,29
"13520","2841台開","110/07/07","陽信-石牌",0,31,-31
"13521","2841台開","110/07/07","凱基-文心",28,0,28
"13522","2841台開","110/07/07","元大-福營",0,31,-31
"13523","2841台開","110/07/07","凱基-站前",27,0,27
"13524","2841台開","110/07/07","第一金-澎湖",0,30,-30
"13525","2841台開","110/07/07","大昌-安康",38,16,22
"13526","2841台開","110/07/07","元大-新莊",0,30,-30
"13527","2841台開","110/07/07","合庫-台中",20,0,20
"13528","2841台開","110/07/07","國泰-館前",0,28,-28
"13529","2841台開","110/07/07","日盛-台南",20,0,20
"13530","2841台開","110/07/07","元大-竹科",0,25,-25
"13531","2841台開","110/07/07","台中銀-員林",20,0,20
"13532","2841台開","110/07/07","富邦-仁愛",1,22,-21
"13533","6207雷科","110/07/07","元大-大天母",21,0,21
"13534","6207雷科","110/07/07","元大-高雄",0,105,-105
"13535","6207雷科","110/07/07","元大-頭份",18,0,18
"13536","6207雷科","110/07/07","永豐金-中正",0,35,-35
"13537","6207雷科","110/07/07","第一金-新興",16,0,16
"13538","6207雷科","110/07/07","摩根大通",8,39,-31
"13539","6207雷科","110/07/07","富邦-虎尾",12,0,12
"13540","6207雷科","110/07/07","元大-林園",0,30,-30
"13541","6207雷科","110/07/07","兆豐-板橋",10,0,10
"13542","6207雷科","110/07/07","凱基-台北",0,19,-19
"13543","6207雷科","110/07/07","玉山-台大",10,0,10
"13544","6207雷科","110/07/07","國票-中和",13,25,-12
"13545","6207雷科","110/07/07","元大-四維",10,0,10
"13546","6207雷科","110/07/07","新加坡商瑞銀",0,9,-9
"13547","6207雷科","110/07/07","元大-鹿港",10,0,10
"13548","6207雷科","110/07/07","玉山-高雄",0,8,-8
"13549","6207雷科","110/07/07","元大-信義",10,0,10
"13550","6207雷科","110/07/07","玉山-台南",0,8,-8
"13551","6207雷科","110/07/07","台新-三民",8,0,8
"13552","6207雷科","110/07/07","宏遠-高雄",0,5,-5
"13553","6207雷科","110/07/07","元大-上新莊",8,0,8
"13554","6207雷科","110/07/07","元大-南海",0,5,-5
"13555","6207雷科","110/07/07","大昌-桃園",7,0,7
"13556","6207雷科","110/07/07","元大-莒光",0,4,-4
"13557","6207雷科","110/07/07","新光-台中",10,4,6
"13558","6207雷科","110/07/07","港商野村",0,3,-3
"13559","6207雷科","110/07/07","日盛-頭份",5,0,5
"13560","6207雷科","110/07/07","大慶-台南",0,3,-3
"13561","6207雷科","110/07/07","日茂-埔里",5,0,5
"13562","6207雷科","110/07/07","凱基-站前",0,3,-3
"13563","3679新至陞","110/07/07","永豐金證券",18,0,18
"13564","3679新至陞","110/07/07","美林",0,13,-13
"13565","3679新至陞","110/07/07","元大-文心興安",6,0,6
"13566","3679新至陞","110/07/07","兆豐-大安",0,10,-10
"13567","3679新至陞","110/07/07","中農",5,0,5
"13568","3679新至陞","110/07/07","國泰-桃園",0,4,-4
"13569","3679新至陞","110/07/07","台新證券",4,0,4
"13570","3679新至陞","110/07/07","永豐金-虎尾",0,4,-4
"13571","3679新至陞","110/07/07","華南永昌-小港",4,0,4
"13572","3679新至陞","110/07/07","台灣摩根士丹利",0,3,-3
"13573","3679新至陞","110/07/07","元大-天母",4,0,4
"13574","3679新至陞","110/07/07","瑞士信貸",0,3,-3
"13575","3679新至陞","110/07/07","台中銀-員林",4,1,3
"13576","3679新至陞","110/07/07","統一-新竹",0,3,-3
"13577","3679新至陞","110/07/07","摩根大通",4,1,3
"13578","3679新至陞","110/07/07","統一-三重",0,3,-3
"13579","3679新至陞","110/07/07","凱基-台北",7,4,3
"13580","3679新至陞","110/07/07","凱基-竹北",0,3,-3
"13581","3679新至陞","110/07/07","華南永昌-高雄",3,0,3
"13582","3679新至陞","110/07/07","元富-世貿",0,2,-2
"13583","3679新至陞","110/07/07","永豐金-潮州",2,0,2
"13584","3679新至陞","110/07/07","兆豐-鹿港",0,2,-2
"13585","3679新至陞","110/07/07","合庫-新竹",1,0,1
"13586","3679新至陞","110/07/07","玉山-台大",0,2,-2
"13587","3679新至陞","110/07/07","土銀-高雄",1,0,1
"13588","3679新至陞","110/07/07","國泰-館前",0,2,-2
"13589","3679新至陞","110/07/07","元富-新興",1,0,1
"13590","3679新至陞","110/07/07","群益金鼎-新莊",0,2,-2
"13591","3679新至陞","110/07/07","富邦-中壢",1,0,1
"13592","3679新至陞","110/07/07","元大-桃園",0,2,-2
"13593","2727王品","110/07/07","第一金",62,0,62
"13594","2727王品","110/07/07","台灣摩根士丹利",1,177,-176
"13595","2727王品","110/07/07","凱基-埔墘",40,0,40
"13596","2727王品","110/07/07","凱基-台北",49,151,-102
"13597","2727王品","110/07/07","中國信託-忠孝",40,1,39
"13598","2727王品","110/07/07","摩根大通",19,107,-88
"13599","2727王品","110/07/07","玉山-板橋",40,6,34
"13600","2727王品","110/07/07","美商高盛",2,86,-84
"13601","2727王品","110/07/07","亞東-新竹",31,1,30
"13602","2727王品","110/07/07","元大-北屯",1,52,-51
"13603","2727王品","110/07/07","群益金鼎-宜蘭",25,1,24
"13604","2727王品","110/07/07","國泰證券",1,47,-46
"13605","2727王品","110/07/07","富邦-竹北",23,0,23
"13606","2727王品","110/07/07","統一",3,33,-30
"13607","2727王品","110/07/07","元大-旗山",23,0,23
"13608","2727王品","110/07/07","第一金-台中",1,30,-29
"13609","2727王品","110/07/07","元富-宜蘭",21,0,21
"13610","2727王品","110/07/07","華南永昌-中正",4,29,-25
"13611","2727王品","110/07/07","國票-長城",20,0,20
"13612","2727王品","110/07/07","美林",0,23,-23
"13613","2727王品","110/07/07","台新證券",47,28,19
"13614","2727王品","110/07/07","群益金鼎-館前",0,20,-20
"13615","2727王品","110/07/07","富邦-新竹華信",18,1,17
"13616","2727王品","110/07/07","國票-內壢",0,16,-16
"13617","2727王品","110/07/07","永豐金-中正",18,1,17
"13618","2727王品","110/07/07","兆豐-新莊",0,15,-15
"13619","2727王品","110/07/07","華南永昌-麻豆",17,1,16
"13620","2727王品","110/07/07","港商野村",15,28,-13
"13621","2727王品","110/07/07","永豐金-潮州",15,0,15
"13622","2727王品","110/07/07","元大-善化",1,13,-12
"13623","1570力肯","110/07/07","台新證券",88,0,88
"13624","1570力肯","110/07/07","新光",0,54,-54
"13625","1570力肯","110/07/07","摩根大通",49,15,34
"13626","1570力肯","110/07/07","元大-高雄",0,40,-40
"13627","1570力肯","110/07/07","合庫-桃園",20,0,20
"13628","1570力肯","110/07/07","國票-北高雄",38,50,-12
"13629","1570力肯","110/07/07","元大-土城學府",20,0,20
"13630","1570力肯","110/07/07","群益金鼎-嘉義",0,10,-10
"13631","1570力肯","110/07/07","永豐金-板盛",18,0,18
"13632","1570力肯","110/07/07","元大-草屯",0,10,-10
"13633","1570力肯","110/07/07","永豐金-永康",18,0,18
"13634","1570力肯","110/07/07","日盛-高雄",0,9,-9
"13635","1570力肯","110/07/07","統一-員林",14,0,14
"13636","1570力肯","110/07/07","第一金-路竹",0,9,-9
"13637","1570力肯","110/07/07","元大-竹山",6,0,6
"13638","1570力肯","110/07/07","元大-古亭",0,9,-9
"13639","1570力肯","110/07/07","統一-敦南",5,0,5
"13640","1570力肯","110/07/07","國票-中正",0,8,-8
"13641","1570力肯","110/07/07","元大-永和",5,0,5
"13642","1570力肯","110/07/07","群益金鼎-鳳山",0,6,-6
"13643","1570力肯","110/07/07","元富-大裕",4,0,4
"13644","1570力肯","110/07/07","元大-土城永寧",0,6,-6
"13645","1570力肯","110/07/07","華南永昌-斗六",4,0,4
"13646","1570力肯","110/07/07","中國信託",0,5,-5
"13647","1570力肯","110/07/07","永豐金-松山",6,3,3
"13648","1570力肯","110/07/07","日盛-板橋",0,4,-4
"13649","1570力肯","110/07/07","永豐金-南投",4,1,3
"13650","1570力肯","110/07/07","日盛-木柵",0,4,-4
"13651","1570力肯","110/07/07","土銀-彰化",2,0,2
"13652","1570力肯","110/07/07","玉山-桃園",0,4,-4
"13653","6180橘子","110/07/07","臺銀-金山",27,0,27
"13654","6180橘子","110/07/07","凱基-台北",6,36,-30
"13655","6180橘子","110/07/07","元富-潮州",20,0,20
"13656","6180橘子","110/07/07","元大-天母",1,26,-25
"13657","6180橘子","110/07/07","凱基-中山",20,0,20
"13658","6180橘子","110/07/07","富邦-陽明",0,22,-22
"13659","6180橘子","110/07/07","元大-太平",23,4,19
"13660","6180橘子","110/07/07","日盛-頭份",0,20,-20
"13661","6180橘子","110/07/07","摩根大通",17,0,17
"13662","6180橘子","110/07/07","富邦-仁愛",0,20,-20
"13663","6180橘子","110/07/07","元大-草屯",20,3,17
"13664","6180橘子","110/07/07","永豐金-新莊",0,20,-20
"13665","6180橘子","110/07/07","華南永昌-楠梓",15,1,14
"13666","6180橘子","110/07/07","台灣摩根士丹利",0,18,-18
"13667","6180橘子","110/07/07","中國信託-永康",12,0,12
"13668","6180橘子","110/07/07","華南永昌-長虹",1,16,-15
"13669","6180橘子","110/07/07","日盛-文化",10,0,10
"13670","6180橘子","110/07/07","新光-新竹",0,12,-12
"13671","6180橘子","110/07/07","國泰-館前",10,0,10
"13672","6180橘子","110/07/07","凱基-中壢",0,12,-12
"13673","6180橘子","110/07/07","華南永昌-鶯歌",10,0,10
"13674","6180橘子","110/07/07","第一金-忠孝",0,11,-11
"13675","6180橘子","110/07/07","元大-豐原站前",10,0,10
"13676","6180橘子","110/07/07","元大-沙鹿",0,11,-11
"13677","6180橘子","110/07/07","元大-北屯",10,0,10
"13678","6180橘子","110/07/07","永豐金-羅東",0,11,-11
"13679","6180橘子","110/07/07","兆豐-台中",10,1,9
"13680","6180橘子","110/07/07","兆豐-埔墘",0,10,-10
"13681","6180橘子","110/07/07","群益金鼎-開元",9,0,9
"13682","6180橘子","110/07/07","華南永昌-台中",0,10,-10
"13683","2390云辰","110/07/07","元大-向上",144,0,144
"13684","2390云辰","110/07/07","摩根大通",18,674,-656
"13685","2390云辰","110/07/07","元富-中港",102,0,102
"13686","2390云辰","110/07/07","凱基-台北",141,625,-484
"13687","2390云辰","110/07/07","群益金鼎-民權",104,4,100
"13688","2390云辰","110/07/07","美林",32,261,-229
"13689","2390云辰","110/07/07","兆豐-忠孝",81,0,81
"13690","2390云辰","110/07/07","新加坡商瑞銀",50,149,-99
"13691","2390云辰","110/07/07","合庫-新竹",60,0,60
"13692","2390云辰","110/07/07","台灣摩根士丹利",7,87,-80
"13693","2390云辰","110/07/07","元大-土城學府",59,1,58
"13694","2390云辰","110/07/07","元大-金華",2,68,-66
"13695","2390云辰","110/07/07","玉山-大里",58,3,55
"13696","2390云辰","110/07/07","國票-新莊",13,65,-52
"13697","2390云辰","110/07/07","元大-東蘆",54,1,53
"13698","2390云辰","110/07/07","凱基-三重",12,56,-44
"13699","2390云辰","110/07/07","元富-三重",51,0,51
"13700","2390云辰","110/07/07","新光-台中",23,65,-42
"13701","2390云辰","110/07/07","元富-埔里",50,0,50
"13702","2390云辰","110/07/07","第一金-中壢",5,45,-40
"13703","2390云辰","110/07/07","中國信託-三重",52,3,49
"13704","2390云辰","110/07/07","華南永昌-斗六",0,40,-40
"13705","2390云辰","110/07/07","元大-彰化民生",64,15,49
"13706","2390云辰","110/07/07","富邦-新竹華信",25,61,-36
"13707","2390云辰","110/07/07","元大-潮州",50,5,45
"13708","2390云辰","110/07/07","玉山-新莊",2,32,-30
"13709","2390云辰","110/07/07","元富-高雄",57,14,43
"13710","2390云辰","110/07/07","凱基-新豐",17,47,-30
"13711","2390云辰","110/07/07","凱基-和平",40,0,40
"13712","2390云辰","110/07/07","統一-汐止",1,29,-28
"13713","4903聯光通","110/07/06","元大-苗栗",10,0,10
"13714","4903聯光通","110/07/06","宏遠證券",0,13,-13
"13715","4903聯光通","110/07/06","彰銀",5,0,5
"13716","4903聯光通","110/07/06","富邦-新營",0,4,-4
"13717","4903聯光通","110/07/06","元大-松山",5,0,5
"13718","4903聯光通","110/07/06","元富-草屯",0,3,-3
"13719","4903聯光通","110/07/06","新光",3,0,3
"13720","4903聯光通","110/07/06","元大-羅東",0,3,-3
"13721","4903聯光通","110/07/06","群益金鼎-館前",1,0,1
"13722","4903聯光通","110/07/06","元大-北三重",0,2,-2
"13723","4903聯光通","110/07/06","華南永昌-鶯歌",1,0,1
"13724","4903聯光通","110/07/06","國泰-敦南",0,1,-1
"13725","4903聯光通","110/07/06","永豐金-市政",1,0,1
"13726","4903聯光通","110/07/06","元富-板橋",0,0,0
"13727","4903聯光通","110/07/06","元富-板橋",0,0,0
"13728","4903聯光通","110/07/06","華南永昌",0,0,0
"13729","4903聯光通","110/07/06","華南永昌",0,0,0
"13730","4903聯光通","110/07/06","元大-太平",2,2,0
"13731","4903聯光通","110/07/06","元大-太平",2,2,0
"13732","2929淘帝","110/07/06","新光",204,85,119
"13733","2929淘帝","110/07/06","港商野村",62,282,-220
"13734","2929淘帝","110/07/06","日盛-中壢",94,0,94
"13735","2929淘帝","110/07/06","摩根大通",64,264,-200
"13736","2929淘帝","110/07/06","元富-城東",84,0,84
"13737","2929淘帝","110/07/06","統一",0,163,-163
"13738","2929淘帝","110/07/06","日盛-雙和",55,0,55
"13739","2929淘帝","110/07/06","香港上海匯豐",0,141,-141
"13740","2929淘帝","110/07/06","第一金-路竹",71,17,54
"13741","2929淘帝","110/07/06","新加坡商瑞銀",54,179,-125
"13742","2929淘帝","110/07/06","元大-花蓮",44,2,42
"13743","2929淘帝","110/07/06","合庫-高雄",3,122,-119
"13744","2929淘帝","110/07/06","永豐金-大園",73,33,40
"13745","2929淘帝","110/07/06","美林",34,118,-84
"13746","2929淘帝","110/07/06","元大-太平",44,6,38
"13747","2929淘帝","110/07/06","元大-員林",2,82,-80
"13748","2929淘帝","110/07/06","國泰-板橋",40,5,35
"13749","2929淘帝","110/07/06","元富-松德",26,75,-49
"13750","2929淘帝","110/07/06","兆豐-內湖",33,1,32
"13751","2929淘帝","110/07/06","臺銀-臺南",9,52,-43
"13752","2929淘帝","110/07/06","元大-博愛",43,11,32
"13753","2929淘帝","110/07/06","元大-北投",5,48,-43
"13754","2929淘帝","110/07/06","日盛-竹北",40,10,30
"13755","2929淘帝","110/07/06","臺銀-民權",1,41,-40
"13756","2929淘帝","110/07/06","元大-善化",52,22,30
"13757","2929淘帝","110/07/06","兆豐-忠孝",1,41,-40
"13758","2929淘帝","110/07/06","富邦-北港",29,0,29
"13759","2929淘帝","110/07/06","元大-西門",1,36,-35
"13760","2929淘帝","110/07/06","凱基-湖口",27,0,27
"13761","2929淘帝","110/07/06","玉山-嘉義",3,35,-32
"13762","5410國眾","110/07/06","兆豐-城中",28,0,28
"13763","5410國眾","110/07/06","凱基-高美館",1,18,-17
"13764","5410國眾","110/07/06","元大-小港",20,0,20
"13765","5410國眾","110/07/06","國泰-館前",0,15,-15
"13766","5410國眾","110/07/06","元大-新盛",18,0,18
"13767","5410國眾","110/07/06","國泰-板橋",2,17,-15
"13768","5410國眾","110/07/06","香港上海匯豐",15,0,15
"13769","5410國眾","110/07/06","新光",0,13,-13
"13770","5410國眾","110/07/06","華南永昌-小港",15,0,15
"13771","5410國眾","110/07/06","元富-緯城",0,10,-10
"13772","5410國眾","110/07/06","元富-大昌",13,0,13
"13773","5410國眾","110/07/06","中農",0,10,-10
"13774","5410國眾","110/07/06","臺銀-臺南",10,0,10
"13775","5410國眾","110/07/06","凱基-屏東",0,10,-10
"13776","5410國眾","110/07/06","元富-延平",8,0,8
"13777","5410國眾","110/07/06","新光-桃園",0,6,-6
"13778","5410國眾","110/07/06","元大-八德",17,9,8
"13779","5410國眾","110/07/06","高橋-龍潭",0,5,-5
"13780","5410國眾","110/07/06","摩根大通",7,0,7
"13781","5410國眾","110/07/06","元富-世貿",0,5,-5
"13782","5410國眾","110/07/06","凱基-桃園",7,0,7
"13783","5410國眾","110/07/06","群益金鼎-瑞豐",0,5,-5
"13784","5410國眾","110/07/06","永豐金-屏東",7,0,7
"13785","5410國眾","110/07/06","富邦-台中",0,5,-5
"13786","5410國眾","110/07/06","台新-左楠",5,0,5
"13787","5410國眾","110/07/06","永豐金-板橋",0,5,-5
"13788","5410國眾","110/07/06","富邦-竹東",5,0,5
"13789","5410國眾","110/07/06","富邦-台南",0,4,-4
"13790","5410國眾","110/07/06","元大-新莊",5,0,5
"13791","5410國眾","110/07/06","凱基-站前",0,3,-3
"13792","2841台開","110/07/06","群益金鼎-忠孝",100,0,100
"13793","2841台開","110/07/06","港商野村",0,295,-295
"13794","2841台開","110/07/06","台新證券",58,0,58
"13795","2841台開","110/07/06","元大-善化",0,50,-50
"13796","2841台開","110/07/06","台新-台中",58,0,58
"13797","2841台開","110/07/06","元大-四維",0,50,-50
"13798","2841台開","110/07/06","永豐金-敦南",50,0,50
"13799","2841台開","110/07/06","台新-新營",0,30,-30
"13800","2841台開","110/07/06","元大-台中",45,0,45
"13801","2841台開","110/07/06","群益金鼎-桃園",0,21,-21
"13802","2841台開","110/07/06","凱基-文心",43,0,43
"13803","2841台開","110/07/06","台中銀-員林",0,20,-20
"13804","2841台開","110/07/06","永豐金-潮州",30,0,30
"13805","2841台開","110/07/06","群益金鼎-延平",0,15,-15
"13806","2841台開","110/07/06","第一金-自由",25,0,25
"13807","2841台開","110/07/06","元大-三重",0,13,-13
"13808","2841台開","110/07/06","美商高盛",17,0,17
"13809","2841台開","110/07/06","元富-古亭",0,10,-10
"13810","2841台開","110/07/06","大昌-安康",39,22,17
"13811","2841台開","110/07/06","群益金鼎-北高雄",0,10,-10
"13812","2841台開","110/07/06","台中銀",15,0,15
"13813","2841台開","110/07/06","華南永昌-南京",0,10,-10
"13814","2841台開","110/07/06","玉山-嘉義",15,0,15
"13815","2841台開","110/07/06","富邦-花蓮",0,10,-10
"13816","2841台開","110/07/06","新光",11,0,11
"13817","2841台開","110/07/06","富邦-高雄",0,10,-10
"13818","2841台開","110/07/06","兆豐-永和",10,0,10
"13819","2841台開","110/07/06","元大-竹山",0,10,-10
"13820","2841台開","110/07/06","康和-內湖",10,0,10
"13821","2841台開","110/07/06","元大-屏東",0,10,-10
"13822","6207雷科","110/07/06","新光",45,4,41
"13823","6207雷科","110/07/06","凱基-高美館",1,104,-103
"13824","6207雷科","110/07/06","統一-基隆",30,0,30
"13825","6207雷科","110/07/06","摩根大通",11,45,-34
"13826","6207雷科","110/07/06","康和-南崁",13,0,13
"13827","6207雷科","110/07/06","群益金鼎-新竹",0,22,-22
"13828","6207雷科","110/07/06","宏遠-台南",10,0,10
"13829","6207雷科","110/07/06","港商野村",2,23,-21
"13830","6207雷科","110/07/06","國票-和平",10,0,10
"13831","6207雷科","110/07/06","凱基-台北",0,14,-14
"13832","6207雷科","110/07/06","永豐金-天母",10,0,10
"13833","6207雷科","110/07/06","台新-三民",0,12,-12
"13834","6207雷科","110/07/06","台新證券",10,1,9
"13835","6207雷科","110/07/06","群益金鼎-開元",1,11,-10
"13836","6207雷科","110/07/06","群益金鼎-士林",8,0,8
"13837","6207雷科","110/07/06","富邦-南屯",0,8,-8
"13838","6207雷科","110/07/06","群益金鼎-瑞豐",7,0,7
"13839","6207雷科","110/07/06","元大-善化",0,8,-8
"13840","6207雷科","110/07/06","元大-四維",7,0,7
"13841","6207雷科","110/07/06","日盛-頭份",0,5,-5
"13842","6207雷科","110/07/06","國票-中和",6,0,6
"13843","6207雷科","110/07/06","第一金-高雄",0,5,-5
"13844","6207雷科","110/07/06","台新-中壢",6,0,6
"13845","6207雷科","110/07/06","凱基-八德",0,5,-5
"13846","6207雷科","110/07/06","凱基-高雄",6,0,6
"13847","6207雷科","110/07/06","凱基-頭份",0,5,-5
"13848","6207雷科","110/07/06","富邦-彰化",6,0,6
"13849","6207雷科","110/07/06","合庫-新竹",0,4,-4
"13850","6207雷科","110/07/06","凱基-大安",5,0,5
"13851","6207雷科","110/07/06","新光-高雄",0,4,-4
"13852","3679新至陞","110/07/06","凱基",11,0,11
"13853","3679新至陞","110/07/06","摩根大通",0,22,-22
"13854","3679新至陞","110/07/06","台中銀-員林",11,1,10
"13855","3679新至陞","110/07/06","凱基-台北",6,21,-15
"13856","3679新至陞","110/07/06","安泰-大發",10,0,10
"13857","3679新至陞","110/07/06","瑞士信貸",0,13,-13
"13858","3679新至陞","110/07/06","香港上海匯豐",8,0,8
"13859","3679新至陞","110/07/06","富邦-苗栗",0,10,-10
"13860","3679新至陞","110/07/06","永豐金證券",8,2,6
"13861","3679新至陞","110/07/06","元大-永春",0,6,-6
"13862","3679新至陞","110/07/06","第一金-高雄",5,0,5
"13863","3679新至陞","110/07/06","凱基-興隆",0,5,-5
"13864","3679新至陞","110/07/06","群益金鼎-高盛",3,0,3
"13865","3679新至陞","110/07/06","國泰-桃園",0,3,-3
"13866","3679新至陞","110/07/06","元大-嘉義",3,0,3
"13867","3679新至陞","110/07/06","元大-萬華",2,5,-3
"13868","3679新至陞","110/07/06","臺銀-高雄",2,0,2
"13869","3679新至陞","110/07/06","美林",0,2,-2
"13870","3679新至陞","110/07/06","日盛-復興",2,0,2
"13871","3679新至陞","110/07/06","第一金-華江",0,2,-2
"13872","3679新至陞","110/07/06","日盛-樹林",4,2,2
"13873","3679新至陞","110/07/06","新光-台中",0,2,-2
"13874","3679新至陞","110/07/06","宏遠-館前",2,0,2
"13875","3679新至陞","110/07/06","華南永昌-民權",0,2,-2
"13876","3679新至陞","110/07/06","台新證券",2,0,2
"13877","3679新至陞","110/07/06","元大-板橋",0,2,-2
"13878","3679新至陞","110/07/06","康和-板橋",2,0,2
"13879","3679新至陞","110/07/06","日盛-板橋中山",0,1,-1
"13880","3679新至陞","110/07/06","群益金鼎-台南",2,0,2
"13881","3679新至陞","110/07/06","宏遠證券",0,1,-1
"13882","2727王品","110/07/06","元大證券",1033,729,304
"13883","2727王品","110/07/06","台灣摩根士丹利",35,184,-149
"13884","2727王品","110/07/06","富邦-台北",332,46,286
"13885","2727王品","110/07/06","元大-北屯",11,79,-68
"13886","2727王品","110/07/06","統一",252,43,209
"13887","2727王品","110/07/06","元富-敦南",4,70,-66
"13888","2727王品","110/07/06","永豐金-松山",147,14,133
"13889","2727王品","110/07/06","元大-基隆孝二",11,75,-64
"13890","2727王品","110/07/06","富邦-嘉義",301,198,103
"13891","2727王品","110/07/06","臺銀-臺南",9,69,-60
"13892","2727王品","110/07/06","新加坡商瑞銀",128,34,94
"13893","2727王品","110/07/06","中國信託-忠孝",5,48,-43
"13894","2727王品","110/07/06","元富-台南",97,6,91
"13895","2727王品","110/07/06","永豐金-市政",5,46,-41
"13896","2727王品","110/07/06","台新證券",169,105,64
"13897","2727王品","110/07/06","彰銀-台中",19,56,-37
"13898","2727王品","110/07/06","美林",115,58,57
"13899","2727王品","110/07/06","玉山證券",30,67,-37
"13900","2727王品","110/07/06","華南永昌",75,23,52
"13901","2727王品","110/07/06","凱基-埔墘",4,41,-37
"13902","2727王品","110/07/06","凱基-台北",445,398,47
"13903","2727王品","110/07/06","永豐金-大園",3,40,-37
"13904","2727王品","110/07/06","凱基-大直",48,7,41
"13905","2727王品","110/07/06","元富",2,37,-35
"13906","2727王品","110/07/06","凱基-林口",45,4,41
"13907","2727王品","110/07/06","富邦-仁愛",32,64,-32
"13908","2727王品","110/07/06","德信",40,1,39
"13909","2727王品","110/07/06","玉山-板橋",52,82,-30
"13910","2727王品","110/07/06","第一金",42,5,37
"13911","2727王品","110/07/06","中國信託-文心",10,39,-29
"13912","1570力肯","110/07/06","香港上海匯豐",47,0,47
"13913","1570力肯","110/07/06","新光",2,107,-105
"13914","1570力肯","110/07/06","元大-高雄",55,16,39
"13915","1570力肯","110/07/06","摩根大通",11,58,-47
"13916","1570力肯","110/07/06","元富-緯城",37,0,37
"13917","1570力肯","110/07/06","高橋",4,50,-46
"13918","1570力肯","110/07/06","台新-台南",16,0,16
"13919","1570力肯","110/07/06","合庫-桃園",0,20,-20
"13920","1570力肯","110/07/06","元大-新竹經國",14,0,14
"13921","1570力肯","110/07/06","永豐金-板盛",0,18,-18
"13922","1570力肯","110/07/06","富邦-左營",12,0,12
"13923","1570力肯","110/07/06","華南永昌-公誠",0,9,-9
"13924","1570力肯","110/07/06","國票-中正",12,2,10
"13925","1570力肯","110/07/06","凱基-台北",1,9,-8
"13926","1570力肯","110/07/06","國票-博愛",10,0,10
"13927","1570力肯","110/07/06","臺銀-臺中",0,6,-6
"13928","1570力肯","110/07/06","統一-敦南",12,5,7
"13929","1570力肯","110/07/06","台新-三民",0,5,-5
"13930","1570力肯","110/07/06","群益金鼎-三重",7,0,7
"13931","1570力肯","110/07/06","華南永昌-麻豆",0,5,-5
"13932","1570力肯","110/07/06","臺銀-臺南",6,0,6
"13933","1570力肯","110/07/06","合庫-台南",0,4,-4
"13934","1570力肯","110/07/06","大慶-蘆洲",6,0,6
"13935","1570力肯","110/07/06","統一-員林",0,4,-4
"13936","1570力肯","110/07/06","元富-新店",6,0,6
"13937","1570力肯","110/07/06","康和-澎湖",0,4,-4
"13938","1570力肯","110/07/06","玉山-雙和",7,1,6
"13939","1570力肯","110/07/06","華南永昌-斗六",0,4,-4
"13940","1570力肯","110/07/06","永豐金-敦南",9,3,6
"13941","1570力肯","110/07/06","元大-和平",0,4,-4
"13942","6180橘子","110/07/06","凱基-台北",72,12,60
"13943","6180橘子","110/07/06","臺銀-金山",5,105,-100
"13944","6180橘子","110/07/06","美林",29,0,29
"13945","6180橘子","110/07/06","元大-台中",0,100,-100
"13946","6180橘子","110/07/06","合庫-自強",21,0,21
"13947","6180橘子","110/07/06","康和-台南",3,50,-47
"13948","6180橘子","110/07/06","凱基-三峽",17,0,17
"13949","6180橘子","110/07/06","元大-中和",0,35,-35
"13950","6180橘子","110/07/06","富邦-虎尾",15,1,14
"13951","6180橘子","110/07/06","中國信託-忠孝",0,16,-16
"13952","6180橘子","110/07/06","元富-潮州",13,0,13
"13953","6180橘子","110/07/06","玉山-高雄",0,12,-12
"13954","6180橘子","110/07/06","中國信託-永康",13,0,13
"13955","6180橘子","110/07/06","港商野村",0,11,-11
"13956","6180橘子","110/07/06","元大-草屯",18,5,13
"13957","6180橘子","110/07/06","群益金鼎-松山",0,11,-11
"13958","6180橘子","110/07/06","臺銀",11,0,11
"13959","6180橘子","110/07/06","永豐金-豐原",0,11,-11
"13960","6180橘子","110/07/06","新光",15,4,11
"13961","6180橘子","110/07/06","元富-嘉義",5,15,-10
"13962","6180橘子","110/07/06","元大-竹東",11,0,11
"13963","6180橘子","110/07/06","玉山-士林",0,10,-10
"13964","6180橘子","110/07/06","宏遠-台中",10,0,10
"13965","6180橘子","110/07/06","凱基-北門",0,10,-10
"13966","6180橘子","110/07/06","第一金-台南",10,0,10
"13967","6180橘子","110/07/06","第一金-忠孝",0,9,-9
"13968","6180橘子","110/07/06","國泰-敦南",10,0,10
"13969","6180橘子","110/07/06","統一-基隆",0,9,-9
"13970","6180橘子","110/07/06","富邦-嘉義",10,0,10
"13971","6180橘子","110/07/06","安泰-大發",1,10,-9
"13972","2390云辰","110/07/06","元大-天母",975,276,699
"13973","2390云辰","110/07/06","台灣摩根士丹利",3,265,-262
"13974","2390云辰","110/07/06","摩根大通",688,312,376
"13975","2390云辰","110/07/06","群益金鼎-海山",3,166,-163
"13976","2390云辰","110/07/06","國泰-忠孝",164,3,161
"13977","2390云辰","110/07/06","國泰-敦南",188,339,-151
"13978","2390云辰","110/07/06","富邦-北港",140,7,133
"13979","2390云辰","110/07/06","元大-土城學府",12,119,-107
"13980","2390云辰","110/07/06","聯邦商銀",151,22,129
"13981","2390云辰","110/07/06","永豐金-高雄",4,103,-99
"13982","2390云辰","110/07/06","中國信託-文心",143,17,126
"13983","2390云辰","110/07/06","土銀-士林",0,94,-94
"13984","2390云辰","110/07/06","永豐金-中正",133,7,126
"13985","2390云辰","110/07/06","元大-佳里",11,91,-80
"13986","2390云辰","110/07/06","群益金鼎-大興",178,76,102
"13987","2390云辰","110/07/06","玉山-台中",10,86,-76
"13988","2390云辰","110/07/06","元富-中港",103,3,100
"13989","2390云辰","110/07/06","新光",251,324,-73
"13990","2390云辰","110/07/06","統一-新台中",104,12,92
"13991","2390云辰","110/07/06","富邦-敦南",29,101,-72
"13992","2390云辰","110/07/06","新加坡商瑞銀",211,120,91
"13993","2390云辰","110/07/06","兆豐-台中",0,58,-58
"13994","2390云辰","110/07/06","兆豐-忠孝",100,11,89
"13995","2390云辰","110/07/06","日盛證券",16,73,-57
"13996","2390云辰","110/07/06","凱基-林口",87,9,78
"13997","2390云辰","110/07/06","元大-東泰",5,61,-56
"13998","2390云辰","110/07/06","元富-西松",72,4,68
"13999","2390云辰","110/07/06","台新證券",136,190,-54
"14000","2390云辰","110/07/06","台新-左楠",66,9,57
"14001","2390云辰","110/07/06","元大-六合",10,63,-53
