"","stake","date","name","buy","sell","total"
"1","2834臺企銀","110/09/06","凱基-台北",22144,15172,6972
"2","2834臺企銀","110/09/06","港商法國興業",0,4885,-4885
"3","2834臺企銀","110/09/06","美商高盛",2346,481,1865
"4","2834臺企銀","110/09/06","永豐金-中和",20,2832,-2812
"5","2834臺企銀","110/09/06","摩根大通",2015,398,1617
"6","2834臺企銀","110/09/06","新加坡商瑞銀",738,2933,-2195
"7","2834臺企銀","110/09/06","富邦-南屯",1605,465,1140
"8","2834臺企銀","110/09/06","國票-長城",50,2000,-1950
"9","2834臺企銀","110/09/06","新光",1309,213,1096
"10","2834臺企銀","110/09/06","台灣摩根士丹利",208,1932,-1724
"11","2834臺企銀","110/09/06","富邦-建國",1122,126,996
"12","2834臺企銀","110/09/06","瑞士信貸",439,1649,-1210
"13","2834臺企銀","110/09/06","美林",1410,419,991
"14","2834臺企銀","110/09/06","凱基-板橋",13,1016,-1003
"15","2834臺企銀","110/09/06","日盛-二林",674,40,634
"16","2834臺企銀","110/09/06","兆豐-天母",0,1000,-1000
"17","2834臺企銀","110/09/06","元大-高雄",658,40,618
"18","2834臺企銀","110/09/06","日盛證券",39,932,-893
"19","2834臺企銀","110/09/06","元大-竹南",602,10,592
"20","2834臺企銀","110/09/06","富邦-新竹",54,856,-802
"21","2834臺企銀","110/09/06","富邦-陽明",532,5,527
"22","2834臺企銀","110/09/06","玉山-嘉義",123,882,-759
"23","2834臺企銀","110/09/06","(牛牛牛)亞-鑫豐",807,297,510
"24","2834臺企銀","110/09/06","富邦-板橋",117,736,-619
"25","2834臺企銀","110/09/06","統一-三重",503,21,482
"26","2834臺企銀","110/09/06","永豐金-敦北",56,611,-555
"27","2834臺企銀","110/09/06","永豐金-彰化",414,5,409
"28","2834臺企銀","110/09/06","台新-中壢",33,569,-536
"29","2834臺企銀","110/09/06","凱基-林口",412,4,408
"30","2834臺企銀","110/09/06","元大-中壢",96,612,-516
"31","5511德昌","110/09/06","統一-士林",26,0,26
"32","5511德昌","110/09/06","寶盛",0,19,-19
"33","5511德昌","110/09/06","國票-九鼎",20,0,20
"34","5511德昌","110/09/06","日盛-南京",0,5,-5
"35","5511德昌","110/09/06","台中銀-豐原",8,0,8
"36","5511德昌","110/09/06","統一-新竹",0,5,-5
"37","5511德昌","110/09/06","元富-安南",5,0,5
"38","5511德昌","110/09/06","兆豐-公益",0,5,-5
"39","5511德昌","110/09/06","元富-文心",1,0,1
"40","5511德昌","110/09/06","康和-內湖",0,4,-4
"41","5511德昌","110/09/06","凱基-台北",1,0,1
"42","5511德昌","110/09/06","永豐金-天母",0,3,-3
"43","5511德昌","110/09/06","富邦-台北",1,0,1
"44","5511德昌","110/09/06","富邦-仁愛",0,3,-3
"45","5511德昌","110/09/06","彰銀-台中",0,0,0
"46","5511德昌","110/09/06","致和-崇德",0,3,-3
"47","5511德昌","110/09/06","康和-板橋",0,0,0
"48","5511德昌","110/09/06","永豐金-新店",0,2,-2
"49","5511德昌","110/09/06","國泰-台中",1,1,0
"50","5511德昌","110/09/06","(牛牛牛)亞-鑫豐",0,2,-2
"51","5511德昌","110/09/06","群益金鼎-台中",0,0,0
"52","5511德昌","110/09/06","日盛-復興",0,2,-2
"53","5511德昌","110/09/06","群益金鼎-鳳山",0,0,0
"54","5511德昌","110/09/06","日盛-斗六",0,2,-2
"55","5511德昌","110/09/06","華南永昌-大安",0,0,0
"56","5511德昌","110/09/06","元富-虎尾",0,1,-1
"57","5511德昌","110/09/06","永豐金-萬盛",0,0,0
"58","5511德昌","110/09/06","臺銀-臺中",0,1,-1
"59","5511德昌","110/09/06","",NA,NA,NA
"60","5511德昌","110/09/06","土銀-台中",0,1,-1
"61","2489瑞軒","110/09/06","台灣企銀-屏東",110,0,110
"62","2489瑞軒","110/09/06","摩根大通",82,437,-355
"63","2489瑞軒","110/09/06","元富-文心",106,0,106
"64","2489瑞軒","110/09/06","元大-士林",0,150,-150
"65","2489瑞軒","110/09/06","康和-台中",102,3,99
"66","2489瑞軒","110/09/06","瑞士信貸",81,227,-146
"67","2489瑞軒","110/09/06","元大-清水",91,0,91
"68","2489瑞軒","110/09/06","台灣摩根士丹利",18,158,-140
"69","2489瑞軒","110/09/06","凱基-桃園",84,0,84
"70","2489瑞軒","110/09/06","凱基-台北",79,213,-134
"71","2489瑞軒","110/09/06","華南永昌-虎尾",123,40,83
"72","2489瑞軒","110/09/06","元大-豐原",1,134,-133
"73","2489瑞軒","110/09/06","元大-淡水",76,0,76
"74","2489瑞軒","110/09/06","群益金鼎-大安",0,130,-130
"75","2489瑞軒","110/09/06","合庫-桃園",50,2,48
"76","2489瑞軒","110/09/06","美商高盛",53,154,-101
"77","2489瑞軒","110/09/06","新光",51,8,43
"78","2489瑞軒","110/09/06","富邦-新竹",3,102,-99
"79","2489瑞軒","110/09/06","永豐金-大園",41,0,41
"80","2489瑞軒","110/09/06","元大-歸仁",2,100,-98
"81","2489瑞軒","110/09/06","中國信託-新竹",50,13,37
"82","2489瑞軒","110/09/06","兆豐-公益",3,89,-86
"83","2489瑞軒","110/09/06","大昌-桃園",40,3,37
"84","2489瑞軒","110/09/06","華南永昌-忠孝",0,60,-60
"85","2489瑞軒","110/09/06","凱基-長庚",37,0,37
"86","2489瑞軒","110/09/06","元大-南屯",0,60,-60
"87","2489瑞軒","110/09/06","合庫-台南",35,0,35
"88","2489瑞軒","110/09/06","元大-彰化",1,60,-59
"89","2489瑞軒","110/09/06","元大-大天母",35,0,35
"90","2489瑞軒","110/09/06","港商野村",95,147,-52
"91","2428興勤","110/09/06","統一-桃園",68,0,68
"92","2428興勤","110/09/06","美商高盛",4,36,-32
"93","2428興勤","110/09/06","日盛-新竹",13,2,11
"94","2428興勤","110/09/06","美林",1,27,-26
"95","2428興勤","110/09/06","新加坡商瑞銀",18,8,10
"96","2428興勤","110/09/06","富邦-台北",0,24,-24
"97","2428興勤","110/09/06","元富-新竹",6,0,6
"98","2428興勤","110/09/06","統一",0,21,-21
"99","2428興勤","110/09/06","凱基-三重",7,1,6
"100","2428興勤","110/09/06","富邦-敦南",0,20,-20
"101","2428興勤","110/09/06","臺銀",5,0,5
"102","2428興勤","110/09/06","摩根大通",10,28,-18
"103","2428興勤","110/09/06","兆豐-公益",6,1,5
"104","2428興勤","110/09/06","凱基-台北",1,18,-17
"105","2428興勤","110/09/06","元大-金華",5,0,5
"106","2428興勤","110/09/06","瑞士信貸",2,15,-13
"107","2428興勤","110/09/06","日盛-景美",4,0,4
"108","2428興勤","110/09/06","永豐金-南投",0,6,-6
"109","2428興勤","110/09/06","兆豐-大安",4,0,4
"110","2428興勤","110/09/06","日盛證券",0,4,-4
"111","2428興勤","110/09/06","日盛-樹林",3,0,3
"112","2428興勤","110/09/06","國泰證券",0,4,-4
"113","2428興勤","110/09/06","(牛牛牛)亞-鑫豐",4,1,3
"114","2428興勤","110/09/06","凱基-民權",0,4,-4
"115","2428興勤","110/09/06","凱基-復興",3,0,3
"116","2428興勤","110/09/06","元大-左營",0,3,-3
"117","2428興勤","110/09/06","華南永昌-古亭",3,0,3
"118","2428興勤","110/09/06","永豐金-敦南",0,3,-3
"119","2428興勤","110/09/06","元大-東泰",3,0,3
"120","2428興勤","110/09/06","港商野村",11,13,-2
"121","3176基亞","110/09/06","元大-土城永寧",34,0,34
"122","3176基亞","110/09/06","臺銀",0,27,-27
"123","3176基亞","110/09/06","元大-新竹經國",16,0,16
"124","3176基亞","110/09/06","台中銀",0,20,-20
"125","3176基亞","110/09/06","元大-小港",15,0,15
"126","3176基亞","110/09/06","群益金鼎-板橋",0,17,-17
"127","3176基亞","110/09/06","群益金鼎-中壢",15,1,14
"128","3176基亞","110/09/06","元大-汐止",0,16,-16
"129","3176基亞","110/09/06","日盛-文化",10,0,10
"130","3176基亞","110/09/06","第一金-路竹",0,13,-13
"131","3176基亞","110/09/06","大慶-富順",10,0,10
"132","3176基亞","110/09/06","永豐金證券",3,15,-12
"133","3176基亞","110/09/06","凱基-文心",10,0,10
"134","3176基亞","110/09/06","華南永昌-民權",0,11,-11
"135","3176基亞","110/09/06","永豐金-北高雄",10,0,10
"136","3176基亞","110/09/06","宏遠-館前",0,10,-10
"137","3176基亞","110/09/06","兆豐-忠孝",10,1,9
"138","3176基亞","110/09/06","國票-台中",0,8,-8
"139","3176基亞","110/09/06","玉山證券",7,0,7
"140","3176基亞","110/09/06","元大-樹林",0,8,-8
"141","3176基亞","110/09/06","國泰-板橋",7,0,7
"142","3176基亞","110/09/06","日盛-樹林",0,6,-6
"143","3176基亞","110/09/06","日盛-台南",6,1,5
"144","3176基亞","110/09/06","玉山-士林",1,7,-6
"145","3176基亞","110/09/06","元富-高雄",5,0,5
"146","3176基亞","110/09/06","第一金-高雄",0,5,-5
"147","3176基亞","110/09/06","元富-緯城",5,0,5
"148","3176基亞","110/09/06","國泰-敦南",1,6,-5
"149","3176基亞","110/09/06","華南永昌",5,0,5
"150","3176基亞","110/09/06","元大-永春",0,5,-5
"151","2409友達","110/09/06","瑞士信貸",22305,4023,18282
"152","2409友達","110/09/06","台灣摩根士丹利",4953,28009,-23056
"153","2409友達","110/09/06","永豐金證券",11529,746,10783
"154","2409友達","110/09/06","凱基-苗栗",64,5070,-5006
"155","2409友達","110/09/06","美商高盛",11094,2003,9091
"156","2409友達","110/09/06","香港上海匯豐",93,4000,-3907
"157","2409友達","110/09/06","摩根大通",11082,2196,8886
"158","2409友達","110/09/06","花旗環球",1520,4800,-3280
"159","2409友達","110/09/06","港商野村",11674,3314,8360
"160","2409友達","110/09/06","元大-六合",222,3118,-2896
"161","2409友達","110/09/06","美林",8993,3556,5437
"162","2409友達","110/09/06","玉山-台中",154,1649,-1495
"163","2409友達","110/09/06","新加坡商瑞銀",6748,2579,4169
"164","2409友達","110/09/06","中國信託-嘉義",751,2006,-1255
"165","2409友達","110/09/06","凱基-台北",7933,3867,4066
"166","2409友達","110/09/06","宏遠證券",46,1269,-1223
"167","2409友達","110/09/06","日盛證券",2936,262,2674
"168","2409友達","110/09/06","國泰-敦南",891,2106,-1215
"169","2409友達","110/09/06","合庫證券",1221,113,1108
"170","2409友達","110/09/06","台灣企銀-台南",104,1212,-1108
"171","2409友達","110/09/06","華南永昌-忠孝",503,3,500
"172","2409友達","110/09/06","元大證券",2581,3599,-1018
"173","2409友達","110/09/06","(牛牛牛)亞-鑫豐",687,198,489
"174","2409友達","110/09/06","光和-溪湖",110,1080,-970
"175","2409友達","110/09/06","永豐金-內湖",484,45,439
"176","2409友達","110/09/06","元富",215,1130,-915
"177","2409友達","110/09/06","元大-開元",497,101,396
"178","2409友達","110/09/06","凱基-中山",654,1540,-886
"179","2409友達","110/09/06","富邦-台北",522,188,334
"180","2409友達","110/09/06","第一金-桃園",102,826,-724
"181","1315達新","110/09/06","元大-文心興安",13,0,13
"182","1315達新","110/09/06","美林",0,14,-14
"183","1315達新","110/09/06","凱基-中港",10,0,10
"184","1315達新","110/09/06","永豐金-高雄",0,14,-14
"185","1315達新","110/09/06","日盛-大墩",4,0,4
"186","1315達新","110/09/06","日盛-頭份",0,5,-5
"187","1315達新","110/09/06","富邦-員林",3,0,3
"188","1315達新","110/09/06","台新證券",1,5,-4
"189","1315達新","110/09/06","台灣摩根士丹利",2,0,2
"190","1315達新","110/09/06","元富-新竹",0,2,-2
"191","1315達新","110/09/06","統一-彰化",2,0,2
"192","1315達新","110/09/06","富邦-三重",0,2,-2
"193","1315達新","110/09/06","摩根大通",2,0,2
"194","1315達新","110/09/06","光和-溪湖",0,1,-1
"195","1315達新","110/09/06","陽信-石牌",1,0,1
"196","1315達新","110/09/06","群益金鼎-古亭",1,2,-1
"197","1315達新","110/09/06","永豐金-古亭",1,0,1
"198","1315達新","110/09/06","群益金鼎-建成",0,1,-1
"199","1315達新","110/09/06","元大-太平",1,0,1
"200","1315達新","110/09/06","元大-基隆孝二",0,1,-1
"201","1315達新","110/09/06","元大-斗六",1,0,1
"202","1315達新","110/09/06","永豐金-竹北",0,1,-1
"203","1315達新","110/09/06","台新-高雄",1,0,1
"204","1315達新","110/09/06","新光",0,0,0
"205","1315達新","110/09/06","大展",1,0,1
"206","1315達新","110/09/06","國泰-台中",0,0,0
"207","1315達新","110/09/06","新加坡商瑞銀",1,0,1
"208","1315達新","110/09/06","群益金鼎-士林",0,0,0
"209","1315達新","110/09/06","彰銀-台中",1,0,1
"210","1315達新","110/09/06","元大證券",0,0,0
"211","2609陽明","110/09/06","瑞士信貸",7108,111,6997
"212","2609陽明","110/09/06","凱基-台北",1502,4648,-3146
"213","2609陽明","110/09/06","兆豐-虎尾",1704,6,1698
"214","2609陽明","110/09/06","兆豐-北高雄",180,1631,-1451
"215","2609陽明","110/09/06","台灣摩根士丹利",994,35,959
"216","2609陽明","110/09/06","康和",534,1807,-1273
"217","2609陽明","110/09/06","新加坡商瑞銀",1424,521,903
"218","2609陽明","110/09/06","華南永昌",347,1439,-1092
"219","2609陽明","110/09/06","美林",3107,2252,855
"220","2609陽明","110/09/06","元大-西門",110,1062,-952
"221","2609陽明","110/09/06","摩根大通",5471,4742,729
"222","2609陽明","110/09/06","凱基-復興",1344,2244,-900
"223","2609陽明","110/09/06","元大-士林",7870,7332,538
"224","2609陽明","110/09/06","日盛證券",201,718,-517
"225","2609陽明","110/09/06","元大-土城永寧",623,114,509
"226","2609陽明","110/09/06","元大-開元",106,607,-501
"227","2609陽明","110/09/06","凱基-虎尾",439,28,411
"228","2609陽明","110/09/06","合庫-高雄",82,545,-463
"229","2609陽明","110/09/06","美商高盛",700,304,396
"230","2609陽明","110/09/06","永豐金-復興",66,527,-461
"231","2609陽明","110/09/06","新光-新竹",814,428,386
"232","2609陽明","110/09/06","華南永昌-斗六",45,465,-420
"233","2609陽明","110/09/06","國泰-松江",641,259,382
"234","2609陽明","110/09/06","玉山-嘉義",128,539,-411
"235","2609陽明","110/09/06","永豐金證券",599,234,365
"236","2609陽明","110/09/06","群益金鼎",229,637,-408
"237","2609陽明","110/09/06","華南永昌-虎尾",370,58,312
"238","2609陽明","110/09/06","統一-仁愛",1055,1440,-385
"239","2609陽明","110/09/06","新光",2047,1803,244
"240","2609陽明","110/09/06","元大-東蘆",182,551,-369
"241","2636台驊投控","110/09/06","台灣摩根士丹利",776,2,774
"242","2636台驊投控","110/09/06","元大證券",64,244,-180
"243","2636台驊投控","110/09/06","凱基-復興",705,103,602
"244","2636台驊投控","110/09/06","元大-龍潭",7,146,-139
"245","2636台驊投控","110/09/06","瑞士信貸",607,29,578
"246","2636台驊投控","110/09/06","華南永昌-潮州",4,109,-105
"247","2636台驊投控","110/09/06","富邦證券",479,22,457
"248","2636台驊投控","110/09/06","兆豐證券",0,102,-102
"249","2636台驊投控","110/09/06","美林",503,180,323
"250","2636台驊投控","110/09/06","新光",172,266,-94
"251","2636台驊投控","110/09/06","美商高盛",395,117,278
"252","2636台驊投控","110/09/06","元大-北成功",2,96,-94
"253","2636台驊投控","110/09/06","摩根大通",731,475,256
"254","2636台驊投控","110/09/06","臺銀-高雄",8,80,-72
"255","2636台驊投控","110/09/06","日盛-台中",274,23,251
"256","2636台驊投控","110/09/06","國泰-敦南",88,149,-61
"257","2636台驊投控","110/09/06","統一",337,150,187
"258","2636台驊投控","110/09/06","凱基-高雄",2,59,-57
"259","2636台驊投控","110/09/06","新加坡商瑞銀",225,57,168
"260","2636台驊投控","110/09/06","元富-文心",6,60,-54
"261","2636台驊投控","110/09/06","元大-南屯",81,6,75
"262","2636台驊投控","110/09/06","台新證券",52,104,-52
"263","2636台驊投控","110/09/06","凱基-台北",465,391,74
"264","2636台驊投控","110/09/06","康和-延平",1,49,-48
"265","2636台驊投控","110/09/06","群益金鼎-台南",73,43,30
"266","2636台驊投控","110/09/06","玉山-嘉義",11,57,-46
"267","2636台驊投控","110/09/06","凱基-竹科",31,4,27
"268","2636台驊投控","110/09/06","元大-豐原站前",6,49,-43
"269","2636台驊投控","110/09/06","元富-安南",23,4,19
"270","2636台驊投控","110/09/06","群益金鼎-竹南",0,42,-42
"271","2867三商壽","110/09/06","美林",487,0,487
"272","2867三商壽","110/09/06","新光",39,343,-304
"273","2867三商壽","110/09/06","摩根大通",389,5,384
"274","2867三商壽","110/09/06","元大-桃園",150,450,-300
"275","2867三商壽","110/09/06","台新證券",319,7,312
"276","2867三商壽","110/09/06","新光-新竹",0,222,-222
"277","2867三商壽","110/09/06","永豐金-松山",210,0,210
"278","2867三商壽","110/09/06","元大-永春",1,150,-149
"279","2867三商壽","110/09/06","台灣摩根士丹利",237,43,194
"280","2867三商壽","110/09/06","新光-高雄",0,105,-105
"281","2867三商壽","110/09/06","凱基-台北",332,166,166
"282","2867三商壽","110/09/06","元富-大昌",0,94,-94
"283","2867三商壽","110/09/06","國票-台南",150,0,150
"284","2867三商壽","110/09/06","港商野村",0,72,-72
"285","2867三商壽","110/09/06","凱基-永和",100,0,100
"286","2867三商壽","110/09/06","元大-中壢",0,53,-53
"287","2867三商壽","110/09/06","華南永昌-虎尾",90,0,90
"288","2867三商壽","110/09/06","臺銀-民權",0,50,-50
"289","2867三商壽","110/09/06","大昌-新店",79,0,79
"290","2867三商壽","110/09/06","兆豐-鹿港",0,50,-50
"291","2867三商壽","110/09/06","新加坡商瑞銀",59,0,59
"292","2867三商壽","110/09/06","元大-八德",0,50,-50
"293","2867三商壽","110/09/06","統一-平鎮",50,0,50
"294","2867三商壽","110/09/06","玉山-板橋",1,45,-44
"295","2867三商壽","110/09/06","永豐金-市政",50,1,49
"296","2867三商壽","110/09/06","新光-台中",25,68,-43
"297","2867三商壽","110/09/06","永豐金-永康",48,0,48
"298","2867三商壽","110/09/06","第一金-路竹",0,32,-32
"299","2867三商壽","110/09/06","元大-豐原",41,0,41
"300","2867三商壽","110/09/06","元大-博愛",0,32,-32
"301","5521工信","110/09/06","元富",427,0,427
"302","5521工信","110/09/06","日進",14,2000,-1986
"303","5521工信","110/09/06","國票-敦北法人",412,0,412
"304","5521工信","110/09/06","元大-成功",0,560,-560
"305","5521工信","110/09/06","永豐金-松山",373,0,373
"306","5521工信","110/09/06","華南永昌-民權",0,421,-421
"307","5521工信","110/09/06","美林",203,2,201
"308","5521工信","110/09/06","元大-南投",1,260,-259
"309","5521工信","110/09/06","台新證券",237,45,192
"310","5521工信","110/09/06","凱基-台北",277,474,-197
"311","5521工信","110/09/06","群益金鼎-台中",188,0,188
"312","5521工信","110/09/06","群益金鼎-大甲",0,185,-185
"313","5521工信","110/09/06","元大-南屯",132,0,132
"314","5521工信","110/09/06","富邦-敦南",3,146,-143
"315","5521工信","110/09/06","台中銀",109,0,109
"316","5521工信","110/09/06","中國信託-三重",23,129,-106
"317","5521工信","110/09/06","凱基-中山",102,0,102
"318","5521工信","110/09/06","凱基-松山",2,102,-100
"319","5521工信","110/09/06","合庫-台中",98,0,98
"320","5521工信","110/09/06","國泰-敦南",87,179,-92
"321","5521工信","110/09/06","(牛牛牛)亞-鑫豐",118,20,98
"322","5521工信","110/09/06","元大-內湖",3,65,-62
"323","5521工信","110/09/06","元富-大昌",100,5,95
"324","5521工信","110/09/06","永興-大墩",0,57,-57
"325","5521工信","110/09/06","玉山-板橋",91,0,91
"326","5521工信","110/09/06","合庫-彰化",0,41,-41
"327","5521工信","110/09/06","美商高盛",105,15,90
"328","5521工信","110/09/06","福勝",9,50,-41
"329","5521工信","110/09/06","華南永昌",84,10,74
"330","5521工信","110/09/06","元富-台南",0,40,-40
"331","1471首利","110/09/06","摩根大通",119,52,67
"332","1471首利","110/09/06","第一金-路竹",0,96,-96
"333","1471首利","110/09/06","新光",40,0,40
"334","1471首利","110/09/06","元大-內湖",0,55,-55
"335","1471首利","110/09/06","台新-松江",37,0,37
"336","1471首利","110/09/06","永興-水湳",0,50,-50
"337","1471首利","110/09/06","元大-鳳山",31,0,31
"338","1471首利","110/09/06","元富-埔里",0,40,-40
"339","1471首利","110/09/06","日盛-新莊",30,0,30
"340","1471首利","110/09/06","宏遠-光隆",0,24,-24
"341","1471首利","110/09/06","日盛-大墩",28,0,28
"342","1471首利","110/09/06","大昌",0,24,-24
"343","1471首利","110/09/06","合庫-基隆",20,0,20
"344","1471首利","110/09/06","台中銀",0,20,-20
"345","1471首利","110/09/06","凱基-八德",20,0,20
"346","1471首利","110/09/06","永豐金-中和",0,20,-20
"347","1471首利","110/09/06","兆豐-桃園",24,5,19
"348","1471首利","110/09/06","兆豐-寶成",0,18,-18
"349","1471首利","110/09/06","永豐金-忠孝",16,0,16
"350","1471首利","110/09/06","凱基-台北",0,18,-18
"351","1471首利","110/09/06","國泰-敦南",20,7,13
"352","1471首利","110/09/06","元大-新店中正",0,17,-17
"353","1471首利","110/09/06","永豐金-鳳山",13,0,13
"354","1471首利","110/09/06","國泰-台中",7,20,-13
"355","1471首利","110/09/06","元富-民權",12,0,12
"356","1471首利","110/09/06","凱基-和平",0,13,-13
"357","1471首利","110/09/06","日盛-景美",10,0,10
"358","1471首利","110/09/06","統一-新台中",1,13,-12
"359","1471首利","110/09/06","日盛-南京",10,0,10
"360","1471首利","110/09/06","元大-東蘆",0,12,-12
"361","2883開發金","110/09/06","摩根大通",1695,359,1336
"362","2883開發金","110/09/06","台灣摩根士丹利",431,9656,-9225
"363","2883開發金","110/09/06","凱基-台北",1946,939,1007
"364","2883開發金","110/09/06","國泰證券",136,1401,-1265
"365","2883開發金","110/09/06","新光-台中",839,33,806
"366","2883開發金","110/09/06","合庫-自強",42,800,-758
"367","2883開發金","110/09/06","亞東-新竹",1356,600,756
"368","2883開發金","110/09/06","華南永昌-東昇",25,705,-680
"369","2883開發金","110/09/06","元大-林森",704,20,684
"370","2883開發金","110/09/06","兆豐-台中港",31,663,-632
"371","2883開發金","110/09/06","富邦-花蓮",478,103,375
"372","2883開發金","110/09/06","富邦-建國",72,617,-545
"373","2883開發金","110/09/06","臺銀-鳳山",355,9,346
"374","2883開發金","110/09/06","港商麥格理",0,416,-416
"375","2883開發金","110/09/06","統一-彰化",344,13,331
"376","2883開發金","110/09/06","永豐金-中正",43,392,-349
"377","2883開發金","110/09/06","富邦-中壢",331,12,319
"378","2883開發金","110/09/06","元大-民雄",4,348,-344
"379","2883開發金","110/09/06","玉山-大里",332,15,317
"380","2883開發金","110/09/06","美林",0,316,-316
"381","2883開發金","110/09/06","統一-新營",281,0,281
"382","2883開發金","110/09/06","凱基-復興",9,317,-308
"383","2883開發金","110/09/06","元大-大益",245,5,240
"384","2883開發金","110/09/06","元大-四維",10,318,-308
"385","2883開發金","110/09/06","元富-花蓮",253,20,233
"386","2883開發金","110/09/06","元大-竹南",39,320,-281
"387","2883開發金","110/09/06","元大-頭份",218,0,218
"388","2883開發金","110/09/06","瑞士信貸",8,260,-252
"389","2883開發金","110/09/06","永豐金證券",229,20,209
"390","2883開發金","110/09/06","台新-三民",18,232,-214
"391","6205詮欣","110/09/06","摩根大通",14,0,14
"392","6205詮欣","110/09/06","元大-雙和",1,44,-43
"393","6205詮欣","110/09/06","臺銀",10,0,10
"394","6205詮欣","110/09/06","德信",0,10,-10
"395","6205詮欣","110/09/06","元富-宜蘭",10,0,10
"396","6205詮欣","110/09/06","兆豐-南京",0,6,-6
"397","6205詮欣","110/09/06","元大-南投",10,0,10
"398","6205詮欣","110/09/06","美林",1,6,-5
"399","6205詮欣","110/09/06","玉山-城中",9,0,9
"400","6205詮欣","110/09/06","瑞士信貸",0,3,-3
"401","6205詮欣","110/09/06","永豐金-中正",9,0,9
"402","6205詮欣","110/09/06","新光-桃園",0,3,-3
"403","6205詮欣","110/09/06","凱基-汐止",5,0,5
"404","6205詮欣","110/09/06","凱基-天母",0,3,-3
"405","6205詮欣","110/09/06","臺銀-民權",3,0,3
"406","6205詮欣","110/09/06","元大-竹科",0,3,-3
"407","6205詮欣","110/09/06","元富-成功",3,0,3
"408","6205詮欣","110/09/06","德信-新營",0,2,-2
"409","6205詮欣","110/09/06","玉山-雙和",2,0,2
"410","6205詮欣","110/09/06","群益金鼎-新莊",0,2,-2
"411","6205詮欣","110/09/06","元大-西門",2,0,2
"412","6205詮欣","110/09/06","富邦-陽明",1,3,-2
"413","6205詮欣","110/09/06","元大-汐止",2,0,2
"414","6205詮欣","110/09/06","元大-博愛",0,2,-2
"415","6205詮欣","110/09/06","永豐金證券",2,0,2
"416","6205詮欣","110/09/06","富邦-嘉義",0,1,-1
"417","6205詮欣","110/09/06","第一金-大稻埕",1,0,1
"418","6205詮欣","110/09/06","元大-西螺",0,1,-1
"419","6205詮欣","110/09/06","華南永昌-古亭",1,0,1
"420","6205詮欣","110/09/06","康和-板橋",0,0,0
"421","1540喬福","110/09/06","凱基-興隆",10,0,10
"422","1540喬福","110/09/06","台新證券",0,10,-10
"423","1540喬福","110/09/06","致和證券",4,0,4
"424","1540喬福","110/09/06","國票-彰化",0,3,-3
"425","1540喬福","110/09/06","元大-四維",1,0,1
"426","1540喬福","110/09/06","元大證券",0,2,-2
"427","1540喬福","110/09/06","元大-太平",1,0,1
"428","1540喬福","110/09/06","凱基-文心",0,2,-2
"429","1540喬福","110/09/06","兆豐-高雄",1,0,1
"430","1540喬福","110/09/06","永豐金-中盛",0,1,-1
"431","1540喬福","110/09/06","玉山-台南",1,0,1
"432","1540喬福","110/09/06","永豐金證券",0,1,-1
"433","1540喬福","110/09/06","凱基-復興",1,0,1
"434","1540喬福","110/09/06","美林",0,1,-1
"435","1540喬福","110/09/06","合庫-台南",1,0,1
"436","1540喬福","110/09/06","國泰-松江",0,0,0
"437","1540喬福","110/09/06","國泰-松江",0,0,0
"438","1540喬福","110/09/06","富邦-新店",0,0,0
"439","1540喬福","110/09/06","富邦-新店",0,0,0
"440","1540喬福","110/09/06","群益金鼎-館前",0,0,0
"441","1540喬福","110/09/06","群益金鼎-館前",0,0,0
"442","1540喬福","110/09/06","群益金鼎-北高雄",0,0,0
"443","1540喬福","110/09/06","群益金鼎-北高雄",0,0,0
"444","1540喬福","110/09/06","國泰-敦南",0,0,0
"445","1540喬福","110/09/06","國泰-敦南",0,0,0
"446","1540喬福","110/09/06","國泰-台中",0,0,0
"447","1540喬福","110/09/06","國泰-台中",0,0,0
"448","1540喬福","110/09/06","玉山-雙和",0,0,0
"449","1540喬福","110/09/06","玉山-雙和",0,0,0
"450","1540喬福","110/09/06","統一-士林",0,0,0
"451","2888新光金","110/09/06","瑞士信貸",1045,87,958
"452","2888新光金","110/09/06","永豐金-板橋",110,2037,-1927
"453","2888新光金","110/09/06","凱基-台北",1359,568,791
"454","2888新光金","110/09/06","彰銀",20,680,-660
"455","2888新光金","110/09/06","富邦-花蓮",900,129,771
"456","2888新光金","110/09/06","港商法國興業",62,704,-642
"457","2888新光金","110/09/06","國票-長城",801,43,758
"458","2888新光金","110/09/06","致和證券",10,600,-590
"459","2888新光金","110/09/06","新加坡商瑞銀",739,39,700
"460","2888新光金","110/09/06","(牛牛牛)亞-鑫豐",42,589,-547
"461","2888新光金","110/09/06","元大-鹿港",513,5,508
"462","2888新光金","110/09/06","兆豐-鹿港",61,604,-543
"463","2888新光金","110/09/06","台新證券",514,51,463
"464","2888新光金","110/09/06","元大-新莊",34,533,-499
"465","2888新光金","110/09/06","台灣摩根士丹利",634,179,455
"466","2888新光金","110/09/06","光和-溪湖",20,491,-471
"467","2888新光金","110/09/06","元大-彰化民生",458,7,451
"468","2888新光金","110/09/06","台新-三民",1,345,-344
"469","2888新光金","110/09/06","華南永昌-小港",452,6,446
"470","2888新光金","110/09/06","美商高盛",265,600,-335
"471","2888新光金","110/09/06","國票-南京",400,0,400
"472","2888新光金","110/09/06","中國信託-高雄",7,323,-316
"473","2888新光金","110/09/06","統一-板橋",448,51,397
"474","2888新光金","110/09/06","元大-善化",7,312,-305
"475","2888新光金","110/09/06","兆豐-民生",281,0,281
"476","2888新光金","110/09/06","群益金鼎-館前",9,311,-302
"477","2888新光金","110/09/06","兆豐-嘉義",250,2,248
"478","2888新光金","110/09/06","新百王",101,402,-301
"479","2888新光金","110/09/06","元大證券",377,146,231
"480","2888新光金","110/09/06","台新-新營",12,301,-289
"481","1340勝悅","110/09/06","玉山-新竹",55,0,55
"482","1340勝悅","110/09/06","元大-忠孝鼎富",0,41,-41
"483","1340勝悅","110/09/06","華南永昌-公誠",10,0,10
"484","1340勝悅","110/09/06","凱基-台北",0,13,-13
"485","1340勝悅","110/09/06","美商高盛",4,1,3
"486","1340勝悅","110/09/06","日盛證券",0,10,-10
"487","1340勝悅","110/09/06","國泰-台中",3,0,3
"488","1340勝悅","110/09/06","美林",0,8,-8
"489","1340勝悅","110/09/06","群益金鼎-崇德",4,1,3
"490","1340勝悅","110/09/06","群益金鼎-屏東",0,8,-8
"491","1340勝悅","110/09/06","日盛-員林",2,0,2
"492","1340勝悅","110/09/06","國票-台東",0,5,-5
"493","1340勝悅","110/09/06","元富-宜蘭",2,0,2
"494","1340勝悅","110/09/06","華南永昌-忠孝",0,5,-5
"495","1340勝悅","110/09/06","國泰-高雄",4,2,2
"496","1340勝悅","110/09/06","臺銀-高雄",0,3,-3
"497","1340勝悅","110/09/06","國泰-板橋",2,0,2
"498","1340勝悅","110/09/06","群益金鼎-敦南",0,3,-3
"499","1340勝悅","110/09/06","華南永昌-中正",2,0,2
"500","1340勝悅","110/09/06","高橋",0,2,-2
"501","1340勝悅","110/09/06","富邦-嘉義",2,0,2
"502","1340勝悅","110/09/06","摩根大通",0,2,-2
"503","1340勝悅","110/09/06","國泰-桃園",1,0,1
"504","1340勝悅","110/09/06","新光",1,3,-2
"505","1340勝悅","110/09/06","國泰-敦南",2,1,1
"506","1340勝悅","110/09/06","永豐金-屏東",0,2,-2
"507","1340勝悅","110/09/06","群益金鼎-館前",2,1,1
"508","1340勝悅","110/09/06","元富-新竹",0,1,-1
"509","1340勝悅","110/09/06","華南永昌-高雄",1,0,1
"510","1340勝悅","110/09/06","永豐金-台中",0,1,-1
"511","6246臺龍","110/09/06","統一-台南",16,0,16
"512","6246臺龍","110/09/06","群益金鼎-古亭",0,13,-13
"513","6246臺龍","110/09/06","元富-屏東",11,0,11
"514","6246臺龍","110/09/06","港商野村",0,12,-12
"515","6246臺龍","110/09/06","台新證券",10,0,10
"516","6246臺龍","110/09/06","日進",0,9,-9
"517","6246臺龍","110/09/06","富邦-新竹",10,0,10
"518","6246臺龍","110/09/06","統一-土城",0,8,-8
"519","6246臺龍","110/09/06","元大-永康",7,0,7
"520","6246臺龍","110/09/06","玉山證券",0,6,-6
"521","6246臺龍","110/09/06","凱基-南崁",5,0,5
"522","6246臺龍","110/09/06","凱基-台北",0,6,-6
"523","6246臺龍","110/09/06","宏遠-館前",3,0,3
"524","6246臺龍","110/09/06","元富-大裕",0,5,-5
"525","6246臺龍","110/09/06","玉山-板橋",3,0,3
"526","6246臺龍","110/09/06","光和",0,5,-5
"527","6246臺龍","110/09/06","群益金鼎-新竹",3,0,3
"528","6246臺龍","110/09/06","群益金鼎-開元",0,5,-5
"529","6246臺龍","110/09/06","元大-台中中港",3,0,3
"530","6246臺龍","110/09/06","元大-西螺",0,5,-5
"531","6246臺龍","110/09/06","永豐金-中盛",3,0,3
"532","6246臺龍","110/09/06","台灣企銀",0,4,-4
"533","6246臺龍","110/09/06","土銀-新竹",2,0,2
"534","6246臺龍","110/09/06","國泰-新莊",0,3,-3
"535","6246臺龍","110/09/06","土銀-彰化",2,0,2
"536","6246臺龍","110/09/06","國泰-敦南",1,4,-3
"537","6246臺龍","110/09/06","兆豐-鹿港",2,0,2
"538","6246臺龍","110/09/06","日盛-二林",0,2,-2
"539","6246臺龍","110/09/06","國票-敦北法人",2,0,2
"540","6246臺龍","110/09/06","光和-高雄",0,2,-2
"541","00715L期街口布蘭特正2","110/09/06","永豐金證券",1263,0,1263
"542","00715L期街口布蘭特正2","110/09/06","元大-敦化",0,1040,-1040
"543","00715L期街口布蘭特正2","110/09/06","元富-大裕",505,0,505
"544","00715L期街口布蘭特正2","110/09/06","富邦證券",0,1003,-1003
"545","00715L期街口布蘭特正2","110/09/06","日盛-新莊",383,22,361
"546","00715L期街口布蘭特正2","110/09/06","元大-高雄",102,987,-885
"547","00715L期街口布蘭特正2","110/09/06","兆豐-台中港",351,5,346
"548","00715L期街口布蘭特正2","110/09/06","永豐金-新店",0,707,-707
"549","00715L期街口布蘭特正2","110/09/06","日盛-和美",307,8,299
"550","00715L期街口布蘭特正2","110/09/06","元大-復北",2,520,-518
"551","00715L期街口布蘭特正2","110/09/06","元大-花蓮",200,0,200
"552","00715L期街口布蘭特正2","110/09/06","新光-台中",324,761,-437
"553","00715L期街口布蘭特正2","110/09/06","元富-文心",149,0,149
"554","00715L期街口布蘭特正2","110/09/06","元大證券",3767,4194,-427
"555","00715L期街口布蘭特正2","110/09/06","新光-新竹",137,1,136
"556","00715L期街口布蘭特正2","110/09/06","凱基-站前",0,300,-300
"557","00715L期街口布蘭特正2","110/09/06","元大-草屯",141,9,132
"558","00715L期街口布蘭特正2","110/09/06","元大-南崁",0,170,-170
"559","00715L期街口布蘭特正2","110/09/06","元大-鳳中",119,0,119
"560","00715L期街口布蘭特正2","110/09/06","港商野村",778,930,-152
"561","00715L期街口布蘭特正2","110/09/06","康和",110,0,110
"562","00715L期街口布蘭特正2","110/09/06","凱基-三重",0,150,-150
"563","00715L期街口布蘭特正2","110/09/06","凱基-竹北",110,0,110
"564","00715L期街口布蘭特正2","110/09/06","元大-永康",0,142,-142
"565","00715L期街口布蘭特正2","110/09/06","元大-中和",110,0,110
"566","00715L期街口布蘭特正2","110/09/06","玉山-嘉義",0,141,-141
"567","00715L期街口布蘭特正2","110/09/06","大昌-樹林",112,3,109
"568","00715L期街口布蘭特正2","110/09/06","華南永昌-台中",19,141,-122
"569","00715L期街口布蘭特正2","110/09/06","日盛-永康",107,0,107
"570","00715L期街口布蘭特正2","110/09/06","永豐金-桃園",6,118,-112
"571","8941關中","110/09/06","國泰-新莊",1,0,1
"572","8941關中","110/09/06","華南永昌-公誠",0,1,-1
"573","8941關中","110/09/06","凱基-文心",1,0,1
"574","8941關中","110/09/06","華南永昌-潮州",0,1,-1
"575","8941關中","110/09/06","彰銀-台中",0,0,0
"576","8941關中","110/09/06","彰銀-台中",0,0,0
"577","8941關中","110/09/06","宏遠-館前",0,0,0
"578","8941關中","110/09/06","宏遠-館前",0,0,0
"579","8941關中","110/09/06","康和-板橋",0,0,0
"580","8941關中","110/09/06","康和-板橋",0,0,0
"581","8941關中","110/09/06","元大-鹿港",0,0,0
"582","8941關中","110/09/06","元大-鹿港",0,0,0
"583","8941關中","110/09/06","",NA,NA,NA
"584","8941關中","110/09/06","",NA,NA,NA
"585","8941關中","110/09/06","",NA,NA,NA
"586","8941關中","110/09/06","",NA,NA,NA
"587","8941關中","110/09/06","",NA,NA,NA
"588","8941關中","110/09/06","",NA,NA,NA
"589","8941關中","110/09/06","",NA,NA,NA
"590","8941關中","110/09/06","",NA,NA,NA
"591","8941關中","110/09/06","",NA,NA,NA
"592","8941關中","110/09/06","",NA,NA,NA
"593","8941關中","110/09/06","",NA,NA,NA
"594","8941關中","110/09/06","",NA,NA,NA
"595","8941關中","110/09/06","",NA,NA,NA
"596","8941關中","110/09/06","",NA,NA,NA
"597","8941關中","110/09/06","",NA,NA,NA
"598","8941關中","110/09/06","",NA,NA,NA
"599","8941關中","110/09/06","",NA,NA,NA
"600","8941關中","110/09/06","",NA,NA,NA
"601","8936國統","110/09/06","凱基-台北",178,30,148
"602","8936國統","110/09/06","永豐金-博愛",0,100,-100
"603","8936國統","110/09/06","美林",81,0,81
"604","8936國統","110/09/06","元大-屏東民生",0,86,-86
"605","8936國統","110/09/06","摩根大通",108,35,73
"606","8936國統","110/09/06","兆豐-大同",0,46,-46
"607","8936國統","110/09/06","新加坡商瑞銀",62,36,26
"608","8936國統","110/09/06","瑞士信貸",0,44,-44
"609","8936國統","110/09/06","台新-高雄",35,10,25
"610","8936國統","110/09/06","台灣摩根士丹利",0,40,-40
"611","8936國統","110/09/06","元大-東泰",30,5,25
"612","8936國統","110/09/06","元富-緯城",0,40,-40
"613","8936國統","110/09/06","元富-敦南",24,0,24
"614","8936國統","110/09/06","美商高盛",10,45,-35
"615","8936國統","110/09/06","永豐金-忠孝",28,5,23
"616","8936國統","110/09/06","凱基-高美館",9,37,-28
"617","8936國統","110/09/06","富邦-建國",21,0,21
"618","8936國統","110/09/06","兆豐-嘉義",0,25,-25
"619","8936國統","110/09/06","富邦-中壢",20,1,19
"620","8936國統","110/09/06","統一-台中",0,22,-22
"621","8936國統","110/09/06","第一金-新興",17,0,17
"622","8936國統","110/09/06","元大-承德",0,20,-20
"623","8936國統","110/09/06","元大-旗山",17,0,17
"624","8936國統","110/09/06","元大-左營",1,20,-19
"625","8936國統","110/09/06","兆豐-來福",15,0,15
"626","8936國統","110/09/06","永豐金-苓雅",2,20,-18
"627","8936國統","110/09/06","元大-博愛",13,0,13
"628","8936國統","110/09/06","玉山證券",3,19,-16
"629","8936國統","110/09/06","元大-桃興",13,0,13
"630","8936國統","110/09/06","港商野村",10,24,-14
"631","6226光鼎","110/09/06","富邦-台北",120,6,114
"632","6226光鼎","110/09/06","凱基-台北",112,220,-108
"633","6226光鼎","110/09/06","永豐金-大園",72,0,72
"634","6226光鼎","110/09/06","元大-北成功",2,107,-105
"635","6226光鼎","110/09/06","瑞士信貸",63,0,63
"636","6226光鼎","110/09/06","大昌-新店",21,111,-90
"637","6226光鼎","110/09/06","合庫-鳳山",60,0,60
"638","6226光鼎","110/09/06","摩根大通",118,200,-82
"639","6226光鼎","110/09/06","臺銀-臺南",67,9,58
"640","6226光鼎","110/09/06","華南永昌",11,83,-72
"641","6226光鼎","110/09/06","國泰-板橋",94,44,50
"642","6226光鼎","110/09/06","台灣企銀-三民",0,51,-51
"643","6226光鼎","110/09/06","玉山-士林",46,4,42
"644","6226光鼎","110/09/06","第一金-光復",13,60,-47
"645","6226光鼎","110/09/06","永豐金-新莊",38,0,38
"646","6226光鼎","110/09/06","元大-竹北",2,43,-41
"647","6226光鼎","110/09/06","土銀-嘉義",34,0,34
"648","6226光鼎","110/09/06","華南永昌-岡山",0,38,-38
"649","6226光鼎","110/09/06","群益金鼎-開元",35,2,33
"650","6226光鼎","110/09/06","富邦-彰化",1,39,-38
"651","6226光鼎","110/09/06","日盛-大墩",34,2,32
"652","6226光鼎","110/09/06","日盛-和美",0,35,-35
"653","6226光鼎","110/09/06","永豐金-台南",49,17,32
"654","6226光鼎","110/09/06","新光",61,96,-35
"655","6226光鼎","110/09/06","元大-楊梅",34,3,31
"656","6226光鼎","110/09/06","凱基-台南",5,40,-35
"657","6226光鼎","110/09/06","元大-員林",44,13,31
"658","6226光鼎","110/09/06","港商野村",57,91,-34
"659","6226光鼎","110/09/06","永豐金證券",32,2,30
"660","6226光鼎","110/09/06","群益金鼎-新竹",7,41,-34
"661","2363矽統","110/09/06","合庫-基隆",1471,72,1399
"662","2363矽統","110/09/06","凱基-松山",1312,10959,-9647
"663","2363矽統","110/09/06","美林",6969,5651,1318
"664","2363矽統","110/09/06","統一",1488,4742,-3254
"665","2363矽統","110/09/06","元大-大里",1591,439,1152
"666","2363矽統","110/09/06","摩根大通",4294,7186,-2892
"667","2363矽統","110/09/06","玉山-大里",1189,225,964
"668","2363矽統","110/09/06","日盛-文化",172,1199,-1027
"669","2363矽統","110/09/06","國泰-敦南",5341,4502,839
"670","2363矽統","110/09/06","統一-敦南",499,1515,-1016
"671","2363矽統","110/09/06","元富-大裕",820,99,721
"672","2363矽統","110/09/06","凱基-台北",4788,5774,-986
"673","2363矽統","110/09/06","群益金鼎-敦南",730,205,525
"674","2363矽統","110/09/06","凱基-大直",61,1043,-982
"675","2363矽統","110/09/06","元大-佳里",964,440,524
"676","2363矽統","110/09/06","統一-土城",151,1105,-954
"677","2363矽統","110/09/06","合庫-高雄",582,81,501
"678","2363矽統","110/09/06","台灣摩根士丹利",683,1562,-879
"679","2363矽統","110/09/06","港商野村",714,235,479
"680","2363矽統","110/09/06","統一-仁愛",306,851,-545
"681","2363矽統","110/09/06","瑞士信貸",522,59,463
"682","2363矽統","110/09/06","統一-城中",175,650,-475
"683","2363矽統","110/09/06","新光-高雄",1086,669,417
"684","2363矽統","110/09/06","康和",347,811,-464
"685","2363矽統","110/09/06","合庫-台中",803,394,409
"686","2363矽統","110/09/06","國票-敦北法人",159,589,-430
"687","2363矽統","110/09/06","兆豐-板橋",431,37,394
"688","2363矽統","110/09/06","凱基-復興",82,477,-395
"689","2363矽統","110/09/06","第一金-新竹",1613,1222,391
"690","2363矽統","110/09/06","美商高盛",1531,1889,-358
"691","8112至上","110/09/06","元大-汐止",101,0,101
"692","8112至上","110/09/06","凱基-敦北",0,201,-201
"693","8112至上","110/09/06","玉山-桃園",87,0,87
"694","8112至上","110/09/06","凱基-台北",68,213,-145
"695","8112至上","110/09/06","群益金鼎-敦南",66,2,64
"696","8112至上","110/09/06","美林",18,154,-136
"697","8112至上","110/09/06","合庫證券",62,0,62
"698","8112至上","110/09/06","大昌-桃園",0,115,-115
"699","8112至上","110/09/06","宏遠證券",50,0,50
"700","8112至上","110/09/06","摩根大通",47,150,-103
"701","8112至上","110/09/06","群益金鼎-內湖",50,0,50
"702","8112至上","110/09/06","凱基-竹科",2,81,-79
"703","8112至上","110/09/06","富邦-仁愛",50,6,44
"704","8112至上","110/09/06","港商野村",16,87,-71
"705","8112至上","110/09/06","元大-文心",44,0,44
"706","8112至上","110/09/06","國票-南京",10,80,-70
"707","8112至上","110/09/06","群益金鼎-高盛",43,0,43
"708","8112至上","110/09/06","元大-信義",0,65,-65
"709","8112至上","110/09/06","永豐金-中盛",31,0,31
"710","8112至上","110/09/06","新加坡商瑞銀",18,82,-64
"711","8112至上","110/09/06","日盛-大墩",35,6,29
"712","8112至上","110/09/06","美商高盛",29,75,-46
"713","8112至上","110/09/06","臺銀",28,1,27
"714","8112至上","110/09/06","玉山-城中",4,43,-39
"715","8112至上","110/09/06","元大-善化",26,1,25
"716","8112至上","110/09/06","(牛牛牛)亞-鑫豐",6,41,-35
"717","8112至上","110/09/06","兆豐-台中港",26,2,24
"718","8112至上","110/09/06","台灣摩根士丹利",11,39,-28
"719","8112至上","110/09/06","統一-南京",21,0,21
"720","8112至上","110/09/06","中國信託",1,27,-26
"721","1570力肯","110/09/06","國票-和平",50,0,50
"722","1570力肯","110/09/06","元大-板橋",1,65,-64
"723","1570力肯","110/09/06","元大-北三重",36,0,36
"724","1570力肯","110/09/06","元大-內湖",0,40,-40
"725","1570力肯","110/09/06","國票-北高雄",23,0,23
"726","1570力肯","110/09/06","凱基-台北",2,38,-36
"727","1570力肯","110/09/06","凱基-天母",20,0,20
"728","1570力肯","110/09/06","宏遠證券",15,50,-35
"729","1570力肯","110/09/06","元大-員林",20,0,20
"730","1570力肯","110/09/06","合庫-桃園",0,20,-20
"731","1570力肯","110/09/06","永豐金-苓雅",20,0,20
"732","1570力肯","110/09/06","永豐金-中和",0,20,-20
"733","1570力肯","110/09/06","新光-新竹",12,0,12
"734","1570力肯","110/09/06","摩根大通",0,18,-18
"735","1570力肯","110/09/06","元大-莒光",12,0,12
"736","1570力肯","110/09/06","元大-基隆",0,17,-17
"737","1570力肯","110/09/06","元大-草屯",12,0,12
"738","1570力肯","110/09/06","統一-松江",0,16,-16
"739","1570力肯","110/09/06","兆豐-員林",10,0,10
"740","1570力肯","110/09/06","聯邦商銀",0,10,-10
"741","1570力肯","110/09/06","富邦-新營",10,0,10
"742","1570力肯","110/09/06","富邦-台南",0,10,-10
"743","1570力肯","110/09/06","國票-內壢",9,0,9
"744","1570力肯","110/09/06","群益金鼎-松山",0,9,-9
"745","1570力肯","110/09/06","臺銀-臺南",6,0,6
"746","1570力肯","110/09/06","兆豐-民生",0,8,-8
"747","1570力肯","110/09/06","大昌-桃園",6,0,6
"748","1570力肯","110/09/06","群益金鼎-丹鳳",0,7,-7
"749","1570力肯","110/09/06","彰銀-七賢",5,0,5
"750","1570力肯","110/09/06","元大-竹科",0,7,-7
"751","2929淘帝","110/09/06","新光-台中",20,0,20
"752","2929淘帝","110/09/06","玉山-新竹",0,60,-60
"753","2929淘帝","110/09/06","富邦-內湖",15,0,15
"754","2929淘帝","110/09/06","美林",2,22,-20
"755","2929淘帝","110/09/06","日盛-八德",10,0,10
"756","2929淘帝","110/09/06","凱基-長庚",0,19,-19
"757","2929淘帝","110/09/06","元富-大裕",10,0,10
"758","2929淘帝","110/09/06","新加坡商瑞銀",1,19,-18
"759","2929淘帝","110/09/06","富邦-台南",10,0,10
"760","2929淘帝","110/09/06","日盛-南京",0,15,-15
"761","2929淘帝","110/09/06","元富-新竹",7,0,7
"762","2929淘帝","110/09/06","國泰-台中",0,8,-8
"763","2929淘帝","110/09/06","凱基-林口",7,0,7
"764","2929淘帝","110/09/06","元大-左營",0,6,-6
"765","2929淘帝","110/09/06","華南永昌-古亭",7,0,7
"766","2929淘帝","110/09/06","港商野村",0,5,-5
"767","2929淘帝","110/09/06","富邦-台北",7,0,7
"768","2929淘帝","110/09/06","第一金-自由",0,5,-5
"769","2929淘帝","110/09/06","元大-承德",6,0,6
"770","2929淘帝","110/09/06","元富-基隆",0,5,-5
"771","2929淘帝","110/09/06","合庫-高雄",5,0,5
"772","2929淘帝","110/09/06","光和-高雄",0,5,-5
"773","2929淘帝","110/09/06","元富-草屯",5,0,5
"774","2929淘帝","110/09/06","永豐金-忠孝",0,5,-5
"775","2929淘帝","110/09/06","台新證券",6,1,5
"776","2929淘帝","110/09/06","台新-高雄",0,4,-4
"777","2929淘帝","110/09/06","台新-建北",5,0,5
"778","2929淘帝","110/09/06","富邦-南屯",0,4,-4
"779","2929淘帝","110/09/06","玉山-台南",5,0,5
"780","2929淘帝","110/09/06","臺銀-臺南",0,3,-3
"781","5410國眾","110/09/06","華南永昌-高雄",30,0,30
"782","5410國眾","110/09/06","凱基-台北",1,12,-11
"783","5410國眾","110/09/06","元大-木柵",8,0,8
"784","5410國眾","110/09/06","新光-台中",0,10,-10
"785","5410國眾","110/09/06","兆豐-嘉義",4,0,4
"786","5410國眾","110/09/06","群益金鼎-中壢",0,10,-10
"787","5410國眾","110/09/06","新光",3,0,3
"788","5410國眾","110/09/06","臺銀-金山",0,9,-9
"789","5410國眾","110/09/06","華南永昌-淡水",3,0,3
"790","5410國眾","110/09/06","大昌",0,5,-5
"791","5410國眾","110/09/06","元大-大灣",3,0,3
"792","5410國眾","110/09/06","臺銀-高雄",0,3,-3
"793","5410國眾","110/09/06","元富-緯城",2,0,2
"794","5410國眾","110/09/06","元富-板橋",0,3,-3
"795","5410國眾","110/09/06","元富-嘉義",2,0,2
"796","5410國眾","110/09/06","元富-林園",0,2,-2
"797","5410國眾","110/09/06","國泰-台中",2,0,2
"798","5410國眾","110/09/06","國票-博愛",0,2,-2
"799","5410國眾","110/09/06","群益金鼎-士林",2,0,2
"800","5410國眾","110/09/06","康和-延平",0,2,-2
"801","5410國眾","110/09/06","凱基-台東",2,0,2
"802","5410國眾","110/09/06","玉山-數位",0,2,-2
"803","5410國眾","110/09/06","元大-鳳中",2,0,2
"804","5410國眾","110/09/06","國泰-敦南",2,4,-2
"805","5410國眾","110/09/06","元大-左營",2,0,2
"806","5410國眾","110/09/06","凱基-岡山",0,2,-2
"807","5410國眾","110/09/06","永豐金-竹北",2,0,2
"808","5410國眾","110/09/06","華南永昌-公誠",0,2,-2
"809","5410國眾","110/09/06","元大-崇德",1,0,1
"810","5410國眾","110/09/06","元大-苑裡",0,2,-2
"811","2841台開","110/09/06","永豐金-員林",60,0,60
"812","2841台開","110/09/06","華南永昌-潮州",0,75,-75
"813","2841台開","110/09/06","群益金鼎-彰化",50,0,50
"814","2841台開","110/09/06","富隆-長安",0,40,-40
"815","2841台開","110/09/06","台中銀",40,0,40
"816","2841台開","110/09/06","永豐金-南投",0,25,-25
"817","2841台開","110/09/06","富邦-新店",24,0,24
"818","2841台開","110/09/06","台灣摩根士丹利",0,13,-13
"819","2841台開","110/09/06","宏遠-館前",21,0,21
"820","2841台開","110/09/06","群益金鼎-永和",0,13,-13
"821","2841台開","110/09/06","群益金鼎-崇德",20,0,20
"822","2841台開","110/09/06","國票-中和",0,12,-12
"823","2841台開","110/09/06","凱基-大里",16,0,16
"824","2841台開","110/09/06","國票-和平",0,10,-10
"825","2841台開","110/09/06","日盛證券",17,5,12
"826","2841台開","110/09/06","富邦-新竹",0,10,-10
"827","2841台開","110/09/06","群益金鼎-大甲",10,0,10
"828","2841台開","110/09/06","元大-復北",0,10,-10
"829","2841台開","110/09/06","永豐金-敦南",23,15,8
"830","2841台開","110/09/06","富邦-苗栗",0,9,-9
"831","2841台開","110/09/06","國泰-敦南",6,0,6
"832","2841台開","110/09/06","凱基-三重",0,8,-8
"833","2841台開","110/09/06","元大-南勢角",6,0,6
"834","2841台開","110/09/06","群益金鼎-新竹",0,7,-7
"835","2841台開","110/09/06","國票-天祥",2,0,2
"836","2841台開","110/09/06","元大-歸仁",0,7,-7
"837","2841台開","110/09/06","國泰-桃園",2,0,2
"838","2841台開","110/09/06","台新-台中",0,5,-5
"839","2841台開","110/09/06","群益金鼎-館前",1,0,1
"840","2841台開","110/09/06","元大-東蘆",0,5,-5
"841","6207雷科","110/09/06","台新-高雄",57,0,57
"842","6207雷科","110/09/06","新加坡商瑞銀",11,65,-54
"843","6207雷科","110/09/06","元大-高雄",52,0,52
"844","6207雷科","110/09/06","凱基-台北",17,56,-39
"845","6207雷科","110/09/06","群益金鼎-瑞豐",40,0,40
"846","6207雷科","110/09/06","(牛牛牛)亞-鑫豐",0,28,-28
"847","6207雷科","110/09/06","中國信託-高雄",17,0,17
"848","6207雷科","110/09/06","港商野村",0,27,-27
"849","6207雷科","110/09/06","永全-八德",9,0,9
"850","6207雷科","110/09/06","美商高盛",2,28,-26
"851","6207雷科","110/09/06","永豐金-北高雄",9,0,9
"852","6207雷科","110/09/06","華南永昌-朴子",0,20,-20
"853","6207雷科","110/09/06","大昌-桃園",8,0,8
"854","6207雷科","110/09/06","摩根大通",1,20,-19
"855","6207雷科","110/09/06","凱基-中山",8,0,8
"856","6207雷科","110/09/06","元大-博愛",0,15,-15
"857","6207雷科","110/09/06","元大-大灣",8,0,8
"858","6207雷科","110/09/06","國票-九鼎",2,16,-14
"859","6207雷科","110/09/06","國泰-敦南",7,0,7
"860","6207雷科","110/09/06","美林",0,13,-13
"861","6207雷科","110/09/06","玉山-台南",6,0,6
"862","6207雷科","110/09/06","大慶-富順",4,17,-13
"863","6207雷科","110/09/06","富邦-內湖",6,0,6
"864","6207雷科","110/09/06","統一-台中",1,14,-13
"865","6207雷科","110/09/06","玉山-大里",5,0,5
"866","6207雷科","110/09/06","兆豐-嘉義",1,14,-13
"867","6207雷科","110/09/06","群益金鼎-高盛",5,0,5
"868","6207雷科","110/09/06","國票-台南",0,8,-8
"869","6207雷科","110/09/06","富邦-高雄",5,0,5
"870","6207雷科","110/09/06","台新-台中",0,5,-5
"871","3679新至陞","110/09/06","元大-大天母",30,0,30
"872","3679新至陞","110/09/06","凱基-台北",0,17,-17
"873","3679新至陞","110/09/06","元大-成功",14,0,14
"874","3679新至陞","110/09/06","摩根大通",1,17,-16
"875","3679新至陞","110/09/06","永豐金-南投",5,0,5
"876","3679新至陞","110/09/06","華南永昌-三重",0,13,-13
"877","3679新至陞","110/09/06","大昌-桃園",3,0,3
"878","3679新至陞","110/09/06","瑞士信貸",0,9,-9
"879","3679新至陞","110/09/06","玉山-台大",3,0,3
"880","3679新至陞","110/09/06","北城證券",0,6,-6
"881","3679新至陞","110/09/06","永豐金-松山",3,0,3
"882","3679新至陞","110/09/06","台灣摩根士丹利",0,5,-5
"883","3679新至陞","110/09/06","日盛-嘉義",2,0,2
"884","3679新至陞","110/09/06","美商高盛",0,3,-3
"885","3679新至陞","110/09/06","兆豐-松德",2,0,2
"886","3679新至陞","110/09/06","港商野村",0,3,-3
"887","3679新至陞","110/09/06","凱基-彰化",2,0,2
"888","3679新至陞","110/09/06","凱基-埔墘",0,3,-3
"889","3679新至陞","110/09/06","元大-草屯",2,0,2
"890","3679新至陞","110/09/06","元大-松山",0,3,-3
"891","3679新至陞","110/09/06","土銀-和平",2,1,1
"892","3679新至陞","110/09/06","安泰",0,2,-2
"893","3679新至陞","110/09/06","土銀-士林",1,0,1
"894","3679新至陞","110/09/06","元大-萬華",0,2,-2
"895","3679新至陞","110/09/06","臺銀-高雄",1,0,1
"896","3679新至陞","110/09/06","美林",1,2,-1
"897","3679新至陞","110/09/06","統一",1,0,1
"898","3679新至陞","110/09/06","亞東",0,1,-1
"899","3679新至陞","110/09/06","元富-緯城",1,0,1
"900","3679新至陞","110/09/06","元大證券",0,1,-1
"901","2727王品","110/09/06","統一-三重",24,0,24
"902","2727王品","110/09/06","美林",0,81,-81
"903","2727王品","110/09/06","聯邦-興中",20,0,20
"904","2727王品","110/09/06","華南永昌-麻豆",0,60,-60
"905","2727王品","110/09/06","國泰-敦南",30,13,17
"906","2727王品","110/09/06","港商野村",19,60,-41
"907","2727王品","110/09/06","(牛牛牛)亞-鑫豐",17,3,14
"908","2727王品","110/09/06","凱基-台北",32,69,-37
"909","2727王品","110/09/06","元富-永和",13,0,13
"910","2727王品","110/09/06","中國信託",0,33,-33
"911","2727王品","110/09/06","凱基-板橋",14,1,13
"912","2727王品","110/09/06","統一",0,20,-20
"913","2727王品","110/09/06","國票-九鼎",15,3,12
"914","2727王品","110/09/06","永豐金-桃盛",0,20,-20
"915","2727王品","110/09/06","日盛-木柵",11,0,11
"916","2727王品","110/09/06","富邦-新竹",0,15,-15
"917","2727王品","110/09/06","永豐金-忠孝",11,0,11
"918","2727王品","110/09/06","群益金鼎-大興",0,13,-13
"919","2727王品","110/09/06","德信",10,0,10
"920","2727王品","110/09/06","摩根大通",18,30,-12
"921","2727王品","110/09/06","新光",12,3,9
"922","2727王品","110/09/06","凱基-興隆",1,12,-11
"923","2727王品","110/09/06","元富",8,0,8
"924","2727王品","110/09/06","元大-南京",2,13,-11
"925","2727王品","110/09/06","玉山-桃園",11,3,8
"926","2727王品","110/09/06","元大-高雄",2,13,-11
"927","2727王品","110/09/06","永豐金-彰化",9,1,8
"928","2727王品","110/09/06","群益金鼎-士林",0,8,-8
"929","2727王品","110/09/06","玉山-板橋",8,1,7
"930","2727王品","110/09/06","華南永昌",1,8,-7
"931","1570力肯","110/09/06","國票-和平",50,0,50
"932","1570力肯","110/09/06","元大-板橋",1,65,-64
"933","1570力肯","110/09/06","元大-北三重",36,0,36
"934","1570力肯","110/09/06","元大-內湖",0,40,-40
"935","1570力肯","110/09/06","國票-北高雄",23,0,23
"936","1570力肯","110/09/06","凱基-台北",2,38,-36
"937","1570力肯","110/09/06","凱基-天母",20,0,20
"938","1570力肯","110/09/06","宏遠證券",15,50,-35
"939","1570力肯","110/09/06","元大-員林",20,0,20
"940","1570力肯","110/09/06","合庫-桃園",0,20,-20
"941","1570力肯","110/09/06","永豐金-苓雅",20,0,20
"942","1570力肯","110/09/06","永豐金-中和",0,20,-20
"943","1570力肯","110/09/06","新光-新竹",12,0,12
"944","1570力肯","110/09/06","摩根大通",0,18,-18
"945","1570力肯","110/09/06","元大-莒光",12,0,12
"946","1570力肯","110/09/06","元大-基隆",0,17,-17
"947","1570力肯","110/09/06","元大-草屯",12,0,12
"948","1570力肯","110/09/06","統一-松江",0,16,-16
"949","1570力肯","110/09/06","兆豐-員林",10,0,10
"950","1570力肯","110/09/06","聯邦商銀",0,10,-10
"951","1570力肯","110/09/06","富邦-新營",10,0,10
"952","1570力肯","110/09/06","富邦-台南",0,10,-10
"953","1570力肯","110/09/06","國票-內壢",9,0,9
"954","1570力肯","110/09/06","群益金鼎-松山",0,9,-9
"955","1570力肯","110/09/06","臺銀-臺南",6,0,6
"956","1570力肯","110/09/06","兆豐-民生",0,8,-8
"957","1570力肯","110/09/06","大昌-桃園",6,0,6
"958","1570力肯","110/09/06","群益金鼎-丹鳳",0,7,-7
"959","1570力肯","110/09/06","彰銀-七賢",5,0,5
"960","1570力肯","110/09/06","元大-竹科",0,7,-7
"961","6180橘子","110/09/06","凱基-永康",90,0,90
"962","6180橘子","110/09/06","凱基-台北",22,132,-110
"963","6180橘子","110/09/06","國泰-敦南",19,3,16
"964","6180橘子","110/09/06","元大-大安",0,25,-25
"965","6180橘子","110/09/06","玉山-大里",13,0,13
"966","6180橘子","110/09/06","美林",0,24,-24
"967","6180橘子","110/09/06","日盛-文化",12,0,12
"968","6180橘子","110/09/06","國票-長城",0,22,-22
"969","6180橘子","110/09/06","台灣摩根士丹利",12,0,12
"970","6180橘子","110/09/06","國泰-台南",1,23,-22
"971","6180橘子","110/09/06","合庫-自強",10,0,10
"972","6180橘子","110/09/06","元大-草屯",0,22,-22
"973","6180橘子","110/09/06","元富-大裕",10,0,10
"974","6180橘子","110/09/06","凱基-中壢",0,21,-21
"975","6180橘子","110/09/06","元大-金華",10,0,10
"976","6180橘子","110/09/06","大慶-蘆洲",0,20,-20
"977","6180橘子","110/09/06","港商野村",10,1,9
"978","6180橘子","110/09/06","凱基-高美館",0,20,-20
"979","6180橘子","110/09/06","土銀-和平",8,0,8
"980","6180橘子","110/09/06","富邦-員林",0,18,-18
"981","6180橘子","110/09/06","永豐金證券",8,0,8
"982","6180橘子","110/09/06","摩根大通",26,41,-15
"983","6180橘子","110/09/06","新光-高雄",8,1,7
"984","6180橘子","110/09/06","國泰-新莊",0,10,-10
"985","6180橘子","110/09/06","永豐金-萬盛",7,0,7
"986","6180橘子","110/09/06","元大-大里德芳",0,10,-10
"987","6180橘子","110/09/06","臺銀-高雄",6,0,6
"988","6180橘子","110/09/06","國票-中和",0,8,-8
"989","6180橘子","110/09/06","華南永昌-古亭",8,2,6
"990","6180橘子","110/09/06","台新-左楠",0,8,-8
"991","2390云辰","110/09/06","台灣摩根士丹利",242,16,226
"992","2390云辰","110/09/06","摩根大通",36,602,-566
"993","2390云辰","110/09/06","群益金鼎-海山",164,5,159
"994","2390云辰","110/09/06","美商高盛",139,334,-195
"995","2390云辰","110/09/06","元大-松山",107,4,103
"996","2390云辰","110/09/06","美林",67,190,-123
"997","2390云辰","110/09/06","新光-桃園",64,13,51
"998","2390云辰","110/09/06","新光-台中",0,81,-81
"999","2390云辰","110/09/06","兆豐-北高雄",50,0,50
"1000","2390云辰","110/09/06","臺銀-臺中",26,93,-67
"1001","2390云辰","110/09/06","元大-嘉義",50,0,50
"1002","2390云辰","110/09/06","元大-館前",5,66,-61
"1003","2390云辰","110/09/06","新加坡商瑞銀",113,71,42
"1004","2390云辰","110/09/06","群益金鼎-延平",1,49,-48
"1005","2390云辰","110/09/06","元大-內湖",41,0,41
"1006","2390云辰","110/09/06","凱基-台北",113,160,-47
"1007","2390云辰","110/09/06","兆豐-寶成",41,1,40
"1008","2390云辰","110/09/06","瑞士信貸",0,31,-31
"1009","2390云辰","110/09/06","元大-北三重",41,1,40
"1010","2390云辰","110/09/06","元富-高雄",0,31,-31
"1011","2390云辰","110/09/06","元大-福營",36,0,36
"1012","2390云辰","110/09/06","國票-中和",10,40,-30
"1013","2390云辰","110/09/06","第一金-新竹",30,1,29
"1014","2390云辰","110/09/06","大慶-中壢",3,30,-27
"1015","2390云辰","110/09/06","國票-敦北法人",29,1,28
"1016","2390云辰","110/09/06","日盛-新莊",32,57,-25
"1017","2390云辰","110/09/06","元大-土城學府",135,108,27
"1018","2390云辰","110/09/06","中國信託-嘉義",2,26,-24
"1019","2390云辰","110/09/06","富邦-板橋",30,4,26
"1020","2390云辰","110/09/06","凱基-內埔",0,20,-20
"1021","2834臺企銀","110/09/03","凱基-台北",6916,1284,5632
"1022","2834臺企銀","110/09/03","新加坡商瑞銀",141,10693,-10552
"1023","2834臺企銀","110/09/03","摩根大通",2831,187,2644
"1024","2834臺企銀","110/09/03","新光-台中",69,1833,-1764
"1025","2834臺企銀","110/09/03","花旗環球",1989,0,1989
"1026","2834臺企銀","110/09/03","永豐金-彰化",0,1201,-1201
"1027","2834臺企銀","110/09/03","港商法國興業",1852,0,1852
"1028","2834臺企銀","110/09/03","元富-城東",0,1155,-1155
"1029","2834臺企銀","110/09/03","港商野村",1704,220,1484
"1030","2834臺企銀","110/09/03","台灣摩根士丹利",664,1433,-769
"1031","2834臺企銀","110/09/03","日盛證券",1112,12,1100
"1032","2834臺企銀","110/09/03","元大-蘆洲",92,716,-624
"1033","2834臺企銀","110/09/03","美商高盛",724,77,647
"1034","2834臺企銀","110/09/03","臺銀-臺南",11,630,-619
"1035","2834臺企銀","110/09/03","元大-竹南",611,12,599
"1036","2834臺企銀","110/09/03","華南永昌-麻豆",26,497,-471
"1037","2834臺企銀","110/09/03","中國信託-文心",529,2,527
"1038","2834臺企銀","110/09/03","統一-板橋",150,600,-450
"1039","2834臺企銀","110/09/03","新光",758,240,518
"1040","2834臺企銀","110/09/03","凱基-高美館",3,342,-339
"1041","2834臺企銀","110/09/03","瑞士信貸",4566,4083,483
"1042","2834臺企銀","110/09/03","日盛-新莊",0,306,-306
"1043","2834臺企銀","110/09/03","元大-大里",564,106,458
"1044","2834臺企銀","110/09/03","元富-松德",7,303,-296
"1045","2834臺企銀","110/09/03","元富-虎尾",420,1,419
"1046","2834臺企銀","110/09/03","第一金-忠孝",2,284,-282
"1047","2834臺企銀","110/09/03","華南永昌-嘉義",402,0,402
"1048","2834臺企銀","110/09/03","永豐金-中和",0,282,-282
"1049","2834臺企銀","110/09/03","永豐金-埔里",406,21,385
"1050","2834臺企銀","110/09/03","臺銀-民權",43,292,-249
"1051","5511德昌","110/09/03","永豐金-內湖",35,0,35
"1052","5511德昌","110/09/03","寶盛",0,30,-30
"1053","5511德昌","110/09/03","華南永昌-忠孝",25,0,25
"1054","5511德昌","110/09/03","第一金-台中",0,15,-15
"1055","5511德昌","110/09/03","統一-士林",24,0,24
"1056","5511德昌","110/09/03","康和-內湖",0,10,-10
"1057","5511德昌","110/09/03","永豐金-市政",7,0,7
"1058","5511德昌","110/09/03","玉山-台南",0,5,-5
"1059","5511德昌","110/09/03","凱基-台北",5,0,5
"1060","5511德昌","110/09/03","致和-崇德",0,5,-5
"1061","5511德昌","110/09/03","兆豐-南京",3,0,3
"1062","5511德昌","110/09/03","大昌",0,4,-4
"1063","5511德昌","110/09/03","摩根大通",1,0,1
"1064","5511德昌","110/09/03","凱基-復興",0,3,-3
"1065","5511德昌","110/09/03","元大-清水",1,0,1
"1066","5511德昌","110/09/03","永豐金-台南",0,3,-3
"1067","5511德昌","110/09/03","元富-城中",0,0,0
"1068","5511德昌","110/09/03","群益金鼎-海山",0,2,-2
"1069","5511德昌","110/09/03","元富-中原",0,0,0
"1070","5511德昌","110/09/03","富邦-建國",0,2,-2
"1071","5511德昌","110/09/03","大昌-新竹",0,0,0
"1072","5511德昌","110/09/03","元大-新盛",0,2,-2
"1073","5511德昌","110/09/03","國票-南崁",0,0,0
"1074","5511德昌","110/09/03","元大-新莊",0,2,-2
"1075","5511德昌","110/09/03","台新-屏東",0,0,0
"1076","5511德昌","110/09/03","永豐金-中壢",0,2,-2
"1077","5511德昌","110/09/03","凱基-文心",0,0,0
"1078","5511德昌","110/09/03","永豐金-三重",0,2,-2
"1079","5511德昌","110/09/03","元大-沙鹿",0,0,0
"1080","5511德昌","110/09/03","兆豐-城中",0,1,-1
"1081","2489瑞軒","110/09/03","元大-豐原",137,0,137
"1082","2489瑞軒","110/09/03","台新-高雄",1,155,-154
"1083","2489瑞軒","110/09/03","瑞士信貸",136,0,136
"1084","2489瑞軒","110/09/03","美商高盛",0,101,-101
"1085","2489瑞軒","110/09/03","群益金鼎-大安",130,0,130
"1086","2489瑞軒","110/09/03","兆豐-岡山",0,100,-100
"1087","2489瑞軒","110/09/03","摩根大通",142,17,125
"1088","2489瑞軒","110/09/03","合庫-桃園",0,60,-60
"1089","2489瑞軒","110/09/03","美林",164,86,78
"1090","2489瑞軒","110/09/03","元大-東泰",0,60,-60
"1091","2489瑞軒","110/09/03","台灣摩根士丹利",74,13,61
"1092","2489瑞軒","110/09/03","康和-台中",0,51,-51
"1093","2489瑞軒","110/09/03","華南永昌-忠孝",60,0,60
"1094","2489瑞軒","110/09/03","第一金-路竹",0,50,-50
"1095","2489瑞軒","110/09/03","富邦-岡山",55,0,55
"1096","2489瑞軒","110/09/03","元大-汐止",1,44,-43
"1097","2489瑞軒","110/09/03","凱基-台北",152,104,48
"1098","2489瑞軒","110/09/03","合庫-台南",0,30,-30
"1099","2489瑞軒","110/09/03","花旗環球",46,0,46
"1100","2489瑞軒","110/09/03","國票-南科",0,30,-30
"1101","2489瑞軒","110/09/03","華南永昌-頭份",37,0,37
"1102","2489瑞軒","110/09/03","凱基-中山",0,25,-25
"1103","2489瑞軒","110/09/03","元大-歸仁",32,0,32
"1104","2489瑞軒","110/09/03","國票-長城",0,24,-24
"1105","2489瑞軒","110/09/03","富邦-陽明",30,1,29
"1106","2489瑞軒","110/09/03","群益金鼎-民權",0,22,-22
"1107","2489瑞軒","110/09/03","日盛-忠孝",25,0,25
"1108","2489瑞軒","110/09/03","群益金鼎-潭子",0,22,-22
"1109","2489瑞軒","110/09/03","永豐金-中正",28,5,23
"1110","2489瑞軒","110/09/03","大慶-富順",0,21,-21
"1111","2428興勤","110/09/03","美林",40,0,40
"1112","2428興勤","110/09/03","港商麥格理",0,46,-46
"1113","2428興勤","110/09/03","台灣摩根士丹利",32,2,30
"1114","2428興勤","110/09/03","宏遠-桃園",0,25,-25
"1115","2428興勤","110/09/03","摩根大通",31,4,27
"1116","2428興勤","110/09/03","永豐金證券",0,12,-12
"1117","2428興勤","110/09/03","美商高盛",26,0,26
"1118","2428興勤","110/09/03","永豐金-天母",0,12,-12
"1119","2428興勤","110/09/03","凱基-台北",27,3,24
"1120","2428興勤","110/09/03","國泰證券",0,10,-10
"1121","2428興勤","110/09/03","瑞士信貸",18,1,17
"1122","2428興勤","110/09/03","凱基-桃園",0,10,-10
"1123","2428興勤","110/09/03","新加坡商瑞銀",12,1,11
"1124","2428興勤","110/09/03","元大-旗山",0,10,-10
"1125","2428興勤","110/09/03","富邦-台南",10,0,10
"1126","2428興勤","110/09/03","永豐金-市政",0,10,-10
"1127","2428興勤","110/09/03","花旗環球",7,0,7
"1128","2428興勤","110/09/03","日盛-花蓮",3,10,-7
"1129","2428興勤","110/09/03","日盛-新竹",5,0,5
"1130","2428興勤","110/09/03","中國信託",0,7,-7
"1131","2428興勤","110/09/03","中國信託-高雄",5,0,5
"1132","2428興勤","110/09/03","聯邦-富強",0,6,-6
"1133","2428興勤","110/09/03","富邦-仁愛",5,0,5
"1134","2428興勤","110/09/03","國票-安和",2,7,-5
"1135","2428興勤","110/09/03","永興",4,0,4
"1136","2428興勤","110/09/03","元大-鹿港",0,5,-5
"1137","2428興勤","110/09/03","兆豐-公益",6,2,4
"1138","2428興勤","110/09/03","大昌-桃園",0,4,-4
"1139","2428興勤","110/09/03","凱基",3,0,3
"1140","2428興勤","110/09/03","台新-台中",1,5,-4
"1141","3176基亞","110/09/03","玉山-城中",44,0,44
"1142","3176基亞","110/09/03","永豐金-南投",0,67,-67
"1143","3176基亞","110/09/03","康和-板橋",25,0,25
"1144","3176基亞","110/09/03","台中銀",0,55,-55
"1145","3176基亞","110/09/03","第一金-路竹",20,0,20
"1146","3176基亞","110/09/03","元大-虎尾",0,25,-25
"1147","3176基亞","110/09/03","群益金鼎-板橋",20,0,20
"1148","3176基亞","110/09/03","群益金鼎-中壢",0,18,-18
"1149","3176基亞","110/09/03","元大-新竹經國",20,0,20
"1150","3176基亞","110/09/03","群益金鼎-敦南",0,13,-13
"1151","3176基亞","110/09/03","日盛-板橋",17,0,17
"1152","3176基亞","110/09/03","日盛-南京",0,10,-10
"1153","3176基亞","110/09/03","元富-高雄",12,0,12
"1154","3176基亞","110/09/03","元大-南京",0,10,-10
"1155","3176基亞","110/09/03","玉山-雙和",10,0,10
"1156","3176基亞","110/09/03","富邦-台中",0,9,-9
"1157","3176基亞","110/09/03","群益金鼎-大興",10,0,10
"1158","3176基亞","110/09/03","宏遠-台南",0,8,-8
"1159","3176基亞","110/09/03","日盛-高雄",8,0,8
"1160","3176基亞","110/09/03","新光",9,16,-7
"1161","3176基亞","110/09/03","富邦-台北",10,2,8
"1162","3176基亞","110/09/03","國泰-台中",0,7,-7
"1163","3176基亞","110/09/03","日盛-中壢",6,0,6
"1164","3176基亞","110/09/03","台灣摩根士丹利",0,6,-6
"1165","3176基亞","110/09/03","宏遠-光隆",6,0,6
"1166","3176基亞","110/09/03","第一金-新竹",0,6,-6
"1167","3176基亞","110/09/03","臺灣企銀-桃園",5,0,5
"1168","3176基亞","110/09/03","華南永昌-林口",0,6,-6
"1169","3176基亞","110/09/03","日盛-永康",5,0,5
"1170","3176基亞","110/09/03","第一金-桃園",0,5,-5
"1171","2409友達","110/09/03","永豐金證券",10515,756,9759
"1172","2409友達","110/09/03","台灣摩根士丹利",3924,11957,-8033
"1173","2409友達","110/09/03","摩根大通",6728,2458,4270
"1174","2409友達","110/09/03","元大-前金",33,1976,-1943
"1175","2409友達","110/09/03","合庫證券",2441,63,2378
"1176","2409友達","110/09/03","港商野村",1517,2516,-999
"1177","2409友達","110/09/03","凱基-台北",2289,1219,1070
"1178","2409友達","110/09/03","美商高盛",1046,1706,-660
"1179","2409友達","110/09/03","瑞士信貸",945,31,914
"1180","2409友達","110/09/03","日盛證券",148,796,-648
"1181","2409友達","110/09/03","花旗環球",830,0,830
"1182","2409友達","110/09/03","華南永昌-忠孝",0,606,-606
"1183","2409友達","110/09/03","元大-南屯",896,77,819
"1184","2409友達","110/09/03","兆豐-南京",68,580,-512
"1185","2409友達","110/09/03","康和-新竹",835,41,794
"1186","2409友達","110/09/03","元富-城東",66,563,-497
"1187","2409友達","110/09/03","凱基-中山",765,51,714
"1188","2409友達","110/09/03","玉山-桃園",20,382,-362
"1189","2409友達","110/09/03","元富-安南",705,23,682
"1190","2409友達","110/09/03","日盛-永康",198,528,-330
"1191","2409友達","110/09/03","宏遠-台中",618,1,617
"1192","2409友達","110/09/03","富邦-建國",99,418,-319
"1193","2409友達","110/09/03","華南永昌-南京",1042,532,510
"1194","2409友達","110/09/03","新光-桃園",92,379,-287
"1195","2409友達","110/09/03","玉山-雙和",579,129,450
"1196","2409友達","110/09/03","國泰-台中",119,399,-280
"1197","2409友達","110/09/03","元大-東泰",376,22,354
"1198","2409友達","110/09/03","統一-三重",20,297,-277
"1199","2409友達","110/09/03","玉山-高雄",773,437,336
"1200","2409友達","110/09/03","國票-台中",14,270,-256
"1201","1315達新","110/09/03","凱基-中港",16,0,16
"1202","1315達新","110/09/03","摩根大通",3,15,-12
"1203","1315達新","110/09/03","凱基",11,0,11
"1204","1315達新","110/09/03","富邦-台北",0,7,-7
"1205","1315達新","110/09/03","花旗環球",8,0,8
"1206","1315達新","110/09/03","國泰-桃園",0,5,-5
"1207","1315達新","110/09/03","豐農",8,0,8
"1208","1315達新","110/09/03","元大-花蓮",0,4,-4
"1209","1315達新","110/09/03","台灣摩根士丹利",5,0,5
"1210","1315達新","110/09/03","土銀",0,3,-3
"1211","1315達新","110/09/03","元大-文心興安",5,0,5
"1212","1315達新","110/09/03","台灣企銀-台中",0,3,-3
"1213","1315達新","110/09/03","美林",4,0,4
"1214","1315達新","110/09/03","群益金鼎-彰化",0,3,-3
"1215","1315達新","110/09/03","美商高盛",4,0,4
"1216","1315達新","110/09/03","元大-博愛",0,3,-3
"1217","1315達新","110/09/03","凱基-台北",4,1,3
"1218","1315達新","110/09/03","臺灣企銀-桃園",0,2,-2
"1219","1315達新","110/09/03","凱基-文心",3,0,3
"1220","1315達新","110/09/03","統一",0,2,-2
"1221","1315達新","110/09/03","亞東-板橋",2,0,2
"1222","1315達新","110/09/03","國票-桃園",0,2,-2
"1223","1315達新","110/09/03","元大-新店中正",2,0,2
"1224","1315達新","110/09/03","台新證券",0,2,-2
"1225","1315達新","110/09/03","新加坡商瑞銀",1,0,1
"1226","1315達新","110/09/03","富邦-內湖",0,2,-2
"1227","1315達新","110/09/03","元富-文心",1,0,1
"1228","1315達新","110/09/03","富邦-宜蘭",0,2,-2
"1229","1315達新","110/09/03","群益金鼎-板橋",1,0,1
"1230","1315達新","110/09/03","元大-南屯",0,2,-2
"1231","2609陽明","110/09/03","港商麥格理",610,0,610
"1232","2609陽明","110/09/03","富邦證券",308,2406,-2098
"1233","2609陽明","110/09/03","永豐金證券",610,65,545
"1234","2609陽明","110/09/03","康和",42,2053,-2011
"1235","2609陽明","110/09/03","元大-大天母",502,111,391
"1236","2609陽明","110/09/03","美林",26,1612,-1586
"1237","2609陽明","110/09/03","凱基-復興",2259,1887,372
"1238","2609陽明","110/09/03","富邦-新竹",258,1413,-1155
"1239","2609陽明","110/09/03","華南永昌-桃園",360,15,345
"1240","2609陽明","110/09/03","日盛-雙和",67,1210,-1143
"1241","2609陽明","110/09/03","兆豐-板橋",612,330,282
"1242","2609陽明","110/09/03","統一",717,1794,-1077
"1243","2609陽明","110/09/03","國泰-敦南",1931,1665,266
"1244","2609陽明","110/09/03","富邦-虎尾",5084,5917,-833
"1245","2609陽明","110/09/03","國票-桃園",277,35,242
"1246","2609陽明","110/09/03","新加坡商瑞銀",1267,2013,-746
"1247","2609陽明","110/09/03","華南永昌-竹北",1313,1073,240
"1248","2609陽明","110/09/03","元富-緯城",140,829,-689
"1249","2609陽明","110/09/03","玉山-新莊",419,182,237
"1250","2609陽明","110/09/03","美商高盛",340,1019,-679
"1251","2609陽明","110/09/03","台中銀",299,65,234
"1252","2609陽明","110/09/03","凱基-台北",2120,2780,-660
"1253","2609陽明","110/09/03","永豐金-竹科",381,155,226
"1254","2609陽明","110/09/03","國泰證券",61,682,-621
"1255","2609陽明","110/09/03","玉山-台大",267,47,220
"1256","2609陽明","110/09/03","中國信託-新竹",161,673,-512
"1257","2609陽明","110/09/03","國票-安和",420,201,219
"1258","2609陽明","110/09/03","日盛-大墩",223,708,-485
"1259","2609陽明","110/09/03","凱基-彰化",308,94,214
"1260","2609陽明","110/09/03","兆豐-三民",109,565,-456
"1261","2636台驊投控","110/09/03","摩根大通",610,329,281
"1262","2636台驊投控","110/09/03","凱基-復興",33,624,-591
"1263","2636台驊投控","110/09/03","統一-新台中",194,12,182
"1264","2636台驊投控","110/09/03","富邦證券",0,512,-512
"1265","2636台驊投控","110/09/03","第一金-桃園",148,24,124
"1266","2636台驊投控","110/09/03","統一",86,544,-458
"1267","2636台驊投控","110/09/03","新光",234,145,89
"1268","2636台驊投控","110/09/03","元富-嘉義",4,227,-223
"1269","2636台驊投控","110/09/03","宏遠-新化",79,1,78
"1270","2636台驊投控","110/09/03","兆豐-中壢",2,200,-198
"1271","2636台驊投控","110/09/03","國泰-敦南",258,184,74
"1272","2636台驊投控","110/09/03","凱基-信義",5,178,-173
"1273","2636台驊投控","110/09/03","大慶-中壢",91,18,73
"1274","2636台驊投控","110/09/03","華南永昌-朴子",10,148,-138
"1275","2636台驊投控","110/09/03","國泰-台中",113,52,61
"1276","2636台驊投控","110/09/03","元大-南屯",8,137,-129
"1277","2636台驊投控","110/09/03","永豐金-市政",109,52,57
"1278","2636台驊投控","110/09/03","國票-安和",8,136,-128
"1279","2636台驊投控","110/09/03","國泰-松江",64,8,56
"1280","2636台驊投控","110/09/03","國票-南港",7,121,-114
"1281","2636台驊投控","110/09/03","永豐金-豐原",67,11,56
"1282","2636台驊投控","110/09/03","美林",235,339,-104
"1283","2636台驊投控","110/09/03","玉山-南京東路",120,65,55
"1284","2636台驊投控","110/09/03","中國信託",21,115,-94
"1285","2636台驊投控","110/09/03","群益金鼎-竹南",46,1,45
"1286","2636台驊投控","110/09/03","永豐金-嘉義",1,92,-91
"1287","2636台驊投控","110/09/03","國泰-忠孝",106,62,44
"1288","2636台驊投控","110/09/03","瑞士信貸",0,89,-89
"1289","2636台驊投控","110/09/03","玉山-高雄",53,12,41
"1290","2636台驊投控","110/09/03","統一-基隆",6,90,-84
"1291","2867三商壽","110/09/03","美林",479,40,439
"1292","2867三商壽","110/09/03","元大-桃園",30,800,-770
"1293","2867三商壽","110/09/03","摩根大通",412,67,345
"1294","2867三商壽","110/09/03","日盛-中和",0,301,-301
"1295","2867三商壽","110/09/03","台新證券",261,7,254
"1296","2867三商壽","110/09/03","新光",22,322,-300
"1297","2867三商壽","110/09/03","元大-苑裡",220,0,220
"1298","2867三商壽","110/09/03","日盛-頭份",0,100,-100
"1299","2867三商壽","110/09/03","兆豐-東門",200,0,200
"1300","2867三商壽","110/09/03","新光-新竹",0,100,-100
"1301","2867三商壽","110/09/03","凱基",193,0,193
"1302","2867三商壽","110/09/03","新光-台中",6,89,-83
"1303","2867三商壽","110/09/03","凱基-台北",309,119,190
"1304","2867三商壽","110/09/03","元大-永春",0,75,-75
"1305","2867三商壽","110/09/03","統一-士林",180,0,180
"1306","2867三商壽","110/09/03","玉山-板橋",0,72,-72
"1307","2867三商壽","110/09/03","台灣摩根士丹利",183,5,178
"1308","2867三商壽","110/09/03","宏遠-高雄",0,64,-64
"1309","2867三商壽","110/09/03","花旗環球",142,0,142
"1310","2867三商壽","110/09/03","兆豐-新營",0,59,-59
"1311","2867三商壽","110/09/03","大展",134,1,133
"1312","2867三商壽","110/09/03","群益金鼎-中港",0,51,-51
"1313","2867三商壽","110/09/03","瑞士信貸",124,0,124
"1314","2867三商壽","110/09/03","群益金鼎-開元",0,50,-50
"1315","2867三商壽","110/09/03","台新-台中",102,2,100
"1316","2867三商壽","110/09/03","凱基-林口",0,50,-50
"1317","2867三商壽","110/09/03","新加坡商瑞銀",60,0,60
"1318","2867三商壽","110/09/03","國泰-台中",5,53,-48
"1319","2867三商壽","110/09/03","元大-前金",60,0,60
"1320","2867三商壽","110/09/03","宏遠-台中",0,44,-44
"1321","5521工信","110/09/03","摩根大通",434,12,422
"1322","5521工信","110/09/03","元大-成功",0,185,-185
"1323","5521工信","110/09/03","美林",175,1,174
"1324","5521工信","110/09/03","光和-溪湖",5,155,-150
"1325","5521工信","110/09/03","台新證券",175,29,146
"1326","5521工信","110/09/03","富邦-員林",2,108,-106
"1327","5521工信","110/09/03","康和-澎湖",110,0,110
"1328","5521工信","110/09/03","日盛-板橋中山",0,103,-103
"1329","5521工信","110/09/03","瑞士信貸",77,0,77
"1330","5521工信","110/09/03","大慶",0,100,-100
"1331","5521工信","110/09/03","美商高盛",72,0,72
"1332","5521工信","110/09/03","富邦-南屯",0,100,-100
"1333","5521工信","110/09/03","港商法國興業",72,0,72
"1334","5521工信","110/09/03","國泰-高雄",7,100,-93
"1335","5521工信","110/09/03","光和-花壇",60,0,60
"1336","5521工信","110/09/03","凱基-台北",620,701,-81
"1337","5521工信","110/09/03","第一金-豐原",50,0,50
"1338","5521工信","110/09/03","凱基-斗六",0,73,-73
"1339","5521工信","110/09/03","玉山-左營",50,2,48
"1340","5521工信","110/09/03","元大-林森",1,68,-67
"1341","5521工信","110/09/03","港商野村",45,0,45
"1342","5521工信","110/09/03","元富-板橋",0,64,-64
"1343","5521工信","110/09/03","富邦-台北",51,14,37
"1344","5521工信","110/09/03","華南永昌-民權",0,50,-50
"1345","5521工信","110/09/03","(牛牛牛)亞-鑫豐",45,13,32
"1346","5521工信","110/09/03","元大證券",0,50,-50
"1347","5521工信","110/09/03","群益金鼎-萬華",27,0,27
"1348","5521工信","110/09/03","元大-大里德芳",0,50,-50
"1349","5521工信","110/09/03","台灣摩根士丹利",39,16,23
"1350","5521工信","110/09/03","兆豐-三民",0,43,-43
"1351","1471首利","110/09/03","台新-松江",39,0,39
"1352","1471首利","110/09/03","元大-路竹",0,121,-121
"1353","1471首利","110/09/03","元大-西門",27,0,27
"1354","1471首利","110/09/03","日盛-文化",0,50,-50
"1355","1471首利","110/09/03","富邦-新竹",22,0,22
"1356","1471首利","110/09/03","大慶-蘆洲",0,20,-20
"1357","1471首利","110/09/03","日盛-景美",20,0,20
"1358","1471首利","110/09/03","摩根大通",14,29,-15
"1359","1471首利","110/09/03","日盛-大墩",18,0,18
"1360","1471首利","110/09/03","聯邦-高雄",0,14,-14
"1361","1471首利","110/09/03","元富-民權",15,0,15
"1362","1471首利","110/09/03","臺銀",1,14,-13
"1363","1471首利","110/09/03","群益金鼎-桃園",15,0,15
"1364","1471首利","110/09/03","臺銀-臺中",0,11,-11
"1365","1471首利","110/09/03","凱基-三多",15,0,15
"1366","1471首利","110/09/03","兆豐-麻豆",0,10,-10
"1367","1471首利","110/09/03","兆豐-桃園",14,0,14
"1368","1471首利","110/09/03","兆豐-高雄",0,10,-10
"1369","1471首利","110/09/03","統一-新台中",13,0,13
"1370","1471首利","110/09/03","國票-嘉義",0,10,-10
"1371","1471首利","110/09/03","花旗環球",11,0,11
"1372","1471首利","110/09/03","聯邦-大業",0,10,-10
"1373","1471首利","110/09/03","凱基-東勢",10,0,10
"1374","1471首利","110/09/03","華南永昌-鳳山",0,10,-10
"1375","1471首利","110/09/03","華南永昌-公誠",10,0,10
"1376","1471首利","110/09/03","富邦-嘉義",0,10,-10
"1377","1471首利","110/09/03","元大-鳳山",10,0,10
"1378","1471首利","110/09/03","元大-楊梅",0,10,-10
"1379","1471首利","110/09/03","國泰-敦南",12,3,9
"1380","1471首利","110/09/03","元富-宜蘭",1,10,-9
"1381","2883開發金","110/09/03","凱基-台北",2700,224,2476
"1382","2883開發金","110/09/03","國泰證券",41,2505,-2464
"1383","2883開發金","110/09/03","美商高盛",1463,120,1343
"1384","2883開發金","110/09/03","台灣摩根士丹利",981,3375,-2394
"1385","2883開發金","110/09/03","新加坡商瑞銀",1717,492,1225
"1386","2883開發金","110/09/03","亞東-新竹",1,1198,-1197
"1387","2883開發金","110/09/03","美林",1358,164,1194
"1388","2883開發金","110/09/03","富邦-內湖",60,1193,-1133
"1389","2883開發金","110/09/03","花旗環球",1093,0,1093
"1390","2883開發金","110/09/03","華南永昌-竹北",0,859,-859
"1391","2883開發金","110/09/03","元大-林森",805,1,804
"1392","2883開發金","110/09/03","富邦-台北",24,613,-589
"1393","2883開發金","110/09/03","摩根大通",941,308,633
"1394","2883開發金","110/09/03","元大-四維",4,530,-526
"1395","2883開發金","110/09/03","凱基-中壢",656,28,628
"1396","2883開發金","110/09/03","第一金-豐原",12,404,-392
"1397","2883開發金","110/09/03","玉山證券",706,97,609
"1398","2883開發金","110/09/03","元大-苗栗",0,386,-386
"1399","2883開發金","110/09/03","港商野村",757,239,518
"1400","2883開發金","110/09/03","亞東-台中",0,321,-321
"1401","2883開發金","110/09/03","永豐金-台南",447,10,437
"1402","2883開發金","110/09/03","新光-台南",58,377,-319
"1403","2883開發金","110/09/03","法銀巴黎",434,0,434
"1404","2883開發金","110/09/03","康和-延平",1,300,-299
"1405","2883開發金","110/09/03","元大-成功",475,46,429
"1406","2883開發金","110/09/03","國泰-新莊",4,278,-274
"1407","2883開發金","110/09/03","元大-民雄",310,3,307
"1408","2883開發金","110/09/03","國泰-敦南",125,383,-258
"1409","2883開發金","110/09/03","臺銀-鳳山",321,19,302
"1410","2883開發金","110/09/03","國泰-館前",52,293,-241
"1411","6205詮欣","110/09/03","元大-汐止",16,3,13
"1412","6205詮欣","110/09/03","元大-中和",0,26,-26
"1413","6205詮欣","110/09/03","美林",9,0,9
"1414","6205詮欣","110/09/03","日盛-木柵",0,6,-6
"1415","6205詮欣","110/09/03","摩根大通",8,0,8
"1416","6205詮欣","110/09/03","元富-花蓮",0,5,-5
"1417","6205詮欣","110/09/03","凱基-台北",6,0,6
"1418","6205詮欣","110/09/03","華南永昌-東昇",0,5,-5
"1419","6205詮欣","110/09/03","新光",5,0,5
"1420","6205詮欣","110/09/03","元大-基隆孝二",0,5,-5
"1421","6205詮欣","110/09/03","永豐金證券",5,0,5
"1422","6205詮欣","110/09/03","富邦-板橋",0,4,-4
"1423","6205詮欣","110/09/03","瑞士信貸",4,0,4
"1424","6205詮欣","110/09/03","永豐金-新竹",0,4,-4
"1425","6205詮欣","110/09/03","花旗環球",4,0,4
"1426","6205詮欣","110/09/03","亞東",0,2,-2
"1427","6205詮欣","110/09/03","玉山-城中",3,0,3
"1428","6205詮欣","110/09/03","光和",0,2,-2
"1429","6205詮欣","110/09/03","元大-崇德",3,0,3
"1430","6205詮欣","110/09/03","兆豐-台中",0,2,-2
"1431","6205詮欣","110/09/03","元大-新店中正",3,0,3
"1432","6205詮欣","110/09/03","兆豐-岡山",0,2,-2
"1433","6205詮欣","110/09/03","日盛-新莊",2,0,2
"1434","6205詮欣","110/09/03","富邦-仁愛",0,2,-2
"1435","6205詮欣","110/09/03","新光-桃園",3,1,2
"1436","6205詮欣","110/09/03","第一金-新興",0,1,-1
"1437","6205詮欣","110/09/03","凱基",2,0,2
"1438","6205詮欣","110/09/03","元富-同大",0,1,-1
"1439","6205詮欣","110/09/03","元大-大安",2,0,2
"1440","6205詮欣","110/09/03","元富-桃園",0,1,-1
"1441","1540喬福","110/09/03","國票-台南",6,0,6
"1442","1540喬福","110/09/03","亞東-高雄",0,6,-6
"1443","1540喬福","110/09/03","群益金鼎-館前",6,0,6
"1444","1540喬福","110/09/03","元大-龍潭",0,6,-6
"1445","1540喬福","110/09/03","凱基",6,0,6
"1446","1540喬福","110/09/03","兆豐-鹿港",0,3,-3
"1447","1540喬福","110/09/03","花旗環球",5,0,5
"1448","1540喬福","110/09/03","群益金鼎-永和",0,2,-2
"1449","1540喬福","110/09/03","元大-鳳中",1,0,1
"1450","1540喬福","110/09/03","永豐金-忠孝",0,1,-1
"1451","1540喬福","110/09/03","元大-土城永寧",1,0,1
"1452","1540喬福","110/09/03","美林",0,1,-1
"1453","1540喬福","110/09/03","日盛-土城",1,1,0
"1454","1540喬福","110/09/03","元富",0,1,-1
"1455","1540喬福","110/09/03","新光",0,0,0
"1456","1540喬福","110/09/03","元富-虎尾",0,1,-1
"1457","1540喬福","110/09/03","玉山-台中",0,0,0
"1458","1540喬福","110/09/03","中國信託-新竹",0,1,-1
"1459","1540喬福","110/09/03","國泰-敦南",0,0,0
"1460","1540喬福","110/09/03","新光-新竹",0,1,-1
"1461","1540喬福","110/09/03","群益金鼎-北高雄",0,0,0
"1462","1540喬福","110/09/03","土銀-和平",0,1,-1
"1463","1540喬福","110/09/03","華南永昌-高雄",0,0,0
"1464","1540喬福","110/09/03","元大-台北",0,1,-1
"1465","1540喬福","110/09/03","華南永昌-苗栗",0,0,0
"1466","1540喬福","110/09/03","群益金鼎-台中",0,1,-1
"1467","1540喬福","110/09/03","富邦-北港",0,0,0
"1468","1540喬福","110/09/03","國泰-敦南",0,0,0
"1469","1540喬福","110/09/03","元大-新竹經國",0,0,0
"1470","1540喬福","110/09/03","元大-新竹經國",0,0,0
"1471","2888新光金","110/09/03","元大-館前",4899,31,4868
"1472","2888新光金","110/09/03","永豐金證券",17,2041,-2024
"1473","2888新光金","110/09/03","摩根大通",2598,419,2179
"1474","2888新光金","110/09/03","元大證券",32,1634,-1602
"1475","2888新光金","110/09/03","美林",2132,22,2110
"1476","2888新光金","110/09/03","瑞士信貸",706,1308,-602
"1477","2888新光金","110/09/03","永豐金-板橋",2028,227,1801
"1478","2888新光金","110/09/03","群益金鼎-台中",8,554,-546
"1479","2888新光金","110/09/03","凱基-台北",2476,1063,1413
"1480","2888新光金","110/09/03","元大-大甲",18,557,-539
"1481","2888新光金","110/09/03","花旗環球",1073,0,1073
"1482","2888新光金","110/09/03","宏遠-桃園",0,520,-520
"1483","2888新光金","110/09/03","新加坡商瑞銀",936,0,936
"1484","2888新光金","110/09/03","日盛-雙和",2,515,-513
"1485","2888新光金","110/09/03","凱基",789,0,789
"1486","2888新光金","110/09/03","統一-台中",101,595,-494
"1487","2888新光金","110/09/03","元大-苑裡",512,1,511
"1488","2888新光金","110/09/03","國票-嘉義",5,407,-402
"1489","2888新光金","110/09/03","(牛牛牛)亞-鑫豐",570,231,339
"1490","2888新光金","110/09/03","元大-景美",8,372,-364
"1491","2888新光金","110/09/03","元大-彰化民生",413,104,309
"1492","2888新光金","110/09/03","永全-南崁",0,361,-361
"1493","2888新光金","110/09/03","台新-新營",318,13,305
"1494","2888新光金","110/09/03","新光",273,603,-330
"1495","2888新光金","110/09/03","法銀巴黎",300,0,300
"1496","2888新光金","110/09/03","凱基-頭份",0,303,-303
"1497","2888新光金","110/09/03","日進",300,8,292
"1498","2888新光金","110/09/03","合庫證券",60,335,-275
"1499","2888新光金","110/09/03","台灣摩根士丹利",494,257,237
"1500","2888新光金","110/09/03","統一-板橋",112,361,-249
"1501","1340勝悅","110/09/03","元大-前金",63,0,63
"1502","1340勝悅","110/09/03","台中銀",0,26,-26
"1503","1340勝悅","110/09/03","玉山-新竹",20,0,20
"1504","1340勝悅","110/09/03","元大-忠孝鼎富",0,15,-15
"1505","1340勝悅","110/09/03","摩根大通",13,3,10
"1506","1340勝悅","110/09/03","統一-宜蘭",0,11,-11
"1507","1340勝悅","110/09/03","花旗環球",7,0,7
"1508","1340勝悅","110/09/03","合庫-西台中",0,10,-10
"1509","1340勝悅","110/09/03","港商法國興業",6,0,6
"1510","1340勝悅","110/09/03","大昌-新店",0,10,-10
"1511","1340勝悅","110/09/03","瑞士信貸",4,0,4
"1512","1340勝悅","110/09/03","宏遠-桃園",0,8,-8
"1513","1340勝悅","110/09/03","凱基-台北",5,1,4
"1514","1340勝悅","110/09/03","(牛牛牛)亞-鑫豐",0,7,-7
"1515","1340勝悅","110/09/03","美商高盛",3,0,3
"1516","1340勝悅","110/09/03","玉山-桃園",0,7,-7
"1517","1340勝悅","110/09/03","大昌-樹林",3,0,3
"1518","1340勝悅","110/09/03","凱基-北門",0,7,-7
"1519","1340勝悅","110/09/03","凱基",3,0,3
"1520","1340勝悅","110/09/03","新光",1,7,-6
"1521","1340勝悅","110/09/03","元大-大雅",3,0,3
"1522","1340勝悅","110/09/03","統一-城中",0,5,-5
"1523","1340勝悅","110/09/03","元大-和平",3,0,3
"1524","1340勝悅","110/09/03","富邦-陽明",0,4,-4
"1525","1340勝悅","110/09/03","中國信託-文心",2,0,2
"1526","1340勝悅","110/09/03","元大-敦南",0,4,-4
"1527","1340勝悅","110/09/03","凱基-湖口",2,0,2
"1528","1340勝悅","110/09/03","日盛-員林",1,4,-3
"1529","1340勝悅","110/09/03","富邦-北港",2,0,2
"1530","1340勝悅","110/09/03","國泰-敦南",1,4,-3
"1531","6246臺龍","110/09/03","富邦-新竹",11,0,11
"1532","6246臺龍","110/09/03","元富-新店",0,11,-11
"1533","6246臺龍","110/09/03","統一-土城",9,1,8
"1534","6246臺龍","110/09/03","大慶-苗栗",0,8,-8
"1535","6246臺龍","110/09/03","群益金鼎-古亭",7,0,7
"1536","6246臺龍","110/09/03","港商野村",1,8,-7
"1537","6246臺龍","110/09/03","凱基-台北",5,0,5
"1538","6246臺龍","110/09/03","華南永昌-彰化",0,6,-6
"1539","6246臺龍","110/09/03","元富-屏東",4,0,4
"1540","6246臺龍","110/09/03","群益金鼎-永和",0,5,-5
"1541","6246臺龍","110/09/03","日盛-大墩",3,0,3
"1542","6246臺龍","110/09/03","富邦-彰化",0,5,-5
"1543","6246臺龍","110/09/03","元富-台中",3,0,3
"1544","6246臺龍","110/09/03","華南永昌-楠梓",0,4,-4
"1545","6246臺龍","110/09/03","元大-台中中港",3,0,3
"1546","6246臺龍","110/09/03","中國信託-永康",0,2,-2
"1547","6246臺龍","110/09/03","永豐金-苓雅",3,0,3
"1548","6246臺龍","110/09/03","臺銀-金山",0,1,-1
"1549","6246臺龍","110/09/03","日盛-中和",1,0,1
"1550","6246臺龍","110/09/03","第一金-台南",0,1,-1
"1551","6246臺龍","110/09/03","盈溢-楠梓",1,0,1
"1552","6246臺龍","110/09/03","兆豐-岡山",0,1,-1
"1553","6246臺龍","110/09/03","兆豐-新營",1,0,1
"1554","6246臺龍","110/09/03","台新-台中",0,1,-1
"1555","6246臺龍","110/09/03","台新-屏東",2,1,1
"1556","6246臺龍","110/09/03","國泰-桃園",0,1,-1
"1557","6246臺龍","110/09/03","玉山證券",1,0,1
"1558","6246臺龍","110/09/03","群益金鼎-東門",0,1,-1
"1559","6246臺龍","110/09/03","玉山-嘉義",1,0,1
"1560","6246臺龍","110/09/03","華南永昌",0,1,-1
"1561","00715L期街口布蘭特正2","110/09/03","元大證券",14101,122,13979
"1562","00715L期街口布蘭特正2","110/09/03","第一金-台中",2,4435,-4433
"1563","00715L期街口布蘭特正2","110/09/03","永豐金證券",6178,185,5993
"1564","00715L期街口布蘭特正2","110/09/03","豐農",0,1100,-1100
"1565","00715L期街口布蘭特正2","110/09/03","群益金鼎",4720,0,4720
"1566","00715L期街口布蘭特正2","110/09/03","國泰-板橋",0,1068,-1068
"1567","00715L期街口布蘭特正2","110/09/03","凱基-台北",3427,108,3319
"1568","00715L期街口布蘭特正2","110/09/03","群益金鼎-士林",0,900,-900
"1569","00715L期街口布蘭特正2","110/09/03","國票",2729,7,2722
"1570","00715L期街口布蘭特正2","110/09/03","元大-復北",0,890,-890
"1571","00715L期街口布蘭特正2","110/09/03","凱基-市政",2138,7,2131
"1572","00715L期街口布蘭特正2","110/09/03","永豐金-羅東",0,734,-734
"1573","00715L期街口布蘭特正2","110/09/03","富邦證券",1801,266,1535
"1574","00715L期街口布蘭特正2","110/09/03","群益金鼎-板橋",0,720,-720
"1575","00715L期街口布蘭特正2","110/09/03","永豐金-內湖",1500,0,1500
"1576","00715L期街口布蘭特正2","110/09/03","群益金鼎-宜蘭",0,707,-707
"1577","00715L期街口布蘭特正2","110/09/03","元富",1509,29,1480
"1578","00715L期街口布蘭特正2","110/09/03","日盛-新莊",0,666,-666
"1579","00715L期街口布蘭特正2","110/09/03","合庫證券",1190,9,1181
"1580","00715L期街口布蘭特正2","110/09/03","群益金鼎-大甲",14,652,-638
"1581","00715L期街口布蘭特正2","110/09/03","國票-中港",1000,40,960
"1582","00715L期街口布蘭特正2","110/09/03","日盛-和美",6,616,-610
"1583","00715L期街口布蘭特正2","110/09/03","康和",957,0,957
"1584","00715L期街口布蘭特正2","110/09/03","元大-大灣",0,599,-599
"1585","00715L期街口布蘭特正2","110/09/03","統一",720,9,711
"1586","00715L期街口布蘭特正2","110/09/03","中國信託-新竹",0,460,-460
"1587","00715L期街口布蘭特正2","110/09/03","永豐金-三重",625,1,624
"1588","00715L期街口布蘭特正2","110/09/03","玉山-高雄",25,478,-453
"1589","00715L期街口布蘭特正2","110/09/03","永豐金-博愛",500,20,480
"1590","00715L期街口布蘭特正2","110/09/03","宏遠-光隆",0,435,-435
"1591","8941關中","110/09/03","元大-士林",2,0,2
"1592","8941關中","110/09/03","彰銀-台中",0,1,-1
"1593","8941關中","110/09/03","國泰-新莊",1,0,1
"1594","8941關中","110/09/03","玉山-桃園",0,1,-1
"1595","8941關中","110/09/03","凱基-虎尾",1,0,1
"1596","8941關中","110/09/03","元大-豐原",0,1,-1
"1597","8941關中","110/09/03","國泰-高雄",0,0,0
"1598","8941關中","110/09/03","元大-金華",0,1,-1
"1599","8941關中","110/09/03","元大-斗信",0,0,0
"1600","8941關中","110/09/03","國泰-高雄",0,0,0
"1601","8941關中","110/09/03","元大-鹿港",0,0,0
"1602","8941關中","110/09/03","元大-斗信",0,0,0
"1603","8941關中","110/09/03","",NA,NA,NA
"1604","8941關中","110/09/03","元大-鹿港",0,0,0
"1605","8941關中","110/09/03","",NA,NA,NA
"1606","8941關中","110/09/03","",NA,NA,NA
"1607","8941關中","110/09/03","",NA,NA,NA
"1608","8941關中","110/09/03","",NA,NA,NA
"1609","8941關中","110/09/03","",NA,NA,NA
"1610","8941關中","110/09/03","",NA,NA,NA
"1611","8941關中","110/09/03","",NA,NA,NA
"1612","8941關中","110/09/03","",NA,NA,NA
"1613","8941關中","110/09/03","",NA,NA,NA
"1614","8941關中","110/09/03","",NA,NA,NA
"1615","8941關中","110/09/03","",NA,NA,NA
"1616","8941關中","110/09/03","",NA,NA,NA
"1617","8941關中","110/09/03","",NA,NA,NA
"1618","8941關中","110/09/03","",NA,NA,NA
"1619","8941關中","110/09/03","",NA,NA,NA
"1620","8941關中","110/09/03","",NA,NA,NA
"1621","8936國統","110/09/03","華南永昌-高雄",405,0,405
"1622","8936國統","110/09/03","美商高盛",24,188,-164
"1623","8936國統","110/09/03","凱基-台北",306,200,106
"1624","8936國統","110/09/03","台新證券",8,165,-157
"1625","8936國統","110/09/03","第一金-路竹",85,0,85
"1626","8936國統","110/09/03","摩根大通",65,214,-149
"1627","8936國統","110/09/03","凱基-信義",54,0,54
"1628","8936國統","110/09/03","瑞士信貸",0,105,-105
"1629","8936國統","110/09/03","康和-高雄",41,0,41
"1630","8936國統","110/09/03","新加坡商瑞銀",115,216,-101
"1631","8936國統","110/09/03","元大-東泰",61,24,37
"1632","8936國統","110/09/03","合庫-自強",0,100,-100
"1633","8936國統","110/09/03","日盛-北高雄",40,5,35
"1634","8936國統","110/09/03","國泰-高雄",2,100,-98
"1635","8936國統","110/09/03","台新-高雄",36,10,26
"1636","8936國統","110/09/03","合庫-高雄",1,95,-94
"1637","8936國統","110/09/03","統一-新台中",27,2,25
"1638","8936國統","110/09/03","國票-北高雄",2,90,-88
"1639","8936國統","110/09/03","永豐金-竹科",22,0,22
"1640","8936國統","110/09/03","中國信託-高雄",13,100,-87
"1641","8936國統","110/09/03","元大-博愛",22,1,21
"1642","8936國統","110/09/03","港商野村",91,173,-82
"1643","8936國統","110/09/03","元大-鳳山",22,1,21
"1644","8936國統","110/09/03","元富-敦南",17,92,-75
"1645","8936國統","110/09/03","統一-桃園",20,0,20
"1646","8936國統","110/09/03","元大-高雄",2,50,-48
"1647","8936國統","110/09/03","元富-林園",20,0,20
"1648","8936國統","110/09/03","元大-莒光",2,49,-47
"1649","8936國統","110/09/03","元富-緯城",25,5,20
"1650","8936國統","110/09/03","光和-溪湖",3,44,-41
"1651","6226光鼎","110/09/03","台新-台中",348,25,323
"1652","6226光鼎","110/09/03","合庫-台中",0,229,-229
"1653","6226光鼎","110/09/03","摩根大通",251,83,168
"1654","6226光鼎","110/09/03","大展-台南",0,130,-130
"1655","6226光鼎","110/09/03","美林",203,44,159
"1656","6226光鼎","110/09/03","台新-左楠",0,110,-110
"1657","6226光鼎","110/09/03","美商高盛",158,11,147
"1658","6226光鼎","110/09/03","玉山-士林",8,62,-54
"1659","6226光鼎","110/09/03","凱基-台北",141,41,100
"1660","6226光鼎","110/09/03","群益金鼎-開元",31,83,-52
"1661","6226光鼎","110/09/03","臺銀-新竹",72,1,71
"1662","6226光鼎","110/09/03","群益金鼎-西松",1,50,-49
"1663","6226光鼎","110/09/03","大慶-富順",60,0,60
"1664","6226光鼎","110/09/03","元大-板橋三民",14,61,-47
"1665","6226光鼎","110/09/03","凱基-岡山",60,1,59
"1666","6226光鼎","110/09/03","統一-竹南",1,47,-46
"1667","6226光鼎","110/09/03","第一金-桃園",52,0,52
"1668","6226光鼎","110/09/03","日盛-新竹",1,41,-40
"1669","6226光鼎","110/09/03","新加坡商瑞銀",59,9,50
"1670","6226光鼎","110/09/03","元大-員林中山",12,47,-35
"1671","6226光鼎","110/09/03","元大-中壢",70,24,46
"1672","6226光鼎","110/09/03","國泰-館前",35,67,-32
"1673","6226光鼎","110/09/03","元大-新營",46,4,42
"1674","6226光鼎","110/09/03","元大-新莊",4,35,-31
"1675","6226光鼎","110/09/03","華南永昌-世貿",42,1,41
"1676","6226光鼎","110/09/03","元富-敦南",0,30,-30
"1677","6226光鼎","110/09/03","群益金鼎-新竹",38,0,38
"1678","6226光鼎","110/09/03","群益金鼎-台北",6,36,-30
"1679","6226光鼎","110/09/03","元大-路竹",38,2,36
"1680","6226光鼎","110/09/03","元大-大雅",5,34,-29
"1681","2363矽統","110/09/03","凱基-松山",21948,12385,9563
"1682","2363矽統","110/09/03","元大-前金",139,785,-646
"1683","2363矽統","110/09/03","台灣摩根士丹利",5089,3,5086
"1684","2363矽統","110/09/03","國泰-敦南",1244,1857,-613
"1685","2363矽統","110/09/03","統一",4355,245,4110
"1686","2363矽統","110/09/03","新光",893,1469,-576
"1687","2363矽統","110/09/03","摩根大通",5484,2094,3390
"1688","2363矽統","110/09/03","統一-南京",33,497,-464
"1689","2363矽統","110/09/03","凱基-台北",5687,3262,2425
"1690","2363矽統","110/09/03","永豐金-竹科",24,456,-432
"1691","2363矽統","110/09/03","美商高盛",1980,496,1484
"1692","2363矽統","110/09/03","元大-佳里",77,479,-402
"1693","2363矽統","110/09/03","瑞士信貸",1319,12,1307
"1694","2363矽統","110/09/03","群益金鼎-士林",103,503,-400
"1695","2363矽統","110/09/03","統一-土城",1030,41,989
"1696","2363矽統","110/09/03","富邦-彰化",33,393,-360
"1697","2363矽統","110/09/03","日盛-文化",1068,94,974
"1698","2363矽統","110/09/03","華南永昌-公誠",101,459,-358
"1699","2363矽統","110/09/03","凱基-大直",1064,92,972
"1700","2363矽統","110/09/03","台新-左楠",85,441,-356
"1701","2363矽統","110/09/03","新加坡商瑞銀",1692,905,787
"1702","2363矽統","110/09/03","日盛-和美",64,387,-323
"1703","2363矽統","110/09/03","富邦-北港",921,155,766
"1704","2363矽統","110/09/03","光和-和美",7,324,-317
"1705","2363矽統","110/09/03","康和",1172,512,660
"1706","2363矽統","110/09/03","富邦-新竹",198,503,-305
"1707","2363矽統","110/09/03","美林",717,85,632
"1708","2363矽統","110/09/03","凱基-士林",68,364,-296
"1709","2363矽統","110/09/03","永豐金證券",1674,1126,548
"1710","2363矽統","110/09/03","永豐金-南投",60,355,-295
"1711","8112至上","110/09/03","凱基-台北",204,76,128
"1712","8112至上","110/09/03","元大-信義",0,185,-185
"1713","8112至上","110/09/03","美林",146,20,126
"1714","8112至上","110/09/03","富邦-北港",0,70,-70
"1715","8112至上","110/09/03","瑞士信貸",78,0,78
"1716","8112至上","110/09/03","華南永昌-鳳山",0,54,-54
"1717","8112至上","110/09/03","國票-南京",45,0,45
"1718","8112至上","110/09/03","富邦-新竹",2,49,-47
"1719","8112至上","110/09/03","永豐金-竹科",36,0,36
"1720","8112至上","110/09/03","臺灣企銀-桃園",1,45,-44
"1721","8112至上","110/09/03","群益金鼎-士林",25,0,25
"1722","8112至上","110/09/03","元大-北港",8,48,-40
"1723","8112至上","110/09/03","凱基-長庚",25,0,25
"1724","8112至上","110/09/03","國票-九鼎",0,34,-34
"1725","8112至上","110/09/03","美商高盛",23,1,22
"1726","8112至上","110/09/03","摩根大通",85,119,-34
"1727","8112至上","110/09/03","元富-古亭",20,0,20
"1728","8112至上","110/09/03","中國信託",0,20,-20
"1729","8112至上","110/09/03","凱基-文心",20,0,20
"1730","8112至上","110/09/03","永全",0,20,-20
"1731","8112至上","110/09/03","台新證券",19,0,19
"1732","8112至上","110/09/03","富邦-南屯",0,20,-20
"1733","8112至上","110/09/03","(牛牛牛)亞-鑫豐",18,2,16
"1734","8112至上","110/09/03","中國信託-中壢",0,16,-16
"1735","8112至上","110/09/03","凱基-市政",15,0,15
"1736","8112至上","110/09/03","新光-桃園",0,15,-15
"1737","8112至上","110/09/03","元大-善化",15,0,15
"1738","8112至上","110/09/03","元大-林園",0,15,-15
"1739","8112至上","110/09/03","元大-嘉義",15,0,15
"1740","8112至上","110/09/03","宏遠-館前",0,13,-13
"1741","1570力肯","110/09/03","大展",39,0,39
"1742","1570力肯","110/09/03","元大-北成功",0,35,-35
"1743","1570力肯","110/09/03","宏遠證券",35,0,35
"1744","1570力肯","110/09/03","元大-新店中正",0,30,-30
"1745","1570力肯","110/09/03","元大-北三重",16,0,16
"1746","1570力肯","110/09/03","新光",20,43,-23
"1747","1570力肯","110/09/03","元大-新竹經國",15,0,15
"1748","1570力肯","110/09/03","兆豐-寶成",0,18,-18
"1749","1570力肯","110/09/03","大昌",10,0,10
"1750","1570力肯","110/09/03","兆豐-公益",0,15,-15
"1751","1570力肯","110/09/03","兆豐-彰化",10,0,10
"1752","1570力肯","110/09/03","兆豐-嘉義",0,14,-14
"1753","1570力肯","110/09/03","凱基-永康",10,0,10
"1754","1570力肯","110/09/03","國票-博愛",0,9,-9
"1755","1570力肯","110/09/03","元大-內湖",10,0,10
"1756","1570力肯","110/09/03","元大-東泰",0,9,-9
"1757","1570力肯","110/09/03","瑞士信貸",8,0,8
"1758","1570力肯","110/09/03","元大-竹南",0,9,-9
"1759","1570力肯","110/09/03","國泰-台中",6,0,6
"1760","1570力肯","110/09/03","永豐金-虎尾",0,7,-7
"1761","1570力肯","110/09/03","康和-台中",5,0,5
"1762","1570力肯","110/09/03","大慶-泰山",0,6,-6
"1763","1570力肯","110/09/03","凱基-三峽",5,0,5
"1764","1570力肯","110/09/03","元富-敦南",0,6,-6
"1765","1570力肯","110/09/03","華南永昌-苑裡",5,0,5
"1766","1570力肯","110/09/03","凱基-文心",0,6,-6
"1767","1570力肯","110/09/03","元富-緯城",4,0,4
"1768","1570力肯","110/09/03","合庫-台中",0,5,-5
"1769","1570力肯","110/09/03","台新證券",5,1,4
"1770","1570力肯","110/09/03","富邦-內湖",0,5,-5
"1771","2929淘帝","110/09/03","摩根大通",27,0,27
"1772","2929淘帝","110/09/03","兆豐-新營",0,11,-11
"1773","2929淘帝","110/09/03","兆豐-大同",20,0,20
"1774","2929淘帝","110/09/03","日盛-台南",0,10,-10
"1775","2929淘帝","110/09/03","元大-前金",13,0,13
"1776","2929淘帝","110/09/03","元富-基隆",0,10,-10
"1777","2929淘帝","110/09/03","港商法國興業",6,0,6
"1778","2929淘帝","110/09/03","日盛-中壢",0,9,-9
"1779","2929淘帝","110/09/03","花旗環球",6,0,6
"1780","2929淘帝","110/09/03","新光",0,8,-8
"1781","2929淘帝","110/09/03","中國信託-高雄",5,0,5
"1782","2929淘帝","110/09/03","玉山-士林",0,7,-7
"1783","2929淘帝","110/09/03","美林",10,7,3
"1784","2929淘帝","110/09/03","元大-潮州",0,7,-7
"1785","2929淘帝","110/09/03","元富-世貿",3,0,3
"1786","2929淘帝","110/09/03","第一金-忠孝",0,5,-5
"1787","2929淘帝","110/09/03","新光-新竹",3,0,3
"1788","2929淘帝","110/09/03","台新-台中",0,5,-5
"1789","2929淘帝","110/09/03","陽信",3,0,3
"1790","2929淘帝","110/09/03","富邦-新竹",0,5,-5
"1791","2929淘帝","110/09/03","元富-文心",2,0,2
"1792","2929淘帝","110/09/03","國泰-敦南",0,4,-4
"1793","2929淘帝","110/09/03","台新-高雄",4,2,2
"1794","2929淘帝","110/09/03","元富-大裕",0,3,-3
"1795","2929淘帝","110/09/03","群益金鼎-三民",2,0,2
"1796","2929淘帝","110/09/03","富邦-仁愛",0,3,-3
"1797","2929淘帝","110/09/03","華南永昌-公誠",2,0,2
"1798","2929淘帝","110/09/03","富邦-台北",0,2,-2
"1799","2929淘帝","110/09/03","富邦-新店",1,0,1
"1800","2929淘帝","110/09/03","元大-斗六",0,2,-2
"1801","5410國眾","110/09/03","華南永昌-高雄",25,0,25
"1802","5410國眾","110/09/03","群益金鼎-中壢",0,50,-50
"1803","5410國眾","110/09/03","兆豐-嘉義",7,0,7
"1804","5410國眾","110/09/03","永豐金-萬盛",0,17,-17
"1805","5410國眾","110/09/03","凱基-中山",6,0,6
"1806","5410國眾","110/09/03","日盛-屏東",0,6,-6
"1807","5410國眾","110/09/03","國泰-台中",6,1,5
"1808","5410國眾","110/09/03","新光-台中",0,6,-6
"1809","5410國眾","110/09/03","群益金鼎-桃園",5,0,5
"1810","5410國眾","110/09/03","德信-和平",0,5,-5
"1811","5410國眾","110/09/03","富邦-台北",5,0,5
"1812","5410國眾","110/09/03","兆豐-桃園",0,5,-5
"1813","5410國眾","110/09/03","國票-北高雄",4,0,4
"1814","5410國眾","110/09/03","凱基-永康",0,3,-3
"1815","5410國眾","110/09/03","元大-和平",4,0,4
"1816","5410國眾","110/09/03","華南永昌-內壢",0,3,-3
"1817","5410國眾","110/09/03","宏遠-館前",3,0,3
"1818","5410國眾","110/09/03","元大-板橋",0,3,-3
"1819","5410國眾","110/09/03","國泰-敦南",3,0,3
"1820","5410國眾","110/09/03","玉山-新莊",0,2,-2
"1821","5410國眾","110/09/03","永豐金-桃園",3,0,3
"1822","5410國眾","110/09/03","群益金鼎-宜蘭",0,2,-2
"1823","5410國眾","110/09/03","臺銀-新竹",2,0,2
"1824","5410國眾","110/09/03","永豐金-台南",0,2,-2
"1825","5410國眾","110/09/03","台灣企銀-建成",2,0,2
"1826","5410國眾","110/09/03","日盛-高雄",0,1,-1
"1827","5410國眾","110/09/03","中國信託-新竹",2,0,2
"1828","5410國眾","110/09/03","台新-建北",0,1,-1
"1829","5410國眾","110/09/03","富邦-新店",2,0,2
"1830","5410國眾","110/09/03","安泰",0,1,-1
"1831","2841台開","110/09/03","群益金鼎-彰化",150,0,150
"1832","2841台開","110/09/03","華南永昌-台南",1,96,-95
"1833","2841台開","110/09/03","群益金鼎-海山",50,0,50
"1834","2841台開","110/09/03","兆豐-北高雄",0,60,-60
"1835","2841台開","110/09/03","元大-天母",40,0,40
"1836","2841台開","110/09/03","統一-嘉義",0,50,-50
"1837","2841台開","110/09/03","永豐金-板橋",35,0,35
"1838","2841台開","110/09/03","富邦-新竹",0,50,-50
"1839","2841台開","110/09/03","元大-福營",20,0,20
"1840","2841台開","110/09/03","華南永昌-潮州",0,25,-25
"1841","2841台開","110/09/03","宏遠-館前",16,0,16
"1842","2841台開","110/09/03","元大-員林",0,11,-11
"1843","2841台開","110/09/03","元大-歸仁",14,0,14
"1844","2841台開","110/09/03","台新證券",0,10,-10
"1845","2841台開","110/09/03","富邦-岡山",10,0,10
"1846","2841台開","110/09/03","永豐金-敦南",65,75,-10
"1847","2841台開","110/09/03","富邦-建國",6,0,6
"1848","2841台開","110/09/03","日盛證券",5,13,-8
"1849","2841台開","110/09/03","台中銀",5,0,5
"1850","2841台開","110/09/03","永豐金-高雄",0,6,-6
"1851","2841台開","110/09/03","台新-新營",3,0,3
"1852","2841台開","110/09/03","大昌-安康",23,28,-5
"1853","2841台開","110/09/03","群益金鼎-崇德",3,0,3
"1854","2841台開","110/09/03","國泰-館前",0,5,-5
"1855","2841台開","110/09/03","中國信託",2,0,2
"1856","2841台開","110/09/03","新光-桃園",0,4,-4
"1857","2841台開","110/09/03","中國信託-永康",2,0,2
"1858","2841台開","110/09/03","永豐金-桃園",0,4,-4
"1859","2841台開","110/09/03","國泰-台中",2,0,2
"1860","2841台開","110/09/03","兆豐-三民",0,3,-3
"1861","6207雷科","110/09/03","凱基-高美館",41,0,41
"1862","6207雷科","110/09/03","(牛牛牛)亞-鑫豐",0,30,-30
"1863","6207雷科","110/09/03","新加坡商瑞銀",33,4,29
"1864","6207雷科","110/09/03","元大-北成功",0,15,-15
"1865","6207雷科","110/09/03","摩根大通",26,6,20
"1866","6207雷科","110/09/03","元富-板橋",0,10,-10
"1867","6207雷科","110/09/03","美林",16,0,16
"1868","6207雷科","110/09/03","光和-和美",0,10,-10
"1869","6207雷科","110/09/03","凱基-中山",12,0,12
"1870","6207雷科","110/09/03","康和-延平",0,10,-10
"1871","6207雷科","110/09/03","元大-高雄",15,3,12
"1872","6207雷科","110/09/03","元富-成功",0,9,-9
"1873","6207雷科","110/09/03","元大-大里",15,4,11
"1874","6207雷科","110/09/03","致和-金華",0,7,-7
"1875","6207雷科","110/09/03","元大-大統",11,0,11
"1876","6207雷科","110/09/03","凱基-南崁",0,7,-7
"1877","6207雷科","110/09/03","凱基-台北",17,8,9
"1878","6207雷科","110/09/03","新光-台中",0,6,-6
"1879","6207雷科","110/09/03","美商高盛",8,1,7
"1880","6207雷科","110/09/03","玉山-台南",0,6,-6
"1881","6207雷科","110/09/03","宏遠-高雄",6,0,6
"1882","6207雷科","110/09/03","國泰-敦南",0,6,-6
"1883","6207雷科","110/09/03","富隆-長安",6,0,6
"1884","6207雷科","110/09/03","富邦-中壢",0,6,-6
"1885","6207雷科","110/09/03","統一-敦南",5,0,5
"1886","6207雷科","110/09/03","富邦-彰化",0,6,-6
"1887","6207雷科","110/09/03","元大-中壢",5,0,5
"1888","6207雷科","110/09/03","永豐金-板新",0,6,-6
"1889","6207雷科","110/09/03","群益金鼎-瑞豐",7,3,4
"1890","6207雷科","110/09/03","元大-四維",0,5,-5
"1891","3679新至陞","110/09/03","華南永昌-淡水",10,0,10
"1892","3679新至陞","110/09/03","元大-民生",0,8,-8
"1893","3679新至陞","110/09/03","花旗環球",4,0,4
"1894","3679新至陞","110/09/03","瑞士信貸",2,8,-6
"1895","3679新至陞","110/09/03","福邦-新竹",4,0,4
"1896","3679新至陞","110/09/03","美林",0,3,-3
"1897","3679新至陞","110/09/03","元大-大同",3,0,3
"1898","3679新至陞","110/09/03","第一金-澎湖",0,3,-3
"1899","3679新至陞","110/09/03","日盛-文化",2,0,2
"1900","3679新至陞","110/09/03","元大-板橋",0,3,-3
"1901","3679新至陞","110/09/03","國票-新莊",2,0,2
"1902","3679新至陞","110/09/03","宏遠-光隆",0,2,-2
"1903","3679新至陞","110/09/03","富邦-建國",2,0,2
"1904","3679新至陞","110/09/03","港商野村",0,2,-2
"1905","3679新至陞","110/09/03","元大-屏南",2,0,2
"1906","3679新至陞","110/09/03","高橋",0,2,-2
"1907","3679新至陞","110/09/03","日盛-三重",1,0,1
"1908","3679新至陞","110/09/03","元大證券",0,2,-2
"1909","3679新至陞","110/09/03","盈溢-楠梓",1,0,1
"1910","3679新至陞","110/09/03","元大-永春",2,4,-2
"1911","3679新至陞","110/09/03","元富-永和",1,0,1
"1912","3679新至陞","110/09/03","日盛-內湖",0,1,-1
"1913","3679新至陞","110/09/03","兆豐-西螺",1,0,1
"1914","3679新至陞","110/09/03","第一金-新竹",0,1,-1
"1915","3679新至陞","110/09/03","兆豐-彰化",1,0,1
"1916","3679新至陞","110/09/03","元富-松德",0,1,-1
"1917","3679新至陞","110/09/03","國泰-板橋",1,0,1
"1918","3679新至陞","110/09/03","台新-松江",0,1,-1
"1919","3679新至陞","110/09/03","群益金鼎-新莊",1,0,1
"1920","3679新至陞","110/09/03","安泰-大發",0,1,-1
"1921","2727王品","110/09/03","美商高盛",51,0,51
"1922","2727王品","110/09/03","第一金-台中",0,14,-14
"1923","2727王品","110/09/03","台灣摩根士丹利",37,6,31
"1924","2727王品","110/09/03","富邦-仁愛",0,11,-11
"1925","2727王品","110/09/03","港商野村",28,5,23
"1926","2727王品","110/09/03","日茂-埔里",0,10,-10
"1927","2727王品","110/09/03","凱基-台北",30,11,19
"1928","2727王品","110/09/03","摩根大通",12,21,-9
"1929","2727王品","110/09/03","美林",21,6,15
"1930","2727王品","110/09/03","新光",4,13,-9
"1931","2727王品","110/09/03","國泰-敦南",16,5,11
"1932","2727王品","110/09/03","元大-博愛",0,7,-7
"1933","2727王品","110/09/03","群益金鼎-士林",10,0,10
"1934","2727王品","110/09/03","兆豐-台南",0,6,-6
"1935","2727王品","110/09/03","玉山-板橋",10,2,8
"1936","2727王品","110/09/03","華南永昌-合泰",0,6,-6
"1937","2727王品","110/09/03","瑞士信貸",10,3,7
"1938","2727王品","110/09/03","日盛-木柵",0,5,-5
"1939","2727王品","110/09/03","永豐金-中盛",5,0,5
"1940","2727王品","110/09/03","玉山-嘉義",0,5,-5
"1941","2727王品","110/09/03","花旗環球",4,0,4
"1942","2727王品","110/09/03","富邦-陽明",0,5,-5
"1943","2727王品","110/09/03","元大-太平",4,0,4
"1944","2727王品","110/09/03","富邦-中壢",1,6,-5
"1945","2727王品","110/09/03","台新證券",4,1,3
"1946","2727王品","110/09/03","康和",0,4,-4
"1947","2727王品","110/09/03","國泰證券",3,0,3
"1948","2727王品","110/09/03","凱基-竹東",0,4,-4
"1949","2727王品","110/09/03","國泰-桃園",3,0,3
"1950","2727王品","110/09/03","元大-大雅",0,4,-4
"1951","1570力肯","110/09/03","大展",39,0,39
"1952","1570力肯","110/09/03","元大-北成功",0,35,-35
"1953","1570力肯","110/09/03","宏遠證券",35,0,35
"1954","1570力肯","110/09/03","元大-新店中正",0,30,-30
"1955","1570力肯","110/09/03","元大-北三重",16,0,16
"1956","1570力肯","110/09/03","新光",20,43,-23
"1957","1570力肯","110/09/03","元大-新竹經國",15,0,15
"1958","1570力肯","110/09/03","兆豐-寶成",0,18,-18
"1959","1570力肯","110/09/03","大昌",10,0,10
"1960","1570力肯","110/09/03","兆豐-公益",0,15,-15
"1961","1570力肯","110/09/03","兆豐-彰化",10,0,10
"1962","1570力肯","110/09/03","兆豐-嘉義",0,14,-14
"1963","1570力肯","110/09/03","凱基-永康",10,0,10
"1964","1570力肯","110/09/03","國票-博愛",0,9,-9
"1965","1570力肯","110/09/03","元大-內湖",10,0,10
"1966","1570力肯","110/09/03","元大-東泰",0,9,-9
"1967","1570力肯","110/09/03","瑞士信貸",8,0,8
"1968","1570力肯","110/09/03","元大-竹南",0,9,-9
"1969","1570力肯","110/09/03","國泰-台中",6,0,6
"1970","1570力肯","110/09/03","永豐金-虎尾",0,7,-7
"1971","1570力肯","110/09/03","康和-台中",5,0,5
"1972","1570力肯","110/09/03","大慶-泰山",0,6,-6
"1973","1570力肯","110/09/03","凱基-三峽",5,0,5
"1974","1570力肯","110/09/03","元富-敦南",0,6,-6
"1975","1570力肯","110/09/03","華南永昌-苑裡",5,0,5
"1976","1570力肯","110/09/03","凱基-文心",0,6,-6
"1977","1570力肯","110/09/03","元富-緯城",4,0,4
"1978","1570力肯","110/09/03","合庫-台中",0,5,-5
"1979","1570力肯","110/09/03","台新證券",5,1,4
"1980","1570力肯","110/09/03","富邦-內湖",0,5,-5
"1981","6180橘子","110/09/03","台灣摩根士丹利",93,9,84
"1982","6180橘子","110/09/03","康和-澎湖",0,20,-20
"1983","6180橘子","110/09/03","玉山-新莊",14,0,14
"1984","6180橘子","110/09/03","美林",0,14,-14
"1985","6180橘子","110/09/03","凱基-中壢",10,0,10
"1986","6180橘子","110/09/03","凱基-科園",0,10,-10
"1987","6180橘子","110/09/03","摩根大通",12,4,8
"1988","6180橘子","110/09/03","華南永昌-內壢",0,10,-10
"1989","6180橘子","110/09/03","大慶-苗栗",7,0,7
"1990","6180橘子","110/09/03","元大-大雅",4,14,-10
"1991","6180橘子","110/09/03","永豐金-大園",7,0,7
"1992","6180橘子","110/09/03","統一-士林",0,9,-9
"1993","6180橘子","110/09/03","日盛-桃園",5,0,5
"1994","6180橘子","110/09/03","元大-新店中正",0,9,-9
"1995","6180橘子","110/09/03","元富-彰化",5,0,5
"1996","6180橘子","110/09/03","群益金鼎-嘉義",0,8,-8
"1997","6180橘子","110/09/03","兆豐-高雄",5,0,5
"1998","6180橘子","110/09/03","致和證券",0,7,-7
"1999","6180橘子","110/09/03","國泰-敦南",7,2,5
"2000","6180橘子","110/09/03","元大-竹山",0,7,-7
"2001","6180橘子","110/09/03","群益金鼎-敦南",5,0,5
"2002","6180橘子","110/09/03","第一金-台中",0,6,-6
"2003","6180橘子","110/09/03","元大證券",5,0,5
"2004","6180橘子","110/09/03","第一金-中壢",0,5,-5
"2005","6180橘子","110/09/03","合庫-新竹",5,1,4
"2006","6180橘子","110/09/03","第一金-安和",0,5,-5
"2007","6180橘子","110/09/03","美商高盛",4,0,4
"2008","6180橘子","110/09/03","台新證券",2,7,-5
"2009","6180橘子","110/09/03","凱基-土城",4,0,4
"2010","6180橘子","110/09/03","合庫-台中",0,4,-4
"2011","2390云辰","110/09/03","摩根大通",667,46,621
"2012","2390云辰","110/09/03","統一-新台中",2,442,-440
"2013","2390云辰","110/09/03","新加坡商瑞銀",402,0,402
"2014","2390云辰","110/09/03","元富-草屯",5,364,-359
"2015","2390云辰","110/09/03","美商高盛",302,75,227
"2016","2390云辰","110/09/03","凱基-台中",12,184,-172
"2017","2390云辰","110/09/03","凱基-台北",256,86,170
"2018","2390云辰","110/09/03","元大-忠孝",1,150,-149
"2019","2390云辰","110/09/03","美林",116,9,107
"2020","2390云辰","110/09/03","日盛-新莊",29,174,-145
"2021","2390云辰","110/09/03","台灣摩根士丹利",156,73,83
"2022","2390云辰","110/09/03","國票-中和",10,120,-110
"2023","2390云辰","110/09/03","華南永昌-合泰",51,0,51
"2024","2390云辰","110/09/03","統一-新營",2,111,-109
"2025","2390云辰","110/09/03","元大-竹山",52,1,51
"2026","2390云辰","110/09/03","華南永昌-中正",91,173,-82
"2027","2390云辰","110/09/03","港商野村",98,51,47
"2028","2390云辰","110/09/03","元富-安南",2,72,-70
"2029","2390云辰","110/09/03","玉山-台中",46,2,44
"2030","2390云辰","110/09/03","群益金鼎-民權",2,71,-69
"2031","2390云辰","110/09/03","元大-小港",42,0,42
"2032","2390云辰","110/09/03","元大-內湖",3,53,-50
"2033","2390云辰","110/09/03","元富-林園",40,0,40
"2034","2390云辰","110/09/03","國泰-館前",7,56,-49
"2035","2390云辰","110/09/03","凱基-湖口",35,0,35
"2036","2390云辰","110/09/03","凱基-和平",0,46,-46
"2037","2390云辰","110/09/03","凱基-長庚",40,5,35
"2038","2390云辰","110/09/03","土銀-花蓮",0,39,-39
"2039","2390云辰","110/09/03","玉山-高雄",33,1,32
"2040","2390云辰","110/09/03","凱基-彰化",2,34,-32
"2041","2834臺企銀","110/09/02","凱基-台北",3603,1646,1957
"2042","2834臺企銀","110/09/02","新加坡商瑞銀",900,9806,-8906
"2043","2834臺企銀","110/09/02","瑞士信貸",1919,1,1918
"2044","2834臺企銀","110/09/02","台灣摩根士丹利",1313,5660,-4347
"2045","2834臺企銀","110/09/02","新光-台中",1886,26,1860
"2046","2834臺企銀","110/09/02","凱基-宜蘭",10,2003,-1993
"2047","2834臺企銀","110/09/02","港商法國興業",1787,0,1787
"2048","2834臺企銀","110/09/02","美商高盛",485,1313,-828
"2049","2834臺企銀","110/09/02","華南永昌-高雄",617,21,596
"2050","2834臺企銀","110/09/02","兆豐-寶成",4,800,-796
"2051","2834臺企銀","110/09/02","彰銀",505,10,495
"2052","2834臺企銀","110/09/02","港商野村",12,645,-633
"2053","2834臺企銀","110/09/02","元大-高雄",495,0,495
"2054","2834臺企銀","110/09/02","港商麥格理",0,585,-585
"2055","2834臺企銀","110/09/02","永豐金證券",430,0,430
"2056","2834臺企銀","110/09/02","元大-南海",0,550,-550
"2057","2834臺企銀","110/09/02","康和",405,0,405
"2058","2834臺企銀","110/09/02","富邦-台北",32,503,-471
"2059","2834臺企銀","110/09/02","元富-城中",404,16,388
"2060","2834臺企銀","110/09/02","美林",186,515,-329
"2061","2834臺企銀","110/09/02","元大-斗六",329,1,328
"2062","2834臺企銀","110/09/02","摩根大通",800,1106,-306
"2063","2834臺企銀","110/09/02","統一-板橋",565,250,315
"2064","2834臺企銀","110/09/02","元富-虎尾",17,280,-263
"2065","2834臺企銀","110/09/02","兆豐-中壢",222,0,222
"2066","2834臺企銀","110/09/02","元富-林園",3,264,-261
"2067","2834臺企銀","110/09/02","統一-松江",220,0,220
"2068","2834臺企銀","110/09/02","新光-桃園",63,324,-261
"2069","2834臺企銀","110/09/02","大昌",230,10,220
"2070","2834臺企銀","110/09/02","高橋",83,340,-257
"2071","5511德昌","110/09/02","永豐金-市政",122,1,121
"2072","5511德昌","110/09/02","兆豐-台中港",0,50,-50
"2073","5511德昌","110/09/02","玉山-台大",10,0,10
"2074","5511德昌","110/09/02","元大-台中",0,39,-39
"2075","5511德昌","110/09/02","兆豐-南京",9,0,9
"2076","5511德昌","110/09/02","寶盛",0,21,-21
"2077","5511德昌","110/09/02","元大-清水",4,0,4
"2078","5511德昌","110/09/02","永豐金-南京",0,10,-10
"2079","5511德昌","110/09/02","凱基-中壢",3,0,3
"2080","5511德昌","110/09/02","(牛牛牛)亞-鑫豐",0,4,-4
"2081","5511德昌","110/09/02","群益金鼎-潭子",2,0,2
"2082","5511德昌","110/09/02","永豐金-羅東",0,3,-3
"2083","5511德昌","110/09/02","新光",1,0,1
"2084","5511德昌","110/09/02","致和-崇德",0,2,-2
"2085","5511德昌","110/09/02","元富-城中",0,0,0
"2086","5511德昌","110/09/02","凱基-八德",0,2,-2
"2087","5511德昌","110/09/02","元富-新竹",0,0,0
"2088","5511德昌","110/09/02","群益金鼎-中壢",0,2,-2
"2089","5511德昌","110/09/02","國票-台中",0,0,0
"2090","5511德昌","110/09/02","國票-北高雄",0,2,-2
"2091","5511德昌","110/09/02","玉山-數位",0,0,0
"2092","5511德昌","110/09/02","臺銀-高雄",0,2,-2
"2093","5511德昌","110/09/02","華南永昌-彰化",1,1,0
"2094","5511德昌","110/09/02","合庫-彰化",0,2,-2
"2095","5511德昌","110/09/02","元大-西門",0,0,0
"2096","5511德昌","110/09/02","大昌-新店",0,1,-1
"2097","5511德昌","110/09/02","",NA,NA,NA
"2098","5511德昌","110/09/02","合庫-台南",0,1,-1
"2099","5511德昌","110/09/02","",NA,NA,NA
"2100","5511德昌","110/09/02","日盛-宜蘭",0,1,-1
"2101","2489瑞軒","110/09/02","瑞士信貸",150,0,150
"2102","2489瑞軒","110/09/02","美林",51,321,-270
"2103","2489瑞軒","110/09/02","合庫-台中",134,0,134
"2104","2489瑞軒","110/09/02","摩根大通",58,259,-201
"2105","2489瑞軒","110/09/02","兆豐-東門",100,0,100
"2106","2489瑞軒","110/09/02","港商野村",27,173,-146
"2107","2489瑞軒","110/09/02","凱基-竹北",100,1,99
"2108","2489瑞軒","110/09/02","第一金-新興",2,137,-135
"2109","2489瑞軒","110/09/02","華南永昌-虎尾",113,21,92
"2110","2489瑞軒","110/09/02","美商高盛",0,127,-127
"2111","2489瑞軒","110/09/02","日盛-大墩",60,0,60
"2112","2489瑞軒","110/09/02","元大-內湖",1,122,-121
"2113","2489瑞軒","110/09/02","元大-清水",60,0,60
"2114","2489瑞軒","110/09/02","永豐金-新竹",0,100,-100
"2115","2489瑞軒","110/09/02","康和-台中",60,2,58
"2116","2489瑞軒","110/09/02","凱基-台北",37,105,-68
"2117","2489瑞軒","110/09/02","富邦-陽明",50,3,47
"2118","2489瑞軒","110/09/02","台灣摩根士丹利",16,72,-56
"2119","2489瑞軒","110/09/02","元大-土城永寧",41,0,41
"2120","2489瑞軒","110/09/02","元富-四維",0,42,-42
"2121","2489瑞軒","110/09/02","玉山-左營",34,2,32
"2122","2489瑞軒","110/09/02","凱基-和平",22,63,-41
"2123","2489瑞軒","110/09/02","合庫-台南",31,0,31
"2124","2489瑞軒","110/09/02","新加坡商瑞銀",31,65,-34
"2125","2489瑞軒","110/09/02","兆豐-鹿港",30,0,30
"2126","2489瑞軒","110/09/02","元大-楊梅",45,71,-26
"2127","2489瑞軒","110/09/02","華南永昌-苗栗",30,0,30
"2128","2489瑞軒","110/09/02","日茂-埔里",0,23,-23
"2129","2489瑞軒","110/09/02","元大-員林中山",30,1,29
"2130","2489瑞軒","110/09/02","群益金鼎-高盛",2,23,-21
"2131","2428興勤","110/09/02","元大-南京",20,0,20
"2132","2428興勤","110/09/02","港商麥格理",0,69,-69
"2133","2428興勤","110/09/02","台灣摩根士丹利",25,14,11
"2134","2428興勤","110/09/02","富邦-敦南",0,50,-50
"2135","2428興勤","110/09/02","美商高盛",12,2,10
"2136","2428興勤","110/09/02","元大-虎尾",0,40,-40
"2137","2428興勤","110/09/02","中國信託",11,1,10
"2138","2428興勤","110/09/02","新光",6,35,-29
"2139","2428興勤","110/09/02","永豐金-中正",11,1,10
"2140","2428興勤","110/09/02","凱基-台北",11,34,-23
"2141","2428興勤","110/09/02","亞東-高雄",9,0,9
"2142","2428興勤","110/09/02","國票-安和",0,19,-19
"2143","2428興勤","110/09/02","元富-緯城",9,0,9
"2144","2428興勤","110/09/02","台新證券",5,24,-19
"2145","2428興勤","110/09/02","新加坡商瑞銀",35,27,8
"2146","2428興勤","110/09/02","摩根大通",44,59,-15
"2147","2428興勤","110/09/02","國泰-高雄",8,0,8
"2148","2428興勤","110/09/02","瑞士信貸",9,23,-14
"2149","2428興勤","110/09/02","台新-台中",7,0,7
"2150","2428興勤","110/09/02","日盛-南京",0,13,-13
"2151","2428興勤","110/09/02","玉山-左營",7,0,7
"2152","2428興勤","110/09/02","統一",1,13,-12
"2153","2428興勤","110/09/02","凱基-中山",7,0,7
"2154","2428興勤","110/09/02","凱基-信義",0,10,-10
"2155","2428興勤","110/09/02","臺銀-民權",6,0,6
"2156","2428興勤","110/09/02","元富-台中",0,7,-7
"2157","2428興勤","110/09/02","宏遠-桃園",6,0,6
"2158","2428興勤","110/09/02","富邦-新竹",0,6,-6
"2159","2428興勤","110/09/02","凱基-三重",6,0,6
"2160","2428興勤","110/09/02","安泰",0,5,-5
"2161","3176基亞","110/09/02","國票-北投",110,0,110
"2162","3176基亞","110/09/02","宏遠-民生",0,43,-43
"2163","3176基亞","110/09/02","統一-土城",61,0,61
"2164","3176基亞","110/09/02","玉山-南京東路",0,35,-35
"2165","3176基亞","110/09/02","康和-板橋",25,0,25
"2166","3176基亞","110/09/02","富邦-永和",0,35,-35
"2167","3176基亞","110/09/02","凱基-高美館",18,1,17
"2168","3176基亞","110/09/02","富邦-高雄",1,31,-30
"2169","3176基亞","110/09/02","元富-高雄",16,0,16
"2170","3176基亞","110/09/02","萬泰",1,22,-21
"2171","3176基亞","110/09/02","摩根大通",17,1,16
"2172","3176基亞","110/09/02","凱基-三重",0,21,-21
"2173","3176基亞","110/09/02","富邦-仁愛",11,0,11
"2174","3176基亞","110/09/02","新光",4,23,-19
"2175","3176基亞","110/09/02","第一金-嘉義",10,0,10
"2176","3176基亞","110/09/02","國泰-敦南",0,15,-15
"2177","3176基亞","110/09/02","凱基-高雄",8,0,8
"2178","3176基亞","110/09/02","國泰-板橋",4,19,-15
"2179","3176基亞","110/09/02","台新證券",7,0,7
"2180","3176基亞","110/09/02","富邦-竹東",0,12,-12
"2181","3176基亞","110/09/02","富邦-員林",9,2,7
"2182","3176基亞","110/09/02","中國信託-忠孝",0,11,-11
"2183","3176基亞","110/09/02","富邦-虎尾",6,0,6
"2184","3176基亞","110/09/02","統一-員林",0,10,-10
"2185","3176基亞","110/09/02","元大證券",6,0,6
"2186","3176基亞","110/09/02","富邦-北港",1,11,-10
"2187","3176基亞","110/09/02","日盛-永康",5,0,5
"2188","3176基亞","110/09/02","元大-和平",0,10,-10
"2189","3176基亞","110/09/02","宏遠-光隆",5,0,5
"2190","3176基亞","110/09/02","富邦-板橋",1,10,-9
"2191","2409友達","110/09/02","摩根大通",13939,2902,11037
"2192","2409友達","110/09/02","台灣摩根士丹利",3905,23925,-20020
"2193","2409友達","110/09/02","瑞士信貸",7765,239,7526
"2194","2409友達","110/09/02","美林",2916,8870,-5954
"2195","2409友達","110/09/02","凱基-台北",9079,3811,5268
"2196","2409友達","110/09/02","群益金鼎",18,4663,-4645
"2197","2409友達","110/09/02","合庫證券",4069,211,3858
"2198","2409友達","110/09/02","富邦-虎尾",5052,7783,-2731
"2199","2409友達","110/09/02","寶盛",1560,60,1500
"2200","2409友達","110/09/02","第一金-華江",90,2245,-2155
"2201","2409友達","110/09/02","宏遠證券",1286,52,1234
"2202","2409友達","110/09/02","凱基-苗栗",53,1409,-1356
"2203","2409友達","110/09/02","土銀-和平",1014,20,994
"2204","2409友達","110/09/02","康和",734,2081,-1347
"2205","2409友達","110/09/02","玉山-高雄",1134,377,757
"2206","2409友達","110/09/02","港商野村",2398,3664,-1266
"2207","2409友達","110/09/02","陽信",596,17,579
"2208","2409友達","110/09/02","日茂-埔里",13,1105,-1092
"2209","2409友達","110/09/02","富邦-竹北",561,27,534
"2210","2409友達","110/09/02","日盛-和美",174,1250,-1076
"2211","2409友達","110/09/02","新光",1902,1400,502
"2212","2409友達","110/09/02","美商高盛",940,2011,-1071
"2213","2409友達","110/09/02","北城證券",525,46,479
"2214","2409友達","110/09/02","元大-開元",76,1015,-939
"2215","2409友達","110/09/02","中國信託-新竹",566,95,471
"2216","2409友達","110/09/02","花旗環球",1254,2093,-839
"2217","2409友達","110/09/02","國泰-敦南",1371,913,458
"2218","2409友達","110/09/02","元大-南屯",314,1123,-809
"2219","2409友達","110/09/02","宏遠-高雄",445,4,441
"2220","2409友達","110/09/02","康和-新竹",29,812,-783
"2221","1315達新","110/09/02","凱基-中港",12,0,12
"2222","1315達新","110/09/02","永豐金證券",0,6,-6
"2223","1315達新","110/09/02","元大-文心興安",5,0,5
"2224","1315達新","110/09/02","統一-桃園",0,5,-5
"2225","1315達新","110/09/02","永豐金-高雄",5,0,5
"2226","1315達新","110/09/02","致和-東門",0,5,-5
"2227","1315達新","110/09/02","台灣摩根士丹利",4,0,4
"2228","1315達新","110/09/02","富邦-宜蘭",0,3,-3
"2229","1315達新","110/09/02","群益金鼎-彰化",3,0,3
"2230","1315達新","110/09/02","凱基-台北",0,2,-2
"2231","1315達新","110/09/02","美商高盛",2,0,2
"2232","1315達新","110/09/02","富邦-高雄",0,2,-2
"2233","1315達新","110/09/02","亞東-板橋",1,0,1
"2234","1315達新","110/09/02","元富-成功",0,2,-2
"2235","1315達新","110/09/02","台新證券",3,2,1
"2236","1315達新","110/09/02","日盛-大墩",0,2,-2
"2237","1315達新","110/09/02","摩根大通",1,0,1
"2238","1315達新","110/09/02","國票-桃園",0,1,-1
"2239","1315達新","110/09/02","元大證券",1,0,1
"2240","1315達新","110/09/02","國泰-板橋",0,1,-1
"2241","1315達新","110/09/02","元大-花蓮",1,0,1
"2242","1315達新","110/09/02","富邦-台北",0,1,-1
"2243","1315達新","110/09/02","日盛-雙和",0,0,0
"2244","1315達新","110/09/02","元富-大昌",0,1,-1
"2245","1315達新","110/09/02","玉山-數位",0,0,0
"2246","1315達新","110/09/02","元大-天母",0,1,-1
"2247","1315達新","110/09/02","元大-屏東民生",0,0,0
"2248","1315達新","110/09/02","元大-大安",0,1,-1
"2249","1315達新","110/09/02","元大-豐原站前",0,0,0
"2250","1315達新","110/09/02","元大-龍潭",0,1,-1
"2251","2609陽明","110/09/02","康和",4708,555,4153
"2252","2609陽明","110/09/02","富邦證券",986,2072,-1086
"2253","2609陽明","110/09/02","摩根大通",5457,2911,2546
"2254","2609陽明","110/09/02","凱基-台北",977,1940,-963
"2255","2609陽明","110/09/02","新加坡商瑞銀",2881,338,2543
"2256","2609陽明","110/09/02","元大-仁愛",48,601,-553
"2257","2609陽明","110/09/02","美林",3860,2164,1696
"2258","2609陽明","110/09/02","統一-新台中",73,607,-534
"2259","2609陽明","110/09/02","台灣摩根士丹利",1541,85,1456
"2260","2609陽明","110/09/02","群益金鼎-高雄",70,506,-436
"2261","2609陽明","110/09/02","港商麥格理",1258,0,1258
"2262","2609陽明","110/09/02","永豐金證券",153,459,-306
"2263","2609陽明","110/09/02","富邦-虎尾",5424,4714,710
"2264","2609陽明","110/09/02","統一-三重",140,439,-299
"2265","2609陽明","110/09/02","永豐金-信義",749,51,698
"2266","2609陽明","110/09/02","統一-桃園",158,447,-289
"2267","2609陽明","110/09/02","統一-仁愛",3359,2671,688
"2268","2609陽明","110/09/02","國泰-敦南",1735,2011,-276
"2269","2609陽明","110/09/02","元大-開元",661,64,597
"2270","2609陽明","110/09/02","元大-南崁",43,316,-273
"2271","2609陽明","110/09/02","凱基-桃園",713,174,539
"2272","2609陽明","110/09/02","永豐金-古亭",44,310,-266
"2273","2609陽明","110/09/02","元大-南屯",523,129,394
"2274","2609陽明","110/09/02","兆豐-板橋",224,478,-254
"2275","2609陽明","110/09/02","第一金-桃園",498,121,377
"2276","2609陽明","110/09/02","新光",1385,1635,-250
"2277","2609陽明","110/09/02","元富",290,30,260
"2278","2609陽明","110/09/02","凱基-竹北",102,352,-250
"2279","2609陽明","110/09/02","兆豐-虎尾",628,369,259
"2280","2609陽明","110/09/02","富邦-南屯",136,384,-248
"2281","2636台驊投控","110/09/02","美商高盛",219,22,197
"2282","2636台驊投控","110/09/02","統一-新台中",3,162,-159
"2283","2636台驊投控","110/09/02","摩根大通",262,70,192
"2284","2636台驊投控","110/09/02","日盛-景美",8,120,-112
"2285","2636台驊投控","110/09/02","台灣摩根士丹利",185,3,182
"2286","2636台驊投控","110/09/02","台新證券",16,60,-44
"2287","2636台驊投控","110/09/02","美林",226,45,181
"2288","2636台驊投控","110/09/02","群益金鼎-古亭",32,73,-41
"2289","2636台驊投控","110/09/02","國票-安和",150,1,149
"2290","2636台驊投控","110/09/02","群益金鼎-中壢",0,36,-36
"2291","2636台驊投控","110/09/02","國票-南港",120,0,120
"2292","2636台驊投控","110/09/02","第一金-員林",1,35,-34
"2293","2636台驊投控","110/09/02","新加坡商瑞銀",141,23,118
"2294","2636台驊投控","110/09/02","華南永昌-虎尾",12,44,-32
"2295","2636台驊投控","110/09/02","凱基-台北",179,89,90
"2296","2636台驊投控","110/09/02","元大-左營",0,29,-29
"2297","2636台驊投控","110/09/02","港商野村",604,521,83
"2298","2636台驊投控","110/09/02","日盛-台中",3,30,-27
"2299","2636台驊投控","110/09/02","瑞士信貸",83,11,72
"2300","2636台驊投控","110/09/02","永豐金-員林",1,27,-26
"2301","2636台驊投控","110/09/02","群益金鼎-南京",42,0,42
"2302","2636台驊投控","110/09/02","花旗環球",0,25,-25
"2303","2636台驊投控","110/09/02","元大-林森",72,42,30
"2304","2636台驊投控","110/09/02","凱基-鳳山",2,27,-25
"2305","2636台驊投控","110/09/02","元大-敦南",44,16,28
"2306","2636台驊投控","110/09/02","永豐金-中正",2,26,-24
"2307","2636台驊投控","110/09/02","永豐金-屏東",30,4,26
"2308","2636台驊投控","110/09/02","康和-延平",50,73,-23
"2309","2636台驊投控","110/09/02","元大-天母",28,4,24
"2310","2636台驊投控","110/09/02","元富-成功",3,25,-22
"2311","2867三商壽","110/09/02","統一-平鎮",850,0,850
"2312","2867三商壽","110/09/02","新光-新竹",0,709,-709
"2313","2867三商壽","110/09/02","元大-桃園",150,0,150
"2314","2867三商壽","110/09/02","元富-新興",5,300,-295
"2315","2867三商壽","110/09/02","凱基-中壢",140,0,140
"2316","2867三商壽","110/09/02","新光",115,367,-252
"2317","2867三商壽","110/09/02","美商高盛",177,38,139
"2318","2867三商壽","110/09/02","美林",36,281,-245
"2319","2867三商壽","110/09/02","凱基-台北",131,22,109
"2320","2867三商壽","110/09/02","摩根大通",0,211,-211
"2321","2867三商壽","110/09/02","日盛-頭份",100,0,100
"2322","2867三商壽","110/09/02","台新證券",7,114,-107
"2323","2867三商壽","110/09/02","新光-台中",109,21,88
"2324","2867三商壽","110/09/02","臺銀-臺南",1,100,-99
"2325","2867三商壽","110/09/02","元大-豐原站前",79,0,79
"2326","2867三商壽","110/09/02","新加坡商瑞銀",8,99,-91
"2327","2867三商壽","110/09/02","永豐金-永康",61,0,61
"2328","2867三商壽","110/09/02","國票-南京",0,80,-80
"2329","2867三商壽","110/09/02","日盛-中和",60,3,57
"2330","2867三商壽","110/09/02","凱基-士林",0,50,-50
"2331","2867三商壽","110/09/02","國票-台南",50,0,50
"2332","2867三商壽","110/09/02","元大-四維",5,50,-45
"2333","2867三商壽","110/09/02","華南永昌-虎尾",64,14,50
"2334","2867三商壽","110/09/02","兆豐-新營",0,41,-41
"2335","2867三商壽","110/09/02","元大-彰化民生",50,0,50
"2336","2867三商壽","110/09/02","永豐金-高雄",0,40,-40
"2337","2867三商壽","110/09/02","凱基-高雄",50,1,49
"2338","2867三商壽","110/09/02","日茂-南投",0,34,-34
"2339","2867三商壽","110/09/02","瑞士信貸",46,0,46
"2340","2867三商壽","110/09/02","(牛牛牛)亞-網路",0,26,-26
"2341","5521工信","110/09/02","群益金鼎-台南",150,0,150
"2342","5521工信","110/09/02","永豐金證券",2,223,-221
"2343","5521工信","110/09/02","富邦-台北",130,0,130
"2344","5521工信","110/09/02","台灣摩根士丹利",27,188,-161
"2345","5521工信","110/09/02","玉山-台大",95,0,95
"2346","5521工信","110/09/02","元大-成功",0,100,-100
"2347","5521工信","110/09/02","華南永昌",68,5,63
"2348","5521工信","110/09/02","元富-大昌",2,100,-98
"2349","5521工信","110/09/02","富邦-板橋",62,0,62
"2350","5521工信","110/09/02","凱基-台北",468,542,-74
"2351","5521工信","110/09/02","凱基-宜蘭",55,0,55
"2352","5521工信","110/09/02","新百王",0,50,-50
"2353","5521工信","110/09/02","日盛-高雄",50,0,50
"2354","5521工信","110/09/02","群益金鼎-崇德",0,50,-50
"2355","5521工信","110/09/02","康和-澎湖",50,0,50
"2356","5521工信","110/09/02","華南永昌-民權",0,50,-50
"2357","5521工信","110/09/02","玉山-左營",50,0,50
"2358","5521工信","110/09/02","福勝",3,49,-46
"2359","5521工信","110/09/02","元大-小港",44,0,44
"2360","5521工信","110/09/02","摩根大通",162,206,-44
"2361","5521工信","110/09/02","凱基-站前",45,2,43
"2362","5521工信","110/09/02","臺銀",1,35,-34
"2363","5521工信","110/09/02","富邦-員林",43,0,43
"2364","5521工信","110/09/02","高橋-內壢",0,30,-30
"2365","5521工信","110/09/02","國票-中港",40,0,40
"2366","5521工信","110/09/02","第一金-華江",0,30,-30
"2367","5521工信","110/09/02","元大-旗山",40,0,40
"2368","5521工信","110/09/02","華南永昌-彰化",0,28,-28
"2369","5521工信","110/09/02","瑞士信貸",39,0,39
"2370","5521工信","110/09/02","台新-新莊",3,30,-27
"2371","1471首利","110/09/02","元富-民權",60,0,60
"2372","1471首利","110/09/02","摩根大通",12,98,-86
"2373","1471首利","110/09/02","元富-花蓮",20,0,20
"2374","1471首利","110/09/02","中國信託-文心",0,40,-40
"2375","1471首利","110/09/02","大昌-桃園",20,0,20
"2376","1471首利","110/09/02","宏遠-桃園",0,35,-35
"2377","1471首利","110/09/02","台新-松江",20,0,20
"2378","1471首利","110/09/02","台灣摩根士丹利",0,34,-34
"2379","1471首利","110/09/02","凱基-內埔",15,0,15
"2380","1471首利","110/09/02","元大-西門",0,29,-29
"2381","1471首利","110/09/02","凱基-市府",12,0,12
"2382","1471首利","110/09/02","美林",0,24,-24
"2383","1471首利","110/09/02","元大-頭份",12,0,12
"2384","1471首利","110/09/02","瑞士信貸",1,23,-22
"2385","1471首利","110/09/02","日盛-鳳山",10,0,10
"2386","1471首利","110/09/02","宏遠-光隆",0,20,-20
"2387","1471首利","110/09/02","中國信託",10,0,10
"2388","1471首利","110/09/02","台中銀-員林",0,20,-20
"2389","1471首利","110/09/02","國泰-台南",10,0,10
"2390","1471首利","110/09/02","元大-莒光",1,20,-19
"2391","1471首利","110/09/02","富邦-永和",10,0,10
"2392","1471首利","110/09/02","聯邦-高雄",0,13,-13
"2393","1471首利","110/09/02","富邦-南屯",10,0,10
"2394","1471首利","110/09/02","日盛-八德",0,11,-11
"2395","1471首利","110/09/02","富邦-新營",10,0,10
"2396","1471首利","110/09/02","凱基-台北",3,14,-11
"2397","1471首利","110/09/02","元大-南崁",10,0,10
"2398","1471首利","110/09/02","國泰-館前",0,10,-10
"2399","1471首利","110/09/02","元大-松山",10,0,10
"2400","1471首利","110/09/02","元大-中壢",0,10,-10
"2401","2883開發金","110/09/02","玉山證券",4630,30,4600
"2402","2883開發金","110/09/02","臺銀-新竹",2429,10392,-7963
"2403","2883開發金","110/09/02","凱基-新店",1053,0,1053
"2404","2883開發金","110/09/02","元大證券",934,7552,-6618
"2405","2883開發金","110/09/02","玉山-大里",1094,61,1033
"2406","2883開發金","110/09/02","元富",1212,6466,-5254
"2407","2883開發金","110/09/02","台新證券",1142,197,945
"2408","2883開發金","110/09/02","台灣摩根士丹利",873,4900,-4027
"2409","2883開發金","110/09/02","新光",2576,1805,771
"2410","2883開發金","110/09/02","瑞士信貸",101,3288,-3187
"2411","2883開發金","110/09/02","國泰-敦南",1107,404,703
"2412","2883開發金","110/09/02","凱基-台北",2289,4969,-2680
"2413","2883開發金","110/09/02","臺銀",649,25,624
"2414","2883開發金","110/09/02","國票-南京",0,2000,-2000
"2415","2883開發金","110/09/02","新光-台中",629,24,605
"2416","2883開發金","110/09/02","美林",1044,2979,-1935
"2417","2883開發金","110/09/02","國票-安和",569,0,569
"2418","2883開發金","110/09/02","兆豐-北高雄",115,1602,-1487
"2419","2883開發金","110/09/02","國泰-板橋",617,57,560
"2420","2883開發金","110/09/02","港商野村",1290,2552,-1262
"2421","2883開發金","110/09/02","兆豐-台中港",583,30,553
"2422","2883開發金","110/09/02","兆豐-竹北",234,1375,-1141
"2423","2883開發金","110/09/02","國票-長城",510,2,508
"2424","2883開發金","110/09/02","群益金鼎-南京",9,1125,-1116
"2425","2883開發金","110/09/02","中國信託",550,47,503
"2426","2883開發金","110/09/02","永豐金-台南",139,1126,-987
"2427","2883開發金","110/09/02","兆豐-高雄",413,12,401
"2428","2883開發金","110/09/02","亞東-新竹",1173,2062,-889
"2429","2883開發金","110/09/02","統一-新竹",369,0,369
"2430","2883開發金","110/09/02","日盛-台中",3,635,-632
"2431","6205詮欣","110/09/02","合庫-三重",33,0,33
"2432","6205詮欣","110/09/02","日盛-三重",0,53,-53
"2433","6205詮欣","110/09/02","元大-向上",19,0,19
"2434","6205詮欣","110/09/02","元大-中和",0,17,-17
"2435","6205詮欣","110/09/02","摩根大通",9,2,7
"2436","6205詮欣","110/09/02","玉山證券",0,5,-5
"2437","6205詮欣","110/09/02","永豐金證券",4,0,4
"2438","6205詮欣","110/09/02","群益金鼎-基隆",0,3,-3
"2439","6205詮欣","110/09/02","元大-南投",4,0,4
"2440","6205詮欣","110/09/02","日盛-台中",0,2,-2
"2441","6205詮欣","110/09/02","元大-汐止",3,0,3
"2442","6205詮欣","110/09/02","美林",0,2,-2
"2443","6205詮欣","110/09/02","國票",3,0,3
"2444","6205詮欣","110/09/02","兆豐-桃園",0,2,-2
"2445","6205詮欣","110/09/02","玉山-高雄",3,0,3
"2446","6205詮欣","110/09/02","兆豐-新營",0,1,-1
"2447","6205詮欣","110/09/02","玉山-新莊",2,0,2
"2448","6205詮欣","110/09/02","凱基-桃園",0,1,-1
"2449","6205詮欣","110/09/02","臺銀-臺中",1,0,1
"2450","6205詮欣","110/09/02","華南永昌-東昇",0,1,-1
"2451","6205詮欣","110/09/02","台新-台中",1,0,1
"2452","6205詮欣","110/09/02","富邦-板橋",0,1,-1
"2453","6205詮欣","110/09/02","台新-高雄",1,0,1
"2454","6205詮欣","110/09/02","永豐金-中和",0,1,-1
"2455","6205詮欣","110/09/02","兆豐-竹北",1,0,1
"2456","6205詮欣","110/09/02","康和-板橋",0,0,0
"2457","6205詮欣","110/09/02","瑞士信貸",2,1,1
"2458","6205詮欣","110/09/02","華南永昌-高雄",0,0,0
"2459","6205詮欣","110/09/02","日盛-中和",1,0,1
"2460","6205詮欣","110/09/02","元大-民生",2,2,0
"2461","1540喬福","110/09/02","元富-板橋",17,0,17
"2462","1540喬福","110/09/02","富邦-中壢",0,13,-13
"2463","1540喬福","110/09/02","元大-四維",5,0,5
"2464","1540喬福","110/09/02","摩根大通",0,5,-5
"2465","1540喬福","110/09/02","元富-中原",3,0,3
"2466","1540喬福","110/09/02","富邦-台南",0,5,-5
"2467","1540喬福","110/09/02","元大-大雅",2,0,2
"2468","1540喬福","110/09/02","富邦-虎尾",0,5,-5
"2469","1540喬福","110/09/02","元大-竹東",2,0,2
"2470","1540喬福","110/09/02","永豐金-鳳山",0,5,-5
"2471","1540喬福","110/09/02","兆豐-員林",2,0,2
"2472","1540喬福","110/09/02","元大-斗信",0,4,-4
"2473","1540喬福","110/09/02","元大-頭份",2,0,2
"2474","1540喬福","110/09/02","元大-龍潭",0,2,-2
"2475","1540喬福","110/09/02","群益金鼎-館前",5,3,2
"2476","1540喬福","110/09/02","永豐金-高雄",0,2,-2
"2477","1540喬福","110/09/02","富邦-建國",2,0,2
"2478","1540喬福","110/09/02","台新證券",0,1,-1
"2479","1540喬福","110/09/02","富邦-仁愛",2,0,2
"2480","1540喬福","110/09/02","元大-東蘆",0,1,-1
"2481","1540喬福","110/09/02","統一-汐止",1,0,1
"2482","1540喬福","110/09/02","美林",1,1,0
"2483","1540喬福","110/09/02","元大-彰化",1,0,1
"2484","1540喬福","110/09/02","康和-板橋",0,0,0
"2485","1540喬福","110/09/02","凱基-台北",1,0,1
"2486","1540喬福","110/09/02","新光",0,0,0
"2487","1540喬福","110/09/02","元富",1,0,1
"2488","1540喬福","110/09/02","元大-竹北",0,0,0
"2489","1540喬福","110/09/02","元大-竹北",0,0,0
"2490","1540喬福","110/09/02","元大-鹿港",0,0,0
"2491","2888新光金","110/09/02","瑞士信貸",4150,60,4090
"2492","2888新光金","110/09/02","臺銀-高雄",126,7509,-7383
"2493","2888新光金","110/09/02","元大證券",2179,241,1938
"2494","2888新光金","110/09/02","國票-長城",23,3040,-3017
"2495","2888新光金","110/09/02","凱基-台北",2132,1288,844
"2496","2888新光金","110/09/02","日盛-台中",68,2972,-2904
"2497","2888新光金","110/09/02","凱基-站前",856,16,840
"2498","2888新光金","110/09/02","美林",275,3018,-2743
"2499","2888新光金","110/09/02","(牛牛牛)亞-網路",850,48,802
"2500","2888新光金","110/09/02","台灣摩根士丹利",279,2624,-2345
"2501","2888新光金","110/09/02","台新-台中",681,49,632
"2502","2888新光金","110/09/02","台新-三民",74,2010,-1936
"2503","2888新光金","110/09/02","宏遠-桃園",637,20,617
"2504","2888新光金","110/09/02","永豐金證券",270,2043,-1773
"2505","2888新光金","110/09/02","元大-南海",595,0,595
"2506","2888新光金","110/09/02","港商野村",8,1614,-1606
"2507","2888新光金","110/09/02","富邦-建國",659,70,589
"2508","2888新光金","110/09/02","永豐金-桃園",50,1504,-1454
"2509","2888新光金","110/09/02","兆豐-台中港",539,3,536
"2510","2888新光金","110/09/02","永全-南崁",611,1862,-1251
"2511","2888新光金","110/09/02","兆豐-三民",530,0,530
"2512","2888新光金","110/09/02","凱基-新店",3,1150,-1147
"2513","2888新光金","110/09/02","日盛-雙和",606,80,526
"2514","2888新光金","110/09/02","元大-豐原",47,1060,-1013
"2515","2888新光金","110/09/02","群益金鼎-台中",621,112,509
"2516","2888新光金","110/09/02","美商高盛",12,861,-849
"2517","2888新光金","110/09/02","中農",499,20,479
"2518","2888新光金","110/09/02","臺銀-金山",125,833,-708
"2519","2888新光金","110/09/02","華南永昌-中正",438,6,432
"2520","2888新光金","110/09/02","元大-四維",76,779,-703
"2521","1340勝悅","110/09/02","玉山-新竹",33,0,33
"2522","1340勝悅","110/09/02","台中銀",0,27,-27
"2523","1340勝悅","110/09/02","宏遠-館前",10,0,10
"2524","1340勝悅","110/09/02","日盛證券",0,10,-10
"2525","1340勝悅","110/09/02","華南永昌-虎尾",6,0,6
"2526","1340勝悅","110/09/02","群益金鼎-敦南",0,10,-10
"2527","1340勝悅","110/09/02","臺銀",5,0,5
"2528","1340勝悅","110/09/02","美林",0,9,-9
"2529","1340勝悅","110/09/02","臺銀-鳳山",5,0,5
"2530","1340勝悅","110/09/02","統一-新營",0,8,-8
"2531","1340勝悅","110/09/02","凱基-北門",5,0,5
"2532","1340勝悅","110/09/02","玉山-桃園",0,8,-8
"2533","1340勝悅","110/09/02","元富-新店",4,0,4
"2534","1340勝悅","110/09/02","摩根大通",0,7,-7
"2535","1340勝悅","110/09/02","新光",4,0,4
"2536","1340勝悅","110/09/02","日盛-員林",0,6,-6
"2537","1340勝悅","110/09/02","國泰-敦南",4,0,4
"2538","1340勝悅","110/09/02","元大-龍潭",0,5,-5
"2539","1340勝悅","110/09/02","美商高盛",3,0,3
"2540","1340勝悅","110/09/02","大慶-苗栗",0,4,-4
"2541","1340勝悅","110/09/02","元大-基隆",3,0,3
"2542","1340勝悅","110/09/02","凱基-台中",0,4,-4
"2543","1340勝悅","110/09/02","臺灣企銀-埔墘",2,0,2
"2544","1340勝悅","110/09/02","元富-板橋",0,3,-3
"2545","1340勝悅","110/09/02","光和",2,0,2
"2546","1340勝悅","110/09/02","永豐金-苓雅",0,3,-3
"2547","1340勝悅","110/09/02","兆豐-大安",2,0,2
"2548","1340勝悅","110/09/02","日盛-景美",0,2,-2
"2549","1340勝悅","110/09/02","國票-長城",2,0,2
"2550","1340勝悅","110/09/02","統一-城中",6,8,-2
"2551","6246臺龍","110/09/02","宏遠-館前",32,13,19
"2552","6246臺龍","110/09/02","元大-南投",0,19,-19
"2553","6246臺龍","110/09/02","元富-新店",11,0,11
"2554","6246臺龍","110/09/02","永豐金-松山",0,15,-15
"2555","6246臺龍","110/09/02","德信-新營",10,0,10
"2556","6246臺龍","110/09/02","群益金鼎-古亭",0,10,-10
"2557","6246臺龍","110/09/02","元大-屏南",10,0,10
"2558","6246臺龍","110/09/02","大昌-桃園",0,5,-5
"2559","6246臺龍","110/09/02","華南永昌-彰化",6,0,6
"2560","6246臺龍","110/09/02","凱基-台北",1,6,-5
"2561","6246臺龍","110/09/02","群益金鼎-永和",5,0,5
"2562","6246臺龍","110/09/02","元大-金門",0,5,-5
"2563","6246臺龍","110/09/02","(牛牛牛)亞-鑫豐",4,0,4
"2564","6246臺龍","110/09/02","元富-吉利",0,4,-4
"2565","6246臺龍","110/09/02","華南永昌-公誠",4,0,4
"2566","6246臺龍","110/09/02","國泰-板橋",0,4,-4
"2567","6246臺龍","110/09/02","富邦-板橋",5,1,4
"2568","6246臺龍","110/09/02","第一金-頭份",0,3,-3
"2569","6246臺龍","110/09/02","元富-埔里",3,0,3
"2570","6246臺龍","110/09/02","新光-新竹",0,3,-3
"2571","6246臺龍","110/09/02","元富-新興",3,0,3
"2572","6246臺龍","110/09/02","港商野村",3,5,-2
"2573","6246臺龍","110/09/02","兆豐-新營",3,0,3
"2574","6246臺龍","110/09/02","國票-北高雄",0,2,-2
"2575","6246臺龍","110/09/02","國票-桃園",3,0,3
"2576","6246臺龍","110/09/02","國票-敦北法人",0,2,-2
"2577","6246臺龍","110/09/02","華南永昌-台中",3,0,3
"2578","6246臺龍","110/09/02","台新-台南",0,2,-2
"2579","6246臺龍","110/09/02","元大-大雅",3,0,3
"2580","6246臺龍","110/09/02","台新-屏東",0,2,-2
"2581","00715L期街口布蘭特正2","110/09/02","元大證券",5620,931,4689
"2582","00715L期街口布蘭特正2","110/09/02","元大-復北",0,1372,-1372
"2583","00715L期街口布蘭特正2","110/09/02","(牛牛牛)亞-鑫豐",1283,115,1168
"2584","00715L期街口布蘭特正2","110/09/02","凱基-新豐",0,1053,-1053
"2585","00715L期街口布蘭特正2","110/09/02","永豐金證券",1199,60,1139
"2586","00715L期街口布蘭特正2","110/09/02","永豐金-市政",0,829,-829
"2587","00715L期街口布蘭特正2","110/09/02","元大-萬華",920,0,920
"2588","00715L期街口布蘭特正2","110/09/02","新光-台中",221,719,-498
"2589","00715L期街口布蘭特正2","110/09/02","群益金鼎",829,0,829
"2590","00715L期街口布蘭特正2","110/09/02","玉山-雙和",0,420,-420
"2591","00715L期街口布蘭特正2","110/09/02","統一",787,0,787
"2592","00715L期街口布蘭特正2","110/09/02","中國信託-新竹",0,400,-400
"2593","00715L期街口布蘭特正2","110/09/02","康和",1080,412,668
"2594","00715L期街口布蘭特正2","110/09/02","兆豐-台中港",12,362,-350
"2595","00715L期街口布蘭特正2","110/09/02","元富",609,0,609
"2596","00715L期街口布蘭特正2","110/09/02","康和-嘉義",0,300,-300
"2597","00715L期街口布蘭特正2","110/09/02","台新-台中",543,43,500
"2598","00715L期街口布蘭特正2","110/09/02","台中銀-豐原",12,310,-298
"2599","00715L期街口布蘭特正2","110/09/02","元富-大裕",478,0,478
"2600","00715L期街口布蘭特正2","110/09/02","元大-草屯",7,254,-247
"2601","00715L期街口布蘭特正2","110/09/02","群益金鼎-台中",354,1,353
"2602","00715L期街口布蘭特正2","110/09/02","凱基-站前",0,245,-245
"2603","00715L期街口布蘭特正2","110/09/02","元大-花蓮",146,11,135
"2604","00715L期街口布蘭特正2","110/09/02","凱基-城中",0,237,-237
"2605","00715L期街口布蘭特正2","110/09/02","元大-前金",102,0,102
"2606","00715L期街口布蘭特正2","110/09/02","富邦-台北",5,223,-218
"2607","00715L期街口布蘭特正2","110/09/02","中國信託-高雄",102,19,83
"2608","00715L期街口布蘭特正2","110/09/02","新光",125,342,-217
"2609","00715L期街口布蘭特正2","110/09/02","元大-大雅",95,22,73
"2610","00715L期街口布蘭特正2","110/09/02","兆豐-嘉義",0,206,-206
"2611","8941關中","110/09/02","高橋-內壢",2,0,2
"2612","8941關中","110/09/02","元大-金華",0,2,-2
"2613","8941關中","110/09/02","日盛-板橋",1,0,1
"2614","8941關中","110/09/02","統一-彰化",0,1,-1
"2615","8941關中","110/09/02","凱基-市府",1,0,1
"2616","8941關中","110/09/02","國泰-忠孝",0,1,-1
"2617","8941關中","110/09/02","宏遠-館前",0,0,0
"2618","8941關中","110/09/02","宏遠-館前",0,0,0
"2619","8941關中","110/09/02","元大-淡水",0,0,0
"2620","8941關中","110/09/02","元大-淡水",0,0,0
"2621","8941關中","110/09/02","元大-鹿港",0,0,0
"2622","8941關中","110/09/02","元大-鹿港",0,0,0
"2623","8941關中","110/09/02","永豐金-敦北",0,0,0
"2624","8941關中","110/09/02","永豐金-敦北",0,0,0
"2625","8941關中","110/09/02","永豐金-萬盛",0,0,0
"2626","8941關中","110/09/02","永豐金-萬盛",0,0,0
"2627","8941關中","110/09/02","永豐金-南投",0,0,0
"2628","8941關中","110/09/02","永豐金-南投",0,0,0
"2629","8941關中","110/09/02","",NA,NA,NA
"2630","8941關中","110/09/02","",NA,NA,NA
"2631","8941關中","110/09/02","",NA,NA,NA
"2632","8941關中","110/09/02","",NA,NA,NA
"2633","8941關中","110/09/02","",NA,NA,NA
"2634","8941關中","110/09/02","",NA,NA,NA
"2635","8941關中","110/09/02","",NA,NA,NA
"2636","8941關中","110/09/02","",NA,NA,NA
"2637","8941關中","110/09/02","",NA,NA,NA
"2638","8941關中","110/09/02","",NA,NA,NA
"2639","8941關中","110/09/02","",NA,NA,NA
"2640","8941關中","110/09/02","",NA,NA,NA
"2641","8936國統","110/09/02","台新證券",163,5,158
"2642","8936國統","110/09/02","永豐金-竹科",10,150,-140
"2643","8936國統","110/09/02","新加坡商瑞銀",163,51,112
"2644","8936國統","110/09/02","摩根大通",59,163,-104
"2645","8936國統","110/09/02","美林",120,13,107
"2646","8936國統","110/09/02","永豐金-高雄",1,100,-99
"2647","8936國統","110/09/02","華南永昌-高雄",91,0,91
"2648","8936國統","110/09/02","瑞士信貸",1,72,-71
"2649","8936國統","110/09/02","凱基-台北",174,108,66
"2650","8936國統","110/09/02","永豐金-彰化",5,56,-51
"2651","8936國統","110/09/02","元大-東泰",59,9,50
"2652","8936國統","110/09/02","元大-旗山",0,24,-24
"2653","8936國統","110/09/02","日盛-樹林",40,0,40
"2654","8936國統","110/09/02","大昌-新店",0,19,-19
"2655","8936國統","110/09/02","台新-高雄",40,9,31
"2656","8936國統","110/09/02","元大-南京",2,20,-18
"2657","8936國統","110/09/02","新光-台中",37,9,28
"2658","8936國統","110/09/02","國票-中正",0,16,-16
"2659","8936國統","110/09/02","美商高盛",57,31,26
"2660","8936國統","110/09/02","富邦-高雄",0,15,-15
"2661","8936國統","110/09/02","日盛-北高雄",41,16,25
"2662","8936國統","110/09/02","宏遠-新化",0,14,-14
"2663","8936國統","110/09/02","元富-敦南",25,0,25
"2664","8936國統","110/09/02","中國信託-高雄",0,13,-13
"2665","8936國統","110/09/02","國泰-敦南",29,9,20
"2666","8936國統","110/09/02","群益金鼎-忠孝",8,21,-13
"2667","8936國統","110/09/02","凱基-信義",20,1,19
"2668","8936國統","110/09/02","臺銀-金山",0,11,-11
"2669","8936國統","110/09/02","玉山-大里",16,0,16
"2670","8936國統","110/09/02","台灣摩根士丹利",0,11,-11
"2671","6226光鼎","110/09/02","元大-大灣",118,3,115
"2672","6226光鼎","110/09/02","港商野村",148,254,-106
"2673","6226光鼎","110/09/02","大昌-新店",95,5,90
"2674","6226光鼎","110/09/02","台新證券",65,150,-85
"2675","6226光鼎","110/09/02","統一-桃園",76,0,76
"2676","6226光鼎","110/09/02","日盛-鳳山",0,80,-80
"2677","6226光鼎","110/09/02","元大-小港",78,7,71
"2678","6226光鼎","110/09/02","台灣摩根士丹利",0,77,-77
"2679","6226光鼎","110/09/02","元大-嘉義",60,0,60
"2680","6226光鼎","110/09/02","元大-龍潭",1,71,-70
"2681","6226光鼎","110/09/02","元富-松德",52,0,52
"2682","6226光鼎","110/09/02","凱基-岡山",1,61,-60
"2683","6226光鼎","110/09/02","元富-高雄",62,11,51
"2684","6226光鼎","110/09/02","台新-新營",4,63,-59
"2685","6226光鼎","110/09/02","群益金鼎-中壢",45,1,44
"2686","6226光鼎","110/09/02","元大-北投",5,61,-56
"2687","6226光鼎","110/09/02","大展-台南",43,0,43
"2688","6226光鼎","110/09/02","大慶-富順",0,45,-45
"2689","6226光鼎","110/09/02","華南永昌-楠梓",62,19,43
"2690","6226光鼎","110/09/02","元大-虎尾",5,50,-45
"2691","6226光鼎","110/09/02","元大-楊梅",43,1,42
"2692","6226光鼎","110/09/02","元大-台中中港",10,55,-45
"2693","6226光鼎","110/09/02","元大-員林中山",40,0,40
"2694","6226光鼎","110/09/02","台新-台南",3,40,-37
"2695","6226光鼎","110/09/02","元大-汐止",40,0,40
"2696","6226光鼎","110/09/02","中國信託-忠孝",11,46,-35
"2697","6226光鼎","110/09/02","日盛-景美",34,0,34
"2698","6226光鼎","110/09/02","華南永昌-東勢",20,54,-34
"2699","6226光鼎","110/09/02","群益金鼎-開元",61,31,30
"2700","6226光鼎","110/09/02","元大-新竹經國",9,43,-34
"2701","2363矽統","110/09/02","日盛-南京",869,3,866
"2702","2363矽統","110/09/02","美林",216,1191,-975
"2703","2363矽統","110/09/02","台灣摩根士丹利",437,2,435
"2704","2363矽統","110/09/02","永豐金-南投",29,917,-888
"2705","2363矽統","110/09/02","元大-佳里",547,264,283
"2706","2363矽統","110/09/02","摩根大通",540,1319,-779
"2707","2363矽統","110/09/02","元大-前金",268,49,219
"2708","2363矽統","110/09/02","德信-中正",56,575,-519
"2709","2363矽統","110/09/02","國泰-敦南",958,758,200
"2710","2363矽統","110/09/02","凱基-台北",2310,2708,-398
"2711","2363矽統","110/09/02","永豐金-竹科",184,41,143
"2712","2363矽統","110/09/02","台新-三民",75,444,-369
"2713","2363矽統","110/09/02","新加坡商瑞銀",419,282,137
"2714","2363矽統","110/09/02","瑞士信貸",62,392,-330
"2715","2363矽統","110/09/02","中國信託-忠孝",153,18,135
"2716","2363矽統","110/09/02","永豐金證券",124,377,-253
"2717","2363矽統","110/09/02","國泰-館前",271,144,127
"2718","2363矽統","110/09/02","凱基-南崁",51,235,-184
"2719","2363矽統","110/09/02","元大-南京",139,16,123
"2720","2363矽統","110/09/02","富邦-北港",101,284,-183
"2721","2363矽統","110/09/02","臺銀-金山",170,50,120
"2722","2363矽統","110/09/02","群益金鼎",105,252,-147
"2723","2363矽統","110/09/02","北城證券",135,18,117
"2724","2363矽統","110/09/02","凱基-科園",82,224,-142
"2725","2363矽統","110/09/02","兆豐-公益",142,27,115
"2726","2363矽統","110/09/02","富邦-台北",145,286,-141
"2727","2363矽統","110/09/02","台新證券",636,521,115
"2728","2363矽統","110/09/02","富邦證券",98,235,-137
"2729","2363矽統","110/09/02","元大證券",217,105,112
"2730","2363矽統","110/09/02","康和",30,162,-132
"2731","8112至上","110/09/02","合庫證券",92,0,92
"2732","8112至上","110/09/02","摩根大通",4,169,-165
"2733","8112至上","110/09/02","元大-竹東",70,0,70
"2734","8112至上","110/09/02","元大-東門",0,90,-90
"2735","8112至上","110/09/02","新光",51,5,46
"2736","8112至上","110/09/02","港商野村",36,114,-78
"2737","8112至上","110/09/02","凱基-長庚",46,0,46
"2738","8112至上","110/09/02","美林",52,115,-63
"2739","8112至上","110/09/02","群益金鼎-士林",36,0,36
"2740","8112至上","110/09/02","國票-南京",0,62,-62
"2741","8112至上","110/09/02","台新-新營",32,0,32
"2742","8112至上","110/09/02","凱基-台北",58,117,-59
"2743","8112至上","110/09/02","臺銀",27,0,27
"2744","8112至上","110/09/02","美商高盛",0,52,-52
"2745","8112至上","110/09/02","新光-高雄",29,2,27
"2746","8112至上","110/09/02","元大-南屯",0,52,-52
"2747","8112至上","110/09/02","富邦-台中",25,0,25
"2748","8112至上","110/09/02","瑞士信貸",0,48,-48
"2749","8112至上","110/09/02","元富-大裕",24,1,23
"2750","8112至上","110/09/02","元大-大里",9,55,-46
"2751","8112至上","110/09/02","大慶-楊梅",22,0,22
"2752","8112至上","110/09/02","元大-士林",0,45,-45
"2753","8112至上","110/09/02","國票-內壢",21,0,21
"2754","8112至上","110/09/02","香港上海匯豐",0,42,-42
"2755","8112至上","110/09/02","華南永昌-鳳山",21,0,21
"2756","8112至上","110/09/02","凱基-松山",0,37,-37
"2757","8112至上","110/09/02","元大-淡水",21,0,21
"2758","8112至上","110/09/02","日盛-三峽",0,30,-30
"2759","8112至上","110/09/02","群益金鼎-北高雄",20,0,20
"2760","8112至上","110/09/02","台灣匯立證券",0,29,-29
"2761","1570力肯","110/09/02","國票-和平",85,0,85
"2762","1570力肯","110/09/02","新光",25,211,-186
"2763","1570力肯","110/09/02","元大-北三重",68,0,68
"2764","1570力肯","110/09/02","群益金鼎-高雄",5,60,-55
"2765","1570力肯","110/09/02","國票",30,0,30
"2766","1570力肯","110/09/02","摩根大通",0,54,-54
"2767","1570力肯","110/09/02","元大-內湖",30,1,29
"2768","1570力肯","110/09/02","元大-東泰",0,41,-41
"2769","1570力肯","110/09/02","第一金-嘉義",25,0,25
"2770","1570力肯","110/09/02","凱基-台北",1,32,-31
"2771","1570力肯","110/09/02","光和-田中",19,0,19
"2772","1570力肯","110/09/02","合庫-嘉義",1,30,-29
"2773","1570力肯","110/09/02","元大-板橋",16,0,16
"2774","1570力肯","110/09/02","元大-南屯",0,22,-22
"2775","1570力肯","110/09/02","兆豐-嘉義",16,1,15
"2776","1570力肯","110/09/02","元大-永和",0,22,-22
"2777","1570力肯","110/09/02","凱基-高美館",15,0,15
"2778","1570力肯","110/09/02","富邦-嘉義",0,20,-20
"2779","1570力肯","110/09/02","富邦-建國",15,0,15
"2780","1570力肯","110/09/02","華南永昌-彰化",0,15,-15
"2781","1570力肯","110/09/02","彰銀-七賢",14,0,14
"2782","1570力肯","110/09/02","(牛牛牛)亞-網路",1,15,-14
"2783","1570力肯","110/09/02","大慶-蘆洲",11,0,11
"2784","1570力肯","110/09/02","元大-員林中山",0,13,-13
"2785","1570力肯","110/09/02","富邦-新營",10,0,10
"2786","1570力肯","110/09/02","聯邦-三重",0,10,-10
"2787","1570力肯","110/09/02","永豐金-中和",10,0,10
"2788","1570力肯","110/09/02","群益金鼎-三民",0,8,-8
"2789","1570力肯","110/09/02","群益金鼎-瑞豐",9,0,9
"2790","1570力肯","110/09/02","日盛-園區",0,6,-6
"2791","2929淘帝","110/09/02","摩根大通",11,0,11
"2792","2929淘帝","110/09/02","日盛-板橋中山",0,30,-30
"2793","2929淘帝","110/09/02","凱基-東門",11,0,11
"2794","2929淘帝","110/09/02","美林",0,16,-16
"2795","2929淘帝","110/09/02","臺銀-臺南",10,0,10
"2796","2929淘帝","110/09/02","日盛-台南",0,12,-12
"2797","2929淘帝","110/09/02","元大-太平",6,0,6
"2798","2929淘帝","110/09/02","元富-大裕",0,12,-12
"2799","2929淘帝","110/09/02","日盛-台中",5,0,5
"2800","2929淘帝","110/09/02","港商野村",0,6,-6
"2801","2929淘帝","110/09/02","台新-建北",5,0,5
"2802","2929淘帝","110/09/02","新加坡商瑞銀",0,6,-6
"2803","2929淘帝","110/09/02","富邦-新竹",5,0,5
"2804","2929淘帝","110/09/02","元大-竹科",0,4,-4
"2805","2929淘帝","110/09/02","富邦-南屯",5,0,5
"2806","2929淘帝","110/09/02","元富-板橋",0,3,-3
"2807","2929淘帝","110/09/02","群益金鼎",4,0,4
"2808","2929淘帝","110/09/02","群益金鼎-敦南",0,3,-3
"2809","2929淘帝","110/09/02","元大-府城",4,0,4
"2810","2929淘帝","110/09/02","凱基-敦北",0,3,-3
"2811","2929淘帝","110/09/02","元大-大雅",4,0,4
"2812","2929淘帝","110/09/02","元大-虎尾",0,3,-3
"2813","2929淘帝","110/09/02","(牛牛牛)亞-鑫豐",4,1,3
"2814","2929淘帝","110/09/02","新光-高雄",0,2,-2
"2815","2929淘帝","110/09/02","新光-新竹",3,0,3
"2816","2929淘帝","110/09/02","國泰-館前",0,2,-2
"2817","2929淘帝","110/09/02","玉山-大里",3,0,3
"2818","2929淘帝","110/09/02","富邦-花蓮",0,2,-2
"2819","2929淘帝","110/09/02","臺銀-臺中",2,0,2
"2820","2929淘帝","110/09/02","富邦-建國",0,2,-2
"2821","5410國眾","110/09/02","富邦-板橋",10,0,10
"2822","5410國眾","110/09/02","群益金鼎-民權",0,10,-10
"2823","5410國眾","110/09/02","臺銀",5,0,5
"2824","5410國眾","110/09/02","玉山-南京東路",0,5,-5
"2825","5410國眾","110/09/02","台新-左楠",5,0,5
"2826","5410國眾","110/09/02","元大-新莊",0,5,-5
"2827","5410國眾","110/09/02","玉山-板橋",5,0,5
"2828","5410國眾","110/09/02","摩根大通",0,3,-3
"2829","5410國眾","110/09/02","凱基-科園",5,0,5
"2830","5410國眾","110/09/02","國泰-敦南",1,4,-3
"2831","5410國眾","110/09/02","元大-彰化民生",3,0,3
"2832","5410國眾","110/09/02","華南永昌-鶯歌",0,3,-3
"2833","5410國眾","110/09/02","台新-中壢",2,0,2
"2834","5410國眾","110/09/02","台新證券",0,2,-2
"2835","5410國眾","110/09/02","新光",2,0,2
"2836","5410國眾","110/09/02","台新-新營",0,2,-2
"2837","5410國眾","110/09/02","元大-虎尾",2,0,2
"2838","5410國眾","110/09/02","凱基-雙和",0,2,-2
"2839","5410國眾","110/09/02","永豐金-中正",2,0,2
"2840","5410國眾","110/09/02","永豐金-中盛",0,2,-2
"2841","5410國眾","110/09/02","元富-新店",1,0,1
"2842","5410國眾","110/09/02","元富-大昌",0,1,-1
"2843","5410國眾","110/09/02","元富-敦南",1,0,1
"2844","5410國眾","110/09/02","元富-埔里",0,1,-1
"2845","5410國眾","110/09/02","中國信託-中壢",1,0,1
"2846","5410國眾","110/09/02","兆豐-北高雄",0,1,-1
"2847","5410國眾","110/09/02","群益金鼎-基隆",1,0,1
"2848","5410國眾","110/09/02","台新-建北",0,1,-1
"2849","5410國眾","110/09/02","富邦-彰化",1,0,1
"2850","5410國眾","110/09/02","富邦-員林",0,1,-1
"2851","2841台開","110/09/02","群益金鼎-海山",100,0,100
"2852","2841台開","110/09/02","元大-八德",0,100,-100
"2853","2841台開","110/09/02","宏遠-館前",65,0,65
"2854","2841台開","110/09/02","兆豐-彰化",0,60,-60
"2855","2841台開","110/09/02","台中銀",40,3,37
"2856","2841台開","110/09/02","港商野村",0,43,-43
"2857","2841台開","110/09/02","群益金鼎-崇德",26,0,26
"2858","2841台開","110/09/02","兆豐-新營",0,20,-20
"2859","2841台開","110/09/02","台新-三民",20,0,20
"2860","2841台開","110/09/02","玉山-台中",0,20,-20
"2861","2841台開","110/09/02","大慶-蘆洲",10,0,10
"2862","2841台開","110/09/02","永豐金-中正",0,20,-20
"2863","2841台開","110/09/02","元大-新竹經國",10,0,10
"2864","2841台開","110/09/02","日盛證券",6,25,-19
"2865","2841台開","110/09/02","富邦-左營",8,0,8
"2866","2841台開","110/09/02","台灣摩根士丹利",0,19,-19
"2867","2841台開","110/09/02","富邦-台北",7,0,7
"2868","2841台開","110/09/02","元大-復北",0,11,-11
"2869","2841台開","110/09/02","日盛-忠孝",6,0,6
"2870","2841台開","110/09/02","日盛-台中",10,20,-10
"2871","2841台開","110/09/02","大昌-安康",27,21,6
"2872","2841台開","110/09/02","富邦-新店",0,10,-10
"2873","2841台開","110/09/02","台新-台中",6,0,6
"2874","2841台開","110/09/02","國票-中和",0,8,-8
"2875","2841台開","110/09/02","新光-桃園",6,0,6
"2876","2841台開","110/09/02","元大-萬華",0,8,-8
"2877","2841台開","110/09/02","國泰-館前",6,0,6
"2878","2841台開","110/09/02","兆豐-高雄",0,6,-6
"2879","2841台開","110/09/02","元大-屏南",6,0,6
"2880","2841台開","110/09/02","群益金鼎-民權",0,6,-6
"2881","6207雷科","110/09/02","元大-高雄",52,3,49
"2882","6207雷科","110/09/02","新加坡商瑞銀",4,48,-44
"2883","6207雷科","110/09/02","凱基-高美館",21,0,21
"2884","6207雷科","110/09/02","摩根大通",9,30,-21
"2885","6207雷科","110/09/02","群益金鼎-大甲",12,0,12
"2886","6207雷科","110/09/02","元大-大灣",0,21,-21
"2887","6207雷科","110/09/02","永豐金-高雄",12,0,12
"2888","6207雷科","110/09/02","康和-石牌",0,20,-20
"2889","6207雷科","110/09/02","國泰-台南",20,10,10
"2890","6207雷科","110/09/02","群益金鼎-館前",0,20,-20
"2891","6207雷科","110/09/02","群益金鼎-瑞豐",10,0,10
"2892","6207雷科","110/09/02","華南永昌-虎尾",0,19,-19
"2893","6207雷科","110/09/02","元大-博愛",10,0,10
"2894","6207雷科","110/09/02","(牛牛牛)亞-鑫豐",0,13,-13
"2895","6207雷科","110/09/02","元富-板橋",5,0,5
"2896","6207雷科","110/09/02","大慶-泰山",0,10,-10
"2897","6207雷科","110/09/02","兆豐-桃園",5,0,5
"2898","6207雷科","110/09/02","元富-民權",0,10,-10
"2899","6207雷科","110/09/02","國泰-台中",5,0,5
"2900","6207雷科","110/09/02","港商野村",1,8,-7
"2901","6207雷科","110/09/02","凱基-市政",5,0,5
"2902","6207雷科","110/09/02","統一-員林",1,7,-6
"2903","6207雷科","110/09/02","富邦-左營",5,0,5
"2904","6207雷科","110/09/02","元大-木柵",0,6,-6
"2905","6207雷科","110/09/02","富邦-宜蘭",5,0,5
"2906","6207雷科","110/09/02","日盛-中壢",0,5,-5
"2907","6207雷科","110/09/02","元大-士林",6,1,5
"2908","6207雷科","110/09/02","兆豐-台中",0,5,-5
"2909","6207雷科","110/09/02","元大-六合",5,0,5
"2910","6207雷科","110/09/02","康和-延平",0,5,-5
"2911","3679新至陞","110/09/02","元大-成功",12,0,12
"2912","3679新至陞","110/09/02","凱基-台北",4,18,-14
"2913","3679新至陞","110/09/02","元大-大天母",10,0,10
"2914","3679新至陞","110/09/02","美林",0,10,-10
"2915","3679新至陞","110/09/02","富邦-嘉義",5,0,5
"2916","3679新至陞","110/09/02","兆豐-高雄",0,10,-10
"2917","3679新至陞","110/09/02","致和-東門",3,0,3
"2918","3679新至陞","110/09/02","摩根大通",0,9,-9
"2919","3679新至陞","110/09/02","元大-福營",3,0,3
"2920","3679新至陞","110/09/02","瑞士信貸",1,8,-7
"2921","3679新至陞","110/09/02","元大-小港",3,0,3
"2922","3679新至陞","110/09/02","美商高盛",0,3,-3
"2923","3679新至陞","110/09/02","元富-緯城",2,0,2
"2924","3679新至陞","110/09/02","新加坡商瑞銀",0,3,-3
"2925","3679新至陞","110/09/02","台中銀-員林",2,0,2
"2926","3679新至陞","110/09/02","日盛-樹林",0,2,-2
"2927","3679新至陞","110/09/02","新百王",2,0,2
"2928","3679新至陞","110/09/02","港商野村",0,2,-2
"2929","3679新至陞","110/09/02","國票-台東",2,0,2
"2930","3679新至陞","110/09/02","兆豐-公益",0,2,-2
"2931","3679新至陞","110/09/02","玉山證券",2,0,2
"2932","3679新至陞","110/09/02","玉山-台中",0,2,-2
"2933","3679新至陞","110/09/02","群益金鼎-台中",2,0,2
"2934","3679新至陞","110/09/02","凱基-高雄",0,2,-2
"2935","3679新至陞","110/09/02","群益金鼎-三民",2,0,2
"2936","3679新至陞","110/09/02","凱基-新店",0,2,-2
"2937","3679新至陞","110/09/02","富邦-岡山",2,0,2
"2938","3679新至陞","110/09/02","亞東-板橋",0,1,-1
"2939","3679新至陞","110/09/02","元大-文心興安",2,0,2
"2940","3679新至陞","110/09/02","富隆-長安",0,1,-1
"2941","2727王品","110/09/02","台灣摩根士丹利",50,32,18
"2942","2727王品","110/09/02","永豐金證券",1,32,-31
"2943","2727王品","110/09/02","摩根大通",15,0,15
"2944","2727王品","110/09/02","凱基-台北",12,34,-22
"2945","2727王品","110/09/02","美商高盛",15,3,12
"2946","2727王品","110/09/02","美林",8,27,-19
"2947","2727王品","110/09/02","富邦-桃園",10,0,10
"2948","2727王品","110/09/02","國泰-板橋",6,19,-13
"2949","2727王品","110/09/02","日盛-木柵",6,0,6
"2950","2727王品","110/09/02","凱基-板橋",0,11,-11
"2951","2727王品","110/09/02","新光",11,6,5
"2952","2727王品","110/09/02","國泰-台南",0,10,-10
"2953","2727王品","110/09/02","群益金鼎-高雄",5,0,5
"2954","2727王品","110/09/02","富邦-建國",10,20,-10
"2955","2727王品","110/09/02","凱基-基隆",5,0,5
"2956","2727王品","110/09/02","元大-內湖",0,10,-10
"2957","2727王品","110/09/02","元大-桃興",5,0,5
"2958","2727王品","110/09/02","永豐金-竹科",1,10,-9
"2959","2727王品","110/09/02","永豐金-新店",5,0,5
"2960","2727王品","110/09/02","元大-高雄",1,9,-8
"2961","2727王品","110/09/02","元富-延平",4,0,4
"2962","2727王品","110/09/02","玉山-台南",1,8,-7
"2963","2727王品","110/09/02","玉山-大里",4,0,4
"2964","2727王品","110/09/02","統一",1,7,-6
"2965","2727王品","110/09/02","國泰-台中",5,1,4
"2966","2727王品","110/09/02","中國信託-文心",0,6,-6
"2967","2727王品","110/09/02","元大-民生",4,0,4
"2968","2727王品","110/09/02","群益金鼎-東大",0,6,-6
"2969","2727王品","110/09/02","群益金鼎-宜蘭",3,0,3
"2970","2727王品","110/09/02","永豐金-忠孝",0,6,-6
"2971","1570力肯","110/09/02","國票-和平",85,0,85
"2972","1570力肯","110/09/02","新光",25,211,-186
"2973","1570力肯","110/09/02","元大-北三重",68,0,68
"2974","1570力肯","110/09/02","群益金鼎-高雄",5,60,-55
"2975","1570力肯","110/09/02","國票",30,0,30
"2976","1570力肯","110/09/02","摩根大通",0,54,-54
"2977","1570力肯","110/09/02","元大-內湖",30,1,29
"2978","1570力肯","110/09/02","元大-東泰",0,41,-41
"2979","1570力肯","110/09/02","第一金-嘉義",25,0,25
"2980","1570力肯","110/09/02","凱基-台北",1,32,-31
"2981","1570力肯","110/09/02","光和-田中",19,0,19
"2982","1570力肯","110/09/02","合庫-嘉義",1,30,-29
"2983","1570力肯","110/09/02","元大-板橋",16,0,16
"2984","1570力肯","110/09/02","元大-南屯",0,22,-22
"2985","1570力肯","110/09/02","兆豐-嘉義",16,1,15
"2986","1570力肯","110/09/02","元大-永和",0,22,-22
"2987","1570力肯","110/09/02","凱基-高美館",15,0,15
"2988","1570力肯","110/09/02","富邦-嘉義",0,20,-20
"2989","1570力肯","110/09/02","富邦-建國",15,0,15
"2990","1570力肯","110/09/02","華南永昌-彰化",0,15,-15
"2991","1570力肯","110/09/02","彰銀-七賢",14,0,14
"2992","1570力肯","110/09/02","(牛牛牛)亞-網路",1,15,-14
"2993","1570力肯","110/09/02","大慶-蘆洲",11,0,11
"2994","1570力肯","110/09/02","元大-員林中山",0,13,-13
"2995","1570力肯","110/09/02","富邦-新營",10,0,10
"2996","1570力肯","110/09/02","聯邦-三重",0,10,-10
"2997","1570力肯","110/09/02","永豐金-中和",10,0,10
"2998","1570力肯","110/09/02","群益金鼎-三民",0,8,-8
"2999","1570力肯","110/09/02","群益金鼎-瑞豐",9,0,9
"3000","1570力肯","110/09/02","日盛-園區",0,6,-6
"3001","6180橘子","110/09/02","華南永昌",84,1,83
"3002","6180橘子","110/09/02","亞東-高雄",0,22,-22
"3003","6180橘子","110/09/02","摩根大通",29,4,25
"3004","6180橘子","110/09/02","凱基-台北",3,23,-20
"3005","6180橘子","110/09/02","台灣摩根士丹利",23,0,23
"3006","6180橘子","110/09/02","元富-高雄",0,12,-12
"3007","6180橘子","110/09/02","美商高盛",25,6,19
"3008","6180橘子","110/09/02","新光",3,14,-11
"3009","6180橘子","110/09/02","台新證券",13,0,13
"3010","6180橘子","110/09/02","新光-台南",0,10,-10
"3011","6180橘子","110/09/02","美林",6,0,6
"3012","6180橘子","110/09/02","富邦-竹北",0,10,-10
"3013","6180橘子","110/09/02","元富-永和",6,0,6
"3014","6180橘子","110/09/02","元大-大益",0,10,-10
"3015","6180橘子","110/09/02","玉山-新莊",6,0,6
"3016","6180橘子","110/09/02","統一-彰化",0,8,-8
"3017","6180橘子","110/09/02","凱基-復興",5,0,5
"3018","6180橘子","110/09/02","元大-館前",0,8,-8
"3019","6180橘子","110/09/02","台新-台中",4,0,4
"3020","6180橘子","110/09/02","群益金鼎-西松",0,6,-6
"3021","6180橘子","110/09/02","國泰-敦南",10,6,4
"3022","6180橘子","110/09/02","合庫-三重",0,5,-5
"3023","6180橘子","110/09/02","日盛-永康",3,0,3
"3024","6180橘子","110/09/02","日盛-和美",0,5,-5
"3025","6180橘子","110/09/02","彰銀",3,0,3
"3026","6180橘子","110/09/02","統一-嘉義",0,5,-5
"3027","6180橘子","110/09/02","第一金-新竹",3,0,3
"3028","6180橘子","110/09/02","國泰-館前",0,5,-5
"3029","6180橘子","110/09/02","玉山證券",3,0,3
"3030","6180橘子","110/09/02","元大證券",1,6,-5
"3031","2390云辰","110/09/02","日盛-新莊",271,5,266
"3032","2390云辰","110/09/02","凱基-台北",35,186,-151
"3033","2390云辰","110/09/02","元大證券",118,6,112
"3034","2390云辰","110/09/02","元富-安南",4,147,-143
"3035","2390云辰","110/09/02","華南永昌-中正",106,4,102
"3036","2390云辰","110/09/02","元大-雙和",34,135,-101
"3037","2390云辰","110/09/02","台灣摩根士丹利",94,0,94
"3038","2390云辰","110/09/02","元大-南屯",2,82,-80
"3039","2390云辰","110/09/02","大慶-富順",76,2,74
"3040","2390云辰","110/09/02","元大-林園",0,79,-79
"3041","2390云辰","110/09/02","凱基-長庚",56,0,56
"3042","2390云辰","110/09/02","國泰-板橋",14,82,-68
"3043","2390云辰","110/09/02","元大-松山",55,0,55
"3044","2390云辰","110/09/02","元大-板橋",4,71,-67
"3045","2390云辰","110/09/02","玉山-台中",54,2,52
"3046","2390云辰","110/09/02","國泰-館前",3,59,-56
"3047","2390云辰","110/09/02","元富-高雄",52,2,50
"3048","2390云辰","110/09/02","凱基-和平",0,52,-52
"3049","2390云辰","110/09/02","元大-嘉義",50,5,45
"3050","2390云辰","110/09/02","康和",0,50,-50
"3051","2390云辰","110/09/02","華南永昌-合泰",40,0,40
"3052","2390云辰","110/09/02","第一金-中山",2,50,-48
"3053","2390云辰","110/09/02","統一-新台中",45,6,39
"3054","2390云辰","110/09/02","統一",7,55,-48
"3055","2390云辰","110/09/02","統一-員林",46,10,36
"3056","2390云辰","110/09/02","元富-信義",3,51,-48
"3057","2390云辰","110/09/02","美商高盛",49,14,35
"3058","2390云辰","110/09/02","土銀-花蓮",0,47,-47
"3059","2390云辰","110/09/02","元大-前金",35,0,35
"3060","2390云辰","110/09/02","元大-新盛",1,48,-47
"3061","2834臺企銀","110/08/31","新加坡商瑞銀",58095,14804,43291
"3062","2834臺企銀","110/08/31","台灣摩根士丹利",138752,224200,-85448
"3063","2834臺企銀","110/08/31","瑞士信貸",40098,11880,28218
"3064","2834臺企銀","110/08/31","美林",16181,38669,-22488
"3065","2834臺企銀","110/08/31","凱基-台北",24998,6606,18392
"3066","2834臺企銀","110/08/31","港商法國興業",11216,33391,-22175
"3067","2834臺企銀","110/08/31","摩根大通",37495,20369,17126
"3068","2834臺企銀","110/08/31","永豐金證券",227,4552,-4325
"3069","2834臺企銀","110/08/31","美商高盛",58399,41472,16927
"3070","2834臺企銀","110/08/31","法銀巴黎",2076,6320,-4244
"3071","2834臺企銀","110/08/31","港商野村",10074,4570,5504
"3072","2834臺企銀","110/08/31","元大證券",1048,5233,-4185
"3073","2834臺企銀","110/08/31","國票-長城",5000,0,5000
"3074","2834臺企銀","110/08/31","花旗環球",3376,5995,-2619
"3075","2834臺企銀","110/08/31","兆豐-寶成",1000,0,1000
"3076","2834臺企銀","110/08/31","華南永昌-高雄",24,1662,-1638
"3077","2834臺企銀","110/08/31","國泰-台南",609,2,607
"3078","2834臺企銀","110/08/31","豐農",1,760,-759
"3079","2834臺企銀","110/08/31","彰銀-台中",621,83,538
"3080","2834臺企銀","110/08/31","香港上海匯豐",549,1100,-551
"3081","2834臺企銀","110/08/31","元大-蘆洲",529,5,524
"3082","2834臺企銀","110/08/31","群益金鼎-彰化",59,499,-440
"3083","2834臺企銀","110/08/31","富邦-新竹",481,26,455
"3084","2834臺企銀","110/08/31","元大-苗栗",7,400,-393
"3085","2834臺企銀","110/08/31","群益金鼎-土城",418,0,418
"3086","2834臺企銀","110/08/31","凱基-興隆",0,320,-320
"3087","2834臺企銀","110/08/31","群益金鼎-萬華",400,0,400
"3088","2834臺企銀","110/08/31","日盛證券",442,747,-305
"3089","2834臺企銀","110/08/31","元大-復北",404,8,396
"3090","2834臺企銀","110/08/31","群益金鼎-板橋",30,325,-295
"3091","5511德昌","110/08/31","永豐金-市政",107,0,107
"3092","5511德昌","110/08/31","兆豐-台中港",0,80,-80
"3093","5511德昌","110/08/31","日盛-新竹",10,0,10
"3094","5511德昌","110/08/31","統一",0,10,-10
"3095","5511德昌","110/08/31","元大-彰化",10,0,10
"3096","5511德昌","110/08/31","致和-崇德",0,10,-10
"3097","5511德昌","110/08/31","第一金-台中",8,0,8
"3098","5511德昌","110/08/31","凱基-台北",1,10,-9
"3099","5511德昌","110/08/31","瑞士信貸",2,0,2
"3100","5511德昌","110/08/31","兆豐-台中",0,8,-8
"3101","5511德昌","110/08/31","元大-中壢",2,0,2
"3102","5511德昌","110/08/31","第一金",0,5,-5
"3103","5511德昌","110/08/31","元大-北屯",2,0,2
"3104","5511德昌","110/08/31","第一金-大稻埕",0,2,-2
"3105","5511德昌","110/08/31","兆豐-南京",1,0,1
"3106","5511德昌","110/08/31","元大-員林",0,2,-2
"3107","5511德昌","110/08/31","元大-東蘆",1,0,1
"3108","5511德昌","110/08/31","華南永昌-麻豆",0,2,-2
"3109","5511德昌","110/08/31","永豐金-苓雅",1,0,1
"3110","5511德昌","110/08/31","國泰-敦南",0,2,-2
"3111","5511德昌","110/08/31","永豐金-新店",1,0,1
"3112","5511德昌","110/08/31","康和-仁愛",0,2,-2
"3113","5511德昌","110/08/31","台中銀-員林",0,0,0
"3114","5511德昌","110/08/31","國票-中和",0,2,-2
"3115","5511德昌","110/08/31","中國信託",0,0,0
"3116","5511德昌","110/08/31","台新證券",0,1,-1
"3117","5511德昌","110/08/31","國泰-台中",0,0,0
"3118","5511德昌","110/08/31","國票-天祥",0,1,-1
"3119","5511德昌","110/08/31","群益金鼎-鳳山",0,0,0
"3120","5511德昌","110/08/31","中國信託-忠孝",0,1,-1
"3121","2489瑞軒","110/08/31","瑞士信貸",348,4,344
"3122","2489瑞軒","110/08/31","台灣摩根士丹利",17,427,-410
"3123","2489瑞軒","110/08/31","美林",278,81,197
"3124","2489瑞軒","110/08/31","摩根大通",116,283,-167
"3125","2489瑞軒","110/08/31","凱基-台北",133,0,133
"3126","2489瑞軒","110/08/31","日盛-嘉義",10,128,-118
"3127","2489瑞軒","110/08/31","國泰-敦南",134,46,88
"3128","2489瑞軒","110/08/31","第一金-新興",0,84,-84
"3129","2489瑞軒","110/08/31","新加坡商瑞銀",89,2,87
"3130","2489瑞軒","110/08/31","美商高盛",0,79,-79
"3131","2489瑞軒","110/08/31","合庫-桃園",61,3,58
"3132","2489瑞軒","110/08/31","元大-樹林",2,80,-78
"3133","2489瑞軒","110/08/31","台新-台中",50,0,50
"3134","2489瑞軒","110/08/31","元富-四維",3,67,-64
"3135","2489瑞軒","110/08/31","元富-潮州",41,0,41
"3136","2489瑞軒","110/08/31","永豐金-竹科",0,36,-36
"3137","2489瑞軒","110/08/31","新光",42,2,40
"3138","2489瑞軒","110/08/31","凱基-城中",0,35,-35
"3139","2489瑞軒","110/08/31","合庫-嘉義",30,0,30
"3140","2489瑞軒","110/08/31","元富-文心",0,30,-30
"3141","2489瑞軒","110/08/31","華南永昌-虎尾",91,61,30
"3142","2489瑞軒","110/08/31","富邦-永和",0,30,-30
"3143","2489瑞軒","110/08/31","元大-南屯",30,0,30
"3144","2489瑞軒","110/08/31","富邦-桃園",0,30,-30
"3145","2489瑞軒","110/08/31","元大-龍潭",30,2,28
"3146","2489瑞軒","110/08/31","永豐金-大園",1,30,-29
"3147","2489瑞軒","110/08/31","元大-楊梅",25,0,25
"3148","2489瑞軒","110/08/31","元大-彰化",0,26,-26
"3149","2489瑞軒","110/08/31","富邦-羅東",21,0,21
"3150","2489瑞軒","110/08/31","(牛牛牛)亞-鑫豐",36,59,-23
"3151","2428興勤","110/08/31","元大-南京",18,0,18
"3152","2428興勤","110/08/31","瑞士信貸",0,68,-68
"3153","2428興勤","110/08/31","凱基-信義",15,0,15
"3154","2428興勤","110/08/31","港商麥格理",0,29,-29
"3155","2428興勤","110/08/31","兆豐-景美",10,0,10
"3156","2428興勤","110/08/31","美林",2,28,-26
"3157","2428興勤","110/08/31","凱基-鳳山",10,0,10
"3158","2428興勤","110/08/31","摩根大通",9,33,-24
"3159","2428興勤","110/08/31","臺銀-金山",8,0,8
"3160","2428興勤","110/08/31","元大-西門",0,21,-21
"3161","2428興勤","110/08/31","元富-緯城",10,2,8
"3162","2428興勤","110/08/31","美商高盛",2,17,-15
"3163","2428興勤","110/08/31","港商野村",6,0,6
"3164","2428興勤","110/08/31","康和",0,14,-14
"3165","2428興勤","110/08/31","凱基-三重",8,2,6
"3166","2428興勤","110/08/31","康和-板橋",0,13,-13
"3167","2428興勤","110/08/31","凱基-台北",19,13,6
"3168","2428興勤","110/08/31","國票-安和",0,12,-12
"3169","2428興勤","110/08/31","元大-萬華",6,0,6
"3170","2428興勤","110/08/31","富邦證券",0,10,-10
"3171","2428興勤","110/08/31","元大-敦南",6,0,6
"3172","2428興勤","110/08/31","日盛-景美",1,10,-9
"3173","2428興勤","110/08/31","永豐金-板橋",6,0,6
"3174","2428興勤","110/08/31","台灣摩根士丹利",7,16,-9
"3175","2428興勤","110/08/31","永豐金-中正",6,0,6
"3176","2428興勤","110/08/31","永豐金-信義",0,8,-8
"3177","2428興勤","110/08/31","第一金-大稻埕",5,0,5
"3178","2428興勤","110/08/31","富邦-敦南",1,7,-6
"3179","2428興勤","110/08/31","凱基-天母",5,0,5
"3180","2428興勤","110/08/31","元大-屏東",0,6,-6
"3181","3176基亞","110/08/31","日盛-桃園",27,0,27
"3182","3176基亞","110/08/31","富邦-台北",0,126,-126
"3183","3176基亞","110/08/31","統一-土城",20,0,20
"3184","3176基亞","110/08/31","元大-大益",0,32,-32
"3185","3176基亞","110/08/31","富邦-羅東",21,1,20
"3186","3176基亞","110/08/31","台灣摩根士丹利",0,9,-9
"3187","3176基亞","110/08/31","摩根大通",16,0,16
"3188","3176基亞","110/08/31","統一-汐止",0,9,-9
"3189","3176基亞","110/08/31","永豐金-北高雄",15,0,15
"3190","3176基亞","110/08/31","凱基-湖口",0,9,-9
"3191","3176基亞","110/08/31","大慶-苗栗",10,0,10
"3192","3176基亞","110/08/31","華南永昌-公誠",1,10,-9
"3193","3176基亞","110/08/31","大慶-富順",10,0,10
"3194","3176基亞","110/08/31","元富-同大",1,8,-7
"3195","3176基亞","110/08/31","台新-左楠",10,0,10
"3196","3176基亞","110/08/31","凱基-台北",0,7,-7
"3197","3176基亞","110/08/31","華南永昌",11,1,10
"3198","3176基亞","110/08/31","元大-士林",1,8,-7
"3199","3176基亞","110/08/31","群益金鼎-高雄",8,1,7
"3200","3176基亞","110/08/31","元大-新營",0,7,-7
"3201","3176基亞","110/08/31","富邦-仁愛",6,0,6
"3202","3176基亞","110/08/31","新加坡商瑞銀",2,8,-6
"3203","3176基亞","110/08/31","宏遠-中和",5,0,5
"3204","3176基亞","110/08/31","中國信託-永康",0,6,-6
"3205","3176基亞","110/08/31","元富-草屯",5,0,5
"3206","3176基亞","110/08/31","元大-彰化民生",0,6,-6
"3207","3176基亞","110/08/31","台新-台中",5,0,5
"3208","3176基亞","110/08/31","永豐金-羅東",0,6,-6
"3209","3176基亞","110/08/31","群益金鼎-嘉義",5,0,5
"3210","3176基亞","110/08/31","國泰-館前",0,5,-5
"3211","2409友達","110/08/31","摩根大通",12388,3383,9005
"3212","2409友達","110/08/31","香港上海匯豐",651,24651,-24000
"3213","2409友達","110/08/31","美林",8491,2090,6401
"3214","2409友達","110/08/31","台灣摩根士丹利",4000,24791,-20791
"3215","2409友達","110/08/31","合庫證券",5242,27,5215
"3216","2409友達","110/08/31","永豐金證券",1612,6074,-4462
"3217","2409友達","110/08/31","台灣匯立證券",3859,0,3859
"3218","2409友達","110/08/31","花旗環球",81,3901,-3820
"3219","2409友達","110/08/31","瑞士信貸",4073,283,3790
"3220","2409友達","110/08/31","港商野村",3031,6453,-3422
"3221","2409友達","110/08/31","(牛牛牛)亞證券",3233,0,3233
"3222","2409友達","110/08/31","元大證券",1580,4157,-2577
"3223","2409友達","110/08/31","富邦證券",3021,57,2964
"3224","2409友達","110/08/31","凱基-員林",33,2035,-2002
"3225","2409友達","110/08/31","新加坡商瑞銀",3845,1353,2492
"3226","2409友達","110/08/31","法銀巴黎",348,1702,-1354
"3227","2409友達","110/08/31","寶盛",2013,0,2013
"3228","2409友達","110/08/31","凱基-東港",507,1794,-1287
"3229","2409友達","110/08/31","宏遠-館前",2233,286,1947
"3230","2409友達","110/08/31","元大-博愛",54,1174,-1120
"3231","2409友達","110/08/31","凱基-台北",4372,2949,1423
"3232","2409友達","110/08/31","日盛-中壢",92,1079,-987
"3233","2409友達","110/08/31","港商麥格理",1513,297,1216
"3234","2409友達","110/08/31","第一金-中壢",129,1071,-942
"3235","2409友達","110/08/31","日盛證券",1200,109,1091
"3236","2409友達","110/08/31","元大-豐原",85,933,-848
"3237","2409友達","110/08/31","美商高盛",2007,1058,949
"3238","2409友達","110/08/31","元大-北屯",107,871,-764
"3239","2409友達","110/08/31","元富-台南",857,3,854
"3240","2409友達","110/08/31","群益金鼎",53,722,-669
"3241","1315達新","110/08/31","元大-文心興安",6,0,6
"3242","1315達新","110/08/31","花旗環球",0,10,-10
"3243","1315達新","110/08/31","美林",8,3,5
"3244","1315達新","110/08/31","高橋-龍潭",0,7,-7
"3245","1315達新","110/08/31","致和-東門",5,0,5
"3246","1315達新","110/08/31","凱基-岡山",0,6,-6
"3247","1315達新","110/08/31","豐農",4,0,4
"3248","1315達新","110/08/31","華南永昌-彰化",0,5,-5
"3249","1315達新","110/08/31","美商高盛",3,0,3
"3250","1315達新","110/08/31","台新證券",2,5,-3
"3251","1315達新","110/08/31","富邦-永和",3,0,3
"3252","1315達新","110/08/31","元大-八德",0,3,-3
"3253","1315達新","110/08/31","元大-虎尾",3,0,3
"3254","1315達新","110/08/31","新百王",0,2,-2
"3255","1315達新","110/08/31","元大-花蓮",3,0,3
"3256","1315達新","110/08/31","兆豐-公益",0,2,-2
"3257","1315達新","110/08/31","第一金-豐原",2,0,2
"3258","1315達新","110/08/31","國泰-敦南",2,4,-2
"3259","1315達新","110/08/31","玉山證券",2,0,2
"3260","1315達新","110/08/31","元大-萬華",0,2,-2
"3261","1315達新","110/08/31","群益金鼎-新莊",2,0,2
"3262","1315達新","110/08/31","永豐金-中正",0,2,-2
"3263","1315達新","110/08/31","永豐金-敦南",2,0,2
"3264","1315達新","110/08/31","元富-虎尾",0,1,-1
"3265","1315達新","110/08/31","港商法國興業",1,0,1
"3266","1315達新","110/08/31","元富-文心",0,1,-1
"3267","1315達新","110/08/31","亞東-板橋",1,0,1
"3268","1315達新","110/08/31","凱基-桃園",0,1,-1
"3269","1315達新","110/08/31","兆豐-台南",1,0,1
"3270","1315達新","110/08/31","華南永昌-長虹",0,1,-1
"3271","2609陽明","110/08/31","港商麥格理",2365,7,2358
"3272","2609陽明","110/08/31","康和",70,7383,-7313
"3273","2609陽明","110/08/31","台灣摩根士丹利",4559,2270,2289
"3274","2609陽明","110/08/31","永豐金-信義",20,3830,-3810
"3275","2609陽明","110/08/31","美林",2036,829,1207
"3276","2609陽明","110/08/31","兆豐-大安",19,3214,-3195
"3277","2609陽明","110/08/31","花旗環球",810,24,786
"3278","2609陽明","110/08/31","瑞士信貸",1526,3530,-2004
"3279","2609陽明","110/08/31","新光-新竹",962,211,751
"3280","2609陽明","110/08/31","新加坡商瑞銀",576,2446,-1870
"3281","2609陽明","110/08/31","統一-新台中",578,32,546
"3282","2609陽明","110/08/31","凱基-台北",2645,4077,-1432
"3283","2609陽明","110/08/31","港商法國興業",519,8,511
"3284","2609陽明","110/08/31","富邦證券",1404,2833,-1429
"3285","2609陽明","110/08/31","元富",539,140,399
"3286","2609陽明","110/08/31","兆豐-三民",57,1026,-969
"3287","2609陽明","110/08/31","國泰-敦南",1724,1347,377
"3288","2609陽明","110/08/31","統一-仁愛",926,1805,-879
"3289","2609陽明","110/08/31","新光",1890,1520,370
"3290","2609陽明","110/08/31","華南永昌-南京",240,691,-451
"3291","2609陽明","110/08/31","第一金-桃園",429,100,329
"3292","2609陽明","110/08/31","日盛-文化",21,458,-437
"3293","2609陽明","110/08/31","陽信-石牌",350,48,302
"3294","2609陽明","110/08/31","群益金鼎-大安",58,418,-360
"3295","2609陽明","110/08/31","凱基-民權",278,21,257
"3296","2609陽明","110/08/31","台新-三民",90,446,-356
"3297","2609陽明","110/08/31","華南永昌-台中",339,92,247
"3298","2609陽明","110/08/31","日盛證券",155,503,-348
"3299","2609陽明","110/08/31","摩根大通",2595,2358,237
"3300","2609陽明","110/08/31","元大證券",1007,1299,-292
"3301","2636台驊投控","110/08/31","群益金鼎-敦南",149,2,147
"3302","2636台驊投控","110/08/31","日盛-台中",3,200,-197
"3303","2636台驊投控","110/08/31","亞東",137,3,134
"3304","2636台驊投控","110/08/31","統一-新台中",0,165,-165
"3305","2636台驊投控","110/08/31","臺銀-高雄",94,4,90
"3306","2636台驊投控","110/08/31","美商高盛",8,140,-132
"3307","2636台驊投控","110/08/31","宏遠-館前",52,0,52
"3308","2636台驊投控","110/08/31","瑞士信貸",89,213,-124
"3309","2636台驊投控","110/08/31","群益金鼎-古亭",44,4,40
"3310","2636台驊投控","110/08/31","富邦-虎尾",5,105,-100
"3311","2636台驊投控","110/08/31","永豐金-敦南",41,3,38
"3312","2636台驊投控","110/08/31","新加坡商瑞銀",11,71,-60
"3313","2636台驊投控","110/08/31","永豐金-大園",35,0,35
"3314","2636台驊投控","110/08/31","台灣摩根士丹利",43,101,-58
"3315","2636台驊投控","110/08/31","港商野村",372,343,29
"3316","2636台驊投控","110/08/31","凱基-台北",166,200,-34
"3317","2636台驊投控","110/08/31","凱基-桃園",28,3,25
"3318","2636台驊投控","110/08/31","凱基-中山",0,30,-30
"3319","2636台驊投控","110/08/31","凱基-南崁",25,1,24
"3320","2636台驊投控","110/08/31","台新-台南",5,33,-28
"3321","2636台驊投控","110/08/31","新光",67,46,21
"3322","2636台驊投控","110/08/31","日盛-復興",3,26,-23
"3323","2636台驊投控","110/08/31","台灣企銀-岡山",20,0,20
"3324","2636台驊投控","110/08/31","凱基-高美館",9,31,-22
"3325","2636台驊投控","110/08/31","合庫-自強",24,5,19
"3326","2636台驊投控","110/08/31","第一金-桃園",8,28,-20
"3327","2636台驊投控","110/08/31","元大-東門",20,1,19
"3328","2636台驊投控","110/08/31","摩根大通",67,87,-20
"3329","2636台驊投控","110/08/31","康和-石牌",16,0,16
"3330","2636台驊投控","110/08/31","永豐金-台南",3,23,-20
"3331","2867三商壽","110/08/31","美商高盛",202,34,168
"3332","2867三商壽","110/08/31","摩根大通",159,436,-277
"3333","2867三商壽","110/08/31","統一-平鎮",160,1,159
"3334","2867三商壽","110/08/31","凱基-台北",66,209,-143
"3335","2867三商壽","110/08/31","兆豐-岡山",110,0,110
"3336","2867三商壽","110/08/31","新光-新竹",0,101,-101
"3337","2867三商壽","110/08/31","元富-佳里",106,0,106
"3338","2867三商壽","110/08/31","富邦-三重",0,91,-91
"3339","2867三商壽","110/08/31","玉山-城中",100,0,100
"3340","2867三商壽","110/08/31","元大-太平",0,85,-85
"3341","2867三商壽","110/08/31","凱基-南崁",100,0,100
"3342","2867三商壽","110/08/31","元大-永春",0,75,-75
"3343","2867三商壽","110/08/31","瑞士信貸",98,1,97
"3344","2867三商壽","110/08/31","美林",65,116,-51
"3345","2867三商壽","110/08/31","華南永昌-朴子",80,0,80
"3346","2867三商壽","110/08/31","玉山-台大",0,50,-50
"3347","2867三商壽","110/08/31","凱基",73,0,73
"3348","2867三商壽","110/08/31","永豐金-新莊",0,50,-50
"3349","2867三商壽","110/08/31","元大-沙鹿",70,0,70
"3350","2867三商壽","110/08/31","永豐金-市政",0,50,-50
"3351","2867三商壽","110/08/31","元富-大昌",57,0,57
"3352","2867三商壽","110/08/31","港商野村",27,72,-45
"3353","2867三商壽","110/08/31","國泰-台中",64,10,54
"3354","2867三商壽","110/08/31","宏遠-台中",0,39,-39
"3355","2867三商壽","110/08/31","凱基-高雄",50,0,50
"3356","2867三商壽","110/08/31","宏遠證券",0,38,-38
"3357","2867三商壽","110/08/31","元大-桃園",50,0,50
"3358","2867三商壽","110/08/31","新光",22,55,-33
"3359","2867三商壽","110/08/31","華南永昌",46,2,44
"3360","2867三商壽","110/08/31","元大-開元",0,33,-33
"3361","5521工信","110/08/31","國票-敦北法人",411,0,411
"3362","5521工信","110/08/31","凱基-台北",144,477,-333
"3363","5521工信","110/08/31","光和-溪湖",150,0,150
"3364","5521工信","110/08/31","永豐金證券",0,200,-200
"3365","5521工信","110/08/31","元富",124,0,124
"3366","5521工信","110/08/31","港商野村",0,166,-166
"3367","5521工信","110/08/31","摩根大通",151,57,94
"3368","5521工信","110/08/31","統一-員林",0,70,-70
"3369","5521工信","110/08/31","富邦-員林",68,0,68
"3370","5521工信","110/08/31","台新-台中",0,62,-62
"3371","5521工信","110/08/31","元富-板橋",66,0,66
"3372","5521工信","110/08/31","永豐金-中正",0,50,-50
"3373","5521工信","110/08/31","第一金-新竹",40,4,36
"3374","5521工信","110/08/31","群益金鼎-基隆",0,34,-34
"3375","5521工信","110/08/31","新百王",32,0,32
"3376","5521工信","110/08/31","美商高盛",0,33,-33
"3377","5521工信","110/08/31","(牛牛牛)亞-鑫豐",32,6,26
"3378","5521工信","110/08/31","元大-台中",0,30,-30
"3379","5521工信","110/08/31","群益金鼎-大甲",21,0,21
"3380","5521工信","110/08/31","元大-南屯",10,35,-25
"3381","5521工信","110/08/31","華南永昌",36,15,21
"3382","5521工信","110/08/31","國泰-新莊",0,21,-21
"3383","5521工信","110/08/31","康和-澎湖",20,0,20
"3384","5521工信","110/08/31","元大-六合",0,20,-20
"3385","5521工信","110/08/31","元大-佳里",20,0,20
"3386","5521工信","110/08/31","國泰-台中",1,20,-19
"3387","5521工信","110/08/31","元大-沙鹿",19,0,19
"3388","5521工信","110/08/31","富邦-高雄",0,19,-19
"3389","5521工信","110/08/31","元富-基隆",15,0,15
"3390","5521工信","110/08/31","元大-斗六",1,20,-19
"3391","1471首利","110/08/31","永豐金-員林",25,0,25
"3392","1471首利","110/08/31","群益金鼎-東大",0,51,-51
"3393","1471首利","110/08/31","大昌-桃園",20,0,20
"3394","1471首利","110/08/31","元大-清水",5,40,-35
"3395","1471首利","110/08/31","華南永昌-中正",20,0,20
"3396","1471首利","110/08/31","臺銀",0,32,-32
"3397","1471首利","110/08/31","臺銀-臺中",15,0,15
"3398","1471首利","110/08/31","凱基-科園",0,32,-32
"3399","1471首利","110/08/31","大慶-富順",15,0,15
"3400","1471首利","110/08/31","元大-台南",0,30,-30
"3401","1471首利","110/08/31","台新-松江",15,0,15
"3402","1471首利","110/08/31","富邦-陽明",0,16,-16
"3403","1471首利","110/08/31","港商法國興業",13,0,13
"3404","1471首利","110/08/31","凱基-台北",0,13,-13
"3405","1471首利","110/08/31","瑞士信貸",11,0,11
"3406","1471首利","110/08/31","元大-竹科",0,11,-11
"3407","1471首利","110/08/31","日盛-鳳山",10,0,10
"3408","1471首利","110/08/31","美林",3,10,-7
"3409","1471首利","110/08/31","富邦-中壢",10,0,10
"3410","1471首利","110/08/31","玉山-大里",0,7,-7
"3411","1471首利","110/08/31","元大-中壢",10,0,10
"3412","1471首利","110/08/31","元富-安南",0,6,-6
"3413","1471首利","110/08/31","元大-板橋",10,0,10
"3414","1471首利","110/08/31","大昌-新店",0,6,-6
"3415","1471首利","110/08/31","台新-左楠",9,0,9
"3416","1471首利","110/08/31","元大-斗信",0,6,-6
"3417","1471首利","110/08/31","永豐金-三重",9,0,9
"3418","1471首利","110/08/31","元大-花蓮",0,5,-5
"3419","1471首利","110/08/31","國泰-台南",10,2,8
"3420","1471首利","110/08/31","永豐金-高雄",5,10,-5
"3421","2883開發金","110/08/31","新加坡商瑞銀",5199,2017,3182
"3422","2883開發金","110/08/31","香港上海匯豐",0,10048,-10048
"3423","2883開發金","110/08/31","亞東-新竹",2900,216,2684
"3424","2883開發金","110/08/31","元大證券",555,10482,-9927
"3425","2883開發金","110/08/31","瑞士信貸",2653,204,2449
"3426","2883開發金","110/08/31","第一金-忠孝",133,1540,-1407
"3427","2883開發金","110/08/31","台灣摩根士丹利",4184,2771,1413
"3428","2883開發金","110/08/31","摩根大通",1383,2786,-1403
"3429","2883開發金","110/08/31","富邦-永和",1249,146,1103
"3430","2883開發金","110/08/31","永豐金-板橋",5,1306,-1301
"3431","2883開發金","110/08/31","花旗環球",1908,911,997
"3432","2883開發金","110/08/31","國票-南京",5,1035,-1030
"3433","2883開發金","110/08/31","華南永昌-竹北",859,18,841
"3434","2883開發金","110/08/31","兆豐-三民",41,997,-956
"3435","2883開發金","110/08/31","元大-大灣",824,39,785
"3436","2883開發金","110/08/31","福勝",4,402,-398
"3437","2883開發金","110/08/31","日盛-台中",640,8,632
"3438","2883開發金","110/08/31","第一金-豐原",12,403,-391
"3439","2883開發金","110/08/31","港商法國興業",564,0,564
"3440","2883開發金","110/08/31","國泰-館前",102,484,-382
"3441","2883開發金","110/08/31","元富",795,258,537
"3442","2883開發金","110/08/31","兆豐-內湖",5,375,-370
"3443","2883開發金","110/08/31","國票-長城",507,4,503
"3444","2883開發金","110/08/31","法銀巴黎",154,513,-359
"3445","2883開發金","110/08/31","台灣企銀-竹北",500,0,500
"3446","2883開發金","110/08/31","統一",112,468,-356
"3447","2883開發金","110/08/31","華南永昌-中正",628,130,498
"3448","2883開發金","110/08/31","兆豐-桃園",87,435,-348
"3449","2883開發金","110/08/31","富邦-台中",456,40,416
"3450","2883開發金","110/08/31","富邦-仁愛",106,418,-312
"3451","6205詮欣","110/08/31","港商法國興業",13,0,13
"3452","6205詮欣","110/08/31","元大-中和",0,35,-35
"3453","6205詮欣","110/08/31","華南永昌-長虹",10,0,10
"3454","6205詮欣","110/08/31","台新證券",0,6,-6
"3455","6205詮欣","110/08/31","瑞士信貸",4,0,4
"3456","6205詮欣","110/08/31","玉山-左營",0,3,-3
"3457","6205詮欣","110/08/31","統一-屏東",3,0,3
"3458","6205詮欣","110/08/31","群益金鼎-三重",0,2,-2
"3459","6205詮欣","110/08/31","台中銀",3,0,3
"3460","6205詮欣","110/08/31","元大-汐止",0,2,-2
"3461","6205詮欣","110/08/31","元大-民雄",3,0,3
"3462","6205詮欣","110/08/31","日盛-台中",0,1,-1
"3463","6205詮欣","110/08/31","臺銀-民權",2,0,2
"3464","6205詮欣","110/08/31","美商高盛",0,1,-1
"3465","6205詮欣","110/08/31","國票-中和",2,0,2
"3466","6205詮欣","110/08/31","花旗環球",0,1,-1
"3467","6205詮欣","110/08/31","摩根大通",4,2,2
"3468","6205詮欣","110/08/31","國票-博愛",0,1,-1
"3469","6205詮欣","110/08/31","康和-板橋",2,0,2
"3470","6205詮欣","110/08/31","凱基-和平",0,1,-1
"3471","6205詮欣","110/08/31","富邦-苗栗",2,0,2
"3472","6205詮欣","110/08/31","富邦-陽明",0,1,-1
"3473","6205詮欣","110/08/31","美林",1,0,1
"3474","6205詮欣","110/08/31","臺銀-高雄",0,0,0
"3475","6205詮欣","110/08/31","第一金-大稻埕",1,0,1
"3476","6205詮欣","110/08/31","元大-大里",1,1,0
"3477","6205詮欣","110/08/31","第一金-路竹",1,0,1
"3478","6205詮欣","110/08/31","",NA,NA,NA
"3479","6205詮欣","110/08/31","元富-桃園",1,0,1
"3480","6205詮欣","110/08/31","",NA,NA,NA
"3481","1540喬福","110/08/31","日盛-樹林",5,0,5
"3482","1540喬福","110/08/31","富邦-中壢",0,19,-19
"3483","1540喬福","110/08/31","安泰",5,0,5
"3484","1540喬福","110/08/31","日盛-南京",0,6,-6
"3485","1540喬福","110/08/31","凱基-中壢",4,0,4
"3486","1540喬福","110/08/31","富邦-虎尾",0,4,-4
"3487","1540喬福","110/08/31","新光-台南",4,0,4
"3488","1540喬福","110/08/31","元富-中原",0,2,-2
"3489","1540喬福","110/08/31","土銀-新竹",2,0,2
"3490","1540喬福","110/08/31","美林",0,1,-1
"3491","1540喬福","110/08/31","元大-東蘆",2,0,2
"3492","1540喬福","110/08/31","美商高盛",0,1,-1
"3493","1540喬福","110/08/31","富邦-高雄",2,0,2
"3494","1540喬福","110/08/31","花旗環球",0,1,-1
"3495","1540喬福","110/08/31","凱基-斗六",2,0,2
"3496","1540喬福","110/08/31","元富",0,1,-1
"3497","1540喬福","110/08/31","合庫證券",2,0,2
"3498","1540喬福","110/08/31","康和-板橋",0,1,-1
"3499","1540喬福","110/08/31","群益金鼎-永和",2,0,2
"3500","1540喬福","110/08/31","元富-中港",0,0,0
"3501","1540喬福","110/08/31","國泰-忠孝",1,0,1
"3502","1540喬福","110/08/31","致和-南京",2,2,0
"3503","1540喬福","110/08/31","凱基",1,0,1
"3504","1540喬福","110/08/31","凱基-竹北",0,0,0
"3505","1540喬福","110/08/31","台新證券",1,0,1
"3506","1540喬福","110/08/31","凱基-竹科",0,0,0
"3507","1540喬福","110/08/31","國票-台南",1,0,1
"3508","1540喬福","110/08/31","元大-內湖",0,0,0
"3509","1540喬福","110/08/31","大昌",1,0,1
"3510","1540喬福","110/08/31","永豐金-中盛",0,0,0
"3511","2888新光金","110/08/31","元大證券",14689,281,14408
"3512","2888新光金","110/08/31","美商高盛",230,8929,-8699
"3513","2888新光金","110/08/31","元大-館前",3112,34,3078
"3514","2888新光金","110/08/31","美林",3678,9122,-5444
"3515","2888新光金","110/08/31","日盛-台中",2979,11,2968
"3516","2888新光金","110/08/31","亞東-新竹",30,4195,-4165
"3517","2888新光金","110/08/31","國泰-台南",1886,83,1803
"3518","2888新光金","110/08/31","凱基-台北",1467,5223,-3756
"3519","2888新光金","110/08/31","台灣摩根士丹利",5981,4550,1431
"3520","2888新光金","110/08/31","群益金鼎-崇德",14,2881,-2867
"3521","2888新光金","110/08/31","元大-大益",1444,45,1399
"3522","2888新光金","110/08/31","國票-南京",2,2505,-2503
"3523","2888新光金","110/08/31","兆豐-寶成",1436,61,1375
"3524","2888新光金","110/08/31","元富-城東",28,2075,-2047
"3525","2888新光金","110/08/31","瑞士信貸",2357,1139,1218
"3526","2888新光金","110/08/31","永豐金證券",197,2020,-1823
"3527","2888新光金","110/08/31","群益金鼎-彰化",1186,35,1151
"3528","2888新光金","110/08/31","摩根大通",2340,4119,-1779
"3529","2888新光金","110/08/31","兆豐-台中港",1205,99,1106
"3530","2888新光金","110/08/31","合庫證券",149,1703,-1554
"3531","2888新光金","110/08/31","(牛牛牛)亞-網路",1107,27,1080
"3532","2888新光金","110/08/31","元富-文心",22,1493,-1471
"3533","2888新光金","110/08/31","元大-豐原",1491,544,947
"3534","2888新光金","110/08/31","港商野村",288,1540,-1252
"3535","2888新光金","110/08/31","臺銀-金山",865,125,740
"3536","2888新光金","110/08/31","新加坡商瑞銀",1936,3101,-1165
"3537","2888新光金","110/08/31","元大-中壢",913,195,718
"3538","2888新光金","110/08/31","統一-新台中",54,1199,-1145
"3539","2888新光金","110/08/31","合庫-嘉義",740,74,666
"3540","2888新光金","110/08/31","華南永昌-台中",66,1192,-1126
"3541","1340勝悅","110/08/31","美林",11,1,10
"3542","1340勝悅","110/08/31","台中銀",0,15,-15
"3543","1340勝悅","110/08/31","日盛-忠孝",7,0,7
"3544","1340勝悅","110/08/31","安泰",0,8,-8
"3545","1340勝悅","110/08/31","臺灣企銀-埔墘",5,0,5
"3546","1340勝悅","110/08/31","摩根大通",0,6,-6
"3547","1340勝悅","110/08/31","瑞士信貸",5,0,5
"3548","1340勝悅","110/08/31","第一金-豐原",0,5,-5
"3549","1340勝悅","110/08/31","永豐金-三重",5,0,5
"3550","1340勝悅","110/08/31","元富-世貿",0,5,-5
"3551","1340勝悅","110/08/31","美商高盛",3,0,3
"3552","1340勝悅","110/08/31","國票-台東",0,5,-5
"3553","1340勝悅","110/08/31","玉山-左營",3,0,3
"3554","1340勝悅","110/08/31","永豐金-南投",0,5,-5
"3555","1340勝悅","110/08/31","國泰-敦南",3,0,3
"3556","1340勝悅","110/08/31","富邦-台中",0,4,-4
"3557","1340勝悅","110/08/31","元大-松江",3,0,3
"3558","1340勝悅","110/08/31","玉山-板橋",0,3,-3
"3559","1340勝悅","110/08/31","新光",2,0,2
"3560","1340勝悅","110/08/31","元大-彰化民生",0,3,-3
"3561","1340勝悅","110/08/31","群益金鼎-崇德",2,0,2
"3562","1340勝悅","110/08/31","(牛牛牛)亞-鑫豐",8,10,-2
"3563","1340勝悅","110/08/31","元大-東泰",2,0,2
"3564","1340勝悅","110/08/31","元大-竹山",0,2,-2
"3565","1340勝悅","110/08/31","國泰-新莊",1,0,1
"3566","1340勝悅","110/08/31","第一金-新竹",0,1,-1
"3567","1340勝悅","110/08/31","群益金鼎-高盛",1,0,1
"3568","1340勝悅","110/08/31","凱基-竹北",0,1,-1
"3569","1340勝悅","110/08/31","群益金鼎-館前",1,0,1
"3570","1340勝悅","110/08/31","統一-城中",0,0,0
"3571","6246臺龍","110/08/31","元富-宜蘭",13,0,13
"3572","6246臺龍","110/08/31","華南永昌-頭份",0,20,-20
"3573","6246臺龍","110/08/31","國票-桃園",6,0,6
"3574","6246臺龍","110/08/31","致和-台北",0,14,-14
"3575","6246臺龍","110/08/31","凱基-台北",5,0,5
"3576","6246臺龍","110/08/31","元大-博愛",0,7,-7
"3577","6246臺龍","110/08/31","國票-敦北法人",4,0,4
"3578","6246臺龍","110/08/31","群益金鼎-古亭",0,5,-5
"3579","6246臺龍","110/08/31","台新-屏東",3,0,3
"3580","6246臺龍","110/08/31","合庫-西台中",0,3,-3
"3581","6246臺龍","110/08/31","日盛-內湖",2,0,2
"3582","6246臺龍","110/08/31","群益金鼎-土城",0,3,-3
"3583","6246臺龍","110/08/31","日盛-大墩",2,0,2
"3584","6246臺龍","110/08/31","第一金-自由",0,2,-2
"3585","6246臺龍","110/08/31","元富-屏東",2,0,2
"3586","6246臺龍","110/08/31","台新證券",1,3,-2
"3587","6246臺龍","110/08/31","凱基-桃園",2,0,2
"3588","6246臺龍","110/08/31","台新-三民",0,2,-2
"3589","6246臺龍","110/08/31","華南永昌",2,0,2
"3590","6246臺龍","110/08/31","凱基-東門",0,2,-2
"3591","6246臺龍","110/08/31","元大-豐原站前",2,0,2
"3592","6246臺龍","110/08/31","元大-府城",0,2,-2
"3593","6246臺龍","110/08/31","元大-小港",2,0,2
"3594","6246臺龍","110/08/31","永豐金-新竹",0,2,-2
"3595","6246臺龍","110/08/31","元大-北屯",2,0,2
"3596","6246臺龍","110/08/31","日盛證券",0,1,-1
"3597","6246臺龍","110/08/31","日盛-新莊",1,0,1
"3598","6246臺龍","110/08/31","港商野村",0,1,-1
"3599","6246臺龍","110/08/31","元富-安南",1,0,1
"3600","6246臺龍","110/08/31","元大-沙鹿",0,1,-1
"3601","00715L期街口布蘭特正2","110/08/31","永豐金證券",4504,25,4479
"3602","00715L期街口布蘭特正2","110/08/31","元大-斗六",0,1401,-1401
"3603","00715L期街口布蘭特正2","110/08/31","元大證券",4224,444,3780
"3604","00715L期街口布蘭特正2","110/08/31","永豐金-台中",20,970,-950
"3605","00715L期街口布蘭特正2","110/08/31","國票",2499,0,2499
"3606","00715L期街口布蘭特正2","110/08/31","凱基-高美館",0,746,-746
"3607","00715L期街口布蘭特正2","110/08/31","群益金鼎",1981,0,1981
"3608","00715L期街口布蘭特正2","110/08/31","兆豐-中壢",0,737,-737
"3609","00715L期街口布蘭特正2","110/08/31","元富",1195,0,1195
"3610","00715L期街口布蘭特正2","110/08/31","群益金鼎-中壢",0,573,-573
"3611","00715L期街口布蘭特正2","110/08/31","國票-中港",1000,0,1000
"3612","00715L期街口布蘭特正2","110/08/31","富邦-彰化",100,606,-506
"3613","00715L期街口布蘭特正2","110/08/31","凱基-城中",1001,35,966
"3614","00715L期街口布蘭特正2","110/08/31","元大-金門",0,475,-475
"3615","00715L期街口布蘭特正2","110/08/31","康和",959,0,959
"3616","00715L期街口布蘭特正2","110/08/31","凱基-高雄",0,431,-431
"3617","00715L期街口布蘭特正2","110/08/31","統一",886,0,886
"3618","00715L期街口布蘭特正2","110/08/31","新光",43,382,-339
"3619","00715L期街口布蘭特正2","110/08/31","凱基-台北",684,0,684
"3620","00715L期街口布蘭特正2","110/08/31","元富-文心",21,341,-320
"3621","00715L期街口布蘭特正2","110/08/31","群益金鼎-宜蘭",653,7,646
"3622","00715L期街口布蘭特正2","110/08/31","富邦-嘉義",5,316,-311
"3623","00715L期街口布蘭特正2","110/08/31","永豐金-三重",625,0,625
"3624","00715L期街口布蘭特正2","110/08/31","新光-桃園",42,339,-297
"3625","00715L期街口布蘭特正2","110/08/31","合庫證券",605,10,595
"3626","00715L期街口布蘭特正2","110/08/31","台新-台南",0,290,-290
"3627","00715L期街口布蘭特正2","110/08/31","兆豐-台中",502,0,502
"3628","00715L期街口布蘭特正2","110/08/31","富邦-中壢",0,284,-284
"3629","00715L期街口布蘭特正2","110/08/31","台新-松江",500,0,500
"3630","00715L期街口布蘭特正2","110/08/31","台中銀-豐原",5,265,-260
"3631","8941關中","110/08/31","元大-金華",3,0,3
"3632","8941關中","110/08/31","臺銀-新竹",0,3,-3
"3633","8941關中","110/08/31","永豐金-三重",3,0,3
"3634","8941關中","110/08/31","富邦-仁愛",0,2,-2
"3635","8941關中","110/08/31","國泰-新莊",2,0,2
"3636","8941關中","110/08/31","統一-彰化",0,1,-1
"3637","8941關中","110/08/31","富邦-左營",0,0,0
"3638","8941關中","110/08/31","凱基-台北",0,1,-1
"3639","8941關中","110/08/31","元大-桃興",1,1,0
"3640","8941關中","110/08/31","元大-路竹",0,1,-1
"3641","8941關中","110/08/31","永豐金-南投",0,0,0
"3642","8941關中","110/08/31","富邦-左營",0,0,0
"3643","8941關中","110/08/31","",NA,NA,NA
"3644","8941關中","110/08/31","元大-桃興",1,1,0
"3645","8941關中","110/08/31","",NA,NA,NA
"3646","8941關中","110/08/31","永豐金-南投",0,0,0
"3647","8941關中","110/08/31","",NA,NA,NA
"3648","8941關中","110/08/31","",NA,NA,NA
"3649","8941關中","110/08/31","",NA,NA,NA
"3650","8941關中","110/08/31","",NA,NA,NA
"3651","8941關中","110/08/31","",NA,NA,NA
"3652","8941關中","110/08/31","",NA,NA,NA
"3653","8941關中","110/08/31","",NA,NA,NA
"3654","8941關中","110/08/31","",NA,NA,NA
"3655","8941關中","110/08/31","",NA,NA,NA
"3656","8941關中","110/08/31","",NA,NA,NA
"3657","8941關中","110/08/31","",NA,NA,NA
"3658","8941關中","110/08/31","",NA,NA,NA
"3659","8941關中","110/08/31","",NA,NA,NA
"3660","8941關中","110/08/31","",NA,NA,NA
"3661","8936國統","110/08/31","摩根大通",222,7,215
"3662","8936國統","110/08/31","永豐金-高雄",0,100,-100
"3663","8936國統","110/08/31","台灣摩根士丹利",152,0,152
"3664","8936國統","110/08/31","台新-高雄",75,147,-72
"3665","8936國統","110/08/31","美商高盛",153,3,150
"3666","8936國統","110/08/31","統一-金門",0,45,-45
"3667","8936國統","110/08/31","華南永昌-高雄",142,12,130
"3668","8936國統","110/08/31","凱基-信義",1,30,-29
"3669","8936國統","110/08/31","新加坡商瑞銀",83,9,74
"3670","8936國統","110/08/31","新光-高雄",6,33,-27
"3671","8936國統","110/08/31","港商野村",62,4,58
"3672","8936國統","110/08/31","元大-天母",2,26,-24
"3673","8936國統","110/08/31","永豐金-彰化",50,20,30
"3674","8936國統","110/08/31","元大-博愛",1,23,-22
"3675","8936國統","110/08/31","元富-敦南",19,0,19
"3676","8936國統","110/08/31","元大-員林",0,20,-20
"3677","8936國統","110/08/31","凱基-台北",90,71,19
"3678","8936國統","110/08/31","元大-佳里",0,19,-19
"3679","8936國統","110/08/31","富邦-員林",20,4,16
"3680","8936國統","110/08/31","國泰-高雄",0,18,-18
"3681","8936國統","110/08/31","日盛-豐原",15,0,15
"3682","8936國統","110/08/31","國泰-敦南",6,23,-17
"3683","8936國統","110/08/31","瑞士信貸",15,0,15
"3684","8936國統","110/08/31","富邦-羅東",0,16,-16
"3685","8936國統","110/08/31","第一金-華江",15,0,15
"3686","8936國統","110/08/31","凱基-員林",0,15,-15
"3687","8936國統","110/08/31","美林",15,1,14
"3688","8936國統","110/08/31","新光-桃園",0,12,-12
"3689","8936國統","110/08/31","玉山-高雄",16,3,13
"3690","8936國統","110/08/31","台新-左楠",0,11,-11
"3691","6226光鼎","110/08/31","美商高盛",617,39,578
"3692","6226光鼎","110/08/31","國泰-敦南",37,130,-93
"3693","6226光鼎","110/08/31","港商野村",256,59,197
"3694","6226光鼎","110/08/31","元大-員林中山",5,81,-76
"3695","6226光鼎","110/08/31","美林",201,59,142
"3696","6226光鼎","110/08/31","宏遠-光隆",0,65,-65
"3697","6226光鼎","110/08/31","摩根大通",166,78,88
"3698","6226光鼎","110/08/31","新光",21,75,-54
"3699","6226光鼎","110/08/31","群益金鼎-鳳山",91,3,88
"3700","6226光鼎","110/08/31","永全-南崁",0,40,-40
"3701","6226光鼎","110/08/31","亞東-高雄",60,0,60
"3702","6226光鼎","110/08/31","群益金鼎-忠孝",3,40,-37
"3703","6226光鼎","110/08/31","新加坡商瑞銀",44,4,40
"3704","6226光鼎","110/08/31","台新證券",11,47,-36
"3705","6226光鼎","110/08/31","凱基-台北",45,15,30
"3706","6226光鼎","110/08/31","凱基-中山",0,36,-36
"3707","6226光鼎","110/08/31","元大-新竹經國",31,1,30
"3708","6226光鼎","110/08/31","元大-大灣",0,34,-34
"3709","6226光鼎","110/08/31","兆豐-松德",27,0,27
"3710","6226光鼎","110/08/31","元大-東泰",0,33,-33
"3711","6226光鼎","110/08/31","日盛-員林",29,3,26
"3712","6226光鼎","110/08/31","日盛-八德",11,42,-31
"3713","6226光鼎","110/08/31","元大-小港",29,3,26
"3714","6226光鼎","110/08/31","元富-城中",0,30,-30
"3715","6226光鼎","110/08/31","新光-台中",25,4,21
"3716","6226光鼎","110/08/31","永豐金-台中",3,33,-30
"3717","6226光鼎","110/08/31","群益金鼎-土城",20,0,20
"3718","6226光鼎","110/08/31","群益金鼎-中壢",1,27,-26
"3719","6226光鼎","110/08/31","華南永昌-台中",30,10,20
"3720","6226光鼎","110/08/31","元大-北港",0,26,-26
"3721","2363矽統","110/08/31","康和-台中",674,11,663
"3722","2363矽統","110/08/31","瑞士信貸",0,1792,-1792
"3723","2363矽統","110/08/31","台灣摩根士丹利",210,10,200
"3724","2363矽統","110/08/31","凱基-台北",886,1639,-753
"3725","2363矽統","110/08/31","國泰-敦南",360,168,192
"3726","2363矽統","110/08/31","第一金-桃園",22,620,-598
"3727","2363矽統","110/08/31","元大-前金",267,89,178
"3728","2363矽統","110/08/31","港商野村",242,834,-592
"3729","2363矽統","110/08/31","元大-大統",166,14,152
"3730","2363矽統","110/08/31","凱基-站前",85,565,-480
"3731","2363矽統","110/08/31","日盛-中和",139,8,131
"3732","2363矽統","110/08/31","國票-南港",2,409,-407
"3733","2363矽統","110/08/31","陽信-石牌",141,18,123
"3734","2363矽統","110/08/31","元大-承德",5,402,-397
"3735","2363矽統","110/08/31","第一金-新竹",399,286,113
"3736","2363矽統","110/08/31","台新-新莊",15,308,-293
"3737","2363矽統","110/08/31","國票-博愛",111,3,108
"3738","2363矽統","110/08/31","兆豐-公益",9,223,-214
"3739","2363矽統","110/08/31","元大-士林",119,12,107
"3740","2363矽統","110/08/31","第一金-豐原",40,211,-171
"3741","2363矽統","110/08/31","永豐金-敦南",125,22,103
"3742","2363矽統","110/08/31","永豐金-台中",8,171,-163
"3743","2363矽統","110/08/31","永豐金-中壢",103,0,103
"3744","2363矽統","110/08/31","元大-南勢角",8,135,-127
"3745","2363矽統","110/08/31","彰銀-台中",101,1,100
"3746","2363矽統","110/08/31","群益金鼎",8,126,-118
"3747","2363矽統","110/08/31","台新-台中",113,28,85
"3748","2363矽統","110/08/31","富邦-嘉義",91,209,-118
"3749","2363矽統","110/08/31","臺銀-臺南",94,11,83
"3750","2363矽統","110/08/31","美商高盛",90,206,-116
"3751","8112至上","110/08/31","香港上海匯豐",442,37,405
"3752","8112至上","110/08/31","第一金-頭份",2,99,-97
"3753","8112至上","110/08/31","美林",91,8,83
"3754","8112至上","110/08/31","富邦-仁愛",1,73,-72
"3755","8112至上","110/08/31","凱基-內埔",45,0,45
"3756","8112至上","110/08/31","臺灣企銀-桃園",0,70,-70
"3757","8112至上","110/08/31","國票-南京",40,0,40
"3758","8112至上","110/08/31","法銀巴黎",0,49,-49
"3759","8112至上","110/08/31","元大-士林",42,2,40
"3760","8112至上","110/08/31","元大-仁愛",1,50,-49
"3761","8112至上","110/08/31","瑞士信貸",38,0,38
"3762","8112至上","110/08/31","大昌-桃園",0,40,-40
"3763","8112至上","110/08/31","元大-楊梅",30,0,30
"3764","8112至上","110/08/31","花旗環球",0,30,-30
"3765","8112至上","110/08/31","(牛牛牛)亞-鑫豐",23,0,23
"3766","8112至上","110/08/31","群益金鼎-瑞豐",0,30,-30
"3767","8112至上","110/08/31","富邦-虎尾",24,1,23
"3768","8112至上","110/08/31","日盛-雙和",9,37,-28
"3769","8112至上","110/08/31","群益金鼎-東門",21,0,21
"3770","8112至上","110/08/31","國泰-板橋",0,28,-28
"3771","8112至上","110/08/31","元大-永和",21,0,21
"3772","8112至上","110/08/31","台灣摩根士丹利",24,47,-23
"3773","8112至上","110/08/31","元大-新盛",20,0,20
"3774","8112至上","110/08/31","富邦-南屯",0,20,-20
"3775","8112至上","110/08/31","凱基-士林",19,0,19
"3776","8112至上","110/08/31","元大-小港",0,20,-20
"3777","8112至上","110/08/31","永豐金-竹科",18,0,18
"3778","8112至上","110/08/31","玉山-士林",1,20,-19
"3779","8112至上","110/08/31","凱基-松山",20,4,16
"3780","8112至上","110/08/31","群益金鼎-基隆",2,21,-19
"3781","1570力肯","110/08/31","香港上海匯豐",53,0,53
"3782","1570力肯","110/08/31","元大-板橋",11,60,-49
"3783","1570力肯","110/08/31","凱基-市政",30,1,29
"3784","1570力肯","110/08/31","群益金鼎-北高雄",0,27,-27
"3785","1570力肯","110/08/31","第一金-嘉義",20,0,20
"3786","1570力肯","110/08/31","元富-世貿",0,20,-20
"3787","1570力肯","110/08/31","台新-台南",20,0,20
"3788","1570力肯","110/08/31","永豐金-中壢",0,19,-19
"3789","1570力肯","110/08/31","宏遠-光隆",20,1,19
"3790","1570力肯","110/08/31","兆豐-員林",0,17,-17
"3791","1570力肯","110/08/31","康和-高雄",18,0,18
"3792","1570力肯","110/08/31","摩根大通",0,16,-16
"3793","1570力肯","110/08/31","日茂-南投",17,0,17
"3794","1570力肯","110/08/31","凱基-台北",20,35,-15
"3795","1570力肯","110/08/31","台新-台中",17,1,16
"3796","1570力肯","110/08/31","元大-竹南",1,16,-15
"3797","1570力肯","110/08/31","兆豐-天母",15,0,15
"3798","1570力肯","110/08/31","新光",8,22,-14
"3799","1570力肯","110/08/31","元大-鳳中",18,4,14
"3800","1570力肯","110/08/31","(牛牛牛)亞-鑫豐",11,23,-12
"3801","1570力肯","110/08/31","合庫-嘉義",10,0,10
"3802","1570力肯","110/08/31","臺銀-臺南",0,11,-11
"3803","1570力肯","110/08/31","日盛-員林",10,0,10
"3804","1570力肯","110/08/31","日盛-八德",0,11,-11
"3805","1570力肯","110/08/31","元富-草屯",10,0,10
"3806","1570力肯","110/08/31","富邦-北港",0,11,-11
"3807","1570力肯","110/08/31","國票-九鼎",10,0,10
"3808","1570力肯","110/08/31","日茂",0,10,-10
"3809","1570力肯","110/08/31","國泰-台中",10,0,10
"3810","1570力肯","110/08/31","凱基-東勢",0,10,-10
"3811","2929淘帝","110/08/31","美林",47,2,45
"3812","2929淘帝","110/08/31","元富-敦南",0,121,-121
"3813","2929淘帝","110/08/31","兆豐-大同",37,0,37
"3814","2929淘帝","110/08/31","元富-彰化",0,20,-20
"3815","2929淘帝","110/08/31","摩根大通",27,0,27
"3816","2929淘帝","110/08/31","新加坡商瑞銀",0,15,-15
"3817","2929淘帝","110/08/31","港商野村",52,31,21
"3818","2929淘帝","110/08/31","元大-豐原站前",0,10,-10
"3819","2929淘帝","110/08/31","大昌",10,0,10
"3820","2929淘帝","110/08/31","台新證券",0,5,-5
"3821","2929淘帝","110/08/31","港商法國興業",8,0,8
"3822","2929淘帝","110/08/31","華南永昌-台中",0,5,-5
"3823","2929淘帝","110/08/31","瑞士信貸",6,0,6
"3824","2929淘帝","110/08/31","元大-士林",0,4,-4
"3825","2929淘帝","110/08/31","元大-大雅",6,0,6
"3826","2929淘帝","110/08/31","光和-嘉義",0,3,-3
"3827","2929淘帝","110/08/31","第一金-忠孝",5,0,5
"3828","2929淘帝","110/08/31","臺銀-金山",0,2,-2
"3829","2929淘帝","110/08/31","凱基-東門",5,0,5
"3830","2929淘帝","110/08/31","日盛-雙和",0,2,-2
"3831","2929淘帝","110/08/31","凱基-台北",7,2,5
"3832","2929淘帝","110/08/31","元富-三重",0,2,-2
"3833","2929淘帝","110/08/31","永豐金-板橋",5,0,5
"3834","2929淘帝","110/08/31","元富-中原",0,2,-2
"3835","2929淘帝","110/08/31","元富-新竹",4,0,4
"3836","2929淘帝","110/08/31","(牛牛牛)亞-鑫豐",0,2,-2
"3837","2929淘帝","110/08/31","玉山-士林",4,0,4
"3838","2929淘帝","110/08/31","中國信託",0,2,-2
"3839","2929淘帝","110/08/31","兆豐-桃鶯",3,0,3
"3840","2929淘帝","110/08/31","大昌-新竹",0,2,-2
"3841","5410國眾","110/08/31","永豐金-內湖",20,0,20
"3842","5410國眾","110/08/31","群益金鼎-民權",0,28,-28
"3843","5410國眾","110/08/31","臺銀-臺南",4,0,4
"3844","5410國眾","110/08/31","元大-板橋",0,4,-4
"3845","5410國眾","110/08/31","國泰-台中",4,0,4
"3846","5410國眾","110/08/31","寶盛",0,3,-3
"3847","5410國眾","110/08/31","中國信託-高雄",3,0,3
"3848","5410國眾","110/08/31","兆豐-北高雄",0,3,-3
"3849","5410國眾","110/08/31","台新證券",3,0,3
"3850","5410國眾","110/08/31","國票-和平",0,3,-3
"3851","5410國眾","110/08/31","元大-中壢",3,0,3
"3852","5410國眾","110/08/31","新光",0,3,-3
"3853","5410國眾","110/08/31","新光-台中",2,0,2
"3854","5410國眾","110/08/31","凱基-桃園",0,3,-3
"3855","5410國眾","110/08/31","凱基-科園",2,0,2
"3856","5410國眾","110/08/31","凱基-台南",0,3,-3
"3857","5410國眾","110/08/31","凱基-永康",2,0,2
"3858","5410國眾","110/08/31","富邦-嘉義",0,2,-2
"3859","5410國眾","110/08/31","凱基-興隆",2,0,2
"3860","5410國眾","110/08/31","元大-斗六",0,2,-2
"3861","5410國眾","110/08/31","元大-長庚",2,0,2
"3862","5410國眾","110/08/31","元大-土城學府",0,2,-2
"3863","5410國眾","110/08/31","臺銀-臺中",1,0,1
"3864","5410國眾","110/08/31","永豐金-埔里",0,2,-2
"3865","5410國眾","110/08/31","元富-埔里",1,0,1
"3866","5410國眾","110/08/31","國泰-敦南",0,1,-1
"3867","5410國眾","110/08/31","元富-西松",1,0,1
"3868","5410國眾","110/08/31","群益金鼎-中壢",0,1,-1
"3869","5410國眾","110/08/31","中國信託-永康",1,0,1
"3870","5410國眾","110/08/31","富邦-新店",0,1,-1
"3871","2841台開","110/08/31","宏遠-館前",150,0,150
"3872","2841台開","110/08/31","港商野村",0,171,-171
"3873","2841台開","110/08/31","永豐金-敦南",62,28,34
"3874","2841台開","110/08/31","元大-台中中港",0,39,-39
"3875","2841台開","110/08/31","日盛證券",21,8,13
"3876","2841台開","110/08/31","統一-士林",5,25,-20
"3877","2841台開","110/08/31","大慶-蘆洲",10,0,10
"3878","2841台開","110/08/31","永豐金-復興",0,11,-11
"3879","2841台開","110/08/31","元大-善化",10,0,10
"3880","2841台開","110/08/31","元富-嘉義",0,10,-10
"3881","2841台開","110/08/31","元大-新莊",10,0,10
"3882","2841台開","110/08/31","全泰證券",0,10,-10
"3883","2841台開","110/08/31","大昌-安康",15,6,9
"3884","2841台開","110/08/31","群益金鼎-彰化",0,10,-10
"3885","2841台開","110/08/31","元大-南屯",8,0,8
"3886","2841台開","110/08/31","元大-豐原",0,10,-10
"3887","2841台開","110/08/31","元大-台南",8,0,8
"3888","2841台開","110/08/31","台新證券",0,8,-8
"3889","2841台開","110/08/31","第一金-台南",6,0,6
"3890","2841台開","110/08/31","群益金鼎-丹鳳",0,6,-6
"3891","2841台開","110/08/31","第一金-自由",6,0,6
"3892","2841台開","110/08/31","凱基-鳳山",0,6,-6
"3893","2841台開","110/08/31","台新-台中",6,0,6
"3894","2841台開","110/08/31","元大-大里德芳",0,6,-6
"3895","2841台開","110/08/31","凱基-興隆",6,0,6
"3896","2841台開","110/08/31","日盛-屏東",0,5,-5
"3897","2841台開","110/08/31","元大-屏南",6,0,6
"3898","2841台開","110/08/31","台中銀",0,5,-5
"3899","2841台開","110/08/31","凱基-東港",5,0,5
"3900","2841台開","110/08/31","元大-景美",0,5,-5
"3901","6207雷科","110/08/31","元大-高雄",51,0,51
"3902","6207雷科","110/08/31","(牛牛牛)亞-鑫豐",0,67,-67
"3903","6207雷科","110/08/31","元大-大統",18,0,18
"3904","6207雷科","110/08/31","華南永昌-林口",0,13,-13
"3905","6207雷科","110/08/31","日盛-桃園",15,0,15
"3906","6207雷科","110/08/31","國票-台中",0,12,-12
"3907","6207雷科","110/08/31","群益金鼎-瑞豐",15,1,14
"3908","6207雷科","110/08/31","中國信託-新竹",0,10,-10
"3909","6207雷科","110/08/31","摩根大通",18,5,13
"3910","6207雷科","110/08/31","元大-府城",0,10,-10
"3911","6207雷科","110/08/31","永豐金-高雄",11,0,11
"3912","6207雷科","110/08/31","元大-敦南",0,10,-10
"3913","6207雷科","110/08/31","群益金鼎-新竹",8,0,8
"3914","6207雷科","110/08/31","日盛-台南",0,7,-7
"3915","6207雷科","110/08/31","凱基-中山",6,1,5
"3916","6207雷科","110/08/31","統一-屏東",0,7,-7
"3917","6207雷科","110/08/31","華南永昌-古亭",5,0,5
"3918","6207雷科","110/08/31","元富-中港",0,7,-7
"3919","6207雷科","110/08/31","元大-鳳山",7,2,5
"3920","6207雷科","110/08/31","兆豐-嘉義",0,6,-6
"3921","6207雷科","110/08/31","永豐金-北高雄",5,0,5
"3922","6207雷科","110/08/31","元富-三重",0,5,-5
"3923","6207雷科","110/08/31","富邦-桃園",4,0,4
"3924","6207雷科","110/08/31","元富-新興",0,5,-5
"3925","6207雷科","110/08/31","日盛證券",3,0,3
"3926","6207雷科","110/08/31","日盛-高雄",0,4,-4
"3927","6207雷科","110/08/31","日盛-龍潭",3,0,3
"3928","6207雷科","110/08/31","兆豐-三民",1,5,-4
"3929","6207雷科","110/08/31","富邦-中壢",3,0,3
"3930","6207雷科","110/08/31","合庫-自強",0,3,-3
"3931","3679新至陞","110/08/31","凱基-中山",6,0,6
"3932","3679新至陞","110/08/31","土銀-建國",0,17,-17
"3933","3679新至陞","110/08/31","(牛牛牛)亞-網路",5,0,5
"3934","3679新至陞","110/08/31","凱基-竹科",0,11,-11
"3935","3679新至陞","110/08/31","台中銀-員林",4,0,4
"3936","3679新至陞","110/08/31","摩根大通",1,6,-5
"3937","3679新至陞","110/08/31","國泰-松江",3,0,3
"3938","3679新至陞","110/08/31","玉山-台大",0,4,-4
"3939","3679新至陞","110/08/31","永豐金-南投",3,0,3
"3940","3679新至陞","110/08/31","瑞士信貸",0,2,-2
"3941","3679新至陞","110/08/31","康和-台中",2,0,2
"3942","3679新至陞","110/08/31","國泰-敦南",0,2,-2
"3943","3679新至陞","110/08/31","玉山-高雄",2,0,2
"3944","3679新至陞","110/08/31","永豐金-內湖",0,2,-2
"3945","3679新至陞","110/08/31","元大-新莊",2,0,2
"3946","3679新至陞","110/08/31","台灣摩根士丹利",0,1,-1
"3947","3679新至陞","110/08/31","土銀-台中",1,0,1
"3948","3679新至陞","110/08/31","中國信託",0,1,-1
"3949","3679新至陞","110/08/31","臺銀",1,0,1
"3950","3679新至陞","110/08/31","凱基-新店",0,1,-1
"3951","3679新至陞","110/08/31","臺銀-高雄",1,0,1
"3952","3679新至陞","110/08/31","元大-南海",0,1,-1
"3953","3679新至陞","110/08/31","亞東",1,0,1
"3954","3679新至陞","110/08/31","元大-木柵",0,1,-1
"3955","3679新至陞","110/08/31","統一-敦南",1,0,1
"3956","3679新至陞","110/08/31","元大-東港",0,1,-1
"3957","3679新至陞","110/08/31","大昌-桃園",1,0,1
"3958","3679新至陞","110/08/31","永豐金-敦南",0,1,-1
"3959","3679新至陞","110/08/31","元大-大里",1,0,1
"3960","3679新至陞","110/08/31","元大證券",1,1,0
"3961","2727王品","110/08/31","台灣摩根士丹利",84,8,76
"3962","2727王品","110/08/31","花旗環球",0,30,-30
"3963","2727王品","110/08/31","瑞士信貸",50,6,44
"3964","2727王品","110/08/31","凱基-信義",0,18,-18
"3965","2727王品","110/08/31","華南永昌-鳳山",15,0,15
"3966","2727王品","110/08/31","港商野村",6,22,-16
"3967","2727王品","110/08/31","合庫-新竹",10,1,9
"3968","2727王品","110/08/31","永豐金-苓雅",0,15,-15
"3969","2727王品","110/08/31","合庫-台中",7,0,7
"3970","2727王品","110/08/31","富邦-羅東",0,11,-11
"3971","2727王品","110/08/31","台新證券",14,7,7
"3972","2727王品","110/08/31","中國信託",1,10,-9
"3973","2727王品","110/08/31","安泰",5,0,5
"3974","2727王品","110/08/31","國泰證券",0,9,-9
"3975","2727王品","110/08/31","新光",5,0,5
"3976","2727王品","110/08/31","日盛-中壢",0,7,-7
"3977","2727王品","110/08/31","日盛-屏東",4,0,4
"3978","2727王品","110/08/31","(牛牛牛)亞-鑫豐",1,8,-7
"3979","2727王品","110/08/31","摩根大通",16,12,4
"3980","2727王品","110/08/31","新光-台南",0,7,-7
"3981","2727王品","110/08/31","兆豐-岡山",3,0,3
"3982","2727王品","110/08/31","凱基-市政",5,12,-7
"3983","2727王品","110/08/31","國泰-板橋",5,2,3
"3984","2727王品","110/08/31","統一",1,7,-6
"3985","2727王品","110/08/31","元大-彰化民生",3,0,3
"3986","2727王品","110/08/31","彰銀-七賢",1,6,-5
"3987","2727王品","110/08/31","元大-內湖",5,2,3
"3988","2727王品","110/08/31","彰銀-台中",0,5,-5
"3989","2727王品","110/08/31","永豐金-台中",4,1,3
"3990","2727王品","110/08/31","元大-中壢",0,5,-5
"3991","1570力肯","110/08/31","香港上海匯豐",53,0,53
"3992","1570力肯","110/08/31","元大-板橋",11,60,-49
"3993","1570力肯","110/08/31","凱基-市政",30,1,29
"3994","1570力肯","110/08/31","群益金鼎-北高雄",0,27,-27
"3995","1570力肯","110/08/31","第一金-嘉義",20,0,20
"3996","1570力肯","110/08/31","元富-世貿",0,20,-20
"3997","1570力肯","110/08/31","台新-台南",20,0,20
"3998","1570力肯","110/08/31","永豐金-中壢",0,19,-19
"3999","1570力肯","110/08/31","宏遠-光隆",20,1,19
"4000","1570力肯","110/08/31","兆豐-員林",0,17,-17
"4001","1570力肯","110/08/31","康和-高雄",18,0,18
"4002","1570力肯","110/08/31","摩根大通",0,16,-16
"4003","1570力肯","110/08/31","日茂-南投",17,0,17
"4004","1570力肯","110/08/31","凱基-台北",20,35,-15
"4005","1570力肯","110/08/31","台新-台中",17,1,16
"4006","1570力肯","110/08/31","元大-竹南",1,16,-15
"4007","1570力肯","110/08/31","兆豐-天母",15,0,15
"4008","1570力肯","110/08/31","新光",8,22,-14
"4009","1570力肯","110/08/31","元大-鳳中",18,4,14
"4010","1570力肯","110/08/31","(牛牛牛)亞-鑫豐",11,23,-12
"4011","1570力肯","110/08/31","合庫-嘉義",10,0,10
"4012","1570力肯","110/08/31","臺銀-臺南",0,11,-11
"4013","1570力肯","110/08/31","日盛-員林",10,0,10
"4014","1570力肯","110/08/31","日盛-八德",0,11,-11
"4015","1570力肯","110/08/31","元富-草屯",10,0,10
"4016","1570力肯","110/08/31","富邦-北港",0,11,-11
"4017","1570力肯","110/08/31","國票-九鼎",10,0,10
"4018","1570力肯","110/08/31","日茂",0,10,-10
"4019","1570力肯","110/08/31","國泰-台中",10,0,10
"4020","1570力肯","110/08/31","凱基-東勢",0,10,-10
"4021","6180橘子","110/08/31","美林",80,0,80
"4022","6180橘子","110/08/31","凱基-嘉義",0,75,-75
"4023","6180橘子","110/08/31","凱基-台北",71,6,65
"4024","6180橘子","110/08/31","兆豐證券",0,42,-42
"4025","6180橘子","110/08/31","高橋",17,1,16
"4026","6180橘子","110/08/31","玉山-新莊",0,40,-40
"4027","6180橘子","110/08/31","台灣摩根士丹利",28,13,15
"4028","6180橘子","110/08/31","兆豐-三民",0,20,-20
"4029","6180橘子","110/08/31","美商高盛",24,10,14
"4030","6180橘子","110/08/31","富邦-南屯",2,13,-11
"4031","6180橘子","110/08/31","合庫-自強",10,0,10
"4032","6180橘子","110/08/31","元富-埔里",0,10,-10
"4033","6180橘子","110/08/31","新光-桃園",8,0,8
"4034","6180橘子","110/08/31","玉山-高雄",0,10,-10
"4035","6180橘子","110/08/31","摩根大通",24,17,7
"4036","6180橘子","110/08/31","富邦-竹東",0,10,-10
"4037","6180橘子","110/08/31","華南永昌-朴子",6,0,6
"4038","6180橘子","110/08/31","富邦-陽明",0,9,-9
"4039","6180橘子","110/08/31","國泰-台中",5,0,5
"4040","6180橘子","110/08/31","華南永昌-古亭",3,11,-8
"4041","6180橘子","110/08/31","凱基-東門",5,0,5
"4042","6180橘子","110/08/31","元大-發財",0,8,-8
"4043","6180橘子","110/08/31","凱基-永華",5,0,5
"4044","6180橘子","110/08/31","新光-台中",0,7,-7
"4045","6180橘子","110/08/31","元大證券",5,0,5
"4046","6180橘子","110/08/31","群益金鼎-新店",0,7,-7
"4047","6180橘子","110/08/31","聯邦-嘉義",4,0,4
"4048","6180橘子","110/08/31","永豐金-桃園",0,6,-6
"4049","6180橘子","110/08/31","元大-南屯",4,0,4
"4050","6180橘子","110/08/31","凱基-和平",0,5,-5
"4051","2390云辰","110/08/31","新光-台中",98,11,87
"4052","2390云辰","110/08/31","群益金鼎-敦南",2,56,-54
"4053","2390云辰","110/08/31","兆豐-公益",70,0,70
"4054","2390云辰","110/08/31","日盛-新莊",0,50,-50
"4055","2390云辰","110/08/31","凱基-竹北",67,0,67
"4056","2390云辰","110/08/31","永豐金-竹科",0,50,-50
"4057","2390云辰","110/08/31","華南永昌-麻豆",50,6,44
"4058","2390云辰","110/08/31","港商野村",50,99,-49
"4059","2390云辰","110/08/31","凱基-台北",61,23,38
"4060","2390云辰","110/08/31","兆豐-三民",0,35,-35
"4061","2390云辰","110/08/31","統一",41,5,36
"4062","2390云辰","110/08/31","高橋",1,33,-32
"4063","2390云辰","110/08/31","統一-新營",39,7,32
"4064","2390云辰","110/08/31","統一-屏東",0,30,-30
"4065","2390云辰","110/08/31","富邦-苗栗",22,0,22
"4066","2390云辰","110/08/31","台新-台南",0,25,-25
"4067","2390云辰","110/08/31","第一金-安和",20,0,20
"4068","2390云辰","110/08/31","元大-彰化",0,21,-21
"4069","2390云辰","110/08/31","富邦-羅東",26,6,20
"4070","2390云辰","110/08/31","臺銀-高雄",0,20,-20
"4071","2390云辰","110/08/31","統一-彰化",20,2,18
"4072","2390云辰","110/08/31","凱基-台中",0,20,-20
"4073","2390云辰","110/08/31","華南永昌-內壢",16,0,16
"4074","2390云辰","110/08/31","元大-南屯",6,25,-19
"4075","2390云辰","110/08/31","兆豐-台中",15,0,15
"4076","2390云辰","110/08/31","國泰-敦南",19,37,-18
"4077","2390云辰","110/08/31","元大-中壢",18,3,15
"4078","2390云辰","110/08/31","元大-土城學府",61,78,-17
"4079","2390云辰","110/08/31","台新-中壢",20,7,13
"4080","2390云辰","110/08/31","元大-雙和",4,20,-16
"4081","2834臺企銀","110/08/30","凱基-台北",5495,473,5022
"4082","2834臺企銀","110/08/30","新加坡商瑞銀",2178,10258,-8080
"4083","2834臺企銀","110/08/30","台灣摩根士丹利",4649,0,4649
"4084","2834臺企銀","110/08/30","美商高盛",1692,8522,-6830
"4085","2834臺企銀","110/08/30","美林",4408,656,3752
"4086","2834臺企銀","110/08/30","花旗環球",821,3248,-2427
"4087","2834臺企銀","110/08/30","瑞士信貸",5025,2357,2668
"4088","2834臺企銀","110/08/30","(牛牛牛)亞-鑫豐",66,1298,-1232
"4089","2834臺企銀","110/08/30","元富-虎尾",1361,1,1360
"4090","2834臺企銀","110/08/30","元富-城中",100,1008,-908
"4091","2834臺企銀","110/08/30","元大-草屯",681,126,555
"4092","2834臺企銀","110/08/30","台新-台中",50,668,-618
"4093","2834臺企銀","110/08/30","群益金鼎-彰化",527,0,527
"4094","2834臺企銀","110/08/30","第一金-嘉義",1,590,-589
"4095","2834臺企銀","110/08/30","華南永昌-東昇",500,5,495
"4096","2834臺企銀","110/08/30","中國信託-忠孝",6,550,-544
"4097","2834臺企銀","110/08/30","日盛-竹北",450,0,450
"4098","2834臺企銀","110/08/30","華南永昌-朴子",59,600,-541
"4099","2834臺企銀","110/08/30","華南永昌-虎尾",447,2,445
"4100","2834臺企銀","110/08/30","統一-板橋",154,644,-490
"4101","2834臺企銀","110/08/30","富邦-虎尾",409,5,404
"4102","2834臺企銀","110/08/30","台新-中壢",10,454,-444
"4103","2834臺企銀","110/08/30","元富-嘉義",410,7,403
"4104","2834臺企銀","110/08/30","永豐金證券",14,447,-433
"4105","2834臺企銀","110/08/30","富邦-板橋",427,31,396
"4106","2834臺企銀","110/08/30","元大-大里",14,445,-431
"4107","2834臺企銀","110/08/30","法銀巴黎",434,51,383
"4108","2834臺企銀","110/08/30","永豐金-萬盛",22,449,-427
"4109","2834臺企銀","110/08/30","元大-南海",345,11,334
"4110","2834臺企銀","110/08/30","元大-北投",12,435,-423
"4111","5511德昌","110/08/30","永豐金-市政",94,0,94
"4112","5511德昌","110/08/30","兆豐-台中港",0,50,-50
"4113","5511德昌","110/08/30","華南永昌-忠孝",14,0,14
"4114","5511德昌","110/08/30","致和-崇德",0,10,-10
"4115","5511德昌","110/08/30","元大-北屯",8,0,8
"4116","5511德昌","110/08/30","凱基-新豐",0,8,-8
"4117","5511德昌","110/08/30","永豐金-敦北",8,0,8
"4118","5511德昌","110/08/30","大昌-桃園",0,7,-7
"4119","5511德昌","110/08/30","第一金-台中",4,0,4
"4120","5511德昌","110/08/30","元大-大雅",0,7,-7
"4121","5511德昌","110/08/30","元大-斗信",3,0,3
"4122","5511德昌","110/08/30","富邦-虎尾",0,6,-6
"4123","5511德昌","110/08/30","凱基-台北",3,1,2
"4124","5511德昌","110/08/30","兆豐-北高雄",0,5,-5
"4125","5511德昌","110/08/30","富邦-台北",1,0,1
"4126","5511德昌","110/08/30","元大-鹿港",0,5,-5
"4127","5511德昌","110/08/30","康和-板橋",0,0,0
"4128","5511德昌","110/08/30","華南永昌-世貿",0,5,-5
"4129","5511德昌","110/08/30","康和-南崁",0,0,0
"4130","5511德昌","110/08/30","兆豐-大安",0,4,-4
"4131","5511德昌","110/08/30","新光-台南",0,0,0
"4132","5511德昌","110/08/30","兆豐-來福",0,3,-3
"4133","5511德昌","110/08/30","群益金鼎-鳳山",0,0,0
"4134","5511德昌","110/08/30","國泰-敦南",0,3,-3
"4135","5511德昌","110/08/30","華南永昌-公誠",0,0,0
"4136","5511德昌","110/08/30","玉山-雙和",0,2,-2
"4137","5511德昌","110/08/30","",NA,NA,NA
"4138","5511德昌","110/08/30","玉山-大里",0,2,-2
"4139","5511德昌","110/08/30","",NA,NA,NA
"4140","5511德昌","110/08/30","(牛牛牛)亞-鑫豐",0,2,-2
"4141","2489瑞軒","110/08/30","康和-台中",185,0,185
"4142","2489瑞軒","110/08/30","富邦-仁愛",0,117,-117
"4143","2489瑞軒","110/08/30","瑞士信貸",133,0,133
"4144","2489瑞軒","110/08/30","凱基-五股",0,100,-100
"4145","2489瑞軒","110/08/30","新加坡商瑞銀",77,5,72
"4146","2489瑞軒","110/08/30","康和-石牌",5,100,-95
"4147","2489瑞軒","110/08/30","凱基-台北",78,17,61
"4148","2489瑞軒","110/08/30","日盛-木柵",0,35,-35
"4149","2489瑞軒","110/08/30","美林",66,18,48
"4150","2489瑞軒","110/08/30","第一金-新興",0,30,-30
"4151","2489瑞軒","110/08/30","元富-三重",40,0,40
"4152","2489瑞軒","110/08/30","富邦-新竹",6,32,-26
"4153","2489瑞軒","110/08/30","新光",35,7,28
"4154","2489瑞軒","110/08/30","群益金鼎",0,25,-25
"4155","2489瑞軒","110/08/30","元大-彰化",25,0,25
"4156","2489瑞軒","110/08/30","國泰-敦南",4,27,-23
"4157","2489瑞軒","110/08/30","元大-員林中山",25,0,25
"4158","2489瑞軒","110/08/30","富隆證券",0,20,-20
"4159","2489瑞軒","110/08/30","元大-松江",23,0,23
"4160","2489瑞軒","110/08/30","康和-嘉義",20,40,-20
"4161","2489瑞軒","110/08/30","永豐金-大園",21,0,21
"4162","2489瑞軒","110/08/30","凱基-中港",0,20,-20
"4163","2489瑞軒","110/08/30","大慶-富順",20,0,20
"4164","2489瑞軒","110/08/30","凱基-彰化",0,20,-20
"4165","2489瑞軒","110/08/30","統一-嘉義",20,0,20
"4166","2489瑞軒","110/08/30","元大-東蘆",0,20,-20
"4167","2489瑞軒","110/08/30","元大-汐止",20,0,20
"4168","2489瑞軒","110/08/30","第一金-華江",0,17,-17
"4169","2489瑞軒","110/08/30","元大-樹林",20,0,20
"4170","2489瑞軒","110/08/30","元大-板橋",0,16,-16
"4171","2428興勤","110/08/30","富邦-高雄",31,0,31
"4172","2428興勤","110/08/30","美林",0,26,-26
"4173","2428興勤","110/08/30","元大-南京",16,0,16
"4174","2428興勤","110/08/30","港商野村",2,28,-26
"4175","2428興勤","110/08/30","永興",15,0,15
"4176","2428興勤","110/08/30","台灣摩根士丹利",2,18,-16
"4177","2428興勤","110/08/30","凱基-鳳山",10,0,10
"4178","2428興勤","110/08/30","摩根大通",0,13,-13
"4179","2428興勤","110/08/30","凱基-中山",10,1,9
"4180","2428興勤","110/08/30","元大-八德",0,10,-10
"4181","2428興勤","110/08/30","群益金鼎-屏東",9,1,8
"4182","2428興勤","110/08/30","元大-西門",0,10,-10
"4183","2428興勤","110/08/30","元富-台中",7,1,6
"4184","2428興勤","110/08/30","永豐金證券",1,10,-9
"4185","2428興勤","110/08/30","中國信託",5,0,5
"4186","2428興勤","110/08/30","日盛-竹北",2,10,-8
"4187","2428興勤","110/08/30","兆豐-忠孝",5,0,5
"4188","2428興勤","110/08/30","美商高盛",1,9,-8
"4189","2428興勤","110/08/30","群益金鼎-鳳山",4,0,4
"4190","2428興勤","110/08/30","元大證券",2,9,-7
"4191","2428興勤","110/08/30","元大-敦南",4,0,4
"4192","2428興勤","110/08/30","日盛-中壢",0,6,-6
"4193","2428興勤","110/08/30","永豐金-信義",4,0,4
"4194","2428興勤","110/08/30","統一",0,5,-5
"4195","2428興勤","110/08/30","元富-大昌",3,0,3
"4196","2428興勤","110/08/30","華南永昌",0,4,-4
"4197","2428興勤","110/08/30","(牛牛牛)亞-鑫豐",3,0,3
"4198","2428興勤","110/08/30","元大-大甲",0,3,-3
"4199","2428興勤","110/08/30","富邦-新竹",3,0,3
"4200","2428興勤","110/08/30","日盛-新莊",0,2,-2
"4201","3176基亞","110/08/30","群益金鼎-潭子",31,0,31
"4202","3176基亞","110/08/30","富邦-台北",0,76,-76
"4203","3176基亞","110/08/30","群益金鼎-板橋",20,0,20
"4204","3176基亞","110/08/30","兆豐-三民",0,20,-20
"4205","3176基亞","110/08/30","國泰-敦南",16,1,15
"4206","3176基亞","110/08/30","新加坡商瑞銀",0,13,-13
"4207","3176基亞","110/08/30","永豐金證券",15,0,15
"4208","3176基亞","110/08/30","元富-佳里",0,13,-13
"4209","3176基亞","110/08/30","日盛-桃園",13,0,13
"4210","3176基亞","110/08/30","國泰-板橋",1,14,-13
"4211","3176基亞","110/08/30","國票-北高雄",10,0,10
"4212","3176基亞","110/08/30","元富-桃園",1,12,-11
"4213","3176基亞","110/08/30","華南永昌",10,0,10
"4214","3176基亞","110/08/30","富邦-中壢",0,10,-10
"4215","3176基亞","110/08/30","華南永昌-林口",10,0,10
"4216","3176基亞","110/08/30","富邦-建國",0,10,-10
"4217","3176基亞","110/08/30","富邦-新竹",8,0,8
"4218","3176基亞","110/08/30","元大-楊梅",0,9,-9
"4219","3176基亞","110/08/30","日盛-台南",6,0,6
"4220","3176基亞","110/08/30","臺銀-新竹",0,8,-8
"4221","3176基亞","110/08/30","元富-新店",5,0,5
"4222","3176基亞","110/08/30","玉山-台中",1,8,-7
"4223","3176基亞","110/08/30","兆豐-內湖",5,0,5
"4224","3176基亞","110/08/30","華南永昌-嘉義",0,7,-7
"4225","3176基亞","110/08/30","富邦-花蓮",5,0,5
"4226","3176基亞","110/08/30","元大-南屯",0,7,-7
"4227","3176基亞","110/08/30","元大-豐原",5,0,5
"4228","3176基亞","110/08/30","新光-台南",0,6,-6
"4229","3176基亞","110/08/30","元大-基隆",5,0,5
"4230","3176基亞","110/08/30","元富-大裕",0,5,-5
"4231","2409友達","110/08/30","合庫證券",2480,104,2376
"4232","2409友達","110/08/30","台灣摩根士丹利",1303,13111,-11808
"4233","2409友達","110/08/30","康和",2143,416,1727
"4234","2409友達","110/08/30","美商高盛",946,5209,-4263
"4235","2409友達","110/08/30","瑞士信貸",1713,21,1692
"4236","2409友達","110/08/30","凱基",53,2000,-1947
"4237","2409友達","110/08/30","凱基-員林",1609,4,1605
"4238","2409友達","110/08/30","元富",19,1780,-1761
"4239","2409友達","110/08/30","凱基-東港",1921,570,1351
"4240","2409友達","110/08/30","港商野村",1462,2550,-1088
"4241","2409友達","110/08/30","兆豐證券",1176,17,1159
"4242","2409友達","110/08/30","摩根大通",4521,5376,-855
"4243","2409友達","110/08/30","元大-豐原",1819,949,870
"4244","2409友達","110/08/30","華南永昌-鶯歌",129,957,-828
"4245","2409友達","110/08/30","永豐金證券",1409,547,862
"4246","2409友達","110/08/30","新加坡商瑞銀",185,989,-804
"4247","2409友達","110/08/30","法銀巴黎",837,225,612
"4248","2409友達","110/08/30","中國信託",142,867,-725
"4249","2409友達","110/08/30","大昌-樹林",608,2,606
"4250","2409友達","110/08/30","日盛-永康",209,836,-627
"4251","2409友達","110/08/30","華南永昌-南京",1958,1399,559
"4252","2409友達","110/08/30","玉山-高雄",90,597,-507
"4253","2409友達","110/08/30","群益金鼎",425,9,416
"4254","2409友達","110/08/30","永豐金-板橋",7,482,-475
"4255","2409友達","110/08/30","台灣企銀-北高雄",403,0,403
"4256","2409友達","110/08/30","花旗環球",121,591,-470
"4257","2409友達","110/08/30","台灣匯立證券",546,153,393
"4258","2409友達","110/08/30","元大證券",1282,1608,-326
"4259","2409友達","110/08/30","元富-安南",661,320,341
"4260","2409友達","110/08/30","富邦-中壢",111,354,-243
"4261","1315達新","110/08/30","凱基-中港",17,0,17
"4262","1315達新","110/08/30","香港上海匯豐",0,46,-46
"4263","1315達新","110/08/30","凱基-板橋",15,0,15
"4264","1315達新","110/08/30","元富-板橋",0,21,-21
"4265","1315達新","110/08/30","統一-城中",10,0,10
"4266","1315達新","110/08/30","元大-文心興安",0,19,-19
"4267","1315達新","110/08/30","豐農",9,0,9
"4268","1315達新","110/08/30","台灣企銀-民雄",0,10,-10
"4269","1315達新","110/08/30","美林",17,10,7
"4270","1315達新","110/08/30","群益金鼎-桃園",2,10,-8
"4271","1315達新","110/08/30","美商高盛",9,2,7
"4272","1315達新","110/08/30","元大-四維",0,5,-5
"4273","1315達新","110/08/30","凱基-台北",7,0,7
"4274","1315達新","110/08/30","華南永昌-彰化",0,4,-4
"4275","1315達新","110/08/30","凱基-岡山",6,0,6
"4276","1315達新","110/08/30","台灣企銀-台中",0,3,-3
"4277","1315達新","110/08/30","華南永昌-台中",5,0,5
"4278","1315達新","110/08/30","新光",0,3,-3
"4279","1315達新","110/08/30","富邦-台北",5,0,5
"4280","1315達新","110/08/30","日盛-樹林",0,2,-2
"4281","1315達新","110/08/30","日盛-二林",3,0,3
"4282","1315達新","110/08/30","元大-雙和",0,2,-2
"4283","1315達新","110/08/30","日盛-和美",3,0,3
"4284","1315達新","110/08/30","元大-桃園",0,2,-2
"4285","1315達新","110/08/30","台新證券",3,0,3
"4286","1315達新","110/08/30","永豐金-中盛",0,2,-2
"4287","1315達新","110/08/30","國泰-敦南",4,1,3
"4288","1315達新","110/08/30","合庫-彰化",0,1,-1
"4289","1315達新","110/08/30","台灣摩根士丹利",2,0,2
"4290","1315達新","110/08/30","合庫-鳳山",0,1,-1
"4291","2609陽明","110/08/30","摩根大通",2955,864,2091
"4292","2609陽明","110/08/30","富邦證券",946,2220,-1274
"4293","2609陽明","110/08/30","凱基-台北",2436,1058,1378
"4294","2609陽明","110/08/30","凱基-斗六",1,1007,-1006
"4295","2609陽明","110/08/30","新加坡商瑞銀",771,0,771
"4296","2609陽明","110/08/30","統一-士林",128,996,-868
"4297","2609陽明","110/08/30","兆豐-虎尾",822,67,755
"4298","2609陽明","110/08/30","永豐金-虎尾",774,1318,-544
"4299","2609陽明","110/08/30","華南永昌-竹北",805,178,627
"4300","2609陽明","110/08/30","宏遠證券",344,864,-520
"4301","2609陽明","110/08/30","美林",1702,1259,443
"4302","2609陽明","110/08/30","台灣摩根士丹利",198,638,-440
"4303","2609陽明","110/08/30","元大證券",755,478,277
"4304","2609陽明","110/08/30","元大-內湖",48,467,-419
"4305","2609陽明","110/08/30","兆豐-板橋",382,108,274
"4306","2609陽明","110/08/30","凱基-城中",48,415,-367
"4307","2609陽明","110/08/30","凱基-桃園",394,129,265
"4308","2609陽明","110/08/30","致和-台北",0,360,-360
"4309","2609陽明","110/08/30","美商高盛",399,146,253
"4310","2609陽明","110/08/30","群益金鼎-大安",40,351,-311
"4311","2609陽明","110/08/30","華南永昌-三重",454,213,241
"4312","2609陽明","110/08/30","兆豐-復興",21,324,-303
"4313","2609陽明","110/08/30","兆豐-寶成",281,69,212
"4314","2609陽明","110/08/30","日盛-復興",41,271,-230
"4315","2609陽明","110/08/30","日盛證券",427,228,199
"4316","2609陽明","110/08/30","元大-彰化民生",29,224,-195
"4317","2609陽明","110/08/30","玉山-嘉義",235,39,196
"4318","2609陽明","110/08/30","群益金鼎",284,467,-183
"4319","2609陽明","110/08/30","國票-台中",578,391,187
"4320","2609陽明","110/08/30","統一-三多",24,198,-174
"4321","2636台驊投控","110/08/30","華南永昌-竹北",399,1,398
"4322","2636台驊投控","110/08/30","港商野村",279,397,-118
"4323","2636台驊投控","110/08/30","日盛-台中",232,5,227
"4324","2636台驊投控","110/08/30","摩根大通",72,183,-111
"4325","2636台驊投控","110/08/30","新光-新竹",231,12,219
"4326","2636台驊投控","110/08/30","元富-大昌",14,70,-56
"4327","2636台驊投控","110/08/30","瑞士信貸",227,30,197
"4328","2636台驊投控","110/08/30","元大-北屯",0,51,-51
"4329","2636台驊投控","110/08/30","兆豐-中壢",141,0,141
"4330","2636台驊投控","110/08/30","永豐金-嘉義",1,52,-51
"4331","2636台驊投控","110/08/30","富邦-虎尾",186,86,100
"4332","2636台驊投控","110/08/30","統一-中壢",0,41,-41
"4333","2636台驊投控","110/08/30","台灣摩根士丹利",166,78,88
"4334","2636台驊投控","110/08/30","國泰-敦南",66,97,-31
"4335","2636台驊投控","110/08/30","兆豐-斗南",87,0,87
"4336","2636台驊投控","110/08/30","美商高盛",62,91,-29
"4337","2636台驊投控","110/08/30","元大-南京",50,6,44
"4338","2636台驊投控","110/08/30","新光",30,59,-29
"4339","2636台驊投控","110/08/30","新加坡商瑞銀",69,30,39
"4340","2636台驊投控","110/08/30","新光-台中",6,31,-25
"4341","2636台驊投控","110/08/30","宏遠-館前",39,1,38
"4342","2636台驊投控","110/08/30","台新-三民",0,23,-23
"4343","2636台驊投控","110/08/30","凱基-中山",34,2,32
"4344","2636台驊投控","110/08/30","凱基-台南",10,32,-22
"4345","2636台驊投控","110/08/30","台新-台南",33,4,29
"4346","2636台驊投控","110/08/30","元大-大雅",1,23,-22
"4347","2636台驊投控","110/08/30","凱基-台北",229,200,29
"4348","2636台驊投控","110/08/30","高橋-內壢",1,22,-21
"4349","2636台驊投控","110/08/30","台中銀-台北",27,0,27
"4350","2636台驊投控","110/08/30","康和-高雄",2,23,-21
"4351","2867三商壽","110/08/30","美林",736,19,717
"4352","2867三商壽","110/08/30","元富-佳里",0,541,-541
"4353","2867三商壽","110/08/30","元富-民權",450,0,450
"4354","2867三商壽","110/08/30","永豐金-埔里",2,331,-329
"4355","2867三商壽","110/08/30","華南永昌-大安",352,0,352
"4356","2867三商壽","110/08/30","華南永昌-高雄",1,202,-201
"4357","2867三商壽","110/08/30","元富-新興",304,4,300
"4358","2867三商壽","110/08/30","富邦-桃園",0,135,-135
"4359","2867三商壽","110/08/30","兆豐-北高雄",280,5,275
"4360","2867三商壽","110/08/30","華南永昌-虎尾",0,132,-132
"4361","2867三商壽","110/08/30","摩根大通",257,18,239
"4362","2867三商壽","110/08/30","玉山-台中",2,132,-130
"4363","2867三商壽","110/08/30","新加坡商瑞銀",231,0,231
"4364","2867三商壽","110/08/30","國泰證券",0,120,-120
"4365","2867三商壽","110/08/30","群益金鼎-土城",218,5,213
"4366","2867三商壽","110/08/30","永豐金-中盛",5,123,-118
"4367","2867三商壽","110/08/30","永豐金-豐原",200,0,200
"4368","2867三商壽","110/08/30","元富-潮州",0,115,-115
"4369","2867三商壽","110/08/30","臺銀",190,2,188
"4370","2867三商壽","110/08/30","群益金鼎-東門",0,114,-114
"4371","2867三商壽","110/08/30","國泰-台中",308,148,160
"4372","2867三商壽","110/08/30","台新-台中",0,112,-112
"4373","2867三商壽","110/08/30","富邦-新店",150,0,150
"4374","2867三商壽","110/08/30","國泰-板橋",1,106,-105
"4375","2867三商壽","110/08/30","群益金鼎-北高雄",130,18,112
"4376","2867三商壽","110/08/30","元大-沙鹿",21,111,-90
"4377","2867三商壽","110/08/30","美商高盛",173,68,105
"4378","2867三商壽","110/08/30","新光-台中",90,174,-84
"4379","2867三商壽","110/08/30","聯邦-富強",100,0,100
"4380","2867三商壽","110/08/30","台新-高雄",7,86,-79
"4381","5521工信","110/08/30","摩根大通",397,0,397
"4382","5521工信","110/08/30","康和-高雄",0,200,-200
"4383","5521工信","110/08/30","元富",358,0,358
"4384","5521工信","110/08/30","香港上海匯豐",0,113,-113
"4385","5521工信","110/08/30","凱基-台北",208,23,185
"4386","5521工信","110/08/30","華南永昌-民權",0,100,-100
"4387","5521工信","110/08/30","美商高盛",181,9,172
"4388","5521工信","110/08/30","元富-新店",2,80,-78
"4389","5521工信","110/08/30","台灣摩根士丹利",160,19,141
"4390","5521工信","110/08/30","國泰-敦南",14,87,-73
"4391","5521工信","110/08/30","華南永昌",94,1,93
"4392","5521工信","110/08/30","兆豐-忠孝",0,67,-67
"4393","5521工信","110/08/30","美林",92,3,89
"4394","5521工信","110/08/30","國票-和平",0,66,-66
"4395","5521工信","110/08/30","華南永昌-中正",55,0,55
"4396","5521工信","110/08/30","元大-新莊",0,66,-66
"4397","5521工信","110/08/30","富邦-台北",50,3,47
"4398","5521工信","110/08/30","日盛-忠孝",0,50,-50
"4399","5521工信","110/08/30","兆豐-西螺",20,0,20
"4400","5521工信","110/08/30","新光-高雄",1,31,-30
"4401","5521工信","110/08/30","國票",20,0,20
"4402","5521工信","110/08/30","玉山-雙和",0,30,-30
"4403","5521工信","110/08/30","富邦-羅東",20,0,20
"4404","5521工信","110/08/30","(牛牛牛)亞-鑫豐",5,33,-28
"4405","5521工信","110/08/30","元大-北成功",20,0,20
"4406","5521工信","110/08/30","元富-文心",12,39,-27
"4407","5521工信","110/08/30","國泰-板橋",31,12,19
"4408","5521工信","110/08/30","群益金鼎-丹鳳",0,26,-26
"4409","5521工信","110/08/30","新百王",18,0,18
"4410","5521工信","110/08/30","日盛-高雄",0,24,-24
"4411","1471首利","110/08/30","元大-虎尾",27,0,27
"4412","1471首利","110/08/30","群益金鼎-東大",0,49,-49
"4413","1471首利","110/08/30","凱基-科園",23,0,23
"4414","1471首利","110/08/30","元大-斗信",0,24,-24
"4415","1471首利","110/08/30","新光",15,0,15
"4416","1471首利","110/08/30","臺銀-臺中",0,20,-20
"4417","1471首利","110/08/30","永豐金-三重",11,0,11
"4418","1471首利","110/08/30","美林",0,18,-18
"4419","1471首利","110/08/30","日盛-屏東",10,0,10
"4420","1471首利","110/08/30","凱基-松山",0,12,-12
"4421","1471首利","110/08/30","台新-松江",10,0,10
"4422","1471首利","110/08/30","元富-埔里",0,10,-10
"4423","1471首利","110/08/30","合庫-台中",7,0,7
"4424","1471首利","110/08/30","永豐金-敦北",0,10,-10
"4425","1471首利","110/08/30","日盛-八德",7,0,7
"4426","1471首利","110/08/30","臺銀-鳳山",0,5,-5
"4427","1471首利","110/08/30","日盛-高雄",15,9,6
"4428","1471首利","110/08/30","統一-屏東",0,5,-5
"4429","1471首利","110/08/30","(牛牛牛)亞-鑫豐",6,0,6
"4430","1471首利","110/08/30","元富-烏日",0,5,-5
"4431","1471首利","110/08/30","富邦-仁愛",6,0,6
"4432","1471首利","110/08/30","玉山-桃園",0,5,-5
"4433","1471首利","110/08/30","統一-台南",5,0,5
"4434","1471首利","110/08/30","凱基-三重",0,5,-5
"4435","1471首利","110/08/30","國泰-敦南",6,1,5
"4436","1471首利","110/08/30","凱基-板橋",0,5,-5
"4437","1471首利","110/08/30","凱基-高雄",5,0,5
"4438","1471首利","110/08/30","富邦-高雄",0,5,-5
"4439","1471首利","110/08/30","凱基-城中",5,0,5
"4440","1471首利","110/08/30","元大-左營",0,5,-5
"4441","2883開發金","110/08/30","國票-南京",3819,33,3786
"4442","2883開發金","110/08/30","兆豐證券",21,5003,-4982
"4443","2883開發金","110/08/30","凱基-台北",6596,2919,3677
"4444","2883開發金","110/08/30","第一金-忠孝",48,3082,-3034
"4445","2883開發金","110/08/30","美林",3606,23,3583
"4446","2883開發金","110/08/30","新光",496,1843,-1347
"4447","2883開發金","110/08/30","永豐金證券",3376,93,3283
"4448","2883開發金","110/08/30","玉山-大里",84,1010,-926
"4449","2883開發金","110/08/30","美商高盛",2717,599,2118
"4450","2883開發金","110/08/30","台中銀-員林",10,795,-785
"4451","2883開發金","110/08/30","國票-長城",2056,18,2038
"4452","2883開發金","110/08/30","玉山-高雄",150,860,-710
"4453","2883開發金","110/08/30","臺銀-新竹",2933,1133,1800
"4454","2883開發金","110/08/30","港商麥格理",0,676,-676
"4455","2883開發金","110/08/30","統一",1871,181,1690
"4456","2883開發金","110/08/30","元大-民雄",42,709,-667
"4457","2883開發金","110/08/30","富邦-建國",1672,182,1490
"4458","2883開發金","110/08/30","兆豐-來福",40,678,-638
"4459","2883開發金","110/08/30","永豐金-板橋",1302,2,1300
"4460","2883開發金","110/08/30","華南永昌-中正",145,649,-504
"4461","2883開發金","110/08/30","宏遠證券",1170,44,1126
"4462","2883開發金","110/08/30","凱基-三重",40,540,-500
"4463","2883開發金","110/08/30","法銀巴黎",1059,10,1049
"4464","2883開發金","110/08/30","國泰-台中",154,606,-452
"4465","2883開發金","110/08/30","華南永昌",1089,115,974
"4466","2883開發金","110/08/30","玉山-新竹",18,427,-409
"4467","2883開發金","110/08/30","瑞士信貸",1162,231,931
"4468","2883開發金","110/08/30","國票-安和",14,399,-385
"4469","2883開發金","110/08/30","兆豐-三民",901,14,887
"4470","2883開發金","110/08/30","凱基-站前",80,462,-382
"4471","6205詮欣","110/08/30","台中銀",7,0,7
"4472","6205詮欣","110/08/30","永豐金-敦南",0,5,-5
"4473","6205詮欣","110/08/30","臺銀-臺中",5,0,5
"4474","6205詮欣","110/08/30","第一金-路竹",0,5,-5
"4475","6205詮欣","110/08/30","台新證券",3,0,3
"4476","6205詮欣","110/08/30","元大-屏東",0,3,-3
"4477","6205詮欣","110/08/30","臺銀-民權",2,0,2
"4478","6205詮欣","110/08/30","華南永昌-朴子",0,3,-3
"4479","6205詮欣","110/08/30","光和",2,0,2
"4480","6205詮欣","110/08/30","永豐金證券",0,2,-2
"4481","6205詮欣","110/08/30","元大-豐原站前",1,0,1
"4482","6205詮欣","110/08/30","凱基-中壢",0,1,-1
"4483","6205詮欣","110/08/30","元大-館前",1,0,1
"4484","6205詮欣","110/08/30","元大-開元",0,1,-1
"4485","6205詮欣","110/08/30","元大-松山",1,0,1
"4486","6205詮欣","110/08/30","日盛-台南",0,1,-1
"4487","6205詮欣","110/08/30","大昌-樹林",1,0,1
"4488","6205詮欣","110/08/30","凱基-永康",0,1,-1
"4489","6205詮欣","110/08/30","元富-潮州",1,0,1
"4490","6205詮欣","110/08/30","國票-博愛",0,1,-1
"4491","6205詮欣","110/08/30","美林",1,0,1
"4492","6205詮欣","110/08/30","元富-文心",0,1,-1
"4493","6205詮欣","110/08/30","日盛-新莊",1,0,1
"4494","6205詮欣","110/08/30","統一-松江",0,1,-1
"4495","6205詮欣","110/08/30","兆豐-永和",0,0,0
"4496","6205詮欣","110/08/30","大慶-台南",0,1,-1
"4497","6205詮欣","110/08/30","群益金鼎-台中",0,0,0
"4498","6205詮欣","110/08/30","群益金鼎-台中",0,0,0
"4499","6205詮欣","110/08/30","富邦-台北",0,0,0
"4500","6205詮欣","110/08/30","富邦-台北",0,0,0
"4501","1540喬福","110/08/30","玉山-大里",14,0,14
"4502","1540喬福","110/08/30","凱基-興隆",0,12,-12
"4503","1540喬福","110/08/30","華南永昌-公誠",10,0,10
"4504","1540喬福","110/08/30","國票-中正",0,5,-5
"4505","1540喬福","110/08/30","元大-龍潭",6,0,6
"4506","1540喬福","110/08/30","玉山-板橋",0,5,-5
"4507","1540喬福","110/08/30","國票-台南",5,0,5
"4508","1540喬福","110/08/30","玉山-左營",0,5,-5
"4509","1540喬福","110/08/30","凱基-中壢",3,0,3
"4510","1540喬福","110/08/30","玉山-數位",0,4,-4
"4511","1540喬福","110/08/30","兆豐-內湖",2,0,2
"4512","1540喬福","110/08/30","元大-大安",0,4,-4
"4513","1540喬福","110/08/30","元大-土城永寧",2,0,2
"4514","1540喬福","110/08/30","台新-台中",0,3,-3
"4515","1540喬福","110/08/30","合庫證券",1,0,1
"4516","1540喬福","110/08/30","國泰-敦南",0,3,-3
"4517","1540喬福","110/08/30","日盛-士林",1,0,1
"4518","1540喬福","110/08/30","元富-緯城",0,2,-2
"4519","1540喬福","110/08/30","台灣摩根士丹利",1,0,1
"4520","1540喬福","110/08/30","富邦-仁愛",0,2,-2
"4521","1540喬福","110/08/30","元富",2,1,1
"4522","1540喬福","110/08/30","第一金-員林",0,1,-1
"4523","1540喬福","110/08/30","兆豐-鹿港",1,0,1
"4524","1540喬福","110/08/30","統一-三多",0,1,-1
"4525","1540喬福","110/08/30","凱基-內埔",1,0,1
"4526","1540喬福","110/08/30","元富-虎尾",0,1,-1
"4527","1540喬福","110/08/30","元大-頭份",1,0,1
"4528","1540喬福","110/08/30","致和-南京",0,1,-1
"4529","1540喬福","110/08/30","元大-楊梅",1,0,1
"4530","1540喬福","110/08/30","元大-竹東",0,1,-1
"4531","2888新光金","110/08/30","元大證券",28738,3652,25086
"4532","2888新光金","110/08/30","元富-城東",123,7579,-7456
"4533","2888新光金","110/08/30","美林",6052,562,5490
"4534","2888新光金","110/08/30","永豐金證券",69,4239,-4170
"4535","2888新光金","110/08/30","臺銀-高雄",4494,65,4429
"4536","2888新光金","110/08/30","國票-長城",61,2957,-2896
"4537","2888新光金","110/08/30","美商高盛",4381,1190,3191
"4538","2888新光金","110/08/30","凱基-大里",92,2505,-2413
"4539","2888新光金","110/08/30","台灣摩根士丹利",5027,2870,2157
"4540","2888新光金","110/08/30","華南永昌-台中",43,2049,-2006
"4541","2888新光金","110/08/30","元大-館前",2282,149,2133
"4542","2888新光金","110/08/30","合庫證券",155,2038,-1883
"4543","2888新光金","110/08/30","亞東-新竹",2698,591,2107
"4544","2888新光金","110/08/30","凱基-台北",5304,7027,-1723
"4545","2888新光金","110/08/30","群益金鼎",2082,41,2041
"4546","2888新光金","110/08/30","新光",1799,3317,-1518
"4547","2888新光金","110/08/30","永豐金-中正",2140,106,2034
"4548","2888新光金","110/08/30","兆豐-西螺",167,1632,-1465
"4549","2888新光金","110/08/30","永全-南崁",1904,5,1899
"4550","2888新光金","110/08/30","華南永昌-大安",20,1454,-1434
"4551","2888新光金","110/08/30","元富-草屯",2009,229,1780
"4552","2888新光金","110/08/30","元富-文心",113,1427,-1314
"4553","2888新光金","110/08/30","台新-三民",2093,316,1777
"4554","2888新光金","110/08/30","富邦-中壢",272,1481,-1209
"4555","2888新光金","110/08/30","國泰-台南",2057,285,1772
"4556","2888新光金","110/08/30","元富-世貿",225,1314,-1089
"4557","2888新光金","110/08/30","新加坡商瑞銀",3676,2205,1471
"4558","2888新光金","110/08/30","宏遠-桃園",17,1089,-1072
"4559","2888新光金","110/08/30","法銀巴黎",1141,9,1132
"4560","2888新光金","110/08/30","元富-板橋",154,1212,-1058
"4561","1340勝悅","110/08/30","群益金鼎-三重",10,0,10
"4562","1340勝悅","110/08/30","元大-新盛",0,22,-22
"4563","1340勝悅","110/08/30","美林",8,0,8
"4564","1340勝悅","110/08/30","台灣企銀-民雄",0,8,-8
"4565","1340勝悅","110/08/30","臺灣企銀-埔墘",5,0,5
"4566","1340勝悅","110/08/30","台中銀",0,7,-7
"4567","1340勝悅","110/08/30","國泰-敦南",6,3,3
"4568","1340勝悅","110/08/30","日盛-鳳山",0,5,-5
"4569","1340勝悅","110/08/30","華南永昌-南京",3,0,3
"4570","1340勝悅","110/08/30","摩根大通",0,5,-5
"4571","1340勝悅","110/08/30","元大-屏南",3,0,3
"4572","1340勝悅","110/08/30","凱基-台北",2,7,-5
"4573","1340勝悅","110/08/30","日盛-中和",2,0,2
"4574","1340勝悅","110/08/30","日盛-員林",0,3,-3
"4575","1340勝悅","110/08/30","大慶-泰山",2,0,2
"4576","1340勝悅","110/08/30","元大-林園",0,3,-3
"4577","1340勝悅","110/08/30","第一金-華江",3,1,2
"4578","1340勝悅","110/08/30","合庫-自強",0,2,-2
"4579","1340勝悅","110/08/30","兆豐-三重",2,0,2
"4580","1340勝悅","110/08/30","美商高盛",0,2,-2
"4581","1340勝悅","110/08/30","國票-台南",2,0,2
"4582","1340勝悅","110/08/30","台新-高雄",1,3,-2
"4583","1340勝悅","110/08/30","國票-台中",2,0,2
"4584","1340勝悅","110/08/30","永豐金-信義",0,2,-2
"4585","1340勝悅","110/08/30","玉山-左營",2,0,2
"4586","1340勝悅","110/08/30","日盛-樹林",0,1,-1
"4587","1340勝悅","110/08/30","元大-歸仁",2,0,2
"4588","1340勝悅","110/08/30","台新-台南",0,1,-1
"4589","1340勝悅","110/08/30","群益金鼎-館前",1,0,1
"4590","1340勝悅","110/08/30","永豐金-中正",0,1,-1
"4591","6246臺龍","110/08/30","群益金鼎-古亭",11,1,10
"4592","6246臺龍","110/08/30","群益金鼎-東大",0,30,-30
"4593","6246臺龍","110/08/30","台新證券",10,1,9
"4594","6246臺龍","110/08/30","聯邦-大業",0,10,-10
"4595","6246臺龍","110/08/30","富邦-新竹",4,0,4
"4596","6246臺龍","110/08/30","台新-高雄",0,6,-6
"4597","6246臺龍","110/08/30","元大-館前",4,0,4
"4598","6246臺龍","110/08/30","玉山-新莊",0,3,-3
"4599","6246臺龍","110/08/30","港商野村",3,0,3
"4600","6246臺龍","110/08/30","元大-北港",2,5,-3
"4601","6246臺龍","110/08/30","永豐金-桃園",3,0,3
"4602","6246臺龍","110/08/30","第一金-彰化",0,2,-2
"4603","6246臺龍","110/08/30","福勝",2,0,2
"4604","6246臺龍","110/08/30","國泰-板橋",0,2,-2
"4605","6246臺龍","110/08/30","玉山證券",2,0,2
"4606","6246臺龍","110/08/30","元大-竹山",0,2,-2
"4607","6246臺龍","110/08/30","凱基-板橋",2,0,2
"4608","6246臺龍","110/08/30","日盛-宜蘭",0,1,-1
"4609","6246臺龍","110/08/30","凱基-高美館",2,0,2
"4610","6246臺龍","110/08/30","台新-台南",0,1,-1
"4611","6246臺龍","110/08/30","元大-新盛",2,0,2
"4612","6246臺龍","110/08/30","國泰-台中",0,1,-1
"4613","6246臺龍","110/08/30","元大-大天母",2,0,2
"4614","6246臺龍","110/08/30","元大-鑫永和",0,1,-1
"4615","6246臺龍","110/08/30","元大-內湖",2,0,2
"4616","6246臺龍","110/08/30","元大-大同",0,1,-1
"4617","6246臺龍","110/08/30","永豐金-鳳山",2,0,2
"4618","6246臺龍","110/08/30","元大-古亭",0,1,-1
"4619","6246臺龍","110/08/30","合庫-三重",1,0,1
"4620","6246臺龍","110/08/30","統一-南京",0,0,0
"4621","00715L期街口布蘭特正2","110/08/30","元大證券",14770,43,14727
"4622","00715L期街口布蘭特正2","110/08/30","元大-萬華",0,911,-911
"4623","00715L期街口布蘭特正2","110/08/30","國票",3922,0,3922
"4624","00715L期街口布蘭特正2","110/08/30","兆豐-嘉義",20,754,-734
"4625","00715L期街口布蘭特正2","110/08/30","群益金鼎",1953,405,1548
"4626","00715L期街口布蘭特正2","110/08/30","富邦-台東",0,613,-613
"4627","00715L期街口布蘭特正2","110/08/30","永豐金-內湖",1500,17,1483
"4628","00715L期街口布蘭特正2","110/08/30","元大-嘉義",21,608,-587
"4629","00715L期街口布蘭特正2","110/08/30","永豐金證券",1565,335,1230
"4630","00715L期街口布蘭特正2","110/08/30","港商野村",511,1090,-579
"4631","00715L期街口布蘭特正2","110/08/30","國票-博愛",1155,0,1155
"4632","00715L期街口布蘭特正2","110/08/30","日盛-新莊",210,775,-565
"4633","00715L期街口布蘭特正2","110/08/30","康和",1007,0,1007
"4634","00715L期街口布蘭特正2","110/08/30","日盛-員林",0,540,-540
"4635","00715L期街口布蘭特正2","110/08/30","統一",952,1,951
"4636","00715L期街口布蘭特正2","110/08/30","凱基-屏東",5,543,-538
"4637","00715L期街口布蘭特正2","110/08/30","合庫證券",943,5,938
"4638","00715L期街口布蘭特正2","110/08/30","富邦-陽明",0,509,-509
"4639","00715L期街口布蘭特正2","110/08/30","富邦證券",2782,2251,531
"4640","00715L期街口布蘭特正2","110/08/30","玉山-嘉義",4,512,-508
"4641","00715L期街口布蘭特正2","110/08/30","兆豐-台中",500,0,500
"4642","00715L期街口布蘭特正2","110/08/30","元大-前金",2,506,-504
"4643","00715L期街口布蘭特正2","110/08/30","國票-中港",500,0,500
"4644","00715L期街口布蘭特正2","110/08/30","兆豐-台中港",0,463,-463
"4645","00715L期街口布蘭特正2","110/08/30","凱基-台南",500,1,499
"4646","00715L期街口布蘭特正2","110/08/30","國票-九鼎",1,440,-439
"4647","00715L期街口布蘭特正2","110/08/30","凱基-市政",500,7,493
"4648","00715L期街口布蘭特正2","110/08/30","永豐金-板盛",0,421,-421
"4649","00715L期街口布蘭特正2","110/08/30","元富-大裕",500,22,478
"4650","00715L期街口布蘭特正2","110/08/30","富邦-基隆",0,420,-420
"4651","8941關中","110/08/30","國泰-忠孝",1,0,1
"4652","8941關中","110/08/30","凱基-市府",0,1,-1
"4653","8941關中","110/08/30","第一金-台南",0,0,0
"4654","8941關中","110/08/30","第一金-台南",0,0,0
"4655","8941關中","110/08/30","康和-板橋",0,0,0
"4656","8941關中","110/08/30","康和-板橋",0,0,0
"4657","8941關中","110/08/30","新光-高雄",0,0,0
"4658","8941關中","110/08/30","新光-高雄",0,0,0
"4659","8941關中","110/08/30","華南永昌-淡水",0,0,0
"4660","8941關中","110/08/30","華南永昌-淡水",0,0,0
"4661","8941關中","110/08/30","富邦-台北",0,0,0
"4662","8941關中","110/08/30","富邦-台北",0,0,0
"4663","8941關中","110/08/30","元大-新竹經國",0,0,0
"4664","8941關中","110/08/30","元大-新竹經國",0,0,0
"4665","8941關中","110/08/30","永豐金-萬盛",0,0,0
"4666","8941關中","110/08/30","永豐金-萬盛",0,0,0
"4667","8941關中","110/08/30","",NA,NA,NA
"4668","8941關中","110/08/30","",NA,NA,NA
"4669","8941關中","110/08/30","",NA,NA,NA
"4670","8941關中","110/08/30","",NA,NA,NA
"4671","8941關中","110/08/30","",NA,NA,NA
"4672","8941關中","110/08/30","",NA,NA,NA
"4673","8941關中","110/08/30","",NA,NA,NA
"4674","8941關中","110/08/30","",NA,NA,NA
"4675","8941關中","110/08/30","",NA,NA,NA
"4676","8941關中","110/08/30","",NA,NA,NA
"4677","8941關中","110/08/30","",NA,NA,NA
"4678","8941關中","110/08/30","",NA,NA,NA
"4679","8941關中","110/08/30","",NA,NA,NA
"4680","8941關中","110/08/30","",NA,NA,NA
"4681","8936國統","110/08/30","統一-金門",100,30,70
"4682","8936國統","110/08/30","摩根大通",38,197,-159
"4683","8936國統","110/08/30","中國信託-高雄",56,0,56
"4684","8936國統","110/08/30","新加坡商瑞銀",5,152,-147
"4685","8936國統","110/08/30","國票-天祥",50,0,50
"4686","8936國統","110/08/30","凱基-台北",48,181,-133
"4687","8936國統","110/08/30","國票-敦北法人",50,0,50
"4688","8936國統","110/08/30","美商高盛",10,130,-120
"4689","8936國統","110/08/30","宏遠-光隆",47,0,47
"4690","8936國統","110/08/30","港商野村",4,97,-93
"4691","8936國統","110/08/30","元富-林園",40,0,40
"4692","8936國統","110/08/30","玉山-高雄",2,45,-43
"4693","8936國統","110/08/30","國泰-敦南",50,22,28
"4694","8936國統","110/08/30","華南永昌-楠梓",7,50,-43
"4695","8936國統","110/08/30","元大-松江",22,1,21
"4696","8936國統","110/08/30","新光",18,59,-41
"4697","8936國統","110/08/30","群益金鼎",20,0,20
"4698","8936國統","110/08/30","康和-嘉義",51,71,-20
"4699","8936國統","110/08/30","凱基-站前",20,0,20
"4700","8936國統","110/08/30","凱基-市政",0,20,-20
"4701","8936國統","110/08/30","永豐金-彰化",23,3,20
"4702","8936國統","110/08/30","永豐金-台中",0,20,-20
"4703","8936國統","110/08/30","日盛-台中",20,1,19
"4704","8936國統","110/08/30","台新-左楠",0,14,-14
"4705","8936國統","110/08/30","台灣摩根士丹利",19,0,19
"4706","8936國統","110/08/30","永豐金-苓雅",11,25,-14
"4707","8936國統","110/08/30","中國信託-文心",20,1,19
"4708","8936國統","110/08/30","永全-八德",0,10,-10
"4709","8936國統","110/08/30","元大-東港",16,0,16
"4710","8936國統","110/08/30","兆豐-三民",1,11,-10
"4711","6226光鼎","110/08/30","凱基-站前",105,0,105
"4712","6226光鼎","110/08/30","元富-世貿",0,111,-111
"4713","6226光鼎","110/08/30","台灣摩根士丹利",105,8,97
"4714","6226光鼎","110/08/30","凱基-竹科",10,86,-76
"4715","6226光鼎","110/08/30","國泰-敦南",210,125,85
"4716","6226光鼎","110/08/30","美林",102,165,-63
"4717","6226光鼎","110/08/30","摩根大通",104,29,75
"4718","6226光鼎","110/08/30","華南永昌-南京",6,69,-63
"4719","6226光鼎","110/08/30","永全-南崁",40,0,40
"4720","6226光鼎","110/08/30","玉山-高雄",6,63,-57
"4721","6226光鼎","110/08/30","群益金鼎-忠孝",40,0,40
"4722","6226光鼎","110/08/30","元大-大雅",5,58,-53
"4723","6226光鼎","110/08/30","元大-東泰",38,0,38
"4724","6226光鼎","110/08/30","兆豐-松德",3,53,-50
"4725","6226光鼎","110/08/30","日盛-八德",32,0,32
"4726","6226光鼎","110/08/30","凱基-內埔",15,50,-35
"4727","6226光鼎","110/08/30","台新-台中",41,11,30
"4728","6226光鼎","110/08/30","統一-基隆",0,30,-30
"4729","6226光鼎","110/08/30","凱基-三多",23,0,23
"4730","6226光鼎","110/08/30","中國信託",3,31,-28
"4731","6226光鼎","110/08/30","第一金-中壢",20,0,20
"4732","6226光鼎","110/08/30","凱基-台北",89,117,-28
"4733","6226光鼎","110/08/30","國票-長城",20,0,20
"4734","6226光鼎","110/08/30","合庫-西台中",2,26,-24
"4735","6226光鼎","110/08/30","玉山-大里",23,3,20
"4736","6226光鼎","110/08/30","福勝",10,32,-22
"4737","6226光鼎","110/08/30","富邦-竹北",21,2,19
"4738","6226光鼎","110/08/30","玉山-新莊",5,27,-22
"4739","6226光鼎","110/08/30","永豐金-鳳山",20,1,19
"4740","6226光鼎","110/08/30","元大-南崁",0,21,-21
"4741","2363矽統","110/08/30","元大-萬華",825,16,809
"4742","2363矽統","110/08/30","合庫-基隆",5,1735,-1730
"4743","2363矽統","110/08/30","港商野村",1455,869,586
"4744","2363矽統","110/08/30","康和-台中",23,619,-596
"4745","2363矽統","110/08/30","元大-承德",405,1,404
"4746","2363矽統","110/08/30","台新-台南",39,428,-389
"4747","2363矽統","110/08/30","國票-南港",405,6,399
"4748","2363矽統","110/08/30","元大-士林",9,363,-354
"4749","2363矽統","110/08/30","凱基-站前",367,74,293
"4750","2363矽統","110/08/30","摩根大通",121,453,-332
"4751","2363矽統","110/08/30","凱基-台北",1335,1052,283
"4752","2363矽統","110/08/30","台中銀-豐原",5,255,-250
"4753","2363矽統","110/08/30","永全",305,41,264
"4754","2363矽統","110/08/30","大展",32,271,-239
"4755","2363矽統","110/08/30","第一金-豐原",231,4,227
"4756","2363矽統","110/08/30","台新-台中",102,325,-223
"4757","2363矽統","110/08/30","華南永昌-林口",225,15,210
"4758","2363矽統","110/08/30","國票-和平",0,158,-158
"4759","2363矽統","110/08/30","日盛-樹林",208,49,159
"4760","2363矽統","110/08/30","永豐金-南京",34,165,-131
"4761","2363矽統","110/08/30","台新-新莊",157,7,150
"4762","2363矽統","110/08/30","大昌-樹林",14,136,-122
"4763","2363矽統","110/08/30","新光",236,92,144
"4764","2363矽統","110/08/30","元大-桃興",13,132,-119
"4765","2363矽統","110/08/30","光和",127,7,120
"4766","2363矽統","110/08/30","富邦-新竹",43,157,-114
"4767","2363矽統","110/08/30","臺銀",132,15,117
"4768","2363矽統","110/08/30","元大-大統",27,140,-113
"4769","2363矽統","110/08/30","兆豐-彰化",112,0,112
"4770","2363矽統","110/08/30","日盛-南京",9,113,-104
"4771","8112至上","110/08/30","凱基-竹東",100,0,100
"4772","8112至上","110/08/30","第一金-桃園",5,366,-361
"4773","8112至上","110/08/30","華南永昌-南京",60,1,59
"4774","8112至上","110/08/30","摩根大通",5,228,-223
"4775","8112至上","110/08/30","凱基-長庚",53,0,53
"4776","8112至上","110/08/30","統一-中壢",9,80,-71
"4777","8112至上","110/08/30","永豐金-板盛",50,0,50
"4778","8112至上","110/08/30","美林",16,78,-62
"4779","8112至上","110/08/30","富邦-仁愛",46,0,46
"4780","8112至上","110/08/30","兆豐-西螺",0,60,-60
"4781","8112至上","110/08/30","凱基-竹科",43,1,42
"4782","8112至上","110/08/30","美商高盛",5,60,-55
"4783","8112至上","110/08/30","兆豐-高雄",40,0,40
"4784","8112至上","110/08/30","元大-大灣",1,50,-49
"4785","8112至上","110/08/30","元大-竹東",37,0,37
"4786","8112至上","110/08/30","國票-南京",0,40,-40
"4787","8112至上","110/08/30","富邦-竹東",28,0,28
"4788","8112至上","110/08/30","元大-永和",0,40,-40
"4789","8112至上","110/08/30","統一-高雄",30,4,26
"4790","8112至上","110/08/30","群益金鼎-大甲",0,31,-31
"4791","8112至上","110/08/30","兆豐-天母",25,0,25
"4792","8112至上","110/08/30","台灣摩根士丹利",22,51,-29
"4793","8112至上","110/08/30","元大-高雄",20,0,20
"4794","8112至上","110/08/30","日盛-忠孝",2,28,-26
"4795","8112至上","110/08/30","元富-同大",22,3,19
"4796","8112至上","110/08/30","康和",1,26,-25
"4797","8112至上","110/08/30","凱基-士林",19,0,19
"4798","8112至上","110/08/30","群益金鼎-基隆",0,25,-25
"4799","8112至上","110/08/30","國泰-館前",19,2,17
"4800","8112至上","110/08/30","台中銀-員林",0,23,-23
"4801","1570力肯","110/08/30","摩根大通",69,18,51
"4802","1570力肯","110/08/30","群益金鼎-高雄",0,57,-57
"4803","1570力肯","110/08/30","元大-板橋",31,1,30
"4804","1570力肯","110/08/30","永豐金-永康",0,33,-33
"4805","1570力肯","110/08/30","元大-新營",27,0,27
"4806","1570力肯","110/08/30","國票-南科",0,26,-26
"4807","1570力肯","110/08/30","元大-永和",22,0,22
"4808","1570力肯","110/08/30","國票-北高雄",1,21,-20
"4809","1570力肯","110/08/30","元富-世貿",21,0,21
"4810","1570力肯","110/08/30","富邦-仁愛",1,20,-19
"4811","1570力肯","110/08/30","第一金-嘉義",20,0,20
"4812","1570力肯","110/08/30","元大-花蓮",0,19,-19
"4813","1570力肯","110/08/30","福勝",20,1,19
"4814","1570力肯","110/08/30","元富-延平",0,15,-15
"4815","1570力肯","110/08/30","(牛牛牛)亞-鑫豐",20,2,18
"4816","1570力肯","110/08/30","富邦-高雄",0,15,-15
"4817","1570力肯","110/08/30","台新證券",22,6,16
"4818","1570力肯","110/08/30","元富-新興",0,11,-11
"4819","1570力肯","110/08/30","群益金鼎-台中",16,0,16
"4820","1570力肯","110/08/30","亞東-板橋",0,10,-10
"4821","1570力肯","110/08/30","日盛-雙和",15,0,15
"4822","1570力肯","110/08/30","永豐金-中壢",0,10,-10
"4823","1570力肯","110/08/30","合庫-台中",11,0,11
"4824","1570力肯","110/08/30","元富-緯城",10,19,-9
"4825","1570力肯","110/08/30","聯邦商銀",10,0,10
"4826","1570力肯","110/08/30","元富-民權",5,13,-8
"4827","1570力肯","110/08/30","華南永昌-彰化",10,0,10
"4828","1570力肯","110/08/30","凱基-嘉義",2,10,-8
"4829","1570力肯","110/08/30","元大-鳳中",12,2,10
"4830","1570力肯","110/08/30","元大-南投",0,8,-8
"4831","2929淘帝","110/08/30","摩根大通",22,0,22
"4832","2929淘帝","110/08/30","凱基-高雄",0,150,-150
"4833","2929淘帝","110/08/30","元富-大裕",12,0,12
"4834","2929淘帝","110/08/30","凱基-長庚",0,15,-15
"4835","2929淘帝","110/08/30","華南永昌-台中",11,0,11
"4836","2929淘帝","110/08/30","富邦-南屯",0,13,-13
"4837","2929淘帝","110/08/30","兆豐-忠孝",10,0,10
"4838","2929淘帝","110/08/30","元大-蘆洲",0,12,-12
"4839","2929淘帝","110/08/30","永豐金-博愛",9,0,9
"4840","2929淘帝","110/08/30","元富-三重",0,8,-8
"4841","2929淘帝","110/08/30","國泰-敦南",8,0,8
"4842","2929淘帝","110/08/30","新加坡商瑞銀",3,10,-7
"4843","2929淘帝","110/08/30","凱基-東門",8,0,8
"4844","2929淘帝","110/08/30","元大-博愛",0,6,-6
"4845","2929淘帝","110/08/30","日盛-雙和",7,0,7
"4846","2929淘帝","110/08/30","國票-南京",0,5,-5
"4847","2929淘帝","110/08/30","新光-台中",7,0,7
"4848","2929淘帝","110/08/30","國泰-台南",0,5,-5
"4849","2929淘帝","110/08/30","元大-太平",7,0,7
"4850","2929淘帝","110/08/30","台新-中壢",0,4,-4
"4851","2929淘帝","110/08/30","元大-土城永寧",7,0,7
"4852","2929淘帝","110/08/30","群益金鼎-大安",0,4,-4
"4853","2929淘帝","110/08/30","元大-新竹經國",6,0,6
"4854","2929淘帝","110/08/30","日盛-信義",1,3,-2
"4855","2929淘帝","110/08/30","元富-新竹",5,0,5
"4856","2929淘帝","110/08/30","新光-新竹",0,2,-2
"4857","2929淘帝","110/08/30","台中銀-豐原",5,0,5
"4858","2929淘帝","110/08/30","元大-南屯",0,2,-2
"4859","2929淘帝","110/08/30","台新-建北",5,0,5
"4860","2929淘帝","110/08/30","元大-東蘆",0,2,-2
"4861","5410國眾","110/08/30","華南永昌-高雄",10,0,10
"4862","5410國眾","110/08/30","群益金鼎-新竹",0,8,-8
"4863","5410國眾","110/08/30","群益金鼎-東湖",5,0,5
"4864","5410國眾","110/08/30","日盛-新莊",0,6,-6
"4865","5410國眾","110/08/30","凱基-科園",5,0,5
"4866","5410國眾","110/08/30","凱基-長庚",0,5,-5
"4867","5410國眾","110/08/30","元大-中壢",5,0,5
"4868","5410國眾","110/08/30","元富-嘉義",0,4,-4
"4869","5410國眾","110/08/30","兆豐-嘉義",4,0,4
"4870","5410國眾","110/08/30","台灣企銀",0,3,-3
"4871","5410國眾","110/08/30","元大-彰化",3,0,3
"4872","5410國眾","110/08/30","寶盛",0,3,-3
"4873","5410國眾","110/08/30","玉山-新竹",2,0,2
"4874","5410國眾","110/08/30","元富-台中",1,4,-3
"4875","5410國眾","110/08/30","國泰-台中",2,0,2
"4876","5410國眾","110/08/30","兆豐-竹北",0,3,-3
"4877","5410國眾","110/08/30","國泰-敦南",2,0,2
"4878","5410國眾","110/08/30","元大-屏東民生",0,3,-3
"4879","5410國眾","110/08/30","香港上海匯豐",2,0,2
"4880","5410國眾","110/08/30","永豐金-中正",0,3,-3
"4881","5410國眾","110/08/30","永豐金-萬盛",2,0,2
"4882","5410國眾","110/08/30","統一-基隆",0,2,-2
"4883","5410國眾","110/08/30","日盛-員林",1,0,1
"4884","5410國眾","110/08/30","群益金鼎-新店",0,2,-2
"4885","5410國眾","110/08/30","第一金-高雄",1,0,1
"4886","5410國眾","110/08/30","凱基-台南",0,2,-2
"4887","5410國眾","110/08/30","元富",1,0,1
"4888","5410國眾","110/08/30","元大-龍潭",0,2,-2
"4889","5410國眾","110/08/30","國票-北高雄",1,0,1
"4890","5410國眾","110/08/30","第一金-台南",0,1,-1
"4891","2841台開","110/08/30","宏遠-館前",215,0,215
"4892","2841台開","110/08/30","萬泰",0,50,-50
"4893","2841台開","110/08/30","日盛證券",26,0,26
"4894","2841台開","110/08/30","台中銀",0,40,-40
"4895","2841台開","110/08/30","元大-台中",16,0,16
"4896","2841台開","110/08/30","永豐金-敦南",33,71,-38
"4897","2841台開","110/08/30","第一金-華江",12,0,12
"4898","2841台開","110/08/30","富邦-花蓮",0,21,-21
"4899","2841台開","110/08/30","日盛-台中",20,10,10
"4900","2841台開","110/08/30","元大-嘉義",0,20,-20
"4901","2841台開","110/08/30","新光-桃園",10,0,10
"4902","2841台開","110/08/30","台灣摩根士丹利",0,19,-19
"4903","2841台開","110/08/30","凱基-內湖",10,0,10
"4904","2841台開","110/08/30","新加坡商瑞銀",0,19,-19
"4905","2841台開","110/08/30","元大-沙鹿",5,0,5
"4906","2841台開","110/08/30","台新證券",1,20,-19
"4907","2841台開","110/08/30","元大-南屯",5,0,5
"4908","2841台開","110/08/30","元大-花蓮",0,17,-17
"4909","2841台開","110/08/30","台新-台中",4,0,4
"4910","2841台開","110/08/30","國票-中和",0,12,-12
"4911","2841台開","110/08/30","元大-三重",4,0,4
"4912","2841台開","110/08/30","凱基-竹北",0,10,-10
"4913","2841台開","110/08/30","兆豐-高雄",3,0,3
"4914","2841台開","110/08/30","永豐金-新莊",0,10,-10
"4915","2841台開","110/08/30","日盛-大墩",1,0,1
"4916","2841台開","110/08/30","兆豐-台中",0,5,-5
"4917","2841台開","110/08/30","元富-成功",1,0,1
"4918","2841台開","110/08/30","新光",0,5,-5
"4919","2841台開","110/08/30","國泰-館前",1,0,1
"4920","2841台開","110/08/30","永豐金-忠孝",0,5,-5
"4921","6207雷科","110/08/30","群益金鼎-高雄",45,0,45
"4922","6207雷科","110/08/30","元大-新莊",0,43,-43
"4923","6207雷科","110/08/30","凱基-台北",28,3,25
"4924","6207雷科","110/08/30","新加坡商瑞銀",1,38,-37
"4925","6207雷科","110/08/30","兆豐-嘉義",21,0,21
"4926","6207雷科","110/08/30","臺銀",0,18,-18
"4927","6207雷科","110/08/30","港商野村",30,13,17
"4928","6207雷科","110/08/30","群益金鼎-土城",0,13,-13
"4929","6207雷科","110/08/30","國票-台中",27,15,12
"4930","6207雷科","110/08/30","群益金鼎-延平",0,13,-13
"4931","6207雷科","110/08/30","凱基-彰化",10,0,10
"4932","6207雷科","110/08/30","永豐金-中壢",0,13,-13
"4933","6207雷科","110/08/30","華南永昌-長虹",10,0,10
"4934","6207雷科","110/08/30","元富-延平",0,10,-10
"4935","6207雷科","110/08/30","元大-大灣",10,0,10
"4936","6207雷科","110/08/30","國泰-桃園",0,10,-10
"4937","6207雷科","110/08/30","摩根大通",30,21,9
"4938","6207雷科","110/08/30","中國信託-高雄",0,8,-8
"4939","6207雷科","110/08/30","日盛-台中",8,0,8
"4940","6207雷科","110/08/30","陽信-石牌",0,8,-8
"4941","6207雷科","110/08/30","群益金鼎-鳳山",7,0,7
"4942","6207雷科","110/08/30","群益金鼎-中壢",2,10,-8
"4943","6207雷科","110/08/30","元大-文心興安",7,0,7
"4944","6207雷科","110/08/30","元富-安南",0,6,-6
"4945","6207雷科","110/08/30","台新-屏東",6,0,6
"4946","6207雷科","110/08/30","群益金鼎-士林",0,6,-6
"4947","6207雷科","110/08/30","聯邦-大業",6,0,6
"4948","6207雷科","110/08/30","華南永昌",0,6,-6
"4949","6207雷科","110/08/30","國泰-高雄",6,0,6
"4950","6207雷科","110/08/30","第一金-高雄",0,5,-5
"4951","3679新至陞","110/08/30","永豐金-南投",12,0,12
"4952","3679新至陞","110/08/30","美林",0,9,-9
"4953","3679新至陞","110/08/30","凱基-中山",3,0,3
"4954","3679新至陞","110/08/30","中國信託-三重",0,4,-4
"4955","3679新至陞","110/08/30","元富-埔里",2,0,2
"4956","3679新至陞","110/08/30","摩根大通",0,3,-3
"4957","3679新至陞","110/08/30","凱基",1,0,1
"4958","3679新至陞","110/08/30","台灣摩根士丹利",0,2,-2
"4959","3679新至陞","110/08/30","元大-四維",1,0,1
"4960","3679新至陞","110/08/30","凱基-台北",0,2,-2
"4961","3679新至陞","110/08/30","富邦-竹北",1,0,1
"4962","3679新至陞","110/08/30","華南永昌",0,2,-2
"4963","3679新至陞","110/08/30","華南永昌-大安",1,0,1
"4964","3679新至陞","110/08/30","元大證券",0,2,-2
"4965","3679新至陞","110/08/30","華南永昌-台中",1,0,1
"4966","3679新至陞","110/08/30","永豐金-高雄",0,2,-2
"4967","3679新至陞","110/08/30","日盛-新莊",1,0,1
"4968","3679新至陞","110/08/30","大慶-富順",0,1,-1
"4969","3679新至陞","110/08/30","玉山-新竹",1,0,1
"4970","3679新至陞","110/08/30","國票-九鼎",0,1,-1
"4971","3679新至陞","110/08/30","台新證券",1,0,1
"4972","3679新至陞","110/08/30","富邦-虎尾",0,1,-1
"4973","3679新至陞","110/08/30","大昌-新店",1,0,1
"4974","3679新至陞","110/08/30","元大-屏東民生",0,1,-1
"4975","3679新至陞","110/08/30","光和-溪湖",1,0,1
"4976","3679新至陞","110/08/30","國泰-敦南",0,0,0
"4977","3679新至陞","110/08/30","元富-板橋",1,0,1
"4978","3679新至陞","110/08/30","元大-太平",0,0,0
"4979","3679新至陞","110/08/30","元富-潮州",1,0,1
"4980","3679新至陞","110/08/30","元大-忠孝",0,0,0
"4981","2727王品","110/08/30","台灣摩根士丹利",74,15,59
"4982","2727王品","110/08/30","港商法國興業",0,27,-27
"4983","2727王品","110/08/30","元大-彰化民生",35,0,35
"4984","2727王品","110/08/30","港商野村",6,24,-18
"4985","2727王品","110/08/30","群益金鼎-大興",13,0,13
"4986","2727王品","110/08/30","元大-中壢",0,16,-16
"4987","2727王品","110/08/30","凱基-台北",36,23,13
"4988","2727王品","110/08/30","元大-苗栗",0,11,-11
"4989","2727王品","110/08/30","國泰證券",10,1,9
"4990","2727王品","110/08/30","元大-小港",1,12,-11
"4991","2727王品","110/08/30","元大-仁愛",9,0,9
"4992","2727王品","110/08/30","新光-新竹",0,9,-9
"4993","2727王品","110/08/30","第一金-台南",6,0,6
"4994","2727王品","110/08/30","美林",23,31,-8
"4995","2727王品","110/08/30","凱基-五股",6,0,6
"4996","2727王品","110/08/30","(牛牛牛)亞-鑫豐",4,11,-7
"4997","2727王品","110/08/30","元大-金華",6,0,6
"4998","2727王品","110/08/30","新光",6,13,-7
"4999","2727王品","110/08/30","元大-桃興",7,1,6
"5000","2727王品","110/08/30","元大-南投",1,8,-7
"5001","2727王品","110/08/30","統一",5,0,5
"5002","2727王品","110/08/30","日盛-木柵",0,6,-6
"5003","2727王品","110/08/30","中國信託-嘉義",5,0,5
"5004","2727王品","110/08/30","元富-草屯",0,6,-6
"5005","2727王品","110/08/30","國票-和平",5,0,5
"5006","2727王品","110/08/30","日盛-士林",0,5,-5
"5007","2727王品","110/08/30","富邦-南屯",7,2,5
"5008","2727王品","110/08/30","統一-屏東",0,5,-5
"5009","2727王品","110/08/30","永豐金-松山",5,0,5
"5010","2727王品","110/08/30","永興-台中",0,4,-4
"5011","1570力肯","110/08/30","摩根大通",69,18,51
"5012","1570力肯","110/08/30","群益金鼎-高雄",0,57,-57
"5013","1570力肯","110/08/30","元大-板橋",31,1,30
"5014","1570力肯","110/08/30","永豐金-永康",0,33,-33
"5015","1570力肯","110/08/30","元大-新營",27,0,27
"5016","1570力肯","110/08/30","國票-南科",0,26,-26
"5017","1570力肯","110/08/30","元大-永和",22,0,22
"5018","1570力肯","110/08/30","國票-北高雄",1,21,-20
"5019","1570力肯","110/08/30","元富-世貿",21,0,21
"5020","1570力肯","110/08/30","富邦-仁愛",1,20,-19
"5021","1570力肯","110/08/30","第一金-嘉義",20,0,20
"5022","1570力肯","110/08/30","元大-花蓮",0,19,-19
"5023","1570力肯","110/08/30","福勝",20,1,19
"5024","1570力肯","110/08/30","元富-延平",0,15,-15
"5025","1570力肯","110/08/30","(牛牛牛)亞-鑫豐",20,2,18
"5026","1570力肯","110/08/30","富邦-高雄",0,15,-15
"5027","1570力肯","110/08/30","台新證券",22,6,16
"5028","1570力肯","110/08/30","元富-新興",0,11,-11
"5029","1570力肯","110/08/30","群益金鼎-台中",16,0,16
"5030","1570力肯","110/08/30","亞東-板橋",0,10,-10
"5031","1570力肯","110/08/30","日盛-雙和",15,0,15
"5032","1570力肯","110/08/30","永豐金-中壢",0,10,-10
"5033","1570力肯","110/08/30","合庫-台中",11,0,11
"5034","1570力肯","110/08/30","元富-緯城",10,19,-9
"5035","1570力肯","110/08/30","聯邦商銀",10,0,10
"5036","1570力肯","110/08/30","元富-民權",5,13,-8
"5037","1570力肯","110/08/30","華南永昌-彰化",10,0,10
"5038","1570力肯","110/08/30","凱基-嘉義",2,10,-8
"5039","1570力肯","110/08/30","元大-鳳中",12,2,10
"5040","1570力肯","110/08/30","元大-南投",0,8,-8
"5041","6180橘子","110/08/30","台灣摩根士丹利",43,0,43
"5042","6180橘子","110/08/30","兆豐證券",0,82,-82
"5043","6180橘子","110/08/30","日盛-八德",15,0,15
"5044","6180橘子","110/08/30","元大-新竹",0,30,-30
"5045","6180橘子","110/08/30","華南永昌-台中",13,0,13
"5046","6180橘子","110/08/30","美商高盛",0,25,-25
"5047","6180橘子","110/08/30","元大-北成功",59,46,13
"5048","6180橘子","110/08/30","新光-高雄",0,19,-19
"5049","6180橘子","110/08/30","美林",11,0,11
"5050","6180橘子","110/08/30","新加坡商瑞銀",0,18,-18
"5051","6180橘子","110/08/30","合庫-彰化",10,0,10
"5052","6180橘子","110/08/30","港商野村",0,13,-13
"5053","6180橘子","110/08/30","宏遠-桃園",9,0,9
"5054","6180橘子","110/08/30","元大-上新莊",0,13,-13
"5055","6180橘子","110/08/30","康和-嘉義",8,0,8
"5056","6180橘子","110/08/30","國泰-新莊",0,12,-12
"5057","6180橘子","110/08/30","群益金鼎-古亭",7,0,7
"5058","6180橘子","110/08/30","玉山-板橋",0,11,-11
"5059","6180橘子","110/08/30","國票-新莊",6,0,6
"5060","6180橘子","110/08/30","凱基-高雄",2,11,-9
"5061","6180橘子","110/08/30","玉山-新莊",6,0,6
"5062","6180橘子","110/08/30","元大-草屯",0,6,-6
"5063","6180橘子","110/08/30","凱基-台北",42,36,6
"5064","6180橘子","110/08/30","元大-彰化民生",0,6,-6
"5065","6180橘子","110/08/30","華南永昌-東昇",6,0,6
"5066","6180橘子","110/08/30","新光",3,8,-5
"5067","6180橘子","110/08/30","群益金鼎-敦南",5,0,5
"5068","6180橘子","110/08/30","富邦-苗栗",0,5,-5
"5069","6180橘子","110/08/30","元大證券",5,0,5
"5070","6180橘子","110/08/30","元大-中壢",0,4,-4
"5071","2390云辰","110/08/30","港商野村",174,128,46
"5072","2390云辰","110/08/30","第一金-華江",0,210,-210
"5073","2390云辰","110/08/30","第一金-中山",33,0,33
"5074","2390云辰","110/08/30","玉山-嘉義",42,113,-71
"5075","2390云辰","110/08/30","凱基-台北",90,64,26
"5076","2390云辰","110/08/30","美林",4,65,-61
"5077","2390云辰","110/08/30","元富-中壢",25,1,24
"5078","2390云辰","110/08/30","新光-桃園",2,42,-40
"5079","2390云辰","110/08/30","中國信託-文心",25,3,22
"5080","2390云辰","110/08/30","元大-龍潭",0,40,-40
"5081","2390云辰","110/08/30","臺銀-高雄",20,0,20
"5082","2390云辰","110/08/30","元大-永春",0,35,-35
"5083","2390云辰","110/08/30","日盛-頭份",20,0,20
"5084","2390云辰","110/08/30","兆豐-高雄",0,33,-33
"5085","2390云辰","110/08/30","元富-虎尾",24,4,20
"5086","2390云辰","110/08/30","元大-台南",0,25,-25
"5087","2390云辰","110/08/30","元大-開元",20,0,20
"5088","2390云辰","110/08/30","台灣摩根士丹利",0,21,-21
"5089","2390云辰","110/08/30","元富-板橋",20,1,19
"5090","2390云辰","110/08/30","元大-林園",0,20,-20
"5091","2390云辰","110/08/30","元富-大裕",23,4,19
"5092","2390云辰","110/08/30","元大-斗信",0,18,-18
"5093","2390云辰","110/08/30","國票-博愛",21,2,19
"5094","2390云辰","110/08/30","玉山-新竹",3,20,-17
"5095","2390云辰","110/08/30","兆豐-台中港",17,0,17
"5096","2390云辰","110/08/30","統一-敦南",0,15,-15
"5097","2390云辰","110/08/30","新光",28,11,17
"5098","2390云辰","110/08/30","兆豐-三民",0,15,-15
"5099","2390云辰","110/08/30","元大-台中",17,0,17
"5100","2390云辰","110/08/30","兆豐-景美",1,14,-13
"5101","1315達新","110/08/26","豐農",32,0,32
"5102","1315達新","110/08/26","永豐金證券",1,17,-16
"5103","1315達新","110/08/26","統一-台中",5,0,5
"5104","1315達新","110/08/26","凱基-台北",0,9,-9
"5105","1315達新","110/08/26","凱基-中港",5,0,5
"5106","1315達新","110/08/26","永豐金-市政",0,8,-8
"5107","1315達新","110/08/26","台灣摩根士丹利",5,1,4
"5108","1315達新","110/08/26","富邦-台中",0,5,-5
"5109","1315達新","110/08/26","美商高盛",4,0,4
"5110","1315達新","110/08/26","元大-花蓮",0,5,-5
"5111","1315達新","110/08/26","聯邦-三重",2,0,2
"5112","1315達新","110/08/26","日盛-新竹",0,2,-2
"5113","1315達新","110/08/26","富邦-內湖",2,0,2
"5114","1315達新","110/08/26","美林",0,2,-2
"5115","1315達新","110/08/26","永興",1,0,1
"5116","1315達新","110/08/26","兆豐-南京",0,2,-2
"5117","1315達新","110/08/26","致和-佳里",1,0,1
"5118","1315達新","110/08/26","國泰-台中",1,3,-2
"5119","1315達新","110/08/26","凱基-三重",1,0,1
"5120","1315達新","110/08/26","華南永昌-楠梓",0,2,-2
"5121","1315達新","110/08/26","凱基-高美館",1,0,1
"5122","1315達新","110/08/26","瑞士信貸",0,1,-1
"5123","1315達新","110/08/26","凱基-內埔",1,0,1
"5124","1315達新","110/08/26","花旗環球",0,1,-1
"5125","1315達新","110/08/26","元大證券",1,0,1
"5126","1315達新","110/08/26","亞東-台南",0,1,-1
"5127","1315達新","110/08/26","元大-沙鹿",1,0,1
"5128","1315達新","110/08/26","第一金",0,1,-1
"5129","1315達新","110/08/26","元大-台北",1,0,1
"5130","1315達新","110/08/26","元富-花蓮",0,1,-1
"5131","2609陽明","110/08/26","永豐金-信義",3562,119,3443
"5132","2609陽明","110/08/26","凱基-台北",2973,9333,-6360
"5133","2609陽明","110/08/26","康和",4424,1135,3289
"5134","2609陽明","110/08/26","台灣摩根士丹利",92,1881,-1789
"5135","2609陽明","110/08/26","摩根大通",6387,3687,2700
"5136","2609陽明","110/08/26","美林",515,1703,-1188
"5137","2609陽明","110/08/26","兆豐-三民",2069,35,2034
"5138","2609陽明","110/08/26","兆豐-中壢",10,856,-846
"5139","2609陽明","110/08/26","花旗環球",1142,0,1142
"5140","2609陽明","110/08/26","富邦-台東",35,624,-589
"5141","2609陽明","110/08/26","統一-敦南",2070,936,1134
"5142","2609陽明","110/08/26","瑞士信貸",390,948,-558
"5143","2609陽明","110/08/26","兆豐-南京",1088,76,1012
"5144","2609陽明","110/08/26","日盛-板橋",169,679,-510
"5145","2609陽明","110/08/26","富邦-建國",1011,325,686
"5146","2609陽明","110/08/26","宏遠證券",1001,1420,-419
"5147","2609陽明","110/08/26","兆豐-虎尾",4061,3405,656
"5148","2609陽明","110/08/26","元大證券",1362,1772,-410
"5149","2609陽明","110/08/26","凱基-市政",1854,1349,505
"5150","2609陽明","110/08/26","富邦-南屯",218,600,-382
"5151","2609陽明","110/08/26","國票-彰化",1013,618,395
"5152","2609陽明","110/08/26","新加坡商瑞銀",1501,1879,-378
"5153","2609陽明","110/08/26","元大-樹林",436,112,324
"5154","2609陽明","110/08/26","兆豐-彰化",382,743,-361
"5155","2609陽明","110/08/26","群益金鼎",517,212,305
"5156","2609陽明","110/08/26","富邦-虎尾",3490,3837,-347
"5157","2609陽明","110/08/26","元富-文心",572,288,284
"5158","2609陽明","110/08/26","寶盛",15,315,-300
"5159","2609陽明","110/08/26","兆豐-埔墘",354,143,211
"5160","2609陽明","110/08/26","華南永昌-竹北",709,1009,-300
"5161","2636台驊投控","110/08/26","富邦-台北",72,6,66
"5162","2636台驊投控","110/08/26","凱基-台北",566,1251,-685
"5163","2636台驊投控","110/08/26","元大-松江",77,15,62
"5164","2636台驊投控","110/08/26","瑞士信貸",31,462,-431
"5165","2636台驊投控","110/08/26","永豐金-嘉義",114,54,60
"5166","2636台驊投控","110/08/26","美商高盛",35,394,-359
"5167","2636台驊投控","110/08/26","華南永昌-南京",78,22,56
"5168","2636台驊投控","110/08/26","台灣摩根士丹利",7,344,-337
"5169","2636台驊投控","110/08/26","國泰-敦南",176,125,51
"5170","2636台驊投控","110/08/26","國票-彰化",466,763,-297
"5171","2636台驊投控","110/08/26","宏遠-館前",50,0,50
"5172","2636台驊投控","110/08/26","美林",290,532,-242
"5173","2636台驊投控","110/08/26","群益金鼎-海山",62,18,44
"5174","2636台驊投控","110/08/26","兆豐-中壢",30,234,-204
"5175","2636台驊投控","110/08/26","第一金-中壢",50,7,43
"5176","2636台驊投控","110/08/26","港商野村",679,881,-202
"5177","2636台驊投控","110/08/26","兆豐-南京",54,11,43
"5178","2636台驊投控","110/08/26","元富-西松",54,219,-165
"5179","2636台驊投控","110/08/26","富邦-嘉義",53,11,42
"5180","2636台驊投控","110/08/26","元大-淡水",8,54,-46
"5181","2636台驊投控","110/08/26","新光",183,143,40
"5182","2636台驊投控","110/08/26","元大-士林",41,82,-41
"5183","2636台驊投控","110/08/26","元大-林森",42,3,39
"5184","2636台驊投控","110/08/26","新加坡商瑞銀",127,164,-37
"5185","2636台驊投控","110/08/26","日盛-忠孝",45,9,36
"5186","2636台驊投控","110/08/26","摩根大通",363,399,-36
"5187","2636台驊投控","110/08/26","華南永昌-合泰",56,20,36
"5188","2636台驊投控","110/08/26","日盛-永康",14,43,-29
"5189","2636台驊投控","110/08/26","日盛-木柵",46,11,35
"5190","2636台驊投控","110/08/26","台中銀-台北",5,33,-28
"5191","2867三商壽","110/08/26","美林",559,133,426
"5192","2867三商壽","110/08/26","台灣摩根士丹利",25,307,-282
"5193","2867三商壽","110/08/26","瑞士信貸",223,8,215
"5194","2867三商壽","110/08/26","凱基-中港",2,279,-277
"5195","2867三商壽","110/08/26","日盛-頭份",108,0,108
"5196","2867三商壽","110/08/26","花旗環球",0,180,-180
"5197","2867三商壽","110/08/26","臺銀-臺中",103,0,103
"5198","2867三商壽","110/08/26","元大-桃園",20,199,-179
"5199","2867三商壽","110/08/26","日盛-樹林",100,0,100
"5200","2867三商壽","110/08/26","國泰證券",0,150,-150
"5201","2867三商壽","110/08/26","新光",90,1,89
"5202","2867三商壽","110/08/26","凱基-台北",18,156,-138
"5203","2867三商壽","110/08/26","光和",80,0,80
"5204","2867三商壽","110/08/26","凱基-長庚",0,120,-120
"5205","2867三商壽","110/08/26","兆豐-城中",70,0,70
"5206","2867三商壽","110/08/26","摩根大通",59,172,-113
"5207","2867三商壽","110/08/26","凱基-高雄",60,0,60
"5208","2867三商壽","110/08/26","群益金鼎-大甲",0,90,-90
"5209","2867三商壽","110/08/26","凱基-林口",50,0,50
"5210","2867三商壽","110/08/26","中國信託-忠孝",0,70,-70
"5211","2867三商壽","110/08/26","富邦-高雄",60,11,49
"5212","2867三商壽","110/08/26","兆豐-新營",0,50,-50
"5213","2867三商壽","110/08/26","港商野村",66,29,37
"5214","2867三商壽","110/08/26","台灣企銀",0,40,-40
"5215","2867三商壽","110/08/26","大昌-新店",37,0,37
"5216","2867三商壽","110/08/26","華南永昌-高雄",24,60,-36
"5217","2867三商壽","110/08/26","國票-南崁",30,0,30
"5218","2867三商壽","110/08/26","兆豐-西螺",0,30,-30
"5219","2867三商壽","110/08/26","中農",25,0,25
"5220","2867三商壽","110/08/26","兆豐-斗南",0,30,-30
"5221","5521工信","110/08/26","摩根大通",563,0,563
"5222","5521工信","110/08/26","華南永昌-民權",0,100,-100
"5223","5521工信","110/08/26","凱基-台北",346,17,329
"5224","5521工信","110/08/26","台灣摩根士丹利",14,103,-89
"5225","5521工信","110/08/26","群益金鼎-大甲",145,0,145
"5226","5521工信","110/08/26","富邦-台北",0,47,-47
"5227","5521工信","110/08/26","美林",61,9,52
"5228","5521工信","110/08/26","國泰-板橋",0,46,-46
"5229","5521工信","110/08/26","兆豐-嘉義",50,0,50
"5230","5521工信","110/08/26","元富-新店",0,40,-40
"5231","5521工信","110/08/26","美商高盛",49,0,49
"5232","5521工信","110/08/26","中國信託-三重",0,40,-40
"5233","5521工信","110/08/26","日進",45,0,45
"5234","5521工信","110/08/26","永豐金-中盛",0,33,-33
"5235","5521工信","110/08/26","元大證券",47,2,45
"5236","5521工信","110/08/26","日盛-中壢",0,32,-32
"5237","5521工信","110/08/26","康和-台中",30,0,30
"5238","5521工信","110/08/26","新光",0,32,-32
"5239","5521工信","110/08/26","福勝",30,12,18
"5240","5521工信","110/08/26","富邦-嘉義",0,31,-31
"5241","5521工信","110/08/26","港商野村",16,0,16
"5242","5521工信","110/08/26","日盛-雙和",0,30,-30
"5243","5521工信","110/08/26","統一-屏東",15,0,15
"5244","5521工信","110/08/26","國票-安和",0,24,-24
"5245","5521工信","110/08/26","日盛-新莊",30,20,10
"5246","5521工信","110/08/26","第一金-桃園",0,23,-23
"5247","5521工信","110/08/26","日盛-中和",10,0,10
"5248","5521工信","110/08/26","日盛-大墩",0,20,-20
"5249","5521工信","110/08/26","凱基-高雄",10,0,10
"5250","5521工信","110/08/26","第一金-華江",0,20,-20
"5251","1471首利","110/08/26","瑞士信貸",60,4,56
"5252","1471首利","110/08/26","群益金鼎-東大",0,120,-120
"5253","1471首利","110/08/26","永豐金-台南",34,0,34
"5254","1471首利","110/08/26","元大-敦化",0,86,-86
"5255","1471首利","110/08/26","大慶",25,0,25
"5256","1471首利","110/08/26","美林",0,40,-40
"5257","1471首利","110/08/26","台中銀-員林",20,0,20
"5258","1471首利","110/08/26","台灣摩根士丹利",0,36,-36
"5259","1471首利","110/08/26","群益金鼎-土城",20,0,20
"5260","1471首利","110/08/26","摩根大通",25,61,-36
"5261","1471首利","110/08/26","新光",16,0,16
"5262","1471首利","110/08/26","元大-內湖",0,30,-30
"5263","1471首利","110/08/26","永豐金-大園",11,0,11
"5264","1471首利","110/08/26","凱基-五股",0,25,-25
"5265","1471首利","110/08/26","永豐金-竹北",11,0,11
"5266","1471首利","110/08/26","元大-大甲",0,20,-20
"5267","1471首利","110/08/26","第一金-台南",10,0,10
"5268","1471首利","110/08/26","台新證券",3,20,-17
"5269","1471首利","110/08/26","中國信託",10,0,10
"5270","1471首利","110/08/26","兆豐-西螺",0,14,-14
"5271","1471首利","110/08/26","中國信託-永康",10,0,10
"5272","1471首利","110/08/26","凱基-台北",4,18,-14
"5273","1471首利","110/08/26","群益金鼎-海山",10,0,10
"5274","1471首利","110/08/26","大慶-富順",0,10,-10
"5275","1471首利","110/08/26","富邦-板橋",10,0,10
"5276","1471首利","110/08/26","國票-九鼎",0,5,-5
"5277","1471首利","110/08/26","元大-永康",10,0,10
"5278","1471首利","110/08/26","元大-斗信",0,5,-5
"5279","1471首利","110/08/26","元富-草屯",9,0,9
"5280","1471首利","110/08/26","永豐金-敦北",0,5,-5
"5281","2883開發金","110/08/26","美林",3929,1002,2927
"5282","2883開發金","110/08/26","台灣摩根士丹利",24,5752,-5728
"5283","2883開發金","110/08/26","元大證券",2303,84,2219
"5284","2883開發金","110/08/26","統一",3,2525,-2522
"5285","2883開發金","110/08/26","港商法國興業",1967,153,1814
"5286","2883開發金","110/08/26","瑞士信貸",71,2033,-1962
"5287","2883開發金","110/08/26","玉山證券",1626,46,1580
"5288","2883開發金","110/08/26","永豐金-新莊",1,1001,-1000
"5289","2883開發金","110/08/26","摩根大通",2510,1213,1297
"5290","2883開發金","110/08/26","新加坡商瑞銀",508,1498,-990
"5291","2883開發金","110/08/26","元大-草屯",1002,18,984
"5292","2883開發金","110/08/26","港商野村",4,846,-842
"5293","2883開發金","110/08/26","華南永昌",1021,206,815
"5294","2883開發金","110/08/26","香港上海匯豐",0,698,-698
"5295","2883開發金","110/08/26","陽信",400,0,400
"5296","2883開發金","110/08/26","凱基-台北",725,1403,-678
"5297","2883開發金","110/08/26","第一金-台南",314,12,302
"5298","2883開發金","110/08/26","永豐金證券",100,493,-393
"5299","2883開發金","110/08/26","國泰-館前",373,86,287
"5300","2883開發金","110/08/26","美商高盛",32,393,-361
"5301","2883開發金","110/08/26","亞東-台中",282,0,282
"5302","2883開發金","110/08/26","元富-城東",4,287,-283
"5303","2883開發金","110/08/26","台新證券",390,136,254
"5304","2883開發金","110/08/26","兆豐-北高雄",172,451,-279
"5305","2883開發金","110/08/26","凱基-宜蘭",270,25,245
"5306","2883開發金","110/08/26","富邦證券",10,235,-225
"5307","2883開發金","110/08/26","凱基-台東",342,113,229
"5308","2883開發金","110/08/26","兆豐-三民",2,210,-208
"5309","2883開發金","110/08/26","永豐金-竹科",233,10,223
"5310","2883開發金","110/08/26","新光",885,1069,-184
"5311","6205詮欣","110/08/26","凱基-信義",20,0,20
"5312","6205詮欣","110/08/26","永豐金-敦南",0,30,-30
"5313","6205詮欣","110/08/26","凱基-長庚",11,0,11
"5314","6205詮欣","110/08/26","凱基-台北",0,9,-9
"5315","6205詮欣","110/08/26","日盛-北高雄",5,0,5
"5316","6205詮欣","110/08/26","凱基-台南",0,7,-7
"5317","6205詮欣","110/08/26","台中銀",5,0,5
"5318","6205詮欣","110/08/26","摩根大通",4,10,-6
"5319","6205詮欣","110/08/26","臺銀-民權",4,0,4
"5320","6205詮欣","110/08/26","兆豐-公益",0,4,-4
"5321","6205詮欣","110/08/26","臺銀-臺中",3,0,3
"5322","6205詮欣","110/08/26","永豐金證券",0,4,-4
"5323","6205詮欣","110/08/26","台新-屏東",3,0,3
"5324","6205詮欣","110/08/26","港商法國興業",0,3,-3
"5325","6205詮欣","110/08/26","日盛-土城",2,0,2
"5326","6205詮欣","110/08/26","瑞士信貸",0,2,-2
"5327","6205詮欣","110/08/26","中農",2,0,2
"5328","6205詮欣","110/08/26","亞東",0,2,-2
"5329","6205詮欣","110/08/26","玉山-台大",2,0,2
"5330","6205詮欣","110/08/26","新光-高雄",0,2,-2
"5331","6205詮欣","110/08/26","玉山-大里",2,0,2
"5332","6205詮欣","110/08/26","元大-屏東民生",0,2,-2
"5333","6205詮欣","110/08/26","國泰-板橋",2,0,2
"5334","6205詮欣","110/08/26","元大-仁愛",0,2,-2
"5335","6205詮欣","110/08/26","凱基-高美館",2,0,2
"5336","6205詮欣","110/08/26","永豐金-台南",0,2,-2
"5337","6205詮欣","110/08/26","華南永昌-台中",2,0,2
"5338","6205詮欣","110/08/26","大慶-台南",0,1,-1
"5339","6205詮欣","110/08/26","永豐金-中和",2,0,2
"5340","6205詮欣","110/08/26","新光",0,1,-1
"5341","1540喬福","110/08/26","元大-士林",12,0,12
"5342","1540喬福","110/08/26","富邦-中壢",0,14,-14
"5343","1540喬福","110/08/26","凱基-中壢",5,0,5
"5344","1540喬福","110/08/26","富邦-虎尾",0,13,-13
"5345","1540喬福","110/08/26","富邦-仁愛",5,0,5
"5346","1540喬福","110/08/26","台新-高雄",0,5,-5
"5347","1540喬福","110/08/26","凱基-台北",4,0,4
"5348","1540喬福","110/08/26","日盛-花蓮",0,2,-2
"5349","1540喬福","110/08/26","富邦-建國",3,0,3
"5350","1540喬福","110/08/26","北城證券",0,2,-2
"5351","1540喬福","110/08/26","中國信託",2,0,2
"5352","1540喬福","110/08/26","元大-南屯",0,1,-1
"5353","1540喬福","110/08/26","國泰-忠孝",2,0,2
"5354","1540喬福","110/08/26","凱基-北門",0,1,-1
"5355","1540喬福","110/08/26","群益金鼎-崇德",2,0,2
"5356","1540喬福","110/08/26","統一-員林",0,1,-1
"5357","1540喬福","110/08/26","永豐金-埔里",1,0,1
"5358","1540喬福","110/08/26","美商高盛",0,1,-1
"5359","1540喬福","110/08/26","致和-南京",1,0,1
"5360","1540喬福","110/08/26","美林",0,1,-1
"5361","1540喬福","110/08/26","華南永昌-中正",1,0,1
"5362","1540喬福","110/08/26","康和-板橋",0,0,0
"5363","1540喬福","110/08/26","富邦-台北",1,0,1
"5364","1540喬福","110/08/26","凱基-竹北",0,0,0
"5365","1540喬福","110/08/26","富邦-左營",1,0,1
"5366","1540喬福","110/08/26","高橋",0,0,0
"5367","1540喬福","110/08/26","華南永昌-敦南",0,0,0
"5368","1540喬福","110/08/26","華南永昌-敦南",0,0,0
"5369","1540喬福","110/08/26","元大-金門",0,0,0
"5370","1540喬福","110/08/26","元大-莒光",0,0,0
"5371","2888新光金","110/08/26","瑞士信貸",3038,457,2581
"5372","2888新光金","110/08/26","元富-大昌",7,9389,-9382
"5373","2888新光金","110/08/26","群益金鼎-崇德",1739,0,1739
"5374","2888新光金","110/08/26","元富-城東",37,2318,-2281
"5375","2888新光金","110/08/26","富邦-岡山",1647,23,1624
"5376","2888新光金","110/08/26","永豐金證券",28,1552,-1524
"5377","2888新光金","110/08/26","凱基-台北",3564,2278,1286
"5378","2888新光金","110/08/26","國票-長城",500,2005,-1505
"5379","2888新光金","110/08/26","致和證券",1108,5,1103
"5380","2888新光金","110/08/26","花旗環球",138,1202,-1064
"5381","2888新光金","110/08/26","美林",1537,539,998
"5382","2888新光金","110/08/26","台灣摩根士丹利",55,1026,-971
"5383","2888新光金","110/08/26","群益金鼎-嘉義",903,17,886
"5384","2888新光金","110/08/26","元富",1,799,-798
"5385","2888新光金","110/08/26","大慶-高雄",832,0,832
"5386","2888新光金","110/08/26","元富-世貿",8,776,-768
"5387","2888新光金","110/08/26","永豐金-板橋",820,1,819
"5388","2888新光金","110/08/26","(牛牛牛)亞-鑫豐",34,645,-611
"5389","2888新光金","110/08/26","凱基-桃園",774,15,759
"5390","2888新光金","110/08/26","香港上海匯豐",0,600,-600
"5391","2888新光金","110/08/26","日盛-忠孝",744,10,734
"5392","2888新光金","110/08/26","元大-板橋",37,499,-462
"5393","2888新光金","110/08/26","新光",766,153,613
"5394","2888新光金","110/08/26","港商法國興業",135,568,-433
"5395","2888新光金","110/08/26","合庫-高雄",607,0,607
"5396","2888新光金","110/08/26","元大證券",239,634,-395
"5397","2888新光金","110/08/26","宏遠-桃園",504,0,504
"5398","2888新光金","110/08/26","元富-文心",132,483,-351
"5399","2888新光金","110/08/26","凱基-台南",520,23,497
"5400","2888新光金","110/08/26","元富-成功",19,358,-339
"5401","1340勝悅","110/08/26","元大-基隆孝二",10,0,10
"5402","1340勝悅","110/08/26","元大-新盛",0,16,-16
"5403","1340勝悅","110/08/26","凱基-台北",9,1,8
"5404","1340勝悅","110/08/26","元大-四維",0,11,-11
"5405","1340勝悅","110/08/26","國泰-台中",7,0,7
"5406","1340勝悅","110/08/26","凱基-松山",0,10,-10
"5407","1340勝悅","110/08/26","美林",6,0,6
"5408","1340勝悅","110/08/26","元大-東門",0,10,-10
"5409","1340勝悅","110/08/26","臺灣企銀-埔墘",5,0,5
"5410","1340勝悅","110/08/26","統一-南京",0,8,-8
"5411","1340勝悅","110/08/26","統一-城中",5,1,4
"5412","1340勝悅","110/08/26","國票-台東",0,5,-5
"5413","1340勝悅","110/08/26","群益金鼎-北高雄",4,0,4
"5414","1340勝悅","110/08/26","摩根大通",2,7,-5
"5415","1340勝悅","110/08/26","日盛-鳳山",3,0,3
"5416","1340勝悅","110/08/26","元大-忠孝鼎富",0,5,-5
"5417","1340勝悅","110/08/26","元大-林園",5,2,3
"5418","1340勝悅","110/08/26","港商法國興業",0,2,-2
"5419","1340勝悅","110/08/26","宏遠-桃園",2,0,2
"5420","1340勝悅","110/08/26","兆豐-三民",0,2,-2
"5421","1340勝悅","110/08/26","第一金-華江",2,0,2
"5422","1340勝悅","110/08/26","臺銀",0,1,-1
"5423","1340勝悅","110/08/26","中農",2,0,2
"5424","1340勝悅","110/08/26","中國信託-文心",0,1,-1
"5425","1340勝悅","110/08/26","國泰-敦南",5,3,2
"5426","1340勝悅","110/08/26","凱基",0,1,-1
"5427","1340勝悅","110/08/26","國泰-館前",2,0,2
"5428","1340勝悅","110/08/26","富邦-嘉義",0,1,-1
"5429","1340勝悅","110/08/26","富邦-北港",2,0,2
"5430","1340勝悅","110/08/26","元大-東泰",0,1,-1
"5431","6246臺龍","110/08/26","兆豐-內湖",40,0,40
"5432","6246臺龍","110/08/26","兆豐-忠孝",0,20,-20
"5433","6246臺龍","110/08/26","新光-台中",11,0,11
"5434","6246臺龍","110/08/26","統一-台南",0,15,-15
"5435","6246臺龍","110/08/26","凱基-永康",10,0,10
"5436","6246臺龍","110/08/26","聯邦-大業",0,10,-10
"5437","6246臺龍","110/08/26","元大-屏南",10,0,10
"5438","6246臺龍","110/08/26","港商野村",0,9,-9
"5439","6246臺龍","110/08/26","元富-板橋",5,0,5
"5440","6246臺龍","110/08/26","元大-員林",0,6,-6
"5441","6246臺龍","110/08/26","元大-北港",5,0,5
"5442","6246臺龍","110/08/26","元富-宜蘭",0,5,-5
"5443","6246臺龍","110/08/26","元大-小港",5,0,5
"5444","6246臺龍","110/08/26","永豐金-板橋",0,5,-5
"5445","6246臺龍","110/08/26","兆豐-竹北",4,0,4
"5446","6246臺龍","110/08/26","兆豐-公益",0,4,-4
"5447","6246臺龍","110/08/26","華南永昌-台中",4,0,4
"5448","6246臺龍","110/08/26","兆豐-新營",0,4,-4
"5449","6246臺龍","110/08/26","華南永昌-彰化",3,0,3
"5450","6246臺龍","110/08/26","國票-新莊",0,4,-4
"5451","6246臺龍","110/08/26","元大-大雅",3,0,3
"5452","6246臺龍","110/08/26","玉山證券",0,4,-4
"5453","6246臺龍","110/08/26","土銀-新竹",2,0,2
"5454","6246臺龍","110/08/26","凱基-長庚",0,4,-4
"5455","6246臺龍","110/08/26","日盛-八德",2,0,2
"5456","6246臺龍","110/08/26","永豐金-復興",1,5,-4
"5457","6246臺龍","110/08/26","高橋",2,0,2
"5458","6246臺龍","110/08/26","元大-永康",0,3,-3
"5459","6246臺龍","110/08/26","玉山-台南",2,0,2
"5460","6246臺龍","110/08/26","台新證券",0,2,-2
"5461","00715L期街口布蘭特正2","110/08/26","元大證券",27288,25,27263
"5462","00715L期街口布蘭特正2","110/08/26","宏遠-高雄",0,11055,-11055
"5463","00715L期街口布蘭特正2","110/08/26","永豐金證券",6471,22,6449
"5464","00715L期街口布蘭特正2","110/08/26","元大-萬華",0,2051,-2051
"5465","00715L期街口布蘭特正2","110/08/26","元富",3942,0,3942
"5466","00715L期街口布蘭特正2","110/08/26","(牛牛牛)亞-鑫豐",17,1456,-1439
"5467","00715L期街口布蘭特正2","110/08/26","合庫證券",3500,20,3480
"5468","00715L期街口布蘭特正2","110/08/26","元大-新竹",110,1320,-1210
"5469","00715L期街口布蘭特正2","110/08/26","國票",2138,8,2130
"5470","00715L期街口布蘭特正2","110/08/26","元大-永康",0,1053,-1053
"5471","00715L期街口布蘭特正2","110/08/26","群益金鼎",1740,0,1740
"5472","00715L期街口布蘭特正2","110/08/26","華南永昌-台中",102,827,-725
"5473","00715L期街口布蘭特正2","110/08/26","統一",1396,3,1393
"5474","00715L期街口布蘭特正2","110/08/26","玉山-大里",2,630,-628
"5475","00715L期街口布蘭特正2","110/08/26","台新證券",1085,223,862
"5476","00715L期街口布蘭特正2","110/08/26","華南永昌",0,606,-606
"5477","00715L期街口布蘭特正2","110/08/26","聯邦-三重",550,19,531
"5478","00715L期街口布蘭特正2","110/08/26","新光",179,718,-539
"5479","00715L期街口布蘭特正2","110/08/26","國票-博愛",550,30,520
"5480","00715L期街口布蘭特正2","110/08/26","國泰-敦南",607,1119,-512
"5481","00715L期街口布蘭特正2","110/08/26","富邦證券",562,99,463
"5482","00715L期街口布蘭特正2","110/08/26","元大-大雅",22,524,-502
"5483","00715L期街口布蘭特正2","110/08/26","兆豐證券",600,156,444
"5484","00715L期街口布蘭特正2","110/08/26","玉山-新竹",0,489,-489
"5485","00715L期街口布蘭特正2","110/08/26","凱基-台北",401,129,272
"5486","00715L期街口布蘭特正2","110/08/26","第一金-路竹",5,459,-454
"5487","00715L期街口布蘭特正2","110/08/26","凱基-新豐",208,20,188
"5488","00715L期街口布蘭特正2","110/08/26","富邦-嘉義",0,406,-406
"5489","00715L期街口布蘭特正2","110/08/26","新光-桃園",92,29,63
"5490","00715L期街口布蘭特正2","110/08/26","元大-淡水",1,326,-325
"5491","8941關中","110/08/26","元大-四維",6,0,6
"5492","8941關中","110/08/26","凱基-中山",0,4,-4
"5493","8941關中","110/08/26","玉山證券",4,0,4
"5494","8941關中","110/08/26","富邦-員林",2,6,-4
"5495","8941關中","110/08/26","元富-台中",1,0,1
"5496","8941關中","110/08/26","彰銀-台中",0,1,-1
"5497","8941關中","110/08/26","元大-斗六",1,0,1
"5498","8941關中","110/08/26","第一金-台中",0,1,-1
"5499","8941關中","110/08/26","凱基-高美館",3,3,0
"5500","8941關中","110/08/26","康和-板橋",0,1,-1
"5501","8941關中","110/08/26","元大-金華",3,3,0
"5502","8941關中","110/08/26","元大-桃興",1,2,-1
"5503","8941關中","110/08/26","永豐金-敦北",0,0,0
"5504","8941關中","110/08/26","凱基-高美館",3,3,0
"5505","8941關中","110/08/26","永豐金-萬盛",0,0,0
"5506","8941關中","110/08/26","元大-金華",3,3,0
"5507","8941關中","110/08/26","永豐金-南投",0,0,0
"5508","8941關中","110/08/26","永豐金-敦北",0,0,0
"5509","8941關中","110/08/26","",NA,NA,NA
"5510","8941關中","110/08/26","永豐金-萬盛",0,0,0
"5511","8941關中","110/08/26","",NA,NA,NA
"5512","8941關中","110/08/26","永豐金-南投",0,0,0
"5513","8941關中","110/08/26","",NA,NA,NA
"5514","8941關中","110/08/26","",NA,NA,NA
"5515","8941關中","110/08/26","",NA,NA,NA
"5516","8941關中","110/08/26","",NA,NA,NA
"5517","8941關中","110/08/26","",NA,NA,NA
"5518","8941關中","110/08/26","",NA,NA,NA
"5519","8941關中","110/08/26","",NA,NA,NA
"5520","8941關中","110/08/26","",NA,NA,NA
"5521","8936國統","110/08/26","永豐金-苓雅",106,0,106
"5522","8936國統","110/08/26","元大-蘆洲",0,107,-107
"5523","8936國統","110/08/26","台新-高雄",48,2,46
"5524","8936國統","110/08/26","元富-新興",0,96,-96
"5525","8936國統","110/08/26","元大-天母",43,0,43
"5526","8936國統","110/08/26","康和-嘉義",2,79,-77
"5527","8936國統","110/08/26","光和-溪湖",40,0,40
"5528","8936國統","110/08/26","凱基-台北",1,72,-71
"5529","8936國統","110/08/26","元富-敦南",32,0,32
"5530","8936國統","110/08/26","新光-台中",30,89,-59
"5531","8936國統","110/08/26","中國信託-高雄",31,0,31
"5532","8936國統","110/08/26","國票-台東",0,50,-50
"5533","8936國統","110/08/26","國票-敦北法人",20,0,20
"5534","8936國統","110/08/26","摩根大通",4,39,-35
"5535","8936國統","110/08/26","台灣摩根士丹利",14,0,14
"5536","8936國統","110/08/26","富邦-陽明",0,30,-30
"5537","8936國統","110/08/26","美林",12,0,12
"5538","8936國統","110/08/26","新加坡商瑞銀",23,51,-28
"5539","8936國統","110/08/26","國泰-館前",12,0,12
"5540","8936國統","110/08/26","新光-新竹",5,25,-20
"5541","8936國統","110/08/26","第一金-桃園",11,0,11
"5542","8936國統","110/08/26","永豐金-北高雄",0,15,-15
"5543","8936國統","110/08/26","日盛證券",10,0,10
"5544","8936國統","110/08/26","群益金鼎-彰化",0,12,-12
"5545","8936國統","110/08/26","日盛-北高雄",10,0,10
"5546","8936國統","110/08/26","日盛-忠孝",0,10,-10
"5547","8936國統","110/08/26","統一-台中",10,0,10
"5548","8936國統","110/08/26","中國信託-松江",0,10,-10
"5549","8936國統","110/08/26","兆豐-竹北",10,0,10
"5550","8936國統","110/08/26","富邦-三重",0,10,-10
"5551","6226光鼎","110/08/26","大展-台南",235,14,221
"5552","6226光鼎","110/08/26","摩根大通",0,1105,-1105
"5553","6226光鼎","110/08/26","宏遠-光隆",186,32,154
"5554","6226光鼎","110/08/26","台灣摩根士丹利",12,742,-730
"5555","6226光鼎","110/08/26","兆豐-松德",145,0,145
"5556","6226光鼎","110/08/26","元大-大同",6,557,-551
"5557","6226光鼎","110/08/26","凱基-台北",204,67,137
"5558","6226光鼎","110/08/26","統一",13,410,-397
"5559","6226光鼎","110/08/26","合庫-台中",127,13,114
"5560","6226光鼎","110/08/26","凱基-永和",10,305,-295
"5561","6226光鼎","110/08/26","元大-敦化",97,0,97
"5562","6226光鼎","110/08/26","港商野村",193,480,-287
"5563","6226光鼎","110/08/26","中國信託-忠孝",97,13,84
"5564","6226光鼎","110/08/26","美商高盛",48,329,-281
"5565","6226光鼎","110/08/26","國泰-敦南",354,272,82
"5566","6226光鼎","110/08/26","美林",73,274,-201
"5567","6226光鼎","110/08/26","臺銀-鳳山",84,12,72
"5568","6226光鼎","110/08/26","統一-南京",5,205,-200
"5569","6226光鼎","110/08/26","元大-木柵",80,12,68
"5570","6226光鼎","110/08/26","富邦證券",0,95,-95
"5571","6226光鼎","110/08/26","富邦-台北",73,6,67
"5572","6226光鼎","110/08/26","凱基-大直",110,187,-77
"5573","6226光鼎","110/08/26","永豐金-苓雅",67,0,67
"5574","6226光鼎","110/08/26","元大-四維",61,135,-74
"5575","6226光鼎","110/08/26","元大-大雅",184,127,57
"5576","6226光鼎","110/08/26","群益金鼎-鳳山",2,61,-59
"5577","6226光鼎","110/08/26","玉山-板橋",55,0,55
"5578","6226光鼎","110/08/26","富邦-建國",18,74,-56
"5579","6226光鼎","110/08/26","元大-仁愛",55,0,55
"5580","6226光鼎","110/08/26","永豐金-虎尾",1,50,-49
"5581","2363矽統","110/08/26","美林",676,159,517
"5582","2363矽統","110/08/26","凱基-台北",1056,1726,-670
"5583","2363矽統","110/08/26","合庫-基隆",1381,1003,378
"5584","2363矽統","110/08/26","宏遠-光隆",18,368,-350
"5585","2363矽統","110/08/26","富邦-彰化",380,25,355
"5586","2363矽統","110/08/26","台新-台南",56,248,-192
"5587","2363矽統","110/08/26","第一金-桃園",311,12,299
"5588","2363矽統","110/08/26","日盛-南京",34,170,-136
"5589","2363矽統","110/08/26","華南永昌-台中",349,81,268
"5590","2363矽統","110/08/26","北城證券",206,329,-123
"5591","2363矽統","110/08/26","新光",480,249,231
"5592","2363矽統","110/08/26","光和-嘉義",20,137,-117
"5593","2363矽統","110/08/26","瑞士信貸",198,3,195
"5594","2363矽統","110/08/26","統一-城中",75,189,-114
"5595","2363矽統","110/08/26","元大-前金",160,31,129
"5596","2363矽統","110/08/26","華南永昌-朴子",28,131,-103
"5597","2363矽統","110/08/26","元大-博愛",157,31,126
"5598","2363矽統","110/08/26","康和-嘉義",3,101,-98
"5599","2363矽統","110/08/26","凱基-嘉義",90,6,84
"5600","2363矽統","110/08/26","凱基-中山",8,105,-97
"5601","2363矽統","110/08/26","玉山-桃園",104,24,80
"5602","2363矽統","110/08/26","台新-台中",29,118,-89
"5603","2363矽統","110/08/26","元大-和平",80,13,67
"5604","2363矽統","110/08/26","凱基-大直",30,108,-78
"5605","2363矽統","110/08/26","第一金-嘉義",71,11,60
"5606","2363矽統","110/08/26","亞東-板橋",17,89,-72
"5607","2363矽統","110/08/26","新光-桃園",163,105,58
"5608","2363矽統","110/08/26","國泰-板橋",93,164,-71
"5609","2363矽統","110/08/26","元大-左營",68,13,55
"5610","2363矽統","110/08/26","統一-永和",2,62,-60
"5611","8112至上","110/08/26","凱基-台北",372,56,316
"5612","8112至上","110/08/26","群益金鼎",0,150,-150
"5613","8112至上","110/08/26","摩根大通",376,62,314
"5614","8112至上","110/08/26","台新-台中",10,113,-103
"5615","8112至上","110/08/26","凱基-竹科",151,1,150
"5616","8112至上","110/08/26","群益金鼎-基隆",0,90,-90
"5617","8112至上","110/08/26","新加坡商瑞銀",191,45,146
"5618","8112至上","110/08/26","永豐金-台中",1,80,-79
"5619","8112至上","110/08/26","台灣摩根士丹利",129,41,88
"5620","8112至上","110/08/26","凱基-東勢",0,50,-50
"5621","8112至上","110/08/26","美商高盛",172,92,80
"5622","8112至上","110/08/26","凱基-北門",0,50,-50
"5623","8112至上","110/08/26","日進",69,3,66
"5624","8112至上","110/08/26","元大-西門",0,50,-50
"5625","8112至上","110/08/26","兆豐-西螺",60,0,60
"5626","8112至上","110/08/26","群益金鼎-高雄",0,40,-40
"5627","8112至上","110/08/26","港商野村",63,24,39
"5628","8112至上","110/08/26","元富-新莊",0,31,-31
"5629","8112至上","110/08/26","元大-竹東",30,0,30
"5630","8112至上","110/08/26","日盛-復興",1,31,-30
"5631","8112至上","110/08/26","元大-淡水",30,2,28
"5632","8112至上","110/08/26","統一-南京",0,30,-30
"5633","8112至上","110/08/26","康和",30,5,25
"5634","8112至上","110/08/26","凱基-士林",1,31,-30
"5635","8112至上","110/08/26","凱基-三重",22,0,22
"5636","8112至上","110/08/26","元大-佳里",0,30,-30
"5637","8112至上","110/08/26","元大-楊梅",20,1,19
"5638","8112至上","110/08/26","台灣企銀-民雄",0,27,-27
"5639","8112至上","110/08/26","元大-豐原",20,2,18
"5640","8112至上","110/08/26","日盛-台南",0,27,-27
"5641","1570力肯","110/08/26","群益金鼎-高雄",34,0,34
"5642","1570力肯","110/08/26","永豐金-虎尾",0,50,-50
"5643","1570力肯","110/08/26","香港上海匯豐",21,0,21
"5644","1570力肯","110/08/26","富邦-高雄",0,38,-38
"5645","1570力肯","110/08/26","凱基-台北",9,1,8
"5646","1570力肯","110/08/26","華南永昌-麻豆",0,14,-14
"5647","1570力肯","110/08/26","國票-台中",7,0,7
"5648","1570力肯","110/08/26","摩根大通",0,11,-11
"5649","1570力肯","110/08/26","美林",6,0,6
"5650","1570力肯","110/08/26","凱基-復興",0,7,-7
"5651","1570力肯","110/08/26","群益金鼎-瑞豐",6,0,6
"5652","1570力肯","110/08/26","元大-基隆孝二",0,7,-7
"5653","1570力肯","110/08/26","日茂-南投",5,0,5
"5654","1570力肯","110/08/26","國票-博愛",2,8,-6
"5655","1570力肯","110/08/26","兆豐-鹿港",5,0,5
"5656","1570力肯","110/08/26","元富-城東",0,5,-5
"5657","1570力肯","110/08/26","兆豐-松德",5,0,5
"5658","1570力肯","110/08/26","兆豐-中壢",0,4,-4
"5659","1570力肯","110/08/26","國票-和平",5,0,5
"5660","1570力肯","110/08/26","華南永昌-大安",0,4,-4
"5661","1570力肯","110/08/26","凱基-站前",5,0,5
"5662","1570力肯","110/08/26","統一-三重",0,3,-3
"5663","1570力肯","110/08/26","元大-新竹經國",5,0,5
"5664","1570力肯","110/08/26","統一-員林",0,2,-2
"5665","1570力肯","110/08/26","元大-草屯",4,0,4
"5666","1570力肯","110/08/26","凱基-天母",0,2,-2
"5667","1570力肯","110/08/26","(牛牛牛)亞-鑫豐",3,0,3
"5668","1570力肯","110/08/26","元大-大里",0,2,-2
"5669","1570力肯","110/08/26","國票-北高雄",4,1,3
"5670","1570力肯","110/08/26","大慶-富順",0,1,-1
"5671","2929淘帝","110/08/26","新光-新竹",47,0,47
"5672","2929淘帝","110/08/26","元大-豐原站前",0,20,-20
"5673","2929淘帝","110/08/26","摩根大通",20,0,20
"5674","2929淘帝","110/08/26","康和-仁愛",0,17,-17
"5675","2929淘帝","110/08/26","兆豐-民生",10,0,10
"5676","2929淘帝","110/08/26","新光-台中",16,32,-16
"5677","2929淘帝","110/08/26","元大-承德",10,0,10
"5678","2929淘帝","110/08/26","港商野村",3,15,-12
"5679","2929淘帝","110/08/26","元大-萬華",10,0,10
"5680","2929淘帝","110/08/26","合庫-自強",0,10,-10
"5681","2929淘帝","110/08/26","日盛-和美",5,0,5
"5682","2929淘帝","110/08/26","美林",3,12,-9
"5683","2929淘帝","110/08/26","台中銀-豐原",5,0,5
"5684","2929淘帝","110/08/26","富邦-南屯",1,10,-9
"5685","2929淘帝","110/08/26","國泰-敦南",5,0,5
"5686","2929淘帝","110/08/26","元富-花蓮",0,8,-8
"5687","2929淘帝","110/08/26","元大-大雅",5,0,5
"5688","2929淘帝","110/08/26","富邦-高雄",0,8,-8
"5689","2929淘帝","110/08/26","元大-蘆洲",5,0,5
"5690","2929淘帝","110/08/26","華南永昌-古亭",0,5,-5
"5691","2929淘帝","110/08/26","富邦-內湖",4,0,4
"5692","2929淘帝","110/08/26","港商法國興業",0,4,-4
"5693","2929淘帝","110/08/26","元大-太平",4,0,4
"5694","2929淘帝","110/08/26","新加坡商瑞銀",0,4,-4
"5695","2929淘帝","110/08/26","新光-台南",3,0,3
"5696","2929淘帝","110/08/26","第一金-台南",0,4,-4
"5697","2929淘帝","110/08/26","陽信",3,0,3
"5698","2929淘帝","110/08/26","凱基-長庚",0,4,-4
"5699","2929淘帝","110/08/26","國泰-板橋",3,0,3
"5700","2929淘帝","110/08/26","元大-新竹經國",0,4,-4
"5701","5410國眾","110/08/26","香港上海匯豐",34,0,34
"5702","5410國眾","110/08/26","高橋",0,20,-20
"5703","5410國眾","110/08/26","凱基-台北",34,1,33
"5704","5410國眾","110/08/26","寶盛",0,10,-10
"5705","5410國眾","110/08/26","玉山-高雄",15,0,15
"5706","5410國眾","110/08/26","安泰",0,10,-10
"5707","5410國眾","110/08/26","富邦-內湖",10,0,10
"5708","5410國眾","110/08/26","國泰-敦南",0,10,-10
"5709","5410國眾","110/08/26","元大-中壢",7,0,7
"5710","5410國眾","110/08/26","國泰-台南",0,9,-9
"5711","5410國眾","110/08/26","元大-內湖",7,0,7
"5712","5410國眾","110/08/26","玉山-雙和",0,7,-7
"5713","5410國眾","110/08/26","康和-新竹",6,0,6
"5714","5410國眾","110/08/26","元大-金華",0,7,-7
"5715","5410國眾","110/08/26","摩根大通",5,0,5
"5716","5410國眾","110/08/26","台新-建北",0,6,-6
"5717","5410國眾","110/08/26","凱基-長庚",5,0,5
"5718","5410國眾","110/08/26","元大-羅東",0,6,-6
"5719","5410國眾","110/08/26","元大-向上",5,0,5
"5720","5410國眾","110/08/26","合庫-嘉義",0,5,-5
"5721","5410國眾","110/08/26","元大-南屯",5,0,5
"5722","5410國眾","110/08/26","新光",1,6,-5
"5723","5410國眾","110/08/26","華南永昌-林口",4,0,4
"5724","5410國眾","110/08/26","富邦-台北",0,5,-5
"5725","5410國眾","110/08/26","台新-中壢",3,0,3
"5726","5410國眾","110/08/26","元大-土城",0,5,-5
"5727","5410國眾","110/08/26","華南永昌-內壢",3,0,3
"5728","5410國眾","110/08/26","臺銀-臺中",0,3,-3
"5729","5410國眾","110/08/26","元大-北投",2,0,2
"5730","5410國眾","110/08/26","第一金-澎湖",0,3,-3
"5731","2841台開","110/08/26","宏遠-館前",180,0,180
"5732","2841台開","110/08/26","台中銀",0,50,-50
"5733","2841台開","110/08/26","元富-新興",25,0,25
"5734","2841台開","110/08/26","港商野村",0,35,-35
"5735","2841台開","110/08/26","永豐金-敦南",23,12,11
"5736","2841台開","110/08/26","台新-屏東",0,21,-21
"5737","2841台開","110/08/26","康和-內湖",8,0,8
"5738","2841台開","110/08/26","新加坡商瑞銀",0,20,-20
"5739","2841台開","110/08/26","永豐金-古亭",6,0,6
"5740","2841台開","110/08/26","新光-新竹",0,20,-20
"5741","2841台開","110/08/26","台新-新營",5,0,5
"5742","2841台開","110/08/26","元大-彰化民生",0,18,-18
"5743","2841台開","110/08/26","玉山證券",5,0,5
"5744","2841台開","110/08/26","台灣摩根士丹利",0,12,-12
"5745","2841台開","110/08/26","元大-板橋",4,0,4
"5746","2841台開","110/08/26","日盛-頭份",0,11,-11
"5747","2841台開","110/08/26","國泰-敦南",3,0,3
"5748","2841台開","110/08/26","華南永昌-虎尾",0,10,-10
"5749","2841台開","110/08/26","日盛-和美",2,0,2
"5750","2841台開","110/08/26","元大-承德",0,10,-10
"5751","2841台開","110/08/26","台新-台南",2,0,2
"5752","2841台開","110/08/26","元大-北三重",0,10,-10
"5753","2841台開","110/08/26","凱基-台北",5,3,2
"5754","2841台開","110/08/26","富邦-宜蘭",0,7,-7
"5755","2841台開","110/08/26","合庫-自強",1,0,1
"5756","2841台開","110/08/26","華南永昌-岡山",0,5,-5
"5757","2841台開","110/08/26","元富-板橋",1,0,1
"5758","2841台開","110/08/26","富邦-中壢",0,5,-5
"5759","2841台開","110/08/26","群益金鼎-崇德",1,0,1
"5760","2841台開","110/08/26","日盛-二林",0,4,-4
"5761","6207雷科","110/08/26","凱基-台北",21,0,21
"5762","6207雷科","110/08/26","新加坡商瑞銀",1,63,-62
"5763","6207雷科","110/08/26","統一-竹南",18,0,18
"5764","6207雷科","110/08/26","凱基-高美館",5,32,-27
"5765","6207雷科","110/08/26","凱基-台東",15,0,15
"5766","6207雷科","110/08/26","第一金-華江",0,11,-11
"5767","6207雷科","110/08/26","元大-六合",12,0,12
"5768","6207雷科","110/08/26","國泰-板橋",0,11,-11
"5769","6207雷科","110/08/26","元大-大灣",10,0,10
"5770","6207雷科","110/08/26","港商野村",10,20,-10
"5771","6207雷科","110/08/26","瑞士信貸",7,0,7
"5772","6207雷科","110/08/26","國票-中正",0,10,-10
"5773","6207雷科","110/08/26","亞東-台南",7,0,7
"5774","6207雷科","110/08/26","永豐金-內湖",0,10,-10
"5775","6207雷科","110/08/26","寶盛",6,0,6
"5776","6207雷科","110/08/26","中國信託-高雄",0,9,-9
"5777","6207雷科","110/08/26","永豐金-板新",6,0,6
"5778","6207雷科","110/08/26","元大-大同",0,8,-8
"5779","6207雷科","110/08/26","日盛-員林",22,17,5
"5780","6207雷科","110/08/26","合庫-台中",0,5,-5
"5781","6207雷科","110/08/26","第一金-高雄",5,0,5
"5782","6207雷科","110/08/26","第一金-中山",0,5,-5
"5783","6207雷科","110/08/26","第一金-路竹",5,0,5
"5784","6207雷科","110/08/26","德信-和平",0,5,-5
"5785","6207雷科","110/08/26","兆豐-三民",5,0,5
"5786","6207雷科","110/08/26","群益金鼎-忠孝",0,5,-5
"5787","6207雷科","110/08/26","國票-新莊",5,0,5
"5788","6207雷科","110/08/26","凱基-長庚",0,5,-5
"5789","6207雷科","110/08/26","群益金鼎-高盛",5,0,5
"5790","6207雷科","110/08/26","華南永昌-林口",0,5,-5
"5791","3679新至陞","110/08/26","永豐金-南投",13,0,13
"5792","3679新至陞","110/08/26","凱基-台北",0,11,-11
"5793","3679新至陞","110/08/26","元大-大天母",10,0,10
"5794","3679新至陞","110/08/26","摩根大通",0,10,-10
"5795","3679新至陞","110/08/26","玉山-台大",6,0,6
"5796","3679新至陞","110/08/26","美林",0,9,-9
"5797","3679新至陞","110/08/26","台灣摩根士丹利",3,2,1
"5798","3679新至陞","110/08/26","瑞士信貸",0,5,-5
"5799","3679新至陞","110/08/26","亞東-板橋",1,0,1
"5800","3679新至陞","110/08/26","華南永昌-嘉義",0,4,-4
"5801","3679新至陞","110/08/26","統一-桃園",1,0,1
"5802","3679新至陞","110/08/26","元大-福營",0,3,-3
"5803","3679新至陞","110/08/26","元富-埔里",1,0,1
"5804","3679新至陞","110/08/26","花旗環球",0,1,-1
"5805","3679新至陞","110/08/26","台中銀-員林",1,0,1
"5806","3679新至陞","110/08/26","新加坡商瑞銀",0,1,-1
"5807","3679新至陞","110/08/26","兆豐-來福",1,0,1
"5808","3679新至陞","110/08/26","中國信託-永康",0,1,-1
"5809","3679新至陞","110/08/26","兆豐-松德",1,0,1
"5810","3679新至陞","110/08/26","國票-中和",0,1,-1
"5811","3679新至陞","110/08/26","玉山-高雄",2,1,1
"5812","3679新至陞","110/08/26","香港上海匯豐",0,1,-1
"5813","3679新至陞","110/08/26","凱基-桃園",1,0,1
"5814","3679新至陞","110/08/26","富邦-建國",0,1,-1
"5815","3679新至陞","110/08/26","凱基-幸福",1,0,1
"5816","3679新至陞","110/08/26","富邦-新店",1,2,-1
"5817","3679新至陞","110/08/26","凱基-城中",1,0,1
"5818","3679新至陞","110/08/26","元大-永春",0,1,-1
"5819","3679新至陞","110/08/26","華南永昌-大安",1,0,1
"5820","3679新至陞","110/08/26","永豐金證券",0,1,-1
"5821","2727王品","110/08/26","瑞士信貸",54,0,54
"5822","2727王品","110/08/26","凱基-台北",11,70,-59
"5823","2727王品","110/08/26","元大-桃園",26,0,26
"5824","2727王品","110/08/26","永豐金證券",0,48,-48
"5825","2727王品","110/08/26","兆豐-北高雄",32,7,25
"5826","2727王品","110/08/26","華南永昌-鳳山",0,36,-36
"5827","2727王品","110/08/26","台新證券",29,8,21
"5828","2727王品","110/08/26","元大-彰化民生",1,35,-34
"5829","2727王品","110/08/26","康和-澎湖",20,0,20
"5830","2727王品","110/08/26","摩根大通",13,46,-33
"5831","2727王品","110/08/26","台灣摩根士丹利",54,35,19
"5832","2727王品","110/08/26","元大證券",25,57,-32
"5833","2727王品","110/08/26","(牛牛牛)亞-鑫豐",18,2,16
"5834","2727王品","110/08/26","彰銀-台中",1,30,-29
"5835","2727王品","110/08/26","元大-中壢",16,1,15
"5836","2727王品","110/08/26","國泰證券",0,19,-19
"5837","2727王品","110/08/26","華南永昌",13,1,12
"5838","2727王品","110/08/26","富邦-建國",2,21,-19
"5839","2727王品","110/08/26","永豐金-萬盛",12,0,12
"5840","2727王品","110/08/26","美林",5,19,-14
"5841","2727王品","110/08/26","新光-台中",14,3,11
"5842","2727王品","110/08/26","統一",0,14,-14
"5843","2727王品","110/08/26","新光",19,9,10
"5844","2727王品","110/08/26","國票-內壢",1,14,-13
"5845","2727王品","110/08/26","國泰-台南",12,3,9
"5846","2727王品","110/08/26","台灣企銀",0,12,-12
"5847","2727王品","110/08/26","元大-景美",9,1,8
"5848","2727王品","110/08/26","康和-高雄",0,10,-10
"5849","2727王品","110/08/26","國泰-敦南",20,13,7
"5850","2727王品","110/08/26","統一-松江",0,8,-8
"5851","1570力肯","110/08/26","群益金鼎-高雄",34,0,34
"5852","1570力肯","110/08/26","永豐金-虎尾",0,50,-50
"5853","1570力肯","110/08/26","香港上海匯豐",21,0,21
"5854","1570力肯","110/08/26","富邦-高雄",0,38,-38
"5855","1570力肯","110/08/26","凱基-台北",9,1,8
"5856","1570力肯","110/08/26","華南永昌-麻豆",0,14,-14
"5857","1570力肯","110/08/26","國票-台中",7,0,7
"5858","1570力肯","110/08/26","摩根大通",0,11,-11
"5859","1570力肯","110/08/26","美林",6,0,6
"5860","1570力肯","110/08/26","凱基-復興",0,7,-7
"5861","1570力肯","110/08/26","群益金鼎-瑞豐",6,0,6
"5862","1570力肯","110/08/26","元大-基隆孝二",0,7,-7
"5863","1570力肯","110/08/26","日茂-南投",5,0,5
"5864","1570力肯","110/08/26","國票-博愛",2,8,-6
"5865","1570力肯","110/08/26","兆豐-鹿港",5,0,5
"5866","1570力肯","110/08/26","元富-城東",0,5,-5
"5867","1570力肯","110/08/26","兆豐-松德",5,0,5
"5868","1570力肯","110/08/26","兆豐-中壢",0,4,-4
"5869","1570力肯","110/08/26","國票-和平",5,0,5
"5870","1570力肯","110/08/26","華南永昌-大安",0,4,-4
"5871","1570力肯","110/08/26","凱基-站前",5,0,5
"5872","1570力肯","110/08/26","統一-三重",0,3,-3
"5873","1570力肯","110/08/26","元大-新竹經國",5,0,5
"5874","1570力肯","110/08/26","統一-員林",0,2,-2
"5875","1570力肯","110/08/26","元大-草屯",4,0,4
"5876","1570力肯","110/08/26","凱基-天母",0,2,-2
"5877","1570力肯","110/08/26","(牛牛牛)亞-鑫豐",3,0,3
"5878","1570力肯","110/08/26","元大-大里",0,2,-2
"5879","1570力肯","110/08/26","國票-北高雄",4,1,3
"5880","1570力肯","110/08/26","大慶-富順",0,1,-1
"5881","6180橘子","110/08/26","港商野村",126,2,124
"5882","6180橘子","110/08/26","國票-南港",0,71,-71
"5883","6180橘子","110/08/26","美林",29,0,29
"5884","6180橘子","110/08/26","新加坡商瑞銀",0,31,-31
"5885","6180橘子","110/08/26","國泰-敦南",19,1,18
"5886","6180橘子","110/08/26","大慶-富順",0,22,-22
"5887","6180橘子","110/08/26","日盛-文化",15,0,15
"5888","6180橘子","110/08/26","摩根大通",28,47,-19
"5889","6180橘子","110/08/26","美商高盛",26,11,15
"5890","6180橘子","110/08/26","華南永昌-公誠",1,20,-19
"5891","6180橘子","110/08/26","高橋",15,0,15
"5892","6180橘子","110/08/26","元大-台中中港",1,17,-16
"5893","6180橘子","110/08/26","新光-台中",14,0,14
"5894","6180橘子","110/08/26","新光",5,20,-15
"5895","6180橘子","110/08/26","日盛-中壢",13,0,13
"5896","6180橘子","110/08/26","國泰-高雄",1,16,-15
"5897","6180橘子","110/08/26","富邦-新營",13,0,13
"5898","6180橘子","110/08/26","凱基-台北",263,277,-14
"5899","6180橘子","110/08/26","永豐金-松山",14,1,13
"5900","6180橘子","110/08/26","元大-天母",0,14,-14
"5901","6180橘子","110/08/26","日盛-花蓮",10,0,10
"5902","6180橘子","110/08/26","元大-草屯",0,13,-13
"5903","6180橘子","110/08/26","第一金-光復",14,4,10
"5904","6180橘子","110/08/26","富隆-長安",0,12,-12
"5905","6180橘子","110/08/26","台新-高雄",10,0,10
"5906","6180橘子","110/08/26","凱基-站前",0,12,-12
"5907","6180橘子","110/08/26","玉山-高雄",12,2,10
"5908","6180橘子","110/08/26","元大-北成功",0,12,-12
"5909","6180橘子","110/08/26","凱基-高雄",10,0,10
"5910","6180橘子","110/08/26","合庫-新竹",2,12,-10
"5911","2390云辰","110/08/26","統一-新台中",134,19,115
"5912","2390云辰","110/08/26","元大證券",22,150,-128
"5913","2390云辰","110/08/26","元大-松山",82,0,82
"5914","2390云辰","110/08/26","摩根大通",18,141,-123
"5915","2390云辰","110/08/26","國泰-桃園",78,7,71
"5916","2390云辰","110/08/26","凱基-湖口",6,101,-95
"5917","2390云辰","110/08/26","元大-土城學府",121,63,58
"5918","2390云辰","110/08/26","元大-前金",3,82,-79
"5919","2390云辰","110/08/26","台新-左楠",47,0,47
"5920","2390云辰","110/08/26","康和-石牌",3,53,-50
"5921","2390云辰","110/08/26","玉山-板橋",45,1,44
"5922","2390云辰","110/08/26","港商野村",348,393,-45
"5923","2390云辰","110/08/26","國票-嘉義",40,0,40
"5924","2390云辰","110/08/26","凱基-大直",0,45,-45
"5925","2390云辰","110/08/26","凱基-台北",142,106,36
"5926","2390云辰","110/08/26","新加坡商瑞銀",4,48,-44
"5927","2390云辰","110/08/26","群益金鼎-民權",33,0,33
"5928","2390云辰","110/08/26","永豐金-敦北",1,40,-39
"5929","2390云辰","110/08/26","富邦-三重",33,1,32
"5930","2390云辰","110/08/26","大慶-富順",7,40,-33
"5931","2390云辰","110/08/26","富邦-中壢",35,8,27
"5932","2390云辰","110/08/26","元大-豐原",3,36,-33
"5933","2390云辰","110/08/26","玉山-嘉義",29,3,26
"5934","2390云辰","110/08/26","日盛-和美",0,30,-30
"5935","2390云辰","110/08/26","高橋-中壢",25,0,25
"5936","2390云辰","110/08/26","宏遠證券",0,30,-30
"5937","2390云辰","110/08/26","國泰-板橋",44,19,25
"5938","2390云辰","110/08/26","元大-士林",4,34,-30
"5939","2390云辰","110/08/26","富邦-陽明",43,18,25
"5940","2390云辰","110/08/26","台灣摩根士丹利",5,34,-29
"5941","1315達新","110/08/25","凱基-中港",7,0,7
"5942","1315達新","110/08/25","群益金鼎-東湖",0,9,-9
"5943","1315達新","110/08/25","富邦-台中",7,0,7
"5944","1315達新","110/08/25","永豐金證券",0,8,-8
"5945","1315達新","110/08/25","台灣摩根士丹利",4,0,4
"5946","1315達新","110/08/25","群益金鼎-瑞豐",0,3,-3
"5947","1315達新","110/08/25","元大-歸仁",2,0,2
"5948","1315達新","110/08/25","元富-世貿",0,2,-2
"5949","1315達新","110/08/25","元大-南屯",2,0,2
"5950","1315達新","110/08/25","元富-花蓮",0,2,-2
"5951","1315達新","110/08/25","永豐金-中正",2,0,2
"5952","1315達新","110/08/25","元大-文心興安",0,2,-2
"5953","1315達新","110/08/25","統一-城中",1,0,1
"5954","1315達新","110/08/25","宏遠-館前",0,1,-1
"5955","1315達新","110/08/25","統一-三重",1,0,1
"5956","1315達新","110/08/25","統一-敦南",0,1,-1
"5957","1315達新","110/08/25","德信-中正",1,0,1
"5958","1315達新","110/08/25","元富-文心",0,1,-1
"5959","1315達新","110/08/25","玉山-新莊",1,0,1
"5960","1315達新","110/08/25","兆豐-嘉義",0,1,-1
"5961","1315達新","110/08/25","國泰-台南",1,0,1
"5962","1315達新","110/08/25","凱基-市政",0,1,-1
"5963","1315達新","110/08/25","群益金鼎-建成",1,0,1
"5964","1315達新","110/08/25","元大-開元",0,1,-1
"5965","1315達新","110/08/25","群益金鼎-鳳山",1,0,1
"5966","1315達新","110/08/25","元大-東蘆",0,1,-1
"5967","1315達新","110/08/25","凱基",1,0,1
"5968","1315達新","110/08/25","元大-桃園",0,1,-1
"5969","1315達新","110/08/25","凱基-台北",1,0,1
"5970","1315達新","110/08/25","元大-北投",0,1,-1
"5971","2609陽明","110/08/25","康和",4817,1130,3687
"5972","2609陽明","110/08/25","富邦證券",20,1499,-1479
"5973","2609陽明","110/08/25","富邦-虎尾",5954,3739,2215
"5974","2609陽明","110/08/25","華南永昌-虎尾",60,1507,-1447
"5975","2609陽明","110/08/25","台灣摩根士丹利",2126,25,2101
"5976","2609陽明","110/08/25","華南永昌-竹北",35,1362,-1327
"5977","2609陽明","110/08/25","凱基-台北",2778,942,1836
"5978","2609陽明","110/08/25","富邦-建國",327,1397,-1070
"5979","2609陽明","110/08/25","兆豐-虎尾",5704,4355,1349
"5980","2609陽明","110/08/25","群益金鼎-大安",177,815,-638
"5981","2609陽明","110/08/25","元大-開元",1090,150,940
"5982","2609陽明","110/08/25","永豐金-松山",135,646,-511
"5983","2609陽明","110/08/25","新加坡商瑞銀",1582,730,852
"5984","2609陽明","110/08/25","華南永昌-長虹",344,810,-466
"5985","2609陽明","110/08/25","統一-仁愛",961,139,822
"5986","2609陽明","110/08/25","新光",1804,2222,-418
"5987","2609陽明","110/08/25","瑞士信貸",1307,553,754
"5988","2609陽明","110/08/25","合庫-桃園",48,447,-399
"5989","2609陽明","110/08/25","美林",4574,3894,680
"5990","2609陽明","110/08/25","元大-雙和",203,536,-333
"5991","2609陽明","110/08/25","國票-彰化",685,112,573
"5992","2609陽明","110/08/25","永豐金證券",145,468,-323
"5993","2609陽明","110/08/25","摩根大通",4654,4103,551
"5994","2609陽明","110/08/25","兆豐-板橋",88,398,-310
"5995","2609陽明","110/08/25","日盛-板橋",648,186,462
"5996","2609陽明","110/08/25","群益金鼎-敦南",98,346,-248
"5997","2609陽明","110/08/25","兆豐-彰化",904,448,456
"5998","2609陽明","110/08/25","國泰-敦南",1686,1916,-230
"5999","2609陽明","110/08/25","兆豐-中壢",425,15,410
"6000","2609陽明","110/08/25","元大-佳里",54,271,-217
"6001","2636台驊投控","110/08/25","凱基-台北",791,245,546
"6002","2636台驊投控","110/08/25","日進",10,242,-232
"6003","2636台驊投控","110/08/25","美商高盛",508,168,340
"6004","2636台驊投控","110/08/25","兆豐-中壢",0,209,-209
"6005","2636台驊投控","110/08/25","國票-彰化",292,29,263
"6006","2636台驊投控","110/08/25","元大-松江",3,68,-65
"6007","2636台驊投控","110/08/25","美林",331,117,214
"6008","2636台驊投控","110/08/25","國泰-敦南",61,106,-45
"6009","2636台驊投控","110/08/25","摩根大通",424,213,211
"6010","2636台驊投控","110/08/25","富邦-嘉義",10,55,-45
"6011","2636台驊投控","110/08/25","港商野村",852,674,178
"6012","2636台驊投控","110/08/25","群益金鼎-大安",2,43,-41
"6013","2636台驊投控","110/08/25","台灣摩根士丹利",205,89,116
"6014","2636台驊投控","110/08/25","元大-林森",45,84,-39
"6015","2636台驊投控","110/08/25","瑞士信貸",148,86,62
"6016","2636台驊投控","110/08/25","華南永昌-合泰",0,36,-36
"6017","2636台驊投控","110/08/25","元大-士林",43,0,43
"6018","2636台驊投控","110/08/25","富邦-建國",17,52,-35
"6019","2636台驊投控","110/08/25","宏遠-台南",37,3,34
"6020","2636台驊投控","110/08/25","兆豐-城中",1,31,-30
"6021","2636台驊投控","110/08/25","永豐金-萬盛",38,4,34
"6022","2636台驊投控","110/08/25","新光-台中",33,62,-29
"6023","2636台驊投控","110/08/25","凱基-鳳山",32,2,30
"6024","2636台驊投控","110/08/25","台新-台中",13,40,-27
"6025","2636台驊投控","110/08/25","元大-桃園",29,1,28
"6026","2636台驊投控","110/08/25","玉山證券",20,47,-27
"6027","2636台驊投控","110/08/25","新加坡商瑞銀",58,33,25
"6028","2636台驊投控","110/08/25","永豐金-天母",3,30,-27
"6029","2636台驊投控","110/08/25","兆豐-三民",21,0,21
"6030","2636台驊投控","110/08/25","元大-成功",2,24,-22
"6031","2867三商壽","110/08/25","華南永昌-大安",201,0,201
"6032","2867三商壽","110/08/25","元大-北投",0,384,-384
"6033","2867三商壽","110/08/25","元大-竹科",140,0,140
"6034","2867三商壽","110/08/25","摩根大通",78,315,-237
"6035","2867三商壽","110/08/25","美林",174,50,124
"6036","2867三商壽","110/08/25","國泰證券",0,150,-150
"6037","2867三商壽","110/08/25","凱基-台北",125,26,99
"6038","2867三商壽","110/08/25","土銀-台中",0,120,-120
"6039","2867三商壽","110/08/25","瑞士信貸",98,0,98
"6040","2867三商壽","110/08/25","台灣摩根士丹利",0,120,-120
"6041","2867三商壽","110/08/25","兆豐-新營",70,0,70
"6042","2867三商壽","110/08/25","日盛-員林",0,99,-99
"6043","2867三商壽","110/08/25","兆豐-永和",64,0,64
"6044","2867三商壽","110/08/25","兆豐-斗南",0,40,-40
"6045","2867三商壽","110/08/25","群益金鼎-大甲",47,4,43
"6046","2867三商壽","110/08/25","中國信託-永康",0,35,-35
"6047","2867三商壽","110/08/25","群益金鼎-東門",40,0,40
"6048","2867三商壽","110/08/25","群益金鼎-屏東",0,32,-32
"6049","2867三商壽","110/08/25","元大-沙鹿",40,0,40
"6050","2867三商壽","110/08/25","群益金鼎-彰化",2,32,-30
"6051","2867三商壽","110/08/25","國泰-板橋",40,1,39
"6052","2867三商壽","110/08/25","元大-基隆孝二",0,30,-30
"6053","2867三商壽","110/08/25","元大-桃園",36,0,36
"6054","2867三商壽","110/08/25","元大-四維",0,25,-25
"6055","2867三商壽","110/08/25","合庫-基隆",30,0,30
"6056","2867三商壽","110/08/25","國票-北高雄",0,20,-20
"6057","2867三商壽","110/08/25","凱基",26,0,26
"6058","2867三商壽","110/08/25","華南永昌-南京",0,20,-20
"6059","2867三商壽","110/08/25","兆豐-台南",25,0,25
"6060","2867三商壽","110/08/25","宏遠-台中",0,16,-16
"6061","5521工信","110/08/25","凱基-台北",112,46,66
"6062","5521工信","110/08/25","兆豐-桃園",0,207,-207
"6063","5521工信","110/08/25","元大證券",66,0,66
"6064","5521工信","110/08/25","台灣摩根士丹利",1,206,-205
"6065","5521工信","110/08/25","元大-大統",42,0,42
"6066","5521工信","110/08/25","華南永昌-朴子",10,53,-43
"6067","5521工信","110/08/25","元大-南屯",40,0,40
"6068","5521工信","110/08/25","美林",0,35,-35
"6069","5521工信","110/08/25","華南永昌",38,0,38
"6070","5521工信","110/08/25","國泰-板橋",0,34,-34
"6071","5521工信","110/08/25","合庫-台南",30,0,30
"6072","5521工信","110/08/25","豐農",0,30,-30
"6073","5521工信","110/08/25","高橋-內壢",30,0,30
"6074","5521工信","110/08/25","富邦-新竹",0,21,-21
"6075","5521工信","110/08/25","摩根大通",121,91,30
"6076","5521工信","110/08/25","群益金鼎-萬華",0,20,-20
"6077","5521工信","110/08/25","台新-左楠",28,0,28
"6078","5521工信","110/08/25","元大-基隆孝二",0,20,-20
"6079","5521工信","110/08/25","日盛-斗六",26,0,26
"6080","5521工信","110/08/25","凱基-斗六",2,20,-18
"6081","5521工信","110/08/25","元大-東蘆",21,0,21
"6082","5521工信","110/08/25","富邦-陽明",0,16,-16
"6083","5521工信","110/08/25","第一金-新竹",21,3,18
"6084","5521工信","110/08/25","港商野村",0,13,-13
"6085","5521工信","110/08/25","玉山-新莊",16,0,16
"6086","5521工信","110/08/25","群益金鼎-館前",0,11,-11
"6087","5521工信","110/08/25","元大-北投",15,0,15
"6088","5521工信","110/08/25","土銀-高雄",0,10,-10
"6089","5521工信","110/08/25","凱基-台東",15,1,14
"6090","5521工信","110/08/25","統一",0,10,-10
"6091","1471首利","110/08/25","元大-敦化",86,0,86
"6092","1471首利","110/08/25","元大-清水",0,111,-111
"6093","1471首利","110/08/25","凱基-台北",46,0,46
"6094","1471首利","110/08/25","群益金鼎-東大",0,78,-78
"6095","1471首利","110/08/25","美林",34,0,34
"6096","1471首利","110/08/25","新光",0,39,-39
"6097","1471首利","110/08/25","摩根大通",53,26,27
"6098","1471首利","110/08/25","國票-北高雄",0,25,-25
"6099","1471首利","110/08/25","凱基-五股",25,0,25
"6100","1471首利","110/08/25","富邦-高雄",0,15,-15
"6101","1471首利","110/08/25","日盛-樹林",20,0,20
"6102","1471首利","110/08/25","兆豐-員林",0,14,-14
"6103","1471首利","110/08/25","瑞士信貸",20,0,20
"6104","1471首利","110/08/25","元大-土城永寧",0,13,-13
"6105","1471首利","110/08/25","元大-莒光",21,5,16
"6106","1471首利","110/08/25","盈溢-楠梓",0,11,-11
"6107","1471首利","110/08/25","統一-新台中",15,0,15
"6108","1471首利","110/08/25","元大-大里",0,11,-11
"6109","1471首利","110/08/25","永豐金-敦南",15,0,15
"6110","1471首利","110/08/25","日盛-高雄",5,15,-10
"6111","1471首利","110/08/25","光和-溪湖",13,0,13
"6112","1471首利","110/08/25","凱基-竹科",0,10,-10
"6113","1471首利","110/08/25","日盛-屏東",10,0,10
"6114","1471首利","110/08/25","元大-斗信",0,10,-10
"6115","1471首利","110/08/25","兆豐-高雄",10,0,10
"6116","1471首利","110/08/25","第一金-台南",1,10,-9
"6117","1471首利","110/08/25","中農",10,0,10
"6118","1471首利","110/08/25","台灣企銀-太平",0,8,-8
"6119","1471首利","110/08/25","華南永昌-合泰",10,0,10
"6120","1471首利","110/08/25","新光-台中",5,12,-7
"6121","2883開發金","110/08/25","凱基",4004,0,4004
"6122","2883開發金","110/08/25","摩根大通",106,4873,-4767
"6123","2883開發金","110/08/25","群益金鼎",2728,3,2725
"6124","2883開發金","110/08/25","瑞士信貸",1180,3777,-2597
"6125","2883開發金","110/08/25","美林",2122,57,2065
"6126","2883開發金","110/08/25","元大-開元",29,2542,-2513
"6127","2883開發金","110/08/25","凱基-台北",2581,555,2026
"6128","2883開發金","110/08/25","聯邦商銀",1,1900,-1899
"6129","2883開發金","110/08/25","富邦-建國",2069,82,1987
"6130","2883開發金","110/08/25","台灣摩根士丹利",3322,4605,-1283
"6131","2883開發金","110/08/25","中國信託",3132,1528,1604
"6132","2883開發金","110/08/25","元大-忠孝",10,1219,-1209
"6133","2883開發金","110/08/25","兆豐-北高雄",1657,83,1574
"6134","2883開發金","110/08/25","香港上海匯豐",0,1001,-1001
"6135","2883開發金","110/08/25","統一",1311,107,1204
"6136","2883開發金","110/08/25","新光",1050,1828,-778
"6137","2883開發金","110/08/25","永豐金-南京",1030,3,1027
"6138","2883開發金","110/08/25","港商野村",1304,2000,-696
"6139","2883開發金","110/08/25","美商高盛",1733,815,918
"6140","2883開發金","110/08/25","元富",314,1002,-688
"6141","2883開發金","110/08/25","台灣匯立證券",638,0,638
"6142","2883開發金","110/08/25","國泰-敦南",289,975,-686
"6143","2883開發金","110/08/25","合庫-台中",608,38,570
"6144","2883開發金","110/08/25","新光-台南",23,521,-498
"6145","2883開發金","110/08/25","臺銀",1016,450,566
"6146","2883開發金","110/08/25","合庫證券",19,461,-442
"6147","2883開發金","110/08/25","元大-豐原",556,25,531
"6148","2883開發金","110/08/25","(牛牛牛)亞-鑫豐",134,538,-404
"6149","2883開發金","110/08/25","台中銀-員林",501,13,488
"6150","2883開發金","110/08/25","元大-士林",8,385,-377
"6151","6205詮欣","110/08/25","日盛-新莊",12,2,10
"6152","6205詮欣","110/08/25","日盛-樹林",0,12,-12
"6153","6205詮欣","110/08/25","康和-台北",10,0,10
"6154","6205詮欣","110/08/25","臺銀-民權",0,10,-10
"6155","6205詮欣","110/08/25","臺銀-臺中",9,0,9
"6156","6205詮欣","110/08/25","元大-博愛",20,30,-10
"6157","6205詮欣","110/08/25","瑞士信貸",10,2,8
"6158","6205詮欣","110/08/25","元大-羅東",0,8,-8
"6159","6205詮欣","110/08/25","摩根大通",17,10,7
"6160","6205詮欣","110/08/25","元富-三重",0,6,-6
"6161","6205詮欣","110/08/25","凱基-台南",6,0,6
"6162","6205詮欣","110/08/25","群益金鼎-永和",0,5,-5
"6163","6205詮欣","110/08/25","玉山證券",5,0,5
"6164","6205詮欣","110/08/25","元大-館前",0,5,-5
"6165","6205詮欣","110/08/25","元大-東泰",5,0,5
"6166","6205詮欣","110/08/25","凱基-汐止",0,4,-4
"6167","6205詮欣","110/08/25","元富-潮州",4,0,4
"6168","6205詮欣","110/08/25","元大-大益",0,4,-4
"6169","6205詮欣","110/08/25","大慶-泰山",3,0,3
"6170","6205詮欣","110/08/25","永豐金證券",0,4,-4
"6171","6205詮欣","110/08/25","亞東-台南",2,0,2
"6172","6205詮欣","110/08/25","永豐金-台南",0,4,-4
"6173","6205詮欣","110/08/25","兆豐-台南",2,0,2
"6174","6205詮欣","110/08/25","台灣企銀-九如",0,3,-3
"6175","6205詮欣","110/08/25","兆豐-公益",2,0,2
"6176","6205詮欣","110/08/25","兆豐-景美",0,3,-3
"6177","6205詮欣","110/08/25","凱基-松山",2,0,2
"6178","6205詮欣","110/08/25","北城證券",0,3,-3
"6179","6205詮欣","110/08/25","凱基-台北",2,0,2
"6180","6205詮欣","110/08/25","元大-忠孝",0,3,-3
"6181","1540喬福","110/08/25","元大-士林",8,0,8
"6182","1540喬福","110/08/25","摩根大通",0,13,-13
"6183","1540喬福","110/08/25","元富-文心",5,0,5
"6184","1540喬福","110/08/25","永豐金-永康",0,6,-6
"6185","1540喬福","110/08/25","凱基-台北",4,0,4
"6186","1540喬福","110/08/25","群益金鼎-丹鳳",0,5,-5
"6187","1540喬福","110/08/25","元大-土城永寧",2,0,2
"6188","1540喬福","110/08/25","合庫-鳳山",0,1,-1
"6189","1540喬福","110/08/25","元大-頭份",2,0,2
"6190","1540喬福","110/08/25","美商高盛",0,1,-1
"6191","1540喬福","110/08/25","兆豐-北高雄",2,0,2
"6192","1540喬福","110/08/25","中國信託-忠孝",0,1,-1
"6193","1540喬福","110/08/25","凱基-中壢",2,0,2
"6194","1540喬福","110/08/25","致和-南京",0,1,-1
"6195","1540喬福","110/08/25","美林",1,0,1
"6196","1540喬福","110/08/25","富邦-仁愛",0,1,-1
"6197","1540喬福","110/08/25","永豐金-中正",1,0,1
"6198","1540喬福","110/08/25","元大-大里德芳",0,1,-1
"6199","1540喬福","110/08/25","元大-文心興安",1,0,1
"6200","1540喬福","110/08/25","元大-左營",0,1,-1
"6201","1540喬福","110/08/25","華南永昌-公誠",1,0,1
"6202","1540喬福","110/08/25","元大-汐止",0,1,-1
"6203","1540喬福","110/08/25","大昌-新店",1,0,1
"6204","1540喬福","110/08/25","日盛-內湖",0,0,0
"6205","1540喬福","110/08/25","元富-大昌",1,0,1
"6206","1540喬福","110/08/25","(牛牛牛)亞-網路",0,0,0
"6207","1540喬福","110/08/25","元富",1,0,1
"6208","1540喬福","110/08/25","康和-板橋",0,0,0
"6209","1540喬福","110/08/25","凱基-竹北",0,0,0
"6210","1540喬福","110/08/25","凱基-竹北",0,0,0
"6211","2888新光金","110/08/25","統一",11078,277,10801
"6212","2888新光金","110/08/25","元富-城東",162,17808,-17646
"6213","2888新光金","110/08/25","元大-忠孝鼎富",10200,0,10200
"6214","2888新光金","110/08/25","康和-台中",45,10015,-9970
"6215","2888新光金","110/08/25","華南永昌-岡山",9944,105,9839
"6216","2888新光金","110/08/25","第一金-華江",266,9839,-9573
"6217","2888新光金","110/08/25","日盛證券",8935,66,8869
"6218","2888新光金","110/08/25","元富-新店",37,2975,-2938
"6219","2888新光金","110/08/25","瑞士信貸",8347,1175,7172
"6220","2888新光金","110/08/25","元富-世貿",332,3270,-2938
"6221","2888新光金","110/08/25","富邦-岡山",5039,52,4987
"6222","2888新光金","110/08/25","元富-新興",31,2160,-2129
"6223","2888新光金","110/08/25","國票-九鼎",4662,102,4560
"6224","2888新光金","110/08/25","元富-敦南",19,2135,-2116
"6225","2888新光金","110/08/25","國票-長城",4288,5,4283
"6226","2888新光金","110/08/25","元富",7,2039,-2032
"6227","2888新光金","110/08/25","國票-北高雄",2515,38,2477
"6228","2888新光金","110/08/25","元富-成功",184,2095,-1911
"6229","2888新光金","110/08/25","新光",2800,661,2139
"6230","2888新光金","110/08/25","元富-板橋",65,1967,-1902
"6231","2888新光金","110/08/25","統一-板橋",1762,10,1752
"6232","2888新光金","110/08/25","彰銀",0,1865,-1865
"6233","2888新光金","110/08/25","玉山-板橋",1714,21,1693
"6234","2888新光金","110/08/25","元富-文心",159,1916,-1757
"6235","2888新光金","110/08/25","美商高盛",2345,739,1606
"6236","2888新光金","110/08/25","元富-吉利",45,1701,-1656
"6237","2888新光金","110/08/25","國票-博愛",1264,4,1260
"6238","2888新光金","110/08/25","元富-花蓮",13,1602,-1589
"6239","2888新光金","110/08/25","富邦-中壢",1278,95,1183
"6240","2888新光金","110/08/25","凱基-台北",1875,3353,-1478
"6241","1340勝悅","110/08/25","凱基-台北",13,0,13
"6242","1340勝悅","110/08/25","日盛-永康",0,10,-10
"6243","1340勝悅","110/08/25","華南永昌-公誠",10,0,10
"6244","1340勝悅","110/08/25","元大-忠孝鼎富",0,10,-10
"6245","1340勝悅","110/08/25","臺灣企銀-埔墘",5,0,5
"6246","1340勝悅","110/08/25","華南永昌-東昇",0,9,-9
"6247","1340勝悅","110/08/25","美商高盛",3,0,3
"6248","1340勝悅","110/08/25","摩根大通",1,9,-8
"6249","1340勝悅","110/08/25","元大-仁愛",3,0,3
"6250","1340勝悅","110/08/25","華南永昌-林口",0,6,-6
"6251","1340勝悅","110/08/25","永豐金-永康",3,0,3
"6252","1340勝悅","110/08/25","兆豐-新營",0,5,-5
"6253","1340勝悅","110/08/25","國泰-敦南",3,1,2
"6254","1340勝悅","110/08/25","富邦-羅東",0,3,-3
"6255","1340勝悅","110/08/25","富邦-北港",2,0,2
"6256","1340勝悅","110/08/25","元大-竹山",0,3,-3
"6257","1340勝悅","110/08/25","元大-南勢角",2,0,2
"6258","1340勝悅","110/08/25","元大-復北",0,3,-3
"6259","1340勝悅","110/08/25","合庫-台中",1,0,1
"6260","1340勝悅","110/08/25","元大-嘉義",0,3,-3
"6261","1340勝悅","110/08/25","日盛-新莊",1,0,1
"6262","1340勝悅","110/08/25","元大-草屯",0,2,-2
"6263","1340勝悅","110/08/25","日盛-頭份",1,0,1
"6264","1340勝悅","110/08/25","國票-和平",0,1,-1
"6265","1340勝悅","110/08/25","國泰-台中",6,5,1
"6266","1340勝悅","110/08/25","新光",0,1,-1
"6267","1340勝悅","110/08/25","國泰-台南",1,0,1
"6268","1340勝悅","110/08/25","群益金鼎-高盛",0,1,-1
"6269","1340勝悅","110/08/25","元大-竹東",1,0,1
"6270","1340勝悅","110/08/25","元大-新竹經國",0,1,-1
"6271","6246臺龍","110/08/25","統一-台南",15,0,15
"6272","6246臺龍","110/08/25","日盛-斗六",0,9,-9
"6273","6246臺龍","110/08/25","新光-台中",7,0,7
"6274","6246臺龍","110/08/25","新光-高雄",0,5,-5
"6275","6246臺龍","110/08/25","永豐金-嘉義",4,0,4
"6276","6246臺龍","110/08/25","光和-高雄",0,3,-3
"6277","6246臺龍","110/08/25","台新證券",4,1,3
"6278","6246臺龍","110/08/25","永全",0,3,-3
"6279","6246臺龍","110/08/25","凱基-竹科",3,0,3
"6280","6246臺龍","110/08/25","國泰-敦南",0,3,-3
"6281","6246臺龍","110/08/25","統一-中壢",2,0,2
"6282","6246臺龍","110/08/25","元大-員林",4,7,-3
"6283","6246臺龍","110/08/25","兆豐-竹北",2,0,2
"6284","6246臺龍","110/08/25","元大-小港",0,3,-3
"6285","6246臺龍","110/08/25","兆豐-景美",2,0,2
"6286","6246臺龍","110/08/25","土銀-花蓮",0,2,-2
"6287","6246臺龍","110/08/25","元大-內湖",4,2,2
"6288","6246臺龍","110/08/25","日盛-文化",0,2,-2
"6289","6246臺龍","110/08/25","元大-北屯",2,0,2
"6290","6246臺龍","110/08/25","統一-新竹",0,2,-2
"6291","6246臺龍","110/08/25","日盛-中壢",1,0,1
"6292","6246臺龍","110/08/25","台新-台南",0,2,-2
"6293","6246臺龍","110/08/25","日盛-八德",1,0,1
"6294","6246臺龍","110/08/25","國泰-板橋",0,2,-2
"6295","6246臺龍","110/08/25","日盛-新竹",1,0,1
"6296","6246臺龍","110/08/25","富邦-竹東",0,2,-2
"6297","6246臺龍","110/08/25","日盛-宜蘭",1,0,1
"6298","6246臺龍","110/08/25","合庫-西台中",0,1,-1
"6299","6246臺龍","110/08/25","日盛-頭份",1,0,1
"6300","6246臺龍","110/08/25","日盛-新莊",0,1,-1
"6301","00715L期街口布蘭特正2","110/08/25","元大證券",19583,546,19037
"6302","00715L期街口布蘭特正2","110/08/25","第一金-豐原",0,1000,-1000
"6303","00715L期街口布蘭特正2","110/08/25","合庫證券",4367,15,4352
"6304","00715L期街口布蘭特正2","110/08/25","新光",311,1182,-871
"6305","00715L期街口布蘭特正2","110/08/25","永豐金證券",3240,15,3225
"6306","00715L期街口布蘭特正2","110/08/25","兆豐-台中",0,798,-798
"6307","00715L期街口布蘭特正2","110/08/25","元富",3115,0,3115
"6308","00715L期街口布蘭特正2","110/08/25","玉山-新莊",2,634,-632
"6309","00715L期街口布蘭特正2","110/08/25","統一",2701,40,2661
"6310","00715L期街口布蘭特正2","110/08/25","元富-中壢",22,630,-608
"6311","00715L期街口布蘭特正2","110/08/25","第一金-台中",800,2,798
"6312","00715L期街口布蘭特正2","110/08/25","玉山-板橋",1,563,-562
"6313","00715L期街口布蘭特正2","110/08/25","聯邦-三重",750,10,740
"6314","00715L期街口布蘭特正2","110/08/25","華南永昌-台中",105,642,-537
"6315","00715L期街口布蘭特正2","110/08/25","富邦證券",945,420,525
"6316","00715L期街口布蘭特正2","110/08/25","(牛牛牛)亞-鑫豐",31,557,-526
"6317","00715L期街口布蘭特正2","110/08/25","元大-三重",500,3,497
"6318","00715L期街口布蘭特正2","110/08/25","玉山-新竹",0,508,-508
"6319","00715L期街口布蘭特正2","110/08/25","台新證券",955,537,418
"6320","00715L期街口布蘭特正2","110/08/25","新光-台中",52,556,-504
"6321","00715L期街口布蘭特正2","110/08/25","國票-博愛",260,0,260
"6322","00715L期街口布蘭特正2","110/08/25","富邦-陽明",2,475,-473
"6323","00715L期街口布蘭特正2","110/08/25","元大-蘆洲",262,15,247
"6324","00715L期街口布蘭特正2","110/08/25","中國信託-新竹",0,455,-455
"6325","00715L期街口布蘭特正2","110/08/25","台新-台中",390,161,229
"6326","00715L期街口布蘭特正2","110/08/25","群益金鼎-宜蘭",1,448,-447
"6327","00715L期街口布蘭特正2","110/08/25","康和-嘉義",250,36,214
"6328","00715L期街口布蘭特正2","110/08/25","臺銀-新竹",34,435,-401
"6329","00715L期街口布蘭特正2","110/08/25","凱基-站前",245,36,209
"6330","00715L期街口布蘭特正2","110/08/25","第一金-台南",1,400,-399
"6331","8941關中","110/08/25","國泰-新莊",2,0,2
"6332","8941關中","110/08/25","富邦-左營",0,1,-1
"6333","8941關中","110/08/25","(牛牛牛)亞-鑫豐",0,0,0
"6334","8941關中","110/08/25","富邦-員林",0,1,-1
"6335","8941關中","110/08/25","康和-板橋",0,0,0
"6336","8941關中","110/08/25","(牛牛牛)亞-鑫豐",0,0,0
"6337","8941關中","110/08/25","凱基-板橋",0,0,0
"6338","8941關中","110/08/25","康和-板橋",0,0,0
"6339","8941關中","110/08/25","富邦-竹北",0,0,0
"6340","8941關中","110/08/25","凱基-板橋",0,0,0
"6341","8941關中","110/08/25","元大-花蓮",0,0,0
"6342","8941關中","110/08/25","富邦-竹北",0,0,0
"6343","8941關中","110/08/25","元大-土城",0,0,0
"6344","8941關中","110/08/25","元大-花蓮",0,0,0
"6345","8941關中","110/08/25","永豐金-萬盛",0,0,0
"6346","8941關中","110/08/25","元大-土城",0,0,0
"6347","8941關中","110/08/25","永豐金-南投",0,0,0
"6348","8941關中","110/08/25","永豐金-萬盛",0,0,0
"6349","8941關中","110/08/25","",NA,NA,NA
"6350","8941關中","110/08/25","永豐金-南投",0,0,0
"6351","8941關中","110/08/25","",NA,NA,NA
"6352","8941關中","110/08/25","",NA,NA,NA
"6353","8941關中","110/08/25","",NA,NA,NA
"6354","8941關中","110/08/25","",NA,NA,NA
"6355","8941關中","110/08/25","",NA,NA,NA
"6356","8941關中","110/08/25","",NA,NA,NA
"6357","8941關中","110/08/25","",NA,NA,NA
"6358","8941關中","110/08/25","",NA,NA,NA
"6359","8941關中","110/08/25","",NA,NA,NA
"6360","8941關中","110/08/25","",NA,NA,NA
"6361","8936國統","110/08/25","台灣摩根士丹利",132,11,121
"6362","8936國統","110/08/25","第一金-高雄",1,100,-99
"6363","8936國統","110/08/25","元富-新興",96,0,96
"6364","8936國統","110/08/25","美商高盛",1,63,-62
"6365","8936國統","110/08/25","瑞士信貸",74,0,74
"6366","8936國統","110/08/25","元大-蘆洲",0,50,-50
"6367","8936國統","110/08/25","摩根大通",113,52,61
"6368","8936國統","110/08/25","凱基-市政",0,35,-35
"6369","8936國統","110/08/25","永豐金-松山",50,0,50
"6370","8936國統","110/08/25","元大-北港",0,31,-31
"6371","8936國統","110/08/25","凱基-台北",84,52,32
"6372","8936國統","110/08/25","港商野村",4,26,-22
"6373","8936國統","110/08/25","新光",66,36,30
"6374","8936國統","110/08/25","日盛-豐原",0,20,-20
"6375","8936國統","110/08/25","新光-台中",50,24,26
"6376","8936國統","110/08/25","元大-鳳山",0,19,-19
"6377","8936國統","110/08/25","凱基-信義",20,0,20
"6378","8936國統","110/08/25","新加坡商瑞銀",27,45,-18
"6379","8936國統","110/08/25","永豐金-苓雅",20,0,20
"6380","8936國統","110/08/25","群益金鼎-嘉義",0,16,-16
"6381","8936國統","110/08/25","元大-天母",49,30,19
"6382","8936國統","110/08/25","凱基-林口",0,15,-15
"6383","8936國統","110/08/25","華南永昌",21,3,18
"6384","8936國統","110/08/25","台新-高雄",2,16,-14
"6385","8936國統","110/08/25","日盛-板橋",23,7,16
"6386","8936國統","110/08/25","國票-內壢",0,13,-13
"6387","8936國統","110/08/25","元富-敦南",15,0,15
"6388","8936國統","110/08/25","元富-三重",0,12,-12
"6389","8936國統","110/08/25","群益金鼎-古亭",15,0,15
"6390","8936國統","110/08/25","元富-緯城",5,17,-12
"6391","6226光鼎","110/08/25","摩根大通",1583,220,1363
"6392","6226光鼎","110/08/25","瑞士信貸",30,229,-199
"6393","6226光鼎","110/08/25","統一",1723,948,775
"6394","6226光鼎","110/08/25","國泰-敦南",442,580,-138
"6395","6226光鼎","110/08/25","元大-大同",1456,903,553
"6396","6226光鼎","110/08/25","台新-中壢",5,141,-136
"6397","6226光鼎","110/08/25","港商野村",688,373,315
"6398","6226光鼎","110/08/25","宏遠-光隆",22,137,-115
"6399","6226光鼎","110/08/25","凱基-永和",505,200,305
"6400","6226光鼎","110/08/25","元大-虎尾",5,96,-91
"6401","6226光鼎","110/08/25","統一-南京",303,106,197
"6402","6226光鼎","110/08/25","新加坡商瑞銀",49,134,-85
"6403","6226光鼎","110/08/25","美商高盛",243,76,167
"6404","6226光鼎","110/08/25","元大-板橋",2,83,-81
"6405","6226光鼎","110/08/25","台灣摩根士丹利",142,0,142
"6406","6226光鼎","110/08/25","玉山-桃園",46,126,-80
"6407","6226光鼎","110/08/25","兆豐-松德",145,46,99
"6408","6226光鼎","110/08/25","富邦-台北",27,101,-74
"6409","6226光鼎","110/08/25","玉山-城中",115,19,96
"6410","6226光鼎","110/08/25","兆豐-埔墘",0,67,-67
"6411","6226光鼎","110/08/25","富邦證券",148,53,95
"6412","6226光鼎","110/08/25","凱基-台北",51,113,-62
"6413","6226光鼎","110/08/25","富邦-建國",206,126,80
"6414","6226光鼎","110/08/25","台新-高雄",45,101,-56
"6415","6226光鼎","110/08/25","凱基-大直",81,2,79
"6416","6226光鼎","110/08/25","華南永昌-麻豆",5,61,-56
"6417","6226光鼎","110/08/25","元大-四維",149,71,78
"6418","6226光鼎","110/08/25","凱基-內埔",0,52,-52
"6419","6226光鼎","110/08/25","大展-台南",75,0,75
"6420","6226光鼎","110/08/25","日盛-復興",58,109,-51
"6421","2363矽統","110/08/25","合庫-基隆",894,406,488
"6422","2363矽統","110/08/25","元大-萬華",51,751,-700
"6423","2363矽統","110/08/25","瑞士信貸",448,0,448
"6424","2363矽統","110/08/25","美商高盛",260,879,-619
"6425","2363矽統","110/08/25","華南永昌-林口",256,17,239
"6426","2363矽統","110/08/25","凱基-台北",1409,1709,-300
"6427","2363矽統","110/08/25","元大-東泰",360,132,228
"6428","2363矽統","110/08/25","美林",337,633,-296
"6429","2363矽統","110/08/25","元大-員林中山",246,46,200
"6430","2363矽統","110/08/25","摩根大通",712,999,-287
"6431","2363矽統","110/08/25","富邦-新店",246,104,142
"6432","2363矽統","110/08/25","新加坡商瑞銀",671,900,-229
"6433","2363矽統","110/08/25","統一-城中",173,37,136
"6434","2363矽統","110/08/25","大昌-桃園",138,342,-204
"6435","2363矽統","110/08/25","富邦-板橋",196,72,124
"6436","2363矽統","110/08/25","中國信託-忠孝",134,313,-179
"6437","2363矽統","110/08/25","土銀-士林",100,0,100
"6438","2363矽統","110/08/25","元大-淡水",23,201,-178
"6439","2363矽統","110/08/25","新光",427,328,99
"6440","2363矽統","110/08/25","富邦-苗栗",215,356,-141
"6441","2363矽統","110/08/25","元大-員林",121,22,99
"6442","2363矽統","110/08/25","北城證券",23,144,-121
"6443","2363矽統","110/08/25","凱基-台中",107,11,96
"6444","2363矽統","110/08/25","新光-台中",92,210,-118
"6445","2363矽統","110/08/25","富邦-北港",212,117,95
"6446","2363矽統","110/08/25","永豐金-天母",17,132,-115
"6447","2363矽統","110/08/25","統一-高雄",110,18,92
"6448","2363矽統","110/08/25","日盛-台南",256,356,-100
"6449","2363矽統","110/08/25","凱基-苗栗",91,1,90
"6450","2363矽統","110/08/25","元大-大同",22,118,-96
"6451","8112至上","110/08/25","台灣匯立證券",237,0,237
"6452","8112至上","110/08/25","群益金鼎-基隆",1,95,-94
"6453","8112至上","110/08/25","摩根大通",283,173,110
"6454","8112至上","110/08/25","元大-路竹",2,74,-72
"6455","8112至上","110/08/25","第一金-桃園",96,0,96
"6456","8112至上","110/08/25","台灣摩根士丹利",1,61,-60
"6457","8112至上","110/08/25","凱基-台北",126,33,93
"6458","8112至上","110/08/25","永豐金-台中",2,55,-53
"6459","8112至上","110/08/25","國票-南京",80,0,80
"6460","8112至上","110/08/25","(牛牛牛)亞-鑫豐",5,49,-44
"6461","8112至上","110/08/25","瑞士信貸",78,1,77
"6462","8112至上","110/08/25","群益金鼎-高盛",0,43,-43
"6463","8112至上","110/08/25","富邦-仁愛",110,35,75
"6464","8112至上","110/08/25","永豐金-永康",3,46,-43
"6465","8112至上","110/08/25","群益金鼎-敦南",72,0,72
"6466","8112至上","110/08/25","日盛-花蓮",0,40,-40
"6467","8112至上","110/08/25","新加坡商瑞銀",63,9,54
"6468","8112至上","110/08/25","凱基-東勢",0,35,-35
"6469","8112至上","110/08/25","華南永昌-南京",50,0,50
"6470","8112至上","110/08/25","元大-仁愛",0,34,-34
"6471","8112至上","110/08/25","港商野村",45,2,43
"6472","8112至上","110/08/25","台新-台中",0,31,-31
"6473","8112至上","110/08/25","元大-新竹經國",34,3,31
"6474","8112至上","110/08/25","元大-佳里",0,31,-31
"6475","8112至上","110/08/25","康和-仁愛",30,0,30
"6476","8112至上","110/08/25","兆豐-西螺",10,40,-30
"6477","8112至上","110/08/25","凱基-士林",30,0,30
"6478","8112至上","110/08/25","元大-楊梅",0,30,-30
"6479","8112至上","110/08/25","元大-永和",25,0,25
"6480","8112至上","110/08/25","永豐金證券",0,28,-28
"6481","1570力肯","110/08/25","永豐金-虎尾",52,0,52
"6482","1570力肯","110/08/25","元大-竹山",0,14,-14
"6483","1570力肯","110/08/25","國票-南科",26,0,26
"6484","1570力肯","110/08/25","日盛-忠孝",0,12,-12
"6485","1570力肯","110/08/25","凱基-台北",22,3,19
"6486","1570力肯","110/08/25","凱基-高美館",0,10,-10
"6487","1570力肯","110/08/25","日茂-南投",17,0,17
"6488","1570力肯","110/08/25","元富-緯城",3,12,-9
"6489","1570力肯","110/08/25","兆豐-台中港",12,0,12
"6490","1570力肯","110/08/25","(牛牛牛)亞-鑫豐",2,11,-9
"6491","1570力肯","110/08/25","合庫-嘉義",10,0,10
"6492","1570力肯","110/08/25","元大-鳳山",0,8,-8
"6493","1570力肯","110/08/25","凱基-復興",10,0,10
"6494","1570力肯","110/08/25","台灣摩根士丹利",0,7,-7
"6495","1570力肯","110/08/25","國票-博愛",16,7,9
"6496","1570力肯","110/08/25","兆豐-中壢",0,6,-6
"6497","1570力肯","110/08/25","香港上海匯豐",9,0,9
"6498","1570力肯","110/08/25","國票",0,6,-6
"6499","1570力肯","110/08/25","瑞士信貸",8,0,8
"6500","1570力肯","110/08/25","國票-天祥",0,6,-6
"6501","1570力肯","110/08/25","富邦-高雄",8,0,8
"6502","1570力肯","110/08/25","群益金鼎-桃園",0,6,-6
"6503","1570力肯","110/08/25","摩根大通",12,9,3
"6504","1570力肯","110/08/25","華南永昌-大安",0,6,-6
"6505","1570力肯","110/08/25","新光-新竹",3,0,3
"6506","1570力肯","110/08/25","永豐金-桃園",0,6,-6
"6507","1570力肯","110/08/25","群益金鼎-民權",3,0,3
"6508","1570力肯","110/08/25","兆豐-松德",0,5,-5
"6509","1570力肯","110/08/25","富邦-建國",5,2,3
"6510","1570力肯","110/08/25","群益金鼎-鳳山",0,5,-5
"6511","2929淘帝","110/08/25","摩根大通",64,0,64
"6512","2929淘帝","110/08/25","康和-仁愛",0,44,-44
"6513","2929淘帝","110/08/25","港商野村",37,8,29
"6514","2929淘帝","110/08/25","新光-台中",20,43,-23
"6515","2929淘帝","110/08/25","新加坡商瑞銀",36,12,24
"6516","2929淘帝","110/08/25","台新-台中",0,11,-11
"6517","2929淘帝","110/08/25","美林",29,6,23
"6518","2929淘帝","110/08/25","日盛-中壢",0,10,-10
"6519","2929淘帝","110/08/25","群益金鼎-三重",21,0,21
"6520","2929淘帝","110/08/25","日盛-中和",0,10,-10
"6521","2929淘帝","110/08/25","元大-豐原站前",20,0,20
"6522","2929淘帝","110/08/25","兆豐-忠孝",0,10,-10
"6523","2929淘帝","110/08/25","富邦-高雄",20,2,18
"6524","2929淘帝","110/08/25","華南永昌-台中",0,10,-10
"6525","2929淘帝","110/08/25","日盛-台中",16,0,16
"6526","2929淘帝","110/08/25","華南永昌-麻豆",0,10,-10
"6527","2929淘帝","110/08/25","新光-新竹",17,4,13
"6528","2929淘帝","110/08/25","富邦-陽明",0,10,-10
"6529","2929淘帝","110/08/25","凱基-豐中",13,0,13
"6530","2929淘帝","110/08/25","新光",1,9,-8
"6531","2929淘帝","110/08/25","元富-花蓮",10,0,10
"6532","2929淘帝","110/08/25","元大-大里",0,8,-8
"6533","2929淘帝","110/08/25","元富-板橋",8,0,8
"6534","2929淘帝","110/08/25","永豐金-市政",0,8,-8
"6535","2929淘帝","110/08/25","元大-太平",7,0,7
"6536","2929淘帝","110/08/25","合庫-台中",0,7,-7
"6537","2929淘帝","110/08/25","元大-永和",6,0,6
"6538","2929淘帝","110/08/25","元大-文心",0,7,-7
"6539","2929淘帝","110/08/25","日盛-八德",6,1,5
"6540","2929淘帝","110/08/25","日盛-員林",4,10,-6
"6541","5410國眾","110/08/25","華南永昌-高雄",23,0,23
"6542","5410國眾","110/08/25","元大-崇德",0,30,-30
"6543","5410國眾","110/08/25","香港上海匯豐",12,0,12
"6544","5410國眾","110/08/25","日盛-木柵",0,20,-20
"6545","5410國眾","110/08/25","永豐金-內湖",6,0,6
"6546","5410國眾","110/08/25","大展",0,5,-5
"6547","5410國眾","110/08/25","土銀",5,0,5
"6548","5410國眾","110/08/25","國泰-敦南",0,5,-5
"6549","5410國眾","110/08/25","日盛-屏東",5,0,5
"6550","5410國眾","110/08/25","凱基-基隆",0,5,-5
"6551","5410國眾","110/08/25","國泰-板橋",5,0,5
"6552","5410國眾","110/08/25","華南永昌-淡水",0,5,-5
"6553","5410國眾","110/08/25","元大-南京",5,0,5
"6554","5410國眾","110/08/25","元大-新莊",0,5,-5
"6555","5410國眾","110/08/25","新光-台中",4,0,4
"6556","5410國眾","110/08/25","群益金鼎-新店",0,4,-4
"6557","5410國眾","110/08/25","臺銀-金山",3,0,3
"6558","5410國眾","110/08/25","華南永昌-公誠",0,4,-4
"6559","5410國眾","110/08/25","摩根大通",3,0,3
"6560","5410國眾","110/08/25","元大-龍潭",0,4,-4
"6561","5410國眾","110/08/25","元大-鳳山",3,0,3
"6562","5410國眾","110/08/25","元富-大裕",0,3,-3
"6563","5410國眾","110/08/25","台新-中壢",2,0,2
"6564","5410國眾","110/08/25","富邦-建國",0,3,-3
"6565","5410國眾","110/08/25","新光",2,0,2
"6566","5410國眾","110/08/25","美林",0,2,-2
"6567","5410國眾","110/08/25","群益金鼎-新竹",2,0,2
"6568","5410國眾","110/08/25","新光-桃園",0,2,-2
"6569","5410國眾","110/08/25","群益金鼎-三民",2,0,2
"6570","5410國眾","110/08/25","元大-花蓮",0,2,-2
"6571","2841台開","110/08/25","宏遠-館前",155,0,155
"6572","2841台開","110/08/25","台中銀",0,45,-45
"6573","2841台開","110/08/25","元大-仁愛",50,0,50
"6574","2841台開","110/08/25","元大-承德",0,40,-40
"6575","2841台開","110/08/25","永豐金-豐原",50,0,50
"6576","2841台開","110/08/25","永豐金-桃盛",0,40,-40
"6577","2841台開","110/08/25","元大-草屯",40,0,40
"6578","2841台開","110/08/25","港商野村",0,34,-34
"6579","2841台開","110/08/25","永豐金-敦南",45,12,33
"6580","2841台開","110/08/25","永豐金-台中",0,18,-18
"6581","2841台開","110/08/25","元大-沙鹿",10,0,10
"6582","2841台開","110/08/25","國票-中和",0,17,-17
"6583","2841台開","110/08/25","第一金",8,0,8
"6584","2841台開","110/08/25","凱基-高美館",0,16,-16
"6585","2841台開","110/08/25","康和-內湖",7,0,7
"6586","2841台開","110/08/25","永豐金-桃園",0,15,-15
"6587","2841台開","110/08/25","富邦-台北",5,0,5
"6588","2841台開","110/08/25","台灣摩根士丹利",0,11,-11
"6589","2841台開","110/08/25","玉山證券",4,0,4
"6590","2841台開","110/08/25","元富-三重",0,10,-10
"6591","2841台開","110/08/25","富邦-新竹",4,0,4
"6592","2841台開","110/08/25","華南永昌-虎尾",0,10,-10
"6593","2841台開","110/08/25","元大-大里",3,0,3
"6594","2841台開","110/08/25","富邦-基隆",0,10,-10
"6595","2841台開","110/08/25","兆豐-忠孝",2,0,2
"6596","2841台開","110/08/25","元大-成功",0,10,-10
"6597","2841台開","110/08/25","新光",4,2,2
"6598","2841台開","110/08/25","元大-北三重",0,10,-10
"6599","2841台開","110/08/25","元大-南崁",2,0,2
"6600","2841台開","110/08/25","新光-高雄",0,9,-9
"6601","6207雷科","110/08/25","摩根大通",76,0,76
"6602","6207雷科","110/08/25","凱基-復興",0,160,-160
"6603","6207雷科","110/08/25","永豐金證券",63,9,54
"6604","6207雷科","110/08/25","元大-高雄",0,100,-100
"6605","6207雷科","110/08/25","凱基-台北",50,5,45
"6606","6207雷科","110/08/25","元大-林園",0,65,-65
"6607","6207雷科","110/08/25","美商高盛",25,0,25
"6608","6207雷科","110/08/25","臺灣企銀-埔墘",0,20,-20
"6609","6207雷科","110/08/25","港商野村",24,3,21
"6610","6207雷科","110/08/25","第一金-高雄",0,20,-20
"6611","6207雷科","110/08/25","台新-高雄",20,1,19
"6612","6207雷科","110/08/25","元大-大里德芳",0,18,-18
"6613","6207雷科","110/08/25","兆豐-高雄",17,0,17
"6614","6207雷科","110/08/25","元大-敦南",2,18,-16
"6615","6207雷科","110/08/25","新加坡商瑞銀",32,21,11
"6616","6207雷科","110/08/25","玉山-高雄",0,15,-15
"6617","6207雷科","110/08/25","台灣企銀-屏東",10,0,10
"6618","6207雷科","110/08/25","臺銀-鳳山",1,13,-12
"6619","6207雷科","110/08/25","富邦-虎尾",10,0,10
"6620","6207雷科","110/08/25","第一金-中山",10,20,-10
"6621","6207雷科","110/08/25","永豐金-博愛",10,0,10
"6622","6207雷科","110/08/25","元大-鳳山",0,10,-10
"6623","6207雷科","110/08/25","永豐金-中壢",10,0,10
"6624","6207雷科","110/08/25","華南永昌-古亭",5,14,-9
"6625","6207雷科","110/08/25","兆豐-城中",9,0,9
"6626","6207雷科","110/08/25","華南永昌-高雄",3,10,-7
"6627","6207雷科","110/08/25","兆豐-嘉義",7,0,7
"6628","6207雷科","110/08/25","永豐金-市政",0,6,-6
"6629","6207雷科","110/08/25","兆豐-三民",6,0,6
"6630","6207雷科","110/08/25","群益金鼎-嘉義",1,6,-5
"6631","3679新至陞","110/08/25","永豐金-南投",11,0,11
"6632","3679新至陞","110/08/25","台灣摩根士丹利",6,14,-8
"6633","3679新至陞","110/08/25","港商法國興業",10,0,10
"6634","3679新至陞","110/08/25","瑞士信貸",0,6,-6
"6635","3679新至陞","110/08/25","兆豐-公益",3,0,3
"6636","3679新至陞","110/08/25","永豐金-敦北",0,5,-5
"6637","3679新至陞","110/08/25","(牛牛牛)亞-網路",2,0,2
"6638","3679新至陞","110/08/25","群益金鼎-高盛",0,4,-4
"6639","3679新至陞","110/08/25","玉山-嘉義",2,0,2
"6640","3679新至陞","110/08/25","元大-文心興安",0,4,-4
"6641","3679新至陞","110/08/25","元大-華山",2,0,2
"6642","3679新至陞","110/08/25","臺銀-臺中",0,3,-3
"6643","3679新至陞","110/08/25","臺銀",1,0,1
"6644","3679新至陞","110/08/25","美商高盛",0,3,-3
"6645","3679新至陞","110/08/25","美林",3,2,1
"6646","3679新至陞","110/08/25","臺銀-新竹",0,2,-2
"6647","3679新至陞","110/08/25","港商野村",1,0,1
"6648","3679新至陞","110/08/25","宏遠-中和",0,2,-2
"6649","3679新至陞","110/08/25","富隆-長安",1,0,1
"6650","3679新至陞","110/08/25","摩根大通",5,7,-2
"6651","3679新至陞","110/08/25","大慶-富順",1,0,1
"6652","3679新至陞","110/08/25","合庫-彰化",0,1,-1
"6653","3679新至陞","110/08/25","元富-林園",1,0,1
"6654","3679新至陞","110/08/25","臺銀-高雄",0,1,-1
"6655","3679新至陞","110/08/25","元富-嘉義",1,0,1
"6656","3679新至陞","110/08/25","日盛-木柵",0,1,-1
"6657","3679新至陞","110/08/25","元富-埔里",1,0,1
"6658","3679新至陞","110/08/25","日盛-文化",0,1,-1
"6659","3679新至陞","110/08/25","台中銀-員林",1,0,1
"6660","3679新至陞","110/08/25","玉山證券",0,1,-1
"6661","2727王品","110/08/25","美商高盛",121,6,115
"6662","2727王品","110/08/25","美林",9,114,-105
"6663","2727王品","110/08/25","台灣摩根士丹利",139,57,82
"6664","2727王品","110/08/25","永豐金證券",3,71,-68
"6665","2727王品","110/08/25","凱基-台北",105,26,79
"6666","2727王品","110/08/25","元大證券",52,108,-56
"6667","2727王品","110/08/25","新光-台中",34,5,29
"6668","2727王品","110/08/25","摩根大通",35,73,-38
"6669","2727王品","110/08/25","瑞士信貸",20,0,20
"6670","2727王品","110/08/25","華南永昌-麻豆",1,21,-20
"6671","2727王品","110/08/25","凱基-信義",19,1,18
"6672","2727王品","110/08/25","國泰-台中",5,19,-14
"6673","2727王品","110/08/25","國票-內壢",13,0,13
"6674","2727王品","110/08/25","富邦-羅東",2,16,-14
"6675","2727王品","110/08/25","中國信託",12,0,12
"6676","2727王品","110/08/25","富邦-高雄",2,16,-14
"6677","2727王品","110/08/25","元大-中壢",15,3,12
"6678","2727王品","110/08/25","富邦-台中",2,16,-14
"6679","2727王品","110/08/25","日盛-景美",11,0,11
"6680","2727王品","110/08/25","華南永昌",61,73,-12
"6681","2727王品","110/08/25","富邦-板橋",11,0,11
"6682","2727王品","110/08/25","群益金鼎",1,12,-11
"6683","2727王品","110/08/25","元大-台中",11,0,11
"6684","2727王品","110/08/25","群益金鼎-松山",0,10,-10
"6685","2727王品","110/08/25","台新-高雄",14,4,10
"6686","2727王品","110/08/25","凱基-市府",0,10,-10
"6687","2727王品","110/08/25","康和",12,2,10
"6688","2727王品","110/08/25","凱基-市政",1,10,-9
"6689","2727王品","110/08/25","新加坡商瑞銀",9,0,9
"6690","2727王品","110/08/25","富邦-台北",2,10,-8
"6691","1570力肯","110/08/25","永豐金-虎尾",52,0,52
"6692","1570力肯","110/08/25","元大-竹山",0,14,-14
"6693","1570力肯","110/08/25","國票-南科",26,0,26
"6694","1570力肯","110/08/25","日盛-忠孝",0,12,-12
"6695","1570力肯","110/08/25","凱基-台北",22,3,19
"6696","1570力肯","110/08/25","凱基-高美館",0,10,-10
"6697","1570力肯","110/08/25","日茂-南投",17,0,17
"6698","1570力肯","110/08/25","元富-緯城",3,12,-9
"6699","1570力肯","110/08/25","兆豐-台中港",12,0,12
"6700","1570力肯","110/08/25","(牛牛牛)亞-鑫豐",2,11,-9
"6701","1570力肯","110/08/25","合庫-嘉義",10,0,10
"6702","1570力肯","110/08/25","元大-鳳山",0,8,-8
"6703","1570力肯","110/08/25","凱基-復興",10,0,10
"6704","1570力肯","110/08/25","台灣摩根士丹利",0,7,-7
"6705","1570力肯","110/08/25","國票-博愛",16,7,9
"6706","1570力肯","110/08/25","兆豐-中壢",0,6,-6
"6707","1570力肯","110/08/25","香港上海匯豐",9,0,9
"6708","1570力肯","110/08/25","國票",0,6,-6
"6709","1570力肯","110/08/25","瑞士信貸",8,0,8
"6710","1570力肯","110/08/25","國票-天祥",0,6,-6
"6711","1570力肯","110/08/25","富邦-高雄",8,0,8
"6712","1570力肯","110/08/25","群益金鼎-桃園",0,6,-6
"6713","1570力肯","110/08/25","摩根大通",12,9,3
"6714","1570力肯","110/08/25","華南永昌-大安",0,6,-6
"6715","1570力肯","110/08/25","新光-新竹",3,0,3
"6716","1570力肯","110/08/25","永豐金-桃園",0,6,-6
"6717","1570力肯","110/08/25","群益金鼎-民權",3,0,3
"6718","1570力肯","110/08/25","兆豐-松德",0,5,-5
"6719","1570力肯","110/08/25","富邦-建國",5,2,3
"6720","1570力肯","110/08/25","群益金鼎-鳳山",0,5,-5
"6721","6180橘子","110/08/25","摩根大通",127,3,124
"6722","6180橘子","110/08/25","台灣摩根士丹利",5,98,-93
"6723","6180橘子","110/08/25","凱基-台北",387,266,121
"6724","6180橘子","110/08/25","元大-頭份",2,44,-42
"6725","6180橘子","110/08/25","港商野村",106,5,101
"6726","6180橘子","110/08/25","元富-古亭",0,27,-27
"6727","6180橘子","110/08/25","國票-南港",70,1,69
"6728","6180橘子","110/08/25","富邦-陽明",1,28,-27
"6729","6180橘子","110/08/25","美林",47,0,47
"6730","6180橘子","110/08/25","富邦-高雄",0,27,-27
"6731","6180橘子","110/08/25","新加坡商瑞銀",51,6,45
"6732","6180橘子","110/08/25","元大-新店中正",2,25,-23
"6733","6180橘子","110/08/25","美商高盛",43,5,38
"6734","6180橘子","110/08/25","第一金-中山",1,22,-21
"6735","6180橘子","110/08/25","富邦-員林",28,0,28
"6736","6180橘子","110/08/25","合庫-自強",0,20,-20
"6737","6180橘子","110/08/25","大慶-富順",22,0,22
"6738","6180橘子","110/08/25","兆豐證券",0,20,-20
"6739","6180橘子","110/08/25","第一金",20,0,20
"6740","6180橘子","110/08/25","元大-台中中港",1,20,-19
"6741","6180橘子","110/08/25","元富-高雄",20,1,19
"6742","6180橘子","110/08/25","康和-新竹",0,15,-15
"6743","6180橘子","110/08/25","北城證券",18,1,17
"6744","6180橘子","110/08/25","國泰-敦南",3,18,-15
"6745","6180橘子","110/08/25","大昌",15,1,14
"6746","6180橘子","110/08/25","元大-和平",0,15,-15
"6747","6180橘子","110/08/25","元大-六合",13,0,13
"6748","6180橘子","110/08/25","日盛-中壢",0,13,-13
"6749","6180橘子","110/08/25","統一-彰化",13,1,12
"6750","6180橘子","110/08/25","福勝",0,13,-13
"6751","2390云辰","110/08/25","元大-永和",583,40,543
"6752","2390云辰","110/08/25","港商野村",593,815,-222
"6753","2390云辰","110/08/25","元富-安南",400,0,400
"6754","2390云辰","110/08/25","合庫-高雄",19,149,-130
"6755","2390云辰","110/08/25","凱基-台北",361,93,268
"6756","2390云辰","110/08/25","新光-台中",28,149,-121
"6757","2390云辰","110/08/25","凱基-湖口",101,0,101
"6758","2390云辰","110/08/25","致和-崇德",0,116,-116
"6759","2390云辰","110/08/25","元大-土城學府",153,76,77
"6760","2390云辰","110/08/25","美商高盛",11,122,-111
"6761","2390云辰","110/08/25","富邦-陽明",97,28,69
"6762","2390云辰","110/08/25","第一金-豐原",9,109,-100
"6763","2390云辰","110/08/25","群益金鼎-基隆",62,2,60
"6764","2390云辰","110/08/25","元大-雙和",16,113,-97
"6765","2390云辰","110/08/25","元大-南屯",54,4,50
"6766","2390云辰","110/08/25","統一-新台中",81,161,-80
"6767","2390云辰","110/08/25","摩根大通",166,118,48
"6768","2390云辰","110/08/25","富邦-新店",0,80,-80
"6769","2390云辰","110/08/25","元大證券",64,18,46
"6770","2390云辰","110/08/25","國泰-桃園",13,86,-73
"6771","2390云辰","110/08/25","華南永昌-合泰",40,0,40
"6772","2390云辰","110/08/25","台新證券",57,129,-72
"6773","2390云辰","110/08/25","土銀-花蓮",39,0,39
"6774","2390云辰","110/08/25","新光",207,273,-66
"6775","2390云辰","110/08/25","大昌",50,11,39
"6776","2390云辰","110/08/25","華南永昌-楠梓",21,70,-49
"6777","2390云辰","110/08/25","元富-桃園",38,1,37
"6778","2390云辰","110/08/25","群益金鼎-敦南",87,133,-46
"6779","2390云辰","110/08/25","光和-溪湖",32,1,31
"6780","2390云辰","110/08/25","永豐金-敦北",0,40,-40
"6781","1315達新","110/08/23","元大-文心興安",22,0,22
"6782","1315達新","110/08/23","香港上海匯豐",0,25,-25
"6783","1315達新","110/08/23","元大-北屯",9,0,9
"6784","1315達新","110/08/23","港商麥格理",0,22,-22
"6785","1315達新","110/08/23","元大-中壢",6,0,6
"6786","1315達新","110/08/23","群益金鼎-東湖",0,17,-17
"6787","1315達新","110/08/23","新光",5,0,5
"6788","1315達新","110/08/23","日盛-台中",0,9,-9
"6789","1315達新","110/08/23","國泰-桃園",5,0,5
"6790","1315達新","110/08/23","台新-台南",0,8,-8
"6791","1315達新","110/08/23","凱基-中港",5,0,5
"6792","1315達新","110/08/23","元大-四維",0,5,-5
"6793","1315達新","110/08/23","元大-豐原",5,0,5
"6794","1315達新","110/08/23","美林",0,4,-4
"6795","1315達新","110/08/23","致和-東門",3,0,3
"6796","1315達新","110/08/23","群益金鼎-瑞豐",0,3,-3
"6797","1315達新","110/08/23","華南永昌-鳳山",3,0,3
"6798","1315達新","110/08/23","元大-松山",0,2,-2
"6799","1315達新","110/08/23","元大-屏南",3,0,3
"6800","1315達新","110/08/23","元大-板橋",0,2,-2
"6801","1315達新","110/08/23","元大-仁愛",3,0,3
"6802","1315達新","110/08/23","永豐金證券",0,2,-2
"6803","1315達新","110/08/23","日盛-頭份",2,0,2
"6804","1315達新","110/08/23","元富-信義",0,1,-1
"6805","1315達新","110/08/23","港商法國興業",2,0,2
"6806","1315達新","110/08/23","華南永昌-中正",0,1,-1
"6807","1315達新","110/08/23","新加坡商瑞銀",2,0,2
"6808","1315達新","110/08/23","富邦-板橋",0,1,-1
"6809","1315達新","110/08/23","第一金",2,0,2
"6810","1315達新","110/08/23","富邦-仁愛",0,1,-1
"6811","2609陽明","110/08/23","摩根大通",18636,4559,14077
"6812","2609陽明","110/08/23","富邦證券",10185,12443,-2258
"6813","2609陽明","110/08/23","康和",2421,208,2213
"6814","2609陽明","110/08/23","富邦-虎尾",7091,8076,-985
"6815","2609陽明","110/08/23","台灣摩根士丹利",2570,528,2042
"6816","2609陽明","110/08/23","華南永昌-竹北",340,1185,-845
"6817","2609陽明","110/08/23","凱基-台北",2772,1398,1374
"6818","2609陽明","110/08/23","新光-新竹",958,1746,-788
"6819","2609陽明","110/08/23","美林",7570,6327,1243
"6820","2609陽明","110/08/23","凱基-長庚",161,815,-654
"6821","2609陽明","110/08/23","瑞士信貸",1505,326,1179
"6822","2609陽明","110/08/23","凱基-市府",164,817,-653
"6823","2609陽明","110/08/23","日盛-板橋",1087,183,904
"6824","2609陽明","110/08/23","國泰-敦南",5133,5754,-621
"6825","2609陽明","110/08/23","凱基-復興",1293,497,796
"6826","2609陽明","110/08/23","國泰-館前",1329,1670,-341
"6827","2609陽明","110/08/23","元大證券",3275,2760,515
"6828","2609陽明","110/08/23","富邦-建國",489,824,-335
"6829","2609陽明","110/08/23","元大-頭份",776,338,438
"6830","2609陽明","110/08/23","元大-大同",246,569,-323
"6831","2609陽明","110/08/23","富邦-仁愛",1292,875,417
"6832","2609陽明","110/08/23","元大-和平",98,405,-307
"6833","2609陽明","110/08/23","凱基-市政",2414,2002,412
"6834","2609陽明","110/08/23","元大-台中中港",128,429,-301
"6835","2609陽明","110/08/23","元大-士林",2427,2036,391
"6836","2609陽明","110/08/23","玉山證券",756,1049,-293
"6837","2609陽明","110/08/23","宏遠證券",1542,1153,389
"6838","2609陽明","110/08/23","群益金鼎-內湖",32,319,-287
"6839","2609陽明","110/08/23","新加坡商瑞銀",746,375,371
"6840","2609陽明","110/08/23","群益金鼎-大安",1012,1296,-284
"6841","2636台驊投控","110/08/23","摩根大通",1383,622,761
"6842","2636台驊投控","110/08/23","第一金-桃園",32,181,-149
"6843","2636台驊投控","110/08/23","瑞士信貸",679,89,590
"6844","2636台驊投控","110/08/23","永豐金-新竹",6,139,-133
"6845","2636台驊投控","110/08/23","台灣摩根士丹利",413,93,320
"6846","2636台驊投控","110/08/23","日盛-景美",5,108,-103
"6847","2636台驊投控","110/08/23","美商高盛",400,167,233
"6848","2636台驊投控","110/08/23","台新證券",155,215,-60
"6849","2636台驊投控","110/08/23","新加坡商瑞銀",215,57,158
"6850","2636台驊投控","110/08/23","日盛-台中",0,55,-55
"6851","2636台驊投控","110/08/23","元大-松江",81,17,64
"6852","2636台驊投控","110/08/23","富邦-苗栗",2,57,-55
"6853","2636台驊投控","110/08/23","新光",303,240,63
"6854","2636台驊投控","110/08/23","日盛-信義",12,66,-54
"6855","2636台驊投控","110/08/23","凱基-台北",601,539,62
"6856","2636台驊投控","110/08/23","富邦-北港",7,56,-49
"6857","2636台驊投控","110/08/23","富邦-彰化",116,55,61
"6858","2636台驊投控","110/08/23","中國信託-文心",19,67,-48
"6859","2636台驊投控","110/08/23","永豐金-萬盛",84,36,48
"6860","2636台驊投控","110/08/23","統一-城中",34,81,-47
"6861","2636台驊投控","110/08/23","兆豐-中壢",67,22,45
"6862","2636台驊投控","110/08/23","土銀-南港",0,45,-45
"6863","2636台驊投控","110/08/23","兆豐-鹿港",44,4,40
"6864","2636台驊投控","110/08/23","永豐金-桃園",19,64,-45
"6865","2636台驊投控","110/08/23","元大-林森",77,40,37
"6866","2636台驊投控","110/08/23","台新-台中",63,107,-44
"6867","2636台驊投控","110/08/23","富邦-虎尾",255,221,34
"6868","2636台驊投控","110/08/23","日盛證券",24,67,-43
"6869","2636台驊投控","110/08/23","元富-成功",37,6,31
"6870","2636台驊投控","110/08/23","凱基-竹科",80,118,-38
"6871","2867三商壽","110/08/23","凱基-台北",292,9,283
"6872","2867三商壽","110/08/23","宏遠證券",0,1024,-1024
"6873","2867三商壽","110/08/23","康和-台中",273,3,270
"6874","2867三商壽","110/08/23","富邦-陽明",0,280,-280
"6875","2867三商壽","110/08/23","土銀-台中",150,0,150
"6876","2867三商壽","110/08/23","元大-北投",0,100,-100
"6877","2867三商壽","110/08/23","新光",135,10,125
"6878","2867三商壽","110/08/23","元富",0,75,-75
"6879","2867三商壽","110/08/23","新加坡商瑞銀",109,5,104
"6880","2867三商壽","110/08/23","摩根大通",309,368,-59
"6881","2867三商壽","110/08/23","元大-桃園",100,0,100
"6882","2867三商壽","110/08/23","台灣摩根士丹利",6,57,-51
"6883","2867三商壽","110/08/23","元大-沙鹿",76,0,76
"6884","2867三商壽","110/08/23","元富-城東",0,51,-51
"6885","2867三商壽","110/08/23","凱基",75,0,75
"6886","2867三商壽","110/08/23","美林",9,59,-50
"6887","2867三商壽","110/08/23","元大-彰化民生",72,0,72
"6888","2867三商壽","110/08/23","宏遠-中和",3,50,-47
"6889","2867三商壽","110/08/23","國泰-台南",78,10,68
"6890","2867三商壽","110/08/23","元大-永和",0,42,-42
"6891","2867三商壽","110/08/23","元大-屏東",60,0,60
"6892","2867三商壽","110/08/23","土銀-白河",0,36,-36
"6893","2867三商壽","110/08/23","華南永昌-公誠",60,1,59
"6894","2867三商壽","110/08/23","元大-博愛",0,31,-31
"6895","2867三商壽","110/08/23","國票-安和",50,0,50
"6896","2867三商壽","110/08/23","凱基-八德",0,30,-30
"6897","2867三商壽","110/08/23","國泰-板橋",50,0,50
"6898","2867三商壽","110/08/23","元大-永康",0,30,-30
"6899","2867三商壽","110/08/23","永豐金-新莊",50,0,50
"6900","2867三商壽","110/08/23","日盛-二林",20,40,-20
"6901","5521工信","110/08/23","摩根大通",142,16,126
"6902","5521工信","110/08/23","港商野村",0,134,-134
"6903","5521工信","110/08/23","群益金鼎-台中",123,0,123
"6904","5521工信","110/08/23","元大-南屯",10,135,-125
"6905","5521工信","110/08/23","元大證券",106,0,106
"6906","5521工信","110/08/23","國泰-敦南",1,34,-33
"6907","5521工信","110/08/23","凱基-台北",117,24,93
"6908","5521工信","110/08/23","台新-台中",2,30,-28
"6909","5521工信","110/08/23","中國信託-三重",44,0,44
"6910","5521工信","110/08/23","群益金鼎-三民",0,25,-25
"6911","5521工信","110/08/23","日盛-宜蘭",20,0,20
"6912","5521工信","110/08/23","福勝",0,20,-20
"6913","5521工信","110/08/23","元大-桃園",20,0,20
"6914","5521工信","110/08/23","元大-內湖",0,20,-20
"6915","5521工信","110/08/23","日茂",14,0,14
"6916","5521工信","110/08/23","第一金-新竹",0,15,-15
"6917","5521工信","110/08/23","富邦-苗栗",12,0,12
"6918","5521工信","110/08/23","統一-員林",0,15,-15
"6919","5521工信","110/08/23","港商法國興業",11,0,11
"6920","5521工信","110/08/23","新光",0,15,-15
"6921","5521工信","110/08/23","統一-新台中",66,55,11
"6922","5521工信","110/08/23","華南永昌-高雄",0,15,-15
"6923","5521工信","110/08/23","宏遠-桃園",10,0,10
"6924","5521工信","110/08/23","第一金-桃園",0,12,-12
"6925","5521工信","110/08/23","日進",10,0,10
"6926","5521工信","110/08/23","群益金鼎-萬華",0,12,-12
"6927","5521工信","110/08/23","群益金鼎-中壢",10,0,10
"6928","5521工信","110/08/23","兆豐-新竹",0,11,-11
"6929","5521工信","110/08/23","富邦-虎尾",10,0,10
"6930","5521工信","110/08/23","群益金鼎-忠孝",0,10,-10
"6931","1471首利","110/08/23","摩根大通",143,11,132
"6932","1471首利","110/08/23","元大-草屯",0,153,-153
"6933","1471首利","110/08/23","瑞士信貸",79,0,79
"6934","1471首利","110/08/23","富邦-台北",0,30,-30
"6935","1471首利","110/08/23","美林",27,1,26
"6936","1471首利","110/08/23","第一金-路竹",0,28,-28
"6937","1471首利","110/08/23","凱基-台北",23,0,23
"6938","1471首利","110/08/23","光和-嘉義",0,20,-20
"6939","1471首利","110/08/23","港商法國興業",16,0,16
"6940","1471首利","110/08/23","兆豐-台中港",0,20,-20
"6941","1471首利","110/08/23","兆豐-員林",13,1,12
"6942","1471首利","110/08/23","新光-台南",0,20,-20
"6943","1471首利","110/08/23","台新-台南",10,0,10
"6944","1471首利","110/08/23","永豐金-松山",0,20,-20
"6945","1471首利","110/08/23","玉山-新莊",10,0,10
"6946","1471首利","110/08/23","永興-大墩",0,12,-12
"6947","1471首利","110/08/23","元大-南崁",10,0,10
"6948","1471首利","110/08/23","元富-民權",0,12,-12
"6949","1471首利","110/08/23","國泰-敦南",9,0,9
"6950","1471首利","110/08/23","光和",0,11,-11
"6951","1471首利","110/08/23","中農",7,0,7
"6952","1471首利","110/08/23","凱基-嘉義",0,11,-11
"6953","1471首利","110/08/23","元大-南投",7,0,7
"6954","1471首利","110/08/23","宏遠-光隆",0,10,-10
"6955","1471首利","110/08/23","臺銀-鳳山",5,0,5
"6956","1471首利","110/08/23","元富-台南",0,10,-10
"6957","1471首利","110/08/23","臺銀-新竹",5,0,5
"6958","1471首利","110/08/23","國票-天祥",1,7,-6
"6959","1471首利","110/08/23","台新-松江",5,0,5
"6960","1471首利","110/08/23","凱基-新店",1,7,-6
"6961","2883開發金","110/08/23","港商野村",10106,1311,8795
"6962","2883開發金","110/08/23","凱基",0,12731,-12731
"6963","2883開發金","110/08/23","國泰-館前",3231,61,3170
"6964","2883開發金","110/08/23","華南永昌",206,3525,-3319
"6965","2883開發金","110/08/23","美林",3113,860,2253
"6966","2883開發金","110/08/23","台灣摩根士丹利",274,2928,-2654
"6967","2883開發金","110/08/23","元大-開元",2066,52,2014
"6968","2883開發金","110/08/23","凱基-台北",1073,3532,-2459
"6969","2883開發金","110/08/23","統一",1542,16,1526
"6970","2883開發金","110/08/23","新加坡商瑞銀",404,2862,-2458
"6971","2883開發金","110/08/23","永豐金-新莊",1111,2,1109
"6972","2883開發金","110/08/23","群益金鼎",2,1833,-1831
"6973","2883開發金","110/08/23","永豐金-台南",1055,155,900
"6974","2883開發金","110/08/23","摩根大通",987,2808,-1821
"6975","2883開發金","110/08/23","統一-基隆",542,0,542
"6976","2883開發金","110/08/23","聯邦商銀",4,1800,-1796
"6977","2883開發金","110/08/23","花旗環球",650,117,533
"6978","2883開發金","110/08/23","康和",5,1485,-1480
"6979","2883開發金","110/08/23","群益金鼎-開元",531,23,508
"6980","2883開發金","110/08/23","新光",1648,2512,-864
"6981","2883開發金","110/08/23","港商法國興業",484,0,484
"6982","2883開發金","110/08/23","美商高盛",11,687,-676
"6983","2883開發金","110/08/23","統一-台中",496,32,464
"6984","2883開發金","110/08/23","大慶-基隆",3,503,-500
"6985","2883開發金","110/08/23","(牛牛牛)亞-鑫豐",475,48,427
"6986","2883開發金","110/08/23","瑞士信貸",206,641,-435
"6987","2883開發金","110/08/23","元大證券",560,198,362
"6988","2883開發金","110/08/23","第一金-台南",79,494,-415
"6989","2883開發金","110/08/23","台新證券",488,128,360
"6990","2883開發金","110/08/23","華南永昌-苑裡",2,315,-313
"6991","6205詮欣","110/08/23","合庫-三重",49,0,49
"6992","6205詮欣","110/08/23","永豐金-敦南",0,52,-52
"6993","6205詮欣","110/08/23","摩根大通",8,0,8
"6994","6205詮欣","110/08/23","統一-中壢",0,10,-10
"6995","6205詮欣","110/08/23","日盛-高雄",5,0,5
"6996","6205詮欣","110/08/23","瑞士信貸",3,11,-8
"6997","6205詮欣","110/08/23","新光-台南",5,0,5
"6998","6205詮欣","110/08/23","群益金鼎-永和",0,5,-5
"6999","6205詮欣","110/08/23","元大-復北",4,0,4
"7000","6205詮欣","110/08/23","華南永昌-公誠",0,5,-5
"7001","6205詮欣","110/08/23","永豐金證券",4,0,4
"7002","6205詮欣","110/08/23","元大-屏東",0,5,-5
"7003","6205詮欣","110/08/23","臺銀-高雄",3,0,3
"7004","6205詮欣","110/08/23","元大-汐止",1,5,-4
"7005","6205詮欣","110/08/23","港商法國興業",3,0,3
"7006","6205詮欣","110/08/23","統一-汐止",0,3,-3
"7007","6205詮欣","110/08/23","凱基-汐止",3,0,3
"7008","6205詮欣","110/08/23","元富-嘉義",0,2,-2
"7009","6205詮欣","110/08/23","凱基-台北",4,1,3
"7010","6205詮欣","110/08/23","北城證券",0,2,-2
"7011","6205詮欣","110/08/23","日盛-三重",2,0,2
"7012","6205詮欣","110/08/23","凱基-新莊",0,2,-2
"7013","6205詮欣","110/08/23","華南永昌-潮州",2,0,2
"7014","6205詮欣","110/08/23","富邦-仁愛",0,2,-2
"7015","6205詮欣","110/08/23","元大-成功",2,0,2
"7016","6205詮欣","110/08/23","永豐金-新莊",0,2,-2
"7017","6205詮欣","110/08/23","美林",1,0,1
"7018","6205詮欣","110/08/23","永豐金-台中",0,2,-2
"7019","6205詮欣","110/08/23","第一金-大稻埕",1,0,1
"7020","6205詮欣","110/08/23","第一金-路竹",0,1,-1
"7021","1540喬福","110/08/23","玉山證券",6,1,5
"7022","1540喬福","110/08/23","元富-新竹",0,5,-5
"7023","1540喬福","110/08/23","港商法國興業",3,0,3
"7024","1540喬福","110/08/23","玉山-城中",0,5,-5
"7025","1540喬福","110/08/23","元富-敦南",3,0,3
"7026","1540喬福","110/08/23","兆豐-台中港",0,4,-4
"7027","1540喬福","110/08/23","凱基-台北",2,0,2
"7028","1540喬福","110/08/23","元大-太平",0,4,-4
"7029","1540喬福","110/08/23","國泰-敦南",1,0,1
"7030","1540喬福","110/08/23","美林",0,1,-1
"7031","1540喬福","110/08/23","永豐金-豐原",1,0,1
"7032","1540喬福","110/08/23","元富",0,1,-1
"7033","1540喬福","110/08/23","永豐金-敦南",1,0,1
"7034","1540喬福","110/08/23","群益金鼎-海山",0,1,-1
"7035","1540喬福","110/08/23","元大-文心興安",1,0,1
"7036","1540喬福","110/08/23","富邦-嘉義",0,1,-1
"7037","1540喬福","110/08/23","群益金鼎-丹鳳",1,0,1
"7038","1540喬福","110/08/23","日盛-八德",0,0,0
"7039","1540喬福","110/08/23","群益金鼎-高雄",1,0,1
"7040","1540喬福","110/08/23","統一-三重",0,0,0
"7041","1540喬福","110/08/23","合庫-高雄",1,0,1
"7042","1540喬福","110/08/23","(牛牛牛)亞-網路",0,0,0
"7043","1540喬福","110/08/23","致和-南京",2,1,1
"7044","1540喬福","110/08/23","國泰-高雄",0,0,0
"7045","1540喬福","110/08/23","新加坡商瑞銀",1,0,1
"7046","1540喬福","110/08/23","凱基-竹北",0,0,0
"7047","1540喬福","110/08/23","國泰-高雄",0,0,0
"7048","1540喬福","110/08/23","華南永昌-嘉義",0,0,0
"7049","1540喬福","110/08/23","凱基-竹北",0,0,0
"7050","1540喬福","110/08/23","元大-西門",0,0,0
"7051","2888新光金","110/08/23","港商野村",2200,82,2118
"7052","2888新光金","110/08/23","元富-城東",72,2108,-2036
"7053","2888新光金","110/08/23","凱基-台北",1553,74,1479
"7054","2888新光金","110/08/23","元大-北投",15,1631,-1616
"7055","2888新光金","110/08/23","合庫-新竹",800,0,800
"7056","2888新光金","110/08/23","美商高盛",264,1857,-1593
"7057","2888新光金","110/08/23","法銀巴黎",688,38,650
"7058","2888新光金","110/08/23","摩根大通",2146,3664,-1518
"7059","2888新光金","110/08/23","元富",590,17,573
"7060","2888新光金","110/08/23","元大證券",87,1208,-1121
"7061","2888新光金","110/08/23","第一金-新竹",572,0,572
"7062","2888新光金","110/08/23","凱基-頭份",0,1100,-1100
"7063","2888新光金","110/08/23","台灣摩根士丹利",597,168,429
"7064","2888新光金","110/08/23","玉山-板橋",93,712,-619
"7065","2888新光金","110/08/23","福邦-新竹",412,0,412
"7066","2888新光金","110/08/23","瑞士信貸",535,1122,-587
"7067","2888新光金","110/08/23","新光",504,139,365
"7068","2888新光金","110/08/23","元富-嘉義",27,583,-556
"7069","2888新光金","110/08/23","元大-屏南",343,4,339
"7070","2888新光金","110/08/23","凱基-敦北",2,500,-498
"7071","2888新光金","110/08/23","(牛牛牛)亞-鑫豐",398,63,335
"7072","2888新光金","110/08/23","華南永昌-林口",130,620,-490
"7073","2888新光金","110/08/23","永豐金-嘉義",300,0,300
"7074","2888新光金","110/08/23","元大-草屯",27,442,-415
"7075","2888新光金","110/08/23","富邦-台北",309,14,295
"7076","2888新光金","110/08/23","元大-大天母",5,255,-250
"7077","2888新光金","110/08/23","元富-彰化",254,2,252
"7078","2888新光金","110/08/23","土銀-嘉義",10,250,-240
"7079","2888新光金","110/08/23","群益金鼎-竹南",282,32,250
"7080","2888新光金","110/08/23","富邦-高雄",42,266,-224
"7081","1340勝悅","110/08/23","港商法國興業",20,0,20
"7082","1340勝悅","110/08/23","凱基-永華",0,26,-26
"7083","1340勝悅","110/08/23","凱基-台北",15,1,14
"7084","1340勝悅","110/08/23","元大-四維",0,20,-20
"7085","1340勝悅","110/08/23","美林",12,0,12
"7086","1340勝悅","110/08/23","元大-向上",0,19,-19
"7087","1340勝悅","110/08/23","元富-宜蘭",7,0,7
"7088","1340勝悅","110/08/23","元大-竹北",0,18,-18
"7089","1340勝悅","110/08/23","美商高盛",6,0,6
"7090","1340勝悅","110/08/23","永豐金-內湖",0,15,-15
"7091","1340勝悅","110/08/23","國泰-台中",6,0,6
"7092","1340勝悅","110/08/23","摩根大通",0,9,-9
"7093","1340勝悅","110/08/23","臺灣企銀-埔墘",5,0,5
"7094","1340勝悅","110/08/23","元大-忠孝鼎富",0,9,-9
"7095","1340勝悅","110/08/23","元富-彰化",5,0,5
"7096","1340勝悅","110/08/23","凱基-高美館",0,4,-4
"7097","1340勝悅","110/08/23","台中銀",5,0,5
"7098","1340勝悅","110/08/23","臺銀-鳳山",0,3,-3
"7099","1340勝悅","110/08/23","新光",5,0,5
"7100","1340勝悅","110/08/23","統一-城中",3,6,-3
"7101","1340勝悅","110/08/23","瑞士信貸",4,0,4
"7102","1340勝悅","110/08/23","陽信-石牌",0,2,-2
"7103","1340勝悅","110/08/23","華南永昌-新莊",4,0,4
"7104","1340勝悅","110/08/23","群益金鼎-屏東",0,2,-2
"7105","1340勝悅","110/08/23","富邦-新店",5,1,4
"7106","1340勝悅","110/08/23","富邦-羅東",0,2,-2
"7107","1340勝悅","110/08/23","群益金鼎-館前",3,0,3
"7108","1340勝悅","110/08/23","元大-新竹經國",0,2,-2
"7109","1340勝悅","110/08/23","國泰-桃園",2,0,2
"7110","1340勝悅","110/08/23","新光-台南",0,1,-1
"7111","6246臺龍","110/08/23","台新-高雄",46,22,24
"7112","6246臺龍","110/08/23","元富-高雄",0,26,-26
"7113","6246臺龍","110/08/23","凱基-台北",10,1,9
"7114","6246臺龍","110/08/23","元大-台北",0,8,-8
"7115","6246臺龍","110/08/23","臺銀-臺中",6,0,6
"7116","6246臺龍","110/08/23","日進",0,6,-6
"7117","6246臺龍","110/08/23","國票-北高雄",6,0,6
"7118","6246臺龍","110/08/23","第一金-高雄",0,5,-5
"7119","6246臺龍","110/08/23","第一金-安和",5,0,5
"7120","6246臺龍","110/08/23","玉山-桃園",0,5,-5
"7121","6246臺龍","110/08/23","元富-宜蘭",5,0,5
"7122","6246臺龍","110/08/23","群益金鼎-東門",0,5,-5
"7123","6246臺龍","110/08/23","康和-內湖",5,0,5
"7124","6246臺龍","110/08/23","永豐金-三重",0,5,-5
"7125","6246臺龍","110/08/23","兆豐-公益",4,0,4
"7126","6246臺龍","110/08/23","元富-潮州",0,4,-4
"7127","6246臺龍","110/08/23","台新-屏東",20,16,4
"7128","6246臺龍","110/08/23","元大-新莊",0,4,-4
"7129","6246臺龍","110/08/23","元大-高雄",4,0,4
"7130","6246臺龍","110/08/23","宏遠-新化",0,3,-3
"7131","6246臺龍","110/08/23","兆豐-景美",3,0,3
"7132","6246臺龍","110/08/23","富邦-嘉義",0,3,-3
"7133","6246臺龍","110/08/23","國票-敦北法人",5,2,3
"7134","6246臺龍","110/08/23","日盛-新莊",0,2,-2
"7135","6246臺龍","110/08/23","新光-台中",3,0,3
"7136","6246臺龍","110/08/23","元富-花蓮",0,2,-2
"7137","6246臺龍","110/08/23","元大-竹山",3,0,3
"7138","6246臺龍","110/08/23","兆豐-高雄",0,2,-2
"7139","6246臺龍","110/08/23","元大-土城",3,0,3
"7140","6246臺龍","110/08/23","國泰-敦南",1,3,-2
"7141","00715L期街口布蘭特正2","110/08/23","中國信託-永康",1679,1,1678
"7142","00715L期街口布蘭特正2","110/08/23","元大證券",181,15885,-15704
"7143","00715L期街口布蘭特正2","110/08/23","元大-新竹",1242,37,1205
"7144","00715L期街口布蘭特正2","110/08/23","凱基",0,4277,-4277
"7145","00715L期街口布蘭特正2","110/08/23","兆豐-鹿港",790,10,780
"7146","00715L期街口布蘭特正2","110/08/23","合庫證券",25,3475,-3450
"7147","00715L期街口布蘭特正2","110/08/23","凱基-台北",1274,502,772
"7148","00715L期街口布蘭特正2","110/08/23","永豐金證券",100,3461,-3361
"7149","00715L期街口布蘭特正2","110/08/23","新光",913,226,687
"7150","00715L期街口布蘭特正2","110/08/23","元富",11,2829,-2818
"7151","00715L期街口布蘭特正2","110/08/23","台中銀",639,24,615
"7152","00715L期街口布蘭特正2","110/08/23","康和",0,2551,-2551
"7153","00715L期街口布蘭特正2","110/08/23","元大-嘉義",584,0,584
"7154","00715L期街口布蘭特正2","110/08/23","富邦證券",1628,2629,-1001
"7155","00715L期街口布蘭特正2","110/08/23","兆豐-台中港",613,30,583
"7156","00715L期街口布蘭特正2","110/08/23","元大-林森",45,602,-557
"7157","00715L期街口布蘭特正2","110/08/23","永豐金-板盛",506,0,506
"7158","00715L期街口布蘭特正2","110/08/23","元大-三重",21,550,-529
"7159","00715L期街口布蘭特正2","110/08/23","群益金鼎-屏東",501,0,501
"7160","00715L期街口布蘭特正2","110/08/23","元大-民雄",92,575,-483
"7161","00715L期街口布蘭特正2","110/08/23","元大-北港",496,10,486
"7162","00715L期街口布蘭特正2","110/08/23","元大-蘆洲",15,316,-301
"7163","00715L期街口布蘭特正2","110/08/23","新光-台中",463,36,427
"7164","00715L期街口布蘭特正2","110/08/23","群益金鼎-台中",10,300,-290
"7165","00715L期街口布蘭特正2","110/08/23","永豐金-市政",420,15,405
"7166","00715L期街口布蘭特正2","110/08/23","群益金鼎-丹鳳",37,320,-283
"7167","00715L期街口布蘭特正2","110/08/23","元大-復北",415,11,404
"7168","00715L期街口布蘭特正2","110/08/23","富邦-嘉義",346,628,-282
"7169","00715L期街口布蘭特正2","110/08/23","中國信託-高雄",428,28,400
"7170","00715L期街口布蘭特正2","110/08/23","大昌-樹林",48,295,-247
"7171","8941關中","110/08/23","凱基-市府",1,0,1
"7172","8941關中","110/08/23","元大-金華",0,1,-1
"7173","8941關中","110/08/23","元富-台中",0,0,0
"7174","8941關中","110/08/23","元富-台中",0,0,0
"7175","8941關中","110/08/23","康和-板橋",0,0,0
"7176","8941關中","110/08/23","康和-板橋",0,0,0
"7177","8941關中","110/08/23","凱基-市政",0,0,0
"7178","8941關中","110/08/23","凱基-市政",0,0,0
"7179","8941關中","110/08/23","永豐金-敦北",0,0,0
"7180","8941關中","110/08/23","永豐金-敦北",0,0,0
"7181","8941關中","110/08/23","永豐金-南投",0,0,0
"7182","8941關中","110/08/23","永豐金-南投",0,0,0
"7183","8941關中","110/08/23","",NA,NA,NA
"7184","8941關中","110/08/23","",NA,NA,NA
"7185","8941關中","110/08/23","",NA,NA,NA
"7186","8941關中","110/08/23","",NA,NA,NA
"7187","8941關中","110/08/23","",NA,NA,NA
"7188","8941關中","110/08/23","",NA,NA,NA
"7189","8941關中","110/08/23","",NA,NA,NA
"7190","8941關中","110/08/23","",NA,NA,NA
"7191","8941關中","110/08/23","",NA,NA,NA
"7192","8941關中","110/08/23","",NA,NA,NA
"7193","8941關中","110/08/23","",NA,NA,NA
"7194","8941關中","110/08/23","",NA,NA,NA
"7195","8941關中","110/08/23","",NA,NA,NA
"7196","8941關中","110/08/23","",NA,NA,NA
"7197","8941關中","110/08/23","",NA,NA,NA
"7198","8941關中","110/08/23","",NA,NA,NA
"7199","8941關中","110/08/23","",NA,NA,NA
"7200","8941關中","110/08/23","",NA,NA,NA
"7201","8936國統","110/08/23","新加坡商瑞銀",220,12,208
"7202","8936國統","110/08/23","宏遠-台南",0,264,-264
"7203","8936國統","110/08/23","第一金-高雄",100,0,100
"7204","8936國統","110/08/23","康和-高雄",0,156,-156
"7205","8936國統","110/08/23","美商高盛",89,5,84
"7206","8936國統","110/08/23","凱基-高美館",0,56,-56
"7207","8936國統","110/08/23","瑞士信貸",77,0,77
"7208","8936國統","110/08/23","凱基-台北",7,50,-43
"7209","8936國統","110/08/23","中國信託-高雄",55,0,55
"7210","8936國統","110/08/23","大慶-楊梅",0,19,-19
"7211","8936國統","110/08/23","摩根大通",44,0,44
"7212","8936國統","110/08/23","富邦-台北",1,17,-16
"7213","8936國統","110/08/23","港商野村",68,31,37
"7214","8936國統","110/08/23","國票-中正",0,15,-15
"7215","8936國統","110/08/23","富邦-陽明",30,0,30
"7216","8936國統","110/08/23","兆豐-北高雄",0,14,-14
"7217","8936國統","110/08/23","美林",15,0,15
"7218","8936國統","110/08/23","日盛-和美",1,12,-11
"7219","8936國統","110/08/23","華南永昌",15,0,15
"7220","8936國統","110/08/23","統一-新竹",2,13,-11
"7221","8936國統","110/08/23","新光-台中",13,1,12
"7222","8936國統","110/08/23","永興-水湳",0,10,-10
"7223","8936國統","110/08/23","臺銀-鳳山",11,0,11
"7224","8936國統","110/08/23","國票-北高雄",0,10,-10
"7225","8936國統","110/08/23","元富-城東",10,0,10
"7226","8936國統","110/08/23","凱基-科園",0,10,-10
"7227","8936國統","110/08/23","宏遠-高雄",11,2,9
"7228","8936國統","110/08/23","元大-高雄",0,10,-10
"7229","8936國統","110/08/23","元富-古亭",9,0,9
"7230","8936國統","110/08/23","元大-西螺",0,8,-8
"7231","6226光鼎","110/08/23","摩根大通",432,89,343
"7232","6226光鼎","110/08/23","元大-文心興安",17,248,-231
"7233","6226光鼎","110/08/23","凱基-台北",234,13,221
"7234","6226光鼎","110/08/23","台新-台南",5,92,-87
"7235","6226光鼎","110/08/23","瑞士信貸",176,1,175
"7236","6226光鼎","110/08/23","致和-佳里",0,50,-50
"7237","6226光鼎","110/08/23","美林",77,4,73
"7238","6226光鼎","110/08/23","永豐金-大園",1,50,-49
"7239","6226光鼎","110/08/23","元大-板橋",51,4,47
"7240","6226光鼎","110/08/23","永豐金-竹北",0,40,-40
"7241","6226光鼎","110/08/23","港商法國興業",41,0,41
"7242","6226光鼎","110/08/23","凱基-台中",10,46,-36
"7243","6226光鼎","110/08/23","富邦-陽明",60,20,40
"7244","6226光鼎","110/08/23","統一",0,35,-35
"7245","6226光鼎","110/08/23","華南永昌-中正",38,0,38
"7246","6226光鼎","110/08/23","國泰-板橋",13,47,-34
"7247","6226光鼎","110/08/23","美商高盛",120,86,34
"7248","6226光鼎","110/08/23","富邦-岡山",0,34,-34
"7249","6226光鼎","110/08/23","永豐金-虎尾",54,21,33
"7250","6226光鼎","110/08/23","元富-城中",4,37,-33
"7251","6226光鼎","110/08/23","元大-中壢",43,11,32
"7252","6226光鼎","110/08/23","永豐金-中盛",2,35,-33
"7253","6226光鼎","110/08/23","元大-松山",30,0,30
"7254","6226光鼎","110/08/23","新光",29,60,-31
"7255","6226光鼎","110/08/23","華南永昌-麻豆",29,0,29
"7256","6226光鼎","110/08/23","第一金-台南",3,28,-25
"7257","6226光鼎","110/08/23","國泰-敦南",108,80,28
"7258","6226光鼎","110/08/23","元富-同大",0,23,-23
"7259","6226光鼎","110/08/23","凱基-內埔",31,10,21
"7260","6226光鼎","110/08/23","元大-高雄",0,23,-23
"7261","2363矽統","110/08/23","摩根大通",2511,676,1835
"7262","2363矽統","110/08/23","凱基-南崁",11,1553,-1542
"7263","2363矽統","110/08/23","凱基-台北",1871,888,983
"7264","2363矽統","110/08/23","玉山-台中",25,549,-524
"7265","2363矽統","110/08/23","合庫-基隆",965,24,941
"7266","2363矽統","110/08/23","台灣摩根士丹利",0,504,-504
"7267","2363矽統","110/08/23","瑞士信貸",553,0,553
"7268","2363矽統","110/08/23","永豐金-板盛",4,302,-298
"7269","2363矽統","110/08/23","美商高盛",1636,1099,537
"7270","2363矽統","110/08/23","大展",13,289,-276
"7271","2363矽統","110/08/23","港商野村",2021,1501,520
"7272","2363矽統","110/08/23","元大-汐止",123,391,-268
"7273","2363矽統","110/08/23","美林",395,80,315
"7274","2363矽統","110/08/23","台新證券",332,525,-193
"7275","2363矽統","110/08/23","富邦-苗栗",360,53,307
"7276","2363矽統","110/08/23","富邦-新竹",45,201,-156
"7277","2363矽統","110/08/23","統一-土城",254,6,248
"7278","2363矽統","110/08/23","群益金鼎-桃園",4,107,-103
"7279","2363矽統","110/08/23","統一-仁愛",281,48,233
"7280","2363矽統","110/08/23","台新-屏東",58,156,-98
"7281","2363矽統","110/08/23","統一-敦南",261,40,221
"7282","2363矽統","110/08/23","元富-永和",9,103,-94
"7283","2363矽統","110/08/23","統一-城中",276,57,219
"7284","2363矽統","110/08/23","富邦-新店",19,107,-88
"7285","2363矽統","110/08/23","群益金鼎-敦南",209,13,196
"7286","2363矽統","110/08/23","群益金鼎-南京",24,111,-87
"7287","2363矽統","110/08/23","華南永昌-林口",174,12,162
"7288","2363矽統","110/08/23","台新-左楠",4,88,-84
"7289","2363矽統","110/08/23","元大-淡水",210,57,153
"7290","2363矽統","110/08/23","元大-沙鹿",58,137,-79
"7291","8112至上","110/08/23","美林",116,9,107
"7292","8112至上","110/08/23","群益金鼎-基隆",0,172,-172
"7293","8112至上","110/08/23","摩根大通",133,59,74
"7294","8112至上","110/08/23","香港上海匯豐",0,120,-120
"7295","8112至上","110/08/23","第一金-桃園",99,30,69
"7296","8112至上","110/08/23","台灣摩根士丹利",0,110,-110
"7297","8112至上","110/08/23","凱基-台北",129,78,51
"7298","8112至上","110/08/23","群益金鼎",0,100,-100
"7299","8112至上","110/08/23","元大-成功",50,1,49
"7300","8112至上","110/08/23","元大-佳里",5,92,-87
"7301","8112至上","110/08/23","日盛-花蓮",40,0,40
"7302","8112至上","110/08/23","港商野村",77,140,-63
"7303","8112至上","110/08/23","國票-天祥",40,0,40
"7304","8112至上","110/08/23","元大-永和",0,45,-45
"7305","8112至上","110/08/23","群益金鼎-板橋",40,0,40
"7306","8112至上","110/08/23","富邦-仁愛",31,66,-35
"7307","8112至上","110/08/23","元大-萬華",49,10,39
"7308","8112至上","110/08/23","日盛-文化",0,26,-26
"7309","8112至上","110/08/23","合庫-西台中",40,5,35
"7310","8112至上","110/08/23","元富-佳里",4,30,-26
"7311","8112至上","110/08/23","瑞士信貸",33,0,33
"7312","8112至上","110/08/23","第一金-大稻埕",0,25,-25
"7313","8112至上","110/08/23","中國信託-永康",31,0,31
"7314","8112至上","110/08/23","大慶-蘆洲",0,22,-22
"7315","8112至上","110/08/23","亞東",30,0,30
"7316","8112至上","110/08/23","永豐金-敦南",2,23,-21
"7317","8112至上","110/08/23","亞東-台中",26,0,26
"7318","8112至上","110/08/23","台中銀",0,20,-20
"7319","8112至上","110/08/23","富邦-北港",35,11,24
"7320","8112至上","110/08/23","兆豐-西螺",0,20,-20
"7321","1570力肯","110/08/23","國票-和平",39,0,39
"7322","1570力肯","110/08/23","統一",0,28,-28
"7323","1570力肯","110/08/23","摩根大通",22,1,21
"7324","1570力肯","110/08/23","群益金鼎-東門",0,20,-20
"7325","1570力肯","110/08/23","臺銀",18,0,18
"7326","1570力肯","110/08/23","中國信託-嘉義",0,15,-15
"7327","1570力肯","110/08/23","台新-台中",18,0,18
"7328","1570力肯","110/08/23","台新證券",0,15,-15
"7329","1570力肯","110/08/23","凱基-台北",25,8,17
"7330","1570力肯","110/08/23","元富-世貿",0,10,-10
"7331","1570力肯","110/08/23","中農",10,0,10
"7332","1570力肯","110/08/23","國票-博愛",0,10,-10
"7333","1570力肯","110/08/23","瑞士信貸",5,0,5
"7334","1570力肯","110/08/23","元富-新興",0,9,-9
"7335","1570力肯","110/08/23","兆豐-松德",5,0,5
"7336","1570力肯","110/08/23","新光",0,9,-9
"7337","1570力肯","110/08/23","凱基-高美館",5,0,5
"7338","1570力肯","110/08/23","元大-四維",1,7,-6
"7339","1570力肯","110/08/23","凱基-幸福",5,0,5
"7340","1570力肯","110/08/23","元大-淡水",0,4,-4
"7341","1570力肯","110/08/23","元大-和平",20,15,5
"7342","1570力肯","110/08/23","元大-民生",0,4,-4
"7343","1570力肯","110/08/23","元大-草屯",5,0,5
"7344","1570力肯","110/08/23","元大-東港",0,4,-4
"7345","1570力肯","110/08/23","日盛-中壢",4,0,4
"7346","1570力肯","110/08/23","永豐金-松山",0,4,-4
"7347","1570力肯","110/08/23","國票-天祥",3,0,3
"7348","1570力肯","110/08/23","日盛-景美",0,3,-3
"7349","1570力肯","110/08/23","台灣企銀-屏東",2,0,2
"7350","1570力肯","110/08/23","中國信託-新竹",0,3,-3
"7351","2929淘帝","110/08/23","凱基-台北",27,2,25
"7352","2929淘帝","110/08/23","花旗環球",0,22,-22
"7353","2929淘帝","110/08/23","元大-太平",23,0,23
"7354","2929淘帝","110/08/23","宏遠-館前",0,20,-20
"7355","2929淘帝","110/08/23","元大-萬華",20,0,20
"7356","2929淘帝","110/08/23","富邦-高雄",0,20,-20
"7357","2929淘帝","110/08/23","港商野村",14,0,14
"7358","2929淘帝","110/08/23","兆豐-北高雄",0,17,-17
"7359","2929淘帝","110/08/23","摩根大通",14,0,14
"7360","2929淘帝","110/08/23","致和-高雄",0,10,-10
"7361","2929淘帝","110/08/23","富邦-陽明",11,0,11
"7362","2929淘帝","110/08/23","康和-內湖",0,10,-10
"7363","2929淘帝","110/08/23","元大-文心興安",10,0,10
"7364","2929淘帝","110/08/23","元大-沙鹿",0,9,-9
"7365","2929淘帝","110/08/23","永豐金-大園",10,0,10
"7366","2929淘帝","110/08/23","元大-豐原站前",0,8,-8
"7367","2929淘帝","110/08/23","凱基-林口",7,0,7
"7368","2929淘帝","110/08/23","高橋-龍潭",0,7,-7
"7369","2929淘帝","110/08/23","新加坡商瑞銀",9,3,6
"7370","2929淘帝","110/08/23","臺銀-高雄",0,6,-6
"7371","2929淘帝","110/08/23","日盛-員林",5,0,5
"7372","2929淘帝","110/08/23","元富-新竹",0,6,-6
"7373","2929淘帝","110/08/23","元大-虎尾",5,0,5
"7374","2929淘帝","110/08/23","富邦-竹北",0,6,-6
"7375","2929淘帝","110/08/23","美林",6,2,4
"7376","2929淘帝","110/08/23","元大-莒光",0,5,-5
"7377","2929淘帝","110/08/23","港商法國興業",4,0,4
"7378","2929淘帝","110/08/23","元大-左營",0,5,-5
"7379","2929淘帝","110/08/23","凱基-東門",4,0,4
"7380","2929淘帝","110/08/23","元大-鹿港",0,5,-5
"7381","5410國眾","110/08/23","港商野村",14,0,14
"7382","5410國眾","110/08/23","元大-崇德",0,22,-22
"7383","5410國眾","110/08/23","凱基-台北",14,3,11
"7384","5410國眾","110/08/23","元大-清水",0,15,-15
"7385","5410國眾","110/08/23","凱基-科園",10,0,10
"7386","5410國眾","110/08/23","元大-金華",0,10,-10
"7387","5410國眾","110/08/23","華南永昌-高雄",7,0,7
"7388","5410國眾","110/08/23","元大-中壢",0,9,-9
"7389","5410國眾","110/08/23","新加坡商瑞銀",6,0,6
"7390","5410國眾","110/08/23","日盛-台中",0,8,-8
"7391","5410國眾","110/08/23","國泰-台中",5,0,5
"7392","5410國眾","110/08/23","元大-前金",0,6,-6
"7393","5410國眾","110/08/23","國泰-桃園",5,0,5
"7394","5410國眾","110/08/23","華南永昌-公誠",0,5,-5
"7395","5410國眾","110/08/23","華南永昌-淡水",5,0,5
"7396","5410國眾","110/08/23","臺銀-高雄",0,4,-4
"7397","5410國眾","110/08/23","新光",2,0,2
"7398","5410國眾","110/08/23","華南永昌-鶯歌",1,5,-4
"7399","5410國眾","110/08/23","國泰-台南",2,0,2
"7400","5410國眾","110/08/23","元富-烏日",0,3,-3
"7401","5410國眾","110/08/23","凱基-桃園",2,0,2
"7402","5410國眾","110/08/23","富邦-桃園",0,3,-3
"7403","5410國眾","110/08/23","富邦-建國",2,0,2
"7404","5410國眾","110/08/23","元大-發財",0,2,-2
"7405","5410國眾","110/08/23","永豐金-敦北",2,0,2
"7406","5410國眾","110/08/23","元大-雙和",0,2,-2
"7407","5410國眾","110/08/23","日盛-園區",1,0,1
"7408","5410國眾","110/08/23","日盛-中和",0,1,-1
"7409","5410國眾","110/08/23","第一金-中壢",1,0,1
"7410","5410國眾","110/08/23","彰銀",0,1,-1
"7411","2841台開","110/08/23","宏遠-館前",300,0,300
"7412","2841台開","110/08/23","台中銀",0,74,-74
"7413","2841台開","110/08/23","第一金",54,0,54
"7414","2841台開","110/08/23","港商野村",0,62,-62
"7415","2841台開","110/08/23","元大-仁愛",38,0,38
"7416","2841台開","110/08/23","永豐金-敦南",10,58,-48
"7417","2841台開","110/08/23","合庫-三重",15,0,15
"7418","2841台開","110/08/23","台新-三民",0,39,-39
"7419","2841台開","110/08/23","玉山-新竹",15,0,15
"7420","2841台開","110/08/23","日盛證券",0,27,-27
"7421","2841台開","110/08/23","元大-大里德芳",10,0,10
"7422","2841台開","110/08/23","新光",13,37,-24
"7423","2841台開","110/08/23","元大-新莊",10,0,10
"7424","2841台開","110/08/23","凱基-虎尾",0,20,-20
"7425","2841台開","110/08/23","元富-緯城",5,0,5
"7426","2841台開","110/08/23","永豐金-忠孝",0,20,-20
"7427","2841台開","110/08/23","第一金-台南",4,0,4
"7428","2841台開","110/08/23","富邦-板橋",0,19,-19
"7429","2841台開","110/08/23","富邦-岡山",4,0,4
"7430","2841台開","110/08/23","凱基-東港",0,15,-15
"7431","2841台開","110/08/23","元大-虎尾",4,0,4
"7432","2841台開","110/08/23","國泰-敦南",0,11,-11
"7433","2841台開","110/08/23","元大-學甲",2,0,2
"7434","2841台開","110/08/23","元大-竹北",0,10,-10
"7435","2841台開","110/08/23","元大-草屯",2,0,2
"7436","2841台開","110/08/23","元大-彰化",1,11,-10
"7437","2841台開","110/08/23","台中銀-員林",1,0,1
"7438","2841台開","110/08/23","元大-北三重",0,10,-10
"7439","2841台開","110/08/23","台新-新營",1,0,1
"7440","2841台開","110/08/23","國泰-桃園",1,9,-8
"7441","6207雷科","110/08/23","摩根大通",29,6,23
"7442","6207雷科","110/08/23","元大-高雄",0,75,-75
"7443","6207雷科","110/08/23","凱基-台北",18,3,15
"7444","6207雷科","110/08/23","華南永昌-世貿",0,38,-38
"7445","6207雷科","110/08/23","安泰-楠梓",11,0,11
"7446","6207雷科","110/08/23","凱基-高雄",0,13,-13
"7447","6207雷科","110/08/23","凱基-頭份",12,1,11
"7448","6207雷科","110/08/23","港商野村",7,19,-12
"7449","6207雷科","110/08/23","群益金鼎-中壢",10,0,10
"7450","6207雷科","110/08/23","新加坡商瑞銀",1,13,-12
"7451","6207雷科","110/08/23","統一-中壢",9,0,9
"7452","6207雷科","110/08/23","元大-新莊",0,7,-7
"7453","6207雷科","110/08/23","元大-敦南",9,0,9
"7454","6207雷科","110/08/23","兆豐-公益",0,6,-6
"7455","6207雷科","110/08/23","瑞士信貸",8,0,8
"7456","6207雷科","110/08/23","合庫-高雄",0,5,-5
"7457","6207雷科","110/08/23","兆豐-嘉義",8,0,8
"7458","6207雷科","110/08/23","宏遠-高雄",0,5,-5
"7459","6207雷科","110/08/23","華南永昌-古亭",7,0,7
"7460","6207雷科","110/08/23","凱基-板橋",0,5,-5
"7461","6207雷科","110/08/23","富邦-陽明",7,0,7
"7462","6207雷科","110/08/23","群益金鼎-三民",0,4,-4
"7463","6207雷科","110/08/23","日盛-員林",6,0,6
"7464","6207雷科","110/08/23","群益金鼎-東門",0,4,-4
"7465","6207雷科","110/08/23","德信-新營",5,0,5
"7466","6207雷科","110/08/23","富邦-羅東",0,4,-4
"7467","6207雷科","110/08/23","凱基-高美館",5,0,5
"7468","6207雷科","110/08/23","元富-虎尾",0,3,-3
"7469","6207雷科","110/08/23","玉山-高雄",4,0,4
"7470","6207雷科","110/08/23","國泰-桃園",0,3,-3
"7471","3679新至陞","110/08/23","永豐金-南投",17,0,17
"7472","3679新至陞","110/08/23","港商法國興業",0,8,-8
"7473","3679新至陞","110/08/23","元富-埔里",9,0,9
"7474","3679新至陞","110/08/23","凱基-長庚",0,8,-8
"7475","3679新至陞","110/08/23","(牛牛牛)亞-網路",7,0,7
"7476","3679新至陞","110/08/23","宏遠-光隆",0,6,-6
"7477","3679新至陞","110/08/23","美林",7,1,6
"7478","3679新至陞","110/08/23","玉山-高雄",0,5,-5
"7479","3679新至陞","110/08/23","台灣摩根士丹利",5,0,5
"7480","3679新至陞","110/08/23","群益金鼎-高盛",0,3,-3
"7481","3679新至陞","110/08/23","瑞士信貸",6,1,5
"7482","3679新至陞","110/08/23","華南永昌-林口",0,3,-3
"7483","3679新至陞","110/08/23","元大-樹林",5,0,5
"7484","3679新至陞","110/08/23","元大證券",0,3,-3
"7485","3679新至陞","110/08/23","元大-文心興安",6,2,4
"7486","3679新至陞","110/08/23","元大-小港",0,3,-3
"7487","3679新至陞","110/08/23","凱基-台北",3,0,3
"7488","3679新至陞","110/08/23","統一-敦南",0,2,-2
"7489","3679新至陞","110/08/23","臺銀",2,0,2
"7490","3679新至陞","110/08/23","元富-大昌",0,2,-2
"7491","3679新至陞","110/08/23","臺銀-臺中",3,1,2
"7492","3679新至陞","110/08/23","玉山-新莊",0,2,-2
"7493","3679新至陞","110/08/23","新光-高雄",2,0,2
"7494","3679新至陞","110/08/23","群益金鼎-三民",0,2,-2
"7495","3679新至陞","110/08/23","華南永昌",2,0,2
"7496","3679新至陞","110/08/23","富邦-新竹",0,2,-2
"7497","3679新至陞","110/08/23","日盛-二林",1,0,1
"7498","3679新至陞","110/08/23","元大-敦化",0,2,-2
"7499","3679新至陞","110/08/23","新加坡商瑞銀",1,0,1
"7500","3679新至陞","110/08/23","永豐金-內湖",0,2,-2
"7501","2727王品","110/08/23","凱基-台北",163,48,115
"7502","2727王品","110/08/23","港商麥格理",0,51,-51
"7503","2727王品","110/08/23","台灣摩根士丹利",62,0,62
"7504","2727王品","110/08/23","國票-南港",0,50,-50
"7505","2727王品","110/08/23","元大-台中中港",58,0,58
"7506","2727王品","110/08/23","台新證券",9,35,-26
"7507","2727王品","110/08/23","美林",48,0,48
"7508","2727王品","110/08/23","元大-景美",2,21,-19
"7509","2727王品","110/08/23","摩根大通",73,41,32
"7510","2727王品","110/08/23","大慶-台南",0,15,-15
"7511","2727王品","110/08/23","港商野村",61,35,26
"7512","2727王品","110/08/23","中國信託-高雄",1,15,-14
"7513","2727王品","110/08/23","統一",21,4,17
"7514","2727王品","110/08/23","永豐金-市政",2,13,-11
"7515","2727王品","110/08/23","群益金鼎-大興",15,0,15
"7516","2727王品","110/08/23","第一金-桃園",0,10,-10
"7517","2727王品","110/08/23","台灣企銀",12,0,12
"7518","2727王品","110/08/23","玉山證券",1,11,-10
"7519","2727王品","110/08/23","新加坡商瑞銀",11,0,11
"7520","2727王品","110/08/23","凱基-三重",0,10,-10
"7521","2727王品","110/08/23","統一-三重",10,0,10
"7522","2727王品","110/08/23","富邦-建國",0,10,-10
"7523","2727王品","110/08/23","永豐金-竹科",13,3,10
"7524","2727王品","110/08/23","美商高盛",7,16,-9
"7525","2727王品","110/08/23","合庫-台中",10,1,9
"7526","2727王品","110/08/23","群益金鼎-三重",0,9,-9
"7527","2727王品","110/08/23","香港上海匯豐",9,0,9
"7528","2727王品","110/08/23","群益金鼎-宜蘭",0,9,-9
"7529","2727王品","110/08/23","凱基-台南",10,2,8
"7530","2727王品","110/08/23","凱基-高美館",0,9,-9
"7531","1570力肯","110/08/23","國票-和平",39,0,39
"7532","1570力肯","110/08/23","統一",0,28,-28
"7533","1570力肯","110/08/23","摩根大通",22,1,21
"7534","1570力肯","110/08/23","群益金鼎-東門",0,20,-20
"7535","1570力肯","110/08/23","臺銀",18,0,18
"7536","1570力肯","110/08/23","中國信託-嘉義",0,15,-15
"7537","1570力肯","110/08/23","台新-台中",18,0,18
"7538","1570力肯","110/08/23","台新證券",0,15,-15
"7539","1570力肯","110/08/23","凱基-台北",25,8,17
"7540","1570力肯","110/08/23","元富-世貿",0,10,-10
"7541","1570力肯","110/08/23","中農",10,0,10
"7542","1570力肯","110/08/23","國票-博愛",0,10,-10
"7543","1570力肯","110/08/23","瑞士信貸",5,0,5
"7544","1570力肯","110/08/23","元富-新興",0,9,-9
"7545","1570力肯","110/08/23","兆豐-松德",5,0,5
"7546","1570力肯","110/08/23","新光",0,9,-9
"7547","1570力肯","110/08/23","凱基-高美館",5,0,5
"7548","1570力肯","110/08/23","元大-四維",1,7,-6
"7549","1570力肯","110/08/23","凱基-幸福",5,0,5
"7550","1570力肯","110/08/23","元大-淡水",0,4,-4
"7551","1570力肯","110/08/23","元大-和平",20,15,5
"7552","1570力肯","110/08/23","元大-民生",0,4,-4
"7553","1570力肯","110/08/23","元大-草屯",5,0,5
"7554","1570力肯","110/08/23","元大-東港",0,4,-4
"7555","1570力肯","110/08/23","日盛-中壢",4,0,4
"7556","1570力肯","110/08/23","永豐金-松山",0,4,-4
"7557","1570力肯","110/08/23","國票-天祥",3,0,3
"7558","1570力肯","110/08/23","日盛-景美",0,3,-3
"7559","1570力肯","110/08/23","台灣企銀-屏東",2,0,2
"7560","1570力肯","110/08/23","中國信託-新竹",0,3,-3
"7561","6180橘子","110/08/23","凱基-台北",107,15,92
"7562","6180橘子","110/08/23","國泰-館前",2,28,-26
"7563","6180橘子","110/08/23","美林",50,0,50
"7564","6180橘子","110/08/23","元大-中壢",0,22,-22
"7565","6180橘子","110/08/23","摩根大通",66,24,42
"7566","6180橘子","110/08/23","華南永昌-鶯歌",0,21,-21
"7567","6180橘子","110/08/23","港商野村",38,2,36
"7568","6180橘子","110/08/23","台灣企銀-屏東",0,18,-18
"7569","6180橘子","110/08/23","元富-高雄",22,0,22
"7570","6180橘子","110/08/23","永豐金-中壢",0,18,-18
"7571","6180橘子","110/08/23","元大-上新莊",21,0,21
"7572","6180橘子","110/08/23","兆豐-台中",0,17,-17
"7573","6180橘子","110/08/23","福勝",19,1,18
"7574","6180橘子","110/08/23","新光-高雄",1,18,-17
"7575","6180橘子","110/08/23","富邦-內湖",13,2,11
"7576","6180橘子","110/08/23","台灣摩根士丹利",9,21,-12
"7577","6180橘子","110/08/23","永豐金證券",11,0,11
"7578","6180橘子","110/08/23","富邦-永和",0,12,-12
"7579","6180橘子","110/08/23","彰銀-七賢",10,0,10
"7580","6180橘子","110/08/23","合庫-自強",0,11,-11
"7581","6180橘子","110/08/23","中國信託-高雄",10,0,10
"7582","6180橘子","110/08/23","元大-發財",0,11,-11
"7583","6180橘子","110/08/23","兆豐-埔墘",10,0,10
"7584","6180橘子","110/08/23","第一金-新興",0,10,-10
"7585","6180橘子","110/08/23","群益金鼎-敦南",10,0,10
"7586","6180橘子","110/08/23","統一-中壢",0,10,-10
"7587","6180橘子","110/08/23","元大-台南",10,0,10
"7588","6180橘子","110/08/23","台新-屏東",0,10,-10
"7589","6180橘子","110/08/23","元大-左營",11,1,10
"7590","6180橘子","110/08/23","元大-旗山",0,10,-10
"7591","2390云辰","110/08/23","元大-土城學府",197,0,197
"7592","2390云辰","110/08/23","凱基-台北",87,301,-214
"7593","2390云辰","110/08/23","新光-台中",154,34,120
"7594","2390云辰","110/08/23","兆豐-公益",4,173,-169
"7595","2390云辰","110/08/23","宏遠證券",100,0,100
"7596","2390云辰","110/08/23","國票-博愛",65,200,-135
"7597","2390云辰","110/08/23","凱基-林口",92,0,92
"7598","2390云辰","110/08/23","群益金鼎-三重",8,112,-104
"7599","2390云辰","110/08/23","統一-新台中",83,1,82
"7600","2390云辰","110/08/23","日盛-園區",4,104,-100
"7601","2390云辰","110/08/23","凱基-竹北",62,8,54
"7602","2390云辰","110/08/23","凱基-屏東",1,101,-100
"7603","2390云辰","110/08/23","華南永昌-公誠",66,15,51
"7604","2390云辰","110/08/23","富邦-花蓮",2,100,-98
"7605","2390云辰","110/08/23","國泰-敦南",172,129,43
"7606","2390云辰","110/08/23","摩根大通",83,162,-79
"7607","2390云辰","110/08/23","統一-新竹",44,7,37
"7608","2390云辰","110/08/23","元富-花蓮",2,74,-72
"7609","2390云辰","110/08/23","元大-沙鹿",73,39,34
"7610","2390云辰","110/08/23","第一金-安和",32,101,-69
"7611","2390云辰","110/08/23","元大-新盛",47,16,31
"7612","2390云辰","110/08/23","美商高盛",26,92,-66
"7613","2390云辰","110/08/23","華南永昌-鳳山",29,3,26
"7614","2390云辰","110/08/23","統一-三重",6,71,-65
"7615","2390云辰","110/08/23","大昌-樹林",34,9,25
"7616","2390云辰","110/08/23","富邦-嘉義",195,260,-65
"7617","2390云辰","110/08/23","富邦-陽明",59,34,25
"7618","2390云辰","110/08/23","元大-忠孝鼎富",0,50,-50
"7619","2390云辰","110/08/23","富邦-宜蘭",28,3,25
"7620","2390云辰","110/08/23","統一-城中",7,53,-46
"7621","1315達新","110/08/20","日盛-和美",16,0,16
"7622","1315達新","110/08/20","香港上海匯豐",0,41,-41
"7623","1315達新","110/08/20","元富-成功",10,0,10
"7624","1315達新","110/08/20","元大-文心興安",2,36,-34
"7625","1315達新","110/08/20","兆豐-台中",10,0,10
"7626","1315達新","110/08/20","港商麥格理",0,26,-26
"7627","1315達新","110/08/20","凱基-中港",10,0,10
"7628","1315達新","110/08/20","元富",0,14,-14
"7629","1315達新","110/08/20","元大-桃園",8,0,8
"7630","1315達新","110/08/20","元富-敦南",0,8,-8
"7631","1315達新","110/08/20","凱基-高美館",7,0,7
"7632","1315達新","110/08/20","凱基-台北",7,15,-8
"7633","1315達新","110/08/20","統一",5,0,5
"7634","1315達新","110/08/20","元大-花蓮",2,10,-8
"7635","1315達新","110/08/20","中國信託-高雄",5,0,5
"7636","1315達新","110/08/20","摩根大通",0,7,-7
"7637","1315達新","110/08/20","致和-東門",5,0,5
"7638","1315達新","110/08/20","(牛牛牛)亞證券",0,6,-6
"7639","1315達新","110/08/20","國票-北高雄",5,0,5
"7640","1315達新","110/08/20","群益金鼎-鳳山",0,6,-6
"7641","1315達新","110/08/20","國票-桃園",5,0,5
"7642","1315達新","110/08/20","美林",3,8,-5
"7643","1315達新","110/08/20","凱基-高雄",5,0,5
"7644","1315達新","110/08/20","玉山-大里",0,4,-4
"7645","1315達新","110/08/20","凱基-大安",5,0,5
"7646","1315達新","110/08/20","國票-安和",1,4,-3
"7647","1315達新","110/08/20","新光",5,1,4
"7648","1315達新","110/08/20","永興-台中",0,1,-1
"7649","1315達新","110/08/20","國泰-敦南",4,0,4
"7650","1315達新","110/08/20","光和-花壇",0,1,-1
"7651","2609陽明","110/08/20","摩根大通",7094,4108,2986
"7652","2609陽明","110/08/20","富邦證券",916,4167,-3251
"7653","2609陽明","110/08/20","凱基-台北",3009,829,2180
"7654","2609陽明","110/08/20","瑞士信貸",1961,3747,-1786
"7655","2609陽明","110/08/20","永豐金-信義",2022,49,1973
"7656","2609陽明","110/08/20","美林",3367,4938,-1571
"7657","2609陽明","110/08/20","富邦-虎尾",14038,12509,1529
"7658","2609陽明","110/08/20","元大證券",1688,3204,-1516
"7659","2609陽明","110/08/20","華南永昌-竹北",2009,531,1478
"7660","2609陽明","110/08/20","凱基-高美館",303,786,-483
"7661","2609陽明","110/08/20","群益金鼎-大安",1208,64,1144
"7662","2609陽明","110/08/20","日盛-板橋",125,587,-462
"7663","2609陽明","110/08/20","康和",5625,4754,871
"7664","2609陽明","110/08/20","富邦-北港",163,571,-408
"7665","2609陽明","110/08/20","兆豐-虎尾",919,77,842
"7666","2609陽明","110/08/20","凱基-台南",165,557,-392
"7667","2609陽明","110/08/20","新加坡商瑞銀",1133,390,743
"7668","2609陽明","110/08/20","元大-樹林",215,599,-384
"7669","2609陽明","110/08/20","統一-仁愛",1379,702,677
"7670","2609陽明","110/08/20","富邦-台中",246,596,-350
"7671","2609陽明","110/08/20","美商高盛",1051,452,599
"7672","2609陽明","110/08/20","凱基-復興",141,467,-326
"7673","2609陽明","110/08/20","凱基-市府",658,82,576
"7674","2609陽明","110/08/20","台新-高雄",483,807,-324
"7675","2609陽明","110/08/20","元大-新莊",665,169,496
"7676","2609陽明","110/08/20","日盛證券",323,619,-296
"7677","2609陽明","110/08/20","台灣摩根士丹利",773,365,408
"7678","2609陽明","110/08/20","法銀巴黎",0,292,-292
"7679","2609陽明","110/08/20","日盛-雙和",550,197,353
"7680","2609陽明","110/08/20","元大-北投",454,729,-275
"7681","2636台驊投控","110/08/20","摩根大通",709,415,294
"7682","2636台驊投控","110/08/20","台灣摩根士丹利",146,252,-106
"7683","2636台驊投控","110/08/20","台新-台中",176,64,112
"7684","2636台驊投控","110/08/20","港商野村",1266,1357,-91
"7685","2636台驊投控","110/08/20","統一",191,91,100
"7686","2636台驊投控","110/08/20","美林",246,335,-89
"7687","2636台驊投控","110/08/20","永豐金-萬盛",136,39,97
"7688","2636台驊投控","110/08/20","宏遠-新化",1,75,-74
"7689","2636台驊投控","110/08/20","永豐金-南京",105,33,72
"7690","2636台驊投控","110/08/20","群益金鼎-竹南",5,69,-64
"7691","2636台驊投控","110/08/20","日盛-景美",102,32,70
"7692","2636台驊投控","110/08/20","日盛-大墩",4,56,-52
"7693","2636台驊投控","110/08/20","日盛證券",154,103,51
"7694","2636台驊投控","110/08/20","第一金-台中",5,56,-51
"7695","2636台驊投控","110/08/20","第一金-桃園",54,7,47
"7696","2636台驊投控","110/08/20","日盛-宜蘭",2,52,-50
"7697","2636台驊投控","110/08/20","統一-基隆",47,5,42
"7698","2636台驊投控","110/08/20","兆豐-南京",0,49,-49
"7699","2636台驊投控","110/08/20","元富-城東",63,22,41
"7700","2636台驊投控","110/08/20","合庫-新竹",4,47,-43
"7701","2636台驊投控","110/08/20","富邦-建國",67,35,32
"7702","2636台驊投控","110/08/20","統一-城中",6,33,-27
"7703","2636台驊投控","110/08/20","元大-桃興",40,10,30
"7704","2636台驊投控","110/08/20","凱基-科園",7,34,-27
"7705","2636台驊投控","110/08/20","土銀-南港",34,6,28
"7706","2636台驊投控","110/08/20","新光",167,193,-26
"7707","2636台驊投控","110/08/20","永豐金-台南",54,27,27
"7708","2636台驊投控","110/08/20","群益金鼎-古亭",51,75,-24
"7709","2636台驊投控","110/08/20","富邦-台北",45,19,26
"7710","2636台驊投控","110/08/20","富邦-仁愛",51,74,-23
"7711","2867三商壽","110/08/20","凱基-台北",225,43,182
"7712","2867三商壽","110/08/20","宏遠證券",0,1023,-1023
"7713","2867三商壽","110/08/20","元大-土城永寧",150,2,148
"7714","2867三商壽","110/08/20","摩根大通",123,551,-428
"7715","2867三商壽","110/08/20","新光",213,72,141
"7716","2867三商壽","110/08/20","美商高盛",62,194,-132
"7717","2867三商壽","110/08/20","臺銀-鳳山",131,26,105
"7718","2867三商壽","110/08/20","國票-中正",0,130,-130
"7719","2867三商壽","110/08/20","元大-屏東民生",100,0,100
"7720","2867三商壽","110/08/20","美林",1,114,-113
"7721","2867三商壽","110/08/20","元大-桃園",100,1,99
"7722","2867三商壽","110/08/20","台灣摩根士丹利",31,107,-76
"7723","2867三商壽","110/08/20","永豐金-埔里",94,20,74
"7724","2867三商壽","110/08/20","富邦-中壢",1,75,-74
"7725","2867三商壽","110/08/20","土銀-台中",60,0,60
"7726","2867三商壽","110/08/20","華南永昌-南京",10,70,-60
"7727","2867三商壽","110/08/20","臺銀-高雄",56,1,55
"7728","2867三商壽","110/08/20","富邦-彰化",10,67,-57
"7729","2867三商壽","110/08/20","統一-台南",55,0,55
"7730","2867三商壽","110/08/20","凱基-高美館",0,50,-50
"7731","2867三商壽","110/08/20","富邦-仁愛",53,0,53
"7732","2867三商壽","110/08/20","港商野村",35,68,-33
"7733","2867三商壽","110/08/20","富邦-台北",44,1,43
"7734","2867三商壽","110/08/20","台新-高雄",1,31,-30
"7735","2867三商壽","110/08/20","合庫-高雄",40,0,40
"7736","2867三商壽","110/08/20","元大-北屯",9,36,-27
"7737","2867三商壽","110/08/20","華南永昌-虎尾",50,10,40
"7738","2867三商壽","110/08/20","法銀巴黎",1,27,-26
"7739","2867三商壽","110/08/20","富邦-宜蘭",40,0,40
"7740","2867三商壽","110/08/20","日盛-中壢",0,20,-20
"7741","5521工信","110/08/20","元大-內湖",55,0,55
"7742","5521工信","110/08/20","美商高盛",0,182,-182
"7743","5521工信","110/08/20","日進",36,0,36
"7744","5521工信","110/08/20","摩根大通",39,180,-141
"7745","5521工信","110/08/20","兆豐-來福",30,0,30
"7746","5521工信","110/08/20","凱基-台北",0,101,-101
"7747","5521工信","110/08/20","元大-屏南",30,0,30
"7748","5521工信","110/08/20","富邦-岡山",0,50,-50
"7749","5521工信","110/08/20","台新證券",26,4,22
"7750","5521工信","110/08/20","港商野村",0,41,-41
"7751","5521工信","110/08/20","玉山-台大",25,5,20
"7752","5521工信","110/08/20","台灣摩根士丹利",1,30,-29
"7753","5521工信","110/08/20","群益金鼎-忠孝",20,0,20
"7754","5521工信","110/08/20","群益金鼎-高雄",0,20,-20
"7755","5521工信","110/08/20","富邦-台北",20,0,20
"7756","5521工信","110/08/20","華南永昌-中正",0,20,-20
"7757","5521工信","110/08/20","永豐金-中正",19,0,19
"7758","5521工信","110/08/20","台新-新營",0,19,-19
"7759","5521工信","110/08/20","統一-員林",15,0,15
"7760","5521工信","110/08/20","華南永昌-彰化",2,20,-18
"7761","5521工信","110/08/20","合庫-桃園",12,0,12
"7762","5521工信","110/08/20","群益金鼎-潭子",0,15,-15
"7763","5521工信","110/08/20","陽信-石牌",11,0,11
"7764","5521工信","110/08/20","元大-板橋",0,15,-15
"7765","5521工信","110/08/20","元大-基隆孝二",11,0,11
"7766","5521工信","110/08/20","元大-南屯",1,15,-14
"7767","5521工信","110/08/20","土銀-白河",10,0,10
"7768","5521工信","110/08/20","永豐金-桃盛",0,10,-10
"7769","5521工信","110/08/20","華南永昌-大安",10,0,10
"7770","5521工信","110/08/20","聯邦-雙和",0,8,-8
"7771","1471首利","110/08/20","富邦-員林",41,0,41
"7772","1471首利","110/08/20","元大-草屯",1,100,-99
"7773","1471首利","110/08/20","摩根大通",88,63,25
"7774","1471首利","110/08/20","元富-民權",0,41,-41
"7775","1471首利","110/08/20","永豐金-板盛",23,0,23
"7776","1471首利","110/08/20","致和-府前",0,20,-20
"7777","1471首利","110/08/20","台新證券",30,11,19
"7778","1471首利","110/08/20","大慶-蘆洲",0,14,-14
"7779","1471首利","110/08/20","日盛-高雄",15,0,15
"7780","1471首利","110/08/20","凱基-台北",3,16,-13
"7781","1471首利","110/08/20","瑞士信貸",36,21,15
"7782","1471首利","110/08/20","玉山-新莊",1,12,-11
"7783","1471首利","110/08/20","元大-成功",15,0,15
"7784","1471首利","110/08/20","日盛-樹林",0,10,-10
"7785","1471首利","110/08/20","元大-鳳山",13,0,13
"7786","1471首利","110/08/20","台中銀-豐原",0,10,-10
"7787","1471首利","110/08/20","美林",11,0,11
"7788","1471首利","110/08/20","國票-新莊",0,10,-10
"7789","1471首利","110/08/20","兆豐-西螺",10,0,10
"7790","1471首利","110/08/20","元大-開元",0,10,-10
"7791","1471首利","110/08/20","台新-台南",10,0,10
"7792","1471首利","110/08/20","新光",9,18,-9
"7793","1471首利","110/08/20","新光-台中",7,0,7
"7794","1471首利","110/08/20","元大-台中",0,8,-8
"7795","1471首利","110/08/20","凱基-長庚",7,0,7
"7796","1471首利","110/08/20","富邦-竹東",0,7,-7
"7797","1471首利","110/08/20","日盛-大墩",6,0,6
"7798","1471首利","110/08/20","元大-善化",0,7,-7
"7799","1471首利","110/08/20","國泰-敦南",6,0,6
"7800","1471首利","110/08/20","永豐金-忠孝",0,7,-7
"7801","2883開發金","110/08/20","美商高盛",5045,274,4771
"7802","2883開發金","110/08/20","元大-草屯",110,5813,-5703
"7803","2883開發金","110/08/20","摩根大通",6375,3996,2379
"7804","2883開發金","110/08/20","元大-雙和",35,5050,-5015
"7805","2883開發金","110/08/20","瑞士信貸",2180,184,1996
"7806","2883開發金","110/08/20","元富",228,2528,-2300
"7807","2883開發金","110/08/20","港商野村",4455,2645,1810
"7808","2883開發金","110/08/20","新光",2896,4495,-1599
"7809","2883開發金","110/08/20","美林",1695,187,1508
"7810","2883開發金","110/08/20","法銀巴黎",12,1549,-1537
"7811","2883開發金","110/08/20","凱基-台北",3659,2336,1323
"7812","2883開發金","110/08/20","統一",61,1390,-1329
"7813","2883開發金","110/08/20","富邦證券",1343,39,1304
"7814","2883開發金","110/08/20","台灣匯立證券",0,995,-995
"7815","2883開發金","110/08/20","臺銀",1447,177,1270
"7816","2883開發金","110/08/20","台灣摩根士丹利",1050,1929,-879
"7817","2883開發金","110/08/20","國泰證券",1228,72,1156
"7818","2883開發金","110/08/20","元大-前金",15,785,-770
"7819","2883開發金","110/08/20","華南永昌",1230,198,1032
"7820","2883開發金","110/08/20","元大-桃興",64,796,-732
"7821","2883開發金","110/08/20","元大證券",1137,317,820
"7822","2883開發金","110/08/20","宏遠-台南",80,759,-679
"7823","2883開發金","110/08/20","致和證券",819,0,819
"7824","2883開發金","110/08/20","合庫證券",245,861,-616
"7825","2883開發金","110/08/20","元大-善化",756,83,673
"7826","2883開發金","110/08/20","元大-大灣",46,660,-614
"7827","2883開發金","110/08/20","元大-新莊",731,108,623
"7828","2883開發金","110/08/20","國票-南港",32,641,-609
"7829","2883開發金","110/08/20","凱基",520,10,510
"7830","2883開發金","110/08/20","群益金鼎-開元",30,551,-521
"7831","6205詮欣","110/08/20","聯邦商銀",27,0,27
"7832","6205詮欣","110/08/20","凱基-新店",0,24,-24
"7833","6205詮欣","110/08/20","凱基-汐止",25,0,25
"7834","6205詮欣","110/08/20","元大-忠孝",0,18,-18
"7835","6205詮欣","110/08/20","元大-汐止",10,0,10
"7836","6205詮欣","110/08/20","瑞士信貸",0,17,-17
"7837","6205詮欣","110/08/20","臺銀-臺中",7,0,7
"7838","6205詮欣","110/08/20","摩根大通",2,11,-9
"7839","6205詮欣","110/08/20","統一-基隆",7,0,7
"7840","6205詮欣","110/08/20","日盛-永康",0,5,-5
"7841","6205詮欣","110/08/20","臺銀-高雄",6,0,6
"7842","6205詮欣","110/08/20","聯邦-興中",0,5,-5
"7843","6205詮欣","110/08/20","臺銀-民權",5,0,5
"7844","6205詮欣","110/08/20","華南永昌-公誠",0,5,-5
"7845","6205詮欣","110/08/20","亞東",4,0,4
"7846","6205詮欣","110/08/20","元大-西螺",0,5,-5
"7847","6205詮欣","110/08/20","玉山證券",4,0,4
"7848","6205詮欣","110/08/20","群益金鼎-永和",0,4,-4
"7849","6205詮欣","110/08/20","華南永昌-古亭",4,0,4
"7850","6205詮欣","110/08/20","元大-新竹經國",0,4,-4
"7851","6205詮欣","110/08/20","元大-博愛",4,0,4
"7852","6205詮欣","110/08/20","永興-大墩",0,3,-3
"7853","6205詮欣","110/08/20","元富-草屯",3,0,3
"7854","6205詮欣","110/08/20","國票-和平",0,3,-3
"7855","6205詮欣","110/08/20","合庫-鳳山",2,0,2
"7856","6205詮欣","110/08/20","國泰-敦南",0,3,-3
"7857","6205詮欣","110/08/20","日進",2,0,2
"7858","6205詮欣","110/08/20","華南永昌",0,3,-3
"7859","6205詮欣","110/08/20","凱基-苗栗",2,0,2
"7860","6205詮欣","110/08/20","永豐金-新竹",0,3,-3
"7861","1540喬福","110/08/20","富邦-員林",11,0,11
"7862","1540喬福","110/08/20","元大-北三重",0,12,-12
"7863","1540喬福","110/08/20","永豐金-鳳山",5,0,5
"7864","1540喬福","110/08/20","元大-土城永寧",0,10,-10
"7865","1540喬福","110/08/20","亞東",4,0,4
"7866","1540喬福","110/08/20","新光-新竹",1,6,-5
"7867","1540喬福","110/08/20","新光",3,0,3
"7868","1540喬福","110/08/20","富邦-台南",0,5,-5
"7869","1540喬福","110/08/20","日盛-頭份",2,0,2
"7870","1540喬福","110/08/20","元大-龍潭",0,5,-5
"7871","1540喬福","110/08/20","第一金-嘉義",2,0,2
"7872","1540喬福","110/08/20","日盛-台中",0,2,-2
"7873","1540喬福","110/08/20","兆豐-鹿港",2,0,2
"7874","1540喬福","110/08/20","元大-東港",0,1,-1
"7875","1540喬福","110/08/20","摩根大通",2,0,2
"7876","1540喬福","110/08/20","日盛-板橋",0,0,0
"7877","1540喬福","110/08/20","玉山-桃園",1,0,1
"7878","1540喬福","110/08/20","元富",1,1,0
"7879","1540喬福","110/08/20","凱基-台北",1,0,1
"7880","1540喬福","110/08/20","康和-板橋",0,0,0
"7881","1540喬福","110/08/20","凱基-嘉義",1,0,1
"7882","1540喬福","110/08/20","國泰-敦南",0,0,0
"7883","1540喬福","110/08/20","凱基-市府",1,0,1
"7884","1540喬福","110/08/20","群益金鼎-板橋",0,0,0
"7885","1540喬福","110/08/20","群益金鼎-潭子",1,0,1
"7886","1540喬福","110/08/20","富邦-桃園",0,0,0
"7887","1540喬福","110/08/20","台灣企銀-建成",1,0,1
"7888","1540喬福","110/08/20","元大-西門",0,0,0
"7889","1540喬福","110/08/20","國票-天祥",1,0,1
"7890","1540喬福","110/08/20","元大-草屯",0,0,0
"7891","2888新光金","110/08/20","元富",2479,10,2469
"7892","2888新光金","110/08/20","摩根大通",2428,8920,-6492
"7893","2888新光金","110/08/20","華南永昌",1300,1,1299
"7894","2888新光金","110/08/20","台灣摩根士丹利",272,5505,-5233
"7895","2888新光金","110/08/20","凱基-頭份",1104,10,1094
"7896","2888新光金","110/08/20","美商高盛",23,4545,-4522
"7897","2888新光金","110/08/20","新光",1484,401,1083
"7898","2888新光金","110/08/20","瑞士信貸",62,1483,-1421
"7899","2888新光金","110/08/20","元大證券",1044,239,805
"7900","2888新光金","110/08/20","港商法國興業",66,1075,-1009
"7901","2888新光金","110/08/20","國票-北高雄",711,0,711
"7902","2888新光金","110/08/20","元大-大雅",47,998,-951
"7903","2888新光金","110/08/20","兆豐-台中港",629,0,629
"7904","2888新光金","110/08/20","法銀巴黎",449,1363,-914
"7905","2888新光金","110/08/20","臺銀",509,9,500
"7906","2888新光金","110/08/20","國票-九鼎",27,911,-884
"7907","2888新光金","110/08/20","國泰-忠孝",491,53,438
"7908","2888新光金","110/08/20","港商野村",79,637,-558
"7909","2888新光金","110/08/20","國泰-敦南",466,37,429
"7910","2888新光金","110/08/20","群益金鼎-瑞豐",11,560,-549
"7911","2888新光金","110/08/20","台中銀",442,30,412
"7912","2888新光金","110/08/20","德信-和平",8,500,-492
"7913","2888新光金","110/08/20","富邦-南屯",429,30,399
"7914","2888新光金","110/08/20","元大-大天母",54,452,-398
"7915","2888新光金","110/08/20","元大-三重",338,11,327
"7916","2888新光金","110/08/20","合庫證券",34,393,-359
"7917","2888新光金","110/08/20","永豐金-大園",326,10,316
"7918","2888新光金","110/08/20","群益金鼎",16,358,-342
"7919","2888新光金","110/08/20","北城證券",306,6,300
"7920","2888新光金","110/08/20","群益金鼎-板橋",6,304,-298
"7921","1340勝悅","110/08/20","元富-成功",23,0,23
"7922","1340勝悅","110/08/20","摩根大通",0,13,-13
"7923","1340勝悅","110/08/20","華南永昌-高雄",11,0,11
"7924","1340勝悅","110/08/20","港商法國興業",0,10,-10
"7925","1340勝悅","110/08/20","統一-城中",8,2,6
"7926","1340勝悅","110/08/20","凱基-東勢",0,10,-10
"7927","1340勝悅","110/08/20","元大-北成功",6,0,6
"7928","1340勝悅","110/08/20","元大-楊梅",0,10,-10
"7929","1340勝悅","110/08/20","臺銀-臺中",5,0,5
"7930","1340勝悅","110/08/20","華南永昌-東昇",0,9,-9
"7931","1340勝悅","110/08/20","臺灣企銀-埔墘",5,0,5
"7932","1340勝悅","110/08/20","合庫-自強",0,5,-5
"7933","1340勝悅","110/08/20","日盛-板橋",5,0,5
"7934","1340勝悅","110/08/20","兆豐-新竹",0,5,-5
"7935","1340勝悅","110/08/20","美商高盛",4,0,4
"7936","1340勝悅","110/08/20","玉山-桃園",0,5,-5
"7937","1340勝悅","110/08/20","大昌",3,0,3
"7938","1340勝悅","110/08/20","元大-復北",0,5,-5
"7939","1340勝悅","110/08/20","台中銀",2,0,2
"7940","1340勝悅","110/08/20","兆豐-來福",0,4,-4
"7941","1340勝悅","110/08/20","新光-台中",2,0,2
"7942","1340勝悅","110/08/20","新光",0,4,-4
"7943","1340勝悅","110/08/20","群益金鼎-崇德",2,0,2
"7944","1340勝悅","110/08/20","瑞士信貸",0,3,-3
"7945","1340勝悅","110/08/20","群益金鼎-館前",2,0,2
"7946","1340勝悅","110/08/20","台新證券",0,3,-3
"7947","1340勝悅","110/08/20","華南永昌-忠孝",2,0,2
"7948","1340勝悅","110/08/20","臺銀-鳳山",0,2,-2
"7949","1340勝悅","110/08/20","富邦-北港",2,0,2
"7950","1340勝悅","110/08/20","美林",0,2,-2
"7951","6246臺龍","110/08/20","新光-台中",18,0,18
"7952","6246臺龍","110/08/20","元大-林園",0,20,-20
"7953","6246臺龍","110/08/20","凱基-台北",15,0,15
"7954","6246臺龍","110/08/20","凱基-永和",1,15,-14
"7955","6246臺龍","110/08/20","元大-台北",8,0,8
"7956","6246臺龍","110/08/20","凱基-竹北",0,12,-12
"7957","6246臺龍","110/08/20","元大-北屯",6,0,6
"7958","6246臺龍","110/08/20","富邦-桃園",0,6,-6
"7959","6246臺龍","110/08/20","臺銀-臺中",4,0,4
"7960","6246臺龍","110/08/20","國泰-敦南",0,5,-5
"7961","6246臺龍","110/08/20","元富-吉利",4,0,4
"7962","6246臺龍","110/08/20","日盛證券",0,3,-3
"7963","6246臺龍","110/08/20","凱基-內湖",4,0,4
"7964","6246臺龍","110/08/20","第一金-台南",0,3,-3
"7965","6246臺龍","110/08/20","富邦-建國",4,0,4
"7966","6246臺龍","110/08/20","第一金-桃園",0,3,-3
"7967","6246臺龍","110/08/20","宏遠-新化",3,0,3
"7968","6246臺龍","110/08/20","群益金鼎-北高雄",0,3,-3
"7969","6246臺龍","110/08/20","第一金-大稻埕",2,0,2
"7970","6246臺龍","110/08/20","凱基-虎尾",0,3,-3
"7971","6246臺龍","110/08/20","國票-敦北法人",2,0,2
"7972","6246臺龍","110/08/20","元大-博愛",0,3,-3
"7973","6246臺龍","110/08/20","群益金鼎-開元",2,0,2
"7974","6246臺龍","110/08/20","統一-新竹",0,2,-2
"7975","6246臺龍","110/08/20","元大-竹山",2,0,2
"7976","6246臺龍","110/08/20","元富-新店",0,2,-2
"7977","6246臺龍","110/08/20","元大-上新莊",2,0,2
"7978","6246臺龍","110/08/20","元富-烏日",0,2,-2
"7979","6246臺龍","110/08/20","元大-土城",2,0,2
"7980","6246臺龍","110/08/20","台新-中壢",0,2,-2
"7981","00715L期街口布蘭特正2","110/08/20","新光",1501,206,1295
"7982","00715L期街口布蘭特正2","110/08/20","元大證券",460,5183,-4723
"7983","00715L期街口布蘭特正2","110/08/20","富邦-南屯",671,15,656
"7984","00715L期街口布蘭特正2","110/08/20","合庫證券",9,3350,-3341
"7985","00715L期街口布蘭特正2","110/08/20","元大-復北",756,120,636
"7986","00715L期街口布蘭特正2","110/08/20","康和",603,2255,-1652
"7987","00715L期街口布蘭特正2","110/08/20","華南永昌",555,0,555
"7988","00715L期街口布蘭特正2","110/08/20","群益金鼎",0,1488,-1488
"7989","00715L期街口布蘭特正2","110/08/20","玉山證券",525,32,493
"7990","00715L期街口布蘭特正2","110/08/20","凱基-台北",57,1280,-1223
"7991","00715L期街口布蘭特正2","110/08/20","第一金-華江",472,1,471
"7992","00715L期街口布蘭特正2","110/08/20","統一-台中",34,1238,-1204
"7993","00715L期街口布蘭特正2","110/08/20","元大-西屯",412,0,412
"7994","00715L期街口布蘭特正2","110/08/20","國票",306,1276,-970
"7995","00715L期街口布蘭特正2","110/08/20","第一金-豐原",390,0,390
"7996","00715L期街口布蘭特正2","110/08/20","富邦證券",2234,2995,-761
"7997","00715L期街口布蘭特正2","110/08/20","元大-北港",374,0,374
"7998","00715L期街口布蘭特正2","110/08/20","日盛-新莊",221,825,-604
"7999","00715L期街口布蘭特正2","110/08/20","華南永昌-台中",379,10,369
"8000","00715L期街口布蘭特正2","110/08/20","台新-台中",169,711,-542
"8001","00715L期街口布蘭特正2","110/08/20","玉山-新竹",345,10,335
"8002","00715L期街口布蘭特正2","110/08/20","元富",0,507,-507
"8003","00715L期街口布蘭特正2","110/08/20","元大-草屯",413,88,325
"8004","00715L期街口布蘭特正2","110/08/20","台中銀",90,452,-362
"8005","00715L期街口布蘭特正2","110/08/20","日盛-二林",307,1,306
"8006","00715L期街口布蘭特正2","110/08/20","凱基-中壢",98,442,-344
"8007","00715L期街口布蘭特正2","110/08/20","凱基-站前",306,0,306
"8008","00715L期街口布蘭特正2","110/08/20","台新證券",312,644,-332
"8009","00715L期街口布蘭特正2","110/08/20","新光-台中",308,23,285
"8010","00715L期街口布蘭特正2","110/08/20","元大-林森",1,252,-251
"8011","8941關中","110/08/20","合庫-彰化",1,0,1
"8012","8941關中","110/08/20","大慶-富順",0,1,-1
"8013","8941關中","110/08/20","凱基-市府",1,0,1
"8014","8941關中","110/08/20","國泰-忠孝",0,1,-1
"8015","8941關中","110/08/20","玉山-台大",0,0,0
"8016","8941關中","110/08/20","玉山-台大",0,0,0
"8017","8941關中","110/08/20","國泰-高雄",0,0,0
"8018","8941關中","110/08/20","國泰-高雄",0,0,0
"8019","8941關中","110/08/20","元大-南投",0,0,0
"8020","8941關中","110/08/20","元大-南投",0,0,0
"8021","8941關中","110/08/20","永豐金-萬盛",0,0,0
"8022","8941關中","110/08/20","永豐金-萬盛",0,0,0
"8023","8941關中","110/08/20","永豐金-南投",0,0,0
"8024","8941關中","110/08/20","永豐金-南投",0,0,0
"8025","8941關中","110/08/20","",NA,NA,NA
"8026","8941關中","110/08/20","",NA,NA,NA
"8027","8941關中","110/08/20","",NA,NA,NA
"8028","8941關中","110/08/20","",NA,NA,NA
"8029","8941關中","110/08/20","",NA,NA,NA
"8030","8941關中","110/08/20","",NA,NA,NA
"8031","8941關中","110/08/20","",NA,NA,NA
"8032","8941關中","110/08/20","",NA,NA,NA
"8033","8941關中","110/08/20","",NA,NA,NA
"8034","8941關中","110/08/20","",NA,NA,NA
"8035","8941關中","110/08/20","",NA,NA,NA
"8036","8941關中","110/08/20","",NA,NA,NA
"8037","8941關中","110/08/20","",NA,NA,NA
"8038","8941關中","110/08/20","",NA,NA,NA
"8039","8941關中","110/08/20","",NA,NA,NA
"8040","8941關中","110/08/20","",NA,NA,NA
"8041","8936國統","110/08/20","美林",81,0,81
"8042","8936國統","110/08/20","國票-和平",0,75,-75
"8043","8936國統","110/08/20","宏遠-台南",82,29,53
"8044","8936國統","110/08/20","台灣摩根士丹利",9,55,-46
"8045","8936國統","110/08/20","台中銀-高雄",51,0,51
"8046","8936國統","110/08/20","美商高盛",6,33,-27
"8047","8936國統","110/08/20","富邦-岡山",35,0,35
"8048","8936國統","110/08/20","凱基-高美館",6,33,-27
"8049","8936國統","110/08/20","港商野村",73,43,30
"8050","8936國統","110/08/20","新光-台中",18,43,-25
"8051","8936國統","110/08/20","康和-高雄",30,0,30
"8052","8936國統","110/08/20","凱基-中山",0,17,-17
"8053","8936國統","110/08/20","瑞士信貸",15,0,15
"8054","8936國統","110/08/20","玉山-城中",3,17,-14
"8055","8936國統","110/08/20","兆豐-北高雄",14,0,14
"8056","8936國統","110/08/20","日盛-頭份",0,12,-12
"8057","8936國統","110/08/20","元大-汐止",11,0,11
"8058","8936國統","110/08/20","日盛-大墩",0,10,-10
"8059","8936國統","110/08/20","玉山-左營",10,0,10
"8060","8936國統","110/08/20","凱基-台北",34,44,-10
"8061","8936國統","110/08/20","元大-路竹",10,0,10
"8062","8936國統","110/08/20","元大-高雄",0,10,-10
"8063","8936國統","110/08/20","永豐金-南投",10,0,10
"8064","8936國統","110/08/20","元富-同大",0,8,-8
"8065","8936國統","110/08/20","臺銀",8,2,6
"8066","8936國統","110/08/20","元大-鑫永和",0,8,-8
"8067","8936國統","110/08/20","大昌-新店",5,0,5
"8068","8936國統","110/08/20","日盛-豐原",0,7,-7
"8069","8936國統","110/08/20","國票-內壢",5,0,5
"8070","8936國統","110/08/20","第一金-路竹",0,7,-7
"8071","6226光鼎","110/08/20","美商高盛",388,14,374
"8072","6226光鼎","110/08/20","國泰-台中",62,142,-80
"8073","6226光鼎","110/08/20","台灣摩根士丹利",347,26,321
"8074","6226光鼎","110/08/20","元大-北屯",27,101,-74
"8075","6226光鼎","110/08/20","元大-文心興安",238,8,230
"8076","6226光鼎","110/08/20","永豐金-竹科",0,69,-69
"8077","6226光鼎","110/08/20","美林",265,60,205
"8078","6226光鼎","110/08/20","臺銀-高雄",0,61,-61
"8079","6226光鼎","110/08/20","凱基-台北",211,59,152
"8080","6226光鼎","110/08/20","日盛-信義",0,60,-60
"8081","6226光鼎","110/08/20","摩根大通",172,72,100
"8082","6226光鼎","110/08/20","元大證券",18,76,-58
"8083","6226光鼎","110/08/20","新加坡商瑞銀",162,78,84
"8084","6226光鼎","110/08/20","中國信託",31,81,-50
"8085","6226光鼎","110/08/20","港商野村",168,89,79
"8086","6226光鼎","110/08/20","華南永昌-長虹",1,51,-50
"8087","6226光鼎","110/08/20","中國信託-永康",70,28,42
"8088","6226光鼎","110/08/20","富邦-板橋",6,55,-49
"8089","6226光鼎","110/08/20","致和-佳里",39,5,34
"8090","6226光鼎","110/08/20","土銀-彰化",8,53,-45
"8091","6226光鼎","110/08/20","兆豐-桃鶯",30,0,30
"8092","6226光鼎","110/08/20","新光",49,94,-45
"8093","6226光鼎","110/08/20","永豐金-中盛",38,10,28
"8094","6226光鼎","110/08/20","台新證券",86,129,-43
"8095","6226光鼎","110/08/20","凱基-站前",27,0,27
"8096","6226光鼎","110/08/20","元大-竹科",14,57,-43
"8097","6226光鼎","110/08/20","群益金鼎-永和",25,0,25
"8098","6226光鼎","110/08/20","兆豐-寶成",1,43,-42
"8099","6226光鼎","110/08/20","國票-台南",23,0,23
"8100","6226光鼎","110/08/20","國泰-館前",13,55,-42
"8101","2363矽統","110/08/20","凱基-台北",909,319,590
"8102","2363矽統","110/08/20","群益金鼎",10,183,-173
"8103","2363矽統","110/08/20","港商野村",1346,1106,240
"8104","2363矽統","110/08/20","國票-台東",2,153,-151
"8105","2363矽統","110/08/20","美林",332,137,195
"8106","2363矽統","110/08/20","元大-前金",44,169,-125
"8107","2363矽統","110/08/20","摩根大通",268,88,180
"8108","2363矽統","110/08/20","元大-汐止",32,121,-89
"8109","2363矽統","110/08/20","美商高盛",270,113,157
"8110","2363矽統","110/08/20","統一-屏東",14,90,-76
"8111","2363矽統","110/08/20","統一-三重",108,0,108
"8112","2363矽統","110/08/20","國泰-敦南",202,271,-69
"8113","2363矽統","110/08/20","日盛-中和",110,13,97
"8114","2363矽統","110/08/20","凱基-長庚",12,76,-64
"8115","2363矽統","110/08/20","台新-新營",84,14,70
"8116","2363矽統","110/08/20","凱基-鳳山",4,61,-57
"8117","2363矽統","110/08/20","富邦-台北",183,117,66
"8118","2363矽統","110/08/20","群益金鼎-中壢",25,81,-56
"8119","2363矽統","110/08/20","新光",238,178,60
"8120","2363矽統","110/08/20","合庫-高雄",23,78,-55
"8121","2363矽統","110/08/20","元大-士林",56,1,55
"8122","2363矽統","110/08/20","永豐金-市政",23,75,-52
"8123","2363矽統","110/08/20","凱基-台南",54,6,48
"8124","2363矽統","110/08/20","國泰-館前",98,148,-50
"8125","2363矽統","110/08/20","光和",45,4,41
"8126","2363矽統","110/08/20","國票-九鼎",14,62,-48
"8127","2363矽統","110/08/20","凱基-敦北",40,0,40
"8128","2363矽統","110/08/20","台新-左楠",2,47,-45
"8129","2363矽統","110/08/20","永豐金-台中",45,7,38
"8130","2363矽統","110/08/20","永豐金-潮州",3,46,-43
"8131","8112至上","110/08/20","港商法國興業",188,0,188
"8132","8112至上","110/08/20","台灣摩根士丹利",0,152,-152
"8133","8112至上","110/08/20","港商野村",229,78,151
"8134","8112至上","110/08/20","合庫-西台中",0,130,-130
"8135","8112至上","110/08/20","凱基-台北",95,12,83
"8136","8112至上","110/08/20","富邦-仁愛",7,102,-95
"8137","8112至上","110/08/20","美商高盛",100,23,77
"8138","8112至上","110/08/20","元大-永春",0,88,-88
"8139","8112至上","110/08/20","瑞士信貸",54,1,53
"8140","8112至上","110/08/20","元大-佳里",5,60,-55
"8141","8112至上","110/08/20","元大-路竹",38,7,31
"8142","8112至上","110/08/20","群益金鼎-基隆",1,49,-48
"8143","8112至上","110/08/20","富邦-新竹",37,7,30
"8144","8112至上","110/08/20","新加坡商瑞銀",34,73,-39
"8145","8112至上","110/08/20","元大-竹東",23,0,23
"8146","8112至上","110/08/20","摩根大通",183,214,-31
"8147","8112至上","110/08/20","凱基-桃園",22,1,21
"8148","8112至上","110/08/20","亞東-新竹",0,30,-30
"8149","8112至上","110/08/20","群益金鼎-大興",20,0,20
"8150","8112至上","110/08/20","亞東-台中",0,30,-30
"8151","8112至上","110/08/20","富邦-北港",20,0,20
"8152","8112至上","110/08/20","美林",32,61,-29
"8153","8112至上","110/08/20","元大-東港",20,0,20
"8154","8112至上","110/08/20","合庫-基隆",0,21,-21
"8155","8112至上","110/08/20","第一金-頭份",23,5,18
"8156","8112至上","110/08/20","(牛牛牛)亞-鑫豐",14,35,-21
"8157","8112至上","110/08/20","元大-仁愛",17,0,17
"8158","8112至上","110/08/20","國票-南港",5,26,-21
"8159","8112至上","110/08/20","國票-天祥",16,0,16
"8160","8112至上","110/08/20","國泰-台中",5,26,-21
"8161","1570力肯","110/08/20","國票-北高雄",27,0,27
"8162","1570力肯","110/08/20","元大-大雅",8,58,-50
"8163","1570力肯","110/08/20","元大-鹿港",29,4,25
"8164","1570力肯","110/08/20","凱基-三峽",0,30,-30
"8165","1570力肯","110/08/20","摩根大通",27,5,22
"8166","1570力肯","110/08/20","元大-樹林",0,30,-30
"8167","1570力肯","110/08/20","富邦-花蓮",20,0,20
"8168","1570力肯","110/08/20","統一",0,28,-28
"8169","1570力肯","110/08/20","群益金鼎-高雄",18,0,18
"8170","1570力肯","110/08/20","國票-南科",0,13,-13
"8171","1570力肯","110/08/20","元大-草屯",13,0,13
"8172","1570力肯","110/08/20","元大-鑫永和",0,12,-12
"8173","1570力肯","110/08/20","元富-緯城",12,0,12
"8174","1570力肯","110/08/20","台新證券",0,11,-11
"8175","1570力肯","110/08/20","元富-世貿",10,0,10
"8176","1570力肯","110/08/20","群益金鼎-民權",0,10,-10
"8177","1570力肯","110/08/20","大慶-蘆洲",7,0,7
"8178","1570力肯","110/08/20","國票-台中",3,11,-8
"8179","1570力肯","110/08/20","(牛牛牛)亞-鑫豐",25,18,7
"8180","1570力肯","110/08/20","土銀-新竹",1,7,-6
"8181","1570力肯","110/08/20","國票-天祥",6,0,6
"8182","1570力肯","110/08/20","台灣摩根士丹利",0,6,-6
"8183","1570力肯","110/08/20","凱基-台北",7,1,6
"8184","1570力肯","110/08/20","國泰-敦南",1,7,-6
"8185","1570力肯","110/08/20","元富-城東",5,0,5
"8186","1570力肯","110/08/20","高橋-龍潭",0,5,-5
"8187","1570力肯","110/08/20","國票",5,0,5
"8188","1570力肯","110/08/20","玉山-高雄",0,5,-5
"8189","1570力肯","110/08/20","萬泰",5,0,5
"8190","1570力肯","110/08/20","永豐金-苓雅",0,5,-5
"8191","2929淘帝","110/08/20","元大-太平",35,0,35
"8192","2929淘帝","110/08/20","元大-莒光",0,25,-25
"8193","2929淘帝","110/08/20","港商野村",17,5,12
"8194","2929淘帝","110/08/20","富邦-新營",0,20,-20
"8195","2929淘帝","110/08/20","摩根大通",16,6,10
"8196","2929淘帝","110/08/20","華南永昌-古亭",0,16,-16
"8197","2929淘帝","110/08/20","永豐金-板新",10,0,10
"8198","2929淘帝","110/08/20","兆豐-桃鶯",0,12,-12
"8199","2929淘帝","110/08/20","美林",10,1,9
"8200","2929淘帝","110/08/20","中國信託",0,10,-10
"8201","2929淘帝","110/08/20","兆豐-忠孝",8,0,8
"8202","2929淘帝","110/08/20","元大-竹科",0,10,-10
"8203","2929淘帝","110/08/20","凱基-東門",8,0,8
"8204","2929淘帝","110/08/20","永豐金-新莊",0,10,-10
"8205","2929淘帝","110/08/20","高橋-龍潭",5,0,5
"8206","2929淘帝","110/08/20","兆豐-東門",0,8,-8
"8207","2929淘帝","110/08/20","玉山-台南",5,0,5
"8208","2929淘帝","110/08/20","凱基-三峽",0,7,-7
"8209","2929淘帝","110/08/20","凱基-中山",5,0,5
"8210","2929淘帝","110/08/20","宏遠-館前",0,5,-5
"8211","2929淘帝","110/08/20","華南永昌-小港",5,0,5
"8212","2929淘帝","110/08/20","瑞士信貸",0,5,-5
"8213","2929淘帝","110/08/20","元大-員林",5,0,5
"8214","2929淘帝","110/08/20","富邦-陽明",0,5,-5
"8215","2929淘帝","110/08/20","元大-永和",5,0,5
"8216","2929淘帝","110/08/20","中國信託-松江",0,4,-4
"8217","2929淘帝","110/08/20","永豐金-永康",5,0,5
"8218","2929淘帝","110/08/20","玉山-新竹",11,15,-4
"8219","2929淘帝","110/08/20","群益金鼎-潭子",4,0,4
"8220","2929淘帝","110/08/20","元富-成功",0,3,-3
"8221","5410國眾","110/08/20","大昌",5,0,5
"8222","5410國眾","110/08/20","元大-發財",0,9,-9
"8223","5410國眾","110/08/20","華南永昌-高雄",5,0,5
"8224","5410國眾","110/08/20","元大-士林",2,8,-6
"8225","5410國眾","110/08/20","元大-東泰",5,0,5
"8226","5410國眾","110/08/20","日盛-屏東",0,5,-5
"8227","5410國眾","110/08/20","元大-中壢",5,0,5
"8228","5410國眾","110/08/20","新加坡商瑞銀",3,8,-5
"8229","5410國眾","110/08/20","中國信託-新竹",4,0,4
"8230","5410國眾","110/08/20","凱基-台北",0,4,-4
"8231","5410國眾","110/08/20","新光",3,0,3
"8232","5410國眾","110/08/20","元大-南勢角",0,4,-4
"8233","5410國眾","110/08/20","凱基-竹北",3,0,3
"8234","5410國眾","110/08/20","寶盛",0,3,-3
"8235","5410國眾","110/08/20","國泰-松江",2,0,2
"8236","5410國眾","110/08/20","元富-台南",0,2,-2
"8237","5410國眾","110/08/20","群益金鼎-海山",2,0,2
"8238","5410國眾","110/08/20","華南永昌-小港",0,2,-2
"8239","5410國眾","110/08/20","凱基-彰化",2,0,2
"8240","5410國眾","110/08/20","富邦-竹北",1,3,-2
"8241","5410國眾","110/08/20","日盛-二林",1,0,1
"8242","5410國眾","110/08/20","富邦-永和",0,2,-2
"8243","5410國眾","110/08/20","美林",1,0,1
"8244","5410國眾","110/08/20","元大-華山",0,2,-2
"8245","5410國眾","110/08/20","大慶-蘆洲",1,0,1
"8246","5410國眾","110/08/20","中國信託-文心",0,1,-1
"8247","5410國眾","110/08/20","中國信託-嘉義",1,0,1
"8248","5410國眾","110/08/20","國泰-敦南",4,5,-1
"8249","5410國眾","110/08/20","國泰-台南",1,0,1
"8250","5410國眾","110/08/20","華南永昌-楠梓",0,1,-1
"8251","2841台開","110/08/20","宏遠-館前",465,0,465
"8252","2841台開","110/08/20","台中銀",0,113,-113
"8253","2841台開","110/08/20","第一金",102,0,102
"8254","2841台開","110/08/20","國票-敦北法人",0,51,-51
"8255","2841台開","110/08/20","富邦-岡山",18,0,18
"8256","2841台開","110/08/20","高橋",0,50,-50
"8257","2841台開","110/08/20","台新證券",15,2,13
"8258","2841台開","110/08/20","日盛證券",0,43,-43
"8259","2841台開","110/08/20","元大-新竹經國",10,0,10
"8260","2841台開","110/08/20","永豐金-三重",0,39,-39
"8261","2841台開","110/08/20","日盛-新竹",6,0,6
"8262","2841台開","110/08/20","玉山-高雄",0,30,-30
"8263","2841台開","110/08/20","元富-文心",5,0,5
"8264","2841台開","110/08/20","元大-竹山",0,30,-30
"8265","2841台開","110/08/20","第一金-路竹",3,0,3
"8266","2841台開","110/08/20","光和-高雄",0,28,-28
"8267","2841台開","110/08/20","永豐金-中盛",3,0,3
"8268","2841台開","110/08/20","永豐金-敦南",15,37,-22
"8269","2841台開","110/08/20","新光-台中",2,0,2
"8270","2841台開","110/08/20","新光-台南",0,21,-21
"8271","2841台開","110/08/20","群益金鼎-館前",2,0,2
"8272","2841台開","110/08/20","玉山-嘉義",0,20,-20
"8273","2841台開","110/08/20","群益金鼎-東湖",2,0,2
"8274","2841台開","110/08/20","富邦-員林",0,20,-20
"8275","2841台開","110/08/20","元大-屏東民生",2,0,2
"8276","2841台開","110/08/20","元大-竹科",0,20,-20
"8277","2841台開","110/08/20","國泰-板橋",1,0,1
"8278","2841台開","110/08/20","元大-善化",0,15,-15
"8279","2841台開","110/08/20","群益金鼎-崇德",1,0,1
"8280","2841台開","110/08/20","永豐金-忠孝",0,15,-15
"8281","6207雷科","110/08/20","日盛-員林",20,0,20
"8282","6207雷科","110/08/20","凱基-敦北",0,26,-26
"8283","6207雷科","110/08/20","美林",16,0,16
"8284","6207雷科","110/08/20","新加坡商瑞銀",12,27,-15
"8285","6207雷科","110/08/20","凱基-台北",20,8,12
"8286","6207雷科","110/08/20","國票-南科",1,13,-12
"8287","6207雷科","110/08/20","瑞士信貸",11,0,11
"8288","6207雷科","110/08/20","台新證券",0,10,-10
"8289","6207雷科","110/08/20","港商野村",23,12,11
"8290","6207雷科","110/08/20","國票-九鼎",2,10,-8
"8291","6207雷科","110/08/20","摩根大通",33,22,11
"8292","6207雷科","110/08/20","台新-台中",0,5,-5
"8293","6207雷科","110/08/20","凱基-羅東",6,0,6
"8294","6207雷科","110/08/20","玉山-嘉義",0,5,-5
"8295","6207雷科","110/08/20","富邦-中壢",6,0,6
"8296","6207雷科","110/08/20","群益金鼎-三民",0,5,-5
"8297","6207雷科","110/08/20","元大-大灣",6,0,6
"8298","6207雷科","110/08/20","元大-博愛",0,5,-5
"8299","6207雷科","110/08/20","日盛-台南",5,0,5
"8300","6207雷科","110/08/20","中國信託-中壢",0,4,-4
"8301","6207雷科","110/08/20","富邦-台北",5,0,5
"8302","6207雷科","110/08/20","兆豐-彰化",0,4,-4
"8303","6207雷科","110/08/20","富邦-新店",5,0,5
"8304","6207雷科","110/08/20","群益金鼎-東門",0,4,-4
"8305","6207雷科","110/08/20","元大-府城",5,0,5
"8306","6207雷科","110/08/20","致和-高雄",0,3,-3
"8307","6207雷科","110/08/20","中農",3,0,3
"8308","6207雷科","110/08/20","新光-高雄",0,3,-3
"8309","6207雷科","110/08/20","華南永昌-古亭",3,0,3
"8310","6207雷科","110/08/20","凱基-高雄",0,3,-3
"8311","3679新至陞","110/08/20","元大-大天母",10,0,10
"8312","3679新至陞","110/08/20","台灣企銀-建成",0,6,-6
"8313","3679新至陞","110/08/20","港商野村",3,0,3
"8314","3679新至陞","110/08/20","美林",0,6,-6
"8315","3679新至陞","110/08/20","(牛牛牛)亞-網路",3,0,3
"8316","3679新至陞","110/08/20","花旗環球",0,5,-5
"8317","3679新至陞","110/08/20","富邦-花蓮",3,0,3
"8318","3679新至陞","110/08/20","新加坡商瑞銀",0,5,-5
"8319","3679新至陞","110/08/20","凱基-中山",2,0,2
"8320","3679新至陞","110/08/20","日盛-忠孝",0,4,-4
"8321","3679新至陞","110/08/20","日盛-木柵",1,0,1
"8322","3679新至陞","110/08/20","元大證券",1,4,-3
"8323","3679新至陞","110/08/20","日盛-員林",1,0,1
"8324","3679新至陞","110/08/20","摩根大通",4,6,-2
"8325","3679新至陞","110/08/20","日盛-文化",1,0,1
"8326","3679新至陞","110/08/20","凱基-埔墘",0,2,-2
"8327","3679新至陞","110/08/20","台灣摩根士丹利",1,0,1
"8328","3679新至陞","110/08/20","日盛-板橋",0,1,-1
"8329","3679新至陞","110/08/20","瑞士信貸",1,0,1
"8330","3679新至陞","110/08/20","美商高盛",0,1,-1
"8331","3679新至陞","110/08/20","第一金-澎湖",1,0,1
"8332","3679新至陞","110/08/20","第一金-台南",0,1,-1
"8333","3679新至陞","110/08/20","統一-松江",1,0,1
"8334","3679新至陞","110/08/20","台中銀-員林",0,1,-1
"8335","3679新至陞","110/08/20","元富-草屯",1,0,1
"8336","3679新至陞","110/08/20","北城證券",0,1,-1
"8337","3679新至陞","110/08/20","光和-溪湖",1,0,1
"8338","3679新至陞","110/08/20","國票-九鼎",0,1,-1
"8339","3679新至陞","110/08/20","兆豐-三重",1,0,1
"8340","3679新至陞","110/08/20","富邦-陽明",0,1,-1
"8341","2727王品","110/08/20","元大-台中中港",339,0,339
"8342","2727王品","110/08/20","兆豐-南京",0,980,-980
"8343","2727王品","110/08/20","台灣摩根士丹利",93,12,81
"8344","2727王品","110/08/20","港商麥格理",0,65,-65
"8345","2727王品","110/08/20","摩根大通",63,4,59
"8346","2727王品","110/08/20","玉山證券",2,25,-23
"8347","2727王品","110/08/20","瑞士信貸",62,7,55
"8348","2727王品","110/08/20","元大證券",2,22,-20
"8349","2727王品","110/08/20","國票-南港",50,0,50
"8350","2727王品","110/08/20","永豐金-桃盛",0,20,-20
"8351","2727王品","110/08/20","玉山-板橋",40,10,30
"8352","2727王品","110/08/20","元富-西松",0,18,-18
"8353","2727王品","110/08/20","美林",38,9,29
"8354","2727王品","110/08/20","美商高盛",5,17,-12
"8355","2727王品","110/08/20","國泰-敦南",23,2,21
"8356","2727王品","110/08/20","台新-中壢",0,11,-11
"8357","2727王品","110/08/20","富邦-台北",16,2,14
"8358","2727王品","110/08/20","富邦-桃園",0,11,-11
"8359","2727王品","110/08/20","凱基-科園",15,2,13
"8360","2727王品","110/08/20","永豐金-新竹",0,11,-11
"8361","2727王品","110/08/20","凱基-台北",68,56,12
"8362","2727王品","110/08/20","彰銀-台中",0,10,-10
"8363","2727王品","110/08/20","宏遠-高雄",11,0,11
"8364","2727王品","110/08/20","兆豐-新莊",0,10,-10
"8365","2727王品","110/08/20","日茂-埔里",11,0,11
"8366","2727王品","110/08/20","元大-學甲",0,10,-10
"8367","2727王品","110/08/20","港商野村",58,48,10
"8368","2727王品","110/08/20","群益金鼎-延平",0,9,-9
"8369","2727王品","110/08/20","群益金鼎-潭子",10,0,10
"8370","2727王品","110/08/20","永豐金-松山",2,10,-8
"8371","1570力肯","110/08/20","國票-北高雄",27,0,27
"8372","1570力肯","110/08/20","元大-大雅",8,58,-50
"8373","1570力肯","110/08/20","元大-鹿港",29,4,25
"8374","1570力肯","110/08/20","凱基-三峽",0,30,-30
"8375","1570力肯","110/08/20","摩根大通",27,5,22
"8376","1570力肯","110/08/20","元大-樹林",0,30,-30
"8377","1570力肯","110/08/20","富邦-花蓮",20,0,20
"8378","1570力肯","110/08/20","統一",0,28,-28
"8379","1570力肯","110/08/20","群益金鼎-高雄",18,0,18
"8380","1570力肯","110/08/20","國票-南科",0,13,-13
"8381","1570力肯","110/08/20","元大-草屯",13,0,13
"8382","1570力肯","110/08/20","元大-鑫永和",0,12,-12
"8383","1570力肯","110/08/20","元富-緯城",12,0,12
"8384","1570力肯","110/08/20","台新證券",0,11,-11
"8385","1570力肯","110/08/20","元富-世貿",10,0,10
"8386","1570力肯","110/08/20","群益金鼎-民權",0,10,-10
"8387","1570力肯","110/08/20","大慶-蘆洲",7,0,7
"8388","1570力肯","110/08/20","國票-台中",3,11,-8
"8389","1570力肯","110/08/20","(牛牛牛)亞-鑫豐",25,18,7
"8390","1570力肯","110/08/20","土銀-新竹",1,7,-6
"8391","1570力肯","110/08/20","國票-天祥",6,0,6
"8392","1570力肯","110/08/20","台灣摩根士丹利",0,6,-6
"8393","1570力肯","110/08/20","凱基-台北",7,1,6
"8394","1570力肯","110/08/20","國泰-敦南",1,7,-6
"8395","1570力肯","110/08/20","元富-城東",5,0,5
"8396","1570力肯","110/08/20","高橋-龍潭",0,5,-5
"8397","1570力肯","110/08/20","國票",5,0,5
"8398","1570力肯","110/08/20","玉山-高雄",0,5,-5
"8399","1570力肯","110/08/20","萬泰",5,0,5
"8400","1570力肯","110/08/20","永豐金-苓雅",0,5,-5
"8401","6180橘子","110/08/20","港商野村",272,0,272
"8402","6180橘子","110/08/20","元大-博愛",0,42,-42
"8403","6180橘子","110/08/20","美林",47,0,47
"8404","6180橘子","110/08/20","群益金鼎-永和",1,40,-39
"8405","6180橘子","110/08/20","兆豐-埔墘",10,0,10
"8406","6180橘子","110/08/20","台灣摩根士丹利",4,39,-35
"8407","6180橘子","110/08/20","元大-天母",9,0,9
"8408","6180橘子","110/08/20","摩根大通",11,46,-35
"8409","6180橘子","110/08/20","永豐金-桃園",10,1,9
"8410","6180橘子","110/08/20","新光-桃園",0,35,-35
"8411","6180橘子","110/08/20","凱基-大里",8,0,8
"8412","6180橘子","110/08/20","臺銀",2,34,-32
"8413","6180橘子","110/08/20","元大-草屯",7,0,7
"8414","6180橘子","110/08/20","國泰-館前",1,33,-32
"8415","6180橘子","110/08/20","日盛-雙和",5,0,5
"8416","6180橘子","110/08/20","新光",7,38,-31
"8417","6180橘子","110/08/20","第一金-高雄",5,0,5
"8418","6180橘子","110/08/20","宏遠-館前",0,21,-21
"8419","6180橘子","110/08/20","第一金-新竹",5,0,5
"8420","6180橘子","110/08/20","富邦-竹東",0,21,-21
"8421","6180橘子","110/08/20","群益金鼎-大興",5,0,5
"8422","6180橘子","110/08/20","日盛-景美",0,20,-20
"8423","6180橘子","110/08/20","群益金鼎-開元",5,0,5
"8424","6180橘子","110/08/20","第一金-新興",0,20,-20
"8425","6180橘子","110/08/20","元大-東泰",5,0,5
"8426","6180橘子","110/08/20","凱基-彰化",0,16,-16
"8427","6180橘子","110/08/20","元大-士林",5,0,5
"8428","6180橘子","110/08/20","新加坡商瑞銀",5,15,-10
"8429","6180橘子","110/08/20","元大-土城",5,0,5
"8430","6180橘子","110/08/20","國票-長城",0,10,-10
"8431","2390云辰","110/08/20","國票-安和",130,0,130
"8432","2390云辰","110/08/20","統一-新台中",0,200,-200
"8433","2390云辰","110/08/20","凱基-屏東",100,0,100
"8434","2390云辰","110/08/20","聯邦-敦化",0,68,-68
"8435","2390云辰","110/08/20","摩根大通",233,161,72
"8436","2390云辰","110/08/20","美林",62,127,-65
"8437","2390云辰","110/08/20","美商高盛",101,30,71
"8438","2390云辰","110/08/20","新加坡商瑞銀",0,61,-61
"8439","2390云辰","110/08/20","兆豐-高雄",78,11,67
"8440","2390云辰","110/08/20","統一-新營",26,71,-45
"8441","2390云辰","110/08/20","凱基-台北",257,199,58
"8442","2390云辰","110/08/20","國泰-敦南",114,153,-39
"8443","2390云辰","110/08/20","第一金-安和",62,8,54
"8444","2390云辰","110/08/20","華南永昌-朴子",2,41,-39
"8445","2390云辰","110/08/20","統一-城中",60,10,50
"8446","2390云辰","110/08/20","元大-土城學府",156,192,-36
"8447","2390云辰","110/08/20","富邦-宜蘭",52,4,48
"8448","2390云辰","110/08/20","元大-六合",17,53,-36
"8449","2390云辰","110/08/20","元大-鳳山",60,12,48
"8450","2390云辰","110/08/20","土銀-嘉義",0,35,-35
"8451","2390云辰","110/08/20","元大-板橋三民",50,2,48
"8452","2390云辰","110/08/20","大昌",5,36,-31
"8453","2390云辰","110/08/20","國票-博愛",178,141,37
"8454","2390云辰","110/08/20","宏遠-台南",0,27,-27
"8455","2390云辰","110/08/20","華南永昌-岡山",33,1,32
"8456","2390云辰","110/08/20","群益金鼎-民權",6,31,-25
"8457","2390云辰","110/08/20","元大-北三重",32,1,31
"8458","2390云辰","110/08/20","國泰-館前",28,52,-24
"8459","2390云辰","110/08/20","第一金-豐原",30,0,30
"8460","2390云辰","110/08/20","富邦-建國",13,36,-23
"8461","2609陽明","110/08/19","美商高盛",2352,641,1711
"8462","2609陽明","110/08/19","凱基-台北",2247,12187,-9940
"8463","2609陽明","110/08/19","華南永昌-竹北",1335,536,799
"8464","2609陽明","110/08/19","康和",1685,8746,-7061
"8465","2609陽明","110/08/19","國泰-敦南",5999,5202,797
"8466","2609陽明","110/08/19","富邦證券",159,6808,-6649
"8467","2609陽明","110/08/19","日盛-雙和",967,217,750
"8468","2609陽明","110/08/19","台灣摩根士丹利",66,2608,-2542
"8469","2609陽明","110/08/19","國泰-館前",1665,1071,594
"8470","2609陽明","110/08/19","兆豐-南京",144,2129,-1985
"8471","2609陽明","110/08/19","台新證券",3672,3095,577
"8472","2609陽明","110/08/19","兆豐-虎尾",7267,9058,-1791
"8473","2609陽明","110/08/19","統一-三重",826,296,530
"8474","2609陽明","110/08/19","美林",2631,4379,-1748
"8475","2609陽明","110/08/19","玉山證券",1424,939,485
"8476","2609陽明","110/08/19","永豐金-信義",140,1816,-1676
"8477","2609陽明","110/08/19","富邦-建國",1115,663,452
"8478","2609陽明","110/08/19","富邦-仁愛",873,2277,-1404
"8479","2609陽明","110/08/19","統一-士林",809,391,418
"8480","2609陽明","110/08/19","摩根大通",4652,6019,-1367
"8481","2609陽明","110/08/19","凱基-城中",614,199,415
"8482","2609陽明","110/08/19","凱基-斗六",3347,4638,-1291
"8483","2609陽明","110/08/19","華南永昌-台中",863,449,414
"8484","2609陽明","110/08/19","富邦-虎尾",11651,12857,-1206
"8485","2609陽明","110/08/19","新光-新竹",1263,857,406
"8486","2609陽明","110/08/19","元大證券",2875,3808,-933
"8487","2609陽明","110/08/19","國泰-台中",1878,1503,375
"8488","2609陽明","110/08/19","統一-仁愛",1484,2392,-908
"8489","2609陽明","110/08/19","玉山-左營",623,251,372
"8490","2609陽明","110/08/19","元大-頭份",315,1194,-879
"8491","2636台驊投控","110/08/19","華南永昌-竹北",257,10,247
"8492","2636台驊投控","110/08/19","富邦證券",8,1056,-1048
"8493","2636台驊投控","110/08/19","國泰-敦南",483,306,177
"8494","2636台驊投控","110/08/19","摩根大通",329,1288,-959
"8495","2636台驊投控","110/08/19","新光-新竹",174,42,132
"8496","2636台驊投控","110/08/19","台灣摩根士丹利",168,753,-585
"8497","2636台驊投控","110/08/19","港商野村",2255,2136,119
"8498","2636台驊投控","110/08/19","凱基-台北",574,996,-422
"8499","2636台驊投控","110/08/19","台新證券",257,150,107
"8500","2636台驊投控","110/08/19","瑞士信貸",75,421,-346
"8501","2636台驊投控","110/08/19","新光",389,312,77
"8502","2636台驊投控","110/08/19","統一",98,420,-322
"8503","2636台驊投控","110/08/19","華南永昌-楠梓",98,27,71
"8504","2636台驊投控","110/08/19","凱基",21,323,-302
"8505","2636台驊投控","110/08/19","華南永昌-南京",104,40,64
"8506","2636台驊投控","110/08/19","富邦-員林",377,670,-293
"8507","2636台驊投控","110/08/19","富邦-苗栗",99,35,64
"8508","2636台驊投控","110/08/19","日盛-台中",26,244,-218
"8509","2636台驊投控","110/08/19","元大-竹北",79,16,63
"8510","2636台驊投控","110/08/19","美商高盛",87,244,-157
"8511","2636台驊投控","110/08/19","凱基-市政",265,203,62
"8512","2636台驊投控","110/08/19","日盛-板橋",40,163,-123
"8513","2636台驊投控","110/08/19","中國信託-文心",80,21,59
"8514","2636台驊投控","110/08/19","大慶",2,120,-118
"8515","2636台驊投控","110/08/19","大昌-安康",60,4,56
"8516","2636台驊投控","110/08/19","日盛-大墩",73,184,-111
"8517","2636台驊投控","110/08/19","日盛-宜蘭",53,0,53
"8518","2636台驊投控","110/08/19","宏遠證券",60,152,-92
"8519","2636台驊投控","110/08/19","元富-大昌",81,28,53
"8520","2636台驊投控","110/08/19","新加坡商瑞銀",88,173,-85
"8521","2867三商壽","110/08/19","美林",389,60,329
"8522","2867三商壽","110/08/19","宏遠證券",0,969,-969
"8523","2867三商壽","110/08/19","元大-土城永寧",252,2,250
"8524","2867三商壽","110/08/19","摩根大通",111,691,-580
"8525","2867三商壽","110/08/19","玉山-板橋",127,0,127
"8526","2867三商壽","110/08/19","土銀-建國",0,240,-240
"8527","2867三商壽","110/08/19","元大-大里德芳",110,0,110
"8528","2867三商壽","110/08/19","日盛-中壢",0,122,-122
"8529","2867三商壽","110/08/19","國泰-台中",103,1,102
"8530","2867三商壽","110/08/19","台新-高雄",4,121,-117
"8531","2867三商壽","110/08/19","新加坡商瑞銀",114,19,95
"8532","2867三商壽","110/08/19","德信-中正",0,100,-100
"8533","2867三商壽","110/08/19","玉山-城中",86,0,86
"8534","2867三商壽","110/08/19","華南永昌-南京",0,100,-100
"8535","2867三商壽","110/08/19","合庫-西台中",80,0,80
"8536","2867三商壽","110/08/19","台新證券",15,101,-86
"8537","2867三商壽","110/08/19","永豐金-竹科",80,1,79
"8538","2867三商壽","110/08/19","凱基-台北",42,118,-76
"8539","2867三商壽","110/08/19","玉山-台中",61,0,61
"8540","2867三商壽","110/08/19","富邦-建國",1,71,-70
"8541","2867三商壽","110/08/19","土銀-台中",60,0,60
"8542","2867三商壽","110/08/19","元大-八德",0,70,-70
"8543","2867三商壽","110/08/19","富邦-台南",60,0,60
"8544","2867三商壽","110/08/19","凱基",0,68,-68
"8545","2867三商壽","110/08/19","元大-中壢",56,0,56
"8546","2867三商壽","110/08/19","富邦-三重",0,55,-55
"8547","2867三商壽","110/08/19","群益金鼎-彰化",62,8,54
"8548","2867三商壽","110/08/19","元大-彰化民生",0,50,-50
"8549","2867三商壽","110/08/19","永豐金-埔里",67,13,54
"8550","2867三商壽","110/08/19","亞東",0,45,-45
"8551","5521工信","110/08/19","元大證券",232,28,204
"8552","5521工信","110/08/19","凱基-台北",0,178,-178
"8553","5521工信","110/08/19","中國信託-三重",70,0,70
"8554","5521工信","110/08/19","福勝",0,80,-80
"8555","5521工信","110/08/19","台新證券",37,0,37
"8556","5521工信","110/08/19","新光-新竹",1,80,-79
"8557","5521工信","110/08/19","日盛-高雄",27,0,27
"8558","5521工信","110/08/19","港商法國興業",0,67,-67
"8559","5521工信","110/08/19","元富-埔里",20,0,20
"8560","5521工信","110/08/19","摩根大通",194,256,-62
"8561","5521工信","110/08/19","玉山-雙和",20,0,20
"8562","5521工信","110/08/19","群益金鼎-敦南",0,50,-50
"8563","5521工信","110/08/19","富邦-台北",20,0,20
"8564","5521工信","110/08/19","第一金-桃園",0,36,-36
"8565","5521工信","110/08/19","永豐金-竹科",19,0,19
"8566","5521工信","110/08/19","德信-中正",0,29,-29
"8567","5521工信","110/08/19","臺銀-鳳山",18,0,18
"8568","5521工信","110/08/19","元大-基隆孝二",0,28,-28
"8569","5521工信","110/08/19","華南永昌-高雄",20,2,18
"8570","5521工信","110/08/19","美林",1,27,-26
"8571","5521工信","110/08/19","華南永昌-彰化",23,8,15
"8572","5521工信","110/08/19","兆豐-員林",0,25,-25
"8573","5521工信","110/08/19","元大-大天母",15,0,15
"8574","5521工信","110/08/19","群益金鼎-土城",0,20,-20
"8575","5521工信","110/08/19","富邦-宜蘭",14,0,14
"8576","5521工信","110/08/19","元富-宜蘭",0,18,-18
"8577","5521工信","110/08/19","台新-台中",12,0,12
"8578","5521工信","110/08/19","富邦-高雄",1,15,-14
"8579","5521工信","110/08/19","臺銀-高雄",11,0,11
"8580","5521工信","110/08/19","元大-歸仁",2,16,-14
"8581","1471首利","110/08/19","新光",35,0,35
"8582","1471首利","110/08/19","摩根大通",42,206,-164
"8583","1471首利","110/08/19","新光-台南",24,0,24
"8584","1471首利","110/08/19","瑞士信貸",1,39,-38
"8585","1471首利","110/08/19","元大-太平",20,2,18
"8586","1471首利","110/08/19","凱基-五股",0,23,-23
"8587","1471首利","110/08/19","土銀-花蓮",15,0,15
"8588","1471首利","110/08/19","凱基-台北",6,29,-23
"8589","1471首利","110/08/19","玉山-桃園",15,0,15
"8590","1471首利","110/08/19","元大-虎尾",7,27,-20
"8591","1471首利","110/08/19","元富-三重",13,0,13
"8592","1471首利","110/08/19","光和",9,24,-15
"8593","1471首利","110/08/19","台新證券",12,0,12
"8594","1471首利","110/08/19","致和-府前",0,15,-15
"8595","1471首利","110/08/19","元大-員林中山",11,0,11
"8596","1471首利","110/08/19","兆豐-員林",0,12,-12
"8597","1471首利","110/08/19","台灣企銀-屏東",10,0,10
"8598","1471首利","110/08/19","凱基-新店",0,12,-12
"8599","1471首利","110/08/19","兆豐-台中港",10,0,10
"8600","1471首利","110/08/19","美林",0,11,-11
"8601","1471首利","110/08/19","致和-崇德",10,0,10
"8602","1471首利","110/08/19","凱基-頭份",0,10,-10
"8603","1471首利","110/08/19","凱基-高美館",10,0,10
"8604","1471首利","110/08/19","華南永昌-台中",0,10,-10
"8605","1471首利","110/08/19","華南永昌-公誠",10,0,10
"8606","1471首利","110/08/19","元大-大甲",0,9,-9
"8607","1471首利","110/08/19","華南永昌-楠梓",10,0,10
"8608","1471首利","110/08/19","凱基-三重",3,10,-7
"8609","1471首利","110/08/19","富邦-南屯",10,0,10
"8610","1471首利","110/08/19","永豐金-新店",0,7,-7
"8611","2883開發金","110/08/19","香港上海匯豐",6827,846,5981
"8612","2883開發金","110/08/19","凱基-台北",1722,11079,-9357
"8613","2883開發金","110/08/19","中國信託-文心",4667,49,4618
"8614","2883開發金","110/08/19","花旗環球",1244,7162,-5918
"8615","2883開發金","110/08/19","新光",3917,1918,1999
"8616","2883開發金","110/08/19","國泰證券",51,3659,-3608
"8617","2883開發金","110/08/19","凱基",1952,0,1952
"8618","2883開發金","110/08/19","台新證券",1038,4320,-3282
"8619","2883開發金","110/08/19","玉山證券",2183,465,1718
"8620","2883開發金","110/08/19","兆豐證券",7,1979,-1972
"8621","2883開發金","110/08/19","元大-忠孝",1666,40,1626
"8622","2883開發金","110/08/19","統一",51,1553,-1502
"8623","2883開發金","110/08/19","國泰-敦南",2025,483,1542
"8624","2883開發金","110/08/19","日盛證券",70,1356,-1286
"8625","2883開發金","110/08/19","新加坡商瑞銀",5707,4366,1341
"8626","2883開發金","110/08/19","合庫-彰化",31,1273,-1242
"8627","2883開發金","110/08/19","瑞士信貸",1645,478,1167
"8628","2883開發金","110/08/19","元大證券",2109,3261,-1152
"8629","2883開發金","110/08/19","康和-仁愛",1143,1,1142
"8630","2883開發金","110/08/19","宏遠證券",11,1083,-1072
"8631","2883開發金","110/08/19","凱基-竹科",753,16,737
"8632","2883開發金","110/08/19","富邦-北港",134,1188,-1054
"8633","2883開發金","110/08/19","國泰-板橋",919,284,635
"8634","2883開發金","110/08/19","元大-福營",55,1070,-1015
"8635","2883開發金","110/08/19","新光-台南",757,132,625
"8636","2883開發金","110/08/19","台灣企銀-民雄",23,1022,-999
"8637","2883開發金","110/08/19","元大-萬華",559,62,497
"8638","2883開發金","110/08/19","永豐金-南京",131,1128,-997
"8639","2883開發金","110/08/19","元大-中壢",533,53,480
"8640","2883開發金","110/08/19","群益金鼎-大安",38,965,-927
"8641","6205詮欣","110/08/19","日盛-三重",23,0,23
"8642","6205詮欣","110/08/19","高橋-內壢",0,20,-20
"8643","6205詮欣","110/08/19","凱基-汐止",21,0,21
"8644","6205詮欣","110/08/19","摩根大通",1,12,-11
"8645","6205詮欣","110/08/19","日茂-埔里",10,0,10
"8646","6205詮欣","110/08/19","福邦證券",0,10,-10
"8647","6205詮欣","110/08/19","凱基-台北",3,0,3
"8648","6205詮欣","110/08/19","元富-安南",0,6,-6
"8649","6205詮欣","110/08/19","永豐金證券",3,0,3
"8650","6205詮欣","110/08/19","永興-大墩",0,4,-4
"8651","6205詮欣","110/08/19","元富-草屯",2,0,2
"8652","6205詮欣","110/08/19","元大-豐原",0,2,-2
"8653","6205詮欣","110/08/19","臺銀-臺中",1,0,1
"8654","6205詮欣","110/08/19","統一-中壢",0,2,-2
"8655","6205詮欣","110/08/19","兆豐-景美",1,0,1
"8656","6205詮欣","110/08/19","中國信託-文心",0,2,-2
"8657","6205詮欣","110/08/19","凱基-桃園",1,0,1
"8658","6205詮欣","110/08/19","大慶-台南",0,1,-1
"8659","6205詮欣","110/08/19","凱基-復興",1,0,1
"8660","6205詮欣","110/08/19","元大-南投",0,1,-1
"8661","6205詮欣","110/08/19","華南永昌-台南",1,0,1
"8662","6205詮欣","110/08/19","華南永昌-虎尾",0,1,-1
"8663","6205詮欣","110/08/19","華南永昌-新莊",0,0,0
"8664","6205詮欣","110/08/19","凱基-和平",0,1,-1
"8665","6205詮欣","110/08/19","元大-大里",0,0,0
"8666","6205詮欣","110/08/19","豐農",0,1,-1
"8667","6205詮欣","110/08/19","永豐金-中和",1,1,0
"8668","6205詮欣","110/08/19","元富-文心",0,1,-1
"8669","6205詮欣","110/08/19","",NA,NA,NA
"8670","6205詮欣","110/08/19","美商高盛",0,1,-1
"8671","1540喬福","110/08/19","日盛-台南",20,0,20
"8672","1540喬福","110/08/19","兆豐-小港",0,30,-30
"8673","1540喬福","110/08/19","元大-板橋三民",11,0,11
"8674","1540喬福","110/08/19","富邦-台南",0,10,-10
"8675","1540喬福","110/08/19","富邦-陽明",10,0,10
"8676","1540喬福","110/08/19","元富-桃園",0,9,-9
"8677","1540喬福","110/08/19","富邦-南屯",10,0,10
"8678","1540喬福","110/08/19","元大-龍潭",0,9,-9
"8679","1540喬福","110/08/19","元大-桃興",10,0,10
"8680","1540喬福","110/08/19","元大-雙和",0,6,-6
"8681","1540喬福","110/08/19","元大-成功",10,0,10
"8682","1540喬福","110/08/19","元大-台南",0,5,-5
"8683","1540喬福","110/08/19","(牛牛牛)亞-網路",7,0,7
"8684","1540喬福","110/08/19","台中銀",0,4,-4
"8685","1540喬福","110/08/19","凱基-中壢",3,0,3
"8686","1540喬福","110/08/19","港商法國興業",0,3,-3
"8687","1540喬福","110/08/19","臺銀-新竹",2,0,2
"8688","1540喬福","110/08/19","富邦-員林",0,3,-3
"8689","1540喬福","110/08/19","國票-南崁",2,0,2
"8690","1540喬福","110/08/19","元富",0,2,-2
"8691","1540喬福","110/08/19","摩根大通",5,3,2
"8692","1540喬福","110/08/19","康和-板橋",0,2,-2
"8693","1540喬福","110/08/19","華南永昌-高雄",2,0,2
"8694","1540喬福","110/08/19","玉山-城中",0,2,-2
"8695","1540喬福","110/08/19","台中銀-豐原",1,0,1
"8696","1540喬福","110/08/19","元大-南崁",0,2,-2
"8697","1540喬福","110/08/19","國票-桃園",1,0,1
"8698","1540喬福","110/08/19","元大-敦南",0,2,-2
"8699","1540喬福","110/08/19","玉山-新竹",1,0,1
"8700","1540喬福","110/08/19","國票-台中",0,1,-1
"8701","2888新光金","110/08/19","兆豐-公益",5003,799,4204
"8702","2888新光金","110/08/19","摩根大通",1356,4583,-3227
"8703","2888新光金","110/08/19","凱基-台北",4068,1621,2447
"8704","2888新光金","110/08/19","凱基",0,3218,-3218
"8705","2888新光金","110/08/19","福邦-新竹",982,0,982
"8706","2888新光金","110/08/19","瑞士信貸",1,3126,-3125
"8707","2888新光金","110/08/19","美商高盛",1215,342,873
"8708","2888新光金","110/08/19","大昌-新竹",2,1424,-1422
"8709","2888新光金","110/08/19","統一-板橋",650,15,635
"8710","2888新光金","110/08/19","元富-虎尾",4,1276,-1272
"8711","2888新光金","110/08/19","凱基-中山",634,3,631
"8712","2888新光金","110/08/19","玉山-台南",134,1204,-1070
"8713","2888新光金","110/08/19","永豐金-鳳山",569,12,557
"8714","2888新光金","110/08/19","宏遠-光隆",25,1050,-1025
"8715","2888新光金","110/08/19","新光",855,323,532
"8716","2888新光金","110/08/19","玉山-板橋",106,841,-735
"8717","2888新光金","110/08/19","統一-台中",558,30,528
"8718","2888新光金","110/08/19","香港上海匯豐",0,728,-728
"8719","2888新光金","110/08/19","凱基-鳳山",525,0,525
"8720","2888新光金","110/08/19","台灣摩根士丹利",940,1609,-669
"8721","2888新光金","110/08/19","統一",577,100,477
"8722","2888新光金","110/08/19","中國信託",15,637,-622
"8723","2888新光金","110/08/19","元大證券",1048,635,413
"8724","2888新光金","110/08/19","元大-永和",20,600,-580
"8725","2888新光金","110/08/19","美林",1075,740,335
"8726","2888新光金","110/08/19","福勝",67,600,-533
"8727","2888新光金","110/08/19","元大-嘉義",315,10,305
"8728","2888新光金","110/08/19","凱基-中港",71,580,-509
"8729","2888新光金","110/08/19","元大-大統",304,13,291
"8730","2888新光金","110/08/19","群益金鼎",50,520,-470
"8731","1340勝悅","110/08/19","國泰-台南",99,3,96
"8732","1340勝悅","110/08/19","元大-成功",0,204,-204
"8733","1340勝悅","110/08/19","台中銀",38,0,38
"8734","1340勝悅","110/08/19","摩根大通",0,20,-20
"8735","1340勝悅","110/08/19","國泰-板橋",13,0,13
"8736","1340勝悅","110/08/19","瑞士信貸",0,12,-12
"8737","1340勝悅","110/08/19","臺銀-金山",10,0,10
"8738","1340勝悅","110/08/19","國票-敦北法人",0,12,-12
"8739","1340勝悅","110/08/19","元富-中港",10,0,10
"8740","1340勝悅","110/08/19","華南永昌-東昇",0,12,-12
"8741","1340勝悅","110/08/19","國泰-敦南",13,3,10
"8742","1340勝悅","110/08/19","永豐金-台南",0,12,-12
"8743","1340勝悅","110/08/19","元富-新店",10,2,8
"8744","1340勝悅","110/08/19","合庫-自強",0,11,-11
"8745","1340勝悅","110/08/19","合庫-新竹",7,0,7
"8746","1340勝悅","110/08/19","富邦-台中",0,5,-5
"8747","1340勝悅","110/08/19","群益金鼎-館前",10,3,7
"8748","1340勝悅","110/08/19","港商法國興業",0,4,-4
"8749","1340勝悅","110/08/19","致和-東門",6,0,6
"8750","1340勝悅","110/08/19","致和-金華",0,4,-4
"8751","1340勝悅","110/08/19","元大-屏南",6,0,6
"8752","1340勝悅","110/08/19","新光-台南",0,4,-4
"8753","1340勝悅","110/08/19","臺灣企銀-埔墘",5,0,5
"8754","1340勝悅","110/08/19","凱基-台北",1,5,-4
"8755","1340勝悅","110/08/19","日盛-和美",5,0,5
"8756","1340勝悅","110/08/19","土銀-南港",0,2,-2
"8757","1340勝悅","110/08/19","第一金-新竹",5,0,5
"8758","1340勝悅","110/08/19","元富-世貿",0,2,-2
"8759","1340勝悅","110/08/19","新光-桃園",5,0,5
"8760","1340勝悅","110/08/19","元大-信義",0,2,-2
"8761","6246臺龍","110/08/19","新光-台中",18,1,17
"8762","6246臺龍","110/08/19","日盛-和美",0,10,-10
"8763","6246臺龍","110/08/19","台灣企銀-台南",10,0,10
"8764","6246臺龍","110/08/19","元大-基隆孝二",0,9,-9
"8765","6246臺龍","110/08/19","凱基-台北",8,2,6
"8766","6246臺龍","110/08/19","港商野村",0,6,-6
"8767","6246臺龍","110/08/19","華南永昌-彰化",5,0,5
"8768","6246臺龍","110/08/19","臺銀-高雄",0,5,-5
"8769","6246臺龍","110/08/19","元大-南投",5,0,5
"8770","6246臺龍","110/08/19","兆豐-公益",0,5,-5
"8771","6246臺龍","110/08/19","元大-林園",5,0,5
"8772","6246臺龍","110/08/19","永豐金-三重",0,5,-5
"8773","6246臺龍","110/08/19","日盛-斗六",4,0,4
"8774","6246臺龍","110/08/19","中國信託",0,4,-4
"8775","6246臺龍","110/08/19","兆豐-新營",4,0,4
"8776","6246臺龍","110/08/19","元大-北成功",0,4,-4
"8777","6246臺龍","110/08/19","(牛牛牛)亞-鑫豐",3,0,3
"8778","6246臺龍","110/08/19","元大-台南",0,4,-4
"8779","6246臺龍","110/08/19","台新-台中",3,0,3
"8780","6246臺龍","110/08/19","元富-烏日",0,3,-3
"8781","6246臺龍","110/08/19","元大-大統",3,0,3
"8782","6246臺龍","110/08/19","玉山-城中",0,3,-3
"8783","6246臺龍","110/08/19","臺銀-民權",2,0,2
"8784","6246臺龍","110/08/19","元大-長庚",0,3,-3
"8785","6246臺龍","110/08/19","第一金-大稻埕",2,0,2
"8786","6246臺龍","110/08/19","元大-苑裡",0,3,-3
"8787","6246臺龍","110/08/19","元富-大昌",2,0,2
"8788","6246臺龍","110/08/19","永豐金-屏東",0,3,-3
"8789","6246臺龍","110/08/19","國票-敦北法人",2,0,2
"8790","6246臺龍","110/08/19","統一-永和",0,2,-2
"8791","00715L期街口布蘭特正2","110/08/19","台新證券",1458,205,1253
"8792","00715L期街口布蘭特正2","110/08/19","元大證券",4224,11178,-6954
"8793","00715L期街口布蘭特正2","110/08/19","富邦-南屯",1119,14,1105
"8794","00715L期街口布蘭特正2","110/08/19","合庫證券",266,2599,-2333
"8795","00715L期街口布蘭特正2","110/08/19","元大-永康",1118,19,1099
"8796","00715L期街口布蘭特正2","110/08/19","永豐金證券",8,2207,-2199
"8797","00715L期街口布蘭特正2","110/08/19","豐農",1023,30,993
"8798","00715L期街口布蘭特正2","110/08/19","元大-屏東民生",14,2200,-2186
"8799","00715L期街口布蘭特正2","110/08/19","元大-復北",954,74,880
"8800","00715L期街口布蘭特正2","110/08/19","凱基-台北",245,1890,-1645
"8801","00715L期街口布蘭特正2","110/08/19","中國信託-新竹",840,0,840
"8802","00715L期街口布蘭特正2","110/08/19","國票-博愛",10,1405,-1395
"8803","00715L期街口布蘭特正2","110/08/19","富邦證券",2317,1629,688
"8804","00715L期街口布蘭特正2","110/08/19","元富",10,1165,-1155
"8805","00715L期街口布蘭特正2","110/08/19","第一金-台南",540,0,540
"8806","00715L期街口布蘭特正2","110/08/19","新光",791,1810,-1019
"8807","00715L期街口布蘭特正2","110/08/19","兆豐-台中港",523,30,493
"8808","00715L期街口布蘭特正2","110/08/19","統一",3,978,-975
"8809","00715L期街口布蘭特正2","110/08/19","兆豐-嘉義",465,110,355
"8810","00715L期街口布蘭特正2","110/08/19","華南永昌-長虹",82,830,-748
"8811","00715L期街口布蘭特正2","110/08/19","元大-大里德芳",323,0,323
"8812","00715L期街口布蘭特正2","110/08/19","群益金鼎-宜蘭",20,737,-717
"8813","00715L期街口布蘭特正2","110/08/19","富邦-基隆",336,20,316
"8814","00715L期街口布蘭特正2","110/08/19","亞東",21,512,-491
"8815","00715L期街口布蘭特正2","110/08/19","元大-草屯",434,124,310
"8816","00715L期街口布蘭特正2","110/08/19","永豐金-板盛",6,420,-414
"8817","00715L期街口布蘭特正2","110/08/19","國泰-敦南",552,280,272
"8818","00715L期街口布蘭特正2","110/08/19","第一金-自由",28,419,-391
"8819","00715L期街口布蘭特正2","110/08/19","永豐金-羅東",270,2,268
"8820","00715L期街口布蘭特正2","110/08/19","元大-高雄",128,502,-374
"8821","8941關中","110/08/19","宏遠-館前",2,0,2
"8822","8941關中","110/08/19","富邦-台中",0,6,-6
"8823","8941關中","110/08/19","元大-西門",2,0,2
"8824","8941關中","110/08/19","兆豐-台中",0,2,-2
"8825","8941關中","110/08/19","新光-台中",1,0,1
"8826","8941關中","110/08/19","元大-金華",1,2,-1
"8827","8941關中","110/08/19","玉山-桃園",1,0,1
"8828","8941關中","110/08/19","兆豐-南京",0,0,0
"8829","8941關中","110/08/19","國泰-忠孝",1,0,1
"8830","8941關中","110/08/19","富邦-仁愛",0,0,0
"8831","8941關中","110/08/19","元大-華山",1,0,1
"8832","8941關中","110/08/19","元大-大雅",0,0,0
"8833","8941關中","110/08/19","元大-桃興",1,0,1
"8834","8941關中","110/08/19","永豐金-敦北",0,0,0
"8835","8941關中","110/08/19","兆豐-南京",0,0,0
"8836","8941關中","110/08/19","永豐金-南投",0,0,0
"8837","8941關中","110/08/19","富邦-仁愛",0,0,0
"8838","8941關中","110/08/19","",NA,NA,NA
"8839","8941關中","110/08/19","元大-大雅",0,0,0
"8840","8941關中","110/08/19","",NA,NA,NA
"8841","8941關中","110/08/19","永豐金-敦北",0,0,0
"8842","8941關中","110/08/19","",NA,NA,NA
"8843","8941關中","110/08/19","永豐金-南投",0,0,0
"8844","8941關中","110/08/19","",NA,NA,NA
"8845","8941關中","110/08/19","",NA,NA,NA
"8846","8941關中","110/08/19","",NA,NA,NA
"8847","8941關中","110/08/19","",NA,NA,NA
"8848","8941關中","110/08/19","",NA,NA,NA
"8849","8941關中","110/08/19","",NA,NA,NA
"8850","8941關中","110/08/19","",NA,NA,NA
"8851","8936國統","110/08/19","宏遠-台南",211,0,211
"8852","8936國統","110/08/19","元大-高雄",0,40,-40
"8853","8936國統","110/08/19","康和-高雄",126,1,125
"8854","8936國統","110/08/19","永豐金-苓雅",0,38,-38
"8855","8936國統","110/08/19","凱基-台北",122,66,56
"8856","8936國統","110/08/19","美商高盛",6,38,-32
"8857","8936國統","110/08/19","美林",54,0,54
"8858","8936國統","110/08/19","港商野村",17,38,-21
"8859","8936國統","110/08/19","新加坡商瑞銀",46,20,26
"8860","8936國統","110/08/19","日盛-頭份",0,20,-20
"8861","8936國統","110/08/19","元富-緯城",25,0,25
"8862","8936國統","110/08/19","兆豐-三重",0,20,-20
"8863","8936國統","110/08/19","富邦-高雄",14,0,14
"8864","8936國統","110/08/19","玉山-桃園",0,20,-20
"8865","8936國統","110/08/19","日盛-復興",10,0,10
"8866","8936國統","110/08/19","國泰-高雄",4,22,-18
"8867","8936國統","110/08/19","宏遠-高雄",18,8,10
"8868","8936國統","110/08/19","台灣摩根士丹利",0,17,-17
"8869","8936國統","110/08/19","中國信託-高雄",20,12,8
"8870","8936國統","110/08/19","凱基-竹科",0,16,-16
"8871","8936國統","110/08/19","日盛-豐原",7,0,7
"8872","8936國統","110/08/19","元大-大里德芳",0,16,-16
"8873","8936國統","110/08/19","元富-三重",7,0,7
"8874","8936國統","110/08/19","大昌-樹林",0,15,-15
"8875","8936國統","110/08/19","台新-高雄",10,3,7
"8876","8936國統","110/08/19","台新-屏東",0,12,-12
"8877","8936國統","110/08/19","臺銀-高雄",6,0,6
"8878","8936國統","110/08/19","中農",0,11,-11
"8879","8936國統","110/08/19","第一金-路竹",6,0,6
"8880","8936國統","110/08/19","臺銀-新竹",0,10,-10
"8881","6226光鼎","110/08/19","富邦-左營",110,2,108
"8882","6226光鼎","110/08/19","凱基-台北",177,732,-555
"8883","6226光鼎","110/08/19","元大-北屯",151,50,101
"8884","6226光鼎","110/08/19","摩根大通",28,396,-368
"8885","6226光鼎","110/08/19","國泰-敦南",201,125,76
"8886","6226光鼎","110/08/19","台灣摩根士丹利",0,254,-254
"8887","6226光鼎","110/08/19","元大-敦化",56,4,52
"8888","6226光鼎","110/08/19","元大-文心興安",1,230,-229
"8889","6226光鼎","110/08/19","兆豐-中壢",50,1,49
"8890","6226光鼎","110/08/19","美商高盛",33,233,-200
"8891","6226光鼎","110/08/19","凱基-台中",44,2,42
"8892","6226光鼎","110/08/19","富邦-台北",22,202,-180
"8893","6226光鼎","110/08/19","新光",121,81,40
"8894","6226光鼎","110/08/19","美林",72,160,-88
"8895","6226光鼎","110/08/19","合庫-西台中",47,10,37
"8896","6226光鼎","110/08/19","新加坡商瑞銀",138,225,-87
"8897","6226光鼎","110/08/19","元大-龍潭",42,5,37
"8898","6226光鼎","110/08/19","元大-南勢角",0,70,-70
"8899","6226光鼎","110/08/19","兆豐-東門",36,0,36
"8900","6226光鼎","110/08/19","臺銀-高雄",0,67,-67
"8901","6226光鼎","110/08/19","新光-台中",83,48,35
"8902","6226光鼎","110/08/19","港商野村",178,231,-53
"8903","6226光鼎","110/08/19","玉山-桃園",39,4,35
"8904","6226光鼎","110/08/19","永豐金-內湖",6,56,-50
"8905","6226光鼎","110/08/19","元大-竹科",59,24,35
"8906","6226光鼎","110/08/19","高橋-內壢",5,54,-49
"8907","6226光鼎","110/08/19","第一金-台南",33,0,33
"8908","6226光鼎","110/08/19","凱基-員林",7,53,-46
"8909","6226光鼎","110/08/19","台新證券",66,33,33
"8910","6226光鼎","110/08/19","台新-台中",28,65,-37
"8911","2363矽統","110/08/19","日盛-樹林",300,12,288
"8912","2363矽統","110/08/19","凱基-台北",560,1671,-1111
"8913","2363矽統","110/08/19","永豐金-板盛",200,2,198
"8914","2363矽統","110/08/19","摩根大通",3,713,-710
"8915","2363矽統","110/08/19","凱基-三峽",134,18,116
"8916","2363矽統","110/08/19","台新-三民",50,291,-241
"8917","2363矽統","110/08/19","富邦-新竹",94,7,87
"8918","2363矽統","110/08/19","台灣摩根士丹利",0,206,-206
"8919","2363矽統","110/08/19","元大-汐止",75,8,67
"8920","2363矽統","110/08/19","凱基-和平",1,132,-131
"8921","2363矽統","110/08/19","元大-斗六",67,2,65
"8922","2363矽統","110/08/19","永豐金證券",12,125,-113
"8923","2363矽統","110/08/19","大慶-蘆洲",69,13,56
"8924","2363矽統","110/08/19","石橋證券",50,155,-105
"8925","2363矽統","110/08/19","永豐金-豐原",55,2,53
"8926","2363矽統","110/08/19","港商野村",838,925,-87
"8927","2363矽統","110/08/19","日盛-豐原",59,10,49
"8928","2363矽統","110/08/19","新光-桃園",4,87,-83
"8929","2363矽統","110/08/19","群益金鼎-中壢",54,7,47
"8930","2363矽統","110/08/19","新光",212,282,-70
"8931","2363矽統","110/08/19","元大-南投",58,12,46
"8932","2363矽統","110/08/19","陽信-石牌",18,83,-65
"8933","2363矽統","110/08/19","富邦-板橋",51,7,44
"8934","2363矽統","110/08/19","美林",31,91,-60
"8935","2363矽統","110/08/19","台新證券",117,74,43
"8936","2363矽統","110/08/19","永豐金-新店",1,59,-58
"8937","2363矽統","110/08/19","元大-東港",45,2,43
"8938","2363矽統","110/08/19","台新-左楠",19,76,-57
"8939","2363矽統","110/08/19","元大-旗山",47,5,42
"8940","2363矽統","110/08/19","永全-南崁",7,53,-46
"8941","8112至上","110/08/19","元大-敦化",60,0,60
"8942","8112至上","110/08/19","港商野村",22,279,-257
"8943","8112至上","110/08/19","玉山-城中",60,2,58
"8944","8112至上","110/08/19","瑞士信貸",0,239,-239
"8945","8112至上","110/08/19","永豐金-敦南",52,4,48
"8946","8112至上","110/08/19","凱基-台北",101,275,-174
"8947","8112至上","110/08/19","統一",41,0,41
"8948","8112至上","110/08/19","摩根大通",161,332,-171
"8949","8112至上","110/08/19","元大-竹東",36,0,36
"8950","8112至上","110/08/19","凱基-市政",0,80,-80
"8951","8112至上","110/08/19","凱基-嘉義",35,0,35
"8952","8112至上","110/08/19","台灣摩根士丹利",6,75,-69
"8953","8112至上","110/08/19","新光-台南",32,0,32
"8954","8112至上","110/08/19","美商高盛",18,76,-58
"8955","8112至上","110/08/19","永興-水湳",30,0,30
"8956","8112至上","110/08/19","新加坡商瑞銀",22,76,-54
"8957","8112至上","110/08/19","元大-永和",29,0,29
"8958","8112至上","110/08/19","美林",9,61,-52
"8959","8112至上","110/08/19","凱基-東勢",26,1,25
"8960","8112至上","110/08/19","富邦-花蓮",1,51,-50
"8961","8112至上","110/08/19","臺銀-臺南",28,4,24
"8962","8112至上","110/08/19","元大-路竹",8,52,-44
"8963","8112至上","110/08/19","富邦-中壢",29,5,24
"8964","8112至上","110/08/19","(牛牛牛)亞-鑫豐",34,77,-43
"8965","8112至上","110/08/19","第一金-桃園",24,1,23
"8966","8112至上","110/08/19","台新-中壢",2,42,-40
"8967","8112至上","110/08/19","國泰-敦南",27,4,23
"8968","8112至上","110/08/19","國泰證券",0,40,-40
"8969","8112至上","110/08/19","凱基-文心",23,0,23
"8970","8112至上","110/08/19","永豐金-苓雅",0,40,-40
"8971","1570力肯","110/08/19","國票-北高雄",37,0,37
"8972","1570力肯","110/08/19","新光-台南",3,44,-41
"8973","1570力肯","110/08/19","康和-台南",30,0,30
"8974","1570力肯","110/08/19","元大-大統",0,20,-20
"8975","1570力肯","110/08/19","國票-內壢",25,0,25
"8976","1570力肯","110/08/19","元富-新店",0,18,-18
"8977","1570力肯","110/08/19","元富-虎尾",20,0,20
"8978","1570力肯","110/08/19","元大-民生",2,19,-17
"8979","1570力肯","110/08/19","國票-博愛",17,0,17
"8980","1570力肯","110/08/19","國泰-敦南",1,16,-15
"8981","1570力肯","110/08/19","日盛-高雄",15,0,15
"8982","1570力肯","110/08/19","富邦-敦南",0,15,-15
"8983","1570力肯","110/08/19","元大-南投",15,0,15
"8984","1570力肯","110/08/19","元大-大雅",10,25,-15
"8985","1570力肯","110/08/19","富邦-嘉義",15,1,14
"8986","1570力肯","110/08/19","日盛-板橋",2,16,-14
"8987","1570力肯","110/08/19","元大-北投",13,0,13
"8988","1570力肯","110/08/19","華南永昌-嘉義",0,12,-12
"8989","1570力肯","110/08/19","元富-緯城",12,0,12
"8990","1570力肯","110/08/19","凱基-台北",3,14,-11
"8991","1570力肯","110/08/19","土銀-新竹",11,0,11
"8992","1570力肯","110/08/19","元富-草屯",0,10,-10
"8993","1570力肯","110/08/19","日盛-嘉義",11,0,11
"8994","1570力肯","110/08/19","新光",7,17,-10
"8995","1570力肯","110/08/19","富邦-羅東",11,0,11
"8996","1570力肯","110/08/19","富邦-內湖",3,13,-10
"8997","1570力肯","110/08/19","富邦-仁愛",10,0,10
"8998","1570力肯","110/08/19","元大-福營",0,10,-10
"8999","1570力肯","110/08/19","元大-羅東",10,0,10
"9000","1570力肯","110/08/19","元大-松山",0,10,-10
"9001","2929淘帝","110/08/19","元大-太平",54,0,54
"9002","2929淘帝","110/08/19","摩根大通",0,58,-58
"9003","2929淘帝","110/08/19","凱基-東門",32,0,32
"9004","2929淘帝","110/08/19","宏遠-館前",0,35,-35
"9005","2929淘帝","110/08/19","日盛-桃園",20,0,20
"9006","2929淘帝","110/08/19","元富-台南",0,32,-32
"9007","2929淘帝","110/08/19","富邦-高雄",16,0,16
"9008","2929淘帝","110/08/19","日茂",0,20,-20
"9009","2929淘帝","110/08/19","元大-員林",11,0,11
"9010","2929淘帝","110/08/19","美商高盛",0,11,-11
"9011","2929淘帝","110/08/19","凱基-中山",10,0,10
"9012","2929淘帝","110/08/19","凱基-站前",0,10,-10
"9013","2929淘帝","110/08/19","富邦-南屯",7,0,7
"9014","2929淘帝","110/08/19","統一-三重",0,8,-8
"9015","2929淘帝","110/08/19","日盛-雙和",6,0,6
"9016","2929淘帝","110/08/19","群益金鼎",0,7,-7
"9017","2929淘帝","110/08/19","亞東-新竹",6,0,6
"9018","2929淘帝","110/08/19","凱基-八德",0,7,-7
"9019","2929淘帝","110/08/19","兆豐-桃鶯",6,0,6
"9020","2929淘帝","110/08/19","港商野村",3,9,-6
"9021","2929淘帝","110/08/19","新光",6,0,6
"9022","2929淘帝","110/08/19","安泰",0,5,-5
"9023","2929淘帝","110/08/19","群益金鼎-三重",5,0,5
"9024","2929淘帝","110/08/19","元大-金門",0,5,-5
"9025","2929淘帝","110/08/19","元大-左營",5,0,5
"9026","2929淘帝","110/08/19","永豐金-竹科",0,5,-5
"9027","2929淘帝","110/08/19","台新-新莊",9,5,4
"9028","2929淘帝","110/08/19","致和證券",0,4,-4
"9029","2929淘帝","110/08/19","群益金鼎-新店",4,0,4
"9030","2929淘帝","110/08/19","元大-苑裡",0,4,-4
"9031","5410國眾","110/08/19","土銀-嘉義",14,0,14
"9032","5410國眾","110/08/19","致和-台北",0,60,-60
"9033","5410國眾","110/08/19","國票-北高雄",10,0,10
"9034","5410國眾","110/08/19","凱基-台北",1,20,-19
"9035","5410國眾","110/08/19","玉山-城中",10,0,10
"9036","5410國眾","110/08/19","新加坡商瑞銀",0,14,-14
"9037","5410國眾","110/08/19","元大-中壢",9,0,9
"9038","5410國眾","110/08/19","亞東-新竹",0,14,-14
"9039","5410國眾","110/08/19","台新證券",8,0,8
"9040","5410國眾","110/08/19","富邦-永和",0,7,-7
"9041","5410國眾","110/08/19","新光",7,1,6
"9042","5410國眾","110/08/19","摩根大通",0,5,-5
"9043","5410國眾","110/08/19","日盛-八德",5,0,5
"9044","5410國眾","110/08/19","元大-南勢角",0,3,-3
"9045","5410國眾","110/08/19","元大-旗山",5,0,5
"9046","5410國眾","110/08/19","元大-板橋三民",0,3,-3
"9047","5410國眾","110/08/19","元大-博愛",5,0,5
"9048","5410國眾","110/08/19","元富-大昌",0,2,-2
"9049","5410國眾","110/08/19","元大-左營",5,0,5
"9050","5410國眾","110/08/19","台中銀-員林",0,2,-2
"9051","5410國眾","110/08/19","臺銀-金山",6,2,4
"9052","5410國眾","110/08/19","台新-左楠",0,2,-2
"9053","5410國眾","110/08/19","統一-台中",4,0,4
"9054","5410國眾","110/08/19","群益金鼎-東門",0,2,-2
"9055","5410國眾","110/08/19","元大-開元",4,0,4
"9056","5410國眾","110/08/19","凱基-汐止",0,2,-2
"9057","5410國眾","110/08/19","日盛-園區",3,0,3
"9058","5410國眾","110/08/19","華南永昌-小港",0,2,-2
"9059","5410國眾","110/08/19","國泰-敦南",3,0,3
"9060","5410國眾","110/08/19","富邦-新店",0,2,-2
"9061","2841台開","110/08/19","宏遠-館前",360,0,360
"9062","2841台開","110/08/19","元大證券",0,108,-108
"9063","2841台開","110/08/19","第一金",104,0,104
"9064","2841台開","110/08/19","國票-敦北法人",0,98,-98
"9065","2841台開","110/08/19","日盛-台中",35,1,34
"9066","2841台開","110/08/19","台中銀",0,93,-93
"9067","2841台開","110/08/19","合庫證券",20,0,20
"9068","2841台開","110/08/19","元大-府城",0,51,-51
"9069","2841台開","110/08/19","第一金-台中",20,0,20
"9070","2841台開","110/08/19","日盛-信義",0,50,-50
"9071","2841台開","110/08/19","富邦-基隆",20,0,20
"9072","2841台開","110/08/19","新光-台南",0,46,-46
"9073","2841台開","110/08/19","富邦-三重",20,0,20
"9074","2841台開","110/08/19","永豐金-桃園",0,41,-41
"9075","2841台開","110/08/19","元大-六合",17,0,17
"9076","2841台開","110/08/19","凱基-高美館",0,30,-30
"9077","2841台開","110/08/19","國泰-館前",11,0,11
"9078","2841台開","110/08/19","凱基-新豐",0,30,-30
"9079","2841台開","110/08/19","統一-新台中",10,0,10
"9080","2841台開","110/08/19","第一金-忠孝",0,20,-20
"9081","2841台開","110/08/19","玉山證券",10,0,10
"9082","2841台開","110/08/19","富邦-員林",0,20,-20
"9083","2841台開","110/08/19","國泰-台中",10,0,10
"9084","2841台開","110/08/19","日盛證券",22,38,-16
"9085","2841台開","110/08/19","國泰-忠孝",10,0,10
"9086","2841台開","110/08/19","國泰-敦南",3,19,-16
"9087","2841台開","110/08/19","元大-東泰",10,0,10
"9088","2841台開","110/08/19","中國信託-嘉義",0,15,-15
"9089","2841台開","110/08/19","元大-高雄",10,0,10
"9090","2841台開","110/08/19","永豐金-敦南",17,29,-12
"9091","6207雷科","110/08/19","元大-高雄",76,0,76
"9092","6207雷科","110/08/19","凱基-大安",0,50,-50
"9093","6207雷科","110/08/19","光和-和美",53,0,53
"9094","6207雷科","110/08/19","凱基-復興",2,30,-28
"9095","6207雷科","110/08/19","日盛-桃園",10,0,10
"9096","6207雷科","110/08/19","日盛-三重",0,23,-23
"9097","6207雷科","110/08/19","元大-六合",10,0,10
"9098","6207雷科","110/08/19","港商野村",8,30,-22
"9099","6207雷科","110/08/19","凱基-台北",21,13,8
"9100","6207雷科","110/08/19","新加坡商瑞銀",12,29,-17
"9101","6207雷科","110/08/19","永豐金-高雄",8,0,8
"9102","6207雷科","110/08/19","日茂-埔里",0,17,-17
"9103","6207雷科","110/08/19","凱基-高雄",7,0,7
"9104","6207雷科","110/08/19","摩根大通",7,21,-14
"9105","6207雷科","110/08/19","元大-沙鹿",6,0,6
"9106","6207雷科","110/08/19","群益金鼎-東門",0,12,-12
"9107","6207雷科","110/08/19","元大-東門",6,0,6
"9108","6207雷科","110/08/19","富邦-虎尾",0,10,-10
"9109","6207雷科","110/08/19","元富-吉利",5,0,5
"9110","6207雷科","110/08/19","凱基-高美館",5,14,-9
"9111","6207雷科","110/08/19","大昌-桃園",5,0,5
"9112","6207雷科","110/08/19","富邦-板橋",0,8,-8
"9113","6207雷科","110/08/19","玉山-大里",5,0,5
"9114","6207雷科","110/08/19","元富-潮州",0,7,-7
"9115","6207雷科","110/08/19","元大-大益",5,0,5
"9116","6207雷科","110/08/19","凱基-員林",0,7,-7
"9117","6207雷科","110/08/19","元大-福營",4,0,4
"9118","6207雷科","110/08/19","華南永昌-林口",0,7,-7
"9119","6207雷科","110/08/19","臺銀-臺中",3,0,3
"9120","6207雷科","110/08/19","日盛-八德",0,6,-6
"9121","3679新至陞","110/08/19","台灣摩根士丹利",7,0,7
"9122","3679新至陞","110/08/19","摩根大通",3,11,-8
"9123","3679新至陞","110/08/19","元大-板橋",6,0,6
"9124","3679新至陞","110/08/19","瑞士信貸",1,6,-5
"9125","3679新至陞","110/08/19","美林",10,5,5
"9126","3679新至陞","110/08/19","美商高盛",0,3,-3
"9127","3679新至陞","110/08/19","日盛-土城",2,0,2
"9128","3679新至陞","110/08/19","宏遠-館前",0,2,-2
"9129","3679新至陞","110/08/19","富邦-新店",2,0,2
"9130","3679新至陞","110/08/19","港商野村",0,2,-2
"9131","3679新至陞","110/08/19","土銀-新竹",1,0,1
"9132","3679新至陞","110/08/19","花旗環球",0,2,-2
"9133","3679新至陞","110/08/19","臺銀-高雄",1,0,1
"9134","3679新至陞","110/08/19","國泰-高雄",0,2,-2
"9135","3679新至陞","110/08/19","(牛牛牛)亞-網路",1,0,1
"9136","3679新至陞","110/08/19","元大證券",1,3,-2
"9137","3679新至陞","110/08/19","中國信託-永康",1,0,1
"9138","3679新至陞","110/08/19","元大-新店中正",0,2,-2
"9139","3679新至陞","110/08/19","光和-溪湖",1,0,1
"9140","3679新至陞","110/08/19","元大-成功",0,2,-2
"9141","3679新至陞","110/08/19","兆豐證券",1,0,1
"9142","3679新至陞","110/08/19","永豐金-板新",0,2,-2
"9143","3679新至陞","110/08/19","國票-台東",1,0,1
"9144","3679新至陞","110/08/19","土銀-和平",0,1,-1
"9145","3679新至陞","110/08/19","玉山-新莊",1,0,1
"9146","3679新至陞","110/08/19","新加坡商瑞銀",0,1,-1
"9147","3679新至陞","110/08/19","玉山-嘉義",1,0,1
"9148","3679新至陞","110/08/19","第一金-忠孝",0,1,-1
"9149","3679新至陞","110/08/19","群益金鼎-高盛",1,0,1
"9150","3679新至陞","110/08/19","凱基",0,1,-1
"9151","2727王品","110/08/19","日盛-忠孝",36,0,36
"9152","2727王品","110/08/19","宏遠證券",0,75,-75
"9153","2727王品","110/08/19","中國信託-高雄",12,0,12
"9154","2727王品","110/08/19","美林",0,49,-49
"9155","2727王品","110/08/19","國泰-敦南",17,6,11
"9156","2727王品","110/08/19","摩根大通",1,47,-46
"9157","2727王品","110/08/19","群益金鼎-新店",10,0,10
"9158","2727王品","110/08/19","永豐金證券",2,45,-43
"9159","2727王品","110/08/19","富邦-羅東",10,0,10
"9160","2727王品","110/08/19","美商高盛",2,39,-37
"9161","2727王品","110/08/19","富邦-仁愛",9,0,9
"9162","2727王品","110/08/19","凱基-台北",27,56,-29
"9163","2727王品","110/08/19","國泰-台中",14,6,8
"9164","2727王品","110/08/19","新光-台中",5,28,-23
"9165","2727王品","110/08/19","元大-北屯",10,2,8
"9166","2727王品","110/08/19","台灣摩根士丹利",1,21,-20
"9167","2727王品","110/08/19","元富-大昌",7,0,7
"9168","2727王品","110/08/19","凱基-東門",0,18,-18
"9169","2727王品","110/08/19","台新-台中",9,2,7
"9170","2727王品","110/08/19","統一",0,17,-17
"9171","2727王品","110/08/19","新光-新竹",7,0,7
"9172","2727王品","110/08/19","瑞士信貸",2,13,-11
"9173","2727王品","110/08/19","凱基-基隆",7,0,7
"9174","2727王品","110/08/19","新加坡商瑞銀",0,11,-11
"9175","2727王品","110/08/19","宏遠-高雄",6,0,6
"9176","2727王品","110/08/19","港商野村",18,28,-10
"9177","2727王品","110/08/19","台新證券",6,0,6
"9178","2727王品","110/08/19","富邦-新店",1,11,-10
"9179","2727王品","110/08/19","玉山證券",6,0,6
"9180","2727王品","110/08/19","元大-善化",0,10,-10
"9181","1570力肯","110/08/19","國票-北高雄",37,0,37
"9182","1570力肯","110/08/19","新光-台南",3,44,-41
"9183","1570力肯","110/08/19","康和-台南",30,0,30
"9184","1570力肯","110/08/19","元大-大統",0,20,-20
"9185","1570力肯","110/08/19","國票-內壢",25,0,25
"9186","1570力肯","110/08/19","元富-新店",0,18,-18
"9187","1570力肯","110/08/19","元富-虎尾",20,0,20
"9188","1570力肯","110/08/19","元大-民生",2,19,-17
"9189","1570力肯","110/08/19","國票-博愛",17,0,17
"9190","1570力肯","110/08/19","國泰-敦南",1,16,-15
"9191","1570力肯","110/08/19","日盛-高雄",15,0,15
"9192","1570力肯","110/08/19","富邦-敦南",0,15,-15
"9193","1570力肯","110/08/19","元大-南投",15,0,15
"9194","1570力肯","110/08/19","元大-大雅",10,25,-15
"9195","1570力肯","110/08/19","富邦-嘉義",15,1,14
"9196","1570力肯","110/08/19","日盛-板橋",2,16,-14
"9197","1570力肯","110/08/19","元大-北投",13,0,13
"9198","1570力肯","110/08/19","華南永昌-嘉義",0,12,-12
"9199","1570力肯","110/08/19","元富-緯城",12,0,12
"9200","1570力肯","110/08/19","凱基-台北",3,14,-11
"9201","1570力肯","110/08/19","土銀-新竹",11,0,11
"9202","1570力肯","110/08/19","元富-草屯",0,10,-10
"9203","1570力肯","110/08/19","日盛-嘉義",11,0,11
"9204","1570力肯","110/08/19","新光",7,17,-10
"9205","1570力肯","110/08/19","富邦-羅東",11,0,11
"9206","1570力肯","110/08/19","富邦-內湖",3,13,-10
"9207","1570力肯","110/08/19","富邦-仁愛",10,0,10
"9208","1570力肯","110/08/19","元大-福營",0,10,-10
"9209","1570力肯","110/08/19","元大-羅東",10,0,10
"9210","1570力肯","110/08/19","元大-松山",0,10,-10
"9211","6180橘子","110/08/19","美林",29,0,29
"9212","6180橘子","110/08/19","新光-台中",4,23,-19
"9213","6180橘子","110/08/19","美商高盛",24,0,24
"9214","6180橘子","110/08/19","元大-大甲",0,16,-16
"9215","6180橘子","110/08/19","富邦-竹東",21,0,21
"9216","6180橘子","110/08/19","元富-城東",1,13,-12
"9217","6180橘子","110/08/19","第一金-新竹",20,0,20
"9218","6180橘子","110/08/19","凱基-台北",2,13,-11
"9219","6180橘子","110/08/19","富邦-永和",11,0,11
"9220","6180橘子","110/08/19","凱基-竹科",1,12,-11
"9221","6180橘子","110/08/19","合庫-自強",10,0,10
"9222","6180橘子","110/08/19","元富-草屯",0,10,-10
"9223","6180橘子","110/08/19","富邦-新竹",12,2,10
"9224","6180橘子","110/08/19","新光",8,18,-10
"9225","6180橘子","110/08/19","元大-中壢",10,1,9
"9226","6180橘子","110/08/19","凱基-站前",0,10,-10
"9227","6180橘子","110/08/19","國泰-板橋",7,1,6
"9228","6180橘子","110/08/19","元大-文心興安",0,10,-10
"9229","6180橘子","110/08/19","富隆-長安",5,0,5
"9230","6180橘子","110/08/19","永豐金-新店",0,10,-10
"9231","6180橘子","110/08/19","大慶-苗栗",5,0,5
"9232","6180橘子","110/08/19","兆豐-新營",1,10,-9
"9233","6180橘子","110/08/19","台新-屏東",5,0,5
"9234","6180橘子","110/08/19","元大-北屯",1,10,-9
"9235","6180橘子","110/08/19","元大-向上",5,0,5
"9236","6180橘子","110/08/19","摩根大通",28,36,-8
"9237","6180橘子","110/08/19","永豐金-竹科",5,0,5
"9238","6180橘子","110/08/19","凱基-市政",0,7,-7
"9239","6180橘子","110/08/19","土銀-新竹",4,0,4
"9240","6180橘子","110/08/19","台灣摩根士丹利",11,17,-6
"9241","2390云辰","110/08/19","富邦-花蓮",100,0,100
"9242","2390云辰","110/08/19","摩根大通",96,805,-709
"9243","2390云辰","110/08/19","統一-新台中",86,0,86
"9244","2390云辰","110/08/19","美林",195,271,-76
"9245","2390云辰","110/08/19","凱基-台北",335,254,81
"9246","2390云辰","110/08/19","兆豐-桃園",15,90,-75
"9247","2390云辰","110/08/19","國票-博愛",132,54,78
"9248","2390云辰","110/08/19","大昌-新店",27,92,-65
"9249","2390云辰","110/08/19","凱基-台中",77,1,76
"9250","2390云辰","110/08/19","宏遠-桃園",1,63,-62
"9251","2390云辰","110/08/19","凱基-和平",60,2,58
"9252","2390云辰","110/08/19","華南永昌-公誠",53,110,-57
"9253","2390云辰","110/08/19","國票-安和",53,10,43
"9254","2390云辰","110/08/19","大慶-富順",11,67,-56
"9255","2390云辰","110/08/19","元大-四維",46,10,36
"9256","2390云辰","110/08/19","元大-歸仁",2,55,-53
"9257","2390云辰","110/08/19","中農",55,20,35
"9258","2390云辰","110/08/19","日茂",7,58,-51
"9259","2390云辰","110/08/19","第一金-安和",55,22,33
"9260","2390云辰","110/08/19","元大-大灣",10,60,-50
"9261","2390云辰","110/08/19","元大-雙和",42,12,30
"9262","2390云辰","110/08/19","凱基-三重",1,48,-47
"9263","2390云辰","110/08/19","國泰-館前",77,48,29
"9264","2390云辰","110/08/19","國票-台東",2,41,-39
"9265","2390云辰","110/08/19","元大-文心興安",42,13,29
"9266","2390云辰","110/08/19","豐農",7,41,-34
"9267","2390云辰","110/08/19","(牛牛牛)亞-鑫豐",59,31,28
"9268","2390云辰","110/08/19","凱基-中港",5,36,-31
"9269","2390云辰","110/08/19","國泰-高雄",44,18,26
"9270","2390云辰","110/08/19","永豐金-嘉義",3,32,-29
"9271","2609陽明","110/08/18","凱基-台北",15132,4630,10502
"9272","2609陽明","110/08/18","兆豐-復興",1580,3572,-1992
"9273","2609陽明","110/08/18","康和",4145,283,3862
"9274","2609陽明","110/08/18","日盛-板橋",943,2532,-1589
"9275","2609陽明","110/08/18","美林",6982,3580,3402
"9276","2609陽明","110/08/18","國泰-敦南",4957,6082,-1125
"9277","2609陽明","110/08/18","富邦證券",5335,3049,2286
"9278","2609陽明","110/08/18","新光",3470,4443,-973
"9279","2609陽明","110/08/18","兆豐-南京",2352,209,2143
"9280","2609陽明","110/08/18","玉山證券",1002,1913,-911
"9281","2609陽明","110/08/18","兆豐-虎尾",4490,2388,2102
"9282","2609陽明","110/08/18","台新證券",2873,3601,-728
"9283","2609陽明","110/08/18","永豐金-信義",1719,99,1620
"9284","2609陽明","110/08/18","國泰-館前",1002,1633,-631
"9285","2609陽明","110/08/18","摩根大通",9173,7611,1562
"9286","2609陽明","110/08/18","日盛-中壢",255,825,-570
"9287","2609陽明","110/08/18","台灣摩根士丹利",2544,1230,1314
"9288","2609陽明","110/08/18","兆豐-板橋",646,1122,-476
"9289","2609陽明","110/08/18","凱基-斗六",4335,3037,1298
"9290","2609陽明","110/08/18","第一金-嘉義",153,589,-436
"9291","2609陽明","110/08/18","統一",1895,653,1242
"9292","2609陽明","110/08/18","第一金-桃園",168,595,-427
"9293","2609陽明","110/08/18","元大證券",3293,2063,1230
"9294","2609陽明","110/08/18","(牛牛牛)亞-鑫豐",283,690,-407
"9295","2609陽明","110/08/18","富邦-仁愛",2205,1064,1141
"9296","2609陽明","110/08/18","國泰-板橋",1508,1913,-405
"9297","2609陽明","110/08/18","富邦-虎尾",10781,9680,1101
"9298","2609陽明","110/08/18","凱基-市政",9806,10201,-395
"9299","2609陽明","110/08/18","元大-頭份",1219,381,838
"9300","2609陽明","110/08/18","凱基-高美館",607,1000,-393
"9301","2636台驊投控","110/08/18","富邦證券",1190,0,1190
"9302","2636台驊投控","110/08/18","凱基",21,470,-449
"9303","2636台驊投控","110/08/18","摩根大通",1639,646,993
"9304","2636台驊投控","110/08/18","玉山-南京東路",3,355,-352
"9305","2636台驊投控","110/08/18","台灣摩根士丹利",825,36,789
"9306","2636台驊投控","110/08/18","統一-新台中",15,291,-276
"9307","2636台驊投控","110/08/18","凱基-台北",881,309,572
"9308","2636台驊投控","110/08/18","永豐金-新竹",38,292,-254
"9309","2636台驊投控","110/08/18","統一",503,143,360
"9310","2636台驊投控","110/08/18","國票-彰化",518,760,-242
"9311","2636台驊投控","110/08/18","富邦-員林",373,78,295
"9312","2636台驊投控","110/08/18","國泰-敦南",456,601,-145
"9313","2636台驊投控","110/08/18","新加坡商瑞銀",307,50,257
"9314","2636台驊投控","110/08/18","日盛-宜蘭",12,143,-131
"9315","2636台驊投控","110/08/18","美林",863,611,252
"9316","2636台驊投控","110/08/18","日盛-景美",26,156,-130
"9317","2636台驊投控","110/08/18","日盛-台中",273,57,216
"9318","2636台驊投控","110/08/18","日盛證券",180,298,-118
"9319","2636台驊投控","110/08/18","日盛-板橋",166,13,153
"9320","2636台驊投控","110/08/18","第一金-桃園",36,154,-118
"9321","2636台驊投控","110/08/18","兆豐-虎尾",169,20,149
"9322","2636台驊投控","110/08/18","新光",402,503,-101
"9323","2636台驊投控","110/08/18","華南永昌-竹北",221,84,137
"9324","2636台驊投控","110/08/18","凱基-市政",93,185,-92
"9325","2636台驊投控","110/08/18","大慶",123,6,117
"9326","2636台驊投控","110/08/18","台新證券",371,450,-79
"9327","2636台驊投控","110/08/18","美商高盛",432,323,109
"9328","2636台驊投控","110/08/18","凱基-天母",2,81,-79
"9329","2636台驊投控","110/08/18","統一-南京",102,33,69
"9330","2636台驊投控","110/08/18","華南永昌-南京",30,101,-71
"9331","2867三商壽","110/08/18","摩根大通",776,115,661
"9332","2867三商壽","110/08/18","華南永昌",2,804,-802
"9333","2867三商壽","110/08/18","美林",510,38,472
"9334","2867三商壽","110/08/18","富邦-陽明",0,253,-253
"9335","2867三商壽","110/08/18","元富-世貿",164,15,149
"9336","2867三商壽","110/08/18","宏遠證券",0,220,-220
"9337","2867三商壽","110/08/18","元大-桃園",110,1,109
"9338","2867三商壽","110/08/18","元大-崇德",0,178,-178
"9339","2867三商壽","110/08/18","新加坡商瑞銀",168,73,95
"9340","2867三商壽","110/08/18","元大證券",7,143,-136
"9341","2867三商壽","110/08/18","台新證券",97,2,95
"9342","2867三商壽","110/08/18","土銀-新竹",0,86,-86
"9343","2867三商壽","110/08/18","康和-台中",90,1,89
"9344","2867三商壽","110/08/18","統一-台中",0,82,-82
"9345","2867三商壽","110/08/18","富邦-三重",90,6,84
"9346","2867三商壽","110/08/18","富邦-嘉義",0,70,-70
"9347","2867三商壽","110/08/18","元富",70,0,70
"9348","2867三商壽","110/08/18","宏遠-台中",7,71,-64
"9349","2867三商壽","110/08/18","兆豐-寶成",70,1,69
"9350","2867三商壽","110/08/18","富邦-南屯",0,63,-63
"9351","2867三商壽","110/08/18","台新-台中",68,13,55
"9352","2867三商壽","110/08/18","元大-大甲",1,61,-60
"9353","2867三商壽","110/08/18","凱基",51,0,51
"9354","2867三商壽","110/08/18","美商高盛",32,87,-55
"9355","2867三商壽","110/08/18","元大-開元",51,0,51
"9356","2867三商壽","110/08/18","元富-大裕",0,50,-50
"9357","2867三商壽","110/08/18","日盛-頭份",50,0,50
"9358","2867三商壽","110/08/18","富邦-高雄",1,48,-47
"9359","2867三商壽","110/08/18","兆豐-台中",50,0,50
"9360","2867三商壽","110/08/18","元大-台北",0,40,-40
"9361","5521工信","110/08/18","台新證券",144,10,134
"9362","5521工信","110/08/18","台新-台中",0,200,-200
"9363","5521工信","110/08/18","群益金鼎-台中",43,0,43
"9364","5521工信","110/08/18","香港上海匯豐",0,143,-143
"9365","5521工信","110/08/18","富邦-嘉義",31,0,31
"9366","5521工信","110/08/18","日盛-雙和",0,100,-100
"9367","5521工信","110/08/18","華南永昌-林口",30,1,29
"9368","5521工信","110/08/18","元大-沙鹿",0,61,-61
"9369","5521工信","110/08/18","日進",25,0,25
"9370","5521工信","110/08/18","凱基-台北",57,116,-59
"9371","5521工信","110/08/18","國泰-敦南",26,3,23
"9372","5521工信","110/08/18","美林",3,61,-58
"9373","5521工信","110/08/18","群益金鼎-高雄",20,0,20
"9374","5521工信","110/08/18","永豐金-桃盛",0,50,-50
"9375","5521工信","110/08/18","元大-屏南",20,0,20
"9376","5521工信","110/08/18","摩根大通",106,150,-44
"9377","5521工信","110/08/18","元大-基隆孝二",20,0,20
"9378","5521工信","110/08/18","大慶-富順",0,42,-42
"9379","5521工信","110/08/18","永豐金-新店",20,0,20
"9380","5521工信","110/08/18","元大-鳳山",0,30,-30
"9381","5521工信","110/08/18","元大-龍潭",17,0,17
"9382","5521工信","110/08/18","凱基-三重",25,50,-25
"9383","5521工信","110/08/18","兆豐-北高雄",16,0,16
"9384","5521工信","110/08/18","光和-田中",2,24,-22
"9385","5521工信","110/08/18","元富-文心",15,0,15
"9386","5521工信","110/08/18","元大-和平",0,20,-20
"9387","5521工信","110/08/18","元大-前金",15,0,15
"9388","5521工信","110/08/18","華南永昌",0,15,-15
"9389","5521工信","110/08/18","元大-北投",15,0,15
"9390","5521工信","110/08/18","凱基-南崁",0,12,-12
"9391","1471首利","110/08/18","摩根大通",195,17,178
"9392","1471首利","110/08/18","元大-西門",16,81,-65
"9393","1471首利","110/08/18","永豐金-板盛",42,0,42
"9394","1471首利","110/08/18","高橋-龍潭",0,35,-35
"9395","1471首利","110/08/18","台新證券",35,13,22
"9396","1471首利","110/08/18","新光",14,41,-27
"9397","1471首利","110/08/18","台灣企銀-九如",20,0,20
"9398","1471首利","110/08/18","台新-高雄",2,25,-23
"9399","1471首利","110/08/18","凱基-五股",20,0,20
"9400","1471首利","110/08/18","元富-世貿",0,20,-20
"9401","1471首利","110/08/18","瑞士信貸",25,13,12
"9402","1471首利","110/08/18","台新-中壢",0,20,-20
"9403","1471首利","110/08/18","群益金鼎-三重",10,0,10
"9404","1471首利","110/08/18","玉山-高雄",1,21,-20
"9405","1471首利","110/08/18","凱基-台南",10,0,10
"9406","1471首利","110/08/18","富邦-基隆",13,30,-17
"9407","1471首利","110/08/18","華南永昌-鳳山",10,0,10
"9408","1471首利","110/08/18","凱基-彰化",0,14,-14
"9409","1471首利","110/08/18","富邦-嘉義",10,0,10
"9410","1471首利","110/08/18","元富-民權",0,12,-12
"9411","1471首利","110/08/18","元大-開元",10,0,10
"9412","1471首利","110/08/18","凱基-羅東",0,11,-11
"9413","1471首利","110/08/18","元大-內湖",10,0,10
"9414","1471首利","110/08/18","合庫證券",0,10,-10
"9415","1471首利","110/08/18","元大-東港",10,0,10
"9416","1471首利","110/08/18","日盛-斗六",0,10,-10
"9417","1471首利","110/08/18","永豐金-台南",10,0,10
"9418","1471首利","110/08/18","群益金鼎-潭子",0,10,-10
"9419","1471首利","110/08/18","凱基-台北",25,16,9
"9420","1471首利","110/08/18","元大-汐止",0,10,-10
"9421","2883開發金","110/08/18","合庫-台中",6579,11,6568
"9422","2883開發金","110/08/18","新加坡商瑞銀",902,7117,-6215
"9423","2883開發金","110/08/18","香港上海匯豐",4579,0,4579
"9424","2883開發金","110/08/18","台灣摩根士丹利",375,5303,-4928
"9425","2883開發金","110/08/18","富邦-台中",3720,12,3708
"9426","2883開發金","110/08/18","凱基",0,4582,-4582
"9427","2883開發金","110/08/18","中國信託-文心",3128,2,3126
"9428","2883開發金","110/08/18","台新證券",425,4594,-4169
"9429","2883開發金","110/08/18","元大-福營",1063,19,1044
"9430","2883開發金","110/08/18","國泰證券",11,3677,-3666
"9431","2883開發金","110/08/18","華南永昌-南京",1046,43,1003
"9432","2883開發金","110/08/18","富邦證券",47,3305,-3258
"9433","2883開發金","110/08/18","合庫證券",999,7,992
"9434","2883開發金","110/08/18","元大證券",1065,3675,-2610
"9435","2883開發金","110/08/18","瑞士信貸",1041,53,988
"9436","2883開發金","110/08/18","凱基-台北",1972,4074,-2102
"9437","2883開發金","110/08/18","摩根大通",2088,1332,756
"9438","2883開發金","110/08/18","國票-長城",711,2005,-1294
"9439","2883開發金","110/08/18","新光",2279,1577,702
"9440","2883開發金","110/08/18","日盛證券",88,1002,-914
"9441","2883開發金","110/08/18","元大-金華",559,0,559
"9442","2883開發金","110/08/18","群益金鼎-西松",38,786,-748
"9443","2883開發金","110/08/18","花旗環球",652,184,468
"9444","2883開發金","110/08/18","兆豐-高雄",12,668,-656
"9445","2883開發金","110/08/18","港商野村",1145,723,422
"9446","2883開發金","110/08/18","元富-四維",2,606,-604
"9447","2883開發金","110/08/18","國泰-敦南",609,244,365
"9448","2883開發金","110/08/18","宏遠-光隆",14,615,-601
"9449","2883開發金","110/08/18","元富",353,0,353
"9450","2883開發金","110/08/18","永豐金-苓雅",30,595,-565
"9451","6205詮欣","110/08/18","摩根大通",14,1,13
"9452","6205詮欣","110/08/18","合庫證券",0,15,-15
"9453","6205詮欣","110/08/18","凱基-汐止",10,0,10
"9454","6205詮欣","110/08/18","國票-南港",0,14,-14
"9455","6205詮欣","110/08/18","臺銀-臺中",9,0,9
"9456","6205詮欣","110/08/18","元大-大天母",0,8,-8
"9457","6205詮欣","110/08/18","德信-新營",7,0,7
"9458","6205詮欣","110/08/18","富邦-仁愛",0,6,-6
"9459","6205詮欣","110/08/18","元富-安南",6,0,6
"9460","6205詮欣","110/08/18","兆豐-竹北",0,5,-5
"9461","6205詮欣","110/08/18","凱基-台北",5,0,5
"9462","6205詮欣","110/08/18","兆豐-台中",0,4,-4
"9463","6205詮欣","110/08/18","美林",4,0,4
"9464","6205詮欣","110/08/18","元大-土城學府",0,3,-3
"9465","6205詮欣","110/08/18","華南永昌-古亭",6,2,4
"9466","6205詮欣","110/08/18","永豐金-台南",0,3,-3
"9467","6205詮欣","110/08/18","永豐金證券",4,0,4
"9468","6205詮欣","110/08/18","日盛-板橋中山",0,2,-2
"9469","6205詮欣","110/08/18","玉山證券",3,0,3
"9470","6205詮欣","110/08/18","亞東-高雄",0,2,-2
"9471","6205詮欣","110/08/18","永豐金-中正",3,0,3
"9472","6205詮欣","110/08/18","大昌-安康",0,2,-2
"9473","6205詮欣","110/08/18","大慶-台南",2,0,2
"9474","6205詮欣","110/08/18","大昌-新店",0,2,-2
"9475","6205詮欣","110/08/18","元富-草屯",2,0,2
"9476","6205詮欣","110/08/18","玉山-高雄",0,2,-2
"9477","6205詮欣","110/08/18","元大-豐原",2,0,2
"9478","6205詮欣","110/08/18","日盛-板橋",0,1,-1
"9479","6205詮欣","110/08/18","日盛-三重",1,0,1
"9480","6205詮欣","110/08/18","宏遠-民生",0,1,-1
"9481","1540喬福","110/08/18","凱基-台北",26,5,21
"9482","1540喬福","110/08/18","兆豐-小港",0,45,-45
"9483","1540喬福","110/08/18","元大-土城永寧",15,0,15
"9484","1540喬福","110/08/18","群益金鼎-館前",1,40,-39
"9485","1540喬福","110/08/18","凱基-中壢",12,0,12
"9486","1540喬福","110/08/18","新光-台南",0,10,-10
"9487","1540喬福","110/08/18","日盛-二林",10,0,10
"9488","1540喬福","110/08/18","元大-北屯",0,6,-6
"9489","1540喬福","110/08/18","日盛-鳳山",6,0,6
"9490","1540喬福","110/08/18","新光-桃園",0,5,-5
"9491","1540喬福","110/08/18","兆豐-北高雄",6,0,6
"9492","1540喬福","110/08/18","元富",0,4,-4
"9493","1540喬福","110/08/18","元大-龍潭",6,0,6
"9494","1540喬福","110/08/18","元大-館前",0,4,-4
"9495","1540喬福","110/08/18","日盛-樹林",5,0,5
"9496","1540喬福","110/08/18","國票-台東",0,3,-3
"9497","1540喬福","110/08/18","瑞士信貸",3,0,3
"9498","1540喬福","110/08/18","富邦-台南",0,3,-3
"9499","1540喬福","110/08/18","兆豐-三民",3,0,3
"9500","1540喬福","110/08/18","第一金-大稻埕",0,2,-2
"9501","1540喬福","110/08/18","國票-彰化",3,0,3
"9502","1540喬福","110/08/18","致和-南京",0,2,-2
"9503","1540喬福","110/08/18","富邦-員林",3,0,3
"9504","1540喬福","110/08/18","玉山-城中",0,2,-2
"9505","1540喬福","110/08/18","永豐金-敦南",3,0,3
"9506","1540喬福","110/08/18","元大-南崁",0,2,-2
"9507","1540喬福","110/08/18","日盛-板橋",2,0,2
"9508","1540喬福","110/08/18","元大-府城",1,3,-2
"9509","1540喬福","110/08/18","兆豐-台中港",2,0,2
"9510","1540喬福","110/08/18","元大-松山",0,2,-2
"9511","2888新光金","110/08/18","兆豐-公益",6495,300,6195
"9512","2888新光金","110/08/18","美商高盛",222,4409,-4187
"9513","2888新光金","110/08/18","元大-忠孝鼎富",4187,0,4187
"9514","2888新光金","110/08/18","元富-城東",12,2101,-2089
"9515","2888新光金","110/08/18","瑞士信貸",2917,33,2884
"9516","2888新光金","110/08/18","華南永昌",26,1674,-1648
"9517","2888新光金","110/08/18","華南永昌-大安",1071,5,1066
"9518","2888新光金","110/08/18","華南永昌-忠孝",0,1211,-1211
"9519","2888新光金","110/08/18","宏遠-光隆",1044,6,1038
"9520","2888新光金","110/08/18","群益金鼎-彰化",14,1211,-1197
"9521","2888新光金","110/08/18","元富",805,90,715
"9522","2888新光金","110/08/18","元大-大同",5,711,-706
"9523","2888新光金","110/08/18","凱基-台北",2712,2138,574
"9524","2888新光金","110/08/18","凱基-桃園",93,755,-662
"9525","2888新光金","110/08/18","台灣摩根士丹利",742,305,437
"9526","2888新光金","110/08/18","新光-台南",2,610,-608
"9527","2888新光金","110/08/18","富邦證券",385,20,365
"9528","2888新光金","110/08/18","第一金-新竹",100,706,-606
"9529","2888新光金","110/08/18","摩根大通",2204,1868,336
"9530","2888新光金","110/08/18","福勝",2,600,-598
"9531","2888新光金","110/08/18","永興-台中",303,29,274
"9532","2888新光金","110/08/18","華南永昌-岡山",12,457,-445
"9533","2888新光金","110/08/18","元大-六合",302,28,274
"9534","2888新光金","110/08/18","花旗環球",38,466,-428
"9535","2888新光金","110/08/18","華南永昌-敦南",262,10,252
"9536","2888新光金","110/08/18","元富-民權",0,300,-300
"9537","2888新光金","110/08/18","新加坡商瑞銀",287,70,217
"9538","2888新光金","110/08/18","華南永昌-合泰",4,303,-299
"9539","2888新光金","110/08/18","統一-板橋",170,5,165
"9540","2888新光金","110/08/18","元富-中港",3,300,-297
"9541","1340勝悅","110/08/18","摩根大通",139,18,121
"9542","1340勝悅","110/08/18","聯邦-三重",0,100,-100
"9543","1340勝悅","110/08/18","華南永昌-敦南",8,0,8
"9544","1340勝悅","110/08/18","華南永昌",1,20,-19
"9545","1340勝悅","110/08/18","永豐金-板盛",7,0,7
"9546","1340勝悅","110/08/18","合庫證券",0,10,-10
"9547","1340勝悅","110/08/18","美商高盛",6,0,6
"9548","1340勝悅","110/08/18","新光-新竹",0,10,-10
"9549","1340勝悅","110/08/18","臺灣企銀-埔墘",5,0,5
"9550","1340勝悅","110/08/18","富邦-嘉義",0,8,-8
"9551","1340勝悅","110/08/18","國泰-台中",5,0,5
"9552","1340勝悅","110/08/18","元大-新竹經國",0,7,-7
"9553","1340勝悅","110/08/18","凱基-松山",5,0,5
"9554","1340勝悅","110/08/18","臺銀-鳳山",5,10,-5
"9555","1340勝悅","110/08/18","新光",4,0,4
"9556","1340勝悅","110/08/18","瑞士信貸",0,5,-5
"9557","1340勝悅","110/08/18","中國信託-文心",3,0,3
"9558","1340勝悅","110/08/18","統一-城中",9,13,-4
"9559","1340勝悅","110/08/18","康和-延平",3,0,3
"9560","1340勝悅","110/08/18","元大-歸仁",0,4,-4
"9561","1340勝悅","110/08/18","新光-桃園",3,0,3
"9562","1340勝悅","110/08/18","元大-桃興",1,5,-4
"9563","1340勝悅","110/08/18","凱基-基隆",3,0,3
"9564","1340勝悅","110/08/18","(牛牛牛)亞-鑫豐",1,4,-3
"9565","1340勝悅","110/08/18","合庫-鳳山",2,0,2
"9566","1340勝悅","110/08/18","台新證券",0,3,-3
"9567","1340勝悅","110/08/18","元富-板橋",2,0,2
"9568","1340勝悅","110/08/18","合庫-高雄",0,2,-2
"9569","1340勝悅","110/08/18","大昌-安康",2,0,2
"9570","1340勝悅","110/08/18","日盛-文化",0,2,-2
"9571","6246臺龍","110/08/18","港商野村",62,7,55
"9572","6246臺龍","110/08/18","元富-高雄",0,20,-20
"9573","6246臺龍","110/08/18","台新-三民",20,0,20
"9574","6246臺龍","110/08/18","新光",1,16,-15
"9575","6246臺龍","110/08/18","台新證券",19,0,19
"9576","6246臺龍","110/08/18","日盛-板橋",0,10,-10
"9577","6246臺龍","110/08/18","元富-林園",10,0,10
"9578","6246臺龍","110/08/18","致和-台北",0,10,-10
"9579","6246臺龍","110/08/18","光和-和美",10,0,10
"9580","6246臺龍","110/08/18","凱基-永和",0,10,-10
"9581","6246臺龍","110/08/18","凱基-屏東",10,0,10
"9582","6246臺龍","110/08/18","華南永昌-公誠",0,10,-10
"9583","6246臺龍","110/08/18","元大-永康",10,0,10
"9584","6246臺龍","110/08/18","凱基-台北",1,10,-9
"9585","6246臺龍","110/08/18","元大-竹科",5,0,5
"9586","6246臺龍","110/08/18","元大-北港",0,9,-9
"9587","6246臺龍","110/08/18","元大-北成功",4,0,4
"9588","6246臺龍","110/08/18","日盛-和美",0,6,-6
"9589","6246臺龍","110/08/18","大慶-苗栗",3,0,3
"9590","6246臺龍","110/08/18","群益金鼎-北高雄",0,6,-6
"9591","6246臺龍","110/08/18","統一-彰化",3,0,3
"9592","6246臺龍","110/08/18","日進",0,5,-5
"9593","6246臺龍","110/08/18","日茂-南投",3,0,3
"9594","6246臺龍","110/08/18","凱基-松山",0,5,-5
"9595","6246臺龍","110/08/18","兆豐-新營",3,0,3
"9596","6246臺龍","110/08/18","凱基-三多",2,7,-5
"9597","6246臺龍","110/08/18","元大-南投",3,0,3
"9598","6246臺龍","110/08/18","元富-烏日",0,4,-4
"9599","6246臺龍","110/08/18","元富-大裕",2,0,2
"9600","6246臺龍","110/08/18","兆豐-景美",0,4,-4
"9601","00715L期街口布蘭特正2","110/08/18","兆豐-鹿港",751,0,751
"9602","00715L期街口布蘭特正2","110/08/18","元大證券",368,4666,-4298
"9603","00715L期街口布蘭特正2","110/08/18","合庫-新竹",597,1,596
"9604","00715L期街口布蘭特正2","110/08/18","凱基-台北",310,4173,-3863
"9605","00715L期街口布蘭特正2","110/08/18","(牛牛牛)亞-鑫豐",606,24,582
"9606","00715L期街口布蘭特正2","110/08/18","統一",5,1703,-1698
"9607","00715L期街口布蘭特正2","110/08/18","元富-古亭",499,0,499
"9608","00715L期街口布蘭特正2","110/08/18","元大-台中",8,1176,-1168
"9609","00715L期街口布蘭特正2","110/08/18","統一-新竹",411,0,411
"9610","00715L期街口布蘭特正2","110/08/18","兆豐-來福",0,590,-590
"9611","00715L期街口布蘭特正2","110/08/18","永豐金-北高雄",331,0,331
"9612","00715L期街口布蘭特正2","110/08/18","元富",5,588,-583
"9613","00715L期街口布蘭特正2","110/08/18","中國信託-新竹",327,0,327
"9614","00715L期街口布蘭特正2","110/08/18","康和",686,1184,-498
"9615","00715L期街口布蘭特正2","110/08/18","新光",396,124,272
"9616","00715L期街口布蘭特正2","110/08/18","新光-台中",143,525,-382
"9617","00715L期街口布蘭特正2","110/08/18","元大-沙鹿",216,0,216
"9618","00715L期街口布蘭特正2","110/08/18","元大-雙和",25,380,-355
"9619","00715L期街口布蘭特正2","110/08/18","國泰-敦南",244,30,214
"9620","00715L期街口布蘭特正2","110/08/18","玉山-新竹",8,324,-316
"9621","00715L期街口布蘭特正2","110/08/18","元大-花蓮",229,20,209
"9622","00715L期街口布蘭特正2","110/08/18","玉山-台南",19,285,-266
"9623","00715L期街口布蘭特正2","110/08/18","兆豐-台中",226,36,190
"9624","00715L期街口布蘭特正2","110/08/18","永豐金證券",4,240,-236
"9625","00715L期街口布蘭特正2","110/08/18","元大-復北",200,10,190
"9626","00715L期街口布蘭特正2","110/08/18","永豐金-台南",13,230,-217
"9627","00715L期街口布蘭特正2","110/08/18","台新-新營",221,32,189
"9628","00715L期街口布蘭特正2","110/08/18","中國信託-永康",15,210,-195
"9629","00715L期街口布蘭特正2","110/08/18","新光-新竹",204,17,187
"9630","00715L期街口布蘭特正2","110/08/18","凱基-大里",2,189,-187
"9631","8941關中","110/08/18","元大-華山",1,0,1
"9632","8941關中","110/08/18","群益金鼎-開元",0,2,-2
"9633","8941關中","110/08/18","元大-南京",1,0,1
"9634","8941關中","110/08/18","元大-桃興",0,1,-1
"9635","8941關中","110/08/18","元大-西門",1,0,1
"9636","8941關中","110/08/18","華南永昌-淡水",0,0,0
"9637","8941關中","110/08/18","華南永昌-淡水",0,0,0
"9638","8941關中","110/08/18","富邦-台北",0,0,0
"9639","8941關中","110/08/18","富邦-台北",0,0,0
"9640","8941關中","110/08/18","元大-金華",1,1,0
"9641","8941關中","110/08/18","元大-金華",1,1,0
"9642","8941關中","110/08/18","永豐金-敦北",0,0,0
"9643","8941關中","110/08/18","永豐金-敦北",0,0,0
"9644","8941關中","110/08/18","",NA,NA,NA
"9645","8941關中","110/08/18","",NA,NA,NA
"9646","8941關中","110/08/18","",NA,NA,NA
"9647","8941關中","110/08/18","",NA,NA,NA
"9648","8941關中","110/08/18","",NA,NA,NA
"9649","8941關中","110/08/18","",NA,NA,NA
"9650","8941關中","110/08/18","",NA,NA,NA
"9651","8941關中","110/08/18","",NA,NA,NA
"9652","8941關中","110/08/18","",NA,NA,NA
"9653","8941關中","110/08/18","",NA,NA,NA
"9654","8941關中","110/08/18","",NA,NA,NA
"9655","8941關中","110/08/18","",NA,NA,NA
"9656","8941關中","110/08/18","",NA,NA,NA
"9657","8941關中","110/08/18","",NA,NA,NA
"9658","8941關中","110/08/18","",NA,NA,NA
"9659","8941關中","110/08/18","",NA,NA,NA
"9660","8941關中","110/08/18","",NA,NA,NA
"9661","8936國統","110/08/18","凱基-台北",120,29,91
"9662","8936國統","110/08/18","新光-高雄",0,70,-70
"9663","8936國統","110/08/18","美林",66,1,65
"9664","8936國統","110/08/18","華南永昌-林口",1,70,-69
"9665","8936國統","110/08/18","元大-萬華",50,0,50
"9666","8936國統","110/08/18","台新-高雄",36,97,-61
"9667","8936國統","110/08/18","摩根大通",95,54,41
"9668","8936國統","110/08/18","永豐金-忠孝",12,44,-32
"9669","8936國統","110/08/18","港商野村",92,58,34
"9670","8936國統","110/08/18","台灣摩根士丹利",26,53,-27
"9671","8936國統","110/08/18","中國信託-高雄",12,0,12
"9672","8936國統","110/08/18","台新-中壢",0,25,-25
"9673","8936國統","110/08/18","玉山-台南",12,0,12
"9674","8936國統","110/08/18","元大-高雄",5,30,-25
"9675","8936國統","110/08/18","國泰-敦南",18,6,12
"9676","8936國統","110/08/18","玉山-嘉義",5,25,-20
"9677","8936國統","110/08/18","元大-成功",11,0,11
"9678","8936國統","110/08/18","新加坡商瑞銀",120,137,-17
"9679","8936國統","110/08/18","臺銀-新竹",10,0,10
"9680","8936國統","110/08/18","美商高盛",7,23,-16
"9681","8936國統","110/08/18","大慶-楊梅",10,0,10
"9682","8936國統","110/08/18","國泰-板橋",0,13,-13
"9683","8936國統","110/08/18","兆豐-三重",10,0,10
"9684","8936國統","110/08/18","群益金鼎-潭子",0,12,-12
"9685","8936國統","110/08/18","兆豐-北高雄",10,0,10
"9686","8936國統","110/08/18","群益金鼎-鳳山",0,12,-12
"9687","8936國統","110/08/18","元大-大里德芳",10,0,10
"9688","8936國統","110/08/18","合庫-高雄",0,10,-10
"9689","8936國統","110/08/18","永豐金-新莊",10,0,10
"9690","8936國統","110/08/18","第一金-新興",0,10,-10
"9691","6226光鼎","110/08/18","凱基-台北",625,134,491
"9692","6226光鼎","110/08/18","國泰-台中",21,655,-634
"9693","6226光鼎","110/08/18","元大-文心興安",224,4,220
"9694","6226光鼎","110/08/18","群益金鼎-士林",0,100,-100
"9695","6226光鼎","110/08/18","美商高盛",231,46,185
"9696","6226光鼎","110/08/18","元大-竹科",24,122,-98
"9697","6226光鼎","110/08/18","美林",213,118,95
"9698","6226光鼎","110/08/18","新光-桃園",22,96,-74
"9699","6226光鼎","110/08/18","新加坡商瑞銀",165,83,82
"9700","6226光鼎","110/08/18","永豐金-南投",15,83,-68
"9701","6226光鼎","110/08/18","凱基-竹科",67,4,63
"9702","6226光鼎","110/08/18","富邦-建國",21,80,-59
"9703","6226光鼎","110/08/18","元大證券",92,29,63
"9704","6226光鼎","110/08/18","元富-信義",2,58,-56
"9705","6226光鼎","110/08/18","元大-敦化",63,11,52
"9706","6226光鼎","110/08/18","凱基-新豐",15,69,-54
"9707","6226光鼎","110/08/18","兆豐-鹿港",54,4,50
"9708","6226光鼎","110/08/18","群益金鼎-台中",2,54,-52
"9709","6226光鼎","110/08/18","群益金鼎-萬華",54,9,45
"9710","6226光鼎","110/08/18","宏遠-光隆",0,50,-50
"9711","6226光鼎","110/08/18","大昌",48,12,36
"9712","6226光鼎","110/08/18","元大-福營",5,53,-48
"9713","6226光鼎","110/08/18","凱基-站前",35,1,34
"9714","6226光鼎","110/08/18","永豐金-竹北",2,43,-41
"9715","6226光鼎","110/08/18","日盛-和美",47,16,31
"9716","6226光鼎","110/08/18","兆豐-民生",0,40,-40
"9717","6226光鼎","110/08/18","群益金鼎-永和",30,0,30
"9718","6226光鼎","110/08/18","玉山證券",10,50,-40
"9719","6226光鼎","110/08/18","凱基-中港",30,0,30
"9720","6226光鼎","110/08/18","凱基-民權",11,51,-40
"9721","2363矽統","110/08/18","凱基-南崁",1528,19,1509
"9722","2363矽統","110/08/18","台灣摩根士丹利",64,1051,-987
"9723","2363矽統","110/08/18","凱基-台北",1850,671,1179
"9724","2363矽統","110/08/18","美商高盛",386,711,-325
"9725","2363矽統","110/08/18","摩根大通",1073,563,510
"9726","2363矽統","110/08/18","台新-三民",47,361,-314
"9727","2363矽統","110/08/18","富邦-板橋",403,71,332
"9728","2363矽統","110/08/18","新加坡商瑞銀",699,987,-288
"9729","2363矽統","110/08/18","玉山-高雄",391,228,163
"9730","2363矽統","110/08/18","富邦-台北",82,251,-169
"9731","2363矽統","110/08/18","群益金鼎",154,21,133
"9732","2363矽統","110/08/18","富邦-新店",28,140,-112
"9733","2363矽統","110/08/18","永豐金證券",155,31,124
"9734","2363矽統","110/08/18","中國信託-忠孝",89,200,-111
"9735","2363矽統","110/08/18","日盛-樹林",159,39,120
"9736","2363矽統","110/08/18","玉山-台中",14,122,-108
"9737","2363矽統","110/08/18","石橋證券",112,1,111
"9738","2363矽統","110/08/18","元大-汐止",112,215,-103
"9739","2363矽統","110/08/18","合庫-高雄",123,15,108
"9740","2363矽統","110/08/18","永豐金-板盛",2,105,-103
"9741","2363矽統","110/08/18","凱基-汐止",103,1,102
"9742","2363矽統","110/08/18","群益金鼎-南京",59,160,-101
"9743","2363矽統","110/08/18","永興",94,4,90
"9744","2363矽統","110/08/18","永豐金-天母",14,112,-98
"9745","2363矽統","110/08/18","元大-前金",207,139,68
"9746","2363矽統","110/08/18","凱基-竹科",22,110,-88
"9747","2363矽統","110/08/18","新光-桃園",84,17,67
"9748","2363矽統","110/08/18","華南永昌-台中",35,122,-87
"9749","2363矽統","110/08/18","富邦-台南",95,30,65
"9750","2363矽統","110/08/18","國泰-敦南",437,521,-84
"9751","8112至上","110/08/18","港商野村",371,52,319
"9752","8112至上","110/08/18","新加坡商瑞銀",70,220,-150
"9753","8112至上","110/08/18","凱基-台北",202,29,173
"9754","8112至上","110/08/18","元大證券",3,102,-99
"9755","8112至上","110/08/18","美林",135,39,96
"9756","8112至上","110/08/18","凱基-新店",0,91,-91
"9757","8112至上","110/08/18","凱基-市政",81,0,81
"9758","8112至上","110/08/18","台灣摩根士丹利",0,87,-87
"9759","8112至上","110/08/18","摩根大通",287,209,78
"9760","8112至上","110/08/18","元大-佳里",3,82,-79
"9761","8112至上","110/08/18","美商高盛",97,25,72
"9762","8112至上","110/08/18","合庫-台中",5,67,-62
"9763","8112至上","110/08/18","台新證券",71,13,58
"9764","8112至上","110/08/18","宏遠證券",0,59,-59
"9765","8112至上","110/08/18","大慶",60,10,50
"9766","8112至上","110/08/18","凱基-文心",0,53,-53
"9767","8112至上","110/08/18","凱基-站前",52,13,39
"9768","8112至上","110/08/18","元大-樹林",8,60,-52
"9769","8112至上","110/08/18","元大-大灣",38,0,38
"9770","8112至上","110/08/18","元大-永春",2,43,-41
"9771","8112至上","110/08/18","永豐金-中盛",31,3,28
"9772","8112至上","110/08/18","富邦-新營",2,40,-38
"9773","8112至上","110/08/18","國票-北高雄",25,0,25
"9774","8112至上","110/08/18","永豐金-員林",1,38,-37
"9775","8112至上","110/08/18","富邦-竹東",21,0,21
"9776","8112至上","110/08/18","玉山-高雄",23,55,-32
"9777","8112至上","110/08/18","彰銀-七賢",20,0,20
"9778","8112至上","110/08/18","大昌-桃園",1,30,-29
"9779","8112至上","110/08/18","元富-新莊",20,0,20
"9780","8112至上","110/08/18","新光-台南",1,30,-29
"9781","1570力肯","110/08/18","凱基-台北",129,5,124
"9782","1570力肯","110/08/18","華南永昌-桃園",0,102,-102
"9783","1570力肯","110/08/18","香港上海匯豐",36,0,36
"9784","1570力肯","110/08/18","中國信託-高雄",0,49,-49
"9785","1570力肯","110/08/18","統一",30,0,30
"9786","1570力肯","110/08/18","元富-世貿",0,20,-20
"9787","1570力肯","110/08/18","群益金鼎-北高雄",27,0,27
"9788","1570力肯","110/08/18","國泰證券",0,20,-20
"9789","1570力肯","110/08/18","國票-北高雄",21,3,18
"9790","1570力肯","110/08/18","元大-屏南",0,15,-15
"9791","1570力肯","110/08/18","元大-南投",20,4,16
"9792","1570力肯","110/08/18","元大-和平",5,20,-15
"9793","1570力肯","110/08/18","新光-台南",15,0,15
"9794","1570力肯","110/08/18","元大-基隆",0,12,-12
"9795","1570力肯","110/08/18","富邦-高雄",15,0,15
"9796","1570力肯","110/08/18","玉山-台中",0,10,-10
"9797","1570力肯","110/08/18","華南永昌-嘉義",12,0,12
"9798","1570力肯","110/08/18","元大-苗栗",0,10,-10
"9799","1570力肯","110/08/18","富邦-花蓮",10,0,10
"9800","1570力肯","110/08/18","元大-草屯",0,10,-10
"9801","1570力肯","110/08/18","元富-新店",10,2,8
"9802","1570力肯","110/08/18","富邦-彰化",0,8,-8
"9803","1570力肯","110/08/18","富邦-台東",12,4,8
"9804","1570力肯","110/08/18","日盛-嘉義",0,7,-7
"9805","1570力肯","110/08/18","日盛-高雄",7,0,7
"9806","1570力肯","110/08/18","永豐金-桃園",3,10,-7
"9807","1570力肯","110/08/18","元大-羅東",7,0,7
"9808","1570力肯","110/08/18","大昌-安康",0,6,-6
"9809","1570力肯","110/08/18","大慶-蘆洲",9,3,6
"9810","1570力肯","110/08/18","國票-和平",0,6,-6
"9811","2929淘帝","110/08/18","摩根大通",42,2,40
"9812","2929淘帝","110/08/18","日盛-嘉義",0,30,-30
"9813","2929淘帝","110/08/18","元富-板橋",23,0,23
"9814","2929淘帝","110/08/18","兆豐-復興",0,16,-16
"9815","2929淘帝","110/08/18","元大-太平",19,0,19
"9816","2929淘帝","110/08/18","兆豐-桃鶯",0,13,-13
"9817","2929淘帝","110/08/18","永豐金-中盛",10,0,10
"9818","2929淘帝","110/08/18","中國信託",4,14,-10
"9819","2929淘帝","110/08/18","新光",18,9,9
"9820","2929淘帝","110/08/18","宏遠-高雄",0,6,-6
"9821","2929淘帝","110/08/18","永豐金證券",8,0,8
"9822","2929淘帝","110/08/18","元大-東泰",0,5,-5
"9823","2929淘帝","110/08/18","元富-新竹",5,0,5
"9824","2929淘帝","110/08/18","港商野村",5,9,-4
"9825","2929淘帝","110/08/18","富邦-新店",5,0,5
"9826","2929淘帝","110/08/18","(牛牛牛)亞-鑫豐",0,4,-4
"9827","2929淘帝","110/08/18","凱基-豐中",4,0,4
"9828","2929淘帝","110/08/18","群益金鼎-潭子",0,4,-4
"9829","2929淘帝","110/08/18","永豐金-竹北",4,0,4
"9830","2929淘帝","110/08/18","亞東",0,3,-3
"9831","2929淘帝","110/08/18","亞東-板橋",4,1,3
"9832","2929淘帝","110/08/18","台新-高雄",0,3,-3
"9833","2929淘帝","110/08/18","中國信託-中壢",3,0,3
"9834","2929淘帝","110/08/18","國泰-板橋",0,3,-3
"9835","2929淘帝","110/08/18","凱基-中山",7,4,3
"9836","2929淘帝","110/08/18","元大-土城學府",0,3,-3
"9837","2929淘帝","110/08/18","富邦-陽明",5,2,3
"9838","2929淘帝","110/08/18","元大-楊梅",0,3,-3
"9839","2929淘帝","110/08/18","臺銀-鳳山",2,0,2
"9840","2929淘帝","110/08/18","日盛-高雄",0,2,-2
"9841","5410國眾","110/08/18","元大-中壢",31,0,31
"9842","5410國眾","110/08/18","凱基-台北",3,57,-54
"9843","5410國眾","110/08/18","康和-台北",10,0,10
"9844","5410國眾","110/08/18","台灣企銀-北高雄",0,20,-20
"9845","5410國眾","110/08/18","土銀-嘉義",9,0,9
"9846","5410國眾","110/08/18","摩根大通",5,22,-17
"9847","5410國眾","110/08/18","凱基-中山",8,0,8
"9848","5410國眾","110/08/18","臺銀-臺南",1,16,-15
"9849","5410國眾","110/08/18","凱基-彰化",7,0,7
"9850","5410國眾","110/08/18","大昌-樹林",5,20,-15
"9851","5410國眾","110/08/18","永豐金-員林",8,1,7
"9852","5410國眾","110/08/18","宏遠-民生",0,10,-10
"9853","5410國眾","110/08/18","玉山-城中",6,0,6
"9854","5410國眾","110/08/18","兆豐-高雄",0,10,-10
"9855","5410國眾","110/08/18","富邦-員林",6,0,6
"9856","5410國眾","110/08/18","富邦-仁愛",1,10,-9
"9857","5410國眾","110/08/18","元大-崇德",6,0,6
"9858","5410國眾","110/08/18","元大-土城學府",2,11,-9
"9859","5410國眾","110/08/18","永豐金-敦南",6,0,6
"9860","5410國眾","110/08/18","元大-豐原",0,7,-7
"9861","5410國眾","110/08/18","國泰-敦南",5,0,5
"9862","5410國眾","110/08/18","台新-高雄",0,6,-6
"9863","5410國眾","110/08/18","凱基-科園",5,0,5
"9864","5410國眾","110/08/18","元大-大里",0,6,-6
"9865","5410國眾","110/08/18","元大-博愛",5,0,5
"9866","5410國眾","110/08/18","永豐金-復興",0,6,-6
"9867","5410國眾","110/08/18","元大-新盛",5,0,5
"9868","5410國眾","110/08/18","元大-大天母",0,5,-5
"9869","5410國眾","110/08/18","國泰-松江",4,0,4
"9870","5410國眾","110/08/18","永豐金-板新",0,5,-5
"9871","2841台開","110/08/18","宏遠-館前",479,0,479
"9872","2841台開","110/08/18","兆豐-鹿港",0,200,-200
"9873","2841台開","110/08/18","第一金",46,0,46
"9874","2841台開","110/08/18","兆豐-台南",0,120,-120
"9875","2841台開","110/08/18","凱基-竹科",25,0,25
"9876","2841台開","110/08/18","摩根大通",0,100,-100
"9877","2841台開","110/08/18","合庫證券",24,0,24
"9878","2841台開","110/08/18","日盛-信義",0,69,-69
"9879","2841台開","110/08/18","第一金-台中",20,0,20
"9880","2841台開","110/08/18","玉山-高雄",0,51,-51
"9881","2841台開","110/08/18","富邦-板橋",24,5,19
"9882","2841台開","110/08/18","台新證券",5,40,-35
"9883","2841台開","110/08/18","永豐金-中盛",16,0,16
"9884","2841台開","110/08/18","華南永昌-鳳山",0,30,-30
"9885","2841台開","110/08/18","統一-新台中",15,0,15
"9886","2841台開","110/08/18","中國信託-嘉義",0,24,-24
"9887","2841台開","110/08/18","統一-士林",20,5,15
"9888","2841台開","110/08/18","元大-竹山",0,21,-21
"9889","2841台開","110/08/18","華南永昌-台中",14,0,14
"9890","2841台開","110/08/18","凱基-高美館",0,20,-20
"9891","2841台開","110/08/18","元大-彰化",20,7,13
"9892","2841台開","110/08/18","華南永昌-高雄",5,25,-20
"9893","2841台開","110/08/18","元大-六合",13,0,13
"9894","2841台開","110/08/18","元大-嘉義",0,20,-20
"9895","2841台開","110/08/18","兆豐-台中",10,0,10
"9896","2841台開","110/08/18","兆豐-天母",0,10,-10
"9897","2841台開","110/08/18","玉山-桃園",10,0,10
"9898","2841台開","110/08/18","群益金鼎-敦南",0,10,-10
"9899","2841台開","110/08/18","元大-台南",10,0,10
"9900","2841台開","110/08/18","元大-北三重",0,10,-10
"9901","6207雷科","110/08/18","凱基-台北",77,2,75
"9902","6207雷科","110/08/18","元大-高雄",0,106,-106
"9903","6207雷科","110/08/18","摩根大通",94,60,34
"9904","6207雷科","110/08/18","凱基-高雄",4,34,-30
"9905","6207雷科","110/08/18","港商野村",48,17,31
"9906","6207雷科","110/08/18","凱基-復興",0,30,-30
"9907","6207雷科","110/08/18","兆豐-南京",30,0,30
"9908","6207雷科","110/08/18","日盛證券",0,29,-29
"9909","6207雷科","110/08/18","元大-六合",30,0,30
"9910","6207雷科","110/08/18","凱基-敦北",1,28,-27
"9911","6207雷科","110/08/18","新加坡商瑞銀",66,40,26
"9912","6207雷科","110/08/18","群益金鼎-東門",0,16,-16
"9913","6207雷科","110/08/18","台新-高雄",21,0,21
"9914","6207雷科","110/08/18","元大-天母",0,11,-11
"9915","6207雷科","110/08/18","光和-和美",17,0,17
"9916","6207雷科","110/08/18","美商高盛",4,13,-9
"9917","6207雷科","110/08/18","凱基-三重",13,0,13
"9918","6207雷科","110/08/18","新光",0,8,-8
"9919","6207雷科","110/08/18","元富-安南",10,0,10
"9920","6207雷科","110/08/18","永豐金-忠孝",0,8,-8
"9921","6207雷科","110/08/18","元大-東門",9,0,9
"9922","6207雷科","110/08/18","合庫證券",0,7,-7
"9923","6207雷科","110/08/18","第一金-華江",8,2,6
"9924","6207雷科","110/08/18","康和-台中",0,6,-6
"9925","6207雷科","110/08/18","永豐金-高雄",6,0,6
"9926","6207雷科","110/08/18","元大-大天母",0,6,-6
"9927","6207雷科","110/08/18","玉山-台大",5,0,5
"9928","6207雷科","110/08/18","統一-三多",0,5,-5
"9929","6207雷科","110/08/18","凱基-岡山",5,0,5
"9930","6207雷科","110/08/18","中國信託-忠孝",0,5,-5
"9931","3679新至陞","110/08/18","摩根大通",52,6,46
"9932","3679新至陞","110/08/18","統一-三重",0,21,-21
"9933","3679新至陞","110/08/18","凱基-台北",46,13,33
"9934","3679新至陞","110/08/18","元大-北成功",0,19,-19
"9935","3679新至陞","110/08/18","台灣摩根士丹利",31,0,31
"9936","3679新至陞","110/08/18","華南永昌-大安",0,18,-18
"9937","3679新至陞","110/08/18","瑞士信貸",26,1,25
"9938","3679新至陞","110/08/18","台新證券",0,14,-14
"9939","3679新至陞","110/08/18","美林",23,5,18
"9940","3679新至陞","110/08/18","萬泰",0,12,-12
"9941","3679新至陞","110/08/18","元大-文心興安",15,0,15
"9942","3679新至陞","110/08/18","大慶-苗栗",0,10,-10
"9943","3679新至陞","110/08/18","(牛牛牛)亞-網路",8,0,8
"9944","3679新至陞","110/08/18","元大-成功",0,10,-10
"9945","3679新至陞","110/08/18","永豐金-板橋",5,0,5
"9946","3679新至陞","110/08/18","富邦-嘉義",0,8,-8
"9947","3679新至陞","110/08/18","美商高盛",3,0,3
"9948","3679新至陞","110/08/18","凱基-長庚",0,7,-7
"9949","3679新至陞","110/08/18","兆豐-公益",3,0,3
"9950","3679新至陞","110/08/18","凱基-文心",0,6,-6
"9951","3679新至陞","110/08/18","聯邦-三重",3,0,3
"9952","3679新至陞","110/08/18","統一",0,5,-5
"9953","3679新至陞","110/08/18","土銀-台中",2,0,2
"9954","3679新至陞","110/08/18","元大-敦化",0,4,-4
"9955","3679新至陞","110/08/18","土銀-新竹",2,0,2
"9956","3679新至陞","110/08/18","日盛-文化",1,4,-3
"9957","3679新至陞","110/08/18","國泰-高雄",2,0,2
"9958","3679新至陞","110/08/18","彰銀",0,3,-3
"9959","3679新至陞","110/08/18","土銀-士林",1,0,1
"9960","3679新至陞","110/08/18","元富-大昌",0,3,-3
"9961","2727王品","110/08/18","凱基-台北",94,29,65
"9962","2727王品","110/08/18","港商麥格理",0,65,-65
"9963","2727王品","110/08/18","摩根大通",42,13,29
"9964","2727王品","110/08/18","華南永昌",1,39,-38
"9965","2727王品","110/08/18","彰銀-台中",27,0,27
"9966","2727王品","110/08/18","元富-板橋",1,16,-15
"9967","2727王品","110/08/18","瑞士信貸",18,3,15
"9968","2727王品","110/08/18","港商野村",66,79,-13
"9969","2727王品","110/08/18","凱基-埔墘",10,0,10
"9970","2727王品","110/08/18","第一金-桃園",0,11,-11
"9971","2727王品","110/08/18","富邦-建國",13,3,10
"9972","2727王品","110/08/18","元大-汐止",0,11,-11
"9973","2727王品","110/08/18","元大-學甲",10,0,10
"9974","2727王品","110/08/18","凱基-三峽",0,10,-10
"9975","2727王品","110/08/18","國泰-台中",28,19,9
"9976","2727王品","110/08/18","凱基-板橋",3,12,-9
"9977","2727王品","110/08/18","凱基-高美館",7,0,7
"9978","2727王品","110/08/18","凱基-林口",5,14,-9
"9979","2727王品","110/08/18","凱基-竹北",9,2,7
"9980","2727王品","110/08/18","富邦-中壢",2,11,-9
"9981","2727王品","110/08/18","元大-四維",7,0,7
"9982","2727王品","110/08/18","福勝",0,8,-8
"9983","2727王品","110/08/18","元大-敦南",8,1,7
"9984","2727王品","110/08/18","國泰-敦南",4,12,-8
"9985","2727王品","110/08/18","統一",19,13,6
"9986","2727王品","110/08/18","台新-三民",1,8,-7
"9987","2727王品","110/08/18","日盛-屏東",5,0,5
"9988","2727王品","110/08/18","華南永昌-林口",0,7,-7
"9989","2727王品","110/08/18","國泰-館前",6,1,5
"9990","2727王品","110/08/18","永豐金-內湖",0,7,-7
"9991","1570力肯","110/08/18","凱基-台北",129,5,124
"9992","1570力肯","110/08/18","華南永昌-桃園",0,102,-102
"9993","1570力肯","110/08/18","香港上海匯豐",36,0,36
"9994","1570力肯","110/08/18","中國信託-高雄",0,49,-49
"9995","1570力肯","110/08/18","統一",30,0,30
"9996","1570力肯","110/08/18","元富-世貿",0,20,-20
"9997","1570力肯","110/08/18","群益金鼎-北高雄",27,0,27
"9998","1570力肯","110/08/18","國泰證券",0,20,-20
"9999","1570力肯","110/08/18","國票-北高雄",21,3,18
"10000","1570力肯","110/08/18","元大-屏南",0,15,-15
"10001","1570力肯","110/08/18","元大-南投",20,4,16
"10002","1570力肯","110/08/18","元大-和平",5,20,-15
"10003","1570力肯","110/08/18","新光-台南",15,0,15
"10004","1570力肯","110/08/18","元大-基隆",0,12,-12
"10005","1570力肯","110/08/18","富邦-高雄",15,0,15
"10006","1570力肯","110/08/18","玉山-台中",0,10,-10
"10007","1570力肯","110/08/18","華南永昌-嘉義",12,0,12
"10008","1570力肯","110/08/18","元大-苗栗",0,10,-10
"10009","1570力肯","110/08/18","富邦-花蓮",10,0,10
"10010","1570力肯","110/08/18","元大-草屯",0,10,-10
"10011","1570力肯","110/08/18","元富-新店",10,2,8
"10012","1570力肯","110/08/18","富邦-彰化",0,8,-8
"10013","1570力肯","110/08/18","富邦-台東",12,4,8
"10014","1570力肯","110/08/18","日盛-嘉義",0,7,-7
"10015","1570力肯","110/08/18","日盛-高雄",7,0,7
"10016","1570力肯","110/08/18","永豐金-桃園",3,10,-7
"10017","1570力肯","110/08/18","元大-羅東",7,0,7
"10018","1570力肯","110/08/18","大昌-安康",0,6,-6
"10019","1570力肯","110/08/18","大慶-蘆洲",9,3,6
"10020","1570力肯","110/08/18","國票-和平",0,6,-6
"10021","6180橘子","110/08/18","美林",40,0,40
"10022","6180橘子","110/08/18","香港上海匯豐",0,102,-102
"10023","6180橘子","110/08/18","新加坡商瑞銀",23,1,22
"10024","6180橘子","110/08/18","台灣摩根士丹利",2,73,-71
"10025","6180橘子","110/08/18","凱基-基隆",18,2,16
"10026","6180橘子","110/08/18","美商高盛",1,31,-30
"10027","6180橘子","110/08/18","華南永昌-虎尾",15,0,15
"10028","6180橘子","110/08/18","凱基-市政",1,25,-24
"10029","6180橘子","110/08/18","元富-城東",14,1,13
"10030","6180橘子","110/08/18","日盛-板橋",1,20,-19
"10031","6180橘子","110/08/18","富邦-台北",16,3,13
"10032","6180橘子","110/08/18","新光-高雄",1,14,-13
"10033","6180橘子","110/08/18","富邦-中壢",11,2,9
"10034","6180橘子","110/08/18","凱基-東門",2,15,-13
"10035","6180橘子","110/08/18","富邦-宜蘭",9,0,9
"10036","6180橘子","110/08/18","元大-基隆孝二",0,12,-12
"10037","6180橘子","110/08/18","元大-前金",10,1,9
"10038","6180橘子","110/08/18","兆豐-三重",0,11,-11
"10039","6180橘子","110/08/18","中國信託",8,0,8
"10040","6180橘子","110/08/18","日盛證券",0,10,-10
"10041","6180橘子","110/08/18","元大-中壢",12,4,8
"10042","6180橘子","110/08/18","摩根大通",80,89,-9
"10043","6180橘子","110/08/18","凱基-大直",7,0,7
"10044","6180橘子","110/08/18","新光",9,18,-9
"10045","6180橘子","110/08/18","元大證券",9,2,7
"10046","6180橘子","110/08/18","富邦-南屯",0,9,-9
"10047","6180橘子","110/08/18","大慶-楊梅",6,0,6
"10048","6180橘子","110/08/18","元大-板橋三民",0,9,-9
"10049","6180橘子","110/08/18","華南永昌",7,1,6
"10050","6180橘子","110/08/18","元大-桃園",2,11,-9
"10051","2390云辰","110/08/18","兆豐-公益",192,31,161
"10052","2390云辰","110/08/18","摩根大通",1314,1582,-268
"10053","2390云辰","110/08/18","元大-土城學府",406,260,146
"10054","2390云辰","110/08/18","凱基-台北",727,962,-235
"10055","2390云辰","110/08/18","群益金鼎-敦南",106,4,102
"10056","2390云辰","110/08/18","國泰-桃園",53,264,-211
"10057","2390云辰","110/08/18","元大-竹科",136,36,100
"10058","2390云辰","110/08/18","富邦-內湖",0,201,-201
"10059","2390云辰","110/08/18","元大-館前",151,52,99
"10060","2390云辰","110/08/18","元大-復北",5,193,-188
"10061","2390云辰","110/08/18","日盛-園區",128,46,82
"10062","2390云辰","110/08/18","凱基-民權",2,160,-158
"10063","2390云辰","110/08/18","元大-東泰",84,9,75
"10064","2390云辰","110/08/18","國票-安和",98,231,-133
"10065","2390云辰","110/08/18","福勝",68,8,60
"10066","2390云辰","110/08/18","新加坡商瑞銀",102,225,-123
"10067","2390云辰","110/08/18","宏遠-光隆",73,14,59
"10068","2390云辰","110/08/18","港商野村",1128,1238,-110
"10069","2390云辰","110/08/18","元富",66,10,56
"10070","2390云辰","110/08/18","台灣摩根士丹利",3,100,-97
"10071","2390云辰","110/08/18","華南永昌-合泰",54,1,53
"10072","2390云辰","110/08/18","永豐金-嘉義",4,97,-93
"10073","2390云辰","110/08/18","凱基-中港",60,9,51
"10074","2390云辰","110/08/18","統一-城中",57,147,-90
"10075","2390云辰","110/08/18","第一金-忠孝",54,5,49
"10076","2390云辰","110/08/18","富邦-彰化",47,128,-81
"10077","2390云辰","110/08/18","統一-新台中",140,91,49
"10078","2390云辰","110/08/18","美林",341,412,-71
"10079","2390云辰","110/08/18","群益金鼎-台中",53,6,47
"10080","2390云辰","110/08/18","新光",312,382,-70
"10081","2609陽明","110/08/17","兆豐-中壢",5227,708,4519
"10082","2609陽明","110/08/17","康和",48,4865,-4817
"10083","2609陽明","110/08/17","凱基-台北",5969,1780,4189
"10084","2609陽明","110/08/17","永豐金-信義",84,2643,-2559
"10085","2609陽明","110/08/17","兆豐-三民",2114,136,1978
"10086","2609陽明","110/08/17","凱基-虎尾",487,2286,-1799
"10087","2609陽明","110/08/17","兆豐-復興",3638,1682,1956
"10088","2609陽明","110/08/17","港商野村",1127,2155,-1028
"10089","2609陽明","110/08/17","台灣摩根士丹利",2505,858,1647
"10090","2609陽明","110/08/17","兆豐-虎尾",1846,2756,-910
"10091","2609陽明","110/08/17","日盛-板橋",1734,262,1472
"10092","2609陽明","110/08/17","富邦-嘉義",7219,8100,-881
"10093","2609陽明","110/08/17","美林",3468,2882,586
"10094","2609陽明","110/08/17","元大-頭份",78,810,-732
"10095","2609陽明","110/08/17","香港上海匯豐",593,100,493
"10096","2609陽明","110/08/17","摩根大通",1422,2133,-711
"10097","2609陽明","110/08/17","統一-土城",366,14,352
"10098","2609陽明","110/08/17","元大-永春",281,971,-690
"10099","2609陽明","110/08/17","統一-敦南",899,577,322
"10100","2609陽明","110/08/17","宏遠證券",948,1614,-666
"10101","2609陽明","110/08/17","富邦-桃園",413,123,290
"10102","2609陽明","110/08/17","凱基-竹東",20,668,-648
"10103","2609陽明","110/08/17","日盛-中壢",537,256,281
"10104","2609陽明","110/08/17","元大證券",1377,2001,-624
"10105","2609陽明","110/08/17","兆豐-板橋",545,318,227
"10106","2609陽明","110/08/17","元富-新店",74,549,-475
"10107","2609陽明","110/08/17","凱基-桃園",367,142,225
"10108","2609陽明","110/08/17","華南永昌-楠梓",73,486,-413
"10109","2609陽明","110/08/17","統一-城中",390,169,221
"10110","2609陽明","110/08/17","臺銀",286,681,-395
"10111","2636台驊投控","110/08/17","元富-文心",272,9,263
"10112","2636台驊投控","110/08/17","凱基-彰化",0,689,-689
"10113","2636台驊投控","110/08/17","日盛-大墩",185,19,166
"10114","2636台驊投控","110/08/17","摩根大通",347,761,-414
"10115","2636台驊投控","110/08/17","第一金-桃園",147,26,121
"10116","2636台驊投控","110/08/17","富邦-花蓮",106,366,-260
"10117","2636台驊投控","110/08/17","元富-大昌",84,15,69
"10118","2636台驊投控","110/08/17","凱基-台北",395,566,-171
"10119","2636台驊投控","110/08/17","新光",258,192,66
"10120","2636台驊投控","110/08/17","大慶",15,175,-160
"10121","2636台驊投控","110/08/17","統一-新台中",64,4,60
"10122","2636台驊投控","110/08/17","統一",111,247,-136
"10123","2636台驊投控","110/08/17","華南永昌-竹北",308,252,56
"10124","2636台驊投控","110/08/17","富邦證券",0,134,-134
"10125","2636台驊投控","110/08/17","日盛-木柵",60,8,52
"10126","2636台驊投控","110/08/17","富邦-虎尾",294,414,-120
"10127","2636台驊投控","110/08/17","國泰-敦南",335,283,52
"10128","2636台驊投控","110/08/17","元大-士林",4,114,-110
"10129","2636台驊投控","110/08/17","美商高盛",96,54,42
"10130","2636台驊投控","110/08/17","美林",320,401,-81
"10131","2636台驊投控","110/08/17","凱基-市政",60,22,38
"10132","2636台驊投控","110/08/17","瑞士信貸",62,134,-72
"10133","2636台驊投控","110/08/17","元大-龍潭",50,13,37
"10134","2636台驊投控","110/08/17","兆豐-東門",70,140,-70
"10135","2636台驊投控","110/08/17","國票-九鼎",50,16,34
"10136","2636台驊投控","110/08/17","凱基-高美館",89,158,-69
"10137","2636台驊投控","110/08/17","元大-東門",37,3,34
"10138","2636台驊投控","110/08/17","日盛證券",103,170,-67
"10139","2636台驊投控","110/08/17","富邦-三重",33,1,32
"10140","2636台驊投控","110/08/17","宏遠-桃園",4,44,-40
"10141","2867三商壽","110/08/17","摩根大通",670,119,551
"10142","2867三商壽","110/08/17","玉山-左營",10,1173,-1163
"10143","2867三商壽","110/08/17","元富-世貿",288,0,288
"10144","2867三商壽","110/08/17","華南永昌",50,736,-686
"10145","2867三商壽","110/08/17","日盛-中和",276,10,266
"10146","2867三商壽","110/08/17","台灣摩根士丹利",37,195,-158
"10147","2867三商壽","110/08/17","新光-台中",243,7,236
"10148","2867三商壽","110/08/17","兆豐-北高雄",0,135,-135
"10149","2867三商壽","110/08/17","台新-台中",198,1,197
"10150","2867三商壽","110/08/17","宏遠證券",9,141,-132
"10151","2867三商壽","110/08/17","華南永昌-長虹",136,0,136
"10152","2867三商壽","110/08/17","永豐金-市政",0,115,-115
"10153","2867三商壽","110/08/17","美林",137,2,135
"10154","2867三商壽","110/08/17","兆豐-新竹",0,113,-113
"10155","2867三商壽","110/08/17","元大-土城永寧",100,1,99
"10156","2867三商壽","110/08/17","永豐金證券",0,82,-82
"10157","2867三商壽","110/08/17","國泰-台中",99,2,97
"10158","2867三商壽","110/08/17","元大-彰化民生",0,80,-80
"10159","2867三商壽","110/08/17","元富-古亭",100,4,96
"10160","2867三商壽","110/08/17","永豐金-中盛",4,77,-73
"10161","2867三商壽","110/08/17","合庫-西台中",80,0,80
"10162","2867三商壽","110/08/17","元富",0,70,-70
"10163","2867三商壽","110/08/17","新加坡商瑞銀",83,4,79
"10164","2867三商壽","110/08/17","宏遠-中和",10,57,-47
"10165","2867三商壽","110/08/17","永豐金-埔里",64,5,59
"10166","2867三商壽","110/08/17","富邦-嘉義",4,50,-46
"10167","2867三商壽","110/08/17","元富-緯城",50,0,50
"10168","2867三商壽","110/08/17","第一金-華江",0,30,-30
"10169","2867三商壽","110/08/17","台新-建北",49,0,49
"10170","2867三商壽","110/08/17","台新證券",2,32,-30
"10171","5521工信","110/08/17","元大-沙鹿",60,0,60
"10172","5521工信","110/08/17","摩根大通",75,227,-152
"10173","5521工信","110/08/17","群益金鼎-萬華",46,0,46
"10174","5521工信","110/08/17","凱基-台北",5,68,-63
"10175","5521工信","110/08/17","台新證券",37,1,36
"10176","5521工信","110/08/17","群益金鼎-敦南",0,60,-60
"10177","5521工信","110/08/17","華南永昌-竹北",31,0,31
"10178","5521工信","110/08/17","台灣摩根士丹利",5,64,-59
"10179","5521工信","110/08/17","元大-北投",30,0,30
"10180","5521工信","110/08/17","元富-古亭",0,40,-40
"10181","5521工信","110/08/17","元富-屏東",24,0,24
"10182","5521工信","110/08/17","台灣企銀-嘉義",0,35,-35
"10183","5521工信","110/08/17","富邦-台北",23,0,23
"10184","5521工信","110/08/17","美林",5,37,-32
"10185","5521工信","110/08/17","元大-屏南",23,0,23
"10186","5521工信","110/08/17","華南永昌",0,27,-27
"10187","5521工信","110/08/17","國泰-敦南",40,18,22
"10188","5521工信","110/08/17","華南永昌-潮州",0,25,-25
"10189","5521工信","110/08/17","兆豐-中壢",20,0,20
"10190","5521工信","110/08/17","台新-高雄",0,24,-24
"10191","5521工信","110/08/17","新光-台南",20,0,20
"10192","5521工信","110/08/17","大慶-楊梅",0,22,-22
"10193","5521工信","110/08/17","臺銀-鳳山",19,0,19
"10194","5521工信","110/08/17","凱基-桃園",0,20,-20
"10195","5521工信","110/08/17","日進",18,0,18
"10196","5521工信","110/08/17","元大-東蘆",0,20,-20
"10197","5521工信","110/08/17","永豐金-鳳山",17,0,17
"10198","5521工信","110/08/17","第一金-桃園",0,18,-18
"10199","5521工信","110/08/17","玉山證券",14,0,14
"10200","5521工信","110/08/17","新光-新竹",3,20,-17
"10201","1471首利","110/08/17","摩根大通",110,14,96
"10202","1471首利","110/08/17","元大-台南",0,54,-54
"10203","1471首利","110/08/17","臺銀-臺中",40,0,40
"10204","1471首利","110/08/17","高橋-龍潭",0,50,-50
"10205","1471首利","110/08/17","瑞士信貸",33,0,33
"10206","1471首利","110/08/17","元大-竹南",0,35,-35
"10207","1471首利","110/08/17","凱基-台北",30,6,24
"10208","1471首利","110/08/17","台新證券",1,31,-30
"10209","1471首利","110/08/17","元大-竹山",23,0,23
"10210","1471首利","110/08/17","國泰-敦南",7,33,-26
"10211","1471首利","110/08/17","大慶-蘆洲",14,0,14
"10212","1471首利","110/08/17","元大-西門",0,23,-23
"10213","1471首利","110/08/17","兆豐-員林",13,1,12
"10214","1471首利","110/08/17","元富-埔里",0,20,-20
"10215","1471首利","110/08/17","致和-府前",11,0,11
"10216","1471首利","110/08/17","富邦-台中",0,20,-20
"10217","1471首利","110/08/17","國票-彰化",11,0,11
"10218","1471首利","110/08/17","日茂",0,11,-11
"10219","1471首利","110/08/17","元富-新莊",10,0,10
"10220","1471首利","110/08/17","高橋",0,10,-10
"10221","1471首利","110/08/17","國票",10,0,10
"10222","1471首利","110/08/17","大昌-新店",0,10,-10
"10223","1471首利","110/08/17","富邦-永和",10,0,10
"10224","1471首利","110/08/17","元富-文心",1,10,-9
"10225","1471首利","110/08/17","元大-新莊",10,0,10
"10226","1471首利","110/08/17","凱基-雙和",0,8,-8
"10227","1471首利","110/08/17","元大-鹿港",10,0,10
"10228","1471首利","110/08/17","凱基-屏東",0,8,-8
"10229","1471首利","110/08/17","元大-清水",11,2,9
"10230","1471首利","110/08/17","日盛-永康",0,7,-7
"10231","2883開發金","110/08/17","中國信託-文心",3524,26,3498
"10232","2883開發金","110/08/17","新加坡商瑞銀",513,7792,-7279
"10233","2883開發金","110/08/17","元大證券",1912,297,1615
"10234","2883開發金","110/08/17","亞東-新竹",206,2692,-2486
"10235","2883開發金","110/08/17","摩根大通",4110,2504,1606
"10236","2883開發金","110/08/17","凱基-台北",2263,4277,-2014
"10237","2883開發金","110/08/17","美林",2099,733,1366
"10238","2883開發金","110/08/17","永豐金證券",103,1899,-1796
"10239","2883開發金","110/08/17","日盛證券",2406,1218,1188
"10240","2883開發金","110/08/17","華南永昌-苑裡",13,1229,-1216
"10241","2883開發金","110/08/17","國泰-館前",942,128,814
"10242","2883開發金","110/08/17","統一-新營",39,1202,-1163
"10243","2883開發金","110/08/17","元富-城中",808,6,802
"10244","2883開發金","110/08/17","兆豐-高雄",68,1153,-1085
"10245","2883開發金","110/08/17","港商法國興業",764,0,764
"10246","2883開發金","110/08/17","凱基-斗六",3,812,-809
"10247","2883開發金","110/08/17","元大-南屯",759,75,684
"10248","2883開發金","110/08/17","元大-四維",736,1467,-731
"10249","2883開發金","110/08/17","康和-仁愛",514,10,504
"10250","2883開發金","110/08/17","台新證券",682,1391,-709
"10251","2883開發金","110/08/17","新光",1403,910,493
"10252","2883開發金","110/08/17","凱基-豐中",7,617,-610
"10253","2883開發金","110/08/17","統一-汐止",489,5,484
"10254","2883開發金","110/08/17","土銀-嘉義",10,580,-570
"10255","2883開發金","110/08/17","永豐金-忠孝",650,206,444
"10256","2883開發金","110/08/17","港商麥格理",1131,1682,-551
"10257","2883開發金","110/08/17","港商野村",2803,2361,442
"10258","2883開發金","110/08/17","富邦-陽明",158,680,-522
"10259","2883開發金","110/08/17","元富-大裕",454,22,432
"10260","2883開發金","110/08/17","台灣摩根士丹利",2238,2750,-512
"10261","6205詮欣","110/08/17","日盛-三重",15,0,15
"10262","6205詮欣","110/08/17","元富-松德",0,10,-10
"10263","6205詮欣","110/08/17","臺銀-民權",5,0,5
"10264","6205詮欣","110/08/17","元富-安南",0,8,-8
"10265","6205詮欣","110/08/17","華南永昌-長虹",5,0,5
"10266","6205詮欣","110/08/17","元大-大雅",0,3,-3
"10267","6205詮欣","110/08/17","德信-新營",4,0,4
"10268","6205詮欣","110/08/17","兆豐-南門",0,3,-3
"10269","6205詮欣","110/08/17","凱基-汐止",4,0,4
"10270","6205詮欣","110/08/17","兆豐-南京",0,3,-3
"10271","6205詮欣","110/08/17","富邦-陽明",4,0,4
"10272","6205詮欣","110/08/17","元大-豐原",0,2,-2
"10273","6205詮欣","110/08/17","元大-汐止",4,0,4
"10274","6205詮欣","110/08/17","大昌",0,1,-1
"10275","6205詮欣","110/08/17","華南永昌-古亭",3,0,3
"10276","6205詮欣","110/08/17","永豐金-中正",0,1,-1
"10277","6205詮欣","110/08/17","凱基-台北",1,0,1
"10278","6205詮欣","110/08/17","大昌-安康",0,1,-1
"10279","6205詮欣","110/08/17","元大-鑫永和",1,0,1
"10280","6205詮欣","110/08/17","日盛-台中",0,1,-1
"10281","6205詮欣","110/08/17","統一-士林",0,0,0
"10282","6205詮欣","110/08/17","新百王",0,1,-1
"10283","6205詮欣","110/08/17","統一-南京",0,0,0
"10284","6205詮欣","110/08/17","元富-文心",0,1,-1
"10285","6205詮欣","110/08/17","國泰證券",0,0,0
"10286","6205詮欣","110/08/17","統一",0,1,-1
"10287","6205詮欣","110/08/17","華南永昌-高雄",0,0,0
"10288","6205詮欣","110/08/17","第一金-中壢",0,1,-1
"10289","6205詮欣","110/08/17","永豐金-中和",1,1,0
"10290","6205詮欣","110/08/17","大慶-基隆",0,1,-1
"10291","1540喬福","110/08/17","元大-松山",20,0,20
"10292","1540喬福","110/08/17","群益金鼎-館前",0,31,-31
"10293","1540喬福","110/08/17","凱基-中壢",17,0,17
"10294","1540喬福","110/08/17","日盛-文化",0,30,-30
"10295","1540喬福","110/08/17","元大-左營",11,0,11
"10296","1540喬福","110/08/17","兆豐-民生",0,17,-17
"10297","1540喬福","110/08/17","元富-文心",10,0,10
"10298","1540喬福","110/08/17","凱基-台北",0,5,-5
"10299","1540喬福","110/08/17","元大-土城永寧",10,0,10
"10300","1540喬福","110/08/17","國票-台中",0,3,-3
"10301","1540喬福","110/08/17","元大-成功",10,0,10
"10302","1540喬福","110/08/17","元大-大益",0,3,-3
"10303","1540喬福","110/08/17","富邦-板橋",6,0,6
"10304","1540喬福","110/08/17","致和-南京",0,2,-2
"10305","1540喬福","110/08/17","新光",4,0,4
"10306","1540喬福","110/08/17","國泰-館前",0,2,-2
"10307","1540喬福","110/08/17","亞東",2,0,2
"10308","1540喬福","110/08/17","富邦-陽明",0,2,-2
"10309","1540喬福","110/08/17","群益金鼎-新店",2,0,2
"10310","1540喬福","110/08/17","元大-龍潭",0,2,-2
"10311","1540喬福","110/08/17","日盛-員林",1,0,1
"10312","1540喬福","110/08/17","日盛-台中",0,1,-1
"10313","1540喬福","110/08/17","日盛-鳳山",1,0,1
"10314","1540喬福","110/08/17","美林",0,1,-1
"10315","1540喬福","110/08/17","統一-屏東",1,0,1
"10316","1540喬福","110/08/17","第一金-高雄",0,1,-1
"10317","1540喬福","110/08/17","元富-大昌",1,0,1
"10318","1540喬福","110/08/17","元富",1,2,-1
"10319","1540喬福","110/08/17","台新-高雄",1,0,1
"10320","1540喬福","110/08/17","新光-新竹",0,1,-1
"10321","2888新光金","110/08/17","華南永昌-岡山",6623,36,6587
"10322","2888新光金","110/08/17","元富-城東",11,13997,-13986
"10323","2888新光金","110/08/17","元大-忠孝鼎富",4976,0,4976
"10324","2888新光金","110/08/17","永豐金證券",19,2260,-2241
"10325","2888新光金","110/08/17","永豐金-萬盛",3955,15,3940
"10326","2888新光金","110/08/17","國票-博愛",0,2051,-2051
"10327","2888新光金","110/08/17","摩根大通",3699,247,3452
"10328","2888新光金","110/08/17","群益金鼎",0,1836,-1836
"10329","2888新光金","110/08/17","瑞士信貸",3064,605,2459
"10330","2888新光金","110/08/17","華南永昌",10,1624,-1614
"10331","2888新光金","110/08/17","凱基-大安",2179,2,2177
"10332","2888新光金","110/08/17","元大-大同",0,714,-714
"10333","2888新光金","110/08/17","國票-台東",1935,23,1912
"10334","2888新光金","110/08/17","安泰",0,598,-598
"10335","2888新光金","110/08/17","永豐金-信義",1497,5,1492
"10336","2888新光金","110/08/17","大昌",3,555,-552
"10337","2888新光金","110/08/17","國票-北投",1304,0,1304
"10338","2888新光金","110/08/17","福勝",3,510,-507
"10339","2888新光金","110/08/17","兆豐-松德",1251,0,1251
"10340","2888新光金","110/08/17","元大-太平",20,525,-505
"10341","2888新光金","110/08/17","花旗環球",1101,147,954
"10342","2888新光金","110/08/17","中國信託-三重",0,503,-503
"10343","2888新光金","110/08/17","港商法國興業",1031,180,851
"10344","2888新光金","110/08/17","台灣摩根士丹利",1136,1627,-491
"10345","2888新光金","110/08/17","凱基-站前",788,13,775
"10346","2888新光金","110/08/17","美林",141,604,-463
"10347","2888新光金","110/08/17","台灣匯立證券",763,0,763
"10348","2888新光金","110/08/17","群益金鼎-土城",0,415,-415
"10349","2888新光金","110/08/17","群益金鼎-崇德",735,3,732
"10350","2888新光金","110/08/17","凱基-台北",632,1033,-401
"10351","1340勝悅","110/08/17","國泰-台中",12,0,12
"10352","1340勝悅","110/08/17","永豐金-潮州",0,20,-20
"10353","1340勝悅","110/08/17","新光-新竹",10,0,10
"10354","1340勝悅","110/08/17","臺灣企銀-桃園",0,10,-10
"10355","1340勝悅","110/08/17","元富-成功",8,0,8
"10356","1340勝悅","110/08/17","瑞士信貸",0,6,-6
"10357","1340勝悅","110/08/17","臺灣企銀-埔墘",5,0,5
"10358","1340勝悅","110/08/17","玉山-桃園",0,5,-5
"10359","1340勝悅","110/08/17","華南永昌-敦南",5,0,5
"10360","1340勝悅","110/08/17","華南永昌-虎尾",0,5,-5
"10361","1340勝悅","110/08/17","富邦-新店",11,6,5
"10362","1340勝悅","110/08/17","永豐金-博愛",0,5,-5
"10363","1340勝悅","110/08/17","美商高盛",4,0,4
"10364","1340勝悅","110/08/17","日盛-永康",0,4,-4
"10365","1340勝悅","110/08/17","新光-桃園",3,0,3
"10366","1340勝悅","110/08/17","元富-世貿",0,4,-4
"10367","1340勝悅","110/08/17","日盛-八德",2,0,2
"10368","1340勝悅","110/08/17","摩根大通",2,6,-4
"10369","1340勝悅","110/08/17","凱基-基隆",2,0,2
"10370","1340勝悅","110/08/17","玉山-新莊",0,3,-3
"10371","1340勝悅","110/08/17","元大-松江",2,0,2
"10372","1340勝悅","110/08/17","國泰-敦南",5,8,-3
"10373","1340勝悅","110/08/17","元大-崇德",2,0,2
"10374","1340勝悅","110/08/17","富邦-桃園",0,3,-3
"10375","1340勝悅","110/08/17","國泰-館前",1,0,1
"10376","1340勝悅","110/08/17","元大-和平",0,3,-3
"10377","1340勝悅","110/08/17","群益金鼎-民權",1,0,1
"10378","1340勝悅","110/08/17","永豐金-南投",0,3,-3
"10379","1340勝悅","110/08/17","華南永昌-大安",1,0,1
"10380","1340勝悅","110/08/17","富邦-羅東",2,4,-2
"10381","6246臺龍","110/08/17","台新-三民",90,0,90
"10382","6246臺龍","110/08/17","日盛證券",0,52,-52
"10383","6246臺龍","110/08/17","港商野村",63,28,35
"10384","6246臺龍","110/08/17","凱基-幸福",0,10,-10
"10385","6246臺龍","110/08/17","台新證券",20,0,20
"10386","6246臺龍","110/08/17","元富-新店",0,9,-9
"10387","6246臺龍","110/08/17","凱基-信義",7,0,7
"10388","6246臺龍","110/08/17","凱基-科園",0,8,-8
"10389","6246臺龍","110/08/17","凱基-站前",5,0,5
"10390","6246臺龍","110/08/17","元富-世貿",0,7,-7
"10391","6246臺龍","110/08/17","合庫-嘉義",5,1,4
"10392","6246臺龍","110/08/17","兆豐-公益",0,7,-7
"10393","6246臺龍","110/08/17","元大-林園",10,6,4
"10394","6246臺龍","110/08/17","元大-東蘆",0,7,-7
"10395","6246臺龍","110/08/17","元大-永康",4,0,4
"10396","6246臺龍","110/08/17","群益金鼎-嘉義",0,6,-6
"10397","6246臺龍","110/08/17","元大-基隆孝二",4,0,4
"10398","6246臺龍","110/08/17","華南永昌-頭份",0,6,-6
"10399","6246臺龍","110/08/17","日盛-斗六",3,0,3
"10400","6246臺龍","110/08/17","元大-北港",0,5,-5
"10401","6246臺龍","110/08/17","永全",3,0,3
"10402","6246臺龍","110/08/17","日盛-和美",0,4,-4
"10403","6246臺龍","110/08/17","兆豐-景美",3,0,3
"10404","6246臺龍","110/08/17","國泰-敦南",1,5,-4
"10405","6246臺龍","110/08/17","台新-台中",3,0,3
"10406","6246臺龍","110/08/17","群益金鼎-新竹",0,4,-4
"10407","6246臺龍","110/08/17","元大-雙和",3,0,3
"10408","6246臺龍","110/08/17","凱基-台北",0,4,-4
"10409","6246臺龍","110/08/17","土銀",2,0,2
"10410","6246臺龍","110/08/17","元大-府城",0,4,-4
"10411","00715L期街口布蘭特正2","110/08/17","華南永昌-長虹",860,0,860
"10412","00715L期街口布蘭特正2","110/08/17","元大證券",78,4339,-4261
"10413","00715L期街口布蘭特正2","110/08/17","永豐金-台中",823,20,803
"10414","00715L期街口布蘭特正2","110/08/17","元富",2,3940,-3938
"10415","00715L期街口布蘭特正2","110/08/17","日盛-和美",595,0,595
"10416","00715L期街口布蘭特正2","110/08/17","永豐金證券",41,1048,-1007
"10417","00715L期街口布蘭特正2","110/08/17","第一金-豐原",420,0,420
"10418","00715L期街口布蘭特正2","110/08/17","統一-桃園",5,850,-845
"10419","00715L期街口布蘭特正2","110/08/17","元大-前金",419,0,419
"10420","00715L期街口布蘭特正2","110/08/17","富邦證券",258,1081,-823
"10421","00715L期街口布蘭特正2","110/08/17","華南永昌-台中",419,5,414
"10422","00715L期街口布蘭特正2","110/08/17","元大-台中",9,534,-525
"10423","00715L期街口布蘭特正2","110/08/17","元大-北三重",403,0,403
"10424","00715L期街口布蘭特正2","110/08/17","合庫-高雄",10,310,-300
"10425","00715L期街口布蘭特正2","110/08/17","日盛-新莊",375,0,375
"10426","00715L期街口布蘭特正2","110/08/17","港商野村",1,240,-239
"10427","00715L期街口布蘭特正2","110/08/17","富邦-基隆",310,0,310
"10428","00715L期街口布蘭特正2","110/08/17","群益金鼎-民權",2,208,-206
"10429","00715L期街口布蘭特正2","110/08/17","臺銀-新竹",311,10,301
"10430","00715L期街口布蘭特正2","110/08/17","元大-大里德芳",1,200,-199
"10431","00715L期街口布蘭特正2","110/08/17","元富-中港",300,0,300
"10432","00715L期街口布蘭特正2","110/08/17","元大-中和",1,187,-186
"10433","00715L期街口布蘭特正2","110/08/17","新光",368,82,286
"10434","00715L期街口布蘭特正2","110/08/17","康和",0,133,-133
"10435","00715L期街口布蘭特正2","110/08/17","中國信託-新竹",263,0,263
"10436","00715L期街口布蘭特正2","110/08/17","永豐金-板新",25,150,-125
"10437","00715L期街口布蘭特正2","110/08/17","台中銀",253,0,253
"10438","00715L期街口布蘭特正2","110/08/17","兆豐-桃鶯",6,110,-104
"10439","00715L期街口布蘭特正2","110/08/17","統一-台中",230,0,230
"10440","00715L期街口布蘭特正2","110/08/17","凱基-大直",2,100,-98
"10441","8941關中","110/08/17","宏遠-館前",4,0,4
"10442","8941關中","110/08/17","凱基-高美館",0,1,-1
"10443","8941關中","110/08/17","",NA,NA,NA
"10444","8941關中","110/08/17","凱基-台北",0,1,-1
"10445","8941關中","110/08/17","",NA,NA,NA
"10446","8941關中","110/08/17","元大-南投",0,1,-1
"10447","8941關中","110/08/17","",NA,NA,NA
"10448","8941關中","110/08/17","元大-華山",0,1,-1
"10449","8941關中","110/08/17","",NA,NA,NA
"10450","8941關中","110/08/17","",NA,NA,NA
"10451","8941關中","110/08/17","",NA,NA,NA
"10452","8941關中","110/08/17","",NA,NA,NA
"10453","8941關中","110/08/17","",NA,NA,NA
"10454","8941關中","110/08/17","",NA,NA,NA
"10455","8941關中","110/08/17","",NA,NA,NA
"10456","8941關中","110/08/17","",NA,NA,NA
"10457","8941關中","110/08/17","",NA,NA,NA
"10458","8941關中","110/08/17","",NA,NA,NA
"10459","8941關中","110/08/17","",NA,NA,NA
"10460","8941關中","110/08/17","",NA,NA,NA
"10461","8941關中","110/08/17","",NA,NA,NA
"10462","8941關中","110/08/17","",NA,NA,NA
"10463","8941關中","110/08/17","",NA,NA,NA
"10464","8941關中","110/08/17","",NA,NA,NA
"10465","8941關中","110/08/17","",NA,NA,NA
"10466","8941關中","110/08/17","",NA,NA,NA
"10467","8941關中","110/08/17","",NA,NA,NA
"10468","8941關中","110/08/17","",NA,NA,NA
"10469","8941關中","110/08/17","",NA,NA,NA
"10470","8941關中","110/08/17","",NA,NA,NA
"10471","8936國統","110/08/17","台新-高雄",511,7,504
"10472","8936國統","110/08/17","凱基-高美館",20,157,-137
"10473","8936國統","110/08/17","美林",60,0,60
"10474","8936國統","110/08/17","台灣摩根士丹利",7,56,-49
"10475","8936國統","110/08/17","台中銀-高雄",33,0,33
"10476","8936國統","110/08/17","永豐金-大園",5,52,-47
"10477","8936國統","110/08/17","摩根大通",71,39,32
"10478","8936國統","110/08/17","新光-台中",16,60,-44
"10479","8936國統","110/08/17","元大-豐原站前",30,0,30
"10480","8936國統","110/08/17","國泰-敦南",14,44,-30
"10481","8936國統","110/08/17","第一金-新興",25,0,25
"10482","8936國統","110/08/17","港商野村",41,64,-23
"10483","8936國統","110/08/17","凱基-台北",45,24,21
"10484","8936國統","110/08/17","凱基-站前",0,20,-20
"10485","8936國統","110/08/17","日盛-忠孝",20,0,20
"10486","8936國統","110/08/17","國泰-高雄",3,20,-17
"10487","8936國統","110/08/17","日盛-高雄",15,0,15
"10488","8936國統","110/08/17","富邦-嘉義",0,17,-17
"10489","8936國統","110/08/17","新加坡商瑞銀",66,53,13
"10490","8936國統","110/08/17","元大-敦化",0,17,-17
"10491","8936國統","110/08/17","玉山-台南",14,3,11
"10492","8936國統","110/08/17","統一-台中",0,15,-15
"10493","8936國統","110/08/17","日盛-斗六",10,0,10
"10494","8936國統","110/08/17","兆豐-高雄",0,15,-15
"10495","8936國統","110/08/17","統一-新營",10,0,10
"10496","8936國統","110/08/17","陽信-石牌",0,15,-15
"10497","8936國統","110/08/17","元富-三重",15,5,10
"10498","8936國統","110/08/17","元大-文心",0,15,-15
"10499","8936國統","110/08/17","群益金鼎-台中",10,0,10
"10500","8936國統","110/08/17","美商高盛",8,22,-14
"10501","6226光鼎","110/08/17","國泰-台中",693,66,627
"10502","6226光鼎","110/08/17","美商高盛",21,669,-648
"10503","6226光鼎","110/08/17","摩根大通",453,306,147
"10504","6226光鼎","110/08/17","凱基-台北",116,705,-589
"10505","6226光鼎","110/08/17","日盛-員林",105,1,104
"10506","6226光鼎","110/08/17","第一金-大稻埕",101,627,-526
"10507","6226光鼎","110/08/17","永豐金-南投",80,0,80
"10508","6226光鼎","110/08/17","瑞士信貸",0,356,-356
"10509","6226光鼎","110/08/17","宏遠-光隆",60,0,60
"10510","6226光鼎","110/08/17","美林",48,202,-154
"10511","6226光鼎","110/08/17","元大-員林中山",52,0,52
"10512","6226光鼎","110/08/17","新光",74,175,-101
"10513","6226光鼎","110/08/17","合庫-鳳山",54,4,50
"10514","6226光鼎","110/08/17","元大-北屯",1,101,-100
"10515","6226光鼎","110/08/17","元大-福營",51,5,46
"10516","6226光鼎","110/08/17","台新-屏東",0,70,-70
"10517","6226光鼎","110/08/17","凱基-市府",46,4,42
"10518","6226光鼎","110/08/17","永豐金-南京",6,74,-68
"10519","6226光鼎","110/08/17","兆豐-永和",41,1,40
"10520","6226光鼎","110/08/17","元大-西螺",2,55,-53
"10521","6226光鼎","110/08/17","凱基-永和",40,1,39
"10522","6226光鼎","110/08/17","統一-基隆",0,50,-50
"10523","6226光鼎","110/08/17","元大-敦化",38,0,38
"10524","6226光鼎","110/08/17","永豐金-板橋",2,46,-44
"10525","6226光鼎","110/08/17","凱基-中山",42,5,37
"10526","6226光鼎","110/08/17","元大-草屯",2,33,-31
"10527","6226光鼎","110/08/17","國泰-桃園",131,97,34
"10528","6226光鼎","110/08/17","元大-西門",0,28,-28
"10529","6226光鼎","110/08/17","富邦-台北",55,21,34
"10530","6226光鼎","110/08/17","凱基-屏東",1,27,-26
"10531","2363矽統","110/08/17","第一金-高雄",356,4,352
"10532","2363矽統","110/08/17","瑞士信貸",86,1495,-1409
"10533","2363矽統","110/08/17","元富-永和",241,5,236
"10534","2363矽統","110/08/17","凱基-台北",737,1867,-1130
"10535","2363矽統","110/08/17","凱基-高美館",254,23,231
"10536","2363矽統","110/08/17","台灣摩根士丹利",0,438,-438
"10537","2363矽統","110/08/17","台新證券",511,295,216
"10538","2363矽統","110/08/17","元富-城東",13,409,-396
"10539","2363矽統","110/08/17","土銀-士林",189,0,189
"10540","2363矽統","110/08/17","(牛牛牛)亞-鑫豐",24,247,-223
"10541","2363矽統","110/08/17","永豐金-天母",155,0,155
"10542","2363矽統","110/08/17","美林",97,274,-177
"10543","2363矽統","110/08/17","玉山-台中",301,164,137
"10544","2363矽統","110/08/17","凱基-長庚",11,134,-123
"10545","2363矽統","110/08/17","凱基-竹北",122,5,117
"10546","2363矽統","110/08/17","元富-新店",4,115,-111
"10547","2363矽統","110/08/17","群益金鼎-三民",115,8,107
"10548","2363矽統","110/08/17","元大-北成功",142,237,-95
"10549","2363矽統","110/08/17","港商野村",1447,1350,97
"10550","2363矽統","110/08/17","日盛-木柵",70,160,-90
"10551","2363矽統","110/08/17","永豐金-新竹",105,20,85
"10552","2363矽統","110/08/17","摩根大通",240,322,-82
"10553","2363矽統","110/08/17","永豐金-松山",77,0,77
"10554","2363矽統","110/08/17","第一金-新竹",266,342,-76
"10555","2363矽統","110/08/17","富邦-宜蘭",84,11,73
"10556","2363矽統","110/08/17","華南永昌-岡山",42,110,-68
"10557","2363矽統","110/08/17","永豐金-南投",72,1,71
"10558","2363矽統","110/08/17","康和",48,112,-64
"10559","2363矽統","110/08/17","富邦-仁愛",90,22,68
"10560","2363矽統","110/08/17","華南永昌-楠梓",30,90,-60
"10561","8112至上","110/08/17","港商麥格理",158,0,158
"10562","8112至上","110/08/17","瑞士信貸",0,249,-249
"10563","8112至上","110/08/17","凱基-台北",177,49,128
"10564","8112至上","110/08/17","摩根大通",56,233,-177
"10565","8112至上","110/08/17","德信",120,0,120
"10566","8112至上","110/08/17","新加坡商瑞銀",19,179,-160
"10567","8112至上","110/08/17","台新證券",116,19,97
"10568","8112至上","110/08/17","富邦-仁愛",13,141,-128
"10569","8112至上","110/08/17","合庫-台中",75,2,73
"10570","8112至上","110/08/17","凱基-復興",1,108,-107
"10571","8112至上","110/08/17","美林",79,10,69
"10572","8112至上","110/08/17","台灣摩根士丹利",0,101,-101
"10573","8112至上","110/08/17","統一",46,0,46
"10574","8112至上","110/08/17","香港上海匯豐",0,96,-96
"10575","8112至上","110/08/17","群益金鼎-瑞豐",40,0,40
"10576","8112至上","110/08/17","群益金鼎-基隆",1,70,-69
"10577","8112至上","110/08/17","臺銀-金山",37,0,37
"10578","8112至上","110/08/17","日盛-花蓮",0,52,-52
"10579","8112至上","110/08/17","新光-高雄",37,4,33
"10580","8112至上","110/08/17","國票-北高雄",0,50,-50
"10581","8112至上","110/08/17","臺銀",41,15,26
"10582","8112至上","110/08/17","永豐金-新竹",0,48,-48
"10583","8112至上","110/08/17","元大證券",27,2,25
"10584","8112至上","110/08/17","日進",0,45,-45
"10585","8112至上","110/08/17","元大-內湖",24,0,24
"10586","8112至上","110/08/17","大展",0,30,-30
"10587","8112至上","110/08/17","國票-天祥",23,0,23
"10588","8112至上","110/08/17","港商野村",30,52,-22
"10589","8112至上","110/08/17","元大-土城永寧",23,0,23
"10590","8112至上","110/08/17","凱基-市府",1,21,-20
"10591","1570力肯","110/08/17","元大-南投",88,1,87
"10592","1570力肯","110/08/17","富邦-仁愛",0,42,-42
"10593","1570力肯","110/08/17","群益金鼎-高雄",51,10,41
"10594","1570力肯","110/08/17","元富-新竹",0,30,-30
"10595","1570力肯","110/08/17","凱基-台北",47,7,40
"10596","1570力肯","110/08/17","元大-新盛",2,28,-26
"10597","1570力肯","110/08/17","統一",29,4,25
"10598","1570力肯","110/08/17","凱基-台南",0,20,-20
"10599","1570力肯","110/08/17","元大-大雅",25,0,25
"10600","1570力肯","110/08/17","日盛-復興",0,15,-15
"10601","1570力肯","110/08/17","台新證券",24,10,14
"10602","1570力肯","110/08/17","元大-前金",1,15,-14
"10603","1570力肯","110/08/17","元大證券",14,0,14
"10604","1570力肯","110/08/17","元大-北成功",0,14,-14
"10605","1570力肯","110/08/17","日盛-板橋",12,0,12
"10606","1570力肯","110/08/17","臺銀-臺南",0,11,-11
"10607","1570力肯","110/08/17","元大-鑫永和",11,0,11
"10608","1570力肯","110/08/17","凱基-彰化",0,11,-11
"10609","1570力肯","110/08/17","富邦-內湖",10,0,10
"10610","1570力肯","110/08/17","合庫-桃園",0,10,-10
"10611","1570力肯","110/08/17","元富-緯城",10,1,9
"10612","1570力肯","110/08/17","凱基-南崁",0,10,-10
"10613","1570力肯","110/08/17","元大-開元",10,2,8
"10614","1570力肯","110/08/17","凱基-台中",0,9,-9
"10615","1570力肯","110/08/17","元大-桃興",8,1,7
"10616","1570力肯","110/08/17","華南永昌-嘉義",0,8,-8
"10617","1570力肯","110/08/17","日盛-員林",6,0,6
"10618","1570力肯","110/08/17","元大-鹿港",1,9,-8
"10619","1570力肯","110/08/17","陽信",5,0,5
"10620","1570力肯","110/08/17","國票-中正",0,7,-7
"10621","2929淘帝","110/08/17","元大-太平",48,0,48
"10622","2929淘帝","110/08/17","華南永昌-苗栗",0,30,-30
"10623","2929淘帝","110/08/17","永豐金-敦南",22,0,22
"10624","2929淘帝","110/08/17","兆豐-復興",0,15,-15
"10625","2929淘帝","110/08/17","永興",12,0,12
"10626","2929淘帝","110/08/17","凱基-長庚",0,13,-13
"10627","2929淘帝","110/08/17","日盛-復興",10,0,10
"10628","2929淘帝","110/08/17","美林",1,13,-12
"10629","2929淘帝","110/08/17","第一金-大稻埕",10,0,10
"10630","2929淘帝","110/08/17","永豐金-豐原",0,10,-10
"10631","2929淘帝","110/08/17","華南永昌-長虹",10,0,10
"10632","2929淘帝","110/08/17","華南永昌-高雄",1,10,-9
"10633","2929淘帝","110/08/17","元大-高雄",8,0,8
"10634","2929淘帝","110/08/17","日盛-南京",0,8,-8
"10635","2929淘帝","110/08/17","港商野村",12,5,7
"10636","2929淘帝","110/08/17","兆豐-大同",0,7,-7
"10637","2929淘帝","110/08/17","亞東-板橋",7,0,7
"10638","2929淘帝","110/08/17","摩根大通",0,6,-6
"10639","2929淘帝","110/08/17","國票-北高雄",6,0,6
"10640","2929淘帝","110/08/17","凱基-台中",0,5,-5
"10641","2929淘帝","110/08/17","國票-九鼎",6,0,6
"10642","2929淘帝","110/08/17","元大-鶯歌",0,5,-5
"10643","2929淘帝","110/08/17","亞東-新竹",5,0,5
"10644","2929淘帝","110/08/17","元大-上新莊",0,5,-5
"10645","2929淘帝","110/08/17","新加坡商瑞銀",4,0,4
"10646","2929淘帝","110/08/17","元大-北三重",0,5,-5
"10647","2929淘帝","110/08/17","凱基-中山",6,2,4
"10648","2929淘帝","110/08/17","第一金-澎湖",4,8,-4
"10649","2929淘帝","110/08/17","富邦-南屯",4,0,4
"10650","2929淘帝","110/08/17","日進",1,5,-4
"10651","5410國眾","110/08/17","元大-博愛",50,3,47
"10652","5410國眾","110/08/17","瑞士信貸",0,61,-61
"10653","5410國眾","110/08/17","土銀-嘉義",38,0,38
"10654","5410國眾","110/08/17","新光",3,41,-38
"10655","5410國眾","110/08/17","國票-北高雄",20,0,20
"10656","5410國眾","110/08/17","凱基-台南",2,30,-28
"10657","5410國眾","110/08/17","凱基-台北",37,22,15
"10658","5410國眾","110/08/17","元富-基隆",0,21,-21
"10659","5410國眾","110/08/17","兆豐-永和",14,0,14
"10660","5410國眾","110/08/17","富邦-新竹",1,16,-15
"10661","5410國眾","110/08/17","富邦-台北",22,10,12
"10662","5410國眾","110/08/17","亞東-新竹",0,14,-14
"10663","5410國眾","110/08/17","元大-中壢",12,0,12
"10664","5410國眾","110/08/17","群益金鼎-新竹",1,15,-14
"10665","5410國眾","110/08/17","摩根大通",25,14,11
"10666","5410國眾","110/08/17","富邦-永和",1,14,-13
"10667","5410國眾","110/08/17","日盛-花蓮",10,0,10
"10668","5410國眾","110/08/17","元大-新竹經國",0,12,-12
"10669","5410國眾","110/08/17","元富-同大",11,1,10
"10670","5410國眾","110/08/17","群益金鼎-三民",0,11,-11
"10671","5410國眾","110/08/17","凱基-科園",10,0,10
"10672","5410國眾","110/08/17","寶盛",0,10,-10
"10673","5410國眾","110/08/17","元大-潮州",10,0,10
"10674","5410國眾","110/08/17","永豐金-板橋",0,10,-10
"10675","5410國眾","110/08/17","台新-左楠",10,1,9
"10676","5410國眾","110/08/17","永豐金-竹科",1,11,-10
"10677","5410國眾","110/08/17","群益金鼎-古亭",14,5,9
"10678","5410國眾","110/08/17","臺銀",1,9,-8
"10679","5410國眾","110/08/17","永豐金-萬盛",9,0,9
"10680","5410國眾","110/08/17","群益金鼎-南京",0,8,-8
"10681","2841台開","110/08/17","宏遠-館前",169,2,167
"10682","2841台開","110/08/17","光和-溪湖",0,120,-120
"10683","2841台開","110/08/17","第一金",54,0,54
"10684","2841台開","110/08/17","兆豐-台南",0,109,-109
"10685","2841台開","110/08/17","台新-三民",50,0,50
"10686","2841台開","110/08/17","永豐金-台南",0,50,-50
"10687","2841台開","110/08/17","日盛證券",52,24,28
"10688","2841台開","110/08/17","兆豐-高雄",0,38,-38
"10689","2841台開","110/08/17","華南永昌-台中",20,0,20
"10690","2841台開","110/08/17","元大-林園",0,30,-30
"10691","2841台開","110/08/17","永豐金-中盛",17,0,17
"10692","2841台開","110/08/17","兆豐-台中",0,20,-20
"10693","2841台開","110/08/17","日盛-台中",15,0,15
"10694","2841台開","110/08/17","元大-敦化",0,20,-20
"10695","2841台開","110/08/17","日盛-園區",15,0,15
"10696","2841台開","110/08/17","元大-彰化民生",2,21,-19
"10697","2841台開","110/08/17","國泰-館前",15,0,15
"10698","2841台開","110/08/17","凱基-彰化",1,14,-13
"10699","2841台開","110/08/17","日盛-大墩",10,0,10
"10700","2841台開","110/08/17","元大-大灣",0,13,-13
"10701","2841台開","110/08/17","大慶-蘆洲",10,0,10
"10702","2841台開","110/08/17","元大-鹿港",0,11,-11
"10703","2841台開","110/08/17","凱基-員林",10,0,10
"10704","2841台開","110/08/17","兆豐-公益",0,10,-10
"10705","2841台開","110/08/17","富邦-基隆",10,0,10
"10706","2841台開","110/08/17","元大-北三重",0,10,-10
"10707","2841台開","110/08/17","元大-新竹經國",10,0,10
"10708","2841台開","110/08/17","華南永昌-鳳山",0,7,-7
"10709","2841台開","110/08/17","元富-成功",8,0,8
"10710","2841台開","110/08/17","元大-南海",0,7,-7
"10711","6207雷科","110/08/17","台新-高雄",82,2,80
"10712","6207雷科","110/08/17","第一金-員林",0,60,-60
"10713","6207雷科","110/08/17","凱基-台北",42,16,26
"10714","6207雷科","110/08/17","元大-高雄",0,47,-47
"10715","6207雷科","110/08/17","摩根大通",26,5,21
"10716","6207雷科","110/08/17","凱基-復興",0,20,-20
"10717","6207雷科","110/08/17","安泰",20,0,20
"10718","6207雷科","110/08/17","元大-新盛",1,20,-19
"10719","6207雷科","110/08/17","富邦-中壢",20,0,20
"10720","6207雷科","110/08/17","元富-大昌",0,12,-12
"10721","6207雷科","110/08/17","新加坡商瑞銀",23,6,17
"10722","6207雷科","110/08/17","華南永昌-岡山",1,12,-11
"10723","6207雷科","110/08/17","日盛-桃園",10,0,10
"10724","6207雷科","110/08/17","日盛-板橋",0,10,-10
"10725","6207雷科","110/08/17","兆豐-西螺",10,0,10
"10726","6207雷科","110/08/17","凱基-中壢",0,10,-10
"10727","6207雷科","110/08/17","中國信託-高雄",8,0,8
"10728","6207雷科","110/08/17","港商野村",7,16,-9
"10729","6207雷科","110/08/17","大昌-桃園",8,0,8
"10730","6207雷科","110/08/17","凱基-三重",1,10,-9
"10731","6207雷科","110/08/17","群益金鼎-士林",6,0,6
"10732","6207雷科","110/08/17","台新-台中",0,8,-8
"10733","6207雷科","110/08/17","美林",5,0,5
"10734","6207雷科","110/08/17","富邦-板橋",0,8,-8
"10735","6207雷科","110/08/17","中國信託-三重",5,0,5
"10736","6207雷科","110/08/17","兆豐-公益",0,6,-6
"10737","6207雷科","110/08/17","康和-內湖",5,0,5
"10738","6207雷科","110/08/17","新光-桃園",0,6,-6
"10739","6207雷科","110/08/17","新光",9,4,5
"10740","6207雷科","110/08/17","凱基-大里",0,6,-6
"10741","3679新至陞","110/08/17","台灣摩根士丹利",20,0,20
"10742","3679新至陞","110/08/17","台新證券",1,31,-30
"10743","3679新至陞","110/08/17","凱基-長庚",12,0,12
"10744","3679新至陞","110/08/17","統一",0,27,-27
"10745","3679新至陞","110/08/17","元大-大天母",12,0,12
"10746","3679新至陞","110/08/17","國票-南科",0,20,-20
"10747","3679新至陞","110/08/17","瑞士信貸",24,15,9
"10748","3679新至陞","110/08/17","國泰-忠孝",0,7,-7
"10749","3679新至陞","110/08/17","康和-板橋",6,0,6
"10750","3679新至陞","110/08/17","美林",10,15,-5
"10751","3679新至陞","110/08/17","元大-四維",6,0,6
"10752","3679新至陞","110/08/17","國泰-桃園",0,5,-5
"10753","3679新至陞","110/08/17","日盛-台中",5,0,5
"10754","3679新至陞","110/08/17","凱基-頭份",0,4,-4
"10755","3679新至陞","110/08/17","第一金-彰化",5,0,5
"10756","3679新至陞","110/08/17","港商野村",1,4,-3
"10757","3679新至陞","110/08/17","凱基-文心",5,1,4
"10758","3679新至陞","110/08/17","凱基-台北",8,11,-3
"10759","3679新至陞","110/08/17","元大-雙和",4,0,4
"10760","3679新至陞","110/08/17","元大證券",1,4,-3
"10761","3679新至陞","110/08/17","元大-草屯",4,0,4
"10762","3679新至陞","110/08/17","元大-新莊",0,3,-3
"10763","3679新至陞","110/08/17","合庫-彰化",2,0,2
"10764","3679新至陞","110/08/17","港商法國興業",0,2,-2
"10765","3679新至陞","110/08/17","臺銀-臺中",2,0,2
"10766","3679新至陞","110/08/17","元富-板橋",0,2,-2
"10767","3679新至陞","110/08/17","日盛-文化",3,1,2
"10768","3679新至陞","110/08/17","康和-高雄",0,2,-2
"10769","3679新至陞","110/08/17","永豐金-敦南",2,0,2
"10770","3679新至陞","110/08/17","群益金鼎-三重",0,2,-2
"10771","2727王品","110/08/17","凱基-台北",63,1,62
"10772","2727王品","110/08/17","第一金-高雄",1,111,-110
"10773","2727王品","110/08/17","台灣摩根士丹利",86,37,49
"10774","2727王品","110/08/17","摩根大通",29,118,-89
"10775","2727王品","110/08/17","瑞士信貸",32,0,32
"10776","2727王品","110/08/17","永豐金證券",0,83,-83
"10777","2727王品","110/08/17","元大-北屯",32,1,31
"10778","2727王品","110/08/17","華南永昌",1,38,-37
"10779","2727王品","110/08/17","美林",37,8,29
"10780","2727王品","110/08/17","合庫-新竹",1,31,-30
"10781","2727王品","110/08/17","凱基-市政",23,0,23
"10782","2727王品","110/08/17","中國信託-新竹",1,23,-22
"10783","2727王品","110/08/17","港商野村",74,54,20
"10784","2727王品","110/08/17","玉山證券",16,33,-17
"10785","2727王品","110/08/17","元大-板橋",20,0,20
"10786","2727王品","110/08/17","富邦-台北",5,19,-14
"10787","2727王品","110/08/17","元大-汐止",12,0,12
"10788","2727王品","110/08/17","群益金鼎-中壢",1,14,-13
"10789","2727王品","110/08/17","元大-龍潭",19,8,11
"10790","2727王品","110/08/17","富邦證券",0,13,-13
"10791","2727王品","110/08/17","元富",10,0,10
"10792","2727王品","110/08/17","元大證券",9,22,-13
"10793","2727王品","110/08/17","彰銀-台中",9,0,9
"10794","2727王品","110/08/17","聯邦商銀",0,12,-12
"10795","2727王品","110/08/17","中國信託",11,2,9
"10796","2727王品","110/08/17","日盛-屏東",7,17,-10
"10797","2727王品","110/08/17","群益金鼎-西松",10,1,9
"10798","2727王品","110/08/17","康和-高雄",0,10,-10
"10799","2727王品","110/08/17","第一金-自由",8,0,8
"10800","2727王品","110/08/17","新光-高雄",1,11,-10
"10801","1570力肯","110/08/17","元大-南投",88,1,87
"10802","1570力肯","110/08/17","富邦-仁愛",0,42,-42
"10803","1570力肯","110/08/17","群益金鼎-高雄",51,10,41
"10804","1570力肯","110/08/17","元富-新竹",0,30,-30
"10805","1570力肯","110/08/17","凱基-台北",47,7,40
"10806","1570力肯","110/08/17","元大-新盛",2,28,-26
"10807","1570力肯","110/08/17","統一",29,4,25
"10808","1570力肯","110/08/17","凱基-台南",0,20,-20
"10809","1570力肯","110/08/17","元大-大雅",25,0,25
"10810","1570力肯","110/08/17","日盛-復興",0,15,-15
"10811","1570力肯","110/08/17","台新證券",24,10,14
"10812","1570力肯","110/08/17","元大-前金",1,15,-14
"10813","1570力肯","110/08/17","元大證券",14,0,14
"10814","1570力肯","110/08/17","元大-北成功",0,14,-14
"10815","1570力肯","110/08/17","日盛-板橋",12,0,12
"10816","1570力肯","110/08/17","臺銀-臺南",0,11,-11
"10817","1570力肯","110/08/17","元大-鑫永和",11,0,11
"10818","1570力肯","110/08/17","凱基-彰化",0,11,-11
"10819","1570力肯","110/08/17","富邦-內湖",10,0,10
"10820","1570力肯","110/08/17","合庫-桃園",0,10,-10
"10821","1570力肯","110/08/17","元富-緯城",10,1,9
"10822","1570力肯","110/08/17","凱基-南崁",0,10,-10
"10823","1570力肯","110/08/17","元大-開元",10,2,8
"10824","1570力肯","110/08/17","凱基-台中",0,9,-9
"10825","1570力肯","110/08/17","元大-桃興",8,1,7
"10826","1570力肯","110/08/17","華南永昌-嘉義",0,8,-8
"10827","1570力肯","110/08/17","日盛-員林",6,0,6
"10828","1570力肯","110/08/17","元大-鹿港",1,9,-8
"10829","1570力肯","110/08/17","陽信",5,0,5
"10830","1570力肯","110/08/17","國票-中正",0,7,-7
"10831","6180橘子","110/08/17","摩根大通",107,25,82
"10832","6180橘子","110/08/17","元大-高雄",0,50,-50
"10833","6180橘子","110/08/17","美林",59,0,59
"10834","6180橘子","110/08/17","第一金-新竹",1,30,-29
"10835","6180橘子","110/08/17","美商高盛",31,0,31
"10836","6180橘子","110/08/17","台新-建北",1,25,-24
"10837","6180橘子","110/08/17","凱基-台北",32,6,26
"10838","6180橘子","110/08/17","群益金鼎-大安",0,20,-20
"10839","6180橘子","110/08/17","合庫-自強",10,0,10
"10840","6180橘子","110/08/17","台灣摩根士丹利",37,54,-17
"10841","6180橘子","110/08/17","元富-世貿",10,0,10
"10842","6180橘子","110/08/17","玉山-台南",1,13,-12
"10843","6180橘子","110/08/17","元大-台中中港",10,0,10
"10844","6180橘子","110/08/17","富邦-基隆",0,11,-11
"10845","6180橘子","110/08/17","臺銀-金山",11,2,9
"10846","6180橘子","110/08/17","日盛-雙和",0,10,-10
"10847","6180橘子","110/08/17","華南永昌-虎尾",8,0,8
"10848","6180橘子","110/08/17","統一-台南",0,10,-10
"10849","6180橘子","110/08/17","元大-彰化民生",7,0,7
"10850","6180橘子","110/08/17","新光-桃園",0,10,-10
"10851","6180橘子","110/08/17","群益金鼎-嘉義",6,0,6
"10852","6180橘子","110/08/17","凱基-竹北",0,10,-10
"10853","6180橘子","110/08/17","元大-太平",6,0,6
"10854","6180橘子","110/08/17","元大-基隆孝二",0,10,-10
"10855","6180橘子","110/08/17","永豐金-敦北",6,0,6
"10856","6180橘子","110/08/17","永豐金-大園",0,10,-10
"10857","6180橘子","110/08/17","華南永昌-台中",5,0,5
"10858","6180橘子","110/08/17","第一金-中山",0,8,-8
"10859","6180橘子","110/08/17","元大-永春",5,0,5
"10860","6180橘子","110/08/17","台新證券",4,12,-8
"10861","2390云辰","110/08/17","美林",601,355,246
"10862","2390云辰","110/08/17","富邦-虎尾",786,1240,-454
"10863","2390云辰","110/08/17","凱基-台北",999,859,140
"10864","2390云辰","110/08/17","富隆-長安",2,262,-260
"10865","2390云辰","110/08/17","新光",1508,1370,138
"10866","2390云辰","110/08/17","摩根大通",2924,3174,-250
"10867","2390云辰","110/08/17","國泰-敦南",1264,1133,131
"10868","2390云辰","110/08/17","元大-木柵",204,419,-215
"10869","2390云辰","110/08/17","富邦-內湖",143,18,125
"10870","2390云辰","110/08/17","兆豐-埔墘",10,165,-155
"10871","2390云辰","110/08/17","統一-新營",142,28,114
"10872","2390云辰","110/08/17","美商高盛",332,483,-151
"10873","2390云辰","110/08/17","兆豐-虎尾",107,5,102
"10874","2390云辰","110/08/17","元大-大同",829,966,-137
"10875","2390云辰","110/08/17","新加坡商瑞銀",274,177,97
"10876","2390云辰","110/08/17","元大-土城學府",236,367,-131
"10877","2390云辰","110/08/17","元大-上新莊",82,9,73
"10878","2390云辰","110/08/17","富邦-花蓮",5,107,-102
"10879","2390云辰","110/08/17","凱基-民權",145,78,67
"10880","2390云辰","110/08/17","元大-台中",20,118,-98
"10881","2390云辰","110/08/17","富邦-彰化",200,133,67
"10882","2390云辰","110/08/17","群益金鼎-開元",70,150,-80
"10883","2390云辰","110/08/17","宏遠-桃園",67,5,62
"10884","2390云辰","110/08/17","永豐金-古亭",27,106,-79
"10885","2390云辰","110/08/17","港商野村",2090,2030,60
"10886","2390云辰","110/08/17","土銀-士林",0,78,-78
"10887","2390云辰","110/08/17","永豐金-萬盛",76,17,59
"10888","2390云辰","110/08/17","元富-高雄",94,166,-72
"10889","2390云辰","110/08/17","元大-歸仁",85,34,51
"10890","2390云辰","110/08/17","富邦-敦南",40,108,-68
"10891","2609陽明","110/08/16","康和",4181,128,4053
"10892","2609陽明","110/08/16","凱基-台北",1053,19933,-18880
"10893","2609陽明","110/08/16","宏遠證券",2579,659,1920
"10894","2609陽明","110/08/16","群益金鼎-三重",162,5149,-4987
"10895","2609陽明","110/08/16","華南永昌-竹北",2072,225,1847
"10896","2609陽明","110/08/16","兆豐-南京",3041,5871,-2830
"10897","2609陽明","110/08/16","凱基-虎尾",4140,2400,1740
"10898","2609陽明","110/08/16","中國信託-松江",116,2823,-2707
"10899","2609陽明","110/08/16","元大證券",8157,7010,1147
"10900","2609陽明","110/08/16","兆豐-復興",107,2607,-2500
"10901","2609陽明","110/08/16","摩根大通",5939,5074,865
"10902","2609陽明","110/08/16","美林",2802,5073,-2271
"10903","2609陽明","110/08/16","永豐金-信義",865,85,780
"10904","2609陽明","110/08/16","兆豐-三民",182,2181,-1999
"10905","2609陽明","110/08/16","元大-頭份",1005,248,757
"10906","2609陽明","110/08/16","新加坡商瑞銀",561,2511,-1950
"10907","2609陽明","110/08/16","港商野村",2920,2184,736
"10908","2609陽明","110/08/16","凱基-城中",585,1560,-975
"10909","2609陽明","110/08/16","元大-信義",944,209,735
"10910","2609陽明","110/08/16","元大-竹科",394,1326,-932
"10911","2609陽明","110/08/16","凱基-市政",14533,13859,674
"10912","2609陽明","110/08/16","群益金鼎-大安",89,951,-862
"10913","2609陽明","110/08/16","富邦-嘉義",7027,6481,546
"10914","2609陽明","110/08/16","瑞士信貸",910,1607,-697
"10915","2609陽明","110/08/16","新光-新竹",1792,1331,461
"10916","2609陽明","110/08/16","兆豐-新竹",305,932,-627
"10917","2609陽明","110/08/16","凱基-台南",808,378,430
"10918","2609陽明","110/08/16","元大-永春",376,856,-480
"10919","2609陽明","110/08/16","凱基-信義",434,31,403
"10920","2609陽明","110/08/16","元富",483,956,-473
"10921","2636台驊投控","110/08/16","凱基",893,138,755
"10922","2636台驊投控","110/08/16","日盛-台中",36,221,-185
"10923","2636台驊投控","110/08/16","瑞士信貸",524,17,507
"10924","2636台驊投控","110/08/16","統一-新竹",4,188,-184
"10925","2636台驊投控","110/08/16","台灣摩根士丹利",534,35,499
"10926","2636台驊投控","110/08/16","國泰-敦南",291,403,-112
"10927","2636台驊投控","110/08/16","富邦-花蓮",283,25,258
"10928","2636台驊投控","110/08/16","新光",259,366,-107
"10929","2636台驊投控","110/08/16","新光-新竹",349,144,205
"10930","2636台驊投控","110/08/16","群益金鼎",89,185,-96
"10931","2636台驊投控","110/08/16","國票-彰化",442,282,160
"10932","2636台驊投控","110/08/16","新光-桃園",22,98,-76
"10933","2636台驊投控","110/08/16","大慶",160,1,159
"10934","2636台驊投控","110/08/16","群益金鼎-南京",57,126,-69
"10935","2636台驊投控","110/08/16","富邦-虎尾",144,13,131
"10936","2636台驊投控","110/08/16","玉山-台南",61,127,-66
"10937","2636台驊投控","110/08/16","元大-士林",118,2,116
"10938","2636台驊投控","110/08/16","元富-大昌",5,66,-61
"10939","2636台驊投控","110/08/16","摩根大通",799,698,101
"10940","2636台驊投控","110/08/16","日盛證券",78,137,-59
"10941","2636台驊投控","110/08/16","日盛-宜蘭",100,3,97
"10942","2636台驊投控","110/08/16","凱基-市政",13,68,-55
"10943","2636台驊投控","110/08/16","凱基-台北",786,690,96
"10944","2636台驊投控","110/08/16","兆豐-城中",7,58,-51
"10945","2636台驊投控","110/08/16","兆豐-東門",101,31,70
"10946","2636台驊投控","110/08/16","永豐金-新竹",33,83,-50
"10947","2636台驊投控","110/08/16","凱基-長庚",66,6,60
"10948","2636台驊投控","110/08/16","國泰-台中",69,115,-46
"10949","2636台驊投控","110/08/16","元富-中壢",76,18,58
"10950","2636台驊投控","110/08/16","國票-九鼎",18,61,-43
"10951","2867三商壽","110/08/16","兆豐-大同",800,0,800
"10952","2867三商壽","110/08/16","台新證券",7,983,-976
"10953","2867三商壽","110/08/16","元富-世貿",646,5,641
"10954","2867三商壽","110/08/16","美林",0,406,-406
"10955","2867三商壽","110/08/16","元大-土城永寧",320,0,320
"10956","2867三商壽","110/08/16","(牛牛牛)亞-鑫豐",15,120,-105
"10957","2867三商壽","110/08/16","新加坡商瑞銀",241,18,223
"10958","2867三商壽","110/08/16","土銀",0,100,-100
"10959","2867三商壽","110/08/16","玉山-城中",156,0,156
"10960","2867三商壽","110/08/16","兆豐-來福",0,100,-100
"10961","2867三商壽","110/08/16","元大-桃園",100,0,100
"10962","2867三商壽","110/08/16","凱基-虎尾",0,90,-90
"10963","2867三商壽","110/08/16","高橋-龍潭",87,1,86
"10964","2867三商壽","110/08/16","瑞士信貸",53,140,-87
"10965","2867三商壽","110/08/16","富邦-員林",79,0,79
"10966","2867三商壽","110/08/16","花旗環球",7,83,-76
"10967","2867三商壽","110/08/16","華南永昌-高雄",50,0,50
"10968","2867三商壽","110/08/16","元大-大同",0,67,-67
"10969","2867三商壽","110/08/16","元大-崇德",50,0,50
"10970","2867三商壽","110/08/16","日盛-板橋",0,60,-60
"10971","2867三商壽","110/08/16","華南永昌-虎尾",40,0,40
"10972","2867三商壽","110/08/16","元大-博愛",2,62,-60
"10973","2867三商壽","110/08/16","元大-大統",40,0,40
"10974","2867三商壽","110/08/16","(牛牛牛)亞-網路",0,55,-55
"10975","2867三商壽","110/08/16","新光",87,48,39
"10976","2867三商壽","110/08/16","美商高盛",105,158,-53
"10977","2867三商壽","110/08/16","元大-大安",36,0,36
"10978","2867三商壽","110/08/16","永豐金-屏東",1,52,-51
"10979","2867三商壽","110/08/16","群益金鼎-西松",35,0,35
"10980","2867三商壽","110/08/16","兆豐-台中港",0,50,-50
"10981","5521工信","110/08/16","第一金-新竹",84,0,84
"10982","5521工信","110/08/16","摩根大通",83,306,-223
"10983","5521工信","110/08/16","日進",60,0,60
"10984","5521工信","110/08/16","日盛證券",0,70,-70
"10985","5521工信","110/08/16","凱基-中壢",40,0,40
"10986","5521工信","110/08/16","群益金鼎-海山",0,40,-40
"10987","5521工信","110/08/16","台新證券",37,0,37
"10988","5521工信","110/08/16","華南永昌",0,39,-39
"10989","5521工信","110/08/16","群益金鼎-台中",35,0,35
"10990","5521工信","110/08/16","美林",5,43,-38
"10991","5521工信","110/08/16","富邦-台北",30,0,30
"10992","5521工信","110/08/16","康和-澎湖",0,30,-30
"10993","5521工信","110/08/16","元大-永和",30,0,30
"10994","5521工信","110/08/16","華南永昌-彰化",5,34,-29
"10995","5521工信","110/08/16","華南永昌-潮州",28,0,28
"10996","5521工信","110/08/16","元大-龍潭",0,25,-25
"10997","5521工信","110/08/16","玉山-嘉義",23,0,23
"10998","5521工信","110/08/16","兆豐-桃園",0,24,-24
"10999","5521工信","110/08/16","元大-新莊",40,17,23
"11000","5521工信","110/08/16","華南永昌-林口",1,25,-24
"11001","5521工信","110/08/16","第一金-桃園",22,0,22
"11002","5521工信","110/08/16","台灣企銀-台中",0,20,-20
"11003","5521工信","110/08/16","凱基-鳳山",20,0,20
"11004","5521工信","110/08/16","第一金-台南",0,20,-20
"11005","5521工信","110/08/16","元大-路竹",20,0,20
"11006","5521工信","110/08/16","元富-古亭",0,20,-20
"11007","5521工信","110/08/16","合庫-桃園",20,1,19
"11008","5521工信","110/08/16","兆豐-中壢",0,20,-20
"11009","5521工信","110/08/16","臺銀-鳳山",21,2,19
"11010","5521工信","110/08/16","元大-仁愛",0,20,-20
"11011","1471首利","110/08/16","摩根大通",196,88,108
"11012","1471首利","110/08/16","元大-草屯",1,200,-199
"11013","1471首利","110/08/16","瑞士信貸",95,17,78
"11014","1471首利","110/08/16","元富-埔里",0,51,-51
"11015","1471首利","110/08/16","新加坡商瑞銀",38,0,38
"11016","1471首利","110/08/16","凱基-雙和",0,40,-40
"11017","1471首利","110/08/16","國泰-敦南",37,2,35
"11018","1471首利","110/08/16","華南永昌-公誠",0,40,-40
"11019","1471首利","110/08/16","凱基-彰化",31,0,31
"11020","1471首利","110/08/16","元大-大灣",0,36,-36
"11021","1471首利","110/08/16","光和-溪湖",20,0,20
"11022","1471首利","110/08/16","新光-台中",17,42,-25
"11023","1471首利","110/08/16","國票-中港",20,0,20
"11024","1471首利","110/08/16","富邦-仁愛",0,25,-25
"11025","1471首利","110/08/16","美林",15,0,15
"11026","1471首利","110/08/16","群益金鼎-台北",0,24,-24
"11027","1471首利","110/08/16","元大-板橋",15,0,15
"11028","1471首利","110/08/16","永豐金-竹北",0,22,-22
"11029","1471首利","110/08/16","凱基-長庚",16,2,14
"11030","1471首利","110/08/16","合庫-台中",0,20,-20
"11031","1471首利","110/08/16","元大-斗信",14,0,14
"11032","1471首利","110/08/16","高橋-龍潭",2,22,-20
"11033","1471首利","110/08/16","第一金-高雄",12,0,12
"11034","1471首利","110/08/16","國票-台中",0,20,-20
"11035","1471首利","110/08/16","玉山-大里",12,0,12
"11036","1471首利","110/08/16","群益金鼎-潭子",0,20,-20
"11037","1471首利","110/08/16","永豐金-大園",12,0,12
"11038","1471首利","110/08/16","台新證券",2,19,-17
"11039","1471首利","110/08/16","永豐金-中正",12,0,12
"11040","1471首利","110/08/16","聯邦-高雄",0,15,-15
"11041","2883開發金","110/08/16","中國信託-文心",4881,27,4854
"11042","2883開發金","110/08/16","摩根大通",1712,30864,-29152
"11043","2883開發金","110/08/16","國泰-敦南",3101,627,2474
"11044","2883開發金","110/08/16","台灣摩根士丹利",453,18916,-18463
"11045","2883開發金","110/08/16","亞東-新竹",3614,1222,2392
"11046","2883開發金","110/08/16","凱基-台北",8208,20874,-12666
"11047","2883開發金","110/08/16","花旗環球",3115,841,2274
"11048","2883開發金","110/08/16","新加坡商瑞銀",363,11873,-11510
"11049","2883開發金","110/08/16","元大證券",3308,1099,2209
"11050","2883開發金","110/08/16","美林",130,9722,-9592
"11051","2883開發金","110/08/16","康和-仁愛",2103,0,2103
"11052","2883開發金","110/08/16","統一",766,7210,-6444
"11053","2883開發金","110/08/16","玉山-大里",1874,31,1843
"11054","2883開發金","110/08/16","元富",48,5683,-5635
"11055","2883開發金","110/08/16","第一金-忠孝",1836,3,1833
"11056","2883開發金","110/08/16","富邦證券",147,4117,-3970
"11057","2883開發金","110/08/16","宏遠證券",1825,5,1820
"11058","2883開發金","110/08/16","國票-長城",22,2713,-2691
"11059","2883開發金","110/08/16","統一-新竹",1630,2,1628
"11060","2883開發金","110/08/16","台新證券",1753,4439,-2686
"11061","2883開發金","110/08/16","國泰-板橋",1493,346,1147
"11062","2883開發金","110/08/16","元大-士林",417,2698,-2281
"11063","2883開發金","110/08/16","國泰-館前",1856,775,1081
"11064","2883開發金","110/08/16","港商野村",3026,5159,-2133
"11065","2883開發金","110/08/16","群益金鼎-高盛",1005,12,993
"11066","2883開發金","110/08/16","瑞士信貸",1295,3237,-1942
"11067","2883開發金","110/08/16","元大-新莊",860,16,844
"11068","2883開發金","110/08/16","美商高盛",162,1917,-1755
"11069","2883開發金","110/08/16","臺銀",807,32,775
"11070","2883開發金","110/08/16","國泰證券",290,1593,-1303
"11071","6205詮欣","110/08/16","凱基-汐止",22,0,22
"11072","6205詮欣","110/08/16","凱基-台北",0,10,-10
"11073","6205詮欣","110/08/16","臺銀-民權",10,0,10
"11074","6205詮欣","110/08/16","永興-水湳",0,6,-6
"11075","6205詮欣","110/08/16","德信-新營",6,0,6
"11076","6205詮欣","110/08/16","國票-博愛",0,6,-6
"11077","6205詮欣","110/08/16","玉山證券",5,0,5
"11078","6205詮欣","110/08/16","日盛-三重",5,10,-5
"11079","6205詮欣","110/08/16","亞東-板橋",4,0,4
"11080","6205詮欣","110/08/16","日盛-永康",0,5,-5
"11081","6205詮欣","110/08/16","元大-羅東",4,0,4
"11082","6205詮欣","110/08/16","摩根大通",0,5,-5
"11083","6205詮欣","110/08/16","元大-汐止",4,0,4
"11084","6205詮欣","110/08/16","玉山-台南",0,5,-5
"11085","6205詮欣","110/08/16","臺銀-高雄",3,0,3
"11086","6205詮欣","110/08/16","元大-大天母",0,4,-4
"11087","6205詮欣","110/08/16","美林",2,0,2
"11088","6205詮欣","110/08/16","永豐金-中盛",0,3,-3
"11089","6205詮欣","110/08/16","群益金鼎-基隆",2,0,2
"11090","6205詮欣","110/08/16","華南永昌-彰化",0,2,-2
"11091","6205詮欣","110/08/16","合庫-三重",1,0,1
"11092","6205詮欣","110/08/16","富邦-中壢",0,2,-2
"11093","6205詮欣","110/08/16","(牛牛牛)亞-網路",1,0,1
"11094","6205詮欣","110/08/16","元大-成功",0,2,-2
"11095","6205詮欣","110/08/16","豐農",1,0,1
"11096","6205詮欣","110/08/16","統一-士林",0,1,-1
"11097","6205詮欣","110/08/16","凱基-站前",1,0,1
"11098","6205詮欣","110/08/16","統一-金門",0,1,-1
"11099","6205詮欣","110/08/16","富邦-建國",1,0,1
"11100","6205詮欣","110/08/16","元富-文心",0,1,-1
"11101","1540喬福","110/08/16","元大-成功",25,0,25
"11102","1540喬福","110/08/16","凱基-台北",0,51,-51
"11103","1540喬福","110/08/16","新光",16,0,16
"11104","1540喬福","110/08/16","新光-新竹",10,29,-19
"11105","1540喬福","110/08/16","日盛-鳳山",10,0,10
"11106","1540喬福","110/08/16","元大-北屯",0,18,-18
"11107","1540喬福","110/08/16","台新-左楠",10,0,10
"11108","1540喬福","110/08/16","北城證券",0,16,-16
"11109","1540喬福","110/08/16","玉山-左營",10,0,10
"11110","1540喬福","110/08/16","國泰-敦南",2,18,-16
"11111","1540喬福","110/08/16","富邦-南屯",10,0,10
"11112","1540喬福","110/08/16","新光-桃園",0,15,-15
"11113","1540喬福","110/08/16","富邦-板橋",8,0,8
"11114","1540喬福","110/08/16","新光-台南",0,12,-12
"11115","1540喬福","110/08/16","凱基-中壢",7,0,7
"11116","1540喬福","110/08/16","凱基-台中",0,12,-12
"11117","1540喬福","110/08/16","元富-新竹",5,0,5
"11118","1540喬福","110/08/16","元大-汐止",0,10,-10
"11119","1540喬福","110/08/16","兆豐-北高雄",5,0,5
"11120","1540喬福","110/08/16","凱基-竹北",0,7,-7
"11121","1540喬福","110/08/16","台新-台中",5,0,5
"11122","1540喬福","110/08/16","日盛-文化",0,4,-4
"11123","1540喬福","110/08/16","凱基-台南",5,0,5
"11124","1540喬福","110/08/16","富邦-桃園",0,3,-3
"11125","1540喬福","110/08/16","元大-龍潭",5,0,5
"11126","1540喬福","110/08/16","摩根大通",1,3,-2
"11127","1540喬福","110/08/16","元富-緯城",4,0,4
"11128","1540喬福","110/08/16","玉山-城中",0,2,-2
"11129","1540喬福","110/08/16","元大-大安",4,0,4
"11130","1540喬福","110/08/16","永豐金-桃園",0,2,-2
"11131","2888新光金","110/08/16","兆豐-公益",12939,12,12927
"11132","2888新光金","110/08/16","摩根大通",2056,10998,-8942
"11133","2888新光金","110/08/16","元大-忠孝鼎富",11100,189,10911
"11134","2888新光金","110/08/16","元富-城東",25,8381,-8356
"11135","2888新光金","110/08/16","港商麥格理",9753,0,9753
"11136","2888新光金","110/08/16","元富",6,7491,-7485
"11137","2888新光金","110/08/16","群益金鼎-大安",3294,0,3294
"11138","2888新光金","110/08/16","美林",136,3975,-3839
"11139","2888新光金","110/08/16","凱基-復興",3020,0,3020
"11140","2888新光金","110/08/16","臺銀-高雄",19,3007,-2988
"11141","2888新光金","110/08/16","美商高盛",5603,3216,2387
"11142","2888新光金","110/08/16","台灣摩根士丹利",419,2562,-2143
"11143","2888新光金","110/08/16","國票-台東",2067,0,2067
"11144","2888新光金","110/08/16","瑞士信貸",58,1618,-1560
"11145","2888新光金","110/08/16","群益金鼎-台北",1872,0,1872
"11146","2888新光金","110/08/16","玉山-新竹",0,1497,-1497
"11147","2888新光金","110/08/16","新加坡商瑞銀",2005,179,1826
"11148","2888新光金","110/08/16","國票-博愛",3,1208,-1205
"11149","2888新光金","110/08/16","華南永昌-忠孝",1827,90,1737
"11150","2888新光金","110/08/16","元大-士林",85,1185,-1100
"11151","2888新光金","110/08/16","富邦-新營",1400,0,1400
"11152","2888新光金","110/08/16","臺銀-民權",19,1095,-1076
"11153","2888新光金","110/08/16","華南永昌-鳳山",1174,11,1163
"11154","2888新光金","110/08/16","法銀巴黎",0,868,-868
"11155","2888新光金","110/08/16","元大-員林",1051,12,1039
"11156","2888新光金","110/08/16","群益金鼎",10,847,-837
"11157","2888新光金","110/08/16","富邦-高雄",1015,11,1004
"11158","2888新光金","110/08/16","元富-世貿",7,794,-787
"11159","2888新光金","110/08/16","日盛-南京",1000,5,995
"11160","2888新光金","110/08/16","國票-安和",0,724,-724
"11161","1340勝悅","110/08/16","元富-成功",30,0,30
"11162","1340勝悅","110/08/16","元富-城東",0,107,-107
"11163","1340勝悅","110/08/16","華南永昌-公誠",30,0,30
"11164","1340勝悅","110/08/16","永豐金-竹科",0,38,-38
"11165","1340勝悅","110/08/16","華南永昌-敦南",25,0,25
"11166","1340勝悅","110/08/16","德信-新營",0,30,-30
"11167","1340勝悅","110/08/16","合庫-自強",15,0,15
"11168","1340勝悅","110/08/16","國泰-松江",0,15,-15
"11169","1340勝悅","110/08/16","臺銀-鳳山",15,0,15
"11170","1340勝悅","110/08/16","摩根大通",5,17,-12
"11171","1340勝悅","110/08/16","元富-中港",10,0,10
"11172","1340勝悅","110/08/16","港商法國興業",0,11,-11
"11173","1340勝悅","110/08/16","永豐金-南京",10,0,10
"11174","1340勝悅","110/08/16","玉山-高雄",0,10,-10
"11175","1340勝悅","110/08/16","新光",9,0,9
"11176","1340勝悅","110/08/16","凱基-台北",0,10,-10
"11177","1340勝悅","110/08/16","國泰-台中",14,7,7
"11178","1340勝悅","110/08/16","華南永昌-嘉義",0,10,-10
"11179","1340勝悅","110/08/16","元大-苗栗",6,0,6
"11180","1340勝悅","110/08/16","合庫-台南",0,6,-6
"11181","1340勝悅","110/08/16","元大-屏南",6,0,6
"11182","1340勝悅","110/08/16","玉山-桃園",0,5,-5
"11183","1340勝悅","110/08/16","臺灣企銀-埔墘",5,0,5
"11184","1340勝悅","110/08/16","永豐金-博愛",0,5,-5
"11185","1340勝悅","110/08/16","日盛-板橋",5,0,5
"11186","1340勝悅","110/08/16","美林",0,2,-2
"11187","1340勝悅","110/08/16","致和-東門",5,0,5
"11188","1340勝悅","110/08/16","兆豐-城中",0,2,-2
"11189","1340勝悅","110/08/16","群益金鼎-館前",7,2,5
"11190","1340勝悅","110/08/16","元大-大雅",0,2,-2
"11191","6246臺龍","110/08/16","元大-南投",25,5,20
"11192","6246臺龍","110/08/16","元大-中壢",9,26,-17
"11193","6246臺龍","110/08/16","港商野村",65,46,19
"11194","6246臺龍","110/08/16","台新-台中",1,15,-14
"11195","6246臺龍","110/08/16","華南永昌",23,5,18
"11196","6246臺龍","110/08/16","群益金鼎-開元",0,12,-12
"11197","6246臺龍","110/08/16","華南永昌-彰化",15,4,11
"11198","6246臺龍","110/08/16","凱基-苗栗",0,7,-7
"11199","6246臺龍","110/08/16","統一-台中",10,0,10
"11200","6246臺龍","110/08/16","日盛-鳳山",0,6,-6
"11201","6246臺龍","110/08/16","兆豐-新營",11,1,10
"11202","6246臺龍","110/08/16","台新證券",4,10,-6
"11203","6246臺龍","110/08/16","玉山-桃園",10,0,10
"11204","6246臺龍","110/08/16","新光",4,10,-6
"11205","6246臺龍","110/08/16","凱基-台北",12,2,10
"11206","6246臺龍","110/08/16","華南永昌-嘉義",0,6,-6
"11207","6246臺龍","110/08/16","群益金鼎-東大",9,0,9
"11208","6246臺龍","110/08/16","元大-竹北",0,6,-6
"11209","6246臺龍","110/08/16","元富-中港",6,0,6
"11210","6246臺龍","110/08/16","元大-永康",0,6,-6
"11211","6246臺龍","110/08/16","德信-新營",6,0,6
"11212","6246臺龍","110/08/16","元富-新店",0,5,-5
"11213","6246臺龍","110/08/16","兆豐-西螺",5,0,5
"11214","6246臺龍","110/08/16","台中銀",0,5,-5
"11215","6246臺龍","110/08/16","群益金鼎-土城",5,0,5
"11216","6246臺龍","110/08/16","群益金鼎-永和",0,5,-5
"11217","6246臺龍","110/08/16","富邦-仁愛",5,0,5
"11218","6246臺龍","110/08/16","元大-台南",0,5,-5
"11219","6246臺龍","110/08/16","元大-基隆孝二",7,2,5
"11220","6246臺龍","110/08/16","元大-土城",0,5,-5
"11221","00715L期街口布蘭特正2","110/08/16","元富",1720,5,1715
"11222","00715L期街口布蘭特正2","110/08/16","元大證券",365,4674,-4309
"11223","00715L期街口布蘭特正2","110/08/16","港商野村",1350,660,690
"11224","00715L期街口布蘭特正2","110/08/16","華南永昌-長虹",50,820,-770
"11225","00715L期街口布蘭特正2","110/08/16","(牛牛牛)亞-鑫豐",587,51,536
"11226","00715L期街口布蘭特正2","110/08/16","凱基-台北",42,470,-428
"11227","00715L期街口布蘭特正2","110/08/16","富邦-嘉義",405,0,405
"11228","00715L期街口布蘭特正2","110/08/16","永豐金證券",5,360,-355
"11229","00715L期街口布蘭特正2","110/08/16","兆豐-嘉義",303,0,303
"11230","00715L期街口布蘭特正2","110/08/16","元大-復北",1,333,-332
"11231","00715L期街口布蘭特正2","110/08/16","元大-學甲",272,0,272
"11232","00715L期街口布蘭特正2","110/08/16","兆豐-新莊",0,306,-306
"11233","00715L期街口布蘭特正2","110/08/16","元大-中和",308,52,256
"11234","00715L期街口布蘭特正2","110/08/16","凱基-松山",0,302,-302
"11235","00715L期街口布蘭特正2","110/08/16","新光",318,84,234
"11236","00715L期街口布蘭特正2","110/08/16","統一-桃園",7,280,-273
"11237","00715L期街口布蘭特正2","110/08/16","元大-北港",165,0,165
"11238","00715L期街口布蘭特正2","110/08/16","日盛-板橋",31,300,-269
"11239","00715L期街口布蘭特正2","110/08/16","台中銀",202,45,157
"11240","00715L期街口布蘭特正2","110/08/16","凱基",0,250,-250
"11241","00715L期街口布蘭特正2","110/08/16","元大-台中中港",157,0,157
"11242","00715L期街口布蘭特正2","110/08/16","富邦-仁愛",11,250,-239
"11243","00715L期街口布蘭特正2","110/08/16","元大-花蓮",150,4,146
"11244","00715L期街口布蘭特正2","110/08/16","台新-台中",34,262,-228
"11245","00715L期街口布蘭特正2","110/08/16","統一-台中",165,32,133
"11246","00715L期街口布蘭特正2","110/08/16","元富-吉利",5,210,-205
"11247","00715L期街口布蘭特正2","110/08/16","永全-南崁",130,0,130
"11248","00715L期街口布蘭特正2","110/08/16","康和",0,150,-150
"11249","00715L期街口布蘭特正2","110/08/16","元富-中壢",223,100,123
"11250","00715L期街口布蘭特正2","110/08/16","兆豐-台中港",53,190,-137
"11251","8941關中","110/08/16","凱基-市府",4,0,4
"11252","8941關中","110/08/16","統一-台中",0,3,-3
"11253","8941關中","110/08/16","(牛牛牛)亞-鑫豐",2,1,1
"11254","8941關中","110/08/16","宏遠-中和",0,1,-1
"11255","8941關中","110/08/16","富邦-左營",1,0,1
"11256","8941關中","110/08/16","富邦-竹北",0,1,-1
"11257","8941關中","110/08/16","元大-路竹",1,0,1
"11258","8941關中","110/08/16","元大-華山",0,1,-1
"11259","8941關中","110/08/16","統一-新台中",0,0,0
"11260","8941關中","110/08/16","永豐金-中正",0,1,-1
"11261","8941關中","110/08/16","元富-中港",0,0,0
"11262","8941關中","110/08/16","統一-新台中",0,0,0
"11263","8941關中","110/08/16","元大證券",0,0,0
"11264","8941關中","110/08/16","元富-中港",0,0,0
"11265","8941關中","110/08/16","元大-龍潭",0,0,0
"11266","8941關中","110/08/16","元大證券",0,0,0
"11267","8941關中","110/08/16","永豐金-南投",0,0,0
"11268","8941關中","110/08/16","元大-龍潭",0,0,0
"11269","8941關中","110/08/16","",NA,NA,NA
"11270","8941關中","110/08/16","永豐金-南投",0,0,0
"11271","8941關中","110/08/16","",NA,NA,NA
"11272","8941關中","110/08/16","",NA,NA,NA
"11273","8941關中","110/08/16","",NA,NA,NA
"11274","8941關中","110/08/16","",NA,NA,NA
"11275","8941關中","110/08/16","",NA,NA,NA
"11276","8941關中","110/08/16","",NA,NA,NA
"11277","8941關中","110/08/16","",NA,NA,NA
"11278","8941關中","110/08/16","",NA,NA,NA
"11279","8941關中","110/08/16","",NA,NA,NA
"11280","8941關中","110/08/16","",NA,NA,NA
"11281","8936國統","110/08/16","台中銀-高雄",200,0,200
"11282","8936國統","110/08/16","摩根大通",39,181,-142
"11283","8936國統","110/08/16","美林",139,31,108
"11284","8936國統","110/08/16","新加坡商瑞銀",48,178,-130
"11285","8936國統","110/08/16","元大-天母",50,0,50
"11286","8936國統","110/08/16","凱基-台北",66,161,-95
"11287","8936國統","110/08/16","中國信託",50,2,48
"11288","8936國統","110/08/16","新光-桃園",2,90,-88
"11289","8936國統","110/08/16","元大-豐原站前",40,0,40
"11290","8936國統","110/08/16","台灣摩根士丹利",1,79,-78
"11291","8936國統","110/08/16","元大-北港",32,0,32
"11292","8936國統","110/08/16","永豐金-苓雅",10,80,-70
"11293","8936國統","110/08/16","永豐金-竹科",28,0,28
"11294","8936國統","110/08/16","富邦-南屯",15,64,-49
"11295","8936國統","110/08/16","凱基-岡山",27,0,27
"11296","8936國統","110/08/16","台新-高雄",10,56,-46
"11297","8936國統","110/08/16","第一金-自由",20,0,20
"11298","8936國統","110/08/16","國票-北高雄",5,30,-25
"11299","8936國統","110/08/16","港商野村",68,50,18
"11300","8936國統","110/08/16","台新-屏東",0,25,-25
"11301","8936國統","110/08/16","華南永昌-岡山",16,0,16
"11302","8936國統","110/08/16","元大-高雄",0,23,-23
"11303","8936國統","110/08/16","新光-台中",59,44,15
"11304","8936國統","110/08/16","台灣企銀-豐原",0,22,-22
"11305","8936國統","110/08/16","日盛證券",14,0,14
"11306","8936國統","110/08/16","玉山證券",0,19,-19
"11307","8936國統","110/08/16","元富-林園",12,0,12
"11308","8936國統","110/08/16","日盛-中壢",0,16,-16
"11309","8936國統","110/08/16","兆豐-景美",12,0,12
"11310","8936國統","110/08/16","美商高盛",6,21,-15
"11311","6226光鼎","110/08/16","凱基-台北",1070,545,525
"11312","6226光鼎","110/08/16","台新證券",86,218,-132
"11313","6226光鼎","110/08/16","美林",291,133,158
"11314","6226光鼎","110/08/16","元富-新竹",10,139,-129
"11315","6226光鼎","110/08/16","瑞士信貸",144,6,138
"11316","6226光鼎","110/08/16","元大-台南",0,101,-101
"11317","6226光鼎","110/08/16","摩根大通",340,206,134
"11318","6226光鼎","110/08/16","永豐金-南投",1,100,-99
"11319","6226光鼎","110/08/16","美商高盛",222,102,120
"11320","6226光鼎","110/08/16","華南永昌-高雄",1,63,-62
"11321","6226光鼎","110/08/16","新光",195,77,118
"11322","6226光鼎","110/08/16","元大-仁愛",1,61,-60
"11323","6226光鼎","110/08/16","第一金-大稻埕",103,1,102
"11324","6226光鼎","110/08/16","群益金鼎-士林",39,98,-59
"11325","6226光鼎","110/08/16","元大-北投",101,4,97
"11326","6226光鼎","110/08/16","元大-府城",20,72,-52
"11327","6226光鼎","110/08/16","元大-竹科",101,10,91
"11328","6226光鼎","110/08/16","合庫-鳳山",4,53,-49
"11329","6226光鼎","110/08/16","元大-北屯",104,15,89
"11330","6226光鼎","110/08/16","國票-九鼎",2,44,-42
"11331","6226光鼎","110/08/16","國泰-桃園",98,29,69
"11332","6226光鼎","110/08/16","元大-金華",13,55,-42
"11333","6226光鼎","110/08/16","群益金鼎-東門",67,0,67
"11334","6226光鼎","110/08/16","富邦-竹東",5,43,-38
"11335","6226光鼎","110/08/16","港商野村",277,215,62
"11336","6226光鼎","110/08/16","元大-雙和",6,43,-37
"11337","6226光鼎","110/08/16","群益金鼎-西松",51,1,50
"11338","6226光鼎","110/08/16","中國信託-忠孝",2,36,-34
"11339","6226光鼎","110/08/16","元富-古亭",50,3,47
"11340","6226光鼎","110/08/16","華南永昌-三重",3,37,-34
"11341","2363矽統","110/08/16","凱基-台北",2187,1127,1060
"11342","2363矽統","110/08/16","元大-東泰",32,339,-307
"11343","2363矽統","110/08/16","美商高盛",1277,381,896
"11344","2363矽統","110/08/16","國泰-敦南",408,608,-200
"11345","2363矽統","110/08/16","美林",777,172,605
"11346","2363矽統","110/08/16","台灣摩根士丹利",6,185,-179
"11347","2363矽統","110/08/16","新加坡商瑞銀",764,476,288
"11348","2363矽統","110/08/16","群益金鼎",14,154,-140
"11349","2363矽統","110/08/16","永豐金-嘉義",250,2,248
"11350","2363矽統","110/08/16","富邦-新竹",103,229,-126
"11351","2363矽統","110/08/16","瑞士信貸",247,11,236
"11352","2363矽統","110/08/16","凱基",0,120,-120
"11353","2363矽統","110/08/16","群益金鼎-士林",173,17,156
"11354","2363矽統","110/08/16","元大-大統",25,138,-113
"11355","2363矽統","110/08/16","統一-新竹",151,2,149
"11356","2363矽統","110/08/16","富邦-中壢",17,125,-108
"11357","2363矽統","110/08/16","港商野村",1539,1409,130
"11358","2363矽統","110/08/16","兆豐-天母",1,102,-101
"11359","2363矽統","110/08/16","凱基-長庚",136,12,124
"11360","2363矽統","110/08/16","陽信-石牌",13,105,-92
"11361","2363矽統","110/08/16","台新-三民",156,49,107
"11362","2363矽統","110/08/16","永豐金-新店",8,100,-92
"11363","2363矽統","110/08/16","凱基-南崁",98,26,72
"11364","2363矽統","110/08/16","日盛-北高雄",25,105,-80
"11365","2363矽統","110/08/16","元富-城東",78,9,69
"11366","2363矽統","110/08/16","元大-萬華",36,116,-80
"11367","2363矽統","110/08/16","元大-汐止",144,79,65
"11368","2363矽統","110/08/16","玉山證券",37,116,-79
"11369","2363矽統","110/08/16","永豐金-中壢",91,28,63
"11370","2363矽統","110/08/16","元大-敦南",3,81,-78
"11371","8112至上","110/08/16","合庫證券",140,7,133
"11372","8112至上","110/08/16","摩根大通",19,588,-569
"11373","8112至上","110/08/16","新光-桃園",102,4,98
"11374","8112至上","110/08/16","新加坡商瑞銀",17,338,-321
"11375","8112至上","110/08/16","元大-敦化",80,2,78
"11376","8112至上","110/08/16","瑞士信貸",3,181,-178
"11377","8112至上","110/08/16","元大-台北",71,0,71
"11378","8112至上","110/08/16","美林",84,183,-99
"11379","8112至上","110/08/16","凱基-嘉義",97,37,60
"11380","8112至上","110/08/16","台灣摩根士丹利",9,101,-92
"11381","8112至上","110/08/16","元大-開元",44,1,43
"11382","8112至上","110/08/16","凱基-台北",133,201,-68
"11383","8112至上","110/08/16","永豐金-台中",43,0,43
"11384","8112至上","110/08/16","新光-高雄",3,57,-54
"11385","8112至上","110/08/16","元大-仁愛",40,0,40
"11386","8112至上","110/08/16","新百王",1,51,-50
"11387","8112至上","110/08/16","富邦-仁愛",65,27,38
"11388","8112至上","110/08/16","華南永昌-新莊",2,47,-45
"11389","8112至上","110/08/16","元大-前金",40,3,37
"11390","8112至上","110/08/16","華南永昌-潮州",0,30,-30
"11391","8112至上","110/08/16","富邦-中壢",33,1,32
"11392","8112至上","110/08/16","國票-長城",18,45,-27
"11393","8112至上","110/08/16","統一-中壢",31,0,31
"11394","8112至上","110/08/16","群益金鼎-海山",3,30,-27
"11395","8112至上","110/08/16","台新-台中",32,1,31
"11396","8112至上","110/08/16","元大-發財",1,28,-27
"11397","8112至上","110/08/16","新光",38,11,27
"11398","8112至上","110/08/16","兆豐-斗南",4,30,-26
"11399","8112至上","110/08/16","合庫-嘉義",25,0,25
"11400","8112至上","110/08/16","國泰-板橋",9,32,-23
"11401","1570力肯","110/08/16","兆豐-民生",80,0,80
"11402","1570力肯","110/08/16","台新證券",17,184,-167
"11403","1570力肯","110/08/16","國票-北高雄",145,85,60
"11404","1570力肯","110/08/16","凱基-台北",61,183,-122
"11405","1570力肯","110/08/16","新光",83,31,52
"11406","1570力肯","110/08/16","摩根大通",18,89,-71
"11407","1570力肯","110/08/16","凱基-三峽",40,0,40
"11408","1570力肯","110/08/16","新光-台南",1,50,-49
"11409","1570力肯","110/08/16","元大-大雅",40,0,40
"11410","1570力肯","110/08/16","國泰-松江",0,30,-30
"11411","1570力肯","110/08/16","元富-新竹",30,0,30
"11412","1570力肯","110/08/16","永豐金-桃園",0,30,-30
"11413","1570力肯","110/08/16","富邦-花蓮",29,0,29
"11414","1570力肯","110/08/16","元富-文心",1,23,-22
"11415","1570力肯","110/08/16","統一-高雄",26,1,25
"11416","1570力肯","110/08/16","永豐金-屏東",3,25,-22
"11417","1570力肯","110/08/16","元大-雙和",24,0,24
"11418","1570力肯","110/08/16","台灣摩根士丹利",0,18,-18
"11419","1570力肯","110/08/16","日盛-高雄",21,0,21
"11420","1570力肯","110/08/16","元富-新店",2,20,-18
"11421","1570力肯","110/08/16","國票-和平",27,6,21
"11422","1570力肯","110/08/16","康和-屏東",0,16,-16
"11423","1570力肯","110/08/16","國泰證券",20,0,20
"11424","1570力肯","110/08/16","聯邦-三重",0,15,-15
"11425","1570力肯","110/08/16","群益金鼎-東門",20,0,20
"11426","1570力肯","110/08/16","富邦-內湖",8,21,-13
"11427","1570力肯","110/08/16","元大-民生",19,0,19
"11428","1570力肯","110/08/16","新光-台中",8,20,-12
"11429","1570力肯","110/08/16","元富-民權",15,0,15
"11430","1570力肯","110/08/16","國泰-館前",0,12,-12
"11431","2929淘帝","110/08/16","日盛-中壢",55,1,54
"11432","2929淘帝","110/08/16","摩根大通",10,80,-70
"11433","2929淘帝","110/08/16","元大-太平",31,0,31
"11434","2929淘帝","110/08/16","港商野村",13,57,-44
"11435","2929淘帝","110/08/16","宏遠-館前",30,0,30
"11436","2929淘帝","110/08/16","元大-西門",0,37,-37
"11437","2929淘帝","110/08/16","凱基-東門",24,0,24
"11438","2929淘帝","110/08/16","新加坡商瑞銀",4,26,-22
"11439","2929淘帝","110/08/16","台新-台中",21,0,21
"11440","2929淘帝","110/08/16","元大-大里",0,22,-22
"11441","2929淘帝","110/08/16","日盛-八德",16,0,16
"11442","2929淘帝","110/08/16","兆豐-三重",0,20,-20
"11443","2929淘帝","110/08/16","元富-文心",10,0,10
"11444","2929淘帝","110/08/16","永豐金-鳳山",0,14,-14
"11445","2929淘帝","110/08/16","兆豐-桃園",10,0,10
"11446","2929淘帝","110/08/16","美林",6,17,-11
"11447","2929淘帝","110/08/16","群益金鼎-基隆",10,0,10
"11448","2929淘帝","110/08/16","臺銀-金山",0,10,-10
"11449","2929淘帝","110/08/16","永豐金證券",10,0,10
"11450","2929淘帝","110/08/16","國票-博愛",0,10,-10
"11451","2929淘帝","110/08/16","新光",10,2,8
"11452","2929淘帝","110/08/16","元大-上新莊",2,12,-10
"11453","2929淘帝","110/08/16","元大-承德",8,0,8
"11454","2929淘帝","110/08/16","兆豐-大同",0,9,-9
"11455","2929淘帝","110/08/16","亞東-新竹",7,0,7
"11456","2929淘帝","110/08/16","台新-建北",0,9,-9
"11457","2929淘帝","110/08/16","凱基-林口",7,0,7
"11458","2929淘帝","110/08/16","國泰-館前",0,7,-7
"11459","2929淘帝","110/08/16","凱基-新豐",6,0,6
"11460","2929淘帝","110/08/16","兆豐-台南",0,6,-6
"11461","5410國眾","110/08/16","兆豐-城中",85,0,85
"11462","5410國眾","110/08/16","國泰-敦南",15,99,-84
"11463","5410國眾","110/08/16","元大-六合",42,0,42
"11464","5410國眾","110/08/16","凱基-高雄",0,50,-50
"11465","5410國眾","110/08/16","兆豐-小港",36,0,36
"11466","5410國眾","110/08/16","瑞士信貸",0,44,-44
"11467","5410國眾","110/08/16","凱基-台南",30,0,30
"11468","5410國眾","110/08/16","摩根大通",46,87,-41
"11469","5410國眾","110/08/16","富邦-建國",31,1,30
"11470","5410國眾","110/08/16","元大-士林",0,38,-38
"11471","5410國眾","110/08/16","國票-安和",31,4,27
"11472","5410國眾","110/08/16","兆豐-台中港",0,30,-30
"11473","5410國眾","110/08/16","凱基-竹北",24,0,24
"11474","5410國眾","110/08/16","凱基-台北",27,55,-28
"11475","5410國眾","110/08/16","玉山-新莊",15,0,15
"11476","5410國眾","110/08/16","元大-古亭",0,26,-26
"11477","5410國眾","110/08/16","元大-木柵",12,0,12
"11478","5410國眾","110/08/16","臺銀",1,24,-23
"11479","5410國眾","110/08/16","元大-新盛",12,0,12
"11480","5410國眾","110/08/16","元大-中壢",3,26,-23
"11481","5410國眾","110/08/16","永豐金-台南",12,1,11
"11482","5410國眾","110/08/16","元大-北港",0,21,-21
"11483","5410國眾","110/08/16","合庫-桃園",10,0,10
"11484","5410國眾","110/08/16","元大-北投",0,20,-20
"11485","5410國眾","110/08/16","日盛-屏東",10,0,10
"11486","5410國眾","110/08/16","元富-潮州",0,15,-15
"11487","5410國眾","110/08/16","元富-城東",10,0,10
"11488","5410國眾","110/08/16","臺銀-鳳山",1,15,-14
"11489","5410國眾","110/08/16","富邦-陽明",10,0,10
"11490","5410國眾","110/08/16","元大-屏東",0,14,-14
"11491","2841台開","110/08/16","宏遠-館前",190,0,190
"11492","2841台開","110/08/16","港商野村",0,44,-44
"11493","2841台開","110/08/16","合庫證券",30,0,30
"11494","2841台開","110/08/16","新光-台南",0,33,-33
"11495","2841台開","110/08/16","凱基-竹科",20,0,20
"11496","2841台開","110/08/16","台新證券",10,42,-32
"11497","2841台開","110/08/16","永豐金-中盛",13,0,13
"11498","2841台開","110/08/16","元大-大里德芳",0,30,-30
"11499","2841台開","110/08/16","大慶-蘆洲",10,0,10
"11500","2841台開","110/08/16","合庫-台中",0,28,-28
"11501","2841台開","110/08/16","新光",13,3,10
"11502","2841台開","110/08/16","元大-善化",0,20,-20
"11503","2841台開","110/08/16","元大-新店中正",10,0,10
"11504","2841台開","110/08/16","永豐金-敦南",30,50,-20
"11505","2841台開","110/08/16","群益金鼎-崇德",8,0,8
"11506","2841台開","110/08/16","新加坡商瑞銀",0,16,-16
"11507","2841台開","110/08/16","元富-成功",7,0,7
"11508","2841台開","110/08/16","玉山-新莊",0,16,-16
"11509","2841台開","110/08/16","元大-彰化",7,0,7
"11510","2841台開","110/08/16","日盛-內湖",0,15,-15
"11511","2841台開","110/08/16","台中銀",5,0,5
"11512","2841台開","110/08/16","兆豐-民生",0,15,-15
"11513","2841台開","110/08/16","中國信託-文心",5,0,5
"11514","2841台開","110/08/16","華南永昌-高雄",0,15,-15
"11515","2841台開","110/08/16","兆豐-台中",5,0,5
"11516","2841台開","110/08/16","元大-永康",0,10,-10
"11517","2841台開","110/08/16","台新-新營",5,0,5
"11518","2841台開","110/08/16","元大-北三重",0,10,-10
"11519","2841台開","110/08/16","凱基-東港",10,5,5
"11520","2841台開","110/08/16","永豐金證券",0,10,-10
"11521","6207雷科","110/08/16","台新-高雄",131,3,128
"11522","6207雷科","110/08/16","元大-高雄",0,52,-52
"11523","6207雷科","110/08/16","凱基-台北",70,20,50
"11524","6207雷科","110/08/16","摩根大通",62,112,-50
"11525","6207雷科","110/08/16","元大-東門",42,0,42
"11526","6207雷科","110/08/16","華南永昌-三重",0,50,-50
"11527","6207雷科","110/08/16","永豐金證券",30,0,30
"11528","6207雷科","110/08/16","凱基-復興",0,40,-40
"11529","6207雷科","110/08/16","元大-六合",21,0,21
"11530","6207雷科","110/08/16","元大-潮州",0,40,-40
"11531","6207雷科","110/08/16","群益金鼎-東門",20,0,20
"11532","6207雷科","110/08/16","日盛證券",2,37,-35
"11533","6207雷科","110/08/16","元大-松江",20,0,20
"11534","6207雷科","110/08/16","新加坡商瑞銀",45,80,-35
"11535","6207雷科","110/08/16","大昌-桃園",28,10,18
"11536","6207雷科","110/08/16","玉山-士林",0,27,-27
"11537","6207雷科","110/08/16","統一-新竹",16,0,16
"11538","6207雷科","110/08/16","元大-大統",0,22,-22
"11539","6207雷科","110/08/16","台中銀",15,0,15
"11540","6207雷科","110/08/16","元大-民生",2,24,-22
"11541","6207雷科","110/08/16","中國信託-三重",13,0,13
"11542","6207雷科","110/08/16","凱基-高雄",6,27,-21
"11543","6207雷科","110/08/16","凱基-岡山",11,0,11
"11544","6207雷科","110/08/16","國票-北高雄",0,15,-15
"11545","6207雷科","110/08/16","富邦-中壢",11,0,11
"11546","6207雷科","110/08/16","新光",0,12,-12
"11547","6207雷科","110/08/16","港商野村",27,17,10
"11548","6207雷科","110/08/16","台新-左楠",1,12,-11
"11549","6207雷科","110/08/16","第一金-安和",10,0,10
"11550","6207雷科","110/08/16","新光-台南",0,10,-10
"11551","3679新至陞","110/08/16","凱基-台北",15,2,13
"11552","3679新至陞","110/08/16","摩根大通",7,19,-12
"11553","3679新至陞","110/08/16","台灣摩根士丹利",8,3,5
"11554","3679新至陞","110/08/16","瑞士信貸",0,11,-11
"11555","3679新至陞","110/08/16","國泰-桃園",5,0,5
"11556","3679新至陞","110/08/16","永豐金-苓雅",1,5,-4
"11557","3679新至陞","110/08/16","美商高盛",3,0,3
"11558","3679新至陞","110/08/16","國泰-松江",0,3,-3
"11559","3679新至陞","110/08/16","華南永昌",3,0,3
"11560","3679新至陞","110/08/16","凱基-台南",0,3,-3
"11561","3679新至陞","110/08/16","日盛-竹北",2,0,2
"11562","3679新至陞","110/08/16","彰銀",0,2,-2
"11563","3679新至陞","110/08/16","日盛-文化",3,1,2
"11564","3679新至陞","110/08/16","新加坡商瑞銀",0,2,-2
"11565","3679新至陞","110/08/16","大慶-蘆洲",3,1,2
"11566","3679新至陞","110/08/16","第一金-頭份",0,2,-2
"11567","3679新至陞","110/08/16","國票-九鼎",2,0,2
"11568","3679新至陞","110/08/16","康和-嘉義",0,2,-2
"11569","3679新至陞","110/08/16","華南永昌-高雄",2,0,2
"11570","3679新至陞","110/08/16","凱基-站前",0,2,-2
"11571","3679新至陞","110/08/16","元大-新店中正",2,0,2
"11572","3679新至陞","110/08/16","元大證券",0,2,-2
"11573","3679新至陞","110/08/16","土銀-士林",1,0,1
"11574","3679新至陞","110/08/16","元大-頭份",0,2,-2
"11575","3679新至陞","110/08/16","日盛證券",1,0,1
"11576","3679新至陞","110/08/16","元大-斗信",0,2,-2
"11577","3679新至陞","110/08/16","美林",10,9,1
"11578","3679新至陞","110/08/16","元大-嘉義",0,2,-2
"11579","3679新至陞","110/08/16","第一金-忠孝",1,0,1
"11580","3679新至陞","110/08/16","日盛-龍潭",0,1,-1
"11581","2727王品","110/08/16","瑞士信貸",49,0,49
"11582","2727王品","110/08/16","台新證券",4,162,-158
"11583","2727王品","110/08/16","台灣摩根士丹利",33,3,30
"11584","2727王品","110/08/16","臺銀-鳳山",5,81,-76
"11585","2727王品","110/08/16","新光",37,12,25
"11586","2727王品","110/08/16","玉山-台南",2,33,-31
"11587","2727王品","110/08/16","日盛-忠孝",20,0,20
"11588","2727王品","110/08/16","美商高盛",0,23,-23
"11589","2727王品","110/08/16","元大-東蘆",16,1,15
"11590","2727王品","110/08/16","兆豐-南京",0,20,-20
"11591","2727王品","110/08/16","第一金-台中",15,1,14
"11592","2727王品","110/08/16","凱基-虎尾",0,20,-20
"11593","2727王品","110/08/16","國泰-敦南",29,15,14
"11594","2727王品","110/08/16","中國信託",2,20,-18
"11595","2727王品","110/08/16","第一金-桃園",13,0,13
"11596","2727王品","110/08/16","新光-桃園",2,20,-18
"11597","2727王品","110/08/16","第一金-忠孝",13,1,12
"11598","2727王品","110/08/16","永豐金證券",2,20,-18
"11599","2727王品","110/08/16","摩根大通",24,12,12
"11600","2727王品","110/08/16","統一",6,22,-16
"11601","2727王品","110/08/16","富邦-陽明",15,3,12
"11602","2727王品","110/08/16","合庫證券",2,14,-12
"11603","2727王品","110/08/16","元富-西松",13,2,11
"11604","2727王品","110/08/16","富邦-仁愛",7,19,-12
"11605","2727王品","110/08/16","聯邦-興中",11,0,11
"11606","2727王品","110/08/16","元大-竹科",4,16,-12
"11607","2727王品","110/08/16","中國信託-松江",10,0,10
"11608","2727王品","110/08/16","元大-和平",0,12,-12
"11609","2727王品","110/08/16","凱基-市府",10,0,10
"11610","2727王品","110/08/16","凱基-興隆",1,12,-11
"11611","1570力肯","110/08/16","兆豐-民生",80,0,80
"11612","1570力肯","110/08/16","台新證券",17,184,-167
"11613","1570力肯","110/08/16","國票-北高雄",145,85,60
"11614","1570力肯","110/08/16","凱基-台北",61,183,-122
"11615","1570力肯","110/08/16","新光",83,31,52
"11616","1570力肯","110/08/16","摩根大通",18,89,-71
"11617","1570力肯","110/08/16","凱基-三峽",40,0,40
"11618","1570力肯","110/08/16","新光-台南",1,50,-49
"11619","1570力肯","110/08/16","元大-大雅",40,0,40
"11620","1570力肯","110/08/16","國泰-松江",0,30,-30
"11621","1570力肯","110/08/16","元富-新竹",30,0,30
"11622","1570力肯","110/08/16","永豐金-桃園",0,30,-30
"11623","1570力肯","110/08/16","富邦-花蓮",29,0,29
"11624","1570力肯","110/08/16","元富-文心",1,23,-22
"11625","1570力肯","110/08/16","統一-高雄",26,1,25
"11626","1570力肯","110/08/16","永豐金-屏東",3,25,-22
"11627","1570力肯","110/08/16","元大-雙和",24,0,24
"11628","1570力肯","110/08/16","台灣摩根士丹利",0,18,-18
"11629","1570力肯","110/08/16","日盛-高雄",21,0,21
"11630","1570力肯","110/08/16","元富-新店",2,20,-18
"11631","1570力肯","110/08/16","國票-和平",27,6,21
"11632","1570力肯","110/08/16","康和-屏東",0,16,-16
"11633","1570力肯","110/08/16","國泰證券",20,0,20
"11634","1570力肯","110/08/16","聯邦-三重",0,15,-15
"11635","1570力肯","110/08/16","群益金鼎-東門",20,0,20
"11636","1570力肯","110/08/16","富邦-內湖",8,21,-13
"11637","1570力肯","110/08/16","元大-民生",19,0,19
"11638","1570力肯","110/08/16","新光-台中",8,20,-12
"11639","1570力肯","110/08/16","元富-民權",15,0,15
"11640","1570力肯","110/08/16","國泰-館前",0,12,-12
"11641","6180橘子","110/08/16","美林",85,0,85
"11642","6180橘子","110/08/16","合庫-高雄",2,121,-119
"11643","6180橘子","110/08/16","新加坡商瑞銀",42,8,34
"11644","6180橘子","110/08/16","群益金鼎-三民",0,100,-100
"11645","6180橘子","110/08/16","合庫-自強",30,0,30
"11646","6180橘子","110/08/16","台灣摩根士丹利",0,50,-50
"11647","6180橘子","110/08/16","元大-中壢",23,0,23
"11648","6180橘子","110/08/16","統一",0,30,-30
"11649","6180橘子","110/08/16","新光-桃園",24,2,22
"11650","6180橘子","110/08/16","凱基-台北",0,27,-27
"11651","6180橘子","110/08/16","日盛-板橋",20,0,20
"11652","6180橘子","110/08/16","群益金鼎-大安",0,20,-20
"11653","6180橘子","110/08/16","康和-嘉義",19,0,19
"11654","6180橘子","110/08/16","元大-博愛",1,20,-19
"11655","6180橘子","110/08/16","永豐金-敦北",19,1,18
"11656","6180橘子","110/08/16","元大-文心興安",2,20,-18
"11657","6180橘子","110/08/16","元大-四維",16,0,16
"11658","6180橘子","110/08/16","統一-中壢",0,15,-15
"11659","6180橘子","110/08/16","元大-和平",16,0,16
"11660","6180橘子","110/08/16","元富-宜蘭",2,15,-13
"11661","6180橘子","110/08/16","港商野村",27,12,15
"11662","6180橘子","110/08/16","元大-沙鹿",0,12,-12
"11663","6180橘子","110/08/16","富隆-長安",15,0,15
"11664","6180橘子","110/08/16","元大-清水",0,12,-12
"11665","6180橘子","110/08/16","摩根大通",51,36,15
"11666","6180橘子","110/08/16","臺銀-鳳山",3,14,-11
"11667","6180橘子","110/08/16","美商高盛",15,1,14
"11668","6180橘子","110/08/16","盈溢",0,10,-10
"11669","6180橘子","110/08/16","元大-永和",13,0,13
"11670","6180橘子","110/08/16","元富-世貿",0,10,-10
"11671","2390云辰","110/08/16","富邦-虎尾",514,48,466
"11672","2390云辰","110/08/16","凱基-台北",495,1222,-727
"11673","2390云辰","110/08/16","摩根大通",2747,2369,378
"11674","2390云辰","110/08/16","元富-西松",194,423,-229
"11675","2390云辰","110/08/16","國泰-桃園",291,66,225
"11676","2390云辰","110/08/16","國票-安和",121,349,-228
"11677","2390云辰","110/08/16","元大-木柵",237,23,214
"11678","2390云辰","110/08/16","元大-信義",10,155,-145
"11679","2390云辰","110/08/16","新光",859,695,164
"11680","2390云辰","110/08/16","統一-新台中",6,137,-131
"11681","2390云辰","110/08/16","元大證券",229,67,162
"11682","2390云辰","110/08/16","美林",355,470,-115
"11683","2390云辰","110/08/16","兆豐-埔墘",719,573,146
"11684","2390云辰","110/08/16","台新-高雄",113,208,-95
"11685","2390云辰","110/08/16","永豐金-嘉義",144,20,124
"11686","2390云辰","110/08/16","豐農",37,114,-77
"11687","2390云辰","110/08/16","元大-台中",126,26,100
"11688","2390云辰","110/08/16","國泰-忠孝",15,85,-70
"11689","2390云辰","110/08/16","瑞士信貸",124,28,96
"11690","2390云辰","110/08/16","富邦-北港",154,223,-69
"11691","2390云辰","110/08/16","永豐金-古亭",120,24,96
"11692","2390云辰","110/08/16","凱基-科園",11,79,-68
"11693","2390云辰","110/08/16","富邦-嘉義",2108,2013,95
"11694","2390云辰","110/08/16","華南永昌-台中",82,149,-67
"11695","2390云辰","110/08/16","富邦-內湖",120,26,94
"11696","2390云辰","110/08/16","台新-左楠",61,126,-65
"11697","2390云辰","110/08/16","群益金鼎-三重",142,56,86
"11698","2390云辰","110/08/16","元大-林園",3,67,-64
"11699","2390云辰","110/08/16","元大-前金",200,123,77
"11700","2390云辰","110/08/16","永豐金-萬盛",23,84,-61
"11701","2867三商壽","110/08/13","美商高盛",295,16,279
"11702","2867三商壽","110/08/13","摩根大通",109,286,-177
"11703","2867三商壽","110/08/13","大慶-中壢",183,1,182
"11704","2867三商壽","110/08/13","元大-佳里",0,113,-113
"11705","2867三商壽","110/08/13","新加坡商瑞銀",121,0,121
"11706","2867三商壽","110/08/13","元大-崇德",0,103,-103
"11707","2867三商壽","110/08/13","凱基-五股",100,0,100
"11708","2867三商壽","110/08/13","台灣摩根士丹利",9,83,-74
"11709","2867三商壽","110/08/13","元大-桃園",100,1,99
"11710","2867三商壽","110/08/13","國泰-台南",1,73,-72
"11711","2867三商壽","110/08/13","凱基-虎尾",90,0,90
"11712","2867三商壽","110/08/13","元大證券",1,62,-61
"11713","2867三商壽","110/08/13","華南永昌-高雄",100,10,90
"11714","2867三商壽","110/08/13","元大-台中",0,60,-60
"11715","2867三商壽","110/08/13","兆豐-北高雄",81,2,79
"11716","2867三商壽","110/08/13","元大-大同",0,53,-53
"11717","2867三商壽","110/08/13","新光",105,39,66
"11718","2867三商壽","110/08/13","兆豐-鹿港",0,50,-50
"11719","2867三商壽","110/08/13","富邦-彰化",60,0,60
"11720","2867三商壽","110/08/13","合庫-西台中",2,50,-48
"11721","2867三商壽","110/08/13","富邦-台南",60,0,60
"11722","2867三商壽","110/08/13","新光-台中",7,53,-46
"11723","2867三商壽","110/08/13","玉山-板橋",60,1,59
"11724","2867三商壽","110/08/13","元大-大益",0,44,-44
"11725","2867三商壽","110/08/13","群益金鼎-新竹",56,0,56
"11726","2867三商壽","110/08/13","亞東-板橋",0,36,-36
"11727","2867三商壽","110/08/13","元大-大統",53,0,53
"11728","2867三商壽","110/08/13","福邦證券",0,34,-34
"11729","2867三商壽","110/08/13","瑞士信貸",55,3,52
"11730","2867三商壽","110/08/13","元大-博愛",16,50,-34
"11731","5521工信","110/08/13","日進",100,0,100
"11732","5521工信","110/08/13","美林",1,87,-86
"11733","5521工信","110/08/13","摩根大通",180,102,78
"11734","5521工信","110/08/13","日盛-復興",1,70,-69
"11735","5521工信","110/08/13","元大-鳳山",30,0,30
"11736","5521工信","110/08/13","永豐金-鳳山",1,60,-59
"11737","5521工信","110/08/13","(牛牛牛)亞-鑫豐",28,2,26
"11738","5521工信","110/08/13","中國信託-三重",0,52,-52
"11739","5521工信","110/08/13","新光",24,0,24
"11740","5521工信","110/08/13","華南永昌-民權",0,50,-50
"11741","5521工信","110/08/13","華南永昌-彰化",21,0,21
"11742","5521工信","110/08/13","第一金-新竹",0,34,-34
"11743","5521工信","110/08/13","台灣企銀-建成",20,0,20
"11744","5521工信","110/08/13","凱基-台北",18,49,-31
"11745","5521工信","110/08/13","大昌",20,0,20
"11746","5521工信","110/08/13","元大-新莊",10,38,-28
"11747","5521工信","110/08/13","兆豐-中壢",20,0,20
"11748","5521工信","110/08/13","台灣摩根士丹利",2,28,-26
"11749","5521工信","110/08/13","國票-和平",20,0,20
"11750","5521工信","110/08/13","華南永昌",0,23,-23
"11751","5521工信","110/08/13","元大-基隆孝二",20,0,20
"11752","5521工信","110/08/13","統一-板橋",0,20,-20
"11753","5521工信","110/08/13","日盛-中和",19,0,19
"11754","5521工信","110/08/13","港商法國興業",0,17,-17
"11755","5521工信","110/08/13","兆豐-小港",19,0,19
"11756","5521工信","110/08/13","元大-府城",0,16,-16
"11757","5521工信","110/08/13","富邦-高雄",17,0,17
"11758","5521工信","110/08/13","元大-敦化",0,16,-16
"11759","5521工信","110/08/13","統一-員林",15,0,15
"11760","5521工信","110/08/13","新光-新竹",5,20,-15
"11761","1471首利","110/08/13","聯邦-高雄",42,0,42
"11762","1471首利","110/08/13","摩根大通",41,220,-179
"11763","1471首利","110/08/13","元大-西門",40,0,40
"11764","1471首利","110/08/13","元大-敦化",0,100,-100
"11765","1471首利","110/08/13","元大-大灣",37,0,37
"11766","1471首利","110/08/13","美林",0,69,-69
"11767","1471首利","110/08/13","第一金-台南",30,0,30
"11768","1471首利","110/08/13","瑞士信貸",5,65,-60
"11769","1471首利","110/08/13","元富-大昌",25,0,25
"11770","1471首利","110/08/13","美商高盛",0,51,-51
"11771","1471首利","110/08/13","大慶-中壢",20,0,20
"11772","1471首利","110/08/13","華南永昌-苗栗",5,30,-25
"11773","1471首利","110/08/13","凱基-台南",20,0,20
"11774","1471首利","110/08/13","玉山-台南",0,22,-22
"11775","1471首利","110/08/13","新光",19,0,19
"11776","1471首利","110/08/13","元富-民權",0,20,-20
"11777","1471首利","110/08/13","凱基-羅東",17,0,17
"11778","1471首利","110/08/13","中國信託",0,20,-20
"11779","1471首利","110/08/13","永豐金-台南",20,4,16
"11780","1471首利","110/08/13","凱基-五股",0,20,-20
"11781","1471首利","110/08/13","元大-屏東",14,0,14
"11782","1471首利","110/08/13","台灣摩根士丹利",0,17,-17
"11783","1471首利","110/08/13","新光-台中",16,4,12
"11784","1471首利","110/08/13","兆豐-員林",2,15,-13
"11785","1471首利","110/08/13","元大-頭份",12,0,12
"11786","1471首利","110/08/13","日盛-宜蘭",0,10,-10
"11787","1471首利","110/08/13","凱基-三重",11,0,11
"11788","1471首利","110/08/13","元富-緯城",1,10,-9
"11789","1471首利","110/08/13","日盛-鳳山",10,0,10
"11790","1471首利","110/08/13","國泰-台中",2,8,-6
"11791","2883開發金","110/08/13","凱基-台北",23196,4416,18780
"11792","2883開發金","110/08/13","永豐金-彰化",79,4793,-4714
"11793","2883開發金","110/08/13","摩根大通",24818,6057,18761
"11794","2883開發金","110/08/13","第一金-忠孝",55,4613,-4558
"11795","2883開發金","110/08/13","新加坡商瑞銀",6645,205,6440
"11796","2883開發金","110/08/13","台新證券",1316,5539,-4223
"11797","2883開發金","110/08/13","中國信託-文心",4723,123,4600
"11798","2883開發金","110/08/13","日盛證券",587,3754,-3167
"11799","2883開發金","110/08/13","美林",6276,1780,4496
"11800","2883開發金","110/08/13","群益金鼎-大甲",48,2429,-2381
"11801","2883開發金","110/08/13","國泰證券",3682,17,3665
"11802","2883開發金","110/08/13","永豐金證券",169,1849,-1680
"11803","2883開發金","110/08/13","台灣摩根士丹利",3927,582,3345
"11804","2883開發金","110/08/13","華南永昌-南京",169,1407,-1238
"11805","2883開發金","110/08/13","群益金鼎",2401,367,2034
"11806","2883開發金","110/08/13","凱基-台東",270,1494,-1224
"11807","2883開發金","110/08/13","香港上海匯豐",2006,0,2006
"11808","2883開發金","110/08/13","日盛-板橋",207,1398,-1191
"11809","2883開發金","110/08/13","兆豐證券",1776,128,1648
"11810","2883開發金","110/08/13","元大-萬華",78,1243,-1165
"11811","2883開發金","110/08/13","瑞士信貸",3551,2174,1377
"11812","2883開發金","110/08/13","富邦-台北",295,1428,-1133
"11813","2883開發金","110/08/13","港商野村",7299,6088,1211
"11814","2883開發金","110/08/13","元大-成功",216,1287,-1071
"11815","2883開發金","110/08/13","美商高盛",1016,0,1016
"11816","2883開發金","110/08/13","新光-台中",485,1519,-1034
"11817","2883開發金","110/08/13","元大-大灣",1183,214,969
"11818","2883開發金","110/08/13","國票",232,1261,-1029
"11819","2883開發金","110/08/13","花旗環球",1104,284,820
"11820","2883開發金","110/08/13","永豐金-桃園",141,1157,-1016
"11821","6205詮欣","110/08/13","合庫-三重",15,0,15
"11822","6205詮欣","110/08/13","摩根大通",3,17,-14
"11823","6205詮欣","110/08/13","港商法國興業",11,0,11
"11824","6205詮欣","110/08/13","元大-善化",0,10,-10
"11825","6205詮欣","110/08/13","臺銀-民權",7,0,7
"11826","6205詮欣","110/08/13","元大-台中中港",0,3,-3
"11827","6205詮欣","110/08/13","日盛-三重",5,0,5
"11828","6205詮欣","110/08/13","合庫-鳳山",0,2,-2
"11829","6205詮欣","110/08/13","群益金鼎-屏東",5,0,5
"11830","6205詮欣","110/08/13","元富-潮州",0,2,-2
"11831","6205詮欣","110/08/13","德信-新營",3,0,3
"11832","6205詮欣","110/08/13","兆豐-桃鶯",0,2,-2
"11833","6205詮欣","110/08/13","美林",2,0,2
"11834","6205詮欣","110/08/13","致和-台北",0,2,-2
"11835","6205詮欣","110/08/13","兆豐-西螺",1,0,1
"11836","6205詮欣","110/08/13","華南永昌-三重",0,2,-2
"11837","6205詮欣","110/08/13","新光-台中",1,0,1
"11838","6205詮欣","110/08/13","土銀-台中",0,1,-1
"11839","6205詮欣","110/08/13","聯邦-嘉義",1,0,1
"11840","6205詮欣","110/08/13","日盛-中壢",0,1,-1
"11841","6205詮欣","110/08/13","玉山-南京東路",1,0,1
"11842","6205詮欣","110/08/13","美商高盛",0,1,-1
"11843","6205詮欣","110/08/13","群益金鼎-中港",1,0,1
"11844","6205詮欣","110/08/13","大展-台南",0,1,-1
"11845","6205詮欣","110/08/13","凱基-大安",1,0,1
"11846","6205詮欣","110/08/13","第一金-彰化",0,1,-1
"11847","6205詮欣","110/08/13","元大-仁愛",1,0,1
"11848","6205詮欣","110/08/13","統一-三重",1,2,-1
"11849","6205詮欣","110/08/13","元大-台南",1,0,1
"11850","6205詮欣","110/08/13","元富-桃園",0,1,-1
"11851","1540喬福","110/08/13","元富-中原",100,0,100
"11852","1540喬福","110/08/13","日盛-文化",0,48,-48
"11853","1540喬福","110/08/13","台新-台中",31,0,31
"11854","1540喬福","110/08/13","凱基-台北",0,33,-33
"11855","1540喬福","110/08/13","兆豐-北高雄",18,0,18
"11856","1540喬福","110/08/13","元大-大安",0,32,-32
"11857","1540喬福","110/08/13","元大-土城永寧",11,0,11
"11858","1540喬福","110/08/13","合庫-台中",2,23,-21
"11859","1540喬福","110/08/13","(牛牛牛)亞-鑫豐",10,0,10
"11860","1540喬福","110/08/13","華南永昌-楠梓",0,20,-20
"11861","1540喬福","110/08/13","凱基-中壢",7,0,7
"11862","1540喬福","110/08/13","群益金鼎-館前",1,20,-19
"11863","1540喬福","110/08/13","安泰",5,0,5
"11864","1540喬福","110/08/13","富邦-花蓮",0,15,-15
"11865","1540喬福","110/08/13","群益金鼎-古亭",5,0,5
"11866","1540喬福","110/08/13","日盛-景美",0,10,-10
"11867","1540喬福","110/08/13","元富-緯城",4,0,4
"11868","1540喬福","110/08/13","台新-高雄",0,9,-9
"11869","1540喬福","110/08/13","兆豐-南京",4,0,4
"11870","1540喬福","110/08/13","玉山-大里",0,8,-8
"11871","1540喬福","110/08/13","凱基-台中",4,0,4
"11872","1540喬福","110/08/13","元大-斗信",0,8,-8
"11873","1540喬福","110/08/13","凱基-台南",5,1,4
"11874","1540喬福","110/08/13","新光-台南",0,6,-6
"11875","1540喬福","110/08/13","元大-龍潭",4,0,4
"11876","1540喬福","110/08/13","兆豐-板橋",0,5,-5
"11877","1540喬福","110/08/13","兆豐-高雄",3,0,3
"11878","1540喬福","110/08/13","富邦-彰化",0,5,-5
"11879","1540喬福","110/08/13","兆豐-鹿港",3,0,3
"11880","1540喬福","110/08/13","美林",0,4,-4
"11881","2888新光金","110/08/13","永豐金-天母",2112,0,2112
"11882","2888新光金","110/08/13","摩根大通",308,3587,-3279
"11883","2888新光金","110/08/13","合庫-西台中",2116,5,2111
"11884","2888新光金","110/08/13","玉山-嘉義",7,1514,-1507
"11885","2888新光金","110/08/13","統一-新竹",1706,0,1706
"11886","2888新光金","110/08/13","國票-台東",0,1500,-1500
"11887","2888新光金","110/08/13","凱基-台北",3076,1640,1436
"11888","2888新光金","110/08/13","台灣摩根士丹利",127,1148,-1021
"11889","2888新光金","110/08/13","元大證券",1418,10,1408
"11890","2888新光金","110/08/13","華南永昌-岡山",62,930,-868
"11891","2888新光金","110/08/13","康和",761,2,759
"11892","2888新光金","110/08/13","港商野村",47,827,-780
"11893","2888新光金","110/08/13","富邦-仁愛",739,52,687
"11894","2888新光金","110/08/13","美商高盛",697,1236,-539
"11895","2888新光金","110/08/13","新加坡商瑞銀",716,121,595
"11896","2888新光金","110/08/13","日盛-八德",88,572,-484
"11897","2888新光金","110/08/13","富邦-彰化",588,12,576
"11898","2888新光金","110/08/13","群益金鼎-三重",1,437,-436
"11899","2888新光金","110/08/13","玉山證券",558,12,546
"11900","2888新光金","110/08/13","永豐金-嘉義",52,472,-420
"11901","2888新光金","110/08/13","群益金鼎-瑞豐",550,10,540
"11902","2888新光金","110/08/13","元富-城東",7,390,-383
"11903","2888新光金","110/08/13","元大-三重",523,0,523
"11904","2888新光金","110/08/13","群益金鼎-高雄",6,387,-381
"11905","2888新光金","110/08/13","永豐金-博愛",420,27,393
"11906","2888新光金","110/08/13","凱基-宜蘭",9,379,-370
"11907","2888新光金","110/08/13","第一金-豐原",364,20,344
"11908","2888新光金","110/08/13","美林",938,1287,-349
"11909","2888新光金","110/08/13","國票-九鼎",317,3,314
"11910","2888新光金","110/08/13","華南永昌-台中",0,329,-329
"11911","1340勝悅","110/08/13","元富-成功",72,0,72
"11912","1340勝悅","110/08/13","元大-忠孝",0,36,-36
"11913","1340勝悅","110/08/13","元大-博愛",10,0,10
"11914","1340勝悅","110/08/13","新光",4,21,-17
"11915","1340勝悅","110/08/13","臺灣企銀-埔墘",5,0,5
"11916","1340勝悅","110/08/13","摩根大通",3,19,-16
"11917","1340勝悅","110/08/13","元大-新莊",5,0,5
"11918","1340勝悅","110/08/13","群益金鼎-三重",0,15,-15
"11919","1340勝悅","110/08/13","美商高盛",4,0,4
"11920","1340勝悅","110/08/13","日盛-永康",0,10,-10
"11921","1340勝悅","110/08/13","國泰-敦南",6,2,4
"11922","1340勝悅","110/08/13","華南永昌-合泰",0,10,-10
"11923","1340勝悅","110/08/13","統一-城中",6,3,3
"11924","1340勝悅","110/08/13","日盛-木柵",0,8,-8
"11925","1340勝悅","110/08/13","元富-新店",3,0,3
"11926","1340勝悅","110/08/13","港商法國興業",0,6,-6
"11927","1340勝悅","110/08/13","玉山-士林",3,0,3
"11928","1340勝悅","110/08/13","群益金鼎-中港",0,5,-5
"11929","1340勝悅","110/08/13","群益金鼎-館前",4,1,3
"11930","1340勝悅","110/08/13","第一金-自由",0,4,-4
"11931","1340勝悅","110/08/13","元富-安南",2,0,2
"11932","1340勝悅","110/08/13","兆豐-新營",0,4,-4
"11933","1340勝悅","110/08/13","大昌-樹林",2,0,2
"11934","1340勝悅","110/08/13","國泰-台中",1,5,-4
"11935","1340勝悅","110/08/13","群益金鼎",2,0,2
"11936","1340勝悅","110/08/13","元大-林園",0,4,-4
"11937","1340勝悅","110/08/13","群益金鼎-北高雄",2,0,2
"11938","1340勝悅","110/08/13","元大-四維",0,4,-4
"11939","1340勝悅","110/08/13","華南永昌",2,0,2
"11940","1340勝悅","110/08/13","美林",0,2,-2
"11941","6246臺龍","110/08/13","華南永昌-彰化",31,0,31
"11942","6246臺龍","110/08/13","永豐金-內湖",0,95,-95
"11943","6246臺龍","110/08/13","合庫-台中",23,0,23
"11944","6246臺龍","110/08/13","玉山-大里",0,21,-21
"11945","6246臺龍","110/08/13","兆豐-忠孝",24,3,21
"11946","6246臺龍","110/08/13","新光-新竹",0,20,-20
"11947","6246臺龍","110/08/13","元大-台北",16,0,16
"11948","6246臺龍","110/08/13","台新-台中",1,19,-18
"11949","6246臺龍","110/08/13","元大-新莊",11,1,10
"11950","6246臺龍","110/08/13","光和",2,17,-15
"11951","6246臺龍","110/08/13","德信-新營",9,0,9
"11952","6246臺龍","110/08/13","日盛-高雄",0,10,-10
"11953","6246臺龍","110/08/13","凱基-永和",9,0,9
"11954","6246臺龍","110/08/13","元富-世貿",0,10,-10
"11955","6246臺龍","110/08/13","港商野村",20,12,8
"11956","6246臺龍","110/08/13","(牛牛牛)亞-鑫豐",1,11,-10
"11957","6246臺龍","110/08/13","富邦-建國",8,0,8
"11958","6246臺龍","110/08/13","國泰-敦南",6,16,-10
"11959","6246臺龍","110/08/13","群益金鼎-開元",12,5,7
"11960","6246臺龍","110/08/13","永豐金-市政",1,10,-9
"11961","6246臺龍","110/08/13","群益金鼎-古亭",7,0,7
"11962","6246臺龍","110/08/13","華南永昌-嘉義",0,8,-8
"11963","6246臺龍","110/08/13","凱基-高美館",7,0,7
"11964","6246臺龍","110/08/13","富邦-敦南",4,11,-7
"11965","6246臺龍","110/08/13","元大-東蘆",10,3,7
"11966","6246臺龍","110/08/13","第一金-彰化",6,12,-6
"11967","6246臺龍","110/08/13","元大-金華",8,1,7
"11968","6246臺龍","110/08/13","新光-桃園",2,8,-6
"11969","6246臺龍","110/08/13","永豐金-松山",7,0,7
"11970","6246臺龍","110/08/13","凱基-竹科",0,6,-6
"11971","00715L期街口布蘭特正2","110/08/13","元大證券",6162,789,5373
"11972","00715L期街口布蘭特正2","110/08/13","元大-四維",2,1000,-998
"11973","00715L期街口布蘭特正2","110/08/13","元富",1528,0,1528
"11974","00715L期街口布蘭特正2","110/08/13","玉山-嘉義",20,1016,-996
"11975","00715L期街口布蘭特正2","110/08/13","合庫證券",1153,0,1153
"11976","00715L期街口布蘭特正2","110/08/13","群益金鼎-古亭",0,666,-666
"11977","00715L期街口布蘭特正2","110/08/13","富邦證券",1029,290,739
"11978","00715L期街口布蘭特正2","110/08/13","富邦-員林",9,489,-480
"11979","00715L期街口布蘭特正2","110/08/13","台新-台中",284,9,275
"11980","00715L期街口布蘭特正2","110/08/13","元大-嘉義",1,400,-399
"11981","00715L期街口布蘭特正2","110/08/13","兆豐-台中",238,0,238
"11982","00715L期街口布蘭特正2","110/08/13","臺銀-新竹",2,360,-358
"11983","00715L期街口布蘭特正2","110/08/13","統一-桃園",283,80,203
"11984","00715L期街口布蘭特正2","110/08/13","日盛-二林",0,300,-300
"11985","00715L期街口布蘭特正2","110/08/13","群益金鼎-屏東",200,0,200
"11986","00715L期街口布蘭特正2","110/08/13","群益金鼎-延平",100,400,-300
"11987","00715L期街口布蘭特正2","110/08/13","元富-虎尾",172,0,172
"11988","00715L期街口布蘭特正2","110/08/13","元大-中和",175,450,-275
"11989","00715L期街口布蘭特正2","110/08/13","凱基-五股",163,0,163
"11990","00715L期街口布蘭特正2","110/08/13","第一金-彰化",5,230,-225
"11991","00715L期街口布蘭特正2","110/08/13","國泰-台南",155,19,136
"11992","00715L期街口布蘭特正2","110/08/13","元大-大里",16,225,-209
"11993","00715L期街口布蘭特正2","110/08/13","永豐金證券",482,350,132
"11994","00715L期街口布蘭特正2","110/08/13","港商野村",7,212,-205
"11995","00715L期街口布蘭特正2","110/08/13","元大-內湖",110,0,110
"11996","00715L期街口布蘭特正2","110/08/13","合庫-新竹",1,199,-198
"11997","00715L期街口布蘭特正2","110/08/13","兆豐-嘉義",103,0,103
"11998","00715L期街口布蘭特正2","110/08/13","高橋",9,205,-196
"11999","00715L期街口布蘭特正2","110/08/13","群益金鼎-土城",100,0,100
"12000","00715L期街口布蘭特正2","110/08/13","國泰-敦南",78,271,-193
"12001","8941關中","110/08/13","宏遠-館前",3,0,3
"12002","8941關中","110/08/13","日盛-信義",0,2,-2
"12003","8941關中","110/08/13","國泰-忠孝",1,0,1
"12004","8941關中","110/08/13","宏遠-中和",0,1,-1
"12005","8941關中","110/08/13","康和-板橋",0,0,0
"12006","8941關中","110/08/13","康和-嘉義",0,1,-1
"12007","8941關中","110/08/13","富邦-左營",0,0,0
"12008","8941關中","110/08/13","康和-板橋",0,0,0
"12009","8941關中","110/08/13","元大-松江",0,0,0
"12010","8941關中","110/08/13","富邦-左營",0,0,0
"12011","8941關中","110/08/13","元大-淡水",0,0,0
"12012","8941關中","110/08/13","元大-松江",0,0,0
"12013","8941關中","110/08/13","",NA,NA,NA
"12014","8941關中","110/08/13","元大-淡水",0,0,0
"12015","8941關中","110/08/13","",NA,NA,NA
"12016","8941關中","110/08/13","",NA,NA,NA
"12017","8941關中","110/08/13","",NA,NA,NA
"12018","8941關中","110/08/13","",NA,NA,NA
"12019","8941關中","110/08/13","",NA,NA,NA
"12020","8941關中","110/08/13","",NA,NA,NA
"12021","8941關中","110/08/13","",NA,NA,NA
"12022","8941關中","110/08/13","",NA,NA,NA
"12023","8941關中","110/08/13","",NA,NA,NA
"12024","8941關中","110/08/13","",NA,NA,NA
"12025","8941關中","110/08/13","",NA,NA,NA
"12026","8941關中","110/08/13","",NA,NA,NA
"12027","8941關中","110/08/13","",NA,NA,NA
"12028","8941關中","110/08/13","",NA,NA,NA
"12029","8941關中","110/08/13","",NA,NA,NA
"12030","8941關中","110/08/13","",NA,NA,NA
"12031","8936國統","110/08/13","台新-高雄",127,0,127
"12032","8936國統","110/08/13","第一金-豐原",0,60,-60
"12033","8936國統","110/08/13","美林",84,18,66
"12034","8936國統","110/08/13","凱基-台北",1,50,-49
"12035","8936國統","110/08/13","摩根大通",40,14,26
"12036","8936國統","110/08/13","凱基-高美館",8,51,-43
"12037","8936國統","110/08/13","凱基-台南",23,0,23
"12038","8936國統","110/08/13","港商野村",8,39,-31
"12039","8936國統","110/08/13","第一金-路竹",20,0,20
"12040","8936國統","110/08/13","日盛-忠孝",0,25,-25
"12041","8936國統","110/08/13","元大-敦化",17,0,17
"12042","8936國統","110/08/13","群益金鼎-台中",0,20,-20
"12043","8936國統","110/08/13","新光-台中",22,6,16
"12044","8936國統","110/08/13","台新-台南",0,15,-15
"12045","8936國統","110/08/13","元大-文心",15,0,15
"12046","8936國統","110/08/13","元大-博愛",0,14,-14
"12047","8936國統","110/08/13","元大-敦南",14,0,14
"12048","8936國統","110/08/13","合庫-台南",0,10,-10
"12049","8936國統","110/08/13","日盛-北高雄",12,0,12
"12050","8936國統","110/08/13","新光-桃園",0,10,-10
"12051","8936國統","110/08/13","元大-西螺",10,0,10
"12052","8936國統","110/08/13","永豐金-南投",0,10,-10
"12053","8936國統","110/08/13","彰銀",8,0,8
"12054","8936國統","110/08/13","永豐金-竹科",0,10,-10
"12055","8936國統","110/08/13","元富-大昌",8,0,8
"12056","8936國統","110/08/13","富邦-竹北",0,8,-8
"12057","8936國統","110/08/13","富邦-南屯",10,2,8
"12058","8936國統","110/08/13","元大-大里德芳",5,13,-8
"12059","8936國統","110/08/13","元大-天母",7,0,7
"12060","8936國統","110/08/13","台新證券",0,7,-7
"12061","6226光鼎","110/08/13","國泰-敦南",676,469,207
"12062","6226光鼎","110/08/13","摩根大通",267,1531,-1264
"12063","6226光鼎","110/08/13","元富-新竹",163,19,144
"12064","6226光鼎","110/08/13","美商高盛",149,1352,-1203
"12065","6226光鼎","110/08/13","合庫-台中",461,334,127
"12066","6226光鼎","110/08/13","瑞士信貸",52,752,-700
"12067","6226光鼎","110/08/13","國泰-台中",734,609,125
"12068","6226光鼎","110/08/13","凱基-台北",84,488,-404
"12069","6226光鼎","110/08/13","元大-小港",198,88,110
"12070","6226光鼎","110/08/13","台新-中壢",2,226,-224
"12071","6226光鼎","110/08/13","凱基-永和",91,0,91
"12072","6226光鼎","110/08/13","元大-文心興安",44,216,-172
"12073","6226光鼎","110/08/13","元大-西螺",82,5,77
"12074","6226光鼎","110/08/13","美林",234,376,-142
"12075","6226光鼎","110/08/13","永豐金-南京",78,1,77
"12076","6226光鼎","110/08/13","凱基-嘉義",12,126,-114
"12077","6226光鼎","110/08/13","群益金鼎-萬華",78,9,69
"12078","6226光鼎","110/08/13","富邦-陽明",23,117,-94
"12079","6226光鼎","110/08/13","日盛-八德",63,1,62
"12080","6226光鼎","110/08/13","兆豐-大安",4,85,-81
"12081","6226光鼎","110/08/13","凱基-桃園",88,27,61
"12082","6226光鼎","110/08/13","永豐金-中盛",27,107,-80
"12083","6226光鼎","110/08/13","凱基-岡山",62,1,61
"12084","6226光鼎","110/08/13","元大證券",232,304,-72
"12085","6226光鼎","110/08/13","臺銀-鳳山",110,52,58
"12086","6226光鼎","110/08/13","凱基-台中",19,84,-65
"12087","6226光鼎","110/08/13","元大-板橋三民",114,56,58
"12088","6226光鼎","110/08/13","元大-士林",107,171,-64
"12089","6226光鼎","110/08/13","凱基-板橋",195,140,55
"12090","6226光鼎","110/08/13","富邦-高雄",15,69,-54
"12091","2363矽統","110/08/13","美商高盛",416,10,406
"12092","2363矽統","110/08/13","元大-佳里",319,1216,-897
"12093","2363矽統","110/08/13","土銀",374,14,360
"12094","2363矽統","110/08/13","瑞士信貸",0,836,-836
"12095","2363矽統","110/08/13","玉山-台中",289,18,271
"12096","2363矽統","110/08/13","永豐金-中正",22,676,-654
"12097","2363矽統","110/08/13","大展",244,10,234
"12098","2363矽統","110/08/13","台灣摩根士丹利",116,566,-450
"12099","2363矽統","110/08/13","永豐金-板盛",172,22,150
"12100","2363矽統","110/08/13","宏遠-桃園",11,359,-348
"12101","2363矽統","110/08/13","富邦-仁愛",198,49,149
"12102","2363矽統","110/08/13","國泰-敦南",671,911,-240
"12103","2363矽統","110/08/13","日盛-北高雄",206,85,121
"12104","2363矽統","110/08/13","元大證券",126,352,-226
"12105","2363矽統","110/08/13","台新-三民",163,55,108
"12106","2363矽統","110/08/13","花旗環球",0,223,-223
"12107","2363矽統","110/08/13","元富-新店",130,23,107
"12108","2363矽統","110/08/13","臺銀",48,259,-211
"12109","2363矽統","110/08/13","永豐金-桃盛",108,5,103
"12110","2363矽統","110/08/13","摩根大通",268,460,-192
"12111","2363矽統","110/08/13","元大-復北",129,28,101
"12112","2363矽統","110/08/13","國票",63,248,-185
"12113","2363矽統","110/08/13","台新-屏東",116,18,98
"12114","2363矽統","110/08/13","台新-高雄",91,263,-172
"12115","2363矽統","110/08/13","華南永昌-虎尾",180,87,93
"12116","2363矽統","110/08/13","合庫證券",18,177,-159
"12117","2363矽統","110/08/13","元大-板橋",101,10,91
"12118","2363矽統","110/08/13","第一金-華江",65,206,-141
"12119","2363矽統","110/08/13","新光",343,260,83
"12120","2363矽統","110/08/13","中國信託-忠孝",65,201,-136
"12121","8112至上","110/08/13","合庫證券",160,5,155
"12122","8112至上","110/08/13","摩根大通",123,818,-695
"12123","8112至上","110/08/13","凱基-竹科",140,12,128
"12124","8112至上","110/08/13","美林",22,299,-277
"12125","8112至上","110/08/13","臺灣企銀-桃園",126,0,126
"12126","8112至上","110/08/13","第一金-華江",4,158,-154
"12127","8112至上","110/08/13","統一-中壢",79,1,78
"12128","8112至上","110/08/13","群益金鼎-基隆",1,117,-116
"12129","8112至上","110/08/13","港商麥格理",86,9,77
"12130","8112至上","110/08/13","新光-桃園",2,100,-98
"12131","8112至上","110/08/13","富邦-新竹",78,2,76
"12132","8112至上","110/08/13","永興-水湳",0,95,-95
"12133","8112至上","110/08/13","凱基-復興",67,0,67
"12134","8112至上","110/08/13","凱基-新店",50,141,-91
"12135","8112至上","110/08/13","合庫-西台中",62,2,60
"12136","8112至上","110/08/13","元富-新興",3,91,-88
"12137","8112至上","110/08/13","大慶",60,0,60
"12138","8112至上","110/08/13","凱基-台北",60,148,-88
"12139","8112至上","110/08/13","日盛-新竹",59,2,57
"12140","8112至上","110/08/13","國票-中和",4,90,-86
"12141","8112至上","110/08/13","元大-開元",53,0,53
"12142","8112至上","110/08/13","新加坡商瑞銀",5,88,-83
"12143","8112至上","110/08/13","富邦-中壢",51,4,47
"12144","8112至上","110/08/13","宏遠-民生",2,52,-50
"12145","8112至上","110/08/13","富邦-桃園",46,0,46
"12146","8112至上","110/08/13","群益金鼎-竹南",0,50,-50
"12147","8112至上","110/08/13","合庫-嘉義",44,0,44
"12148","8112至上","110/08/13","新百王",2,50,-48
"12149","8112至上","110/08/13","元大-府城",55,11,44
"12150","8112至上","110/08/13","港商野村",13,60,-47
"12151","1570力肯","110/08/13","新光",147,12,135
"12152","1570力肯","110/08/13","(牛牛牛)亞-鑫豐",15,136,-121
"12153","1570力肯","110/08/13","國票-北高雄",128,0,128
"12154","1570力肯","110/08/13","富邦-台中",0,51,-51
"12155","1570力肯","110/08/13","凱基-台北",80,24,56
"12156","1570力肯","110/08/13","日盛-頭份",0,50,-50
"12157","1570力肯","110/08/13","統一",54,0,54
"12158","1570力肯","110/08/13","元富-高雄",0,40,-40
"12159","1570力肯","110/08/13","國票-內壢",49,1,48
"12160","1570力肯","110/08/13","凱基-高美館",2,41,-39
"12161","1570力肯","110/08/13","美林",37,0,37
"12162","1570力肯","110/08/13","日盛-忠孝",0,38,-38
"12163","1570力肯","110/08/13","國票-天祥",45,8,37
"12164","1570力肯","110/08/13","元大-羅東",0,20,-20
"12165","1570力肯","110/08/13","摩根大通",67,45,22
"12166","1570力肯","110/08/13","元大-大天母",0,20,-20
"12167","1570力肯","110/08/13","永豐金-屏東",22,0,22
"12168","1570力肯","110/08/13","永豐金-嘉義",0,20,-20
"12169","1570力肯","110/08/13","元富-新店",20,0,20
"12170","1570力肯","110/08/13","國泰-敦南",2,20,-18
"12171","1570力肯","110/08/13","(牛牛牛)亞證券",20,0,20
"12172","1570力肯","110/08/13","元大-沙鹿",1,18,-17
"12173","1570力肯","110/08/13","凱基-台南",20,0,20
"12174","1570力肯","110/08/13","元大-林森",0,16,-16
"12175","1570力肯","110/08/13","元大-開元",20,0,20
"12176","1570力肯","110/08/13","永豐金-市政",1,16,-15
"12177","1570力肯","110/08/13","元大-花蓮",20,0,20
"12178","1570力肯","110/08/13","統一-三重",5,19,-14
"12179","1570力肯","110/08/13","元大-基隆",19,0,19
"12180","1570力肯","110/08/13","國泰-新莊",1,15,-14
"12181","2929淘帝","110/08/13","新光-新竹",488,287,201
"12182","2929淘帝","110/08/13","美林",17,84,-67
"12183","2929淘帝","110/08/13","元大-西門",38,1,37
"12184","2929淘帝","110/08/13","摩根大通",0,63,-63
"12185","2929淘帝","110/08/13","元富-文心",30,0,30
"12186","2929淘帝","110/08/13","港商野村",14,69,-55
"12187","2929淘帝","110/08/13","華南永昌-苗栗",30,0,30
"12188","2929淘帝","110/08/13","玉山-新竹",0,50,-50
"12189","2929淘帝","110/08/13","元大-豐原站前",31,1,30
"12190","2929淘帝","110/08/13","臺銀-新竹",0,30,-30
"12191","2929淘帝","110/08/13","元富-台南",22,0,22
"12192","2929淘帝","110/08/13","元富-三重",23,52,-29
"12193","2929淘帝","110/08/13","凱基-東門",20,0,20
"12194","2929淘帝","110/08/13","新加坡商瑞銀",18,41,-23
"12195","2929淘帝","110/08/13","永豐金-敦南",17,0,17
"12196","2929淘帝","110/08/13","兆豐-大同",0,21,-21
"12197","2929淘帝","110/08/13","新光",44,29,15
"12198","2929淘帝","110/08/13","美商高盛",0,20,-20
"12199","2929淘帝","110/08/13","元大-蘆洲",14,0,14
"12200","2929淘帝","110/08/13","台新-左楠",6,25,-19
"12201","2929淘帝","110/08/13","國票-博愛",12,0,12
"12202","2929淘帝","110/08/13","港商法國興業",0,14,-14
"12203","2929淘帝","110/08/13","合庫-自強",10,0,10
"12204","2929淘帝","110/08/13","台新證券",7,21,-14
"12205","2929淘帝","110/08/13","兆豐-桃園",10,0,10
"12206","2929淘帝","110/08/13","元大-館前",0,14,-14
"12207","2929淘帝","110/08/13","凱基-頭份",10,0,10
"12208","2929淘帝","110/08/13","亞東-新竹",0,13,-13
"12209","2929淘帝","110/08/13","華南永昌-大安",10,0,10
"12210","2929淘帝","110/08/13","元大-永和",7,20,-13
"12211","5410國眾","110/08/13","土銀-嘉義",21,0,21
"12212","5410國眾","110/08/13","國泰-敦南",20,102,-82
"12213","5410國眾","110/08/13","日盛-大墩",15,0,15
"12214","5410國眾","110/08/13","元大-大雅",0,64,-64
"12215","5410國眾","110/08/13","群益金鼎-民權",14,0,14
"12216","5410國眾","110/08/13","大昌-新店",0,37,-37
"12217","5410國眾","110/08/13","玉山-嘉義",12,0,12
"12218","5410國眾","110/08/13","陽信-石牌",0,33,-33
"12219","5410國眾","110/08/13","元大-新竹經國",12,0,12
"12220","5410國眾","110/08/13","摩根大通",0,26,-26
"12221","5410國眾","110/08/13","日盛-屏東",10,0,10
"12222","5410國眾","110/08/13","瑞士信貸",0,18,-18
"12223","5410國眾","110/08/13","富邦-竹北",10,0,10
"12224","5410國眾","110/08/13","元大-北投",8,22,-14
"12225","5410國眾","110/08/13","元富",10,1,9
"12226","5410國眾","110/08/13","合庫-台中",0,10,-10
"12227","5410國眾","110/08/13","凱基-八德",9,0,9
"12228","5410國眾","110/08/13","合庫-新竹",0,10,-10
"12229","5410國眾","110/08/13","富邦-台北",9,0,9
"12230","5410國眾","110/08/13","元大-善化",0,10,-10
"12231","5410國眾","110/08/13","富邦-新店",10,1,9
"12232","5410國眾","110/08/13","大昌",0,9,-9
"12233","5410國眾","110/08/13","元富-虎尾",8,0,8
"12234","5410國眾","110/08/13","兆豐-三重",0,9,-9
"12235","5410國眾","110/08/13","統一",7,0,7
"12236","5410國眾","110/08/13","新光",17,25,-8
"12237","5410國眾","110/08/13","日茂-南投",7,0,7
"12238","5410國眾","110/08/13","亞東-新竹",0,5,-5
"12239","5410國眾","110/08/13","元大-彰化",7,0,7
"12240","5410國眾","110/08/13","兆豐-桃鶯",0,5,-5
"12241","2841台開","110/08/13","宏遠-館前",181,0,181
"12242","2841台開","110/08/13","永豐金-內湖",0,77,-77
"12243","2841台開","110/08/13","日盛證券",70,1,69
"12244","2841台開","110/08/13","富邦-岡山",0,72,-72
"12245","2841台開","110/08/13","台新-三民",50,0,50
"12246","2841台開","110/08/13","永豐金-屏東",0,50,-50
"12247","2841台開","110/08/13","凱基-市政",18,0,18
"12248","2841台開","110/08/13","港商野村",0,38,-38
"12249","2841台開","110/08/13","新光",32,16,16
"12250","2841台開","110/08/13","元大-林園",0,30,-30
"12251","2841台開","110/08/13","兆豐-新營",15,0,15
"12252","2841台開","110/08/13","永豐金-敦南",13,42,-29
"12253","2841台開","110/08/13","日盛-內湖",12,0,12
"12254","2841台開","110/08/13","臺銀-民權",0,20,-20
"12255","2841台開","110/08/13","群益金鼎-基隆",11,0,11
"12256","2841台開","110/08/13","元大-崇德",0,19,-19
"12257","2841台開","110/08/13","富邦-台北",10,0,10
"12258","2841台開","110/08/13","日盛-中壢",0,18,-18
"12259","2841台開","110/08/13","元大-歸仁",10,0,10
"12260","2841台開","110/08/13","兆豐-板橋",0,10,-10
"12261","2841台開","110/08/13","凱基-台北",9,2,7
"12262","2841台開","110/08/13","豐農",0,10,-10
"12263","2841台開","110/08/13","元大-福營",10,3,7
"12264","2841台開","110/08/13","元大-北三重",0,10,-10
"12265","2841台開","110/08/13","元富-文心",5,0,5
"12266","2841台開","110/08/13","台新證券",6,13,-7
"12267","2841台開","110/08/13","凱基-東港",5,0,5
"12268","2841台開","110/08/13","光和-嘉義",0,6,-6
"12269","2841台開","110/08/13","元富-成功",3,0,3
"12270","2841台開","110/08/13","中國信託-高雄",0,5,-5
"12271","6207雷科","110/08/13","安泰",51,0,51
"12272","6207雷科","110/08/13","摩根大通",12,80,-68
"12273","6207雷科","110/08/13","永豐金證券",34,0,34
"12274","6207雷科","110/08/13","美林",1,34,-33
"12275","6207雷科","110/08/13","元大-潮州",32,0,32
"12276","6207雷科","110/08/13","新加坡商瑞銀",18,45,-27
"12277","6207雷科","110/08/13","元大-六合",30,0,30
"12278","6207雷科","110/08/13","凱基-復興",0,20,-20
"12279","6207雷科","110/08/13","富邦-中壢",20,0,20
"12280","6207雷科","110/08/13","凱基-台北",15,31,-16
"12281","6207雷科","110/08/13","統一-台中",10,0,10
"12282","6207雷科","110/08/13","港商野村",1,13,-12
"12283","6207雷科","110/08/13","凱基-岡山",10,0,10
"12284","6207雷科","110/08/13","群益金鼎-東門",0,12,-12
"12285","6207雷科","110/08/13","元大-東門",10,0,10
"12286","6207雷科","110/08/13","凱基-三峽",4,15,-11
"12287","6207雷科","110/08/13","元大-大天母",13,3,10
"12288","6207雷科","110/08/13","兆豐-公益",0,9,-9
"12289","6207雷科","110/08/13","元大-路竹",8,0,8
"12290","6207雷科","110/08/13","元大-鳳山",0,8,-8
"12291","6207雷科","110/08/13","富邦-敦南",7,0,7
"12292","6207雷科","110/08/13","合庫-鳳山",0,6,-6
"12293","6207雷科","110/08/13","兆豐-彰化",6,0,6
"12294","6207雷科","110/08/13","凱基-三重",0,6,-6
"12295","6207雷科","110/08/13","群益金鼎-土城",6,0,6
"12296","6207雷科","110/08/13","凱基-幸福",0,6,-6
"12297","6207雷科","110/08/13","玉山-台南",5,0,5
"12298","6207雷科","110/08/13","富邦-基隆",0,6,-6
"12299","6207雷科","110/08/13","凱基-湖口",5,0,5
"12300","6207雷科","110/08/13","元大-清水",0,6,-6
"12301","3679新至陞","110/08/13","元大-大天母",20,0,20
"12302","3679新至陞","110/08/13","摩根大通",2,27,-25
"12303","3679新至陞","110/08/13","台灣摩根士丹利",12,0,12
"12304","3679新至陞","110/08/13","瑞士信貸",1,16,-15
"12305","3679新至陞","110/08/13","元大-成功",10,0,10
"12306","3679新至陞","110/08/13","美林",0,10,-10
"12307","3679新至陞","110/08/13","兆豐-高雄",9,0,9
"12308","3679新至陞","110/08/13","凱基-台北",11,16,-5
"12309","3679新至陞","110/08/13","國泰-松江",4,0,4
"12310","3679新至陞","110/08/13","元大-東蘆",0,5,-5
"12311","3679新至陞","110/08/13","元大-大同",3,0,3
"12312","3679新至陞","110/08/13","元大-北成功",0,4,-4
"12313","3679新至陞","110/08/13","合庫-台中",2,0,2
"12314","3679新至陞","110/08/13","富邦-中壢",0,3,-3
"12315","3679新至陞","110/08/13","台中銀-員林",2,0,2
"12316","3679新至陞","110/08/13","彰銀",0,2,-2
"12317","3679新至陞","110/08/13","康和-板橋",2,0,2
"12318","3679新至陞","110/08/13","凱基-大安",0,2,-2
"12319","3679新至陞","110/08/13","新光-高雄",2,0,2
"12320","3679新至陞","110/08/13","華南永昌-鶯歌",0,2,-2
"12321","3679新至陞","110/08/13","凱基-文心",5,3,2
"12322","3679新至陞","110/08/13","富邦-仁愛",0,2,-2
"12323","3679新至陞","110/08/13","元大-景美",2,0,2
"12324","3679新至陞","110/08/13","元大證券",1,3,-2
"12325","3679新至陞","110/08/13","元大-土城永寧",2,0,2
"12326","3679新至陞","110/08/13","元大-土城",0,2,-2
"12327","3679新至陞","110/08/13","美商高盛",1,0,1
"12328","3679新至陞","110/08/13","台灣企銀-民雄",0,1,-1
"12329","3679新至陞","110/08/13","台新證券",1,0,1
"12330","3679新至陞","110/08/13","日盛證券",0,1,-1
"12331","2727王品","110/08/13","新光",27,6,21
"12332","2727王品","110/08/13","摩根大通",1,53,-52
"12333","2727王品","110/08/13","大慶-富順",20,0,20
"12334","2727王品","110/08/13","土銀-南港",0,40,-40
"12335","2727王品","110/08/13","兆豐-東門",17,0,17
"12336","2727王品","110/08/13","港商麥格理",0,24,-24
"12337","2727王品","110/08/13","新光-台中",19,2,17
"12338","2727王品","110/08/13","新加坡商瑞銀",0,21,-21
"12339","2727王品","110/08/13","元大-竹科",11,0,11
"12340","2727王品","110/08/13","康和-台南",1,22,-21
"12341","2727王品","110/08/13","日盛-屏東",10,0,10
"12342","2727王品","110/08/13","富邦-員林",0,17,-17
"12343","2727王品","110/08/13","彰銀-七賢",10,0,10
"12344","2727王品","110/08/13","港商野村",3,18,-15
"12345","2727王品","110/08/13","玉山-大里",10,0,10
"12346","2727王品","110/08/13","富邦-新營",0,15,-15
"12347","2727王品","110/08/13","富邦-台中",12,2,10
"12348","2727王品","110/08/13","台灣企銀-竹北",3,17,-14
"12349","2727王品","110/08/13","國泰-敦南",15,6,9
"12350","2727王品","110/08/13","國泰-板橋",3,17,-14
"12351","2727王品","110/08/13","臺銀",9,1,8
"12352","2727王品","110/08/13","凱基-板橋",0,13,-13
"12353","2727王品","110/08/13","元大-台中",8,0,8
"12354","2727王品","110/08/13","日盛-中和",1,13,-12
"12355","2727王品","110/08/13","國泰-台中",11,4,7
"12356","2727王品","110/08/13","第一金-新竹",1,12,-11
"12357","2727王品","110/08/13","永豐金-彰化",7,0,7
"12358","2727王品","110/08/13","統一",1,12,-11
"12359","2727王品","110/08/13","新光-桃園",6,0,6
"12360","2727王品","110/08/13","統一-竹南",0,10,-10
"12361","1570力肯","110/08/13","新光",147,12,135
"12362","1570力肯","110/08/13","(牛牛牛)亞-鑫豐",15,136,-121
"12363","1570力肯","110/08/13","國票-北高雄",128,0,128
"12364","1570力肯","110/08/13","富邦-台中",0,51,-51
"12365","1570力肯","110/08/13","凱基-台北",80,24,56
"12366","1570力肯","110/08/13","日盛-頭份",0,50,-50
"12367","1570力肯","110/08/13","統一",54,0,54
"12368","1570力肯","110/08/13","元富-高雄",0,40,-40
"12369","1570力肯","110/08/13","國票-內壢",49,1,48
"12370","1570力肯","110/08/13","凱基-高美館",2,41,-39
"12371","1570力肯","110/08/13","美林",37,0,37
"12372","1570力肯","110/08/13","日盛-忠孝",0,38,-38
"12373","1570力肯","110/08/13","國票-天祥",45,8,37
"12374","1570力肯","110/08/13","元大-羅東",0,20,-20
"12375","1570力肯","110/08/13","摩根大通",67,45,22
"12376","1570力肯","110/08/13","元大-大天母",0,20,-20
"12377","1570力肯","110/08/13","永豐金-屏東",22,0,22
"12378","1570力肯","110/08/13","永豐金-嘉義",0,20,-20
"12379","1570力肯","110/08/13","元富-新店",20,0,20
"12380","1570力肯","110/08/13","國泰-敦南",2,20,-18
"12381","1570力肯","110/08/13","(牛牛牛)亞證券",20,0,20
"12382","1570力肯","110/08/13","元大-沙鹿",1,18,-17
"12383","1570力肯","110/08/13","凱基-台南",20,0,20
"12384","1570力肯","110/08/13","元大-林森",0,16,-16
"12385","1570力肯","110/08/13","元大-開元",20,0,20
"12386","1570力肯","110/08/13","永豐金-市政",1,16,-15
"12387","1570力肯","110/08/13","元大-花蓮",20,0,20
"12388","1570力肯","110/08/13","統一-三重",5,19,-14
"12389","1570力肯","110/08/13","元大-基隆",19,0,19
"12390","1570力肯","110/08/13","國泰-新莊",1,15,-14
"12391","6180橘子","110/08/13","美商高盛",48,0,48
"12392","6180橘子","110/08/13","玉山-桃園",1,30,-29
"12393","6180橘子","110/08/13","美林",37,0,37
"12394","6180橘子","110/08/13","元大-成功",0,22,-22
"12395","6180橘子","110/08/13","凱基-台北",17,1,16
"12396","6180橘子","110/08/13","群益金鼎",0,11,-11
"12397","6180橘子","110/08/13","台新證券",15,1,14
"12398","6180橘子","110/08/13","亞東-高雄",0,10,-10
"12399","6180橘子","110/08/13","台灣摩根士丹利",13,0,13
"12400","6180橘子","110/08/13","元大-北港",0,10,-10
"12401","6180橘子","110/08/13","元大-北投",11,0,11
"12402","6180橘子","110/08/13","統一-彰化",3,10,-7
"12403","6180橘子","110/08/13","合庫-自強",10,0,10
"12404","6180橘子","110/08/13","摩根大通",6,13,-7
"12405","6180橘子","110/08/13","統一-台南",10,0,10
"12406","6180橘子","110/08/13","群益金鼎-中山",1,8,-7
"12407","6180橘子","110/08/13","兆豐-台中",10,0,10
"12408","6180橘子","110/08/13","元大-敦南",0,7,-7
"12409","6180橘子","110/08/13","群益金鼎-台中",10,0,10
"12410","6180橘子","110/08/13","國泰-板橋",0,6,-6
"12411","6180橘子","110/08/13","康和-台中",6,0,6
"12412","6180橘子","110/08/13","富邦-宜蘭",0,6,-6
"12413","6180橘子","110/08/13","凱基-汐止",5,0,5
"12414","6180橘子","110/08/13","元大-台北",0,6,-6
"12415","6180橘子","110/08/13","日盛-景美",6,2,4
"12416","6180橘子","110/08/13","永豐金-板橋",0,6,-6
"12417","6180橘子","110/08/13","新光-台中",4,0,4
"12418","6180橘子","110/08/13","亞東",0,5,-5
"12419","6180橘子","110/08/13","國泰-敦南",4,0,4
"12420","6180橘子","110/08/13","兆豐-竹北",0,5,-5
"12421","2390云辰","110/08/13","摩根大通",643,393,250
"12422","2390云辰","110/08/13","元大-信義",0,202,-202
"12423","2390云辰","110/08/13","美商高盛",269,138,131
"12424","2390云辰","110/08/13","美林",169,289,-120
"12425","2390云辰","110/08/13","凱基-台北",418,293,125
"12426","2390云辰","110/08/13","元大-東港",9,102,-93
"12427","2390云辰","110/08/13","元富-板橋",94,13,81
"12428","2390云辰","110/08/13","元富-高雄",17,94,-77
"12429","2390云辰","110/08/13","土銀-士林",78,0,78
"12430","2390云辰","110/08/13","凱基-竹科",5,76,-71
"12431","2390云辰","110/08/13","元大-前金",92,16,76
"12432","2390云辰","110/08/13","國票-博愛",40,107,-67
"12433","2390云辰","110/08/13","台新-台中",89,24,65
"12434","2390云辰","110/08/13","群益金鼎-開元",26,90,-64
"12435","2390云辰","110/08/13","光和-嘉義",73,10,63
"12436","2390云辰","110/08/13","新加坡商瑞銀",4,61,-57
"12437","2390云辰","110/08/13","富邦-敦南",59,0,59
"12438","2390云辰","110/08/13","港商野村",277,333,-56
"12439","2390云辰","110/08/13","富邦-彰化",69,11,58
"12440","2390云辰","110/08/13","新光",144,197,-53
"12441","2390云辰","110/08/13","元大-草屯",75,17,58
"12442","2390云辰","110/08/13","統一",23,75,-52
"12443","2390云辰","110/08/13","光和-溪湖",54,1,53
"12444","2390云辰","110/08/13","元大-林園",0,51,-51
"12445","2390云辰","110/08/13","元大-土城學府",263,210,53
"12446","2390云辰","110/08/13","富邦-新營",1,48,-47
"12447","2390云辰","110/08/13","元大-文心興安",64,11,53
"12448","2390云辰","110/08/13","元大-新莊",33,80,-47
"12449","2390云辰","110/08/13","國泰-忠孝",50,0,50
"12450","2390云辰","110/08/13","日盛-園區",10,55,-45
"12451","2867三商壽","110/08/12","新光",292,1,291
"12452","2867三商壽","110/08/12","摩根大通",53,266,-213
"12453","2867三商壽","110/08/12","元大-土城永寧",200,0,200
"12454","2867三商壽","110/08/12","元大-崇德",3,201,-198
"12455","2867三商壽","110/08/12","合庫證券",100,0,100
"12456","2867三商壽","110/08/12","美商高盛",31,159,-128
"12457","2867三商壽","110/08/12","土銀",100,0,100
"12458","2867三商壽","110/08/12","富邦證券",0,120,-120
"12459","2867三商壽","110/08/12","臺銀-臺南",100,0,100
"12460","2867三商壽","110/08/12","凱基-信義",0,117,-117
"12461","2867三商壽","110/08/12","元富-古亭",100,0,100
"12462","2867三商壽","110/08/12","凱基-台北",2,113,-111
"12463","2867三商壽","110/08/12","元大-新莊",100,0,100
"12464","2867三商壽","110/08/12","凱基-虎尾",0,100,-100
"12465","2867三商壽","110/08/12","凱基",97,0,97
"12466","2867三商壽","110/08/12","元大-南投",0,92,-92
"12467","2867三商壽","110/08/12","元大-桃園",60,0,60
"12468","2867三商壽","110/08/12","台灣摩根士丹利",0,70,-70
"12469","2867三商壽","110/08/12","合庫-西台中",51,0,51
"12470","2867三商壽","110/08/12","美林",8,72,-64
"12471","2867三商壽","110/08/12","華南永昌-鳳山",51,1,50
"12472","2867三商壽","110/08/12","新加坡商瑞銀",0,61,-61
"12473","2867三商壽","110/08/12","元大-沙鹿",39,0,39
"12474","2867三商壽","110/08/12","群益金鼎-台北",0,60,-60
"12475","2867三商壽","110/08/12","光和",30,0,30
"12476","2867三商壽","110/08/12","富邦-宜蘭",0,50,-50
"12477","2867三商壽","110/08/12","元大-龍潭",30,0,30
"12478","2867三商壽","110/08/12","元大-旗山",0,50,-50
"12479","2867三商壽","110/08/12","永豐金-員林",30,0,30
"12480","2867三商壽","110/08/12","元富-吉利",0,27,-27
"12481","5521工信","110/08/12","日進",900,0,900
"12482","5521工信","110/08/12","永豐金證券",14,200,-186
"12483","5521工信","110/08/12","摩根大通",678,57,621
"12484","5521工信","110/08/12","富邦-中壢",2,112,-110
"12485","5521工信","110/08/12","國票-安和",254,20,234
"12486","5521工信","110/08/12","中國信託-嘉義",0,100,-100
"12487","5521工信","110/08/12","凱基-台北",194,46,148
"12488","5521工信","110/08/12","元大-南屯",0,58,-58
"12489","5521工信","110/08/12","日盛-中和",103,10,93
"12490","5521工信","110/08/12","凱基-中壢",0,55,-55
"12491","5521工信","110/08/12","新光-新竹",80,5,75
"12492","5521工信","110/08/12","(牛牛牛)亞-鑫豐",1,52,-51
"12493","5521工信","110/08/12","美林",69,10,59
"12494","5521工信","110/08/12","台新證券",1,51,-50
"12495","5521工信","110/08/12","富邦-台北",69,20,49
"12496","5521工信","110/08/12","群益金鼎-崇德",0,48,-48
"12497","5521工信","110/08/12","新光-台南",37,0,37
"12498","5521工信","110/08/12","康和-內湖",0,46,-46
"12499","5521工信","110/08/12","永豐金-鳳山",32,0,32
"12500","5521工信","110/08/12","日盛-新莊",0,45,-45
"12501","5521工信","110/08/12","第一金-台南",67,42,25
"12502","5521工信","110/08/12","元大-旗山",1,46,-45
"12503","5521工信","110/08/12","台灣企銀-台中",20,0,20
"12504","5521工信","110/08/12","元大-內湖",0,45,-45
"12505","5521工信","110/08/12","康和-澎湖",20,0,20
"12506","5521工信","110/08/12","日盛-高雄",0,42,-42
"12507","5521工信","110/08/12","凱基-三多",20,0,20
"12508","5521工信","110/08/12","元大-大同",0,42,-42
"12509","5521工信","110/08/12","元大-仁愛",20,0,20
"12510","5521工信","110/08/12","第一金-新竹",0,40,-40
"12511","1471首利","110/08/12","摩根大通",190,21,169
"12512","1471首利","110/08/12","光和-溪湖",0,75,-75
"12513","1471首利","110/08/12","元大-敦化",100,0,100
"12514","1471首利","110/08/12","富邦-基隆",2,41,-39
"12515","1471首利","110/08/12","瑞士信貸",86,0,86
"12516","1471首利","110/08/12","凱基-台南",0,30,-30
"12517","1471首利","110/08/12","美商高盛",51,0,51
"12518","1471首利","110/08/12","元富-民權",0,29,-29
"12519","1471首利","110/08/12","美林",49,0,49
"12520","1471首利","110/08/12","凱基-東門",0,24,-24
"12521","1471首利","110/08/12","國票-北高雄",20,0,20
"12522","1471首利","110/08/12","永興-大墩",0,20,-20
"12523","1471首利","110/08/12","凱基-五股",20,0,20
"12524","1471首利","110/08/12","元大-土城",1,21,-20
"12525","1471首利","110/08/12","永豐金-中壢",20,0,20
"12526","1471首利","110/08/12","凱基-內埔",1,20,-19
"12527","1471首利","110/08/12","凱基-台北",16,0,16
"12528","1471首利","110/08/12","中國信託",0,17,-17
"12529","1471首利","110/08/12","台新證券",16,3,13
"12530","1471首利","110/08/12","華南永昌-中正",2,19,-17
"12531","1471首利","110/08/12","兆豐-員林",15,3,12
"12532","1471首利","110/08/12","中國信託-文心",0,16,-16
"12533","1471首利","110/08/12","中國信託-永康",10,0,10
"12534","1471首利","110/08/12","兆豐-台南",1,17,-16
"12535","1471首利","110/08/12","華南永昌-麻豆",11,1,10
"12536","1471首利","110/08/12","凱基-新豐",0,15,-15
"12537","1471首利","110/08/12","元大-新營",10,0,10
"12538","1471首利","110/08/12","永豐金-新莊",0,15,-15
"12539","1471首利","110/08/12","新加坡商瑞銀",6,0,6
"12540","1471首利","110/08/12","凱基-彰化",6,20,-14
"12541","2883開發金","110/08/12","美林",2636,759,1877
"12542","2883開發金","110/08/12","摩根大通",28,5087,-5059
"12543","2883開發金","110/08/12","華南永昌",889,3,886
"12544","2883開發金","110/08/12","新加坡商瑞銀",111,2619,-2508
"12545","2883開發金","110/08/12","美商高盛",1037,275,762
"12546","2883開發金","110/08/12","富邦-彰化",7,809,-802
"12547","2883開發金","110/08/12","凱基-員林",600,0,600
"12548","2883開發金","110/08/12","瑞士信貸",773,1528,-755
"12549","2883開發金","110/08/12","日盛-中壢",532,9,523
"12550","2883開發金","110/08/12","港商野村",2,600,-598
"12551","2883開發金","110/08/12","元大證券",631,169,462
"12552","2883開發金","110/08/12","宏遠-民生",0,500,-500
"12553","2883開發金","110/08/12","玉山-高雄",457,5,452
"12554","2883開發金","110/08/12","元大-桃園",19,504,-485
"12555","2883開發金","110/08/12","元大-員林",435,0,435
"12556","2883開發金","110/08/12","台灣摩根士丹利",1506,1983,-477
"12557","2883開發金","110/08/12","永豐金-高雄",343,20,323
"12558","2883開發金","110/08/12","永豐金-台南",29,495,-466
"12559","2883開發金","110/08/12","日盛-大墩",321,0,321
"12560","2883開發金","110/08/12","元大-斗六",4,457,-453
"12561","2883開發金","110/08/12","台新-三民",338,19,319
"12562","2883開發金","110/08/12","群益金鼎-桃園",36,314,-278
"12563","2883開發金","110/08/12","國泰-敦南",468,170,298
"12564","2883開發金","110/08/12","群益金鼎-開元",15,221,-206
"12565","2883開發金","110/08/12","兆豐-北高雄",258,6,252
"12566","2883開發金","110/08/12","土銀-台中",1,202,-201
"12567","2883開發金","110/08/12","安泰",272,53,219
"12568","2883開發金","110/08/12","凱基-台中",12,204,-192
"12569","2883開發金","110/08/12","群益金鼎-彰化",218,4,214
"12570","2883開發金","110/08/12","永豐金-中盛",55,246,-191
"12571","6205詮欣","110/08/12","元大-新竹經國",12,0,12
"12572","6205詮欣","110/08/12","元大-善化",0,20,-20
"12573","6205詮欣","110/08/12","臺銀-民權",8,0,8
"12574","6205詮欣","110/08/12","瑞士信貸",0,4,-4
"12575","6205詮欣","110/08/12","聯邦-嘉義",5,0,5
"12576","6205詮欣","110/08/12","群益金鼎-板橋",0,4,-4
"12577","6205詮欣","110/08/12","中國信託-三重",3,0,3
"12578","6205詮欣","110/08/12","元大-屏東民生",0,4,-4
"12579","6205詮欣","110/08/12","德信-新營",3,0,3
"12580","6205詮欣","110/08/12","臺銀-高雄",0,3,-3
"12581","6205詮欣","110/08/12","合庫-彰化",2,0,2
"12582","6205詮欣","110/08/12","凱基-南崁",0,3,-3
"12583","6205詮欣","110/08/12","新光-台南",2,0,2
"12584","6205詮欣","110/08/12","元大-華山",0,3,-3
"12585","6205詮欣","110/08/12","玉山-雙和",2,0,2
"12586","6205詮欣","110/08/12","摩根大通",0,2,-2
"12587","6205詮欣","110/08/12","元大-南投",2,0,2
"12588","6205詮欣","110/08/12","兆豐-新營",0,1,-1
"12589","6205詮欣","110/08/12","統一-三重",1,0,1
"12590","6205詮欣","110/08/12","兆豐-中壢",0,1,-1
"12591","6205詮欣","110/08/12","元富-安南",1,0,1
"12592","6205詮欣","110/08/12","凱基-台北",0,1,-1
"12593","6205詮欣","110/08/12","豐農",1,0,1
"12594","6205詮欣","110/08/12","凱基-竹科",0,1,-1
"12595","6205詮欣","110/08/12","北城證券",1,0,1
"12596","6205詮欣","110/08/12","富邦-高雄",0,1,-1
"12597","6205詮欣","110/08/12","玉山-嘉義",1,0,1
"12598","6205詮欣","110/08/12","元大-路竹",0,1,-1
"12599","6205詮欣","110/08/12","凱基-五股",1,0,1
"12600","6205詮欣","110/08/12","元大-屏南",0,1,-1
"12601","1540喬福","110/08/12","元富-中原",20,0,20
"12602","1540喬福","110/08/12","永豐金-豐原",0,64,-64
"12603","1540喬福","110/08/12","台中銀",17,0,17
"12604","1540喬福","110/08/12","統一-新台中",0,19,-19
"12605","1540喬福","110/08/12","凱基-中壢",11,0,11
"12606","1540喬福","110/08/12","凱基-興隆",0,7,-7
"12607","1540喬福","110/08/12","凱基-台中",8,0,8
"12608","1540喬福","110/08/12","玉山-城中",0,6,-6
"12609","1540喬福","110/08/12","亞東",5,0,5
"12610","1540喬福","110/08/12","富邦-台北",1,5,-4
"12611","1540喬福","110/08/12","群益金鼎-古亭",5,0,5
"12612","1540喬福","110/08/12","元大-左營",0,2,-2
"12613","1540喬福","110/08/12","美林",4,0,4
"12614","1540喬福","110/08/12","國泰-敦南",0,1,-1
"12615","1540喬福","110/08/12","兆豐-鹿港",4,0,4
"12616","1540喬福","110/08/12","凱基-基隆",0,1,-1
"12617","1540喬福","110/08/12","港商法國興業",3,0,3
"12618","1540喬福","110/08/12","凱基-大里",0,1,-1
"12619","1540喬福","110/08/12","凱基-苗栗",3,0,3
"12620","1540喬福","110/08/12","元富-中壢",0,0,0
"12621","1540喬福","110/08/12","國票-台中",2,0,2
"12622","1540喬福","110/08/12","凱基-竹北",0,0,0
"12623","1540喬福","110/08/12","兆豐-高雄",2,0,2
"12624","1540喬福","110/08/12","凱基-台北",1,1,0
"12625","1540喬福","110/08/12","元富-緯城",2,0,2
"12626","1540喬福","110/08/12","華南永昌-南京",0,0,0
"12627","1540喬福","110/08/12","華南永昌-台中",2,0,2
"12628","1540喬福","110/08/12","富邦-高雄",0,0,0
"12629","1540喬福","110/08/12","富邦-中壢",2,0,2
"12630","1540喬福","110/08/12","富邦-三重",0,0,0
"12631","2888新光金","110/08/12","群益金鼎-崇德",2118,3,2115
"12632","2888新光金","110/08/12","國票-台東",12,1903,-1891
"12633","2888新光金","110/08/12","國票-九鼎",2175,141,2034
"12634","2888新光金","110/08/12","永豐金-竹科",0,1186,-1186
"12635","2888新光金","110/08/12","元大-忠孝鼎富",986,4,982
"12636","2888新光金","110/08/12","群益金鼎-民權",1,1049,-1048
"12637","2888新光金","110/08/12","台灣摩根士丹利",992,319,673
"12638","2888新光金","110/08/12","凱基-台北",1172,2195,-1023
"12639","2888新光金","110/08/12","港商法國興業",670,0,670
"12640","2888新光金","110/08/12","摩根大通",829,1704,-875
"12641","2888新光金","110/08/12","富邦-內湖",605,0,605
"12642","2888新光金","110/08/12","美林",248,668,-420
"12643","2888新光金","110/08/12","華南永昌-台中",600,3,597
"12644","2888新光金","110/08/12","群益金鼎-鳳山",2,404,-402
"12645","2888新光金","110/08/12","元大-豐原站前",556,38,518
"12646","2888新光金","110/08/12","新加坡商瑞銀",470,857,-387
"12647","2888新光金","110/08/12","瑞士信貸",643,139,504
"12648","2888新光金","110/08/12","香港上海匯豐",22,270,-248
"12649","2888新光金","110/08/12","元大-永和",505,8,497
"12650","2888新光金","110/08/12","合庫證券",2,232,-230
"12651","2888新光金","110/08/12","法銀巴黎",498,9,489
"12652","2888新光金","110/08/12","元大-大同",0,214,-214
"12653","2888新光金","110/08/12","福邦-新竹",430,0,430
"12654","2888新光金","110/08/12","元富-文心",2,210,-208
"12655","2888新光金","110/08/12","凱基-鳳山",379,3,376
"12656","2888新光金","110/08/12","新光",154,346,-192
"12657","2888新光金","110/08/12","康和-內湖",306,7,299
"12658","2888新光金","110/08/12","元富-城東",28,215,-187
"12659","2888新光金","110/08/12","元大-樹林",300,10,290
"12660","2888新光金","110/08/12","富邦-彰化",23,201,-178
"12661","1340勝悅","110/08/12","國泰-台中",11,0,11
"12662","1340勝悅","110/08/12","中國信託",0,76,-76
"12663","1340勝悅","110/08/12","元大-博愛",10,0,10
"12664","1340勝悅","110/08/12","日盛-八德",0,14,-14
"12665","1340勝悅","110/08/12","凱基-台北",8,1,7
"12666","1340勝悅","110/08/12","摩根大通",3,13,-10
"12667","1340勝悅","110/08/12","臺灣企銀-埔墘",5,0,5
"12668","1340勝悅","110/08/12","日盛-木柵",0,7,-7
"12669","1340勝悅","110/08/12","第一金-新竹",5,0,5
"12670","1340勝悅","110/08/12","元大-路竹",0,7,-7
"12671","1340勝悅","110/08/12","元富-新興",5,0,5
"12672","1340勝悅","110/08/12","群益金鼎-內湖",0,4,-4
"12673","1340勝悅","110/08/12","兆豐-台南",5,0,5
"12674","1340勝悅","110/08/12","凱基-彰化",0,4,-4
"12675","1340勝悅","110/08/12","玉山-士林",5,0,5
"12676","1340勝悅","110/08/12","元大-大天母",0,3,-3
"12677","1340勝悅","110/08/12","華南永昌-新莊",5,0,5
"12678","1340勝悅","110/08/12","統一-城中",4,6,-2
"12679","1340勝悅","110/08/12","美商高盛",4,0,4
"12680","1340勝悅","110/08/12","兆豐-新竹",0,2,-2
"12681","1340勝悅","110/08/12","港商法國興業",3,0,3
"12682","1340勝悅","110/08/12","台新證券",0,2,-2
"12683","1340勝悅","110/08/12","台新-台中",3,0,3
"12684","1340勝悅","110/08/12","富邦-台南",0,2,-2
"12685","1340勝悅","110/08/12","玉山-台大",3,0,3
"12686","1340勝悅","110/08/12","元大-新營",0,2,-2
"12687","1340勝悅","110/08/12","國泰-高雄",3,0,3
"12688","1340勝悅","110/08/12","瑞士信貸",2,3,-1
"12689","1340勝悅","110/08/12","元大-竹南",3,0,3
"12690","1340勝悅","110/08/12","永豐金-中正",0,1,-1
"12691","6246臺龍","110/08/12","元大-南投",75,0,75
"12692","6246臺龍","110/08/12","統一-台中",0,58,-58
"12693","6246臺龍","110/08/12","元大-台北",32,0,32
"12694","6246臺龍","110/08/12","合庫-台中",1,41,-40
"12695","6246臺龍","110/08/12","元富-世貿",30,2,28
"12696","6246臺龍","110/08/12","凱基-市府",0,40,-40
"12697","6246臺龍","110/08/12","凱基-永和",25,0,25
"12698","6246臺龍","110/08/12","日盛-木柵",4,33,-29
"12699","6246臺龍","110/08/12","元富-新店",18,3,15
"12700","6246臺龍","110/08/12","凱基-台北",1,29,-28
"12701","6246臺龍","110/08/12","華南永昌-忠孝",12,0,12
"12702","6246臺龍","110/08/12","永豐金-內湖",2,30,-28
"12703","6246臺龍","110/08/12","永豐金-復興",12,0,12
"12704","6246臺龍","110/08/12","元大-中壢",23,44,-21
"12705","6246臺龍","110/08/12","富邦-敦南",11,0,11
"12706","6246臺龍","110/08/12","永全-南崁",0,20,-20
"12707","6246臺龍","110/08/12","元大證券",13,2,11
"12708","6246臺龍","110/08/12","國泰-敦南",7,27,-20
"12709","6246臺龍","110/08/12","大慶-蘆洲",10,0,10
"12710","6246臺龍","110/08/12","大昌",0,18,-18
"12711","6246臺龍","110/08/12","元大-新莊",10,0,10
"12712","6246臺龍","110/08/12","新光-台中",3,17,-14
"12713","6246臺龍","110/08/12","元大-林園",10,1,9
"12714","6246臺龍","110/08/12","元大-金門",3,16,-13
"12715","6246臺龍","110/08/12","元大-西屯",10,2,8
"12716","6246臺龍","110/08/12","永全",0,10,-10
"12717","6246臺龍","110/08/12","兆豐-公益",7,0,7
"12718","6246臺龍","110/08/12","元大-新店中正",0,10,-10
"12719","6246臺龍","110/08/12","群益金鼎-開元",7,0,7
"12720","6246臺龍","110/08/12","日盛-八德",0,8,-8
"12721","00715L期街口布蘭特正2","110/08/12","元大證券",13644,167,13477
"12722","00715L期街口布蘭特正2","110/08/12","元大-林森",0,780,-780
"12723","00715L期街口布蘭特正2","110/08/12","永豐金證券",2789,2,2787
"12724","00715L期街口布蘭特正2","110/08/12","台新-新營",12,600,-588
"12725","00715L期街口布蘭特正2","110/08/12","統一",2972,199,2773
"12726","00715L期街口布蘭特正2","110/08/12","台中銀",10,592,-582
"12727","00715L期街口布蘭特正2","110/08/12","元富",1524,5,1519
"12728","00715L期街口布蘭特正2","110/08/12","群益金鼎-屏東",0,575,-575
"12729","00715L期街口布蘭特正2","110/08/12","統一-嘉義",466,26,440
"12730","00715L期街口布蘭特正2","110/08/12","元大-北港",10,505,-495
"12731","00715L期街口布蘭特正2","110/08/12","群益金鼎-延平",300,4,296
"12732","00715L期街口布蘭特正2","110/08/12","兆豐-台中",0,476,-476
"12733","00715L期街口布蘭特正2","110/08/12","台新-三民",300,24,276
"12734","00715L期街口布蘭特正2","110/08/12","宏遠-桃園",0,438,-438
"12735","00715L期街口布蘭特正2","110/08/12","群益金鼎-瑞豐",210,14,196
"12736","00715L期街口布蘭特正2","110/08/12","台新-台中",65,474,-409
"12737","00715L期街口布蘭特正2","110/08/12","港商野村",320,140,180
"12738","00715L期街口布蘭特正2","110/08/12","元大-西螺",3,382,-379
"12739","00715L期街口布蘭特正2","110/08/12","台新-松江",200,35,165
"12740","00715L期街口布蘭特正2","110/08/12","凱基-城中",0,370,-370
"12741","00715L期街口布蘭特正2","110/08/12","合庫證券",121,0,121
"12742","00715L期街口布蘭特正2","110/08/12","元大-歸仁",20,384,-364
"12743","00715L期街口布蘭特正2","110/08/12","元大-旗山",120,1,119
"12744","00715L期街口布蘭特正2","110/08/12","群益金鼎-古亭",13,367,-354
"12745","00715L期街口布蘭特正2","110/08/12","富邦-員林",362,251,111
"12746","00715L期街口布蘭特正2","110/08/12","元大-竹科",6,327,-321
"12747","00715L期街口布蘭特正2","110/08/12","日盛-木柵",130,22,108
"12748","00715L期街口布蘭特正2","110/08/12","臺銀-新竹",0,320,-320
"12749","00715L期街口布蘭特正2","110/08/12","大慶-苗栗",107,2,105
"12750","00715L期街口布蘭特正2","110/08/12","統一-台中",7,325,-318
"12751","8941關中","110/08/12","元大-金華",1,0,1
"12752","8941關中","110/08/12","凱基-士林",0,2,-2
"12753","8941關中","110/08/12","元大-桃興",1,0,1
"12754","8941關中","110/08/12","(牛牛牛)亞-鑫豐",0,0,0
"12755","8941關中","110/08/12","(牛牛牛)亞-鑫豐",0,0,0
"12756","8941關中","110/08/12","台新-三民",0,0,0
"12757","8941關中","110/08/12","台新-三民",0,0,0
"12758","8941關中","110/08/12","國泰-忠孝",1,1,0
"12759","8941關中","110/08/12","國泰-忠孝",1,1,0
"12760","8941關中","110/08/12","凱基-市府",1,1,0
"12761","8941關中","110/08/12","凱基-市府",1,1,0
"12762","8941關中","110/08/12","",NA,NA,NA
"12763","8941關中","110/08/12","",NA,NA,NA
"12764","8941關中","110/08/12","",NA,NA,NA
"12765","8941關中","110/08/12","",NA,NA,NA
"12766","8941關中","110/08/12","",NA,NA,NA
"12767","8941關中","110/08/12","",NA,NA,NA
"12768","8941關中","110/08/12","",NA,NA,NA
"12769","8941關中","110/08/12","",NA,NA,NA
"12770","8941關中","110/08/12","",NA,NA,NA
"12771","8941關中","110/08/12","",NA,NA,NA
"12772","8941關中","110/08/12","",NA,NA,NA
"12773","8941關中","110/08/12","",NA,NA,NA
"12774","8941關中","110/08/12","",NA,NA,NA
"12775","8941關中","110/08/12","",NA,NA,NA
"12776","8941關中","110/08/12","",NA,NA,NA
"12777","8941關中","110/08/12","",NA,NA,NA
"12778","8941關中","110/08/12","",NA,NA,NA
"12779","8941關中","110/08/12","",NA,NA,NA
"12780","8941關中","110/08/12","",NA,NA,NA
"12781","8936國統","110/08/12","台新-高雄",410,32,378
"12782","8936國統","110/08/12","日盛-景美",0,70,-70
"12783","8936國統","110/08/12","元富-林園",65,0,65
"12784","8936國統","110/08/12","臺銀-金山",0,55,-55
"12785","8936國統","110/08/12","摩根大通",64,12,52
"12786","8936國統","110/08/12","元大-敦南",0,32,-32
"12787","8936國統","110/08/12","新加坡商瑞銀",53,31,22
"12788","8936國統","110/08/12","華南永昌-南京",0,30,-30
"12789","8936國統","110/08/12","元大-莒光",19,0,19
"12790","8936國統","110/08/12","玉山-台南",0,23,-23
"12791","8936國統","110/08/12","第一金-高雄",10,0,10
"12792","8936國統","110/08/12","兆豐-岡山",1,21,-20
"12793","8936國統","110/08/12","統一-高雄",10,0,10
"12794","8936國統","110/08/12","統一-新竹",0,14,-14
"12795","8936國統","110/08/12","元富-桃園",10,0,10
"12796","8936國統","110/08/12","國泰-敦南",1,14,-13
"12797","8936國統","110/08/12","台新-台南",10,0,10
"12798","8936國統","110/08/12","台灣摩根士丹利",2,14,-12
"12799","8936國統","110/08/12","元大-竹山",9,0,9
"12800","8936國統","110/08/12","凱基-台南",3,14,-11
"12801","8936國統","110/08/12","港商野村",15,8,7
"12802","8936國統","110/08/12","凱基-高美館",0,11,-11
"12803","8936國統","110/08/12","華南永昌-高雄",6,0,6
"12804","8936國統","110/08/12","元大-博愛",0,10,-10
"12805","8936國統","110/08/12","土銀-高雄",5,0,5
"12806","8936國統","110/08/12","第一金-新興",0,9,-9
"12807","8936國統","110/08/12","大昌-安康",5,0,5
"12808","8936國統","110/08/12","元大-沙鹿",0,9,-9
"12809","8936國統","110/08/12","兆豐-斗南",5,0,5
"12810","8936國統","110/08/12","元大-左營",3,12,-9
"12811","6226光鼎","110/08/12","摩根大通",1930,830,1100
"12812","6226光鼎","110/08/12","凱基-台北",224,675,-451
"12813","6226光鼎","110/08/12","第一金-大稻埕",418,0,418
"12814","6226光鼎","110/08/12","統一-高雄",1,353,-352
"12815","6226光鼎","110/08/12","台新-中壢",239,3,236
"12816","6226光鼎","110/08/12","美林",153,291,-138
"12817","6226光鼎","110/08/12","元大-文心興安",223,27,196
"12818","6226光鼎","110/08/12","大昌",88,225,-137
"12819","6226光鼎","110/08/12","富邦-陽明",112,9,103
"12820","6226光鼎","110/08/12","元大-土城永寧",3,126,-123
"12821","6226光鼎","110/08/12","華南永昌-高雄",96,13,83
"12822","6226光鼎","110/08/12","元大-北屯",16,107,-91
"12823","6226光鼎","110/08/12","永豐金-南投",95,13,82
"12824","6226光鼎","110/08/12","統一-板橋",0,88,-88
"12825","6226光鼎","110/08/12","永豐金-中盛",102,26,76
"12826","6226光鼎","110/08/12","群益金鼎-東大",5,91,-86
"12827","6226光鼎","110/08/12","元大證券",90,15,75
"12828","6226光鼎","110/08/12","富邦-南屯",40,111,-71
"12829","6226光鼎","110/08/12","元大-屏東民生",85,15,70
"12830","6226光鼎","110/08/12","新光",240,309,-69
"12831","6226光鼎","110/08/12","台灣摩根士丹利",93,32,61
"12832","6226光鼎","110/08/12","台新-高雄",75,143,-68
"12833","6226光鼎","110/08/12","富邦-高雄",121,66,55
"12834","6226光鼎","110/08/12","日盛證券",10,76,-66
"12835","6226光鼎","110/08/12","臺銀",106,54,52
"12836","6226光鼎","110/08/12","國泰-敦南",391,457,-66
"12837","6226光鼎","110/08/12","台灣企銀-三民",58,8,50
"12838","6226光鼎","110/08/12","富邦-台北",31,97,-66
"12839","6226光鼎","110/08/12","元大-新竹",250,200,50
"12840","6226光鼎","110/08/12","凱基-永和",30,91,-61
"12841","2363矽統","110/08/12","元大-佳里",810,33,777
"12842","2363矽統","110/08/12","凱基-台北",1783,3582,-1799
"12843","2363矽統","110/08/12","元大-大同",455,30,425
"12844","2363矽統","110/08/12","台灣摩根士丹利",0,959,-959
"12845","2363矽統","110/08/12","富邦-建國",503,100,403
"12846","2363矽統","110/08/12","華南永昌-斗六",90,1037,-947
"12847","2363矽統","110/08/12","北城證券",434,34,400
"12848","2363矽統","110/08/12","群益金鼎-敦南",27,331,-304
"12849","2363矽統","110/08/12","元大-開元",321,33,288
"12850","2363矽統","110/08/12","美商高盛",57,327,-270
"12851","2363矽統","110/08/12","台新-三民",287,84,203
"12852","2363矽統","110/08/12","大慶-蘆洲",26,233,-207
"12853","2363矽統","110/08/12","台中銀",157,23,134
"12854","2363矽統","110/08/12","新光-台南",130,324,-194
"12855","2363矽統","110/08/12","元大-新竹經國",152,21,131
"12856","2363矽統","110/08/12","美林",927,1076,-149
"12857","2363矽統","110/08/12","台新-高雄",449,322,127
"12858","2363矽統","110/08/12","華南永昌-頭份",187,328,-141
"12859","2363矽統","110/08/12","華南永昌",254,163,91
"12860","2363矽統","110/08/12","陽信-石牌",157,276,-119
"12861","2363矽統","110/08/12","凱基-城中",98,13,85
"12862","2363矽統","110/08/12","兆豐證券",0,104,-104
"12863","2363矽統","110/08/12","台中銀-台北",85,4,81
"12864","2363矽統","110/08/12","元大-忠孝鼎富",32,132,-100
"12865","2363矽統","110/08/12","元大-新莊",140,60,80
"12866","2363矽統","110/08/12","元大-鳳中",85,185,-100
"12867","2363矽統","110/08/12","玉山-台中",116,41,75
"12868","2363矽統","110/08/12","永豐金-桃盛",24,119,-95
"12869","2363矽統","110/08/12","元富-彰化",88,23,65
"12870","2363矽統","110/08/12","元大證券",51,145,-94
"12871","8112至上","110/08/12","摩根大通",1492,130,1362
"12872","8112至上","110/08/12","永豐金-台中",0,274,-274
"12873","8112至上","110/08/12","美林",712,13,699
"12874","8112至上","110/08/12","永豐金證券",8,272,-264
"12875","8112至上","110/08/12","台灣摩根士丹利",696,41,655
"12876","8112至上","110/08/12","群益金鼎-基隆",0,249,-249
"12877","8112至上","110/08/12","凱基-台北",582,82,500
"12878","8112至上","110/08/12","國票-長城",2,228,-226
"12879","8112至上","110/08/12","新加坡商瑞銀",359,18,341
"12880","8112至上","110/08/12","新光-新竹",19,208,-189
"12881","8112至上","110/08/12","花旗環球",266,0,266
"12882","8112至上","110/08/12","玉山-嘉義",20,168,-148
"12883","8112至上","110/08/12","富邦-仁愛",231,25,206
"12884","8112至上","110/08/12","元大-高雄",0,131,-131
"12885","8112至上","110/08/12","美商高盛",190,3,187
"12886","8112至上","110/08/12","臺灣企銀-桃園",128,251,-123
"12887","8112至上","110/08/12","凱基-三重",121,6,115
"12888","8112至上","110/08/12","元大-府城",0,115,-115
"12889","8112至上","110/08/12","港商野村",198,88,110
"12890","8112至上","110/08/12","台新證券",100,203,-103
"12891","8112至上","110/08/12","國票-中港",101,0,101
"12892","8112至上","110/08/12","康和-板橋",5,106,-101
"12893","8112至上","110/08/12","日盛-新竹",80,3,77
"12894","8112至上","110/08/12","元大-北成功",0,101,-101
"12895","8112至上","110/08/12","兆豐-斗南",71,8,63
"12896","8112至上","110/08/12","元大-永和",5,88,-83
"12897","8112至上","110/08/12","大慶",63,1,62
"12898","8112至上","110/08/12","群益金鼎-內湖",0,80,-80
"12899","8112至上","110/08/12","群益金鼎-竹南",57,1,56
"12900","8112至上","110/08/12","元大-南勢角",0,80,-80
"12901","1570力肯","110/08/12","台新證券",91,15,76
"12902","1570力肯","110/08/12","國票-北高雄",2,361,-359
"12903","1570力肯","110/08/12","元大-南投",81,5,76
"12904","1570力肯","110/08/12","新光",95,222,-127
"12905","1570力肯","110/08/12","永全-南崁",94,20,74
"12906","1570力肯","110/08/12","(牛牛牛)亞-鑫豐",28,120,-92
"12907","1570力肯","110/08/12","日盛-忠孝",57,0,57
"12908","1570力肯","110/08/12","華南永昌-高雄",0,52,-52
"12909","1570力肯","110/08/12","永豐金-北高雄",55,0,55
"12910","1570力肯","110/08/12","群益金鼎-三重",0,42,-42
"12911","1570力肯","110/08/12","中國信託-高雄",72,22,50
"12912","1570力肯","110/08/12","日盛-八德",2,39,-37
"12913","1570力肯","110/08/12","凱基-天母",49,0,49
"12914","1570力肯","110/08/12","新光-台中",130,167,-37
"12915","1570力肯","110/08/12","新光-台南",56,18,38
"12916","1570力肯","110/08/12","日盛-樹林",1,31,-30
"12917","1570力肯","110/08/12","兆豐-嘉義",35,0,35
"12918","1570力肯","110/08/12","元大-竹北",0,30,-30
"12919","1570力肯","110/08/12","國票-天祥",32,1,31
"12920","1570力肯","110/08/12","元大-楊梅",6,35,-29
"12921","1570力肯","110/08/12","國泰-松江",81,51,30
"12922","1570力肯","110/08/12","元大-桃興",4,32,-28
"12923","1570力肯","110/08/12","元大-新店中正",33,3,30
"12924","1570力肯","110/08/12","亞東-台中",0,26,-26
"12925","1570力肯","110/08/12","統一",48,21,27
"12926","1570力肯","110/08/12","永豐金-屏東",5,30,-25
"12927","1570力肯","110/08/12","國票-內壢",26,0,26
"12928","1570力肯","110/08/12","國泰-館前",0,24,-24
"12929","1570力肯","110/08/12","元大-大益",27,1,26
"12930","1570力肯","110/08/12","摩根大通",173,193,-20
"12931","2929淘帝","110/08/12","摩根大通",47,0,47
"12932","2929淘帝","110/08/12","華南永昌-彰化",0,30,-30
"12933","2929淘帝","110/08/12","宏遠-館前",40,0,40
"12934","2929淘帝","110/08/12","第一金-大稻埕",0,10,-10
"12935","2929淘帝","110/08/12","富邦-高雄",16,0,16
"12936","2929淘帝","110/08/12","統一-敦南",0,10,-10
"12937","2929淘帝","110/08/12","兆豐-內湖",15,0,15
"12938","2929淘帝","110/08/12","玉山-台南",0,10,-10
"12939","2929淘帝","110/08/12","港商野村",29,15,14
"12940","2929淘帝","110/08/12","元大-花蓮",0,10,-10
"12941","2929淘帝","110/08/12","元富-台南",10,0,10
"12942","2929淘帝","110/08/12","凱基-台中",0,9,-9
"12943","2929淘帝","110/08/12","豐農",10,0,10
"12944","2929淘帝","110/08/12","群益金鼎-潭子",0,8,-8
"12945","2929淘帝","110/08/12","群益金鼎-三重",10,0,10
"12946","2929淘帝","110/08/12","新加坡商瑞銀",10,17,-7
"12947","2929淘帝","110/08/12","永豐金證券",10,0,10
"12948","2929淘帝","110/08/12","新光-高雄",0,7,-7
"12949","2929淘帝","110/08/12","永豐金-敦南",10,0,10
"12950","2929淘帝","110/08/12","亞東-板橋",0,6,-6
"12951","2929淘帝","110/08/12","凱基-八德",6,0,6
"12952","2929淘帝","110/08/12","元富-中港",0,6,-6
"12953","2929淘帝","110/08/12","台新-新莊",5,0,5
"12954","2929淘帝","110/08/12","國泰-敦南",1,7,-6
"12955","2929淘帝","110/08/12","群益金鼎-中山",5,0,5
"12956","2929淘帝","110/08/12","永豐金-市政",0,6,-6
"12957","2929淘帝","110/08/12","凱基-幸福",5,0,5
"12958","2929淘帝","110/08/12","永豐金-中盛",10,16,-6
"12959","2929淘帝","110/08/12","元富-新竹",4,0,4
"12960","2929淘帝","110/08/12","台新-三民",0,5,-5
"12961","5410國眾","110/08/12","凱基-八德",23,0,23
"12962","5410國眾","110/08/12","國泰-敦南",1,101,-100
"12963","5410國眾","110/08/12","元大-大灣",11,0,11
"12964","5410國眾","110/08/12","第一金-華江",0,27,-27
"12965","5410國眾","110/08/12","合庫-新竹",10,0,10
"12966","5410國眾","110/08/12","元大-竹科",0,17,-17
"12967","5410國眾","110/08/12","凱基-虎尾",10,0,10
"12968","5410國眾","110/08/12","元大-歸仁",1,15,-14
"12969","5410國眾","110/08/12","富邦-竹北",10,0,10
"12970","5410國眾","110/08/12","日盛-八德",0,10,-10
"12971","5410國眾","110/08/12","玉山-新莊",9,0,9
"12972","5410國眾","110/08/12","華南永昌-潮州",0,10,-10
"12973","5410國眾","110/08/12","玉山-台大",8,0,8
"12974","5410國眾","110/08/12","富邦-板橋",0,7,-7
"12975","5410國眾","110/08/12","凱基-桃園",8,0,8
"12976","5410國眾","110/08/12","凱基-高雄",0,6,-6
"12977","5410國眾","110/08/12","日盛-永康",7,0,7
"12978","5410國眾","110/08/12","元大-忠孝",0,6,-6
"12979","5410國眾","110/08/12","玉山-雙和",7,0,7
"12980","5410國眾","110/08/12","凱基-汐止",0,5,-5
"12981","5410國眾","110/08/12","元大-彰化",7,0,7
"12982","5410國眾","110/08/12","凱基-台北",0,5,-5
"12983","5410國眾","110/08/12","元大-崇德",7,0,7
"12984","5410國眾","110/08/12","元富-花蓮",0,4,-4
"12985","5410國眾","110/08/12","國泰-館前",6,0,6
"12986","5410國眾","110/08/12","凱基-岡山",0,4,-4
"12987","5410國眾","110/08/12","國泰-板橋",8,2,6
"12988","5410國眾","110/08/12","瑞士信貸",0,3,-3
"12989","5410國眾","110/08/12","元富-桃園",5,0,5
"12990","5410國眾","110/08/12","富邦-台中",0,3,-3
"12991","2841台開","110/08/12","宏遠-館前",370,0,370
"12992","2841台開","110/08/12","永豐金-敦南",4,134,-130
"12993","2841台開","110/08/12","永豐金-豐原",94,0,94
"12994","2841台開","110/08/12","港商野村",0,85,-85
"12995","2841台開","110/08/12","富邦-北港",53,0,53
"12996","2841台開","110/08/12","國泰-忠孝",1,40,-39
"12997","2841台開","110/08/12","新光-台中",20,0,20
"12998","2841台開","110/08/12","富邦-仁愛",0,38,-38
"12999","2841台開","110/08/12","凱基-高美館",20,0,20
"13000","2841台開","110/08/12","新加坡商瑞銀",0,27,-27
"13001","2841台開","110/08/12","元大-左營",20,0,20
"13002","2841台開","110/08/12","統一-嘉義",0,21,-21
"13003","2841台開","110/08/12","元大-基隆孝二",11,0,11
"13004","2841台開","110/08/12","日盛-忠孝",0,20,-20
"13005","2841台開","110/08/12","元大-路竹",10,0,10
"13006","2841台開","110/08/12","日盛-中壢",0,20,-20
"13007","2841台開","110/08/12","華南永昌-虎尾",9,0,9
"13008","2841台開","110/08/12","宏遠-桃園",0,20,-20
"13009","2841台開","110/08/12","康和-台北",6,0,6
"13010","2841台開","110/08/12","群益金鼎-南京",0,20,-20
"13011","2841台開","110/08/12","致和-東門",5,0,5
"13012","2841台開","110/08/12","合庫-基隆",0,18,-18
"13013","2841台開","110/08/12","元大-虎尾",5,0,5
"13014","2841台開","110/08/12","日盛證券",0,17,-17
"13015","2841台開","110/08/12","元大-莒光",5,0,5
"13016","2841台開","110/08/12","元大-歸仁",0,15,-15
"13017","2841台開","110/08/12","永豐金-桃園",5,0,5
"13018","2841台開","110/08/12","新光",10,21,-11
"13019","2841台開","110/08/12","新光-台南",4,0,4
"13020","2841台開","110/08/12","群益金鼎-天母",0,11,-11
"13021","6207雷科","110/08/12","摩根大通",125,11,114
"13022","6207雷科","110/08/12","凱基-復興",0,120,-120
"13023","6207雷科","110/08/12","凱基-台北",96,1,95
"13024","6207雷科","110/08/12","元大-鳳山",0,62,-62
"13025","6207雷科","110/08/12","美林",38,3,35
"13026","6207雷科","110/08/12","日盛證券",0,56,-56
"13027","6207雷科","110/08/12","兆豐-南京",30,0,30
"13028","6207雷科","110/08/12","日盛-忠孝",0,48,-48
"13029","6207雷科","110/08/12","港商野村",27,1,26
"13030","6207雷科","110/08/12","日盛-桃園",0,11,-11
"13031","6207雷科","110/08/12","元大-南京",20,0,20
"13032","6207雷科","110/08/12","中國信託-高雄",0,10,-10
"13033","6207雷科","110/08/12","臺銀-臺南",12,0,12
"13034","6207雷科","110/08/12","元大-土城永寧",0,10,-10
"13035","6207雷科","110/08/12","瑞士信貸",11,0,11
"13036","6207雷科","110/08/12","凱基-湖口",0,8,-8
"13037","6207雷科","110/08/12","新加坡商瑞銀",20,11,9
"13038","6207雷科","110/08/12","富邦-敦南",0,7,-7
"13039","6207雷科","110/08/12","第一金-新興",6,0,6
"13040","6207雷科","110/08/12","凱基-三峽",0,6,-6
"13041","6207雷科","110/08/12","群益金鼎-士林",6,0,6
"13042","6207雷科","110/08/12","永豐金-高雄",0,6,-6
"13043","6207雷科","110/08/12","群益金鼎-瑞豐",6,0,6
"13044","6207雷科","110/08/12","宏遠證券",0,5,-5
"13045","6207雷科","110/08/12","兆豐-來福",5,0,5
"13046","6207雷科","110/08/12","元富-彰化",0,5,-5
"13047","6207雷科","110/08/12","華南永昌-彰化",5,0,5
"13048","6207雷科","110/08/12","凱基-岡山",0,5,-5
"13049","6207雷科","110/08/12","富邦-中壢",5,0,5
"13050","6207雷科","110/08/12","富邦-建國",0,5,-5
"13051","3679新至陞","110/08/12","台灣摩根士丹利",10,0,10
"13052","3679新至陞","110/08/12","元大-成功",0,10,-10
"13053","3679新至陞","110/08/12","國泰-松江",8,0,8
"13054","3679新至陞","110/08/12","新加坡商瑞銀",0,7,-7
"13055","3679新至陞","110/08/12","元大-大同",3,0,3
"13056","3679新至陞","110/08/12","摩根大通",2,6,-4
"13057","3679新至陞","110/08/12","聯邦-三重",2,0,2
"13058","3679新至陞","110/08/12","瑞士信貸",0,3,-3
"13059","3679新至陞","110/08/12","凱基-站前",2,0,2
"13060","3679新至陞","110/08/12","港商野村",0,3,-3
"13061","3679新至陞","110/08/12","日盛-板橋",1,0,1
"13062","3679新至陞","110/08/12","凱基-新豐",0,3,-3
"13063","3679新至陞","110/08/12","日盛-龍潭",1,0,1
"13064","3679新至陞","110/08/12","元大證券",0,3,-3
"13065","3679新至陞","110/08/12","美商高盛",1,0,1
"13066","3679新至陞","110/08/12","康和-板橋",0,2,-2
"13067","3679新至陞","110/08/12","大慶-蘆洲",1,0,1
"13068","3679新至陞","110/08/12","富邦-台北",0,2,-2
"13069","3679新至陞","110/08/12","元富-民權",1,0,1
"13070","3679新至陞","110/08/12","元大-土城永寧",0,2,-2
"13071","3679新至陞","110/08/12","元富-花蓮",1,0,1
"13072","3679新至陞","110/08/12","彰銀",0,1,-1
"13073","3679新至陞","110/08/12","(牛牛牛)亞-網路",1,0,1
"13074","3679新至陞","110/08/12","大慶-富順",0,1,-1
"13075","3679新至陞","110/08/12","光和-溪湖",1,0,1
"13076","3679新至陞","110/08/12","台中銀-豐原",0,1,-1
"13077","3679新至陞","110/08/12","兆豐-城中",1,0,1
"13078","3679新至陞","110/08/12","兆豐-東門",0,1,-1
"13079","3679新至陞","110/08/12","兆豐-岡山",1,0,1
"13080","3679新至陞","110/08/12","凱基-新店",0,1,-1
"13081","2727王品","110/08/12","新光",25,8,17
"13082","2727王品","110/08/12","美林",0,76,-76
"13083","2727王品","110/08/12","彰銀-台中",14,2,12
"13084","2727王品","110/08/12","新加坡商瑞銀",0,52,-52
"13085","2727王品","110/08/12","康和-澎湖",10,0,10
"13086","2727王品","110/08/12","凱基-台北",2,38,-36
"13087","2727王品","110/08/12","富邦-建國",10,1,9
"13088","2727王品","110/08/12","國泰證券",0,22,-22
"13089","2727王品","110/08/12","永豐金-中正",9,0,9
"13090","2727王品","110/08/12","統一",1,19,-18
"13091","2727王品","110/08/12","中國信託",12,4,8
"13092","2727王品","110/08/12","元大證券",5,21,-16
"13093","2727王品","110/08/12","國泰-敦南",9,1,8
"13094","2727王品","110/08/12","永豐金證券",0,16,-16
"13095","2727王品","110/08/12","日盛-景美",8,1,7
"13096","2727王品","110/08/12","港商野村",4,15,-11
"13097","2727王品","110/08/12","元富-永和",7,0,7
"13098","2727王品","110/08/12","元富-大昌",0,8,-8
"13099","2727王品","110/08/12","富邦-新店",7,0,7
"13100","2727王品","110/08/12","元大-沙鹿",0,8,-8
"13101","2727王品","110/08/12","日盛-木柵",6,0,6
"13102","2727王品","110/08/12","元大-板橋",5,10,-5
"13103","2727王品","110/08/12","日盛-屏東",7,1,6
"13104","2727王品","110/08/12","永豐金-彰化",0,5,-5
"13105","2727王品","110/08/12","台新-三民",7,1,6
"13106","2727王品","110/08/12","大慶-泰山",0,4,-4
"13107","2727王品","110/08/12","凱基-三重",6,0,6
"13108","2727王品","110/08/12","台中銀",0,4,-4
"13109","2727王品","110/08/12","第一金-台南",5,0,5
"13110","2727王品","110/08/12","康和",0,4,-4
"13111","1570力肯","110/08/12","台新證券",91,15,76
"13112","1570力肯","110/08/12","國票-北高雄",2,361,-359
"13113","1570力肯","110/08/12","元大-南投",81,5,76
"13114","1570力肯","110/08/12","新光",95,222,-127
"13115","1570力肯","110/08/12","永全-南崁",94,20,74
"13116","1570力肯","110/08/12","(牛牛牛)亞-鑫豐",28,120,-92
"13117","1570力肯","110/08/12","日盛-忠孝",57,0,57
"13118","1570力肯","110/08/12","華南永昌-高雄",0,52,-52
"13119","1570力肯","110/08/12","永豐金-北高雄",55,0,55
"13120","1570力肯","110/08/12","群益金鼎-三重",0,42,-42
"13121","1570力肯","110/08/12","中國信託-高雄",72,22,50
"13122","1570力肯","110/08/12","日盛-八德",2,39,-37
"13123","1570力肯","110/08/12","凱基-天母",49,0,49
"13124","1570力肯","110/08/12","新光-台中",130,167,-37
"13125","1570力肯","110/08/12","新光-台南",56,18,38
"13126","1570力肯","110/08/12","日盛-樹林",1,31,-30
"13127","1570力肯","110/08/12","兆豐-嘉義",35,0,35
"13128","1570力肯","110/08/12","元大-竹北",0,30,-30
"13129","1570力肯","110/08/12","國票-天祥",32,1,31
"13130","1570力肯","110/08/12","元大-楊梅",6,35,-29
"13131","1570力肯","110/08/12","國泰-松江",81,51,30
"13132","1570力肯","110/08/12","元大-桃興",4,32,-28
"13133","1570力肯","110/08/12","元大-新店中正",33,3,30
"13134","1570力肯","110/08/12","亞東-台中",0,26,-26
"13135","1570力肯","110/08/12","統一",48,21,27
"13136","1570力肯","110/08/12","永豐金-屏東",5,30,-25
"13137","1570力肯","110/08/12","國票-內壢",26,0,26
"13138","1570力肯","110/08/12","國泰-館前",0,24,-24
"13139","1570力肯","110/08/12","元大-大益",27,1,26
"13140","1570力肯","110/08/12","摩根大通",173,193,-20
"13141","6180橘子","110/08/12","第一金-忠孝",54,0,54
"13142","6180橘子","110/08/12","台灣企銀-屏東",0,30,-30
"13143","6180橘子","110/08/12","美林",35,0,35
"13144","6180橘子","110/08/12","元大-斗信",0,20,-20
"13145","6180橘子","110/08/12","凱基-台北",27,0,27
"13146","6180橘子","110/08/12","永豐金-信義",0,15,-15
"13147","6180橘子","110/08/12","美商高盛",23,2,21
"13148","6180橘子","110/08/12","玉山-桃園",0,14,-14
"13149","6180橘子","110/08/12","元大-前金",20,0,20
"13150","6180橘子","110/08/12","兆豐-埔墘",0,10,-10
"13151","6180橘子","110/08/12","摩根大通",21,5,16
"13152","6180橘子","110/08/12","富邦-高雄",0,10,-10
"13153","6180橘子","110/08/12","元大-敦南",11,0,11
"13154","6180橘子","110/08/12","台新-新營",1,10,-9
"13155","6180橘子","110/08/12","統一-基隆",10,0,10
"13156","6180橘子","110/08/12","富邦-員林",0,9,-9
"13157","6180橘子","110/08/12","元大證券",6,0,6
"13158","6180橘子","110/08/12","台灣摩根士丹利",4,11,-7
"13159","6180橘子","110/08/12","日盛-樹林",5,0,5
"13160","6180橘子","110/08/12","大慶-蘆洲",0,7,-7
"13161","6180橘子","110/08/12","新光-新竹",6,1,5
"13162","6180橘子","110/08/12","元大-北三重",0,7,-7
"13163","6180橘子","110/08/12","元大-上新莊",5,0,5
"13164","6180橘子","110/08/12","新光",1,6,-5
"13165","6180橘子","110/08/12","新加坡商瑞銀",3,0,3
"13166","6180橘子","110/08/12","華南永昌-虎尾",0,5,-5
"13167","6180橘子","110/08/12","統一-中壢",3,0,3
"13168","6180橘子","110/08/12","元大-屏南",0,5,-5
"13169","6180橘子","110/08/12","元富-新店",3,0,3
"13170","6180橘子","110/08/12","群益金鼎-東湖",1,5,-4
"13171","2390云辰","110/08/12","美林",245,9,236
"13172","2390云辰","110/08/12","臺銀-臺中",2,218,-216
"13173","2390云辰","110/08/12","新加坡商瑞銀",90,20,70
"13174","2390云辰","110/08/12","兆豐-寶成",0,185,-185
"13175","2390云辰","110/08/12","台灣摩根士丹利",59,2,57
"13176","2390云辰","110/08/12","元大-板橋三民",1,70,-69
"13177","2390云辰","110/08/12","凱基-台北",127,72,55
"13178","2390云辰","110/08/12","永豐金-松山",5,70,-65
"13179","2390云辰","110/08/12","元大-豐原站前",51,1,50
"13180","2390云辰","110/08/12","富邦-建國",11,62,-51
"13181","2390云辰","110/08/12","港商野村",198,154,44
"13182","2390云辰","110/08/12","元大-土城學府",36,70,-34
"13183","2390云辰","110/08/12","凱基-站前",54,10,44
"13184","2390云辰","110/08/12","元大-土城永寧",10,39,-29
"13185","2390云辰","110/08/12","元大-北三重",34,2,32
"13186","2390云辰","110/08/12","群益金鼎-中壢",3,30,-27
"13187","2390云辰","110/08/12","凱基-民權",30,0,30
"13188","2390云辰","110/08/12","元大-新竹",3,30,-27
"13189","2390云辰","110/08/12","華南永昌-岡山",28,0,28
"13190","2390云辰","110/08/12","元富-城東",2,28,-26
"13191","2390云辰","110/08/12","元富-同大",34,7,27
"13192","2390云辰","110/08/12","群益金鼎-三民",2,26,-24
"13193","2390云辰","110/08/12","元大-路竹",45,20,25
"13194","2390云辰","110/08/12","台新-左楠",28,50,-22
"13195","2390云辰","110/08/12","國票-博愛",34,11,23
"13196","2390云辰","110/08/12","中農",1,23,-22
"13197","2390云辰","110/08/12","元大-台南",25,2,23
"13198","2390云辰","110/08/12","聯邦商銀",0,22,-22
"13199","2390云辰","110/08/12","群益金鼎-開元",30,8,22
"13200","2390云辰","110/08/12","元富-新店",2,23,-21
"13201","2867三商壽","110/08/11","摩根大通",509,31,478
"13202","2867三商壽","110/08/11","港商野村",13,188,-175
"13203","2867三商壽","110/08/11","美商高盛",157,17,140
"13204","2867三商壽","110/08/11","宏遠-高雄",0,150,-150
"13205","2867三商壽","110/08/11","凱基-台北",123,14,109
"13206","2867三商壽","110/08/11","日盛-鳳山",0,73,-73
"13207","2867三商壽","110/08/11","凱基-八德",101,0,101
"13208","2867三商壽","110/08/11","德信-中正",0,71,-71
"13209","2867三商壽","110/08/11","統一-平鎮",100,0,100
"13210","2867三商壽","110/08/11","凱基-新豐",1,67,-66
"13211","2867三商壽","110/08/11","元大-土城永寧",94,5,89
"13212","2867三商壽","110/08/11","土銀-新竹",0,60,-60
"13213","2867三商壽","110/08/11","元大-沙鹿",63,0,63
"13214","2867三商壽","110/08/11","凱基-中港",0,55,-55
"13215","2867三商壽","110/08/11","新加坡商瑞銀",55,1,54
"13216","2867三商壽","110/08/11","中國信託-文心",11,61,-50
"13217","2867三商壽","110/08/11","台灣摩根士丹利",60,10,50
"13218","2867三商壽","110/08/11","國泰-新莊",2,50,-48
"13219","2867三商壽","110/08/11","元富-潮州",41,0,41
"13220","2867三商壽","110/08/11","群益金鼎",0,40,-40
"13221","2867三商壽","110/08/11","統一-汐止",40,0,40
"13222","2867三商壽","110/08/11","元大-大益",0,40,-40
"13223","2867三商壽","110/08/11","新光-高雄",40,4,36
"13224","2867三商壽","110/08/11","富邦-板橋",5,38,-33
"13225","2867三商壽","110/08/11","玉山-板橋",31,1,30
"13226","2867三商壽","110/08/11","元富-古亭",0,30,-30
"13227","2867三商壽","110/08/11","美林",194,168,26
"13228","2867三商壽","110/08/11","元大-金華",0,30,-30
"13229","2867三商壽","110/08/11","凱基",24,0,24
"13230","2867三商壽","110/08/11","元大-汐止",13,42,-29
"13231","5521工信","110/08/11","摩根大通",417,16,401
"13232","5521工信","110/08/11","元大-沙鹿",0,103,-103
"13233","5521工信","110/08/11","凱基-台北",86,5,81
"13234","5521工信","110/08/11","華南永昌",0,43,-43
"13235","5521工信","110/08/11","日進",73,0,73
"13236","5521工信","110/08/11","聯邦-雙和",0,42,-42
"13237","5521工信","110/08/11","日盛證券",70,0,70
"13238","5521工信","110/08/11","元富-基隆",0,38,-38
"13239","5521工信","110/08/11","富邦-台北",65,0,65
"13240","5521工信","110/08/11","第一金-路竹",0,37,-37
"13241","5521工信","110/08/11","富邦-苗栗",50,0,50
"13242","5521工信","110/08/11","土銀-台中",0,35,-35
"13243","5521工信","110/08/11","永豐金-鳳山",40,1,39
"13244","5521工信","110/08/11","玉山-高雄",0,30,-30
"13245","5521工信","110/08/11","台灣企銀-北高雄",30,0,30
"13246","5521工信","110/08/11","凱基-台南",0,30,-30
"13247","5521工信","110/08/11","美林",71,42,29
"13248","5521工信","110/08/11","凱基-復興",0,30,-30
"13249","5521工信","110/08/11","台新-台中",31,6,25
"13250","5521工信","110/08/11","元大-屏南",0,30,-30
"13251","5521工信","110/08/11","凱基-鳳山",20,0,20
"13252","5521工信","110/08/11","永豐金-天母",0,30,-30
"13253","5521工信","110/08/11","元大-東蘆",20,0,20
"13254","5521工信","110/08/11","華南永昌-潮州",4,32,-28
"13255","5521工信","110/08/11","群益金鼎-士林",21,3,18
"13256","5521工信","110/08/11","華南永昌-彰化",13,39,-26
"13257","5521工信","110/08/11","永豐金證券",14,0,14
"13258","5521工信","110/08/11","日盛-新莊",0,25,-25
"13259","5521工信","110/08/11","瑞士信貸",13,0,13
"13260","5521工信","110/08/11","群益金鼎-敦南",0,25,-25
"13261","1471首利","110/08/11","瑞士信貸",162,0,162
"13262","1471首利","110/08/11","日盛-和美",1,55,-54
"13263","1471首利","110/08/11","永全-八德",100,0,100
"13264","1471首利","110/08/11","臺銀-臺中",3,55,-52
"13265","1471首利","110/08/11","摩根大通",128,46,82
"13266","1471首利","110/08/11","永豐金-板盛",0,42,-42
"13267","1471首利","110/08/11","台新證券",48,7,41
"13268","1471首利","110/08/11","兆豐-桃園",0,40,-40
"13269","1471首利","110/08/11","凱基-台南",30,0,30
"13270","1471首利","110/08/11","凱基-東門",0,40,-40
"13271","1471首利","110/08/11","凱基-內埔",20,0,20
"13272","1471首利","110/08/11","元大-新竹經國",0,40,-40
"13273","1471首利","110/08/11","元大-蘆洲",20,0,20
"13274","1471首利","110/08/11","群益金鼎-中港",0,35,-35
"13275","1471首利","110/08/11","台新-高雄",16,0,16
"13276","1471首利","110/08/11","元大-竹山",0,30,-30
"13277","1471首利","110/08/11","大慶-富順",13,0,13
"13278","1471首利","110/08/11","富邦-新竹",1,30,-29
"13279","1471首利","110/08/11","群益金鼎-海山",13,0,13
"13280","1471首利","110/08/11","日盛-八德",0,27,-27
"13281","1471首利","110/08/11","日盛-大墩",12,0,12
"13282","1471首利","110/08/11","大慶-蘆洲",5,30,-25
"13283","1471首利","110/08/11","凱基-三重",12,0,12
"13284","1471首利","110/08/11","元富-林園",0,25,-25
"13285","1471首利","110/08/11","華南永昌-林口",12,0,12
"13286","1471首利","110/08/11","元富-大昌",0,25,-25
"13287","1471首利","110/08/11","富邦-中壢",13,2,11
"13288","1471首利","110/08/11","新光",9,34,-25
"13289","1471首利","110/08/11","合庫-台中",10,0,10
"13290","1471首利","110/08/11","兆豐-寶成",0,24,-24
"13291","2883開發金","110/08/11","瑞士信貸",5796,0,5796
"13292","2883開發金","110/08/11","元富",772,4335,-3563
"13293","2883開發金","110/08/11","元大-板橋三民",4182,53,4129
"13294","2883開發金","110/08/11","美林",2516,5260,-2744
"13295","2883開發金","110/08/11","合庫證券",3532,28,3504
"13296","2883開發金","110/08/11","永豐金-彰化",42,2447,-2405
"13297","2883開發金","110/08/11","兆豐證券",2123,44,2079
"13298","2883開發金","110/08/11","元大證券",1279,3467,-2188
"13299","2883開發金","110/08/11","台灣摩根士丹利",2946,1744,1202
"13300","2883開發金","110/08/11","國票-長城",0,2014,-2014
"13301","2883開發金","110/08/11","富邦-建國",1195,92,1103
"13302","2883開發金","110/08/11","港商野村",3121,4600,-1479
"13303","2883開發金","110/08/11","新光-新竹",1140,38,1102
"13304","2883開發金","110/08/11","元大-金華",31,1341,-1310
"13305","2883開發金","110/08/11","美商高盛",1600,535,1065
"13306","2883開發金","110/08/11","元大-彰化",67,1218,-1151
"13307","2883開發金","110/08/11","群益金鼎-南京",1083,202,881
"13308","2883開發金","110/08/11","玉山-高雄",99,986,-887
"13309","2883開發金","110/08/11","凱基-台北",5046,4258,788
"13310","2883開發金","110/08/11","元富-彰化",27,813,-786
"13311","2883開發金","110/08/11","港商法國興業",728,0,728
"13312","2883開發金","110/08/11","摩根大通",3362,4085,-723
"13313","2883開發金","110/08/11","玉山證券",716,98,618
"13314","2883開發金","110/08/11","國泰證券",21,658,-637
"13315","2883開發金","110/08/11","凱基-豐中",634,76,558
"13316","2883開發金","110/08/11","富邦-新店",61,662,-601
"13317","2883開發金","110/08/11","永豐金-忠孝",1406,858,548
"13318","2883開發金","110/08/11","元大-小港",71,667,-596
"13319","2883開發金","110/08/11","元大-民生",532,2,530
"13320","2883開發金","110/08/11","富邦-台北",213,798,-585
"13321","6205詮欣","110/08/11","臺銀-民權",25,0,25
"13322","6205詮欣","110/08/11","摩根大通",2,46,-44
"13323","6205詮欣","110/08/11","合庫-三重",20,0,20
"13324","6205詮欣","110/08/11","永豐金-敦南",0,14,-14
"13325","6205詮欣","110/08/11","元富-宜蘭",20,0,20
"13326","6205詮欣","110/08/11","瑞士信貸",0,11,-11
"13327","6205詮欣","110/08/11","德信-新營",10,0,10
"13328","6205詮欣","110/08/11","永豐金-忠孝",0,10,-10
"13329","6205詮欣","110/08/11","元大-西屯",10,0,10
"13330","6205詮欣","110/08/11","統一-汐止",0,6,-6
"13331","6205詮欣","110/08/11","永豐金-中正",9,0,9
"13332","6205詮欣","110/08/11","港商野村",0,5,-5
"13333","6205詮欣","110/08/11","日盛-三重",5,0,5
"13334","6205詮欣","110/08/11","新光",0,5,-5
"13335","6205詮欣","110/08/11","日盛-花蓮",5,0,5
"13336","6205詮欣","110/08/11","群益金鼎-開元",0,5,-5
"13337","6205詮欣","110/08/11","宏遠證券",5,0,5
"13338","6205詮欣","110/08/11","富邦-陽明",0,5,-5
"13339","6205詮欣","110/08/11","高橋",5,0,5
"13340","6205詮欣","110/08/11","元大-館前",0,5,-5
"13341","6205詮欣","110/08/11","亞東-板橋",4,0,4
"13342","6205詮欣","110/08/11","大慶-中壢",0,4,-4
"13343","6205詮欣","110/08/11","元富-基隆",3,0,3
"13344","6205詮欣","110/08/11","凱基-和平",0,4,-4
"13345","6205詮欣","110/08/11","元大-台中中港",3,0,3
"13346","6205詮欣","110/08/11","富邦-台北",0,4,-4
"13347","6205詮欣","110/08/11","合庫-彰化",2,0,2
"13348","6205詮欣","110/08/11","元大-南投",0,4,-4
"13349","6205詮欣","110/08/11","元大-西門",2,0,2
"13350","6205詮欣","110/08/11","元大-東蘆",0,4,-4
"13351","1540喬福","110/08/11","元富-中原",30,0,30
"13352","1540喬福","110/08/11","統一-新台中",0,18,-18
"13353","1540喬福","110/08/11","台中銀",17,0,17
"13354","1540喬福","110/08/11","凱基-台北",0,16,-16
"13355","1540喬福","110/08/11","富邦-竹北",11,0,11
"13356","1540喬福","110/08/11","永豐金-板新",0,15,-15
"13357","1540喬福","110/08/11","國泰-敦南",8,0,8
"13358","1540喬福","110/08/11","永豐金-中盛",0,11,-11
"13359","1540喬福","110/08/11","凱基-中壢",6,0,6
"13360","1540喬福","110/08/11","元大-中壢",0,10,-10
"13361","1540喬福","110/08/11","凱基-台南",5,0,5
"13362","1540喬福","110/08/11","玉山-台南",0,4,-4
"13363","1540喬福","110/08/11","元大-土城永寧",3,0,3
"13364","1540喬福","110/08/11","國票-南科",0,3,-3
"13365","1540喬福","110/08/11","臺銀-鳳山",2,0,2
"13366","1540喬福","110/08/11","元大-龍潭",0,3,-3
"13367","1540喬福","110/08/11","日盛-台中",2,0,2
"13368","1540喬福","110/08/11","臺銀-臺中",0,2,-2
"13369","1540喬福","110/08/11","兆豐-北高雄",2,0,2
"13370","1540喬福","110/08/11","(牛牛牛)亞-網路",0,2,-2
"13371","1540喬福","110/08/11","兆豐-三民",2,0,2
"13372","1540喬福","110/08/11","新光-台南",0,2,-2
"13373","1540喬福","110/08/11","合庫-桃園",1,0,1
"13374","1540喬福","110/08/11","凱基-永和",0,2,-2
"13375","1540喬福","110/08/11","臺銀-民權",1,0,1
"13376","1540喬福","110/08/11","元大-南崁",0,2,-2
"13377","1540喬福","110/08/11","臺銀-高雄",1,0,1
"13378","1540喬福","110/08/11","美林",0,1,-1
"13379","1540喬福","110/08/11","日盛-永康",1,0,1
"13380","1540喬福","110/08/11","美商高盛",0,1,-1
"13381","2888新光金","110/08/11","摩根大通",6950,1470,5480
"13382","2888新光金","110/08/11","第一金-高雄",5,5018,-5013
"13383","2888新光金","110/08/11","元大-忠孝鼎富",4314,11,4303
"13384","2888新光金","110/08/11","永豐金-天母",0,2241,-2241
"13385","2888新光金","110/08/11","美商高盛",4420,228,4192
"13386","2888新光金","110/08/11","統一-中壢",11,1720,-1709
"13387","2888新光金","110/08/11","瑞士信貸",2928,166,2762
"13388","2888新光金","110/08/11","美林",1510,3170,-1660
"13389","2888新光金","110/08/11","群益金鼎",1859,0,1859
"13390","2888新光金","110/08/11","國票-台東",21,1606,-1585
"13391","2888新光金","110/08/11","凱基-台北",5335,3700,1635
"13392","2888新光金","110/08/11","元富-城東",25,1082,-1057
"13393","2888新光金","110/08/11","新加坡商瑞銀",1506,65,1441
"13394","2888新光金","110/08/11","台灣摩根士丹利",916,1951,-1035
"13395","2888新光金","110/08/11","港商法國興業",1338,0,1338
"13396","2888新光金","110/08/11","中國信託",25,740,-715
"13397","2888新光金","110/08/11","元富-中港",1250,9,1241
"13398","2888新光金","110/08/11","新光",391,1047,-656
"13399","2888新光金","110/08/11","福邦-新竹",1176,0,1176
"13400","2888新光金","110/08/11","合庫-高雄",1,567,-566
"13401","2888新光金","110/08/11","凱基-林口",1005,35,970
"13402","2888新光金","110/08/11","康和-台中",1,463,-462
"13403","2888新光金","110/08/11","港商野村",1301,434,867
"13404","2888新光金","110/08/11","玉山證券",260,691,-431
"13405","2888新光金","110/08/11","國票-安和",1179,519,660
"13406","2888新光金","110/08/11","元大-和平",4,382,-378
"13407","2888新光金","110/08/11","富邦-敦南",569,19,550
"13408","2888新光金","110/08/11","日盛-新莊",0,350,-350
"13409","2888新光金","110/08/11","香港上海匯豐",441,0,441
"13410","2888新光金","110/08/11","群益金鼎-大興",1,341,-340
"13411","1340勝悅","110/08/11","華南永昌-高雄",24,4,20
"13412","1340勝悅","110/08/11","元大-大統",0,42,-42
"13413","1340勝悅","110/08/11","亞東-板橋",18,0,18
"13414","1340勝悅","110/08/11","(牛牛牛)亞-鑫豐",0,25,-25
"13415","1340勝悅","110/08/11","永豐金-台南",12,0,12
"13416","1340勝悅","110/08/11","美林",0,20,-20
"13417","1340勝悅","110/08/11","永豐金-板盛",10,0,10
"13418","1340勝悅","110/08/11","摩根大通",0,18,-18
"13419","1340勝悅","110/08/11","永豐金-天母",9,0,9
"13420","1340勝悅","110/08/11","元富-基隆",0,12,-12
"13421","1340勝悅","110/08/11","國泰-敦南",15,7,8
"13422","1340勝悅","110/08/11","玉山-高雄",0,12,-12
"13423","1340勝悅","110/08/11","群益金鼎-館前",8,0,8
"13424","1340勝悅","110/08/11","元大-桃興",0,10,-10
"13425","1340勝悅","110/08/11","凱基-台中",7,0,7
"13426","1340勝悅","110/08/11","永豐金-博愛",0,10,-10
"13427","1340勝悅","110/08/11","統一-城中",6,0,6
"13428","1340勝悅","110/08/11","瑞士信貸",0,8,-8
"13429","1340勝悅","110/08/11","群益金鼎-崇德",6,0,6
"13430","1340勝悅","110/08/11","日盛-台中",0,6,-6
"13431","1340勝悅","110/08/11","永豐金-松山",6,0,6
"13432","1340勝悅","110/08/11","元大-景美",0,6,-6
"13433","1340勝悅","110/08/11","臺銀-鳳山",5,0,5
"13434","1340勝悅","110/08/11","日盛-信義",0,5,-5
"13435","1340勝悅","110/08/11","永全-南崁",5,0,5
"13436","1340勝悅","110/08/11","台新證券",0,5,-5
"13437","1340勝悅","110/08/11","玉山-士林",5,0,5
"13438","1340勝悅","110/08/11","元大-忠孝鼎富",0,5,-5
"13439","1340勝悅","110/08/11","國泰-台中",15,10,5
"13440","1340勝悅","110/08/11","元大-中壢",0,5,-5
"13441","6246臺龍","110/08/11","永興",40,3,37
"13442","6246臺龍","110/08/11","港商野村",6,139,-133
"13443","6246臺龍","110/08/11","永豐金-內湖",42,9,33
"13444","6246臺龍","110/08/11","統一",0,97,-97
"13445","6246臺龍","110/08/11","元大-豐原站前",68,41,27
"13446","6246臺龍","110/08/11","兆豐-松德",0,82,-82
"13447","6246臺龍","110/08/11","日盛-員林",21,1,20
"13448","6246臺龍","110/08/11","元大-新盛",24,80,-56
"13449","6246臺龍","110/08/11","康和-澎湖",20,0,20
"13450","6246臺龍","110/08/11","元大-北港",0,35,-35
"13451","6246臺龍","110/08/11","元大-歸仁",18,0,18
"13452","6246臺龍","110/08/11","元大-西門",0,28,-28
"13453","6246臺龍","110/08/11","元大-中壢",35,17,18
"13454","6246臺龍","110/08/11","永興-台中",0,27,-27
"13455","6246臺龍","110/08/11","玉山-大里",17,0,17
"13456","6246臺龍","110/08/11","永興-水湳",0,25,-25
"13457","6246臺龍","110/08/11","大慶-泰山",15,0,15
"13458","6246臺龍","110/08/11","元大-西螺",6,30,-24
"13459","6246臺龍","110/08/11","永豐金-松山",15,1,14
"13460","6246臺龍","110/08/11","元大-西屯",2,25,-23
"13461","6246臺龍","110/08/11","凱基-永和",13,0,13
"13462","6246臺龍","110/08/11","新光",45,67,-22
"13463","6246臺龍","110/08/11","華南永昌-嘉義",13,0,13
"13464","6246臺龍","110/08/11","第一金-台中",0,20,-20
"13465","6246臺龍","110/08/11","富邦-三重",13,0,13
"13466","6246臺龍","110/08/11","兆豐-南京",0,20,-20
"13467","6246臺龍","110/08/11","日盛-高雄",12,0,12
"13468","6246臺龍","110/08/11","日盛-頭份",2,20,-18
"13469","6246臺龍","110/08/11","群益金鼎-北高雄",12,0,12
"13470","6246臺龍","110/08/11","宏遠-桃園",0,17,-17
"13471","00715L期街口布蘭特正2","110/08/11","元大證券",11593,2378,9215
"13472","00715L期街口布蘭特正2","110/08/11","凱基-台北",313,3001,-2688
"13473","00715L期街口布蘭特正2","110/08/11","永豐金-新店",1600,4,1596
"13474","00715L期街口布蘭特正2","110/08/11","富邦-南屯",403,1908,-1505
"13475","00715L期街口布蘭特正2","110/08/11","第一金-台中",1282,31,1251
"13476","00715L期街口布蘭特正2","110/08/11","新光",152,1165,-1013
"13477","00715L期街口布蘭特正2","110/08/11","元大-敦化",1200,20,1180
"13478","00715L期街口布蘭特正2","110/08/11","第一金-台南",0,519,-519
"13479","00715L期街口布蘭特正2","110/08/11","永豐金證券",1128,53,1075
"13480","00715L期街口布蘭特正2","110/08/11","統一-新竹",13,506,-493
"13481","00715L期街口布蘭特正2","110/08/11","元大-復北",556,21,535
"13482","00715L期街口布蘭特正2","110/08/11","台新-三民",0,438,-438
"13483","00715L期街口布蘭特正2","110/08/11","日盛-永康",340,0,340
"13484","00715L期街口布蘭特正2","110/08/11","富邦-彰化",30,391,-361
"13485","00715L期街口布蘭特正2","110/08/11","群益金鼎-板橋",350,17,333
"13486","00715L期街口布蘭特正2","110/08/11","元富-中壢",5,316,-311
"13487","00715L期街口布蘭特正2","110/08/11","元富",325,2,323
"13488","00715L期街口布蘭特正2","110/08/11","凱基-豐中",0,302,-302
"13489","00715L期街口布蘭特正2","110/08/11","凱基-科園",300,0,300
"13490","00715L期街口布蘭特正2","110/08/11","康和",359,645,-286
"13491","00715L期街口布蘭特正2","110/08/11","元大-蘆洲",311,59,252
"13492","00715L期街口布蘭特正2","110/08/11","元富-成功",5,290,-285
"13493","00715L期街口布蘭特正2","110/08/11","群益金鼎-崇德",251,20,231
"13494","00715L期街口布蘭特正2","110/08/11","台新-松江",0,268,-268
"13495","00715L期街口布蘭特正2","110/08/11","富邦-建國",265,42,223
"13496","00715L期街口布蘭特正2","110/08/11","元大-前金",21,279,-258
"13497","00715L期街口布蘭特正2","110/08/11","富邦-嘉義",300,99,201
"13498","00715L期街口布蘭特正2","110/08/11","國泰-高雄",13,236,-223
"13499","00715L期街口布蘭特正2","110/08/11","元大-竹科",314,115,199
"13500","00715L期街口布蘭特正2","110/08/11","中國信託-嘉義",4,223,-219
"13501","8941關中","110/08/11","凱基-市府",1,0,1
"13502","8941關中","110/08/11","元大-古亭",0,1,-1
"13503","8941關中","110/08/11","康和-板橋",0,0,0
"13504","8941關中","110/08/11","康和-板橋",0,0,0
"13505","8941關中","110/08/11","國泰-忠孝",0,0,0
"13506","8941關中","110/08/11","國泰-忠孝",0,0,0
"13507","8941關中","110/08/11","富邦-北港",0,0,0
"13508","8941關中","110/08/11","富邦-北港",0,0,0
"13509","8941關中","110/08/11","元大證券",0,0,0
"13510","8941關中","110/08/11","元大證券",0,0,0
"13511","8941關中","110/08/11","",NA,NA,NA
"13512","8941關中","110/08/11","",NA,NA,NA
"13513","8941關中","110/08/11","",NA,NA,NA
"13514","8941關中","110/08/11","",NA,NA,NA
"13515","8941關中","110/08/11","",NA,NA,NA
"13516","8941關中","110/08/11","",NA,NA,NA
"13517","8941關中","110/08/11","",NA,NA,NA
"13518","8941關中","110/08/11","",NA,NA,NA
"13519","8941關中","110/08/11","",NA,NA,NA
"13520","8941關中","110/08/11","",NA,NA,NA
"13521","8941關中","110/08/11","",NA,NA,NA
"13522","8941關中","110/08/11","",NA,NA,NA
"13523","8941關中","110/08/11","",NA,NA,NA
"13524","8941關中","110/08/11","",NA,NA,NA
"13525","8941關中","110/08/11","",NA,NA,NA
"13526","8941關中","110/08/11","",NA,NA,NA
"13527","8941關中","110/08/11","",NA,NA,NA
"13528","8941關中","110/08/11","",NA,NA,NA
"13529","8941關中","110/08/11","",NA,NA,NA
"13530","8941關中","110/08/11","",NA,NA,NA
"13531","8936國統","110/08/11","台新-高雄",218,1,217
"13532","8936國統","110/08/11","凱基-內埔",0,70,-70
"13533","8936國統","110/08/11","新光-桃園",105,3,102
"13534","8936國統","110/08/11","元大-太平",0,60,-60
"13535","8936國統","110/08/11","新加坡商瑞銀",124,59,65
"13536","8936國統","110/08/11","永豐金-板盛",0,48,-48
"13537","8936國統","110/08/11","美林",61,0,61
"13538","8936國統","110/08/11","兆豐-高雄",0,29,-29
"13539","8936國統","110/08/11","摩根大通",71,16,55
"13540","8936國統","110/08/11","群益金鼎-屏東",0,27,-27
"13541","8936國統","110/08/11","元富-同大",41,5,36
"13542","8936國統","110/08/11","新光",0,24,-24
"13543","8936國統","110/08/11","凱基-台北",38,6,32
"13544","8936國統","110/08/11","凱基-台南",0,22,-22
"13545","8936國統","110/08/11","華南永昌-高雄",22,0,22
"13546","8936國統","110/08/11","合庫-高雄",0,20,-20
"13547","8936國統","110/08/11","日盛-三峽",21,0,21
"13548","8936國統","110/08/11","永豐金-大園",0,20,-20
"13549","8936國統","110/08/11","兆豐-大同",30,9,21
"13550","8936國統","110/08/11","永豐金-台中",0,20,-20
"13551","8936國統","110/08/11","宏遠-台南",20,0,20
"13552","8936國統","110/08/11","永豐金-竹科",0,20,-20
"13553","8936國統","110/08/11","美商高盛",17,1,16
"13554","8936國統","110/08/11","港商野村",49,67,-18
"13555","8936國統","110/08/11","日盛-斗六",15,0,15
"13556","8936國統","110/08/11","第一金-新興",0,16,-16
"13557","8936國統","110/08/11","元富-大裕",15,0,15
"13558","8936國統","110/08/11","新光-台中",14,29,-15
"13559","8936國統","110/08/11","台新-台中",15,2,13
"13560","8936國統","110/08/11","凱基-永和",0,15,-15
"13561","6226光鼎","110/08/11","美商高盛",595,148,447
"13562","6226光鼎","110/08/11","瑞士信貸",297,751,-454
"13563","6226光鼎","110/08/11","凱基-台北",506,69,437
"13564","6226光鼎","110/08/11","摩根大通",911,1317,-406
"13565","6226光鼎","110/08/11","統一-高雄",503,150,353
"13566","6226光鼎","110/08/11","凱基-站前",29,313,-284
"13567","6226光鼎","110/08/11","美林",507,312,195
"13568","6226光鼎","110/08/11","台中銀-台北",0,280,-280
"13569","6226光鼎","110/08/11","合庫-台中",143,4,139
"13570","6226光鼎","110/08/11","國泰-台中",75,176,-101
"13571","6226光鼎","110/08/11","大昌",139,0,139
"13572","6226光鼎","110/08/11","元富-潮州",10,107,-97
"13573","6226光鼎","110/08/11","台灣摩根士丹利",229,101,128
"13574","6226光鼎","110/08/11","中國信託-永康",63,159,-96
"13575","6226光鼎","110/08/11","元大-北投",123,4,119
"13576","6226光鼎","110/08/11","國泰-高雄",15,96,-81
"13577","6226光鼎","110/08/11","富邦-南屯",170,63,107
"13578","6226光鼎","110/08/11","凱基-三多",23,100,-77
"13579","6226光鼎","110/08/11","群益金鼎-西松",176,93,83
"13580","6226光鼎","110/08/11","玉山-高雄",17,90,-73
"13581","6226光鼎","110/08/11","台新證券",167,99,68
"13582","6226光鼎","110/08/11","元大-新盛",8,81,-73
"13583","6226光鼎","110/08/11","永豐金-內湖",79,22,57
"13584","6226光鼎","110/08/11","元大-府城",7,72,-65
"13585","6226光鼎","110/08/11","日盛證券",51,6,45
"13586","6226光鼎","110/08/11","統一-仁愛",13,75,-62
"13587","6226光鼎","110/08/11","臺銀-高雄",70,26,44
"13588","6226光鼎","110/08/11","高橋",4,61,-57
"13589","6226光鼎","110/08/11","富邦-陽明",84,40,44
"13590","6226光鼎","110/08/11","台新-屏東",16,71,-55
"13591","2363矽統","110/08/11","瑞士信貸",547,0,547
"13592","2363矽統","110/08/11","凱基-台北",2934,4385,-1451
"13593","2363矽統","110/08/11","台灣摩根士丹利",677,160,517
"13594","2363矽統","110/08/11","陽信-石牌",34,626,-592
"13595","2363矽統","110/08/11","玉山-台中",331,139,192
"13596","2363矽統","110/08/11","永豐金證券",103,405,-302
"13597","2363矽統","110/08/11","台新-左楠",191,33,158
"13598","2363矽統","110/08/11","元大-成功",60,289,-229
"13599","2363矽統","110/08/11","華南永昌-頭份",197,45,152
"13600","2363矽統","110/08/11","美林",747,959,-212
"13601","2363矽統","110/08/11","元大-忠孝鼎富",196,51,145
"13602","2363矽統","110/08/11","元大-員林中山",83,286,-203
"13603","2363矽統","110/08/11","元大-汐止",279,150,129
"13604","2363矽統","110/08/11","凱基-市府",42,242,-200
"13605","2363矽統","110/08/11","大慶-蘆洲",135,26,109
"13606","2363矽統","110/08/11","永豐金-埔里",4,181,-177
"13607","2363矽統","110/08/11","合庫-高雄",135,30,105
"13608","2363矽統","110/08/11","群益金鼎-內湖",41,195,-154
"13609","2363矽統","110/08/11","兆豐證券",105,1,104
"13610","2363矽統","110/08/11","元大-旗山",157,307,-150
"13611","2363矽統","110/08/11","永豐金-竹科",112,15,97
"13612","2363矽統","110/08/11","兆豐-台中港",38,178,-140
"13613","2363矽統","110/08/11","國票-彰化",95,0,95
"13614","2363矽統","110/08/11","元大-新竹",55,194,-139
"13615","2363矽統","110/08/11","元大-斗信",152,65,87
"13616","2363矽統","110/08/11","凱基-永和",32,161,-129
"13617","2363矽統","110/08/11","亞東",95,10,85
"13618","2363矽統","110/08/11","第一金-桃園",59,183,-124
"13619","2363矽統","110/08/11","美商高盛",906,822,84
"13620","2363矽統","110/08/11","台新證券",525,640,-115
"13621","8112至上","110/08/11","港商野村",188,11,177
"13622","8112至上","110/08/11","新加坡商瑞銀",35,847,-812
"13623","8112至上","110/08/11","大昌-桃園",173,0,173
"13624","8112至上","110/08/11","宏遠證券",2,536,-534
"13625","8112至上","110/08/11","合庫證券",142,3,139
"13626","8112至上","110/08/11","富邦-仁愛",67,324,-257
"13627","8112至上","110/08/11","美商高盛",145,14,131
"13628","8112至上","110/08/11","凱基-市政",0,202,-202
"13629","8112至上","110/08/11","群益金鼎-內湖",132,10,122
"13630","8112至上","110/08/11","凱基-復興",16,190,-174
"13631","8112至上","110/08/11","國票-長城",130,30,100
"13632","8112至上","110/08/11","瑞士信貸",136,306,-170
"13633","8112至上","110/08/11","玉山-板橋",84,0,84
"13634","8112至上","110/08/11","兆豐-公益",1,120,-119
"13635","8112至上","110/08/11","臺灣企銀-桃園",60,0,60
"13636","8112至上","110/08/11","元大-萬華",12,131,-119
"13637","8112至上","110/08/11","新光",103,44,59
"13638","8112至上","110/08/11","凱基-台北",211,321,-110
"13639","8112至上","110/08/11","華南永昌-中正",52,0,52
"13640","8112至上","110/08/11","美林",21,116,-95
"13641","8112至上","110/08/11","元大-仁愛",50,0,50
"13642","8112至上","110/08/11","永豐金-豐原",7,102,-95
"13643","8112至上","110/08/11","元大-北成功",101,53,48
"13644","8112至上","110/08/11","兆豐-民生",0,70,-70
"13645","8112至上","110/08/11","合庫-嘉義",45,0,45
"13646","8112至上","110/08/11","元富",2,71,-69
"13647","8112至上","110/08/11","大慶-富順",46,1,45
"13648","8112至上","110/08/11","玉山-士林",6,67,-61
"13649","8112至上","110/08/11","臺銀-金山",45,1,44
"13650","8112至上","110/08/11","凱基-埔墘",0,60,-60
"13651","1570力肯","110/08/11","國票-內壢",386,0,386
"13652","1570力肯","110/08/11","群益金鼎-大興",0,100,-100
"13653","1570力肯","110/08/11","華南永昌-桃園",104,3,101
"13654","1570力肯","110/08/11","新光",177,255,-78
"13655","1570力肯","110/08/11","摩根大通",154,84,70
"13656","1570力肯","110/08/11","富邦-台中",0,61,-61
"13657","1570力肯","110/08/11","日盛-頭份",51,0,51
"13658","1570力肯","110/08/11","群益金鼎-忠孝",1,60,-59
"13659","1570力肯","110/08/11","永豐金-中壢",51,1,50
"13660","1570力肯","110/08/11","元大-新店中正",2,61,-59
"13661","1570力肯","110/08/11","永豐金-北高雄",50,0,50
"13662","1570力肯","110/08/11","富邦-陽明",1,51,-50
"13663","1570力肯","110/08/11","凱基-天母",51,2,49
"13664","1570力肯","110/08/11","元大-太平",5,54,-49
"13665","1570力肯","110/08/11","日盛-員林",52,5,47
"13666","1570力肯","110/08/11","統一-松江",0,43,-43
"13667","1570力肯","110/08/11","元富-高雄",40,0,40
"13668","1570力肯","110/08/11","台新證券",6,44,-38
"13669","1570力肯","110/08/11","中國信託-嘉義",34,0,34
"13670","1570力肯","110/08/11","永豐金證券",1,36,-35
"13671","1570力肯","110/08/11","元大-北成功",30,1,29
"13672","1570力肯","110/08/11","瑞士信貸",0,27,-27
"13673","1570力肯","110/08/11","亞東-台中",26,0,26
"13674","1570力肯","110/08/11","元大-中壢",9,35,-26
"13675","1570力肯","110/08/11","第一金-嘉義",26,0,26
"13676","1570力肯","110/08/11","美商高盛",0,25,-25
"13677","1570力肯","110/08/11","凱基-中壢",27,3,24
"13678","1570力肯","110/08/11","國票-北高雄",128,153,-25
"13679","1570力肯","110/08/11","元大-福營",25,1,24
"13680","1570力肯","110/08/11","元富-新店",10,34,-24
"13681","2929淘帝","110/08/11","美林",25,5,20
"13682","2929淘帝","110/08/11","華南永昌",0,25,-25
"13683","2929淘帝","110/08/11","永興",20,0,20
"13684","2929淘帝","110/08/11","台新-台中",0,22,-22
"13685","2929淘帝","110/08/11","新光",17,1,16
"13686","2929淘帝","110/08/11","富邦-永和",1,21,-20
"13687","2929淘帝","110/08/11","臺銀-臺南",12,0,12
"13688","2929淘帝","110/08/11","元富-古亭",0,18,-18
"13689","2929淘帝","110/08/11","第一金-大稻埕",10,0,10
"13690","2929淘帝","110/08/11","永豐金-大園",5,23,-18
"13691","2929淘帝","110/08/11","兆豐-桃園",10,0,10
"13692","2929淘帝","110/08/11","富邦-新店",3,19,-16
"13693","2929淘帝","110/08/11","國票-九鼎",10,0,10
"13694","2929淘帝","110/08/11","新光-台中",16,31,-15
"13695","2929淘帝","110/08/11","華南永昌-長虹",10,0,10
"13696","2929淘帝","110/08/11","國泰-新莊",0,10,-10
"13697","2929淘帝","110/08/11","凱基-長庚",7,0,7
"13698","2929淘帝","110/08/11","元大-東泰",0,10,-10
"13699","2929淘帝","110/08/11","凱基-林口",7,0,7
"13700","2929淘帝","110/08/11","凱基-斗六",0,8,-8
"13701","2929淘帝","110/08/11","日盛-中壢",5,0,5
"13702","2929淘帝","110/08/11","永豐金證券",0,7,-7
"13703","2929淘帝","110/08/11","港商法國興業",5,0,5
"13704","2929淘帝","110/08/11","第一金-員林",0,5,-5
"13705","2929淘帝","110/08/11","元富-中壢",5,0,5
"13706","2929淘帝","110/08/11","元富-新竹",0,5,-5
"13707","2929淘帝","110/08/11","元富-文心",5,0,5
"13708","2929淘帝","110/08/11","凱基-東門",0,5,-5
"13709","2929淘帝","110/08/11","凱基-台中",5,0,5
"13710","2929淘帝","110/08/11","元大-桃園",0,5,-5
"13711","5410國眾","110/08/11","群益金鼎",128,0,128
"13712","5410國眾","110/08/11","國泰-敦南",12,206,-194
"13713","5410國眾","110/08/11","富邦-建國",100,0,100
"13714","5410國眾","110/08/11","凱基-竹北",2,112,-110
"13715","5410國眾","110/08/11","玉山-新莊",35,0,35
"13716","5410國眾","110/08/11","大昌-樹林",0,100,-100
"13717","5410國眾","110/08/11","合庫-桃園",30,0,30
"13718","5410國眾","110/08/11","凱基-市政",0,100,-100
"13719","5410國眾","110/08/11","高橋",30,0,30
"13720","5410國眾","110/08/11","摩根大通",20,68,-48
"13721","5410國眾","110/08/11","元大-崇德",28,0,28
"13722","5410國眾","110/08/11","凱基-台北",7,39,-32
"13723","5410國眾","110/08/11","元大-新盛",28,0,28
"13724","5410國眾","110/08/11","元大-復北",0,30,-30
"13725","5410國眾","110/08/11","凱基-三峽",21,0,21
"13726","5410國眾","110/08/11","大昌",0,26,-26
"13727","5410國眾","110/08/11","臺銀-臺中",17,0,17
"13728","5410國眾","110/08/11","第一金-豐原",0,23,-23
"13729","5410國眾","110/08/11","新光",15,0,15
"13730","5410國眾","110/08/11","元富-三重",0,22,-22
"13731","5410國眾","110/08/11","國泰-台中",20,8,12
"13732","5410國眾","110/08/11","元大-樹林",2,21,-19
"13733","5410國眾","110/08/11","新光-桃園",11,0,11
"13734","5410國眾","110/08/11","元大-成功",0,17,-17
"13735","5410國眾","110/08/11","元大-旗山",11,0,11
"13736","5410國眾","110/08/11","新光-台中",0,16,-16
"13737","5410國眾","110/08/11","大昌-新店",10,0,10
"13738","5410國眾","110/08/11","臺銀-臺南",1,14,-13
"13739","5410國眾","110/08/11","豐農",10,0,10
"13740","5410國眾","110/08/11","瑞士信貸",0,12,-12
"13741","2841台開","110/08/11","宏遠-館前",402,0,402
"13742","2841台開","110/08/11","永豐金-敦南",11,270,-259
"13743","2841台開","110/08/11","日盛-信義",129,0,129
"13744","2841台開","110/08/11","國票-天祥",0,100,-100
"13745","2841台開","110/08/11","元大-南投",80,0,80
"13746","2841台開","110/08/11","日盛證券",27,117,-90
"13747","2841台開","110/08/11","日盛-園區",72,0,72
"13748","2841台開","110/08/11","永興-水湳",0,30,-30
"13749","2841台開","110/08/11","華南永昌-鶯歌",45,0,45
"13750","2841台開","110/08/11","兆豐-寶成",0,30,-30
"13751","2841台開","110/08/11","元大-福營",20,0,20
"13752","2841台開","110/08/11","元富-四維",0,26,-26
"13753","2841台開","110/08/11","元大-左營",20,0,20
"13754","2841台開","110/08/11","統一-士林",0,25,-25
"13755","2841台開","110/08/11","永豐金-員林",15,0,15
"13756","2841台開","110/08/11","日盛-忠孝",0,20,-20
"13757","2841台開","110/08/11","日盛-內湖",11,0,11
"13758","2841台開","110/08/11","大慶-蘆洲",0,20,-20
"13759","2841台開","110/08/11","國泰-館前",10,0,10
"13760","2841台開","110/08/11","國票-中和",0,20,-20
"13761","2841台開","110/08/11","華南永昌-潮州",10,0,10
"13762","2841台開","110/08/11","元大-大灣",0,20,-20
"13763","2841台開","110/08/11","元大-大里德芳",10,0,10
"13764","2841台開","110/08/11","元大-雙和",0,20,-20
"13765","2841台開","110/08/11","元大-小港",10,0,10
"13766","2841台開","110/08/11","新光",28,47,-19
"13767","2841台開","110/08/11","新光-台南",7,0,7
"13768","2841台開","110/08/11","玉山-台中",0,13,-13
"13769","2841台開","110/08/11","國泰-台中",6,0,6
"13770","2841台開","110/08/11","富邦-建國",0,12,-12
"13771","6207雷科","110/08/11","台新-高雄",136,8,128
"13772","6207雷科","110/08/11","群益金鼎-東門",1,90,-89
"13773","6207雷科","110/08/11","凱基-台北",108,21,87
"13774","6207雷科","110/08/11","摩根大通",89,156,-67
"13775","6207雷科","110/08/11","富邦-陽明",70,0,70
"13776","6207雷科","110/08/11","元大-鳳山",22,60,-38
"13777","6207雷科","110/08/11","永豐金證券",30,0,30
"13778","6207雷科","110/08/11","凱基-三重",5,40,-35
"13779","6207雷科","110/08/11","永豐金-高雄",29,5,24
"13780","6207雷科","110/08/11","美林",5,35,-30
"13781","6207雷科","110/08/11","元大-高雄",18,0,18
"13782","6207雷科","110/08/11","港商野村",28,58,-30
"13783","6207雷科","110/08/11","元大-竹山",17,0,17
"13784","6207雷科","110/08/11","元大-路竹",3,30,-27
"13785","6207雷科","110/08/11","國泰-台南",15,2,13
"13786","6207雷科","110/08/11","元大-小港",3,30,-27
"13787","6207雷科","110/08/11","元大-東門",12,0,12
"13788","6207雷科","110/08/11","(牛牛牛)亞-網路",0,23,-23
"13789","6207雷科","110/08/11","台灣企銀-太平",10,0,10
"13790","6207雷科","110/08/11","台新證券",4,26,-22
"13791","6207雷科","110/08/11","富邦-中壢",10,0,10
"13792","6207雷科","110/08/11","新光",2,23,-21
"13793","6207雷科","110/08/11","元大-博愛",10,0,10
"13794","6207雷科","110/08/11","元大-雙和",0,19,-19
"13795","6207雷科","110/08/11","富邦-內湖",9,0,9
"13796","6207雷科","110/08/11","新加坡商瑞銀",25,41,-16
"13797","6207雷科","110/08/11","中國信託-高雄",8,0,8
"13798","6207雷科","110/08/11","玉山證券",3,19,-16
"13799","6207雷科","110/08/11","國票-九鼎",8,0,8
"13800","6207雷科","110/08/11","玉山-雙和",0,16,-16
"13801","3679新至陞","110/08/11","摩根大通",62,3,59
"13802","3679新至陞","110/08/11","港商野村",7,25,-18
"13803","3679新至陞","110/08/11","台灣摩根士丹利",38,0,38
"13804","3679新至陞","110/08/11","凱基-文心",0,9,-9
"13805","3679新至陞","110/08/11","華南永昌-台中",16,0,16
"13806","3679新至陞","110/08/11","北城證券",0,8,-8
"13807","3679新至陞","110/08/11","凱基-台北",37,23,14
"13808","3679新至陞","110/08/11","華南永昌-大安",2,10,-8
"13809","3679新至陞","110/08/11","元大-成功",13,1,12
"13810","3679新至陞","110/08/11","元大-板橋",0,8,-8
"13811","3679新至陞","110/08/11","美林",22,16,6
"13812","3679新至陞","110/08/11","致和-東門",0,7,-7
"13813","3679新至陞","110/08/11","新加坡商瑞銀",12,6,6
"13814","3679新至陞","110/08/11","凱基-長庚",0,7,-7
"13815","3679新至陞","110/08/11","國泰-館前",5,0,5
"13816","3679新至陞","110/08/11","花旗環球",0,6,-6
"13817","3679新至陞","110/08/11","瑞士信貸",9,5,4
"13818","3679新至陞","110/08/11","群益金鼎-古亭",0,6,-6
"13819","3679新至陞","110/08/11","國泰-板橋",5,1,4
"13820","3679新至陞","110/08/11","元大-大同",0,6,-6
"13821","3679新至陞","110/08/11","日進",3,0,3
"13822","3679新至陞","110/08/11","華南永昌-鶯歌",0,5,-5
"13823","3679新至陞","110/08/11","(牛牛牛)亞-網路",4,1,3
"13824","3679新至陞","110/08/11","永豐金-新竹",0,5,-5
"13825","3679新至陞","110/08/11","康和-板橋",3,0,3
"13826","3679新至陞","110/08/11","凱基-新豐",0,4,-4
"13827","3679新至陞","110/08/11","高橋-內壢",2,0,2
"13828","3679新至陞","110/08/11","臺銀-高雄",1,4,-3
"13829","3679新至陞","110/08/11","富邦-台北",7,5,2
"13830","3679新至陞","110/08/11","日盛-文化",0,3,-3
"13831","2727王品","110/08/11","美林",113,23,90
"13832","2727王品","110/08/11","台灣摩根士丹利",8,65,-57
"13833","2727王品","110/08/11","富邦-左營",72,1,71
"13834","2727王品","110/08/11","合庫-新竹",1,23,-22
"13835","2727王品","110/08/11","凱基-台北",80,42,38
"13836","2727王品","110/08/11","永豐金-忠孝",0,20,-20
"13837","2727王品","110/08/11","港商野村",96,70,26
"13838","2727王品","110/08/11","彰銀-台中",1,15,-14
"13839","2727王品","110/08/11","國泰證券",23,1,22
"13840","2727王品","110/08/11","國泰-敦南",10,24,-14
"13841","2727王品","110/08/11","統一",28,8,20
"13842","2727王品","110/08/11","凱基-南崁",0,11,-11
"13843","2727王品","110/08/11","玉山-台南",20,1,19
"13844","2727王品","110/08/11","永豐金-三重",0,10,-10
"13845","2727王品","110/08/11","新光-台中",22,9,13
"13846","2727王品","110/08/11","富邦-中壢",3,12,-9
"13847","2727王品","110/08/11","凱基-興隆",11,0,11
"13848","2727王品","110/08/11","新光",16,24,-8
"13849","2727王品","110/08/11","元大證券",44,33,11
"13850","2727王品","110/08/11","國泰-板橋",12,20,-8
"13851","2727王品","110/08/11","日盛-樹林",12,2,10
"13852","2727王品","110/08/11","元大-彰化",0,8,-8
"13853","2727王品","110/08/11","第一金-新竹",10,0,10
"13854","2727王品","110/08/11","日盛-木柵",0,7,-7
"13855","2727王品","110/08/11","永全",10,0,10
"13856","2727王品","110/08/11","第一金-頭份",0,7,-7
"13857","2727王品","110/08/11","凱基-埔墘",10,0,10
"13858","2727王品","110/08/11","中國信託-高雄",2,9,-7
"13859","2727王品","110/08/11","摩根大通",42,33,9
"13860","2727王品","110/08/11","兆豐-公益",0,7,-7
"13861","1570力肯","110/08/11","國票-內壢",386,0,386
"13862","1570力肯","110/08/11","群益金鼎-大興",0,100,-100
"13863","1570力肯","110/08/11","華南永昌-桃園",104,3,101
"13864","1570力肯","110/08/11","新光",177,255,-78
"13865","1570力肯","110/08/11","摩根大通",154,84,70
"13866","1570力肯","110/08/11","富邦-台中",0,61,-61
"13867","1570力肯","110/08/11","日盛-頭份",51,0,51
"13868","1570力肯","110/08/11","群益金鼎-忠孝",1,60,-59
"13869","1570力肯","110/08/11","永豐金-中壢",51,1,50
"13870","1570力肯","110/08/11","元大-新店中正",2,61,-59
"13871","1570力肯","110/08/11","永豐金-北高雄",50,0,50
"13872","1570力肯","110/08/11","富邦-陽明",1,51,-50
"13873","1570力肯","110/08/11","凱基-天母",51,2,49
"13874","1570力肯","110/08/11","元大-太平",5,54,-49
"13875","1570力肯","110/08/11","日盛-員林",52,5,47
"13876","1570力肯","110/08/11","統一-松江",0,43,-43
"13877","1570力肯","110/08/11","元富-高雄",40,0,40
"13878","1570力肯","110/08/11","台新證券",6,44,-38
"13879","1570力肯","110/08/11","中國信託-嘉義",34,0,34
"13880","1570力肯","110/08/11","永豐金證券",1,36,-35
"13881","1570力肯","110/08/11","元大-北成功",30,1,29
"13882","1570力肯","110/08/11","瑞士信貸",0,27,-27
"13883","1570力肯","110/08/11","亞東-台中",26,0,26
"13884","1570力肯","110/08/11","元大-中壢",9,35,-26
"13885","1570力肯","110/08/11","第一金-嘉義",26,0,26
"13886","1570力肯","110/08/11","美商高盛",0,25,-25
"13887","1570力肯","110/08/11","凱基-中壢",27,3,24
"13888","1570力肯","110/08/11","國票-北高雄",128,153,-25
"13889","1570力肯","110/08/11","元大-福營",25,1,24
"13890","1570力肯","110/08/11","元富-新店",10,34,-24
"13891","6180橘子","110/08/11","台灣摩根士丹利",42,7,35
"13892","6180橘子","110/08/11","港商野村",5,128,-123
"13893","6180橘子","110/08/11","美商高盛",25,0,25
"13894","6180橘子","110/08/11","合庫-高雄",0,31,-31
"13895","6180橘子","110/08/11","元大-草屯",17,0,17
"13896","6180橘子","110/08/11","摩根大通",13,36,-23
"13897","6180橘子","110/08/11","日盛-文化",16,0,16
"13898","6180橘子","110/08/11","凱基-台北",37,60,-23
"13899","6180橘子","110/08/11","康和-嘉義",11,0,11
"13900","6180橘子","110/08/11","北城證券",0,19,-19
"13901","6180橘子","110/08/11","元大-左營",11,0,11
"13902","6180橘子","110/08/11","元富-潮州",24,41,-17
"13903","6180橘子","110/08/11","土銀-花蓮",10,0,10
"13904","6180橘子","110/08/11","群益金鼎-新店",0,15,-15
"13905","6180橘子","110/08/11","日盛證券",10,0,10
"13906","6180橘子","110/08/11","兆豐-竹北",0,14,-14
"13907","6180橘子","110/08/11","日盛-高雄",10,0,10
"13908","6180橘子","110/08/11","元富-成功",0,13,-13
"13909","6180橘子","110/08/11","國泰-新莊",10,0,10
"13910","6180橘子","110/08/11","新加坡商瑞銀",0,10,-10
"13911","6180橘子","110/08/11","群益金鼎-東門",10,0,10
"13912","6180橘子","110/08/11","康和-高雄",0,10,-10
"13913","6180橘子","110/08/11","凱基-中壢",10,0,10
"13914","6180橘子","110/08/11","國泰-館前",0,10,-10
"13915","6180橘子","110/08/11","元大-中壢",10,0,10
"13916","6180橘子","110/08/11","群益金鼎-嘉義",1,11,-10
"13917","6180橘子","110/08/11","元大-復北",10,0,10
"13918","6180橘子","110/08/11","華南永昌-虎尾",0,10,-10
"13919","6180橘子","110/08/11","美林",12,3,9
"13920","6180橘子","110/08/11","元富-民權",0,8,-8
"13921","2390云辰","110/08/11","臺銀-臺中",224,5,219
"13922","2390云辰","110/08/11","摩根大通",194,707,-513
"13923","2390云辰","110/08/11","兆豐-寶成",187,2,185
"13924","2390云辰","110/08/11","美商高盛",18,229,-211
"13925","2390云辰","110/08/11","元大-土城學府",143,69,74
"13926","2390云辰","110/08/11","兆豐-岡山",5,103,-98
"13927","2390云辰","110/08/11","凱基-民權",70,0,70
"13928","2390云辰","110/08/11","台新證券",13,108,-95
"13929","2390云辰","110/08/11","元大-草屯",67,2,65
"13930","2390云辰","110/08/11","美林",23,98,-75
"13931","2390云辰","110/08/11","兆豐-公益",60,0,60
"13932","2390云辰","110/08/11","永豐金-竹科",0,71,-71
"13933","2390云辰","110/08/11","國票-安和",56,0,56
"13934","2390云辰","110/08/11","元富-花蓮",0,70,-70
"13935","2390云辰","110/08/11","元富-中港",50,0,50
"13936","2390云辰","110/08/11","統一-城中",5,66,-61
"13937","2390云辰","110/08/11","元富-高雄",48,1,47
"13938","2390云辰","110/08/11","國泰-台中",50,109,-59
"13939","2390云辰","110/08/11","統一-新營",45,5,40
"13940","2390云辰","110/08/11","元大-豐原站前",10,69,-59
"13941","2390云辰","110/08/11","元大-板橋三民",39,1,38
"13942","2390云辰","110/08/11","新加坡商瑞銀",18,75,-57
"13943","2390云辰","110/08/11","元富-新店",52,17,35
"13944","2390云辰","110/08/11","台新-左楠",15,67,-52
"13945","2390云辰","110/08/11","永全-南崁",35,4,31
"13946","2390云辰","110/08/11","凱基-中壢",7,59,-52
"13947","2390云辰","110/08/11","群益金鼎-萬華",33,3,30
"13948","2390云辰","110/08/11","國票-北高雄",23,69,-46
"13949","2390云辰","110/08/11","日盛-宜蘭",25,0,25
"13950","2390云辰","110/08/11","新光-高雄",11,53,-42
"13951","2542興富發","110/08/06","瑞士信貸",747,10,737
"13952","2542興富發","110/08/06","凱基-士林",5,972,-967
"13953","2542興富發","110/08/06","摩根大通",837,107,730
"13954","2542興富發","110/08/06","統一-台中",1,376,-375
"13955","2542興富發","110/08/06","群益金鼎-敦南",681,1,680
"13956","2542興富發","110/08/06","永豐金-豐原",16,133,-117
"13957","2542興富發","110/08/06","凱基-台北",790,360,430
"13958","2542興富發","110/08/06","元富-敦南",0,111,-111
"13959","2542興富發","110/08/06","台灣摩根士丹利",259,20,239
"13960","2542興富發","110/08/06","兆豐-南京",0,108,-108
"13961","2542興富發","110/08/06","美商高盛",235,0,235
"13962","2542興富發","110/08/06","元大-金華",0,100,-100
"13963","2542興富發","110/08/06","新加坡商瑞銀",178,0,178
"13964","2542興富發","110/08/06","陽信",0,80,-80
"13965","2542興富發","110/08/06","凱基-中山",167,2,165
"13966","2542興富發","110/08/06","統一-金門",0,78,-78
"13967","2542興富發","110/08/06","凱基",121,14,107
"13968","2542興富發","110/08/06","新光-台中",7,68,-61
"13969","2542興富發","110/08/06","大慶-楊梅",101,4,97
"13970","2542興富發","110/08/06","富邦-新店",2,58,-56
"13971","2542興富發","110/08/06","美林",193,109,84
"13972","2542興富發","110/08/06","元大-新竹",0,52,-52
"13973","2542興富發","110/08/06","統一",64,5,59
"13974","2542興富發","110/08/06","凱基-永和",0,51,-51
"13975","2542興富發","110/08/06","富邦-南屯",60,1,59
"13976","2542興富發","110/08/06","統一-中壢",0,50,-50
"13977","2542興富發","110/08/06","群益金鼎",43,0,43
"13978","2542興富發","110/08/06","元富",0,50,-50
"13979","2542興富發","110/08/06","元大證券",128,85,43
"13980","2542興富發","110/08/06","法銀巴黎",0,48,-48
"13981","2867三商壽","110/08/06","摩根大通",410,157,253
"13982","2867三商壽","110/08/06","日盛-新莊",0,719,-719
"13983","2867三商壽","110/08/06","元大-北港",201,0,201
"13984","2867三商壽","110/08/06","群益金鼎-桃園",0,400,-400
"13985","2867三商壽","110/08/06","元大-斗信",200,0,200
"13986","2867三商壽","110/08/06","中國信託-文心",1,301,-300
"13987","2867三商壽","110/08/06","元大-沙鹿",199,0,199
"13988","2867三商壽","110/08/06","美林",10,169,-159
"13989","2867三商壽","110/08/06","永豐金-嘉義",130,0,130
"13990","2867三商壽","110/08/06","法銀巴黎",0,122,-122
"13991","2867三商壽","110/08/06","第一金-自由",100,0,100
"13992","2867三商壽","110/08/06","國票-中和",0,100,-100
"13993","2867三商壽","110/08/06","元大-大里德芳",100,0,100
"13994","2867三商壽","110/08/06","台灣摩根士丹利",65,164,-99
"13995","2867三商壽","110/08/06","元大-土城永寧",100,0,100
"13996","2867三商壽","110/08/06","凱基-高美館",2,64,-62
"13997","2867三商壽","110/08/06","瑞士信貸",94,0,94
"13998","2867三商壽","110/08/06","元大證券",1,62,-61
"13999","2867三商壽","110/08/06","元大-汐止",60,0,60
"14000","2867三商壽","110/08/06","華南永昌-南京",0,50,-50
"14001","2867三商壽","110/08/06","元富-大裕",52,0,52
"14002","2867三商壽","110/08/06","凱基-頭份",0,45,-45
"14003","2867三商壽","110/08/06","新光",53,1,52
"14004","2867三商壽","110/08/06","凱基",0,44,-44
"14005","2867三商壽","110/08/06","凱基-市府",51,0,51
"14006","2867三商壽","110/08/06","康和-屏東",0,43,-43
"14007","2867三商壽","110/08/06","安泰",49,0,49
"14008","2867三商壽","110/08/06","凱基-八德",0,40,-40
"14009","2867三商壽","110/08/06","富邦-桃園",50,2,48
"14010","2867三商壽","110/08/06","凱基-虎尾",0,40,-40
"14011","5521工信","110/08/06","日進",412,0,412
"14012","5521工信","110/08/06","中國信託-嘉義",0,100,-100
"14013","5521工信","110/08/06","瑞士信貸",48,0,48
"14014","5521工信","110/08/06","美林",0,69,-69
"14015","5521工信","110/08/06","日盛-雙和",34,0,34
"14016","5521工信","110/08/06","統一-新竹",0,60,-60
"14017","5521工信","110/08/06","聯邦-雙和",25,0,25
"14018","5521工信","110/08/06","第一金-桃園",0,55,-55
"14019","5521工信","110/08/06","台新證券",32,12,20
"14020","5521工信","110/08/06","凱基-台北",0,54,-54
"14021","5521工信","110/08/06","土銀-台中",17,0,17
"14022","5521工信","110/08/06","華南永昌-桃園",0,49,-49
"14023","5521工信","110/08/06","(牛牛牛)亞-鑫豐",15,0,15
"14024","5521工信","110/08/06","第一金-安和",0,40,-40
"14025","5521工信","110/08/06","元大-沙鹿",19,4,15
"14026","5521工信","110/08/06","合庫-台南",0,36,-36
"14027","5521工信","110/08/06","元富-安南",14,0,14
"14028","5521工信","110/08/06","台灣摩根士丹利",7,34,-27
"14029","5521工信","110/08/06","新加坡商瑞銀",10,0,10
"14030","5521工信","110/08/06","摩根大通",22,48,-26
"14031","5521工信","110/08/06","德信-中正",10,0,10
"14032","5521工信","110/08/06","台新-台中",0,20,-20
"14033","5521工信","110/08/06","國泰-敦南",22,12,10
"14034","5521工信","110/08/06","元大-豐原",0,20,-20
"14035","5521工信","110/08/06","群益金鼎-屏東",10,0,10
"14036","5521工信","110/08/06","元大-北成功",0,20,-20
"14037","5521工信","110/08/06","群益金鼎-東門",10,0,10
"14038","5521工信","110/08/06","永豐金-埔里",0,20,-20
"14039","5521工信","110/08/06","元大-西螺",10,0,10
"14040","5521工信","110/08/06","港商野村",0,16,-16
"14041","1471首利","110/08/06","國票-彰化",30,0,30
"14042","1471首利","110/08/06","兆豐-麻豆",0,50,-50
"14043","1471首利","110/08/06","凱基-宜蘭",27,0,27
"14044","1471首利","110/08/06","台新證券",3,30,-27
"14045","1471首利","110/08/06","玉山-桃園",22,0,22
"14046","1471首利","110/08/06","美林",15,41,-26
"14047","1471首利","110/08/06","新光-台中",17,0,17
"14048","1471首利","110/08/06","永豐金-台南",0,25,-25
"14049","1471首利","110/08/06","兆豐-埔墘",14,0,14
"14050","1471首利","110/08/06","元富-草屯",0,19,-19
"14051","1471首利","110/08/06","新光-高雄",11,0,11
"14052","1471首利","110/08/06","新光-桃園",0,17,-17
"14053","1471首利","110/08/06","合庫-鳳山",10,0,10
"14054","1471首利","110/08/06","摩根大通",13,28,-15
"14055","1471首利","110/08/06","統一-竹南",10,0,10
"14056","1471首利","110/08/06","華南永昌-淡水",1,15,-14
"14057","1471首利","110/08/06","(牛牛牛)亞-鑫豐",10,0,10
"14058","1471首利","110/08/06","台中銀",1,14,-13
"14059","1471首利","110/08/06","兆豐-岡山",10,0,10
"14060","1471首利","110/08/06","玉山-板橋",0,12,-12
"14061","1471首利","110/08/06","凱基-彰化",10,0,10
"14062","1471首利","110/08/06","富邦-基隆",10,22,-12
"14063","1471首利","110/08/06","富邦-永和",10,0,10
"14064","1471首利","110/08/06","台灣企銀",0,10,-10
"14065","1471首利","110/08/06","元大-竹山",10,0,10
"14066","1471首利","110/08/06","元富-民權",0,10,-10
"14067","1471首利","110/08/06","元大-民雄",10,0,10
"14068","1471首利","110/08/06","元大-左營",0,10,-10
"14069","1471首利","110/08/06","元大-南崁",10,1,9
"14070","1471首利","110/08/06","大昌-新店",2,11,-9
"14071","2883開發金","110/08/06","國泰證券",7766,49,7717
"14072","2883開發金","110/08/06","永豐金-板橋",2,2245,-2243
"14073","2883開發金","110/08/06","元富-城東",7094,124,6970
"14074","2883開發金","110/08/06","玉山-台南",63,2130,-2067
"14075","2883開發金","110/08/06","摩根大通",4922,1097,3825
"14076","2883開發金","110/08/06","國泰-板橋",236,1871,-1635
"14077","2883開發金","110/08/06","瑞士信貸",3230,108,3122
"14078","2883開發金","110/08/06","港商野村",1243,2562,-1319
"14079","2883開發金","110/08/06","凱基-台北",4810,2311,2499
"14080","2883開發金","110/08/06","美林",1480,2782,-1302
"14081","2883開發金","110/08/06","合庫證券",3551,2064,1487
"14082","2883開發金","110/08/06","群益金鼎-中山",7,1151,-1144
"14083","2883開發金","110/08/06","新加坡商瑞銀",3900,2689,1211
"14084","2883開發金","110/08/06","日盛-員林",17,1100,-1083
"14085","2883開發金","110/08/06","玉山證券",1332,183,1149
"14086","2883開發金","110/08/06","台灣摩根士丹利",509,1544,-1035
"14087","2883開發金","110/08/06","國票-長城",1003,0,1003
"14088","2883開發金","110/08/06","台灣企銀-民雄",0,1004,-1004
"14089","2883開發金","110/08/06","康和",720,0,720
"14090","2883開發金","110/08/06","港商法國興業",7,981,-974
"14091","2883開發金","110/08/06","福邦證券",590,15,575
"14092","2883開發金","110/08/06","新光",240,1199,-959
"14093","2883開發金","110/08/06","台灣企銀-九如",492,10,482
"14094","2883開發金","110/08/06","元大-新莊",58,1017,-959
"14095","2883開發金","110/08/06","宏遠-民生",502,54,448
"14096","2883開發金","110/08/06","富邦-彰化",5,766,-761
"14097","2883開發金","110/08/06","元大證券",803,358,445
"14098","2883開發金","110/08/06","中國信託",270,931,-661
"14099","2883開發金","110/08/06","玉山-高雄",476,80,396
"14100","2883開發金","110/08/06","永豐金-彰化",33,655,-622
"14101","6205詮欣","110/08/06","臺銀-民權",20,0,20
"14102","6205詮欣","110/08/06","元大-板橋",0,50,-50
"14103","6205詮欣","110/08/06","合庫-三重",15,0,15
"14104","6205詮欣","110/08/06","摩根大通",0,29,-29
"14105","6205詮欣","110/08/06","日盛-三重",15,4,11
"14106","6205詮欣","110/08/06","臺銀-新竹",0,3,-3
"14107","6205詮欣","110/08/06","凱基-長庚",10,0,10
"14108","6205詮欣","110/08/06","日盛-頭份",0,3,-3
"14109","6205詮欣","110/08/06","臺銀-臺中",5,0,5
"14110","6205詮欣","110/08/06","群益金鼎-潭子",0,3,-3
"14111","6205詮欣","110/08/06","兆豐-台中",4,0,4
"14112","6205詮欣","110/08/06","永豐金-敦南",0,3,-3
"14113","6205詮欣","110/08/06","凱基-台北",4,0,4
"14114","6205詮欣","110/08/06","美林",0,2,-2
"14115","6205詮欣","110/08/06","元大-龍潭",4,0,4
"14116","6205詮欣","110/08/06","新加坡商瑞銀",6,8,-2
"14117","6205詮欣","110/08/06","瑞士信貸",3,0,3
"14118","6205詮欣","110/08/06","華南永昌-淡水",0,2,-2
"14119","6205詮欣","110/08/06","國泰-板橋",3,0,3
"14120","6205詮欣","110/08/06","元大-發財",0,2,-2
"14121","6205詮欣","110/08/06","台中銀",2,0,2
"14122","6205詮欣","110/08/06","元大-屏東民生",0,2,-2
"14123","6205詮欣","110/08/06","德信-新營",2,0,2
"14124","6205詮欣","110/08/06","統一-南京",0,1,-1
"14125","6205詮欣","110/08/06","兆豐-竹北",2,0,2
"14126","6205詮欣","110/08/06","新光-台中",0,1,-1
"14127","6205詮欣","110/08/06","兆豐-景美",2,0,2
"14128","6205詮欣","110/08/06","玉山證券",0,1,-1
"14129","6205詮欣","110/08/06","台新-台中",2,0,2
"14130","6205詮欣","110/08/06","富邦-左營",0,1,-1
"14131","1540喬福","110/08/06","元富-中原",27,0,27
"14132","1540喬福","110/08/06","統一-新台中",0,25,-25
"14133","1540喬福","110/08/06","合庫-台中",24,0,24
"14134","1540喬福","110/08/06","大慶-中壢",0,24,-24
"14135","1540喬福","110/08/06","台新-台中",10,0,10
"14136","1540喬福","110/08/06","福勝",0,7,-7
"14137","1540喬福","110/08/06","富邦-竹北",7,0,7
"14138","1540喬福","110/08/06","群益金鼎-高雄",0,5,-5
"14139","1540喬福","110/08/06","華南永昌-中正",5,0,5
"14140","1540喬福","110/08/06","富邦-高雄",0,5,-5
"14141","1540喬福","110/08/06","玉山證券",4,0,4
"14142","1540喬福","110/08/06","美林",0,3,-3
"14143","1540喬福","110/08/06","兆豐-台中港",2,0,2
"14144","1540喬福","110/08/06","元大-景美",0,3,-3
"14145","1540喬福","110/08/06","國票-中正",2,0,2
"14146","1540喬福","110/08/06","元大-和平",0,3,-3
"14147","1540喬福","110/08/06","凱基-虎尾",2,0,2
"14148","1540喬福","110/08/06","日盛-台中",0,2,-2
"14149","1540喬福","110/08/06","凱基-台北",2,0,2
"14150","1540喬福","110/08/06","日盛-中和",0,2,-2
"14151","1540喬福","110/08/06","元大-府城",2,0,2
"14152","1540喬福","110/08/06","台新-台南",0,2,-2
"14153","1540喬福","110/08/06","土銀-玉里",1,0,1
"14154","1540喬福","110/08/06","玉山-高雄",0,2,-2
"14155","1540喬福","110/08/06","第一金-中壢",1,0,1
"14156","1540喬福","110/08/06","凱基-中壢",0,2,-2
"14157","1540喬福","110/08/06","國票-彰化",1,0,1
"14158","1540喬福","110/08/06","致和-南京",0,1,-1
"14159","1540喬福","110/08/06","國泰-敦南",1,0,1
"14160","1540喬福","110/08/06","摩根大通",0,1,-1
"14161","2888新光金","110/08/06","玉山-城中",3762,22,3740
"14162","2888新光金","110/08/06","美林",583,3191,-2608
"14163","2888新光金","110/08/06","瑞士信貸",1783,778,1005
"14164","2888新光金","110/08/06","元富-城東",39,1594,-1555
"14165","2888新光金","110/08/06","元大-土城永寧",1004,16,988
"14166","2888新光金","110/08/06","日盛-板橋",19,1000,-981
"14167","2888新光金","110/08/06","新加坡商瑞銀",1129,357,772
"14168","2888新光金","110/08/06","摩根大通",2207,3153,-946
"14169","2888新光金","110/08/06","中國信託",566,4,562
"14170","2888新光金","110/08/06","新光",505,1390,-885
"14171","2888新光金","110/08/06","富邦-員林",484,3,481
"14172","2888新光金","110/08/06","台灣摩根士丹利",181,1022,-841
"14173","2888新光金","110/08/06","臺銀-金山",432,3,429
"14174","2888新光金","110/08/06","元大-四維",35,750,-715
"14175","2888新光金","110/08/06","臺銀",418,2,416
"14176","2888新光金","110/08/06","美商高盛",114,811,-697
"14177","2888新光金","110/08/06","凱基-東勢",404,6,398
"14178","2888新光金","110/08/06","法銀巴黎",274,867,-593
"14179","2888新光金","110/08/06","玉山證券",416,73,343
"14180","2888新光金","110/08/06","元大-員林",18,503,-485
"14181","2888新光金","110/08/06","華南永昌-民權",305,0,305
"14182","2888新光金","110/08/06","富邦-建國",57,471,-414
"14183","2888新光金","110/08/06","永興",300,10,290
"14184","2888新光金","110/08/06","富邦-台中",15,418,-403
"14185","2888新光金","110/08/06","富邦-台北",319,48,271
"14186","2888新光金","110/08/06","華南永昌-嘉義",2,324,-322
"14187","2888新光金","110/08/06","兆豐-員林",274,28,246
"14188","2888新光金","110/08/06","凱基-台北",839,1120,-281
"14189","2888新光金","110/08/06","合庫-台中",240,10,230
"14190","2888新光金","110/08/06","國泰-館前",20,289,-269
"14191","1340勝悅","110/08/06","國泰-台中",30,0,30
"14192","1340勝悅","110/08/06","凱基-三峽",0,20,-20
"14193","1340勝悅","110/08/06","元富-彰化",10,0,10
"14194","1340勝悅","110/08/06","富邦-台東",1,14,-13
"14195","1340勝悅","110/08/06","華南永昌-忠孝",8,0,8
"14196","1340勝悅","110/08/06","華南永昌-三重",0,12,-12
"14197","1340勝悅","110/08/06","華南永昌-大安",7,0,7
"14198","1340勝悅","110/08/06","華南永昌-台中",0,10,-10
"14199","1340勝悅","110/08/06","永豐金-信義",6,0,6
"14200","1340勝悅","110/08/06","美林",0,8,-8
"14201","1340勝悅","110/08/06","臺灣企銀-埔墘",5,0,5
"14202","1340勝悅","110/08/06","第一金-豐原",0,8,-8
"14203","1340勝悅","110/08/06","元大-沙鹿",5,0,5
"14204","1340勝悅","110/08/06","凱基-城中",0,8,-8
"14205","1340勝悅","110/08/06","新光-高雄",4,0,4
"14206","1340勝悅","110/08/06","華南永昌-嘉義",0,6,-6
"14207","1340勝悅","110/08/06","群益金鼎-彰化",4,0,4
"14208","1340勝悅","110/08/06","元富",0,5,-5
"14209","1340勝悅","110/08/06","元大-仁愛",4,0,4
"14210","1340勝悅","110/08/06","光和-田中",0,5,-5
"14211","1340勝悅","110/08/06","美商高盛",3,0,3
"14212","1340勝悅","110/08/06","摩根大通",0,5,-5
"14213","1340勝悅","110/08/06","群益金鼎-館前",3,0,3
"14214","1340勝悅","110/08/06","元大-草屯",0,4,-4
"14215","1340勝悅","110/08/06","臺銀-臺中",2,0,2
"14216","1340勝悅","110/08/06","凱基-台北",1,4,-3
"14217","1340勝悅","110/08/06","永全-南崁",2,0,2
"14218","1340勝悅","110/08/06","元大-苑裡",0,3,-3
"14219","1340勝悅","110/08/06","群益金鼎-崇德",2,0,2
"14220","1340勝悅","110/08/06","日盛-員林",0,2,-2
"14221","6246臺龍","110/08/06","元大-西螺",120,1,119
"14222","6246臺龍","110/08/06","統一",0,247,-247
"14223","6246臺龍","110/08/06","富邦-敦南",111,0,111
"14224","6246臺龍","110/08/06","元大-林森",3,203,-200
"14225","6246臺龍","110/08/06","統一-台中",74,10,64
"14226","6246臺龍","110/08/06","凱基-大直",4,103,-99
"14227","6246臺龍","110/08/06","日盛證券",53,0,53
"14228","6246臺龍","110/08/06","大慶-富順",45,110,-65
"14229","6246臺龍","110/08/06","兆豐-高雄",81,38,43
"14230","6246臺龍","110/08/06","統一-南京",20,70,-50
"14231","6246臺龍","110/08/06","群益金鼎-東大",43,2,41
"14232","6246臺龍","110/08/06","港商野村",166,213,-47
"14233","6246臺龍","110/08/06","統一-永和",40,0,40
"14234","6246臺龍","110/08/06","台灣企銀",0,45,-45
"14235","6246臺龍","110/08/06","凱基-市府",48,8,40
"14236","6246臺龍","110/08/06","華南永昌-忠孝",1,45,-44
"14237","6246臺龍","110/08/06","凱基-員林",40,0,40
"14238","6246臺龍","110/08/06","永豐金-桃盛",0,35,-35
"14239","6246臺龍","110/08/06","新光-高雄",57,21,36
"14240","6246臺龍","110/08/06","康和-澎湖",0,30,-30
"14241","6246臺龍","110/08/06","國泰-敦南",104,69,35
"14242","6246臺龍","110/08/06","康和-石牌",0,30,-30
"14243","6246臺龍","110/08/06","元大-金門",39,5,34
"14244","6246臺龍","110/08/06","中國信託-永康",6,35,-29
"14245","6246臺龍","110/08/06","元大-西屯",29,2,27
"14246","6246臺龍","110/08/06","康和-內湖",2,30,-28
"14247","6246臺龍","110/08/06","永興-水湳",26,1,25
"14248","6246臺龍","110/08/06","大昌",16,43,-27
"14249","6246臺龍","110/08/06","元大-豐原站前",25,0,25
"14250","6246臺龍","110/08/06","台新證券",29,55,-26
"14251","00715L期街口布蘭特正2","110/08/06","華南永昌-長虹",810,50,760
"14252","00715L期街口布蘭特正2","110/08/06","永豐金證券",105,2122,-2017
"14253","00715L期街口布蘭特正2","110/08/06","富邦證券",557,0,557
"14254","00715L期街口布蘭特正2","110/08/06","(牛牛牛)亞-鑫豐",23,892,-869
"14255","00715L期街口布蘭特正2","110/08/06","新光",643,129,514
"14256","00715L期街口布蘭特正2","110/08/06","凱基-台北",1,789,-788
"14257","00715L期街口布蘭特正2","110/08/06","台新-新營",434,0,434
"14258","00715L期街口布蘭特正2","110/08/06","元大-永康",0,781,-781
"14259","00715L期街口布蘭特正2","110/08/06","群益金鼎-屏東",401,0,401
"14260","00715L期街口布蘭特正2","110/08/06","富邦-彰化",0,513,-513
"14261","00715L期街口布蘭特正2","110/08/06","永豐金-板盛",402,21,381
"14262","00715L期街口布蘭特正2","110/08/06","玉山-大里",0,488,-488
"14263","00715L期街口布蘭特正2","110/08/06","兆豐-員林",302,6,296
"14264","00715L期街口布蘭特正2","110/08/06","元大-中和",0,400,-400
"14265","00715L期街口布蘭特正2","110/08/06","兆豐-新莊",260,0,260
"14266","00715L期街口布蘭特正2","110/08/06","元富-安南",2,310,-308
"14267","00715L期街口布蘭特正2","110/08/06","宏遠-光隆",252,0,252
"14268","00715L期街口布蘭特正2","110/08/06","元大-羅東",5,304,-299
"14269","00715L期街口布蘭特正2","110/08/06","台中銀",207,0,207
"14270","00715L期街口布蘭特正2","110/08/06","第一金-路竹",13,273,-260
"14271","00715L期街口布蘭特正2","110/08/06","國票-北高雄",204,0,204
"14272","00715L期街口布蘭特正2","110/08/06","元大-新盛",5,247,-242
"14273","00715L期街口布蘭特正2","110/08/06","永豐金-新店",200,4,196
"14274","00715L期街口布蘭特正2","110/08/06","元大-忠孝",0,202,-202
"14275","00715L期街口布蘭特正2","110/08/06","元大-新莊",211,17,194
"14276","00715L期街口布蘭特正2","110/08/06","兆豐-嘉義",8,200,-192
"14277","00715L期街口布蘭特正2","110/08/06","聯邦-興中",185,0,185
"14278","00715L期街口布蘭特正2","110/08/06","元大-西屯",5,190,-185
"14279","00715L期街口布蘭特正2","110/08/06","元富-成功",244,62,182
"14280","00715L期街口布蘭特正2","110/08/06","元大-前金",1,181,-180
"14281","8941關中","110/08/06","第一金-台南",6,0,6
"14282","8941關中","110/08/06","富邦-員林",0,20,-20
"14283","8941關中","110/08/06","凱基-市府",6,0,6
"14284","8941關中","110/08/06","元大-金華",0,1,-1
"14285","8941關中","110/08/06","合庫-台中",5,0,5
"14286","8941關中","110/08/06","元大-淡水",0,1,-1
"14287","8941關中","110/08/06","永豐金-三重",2,0,2
"14288","8941關中","110/08/06","合庫證券",0,0,0
"14289","8941關中","110/08/06","(牛牛牛)亞-鑫豐",1,0,1
"14290","8941關中","110/08/06","元大證券",0,0,0
"14291","8941關中","110/08/06","群益金鼎-基隆",1,0,1
"14292","8941關中","110/08/06","元大-桃興",2,2,0
"14293","8941關中","110/08/06","元大-古亭",1,0,1
"14294","8941關中","110/08/06","元大-板橋",0,0,0
"14295","8941關中","110/08/06","合庫證券",0,0,0
"14296","8941關中","110/08/06","永豐金-萬盛",0,0,0
"14297","8941關中","110/08/06","元大證券",0,0,0
"14298","8941關中","110/08/06","",NA,NA,NA
"14299","8941關中","110/08/06","元大-桃興",2,2,0
"14300","8941關中","110/08/06","",NA,NA,NA
"14301","8941關中","110/08/06","元大-板橋",0,0,0
"14302","8941關中","110/08/06","",NA,NA,NA
"14303","8941關中","110/08/06","永豐金-萬盛",0,0,0
"14304","8941關中","110/08/06","",NA,NA,NA
"14305","8941關中","110/08/06","",NA,NA,NA
"14306","8941關中","110/08/06","",NA,NA,NA
"14307","8941關中","110/08/06","",NA,NA,NA
"14308","8941關中","110/08/06","",NA,NA,NA
"14309","8941關中","110/08/06","",NA,NA,NA
"14310","8941關中","110/08/06","",NA,NA,NA
"14311","8936國統","110/08/06","摩根大通",55,0,55
"14312","8936國統","110/08/06","大慶-蘆洲",1,63,-62
"14313","8936國統","110/08/06","凱基-台北",66,19,47
"14314","8936國統","110/08/06","宏遠-館前",0,50,-50
"14315","8936國統","110/08/06","國票-敦北法人",25,1,24
"14316","8936國統","110/08/06","凱基-長庚",0,46,-46
"14317","8936國統","110/08/06","元大-大里德芳",22,0,22
"14318","8936國統","110/08/06","台灣摩根士丹利",0,42,-42
"14319","8936國統","110/08/06","兆豐-新營",20,0,20
"14320","8936國統","110/08/06","永豐金-苓雅",15,48,-33
"14321","8936國統","110/08/06","新光-新竹",17,0,17
"14322","8936國統","110/08/06","元大-竹東",0,30,-30
"14323","8936國統","110/08/06","新光-台中",17,4,13
"14324","8936國統","110/08/06","新加坡商瑞銀",23,49,-26
"14325","8936國統","110/08/06","元富-新店",10,0,10
"14326","8936國統","110/08/06","國票-北高雄",0,25,-25
"14327","8936國統","110/08/06","中國信託-永康",10,0,10
"14328","8936國統","110/08/06","國泰-台南",0,20,-20
"14329","8936國統","110/08/06","台新-高雄",11,1,10
"14330","8936國統","110/08/06","國泰-敦南",7,24,-17
"14331","8936國統","110/08/06","國泰-板橋",10,0,10
"14332","8936國統","110/08/06","臺灣企銀-桃園",0,13,-13
"14333","8936國統","110/08/06","群益金鼎-東湖",10,0,10
"14334","8936國統","110/08/06","美商高盛",1,13,-12
"14335","8936國統","110/08/06","元大-北成功",10,0,10
"14336","8936國統","110/08/06","合庫-高雄",0,10,-10
"14337","8936國統","110/08/06","臺銀-高雄",9,0,9
"14338","8936國統","110/08/06","臺銀",0,10,-10
"14339","8936國統","110/08/06","日盛-和美",9,0,9
"14340","8936國統","110/08/06","元大-土城學府",0,10,-10
"14341","6226光鼎","110/08/06","國泰-敦南",183,87,96
"14342","6226光鼎","110/08/06","富邦-嘉義",286,537,-251
"14343","6226光鼎","110/08/06","台新-高雄",129,53,76
"14344","6226光鼎","110/08/06","統一-新竹",30,181,-151
"14345","6226光鼎","110/08/06","新光",81,25,56
"14346","6226光鼎","110/08/06","宏遠-台中",0,118,-118
"14347","6226光鼎","110/08/06","台新證券",112,57,55
"14348","6226光鼎","110/08/06","華南永昌-大安",2,82,-80
"14349","6226光鼎","110/08/06","台新-新營",56,4,52
"14350","6226光鼎","110/08/06","元富-西松",1,76,-75
"14351","6226光鼎","110/08/06","中國信託",48,7,41
"14352","6226光鼎","110/08/06","凱基-豐中",1,74,-73
"14353","6226光鼎","110/08/06","富邦-板橋",38,5,33
"14354","6226光鼎","110/08/06","凱基-長庚",3,64,-61
"14355","6226光鼎","110/08/06","台新-中壢",32,0,32
"14356","6226光鼎","110/08/06","元富-高雄",2,58,-56
"14357","6226光鼎","110/08/06","日盛-北高雄",32,1,31
"14358","6226光鼎","110/08/06","永豐金-萬盛",2,49,-47
"14359","6226光鼎","110/08/06","群益金鼎-桃園",31,0,31
"14360","6226光鼎","110/08/06","統一-仁愛",11,57,-46
"14361","6226光鼎","110/08/06","元大-屏東民生",31,0,31
"14362","6226光鼎","110/08/06","國票-台中",0,46,-46
"14363","6226光鼎","110/08/06","中國信託-永康",35,5,30
"14364","6226光鼎","110/08/06","群益金鼎-嘉義",11,55,-44
"14365","6226光鼎","110/08/06","國泰-台中",57,27,30
"14366","6226光鼎","110/08/06","元大-沙鹿",6,50,-44
"14367","6226光鼎","110/08/06","群益金鼎-板橋",30,0,30
"14368","6226光鼎","110/08/06","新光-高雄",17,58,-41
"14369","6226光鼎","110/08/06","寶盛",29,0,29
"14370","6226光鼎","110/08/06","元大-嘉義",3,36,-33
"14371","2363矽統","110/08/06","新加坡商瑞銀",1338,777,561
"14372","2363矽統","110/08/06","凱基-台北",4343,7347,-3004
"14373","2363矽統","110/08/06","日盛-三峽",475,86,389
"14374","2363矽統","110/08/06","摩根大通",1716,2908,-1192
"14375","2363矽統","110/08/06","中國信託-忠孝",433,44,389
"14376","2363矽統","110/08/06","美商高盛",315,1169,-854
"14377","2363矽統","110/08/06","陽信-石牌",448,73,375
"14378","2363矽統","110/08/06","永豐金證券",168,889,-721
"14379","2363矽統","110/08/06","國泰-台中",743,471,272
"14380","2363矽統","110/08/06","國票-敦北法人",29,513,-484
"14381","2363矽統","110/08/06","國泰-敦南",2177,1919,258
"14382","2363矽統","110/08/06","元富-嘉義",43,424,-381
"14383","2363矽統","110/08/06","台新-台中",565,347,218
"14384","2363矽統","110/08/06","元大-東泰",174,540,-366
"14385","2363矽統","110/08/06","元大-敦化",246,31,215
"14386","2363矽統","110/08/06","元大證券",187,522,-335
"14387","2363矽統","110/08/06","大昌-桃園",241,51,190
"14388","2363矽統","110/08/06","合庫證券",173,495,-322
"14389","2363矽統","110/08/06","華南永昌-淡水",230,48,182
"14390","2363矽統","110/08/06","元大-萬華",128,391,-263
"14391","2363矽統","110/08/06","港商野村",2381,2203,178
"14392","2363矽統","110/08/06","國票-博愛",93,350,-257
"14393","2363矽統","110/08/06","台新-高雄",529,361,168
"14394","2363矽統","110/08/06","台新-屏東",200,455,-255
"14395","2363矽統","110/08/06","元大-新竹",320,156,164
"14396","2363矽統","110/08/06","日盛-南京",74,327,-253
"14397","2363矽統","110/08/06","元大-中壢",454,292,162
"14398","2363矽統","110/08/06","兆豐-民生",16,227,-211
"14399","2363矽統","110/08/06","新光-台南",310,150,160
"14400","2363矽統","110/08/06","元大-旗山",168,364,-196
"14401","8112至上","110/08/06","新光-新竹",533,65,468
"14402","8112至上","110/08/06","摩根大通",12,2930,-2918
"14403","8112至上","110/08/06","國泰-新莊",192,0,192
"14404","8112至上","110/08/06","凱基-台北",388,1548,-1160
"14405","8112至上","110/08/06","合庫證券",195,11,184
"14406","8112至上","110/08/06","新加坡商瑞銀",17,1069,-1052
"14407","8112至上","110/08/06","元大-西門",178,2,176
"14408","8112至上","110/08/06","台灣摩根士丹利",48,955,-907
"14409","8112至上","110/08/06","(牛牛牛)亞-鑫豐",153,13,140
"14410","8112至上","110/08/06","元大-竹科",61,824,-763
"14411","8112至上","110/08/06","永豐金-中正",120,1,119
"14412","8112至上","110/08/06","美林",19,583,-564
"14413","8112至上","110/08/06","陽信",111,0,111
"14414","8112至上","110/08/06","瑞士信貸",0,547,-547
"14415","8112至上","110/08/06","康和-板橋",106,0,106
"14416","8112至上","110/08/06","康和",2,484,-482
"14417","8112至上","110/08/06","群益金鼎-延平",101,0,101
"14418","8112至上","110/08/06","永豐金-台中",17,430,-413
"14419","8112至上","110/08/06","元大-北成功",110,14,96
"14420","8112至上","110/08/06","元大-屏南",4,393,-389
"14421","8112至上","110/08/06","元富-古亭",141,46,95
"14422","8112至上","110/08/06","美商高盛",12,217,-205
"14423","8112至上","110/08/06","臺灣企銀-埔墘",92,1,91
"14424","8112至上","110/08/06","新光-桃園",42,204,-162
"14425","8112至上","110/08/06","第一金-桃園",89,0,89
"14426","8112至上","110/08/06","玉山證券",18,162,-144
"14427","8112至上","110/08/06","台新證券",105,16,89
"14428","8112至上","110/08/06","群益金鼎-基隆",7,151,-144
"14429","8112至上","110/08/06","玉山-板橋",96,10,86
"14430","8112至上","110/08/06","台新-新營",60,183,-123
"14431","1570力肯","110/08/06","國票-北高雄",246,40,206
"14432","1570力肯","110/08/06","富邦-高雄",0,47,-47
"14433","1570力肯","110/08/06","統一-松江",43,0,43
"14434","1570力肯","110/08/06","凱基-台北",55,101,-46
"14435","1570力肯","110/08/06","日茂-南投",42,2,40
"14436","1570力肯","110/08/06","台新證券",25,60,-35
"14437","1570力肯","110/08/06","群益金鼎-三重",34,2,32
"14438","1570力肯","110/08/06","元富-三重",0,32,-32
"14439","1570力肯","110/08/06","華南永昌-麻豆",32,4,28
"14440","1570力肯","110/08/06","台中銀-員林",0,32,-32
"14441","1570力肯","110/08/06","永豐金-中和",29,2,27
"14442","1570力肯","110/08/06","國泰-板橋",1,33,-32
"14443","1570力肯","110/08/06","永豐金-大園",21,0,21
"14444","1570力肯","110/08/06","摩根大通",83,112,-29
"14445","1570力肯","110/08/06","統一-三重",25,5,20
"14446","1570力肯","110/08/06","玉山-新莊",0,27,-27
"14447","1570力肯","110/08/06","元富-新店",20,0,20
"14448","1570力肯","110/08/06","永豐金-虎尾",0,27,-27
"14449","1570力肯","110/08/06","大昌-桃園",21,1,20
"14450","1570力肯","110/08/06","玉山-左營",0,25,-25
"14451","1570力肯","110/08/06","康和-高雄",18,1,17
"14452","1570力肯","110/08/06","富邦-仁愛",10,32,-22
"14453","1570力肯","110/08/06","元富-潮州",16,0,16
"14454","1570力肯","110/08/06","中國信託-忠孝",0,21,-21
"14455","1570力肯","110/08/06","元富-松德",15,0,15
"14456","1570力肯","110/08/06","臺銀-鳳山",4,24,-20
"14457","1570力肯","110/08/06","凱基-嘉義",15,0,15
"14458","1570力肯","110/08/06","台新-屏東",1,21,-20
"14459","1570力肯","110/08/06","凱基-埔墘",15,0,15
"14460","1570力肯","110/08/06","群益金鼎-西松",0,20,-20
"14461","2929淘帝","110/08/06","統一",155,0,155
"14462","2929淘帝","110/08/06","元富-敦南",0,100,-100
"14463","2929淘帝","110/08/06","港商野村",188,52,136
"14464","2929淘帝","110/08/06","兆豐-忠孝",0,60,-60
"14465","2929淘帝","110/08/06","摩根大通",72,3,69
"14466","2929淘帝","110/08/06","台新證券",9,68,-59
"14467","2929淘帝","110/08/06","新光-新竹",45,0,45
"14468","2929淘帝","110/08/06","凱基-台北",30,80,-50
"14469","2929淘帝","110/08/06","華南永昌",40,1,39
"14470","2929淘帝","110/08/06","台新-台中",0,45,-45
"14471","2929淘帝","110/08/06","美林",52,18,34
"14472","2929淘帝","110/08/06","國泰-台中",2,43,-41
"14473","2929淘帝","110/08/06","新加坡商瑞銀",48,14,34
"14474","2929淘帝","110/08/06","華南永昌-林口",0,37,-37
"14475","2929淘帝","110/08/06","日盛-頭份",32,0,32
"14476","2929淘帝","110/08/06","元大-屏南",0,30,-30
"14477","2929淘帝","110/08/06","日盛-板橋中山",30,0,30
"14478","2929淘帝","110/08/06","群益金鼎-潭子",0,26,-26
"14479","2929淘帝","110/08/06","元大-中壢",25,3,22
"14480","2929淘帝","110/08/06","元大-新莊",3,26,-23
"14481","2929淘帝","110/08/06","元大-莒光",21,0,21
"14482","2929淘帝","110/08/06","臺銀-臺南",0,22,-22
"14483","2929淘帝","110/08/06","福勝",20,0,20
"14484","2929淘帝","110/08/06","新光",2,24,-22
"14485","2929淘帝","110/08/06","元富-三重",17,0,17
"14486","2929淘帝","110/08/06","華南永昌-長虹",0,22,-22
"14487","2929淘帝","110/08/06","國票-南京",17,0,17
"14488","2929淘帝","110/08/06","富邦-高雄",0,20,-20
"14489","2929淘帝","110/08/06","合庫證券",16,0,16
"14490","2929淘帝","110/08/06","元大-竹科",0,20,-20
"14491","5410國眾","110/08/06","元大-中壢",15,1,14
"14492","5410國眾","110/08/06","凱基-台北",0,16,-16
"14493","5410國眾","110/08/06","玉山-嘉義",10,0,10
"14494","5410國眾","110/08/06","元大-松山",0,15,-15
"14495","5410國眾","110/08/06","元大-敦南",10,0,10
"14496","5410國眾","110/08/06","元大-斗信",0,10,-10
"14497","5410國眾","110/08/06","永豐金-板橋",10,0,10
"14498","5410國眾","110/08/06","臺銀-臺南",0,9,-9
"14499","5410國眾","110/08/06","華南永昌-新莊",9,0,9
"14500","5410國眾","110/08/06","新光-台中",0,9,-9
"14501","5410國眾","110/08/06","華南永昌-世貿",6,0,6
"14502","5410國眾","110/08/06","群益金鼎-中壢",0,7,-7
"14503","5410國眾","110/08/06","亞東",5,0,5
"14504","5410國眾","110/08/06","永豐金-中和",0,7,-7
"14505","5410國眾","110/08/06","大昌-新店",5,0,5
"14506","5410國眾","110/08/06","元大-北投",0,6,-6
"14507","5410國眾","110/08/06","凱基-民權",5,0,5
"14508","5410國眾","110/08/06","元大-豐原站前",0,6,-6
"14509","5410國眾","110/08/06","元大-士林",5,0,5
"14510","5410國眾","110/08/06","臺銀",0,5,-5
"14511","5410國眾","110/08/06","元大-北三重",5,0,5
"14512","5410國眾","110/08/06","台灣企銀-太平",0,5,-5
"14513","5410國眾","110/08/06","永豐金-桃園",5,0,5
"14514","5410國眾","110/08/06","元大-大益",0,5,-5
"14515","5410國眾","110/08/06","兆豐-員林",4,0,4
"14516","5410國眾","110/08/06","元大-和平",0,5,-5
"14517","5410國眾","110/08/06","台新-三民",4,0,4
"14518","5410國眾","110/08/06","元大-台南",0,5,-5
"14519","5410國眾","110/08/06","國泰-敦南",6,2,4
"14520","5410國眾","110/08/06","元大-古亭",0,5,-5
"14521","2841台開","110/08/06","宏遠-館前",520,0,520
"14522","2841台開","110/08/06","元富-台南",0,200,-200
"14523","2841台開","110/08/06","合庫證券",193,0,193
"14524","2841台開","110/08/06","元大-鹿港",0,182,-182
"14525","2841台開","110/08/06","永興-台中",100,0,100
"14526","2841台開","110/08/06","群益金鼎-桃園",0,132,-132
"14527","2841台開","110/08/06","永豐金-竹北",78,0,78
"14528","2841台開","110/08/06","中國信託-忠孝",0,130,-130
"14529","2841台開","110/08/06","元大證券",50,0,50
"14530","2841台開","110/08/06","元大-四維",3,116,-113
"14531","2841台開","110/08/06","元大-大天母",50,0,50
"14532","2841台開","110/08/06","元富-嘉義",0,50,-50
"14533","2841台開","110/08/06","永豐金-敦南",50,0,50
"14534","2841台開","110/08/06","元富-板橋",0,50,-50
"14535","2841台開","110/08/06","日盛-園區",49,0,49
"14536","2841台開","110/08/06","(牛牛牛)亞-鑫豐",0,50,-50
"14537","2841台開","110/08/06","元大-前金",38,0,38
"14538","2841台開","110/08/06","群益金鼎-新店",0,50,-50
"14539","2841台開","110/08/06","新光-台中",32,1,31
"14540","2841台開","110/08/06","統一-彰化",0,45,-45
"14541","2841台開","110/08/06","華南永昌-台中",30,0,30
"14542","2841台開","110/08/06","台中銀",12,50,-38
"14543","2841台開","110/08/06","第一金-忠孝",20,0,20
"14544","2841台開","110/08/06","國票-中和",0,30,-30
"14545","2841台開","110/08/06","富邦-台北",20,0,20
"14546","2841台開","110/08/06","富邦-竹北",0,29,-29
"14547","2841台開","110/08/06","元大-林園",20,0,20
"14548","2841台開","110/08/06","日盛-樹林",0,26,-26
"14549","2841台開","110/08/06","日盛-信義",18,0,18
"14550","2841台開","110/08/06","富邦-板橋",0,25,-25
"14551","6207雷科","110/08/06","凱基-台北",167,49,118
"14552","6207雷科","110/08/06","群益金鼎-古亭",0,80,-80
"14553","6207雷科","110/08/06","摩根大通",185,102,83
"14554","6207雷科","110/08/06","康和-台中",0,56,-56
"14555","6207雷科","110/08/06","新光-台中",65,1,64
"14556","6207雷科","110/08/06","統一-板橋",8,59,-51
"14557","6207雷科","110/08/06","元大-鳳山",77,40,37
"14558","6207雷科","110/08/06","臺銀",0,50,-50
"14559","6207雷科","110/08/06","德信",30,0,30
"14560","6207雷科","110/08/06","日盛-忠孝",0,50,-50
"14561","6207雷科","110/08/06","新加坡商瑞銀",47,19,28
"14562","6207雷科","110/08/06","永豐金-虎尾",0,29,-29
"14563","6207雷科","110/08/06","凱基-三重",30,2,28
"14564","6207雷科","110/08/06","凱基-敦北",0,23,-23
"14565","6207雷科","110/08/06","凱基-三峽",33,10,23
"14566","6207雷科","110/08/06","華南永昌-世貿",0,22,-22
"14567","6207雷科","110/08/06","玉山-台大",25,3,22
"14568","6207雷科","110/08/06","兆豐-來福",5,25,-20
"14569","6207雷科","110/08/06","元大-板橋",15,0,15
"14570","6207雷科","110/08/06","群益金鼎-中壢",1,21,-20
"14571","6207雷科","110/08/06","元大-南京",13,0,13
"14572","6207雷科","110/08/06","宏遠-台南",0,16,-16
"14573","6207雷科","110/08/06","元富-大昌",12,0,12
"14574","6207雷科","110/08/06","合庫-桃園",0,15,-15
"14575","6207雷科","110/08/06","德信-和平",11,0,11
"14576","6207雷科","110/08/06","玉山-新莊",1,16,-15
"14577","6207雷科","110/08/06","元大-承德",12,1,11
"14578","6207雷科","110/08/06","群益金鼎-敦南",0,15,-15
"14579","6207雷科","110/08/06","台新-高雄",18,8,10
"14580","6207雷科","110/08/06","台新-左楠",2,15,-13
"14581","3679新至陞","110/08/06","國票-安和",10,0,10
"14582","3679新至陞","110/08/06","摩根大通",1,32,-31
"14583","3679新至陞","110/08/06","元大-上新莊",10,0,10
"14584","3679新至陞","110/08/06","凱基-台北",2,17,-15
"14585","3679新至陞","110/08/06","富邦-台北",9,0,9
"14586","3679新至陞","110/08/06","台灣摩根士丹利",0,11,-11
"14587","3679新至陞","110/08/06","元大-板橋",9,3,6
"14588","3679新至陞","110/08/06","瑞士信貸",0,11,-11
"14589","3679新至陞","110/08/06","康和-板橋",5,0,5
"14590","3679新至陞","110/08/06","兆豐-員林",0,10,-10
"14591","3679新至陞","110/08/06","國泰-松江",5,0,5
"14592","3679新至陞","110/08/06","元大-蘆洲",0,10,-10
"14593","3679新至陞","110/08/06","凱基-三峽",5,0,5
"14594","3679新至陞","110/08/06","美林",1,8,-7
"14595","3679新至陞","110/08/06","華南永昌-大安",5,0,5
"14596","3679新至陞","110/08/06","群益金鼎-桃園",0,7,-7
"14597","3679新至陞","110/08/06","台新-屏東",4,0,4
"14598","3679新至陞","110/08/06","玉山-台大",0,5,-5
"14599","3679新至陞","110/08/06","群益金鼎-敦南",4,0,4
"14600","3679新至陞","110/08/06","日盛-新竹",0,4,-4
"14601","3679新至陞","110/08/06","元大-天母",4,0,4
"14602","3679新至陞","110/08/06","土銀-和平",2,5,-3
"14603","3679新至陞","110/08/06","臺銀-高雄",3,0,3
"14604","3679新至陞","110/08/06","元富-松德",0,3,-3
"14605","3679新至陞","110/08/06","台中銀-員林",3,0,3
"14606","3679新至陞","110/08/06","光和-田中",0,3,-3
"14607","3679新至陞","110/08/06","北城證券",3,0,3
"14608","3679新至陞","110/08/06","群益金鼎-台南",0,3,-3
"14609","3679新至陞","110/08/06","元大-景美",3,0,3
"14610","3679新至陞","110/08/06","元大證券",1,4,-3
"14611","2727王品","110/08/06","摩根大通",65,18,47
"14612","2727王品","110/08/06","美商高盛",12,258,-246
"14613","2727王品","110/08/06","華南永昌",18,0,18
"14614","2727王品","110/08/06","安泰",2,60,-58
"14615","2727王品","110/08/06","凱基-台北",41,25,16
"14616","2727王品","110/08/06","台灣摩根士丹利",10,59,-49
"14617","2727王品","110/08/06","元大-中壢",20,4,16
"14618","2727王品","110/08/06","台新證券",17,60,-43
"14619","2727王品","110/08/06","台新-高雄",27,13,14
"14620","2727王品","110/08/06","元大-桃園",0,32,-32
"14621","2727王品","110/08/06","永豐金-苓雅",14,1,13
"14622","2727王品","110/08/06","凱基-基隆",0,30,-30
"14623","2727王品","110/08/06","永豐金-中盛",14,1,13
"14624","2727王品","110/08/06","群益金鼎-台中",0,22,-22
"14625","2727王品","110/08/06","第一金-安和",12,0,12
"14626","2727王品","110/08/06","凱基-三重",1,20,-19
"14627","2727王品","110/08/06","台新-台南",12,0,12
"14628","2727王品","110/08/06","元大證券",23,42,-19
"14629","2727王品","110/08/06","元大-八德",12,0,12
"14630","2727王品","110/08/06","瑞士信貸",0,18,-18
"14631","2727王品","110/08/06","新加坡商瑞銀",14,3,11
"14632","2727王品","110/08/06","港商野村",32,50,-18
"14633","2727王品","110/08/06","美林",11,1,10
"14634","2727王品","110/08/06","元大-羅東",2,17,-15
"14635","2727王品","110/08/06","台新-中壢",10,0,10
"14636","2727王品","110/08/06","元大-彰化",3,15,-12
"14637","2727王品","110/08/06","大昌-新竹",9,0,9
"14638","2727王品","110/08/06","土銀-高雄",1,12,-11
"14639","2727王品","110/08/06","元大-文心興安",11,2,9
"14640","2727王品","110/08/06","台新-新莊",0,11,-11
"14641","1570力肯","110/08/06","國票-北高雄",246,40,206
"14642","1570力肯","110/08/06","富邦-高雄",0,47,-47
"14643","1570力肯","110/08/06","統一-松江",43,0,43
"14644","1570力肯","110/08/06","凱基-台北",55,101,-46
"14645","1570力肯","110/08/06","日茂-南投",42,2,40
"14646","1570力肯","110/08/06","台新證券",25,60,-35
"14647","1570力肯","110/08/06","群益金鼎-三重",34,2,32
"14648","1570力肯","110/08/06","元富-三重",0,32,-32
"14649","1570力肯","110/08/06","華南永昌-麻豆",32,4,28
"14650","1570力肯","110/08/06","台中銀-員林",0,32,-32
"14651","1570力肯","110/08/06","永豐金-中和",29,2,27
"14652","1570力肯","110/08/06","國泰-板橋",1,33,-32
"14653","1570力肯","110/08/06","永豐金-大園",21,0,21
"14654","1570力肯","110/08/06","摩根大通",83,112,-29
"14655","1570力肯","110/08/06","統一-三重",25,5,20
"14656","1570力肯","110/08/06","玉山-新莊",0,27,-27
"14657","1570力肯","110/08/06","元富-新店",20,0,20
"14658","1570力肯","110/08/06","永豐金-虎尾",0,27,-27
"14659","1570力肯","110/08/06","大昌-桃園",21,1,20
"14660","1570力肯","110/08/06","玉山-左營",0,25,-25
"14661","1570力肯","110/08/06","康和-高雄",18,1,17
"14662","1570力肯","110/08/06","富邦-仁愛",10,32,-22
"14663","1570力肯","110/08/06","元富-潮州",16,0,16
"14664","1570力肯","110/08/06","中國信託-忠孝",0,21,-21
"14665","1570力肯","110/08/06","元富-松德",15,0,15
"14666","1570力肯","110/08/06","臺銀-鳳山",4,24,-20
"14667","1570力肯","110/08/06","凱基-嘉義",15,0,15
"14668","1570力肯","110/08/06","台新-屏東",1,21,-20
"14669","1570力肯","110/08/06","凱基-埔墘",15,0,15
"14670","1570力肯","110/08/06","群益金鼎-西松",0,20,-20
"14671","6180橘子","110/08/06","凱基-中山",138,3,135
"14672","6180橘子","110/08/06","新光",6,37,-31
"14673","6180橘子","110/08/06","富邦-高雄",18,0,18
"14674","6180橘子","110/08/06","永豐金-板新",0,24,-24
"14675","6180橘子","110/08/06","美商高盛",14,0,14
"14676","6180橘子","110/08/06","國票-九鼎",0,20,-20
"14677","6180橘子","110/08/06","富邦-板橋",14,0,14
"14678","6180橘子","110/08/06","群益金鼎-古亭",0,20,-20
"14679","6180橘子","110/08/06","台灣摩根士丹利",18,6,12
"14680","6180橘子","110/08/06","凱基-台北",2,22,-20
"14681","6180橘子","110/08/06","聯邦-雙和",11,0,11
"14682","6180橘子","110/08/06","富邦-員林",1,20,-19
"14683","6180橘子","110/08/06","宏遠-光隆",10,0,10
"14684","6180橘子","110/08/06","富邦-基隆",0,14,-14
"14685","6180橘子","110/08/06","元富-四維",10,0,10
"14686","6180橘子","110/08/06","元富-永和",1,12,-11
"14687","6180橘子","110/08/06","摩根大通",11,1,10
"14688","6180橘子","110/08/06","玉山-台南",0,11,-11
"14689","6180橘子","110/08/06","日盛-中壢",9,0,9
"14690","6180橘子","110/08/06","元大-彰化民生",0,11,-11
"14691","6180橘子","110/08/06","中國信託",9,0,9
"14692","6180橘子","110/08/06","群益金鼎-忠孝",0,10,-10
"14693","6180橘子","110/08/06","凱基-板橋",10,1,9
"14694","6180橘子","110/08/06","元大-龍潭",0,10,-10
"14695","6180橘子","110/08/06","日盛-景美",9,2,7
"14696","6180橘子","110/08/06","元大-金華",1,11,-10
"14697","6180橘子","110/08/06","瑞士信貸",7,0,7
"14698","6180橘子","110/08/06","第一金-新興",0,8,-8
"14699","6180橘子","110/08/06","元大-高雄",5,0,5
"14700","6180橘子","110/08/06","美林",0,7,-7
"14701","2390云辰","110/08/06","元大證券",203,14,189
"14702","2390云辰","110/08/06","永豐金-豐原",0,174,-174
"14703","2390云辰","110/08/06","美商高盛",114,7,107
"14704","2390云辰","110/08/06","第一金-華江",0,83,-83
"14705","2390云辰","110/08/06","華南永昌-麻豆",103,0,103
"14706","2390云辰","110/08/06","凱基-台北",126,197,-71
"14707","2390云辰","110/08/06","國票-安和",76,11,65
"14708","2390云辰","110/08/06","摩根大通",129,187,-58
"14709","2390云辰","110/08/06","港商野村",188,138,50
"14710","2390云辰","110/08/06","臺銀-金山",0,50,-50
"14711","2390云辰","110/08/06","元大-土城學府",102,56,46
"14712","2390云辰","110/08/06","聯邦商銀",13,50,-37
"14713","2390云辰","110/08/06","元富-板橋",41,0,41
"14714","2390云辰","110/08/06","元大-上新莊",10,43,-33
"14715","2390云辰","110/08/06","新加坡商瑞銀",47,7,40
"14716","2390云辰","110/08/06","兆豐-三民",0,30,-30
"14717","2390云辰","110/08/06","元大-台南",35,0,35
"14718","2390云辰","110/08/06","富邦-桃園",0,30,-30
"14719","2390云辰","110/08/06","凱基-林口",31,0,31
"14720","2390云辰","110/08/06","國泰-敦南",33,60,-27
"14721","2390云辰","110/08/06","凱基-台中",23,0,23
"14722","2390云辰","110/08/06","元大-天母",1,28,-27
"14723","2390云辰","110/08/06","台新-左楠",22,0,22
"14724","2390云辰","110/08/06","統一-高雄",0,25,-25
"14725","2390云辰","110/08/06","元大-文心",24,2,22
"14726","2390云辰","110/08/06","元大-太平",0,22,-22
"14727","2390云辰","110/08/06","統一-三重",22,1,21
"14728","2390云辰","110/08/06","彰銀-台中",36,56,-20
"14729","2390云辰","110/08/06","台灣企銀-嘉義",20,0,20
"14730","2390云辰","110/08/06","統一-屏東",1,21,-20
"14731","2867三商壽","110/08/05","摩根大通",376,0,376
"14732","2867三商壽","110/08/05","日盛-新莊",0,253,-253
"14733","2867三商壽","110/08/05","玉山-大里",307,1,306
"14734","2867三商壽","110/08/05","宏遠-高雄",0,156,-156
"14735","2867三商壽","110/08/05","元大-土城永寧",250,0,250
"14736","2867三商壽","110/08/05","康和-台中",0,135,-135
"14737","2867三商壽","110/08/05","新加坡商瑞銀",137,0,137
"14738","2867三商壽","110/08/05","台灣摩根士丹利",17,133,-116
"14739","2867三商壽","110/08/05","大展",120,0,120
"14740","2867三商壽","110/08/05","台灣企銀-竹北",0,100,-100
"14741","2867三商壽","110/08/05","凱基-長庚",120,0,120
"14742","2867三商壽","110/08/05","群益金鼎-桃園",1,100,-99
"14743","2867三商壽","110/08/05","元大-大同",104,2,102
"14744","2867三商壽","110/08/05","永豐金-高雄",10,101,-91
"14745","2867三商壽","110/08/05","凱基-台北",98,30,68
"14746","2867三商壽","110/08/05","元富",0,70,-70
"14747","2867三商壽","110/08/05","華南永昌-朴子",60,0,60
"14748","2867三商壽","110/08/05","富邦-花蓮",0,53,-53
"14749","2867三商壽","110/08/05","永豐金-市政",50,0,50
"14750","2867三商壽","110/08/05","日盛-台南",0,43,-43
"14751","2867三商壽","110/08/05","富邦-台南",49,1,48
"14752","2867三商壽","110/08/05","宏遠-台中",6,45,-39
"14753","2867三商壽","110/08/05","永豐金-永康",30,0,30
"14754","2867三商壽","110/08/05","瑞士信貸",0,32,-32
"14755","2867三商壽","110/08/05","富邦-竹東",30,1,29
"14756","2867三商壽","110/08/05","致和-高雄",0,31,-31
"14757","2867三商壽","110/08/05","兆豐-高雄",30,10,20
"14758","2867三商壽","110/08/05","國泰-台南",1,32,-31
"14759","2867三商壽","110/08/05","群益金鼎-西松",20,0,20
"14760","2867三商壽","110/08/05","元大-松山",1,31,-30
"14761","5521工信","110/08/05","兆豐-桃園",72,0,72
"14762","5521工信","110/08/05","美林",5,100,-95
"14763","5521工信","110/08/05","(牛牛牛)亞-鑫豐",24,0,24
"14764","5521工信","110/08/05","華南永昌-桃園",0,76,-76
"14765","5521工信","110/08/05","富邦-建國",22,0,22
"14766","5521工信","110/08/05","第一金-桃園",0,43,-43
"14767","5521工信","110/08/05","日盛-雙和",16,0,16
"14768","5521工信","110/08/05","凱基-台北",0,26,-26
"14769","5521工信","110/08/05","元大-鳳山",16,0,16
"14770","5521工信","110/08/05","台灣摩根士丹利",0,22,-22
"14771","5521工信","110/08/05","元富-城東",12,0,12
"14772","5521工信","110/08/05","富邦-竹北",0,20,-20
"14773","5521工信","110/08/05","元大-東蘆",12,0,12
"14774","5521工信","110/08/05","富邦-員林",0,20,-20
"14775","5521工信","110/08/05","元大-路竹",11,0,11
"14776","5521工信","110/08/05","元大-豐原",0,20,-20
"14777","5521工信","110/08/05","元大-基隆孝二",11,0,11
"14778","5521工信","110/08/05","港商野村",0,17,-17
"14779","5521工信","110/08/05","日盛-園區",10,0,10
"14780","5521工信","110/08/05","元大-大同",0,14,-14
"14781","5521工信","110/08/05","玉山-台大",10,0,10
"14782","5521工信","110/08/05","永豐金證券",0,14,-14
"14783","5521工信","110/08/05","華南永昌-公誠",10,0,10
"14784","5521工信","110/08/05","兆豐-高雄",0,10,-10
"14785","5521工信","110/08/05","元大-斗六",10,0,10
"14786","5521工信","110/08/05","群益金鼎-永和",0,10,-10
"14787","5521工信","110/08/05","元大-屏東",10,0,10
"14788","5521工信","110/08/05","永豐金-中和",0,10,-10
"14789","5521工信","110/08/05","國泰-台中",9,0,9
"14790","5521工信","110/08/05","第一金-高雄",0,7,-7
"14791","1471首利","110/08/05","國票-北高雄",50,0,50
"14792","1471首利","110/08/05","永豐金-板盛",0,129,-129
"14793","1471首利","110/08/05","台灣摩根士丹利",49,0,49
"14794","1471首利","110/08/05","元大-三重",0,50,-50
"14795","1471首利","110/08/05","元大-太平",30,0,30
"14796","1471首利","110/08/05","瑞士信貸",0,42,-42
"14797","1471首利","110/08/05","國泰-敦南",24,0,24
"14798","1471首利","110/08/05","美林",0,37,-37
"14799","1471首利","110/08/05","玉山-桃園",21,0,21
"14800","1471首利","110/08/05","元富-草屯",0,30,-30
"14801","1471首利","110/08/05","宏遠-光隆",20,0,20
"14802","1471首利","110/08/05","元富-民權",0,25,-25
"14803","1471首利","110/08/05","富邦-嘉義",20,1,19
"14804","1471首利","110/08/05","台中銀",0,23,-23
"14805","1471首利","110/08/05","元大-博愛",30,13,17
"14806","1471首利","110/08/05","元富-新興",0,20,-20
"14807","1471首利","110/08/05","台新-高雄",16,0,16
"14808","1471首利","110/08/05","摩根大通",17,33,-16
"14809","1471首利","110/08/05","日盛-文化",15,0,15
"14810","1471首利","110/08/05","日盛-鳳山",0,15,-15
"14811","1471首利","110/08/05","群益金鼎-新莊",15,0,15
"14812","1471首利","110/08/05","高橋",0,14,-14
"14813","1471首利","110/08/05","凱基-科園",13,0,13
"14814","1471首利","110/08/05","富邦-羅東",0,13,-13
"14815","1471首利","110/08/05","元大-高雄",12,0,12
"14816","1471首利","110/08/05","德信-中正",0,12,-12
"14817","1471首利","110/08/05","第一金-桃園",11,0,11
"14818","1471首利","110/08/05","群益金鼎-中港",5,17,-12
"14819","1471首利","110/08/05","台灣企銀-太平",10,0,10
"14820","1471首利","110/08/05","第一金-台南",0,10,-10
"14821","2883開發金","110/08/05","元富",5268,0,5268
"14822","2883開發金","110/08/05","新光-高雄",309,4909,-4600
"14823","2883開發金","110/08/05","瑞士信貸",4963,0,4963
"14824","2883開發金","110/08/05","富邦-竹東",594,3509,-2915
"14825","2883開發金","110/08/05","富邦證券",3800,0,3800
"14826","2883開發金","110/08/05","永豐金-南京",2,1915,-1913
"14827","2883開發金","110/08/05","台灣摩根士丹利",3886,1250,2636
"14828","2883開發金","110/08/05","第一金-自由",2,1894,-1892
"14829","2883開發金","110/08/05","元富-城東",2119,68,2051
"14830","2883開發金","110/08/05","康和-仁愛",0,1820,-1820
"14831","2883開發金","110/08/05","港商野村",2397,395,2002
"14832","2883開發金","110/08/05","兆豐-台中港",22,1522,-1500
"14833","2883開發金","110/08/05","第一金-忠孝",2020,88,1932
"14834","2883開發金","110/08/05","元大-大同",43,1010,-967
"14835","2883開發金","110/08/05","國泰證券",1682,3,1679
"14836","2883開發金","110/08/05","國票",53,645,-592
"14837","2883開發金","110/08/05","大和國泰",1666,0,1666
"14838","2883開發金","110/08/05","富邦-新竹",86,674,-588
"14839","2883開發金","110/08/05","永豐金-板橋",1507,15,1492
"14840","2883開發金","110/08/05","富邦-建國",39,560,-521
"14841","2883開發金","110/08/05","台灣企銀-民雄",1002,0,1002
"14842","2883開發金","110/08/05","日盛-台南",7,525,-518
"14843","2883開發金","110/08/05","美林",1263,577,686
"14844","2883開發金","110/08/05","凱基-基隆",1,510,-509
"14845","2883開發金","110/08/05","康和",640,0,640
"14846","2883開發金","110/08/05","元富-民權",0,500,-500
"14847","2883開發金","110/08/05","凱基-台北",1262,679,583
"14848","2883開發金","110/08/05","永豐金-松山",9,509,-500
"14849","2883開發金","110/08/05","福邦證券",560,50,510
"14850","2883開發金","110/08/05","華南永昌-中正",25,511,-486
"14851","6205詮欣","110/08/05","富邦-高雄",27,0,27
"14852","6205詮欣","110/08/05","臺銀-鳳山",0,31,-31
"14853","6205詮欣","110/08/05","摩根大通",27,1,26
"14854","6205詮欣","110/08/05","合庫-三重",0,15,-15
"14855","6205詮欣","110/08/05","永豐金-敦南",14,0,14
"14856","6205詮欣","110/08/05","臺銀-民權",11,21,-10
"14857","6205詮欣","110/08/05","凱基-台北",14,1,13
"14858","6205詮欣","110/08/05","日盛-中壢",0,10,-10
"14859","6205詮欣","110/08/05","瑞士信貸",14,5,9
"14860","6205詮欣","110/08/05","統一-松江",0,10,-10
"14861","6205詮欣","110/08/05","凱基-湖口",9,0,9
"14862","6205詮欣","110/08/05","台新-三民",0,9,-9
"14863","6205詮欣","110/08/05","德信-新營",4,0,4
"14864","6205詮欣","110/08/05","臺銀-新竹",1,9,-8
"14865","6205詮欣","110/08/05","元大-東蘆",5,1,4
"14866","6205詮欣","110/08/05","康和",0,5,-5
"14867","6205詮欣","110/08/05","臺銀-高雄",3,0,3
"14868","6205詮欣","110/08/05","元大-館前",0,4,-4
"14869","6205詮欣","110/08/05","富邦-左營",3,0,3
"14870","6205詮欣","110/08/05","宏遠-新化",0,3,-3
"14871","6205詮欣","110/08/05","日盛-花蓮",2,0,2
"14872","6205詮欣","110/08/05","新加坡商瑞銀",4,7,-3
"14873","6205詮欣","110/08/05","元富-三重",2,0,2
"14874","6205詮欣","110/08/05","致和-高雄",0,3,-3
"14875","6205詮欣","110/08/05","北城證券",2,0,2
"14876","6205詮欣","110/08/05","國票",0,3,-3
"14877","6205詮欣","110/08/05","國票-南港",2,0,2
"14878","6205詮欣","110/08/05","富邦-嘉義",0,3,-3
"14879","6205詮欣","110/08/05","台新證券",2,0,2
"14880","6205詮欣","110/08/05","統一-士林",0,2,-2
"14881","1540喬福","110/08/05","元富-中原",24,0,24
"14882","1540喬福","110/08/05","統一-新台中",0,21,-21
"14883","1540喬福","110/08/05","台新-台南",10,0,10
"14884","1540喬福","110/08/05","國泰-敦南",0,15,-15
"14885","1540喬福","110/08/05","台新-台中",10,0,10
"14886","1540喬福","110/08/05","華南永昌-南京",0,10,-10
"14887","1540喬福","110/08/05","瑞士信貸",6,0,6
"14888","1540喬福","110/08/05","元大-台中中港",0,10,-10
"14889","1540喬福","110/08/05","台中銀-豐原",6,0,6
"14890","1540喬福","110/08/05","德信-新營",0,8,-8
"14891","1540喬福","110/08/05","凱基-台北",6,0,6
"14892","1540喬福","110/08/05","新光-台南",0,4,-4
"14893","1540喬福","110/08/05","凱基-台南",5,0,5
"14894","1540喬福","110/08/05","元大-大天母",6,10,-4
"14895","1540喬福","110/08/05","元大-士林",5,0,5
"14896","1540喬福","110/08/05","康和-新竹",0,3,-3
"14897","1540喬福","110/08/05","美林",2,0,2
"14898","1540喬福","110/08/05","元大-龍潭",0,3,-3
"14899","1540喬福","110/08/05","群益金鼎-崇德",2,0,2
"14900","1540喬福","110/08/05","第一金-員林",0,1,-1
"14901","1540喬福","110/08/05","凱基-苗栗",2,0,2
"14902","1540喬福","110/08/05","第一金-豐原",0,1,-1
"14903","1540喬福","110/08/05","凱基-中壢",2,0,2
"14904","1540喬福","110/08/05","台新-高雄",0,1,-1
"14905","1540喬福","110/08/05","土銀-士林",1,0,1
"14906","1540喬福","110/08/05","元大-崇德",0,1,-1
"14907","1540喬福","110/08/05","群益金鼎-丹鳳",1,0,1
"14908","1540喬福","110/08/05","元大-中壢",0,1,-1
"14909","1540喬福","110/08/05","元大-文心",1,0,1
"14910","1540喬福","110/08/05","元大-斗信",0,1,-1
"14911","2888新光金","110/08/05","華南永昌-南京",3753,8,3745
"14912","2888新光金","110/08/05","第一金-高雄",0,5007,-5007
"14913","2888新光金","110/08/05","玉山-城中",2004,28,1976
"14914","2888新光金","110/08/05","美商高盛",12,1719,-1707
"14915","2888新光金","110/08/05","元大-西門",906,18,888
"14916","2888新光金","110/08/05","香港上海匯豐",0,1437,-1437
"14917","2888新光金","110/08/05","日盛-和美",557,3,554
"14918","2888新光金","110/08/05","凱基-台南",46,802,-756
"14919","2888新光金","110/08/05","康和-台中",460,49,411
"14920","2888新光金","110/08/05","美林",538,1140,-602
"14921","2888新光金","110/08/05","元富-緯城",302,1,301
"14922","2888新光金","110/08/05","凱基-台北",686,1280,-594
"14923","2888新光金","110/08/05","彰銀",301,3,298
"14924","2888新光金","110/08/05","法銀巴黎",0,562,-562
"14925","2888新光金","110/08/05","花旗環球",356,84,272
"14926","2888新光金","110/08/05","瑞士信貸",1350,1798,-448
"14927","2888新光金","110/08/05","永全-南崁",240,0,240
"14928","2888新光金","110/08/05","群益金鼎-丹鳳",4,303,-299
"14929","2888新光金","110/08/05","永豐金-彰化",232,20,212
"14930","2888新光金","110/08/05","安泰-大發",10,300,-290
"14931","2888新光金","110/08/05","統一-新台中",214,7,207
"14932","2888新光金","110/08/05","摩根大通",1159,1428,-269
"14933","2888新光金","110/08/05","中國信託-永康",203,0,203
"14934","2888新光金","110/08/05","兆豐-員林",4,260,-256
"14935","2888新光金","110/08/05","日盛-景美",200,0,200
"14936","2888新光金","110/08/05","日盛-大墩",0,250,-250
"14937","2888新光金","110/08/05","元大-東泰",207,22,185
"14938","2888新光金","110/08/05","元大-大里",31,243,-212
"14939","2888新光金","110/08/05","合庫證券",181,2,179
"14940","2888新光金","110/08/05","北城證券",25,230,-205
"14941","1340勝悅","110/08/05","富邦-仁愛",20,0,20
"14942","1340勝悅","110/08/05","中國信託",0,36,-36
"14943","1340勝悅","110/08/05","華南永昌-忠孝",12,0,12
"14944","1340勝悅","110/08/05","新光-新竹",0,18,-18
"14945","1340勝悅","110/08/05","華南永昌-楠梓",10,0,10
"14946","1340勝悅","110/08/05","永豐金-嘉義",0,15,-15
"14947","1340勝悅","110/08/05","統一-城中",17,11,6
"14948","1340勝悅","110/08/05","日茂",0,10,-10
"14949","1340勝悅","110/08/05","臺灣企銀-埔墘",5,0,5
"14950","1340勝悅","110/08/05","富邦-宜蘭",0,10,-10
"14951","1340勝悅","110/08/05","國票-台東",5,0,5
"14952","1340勝悅","110/08/05","元富-花蓮",0,9,-9
"14953","1340勝悅","110/08/05","新光-高雄",5,0,5
"14954","1340勝悅","110/08/05","永豐金-南京",0,7,-7
"14955","1340勝悅","110/08/05","國泰-台中",6,1,5
"14956","1340勝悅","110/08/05","統一",0,6,-6
"14957","1340勝悅","110/08/05","富邦-陽明",5,0,5
"14958","1340勝悅","110/08/05","合庫-西台中",0,3,-3
"14959","1340勝悅","110/08/05","日盛-板橋",4,0,4
"14960","1340勝悅","110/08/05","港商野村",0,3,-3
"14961","1340勝悅","110/08/05","港商法國興業",4,0,4
"14962","1340勝悅","110/08/05","兆豐-新竹",0,3,-3
"14963","1340勝悅","110/08/05","臺銀-高雄",3,0,3
"14964","1340勝悅","110/08/05","亞東-台中",0,2,-2
"14965","1340勝悅","110/08/05","元富-新店",3,0,3
"14966","1340勝悅","110/08/05","元大-歸仁",0,2,-2
"14967","1340勝悅","110/08/05","康和-屏東",3,0,3
"14968","1340勝悅","110/08/05","日盛-斗六",0,1,-1
"14969","1340勝悅","110/08/05","群益金鼎-民權",3,0,3
"14970","1340勝悅","110/08/05","日盛-中和",0,1,-1
"14971","6246臺龍","110/08/05","元大-林森",200,0,200
"14972","6246臺龍","110/08/05","統一",0,180,-180
"14973","6246臺龍","110/08/05","元大證券",92,1,91
"14974","6246臺龍","110/08/05","大慶-富順",0,114,-114
"14975","6246臺龍","110/08/05","凱基-大直",99,19,80
"14976","6246臺龍","110/08/05","台新-三民",0,77,-77
"14977","6246臺龍","110/08/05","元大-北港",51,0,51
"14978","6246臺龍","110/08/05","永興",0,48,-48
"14979","6246臺龍","110/08/05","統一-南京",50,0,50
"14980","6246臺龍","110/08/05","華南永昌-嘉義",1,26,-25
"14981","6246臺龍","110/08/05","台灣企銀",40,0,40
"14982","6246臺龍","110/08/05","宏遠-民生",0,20,-20
"14983","6246臺龍","110/08/05","永豐金-虎尾",23,0,23
"14984","6246臺龍","110/08/05","兆豐-大同",0,20,-20
"14985","6246臺龍","110/08/05","凱基-台北",27,5,22
"14986","6246臺龍","110/08/05","華南永昌-林口",0,20,-20
"14987","6246臺龍","110/08/05","元富-新竹",20,0,20
"14988","6246臺龍","110/08/05","元大-永春",0,20,-20
"14989","6246臺龍","110/08/05","康和-石牌",20,0,20
"14990","6246臺龍","110/08/05","元大-東泰",0,19,-19
"14991","6246臺龍","110/08/05","聯邦-大業",20,0,20
"14992","6246臺龍","110/08/05","德信-新營",0,18,-18
"14993","6246臺龍","110/08/05","凱基-彰化",18,0,18
"14994","6246臺龍","110/08/05","永豐金-松山",10,28,-18
"14995","6246臺龍","110/08/05","永豐金-復興",17,1,16
"14996","6246臺龍","110/08/05","台新-台中",4,20,-16
"14997","6246臺龍","110/08/05","新光-台中",17,2,15
"14998","6246臺龍","110/08/05","兆豐-竹北",5,20,-15
"14999","6246臺龍","110/08/05","元大-路竹",15,1,14
"15000","6246臺龍","110/08/05","兆豐-南京",1,14,-13
"15001","00715L期街口布蘭特正2","110/08/05","(牛牛牛)亞-鑫豐",1195,20,1175
"15002","00715L期街口布蘭特正2","110/08/05","元大證券",1735,21716,-19981
"15003","00715L期街口布蘭特正2","110/08/05","元大-萬華",930,0,930
"15004","00715L期街口布蘭特正2","110/08/05","凱基-台北",182,11686,-11504
"15005","00715L期街口布蘭特正2","110/08/05","元大-永康",810,9,801
"15006","00715L期街口布蘭特正2","110/08/05","元富",8,6852,-6844
"15007","00715L期街口布蘭特正2","110/08/05","富邦-彰化",760,0,760
"15008","00715L期街口布蘭特正2","110/08/05","台新證券",598,4522,-3924
"15009","00715L期街口布蘭特正2","110/08/05","國泰-敦南",830,155,675
"15010","00715L期街口布蘭特正2","110/08/05","凱基",0,3168,-3168
"15011","00715L期街口布蘭特正2","110/08/05","新光-台中",698,33,665
"15012","00715L期街口布蘭特正2","110/08/05","群益金鼎",0,1742,-1742
"15013","00715L期街口布蘭特正2","110/08/05","富邦-南屯",621,5,616
"15014","00715L期街口布蘭特正2","110/08/05","國票",22,1607,-1585
"15015","00715L期街口布蘭特正2","110/08/05","群益金鼎-士林",620,40,580
"15016","00715L期街口布蘭特正2","110/08/05","永豐金證券",91,1254,-1163
"15017","00715L期街口布蘭特正2","110/08/05","兆豐-嘉義",510,0,510
"15018","00715L期街口布蘭特正2","110/08/05","富邦證券",140,1095,-955
"15019","00715L期街口布蘭特正2","110/08/05","統一-新竹",508,9,499
"15020","00715L期街口布蘭特正2","110/08/05","元大-雙和",22,850,-828
"15021","00715L期街口布蘭特正2","110/08/05","國泰-板橋",521,24,497
"15022","00715L期街口布蘭特正2","110/08/05","國票-台中",25,805,-780
"15023","00715L期街口布蘭特正2","110/08/05","元大-中和",481,3,478
"15024","00715L期街口布蘭特正2","110/08/05","華南永昌-長虹",145,820,-675
"15025","00715L期街口布蘭特正2","110/08/05","元大-羅東",470,0,470
"15026","00715L期街口布蘭特正2","110/08/05","日盛-大墩",121,455,-334
"15027","00715L期街口布蘭特正2","110/08/05","群益金鼎-嘉義",483,20,463
"15028","00715L期街口布蘭特正2","110/08/05","華南永昌-斗六",52,380,-328
"15029","00715L期街口布蘭特正2","110/08/05","群益金鼎-中壢",476,30,446
"15030","00715L期街口布蘭特正2","110/08/05","康和",0,250,-250
"15031","8941關中","110/08/05","第一金-台南",1,0,1
"15032","8941關中","110/08/05","元富-宜蘭",0,2,-2
"15033","8941關中","110/08/05","康和-嘉義",1,0,1
"15034","8941關中","110/08/05","統一-南京",0,1,-1
"15035","8941關中","110/08/05","群益金鼎-延平",1,0,1
"15036","8941關中","110/08/05","合庫證券",0,0,0
"15037","8941關中","110/08/05","合庫證券",0,0,0
"15038","8941關中","110/08/05","(牛牛牛)亞-鑫豐",0,0,0
"15039","8941關中","110/08/05","(牛牛牛)亞-鑫豐",0,0,0
"15040","8941關中","110/08/05","富邦-北港",0,0,0
"15041","8941關中","110/08/05","富邦-北港",0,0,0
"15042","8941關中","110/08/05","",NA,NA,NA
"15043","8941關中","110/08/05","",NA,NA,NA
"15044","8941關中","110/08/05","",NA,NA,NA
"15045","8941關中","110/08/05","",NA,NA,NA
"15046","8941關中","110/08/05","",NA,NA,NA
"15047","8941關中","110/08/05","",NA,NA,NA
"15048","8941關中","110/08/05","",NA,NA,NA
"15049","8941關中","110/08/05","",NA,NA,NA
"15050","8941關中","110/08/05","",NA,NA,NA
"15051","8941關中","110/08/05","",NA,NA,NA
"15052","8941關中","110/08/05","",NA,NA,NA
"15053","8941關中","110/08/05","",NA,NA,NA
"15054","8941關中","110/08/05","",NA,NA,NA
"15055","8941關中","110/08/05","",NA,NA,NA
"15056","8941關中","110/08/05","",NA,NA,NA
"15057","8941關中","110/08/05","",NA,NA,NA
"15058","8941關中","110/08/05","",NA,NA,NA
"15059","8941關中","110/08/05","",NA,NA,NA
"15060","8941關中","110/08/05","",NA,NA,NA
"15061","8936國統","110/08/05","國票-敦北法人",100,0,100
"15062","8936國統","110/08/05","摩根大通",16,240,-224
"15063","8936國統","110/08/05","第一金-光復",50,0,50
"15064","8936國統","110/08/05","台新-松江",0,205,-205
"15065","8936國統","110/08/05","元大-蘆洲",45,0,45
"15066","8936國統","110/08/05","凱基-台北",1,177,-176
"15067","8936國統","110/08/05","富邦-建國",34,0,34
"15068","8936國統","110/08/05","新加坡商瑞銀",14,119,-105
"15069","8936國統","110/08/05","富邦-高雄",33,1,32
"15070","8936國統","110/08/05","凱基-市政",0,35,-35
"15071","8936國統","110/08/05","元大-敦南",30,0,30
"15072","8936國統","110/08/05","瑞士信貸",0,31,-31
"15073","8936國統","110/08/05","元大-博愛",23,0,23
"15074","8936國統","110/08/05","合庫-高雄",22,49,-27
"15075","8936國統","110/08/05","國票-長城",20,0,20
"15076","8936國統","110/08/05","港商野村",15,41,-26
"15077","8936國統","110/08/05","凱基-岡山",20,0,20
"15078","8936國統","110/08/05","富邦-陽明",1,24,-23
"15079","8936國統","110/08/05","凱基-台南",20,0,20
"15080","8936國統","110/08/05","合庫-新竹",0,22,-22
"15081","8936國統","110/08/05","富邦-中壢",21,2,19
"15082","8936國統","110/08/05","美商高盛",0,20,-20
"15083","8936國統","110/08/05","永豐金-忠孝",17,0,17
"15084","8936國統","110/08/05","元大-雙和",0,20,-20
"15085","8936國統","110/08/05","玉山-台中",16,0,16
"15086","8936國統","110/08/05","彰銀-七賢",0,18,-18
"15087","8936國統","110/08/05","兆豐-景美",15,0,15
"15088","8936國統","110/08/05","台灣企銀-台中",0,15,-15
"15089","8936國統","110/08/05","富邦-南屯",15,0,15
"15090","8936國統","110/08/05","兆豐-大同",0,15,-15
"15091","6226光鼎","110/08/05","國泰-敦南",190,90,100
"15092","6226光鼎","110/08/05","富邦-嘉義",590,964,-374
"15093","6226光鼎","110/08/05","凱基-台中",98,2,96
"15094","6226光鼎","110/08/05","日盛-員林",9,200,-191
"15095","6226光鼎","110/08/05","華南永昌-大安",95,13,82
"15096","6226光鼎","110/08/05","華南永昌",5,157,-152
"15097","6226光鼎","110/08/05","凱基-豐中",68,2,66
"15098","6226光鼎","110/08/05","國票-敦北法人",0,106,-106
"15099","6226光鼎","110/08/05","元富-西松",76,15,61
"15100","6226光鼎","110/08/05","元大-雙和",27,118,-91
"15101","6226光鼎","110/08/05","群益金鼎-土城",61,0,61
"15102","6226光鼎","110/08/05","華南永昌-南京",48,137,-89
"15103","6226光鼎","110/08/05","新光-高雄",64,4,60
"15104","6226光鼎","110/08/05","統一-新竹",37,124,-87
"15105","6226光鼎","110/08/05","宏遠-台中",67,9,58
"15106","6226光鼎","110/08/05","大昌",3,78,-75
"15107","6226光鼎","110/08/05","元大-東港",53,0,53
"15108","6226光鼎","110/08/05","凱基-台北",1,74,-73
"15109","6226光鼎","110/08/05","群益金鼎-敦南",60,10,50
"15110","6226光鼎","110/08/05","中國信託-文心",10,65,-55
"15111","6226光鼎","110/08/05","日盛-高雄",53,7,46
"15112","6226光鼎","110/08/05","台新-新莊",1,54,-53
"15113","6226光鼎","110/08/05","台新-新營",49,4,45
"15114","6226光鼎","110/08/05","台新-台中",84,135,-51
"15115","6226光鼎","110/08/05","玉山-雙和",42,2,40
"15116","6226光鼎","110/08/05","元大-嘉義",77,128,-51
"15117","6226光鼎","110/08/05","永豐金-高雄",44,8,36
"15118","6226光鼎","110/08/05","日盛-大墩",1,43,-42
"15119","6226光鼎","110/08/05","元富-花蓮",42,7,35
"15120","6226光鼎","110/08/05","日茂-埔里",0,41,-41
"15121","2363矽統","110/08/05","瑞士信貸",3345,0,3345
"15122","2363矽統","110/08/05","新加坡商瑞銀",1909,2622,-713
"15123","2363矽統","110/08/05","台灣摩根士丹利",2917,53,2864
"15124","2363矽統","110/08/05","統一-板橋",37,650,-613
"15125","2363矽統","110/08/05","摩根大通",5124,3944,1180
"15126","2363矽統","110/08/05","美商高盛",702,1245,-543
"15127","2363矽統","110/08/05","康和-台中",911,292,619
"15128","2363矽統","110/08/05","元富-西松",367,902,-535
"15129","2363矽統","110/08/05","永豐金證券",951,339,612
"15130","2363矽統","110/08/05","華南永昌-斗六",55,584,-529
"15131","2363矽統","110/08/05","群益金鼎-三民",571,106,465
"15132","2363矽統","110/08/05","美林",2987,3501,-514
"15133","2363矽統","110/08/05","國票-敦北法人",484,51,433
"15134","2363矽統","110/08/05","群益金鼎-館前",331,802,-471
"15135","2363矽統","110/08/05","陽信-石牌",624,204,420
"15136","2363矽統","110/08/05","永豐金-三重",138,571,-433
"15137","2363矽統","110/08/05","合庫證券",520,118,402
"15138","2363矽統","110/08/05","富邦-中壢",348,774,-426
"15139","2363矽統","110/08/05","元大-承德",385,70,315
"15140","2363矽統","110/08/05","北城證券",53,459,-406
"15141","2363矽統","110/08/05","新光",2366,2079,287
"15142","2363矽統","110/08/05","凱基-興隆",370,717,-347
"15143","2363矽統","110/08/05","元大證券",601,329,272
"15144","2363矽統","110/08/05","元大-屏南",132,464,-332
"15145","2363矽統","110/08/05","國泰-敦南",4481,4216,265
"15146","2363矽統","110/08/05","日盛-中和",208,531,-323
"15147","2363矽統","110/08/05","元大-台中",562,349,213
"15148","2363矽統","110/08/05","土銀",28,340,-312
"15149","2363矽統","110/08/05","富邦-台北",584,380,204
"15150","2363矽統","110/08/05","永豐金-嘉義",97,401,-304
"15151","8112至上","110/08/05","元大-竹科",858,64,794
"15152","8112至上","110/08/05","摩根大通",461,775,-314
"15153","8112至上","110/08/05","港商野村",937,361,576
"15154","8112至上","110/08/05","台灣摩根士丹利",16,272,-256
"15155","8112至上","110/08/05","康和",484,0,484
"15156","8112至上","110/08/05","高橋",3,183,-180
"15157","8112至上","110/08/05","新加坡商瑞銀",514,58,456
"15158","8112至上","110/08/05","合庫證券",19,162,-143
"15159","8112至上","110/08/05","元大-屏南",391,4,387
"15160","8112至上","110/08/05","元大-北屯",3,145,-142
"15161","8112至上","110/08/05","國票-長城",427,142,285
"15162","8112至上","110/08/05","元大-府城",14,154,-140
"15163","8112至上","110/08/05","元大-萬華",246,12,234
"15164","8112至上","110/08/05","群益金鼎-三重",0,138,-138
"15165","8112至上","110/08/05","台灣匯立證券",210,0,210
"15166","8112至上","110/08/05","富邦-台北",25,129,-104
"15167","8112至上","110/08/05","凱基-敦北",200,4,196
"15168","8112至上","110/08/05","元富-佳里",7,100,-93
"15169","8112至上","110/08/05","元大-北成功",205,17,188
"15170","8112至上","110/08/05","元富-台南",0,86,-86
"15171","8112至上","110/08/05","元大-高雄",146,14,132
"15172","8112至上","110/08/05","臺灣企銀-桃園",0,82,-82
"15173","8112至上","110/08/05","美商高盛",161,47,114
"15174","8112至上","110/08/05","玉山-嘉義",10,88,-78
"15175","8112至上","110/08/05","花旗環球",102,0,102
"15176","8112至上","110/08/05","凱基-復興",1,67,-66
"15177","8112至上","110/08/05","統一-士林",108,8,100
"15178","8112至上","110/08/05","富邦-中壢",23,89,-66
"15179","8112至上","110/08/05","新光",244,159,85
"15180","8112至上","110/08/05","元大-上新莊",1,67,-66
"15181","1570力肯","110/08/05","國票",352,0,352
"15182","1570力肯","110/08/05","國票-和平",7,402,-395
"15183","1570力肯","110/08/05","台新證券",211,87,124
"15184","1570力肯","110/08/05","摩根大通",46,335,-289
"15185","1570力肯","110/08/05","國泰-敦南",206,125,81
"15186","1570力肯","110/08/05","國票-北高雄",79,306,-227
"15187","1570力肯","110/08/05","聯邦商銀",75,0,75
"15188","1570力肯","110/08/05","統一",3,226,-223
"15189","1570力肯","110/08/05","元大-東泰",61,4,57
"15190","1570力肯","110/08/05","凱基-台北",184,366,-182
"15191","1570力肯","110/08/05","元大-桃興",113,66,47
"15192","1570力肯","110/08/05","統一-土城",89,161,-72
"15193","1570力肯","110/08/05","國泰-板橋",96,50,46
"15194","1570力肯","110/08/05","統一-屏東",0,64,-64
"15195","1570力肯","110/08/05","合庫-桃園",92,48,44
"15196","1570力肯","110/08/05","大昌-新店",9,61,-52
"15197","1570力肯","110/08/05","華南永昌-高雄",53,12,41
"15198","1570力肯","110/08/05","群益金鼎-忠孝",11,60,-49
"15199","1570力肯","110/08/05","國泰-高雄",50,14,36
"15200","1570力肯","110/08/05","臺銀-臺南",12,52,-40
"15201","1570力肯","110/08/05","國泰-台中",60,25,35
"15202","1570力肯","110/08/05","凱基-岡山",28,68,-40
"15203","1570力肯","110/08/05","富邦-仁愛",52,17,35
"15204","1570力肯","110/08/05","元大-蘆洲",8,44,-36
"15205","1570力肯","110/08/05","中國信託-忠孝",37,3,34
"15206","1570力肯","110/08/05","統一-仁愛",25,60,-35
"15207","1570力肯","110/08/05","元大-中壢",44,10,34
"15208","1570力肯","110/08/05","富邦-高雄",8,43,-35
"15209","1570力肯","110/08/05","日盛-新竹",30,0,30
"15210","1570力肯","110/08/05","大慶-蘆洲",110,142,-32
"15211","2929淘帝","110/08/05","國泰-松江",60,0,60
"15212","2929淘帝","110/08/05","摩根大通",4,87,-83
"15213","2929淘帝","110/08/05","美林",79,30,49
"15214","2929淘帝","110/08/05","日盛-南京",0,80,-80
"15215","2929淘帝","110/08/05","港商野村",87,45,42
"15216","2929淘帝","110/08/05","華南永昌-頭份",0,80,-80
"15217","2929淘帝","110/08/05","兆豐-忠孝",40,0,40
"15218","2929淘帝","110/08/05","日盛-雙和",2,57,-55
"15219","2929淘帝","110/08/05","新光-新竹",41,2,39
"15220","2929淘帝","110/08/05","台新-台中",2,33,-31
"15221","2929淘帝","110/08/05","元大-民生",31,0,31
"15222","2929淘帝","110/08/05","群益金鼎-新竹",0,30,-30
"15223","2929淘帝","110/08/05","元富-中港",28,0,28
"15224","2929淘帝","110/08/05","元大-北成功",0,30,-30
"15225","2929淘帝","110/08/05","凱基-台北",66,41,25
"15226","2929淘帝","110/08/05","元大-天母",5,30,-25
"15227","2929淘帝","110/08/05","富邦-新店",20,0,20
"15228","2929淘帝","110/08/05","元大-北港",0,25,-25
"15229","2929淘帝","110/08/05","康和-台中",15,0,15
"15230","2929淘帝","110/08/05","兆豐-彰化",0,24,-24
"15231","2929淘帝","110/08/05","華南永昌-古亭",15,0,15
"15232","2929淘帝","110/08/05","國泰-台中",1,25,-24
"15233","2929淘帝","110/08/05","日盛-景美",11,0,11
"15234","2929淘帝","110/08/05","華南永昌-大安",0,22,-22
"15235","2929淘帝","110/08/05","台新證券",11,0,11
"15236","2929淘帝","110/08/05","國泰-館前",10,31,-21
"15237","2929淘帝","110/08/05","凱基-三重",11,0,11
"15238","2929淘帝","110/08/05","元富-安南",0,20,-20
"15239","2929淘帝","110/08/05","華南永昌-竹北",11,0,11
"15240","2929淘帝","110/08/05","元大-屏南",10,30,-20
"15241","5410國眾","110/08/05","凱基-市政",40,0,40
"15242","5410國眾","110/08/05","元富-台南",0,27,-27
"15243","5410國眾","110/08/05","安泰",16,0,16
"15244","5410國眾","110/08/05","群益金鼎-內湖",0,16,-16
"15245","5410國眾","110/08/05","元大-善化",12,0,12
"15246","5410國眾","110/08/05","中農",0,15,-15
"15247","5410國眾","110/08/05","元富-同大",10,0,10
"15248","5410國眾","110/08/05","新光-台南",0,15,-15
"15249","5410國眾","110/08/05","中國信託-新竹",10,0,10
"15250","5410國眾","110/08/05","統一-平鎮",0,13,-13
"15251","5410國眾","110/08/05","元大-敦南",10,0,10
"15252","5410國眾","110/08/05","臺銀",0,11,-11
"15253","5410國眾","110/08/05","台灣企銀-太平",8,0,8
"15254","5410國眾","110/08/05","凱基-城中",0,10,-10
"15255","5410國眾","110/08/05","瑞士信貸",7,0,7
"15256","5410國眾","110/08/05","元大-崇德",0,10,-10
"15257","5410國眾","110/08/05","元富-烏日",6,0,6
"15258","5410國眾","110/08/05","元大-和平",0,10,-10
"15259","5410國眾","110/08/05","摩根大通",7,1,6
"15260","5410國眾","110/08/05","新光-台中",1,9,-8
"15261","5410國眾","110/08/05","元富-三重",11,6,5
"15262","5410國眾","110/08/05","富邦-板橋",0,6,-6
"15263","5410國眾","110/08/05","中國信託-忠孝",5,0,5
"15264","5410國眾","110/08/05","新百王",0,5,-5
"15265","5410國眾","110/08/05","凱基-復興",5,0,5
"15266","5410國眾","110/08/05","元大-大益",0,5,-5
"15267","5410國眾","110/08/05","永豐金-台中",4,0,4
"15268","5410國眾","110/08/05","永豐金-板橋",0,5,-5
"15269","5410國眾","110/08/05","元富-板橋",3,0,3
"15270","5410國眾","110/08/05","台新-中壢",0,4,-4
"15271","2841台開","110/08/05","日盛證券",201,0,201
"15272","2841台開","110/08/05","第一金-自由",0,272,-272
"15273","2841台開","110/08/05","永豐金-敦南",202,1,201
"15274","2841台開","110/08/05","瑞士信貸",0,149,-149
"15275","2841台開","110/08/05","元大-大天母",200,0,200
"15276","2841台開","110/08/05","玉山-新竹",0,131,-131
"15277","2841台開","110/08/05","永豐金-鳳山",100,0,100
"15278","2841台開","110/08/05","元富-板橋",0,125,-125
"15279","2841台開","110/08/05","台新-三民",100,1,99
"15280","2841台開","110/08/05","元大-台中中港",0,109,-109
"15281","2841台開","110/08/05","凱基-竹科",67,0,67
"15282","2841台開","110/08/05","兆豐-東門",0,100,-100
"15283","2841台開","110/08/05","國泰-敦南",44,5,39
"15284","2841台開","110/08/05","(牛牛牛)亞-鑫豐",0,97,-97
"15285","2841台開","110/08/05","元大-中壢",35,0,35
"15286","2841台開","110/08/05","元富-嘉義",0,50,-50
"15287","2841台開","110/08/05","國泰-忠孝",33,0,33
"15288","2841台開","110/08/05","新光",20,67,-47
"15289","2841台開","110/08/05","元大-新竹經國",30,0,30
"15290","2841台開","110/08/05","永豐金-豐原",3,50,-47
"15291","2841台開","110/08/05","日盛-內湖",24,0,24
"15292","2841台開","110/08/05","統一-士林",0,31,-31
"15293","2841台開","110/08/05","新光-高雄",21,0,21
"15294","2841台開","110/08/05","元大-龍潭",0,30,-30
"15295","2841台開","110/08/05","元大-林園",20,0,20
"15296","2841台開","110/08/05","新光-台南",0,27,-27
"15297","2841台開","110/08/05","元大-仁愛",20,0,20
"15298","2841台開","110/08/05","台新-台中",0,22,-22
"15299","2841台開","110/08/05","群益金鼎-崇德",18,0,18
"15300","2841台開","110/08/05","大昌-安康",0,20,-20
"15301","6207雷科","110/08/05","摩根大通",313,64,249
"15302","6207雷科","110/08/05","日盛-忠孝",2,93,-91
"15303","6207雷科","110/08/05","新加坡商瑞銀",141,6,135
"15304","6207雷科","110/08/05","凱基-復興",0,90,-90
"15305","6207雷科","110/08/05","凱基-台北",142,20,122
"15306","6207雷科","110/08/05","群益金鼎-敦南",0,67,-67
"15307","6207雷科","110/08/05","台新-高雄",111,0,111
"15308","6207雷科","110/08/05","元大-鳳山",11,73,-62
"15309","6207雷科","110/08/05","瑞士信貸",58,0,58
"15310","6207雷科","110/08/05","群益金鼎-東門",0,56,-56
"15311","6207雷科","110/08/05","美林",45,0,45
"15312","6207雷科","110/08/05","元富-同大",1,41,-40
"15313","6207雷科","110/08/05","凱基-板橋",46,1,45
"15314","6207雷科","110/08/05","群益金鼎-屏東",1,41,-40
"15315","6207雷科","110/08/05","美商高盛",37,0,37
"15316","6207雷科","110/08/05","群益金鼎-延平",0,40,-40
"15317","6207雷科","110/08/05","凱基-三多",30,0,30
"15318","6207雷科","110/08/05","群益金鼎-瑞豐",1,33,-32
"15319","6207雷科","110/08/05","永豐金-虎尾",29,0,29
"15320","6207雷科","110/08/05","日盛證券",0,30,-30
"15321","6207雷科","110/08/05","第一金-中山",21,1,20
"15322","6207雷科","110/08/05","臺銀",1,30,-29
"15323","6207雷科","110/08/05","華南永昌-林口",20,0,20
"15324","6207雷科","110/08/05","群益金鼎-古亭",0,26,-26
"15325","6207雷科","110/08/05","兆豐-公益",18,0,18
"15326","6207雷科","110/08/05","凱基-高雄",4,30,-26
"15327","6207雷科","110/08/05","港商野村",62,46,16
"15328","6207雷科","110/08/05","富邦-竹東",0,25,-25
"15329","6207雷科","110/08/05","華南永昌-南京",16,0,16
"15330","6207雷科","110/08/05","元大-台中中港",2,25,-23
"15331","3679新至陞","110/08/05","新光",13,0,13
"15332","3679新至陞","110/08/05","凱基-台北",1,13,-12
"15333","3679新至陞","110/08/05","華南永昌-麻豆",3,0,3
"15334","3679新至陞","110/08/05","台灣摩根士丹利",0,5,-5
"15335","3679新至陞","110/08/05","臺灣企銀-埔墘",2,0,2
"15336","3679新至陞","110/08/05","元大-成功",0,5,-5
"15337","3679新至陞","110/08/05","彰銀",2,0,2
"15338","3679新至陞","110/08/05","元大證券",0,3,-3
"15339","3679新至陞","110/08/05","永全-南崁",2,0,2
"15340","3679新至陞","110/08/05","新加坡商瑞銀",0,2,-2
"15341","3679新至陞","110/08/05","群益金鼎",2,0,2
"15342","3679新至陞","110/08/05","摩根大通",0,2,-2
"15343","3679新至陞","110/08/05","富邦-三重",2,0,2
"15344","3679新至陞","110/08/05","國泰-館前",0,2,-2
"15345","3679新至陞","110/08/05","永豐金-敦北",2,0,2
"15346","3679新至陞","110/08/05","凱基-東港",0,2,-2
"15347","3679新至陞","110/08/05","臺銀-新竹",1,0,1
"15348","3679新至陞","110/08/05","元大-竹北",0,2,-2
"15349","3679新至陞","110/08/05","第一金-新興",1,0,1
"15350","3679新至陞","110/08/05","日盛-嘉義",0,1,-1
"15351","3679新至陞","110/08/05","統一-宜蘭",1,0,1
"15352","3679新至陞","110/08/05","美商高盛",1,2,-1
"15353","3679新至陞","110/08/05","元富-同大",1,0,1
"15354","3679新至陞","110/08/05","港商野村",0,1,-1
"15355","3679新至陞","110/08/05","中國信託-新竹",1,0,1
"15356","3679新至陞","110/08/05","第一金-員林",0,1,-1
"15357","3679新至陞","110/08/05","兆豐-民生",1,0,1
"15358","3679新至陞","110/08/05","統一-中壢",0,1,-1
"15359","3679新至陞","110/08/05","國泰-新莊",1,0,1
"15360","3679新至陞","110/08/05","統一-新竹",0,1,-1
"15361","2727王品","110/08/05","港商野村",68,43,25
"15362","2727王品","110/08/05","元富-宜蘭",6,96,-90
"15363","2727王品","110/08/05","花旗環球",24,0,24
"15364","2727王品","110/08/05","凱基-市政",1,89,-88
"15365","2727王品","110/08/05","新光",42,19,23
"15366","2727王品","110/08/05","群益金鼎-宜蘭",4,89,-85
"15367","2727王品","110/08/05","永豐金-忠孝",21,0,21
"15368","2727王品","110/08/05","永豐金-大園",4,66,-62
"15369","2727王品","110/08/05","凱基-埔墘",15,0,15
"15370","2727王品","110/08/05","康和-澎湖",1,60,-59
"15371","2727王品","110/08/05","新光-桃園",17,3,14
"15372","2727王品","110/08/05","日盛-八德",1,33,-32
"15373","2727王品","110/08/05","日盛-忠孝",16,3,13
"15374","2727王品","110/08/05","元大-桃園",0,29,-29
"15375","2727王品","110/08/05","統一",28,15,13
"15376","2727王品","110/08/05","凱基-竹科",4,31,-27
"15377","2727王品","110/08/05","富邦-員林",15,2,13
"15378","2727王品","110/08/05","富邦-新店",2,29,-27
"15379","2727王品","110/08/05","永豐金-桃盛",16,3,13
"15380","2727王品","110/08/05","兆豐-小港",2,26,-24
"15381","2727王品","110/08/05","元富-屏東",12,0,12
"15382","2727王品","110/08/05","華南永昌",6,25,-19
"15383","2727王品","110/08/05","凱基-台北",52,40,12
"15384","2727王品","110/08/05","台灣摩根士丹利",15,32,-17
"15385","2727王品","110/08/05","永豐金-彰化",12,0,12
"15386","2727王品","110/08/05","凱基-天母",0,15,-15
"15387","2727王品","110/08/05","美林",11,0,11
"15388","2727王品","110/08/05","富邦證券",0,15,-15
"15389","2727王品","110/08/05","群益金鼎-崇德",10,0,10
"15390","2727王品","110/08/05","永豐金證券",1,13,-12
"15391","1570力肯","110/08/05","國票",352,0,352
"15392","1570力肯","110/08/05","國票-和平",7,402,-395
"15393","1570力肯","110/08/05","台新證券",211,87,124
"15394","1570力肯","110/08/05","摩根大通",46,335,-289
"15395","1570力肯","110/08/05","國泰-敦南",206,125,81
"15396","1570力肯","110/08/05","國票-北高雄",79,306,-227
"15397","1570力肯","110/08/05","聯邦商銀",75,0,75
"15398","1570力肯","110/08/05","統一",3,226,-223
"15399","1570力肯","110/08/05","元大-東泰",61,4,57
"15400","1570力肯","110/08/05","凱基-台北",184,366,-182
"15401","1570力肯","110/08/05","元大-桃興",113,66,47
"15402","1570力肯","110/08/05","統一-土城",89,161,-72
"15403","1570力肯","110/08/05","國泰-板橋",96,50,46
"15404","1570力肯","110/08/05","統一-屏東",0,64,-64
"15405","1570力肯","110/08/05","合庫-桃園",92,48,44
"15406","1570力肯","110/08/05","大昌-新店",9,61,-52
"15407","1570力肯","110/08/05","華南永昌-高雄",53,12,41
"15408","1570力肯","110/08/05","群益金鼎-忠孝",11,60,-49
"15409","1570力肯","110/08/05","國泰-高雄",50,14,36
"15410","1570力肯","110/08/05","臺銀-臺南",12,52,-40
"15411","1570力肯","110/08/05","國泰-台中",60,25,35
"15412","1570力肯","110/08/05","凱基-岡山",28,68,-40
"15413","1570力肯","110/08/05","富邦-仁愛",52,17,35
"15414","1570力肯","110/08/05","元大-蘆洲",8,44,-36
"15415","1570力肯","110/08/05","中國信託-忠孝",37,3,34
"15416","1570力肯","110/08/05","統一-仁愛",25,60,-35
"15417","1570力肯","110/08/05","元大-中壢",44,10,34
"15418","1570力肯","110/08/05","富邦-高雄",8,43,-35
"15419","1570力肯","110/08/05","日盛-新竹",30,0,30
"15420","1570力肯","110/08/05","大慶-蘆洲",110,142,-32
"15421","6180橘子","110/08/05","永豐金-松山",51,0,51
"15422","6180橘子","110/08/05","凱基-板橋",0,80,-80
"15423","6180橘子","110/08/05","新光",40,2,38
"15424","6180橘子","110/08/05","康和-高雄",0,40,-40
"15425","6180橘子","110/08/05","兆豐證券",33,0,33
"15426","6180橘子","110/08/05","合庫-鳳山",0,32,-32
"15427","6180橘子","110/08/05","中國信託-文心",15,0,15
"15428","6180橘子","110/08/05","日盛-頭份",1,24,-23
"15429","6180橘子","110/08/05","富邦-陽明",15,0,15
"15430","6180橘子","110/08/05","兆豐-新營",0,22,-22
"15431","6180橘子","110/08/05","元大-龍潭",11,0,11
"15432","6180橘子","110/08/05","元大-福營",0,20,-20
"15433","6180橘子","110/08/05","日盛-新竹",10,0,10
"15434","6180橘子","110/08/05","新加坡商瑞銀",0,19,-19
"15435","6180橘子","110/08/05","凱基-汐止",10,0,10
"15436","6180橘子","110/08/05","永豐金-新竹",0,17,-17
"15437","6180橘子","110/08/05","元大-中壢",10,1,9
"15438","6180橘子","110/08/05","第一金-新興",1,16,-15
"15439","6180橘子","110/08/05","元富-潮州",8,0,8
"15440","6180橘子","110/08/05","凱基-中壢",0,12,-12
"15441","6180橘子","110/08/05","大慶",7,0,7
"15442","6180橘子","110/08/05","光和",0,10,-10
"15443","6180橘子","110/08/05","台新證券",7,0,7
"15444","6180橘子","110/08/05","統一-中壢",0,9,-9
"15445","6180橘子","110/08/05","聯邦-雙和",7,0,7
"15446","6180橘子","110/08/05","富邦-基隆",0,9,-9
"15447","6180橘子","110/08/05","元大證券",7,0,7
"15448","6180橘子","110/08/05","台灣摩根士丹利",0,8,-8
"15449","6180橘子","110/08/05","國泰-新莊",6,0,6
"15450","6180橘子","110/08/05","康和-仁愛",0,8,-8
"15451","2390云辰","110/08/05","日盛證券",100,0,100
"15452","2390云辰","110/08/05","摩根大通",45,525,-480
"15453","2390云辰","110/08/05","兆豐-岡山",63,0,63
"15454","2390云辰","110/08/05","統一-新台中",62,177,-115
"15455","2390云辰","110/08/05","凱基-基隆",65,10,55
"15456","2390云辰","110/08/05","富邦-中壢",0,81,-81
"15457","2390云辰","110/08/05","凱基-中壢",52,3,49
"15458","2390云辰","110/08/05","元大-大甲",3,73,-70
"15459","2390云辰","110/08/05","台新-左楠",30,0,30
"15460","2390云辰","110/08/05","元大-樹林",16,53,-37
"15461","2390云辰","110/08/05","富邦-台北",33,6,27
"15462","2390云辰","110/08/05","元富-大裕",17,46,-29
"15463","2390云辰","110/08/05","統一-中壢",27,1,26
"15464","2390云辰","110/08/05","凱基-台中",1,30,-29
"15465","2390云辰","110/08/05","元大-和平",47,22,25
"15466","2390云辰","110/08/05","大慶-蘆洲",2,30,-28
"15467","2390云辰","110/08/05","統一-士林",26,2,24
"15468","2390云辰","110/08/05","元大-大統",3,31,-28
"15469","2390云辰","110/08/05","富邦-新營",23,0,23
"15470","2390云辰","110/08/05","臺銀-金山",1,27,-26
"15471","2390云辰","110/08/05","元大-景美",22,1,21
"15472","2390云辰","110/08/05","國泰-台中",0,23,-23
"15473","2390云辰","110/08/05","合庫-嘉義",20,0,20
"15474","2390云辰","110/08/05","富邦-岡山",0,23,-23
"15475","2390云辰","110/08/05","台灣企銀-嘉義",20,0,20
"15476","2390云辰","110/08/05","元大-土城學府",24,47,-23
"15477","2390云辰","110/08/05","日盛-板橋",21,1,20
"15478","2390云辰","110/08/05","台新-台中",28,50,-22
"15479","2390云辰","110/08/05","凱基-竹科",28,8,20
"15480","2390云辰","110/08/05","群益金鼎-鳳山",0,21,-21
"15481","1471首利","110/08/04","玉山-桃園",51,0,51
"15482","1471首利","110/08/04","國票-九鼎",0,60,-60
"15483","1471首利","110/08/04","華南永昌-潮州",50,1,49
"15484","1471首利","110/08/04","日盛-士林",0,20,-20
"15485","1471首利","110/08/04","瑞士信貸",33,3,30
"15486","1471首利","110/08/04","元大-博愛",4,24,-20
"15487","1471首利","110/08/04","兆豐-板橋",20,0,20
"15488","1471首利","110/08/04","群益金鼎-台中",1,20,-19
"15489","1471首利","110/08/04","兆豐-台中港",30,13,17
"15490","1471首利","110/08/04","國泰-高雄",0,16,-16
"15491","1471首利","110/08/04","富邦-基隆",16,0,16
"15492","1471首利","110/08/04","元大-台南",1,17,-16
"15493","1471首利","110/08/04","美林",15,0,15
"15494","1471首利","110/08/04","國泰-敦南",18,32,-14
"15495","1471首利","110/08/04","永豐金-員林",12,0,12
"15496","1471首利","110/08/04","新光",21,33,-12
"15497","1471首利","110/08/04","第一金-台南",11,0,11
"15498","1471首利","110/08/04","凱基-土城",0,12,-12
"15499","1471首利","110/08/04","德信-中正",12,1,11
"15500","1471首利","110/08/04","合庫-高雄",0,10,-10
"15501","1471首利","110/08/04","合庫-台中",10,0,10
"15502","1471首利","110/08/04","元富-宜蘭",0,10,-10
"15503","1471首利","110/08/04","國泰-新莊",10,0,10
"15504","1471首利","110/08/04","國泰-板橋",0,10,-10
"15505","1471首利","110/08/04","富邦-桃園",10,0,10
"15506","1471首利","110/08/04","群益金鼎-鳳山",0,10,-10
"15507","1471首利","110/08/04","元大-苗栗",10,0,10
"15508","1471首利","110/08/04","元大-東泰",0,10,-10
"15509","1471首利","110/08/04","玉山-左營",10,1,9
"15510","1471首利","110/08/04","元大-林園",0,10,-10
"15511","2883開發金","110/08/04","國泰證券",3650,0,3650
"15512","2883開發金","110/08/04","康和-仁愛",3,1737,-1734
"15513","2883開發金","110/08/04","統一",2763,29,2734
"15514","2883開發金","110/08/04","新加坡商瑞銀",356,1472,-1116
"15515","2883開發金","110/08/04","凱基-台北",2041,429,1612
"15516","2883開發金","110/08/04","豐農",5,1025,-1020
"15517","2883開發金","110/08/04","元富-城東",1602,26,1576
"15518","2883開發金","110/08/04","富邦-建國",271,1004,-733
"15519","2883開發金","110/08/04","元富",1190,0,1190
"15520","2883開發金","110/08/04","元大-北成功",6,608,-602
"15521","2883開發金","110/08/04","美商高盛",1033,355,678
"15522","2883開發金","110/08/04","台灣摩根士丹利",573,1019,-446
"15523","2883開發金","110/08/04","康和",661,6,655
"15524","2883開發金","110/08/04","台新-中壢",2,431,-429
"15525","2883開發金","110/08/04","國票-長城",504,8,496
"15526","2883開發金","110/08/04","凱基-和平",1,400,-399
"15527","2883開發金","110/08/04","元大-大灣",734,304,430
"15528","2883開發金","110/08/04","元大-蘆洲",7,370,-363
"15529","2883開發金","110/08/04","永豐金-板橋",500,100,400
"15530","2883開發金","110/08/04","元大-民生",10,370,-360
"15531","2883開發金","110/08/04","永豐金-台南",389,11,378
"15532","2883開發金","110/08/04","中國信託-中壢",1,321,-320
"15533","2883開發金","110/08/04","日盛證券",608,255,353
"15534","2883開發金","110/08/04","港商法國興業",0,291,-291
"15535","2883開發金","110/08/04","花旗環球",343,0,343
"15536","2883開發金","110/08/04","日盛-北高雄",20,309,-289
"15537","2883開發金","110/08/04","瑞士信貸",462,121,341
"15538","2883開發金","110/08/04","日盛-花蓮",11,250,-239
"15539","2883開發金","110/08/04","凱基",320,0,320
"15540","2883開發金","110/08/04","群益金鼎-東湖",10,243,-233
"15541","6205詮欣","110/08/04","摩根大通",18,0,18
"15542","6205詮欣","110/08/04","永豐金-敦南",16,36,-20
"15543","6205詮欣","110/08/04","臺銀-民權",5,0,5
"15544","6205詮欣","110/08/04","瑞士信貸",6,10,-4
"15545","6205詮欣","110/08/04","凱基-台北",4,0,4
"15546","6205詮欣","110/08/04","致和-高雄",0,4,-4
"15547","6205詮欣","110/08/04","元富-潮州",3,0,3
"15548","6205詮欣","110/08/04","群益金鼎-台南",0,3,-3
"15549","6205詮欣","110/08/04","台中銀",3,0,3
"15550","6205詮欣","110/08/04","元大-路竹",0,3,-3
"15551","6205詮欣","110/08/04","華南永昌",3,0,3
"15552","6205詮欣","110/08/04","元大-北成功",0,3,-3
"15553","6205詮欣","110/08/04","美林",2,0,2
"15554","6205詮欣","110/08/04","凱基-東門",0,2,-2
"15555","6205詮欣","110/08/04","元富-新店",2,0,2
"15556","6205詮欣","110/08/04","凱基-基隆",0,2,-2
"15557","6205詮欣","110/08/04","元大-羅東",2,0,2
"15558","6205詮欣","110/08/04","凱基-大安",0,2,-2
"15559","6205詮欣","110/08/04","元大-館前",2,0,2
"15560","6205詮欣","110/08/04","元大-土城學府",0,2,-2
"15561","6205詮欣","110/08/04","元大-楊梅",2,0,2
"15562","6205詮欣","110/08/04","元大-民生",0,2,-2
"15563","6205詮欣","110/08/04","元大-信義",2,0,2
"15564","6205詮欣","110/08/04","日盛-八德",0,1,-1
"15565","6205詮欣","110/08/04","永豐金-埔里",2,0,2
"15566","6205詮欣","110/08/04","宏遠-高雄",0,1,-1
"15567","6205詮欣","110/08/04","日盛-板橋",1,0,1
"15568","6205詮欣","110/08/04","新加坡商瑞銀",0,1,-1
"15569","6205詮欣","110/08/04","日盛-木柵",1,0,1
"15570","6205詮欣","110/08/04","第一金-華江",0,1,-1
"15571","1540喬福","110/08/04","元富-中原",58,0,58
"15572","1540喬福","110/08/04","元大-大天母",0,60,-60
"15573","1540喬福","110/08/04","(牛牛牛)亞-鑫豐",26,0,26
"15574","1540喬福","110/08/04","統一-新台中",0,18,-18
"15575","1540喬福","110/08/04","國泰-敦南",10,0,10
"15576","1540喬福","110/08/04","群益金鼎-士林",0,7,-7
"15577","1540喬福","110/08/04","富邦-南屯",10,0,10
"15578","1540喬福","110/08/04","兆豐-北高雄",0,6,-6
"15579","1540喬福","110/08/04","兆豐-鹿港",3,0,3
"15580","1540喬福","110/08/04","凱基-市政",0,5,-5
"15581","1540喬福","110/08/04","元大-土城永寧",2,0,2
"15582","1540喬福","110/08/04","亞東-高雄",0,4,-4
"15583","1540喬福","110/08/04","第一金-桃園",1,0,1
"15584","1540喬福","110/08/04","永豐金-大園",0,4,-4
"15585","1540喬福","110/08/04","兆豐-高雄",1,0,1
"15586","1540喬福","110/08/04","永豐金-豐原",0,2,-2
"15587","1540喬福","110/08/04","元大-苑裡",1,0,1
"15588","1540喬福","110/08/04","兆豐-三重",0,1,-1
"15589","1540喬福","110/08/04","臺銀-鳳山",0,0,0
"15590","1540喬福","110/08/04","致和-南京",0,1,-1
"15591","1540喬福","110/08/04","大慶",0,0,0
"15592","1540喬福","110/08/04","國票-嘉義",0,1,-1
"15593","1540喬福","110/08/04","元富-信義",0,0,0
"15594","1540喬福","110/08/04","兆豐-嘉義",0,1,-1
"15595","1540喬福","110/08/04","德信-新營",1,1,0
"15596","1540喬福","110/08/04","華南永昌-林口",0,1,-1
"15597","1540喬福","110/08/04","國票-台中",1,1,0
"15598","1540喬福","110/08/04","華南永昌-潮州",0,1,-1
"15599","1540喬福","110/08/04","康和-板橋",0,0,0
"15600","1540喬福","110/08/04","國票-台中",1,1,0
"15601","2888新光金","110/08/04","港商麥格理",2490,0,2490
"15602","2888新光金","110/08/04","永豐金-苓雅",2,1543,-1541
"15603","2888新光金","110/08/04","凱基-八德",1000,1,999
"15604","2888新光金","110/08/04","美商高盛",196,1441,-1245
"15605","2888新光金","110/08/04","新光",1122,247,875
"15606","2888新光金","110/08/04","台灣摩根士丹利",724,1776,-1052
"15607","2888新光金","110/08/04","國票-桃園",1200,402,798
"15608","2888新光金","110/08/04","摩根大通",616,1665,-1049
"15609","2888新光金","110/08/04","華南永昌-南京",759,36,723
"15610","2888新光金","110/08/04","康和-台中",0,680,-680
"15611","2888新光金","110/08/04","港商法國興業",568,0,568
"15612","2888新光金","110/08/04","群益金鼎-高雄",0,533,-533
"15613","2888新光金","110/08/04","花旗環球",559,0,559
"15614","2888新光金","110/08/04","亞東",34,531,-497
"15615","2888新光金","110/08/04","法銀巴黎",801,242,559
"15616","2888新光金","110/08/04","群益金鼎-土城",25,464,-439
"15617","2888新光金","110/08/04","凱基-台北",889,355,534
"15618","2888新光金","110/08/04","國票-北高雄",2,425,-423
"15619","2888新光金","110/08/04","統一-松江",500,0,500
"15620","2888新光金","110/08/04","凱基-台南",0,400,-400
"15621","2888新光金","110/08/04","華南永昌-長虹",345,0,345
"15622","2888新光金","110/08/04","新加坡商瑞銀",128,486,-358
"15623","2888新光金","110/08/04","美林",884,551,333
"15624","2888新光金","110/08/04","統一-屏東",0,344,-344
"15625","2888新光金","110/08/04","群益金鼎-中壢",301,3,298
"15626","2888新光金","110/08/04","統一-宜蘭",8,326,-318
"15627","2888新光金","110/08/04","群益金鼎",278,0,278
"15628","2888新光金","110/08/04","群益金鼎-萬華",0,284,-284
"15629","2888新光金","110/08/04","元大-北投",249,5,244
"15630","2888新光金","110/08/04","富邦-仁愛",10,276,-266
"15631","1340勝悅","110/08/04","第一金-新竹",10,0,10
"15632","1340勝悅","110/08/04","中國信託",0,23,-23
"15633","1340勝悅","110/08/04","凱基-虎尾",8,0,8
"15634","1340勝悅","110/08/04","永豐金-潮州",0,19,-19
"15635","1340勝悅","110/08/04","凱基-台中",6,0,6
"15636","1340勝悅","110/08/04","元富-花蓮",0,10,-10
"15637","1340勝悅","110/08/04","臺灣企銀-埔墘",5,0,5
"15638","1340勝悅","110/08/04","中國信託-永康",0,10,-10
"15639","1340勝悅","110/08/04","第一金",5,0,5
"15640","1340勝悅","110/08/04","第一金-中壢",0,7,-7
"15641","1340勝悅","110/08/04","凱基-八德",5,0,5
"15642","1340勝悅","110/08/04","高橋-中壢",0,5,-5
"15643","1340勝悅","110/08/04","永豐金-博愛",5,0,5
"15644","1340勝悅","110/08/04","富邦-新店",0,5,-5
"15645","1340勝悅","110/08/04","摩根大通",6,2,4
"15646","1340勝悅","110/08/04","台新-高雄",0,4,-4
"15647","1340勝悅","110/08/04","凱基-三重",4,0,4
"15648","1340勝悅","110/08/04","新光",0,4,-4
"15649","1340勝悅","110/08/04","統一-城中",7,4,3
"15650","1340勝悅","110/08/04","兆豐-松德",0,2,-2
"15651","1340勝悅","110/08/04","群益金鼎-館前",3,0,3
"15652","1340勝悅","110/08/04","凱基-嘉義",0,2,-2
"15653","1340勝悅","110/08/04","元大-南京",3,0,3
"15654","1340勝悅","110/08/04","富邦-宜蘭",0,2,-2
"15655","1340勝悅","110/08/04","瑞士信貸",2,0,2
"15656","1340勝悅","110/08/04","永豐金-永康",0,2,-2
"15657","1340勝悅","110/08/04","大慶-富順",2,0,2
"15658","1340勝悅","110/08/04","永豐金-嘉義",0,2,-2
"15659","1340勝悅","110/08/04","國泰-高雄",2,0,2
"15660","1340勝悅","110/08/04","玉山證券",0,1,-1
"15661","6246臺龍","110/08/04","統一",347,0,347
"15662","6246臺龍","110/08/04","大慶-富順",0,168,-168
"15663","6246臺龍","110/08/04","元大-西螺",30,0,30
"15664","6246臺龍","110/08/04","元大-善化",1,91,-90
"15665","6246臺龍","110/08/04","華南永昌-嘉義",26,0,26
"15666","6246臺龍","110/08/04","新光-高雄",2,75,-73
"15667","6246臺龍","110/08/04","中國信託-永康",31,9,22
"15668","6246臺龍","110/08/04","元大-永春",1,40,-39
"15669","6246臺龍","110/08/04","元大-西屯",25,4,21
"15670","6246臺龍","110/08/04","元大-基隆孝二",1,35,-34
"15671","6246臺龍","110/08/04","凱基-竹科",23,3,20
"15672","6246臺龍","110/08/04","凱基-復興",10,43,-33
"15673","6246臺龍","110/08/04","凱基-大直",19,0,19
"15674","6246臺龍","110/08/04","國泰-台中",3,34,-31
"15675","6246臺龍","110/08/04","第一金-台南",18,0,18
"15676","6246臺龍","110/08/04","統一-屏東",0,26,-26
"15677","6246臺龍","110/08/04","萬泰",15,0,15
"15678","6246臺龍","110/08/04","台灣企銀-台南",1,25,-24
"15679","6246臺龍","110/08/04","華南永昌-台中",15,0,15
"15680","6246臺龍","110/08/04","宏遠-民生",0,22,-22
"15681","6246臺龍","110/08/04","凱基-板橋",13,0,13
"15682","6246臺龍","110/08/04","兆豐-來福",0,20,-20
"15683","6246臺龍","110/08/04","宏遠-高雄",12,0,12
"15684","6246臺龍","110/08/04","永豐金-市政",0,17,-17
"15685","6246臺龍","110/08/04","新光-台中",11,0,11
"15686","6246臺龍","110/08/04","台新-台中",5,21,-16
"15687","6246臺龍","110/08/04","玉山證券",13,2,11
"15688","6246臺龍","110/08/04","華南永昌-彰化",1,16,-15
"15689","6246臺龍","110/08/04","永豐金-高雄",12,1,11
"15690","6246臺龍","110/08/04","元大-博愛",13,28,-15
"15691","00715L期街口布蘭特正2","110/08/04","宏遠-高雄",1056,0,1056
"15692","00715L期街口布蘭特正2","110/08/04","元大證券",1348,7345,-5997
"15693","00715L期街口布蘭特正2","110/08/04","凱基-豐中",576,0,576
"15694","00715L期街口布蘭特正2","110/08/04","凱基-台北",37,5749,-5712
"15695","00715L期街口布蘭特正2","110/08/04","富邦-基隆",467,0,467
"15696","00715L期街口布蘭特正2","110/08/04","富邦證券",253,2075,-1822
"15697","00715L期街口布蘭特正2","110/08/04","國泰-板橋",470,30,440
"15698","00715L期街口布蘭特正2","110/08/04","第一金-頭份",11,400,-389
"15699","00715L期街口布蘭特正2","110/08/04","統一-高雄",358,3,355
"15700","00715L期街口布蘭特正2","110/08/04","富邦-永和",4,376,-372
"15701","00715L期街口布蘭特正2","110/08/04","中國信託-永康",219,1,218
"15702","00715L期街口布蘭特正2","110/08/04","永豐金-新店",0,370,-370
"15703","00715L期街口布蘭特正2","110/08/04","元大-中和",217,0,217
"15704","00715L期街口布蘭特正2","110/08/04","元富",53,412,-359
"15705","00715L期街口布蘭特正2","110/08/04","日盛-花蓮",201,1,200
"15706","00715L期街口布蘭特正2","110/08/04","臺銀-民權",15,366,-351
"15707","00715L期街口布蘭特正2","110/08/04","元大-中壢",201,12,189
"15708","00715L期街口布蘭特正2","110/08/04","兆豐-新莊",0,300,-300
"15709","00715L期街口布蘭特正2","110/08/04","宏遠-桃園",190,2,188
"15710","00715L期街口布蘭特正2","110/08/04","大昌-新店",17,300,-283
"15711","00715L期街口布蘭特正2","110/08/04","玉山-大里",182,0,182
"15712","00715L期街口布蘭特正2","110/08/04","元大-西螺",87,303,-216
"15713","00715L期街口布蘭特正2","110/08/04","新光",258,80,178
"15714","00715L期街口布蘭特正2","110/08/04","華南永昌-高雄",7,206,-199
"15715","00715L期街口布蘭特正2","110/08/04","元大-花蓮",178,0,178
"15716","00715L期街口布蘭特正2","110/08/04","國票-台中",8,200,-192
"15717","00715L期街口布蘭特正2","110/08/04","新光-台中",242,68,174
"15718","00715L期街口布蘭特正2","110/08/04","群益金鼎-鳳山",12,174,-162
"15719","00715L期街口布蘭特正2","110/08/04","(牛牛牛)亞-網路",166,0,166
"15720","00715L期街口布蘭特正2","110/08/04","國泰-台南",8,150,-142
"15721","8941關中","110/08/04","宏遠-館前",3,0,3
"15722","8941關中","110/08/04","元大-基隆",0,3,-3
"15723","8941關中","110/08/04","日盛-和美",1,0,1
"15724","8941關中","110/08/04","富邦-員林",0,2,-2
"15725","8941關中","110/08/04","元大-華山",1,0,1
"15726","8941關中","110/08/04","新光-高雄",0,0,0
"15727","8941關中","110/08/04","新光-高雄",0,0,0
"15728","8941關中","110/08/04","國泰-高雄",0,0,0
"15729","8941關中","110/08/04","國泰-高雄",0,0,0
"15730","8941關中","110/08/04","富邦-建國",0,0,0
"15731","8941關中","110/08/04","富邦-建國",0,0,0
"15732","8941關中","110/08/04","元大-西屯",0,0,0
"15733","8941關中","110/08/04","元大-西屯",0,0,0
"15734","8941關中","110/08/04","元大-花蓮",0,0,0
"15735","8941關中","110/08/04","元大-花蓮",0,0,0
"15736","8941關中","110/08/04","永豐金-萬盛",0,0,0
"15737","8941關中","110/08/04","永豐金-萬盛",0,0,0
"15738","8941關中","110/08/04","",NA,NA,NA
"15739","8941關中","110/08/04","",NA,NA,NA
"15740","8941關中","110/08/04","",NA,NA,NA
"15741","8941關中","110/08/04","",NA,NA,NA
"15742","8941關中","110/08/04","",NA,NA,NA
"15743","8941關中","110/08/04","",NA,NA,NA
"15744","8941關中","110/08/04","",NA,NA,NA
"15745","8941關中","110/08/04","",NA,NA,NA
"15746","8941關中","110/08/04","",NA,NA,NA
"15747","8941關中","110/08/04","",NA,NA,NA
"15748","8941關中","110/08/04","",NA,NA,NA
"15749","8941關中","110/08/04","",NA,NA,NA
"15750","8941關中","110/08/04","",NA,NA,NA
"15751","8936國統","110/08/04","第一金-光復",120,0,120
"15752","8936國統","110/08/04","兆豐-彰化",0,61,-61
"15753","8936國統","110/08/04","美林",99,3,96
"15754","8936國統","110/08/04","凱基-台北",4,56,-52
"15755","8936國統","110/08/04","華南永昌-楠梓",70,5,65
"15756","8936國統","110/08/04","凱基-內埔",0,50,-50
"15757","8936國統","110/08/04","永豐金-高雄",62,0,62
"15758","8936國統","110/08/04","台灣摩根士丹利",0,42,-42
"15759","8936國統","110/08/04","國票-台南",60,0,60
"15760","8936國統","110/08/04","永豐金-苓雅",1,40,-39
"15761","8936國統","110/08/04","永豐金-台中",30,0,30
"15762","8936國統","110/08/04","群益金鼎-內湖",0,30,-30
"15763","8936國統","110/08/04","第一金-豐原",20,0,20
"15764","8936國統","110/08/04","國票-北高雄",0,20,-20
"15765","8936國統","110/08/04","玉山-高雄",13,0,13
"15766","8936國統","110/08/04","宏遠-館前",0,19,-19
"15767","8936國統","110/08/04","元大-莒光",11,0,11
"15768","8936國統","110/08/04","美商高盛",3,22,-19
"15769","8936國統","110/08/04","亞東-高雄",10,0,10
"15770","8936國統","110/08/04","元大-大里德芳",4,21,-17
"15771","8936國統","110/08/04","第一金-路竹",10,0,10
"15772","8936國統","110/08/04","第一金-高雄",0,14,-14
"15773","8936國統","110/08/04","新光-台中",8,1,7
"15774","8936國統","110/08/04","日盛-竹北",0,12,-12
"15775","8936國統","110/08/04","統一-三多",5,0,5
"15776","8936國統","110/08/04","亞東",0,12,-12
"15777","8936國統","110/08/04","國票-內壢",5,0,5
"15778","8936國統","110/08/04","摩根大通",32,44,-12
"15779","8936國統","110/08/04","新光",10,5,5
"15780","8936國統","110/08/04","第一金-嘉義",0,10,-10
"15781","6226光鼎","110/08/04","富邦-嘉義",1247,573,674
"15782","6226光鼎","110/08/04","國泰-敦南",89,234,-145
"15783","6226光鼎","110/08/04","永豐金-桃盛",205,0,205
"15784","6226光鼎","110/08/04","日盛-嘉義",0,131,-131
"15785","6226光鼎","110/08/04","台新-左楠",120,1,119
"15786","6226光鼎","110/08/04","群益金鼎-東大",35,150,-115
"15787","6226光鼎","110/08/04","群益金鼎-敦南",127,8,119
"15788","6226光鼎","110/08/04","台中銀-員林",0,101,-101
"15789","6226光鼎","110/08/04","台灣摩根士丹利",135,55,80
"15790","6226光鼎","110/08/04","玉山-雙和",2,97,-95
"15791","6226光鼎","110/08/04","華南永昌-南京",89,14,75
"15792","6226光鼎","110/08/04","台新證券",76,167,-91
"15793","6226光鼎","110/08/04","台新-台中",101,32,69
"15794","6226光鼎","110/08/04","華南永昌-頭份",7,86,-79
"15795","6226光鼎","110/08/04","宏遠-台中",60,3,57
"15796","6226光鼎","110/08/04","高橋",0,70,-70
"15797","6226光鼎","110/08/04","大昌",79,26,53
"15798","6226光鼎","110/08/04","國泰-館前",18,62,-44
"15799","6226光鼎","110/08/04","台新-新莊",54,2,52
"15800","6226光鼎","110/08/04","凱基-永和",0,43,-43
"15801","6226光鼎","110/08/04","群益金鼎-三民",51,3,48
"15802","6226光鼎","110/08/04","日盛-景美",0,38,-38
"15803","6226光鼎","110/08/04","中國信託-永康",62,18,44
"15804","6226光鼎","110/08/04","華南永昌-高雄",9,47,-38
"15805","6226光鼎","110/08/04","國票-台中",45,2,43
"15806","6226光鼎","110/08/04","元大-太平",6,44,-38
"15807","6226光鼎","110/08/04","統一-士林",44,4,40
"15808","6226光鼎","110/08/04","元大-北投",0,37,-37
"15809","6226光鼎","110/08/04","統一-仁愛",51,14,37
"15810","6226光鼎","110/08/04","元大-板橋",0,37,-37
"15811","2363矽統","110/08/04","富邦-中壢",628,138,490
"15812","2363矽統","110/08/04","新加坡商瑞銀",986,2541,-1555
"15813","2363矽統","110/08/04","凱基-台北",7207,6730,477
"15814","2363矽統","110/08/04","台灣摩根士丹利",158,1373,-1215
"15815","2363矽統","110/08/04","元大-承德",449,81,368
"15816","2363矽統","110/08/04","摩根大通",2506,3701,-1195
"15817","2363矽統","110/08/04","群益金鼎-高雄",438,99,339
"15818","2363矽統","110/08/04","日盛-文化",121,1226,-1105
"15819","2363矽統","110/08/04","元富-嘉義",383,57,326
"15820","2363矽統","110/08/04","美林",2013,2637,-624
"15821","2363矽統","110/08/04","元大-旗山",446,147,299
"15822","2363矽統","110/08/04","凱基-新莊",44,445,-401
"15823","2363矽統","110/08/04","大慶-台中",304,14,290
"15824","2363矽統","110/08/04","台新-松江",60,449,-389
"15825","2363矽統","110/08/04","國票-博愛",425,150,275
"15826","2363矽統","110/08/04","統一-士林",649,1031,-382
"15827","2363矽統","110/08/04","台新-台南",494,230,264
"15828","2363矽統","110/08/04","新光",1494,1876,-382
"15829","2363矽統","110/08/04","群益金鼎-內湖",393,135,258
"15830","2363矽統","110/08/04","華南永昌",691,1068,-377
"15831","2363矽統","110/08/04","群益金鼎-桃園",295,68,227
"15832","2363矽統","110/08/04","富邦-彰化",122,486,-364
"15833","2363矽統","110/08/04","永豐金-羅東",397,182,215
"15834","2363矽統","110/08/04","凱基-永和",198,478,-280
"15835","2363矽統","110/08/04","元大-永春",347,142,205
"15836","2363矽統","110/08/04","富邦-嘉義",1358,1619,-261
"15837","2363矽統","110/08/04","台新-屏東",466,275,191
"15838","2363矽統","110/08/04","元大-前金",175,419,-244
"15839","2363矽統","110/08/04","元大-萬華",286,96,190
"15840","2363矽統","110/08/04","凱基-大直",681,912,-231
"15841","8112至上","110/08/04","台灣匯立證券",138,0,138
"15842","8112至上","110/08/04","日盛-高雄",1,355,-354
"15843","8112至上","110/08/04","元富-新興",94,8,86
"15844","8112至上","110/08/04","玉山-士林",0,150,-150
"15845","8112至上","110/08/04","合庫-西台中",55,7,48
"15846","8112至上","110/08/04","台灣摩根士丹利",20,143,-123
"15847","8112至上","110/08/04","摩根大通",145,97,48
"15848","8112至上","110/08/04","元富-大昌",0,120,-120
"15849","8112至上","110/08/04","台新證券",48,1,47
"15850","8112至上","110/08/04","華南永昌-林口",1,90,-89
"15851","8112至上","110/08/04","第一金-高雄",40,0,40
"15852","8112至上","110/08/04","元大-北屯",1,70,-69
"15853","8112至上","110/08/04","群益金鼎-大安",40,0,40
"15854","8112至上","110/08/04","凱基-台北",140,206,-66
"15855","8112至上","110/08/04","日盛-新竹",60,26,34
"15856","8112至上","110/08/04","新加坡商瑞銀",16,68,-52
"15857","8112至上","110/08/04","美林",69,38,31
"15858","8112至上","110/08/04","第一金-自由",0,50,-50
"15859","8112至上","110/08/04","凱基-虎尾",30,0,30
"15860","8112至上","110/08/04","康和-內湖",0,34,-34
"15861","8112至上","110/08/04","永豐金-台南",32,2,30
"15862","8112至上","110/08/04","聯邦商銀",0,34,-34
"15863","8112至上","110/08/04","港商野村",30,1,29
"15864","8112至上","110/08/04","臺銀-鳳山",0,28,-28
"15865","8112至上","110/08/04","國泰-館前",29,5,24
"15866","8112至上","110/08/04","兆豐-公益",0,28,-28
"15867","8112至上","110/08/04","元富-佳里",21,0,21
"15868","8112至上","110/08/04","元大-崇德",0,21,-21
"15869","8112至上","110/08/04","日進",20,0,20
"15870","8112至上","110/08/04","元大-土城永寧",0,20,-20
"15871","1570力肯","110/08/04","摩根大通",330,27,303
"15872","1570力肯","110/08/04","元大-板橋",0,86,-86
"15873","1570力肯","110/08/04","統一",224,0,224
"15874","1570力肯","110/08/04","群益金鼎-忠孝",0,80,-80
"15875","1570力肯","110/08/04","富邦-台中",84,1,83
"15876","1570力肯","110/08/04","元富-緯城",0,51,-51
"15877","1570力肯","110/08/04","統一-土城",287,222,65
"15878","1570力肯","110/08/04","國票-和平",0,51,-51
"15879","1570力肯","110/08/04","群益金鼎-中壢",60,0,60
"15880","1570力肯","110/08/04","日盛-二林",0,43,-43
"15881","1570力肯","110/08/04","富邦-高雄",69,10,59
"15882","1570力肯","110/08/04","國泰-板橋",0,43,-43
"15883","1570力肯","110/08/04","統一-屏東",61,4,57
"15884","1570力肯","110/08/04","元大-新莊",1,44,-43
"15885","1570力肯","110/08/04","凱基-岡山",53,1,52
"15886","1570力肯","110/08/04","凱基-嘉義",0,42,-42
"15887","1570力肯","110/08/04","新光-台中",43,12,31
"15888","1570力肯","110/08/04","華南永昌-鳳山",2,42,-40
"15889","1570力肯","110/08/04","台中銀-員林",30,1,29
"15890","1570力肯","110/08/04","凱基-三峽",0,37,-37
"15891","1570力肯","110/08/04","元富-三重",37,12,25
"15892","1570力肯","110/08/04","國票-中正",0,36,-36
"15893","1570力肯","110/08/04","統一-新台中",30,6,24
"15894","1570力肯","110/08/04","高橋",0,30,-30
"15895","1570力肯","110/08/04","致和-府前",25,1,24
"15896","1570力肯","110/08/04","日盛-高雄",0,29,-29
"15897","1570力肯","110/08/04","凱基-中港",22,0,22
"15898","1570力肯","110/08/04","(牛牛牛)亞-鑫豐",6,29,-23
"15899","1570力肯","110/08/04","宏遠證券",20,0,20
"15900","1570力肯","110/08/04","元富-松德",1,22,-21
"15901","2929淘帝","110/08/04","兆豐-忠孝",23,0,23
"15902","2929淘帝","110/08/04","美林",12,107,-95
"15903","2929淘帝","110/08/04","華南永昌-長虹",21,0,21
"15904","2929淘帝","110/08/04","兆豐-新莊",0,94,-94
"15905","2929淘帝","110/08/04","兆豐-桃園",20,0,20
"15906","2929淘帝","110/08/04","富邦-北港",0,30,-30
"15907","2929淘帝","110/08/04","新加坡商瑞銀",34,18,16
"15908","2929淘帝","110/08/04","永興-水湳",0,20,-20
"15909","2929淘帝","110/08/04","凱基-林口",15,0,15
"15910","2929淘帝","110/08/04","兆豐-復興",0,20,-20
"15911","2929淘帝","110/08/04","富邦-竹東",17,5,12
"15912","2929淘帝","110/08/04","國泰-高雄",1,15,-14
"15913","2929淘帝","110/08/04","台新-建北",11,0,11
"15914","2929淘帝","110/08/04","元大-上新莊",0,14,-14
"15915","2929淘帝","110/08/04","凱基-豐中",11,0,11
"15916","2929淘帝","110/08/04","凱基-敦北",0,11,-11
"15917","2929淘帝","110/08/04","統一-汐止",10,0,10
"15918","2929淘帝","110/08/04","臺銀-金山",0,10,-10
"15919","2929淘帝","110/08/04","新百王",10,0,10
"15920","2929淘帝","110/08/04","日盛-斗六",0,10,-10
"15921","2929淘帝","110/08/04","凱基-台北",16,6,10
"15922","2929淘帝","110/08/04","港商野村",16,26,-10
"15923","2929淘帝","110/08/04","華南永昌-苗栗",10,0,10
"15924","2929淘帝","110/08/04","第一金-自由",0,10,-10
"15925","2929淘帝","110/08/04","富邦-板橋",10,0,10
"15926","2929淘帝","110/08/04","玉山-台南",0,10,-10
"15927","2929淘帝","110/08/04","元大-路竹",10,0,10
"15928","2929淘帝","110/08/04","凱基-五股",0,10,-10
"15929","2929淘帝","110/08/04","元大-東蘆",10,0,10
"15930","2929淘帝","110/08/04","華南永昌-楠梓",0,10,-10
"15931","5410國眾","110/08/04","永豐金-內湖",100,1,99
"15932","5410國眾","110/08/04","群益金鼎-內湖",0,46,-46
"15933","5410國眾","110/08/04","永豐金-板新",36,0,36
"15934","5410國眾","110/08/04","新光",2,36,-34
"15935","5410國眾","110/08/04","兆豐-城中",27,0,27
"15936","5410國眾","110/08/04","元富-嘉義",0,20,-20
"15937","5410國眾","110/08/04","凱基-竹北",10,0,10
"15938","5410國眾","110/08/04","元大-博愛",0,20,-20
"15939","5410國眾","110/08/04","新光-高雄",9,0,9
"15940","5410國眾","110/08/04","永豐金-彰化",0,20,-20
"15941","5410國眾","110/08/04","兆豐-北高雄",8,0,8
"15942","5410國眾","110/08/04","元大-斗信",0,11,-11
"15943","5410國眾","110/08/04","元富-三重",9,3,6
"15944","5410國眾","110/08/04","統一-平鎮",0,10,-10
"15945","5410國眾","110/08/04","台新證券",7,1,6
"15946","5410國眾","110/08/04","元大-台北",0,10,-10
"15947","5410國眾","110/08/04","元大-中壢",10,4,6
"15948","5410國眾","110/08/04","元大-大灣",0,10,-10
"15949","5410國眾","110/08/04","北城證券",5,0,5
"15950","5410國眾","110/08/04","元大-前金",0,9,-9
"15951","5410國眾","110/08/04","國票-和平",5,0,5
"15952","5410國眾","110/08/04","致和證券",0,8,-8
"15953","5410國眾","110/08/04","元大-新盛",5,0,5
"15954","5410國眾","110/08/04","元大-崇德",0,7,-7
"15955","5410國眾","110/08/04","永豐金-中盛",5,0,5
"15956","5410國眾","110/08/04","臺銀-鳳山",0,6,-6
"15957","5410國眾","110/08/04","永豐金-桃園",5,0,5
"15958","5410國眾","110/08/04","玉山-左營",0,6,-6
"15959","5410國眾","110/08/04","凱基-台北",7,3,4
"15960","5410國眾","110/08/04","富邦-台中",0,6,-6
"15961","2841台開","110/08/04","永豐金-敦南",1166,0,1166
"15962","2841台開","110/08/04","統一-三重",0,943,-943
"15963","2841台開","110/08/04","永豐金-鳳山",206,50,156
"15964","2841台開","110/08/04","群益金鼎-東大",0,250,-250
"15965","2841台開","110/08/04","凱基-文心",136,0,136
"15966","2841台開","110/08/04","元富-城東",5,250,-245
"15967","2841台開","110/08/04","國泰-敦南",135,7,128
"15968","2841台開","110/08/04","元大-大灣",16,200,-184
"15969","2841台開","110/08/04","新光",109,4,105
"15970","2841台開","110/08/04","元大-新店中正",0,128,-128
"15971","2841台開","110/08/04","日盛-信義",102,0,102
"15972","2841台開","110/08/04","兆豐-麻豆",0,120,-120
"15973","2841台開","110/08/04","兆豐-東門",100,0,100
"15974","2841台開","110/08/04","土銀",0,100,-100
"15975","2841台開","110/08/04","台新-三民",100,0,100
"15976","2841台開","110/08/04","臺銀",0,100,-100
"15977","2841台開","110/08/04","群益金鼎-海山",100,0,100
"15978","2841台開","110/08/04","富邦-新店",4,90,-86
"15979","2841台開","110/08/04","國泰-板橋",106,13,93
"15980","2841台開","110/08/04","合庫-台中",23,104,-81
"15981","2841台開","110/08/04","永豐金-彰化",100,10,90
"15982","2841台開","110/08/04","統一-高雄",0,77,-77
"15983","2841台開","110/08/04","永豐金-萬盛",101,16,85
"15984","2841台開","110/08/04","群益金鼎-屏東",0,75,-75
"15985","2841台開","110/08/04","國票-天祥",80,0,80
"15986","2841台開","110/08/04","中國信託-高雄",2,70,-68
"15987","2841台開","110/08/04","群益金鼎-崇德",84,5,79
"15988","2841台開","110/08/04","凱基-三峽",0,61,-61
"15989","2841台開","110/08/04","群益金鼎-館前",82,3,79
"15990","2841台開","110/08/04","統一-彰化",0,60,-60
"15991","6207雷科","110/08/04","凱基-羅東",80,1,79
"15992","6207雷科","110/08/04","凱基-板橋",1,213,-212
"15993","6207雷科","110/08/04","元大-鳳山",76,2,74
"15994","6207雷科","110/08/04","摩根大通",105,209,-104
"15995","6207雷科","110/08/04","凱基-台南",37,1,36
"15996","6207雷科","110/08/04","凱基-台北",22,122,-100
"15997","6207雷科","110/08/04","富邦-竹東",35,0,35
"15998","6207雷科","110/08/04","華南永昌",12,100,-88
"15999","6207雷科","110/08/04","群益金鼎-東門",31,4,27
"16000","6207雷科","110/08/04","統一-高雄",3,74,-71
"16001","6207雷科","110/08/04","新光-高雄",30,4,26
"16002","6207雷科","110/08/04","群益金鼎-大興",0,70,-70
"16003","6207雷科","110/08/04","大慶-蘆洲",21,0,21
"16004","6207雷科","110/08/04","日盛-忠孝",0,62,-62
"16005","6207雷科","110/08/04","瑞士信貸",20,0,20
"16006","6207雷科","110/08/04","富邦-台中",0,50,-50
"16007","6207雷科","110/08/04","元大-羅東",20,0,20
"16008","6207雷科","110/08/04","永豐金-內湖",0,50,-50
"16009","6207雷科","110/08/04","群益金鼎-南京",20,2,18
"16010","6207雷科","110/08/04","美林",3,47,-44
"16011","6207雷科","110/08/04","元大-汐止",16,0,16
"16012","6207雷科","110/08/04","元富-大昌",0,40,-40
"16013","6207雷科","110/08/04","兆豐-來福",15,0,15
"16014","6207雷科","110/08/04","兆豐-景美",2,40,-38
"16015","6207雷科","110/08/04","國泰-敦南",21,6,15
"16016","6207雷科","110/08/04","新加坡商瑞銀",12,49,-37
"16017","6207雷科","110/08/04","永豐金-台中",15,0,15
"16018","6207雷科","110/08/04","群益金鼎-古亭",2,24,-22
"16019","6207雷科","110/08/04","元大-沙鹿",14,0,14
"16020","6207雷科","110/08/04","華南永昌-虎尾",0,21,-21
"16021","3679新至陞","110/08/04","凱基-台北",27,0,27
"16022","3679新至陞","110/08/04","香港上海匯豐",0,12,-12
"16023","3679新至陞","110/08/04","港商法國興業",20,0,20
"16024","3679新至陞","110/08/04","台灣摩根士丹利",0,10,-10
"16025","3679新至陞","110/08/04","新加坡商瑞銀",13,0,13
"16026","3679新至陞","110/08/04","港商野村",0,8,-8
"16027","3679新至陞","110/08/04","(牛牛牛)亞-網路",11,0,11
"16028","3679新至陞","110/08/04","玉山證券",2,9,-7
"16029","3679新至陞","110/08/04","摩根大通",9,4,5
"16030","3679新至陞","110/08/04","富邦-陽明",0,6,-6
"16031","3679新至陞","110/08/04","國泰-敦南",6,2,4
"16032","3679新至陞","110/08/04","統一",0,5,-5
"16033","3679新至陞","110/08/04","土銀-和平",3,0,3
"16034","3679新至陞","110/08/04","華南永昌-淡水",0,5,-5
"16035","3679新至陞","110/08/04","台中銀-員林",3,0,3
"16036","3679新至陞","110/08/04","元大-成功",0,5,-5
"16037","3679新至陞","110/08/04","元大-永春",3,0,3
"16038","3679新至陞","110/08/04","群益金鼎-內湖",0,4,-4
"16039","3679新至陞","110/08/04","國票-台東",2,0,2
"16040","3679新至陞","110/08/04","國泰-館前",0,3,-3
"16041","3679新至陞","110/08/04","富邦-新店",2,0,2
"16042","3679新至陞","110/08/04","凱基-板橋",0,3,-3
"16043","3679新至陞","110/08/04","富邦-三重",2,0,2
"16044","3679新至陞","110/08/04","凱基-三峽",0,3,-3
"16045","3679新至陞","110/08/04","元大-板橋三民",2,0,2
"16046","3679新至陞","110/08/04","凱基-中山",0,3,-3
"16047","3679新至陞","110/08/04","永豐金-敦南",2,0,2
"16048","3679新至陞","110/08/04","元大-承德",1,4,-3
"16049","3679新至陞","110/08/04","大昌-新店",1,0,1
"16050","3679新至陞","110/08/04","元大-大同",0,3,-3
"16051","2727王品","110/08/04","元富",46,0,46
"16052","2727王品","110/08/04","台灣摩根士丹利",20,277,-257
"16053","2727王品","110/08/04","台新證券",36,7,29
"16054","2727王品","110/08/04","群益金鼎-三民",2,104,-102
"16055","2727王品","110/08/04","國泰-敦南",42,13,29
"16056","2727王品","110/08/04","第一金",1,102,-101
"16057","2727王品","110/08/04","國泰-台中",19,2,17
"16058","2727王品","110/08/04","元大-東蘆",1,45,-44
"16059","2727王品","110/08/04","華南永昌-虎尾",13,0,13
"16060","2727王品","110/08/04","新光-台中",10,43,-33
"16061","2727王品","110/08/04","凱基-五股",11,0,11
"16062","2727王品","110/08/04","新光-桃園",9,42,-33
"16063","2727王品","110/08/04","國泰-館前",16,6,10
"16064","2727王品","110/08/04","凱基-興隆",1,21,-20
"16065","2727王品","110/08/04","凱基-基隆",10,0,10
"16066","2727王品","110/08/04","元大-龍潭",6,23,-17
"16067","2727王品","110/08/04","凱基-南崁",10,0,10
"16068","2727王品","110/08/04","日盛-士林",0,15,-15
"16069","2727王品","110/08/04","富邦-台北",12,2,10
"16070","2727王品","110/08/04","凱基-天母",0,15,-15
"16071","2727王品","110/08/04","新光",34,25,9
"16072","2727王品","110/08/04","日盛-台中",4,15,-11
"16073","2727王品","110/08/04","玉山證券",12,3,9
"16074","2727王品","110/08/04","永豐金-信義",1,12,-11
"16075","2727王品","110/08/04","國泰-高雄",10,2,8
"16076","2727王品","110/08/04","新加坡商瑞銀",2,12,-10
"16077","2727王品","110/08/04","群益金鼎-宜蘭",8,0,8
"16078","2727王品","110/08/04","元大-豐原",0,10,-10
"16079","2727王品","110/08/04","國泰-台南",7,0,7
"16080","2727王品","110/08/04","元大-樹林",1,11,-10
"16081","1570力肯","110/08/04","摩根大通",330,27,303
"16082","1570力肯","110/08/04","元大-板橋",0,86,-86
"16083","1570力肯","110/08/04","統一",224,0,224
"16084","1570力肯","110/08/04","群益金鼎-忠孝",0,80,-80
"16085","1570力肯","110/08/04","富邦-台中",84,1,83
"16086","1570力肯","110/08/04","元富-緯城",0,51,-51
"16087","1570力肯","110/08/04","統一-土城",287,222,65
"16088","1570力肯","110/08/04","國票-和平",0,51,-51
"16089","1570力肯","110/08/04","群益金鼎-中壢",60,0,60
"16090","1570力肯","110/08/04","日盛-二林",0,43,-43
"16091","1570力肯","110/08/04","富邦-高雄",69,10,59
"16092","1570力肯","110/08/04","國泰-板橋",0,43,-43
"16093","1570力肯","110/08/04","統一-屏東",61,4,57
"16094","1570力肯","110/08/04","元大-新莊",1,44,-43
"16095","1570力肯","110/08/04","凱基-岡山",53,1,52
"16096","1570力肯","110/08/04","凱基-嘉義",0,42,-42
"16097","1570力肯","110/08/04","新光-台中",43,12,31
"16098","1570力肯","110/08/04","華南永昌-鳳山",2,42,-40
"16099","1570力肯","110/08/04","台中銀-員林",30,1,29
"16100","1570力肯","110/08/04","凱基-三峽",0,37,-37
"16101","1570力肯","110/08/04","元富-三重",37,12,25
"16102","1570力肯","110/08/04","國票-中正",0,36,-36
"16103","1570力肯","110/08/04","統一-新台中",30,6,24
"16104","1570力肯","110/08/04","高橋",0,30,-30
"16105","1570力肯","110/08/04","致和-府前",25,1,24
"16106","1570力肯","110/08/04","日盛-高雄",0,29,-29
"16107","1570力肯","110/08/04","凱基-中港",22,0,22
"16108","1570力肯","110/08/04","(牛牛牛)亞-鑫豐",6,29,-23
"16109","1570力肯","110/08/04","宏遠證券",20,0,20
"16110","1570力肯","110/08/04","元富-松德",1,22,-21
"16111","6180橘子","110/08/04","新光",67,10,57
"16112","6180橘子","110/08/04","群益金鼎-桃園",0,30,-30
"16113","6180橘子","110/08/04","美林",15,0,15
"16114","6180橘子","110/08/04","華南永昌-苑裡",0,30,-30
"16115","6180橘子","110/08/04","第一金-中山",15,1,14
"16116","6180橘子","110/08/04","台灣摩根士丹利",0,19,-19
"16117","6180橘子","110/08/04","日盛-台中",10,0,10
"16118","6180橘子","110/08/04","台新-三民",0,16,-16
"16119","6180橘子","110/08/04","新光-桃園",10,0,10
"16120","6180橘子","110/08/04","群益金鼎-士林",0,13,-13
"16121","6180橘子","110/08/04","康和",9,0,9
"16122","6180橘子","110/08/04","群益金鼎-中港",0,11,-11
"16123","6180橘子","110/08/04","富邦-羅東",8,0,8
"16124","6180橘子","110/08/04","新加坡商瑞銀",0,10,-10
"16125","6180橘子","110/08/04","國票-九鼎",7,0,7
"16126","6180橘子","110/08/04","統一-彰化",0,10,-10
"16127","6180橘子","110/08/04","玉山-桃園",7,0,7
"16128","6180橘子","110/08/04","兆豐-埔墘",0,10,-10
"16129","6180橘子","110/08/04","元大-員林中山",7,0,7
"16130","6180橘子","110/08/04","摩根大通",3,13,-10
"16131","6180橘子","110/08/04","瑞士信貸",6,0,6
"16132","6180橘子","110/08/04","康和-延平",0,10,-10
"16133","6180橘子","110/08/04","富邦-新竹",7,1,6
"16134","6180橘子","110/08/04","大昌-安康",0,9,-9
"16135","6180橘子","110/08/04","富邦-宜蘭",6,0,6
"16136","6180橘子","110/08/04","富邦-仁愛",1,10,-9
"16137","6180橘子","110/08/04","統一-嘉義",5,0,5
"16138","6180橘子","110/08/04","花旗環球",0,8,-8
"16139","6180橘子","110/08/04","富邦-陽明",5,0,5
"16140","6180橘子","110/08/04","福勝",0,8,-8
"16141","2390云辰","110/08/04","元富-吉利",71,6,65
"16142","2390云辰","110/08/04","港商野村",180,422,-242
"16143","2390云辰","110/08/04","兆豐-新營",53,4,49
"16144","2390云辰","110/08/04","凱基-台北",75,264,-189
"16145","2390云辰","110/08/04","台新證券",83,37,46
"16146","2390云辰","110/08/04","美林",32,132,-100
"16147","2390云辰","110/08/04","日盛-新莊",53,12,41
"16148","2390云辰","110/08/04","華南永昌-鳳山",82,181,-99
"16149","2390云辰","110/08/04","兆豐-岡山",40,0,40
"16150","2390云辰","110/08/04","日盛-園區",1,91,-90
"16151","2390云辰","110/08/04","元大-新莊",42,6,36
"16152","2390云辰","110/08/04","統一-城中",3,82,-79
"16153","2390云辰","110/08/04","永豐金-鳳山",37,3,34
"16154","2390云辰","110/08/04","第一金-中壢",0,73,-73
"16155","2390云辰","110/08/04","德信-新營",37,4,33
"16156","2390云辰","110/08/04","元大-忠孝",8,74,-66
"16157","2390云辰","110/08/04","群益金鼎-三民",35,2,33
"16158","2390云辰","110/08/04","凱基-竹科",6,67,-61
"16159","2390云辰","110/08/04","玉山-雙和",39,7,32
"16160","2390云辰","110/08/04","統一-屏東",0,51,-51
"16161","2390云辰","110/08/04","凱基-三重",33,3,30
"16162","2390云辰","110/08/04","富邦-新店",2,50,-48
"16163","2390云辰","110/08/04","華南永昌-朴子",35,6,29
"16164","2390云辰","110/08/04","元富-大裕",21,56,-35
"16165","2390云辰","110/08/04","國票-和平",29,1,28
"16166","2390云辰","110/08/04","永豐金-三重",6,41,-35
"16167","2390云辰","110/08/04","元大-東蘆",31,3,28
"16168","2390云辰","110/08/04","臺銀",15,47,-32
"16169","2390云辰","110/08/04","日茂",59,33,26
"16170","2390云辰","110/08/04","凱基-台中",1,33,-32
"16171","1471首利","110/08/02","日盛-和美",31,0,31
"16172","1471首利","110/08/02","日盛-八德",0,63,-63
"16173","1471首利","110/08/02","宏遠-光隆",30,0,30
"16174","1471首利","110/08/02","凱基-幸福",0,49,-49
"16175","1471首利","110/08/02","元富-花蓮",25,0,25
"16176","1471首利","110/08/02","富邦-台北",0,30,-30
"16177","1471首利","110/08/02","凱基-台北",25,0,25
"16178","1471首利","110/08/02","元大-東蘆",0,30,-30
"16179","1471首利","110/08/02","日盛-木柵",20,0,20
"16180","1471首利","110/08/02","合庫-桃園",0,20,-20
"16181","1471首利","110/08/02","凱基-高美館",20,0,20
"16182","1471首利","110/08/02","康和-澎湖",0,15,-15
"16183","1471首利","110/08/02","新光-台中",24,5,19
"16184","1471首利","110/08/02","元大-斗信",0,15,-15
"16185","1471首利","110/08/02","富邦-羅東",15,0,15
"16186","1471首利","110/08/02","元富-民權",0,12,-12
"16187","1471首利","110/08/02","兆豐-鹿港",14,0,14
"16188","1471首利","110/08/02","玉山-新莊",0,12,-12
"16189","1471首利","110/08/02","美林",16,4,12
"16190","1471首利","110/08/02","宏遠-桃園",0,10,-10
"16191","1471首利","110/08/02","統一-桃園",12,0,12
"16192","1471首利","110/08/02","瑞士信貸",0,10,-10
"16193","1471首利","110/08/02","合庫-高雄",10,0,10
"16194","1471首利","110/08/02","大慶-苗栗",0,10,-10
"16195","1471首利","110/08/02","日盛-士林",10,0,10
"16196","1471首利","110/08/02","統一-新營",0,10,-10
"16197","1471首利","110/08/02","港商法國興業",10,0,10
"16198","1471首利","110/08/02","群益金鼎-三重",0,10,-10
"16199","1471首利","110/08/02","第一金-台南",10,0,10
"16200","1471首利","110/08/02","元大-基隆",0,10,-10
"16201","2883開發金","110/08/02","統一",3076,29,3047
"16202","2883開發金","110/08/02","中農",2,3126,-3124
"16203","2883開發金","110/08/02","凱基-台北",2789,192,2597
"16204","2883開發金","110/08/02","群益金鼎",11,2008,-1997
"16205","2883開發金","110/08/02","元富-城東",2139,5,2134
"16206","2883開發金","110/08/02","摩根大通",2081,3944,-1863
"16207","2883開發金","110/08/02","瑞士信貸",2184,316,1868
"16208","2883開發金","110/08/02","港商野村",949,2553,-1604
"16209","2883開發金","110/08/02","美林",1160,271,889
"16210","2883開發金","110/08/02","台灣匯立證券",198,1533,-1335
"16211","2883開發金","110/08/02","港商麥格理",855,0,855
"16212","2883開發金","110/08/02","中國信託",69,1041,-972
"16213","2883開發金","110/08/02","元大-金華",533,33,500
"16214","2883開發金","110/08/02","兆豐證券",1,863,-862
"16215","2883開發金","110/08/02","新加坡商瑞銀",1089,624,465
"16216","2883開發金","110/08/02","美商高盛",6,644,-638
"16217","2883開發金","110/08/02","法銀巴黎",441,0,441
"16218","2883開發金","110/08/02","華南永昌-中正",4,632,-628
"16219","2883開發金","110/08/02","富邦-嘉義",425,24,401
"16220","2883開發金","110/08/02","第一金-安和",156,757,-601
"16221","2883開發金","110/08/02","元富-烏日",367,3,364
"16222","2883開發金","110/08/02","國票",0,524,-524
"16223","2883開發金","110/08/02","台灣摩根士丹利",634,280,354
"16224","2883開發金","110/08/02","元富",266,770,-504
"16225","2883開發金","110/08/02","國泰-館前",516,180,336
"16226","2883開發金","110/08/02","新光",1651,1984,-333
"16227","2883開發金","110/08/02","聯邦-敦化",321,5,316
"16228","2883開發金","110/08/02","元富-安南",20,324,-304
"16229","2883開發金","110/08/02","玉山-士林",307,13,294
"16230","2883開發金","110/08/02","群益金鼎-東門",6,280,-274
"16231","6205詮欣","110/08/02","元大-館前",16,0,16
"16232","6205詮欣","110/08/02","永豐金-敦南",0,21,-21
"16233","6205詮欣","110/08/02","臺銀",11,0,11
"16234","6205詮欣","110/08/02","日盛-三重",0,17,-17
"16235","6205詮欣","110/08/02","臺銀-民權",10,0,10
"16236","6205詮欣","110/08/02","永豐金-博愛",0,10,-10
"16237","6205詮欣","110/08/02","摩根大通",11,1,10
"16238","6205詮欣","110/08/02","國票-台南",0,5,-5
"16239","6205詮欣","110/08/02","合庫-三重",5,0,5
"16240","6205詮欣","110/08/02","群益金鼎-三重",0,4,-4
"16241","6205詮欣","110/08/02","元大-東蘆",5,0,5
"16242","6205詮欣","110/08/02","元大-土城",0,4,-4
"16243","6205詮欣","110/08/02","凱基",3,0,3
"16244","6205詮欣","110/08/02","元大-草屯",0,4,-4
"16245","6205詮欣","110/08/02","日盛-雙和",2,0,2
"16246","6205詮欣","110/08/02","臺銀-新竹",1,4,-3
"16247","6205詮欣","110/08/02","兆豐-南京",2,0,2
"16248","6205詮欣","110/08/02","光和-嘉義",0,3,-3
"16249","6205詮欣","110/08/02","凱基-台北",3,1,2
"16250","6205詮欣","110/08/02","永豐金-內湖",0,3,-3
"16251","6205詮欣","110/08/02","元大-西螺",2,0,2
"16252","6205詮欣","110/08/02","第一金-華江",0,2,-2
"16253","6205詮欣","110/08/02","元大-新竹經國",2,0,2
"16254","6205詮欣","110/08/02","中國信託-高雄",0,2,-2
"16255","6205詮欣","110/08/02","元大-北成功",2,0,2
"16256","6205詮欣","110/08/02","兆豐-鹿港",0,2,-2
"16257","6205詮欣","110/08/02","臺銀-臺中",1,0,1
"16258","6205詮欣","110/08/02","統一-平鎮",0,1,-1
"16259","6205詮欣","110/08/02","德信-新營",1,0,1
"16260","6205詮欣","110/08/02","台新-台中",0,1,-1
"16261","1540喬福","110/08/02","富邦-南屯",10,0,10
"16262","1540喬福","110/08/02","永豐金-埔里",0,22,-22
"16263","1540喬福","110/08/02","元富-中原",10,2,8
"16264","1540喬福","110/08/02","統一-新台中",0,17,-17
"16265","1540喬福","110/08/02","德信-新營",6,0,6
"16266","1540喬福","110/08/02","統一-三多",0,3,-3
"16267","1540喬福","110/08/02","元大-龍潭",3,0,3
"16268","1540喬福","110/08/02","光和-高雄",0,2,-2
"16269","1540喬福","110/08/02","凱基-台北",3,0,3
"16270","1540喬福","110/08/02","兆豐-嘉義",0,2,-2
"16271","1540喬福","110/08/02","新光-桃園",3,0,3
"16272","1540喬福","110/08/02","台新-高雄",0,1,-1
"16273","1540喬福","110/08/02","永豐金-內湖",2,0,2
"16274","1540喬福","110/08/02","新光",0,1,-1
"16275","1540喬福","110/08/02","港商法國興業",2,0,2
"16276","1540喬福","110/08/02","國泰-館前",0,1,-1
"16277","1540喬福","110/08/02","統一-台南",2,0,2
"16278","1540喬福","110/08/02","群益金鼎-民權",0,1,-1
"16279","1540喬福","110/08/02","元富-桃園",2,0,2
"16280","1540喬福","110/08/02","富邦-嘉義",0,1,-1
"16281","1540喬福","110/08/02","台中銀-豐原",2,0,2
"16282","1540喬福","110/08/02","元大-新竹",0,1,-1
"16283","1540喬福","110/08/02","(牛牛牛)亞-網路",1,0,1
"16284","1540喬福","110/08/02","元大-豐原站前",0,1,-1
"16285","1540喬福","110/08/02","元富",1,0,1
"16286","1540喬福","110/08/02","臺銀-鳳山",0,0,0
"16287","1540喬福","110/08/02","第一金-桃園",1,0,1
"16288","1540喬福","110/08/02","第一金",0,0,0
"16289","1540喬福","110/08/02","瑞士信貸",1,0,1
"16290","1540喬福","110/08/02","華南永昌-南京",0,0,0
"16291","2888新光金","110/08/02","花旗環球",2291,0,2291
"16292","2888新光金","110/08/02","瑞士信貸",1405,3997,-2592
"16293","2888新光金","110/08/02","美林",2235,208,2027
"16294","2888新光金","110/08/02","新加坡商瑞銀",780,2173,-1393
"16295","2888新光金","110/08/02","群益金鼎-彰化",1014,2,1012
"16296","2888新光金","110/08/02","美商高盛",369,1356,-987
"16297","2888新光金","110/08/02","富邦-建國",823,9,814
"16298","2888新光金","110/08/02","元大-仁愛",69,795,-726
"16299","2888新光金","110/08/02","元大-華山",532,1,531
"16300","2888新光金","110/08/02","永興-台中",0,500,-500
"16301","2888新光金","110/08/02","法銀巴黎",666,166,500
"16302","2888新光金","110/08/02","凱基-站前",17,506,-489
"16303","2888新光金","110/08/02","台灣匯立證券",421,0,421
"16304","2888新光金","110/08/02","元富-城東",38,496,-458
"16305","2888新光金","110/08/02","凱基-台南",376,17,359
"16306","2888新光金","110/08/02","群益金鼎-中港",2,450,-448
"16307","2888新光金","110/08/02","永豐金-嘉義",352,0,352
"16308","2888新光金","110/08/02","華南永昌",25,461,-436
"16309","2888新光金","110/08/02","合庫-台中",339,1,338
"16310","2888新光金","110/08/02","港商野村",135,550,-415
"16311","2888新光金","110/08/02","港商麥格理",316,0,316
"16312","2888新光金","110/08/02","大慶-苗栗",1,406,-405
"16313","2888新光金","110/08/02","群益金鼎-建成",298,5,293
"16314","2888新光金","110/08/02","華南永昌-中正",34,419,-385
"16315","2888新光金","110/08/02","永豐金-板盛",221,0,221
"16316","2888新光金","110/08/02","玉山-台大",0,350,-350
"16317","2888新光金","110/08/02","台灣摩根士丹利",1700,1488,212
"16318","2888新光金","110/08/02","元大-汐止",66,363,-297
"16319","2888新光金","110/08/02","凱基-竹北",200,0,200
"16320","2888新光金","110/08/02","台新-新莊",14,265,-251
"16321","1340勝悅","110/08/02","國泰-台中",22,0,22
"16322","1340勝悅","110/08/02","中國信託",0,83,-83
"16323","1340勝悅","110/08/02","港商法國興業",14,0,14
"16324","1340勝悅","110/08/02","元大-開元",0,11,-11
"16325","1340勝悅","110/08/02","新光",18,5,13
"16326","1340勝悅","110/08/02","凱基-永康",0,10,-10
"16327","1340勝悅","110/08/02","元大-基隆孝二",11,0,11
"16328","1340勝悅","110/08/02","富邦-宜蘭",0,10,-10
"16329","1340勝悅","110/08/02","玉山-士林",10,0,10
"16330","1340勝悅","110/08/02","元大-大統",0,10,-10
"16331","1340勝悅","110/08/02","凱基",6,0,6
"16332","1340勝悅","110/08/02","富邦-板橋",0,5,-5
"16333","1340勝悅","110/08/02","摩根大通",4,0,4
"16334","1340勝悅","110/08/02","瑞士信貸",1,5,-4
"16335","1340勝悅","110/08/02","國泰-敦南",8,4,4
"16336","1340勝悅","110/08/02","華南永昌-忠孝",0,2,-2
"16337","1340勝悅","110/08/02","國泰-新莊",3,0,3
"16338","1340勝悅","110/08/02","元大-虎尾",0,2,-2
"16339","1340勝悅","110/08/02","凱基-嘉義",3,0,3
"16340","1340勝悅","110/08/02","元大-路竹",0,2,-2
"16341","1340勝悅","110/08/02","群益金鼎-館前",3,0,3
"16342","1340勝悅","110/08/02","元大-信義",0,2,-2
"16343","1340勝悅","110/08/02","國泰-館前",3,0,3
"16344","1340勝悅","110/08/02","華南永昌-高雄",0,1,-1
"16345","1340勝悅","110/08/02","臺銀-鳳山",3,0,3
"16346","1340勝悅","110/08/02","玉山-大里",0,0,0
"16347","1340勝悅","110/08/02","國泰-高雄",4,1,3
"16348","1340勝悅","110/08/02","群益金鼎-丹鳳",0,0,0
"16349","1340勝悅","110/08/02","美商高盛",3,0,3
"16350","1340勝悅","110/08/02","富邦-虎尾",0,0,0
"16351","6246臺龍","110/08/02","台新證券",19,1,18
"16352","6246臺龍","110/08/02","元大-新竹經國",0,6,-6
"16353","6246臺龍","110/08/02","凱基-台北",7,2,5
"16354","6246臺龍","110/08/02","台新-台南",0,5,-5
"16355","6246臺龍","110/08/02","國票-九鼎",3,0,3
"16356","6246臺龍","110/08/02","宏遠-新化",1,4,-3
"16357","6246臺龍","110/08/02","國票-南京",3,0,3
"16358","6246臺龍","110/08/02","元富-板橋",0,3,-3
"16359","6246臺龍","110/08/02","新光-台中",3,0,3
"16360","6246臺龍","110/08/02","國泰-敦南",0,3,-3
"16361","6246臺龍","110/08/02","元大-員林",3,0,3
"16362","6246臺龍","110/08/02","富邦-台中",0,3,-3
"16363","6246臺龍","110/08/02","元大-永和",3,0,3
"16364","6246臺龍","110/08/02","元大-大益",2,5,-3
"16365","6246臺龍","110/08/02","港商野村",2,0,2
"16366","6246臺龍","110/08/02","日盛-永康",0,2,-2
"16367","6246臺龍","110/08/02","台新-高雄",2,0,2
"16368","6246臺龍","110/08/02","日盛-宜蘭",0,2,-2
"16369","6246臺龍","110/08/02","新光-台南",2,0,2
"16370","6246臺龍","110/08/02","宏遠-台南",0,2,-2
"16371","6246臺龍","110/08/02","日盛-文化",1,0,1
"16372","6246臺龍","110/08/02","高橋-龍潭",0,2,-2
"16373","6246臺龍","110/08/02","國泰-忠孝",1,0,1
"16374","6246臺龍","110/08/02","群益金鼎-中壢",0,2,-2
"16375","6246臺龍","110/08/02","群益金鼎-崇德",3,2,1
"16376","6246臺龍","110/08/02","凱基-三多",0,2,-2
"16377","6246臺龍","110/08/02","富邦-員林",1,0,1
"16378","6246臺龍","110/08/02","統一-中壢",0,1,-1
"16379","6246臺龍","110/08/02","富邦-三重",1,0,1
"16380","6246臺龍","110/08/02","中國信託-嘉義",0,1,-1
"16381","00715L期街口布蘭特正2","110/08/02","元大證券",7296,1000,6296
"16382","00715L期街口布蘭特正2","110/08/02","富邦-基隆",0,850,-850
"16383","00715L期街口布蘭特正2","110/08/02","永豐金證券",2221,338,1883
"16384","00715L期街口布蘭特正2","110/08/02","(牛牛牛)亞-鑫豐",10,850,-840
"16385","00715L期街口布蘭特正2","110/08/02","統一",1460,100,1360
"16386","00715L期街口布蘭特正2","110/08/02","華南永昌-長虹",57,820,-763
"16387","00715L期街口布蘭特正2","110/08/02","國票-中港",1000,0,1000
"16388","00715L期街口布蘭特正2","110/08/02","富邦-彰化",0,700,-700
"16389","00715L期街口布蘭特正2","110/08/02","第一金-台中",900,13,887
"16390","00715L期街口布蘭特正2","110/08/02","第一金-路竹",0,682,-682
"16391","00715L期街口布蘭特正2","110/08/02","群益金鼎",728,0,728
"16392","00715L期街口布蘭特正2","110/08/02","台新證券",112,791,-679
"16393","00715L期街口布蘭特正2","110/08/02","群益金鼎-古亭",433,1,432
"16394","00715L期街口布蘭特正2","110/08/02","第一金-忠孝",45,483,-438
"16395","00715L期街口布蘭特正2","110/08/02","凱基-市政",525,125,400
"16396","00715L期街口布蘭特正2","110/08/02","玉山-台南",0,373,-373
"16397","00715L期街口布蘭特正2","110/08/02","元大-敦化",400,0,400
"16398","00715L期街口布蘭特正2","110/08/02","國泰-板橋",3,313,-310
"16399","00715L期街口布蘭特正2","110/08/02","元大-草屯",353,21,332
"16400","00715L期街口布蘭特正2","110/08/02","凱基",0,300,-300
"16401","00715L期街口布蘭特正2","110/08/02","元大-萬華",250,0,250
"16402","00715L期街口布蘭特正2","110/08/02","元大-嘉義",1,300,-299
"16403","00715L期街口布蘭特正2","110/08/02","統一-員林",180,0,180
"16404","00715L期街口布蘭特正2","110/08/02","元大-大灣",14,303,-289
"16405","00715L期街口布蘭特正2","110/08/02","富邦證券",282,152,130
"16406","00715L期街口布蘭特正2","110/08/02","新光-桃園",45,295,-250
"16407","00715L期街口布蘭特正2","110/08/02","元富-潮州",125,0,125
"16408","00715L期街口布蘭特正2","110/08/02","元大-新莊",76,306,-230
"16409","00715L期街口布蘭特正2","110/08/02","兆豐-台中港",106,0,106
"16410","00715L期街口布蘭特正2","110/08/02","富邦-台北",0,211,-211
"16411","8941關中","110/08/02","宏遠-館前",3,0,3
"16412","8941關中","110/08/02","富邦-台中",0,5,-5
"16413","8941關中","110/08/02","群益金鼎-彰化",2,0,2
"16414","8941關中","110/08/02","富邦-員林",0,4,-4
"16415","8941關中","110/08/02","第一金-台中",1,0,1
"16416","8941關中","110/08/02","元大-新竹經國",0,0,0
"16417","8941關中","110/08/02","台新-台中",1,0,1
"16418","8941關中","110/08/02","永豐金-萬盛",0,0,0
"16419","8941關中","110/08/02","華南永昌-南京",1,0,1
"16420","8941關中","110/08/02","",NA,NA,NA
"16421","8941關中","110/08/02","元大-桃興",2,1,1
"16422","8941關中","110/08/02","",NA,NA,NA
"16423","8941關中","110/08/02","元大-新竹經國",0,0,0
"16424","8941關中","110/08/02","",NA,NA,NA
"16425","8941關中","110/08/02","永豐金-萬盛",0,0,0
"16426","8941關中","110/08/02","",NA,NA,NA
"16427","8941關中","110/08/02","",NA,NA,NA
"16428","8941關中","110/08/02","",NA,NA,NA
"16429","8941關中","110/08/02","",NA,NA,NA
"16430","8941關中","110/08/02","",NA,NA,NA
"16431","8941關中","110/08/02","",NA,NA,NA
"16432","8941關中","110/08/02","",NA,NA,NA
"16433","8941關中","110/08/02","",NA,NA,NA
"16434","8941關中","110/08/02","",NA,NA,NA
"16435","8941關中","110/08/02","",NA,NA,NA
"16436","8941關中","110/08/02","",NA,NA,NA
"16437","8941關中","110/08/02","",NA,NA,NA
"16438","8941關中","110/08/02","",NA,NA,NA
"16439","8941關中","110/08/02","",NA,NA,NA
"16440","8941關中","110/08/02","",NA,NA,NA
"16441","8936國統","110/08/02","合庫-高雄",68,0,68
"16442","8936國統","110/08/02","凱基-台北",0,125,-125
"16443","8936國統","110/08/02","元大-蘆洲",33,0,33
"16444","8936國統","110/08/02","摩根大通",9,125,-116
"16445","8936國統","110/08/02","富邦-高雄",30,4,26
"16446","8936國統","110/08/02","永全-南崁",0,50,-50
"16447","8936國統","110/08/02","大慶-蘆洲",20,0,20
"16448","8936國統","110/08/02","新光-台中",16,55,-39
"16449","8936國統","110/08/02","兆豐-桃鶯",20,0,20
"16450","8936國統","110/08/02","凱基-市政",0,31,-31
"16451","8936國統","110/08/02","元大-東泰",20,0,20
"16452","8936國統","110/08/02","美商高盛",1,20,-19
"16453","8936國統","110/08/02","永豐金-忠孝",20,0,20
"16454","8936國統","110/08/02","元大-東港",3,20,-17
"16455","8936國統","110/08/02","元大-旗山",15,0,15
"16456","8936國統","110/08/02","台灣企銀-台中",0,15,-15
"16457","8936國統","110/08/02","中國信託-文心",12,0,12
"16458","8936國統","110/08/02","日盛-竹北",0,15,-15
"16459","8936國統","110/08/02","國泰-敦南",14,2,12
"16460","8936國統","110/08/02","瑞士信貸",0,11,-11
"16461","8936國統","110/08/02","元大-敦南",12,0,12
"16462","8936國統","110/08/02","港商野村",26,36,-10
"16463","8936國統","110/08/02","日盛-三峽",11,0,11
"16464","8936國統","110/08/02","統一-竹南",0,10,-10
"16465","8936國統","110/08/02","永豐金-苓雅",11,0,11
"16466","8936國統","110/08/02","國泰-高雄",1,11,-10
"16467","8936國統","110/08/02","宏遠-高雄",11,1,10
"16468","8936國統","110/08/02","元大-天母",0,9,-9
"16469","8936國統","110/08/02","第一金-嘉義",10,0,10
"16470","8936國統","110/08/02","元大-台中中港",0,9,-9
"16471","6226光鼎","110/08/02","新百王",283,0,283
"16472","6226光鼎","110/08/02","元富-安南",3,113,-110
"16473","6226光鼎","110/08/02","日盛-文化",219,3,216
"16474","6226光鼎","110/08/02","群益金鼎-東大",24,124,-100
"16475","6226光鼎","110/08/02","元大-嘉義",127,37,90
"16476","6226光鼎","110/08/02","富邦-南屯",3,100,-97
"16477","6226光鼎","110/08/02","統一-新竹",113,31,82
"16478","6226光鼎","110/08/02","元大-鳳中",2,99,-97
"16479","6226光鼎","110/08/02","台中銀-員林",111,47,64
"16480","6226光鼎","110/08/02","元大-忠孝鼎富",10,100,-90
"16481","6226光鼎","110/08/02","永豐金證券",66,5,61
"16482","6226光鼎","110/08/02","華南永昌-小港",0,84,-84
"16483","6226光鼎","110/08/02","日盛-員林",107,50,57
"16484","6226光鼎","110/08/02","國泰-敦南",247,324,-77
"16485","6226光鼎","110/08/02","國票-九鼎",72,24,48
"16486","6226光鼎","110/08/02","亞東",5,76,-71
"16487","6226光鼎","110/08/02","元大-士林",53,6,47
"16488","6226光鼎","110/08/02","中國信託-新竹",2,62,-60
"16489","6226光鼎","110/08/02","元大-鹿港",48,7,41
"16490","6226光鼎","110/08/02","元大-南屯",12,64,-52
"16491","6226光鼎","110/08/02","中國信託-文心",48,8,40
"16492","6226光鼎","110/08/02","元大-高雄",9,61,-52
"16493","6226光鼎","110/08/02","國泰-新莊",56,17,39
"16494","6226光鼎","110/08/02","元大-台北",2,53,-51
"16495","6226光鼎","110/08/02","元大-大同",39,0,39
"16496","6226光鼎","110/08/02","第一金-華江",8,52,-44
"16497","6226光鼎","110/08/02","富邦-建國",39,1,38
"16498","6226光鼎","110/08/02","元富-新莊",3,44,-41
"16499","6226光鼎","110/08/02","統一-三重",54,18,36
"16500","6226光鼎","110/08/02","玉山-桃園",3,40,-37
"16501","2363矽統","110/08/02","中國信託-忠孝",405,25,380
"16502","2363矽統","110/08/02","富邦證券",16,4082,-4066
"16503","2363矽統","110/08/02","群益金鼎-屏東",349,123,226
"16504","2363矽統","110/08/02","凱基-台北",2669,4466,-1797
"16505","2363矽統","110/08/02","群益金鼎-永和",233,20,213
"16506","2363矽統","110/08/02","台灣摩根士丹利",69,1749,-1680
"16507","2363矽統","110/08/02","富邦-中壢",299,91,208
"16508","2363矽統","110/08/02","新加坡商瑞銀",361,1486,-1125
"16509","2363矽統","110/08/02","永豐金-彰化",188,4,184
"16510","2363矽統","110/08/02","港商野村",619,1622,-1003
"16511","2363矽統","110/08/02","元大-承德",253,73,180
"16512","2363矽統","110/08/02","美商高盛",214,1077,-863
"16513","2363矽統","110/08/02","康和-台中",192,23,169
"16514","2363矽統","110/08/02","兆豐-復興",124,973,-849
"16515","2363矽統","110/08/02","新光",550,382,168
"16516","2363矽統","110/08/02","統一-仁愛",132,666,-534
"16517","2363矽統","110/08/02","元大-萬華",224,61,163
"16518","2363矽統","110/08/02","美林",520,1028,-508
"16519","2363矽統","110/08/02","元大-博愛",204,44,160
"16520","2363矽統","110/08/02","統一-土城",32,536,-504
"16521","2363矽統","110/08/02","兆豐-三民",171,17,154
"16522","2363矽統","110/08/02","華南永昌-斗六",33,526,-493
"16523","2363矽統","110/08/02","元大-新竹",196,44,152
"16524","2363矽統","110/08/02","統一-敦南",35,527,-492
"16525","2363矽統","110/08/02","凱基-三重",178,29,149
"16526","2363矽統","110/08/02","永豐金-員林",12,495,-483
"16527","2363矽統","110/08/02","元大-忠孝",181,38,143
"16528","2363矽統","110/08/02","統一-城中",117,589,-472
"16529","2363矽統","110/08/02","元富-世貿",142,4,138
"16530","2363矽統","110/08/02","摩根大通",1070,1471,-401
"16531","8112至上","110/08/02","合庫證券",213,0,213
"16532","8112至上","110/08/02","台灣摩根士丹利",9,287,-278
"16533","8112至上","110/08/02","凱基-台北",298,152,146
"16534","8112至上","110/08/02","凱基-三重",3,236,-233
"16535","8112至上","110/08/02","大慶",87,0,87
"16536","8112至上","110/08/02","臺銀-鳳山",11,124,-113
"16537","8112至上","110/08/02","凱基-新店",84,0,84
"16538","8112至上","110/08/02","合庫-台中",1,112,-111
"16539","8112至上","110/08/02","香港上海匯豐",76,0,76
"16540","8112至上","110/08/02","土銀-嘉義",0,105,-105
"16541","8112至上","110/08/02","群益金鼎-建成",65,1,64
"16542","8112至上","110/08/02","元大-新莊",2,106,-104
"16543","8112至上","110/08/02","玉山-板橋",63,0,63
"16544","8112至上","110/08/02","台新-建北",0,95,-95
"16545","8112至上","110/08/02","元大-前金",61,2,59
"16546","8112至上","110/08/02","華南永昌-彰化",2,64,-62
"16547","8112至上","110/08/02","台新-台中",58,5,53
"16548","8112至上","110/08/02","群益金鼎-北高雄",3,50,-47
"16549","8112至上","110/08/02","亞東",51,0,51
"16550","8112至上","110/08/02","元大-福營",1,45,-44
"16551","8112至上","110/08/02","美林",49,1,48
"16552","8112至上","110/08/02","永豐金-南京",2,38,-36
"16553","8112至上","110/08/02","摩根大通",114,67,47
"16554","8112至上","110/08/02","亞東-板橋",2,34,-32
"16555","8112至上","110/08/02","美商高盛",46,0,46
"16556","8112至上","110/08/02","元大-台南",2,33,-31
"16557","8112至上","110/08/02","凱基-松山",43,1,42
"16558","8112至上","110/08/02","統一-城中",0,30,-30
"16559","8112至上","110/08/02","群益金鼎-大安",40,0,40
"16560","8112至上","110/08/02","元富-板橋",5,35,-30
"16561","1570力肯","110/08/02","群益金鼎-高雄",11,0,11
"16562","1570力肯","110/08/02","大慶",0,5,-5
"16563","1570力肯","110/08/02","臺銀-臺南",4,0,4
"16564","1570力肯","110/08/02","元大-板橋",0,4,-4
"16565","1570力肯","110/08/02","新光-台中",4,0,4
"16566","1570力肯","110/08/02","玉山證券",0,4,-4
"16567","1570力肯","110/08/02","(牛牛牛)亞-鑫豐",3,0,3
"16568","1570力肯","110/08/02","國泰-台南",0,3,-3
"16569","1570力肯","110/08/02","土銀-白河",2,0,2
"16570","1570力肯","110/08/02","元富-新店",0,3,-3
"16571","1570力肯","110/08/02","統一-松江",2,0,2
"16572","1570力肯","110/08/02","元富-永和",0,2,-2
"16573","1570力肯","110/08/02","中國信託-永康",1,0,1
"16574","1570力肯","110/08/02","凱基-台北",0,2,-2
"16575","1570力肯","110/08/02","凱基-信義",1,0,1
"16576","1570力肯","110/08/02","統一-城中",0,2,-2
"16577","1570力肯","110/08/02","凱基-幸福",1,0,1
"16578","1570力肯","110/08/02","新光",0,1,-1
"16579","1570力肯","110/08/02","元大-歸仁",1,0,1
"16580","1570力肯","110/08/02","凱基-岡山",0,1,-1
"16581","1570力肯","110/08/02","合庫-台中",0,0,0
"16582","1570力肯","110/08/02","富邦-台南",0,1,-1
"16583","1570力肯","110/08/02","康和-板橋",0,0,0
"16584","1570力肯","110/08/02","元大-新盛",0,1,-1
"16585","1570力肯","110/08/02","群益金鼎-鳳山",0,0,0
"16586","1570力肯","110/08/02","永豐金-嘉義",0,1,-1
"16587","1570力肯","110/08/02","元大-樹林",0,0,0
"16588","1570力肯","110/08/02","康和-板橋",0,0,0
"16589","1570力肯","110/08/02","",NA,NA,NA
"16590","1570力肯","110/08/02","合庫-台中",0,0,0
"16591","2929淘帝","110/08/02","元大-民生",29,0,29
"16592","2929淘帝","110/08/02","新加坡商瑞銀",4,70,-66
"16593","2929淘帝","110/08/02","兆豐-桃園",20,0,20
"16594","2929淘帝","110/08/02","富邦-建國",0,26,-26
"16595","2929淘帝","110/08/02","新光",14,0,14
"16596","2929淘帝","110/08/02","美林",0,24,-24
"16597","2929淘帝","110/08/02","兆豐-忠孝",13,0,13
"16598","2929淘帝","110/08/02","元大-和平",0,13,-13
"16599","2929淘帝","110/08/02","兆豐-彰化",12,0,12
"16600","2929淘帝","110/08/02","元大-永和",0,10,-10
"16601","2929淘帝","110/08/02","合庫-高雄",10,0,10
"16602","2929淘帝","110/08/02","日盛-頭份",0,9,-9
"16603","2929淘帝","110/08/02","富邦-台北",10,0,10
"16604","2929淘帝","110/08/02","群益金鼎-中山",0,9,-9
"16605","2929淘帝","110/08/02","國泰-敦南",9,0,9
"16606","2929淘帝","110/08/02","華南永昌-頭份",0,7,-7
"16607","2929淘帝","110/08/02","元富-文心",10,2,8
"16608","2929淘帝","110/08/02","永豐金-敦南",0,7,-7
"16609","2929淘帝","110/08/02","台新-台中",7,0,7
"16610","2929淘帝","110/08/02","凱基-台北",5,11,-6
"16611","2929淘帝","110/08/02","元大-文心",6,0,6
"16612","2929淘帝","110/08/02","臺銀-鳳山",0,5,-5
"16613","2929淘帝","110/08/02","日盛-忠孝",5,0,5
"16614","2929淘帝","110/08/02","凱基-城中",0,5,-5
"16615","2929淘帝","110/08/02","第一金-高雄",5,0,5
"16616","2929淘帝","110/08/02","華南永昌-台中",0,5,-5
"16617","2929淘帝","110/08/02","富邦-基隆",6,1,5
"16618","2929淘帝","110/08/02","元大-博愛",0,5,-5
"16619","2929淘帝","110/08/02","富邦-新店",5,0,5
"16620","2929淘帝","110/08/02","元富-緯城",0,4,-4
"16621","5410國眾","110/08/02","新加坡商瑞銀",19,0,19
"16622","5410國眾","110/08/02","日盛-斗六",0,15,-15
"16623","5410國眾","110/08/02","兆豐-城中",18,0,18
"16624","5410國眾","110/08/02","元大-大同",0,15,-15
"16625","5410國眾","110/08/02","日盛-新莊",10,0,10
"16626","5410國眾","110/08/02","元大-博愛",0,10,-10
"16627","5410國眾","110/08/02","元富-佳里",10,0,10
"16628","5410國眾","110/08/02","凱基-台北",0,7,-7
"16629","5410國眾","110/08/02","摩根大通",9,0,9
"16630","5410國眾","110/08/02","臺銀-臺南",0,6,-6
"16631","5410國眾","110/08/02","國泰-桃園",6,0,6
"16632","5410國眾","110/08/02","元富-嘉義",0,6,-6
"16633","5410國眾","110/08/02","元富-新竹",5,0,5
"16634","5410國眾","110/08/02","第一金-中壢",0,5,-5
"16635","5410國眾","110/08/02","元大-復北",5,0,5
"16636","5410國眾","110/08/02","致和證券",0,5,-5
"16637","5410國眾","110/08/02","永豐金-桃園",5,0,5
"16638","5410國眾","110/08/02","群益金鼎-土城",0,5,-5
"16639","5410國眾","110/08/02","安泰-楠梓",4,0,4
"16640","5410國眾","110/08/02","華南永昌-中正",0,5,-5
"16641","5410國眾","110/08/02","台灣企銀-太平",3,0,3
"16642","5410國眾","110/08/02","元大-新莊",0,5,-5
"16643","5410國眾","110/08/02","新光",3,0,3
"16644","5410國眾","110/08/02","土銀-新竹",0,4,-4
"16645","5410國眾","110/08/02","富邦-內湖",3,0,3
"16646","5410國眾","110/08/02","日盛-員林",0,3,-3
"16647","5410國眾","110/08/02","中國信託-新竹",2,0,2
"16648","5410國眾","110/08/02","元大-新竹經國",0,3,-3
"16649","5410國眾","110/08/02","華南永昌-楠梓",2,0,2
"16650","5410國眾","110/08/02","元富-緯城",0,2,-2
"16651","2841台開","110/08/02","富邦-敦南",71,0,71
"16652","2841台開","110/08/02","永豐金-松山",0,91,-91
"16653","2841台開","110/08/02","國泰-館前",38,0,38
"16654","2841台開","110/08/02","元大-蘆洲",0,40,-40
"16655","2841台開","110/08/02","台中銀",19,0,19
"16656","2841台開","110/08/02","凱基-台北",2,33,-31
"16657","2841台開","110/08/02","元富-烏日",18,0,18
"16658","2841台開","110/08/02","兆豐-寶成",0,20,-20
"16659","2841台開","110/08/02","國泰-板橋",15,0,15
"16660","2841台開","110/08/02","華南永昌-民權",0,20,-20
"16661","2841台開","110/08/02","元大-台中",15,0,15
"16662","2841台開","110/08/02","國票-敦北法人",0,18,-18
"16663","2841台開","110/08/02","元大-福營",15,0,15
"16664","2841台開","110/08/02","第一金-路竹",0,17,-17
"16665","2841台開","110/08/02","日盛-花蓮",14,0,14
"16666","2841台開","110/08/02","中國信託-高雄",0,15,-15
"16667","2841台開","110/08/02","新光",12,0,12
"16668","2841台開","110/08/02","日進",0,10,-10
"16669","2841台開","110/08/02","永豐金-敦南",62,51,11
"16670","2841台開","110/08/02","統一-三多",0,10,-10
"16671","2841台開","110/08/02","日盛-台中",10,0,10
"16672","2841台開","110/08/02","元大-路竹",0,10,-10
"16673","2841台開","110/08/02","群益金鼎-崇德",10,0,10
"16674","2841台開","110/08/02","元大-中和",0,10,-10
"16675","2841台開","110/08/02","元大-南海",10,0,10
"16676","2841台開","110/08/02","宏遠-桃園",0,9,-9
"16677","2841台開","110/08/02","國泰-桃園",8,0,8
"16678","2841台開","110/08/02","大昌-新店",0,6,-6
"16679","2841台開","110/08/02","台新-台中",6,0,6
"16680","2841台開","110/08/02","國票-天祥",0,6,-6
"16681","6207雷科","110/08/02","摩根大通",173,19,154
"16682","6207雷科","110/08/02","凱基-高雄",0,50,-50
"16683","6207雷科","110/08/02","凱基-台北",150,10,140
"16684","6207雷科","110/08/02","群益金鼎-東門",0,26,-26
"16685","6207雷科","110/08/02","華南永昌-朴子",55,0,55
"16686","6207雷科","110/08/02","富邦-竹東",0,25,-25
"16687","6207雷科","110/08/02","新加坡商瑞銀",51,5,46
"16688","6207雷科","110/08/02","華南永昌-東勢",3,27,-24
"16689","6207雷科","110/08/02","元大-西門",54,12,42
"16690","6207雷科","110/08/02","富邦-岡山",1,25,-24
"16691","6207雷科","110/08/02","兆豐-景美",42,2,40
"16692","6207雷科","110/08/02","台灣摩根士丹利",0,22,-22
"16693","6207雷科","110/08/02","日盛-忠孝",35,0,35
"16694","6207雷科","110/08/02","國泰-高雄",1,23,-22
"16695","6207雷科","110/08/02","美林",25,0,25
"16696","6207雷科","110/08/02","富邦-建國",0,17,-17
"16697","6207雷科","110/08/02","日盛-北高雄",16,0,16
"16698","6207雷科","110/08/02","元大-上新莊",0,16,-16
"16699","6207雷科","110/08/02","統一-板橋",15,0,15
"16700","6207雷科","110/08/02","中國信託-高雄",0,15,-15
"16701","6207雷科","110/08/02","凱基-市政",15,0,15
"16702","6207雷科","110/08/02","宏遠證券",0,13,-13
"16703","6207雷科","110/08/02","新光-新竹",16,2,14
"16704","6207雷科","110/08/02","凱基-彰化",0,13,-13
"16705","6207雷科","110/08/02","港商野村",23,12,11
"16706","6207雷科","110/08/02","永豐金-內湖",0,13,-13
"16707","6207雷科","110/08/02","統一-南京",11,0,11
"16708","6207雷科","110/08/02","新百王",0,12,-12
"16709","6207雷科","110/08/02","元大-嘉義",11,0,11
"16710","6207雷科","110/08/02","玉山-大里",0,12,-12
"16711","3679新至陞","110/08/02","元大-成功",26,0,26
"16712","3679新至陞","110/08/02","富邦-陽明",1,34,-33
"16713","3679新至陞","110/08/02","元大-樹林",20,0,20
"16714","3679新至陞","110/08/02","富邦-中壢",0,20,-20
"16715","3679新至陞","110/08/02","(牛牛牛)亞-網路",18,0,18
"16716","3679新至陞","110/08/02","凱基-台北",34,48,-14
"16717","3679新至陞","110/08/02","凱基-中山",12,0,12
"16718","3679新至陞","110/08/02","永豐金證券",0,14,-14
"16719","3679新至陞","110/08/02","統一",21,11,10
"16720","3679新至陞","110/08/02","臺銀-臺南",2,14,-12
"16721","3679新至陞","110/08/02","玉山-台大",10,0,10
"16722","3679新至陞","110/08/02","摩根大通",20,32,-12
"16723","3679新至陞","110/08/02","台中銀",8,0,8
"16724","3679新至陞","110/08/02","富邦-嘉義",0,10,-10
"16725","3679新至陞","110/08/02","港商野村",8,2,6
"16726","3679新至陞","110/08/02","國票-北高雄",1,10,-9
"16727","3679新至陞","110/08/02","群益金鼎-丹鳳",6,0,6
"16728","3679新至陞","110/08/02","台新-台中",0,9,-9
"16729","3679新至陞","110/08/02","元大-高雄",6,0,6
"16730","3679新至陞","110/08/02","凱基-宜蘭",0,7,-7
"16731","3679新至陞","110/08/02","新加坡商瑞銀",5,0,5
"16732","3679新至陞","110/08/02","凱基-埔墘",0,7,-7
"16733","3679新至陞","110/08/02","台灣摩根士丹利",13,9,4
"16734","3679新至陞","110/08/02","永豐金-台中",0,7,-7
"16735","3679新至陞","110/08/02","第一金-華江",4,0,4
"16736","3679新至陞","110/08/02","永豐金-潮州",0,7,-7
"16737","3679新至陞","110/08/02","新光",11,7,4
"16738","3679新至陞","110/08/02","凱基-五股",0,6,-6
"16739","3679新至陞","110/08/02","國泰-館前",4,0,4
"16740","3679新至陞","110/08/02","富邦-建國",0,6,-6
"16741","2727王品","110/08/02","摩根大通",38,5,33
"16742","2727王品","110/08/02","台灣摩根士丹利",13,170,-157
"16743","2727王品","110/08/02","日盛-忠孝",33,3,30
"16744","2727王品","110/08/02","華南永昌",7,156,-149
"16745","2727王品","110/08/02","凱基-天母",30,0,30
"16746","2727王品","110/08/02","凱基-台北",37,57,-20
"16747","2727王品","110/08/02","花旗環球",17,0,17
"16748","2727王品","110/08/02","國票-北高雄",1,19,-18
"16749","2727王品","110/08/02","永豐金-竹科",20,5,15
"16750","2727王品","110/08/02","港商野村",39,54,-15
"16751","2727王品","110/08/02","彰銀-台中",16,2,14
"16752","2727王品","110/08/02","元大-四維",1,15,-14
"16753","2727王品","110/08/02","國票-內壢",14,0,14
"16754","2727王品","110/08/02","美林",12,25,-13
"16755","2727王品","110/08/02","新光-台中",17,3,14
"16756","2727王品","110/08/02","瑞士信貸",0,12,-12
"16757","2727王品","110/08/02","永豐金-南京",16,3,13
"16758","2727王品","110/08/02","元大-北成功",0,10,-10
"16759","2727王品","110/08/02","元大-樹林",13,1,12
"16760","2727王品","110/08/02","元大-崇德",0,8,-8
"16761","2727王品","110/08/02","國泰-板橋",17,7,10
"16762","2727王品","110/08/02","永豐金-內湖",3,10,-7
"16763","2727王品","110/08/02","凱基-埔墘",10,0,10
"16764","2727王品","110/08/02","大昌",5,11,-6
"16765","2727王品","110/08/02","元大-豐原",10,0,10
"16766","2727王品","110/08/02","華南永昌-斗六",2,8,-6
"16767","2727王品","110/08/02","元大-桃園",10,0,10
"16768","2727王品","110/08/02","國泰-台中",4,9,-5
"16769","2727王品","110/08/02","凱基-科園",9,0,9
"16770","2727王品","110/08/02","群益金鼎-土城",0,5,-5
"16771","1570力肯","110/08/02","群益金鼎-高雄",11,0,11
"16772","1570力肯","110/08/02","大慶",0,5,-5
"16773","1570力肯","110/08/02","臺銀-臺南",4,0,4
"16774","1570力肯","110/08/02","元大-板橋",0,4,-4
"16775","1570力肯","110/08/02","新光-台中",4,0,4
"16776","1570力肯","110/08/02","玉山證券",0,4,-4
"16777","1570力肯","110/08/02","(牛牛牛)亞-鑫豐",3,0,3
"16778","1570力肯","110/08/02","國泰-台南",0,3,-3
"16779","1570力肯","110/08/02","土銀-白河",2,0,2
"16780","1570力肯","110/08/02","元富-新店",0,3,-3
"16781","1570力肯","110/08/02","統一-松江",2,0,2
"16782","1570力肯","110/08/02","元富-永和",0,2,-2
"16783","1570力肯","110/08/02","中國信託-永康",1,0,1
"16784","1570力肯","110/08/02","凱基-台北",0,2,-2
"16785","1570力肯","110/08/02","凱基-信義",1,0,1
"16786","1570力肯","110/08/02","統一-城中",0,2,-2
"16787","1570力肯","110/08/02","凱基-幸福",1,0,1
"16788","1570力肯","110/08/02","新光",0,1,-1
"16789","1570力肯","110/08/02","元大-歸仁",1,0,1
"16790","1570力肯","110/08/02","凱基-岡山",0,1,-1
"16791","1570力肯","110/08/02","合庫-台中",0,0,0
"16792","1570力肯","110/08/02","富邦-台南",0,1,-1
"16793","1570力肯","110/08/02","康和-板橋",0,0,0
"16794","1570力肯","110/08/02","元大-新盛",0,1,-1
"16795","1570力肯","110/08/02","群益金鼎-鳳山",0,0,0
"16796","1570力肯","110/08/02","永豐金-嘉義",0,1,-1
"16797","1570力肯","110/08/02","元大-樹林",0,0,0
"16798","1570力肯","110/08/02","康和-板橋",0,0,0
"16799","1570力肯","110/08/02","",NA,NA,NA
"16800","1570力肯","110/08/02","合庫-台中",0,0,0
"16801","6180橘子","110/08/02","美商高盛",21,8,13
"16802","6180橘子","110/08/02","國票-嘉義",0,29,-29
"16803","6180橘子","110/08/02","統一-彰化",10,0,10
"16804","6180橘子","110/08/02","新加坡商瑞銀",0,21,-21
"16805","6180橘子","110/08/02","中國信託-高雄",10,0,10
"16806","6180橘子","110/08/02","凱基-台北",20,40,-20
"16807","6180橘子","110/08/02","兆豐-斗南",10,0,10
"16808","6180橘子","110/08/02","摩根大通",3,15,-12
"16809","6180橘子","110/08/02","兆豐-埔墘",10,0,10
"16810","6180橘子","110/08/02","第一金-桃園",0,10,-10
"16811","6180橘子","110/08/02","玉山證券",10,0,10
"16812","6180橘子","110/08/02","凱基-東港",0,10,-10
"16813","6180橘子","110/08/02","富邦-羅東",8,1,7
"16814","6180橘子","110/08/02","元大-桃園",0,10,-10
"16815","6180橘子","110/08/02","元大證券",7,0,7
"16816","6180橘子","110/08/02","元大-館前",0,9,-9
"16817","6180橘子","110/08/02","元大-復北",7,0,7
"16818","6180橘子","110/08/02","台灣摩根士丹利",3,10,-7
"16819","6180橘子","110/08/02","華南永昌-長虹",6,0,6
"16820","6180橘子","110/08/02","光和-花壇",0,5,-5
"16821","6180橘子","110/08/02","元富-文心",5,0,5
"16822","6180橘子","110/08/02","玉山-嘉義",0,5,-5
"16823","6180橘子","110/08/02","台新-新莊",5,0,5
"16824","6180橘子","110/08/02","凱基-松山",0,5,-5
"16825","6180橘子","110/08/02","康和-嘉義",5,0,5
"16826","6180橘子","110/08/02","永豐金-員林",0,4,-4
"16827","6180橘子","110/08/02","凱基-興隆",5,0,5
"16828","6180橘子","110/08/02","元富-大裕",0,3,-3
"16829","6180橘子","110/08/02","華南永昌-楠梓",5,0,5
"16830","6180橘子","110/08/02","富邦-板橋",0,3,-3
"16831","2390云辰","110/08/02","摩根大通",1945,913,1032
"16832","2390云辰","110/08/02","華南永昌-鳳山",154,448,-294
"16833","2390云辰","110/08/02","富邦-陽明",118,11,107
"16834","2390云辰","110/08/02","群益金鼎-三重",1,168,-167
"16835","2390云辰","110/08/02","兆豐-三民",153,62,91
"16836","2390云辰","110/08/02","統一-內湖",5,102,-97
"16837","2390云辰","110/08/02","光和-嘉義",83,4,79
"16838","2390云辰","110/08/02","台新證券",235,320,-85
"16839","2390云辰","110/08/02","華南永昌-新莊",78,4,74
"16840","2390云辰","110/08/02","統一-新台中",8,87,-79
"16841","2390云辰","110/08/02","統一-城中",182,111,71
"16842","2390云辰","110/08/02","美商高盛",10,88,-78
"16843","2390云辰","110/08/02","台灣摩根士丹利",153,85,68
"16844","2390云辰","110/08/02","元大-汐止",57,130,-73
"16845","2390云辰","110/08/02","凱基-和平",115,47,68
"16846","2390云辰","110/08/02","港商野村",580,638,-58
"16847","2390云辰","110/08/02","華南永昌-公誠",75,13,62
"16848","2390云辰","110/08/02","元富-板橋",5,61,-56
"16849","2390云辰","110/08/02","永豐金-竹科",71,9,62
"16850","2390云辰","110/08/02","新加坡商瑞銀",11,66,-55
"16851","2390云辰","110/08/02","新光",160,100,60
"16852","2390云辰","110/08/02","元大-豐原",6,56,-50
"16853","2390云辰","110/08/02","凱基-岡山",61,1,60
"16854","2390云辰","110/08/02","元大-土城",5,55,-50
"16855","2390云辰","110/08/02","美林",254,195,59
"16856","2390云辰","110/08/02","凱基-站前",1,49,-48
"16857","2390云辰","110/08/02","凱基-大里",76,22,54
"16858","2390云辰","110/08/02","元大-中壢",6,54,-48
"16859","2390云辰","110/08/02","元大-鳳中",60,8,52
"16860","2390云辰","110/08/02","日盛證券",48,95,-47
"16861","1471首利","110/07/29","宏遠-光隆",35,0,35
"16862","1471首利","110/07/29","摩根大通",24,132,-108
"16863","1471首利","110/07/29","玉山-桃園",33,3,30
"16864","1471首利","110/07/29","台灣企銀-太平",0,60,-60
"16865","1471首利","110/07/29","富邦-台南",30,0,30
"16866","1471首利","110/07/29","元大-斗六",0,40,-40
"16867","1471首利","110/07/29","臺灣企銀-桃園",25,0,25
"16868","1471首利","110/07/29","元大-歸仁",0,23,-23
"16869","1471首利","110/07/29","元富-草屯",15,0,15
"16870","1471首利","110/07/29","日盛-永康",0,20,-20
"16871","1471首利","110/07/29","新光-桃園",15,0,15
"16872","1471首利","110/07/29","台中銀-員林",0,20,-20
"16873","1471首利","110/07/29","元大-博愛",15,2,13
"16874","1471首利","110/07/29","凱基-東門",0,14,-14
"16875","1471首利","110/07/29","臺銀-鳳山",12,0,12
"16876","1471首利","110/07/29","元大-草屯",1,15,-14
"16877","1471首利","110/07/29","元富-新莊",11,0,11
"16878","1471首利","110/07/29","元大-新竹經國",0,13,-13
"16879","1471首利","110/07/29","兆豐-來福",11,0,11
"16880","1471首利","110/07/29","日盛-土城",0,10,-10
"16881","1471首利","110/07/29","統一-新營",10,0,10
"16882","1471首利","110/07/29","美林",0,10,-10
"16883","1471首利","110/07/29","光和-溪湖",10,0,10
"16884","1471首利","110/07/29","永興-水湳",0,10,-10
"16885","1471首利","110/07/29","台新-左楠",10,0,10
"16886","1471首利","110/07/29","玉山證券",0,10,-10
"16887","1471首利","110/07/29","群益金鼎-台中",10,0,10
"16888","1471首利","110/07/29","群益金鼎-海山",2,12,-10
"16889","1471首利","110/07/29","凱基-內埔",10,0,10
"16890","1471首利","110/07/29","凱基-羅東",0,10,-10
"16891","2883開發金","110/07/29","國泰證券",2782,3,2779
"16892","2883開發金","110/07/29","永豐金證券",223,3618,-3395
"16893","2883開發金","110/07/29","凱基-台北",2299,284,2015
"16894","2883開發金","110/07/29","摩根大通",411,2625,-2214
"16895","2883開發金","110/07/29","第一金",1539,7,1532
"16896","2883開發金","110/07/29","台灣企銀",5,1717,-1712
"16897","2883開發金","110/07/29","港商野村",1983,585,1398
"16898","2883開發金","110/07/29","新加坡商瑞銀",843,2324,-1481
"16899","2883開發金","110/07/29","元富",1805,427,1378
"16900","2883開發金","110/07/29","港商麥格理",0,1129,-1129
"16901","2883開發金","110/07/29","台灣摩根士丹利",1634,398,1236
"16902","2883開發金","110/07/29","元大-學甲",1,953,-952
"16903","2883開發金","110/07/29","花旗環球",932,0,932
"16904","2883開發金","110/07/29","國票-博愛",100,1025,-925
"16905","2883開發金","110/07/29","凱基-敦北",590,5,585
"16906","2883開發金","110/07/29","國泰-館前",220,944,-724
"16907","2883開發金","110/07/29","國票-長城",506,4,502
"16908","2883開發金","110/07/29","兆豐-高雄",33,650,-617
"16909","2883開發金","110/07/29","港商法國興業",506,18,488
"16910","2883開發金","110/07/29","元富-緯城",1,513,-512
"16911","2883開發金","110/07/29","台新證券",753,287,466
"16912","2883開發金","110/07/29","美林",232,698,-466
"16913","2883開發金","110/07/29","元大-鳳中",495,71,424
"16914","2883開發金","110/07/29","元富-城中",50,513,-463
"16915","2883開發金","110/07/29","日茂",374,3,371
"16916","2883開發金","110/07/29","致和-崇德",0,404,-404
"16917","2883開發金","110/07/29","大和國泰",368,0,368
"16918","2883開發金","110/07/29","永豐金-板橋",123,506,-383
"16919","2883開發金","110/07/29","新光",603,243,360
"16920","2883開發金","110/07/29","中國信託-忠孝",100,423,-323
"16921","6205詮欣","110/07/29","臺銀-鳳山",31,0,31
"16922","6205詮欣","110/07/29","永豐金-敦南",0,53,-53
"16923","6205詮欣","110/07/29","摩根大通",16,2,14
"16924","6205詮欣","110/07/29","元大-土城學府",2,16,-14
"16925","6205詮欣","110/07/29","臺銀",10,0,10
"16926","6205詮欣","110/07/29","元富-潮州",0,11,-11
"16927","6205詮欣","110/07/29","日盛證券",10,0,10
"16928","6205詮欣","110/07/29","元大-清水",0,10,-10
"16929","6205詮欣","110/07/29","兆豐-新莊",10,0,10
"16930","6205詮欣","110/07/29","日盛-三重",0,7,-7
"16931","6205詮欣","110/07/29","元大-南屯",10,0,10
"16932","6205詮欣","110/07/29","日盛-屏東",0,6,-6
"16933","6205詮欣","110/07/29","富邦-建國",4,0,4
"16934","6205詮欣","110/07/29","華南永昌-公誠",0,5,-5
"16935","6205詮欣","110/07/29","富邦-南屯",4,0,4
"16936","6205詮欣","110/07/29","元大-南京",0,5,-5
"16937","6205詮欣","110/07/29","臺銀-臺中",3,0,3
"16938","6205詮欣","110/07/29","瑞士信貸",0,4,-4
"16939","6205詮欣","110/07/29","日盛-和美",3,0,3
"16940","6205詮欣","110/07/29","凱基-大安",0,4,-4
"16941","6205詮欣","110/07/29","德信-新營",3,0,3
"16942","6205詮欣","110/07/29","元大-大里德芳",0,4,-4
"16943","6205詮欣","110/07/29","兆豐-景美",3,0,3
"16944","6205詮欣","110/07/29","合庫-基隆",0,2,-2
"16945","6205詮欣","110/07/29","國票",3,0,3
"16946","6205詮欣","110/07/29","中國信託-永康",0,2,-2
"16947","6205詮欣","110/07/29","國票-南崁",3,0,3
"16948","6205詮欣","110/07/29","兆豐-小港",0,2,-2
"16949","6205詮欣","110/07/29","元大-蘆洲",3,0,3
"16950","6205詮欣","110/07/29","康和-台中",0,2,-2
"16951","1540喬福","110/07/29","高橋-龍潭",10,0,10
"16952","1540喬福","110/07/29","統一-新台中",0,19,-19
"16953","1540喬福","110/07/29","富邦-南屯",10,0,10
"16954","1540喬福","110/07/29","元富-大昌",0,10,-10
"16955","1540喬福","110/07/29","元大-斗六",5,0,5
"16956","1540喬福","110/07/29","大昌-新店",0,6,-6
"16957","1540喬福","110/07/29","兆豐-北高雄",3,0,3
"16958","1540喬福","110/07/29","凱基-台北",0,3,-3
"16959","1540喬福","110/07/29","元大-大安",3,0,3
"16960","1540喬福","110/07/29","台新-台中",0,2,-2
"16961","1540喬福","110/07/29","永豐金-台中",3,0,3
"16962","1540喬福","110/07/29","群益金鼎-嘉義",0,2,-2
"16963","1540喬福","110/07/29","臺銀-金山",2,0,2
"16964","1540喬福","110/07/29","凱基-天母",0,2,-2
"16965","1540喬福","110/07/29","日盛-士林",2,0,2
"16966","1540喬福","110/07/29","花旗環球",0,1,-1
"16967","1540喬福","110/07/29","元大-土城學府",2,0,2
"16968","1540喬福","110/07/29","第一金-大稻埕",0,1,-1
"16969","1540喬福","110/07/29","元大-南京",2,0,2
"16970","1540喬福","110/07/29","統一-嘉義",0,1,-1
"16971","1540喬福","110/07/29","臺銀-臺南",1,0,1
"16972","1540喬福","110/07/29","元富-中港",0,1,-1
"16973","1540喬福","110/07/29","第一金-台南",1,0,1
"16974","1540喬福","110/07/29","(牛牛牛)亞-網路",0,1,-1
"16975","1540喬福","110/07/29","台中銀-豐原",1,0,1
"16976","1540喬福","110/07/29","玉山-高雄",0,1,-1
"16977","1540喬福","110/07/29","中國信託-高雄",1,0,1
"16978","1540喬福","110/07/29","群益金鼎-台南",0,1,-1
"16979","1540喬福","110/07/29","兆豐-台中港",1,0,1
"16980","1540喬福","110/07/29","凱基-鳳山",0,1,-1
"16981","2888新光金","110/07/29","美商高盛",6409,110,6299
"16982","2888新光金","110/07/29","元大-忠孝鼎富",0,6714,-6714
"16983","2888新光金","110/07/29","台灣摩根士丹利",4583,443,4140
"16984","2888新光金","110/07/29","凱基-台北",5855,11898,-6043
"16985","2888新光金","110/07/29","元富-草屯",2193,2,2191
"16986","2888新光金","110/07/29","瑞士信貸",161,6090,-5929
"16987","2888新光金","110/07/29","華南永昌-南京",2059,21,2038
"16988","2888新光金","110/07/29","永豐金-萬盛",124,3599,-3475
"16989","2888新光金","110/07/29","凱基-市政",1558,0,1558
"16990","2888新光金","110/07/29","群益金鼎-大安",2,3306,-3304
"16991","2888新光金","110/07/29","法銀巴黎",1234,0,1234
"16992","2888新光金","110/07/29","凱基-復興",15,3015,-3000
"16993","2888新光金","110/07/29","永豐金-台中",1166,49,1117
"16994","2888新光金","110/07/29","新加坡商瑞銀",1429,4265,-2836
"16995","2888新光金","110/07/29","群益金鼎-崇德",1083,10,1073
"16996","2888新光金","110/07/29","凱基-大安",10,2564,-2554
"16997","2888新光金","110/07/29","兆豐-竹北",1002,29,973
"16998","2888新光金","110/07/29","中國信託",46,2012,-1966
"16999","2888新光金","110/07/29","美林",1767,804,963
"17000","2888新光金","110/07/29","群益金鼎-台北",10,1875,-1865
"17001","2888新光金","110/07/29","元大-三重",882,0,882
"17002","2888新光金","110/07/29","元富-城東",142,1856,-1714
"17003","2888新光金","110/07/29","元大-豐原站前",983,114,869
"17004","2888新光金","110/07/29","華南永昌-忠孝",10,1600,-1590
"17005","2888新光金","110/07/29","元大-北港",868,5,863
"17006","2888新光金","110/07/29","永豐金-信義",10,1497,-1487
"17007","2888新光金","110/07/29","合庫-台中",891,54,837
"17008","2888新光金","110/07/29","富邦-建國",350,1736,-1386
"17009","2888新光金","110/07/29","統一-汐止",725,14,711
"17010","2888新光金","110/07/29","富邦-新營",60,1402,-1342
"17011","1340勝悅","110/07/29","新光-新竹",18,0,18
"17012","1340勝悅","110/07/29","瑞士信貸",0,8,-8
"17013","1340勝悅","110/07/29","華南永昌-彰化",5,0,5
"17014","1340勝悅","110/07/29","台新證券",0,7,-7
"17015","1340勝悅","110/07/29","元大-六合",5,0,5
"17016","1340勝悅","110/07/29","元富-緯城",0,5,-5
"17017","1340勝悅","110/07/29","第一金-自由",4,0,4
"17018","1340勝悅","110/07/29","兆豐-南京",0,5,-5
"17019","1340勝悅","110/07/29","新光",4,0,4
"17020","1340勝悅","110/07/29","富邦-南屯",0,5,-5
"17021","1340勝悅","110/07/29","美商高盛",3,0,3
"17022","1340勝悅","110/07/29","元富-安南",0,4,-4
"17023","1340勝悅","110/07/29","元富-彰化",3,0,3
"17024","1340勝悅","110/07/29","兆豐-三民",0,4,-4
"17025","1340勝悅","110/07/29","大昌",2,0,2
"17026","1340勝悅","110/07/29","兆豐-松德",0,4,-4
"17027","1340勝悅","110/07/29","兆豐-大安",2,0,2
"17028","1340勝悅","110/07/29","國票-台中",0,4,-4
"17029","1340勝悅","110/07/29","摩根大通",2,0,2
"17030","1340勝悅","110/07/29","第一金-路竹",0,3,-3
"17031","1340勝悅","110/07/29","新光-台中",2,0,2
"17032","1340勝悅","110/07/29","統一-城中",2,4,-2
"17033","1340勝悅","110/07/29","凱基-八德",2,0,2
"17034","1340勝悅","110/07/29","元富-同大",0,2,-2
"17035","1340勝悅","110/07/29","合庫-高雄",1,0,1
"17036","1340勝悅","110/07/29","台新-高雄",0,2,-2
"17037","1340勝悅","110/07/29","日進",1,0,1
"17038","1340勝悅","110/07/29","凱基-北門",0,2,-2
"17039","1340勝悅","110/07/29","新光-台南",1,0,1
"17040","1340勝悅","110/07/29","元大-汐止",0,2,-2
"17041","6246臺龍","110/07/29","港商野村",38,1,37
"17042","6246臺龍","110/07/29","玉山-台南",0,27,-27
"17043","6246臺龍","110/07/29","凱基-幸福",25,0,25
"17044","6246臺龍","110/07/29","國泰-忠孝",0,25,-25
"17045","6246臺龍","110/07/29","亞東-板橋",16,0,16
"17046","6246臺龍","110/07/29","光和",0,21,-21
"17047","6246臺龍","110/07/29","元大-台中",10,0,10
"17048","6246臺龍","110/07/29","第一金-安和",0,20,-20
"17049","6246臺龍","110/07/29","兆豐-松德",9,0,9
"17050","6246臺龍","110/07/29","兆豐-竹北",5,25,-20
"17051","6246臺龍","110/07/29","兆豐-公益",8,0,8
"17052","6246臺龍","110/07/29","元大-大里",0,20,-20
"17053","6246臺龍","110/07/29","華南永昌",7,0,7
"17054","6246臺龍","110/07/29","台新-台南",0,15,-15
"17055","6246臺龍","110/07/29","日盛-斗六",6,0,6
"17056","6246臺龍","110/07/29","永豐金-羅東",2,15,-13
"17057","6246臺龍","110/07/29","元富-中港",6,0,6
"17058","6246臺龍","110/07/29","元大-博愛",1,10,-9
"17059","6246臺龍","110/07/29","台新證券",8,2,6
"17060","6246臺龍","110/07/29","宏遠-台中",0,5,-5
"17061","6246臺龍","110/07/29","臺銀-臺中",5,0,5
"17062","6246臺龍","110/07/29","台新-左楠",0,5,-5
"17063","6246臺龍","110/07/29","元富-宜蘭",5,0,5
"17064","6246臺龍","110/07/29","中農",0,5,-5
"17065","6246臺龍","110/07/29","德信-新營",5,0,5
"17066","6246臺龍","110/07/29","群益金鼎-竹南",0,5,-5
"17067","6246臺龍","110/07/29","新光-新竹",5,0,5
"17068","6246臺龍","110/07/29","凱基-科園",0,5,-5
"17069","6246臺龍","110/07/29","國泰-敦南",10,5,5
"17070","6246臺龍","110/07/29","日盛-宜蘭",1,5,-4
"17071","00715L期街口布蘭特正2","110/07/29","永豐金證券",2129,2,2127
"17072","00715L期街口布蘭特正2","110/07/29","國票-博愛",55,702,-647
"17073","00715L期街口布蘭特正2","110/07/29","元大證券",1918,115,1803
"17074","00715L期街口布蘭特正2","110/07/29","富邦-彰化",0,605,-605
"17075","00715L期街口布蘭特正2","110/07/29","統一",1050,313,737
"17076","00715L期街口布蘭特正2","110/07/29","元大-前金",0,440,-440
"17077","00715L期街口布蘭特正2","110/07/29","港商野村",821,263,558
"17078","00715L期街口布蘭特正2","110/07/29","群益金鼎-崇德",0,340,-340
"17079","00715L期街口布蘭特正2","110/07/29","永豐金-內湖",500,0,500
"17080","00715L期街口布蘭特正2","110/07/29","元富-板橋",7,330,-323
"17081","00715L期街口布蘭特正2","110/07/29","元富-大裕",505,23,482
"17082","00715L期街口布蘭特正2","110/07/29","元大-三重",3,200,-197
"17083","00715L期街口布蘭特正2","110/07/29","國票-台中",276,0,276
"17084","00715L期街口布蘭特正2","110/07/29","凱基-東勢",5,194,-189
"17085","00715L期街口布蘭特正2","110/07/29","統一-高雄",300,118,182
"17086","00715L期街口布蘭特正2","110/07/29","富邦-台北",0,181,-181
"17087","00715L期街口布蘭特正2","110/07/29","群益金鼎-瑞豐",180,0,180
"17088","00715L期街口布蘭特正2","110/07/29","大慶-中和",0,174,-174
"17089","00715L期街口布蘭特正2","110/07/29","元大-南崁",128,0,128
"17090","00715L期街口布蘭特正2","110/07/29","永豐金-萬盛",0,153,-153
"17091","00715L期街口布蘭特正2","110/07/29","大慶-蘆洲",106,0,106
"17092","00715L期街口布蘭特正2","110/07/29","元大-開元",0,151,-151
"17093","00715L期街口布蘭特正2","110/07/29","統一-中壢",100,0,100
"17094","00715L期街口布蘭特正2","110/07/29","日盛-新竹",0,126,-126
"17095","00715L期街口布蘭特正2","110/07/29","第一金-自由",100,2,98
"17096","00715L期街口布蘭特正2","110/07/29","凱基-豐中",0,123,-123
"17097","00715L期街口布蘭特正2","110/07/29","華南永昌-內壢",100,2,98
"17098","00715L期街口布蘭特正2","110/07/29","元大-東泰",0,122,-122
"17099","00715L期街口布蘭特正2","110/07/29","永豐金-板橋",98,0,98
"17100","00715L期街口布蘭特正2","110/07/29","台新-高雄",0,121,-121
"17101","8941關中","110/07/29","富邦-仁愛",1,0,1
"17102","8941關中","110/07/29","富邦-員林",0,1,-1
"17103","8941關中","110/07/29","康和-板橋",0,0,0
"17104","8941關中","110/07/29","康和-板橋",0,0,0
"17105","8941關中","110/07/29","玉山證券",0,0,0
"17106","8941關中","110/07/29","玉山證券",0,0,0
"17107","8941關中","110/07/29","玉山-數位",0,0,0
"17108","8941關中","110/07/29","玉山-數位",0,0,0
"17109","8941關中","110/07/29","凱基-市府",0,0,0
"17110","8941關中","110/07/29","凱基-市府",0,0,0
"17111","8941關中","110/07/29","元大-鶯歌",0,0,0
"17112","8941關中","110/07/29","元大-鶯歌",0,0,0
"17113","8941關中","110/07/29","元大-花蓮",0,0,0
"17114","8941關中","110/07/29","元大-花蓮",0,0,0
"17115","8941關中","110/07/29","",NA,NA,NA
"17116","8941關中","110/07/29","",NA,NA,NA
"17117","8941關中","110/07/29","",NA,NA,NA
"17118","8941關中","110/07/29","",NA,NA,NA
"17119","8941關中","110/07/29","",NA,NA,NA
"17120","8941關中","110/07/29","",NA,NA,NA
"17121","8941關中","110/07/29","",NA,NA,NA
"17122","8941關中","110/07/29","",NA,NA,NA
"17123","8941關中","110/07/29","",NA,NA,NA
"17124","8941關中","110/07/29","",NA,NA,NA
"17125","8941關中","110/07/29","",NA,NA,NA
"17126","8941關中","110/07/29","",NA,NA,NA
"17127","8941關中","110/07/29","",NA,NA,NA
"17128","8941關中","110/07/29","",NA,NA,NA
"17129","8941關中","110/07/29","",NA,NA,NA
"17130","8941關中","110/07/29","",NA,NA,NA
"17131","8936國統","110/07/29","新加坡商瑞銀",89,19,70
"17132","8936國統","110/07/29","日盛-忠孝",11,135,-124
"17133","8936國統","110/07/29","瑞士信貸",55,3,52
"17134","8936國統","110/07/29","元富-敦南",0,80,-80
"17135","8936國統","110/07/29","凱基-台北",48,3,45
"17136","8936國統","110/07/29","康和",0,20,-20
"17137","8936國統","110/07/29","摩根大通",97,60,37
"17138","8936國統","110/07/29","元大-竹科",0,20,-20
"17139","8936國統","110/07/29","美林",27,2,25
"17140","8936國統","110/07/29","永豐金-桃園",0,19,-19
"17141","8936國統","110/07/29","凱基-三多",25,0,25
"17142","8936國統","110/07/29","群益金鼎-高盛",0,14,-14
"17143","8936國統","110/07/29","凱基-北門",27,2,25
"17144","8936國統","110/07/29","元富-安南",2,15,-13
"17145","8936國統","110/07/29","兆豐-桃鶯",30,10,20
"17146","8936國統","110/07/29","富邦-內湖",2,15,-13
"17147","8936國統","110/07/29","永豐金-台中",20,0,20
"17148","8936國統","110/07/29","元大-復北",0,11,-11
"17149","8936國統","110/07/29","台灣摩根士丹利",30,12,18
"17150","8936國統","110/07/29","合庫-鳳山",0,10,-10
"17151","8936國統","110/07/29","兆豐-大同",15,0,15
"17152","8936國統","110/07/29","元富-潮州",0,10,-10
"17153","8936國統","110/07/29","新光-台中",39,24,15
"17154","8936國統","110/07/29","群益金鼎-台北",0,10,-10
"17155","8936國統","110/07/29","兆豐-新營",10,0,10
"17156","8936國統","110/07/29","凱基-高雄",20,30,-10
"17157","8936國統","110/07/29","台新-高雄",10,0,10
"17158","8936國統","110/07/29","富邦-桃園",0,10,-10
"17159","8936國統","110/07/29","玉山-士林",10,0,10
"17160","8936國統","110/07/29","新光",1,10,-9
"17161","6226光鼎","110/07/29","台新-台中",396,46,350
"17162","6226光鼎","110/07/29","群益金鼎-東大",11,309,-298
"17163","6226光鼎","110/07/29","元富-永和",242,0,242
"17164","6226光鼎","110/07/29","日盛證券",2,176,-174
"17165","6226光鼎","110/07/29","永豐金-古亭",200,0,200
"17166","6226光鼎","110/07/29","國泰-敦南",90,197,-107
"17167","6226光鼎","110/07/29","華南永昌",216,46,170
"17168","6226光鼎","110/07/29","元大-雙和",16,111,-95
"17169","6226光鼎","110/07/29","國票-北高雄",188,36,152
"17170","6226光鼎","110/07/29","元大-大統",2,94,-92
"17171","6226光鼎","110/07/29","國票-台南",120,4,116
"17172","6226光鼎","110/07/29","元大-板橋",5,78,-73
"17173","6226光鼎","110/07/29","永豐金證券",101,3,98
"17174","6226光鼎","110/07/29","群益金鼎-萬華",46,111,-65
"17175","6226光鼎","110/07/29","富邦-建國",125,28,97
"17176","6226光鼎","110/07/29","華南永昌-竹北",1,60,-59
"17177","6226光鼎","110/07/29","群益金鼎-土城",94,9,85
"17178","6226光鼎","110/07/29","玉山證券",28,86,-58
"17179","6226光鼎","110/07/29","元富-四維",82,4,78
"17180","6226光鼎","110/07/29","元大-土城學府",13,68,-55
"17181","6226光鼎","110/07/29","元大-鳳中",69,15,54
"17182","6226光鼎","110/07/29","元大-豐原",5,59,-54
"17183","6226光鼎","110/07/29","台新-新莊",54,1,53
"17184","6226光鼎","110/07/29","統一",56,107,-51
"17185","6226光鼎","110/07/29","中國信託-新竹",63,13,50
"17186","6226光鼎","110/07/29","統一-內湖",0,48,-48
"17187","6226光鼎","110/07/29","群益金鼎-士林",50,0,50
"17188","6226光鼎","110/07/29","元大-東港",2,50,-48
"17189","6226光鼎","110/07/29","台新-高雄",125,80,45
"17190","6226光鼎","110/07/29","元大-太平",1,46,-45
"17191","2363矽統","110/07/29","凱基-台北",2235,1238,997
"17192","2363矽統","110/07/29","康和-台中",10,437,-427
"17193","2363矽統","110/07/29","摩根大通",1784,793,991
"17194","2363矽統","110/07/29","第一金-新興",11,310,-299
"17195","2363矽統","110/07/29","港商野村",1833,1300,533
"17196","2363矽統","110/07/29","瑞士信貸",9,190,-181
"17197","2363矽統","110/07/29","美林",652,288,364
"17198","2363矽統","110/07/29","台新證券",659,808,-149
"17199","2363矽統","110/07/29","元大-台中",376,38,338
"17200","2363矽統","110/07/29","元大-萬華",42,189,-147
"17201","2363矽統","110/07/29","新加坡商瑞銀",748,474,274
"17202","2363矽統","110/07/29","台新-左楠",26,171,-145
"17203","2363矽統","110/07/29","國泰-敦南",566,333,233
"17204","2363矽統","110/07/29","華南永昌-鳳山",116,241,-125
"17205","2363矽統","110/07/29","元大-旗山",299,66,233
"17206","2363矽統","110/07/29","永全-南崁",0,117,-117
"17207","2363矽統","110/07/29","美商高盛",600,433,167
"17208","2363矽統","110/07/29","群益金鼎-桃園",25,131,-106
"17209","2363矽統","110/07/29","元大-永和",146,12,134
"17210","2363矽統","110/07/29","宏遠-新化",3,103,-100
"17211","2363矽統","110/07/29","元大證券",137,9,128
"17212","2363矽統","110/07/29","新光",331,429,-98
"17213","2363矽統","110/07/29","永豐金-彰化",135,10,125
"17214","2363矽統","110/07/29","中國信託-忠孝",101,188,-87
"17215","2363矽統","110/07/29","北城證券",139,19,120
"17216","2363矽統","110/07/29","群益金鼎-建成",11,95,-84
"17217","2363矽統","110/07/29","富邦-高雄",153,34,119
"17218","2363矽統","110/07/29","群益金鼎-三民",23,105,-82
"17219","2363矽統","110/07/29","元大-蘆洲",120,19,101
"17220","2363矽統","110/07/29","元大-豐原",104,186,-82
"17221","8112至上","110/07/29","合庫證券",194,1,193
"17222","8112至上","110/07/29","摩根大通",4,424,-420
"17223","8112至上","110/07/29","美商高盛",154,5,149
"17224","8112至上","110/07/29","日盛-高雄",2,400,-398
"17225","8112至上","110/07/29","永豐金證券",144,0,144
"17226","8112至上","110/07/29","港商法國興業",0,374,-374
"17227","8112至上","110/07/29","新光-台中",123,12,111
"17228","8112至上","110/07/29","凱基-台北",50,312,-262
"17229","8112至上","110/07/29","新加坡商瑞銀",189,83,106
"17230","8112至上","110/07/29","美林",69,232,-163
"17231","8112至上","110/07/29","華南永昌-新莊",73,0,73
"17232","8112至上","110/07/29","兆豐-公益",0,120,-120
"17233","8112至上","110/07/29","新光",108,49,59
"17234","8112至上","110/07/29","瑞士信貸",1,109,-108
"17235","8112至上","110/07/29","元富-文心",45,3,42
"17236","8112至上","110/07/29","華南永昌-小港",4,30,-26
"17237","8112至上","110/07/29","華南永昌-林口",41,0,41
"17238","8112至上","110/07/29","富邦-中壢",1,24,-23
"17239","8112至上","110/07/29","港商野村",146,112,34
"17240","8112至上","110/07/29","元大-歸仁",2,24,-22
"17241","8112至上","110/07/29","臺銀-高雄",30,0,30
"17242","8112至上","110/07/29","華南永昌-麻豆",0,21,-21
"17243","8112至上","110/07/29","元富-佳里",30,0,30
"17244","8112至上","110/07/29","台新-松江",0,20,-20
"17245","8112至上","110/07/29","永豐金-內湖",30,1,29
"17246","8112至上","110/07/29","元大-新莊",1,20,-19
"17247","8112至上","110/07/29","台新-新營",31,3,28
"17248","8112至上","110/07/29","華南永昌-岡山",1,19,-18
"17249","8112至上","110/07/29","永豐金-彰化",27,0,27
"17250","8112至上","110/07/29","元大-崇德",3,20,-17
"17251","1570力肯","110/07/29","群益金鼎-高雄",20,0,20
"17252","1570力肯","110/07/29","聯邦-興中",0,17,-17
"17253","1570力肯","110/07/29","群益金鼎-板橋",16,0,16
"17254","1570力肯","110/07/29","富邦-建國",0,10,-10
"17255","1570力肯","110/07/29","統一-敦南",5,0,5
"17256","1570力肯","110/07/29","凱基-站前",0,5,-5
"17257","1570力肯","110/07/29","元富-松德",4,0,4
"17258","1570力肯","110/07/29","國泰-板橋",0,4,-4
"17259","1570力肯","110/07/29","元大-和平",4,0,4
"17260","1570力肯","110/07/29","統一-土城",0,3,-3
"17261","1570力肯","110/07/29","凱基-幸福",3,0,3
"17262","1570力肯","110/07/29","凱基-大里",0,3,-3
"17263","1570力肯","110/07/29","華南永昌-鳳山",3,0,3
"17264","1570力肯","110/07/29","凱基-台北",0,3,-3
"17265","1570力肯","110/07/29","元大-北港",4,2,2
"17266","1570力肯","110/07/29","元大-屏東民生",0,3,-3
"17267","1570力肯","110/07/29","美林",1,0,1
"17268","1570力肯","110/07/29","元富-緯城",0,2,-2
"17269","1570力肯","110/07/29","國泰-台南",1,0,1
"17270","1570力肯","110/07/29","台新-高雄",0,2,-2
"17271","1570力肯","110/07/29","元大-歸仁",1,0,1
"17272","1570力肯","110/07/29","華南永昌-楠梓",0,2,-2
"17273","1570力肯","110/07/29","元大-松山",1,0,1
"17274","1570力肯","110/07/29","元大-北成功",0,2,-2
"17275","1570力肯","110/07/29","元大-文心興安",1,0,1
"17276","1570力肯","110/07/29","元大-板橋",0,2,-2
"17277","1570力肯","110/07/29","元大-東蘆",1,0,1
"17278","1570力肯","110/07/29","統一-台南",0,1,-1
"17279","1570力肯","110/07/29","群益金鼎-鳳山",0,0,0
"17280","1570力肯","110/07/29","台新證券",0,1,-1
"17281","2929淘帝","110/07/29","新光-新竹",118,13,105
"17282","2929淘帝","110/07/29","元富-敦南",0,91,-91
"17283","2929淘帝","110/07/29","新加坡商瑞銀",56,0,56
"17284","2929淘帝","110/07/29","日盛-板橋中山",0,38,-38
"17285","2929淘帝","110/07/29","凱基-台北",39,4,35
"17286","2929淘帝","110/07/29","群益金鼎-士林",0,20,-20
"17287","2929淘帝","110/07/29","元大-民生",29,0,29
"17288","2929淘帝","110/07/29","華南永昌-敦南",0,20,-20
"17289","2929淘帝","110/07/29","美林",37,9,28
"17290","2929淘帝","110/07/29","高橋-龍潭",3,20,-17
"17291","2929淘帝","110/07/29","元大-承德",15,0,15
"17292","2929淘帝","110/07/29","凱基-中山",4,19,-15
"17293","2929淘帝","110/07/29","第一金-台南",10,0,10
"17294","2929淘帝","110/07/29","富邦-台北",0,15,-15
"17295","2929淘帝","110/07/29","富邦-桃園",9,0,9
"17296","2929淘帝","110/07/29","元富-台中",0,14,-14
"17297","2929淘帝","110/07/29","港商野村",17,10,7
"17298","2929淘帝","110/07/29","台新-建北",0,13,-13
"17299","2929淘帝","110/07/29","台中銀-豐原",6,0,6
"17300","2929淘帝","110/07/29","永豐金-敦南",0,12,-12
"17301","2929淘帝","110/07/29","元大-文心興安",6,0,6
"17302","2929淘帝","110/07/29","新光-台南",0,11,-11
"17303","2929淘帝","110/07/29","德信-新營",5,0,5
"17304","2929淘帝","110/07/29","宏遠-光隆",0,10,-10
"17305","2929淘帝","110/07/29","元大-博愛",5,0,5
"17306","2929淘帝","110/07/29","元大-嘉義",0,6,-6
"17307","2929淘帝","110/07/29","元大-員林",5,0,5
"17308","2929淘帝","110/07/29","日茂-南投",0,5,-5
"17309","2929淘帝","110/07/29","富邦-中壢",4,0,4
"17310","2929淘帝","110/07/29","新光",0,5,-5
"17311","5410國眾","110/07/29","兆豐-城中",32,0,32
"17312","5410國眾","110/07/29","第一金-台南",0,51,-51
"17313","5410國眾","110/07/29","新加坡商瑞銀",19,0,19
"17314","5410國眾","110/07/29","元富-大昌",0,13,-13
"17315","5410國眾","110/07/29","華南永昌-新莊",16,0,16
"17316","5410國眾","110/07/29","臺銀-臺南",0,12,-12
"17317","5410國眾","110/07/29","元大-小港",11,0,11
"17318","5410國眾","110/07/29","日盛-木柵",0,10,-10
"17319","5410國眾","110/07/29","臺銀",10,0,10
"17320","5410國眾","110/07/29","元富-安南",0,10,-10
"17321","5410國眾","110/07/29","臺銀-臺中",10,0,10
"17322","5410國眾","110/07/29","新光",4,13,-9
"17323","5410國眾","110/07/29","宏遠-館前",10,0,10
"17324","5410國眾","110/07/29","永豐金-屏東",0,5,-5
"17325","5410國眾","110/07/29","台新-中壢",10,0,10
"17326","5410國眾","110/07/29","永豐金-苓雅",0,5,-5
"17327","5410國眾","110/07/29","摩根大通",10,1,9
"17328","5410國眾","110/07/29","國票-台南",0,4,-4
"17329","5410國眾","110/07/29","元大-北投",9,0,9
"17330","5410國眾","110/07/29","永豐金-埔里",0,4,-4
"17331","5410國眾","110/07/29","台新證券",7,1,6
"17332","5410國眾","110/07/29","光和",0,3,-3
"17333","5410國眾","110/07/29","元富-新竹",5,0,5
"17334","5410國眾","110/07/29","凱基-汐止",0,3,-3
"17335","5410國眾","110/07/29","凱基-竹北",5,0,5
"17336","5410國眾","110/07/29","元大-善化",0,3,-3
"17337","5410國眾","110/07/29","永豐金-敦南",5,1,4
"17338","5410國眾","110/07/29","元大-員林",0,3,-3
"17339","5410國眾","110/07/29","美林",4,1,3
"17340","5410國眾","110/07/29","永豐金-台南",0,3,-3
"17341","2841台開","110/07/29","兆豐-台南",237,0,237
"17342","2841台開","110/07/29","元大-四維",0,184,-184
"17343","2841台開","110/07/29","永豐金-敦南",60,10,50
"17344","2841台開","110/07/29","玉山-新竹",0,145,-145
"17345","2841台開","110/07/29","永豐金-板新",50,0,50
"17346","2841台開","110/07/29","港商野村",0,124,-124
"17347","2841台開","110/07/29","華南永昌-南京",45,2,43
"17348","2841台開","110/07/29","永豐金-台南",0,32,-32
"17349","2841台開","110/07/29","群益金鼎-崇德",23,0,23
"17350","2841台開","110/07/29","華南永昌-公誠",0,23,-23
"17351","2841台開","110/07/29","日盛-園區",20,0,20
"17352","2841台開","110/07/29","元大-善化",0,22,-22
"17353","2841台開","110/07/29","台新-台中",20,0,20
"17354","2841台開","110/07/29","元大-豐原",0,20,-20
"17355","2841台開","110/07/29","華南永昌-新莊",20,0,20
"17356","2841台開","110/07/29","凱基-台北",0,15,-15
"17357","2841台開","110/07/29","富邦-仁愛",20,0,20
"17358","2841台開","110/07/29","富邦-台北",0,15,-15
"17359","2841台開","110/07/29","新光",15,0,15
"17360","2841台開","110/07/29","臺銀",0,10,-10
"17361","2841台開","110/07/29","華南永昌-台中",15,0,15
"17362","2841台開","110/07/29","元富-三重",0,10,-10
"17363","2841台開","110/07/29","凱基-彰化",13,0,13
"17364","2841台開","110/07/29","元大-林森",0,10,-10
"17365","2841台開","110/07/29","兆豐-台中",10,0,10
"17366","2841台開","110/07/29","光和-花壇",0,9,-9
"17367","2841台開","110/07/29","永豐金-松山",10,0,10
"17368","2841台開","110/07/29","國泰-桃園",1,10,-9
"17369","2841台開","110/07/29","國泰-館前",9,0,9
"17370","2841台開","110/07/29","玉山-嘉義",0,8,-8
"17371","6207雷科","110/07/29","永豐金-古亭",100,0,100
"17372","6207雷科","110/07/29","摩根大通",59,151,-92
"17373","6207雷科","110/07/29","國泰-館前",52,6,46
"17374","6207雷科","110/07/29","凱基-高雄",0,82,-82
"17375","6207雷科","110/07/29","新加坡商瑞銀",41,12,29
"17376","6207雷科","110/07/29","元大-松江",0,25,-25
"17377","6207雷科","110/07/29","大慶-蘆洲",29,6,23
"17378","6207雷科","110/07/29","元大-雙和",2,25,-23
"17379","6207雷科","110/07/29","永豐金-羅東",21,0,21
"17380","6207雷科","110/07/29","港商野村",16,36,-20
"17381","6207雷科","110/07/29","統一-南京",16,0,16
"17382","6207雷科","110/07/29","盈溢-楠梓",0,20,-20
"17383","6207雷科","110/07/29","凱基-台北",45,29,16
"17384","6207雷科","110/07/29","統一",2,20,-18
"17385","6207雷科","110/07/29","富邦-敦南",16,0,16
"17386","6207雷科","110/07/29","日盛-新竹",1,16,-15
"17387","6207雷科","110/07/29","統一-高雄",15,0,15
"17388","6207雷科","110/07/29","康和-台中",0,15,-15
"17389","6207雷科","110/07/29","台新-中壢",11,0,11
"17390","6207雷科","110/07/29","凱基-竹科",0,13,-13
"17391","6207雷科","110/07/29","台灣企銀-竹北",10,0,10
"17392","6207雷科","110/07/29","元大-鳳中",0,12,-12
"17393","6207雷科","110/07/29","宏遠證券",10,0,10
"17394","6207雷科","110/07/29","元大-土城",0,12,-12
"17395","6207雷科","110/07/29","中國信託-忠孝",10,0,10
"17396","6207雷科","110/07/29","華南永昌-高雄",0,11,-11
"17397","6207雷科","110/07/29","大昌-桃園",11,1,10
"17398","6207雷科","110/07/29","元大-木柵",0,10,-10
"17399","6207雷科","110/07/29","玉山-城中",11,1,10
"17400","6207雷科","110/07/29","日盛-板橋",1,10,-9
"17401","3679新至陞","110/07/29","華南永昌-淡水",5,0,5
"17402","3679新至陞","110/07/29","元富-板橋",0,16,-16
"17403","3679新至陞","110/07/29","富邦-新竹華信",5,0,5
"17404","3679新至陞","110/07/29","凱基-台北",0,8,-8
"17405","3679新至陞","110/07/29","永豐金-中和",5,0,5
"17406","3679新至陞","110/07/29","摩根大通",1,6,-5
"17407","3679新至陞","110/07/29","富邦-台北",4,0,4
"17408","3679新至陞","110/07/29","美林",0,4,-4
"17409","3679新至陞","110/07/29","元富-彰化",2,0,2
"17410","3679新至陞","110/07/29","瑞士信貸",0,4,-4
"17411","3679新至陞","110/07/29","兆豐-台中港",2,0,2
"17412","3679新至陞","110/07/29","元大-成功",0,3,-3
"17413","3679新至陞","110/07/29","富邦-三重",2,0,2
"17414","3679新至陞","110/07/29","統一-台南",0,2,-2
"17415","3679新至陞","110/07/29","元大-沙鹿",2,0,2
"17416","3679新至陞","110/07/29","元富-新興",0,2,-2
"17417","3679新至陞","110/07/29","元大-福營",2,0,2
"17418","3679新至陞","110/07/29","凱基-竹科",0,2,-2
"17419","3679新至陞","110/07/29","元大-花蓮",2,0,2
"17420","3679新至陞","110/07/29","元大證券",0,2,-2
"17421","3679新至陞","110/07/29","元大-板橋",2,0,2
"17422","3679新至陞","110/07/29","日盛-北高雄",0,1,-1
"17423","3679新至陞","110/07/29","永豐金-台南",2,0,2
"17424","3679新至陞","110/07/29","宏遠-高雄",0,1,-1
"17425","3679新至陞","110/07/29","合庫-彰化",1,0,1
"17426","3679新至陞","110/07/29","花旗環球",0,1,-1
"17427","3679新至陞","110/07/29","臺銀-臺南",1,0,1
"17428","3679新至陞","110/07/29","華南永昌-岡山",0,1,-1
"17429","3679新至陞","110/07/29","永興-水湳",1,0,1
"17430","3679新至陞","110/07/29","元大-佳里",0,1,-1
"17431","2727王品","110/07/29","第一金",30,0,30
"17432","2727王品","110/07/29","元大-高雄",1,93,-92
"17433","2727王品","110/07/29","港商麥格理",22,0,22
"17434","2727王品","110/07/29","新加坡商瑞銀",5,82,-77
"17435","2727王品","110/07/29","國票-北高雄",24,2,22
"17436","2727王品","110/07/29","美林",0,27,-27
"17437","2727王品","110/07/29","日盛-忠孝",21,0,21
"17438","2727王品","110/07/29","港商野村",21,48,-27
"17439","2727王品","110/07/29","新光",22,3,19
"17440","2727王品","110/07/29","凱基-台北",43,61,-18
"17441","2727王品","110/07/29","國泰-敦南",18,7,11
"17442","2727王品","110/07/29","華南永昌-麻豆",0,18,-18
"17443","2727王品","110/07/29","凱基-五股",11,0,11
"17444","2727王品","110/07/29","國泰-台中",2,17,-15
"17445","2727王品","110/07/29","兆豐-鹿港",12,2,10
"17446","2727王品","110/07/29","永豐金-桃盛",0,15,-15
"17447","2727王品","110/07/29","凱基-埔墘",10,0,10
"17448","2727王品","110/07/29","美商高盛",1,15,-14
"17449","2727王品","110/07/29","永豐金-潮州",10,0,10
"17450","2727王品","110/07/29","玉山證券",4,15,-11
"17451","2727王品","110/07/29","統一",12,4,8
"17452","2727王品","110/07/29","摩根大通",12,22,-10
"17453","2727王品","110/07/29","國泰-板橋",7,0,7
"17454","2727王品","110/07/29","元大-四維",2,12,-10
"17455","2727王品","110/07/29","彰銀-台中",7,1,6
"17456","2727王品","110/07/29","凱基-興隆",0,9,-9
"17457","2727王品","110/07/29","新光-高雄",12,6,6
"17458","2727王品","110/07/29","瑞士信貸",0,8,-8
"17459","2727王品","110/07/29","玉山-數位",6,0,6
"17460","2727王品","110/07/29","大昌-桃園",0,7,-7
"17461","1570力肯","110/07/29","群益金鼎-高雄",20,0,20
"17462","1570力肯","110/07/29","聯邦-興中",0,17,-17
"17463","1570力肯","110/07/29","群益金鼎-板橋",16,0,16
"17464","1570力肯","110/07/29","富邦-建國",0,10,-10
"17465","1570力肯","110/07/29","統一-敦南",5,0,5
"17466","1570力肯","110/07/29","凱基-站前",0,5,-5
"17467","1570力肯","110/07/29","元富-松德",4,0,4
"17468","1570力肯","110/07/29","國泰-板橋",0,4,-4
"17469","1570力肯","110/07/29","元大-和平",4,0,4
"17470","1570力肯","110/07/29","統一-土城",0,3,-3
"17471","1570力肯","110/07/29","凱基-幸福",3,0,3
"17472","1570力肯","110/07/29","凱基-大里",0,3,-3
"17473","1570力肯","110/07/29","華南永昌-鳳山",3,0,3
"17474","1570力肯","110/07/29","凱基-台北",0,3,-3
"17475","1570力肯","110/07/29","元大-北港",4,2,2
"17476","1570力肯","110/07/29","元大-屏東民生",0,3,-3
"17477","1570力肯","110/07/29","美林",1,0,1
"17478","1570力肯","110/07/29","元富-緯城",0,2,-2
"17479","1570力肯","110/07/29","國泰-台南",1,0,1
"17480","1570力肯","110/07/29","台新-高雄",0,2,-2
"17481","1570力肯","110/07/29","元大-歸仁",1,0,1
"17482","1570力肯","110/07/29","華南永昌-楠梓",0,2,-2
"17483","1570力肯","110/07/29","元大-松山",1,0,1
"17484","1570力肯","110/07/29","元大-北成功",0,2,-2
"17485","1570力肯","110/07/29","元大-文心興安",1,0,1
"17486","1570力肯","110/07/29","元大-板橋",0,2,-2
"17487","1570力肯","110/07/29","元大-東蘆",1,0,1
"17488","1570力肯","110/07/29","統一-台南",0,1,-1
"17489","1570力肯","110/07/29","群益金鼎-鳳山",0,0,0
"17490","1570力肯","110/07/29","台新證券",0,1,-1
"17491","6180橘子","110/07/29","凱基-台北",50,4,46
"17492","6180橘子","110/07/29","兆豐證券",0,95,-95
"17493","6180橘子","110/07/29","花旗環球",25,0,25
"17494","6180橘子","110/07/29","香港上海匯豐",0,74,-74
"17495","6180橘子","110/07/29","瑞士信貸",26,2,24
"17496","6180橘子","110/07/29","福勝",0,24,-24
"17497","6180橘子","110/07/29","兆豐-大同",20,0,20
"17498","6180橘子","110/07/29","第一金-安和",0,20,-20
"17499","6180橘子","110/07/29","新光-台中",17,0,17
"17500","6180橘子","110/07/29","永豐金-敦北",0,18,-18
"17501","6180橘子","110/07/29","元大-南屯",15,0,15
"17502","6180橘子","110/07/29","致和-崇德",0,10,-10
"17503","6180橘子","110/07/29","摩根大通",54,40,14
"17504","6180橘子","110/07/29","玉山-台大",0,10,-10
"17505","6180橘子","110/07/29","玉山-桃園",10,0,10
"17506","6180橘子","110/07/29","元大-四維",0,10,-10
"17507","6180橘子","110/07/29","永豐金-中正",10,0,10
"17508","6180橘子","110/07/29","元大-小港",0,8,-8
"17509","6180橘子","110/07/29","元富-三重",8,0,8
"17510","6180橘子","110/07/29","台灣摩根士丹利",7,13,-6
"17511","6180橘子","110/07/29","國泰-新莊",9,1,8
"17512","6180橘子","110/07/29","群益金鼎-丹鳳",0,6,-6
"17513","6180橘子","110/07/29","元大-木柵",8,0,8
"17514","6180橘子","110/07/29","永豐金-南京",2,8,-6
"17515","6180橘子","110/07/29","國票-敦北法人",7,0,7
"17516","6180橘子","110/07/29","日盛-頭份",5,10,-5
"17517","6180橘子","110/07/29","元大證券",7,0,7
"17518","6180橘子","110/07/29","宏遠-高雄",0,5,-5
"17519","6180橘子","110/07/29","高橋",6,0,6
"17520","6180橘子","110/07/29","第一金-中山",1,5,-4
"17521","2390云辰","110/07/29","元大-永和",561,61,500
"17522","2390云辰","110/07/29","摩根大通",152,377,-225
"17523","2390云辰","110/07/29","台灣摩根士丹利",163,1,162
"17524","2390云辰","110/07/29","元富-同大",3,139,-136
"17525","2390云辰","110/07/29","元大-善化",87,0,87
"17526","2390云辰","110/07/29","豐農",3,128,-125
"17527","2390云辰","110/07/29","元大-草屯",89,6,83
"17528","2390云辰","110/07/29","美商高盛",6,88,-82
"17529","2390云辰","110/07/29","富邦-羅東",74,10,64
"17530","2390云辰","110/07/29","美林",43,112,-69
"17531","2390云辰","110/07/29","元大-鑫永和",61,1,60
"17532","2390云辰","110/07/29","元大-發財",4,61,-57
"17533","2390云辰","110/07/29","元富-高雄",93,40,53
"17534","2390云辰","110/07/29","大慶-泰山",0,51,-51
"17535","2390云辰","110/07/29","台新-左楠",43,1,42
"17536","2390云辰","110/07/29","群益金鼎",5,49,-44
"17537","2390云辰","110/07/29","日盛-永康",35,2,33
"17538","2390云辰","110/07/29","元大-松江",0,40,-40
"17539","2390云辰","110/07/29","玉山-板橋",37,5,32
"17540","2390云辰","110/07/29","統一-新台中",123,161,-38
"17541","2390云辰","110/07/29","日盛-板橋中山",45,15,30
"17542","2390云辰","110/07/29","兆豐-員林",0,35,-35
"17543","2390云辰","110/07/29","元大-大統",30,0,30
"17544","2390云辰","110/07/29","第一金-新竹",1,35,-34
"17545","2390云辰","110/07/29","元大-竹北",30,1,29
"17546","2390云辰","110/07/29","日盛-員林",3,33,-30
"17547","2390云辰","110/07/29","元大-北屯",26,0,26
"17548","2390云辰","110/07/29","新光",40,70,-30
"17549","2390云辰","110/07/29","元大-林園",25,0,25
"17550","2390云辰","110/07/29","永豐金-松山",21,49,-28
"17551","1471首利","110/07/28","美林",138,26,112
"17552","1471首利","110/07/28","玉山-台大",0,234,-234
"17553","1471首利","110/07/28","摩根大通",164,80,84
"17554","1471首利","110/07/28","國票-九鼎",0,149,-149
"17555","1471首利","110/07/28","(牛牛牛)亞-鑫豐",65,0,65
"17556","1471首利","110/07/28","台中銀",0,69,-69
"17557","1471首利","110/07/28","大昌-新店",44,0,44
"17558","1471首利","110/07/28","元大-博愛",0,32,-32
"17559","1471首利","110/07/28","玉山-桃園",69,30,39
"17560","1471首利","110/07/28","凱基-竹北",0,30,-30
"17561","1471首利","110/07/28","兆豐-鹿港",28,0,28
"17562","1471首利","110/07/28","富邦-苗栗",0,30,-30
"17563","1471首利","110/07/28","聯邦-高雄",21,0,21
"17564","1471首利","110/07/28","港商法國興業",0,22,-22
"17565","1471首利","110/07/28","永豐金-中正",21,0,21
"17566","1471首利","110/07/28","國票-安和",0,20,-20
"17567","1471首利","110/07/28","第一金-高雄",16,0,16
"17568","1471首利","110/07/28","華南永昌-苑裡",0,15,-15
"17569","1471首利","110/07/28","統一-桃園",13,0,13
"17570","1471首利","110/07/28","日盛-中壢",0,13,-13
"17571","1471首利","110/07/28","新光-台中",19,6,13
"17572","1471首利","110/07/28","玉山-台南",0,13,-13
"17573","1471首利","110/07/28","彰銀-七賢",11,0,11
"17574","1471首利","110/07/28","凱基-桃園",0,12,-12
"17575","1471首利","110/07/28","第一金-台南",11,0,11
"17576","1471首利","110/07/28","聯邦-雙和",0,11,-11
"17577","1471首利","110/07/28","台新證券",11,0,11
"17578","1471首利","110/07/28","統一-新營",0,10,-10
"17579","1471首利","110/07/28","凱基-東勢",11,0,11
"17580","1471首利","110/07/28","凱基-城中",0,10,-10
"17581","2883開發金","110/07/28","摩根大通",5171,647,4524
"17582","2883開發金","110/07/28","台灣摩根士丹利",921,11451,-10530
"17583","2883開發金","110/07/28","瑞士信貸",4234,62,4172
"17584","2883開發金","110/07/28","美商高盛",522,3615,-3093
"17585","2883開發金","110/07/28","國泰證券",2247,28,2219
"17586","2883開發金","110/07/28","(牛牛牛)亞證券",0,3000,-3000
"17587","2883開發金","110/07/28","元大證券",2306,91,2215
"17588","2883開發金","110/07/28","康和-仁愛",17,3004,-2987
"17589","2883開發金","110/07/28","元富-城東",2203,113,2090
"17590","2883開發金","110/07/28","第一金",18,2301,-2283
"17591","2883開發金","110/07/28","新加坡商瑞銀",1840,81,1759
"17592","2883開發金","110/07/28","凱基-台北",3735,5169,-1434
"17593","2883開發金","110/07/28","永豐金-彰化",1682,27,1655
"17594","2883開發金","110/07/28","宏遠-高雄",4,1420,-1416
"17595","2883開發金","110/07/28","日盛證券",1637,9,1628
"17596","2883開發金","110/07/28","亞東-板橋",507,1722,-1215
"17597","2883開發金","110/07/28","元大-彰化",1183,11,1172
"17598","2883開發金","110/07/28","凱基-豐中",32,1127,-1095
"17599","2883開發金","110/07/28","美林",2507,1378,1129
"17600","2883開發金","110/07/28","群益金鼎-三重",65,993,-928
"17601","2883開發金","110/07/28","華南永昌",1204,239,965
"17602","2883開發金","110/07/28","元大-羅東",30,872,-842
"17603","2883開發金","110/07/28","日盛-台南",816,6,810
"17604","2883開發金","110/07/28","花旗環球",188,1004,-816
"17605","2883開發金","110/07/28","台新-松江",722,40,682
"17606","2883開發金","110/07/28","華南永昌-朴子",33,716,-683
"17607","2883開發金","110/07/28","新光-台中",858,231,627
"17608","2883開發金","110/07/28","元大-永和",31,700,-669
"17609","2883開發金","110/07/28","凱基-員林",634,25,609
"17610","2883開發金","110/07/28","玉山-台南",97,738,-641
"17611","6205詮欣","110/07/28","臺銀",30,0,30
"17612","6205詮欣","110/07/28","台灣摩根士丹利",0,59,-59
"17613","6205詮欣","110/07/28","元大-善化",30,0,30
"17614","6205詮欣","110/07/28","凱基-大安",0,50,-50
"17615","6205詮欣","110/07/28","日盛證券",16,0,16
"17616","6205詮欣","110/07/28","元大-板橋",0,20,-20
"17617","6205詮欣","110/07/28","元大-土城學府",15,3,12
"17618","6205詮欣","110/07/28","摩根大通",17,30,-13
"17619","6205詮欣","110/07/28","臺銀-民權",10,0,10
"17620","6205詮欣","110/07/28","凱基-台北",0,11,-11
"17621","6205詮欣","110/07/28","德信-新營",10,0,10
"17622","6205詮欣","110/07/28","新加坡商瑞銀",0,10,-10
"17623","6205詮欣","110/07/28","福勝",10,0,10
"17624","6205詮欣","110/07/28","第一金-新竹",0,10,-10
"17625","6205詮欣","110/07/28","元大-清水",10,0,10
"17626","6205詮欣","110/07/28","台新-高雄",0,6,-6
"17627","6205詮欣","110/07/28","新光",9,0,9
"17628","6205詮欣","110/07/28","凱基-三多",0,6,-6
"17629","6205詮欣","110/07/28","群益金鼎-屏東",7,0,7
"17630","6205詮欣","110/07/28","美林",2,7,-5
"17631","6205詮欣","110/07/28","元大-汐止",6,0,6
"17632","6205詮欣","110/07/28","瑞士信貸",0,5,-5
"17633","6205詮欣","110/07/28","統一-屏東",5,0,5
"17634","6205詮欣","110/07/28","中國信託-三重",0,5,-5
"17635","6205詮欣","110/07/28","日盛-三重",4,0,4
"17636","6205詮欣","110/07/28","日盛-雙和",0,4,-4
"17637","6205詮欣","110/07/28","亞東-板橋",4,0,4
"17638","6205詮欣","110/07/28","宏遠-光隆",0,4,-4
"17639","6205詮欣","110/07/28","台中銀",4,0,4
"17640","6205詮欣","110/07/28","兆豐-新莊",0,4,-4
"17641","1540喬福","110/07/28","兆豐-北高雄",48,0,48
"17642","1540喬福","110/07/28","合庫-台中",1,60,-59
"17643","1540喬福","110/07/28","兆豐-台中港",33,0,33
"17644","1540喬福","110/07/28","凱基-台北",0,44,-44
"17645","1540喬福","110/07/28","大慶-中壢",19,0,19
"17646","1540喬福","110/07/28","元大-學甲",0,35,-35
"17647","1540喬福","110/07/28","富邦-員林",18,0,18
"17648","1540喬福","110/07/28","統一-新台中",0,26,-26
"17649","1540喬福","110/07/28","(牛牛牛)亞-鑫豐",12,0,12
"17650","1540喬福","110/07/28","新光-新竹",0,21,-21
"17651","1540喬福","110/07/28","元富-文心",10,0,10
"17652","1540喬福","110/07/28","富邦-台北",0,20,-20
"17653","1540喬福","110/07/28","光和-和美",10,0,10
"17654","1540喬福","110/07/28","富邦-南屯",0,20,-20
"17655","1540喬福","110/07/28","永豐金-三重",9,0,9
"17656","1540喬福","110/07/28","元大-鶯歌",0,10,-10
"17657","1540喬福","110/07/28","臺銀-鳳山",8,0,8
"17658","1540喬福","110/07/28","元大-豐原",0,7,-7
"17659","1540喬福","110/07/28","元大-斗六",7,0,7
"17660","1540喬福","110/07/28","大昌-樹林",0,6,-6
"17661","1540喬福","110/07/28","台新-台中",6,0,6
"17662","1540喬福","110/07/28","新光-桃園",0,5,-5
"17663","1540喬福","110/07/28","華南永昌-中正",6,0,6
"17664","1540喬福","110/07/28","凱基-站前",0,5,-5
"17665","1540喬福","110/07/28","永豐金-台中",6,0,6
"17666","1540喬福","110/07/28","臺銀",0,4,-4
"17667","1540喬福","110/07/28","臺銀-民權",5,0,5
"17668","1540喬福","110/07/28","台新證券",0,3,-3
"17669","1540喬福","110/07/28","元富-中原",5,0,5
"17670","1540喬福","110/07/28","台新-高雄",0,3,-3
"17671","2888新光金","110/07/28","臺銀-高雄",3050,3,3047
"17672","2888新光金","110/07/28","摩根大通",2543,11316,-8773
"17673","2888新光金","110/07/28","元富-城東",2019,129,1890
"17674","2888新光金","110/07/28","香港上海匯豐",120,7576,-7456
"17675","2888新光金","110/07/28","元大證券",2106,407,1699
"17676","2888新光金","110/07/28","凱基-台北",1641,5238,-3597
"17677","2888新光金","110/07/28","凱基-台南",1068,33,1035
"17678","2888新光金","110/07/28","新加坡商瑞銀",0,3572,-3572
"17679","2888新光金","110/07/28","彰銀-台中",1098,75,1023
"17680","2888新光金","110/07/28","台灣摩根士丹利",4358,7129,-2771
"17681","2888新光金","110/07/28","元富-城中",1003,0,1003
"17682","2888新光金","110/07/28","元大-大統",103,2853,-2750
"17683","2888新光金","110/07/28","元大-大天母",1113,119,994
"17684","2888新光金","110/07/28","光和",204,2235,-2031
"17685","2888新光金","110/07/28","元大-仁愛",761,1,760
"17686","2888新光金","110/07/28","兆豐-鹿港",80,1755,-1675
"17687","2888新光金","110/07/28","日盛-雙和",927,179,748
"17688","2888新光金","110/07/28","凱基-市政",17,1447,-1430
"17689","2888新光金","110/07/28","元大-大里",648,0,648
"17690","2888新光金","110/07/28","華南永昌-敦南",66,1320,-1254
"17691","2888新光金","110/07/28","凱基-竹科",2665,2026,639
"17692","2888新光金","110/07/28","法銀巴黎",195,1423,-1228
"17693","2888新光金","110/07/28","日盛-高雄",619,11,608
"17694","2888新光金","110/07/28","臺銀",123,1343,-1220
"17695","2888新光金","110/07/28","群益金鼎-海山",710,151,559
"17696","2888新光金","110/07/28","花旗環球",0,865,-865
"17697","2888新光金","110/07/28","台新證券",855,305,550
"17698","2888新光金","110/07/28","元大-鹿港",46,848,-802
"17699","2888新光金","110/07/28","國泰-敦南",774,237,537
"17700","2888新光金","110/07/28","合庫-台中",121,800,-679
"17701","1340勝悅","110/07/28","新光-台南",50,0,50
"17702","1340勝悅","110/07/28","兆豐-南京",0,25,-25
"17703","1340勝悅","110/07/28","臺銀-臺中",6,0,6
"17704","1340勝悅","110/07/28","凱基-台北",0,22,-22
"17705","1340勝悅","110/07/28","新光",6,0,6
"17706","1340勝悅","110/07/28","美林",0,12,-12
"17707","1340勝悅","110/07/28","臺灣企銀-埔墘",5,0,5
"17708","1340勝悅","110/07/28","群益金鼎-台中",0,11,-11
"17709","1340勝悅","110/07/28","國票-敦北法人",5,0,5
"17710","1340勝悅","110/07/28","合庫-西台中",1,10,-9
"17711","1340勝悅","110/07/28","國泰-高雄",5,0,5
"17712","1340勝悅","110/07/28","元大-基隆孝二",0,8,-8
"17713","1340勝悅","110/07/28","國泰-台中",5,0,5
"17714","1340勝悅","110/07/28","統一-城中",0,7,-7
"17715","1340勝悅","110/07/28","群益金鼎-館前",5,0,5
"17716","1340勝悅","110/07/28","凱基-幸福",0,7,-7
"17717","1340勝悅","110/07/28","中國信託-文心",3,0,3
"17718","1340勝悅","110/07/28","臺銀-新竹",0,5,-5
"17719","1340勝悅","110/07/28","群益金鼎-崇德",3,0,3
"17720","1340勝悅","110/07/28","港商法國興業",0,5,-5
"17721","1340勝悅","110/07/28","元大-永春",3,0,3
"17722","1340勝悅","110/07/28","元大-新竹經國",0,5,-5
"17723","1340勝悅","110/07/28","永豐金-松山",3,0,3
"17724","1340勝悅","110/07/28","台新證券",0,4,-4
"17725","1340勝悅","110/07/28","永豐金-嘉義",3,0,3
"17726","1340勝悅","110/07/28","港商野村",0,3,-3
"17727","1340勝悅","110/07/28","日盛-木柵",2,0,2
"17728","1340勝悅","110/07/28","摩根大通",0,3,-3
"17729","1340勝悅","110/07/28","台新-台中",2,0,2
"17730","1340勝悅","110/07/28","富邦-台北",0,3,-3
"17731","6246臺龍","110/07/28","元大-基隆孝二",32,0,32
"17732","6246臺龍","110/07/28","永豐金-桃園",4,135,-131
"17733","6246臺龍","110/07/28","合庫-台中",30,0,30
"17734","6246臺龍","110/07/28","港商野村",5,93,-88
"17735","6246臺龍","110/07/28","元大-木柵",30,0,30
"17736","6246臺龍","110/07/28","凱基-台北",9,65,-56
"17737","6246臺龍","110/07/28","光和",21,0,21
"17738","6246臺龍","110/07/28","元大-西螺",0,31,-31
"17739","6246臺龍","110/07/28","宏遠-民生",20,0,20
"17740","6246臺龍","110/07/28","群益金鼎-鳳山",0,27,-27
"17741","6246臺龍","110/07/28","第一金-安和",20,0,20
"17742","6246臺龍","110/07/28","元大-西屯",0,25,-25
"17743","6246臺龍","110/07/28","兆豐-竹北",24,4,20
"17744","6246臺龍","110/07/28","永豐金-虎尾",6,27,-21
"17745","6246臺龍","110/07/28","凱基-幸福",20,0,20
"17746","6246臺龍","110/07/28","日盛-台中",1,20,-19
"17747","6246臺龍","110/07/28","德信-新營",19,0,19
"17748","6246臺龍","110/07/28","統一",0,16,-16
"17749","6246臺龍","110/07/28","台新證券",21,4,17
"17750","6246臺龍","110/07/28","群益金鼎-土城",0,16,-16
"17751","6246臺龍","110/07/28","華南永昌-公誠",17,0,17
"17752","6246臺龍","110/07/28","元大-員林",0,15,-15
"17753","6246臺龍","110/07/28","中國信託-文心",15,0,15
"17754","6246臺龍","110/07/28","華南永昌-長虹",0,11,-11
"17755","6246臺龍","110/07/28","群益金鼎-崇德",15,0,15
"17756","6246臺龍","110/07/28","日盛-中壢",0,10,-10
"17757","6246臺龍","110/07/28","兆豐-公益",12,0,12
"17758","6246臺龍","110/07/28","第一金-彰化",0,10,-10
"17759","6246臺龍","110/07/28","國票",12,0,12
"17760","6246臺龍","110/07/28","元富-中原",0,10,-10
"17761","00715L期街口布蘭特正2","110/07/28","永豐金證券",5725,30,5695
"17762","00715L期街口布蘭特正2","110/07/28","元大-四維",0,2013,-2013
"17763","00715L期街口布蘭特正2","110/07/28","元大證券",5235,705,4530
"17764","00715L期街口布蘭特正2","110/07/28","凱基-豐中",0,1536,-1536
"17765","00715L期街口布蘭特正2","110/07/28","國票",2733,11,2722
"17766","00715L期街口布蘭特正2","110/07/28","華南永昌-東昇",0,1010,-1010
"17767","00715L期街口布蘭特正2","110/07/28","富邦證券",2340,417,1923
"17768","00715L期街口布蘭特正2","110/07/28","兆豐-三民",0,1004,-1004
"17769","00715L期街口布蘭特正2","110/07/28","凱基-台北",2241,325,1916
"17770","00715L期街口布蘭特正2","110/07/28","元富-古亭",0,600,-600
"17771","00715L期街口布蘭特正2","110/07/28","統一",1635,132,1503
"17772","00715L期街口布蘭特正2","110/07/28","台新-新營",20,558,-538
"17773","00715L期街口布蘭特正2","110/07/28","國票-中港",1500,0,1500
"17774","00715L期街口布蘭特正2","110/07/28","富邦-台北",0,453,-453
"17775","00715L期街口布蘭特正2","110/07/28","兆豐-台中",525,6,519
"17776","00715L期街口布蘭特正2","110/07/28","港商野村",71,519,-448
"17777","00715L期街口布蘭特正2","110/07/28","合庫證券",1008,500,508
"17778","00715L期街口布蘭特正2","110/07/28","第一金-自由",10,405,-395
"17779","00715L期街口布蘭特正2","110/07/28","永豐金-三重",500,0,500
"17780","00715L期街口布蘭特正2","110/07/28","玉山-高雄",17,387,-370
"17781","00715L期街口布蘭特正2","110/07/28","凱基-市政",500,1,499
"17782","00715L期街口布蘭特正2","110/07/28","統一-桃園",0,331,-331
"17783","00715L期街口布蘭特正2","110/07/28","元富-大裕",500,8,492
"17784","00715L期街口布蘭特正2","110/07/28","元富-中壢",0,309,-309
"17785","00715L期街口布蘭特正2","110/07/28","永豐金-內湖",503,18,485
"17786","00715L期街口布蘭特正2","110/07/28","台新證券",21,329,-308
"17787","00715L期街口布蘭特正2","110/07/28","元富-吉利",280,0,280
"17788","00715L期街口布蘭特正2","110/07/28","國票-台中",0,275,-275
"17789","00715L期街口布蘭特正2","110/07/28","國票-博愛",200,0,200
"17790","00715L期街口布蘭特正2","110/07/28","日盛-木柵",0,268,-268
"17791","8941關中","110/07/28","第一金-台南",2,0,2
"17792","8941關中","110/07/28","聯邦-富強",0,3,-3
"17793","8941關中","110/07/28","元大-西屯",2,0,2
"17794","8941關中","110/07/28","富邦-員林",0,3,-3
"17795","8941關中","110/07/28","玉山證券",1,0,1
"17796","8941關中","110/07/28","第一金-安和",0,2,-2
"17797","8941關中","110/07/28","國泰-忠孝",1,0,1
"17798","8941關中","110/07/28","第一金-台中",0,1,-1
"17799","8941關中","110/07/28","凱基-岡山",1,0,1
"17800","8941關中","110/07/28","玉山-台中",0,0,0
"17801","8941關中","110/07/28","富邦-羅東",1,0,1
"17802","8941關中","110/07/28","元大-新竹經國",0,0,0
"17803","8941關中","110/07/28","永豐金-敦南",1,0,1
"17804","8941關中","110/07/28","元大-桃興",1,1,0
"17805","8941關中","110/07/28","玉山-台中",0,0,0
"17806","8941關中","110/07/28","",NA,NA,NA
"17807","8941關中","110/07/28","元大-新竹經國",0,0,0
"17808","8941關中","110/07/28","",NA,NA,NA
"17809","8941關中","110/07/28","元大-桃興",1,1,0
"17810","8941關中","110/07/28","",NA,NA,NA
"17811","8941關中","110/07/28","",NA,NA,NA
"17812","8941關中","110/07/28","",NA,NA,NA
"17813","8941關中","110/07/28","",NA,NA,NA
"17814","8941關中","110/07/28","",NA,NA,NA
"17815","8941關中","110/07/28","",NA,NA,NA
"17816","8941關中","110/07/28","",NA,NA,NA
"17817","8941關中","110/07/28","",NA,NA,NA
"17818","8941關中","110/07/28","",NA,NA,NA
"17819","8941關中","110/07/28","",NA,NA,NA
"17820","8941關中","110/07/28","",NA,NA,NA
"17821","8936國統","110/07/28","宏遠-高雄",141,1,140
"17822","8936國統","110/07/28","摩根大通",82,517,-435
"17823","8936國統","110/07/28","日盛-景美",100,0,100
"17824","8936國統","110/07/28","凱基-台北",5,290,-285
"17825","8936國統","110/07/28","永豐金-苓雅",67,0,67
"17826","8936國統","110/07/28","瑞士信貸",0,245,-245
"17827","8936國統","110/07/28","玉山-台南",64,0,64
"17828","8936國統","110/07/28","台灣摩根士丹利",16,176,-160
"17829","8936國統","110/07/28","國票-北高雄",61,1,60
"17830","8936國統","110/07/28","凱基-市政",11,110,-99
"17831","8936國統","110/07/28","玉山-高雄",49,0,49
"17832","8936國統","110/07/28","元大-東蘆",0,82,-82
"17833","8936國統","110/07/28","元大-小港",47,0,47
"17834","8936國統","110/07/28","新加坡商瑞銀",128,205,-77
"17835","8936國統","110/07/28","元大-台中",40,0,40
"17836","8936國統","110/07/28","元大-歸仁",30,75,-45
"17837","8936國統","110/07/28","新光-台中",41,7,34
"17838","8936國統","110/07/28","台新-台中",17,55,-38
"17839","8936國統","110/07/28","元大-豐原站前",32,0,32
"17840","8936國統","110/07/28","康和",20,58,-38
"17841","8936國統","110/07/28","玉山-台中",31,0,31
"17842","8936國統","110/07/28","第一金-新興",0,31,-31
"17843","8936國統","110/07/28","富邦-高雄",26,0,26
"17844","8936國統","110/07/28","元富-松德",0,30,-30
"17845","8936國統","110/07/28","元大-鳳中",30,5,25
"17846","8936國統","110/07/28","元大-中和",2,30,-28
"17847","8936國統","110/07/28","元富-林園",20,0,20
"17848","8936國統","110/07/28","兆豐-嘉義",0,22,-22
"17849","8936國統","110/07/28","兆豐-北高雄",20,0,20
"17850","8936國統","110/07/28","美林",11,32,-21
"17851","6226光鼎","110/07/28","群益金鼎-萬華",147,14,133
"17852","6226光鼎","110/07/28","群益金鼎-敦南",5,282,-277
"17853","6226光鼎","110/07/28","台新-台中",227,114,113
"17854","6226光鼎","110/07/28","華南永昌",19,142,-123
"17855","6226光鼎","110/07/28","摩根大通",109,0,109
"17856","6226光鼎","110/07/28","康和-台北",0,100,-100
"17857","6226光鼎","110/07/28","統一",107,0,107
"17858","6226光鼎","110/07/28","臺銀-民權",4,100,-96
"17859","6226光鼎","110/07/28","凱基-台北",103,1,102
"17860","6226光鼎","110/07/28","元大-潮州",11,102,-91
"17861","6226光鼎","110/07/28","台灣摩根士丹利",104,7,97
"17862","6226光鼎","110/07/28","華南永昌-嘉義",50,130,-80
"17863","6226光鼎","110/07/28","群益金鼎-館前",97,0,97
"17864","6226光鼎","110/07/28","台新證券",79,153,-74
"17865","6226光鼎","110/07/28","國泰-台中",97,20,77
"17866","6226光鼎","110/07/28","玉山-台南",4,74,-70
"17867","6226光鼎","110/07/28","元大-嘉義",83,16,67
"17868","6226光鼎","110/07/28","臺銀-臺中",6,65,-59
"17869","6226光鼎","110/07/28","新光-桃園",69,8,61
"17870","6226光鼎","110/07/28","富邦-仁愛",6,63,-57
"17871","6226光鼎","110/07/28","群益金鼎-三重",59,2,57
"17872","6226光鼎","110/07/28","凱基-大里",0,51,-51
"17873","6226光鼎","110/07/28","日盛-員林",63,12,51
"17874","6226光鼎","110/07/28","國泰-敦南",116,166,-50
"17875","6226光鼎","110/07/28","永豐金-松山",66,20,46
"17876","6226光鼎","110/07/28","元富-中港",2,51,-49
"17877","6226光鼎","110/07/28","統一-內湖",48,7,41
"17878","6226光鼎","110/07/28","群益金鼎-延平",0,49,-49
"17879","6226光鼎","110/07/28","凱基-高美館",51,10,41
"17880","6226光鼎","110/07/28","元大-新竹經國",5,53,-48
"17881","2363矽統","110/07/28","摩根大通",809,282,527
"17882","2363矽統","110/07/28","國泰-敦南",145,861,-716
"17883","2363矽統","110/07/28","美商高盛",532,264,268
"17884","2363矽統","110/07/28","元大-台中",18,384,-366
"17885","2363矽統","110/07/28","台新-三民",263,18,245
"17886","2363矽統","110/07/28","新光",197,525,-328
"17887","2363矽統","110/07/28","台新證券",929,703,226
"17888","2363矽統","110/07/28","群益金鼎-三民",24,266,-242
"17889","2363矽統","110/07/28","第一金-嘉義",154,0,154
"17890","2363矽統","110/07/28","凱基-斗六",0,187,-187
"17891","2363矽統","110/07/28","凱基-台北",1039,889,150
"17892","2363矽統","110/07/28","元大-上新莊",3,134,-131
"17893","2363矽統","110/07/28","永豐金-竹科",132,11,121
"17894","2363矽統","110/07/28","永豐金-彰化",5,134,-129
"17895","2363矽統","110/07/28","華南永昌-鳳山",146,34,112
"17896","2363矽統","110/07/28","日盛-二林",15,142,-127
"17897","2363矽統","110/07/28","第一金-新興",108,1,107
"17898","2363矽統","110/07/28","元大證券",18,125,-107
"17899","2363矽統","110/07/28","港商野村",673,568,105
"17900","2363矽統","110/07/28","新光-台南",25,129,-104
"17901","2363矽統","110/07/28","群益金鼎-桃園",111,11,100
"17902","2363矽統","110/07/28","統一",7,109,-102
"17903","2363矽統","110/07/28","台新-左楠",94,15,79
"17904","2363矽統","110/07/28","康和-南崁",11,108,-97
"17905","2363矽統","110/07/28","新加坡商瑞銀",789,711,78
"17906","2363矽統","110/07/28","國票",25,121,-96
"17907","2363矽統","110/07/28","國票-九鼎",99,26,73
"17908","2363矽統","110/07/28","群益金鼎-敦南",11,107,-96
"17909","2363矽統","110/07/28","兆豐-埔墘",62,0,62
"17910","2363矽統","110/07/28","兆豐-寶成",2,79,-77
"17911","8112至上","110/07/28","摩根大通",630,183,447
"17912","8112至上","110/07/28","永豐金-永康",0,242,-242
"17913","8112至上","110/07/28","合庫證券",317,21,296
"17914","8112至上","110/07/28","高橋",3,222,-219
"17915","8112至上","110/07/28","新加坡商瑞銀",417,132,285
"17916","8112至上","110/07/28","玉山證券",2,206,-204
"17917","8112至上","110/07/28","台灣摩根士丹利",253,58,195
"17918","8112至上","110/07/28","新光",50,206,-156
"17919","8112至上","110/07/28","港商野村",350,164,186
"17920","8112至上","110/07/28","永豐金-苓雅",2,102,-100
"17921","8112至上","110/07/28","美商高盛",184,7,177
"17922","8112至上","110/07/28","凱基-永和",0,80,-80
"17923","8112至上","110/07/28","美林",213,53,160
"17924","8112至上","110/07/28","華南永昌-新莊",60,134,-74
"17925","8112至上","110/07/28","花旗環球",86,16,70
"17926","8112至上","110/07/28","台新-松江",27,90,-63
"17927","8112至上","110/07/28","玉山-板橋",82,17,65
"17928","8112至上","110/07/28","宏遠證券",1,50,-49
"17929","8112至上","110/07/28","凱基-竹科",67,3,64
"17930","8112至上","110/07/28","元大-苑裡",23,72,-49
"17931","8112至上","110/07/28","元大-府城",56,0,56
"17932","8112至上","110/07/28","元大-基隆孝二",5,53,-48
"17933","8112至上","110/07/28","永豐金-內湖",37,0,37
"17934","8112至上","110/07/28","康和-仁愛",5,51,-46
"17935","8112至上","110/07/28","瑞士信貸",58,26,32
"17936","8112至上","110/07/28","台新證券",31,73,-42
"17937","8112至上","110/07/28","元大證券",60,29,31
"17938","8112至上","110/07/28","兆豐-公益",0,40,-40
"17939","8112至上","110/07/28","元富-新店",35,5,30
"17940","8112至上","110/07/28","中國信託-忠孝",1,37,-36
"17941","1570力肯","110/07/28","國泰-敦南",50,0,50
"17942","1570力肯","110/07/28","元大-高雄",0,42,-42
"17943","1570力肯","110/07/28","群益金鼎-高雄",31,0,31
"17944","1570力肯","110/07/28","國票-新莊",0,14,-14
"17945","1570力肯","110/07/28","元富-延平",15,0,15
"17946","1570力肯","110/07/28","凱基-站前",0,10,-10
"17947","1570力肯","110/07/28","(牛牛牛)亞-鑫豐",10,0,10
"17948","1570力肯","110/07/28","凱基-台北",0,10,-10
"17949","1570力肯","110/07/28","元富-緯城",6,0,6
"17950","1570力肯","110/07/28","元大-忠孝",0,10,-10
"17951","1570力肯","110/07/28","合庫-自強",5,0,5
"17952","1570力肯","110/07/28","台灣摩根士丹利",0,9,-9
"17953","1570力肯","110/07/28","臺銀-臺南",4,0,4
"17954","1570力肯","110/07/28","群益金鼎-板橋",0,8,-8
"17955","1570力肯","110/07/28","兆豐-台中港",3,0,3
"17956","1570力肯","110/07/28","永豐金-大園",0,7,-7
"17957","1570力肯","110/07/28","日盛-板橋",2,0,2
"17958","1570力肯","110/07/28","元大-台南",0,5,-5
"17959","1570力肯","110/07/28","統一-松江",2,0,2
"17960","1570力肯","110/07/28","合庫-台中",0,4,-4
"17961","1570力肯","110/07/28","台新-三民",2,0,2
"17962","1570力肯","110/07/28","富邦-板橋",0,3,-3
"17963","1570力肯","110/07/28","群益金鼎-土城",2,0,2
"17964","1570力肯","110/07/28","元大-板橋",0,3,-3
"17965","1570力肯","110/07/28","元大-和平",2,0,2
"17966","1570力肯","110/07/28","統一-桃園",0,2,-2
"17967","1570力肯","110/07/28","元大-土城永寧",2,0,2
"17968","1570力肯","110/07/28","凱基-三多",0,2,-2
"17969","1570力肯","110/07/28","大昌-樹林",1,0,1
"17970","1570力肯","110/07/28","華南永昌-高雄",0,2,-2
"17971","2929淘帝","110/07/28","日盛-八德",40,0,40
"17972","2929淘帝","110/07/28","凱基-林口",0,150,-150
"17973","2929淘帝","110/07/28","玉山-新竹",30,0,30
"17974","2929淘帝","110/07/28","日盛-台中",0,35,-35
"17975","2929淘帝","110/07/28","國泰-松江",33,3,30
"17976","2929淘帝","110/07/28","永豐金-永康",0,21,-21
"17977","2929淘帝","110/07/28","元大-民生",28,0,28
"17978","2929淘帝","110/07/28","新加坡商瑞銀",13,32,-19
"17979","2929淘帝","110/07/28","合庫-高雄",21,0,21
"17980","2929淘帝","110/07/28","國泰-敦南",2,20,-18
"17981","2929淘帝","110/07/28","華南永昌",20,0,20
"17982","2929淘帝","110/07/28","臺銀",2,17,-15
"17983","2929淘帝","110/07/28","台新證券",12,0,12
"17984","2929淘帝","110/07/28","群益金鼎-敦南",0,13,-13
"17985","2929淘帝","110/07/28","第一金-大稻埕",10,0,10
"17986","2929淘帝","110/07/28","富邦-建國",1,13,-12
"17987","2929淘帝","110/07/28","華南永昌-台中",10,0,10
"17988","2929淘帝","110/07/28","元富-城東",0,10,-10
"17989","2929淘帝","110/07/28","元大-士林",10,0,10
"17990","2929淘帝","110/07/28","兆豐-景美",0,8,-8
"17991","2929淘帝","110/07/28","元大-屏南",10,0,10
"17992","2929淘帝","110/07/28","美林",3,10,-7
"17993","2929淘帝","110/07/28","元大-員林",10,0,10
"17994","2929淘帝","110/07/28","元富-彰化",0,7,-7
"17995","2929淘帝","110/07/28","新光-桃園",9,0,9
"17996","2929淘帝","110/07/28","港商法國興業",0,6,-6
"17997","2929淘帝","110/07/28","日盛-景美",7,0,7
"17998","2929淘帝","110/07/28","新光-高雄",0,6,-6
"17999","2929淘帝","110/07/28","玉山證券",7,0,7
"18000","2929淘帝","110/07/28","港商野村",3,8,-5
"18001","5410國眾","110/07/28","兆豐-城中",38,0,38
"18002","5410國眾","110/07/28","兆豐-南門",3,80,-77
"18003","5410國眾","110/07/28","大展",20,0,20
"18004","5410國眾","110/07/28","摩根大通",12,56,-44
"18005","5410國眾","110/07/28","新光-桃園",20,0,20
"18006","5410國眾","110/07/28","凱基-台北",0,28,-28
"18007","5410國眾","110/07/28","凱基-竹北",20,0,20
"18008","5410國眾","110/07/28","亞東-板橋",0,20,-20
"18009","5410國眾","110/07/28","元大-新莊",17,0,17
"18010","5410國眾","110/07/28","統一-新台中",0,20,-20
"18011","5410國眾","110/07/28","新光",20,8,12
"18012","5410國眾","110/07/28","瑞士信貸",0,16,-16
"18013","5410國眾","110/07/28","國泰-敦南",11,0,11
"18014","5410國眾","110/07/28","新加坡商瑞銀",0,15,-15
"18015","5410國眾","110/07/28","日盛-內湖",10,0,10
"18016","5410國眾","110/07/28","統一-金門",0,15,-15
"18017","5410國眾","110/07/28","元富-新竹",10,0,10
"18018","5410國眾","110/07/28","元大-北投",0,12,-12
"18019","5410國眾","110/07/28","群益金鼎-永和",10,0,10
"18020","5410國眾","110/07/28","新百王",0,10,-10
"18021","5410國眾","110/07/28","華南永昌-中正",10,0,10
"18022","5410國眾","110/07/28","元大-館前",0,10,-10
"18023","5410國眾","110/07/28","元大-旗山",10,0,10
"18024","5410國眾","110/07/28","元富-安南",0,9,-9
"18025","5410國眾","110/07/28","元大-大天母",10,0,10
"18026","5410國眾","110/07/28","元大-龍潭",1,10,-9
"18027","5410國眾","110/07/28","大昌",9,0,9
"18028","5410國眾","110/07/28","港商野村",1,7,-6
"18029","5410國眾","110/07/28","臺銀-鳳山",8,0,8
"18030","5410國眾","110/07/28","元大-東泰",0,6,-6
"18031","2841台開","110/07/28","台新-台中",36,0,36
"18032","2841台開","110/07/28","元大-大雅",0,90,-90
"18033","2841台開","110/07/28","群益金鼎-大甲",24,0,24
"18034","2841台開","110/07/28","凱基-台北",0,73,-73
"18035","2841台開","110/07/28","永豐金-敦南",29,8,21
"18036","2841台開","110/07/28","港商野村",0,27,-27
"18037","2841台開","110/07/28","第一金-台中",20,0,20
"18038","2841台開","110/07/28","大慶-富順",0,20,-20
"18039","2841台開","110/07/28","元富-烏日",20,0,20
"18040","2841台開","110/07/28","豐農",0,17,-17
"18041","2841台開","110/07/28","元大-歸仁",20,0,20
"18042","2841台開","110/07/28","元大-大里德芳",0,15,-15
"18043","2841台開","110/07/28","永豐金-豐原",20,0,20
"18044","2841台開","110/07/28","日盛-大墩",0,10,-10
"18045","2841台開","110/07/28","日盛-花蓮",15,0,15
"18046","2841台開","110/07/28","元大-博愛",0,10,-10
"18047","2841台開","110/07/28","大昌-安康",18,3,15
"18048","2841台開","110/07/28","元大-豐原站前",0,10,-10
"18049","2841台開","110/07/28","陽信-石牌",13,0,13
"18050","2841台開","110/07/28","台新證券",6,13,-7
"18051","2841台開","110/07/28","台灣摩根士丹利",10,0,10
"18052","2841台開","110/07/28","台中銀",0,5,-5
"18053","2841台開","110/07/28","台新-高雄",10,0,10
"18054","2841台開","110/07/28","中國信託-中壢",0,5,-5
"18055","2841台開","110/07/28","國泰-忠孝",10,0,10
"18056","2841台開","110/07/28","元大-大同",0,5,-5
"18057","2841台開","110/07/28","元大-竹南",10,0,10
"18058","2841台開","110/07/28","元大-大益",0,4,-4
"18059","2841台開","110/07/28","元大-屏南",9,0,9
"18060","2841台開","110/07/28","元富-松德",0,3,-3
"18061","6207雷科","110/07/28","新加坡商瑞銀",153,44,109
"18062","6207雷科","110/07/28","康和-延平",0,48,-48
"18063","6207雷科","110/07/28","摩根大通",219,131,88
"18064","6207雷科","110/07/28","元富-大昌",0,33,-33
"18065","6207雷科","110/07/28","康和-台中",70,0,70
"18066","6207雷科","110/07/28","聯邦商銀",0,30,-30
"18067","6207雷科","110/07/28","凱基-台北",112,49,63
"18068","6207雷科","110/07/28","兆豐-三民",1,30,-29
"18069","6207雷科","110/07/28","凱基-復興",63,3,60
"18070","6207雷科","110/07/28","元大-龍潭",0,25,-25
"18071","6207雷科","110/07/28","群益金鼎-三民",59,8,51
"18072","6207雷科","110/07/28","宏遠證券",0,23,-23
"18073","6207雷科","110/07/28","永豐金-羅東",50,0,50
"18074","6207雷科","110/07/28","大昌-桃園",15,36,-21
"18075","6207雷科","110/07/28","美林",46,3,43
"18076","6207雷科","110/07/28","國泰-桃園",0,21,-21
"18077","6207雷科","110/07/28","群益金鼎-敦南",51,16,35
"18078","6207雷科","110/07/28","凱基-中壢",0,21,-21
"18079","6207雷科","110/07/28","日盛-忠孝",31,0,31
"18080","6207雷科","110/07/28","富邦-台北",4,24,-20
"18081","6207雷科","110/07/28","港商野村",32,8,24
"18082","6207雷科","110/07/28","臺銀-臺南",0,19,-19
"18083","6207雷科","110/07/28","群益金鼎-東門",22,0,22
"18084","6207雷科","110/07/28","新光",5,24,-19
"18085","6207雷科","110/07/28","統一-高雄",41,20,21
"18086","6207雷科","110/07/28","群益金鼎-大甲",1,20,-19
"18087","6207雷科","110/07/28","群益金鼎-延平",21,0,21
"18088","6207雷科","110/07/28","元大-中壢",10,28,-18
"18089","6207雷科","110/07/28","彰銀-台中",20,0,20
"18090","6207雷科","110/07/28","永豐金-北高雄",3,20,-17
"18091","3679新至陞","110/07/28","華南永昌-淡水",10,0,10
"18092","3679新至陞","110/07/28","瑞士信貸",0,25,-25
"18093","3679新至陞","110/07/28","富邦-嘉義",10,0,10
"18094","3679新至陞","110/07/28","凱基-台北",6,14,-8
"18095","3679新至陞","110/07/28","台中銀-員林",11,2,9
"18096","3679新至陞","110/07/28","美林",5,12,-7
"18097","3679新至陞","110/07/28","大昌-樹林",7,0,7
"18098","3679新至陞","110/07/28","摩根大通",5,11,-6
"18099","3679新至陞","110/07/28","康和-澎湖",5,0,5
"18100","3679新至陞","110/07/28","兆豐-新莊",0,5,-5
"18101","3679新至陞","110/07/28","富邦-台北",5,0,5
"18102","3679新至陞","110/07/28","群益金鼎-新莊",0,5,-5
"18103","3679新至陞","110/07/28","元大-成功",5,0,5
"18104","3679新至陞","110/07/28","台灣摩根士丹利",0,4,-4
"18105","3679新至陞","110/07/28","新加坡商瑞銀",3,0,3
"18106","3679新至陞","110/07/28","日盛-新竹",0,3,-3
"18107","3679新至陞","110/07/28","中國信託-新竹",3,0,3
"18108","3679新至陞","110/07/28","群益金鼎-東門",0,3,-3
"18109","3679新至陞","110/07/28","元大-新莊",3,0,3
"18110","3679新至陞","110/07/28","元大證券",0,3,-3
"18111","3679新至陞","110/07/28","宏遠-光隆",2,0,2
"18112","3679新至陞","110/07/28","元大-忠孝",0,3,-3
"18113","3679新至陞","110/07/28","大慶-蘆洲",2,0,2
"18114","3679新至陞","110/07/28","合庫-西台中",0,2,-2
"18115","3679新至陞","110/07/28","台新-左楠",2,0,2
"18116","3679新至陞","110/07/28","日盛-板橋",0,2,-2
"18117","3679新至陞","110/07/28","群益金鼎-三重",2,0,2
"18118","3679新至陞","110/07/28","國票-桃園",0,2,-2
"18119","3679新至陞","110/07/28","華南永昌-高雄",2,0,2
"18120","3679新至陞","110/07/28","台新-台南",0,2,-2
"18121","2727王品","110/07/28","凱基-台北",139,50,89
"18122","2727王品","110/07/28","新光-台中",9,68,-59
"18123","2727王品","110/07/28","美林",77,10,67
"18124","2727王品","110/07/28","瑞士信貸",16,54,-38
"18125","2727王品","110/07/28","港商野村",118,64,54
"18126","2727王品","110/07/28","華南永昌",4,41,-37
"18127","2727王品","110/07/28","國泰-敦南",51,30,21
"18128","2727王品","110/07/28","美商高盛",2,30,-28
"18129","2727王品","110/07/28","新加坡商瑞銀",58,38,20
"18130","2727王品","110/07/28","富邦-板橋",17,38,-21
"18131","2727王品","110/07/28","永豐金-中盛",24,4,20
"18132","2727王品","110/07/28","富邦-竹北",0,20,-20
"18133","2727王品","110/07/28","元大-南崁",20,2,18
"18134","2727王品","110/07/28","元大-小港",1,21,-20
"18135","2727王品","110/07/28","摩根大通",48,32,16
"18136","2727王品","110/07/28","凱基",0,18,-18
"18137","2727王品","110/07/28","臺銀-高雄",14,0,14
"18138","2727王品","110/07/28","統一",15,31,-16
"18139","2727王品","110/07/28","永豐金-桃盛",19,5,14
"18140","2727王品","110/07/28","國泰-台中",12,28,-16
"18141","2727王品","110/07/28","凱基-內湖",13,0,13
"18142","2727王品","110/07/28","元大-台中",7,22,-15
"18143","2727王品","110/07/28","永豐金-中正",15,2,13
"18144","2727王品","110/07/28","華南永昌-麻豆",0,14,-14
"18145","2727王品","110/07/28","富邦-建國",18,7,11
"18146","2727王品","110/07/28","永豐金-豐原",1,15,-14
"18147","2727王品","110/07/28","富邦-陽明",15,5,10
"18148","2727王品","110/07/28","國票-內壢",1,14,-13
"18149","2727王品","110/07/28","元大-南京",10,0,10
"18150","2727王品","110/07/28","永豐金證券",2,15,-13
"18151","1570力肯","110/07/28","國泰-敦南",50,0,50
"18152","1570力肯","110/07/28","元大-高雄",0,42,-42
"18153","1570力肯","110/07/28","群益金鼎-高雄",31,0,31
"18154","1570力肯","110/07/28","國票-新莊",0,14,-14
"18155","1570力肯","110/07/28","元富-延平",15,0,15
"18156","1570力肯","110/07/28","凱基-站前",0,10,-10
"18157","1570力肯","110/07/28","(牛牛牛)亞-鑫豐",10,0,10
"18158","1570力肯","110/07/28","凱基-台北",0,10,-10
"18159","1570力肯","110/07/28","元富-緯城",6,0,6
"18160","1570力肯","110/07/28","元大-忠孝",0,10,-10
"18161","1570力肯","110/07/28","合庫-自強",5,0,5
"18162","1570力肯","110/07/28","台灣摩根士丹利",0,9,-9
"18163","1570力肯","110/07/28","臺銀-臺南",4,0,4
"18164","1570力肯","110/07/28","群益金鼎-板橋",0,8,-8
"18165","1570力肯","110/07/28","兆豐-台中港",3,0,3
"18166","1570力肯","110/07/28","永豐金-大園",0,7,-7
"18167","1570力肯","110/07/28","日盛-板橋",2,0,2
"18168","1570力肯","110/07/28","元大-台南",0,5,-5
"18169","1570力肯","110/07/28","統一-松江",2,0,2
"18170","1570力肯","110/07/28","合庫-台中",0,4,-4
"18171","1570力肯","110/07/28","台新-三民",2,0,2
"18172","1570力肯","110/07/28","富邦-板橋",0,3,-3
"18173","1570力肯","110/07/28","群益金鼎-土城",2,0,2
"18174","1570力肯","110/07/28","元大-板橋",0,3,-3
"18175","1570力肯","110/07/28","元大-和平",2,0,2
"18176","1570力肯","110/07/28","統一-桃園",0,2,-2
"18177","1570力肯","110/07/28","元大-土城永寧",2,0,2
"18178","1570力肯","110/07/28","凱基-三多",0,2,-2
"18179","1570力肯","110/07/28","大昌-樹林",1,0,1
"18180","1570力肯","110/07/28","華南永昌-高雄",0,2,-2
"18181","6180橘子","110/07/28","凱基-台北",152,85,67
"18182","6180橘子","110/07/28","摩根大通",20,92,-72
"18183","6180橘子","110/07/28","新光",57,18,39
"18184","6180橘子","110/07/28","大慶-台中",0,33,-33
"18185","6180橘子","110/07/28","美商高盛",49,12,37
"18186","6180橘子","110/07/28","兆豐證券",0,25,-25
"18187","6180橘子","110/07/28","第一金-安和",20,0,20
"18188","6180橘子","110/07/28","元大-上新莊",0,22,-22
"18189","6180橘子","110/07/28","元富-桃園",20,0,20
"18190","6180橘子","110/07/28","新加坡商瑞銀",23,44,-21
"18191","6180橘子","110/07/28","第一金-員林",19,0,19
"18192","6180橘子","110/07/28","富邦-內湖",0,21,-21
"18193","6180橘子","110/07/28","富邦-嘉義",22,4,18
"18194","6180橘子","110/07/28","第一金-新興",0,20,-20
"18195","6180橘子","110/07/28","統一-嘉義",16,0,16
"18196","6180橘子","110/07/28","臺銀-臺南",5,22,-17
"18197","6180橘子","110/07/28","國票-九鼎",15,0,15
"18198","6180橘子","110/07/28","第一金-忠孝",0,10,-10
"18199","6180橘子","110/07/28","華南永昌-朴子",14,0,14
"18200","6180橘子","110/07/28","元富-屏東",0,10,-10
"18201","6180橘子","110/07/28","群益金鼎-台南",13,0,13
"18202","6180橘子","110/07/28","凱基-八德",1,11,-10
"18203","6180橘子","110/07/28","富邦-建國",13,1,12
"18204","6180橘子","110/07/28","元大-和平",1,11,-10
"18205","6180橘子","110/07/28","富邦-板橋",16,5,11
"18206","6180橘子","110/07/28","元大-台中中港",0,10,-10
"18207","6180橘子","110/07/28","元富-新店",10,0,10
"18208","6180橘子","110/07/28","元大-南屯",0,9,-9
"18209","6180橘子","110/07/28","元大-台南",10,0,10
"18210","6180橘子","110/07/28","永豐金-屏東",0,9,-9
"18211","2390云辰","110/07/28","摩根大通",1589,780,809
"18212","2390云辰","110/07/28","華南永昌-鳳山",34,290,-256
"18213","2390云辰","110/07/28","凱基-台北",457,300,157
"18214","2390云辰","110/07/28","凱基-基隆",0,224,-224
"18215","2390云辰","110/07/28","美林",330,206,124
"18216","2390云辰","110/07/28","元富-高雄",56,177,-121
"18217","2390云辰","110/07/28","元富-同大",159,35,124
"18218","2390云辰","110/07/28","元富-中港",1,100,-99
"18219","2390云辰","110/07/28","台灣摩根士丹利",193,71,122
"18220","2390云辰","110/07/28","兆豐-公益",4,100,-96
"18221","2390云辰","110/07/28","元大-前金",150,49,101
"18222","2390云辰","110/07/28","統一-新台中",180,274,-94
"18223","2390云辰","110/07/28","永豐金-鳳山",110,18,92
"18224","2390云辰","110/07/28","日盛-新莊",4,76,-72
"18225","2390云辰","110/07/28","元大-林園",99,11,88
"18226","2390云辰","110/07/28","永豐金-新店",0,57,-57
"18227","2390云辰","110/07/28","元大-信義",121,35,86
"18228","2390云辰","110/07/28","華南永昌-內壢",0,56,-56
"18229","2390云辰","110/07/28","美商高盛",206,123,83
"18230","2390云辰","110/07/28","第一金-豐原",9,63,-54
"18231","2390云辰","110/07/28","統一-城中",101,37,64
"18232","2390云辰","110/07/28","華南永昌-中正",13,67,-54
"18233","2390云辰","110/07/28","元大-竹山",75,20,55
"18234","2390云辰","110/07/28","元大-大益",7,59,-52
"18235","2390云辰","110/07/28","豐農",79,25,54
"18236","2390云辰","110/07/28","大慶",0,50,-50
"18237","2390云辰","110/07/28","新加坡商瑞銀",68,15,53
"18238","2390云辰","110/07/28","凱基-豐中",3,49,-46
"18239","2390云辰","110/07/28","統一-屏東",54,5,49
"18240","2390云辰","110/07/28","元大-彰化民生",7,51,-44
"18241","1471首利","110/07/27","永全-八德",50,0,50
"18242","1471首利","110/07/27","國票-九鼎",0,306,-306
"18243","1471首利","110/07/27","中國信託-松江",48,0,48
"18244","1471首利","110/07/27","兆豐-天母",1,115,-114
"18245","1471首利","110/07/27","富邦-嘉義",40,0,40
"18246","1471首利","110/07/27","美林",0,42,-42
"18247","1471首利","110/07/27","富邦-台南",33,0,33
"18248","1471首利","110/07/27","摩根大通",45,75,-30
"18249","1471首利","110/07/27","(牛牛牛)亞-鑫豐",32,0,32
"18250","1471首利","110/07/27","凱基-八德",0,30,-30
"18251","1471首利","110/07/27","台灣企銀-太平",25,0,25
"18252","1471首利","110/07/27","中國信託-高雄",0,25,-25
"18253","1471首利","110/07/27","群益金鼎-台中",23,0,23
"18254","1471首利","110/07/27","統一-新台中",0,24,-24
"18255","1471首利","110/07/27","元富-潮州",20,0,20
"18256","1471首利","110/07/27","聯邦-高雄",0,21,-21
"18257","1471首利","110/07/27","凱基-信義",20,0,20
"18258","1471首利","110/07/27","德信-中正",0,20,-20
"18259","1471首利","110/07/27","富邦-基隆",26,8,18
"18260","1471首利","110/07/27","元大-福營",3,20,-17
"18261","1471首利","110/07/27","日盛-高雄",17,0,17
"18262","1471首利","110/07/27","凱基-宜蘭",0,16,-16
"18263","1471首利","110/07/27","國泰-敦南",16,2,14
"18264","1471首利","110/07/27","凱基-天母",0,15,-15
"18265","1471首利","110/07/27","元大-大甲",13,0,13
"18266","1471首利","110/07/27","第一金-高雄",6,20,-14
"18267","1471首利","110/07/27","合庫-鳳山",12,0,12
"18268","1471首利","110/07/27","元大-中壢",0,13,-13
"18269","1471首利","110/07/27","日盛-大墩",12,0,12
"18270","1471首利","110/07/27","元富-安南",0,12,-12
"18271","2883開發金","110/07/27","元富",1762,67,1695
"18272","2883開發金","110/07/27","美林",0,11931,-11931
"18273","2883開發金","110/07/27","福邦證券",1450,0,1450
"18274","2883開發金","110/07/27","新加坡商瑞銀",1513,8370,-6857
"18275","2883開發金","110/07/27","凱基",1422,0,1422
"18276","2883開發金","110/07/27","凱基-台北",1081,5265,-4184
"18277","2883開發金","110/07/27","瑞士信貸",2044,731,1313
"18278","2883開發金","110/07/27","摩根大通",612,3392,-2780
"18279","2883開發金","110/07/27","台灣摩根士丹利",2112,921,1191
"18280","2883開發金","110/07/27","統一-仁愛",31,2002,-1971
"18281","2883開發金","110/07/27","新光",1474,461,1013
"18282","2883開發金","110/07/27","兆豐證券",192,1910,-1718
"18283","2883開發金","110/07/27","國票-長城",1003,20,983
"18284","2883開發金","110/07/27","(牛牛牛)亞-鑫豐",276,1815,-1539
"18285","2883開發金","110/07/27","台新證券",1207,362,845
"18286","2883開發金","110/07/27","永豐金-板橋",197,1610,-1413
"18287","2883開發金","110/07/27","港商野村",2209,1498,711
"18288","2883開發金","110/07/27","美商高盛",16,1337,-1321
"18289","2883開發金","110/07/27","永豐金-彰化",680,26,654
"18290","2883開發金","110/07/27","兆豐-北高雄",60,1360,-1300
"18291","2883開發金","110/07/27","台新-高雄",918,265,653
"18292","2883開發金","110/07/27","兆豐-景美",26,1070,-1044
"18293","2883開發金","110/07/27","國泰-敦南",1273,634,639
"18294","2883開發金","110/07/27","亞東-新竹",7,1001,-994
"18295","2883開發金","110/07/27","元大證券",876,246,630
"18296","2883開發金","110/07/27","富邦-羅東",201,1098,-897
"18297","2883開發金","110/07/27","致和證券",684,92,592
"18298","2883開發金","110/07/27","統一",159,811,-652
"18299","2883開發金","110/07/27","元大-民生",550,2,548
"18300","2883開發金","110/07/27","香港上海匯豐",0,584,-584
"18301","6205詮欣","110/07/27","土銀-和平",20,0,20
"18302","6205詮欣","110/07/27","摩根大通",3,22,-19
"18303","6205詮欣","110/07/27","臺銀-民權",20,6,14
"18304","6205詮欣","110/07/27","瑞士信貸",5,16,-11
"18305","6205詮欣","110/07/27","台新證券",5,0,5
"18306","6205詮欣","110/07/27","臺銀-鳳山",0,6,-6
"18307","6205詮欣","110/07/27","華南永昌-小港",5,0,5
"18308","6205詮欣","110/07/27","臺銀-新竹",0,5,-5
"18309","6205詮欣","110/07/27","日盛-新莊",4,0,4
"18310","6205詮欣","110/07/27","國票-和平",0,4,-4
"18311","6205詮欣","110/07/27","元富-三重",4,0,4
"18312","6205詮欣","110/07/27","凱基-東門",0,4,-4
"18313","6205詮欣","110/07/27","致和-佳里",4,1,3
"18314","6205詮欣","110/07/27","富邦-花蓮",0,3,-3
"18315","6205詮欣","110/07/27","華南永昌-岡山",3,0,3
"18316","6205詮欣","110/07/27","元大-北投",0,3,-3
"18317","6205詮欣","110/07/27","元大-成功",3,0,3
"18318","6205詮欣","110/07/27","元大-民生",2,5,-3
"18319","6205詮欣","110/07/27","土銀-嘉義",2,0,2
"18320","6205詮欣","110/07/27","日盛-三重",0,2,-2
"18321","6205詮欣","110/07/27","第一金-光復",2,0,2
"18322","6205詮欣","110/07/27","日盛-北高雄",0,2,-2
"18323","6205詮欣","110/07/27","統一-屏東",2,0,2
"18324","6205詮欣","110/07/27","港商野村",0,2,-2
"18325","6205詮欣","110/07/27","元富-新莊",2,0,2
"18326","6205詮欣","110/07/27","統一-彰化",0,2,-2
"18327","6205詮欣","110/07/27","兆豐-竹北",2,0,2
"18328","6205詮欣","110/07/27","永全",0,2,-2
"18329","6205詮欣","110/07/27","新光",2,0,2
"18330","6205詮欣","110/07/27","兆豐-西螺",0,2,-2
"18331","1540喬福","110/07/27","富邦-員林",10,0,10
"18332","1540喬福","110/07/27","合庫-台中",0,26,-26
"18333","1540喬福","110/07/27","元大-中壢",10,0,10
"18334","1540喬福","110/07/27","統一-新台中",0,25,-25
"18335","1540喬福","110/07/27","凱基-台中",8,0,8
"18336","1540喬福","110/07/27","元大-斗六",0,10,-10
"18337","1540喬福","110/07/27","大慶-中壢",5,0,5
"18338","1540喬福","110/07/27","凱基-中港",0,9,-9
"18339","1540喬福","110/07/27","兆豐-北高雄",5,0,5
"18340","1540喬福","110/07/27","國票-中正",0,8,-8
"18341","1540喬福","110/07/27","兆豐-三民",5,0,5
"18342","1540喬福","110/07/27","臺銀-臺中",0,5,-5
"18343","1540喬福","110/07/27","台新-台中",5,0,5
"18344","1540喬福","110/07/27","元富-中原",0,5,-5
"18345","1540喬福","110/07/27","國票-九鼎",4,0,4
"18346","1540喬福","110/07/27","新光-桃園",0,5,-5
"18347","1540喬福","110/07/27","富邦-高雄",5,1,4
"18348","1540喬福","110/07/27","大昌-新竹",0,4,-4
"18349","1540喬福","110/07/27","永豐金-羅東",4,0,4
"18350","1540喬福","110/07/27","元大-員林中山",0,4,-4
"18351","1540喬福","110/07/27","台新證券",3,0,3
"18352","1540喬福","110/07/27","群益金鼎-瑞豐",0,3,-3
"18353","1540喬福","110/07/27","華南永昌-台中",3,0,3
"18354","1540喬福","110/07/27","凱基-台北",0,3,-3
"18355","1540喬福","110/07/27","富邦-台東",3,0,3
"18356","1540喬福","110/07/27","富邦-建國",0,3,-3
"18357","1540喬福","110/07/27","元大-台中中港",3,0,3
"18358","1540喬福","110/07/27","國票-北投",0,2,-2
"18359","1540喬福","110/07/27","亞東",2,0,2
"18360","1540喬福","110/07/27","元大-鳳山",0,2,-2
"18361","2888新光金","110/07/27","台灣摩根士丹利",11737,746,10991
"18362","2888新光金","110/07/27","玉山-城中",112,6002,-5890
"18363","2888新光金","110/07/27","美林",3692,417,3275
"18364","2888新光金","110/07/27","新加坡商瑞銀",120,5935,-5815
"18365","2888新光金","110/07/27","凱基-台北",4378,2713,1665
"18366","2888新光金","110/07/27","摩根大通",1586,7187,-5601
"18367","2888新光金","110/07/27","凱基-台南",1551,3,1548
"18368","2888新光金","110/07/27","富邦-建國",298,5641,-5343
"18369","2888新光金","110/07/27","台新證券",1494,124,1370
"18370","2888新光金","110/07/27","第一金-高雄",81,5014,-4933
"18371","2888新光金","110/07/27","新光",2434,1212,1222
"18372","2888新光金","110/07/27","瑞士信貸",191,4524,-4333
"18373","2888新光金","110/07/27","元大-四維",1246,25,1221
"18374","2888新光金","110/07/27","兆豐-鹿港",45,2632,-2587
"18375","2888新光金","110/07/27","富隆-長安",1070,0,1070
"18376","2888新光金","110/07/27","國票-彰化",3,1803,-1800
"18377","2888新光金","110/07/27","永豐金-萬盛",1052,0,1052
"18378","2888新光金","110/07/27","港商野村",0,1434,-1434
"18379","2888新光金","110/07/27","法銀巴黎",1116,120,996
"18380","2888新光金","110/07/27","統一-高雄",173,1511,-1338
"18381","2888新光金","110/07/27","凱基-竹科",853,4,849
"18382","2888新光金","110/07/27","群益金鼎-古亭",40,1202,-1162
"18383","2888新光金","110/07/27","元大-斗信",874,50,824
"18384","2888新光金","110/07/27","日盛-樹林",34,1034,-1000
"18385","2888新光金","110/07/27","日盛-景美",811,119,692
"18386","2888新光金","110/07/27","統一-土城",18,1000,-982
"18387","2888新光金","110/07/27","元富-世貿",568,2,566
"18388","2888新光金","110/07/27","元大-鹿港",125,1057,-932
"18389","2888新光金","110/07/27","日盛-雙和",567,2,565
"18390","2888新光金","110/07/27","新光-桃園",91,993,-902
"18391","1340勝悅","110/07/27","亞東-台中",15,0,15
"18392","1340勝悅","110/07/27","凱基-岡山",0,25,-25
"18393","1340勝悅","110/07/27","元大-路竹",15,0,15
"18394","1340勝悅","110/07/27","合庫-嘉義",0,14,-14
"18395","1340勝悅","110/07/27","臺銀-臺中",7,0,7
"18396","1340勝悅","110/07/27","元大-北港",0,14,-14
"18397","1340勝悅","110/07/27","台新-台中",7,0,7
"18398","1340勝悅","110/07/27","凱基-台北",0,12,-12
"18399","1340勝悅","110/07/27","元大-屏南",6,0,6
"18400","1340勝悅","110/07/27","兆豐-三民",0,7,-7
"18401","1340勝悅","110/07/27","臺灣企銀-埔墘",5,0,5
"18402","1340勝悅","110/07/27","華南永昌-台中",1,7,-6
"18403","1340勝悅","110/07/27","日盛-板橋",5,0,5
"18404","1340勝悅","110/07/27","日盛-信義",0,5,-5
"18405","1340勝悅","110/07/27","日盛-新莊",5,0,5
"18406","1340勝悅","110/07/27","德信-和平",0,5,-5
"18407","1340勝悅","110/07/27","臺銀-鳳山",4,0,4
"18408","1340勝悅","110/07/27","台新證券",0,5,-5
"18409","1340勝悅","110/07/27","玉山-城中",4,0,4
"18410","1340勝悅","110/07/27","新光-高雄",0,4,-4
"18411","1340勝悅","110/07/27","美商高盛",3,0,3
"18412","1340勝悅","110/07/27","瑞士信貸",0,2,-2
"18413","1340勝悅","110/07/27","(牛牛牛)亞-鑫豐",3,0,3
"18414","1340勝悅","110/07/27","港商野村",0,2,-2
"18415","1340勝悅","110/07/27","國票-長城",2,0,2
"18416","1340勝悅","110/07/27","台新-高雄",1,3,-2
"18417","1340勝悅","110/07/27","新光",2,0,2
"18418","1340勝悅","110/07/27","玉山證券",0,2,-2
"18419","1340勝悅","110/07/27","群益金鼎-館前",2,0,2
"18420","1340勝悅","110/07/27","玉山-南京東路",0,2,-2
"18421","6246臺龍","110/07/27","永豐金-桃園",135,0,135
"18422","6246臺龍","110/07/27","元大-木柵",0,59,-59
"18423","6246臺龍","110/07/27","港商野村",111,30,81
"18424","6246臺龍","110/07/27","日盛-景美",0,52,-52
"18425","6246臺龍","110/07/27","元大-西螺",31,0,31
"18426","6246臺龍","110/07/27","華南永昌-彰化",0,46,-46
"18427","6246臺龍","110/07/27","群益金鼎-鳳山",27,0,27
"18428","6246臺龍","110/07/27","兆豐-松德",0,43,-43
"18429","6246臺龍","110/07/27","永豐金-虎尾",27,0,27
"18430","6246臺龍","110/07/27","華南永昌-公誠",5,35,-30
"18431","6246臺龍","110/07/27","玉山-台南",28,2,26
"18432","6246臺龍","110/07/27","凱基-幸福",0,28,-28
"18433","6246臺龍","110/07/27","元大-西屯",25,0,25
"18434","6246臺龍","110/07/27","元富-安南",0,22,-22
"18435","6246臺龍","110/07/27","國泰-忠孝",23,0,23
"18436","6246臺龍","110/07/27","日盛-文化",0,20,-20
"18437","6246臺龍","110/07/27","元大-大里",21,0,21
"18438","6246臺龍","110/07/27","兆豐-寶成",0,20,-20
"18439","6246臺龍","110/07/27","兆豐-竹北",20,0,20
"18440","6246臺龍","110/07/27","華南永昌-虎尾",0,20,-20
"18441","6246臺龍","110/07/27","元大-員林",20,0,20
"18442","6246臺龍","110/07/27","永豐金-埔里",0,19,-19
"18443","6246臺龍","110/07/27","永豐金-敦南",20,0,20
"18444","6246臺龍","110/07/27","兆豐-新營",2,20,-18
"18445","6246臺龍","110/07/27","永豐金-羅東",23,5,18
"18446","6246臺龍","110/07/27","新光-台中",3,20,-17
"18447","6246臺龍","110/07/27","永豐金-桃盛",18,0,18
"18448","6246臺龍","110/07/27","凱基-市政",0,17,-17
"18449","6246臺龍","110/07/27","統一",16,0,16
"18450","6246臺龍","110/07/27","元大-蘆洲",0,16,-16
"18451","00715L期街口布蘭特正2","110/07/27","元大證券",10436,28,10408
"18452","00715L期街口布蘭特正2","110/07/27","元大-萬華",0,751,-751
"18453","00715L期街口布蘭特正2","110/07/27","凱基-台北",4269,129,4140
"18454","00715L期街口布蘭特正2","110/07/27","元大-大里德芳",0,734,-734
"18455","00715L期街口布蘭特正2","110/07/27","群益金鼎",3798,0,3798
"18456","00715L期街口布蘭特正2","110/07/27","新光",380,1105,-725
"18457","00715L期街口布蘭特正2","110/07/27","永豐金證券",2610,22,2588
"18458","00715L期街口布蘭特正2","110/07/27","(牛牛牛)亞-網路",10,697,-687
"18459","00715L期街口布蘭特正2","110/07/27","國票",2605,21,2584
"18460","00715L期街口布蘭特正2","110/07/27","日盛-新莊",5,550,-545
"18461","00715L期街口布蘭特正2","110/07/27","富邦證券",1522,0,1522
"18462","00715L期街口布蘭特正2","110/07/27","玉山-高雄",7,494,-487
"18463","00715L期街口布蘭特正2","110/07/27","合庫證券",1507,239,1268
"18464","00715L期街口布蘭特正2","110/07/27","華南永昌",1,471,-470
"18465","00715L期街口布蘭特正2","110/07/27","元富",1102,0,1102
"18466","00715L期街口布蘭特正2","110/07/27","華南永昌-竹北",0,469,-469
"18467","00715L期街口布蘭特正2","110/07/27","凱基",980,0,980
"18468","00715L期街口布蘭特正2","110/07/27","兆豐-嘉義",0,420,-420
"18469","00715L期街口布蘭特正2","110/07/27","國票-博愛",702,0,702
"18470","00715L期街口布蘭特正2","110/07/27","國票-九鼎",0,409,-409
"18471","00715L期街口布蘭特正2","110/07/27","統一",796,117,679
"18472","00715L期街口布蘭特正2","110/07/27","統一-高雄",0,405,-405
"18473","00715L期街口布蘭特正2","110/07/27","華南永昌-長虹",810,185,625
"18474","00715L期街口布蘭特正2","110/07/27","富邦-彰化",0,402,-402
"18475","00715L期街口布蘭特正2","110/07/27","港商野村",1076,494,582
"18476","00715L期街口布蘭特正2","110/07/27","元大-羅東",0,400,-400
"18477","00715L期街口布蘭特正2","110/07/27","永豐金-三重",500,16,484
"18478","00715L期街口布蘭特正2","110/07/27","富邦-高雄",0,398,-398
"18479","00715L期街口布蘭特正2","110/07/27","元大-敦化",420,0,420
"18480","00715L期街口布蘭特正2","110/07/27","新光-台中",17,391,-374
"18481","8941關中","110/07/27","富邦-仁愛",4,0,4
"18482","8941關中","110/07/27","光和-溪湖",0,2,-2
"18483","8941關中","110/07/27","日盛-新莊",1,0,1
"18484","8941關中","110/07/27","富邦-園區",0,2,-2
"18485","8941關中","110/07/27","台新-高雄",1,0,1
"18486","8941關中","110/07/27","合庫-高雄",0,1,-1
"18487","8941關中","110/07/27","元大-金華",1,0,1
"18488","8941關中","110/07/27","凱基-台北",0,1,-1
"18489","8941關中","110/07/27","臺銀-鳳山",0,0,0
"18490","8941關中","110/07/27","富邦-台東",0,1,-1
"18491","8941關中","110/07/27","日盛-花蓮",0,0,0
"18492","8941關中","110/07/27","臺銀-鳳山",0,0,0
"18493","8941關中","110/07/27","康和-板橋",0,0,0
"18494","8941關中","110/07/27","日盛-花蓮",0,0,0
"18495","8941關中","110/07/27","富邦-宜蘭",0,0,0
"18496","8941關中","110/07/27","康和-板橋",0,0,0
"18497","8941關中","110/07/27","元大-新竹經國",0,0,0
"18498","8941關中","110/07/27","富邦-宜蘭",0,0,0
"18499","8941關中","110/07/27","永豐金-萬盛",0,0,0
"18500","8941關中","110/07/27","元大-新竹經國",0,0,0
"18501","8941關中","110/07/27","永豐金-桃盛",0,0,0
"18502","8941關中","110/07/27","永豐金-萬盛",0,0,0
"18503","8941關中","110/07/27","",NA,NA,NA
"18504","8941關中","110/07/27","永豐金-桃盛",0,0,0
"18505","8941關中","110/07/27","",NA,NA,NA
"18506","8941關中","110/07/27","",NA,NA,NA
"18507","8941關中","110/07/27","",NA,NA,NA
"18508","8941關中","110/07/27","",NA,NA,NA
"18509","8941關中","110/07/27","",NA,NA,NA
"18510","8941關中","110/07/27","",NA,NA,NA
"18511","8936國統","110/07/27","日盛-景美",100,0,100
"18512","8936國統","110/07/27","摩根大通",115,220,-105
"18513","8936國統","110/07/27","大慶-蘆洲",90,0,90
"18514","8936國統","110/07/27","玉山-桃園",0,75,-75
"18515","8936國統","110/07/27","台新-建北",60,0,60
"18516","8936國統","110/07/27","凱基-台北",13,77,-64
"18517","8936國統","110/07/27","日盛-忠孝",40,1,39
"18518","8936國統","110/07/27","元富-大昌",2,50,-48
"18519","8936國統","110/07/27","新加坡商瑞銀",109,71,38
"18520","8936國統","110/07/27","華南永昌-台中",4,45,-41
"18521","8936國統","110/07/27","華南永昌",30,0,30
"18522","8936國統","110/07/27","新光-台中",26,66,-40
"18523","8936國統","110/07/27","兆豐-來福",29,0,29
"18524","8936國統","110/07/27","台灣摩根士丹利",20,54,-34
"18525","8936國統","110/07/27","元大-旗山",28,0,28
"18526","8936國統","110/07/27","元大-東蘆",0,34,-34
"18527","8936國統","110/07/27","元大-松江",27,0,27
"18528","8936國統","110/07/27","富邦-仁愛",1,34,-33
"18529","8936國統","110/07/27","新光",41,19,22
"18530","8936國統","110/07/27","凱基-板橋",0,31,-31
"18531","8936國統","110/07/27","元富-林園",20,0,20
"18532","8936國統","110/07/27","凱基-信義",0,30,-30
"18533","8936國統","110/07/27","玉山-高雄",20,0,20
"18534","8936國統","110/07/27","瑞士信貸",1,30,-29
"18535","8936國統","110/07/27","凱基-桃園",23,3,20
"18536","8936國統","110/07/27","元大-花蓮",2,24,-22
"18537","8936國統","110/07/27","永豐金-永康",20,0,20
"18538","8936國統","110/07/27","元富-緯城",0,20,-20
"18539","8936國統","110/07/27","日盛-屏東",23,4,19
"18540","8936國統","110/07/27","群益金鼎-宜蘭",0,20,-20
"18541","6226光鼎","110/07/27","第一金-忠孝",405,4,401
"18542","6226光鼎","110/07/27","華南永昌-台南",5,240,-235
"18543","6226光鼎","110/07/27","台新-台中",272,75,197
"18544","6226光鼎","110/07/27","大慶-泰山",0,201,-201
"18545","6226光鼎","110/07/27","凱基-和平",155,7,148
"18546","6226光鼎","110/07/27","富邦-員林",2,151,-149
"18547","6226光鼎","110/07/27","新加坡商瑞銀",133,0,133
"18548","6226光鼎","110/07/27","群益金鼎-東大",23,165,-142
"18549","6226光鼎","110/07/27","統一-敦南",126,3,123
"18550","6226光鼎","110/07/27","元大-景美",3,132,-129
"18551","6226光鼎","110/07/27","台灣摩根士丹利",129,8,121
"18552","6226光鼎","110/07/27","台新-高雄",84,186,-102
"18553","6226光鼎","110/07/27","統一-新竹",117,1,116
"18554","6226光鼎","110/07/27","合庫證券",27,121,-94
"18555","6226光鼎","110/07/27","日盛證券",122,13,109
"18556","6226光鼎","110/07/27","致和-佳里",5,81,-76
"18557","6226光鼎","110/07/27","元大-潮州",101,1,100
"18558","6226光鼎","110/07/27","永豐金-南投",3,77,-74
"18559","6226光鼎","110/07/27","國泰-敦南",232,145,87
"18560","6226光鼎","110/07/27","台新-新莊",1,57,-56
"18561","6226光鼎","110/07/27","摩根大通",86,0,86
"18562","6226光鼎","110/07/27","日盛-中壢",11,64,-53
"18563","6226光鼎","110/07/27","元富",80,0,80
"18564","6226光鼎","110/07/27","日進",11,63,-52
"18565","6226光鼎","110/07/27","華南永昌-嘉義",80,1,79
"18566","6226光鼎","110/07/27","高橋",13,64,-51
"18567","6226光鼎","110/07/27","元大-高雄",70,3,67
"18568","6226光鼎","110/07/27","元大-土城",1,52,-51
"18569","6226光鼎","110/07/27","華南永昌",82,21,61
"18570","6226光鼎","110/07/27","華南永昌-林口",11,60,-49
"18571","2363矽統","110/07/27","國泰-敦南",541,118,423
"18572","2363矽統","110/07/27","摩根大通",317,1405,-1088
"18573","2363矽統","110/07/27","台新證券",564,333,231
"18574","2363矽統","110/07/27","美林",210,1095,-885
"18575","2363矽統","110/07/27","元大-沙鹿",196,9,187
"18576","2363矽統","110/07/27","港商野村",275,1065,-790
"18577","2363矽統","110/07/27","新光",300,151,149
"18578","2363矽統","110/07/27","凱基-台北",518,1192,-674
"18579","2363矽統","110/07/27","華南永昌-台南",108,3,105
"18580","2363矽統","110/07/27","新加坡商瑞銀",213,703,-490
"18581","2363矽統","110/07/27","華南永昌-朴子",140,43,97
"18582","2363矽統","110/07/27","富邦-南屯",6,272,-266
"18583","2363矽統","110/07/27","華南永昌-公誠",109,13,96
"18584","2363矽統","110/07/27","美商高盛",31,233,-202
"18585","2363矽統","110/07/27","元富-松德",95,1,94
"18586","2363矽統","110/07/27","元大證券",38,235,-197
"18587","2363矽統","110/07/27","中國信託-永康",102,8,94
"18588","2363矽統","110/07/27","永豐金證券",15,201,-186
"18589","2363矽統","110/07/27","台新-三民",111,21,90
"18590","2363矽統","110/07/27","亞東",46,206,-160
"18591","2363矽統","110/07/27","凱基-中港",85,3,82
"18592","2363矽統","110/07/27","群益金鼎",21,169,-148
"18593","2363矽統","110/07/27","元富-烏日",87,6,81
"18594","2363矽統","110/07/27","第一金-嘉義",0,100,-100
"18595","2363矽統","110/07/27","富邦-台北",135,56,79
"18596","2363矽統","110/07/27","凱基-彰化",9,100,-91
"18597","2363矽統","110/07/27","元大-復北",81,12,69
"18598","2363矽統","110/07/27","元富-佳里",27,97,-70
"18599","2363矽統","110/07/27","中國信託-忠孝",94,26,68
"18600","2363矽統","110/07/27","合庫-桃園",8,76,-68
"18601","8112至上","110/07/27","凱基-竹科",300,10,290
"18602","8112至上","110/07/27","凱基-三重",1,501,-500
"18603","8112至上","110/07/27","台灣摩根士丹利",271,49,222
"18604","8112至上","110/07/27","美林",21,339,-318
"18605","8112至上","110/07/27","摩根大通",488,427,61
"18606","8112至上","110/07/27","凱基-台北",423,615,-192
"18607","8112至上","110/07/27","香港上海匯豐",61,0,61
"18608","8112至上","110/07/27","港商野村",83,183,-100
"18609","8112至上","110/07/27","日盛證券",62,4,58
"18610","8112至上","110/07/27","永豐金-台南",2,79,-77
"18611","8112至上","110/07/27","元大-基隆孝二",52,0,52
"18612","8112至上","110/07/27","福邦證券",0,71,-71
"18613","8112至上","110/07/27","永豐金-中正",59,7,52
"18614","8112至上","110/07/27","兆豐-天母",0,50,-50
"18615","8112至上","110/07/27","群益金鼎-高盛",47,0,47
"18616","8112至上","110/07/27","元富-林園",3,52,-49
"18617","8112至上","110/07/27","永豐金-內湖",47,0,47
"18618","8112至上","110/07/27","永豐金-苓雅",1,50,-49
"18619","8112至上","110/07/27","富邦-台北",45,5,40
"18620","8112至上","110/07/27","元大-新莊",9,53,-44
"18621","8112至上","110/07/27","台新證券",78,39,39
"18622","8112至上","110/07/27","第一金-路竹",20,57,-37
"18623","8112至上","110/07/27","新光-台中",44,7,37
"18624","8112至上","110/07/27","新光-桃園",2,36,-34
"18625","8112至上","110/07/27","元大-羅東",38,1,37
"18626","8112至上","110/07/27","元大-東港",0,27,-27
"18627","8112至上","110/07/27","新光",101,65,36
"18628","8112至上","110/07/27","國泰-松江",2,28,-26
"18629","8112至上","110/07/27","元大-新竹",63,28,35
"18630","8112至上","110/07/27","群益金鼎-潭子",2,28,-26
"18631","1570力肯","110/07/27","國票-北高雄",7,0,7
"18632","1570力肯","110/07/27","元大-高雄",0,16,-16
"18633","1570力肯","110/07/27","富邦-陽明",5,0,5
"18634","1570力肯","110/07/27","國票-新莊",0,5,-5
"18635","1570力肯","110/07/27","元大-民雄",3,0,3
"18636","1570力肯","110/07/27","凱基-台北",0,5,-5
"18637","1570力肯","110/07/27","凱基-大里",3,0,3
"18638","1570力肯","110/07/27","美林",0,2,-2
"18639","1570力肯","110/07/27","凱基-長庚",3,0,3
"18640","1570力肯","110/07/27","富邦-南屯",0,2,-2
"18641","1570力肯","110/07/27","元大-新莊",2,0,2
"18642","1570力肯","110/07/27","元大-南崁",0,2,-2
"18643","1570力肯","110/07/27","大昌-樹林",2,0,2
"18644","1570力肯","110/07/27","元大-板橋",0,2,-2
"18645","1570力肯","110/07/27","台新-台中",2,0,2
"18646","1570力肯","110/07/27","新光",0,1,-1
"18647","1570力肯","110/07/27","新光-新竹",2,0,2
"18648","1570力肯","110/07/27","國泰-板橋",0,1,-1
"18649","1570力肯","110/07/27","富邦-左營",2,0,2
"18650","1570力肯","110/07/27","凱基-鳳山",0,1,-1
"18651","1570力肯","110/07/27","群益金鼎-土城",1,0,1
"18652","1570力肯","110/07/27","(牛牛牛)亞-鑫豐",2,2,0
"18653","1570力肯","110/07/27","凱基-竹東",1,0,1
"18654","1570力肯","110/07/27","元大-新盛",1,1,0
"18655","1570力肯","110/07/27","日盛-員林",1,0,1
"18656","1570力肯","110/07/27","",NA,NA,NA
"18657","1570力肯","110/07/27","玉山-板橋",1,0,1
"18658","1570力肯","110/07/27","",NA,NA,NA
"18659","1570力肯","110/07/27","元富-同大",1,0,1
"18660","1570力肯","110/07/27","",NA,NA,NA
"18661","2929淘帝","110/07/27","元大-民生",28,0,28
"18662","2929淘帝","110/07/27","元大-鳳山",0,20,-20
"18663","2929淘帝","110/07/27","臺銀-民權",18,0,18
"18664","2929淘帝","110/07/27","港商野村",1,18,-17
"18665","2929淘帝","110/07/27","合庫-高雄",13,0,13
"18666","2929淘帝","110/07/27","玉山-板橋",0,15,-15
"18667","2929淘帝","110/07/27","永興-水湳",10,0,10
"18668","2929淘帝","110/07/27","美林",0,10,-10
"18669","2929淘帝","110/07/27","富邦-陽明",10,0,10
"18670","2929淘帝","110/07/27","凱基-八德",0,10,-10
"18671","2929淘帝","110/07/27","元大-中和",10,0,10
"18672","2929淘帝","110/07/27","永豐金證券",0,9,-9
"18673","2929淘帝","110/07/27","國泰-館前",6,0,6
"18674","2929淘帝","110/07/27","新加坡商瑞銀",10,18,-8
"18675","2929淘帝","110/07/27","富邦-內湖",6,0,6
"18676","2929淘帝","110/07/27","富邦-台北",0,8,-8
"18677","2929淘帝","110/07/27","合庫-台南",5,0,5
"18678","2929淘帝","110/07/27","宏遠-台中",0,7,-7
"18679","2929淘帝","110/07/27","凱基-東門",5,0,5
"18680","2929淘帝","110/07/27","元富-潮州",0,7,-7
"18681","2929淘帝","110/07/27","元大-大益",5,0,5
"18682","2929淘帝","110/07/27","群益金鼎-延平",0,6,-6
"18683","2929淘帝","110/07/27","元大-屏南",5,0,5
"18684","2929淘帝","110/07/27","元大-文心",0,6,-6
"18685","2929淘帝","110/07/27","永豐金-板盛",5,0,5
"18686","2929淘帝","110/07/27","永豐金-中壢",0,6,-6
"18687","2929淘帝","110/07/27","臺銀",4,0,4
"18688","2929淘帝","110/07/27","美商高盛",0,5,-5
"18689","2929淘帝","110/07/27","永豐金-市政",4,0,4
"18690","2929淘帝","110/07/27","兆豐-南門",0,5,-5
"18691","5410國眾","110/07/27","摩根大通",47,0,47
"18692","5410國眾","110/07/27","元富-嘉義",0,48,-48
"18693","5410國眾","110/07/27","兆豐-城中",43,0,43
"18694","5410國眾","110/07/27","統一-平鎮",0,20,-20
"18695","5410國眾","110/07/27","香港上海匯豐",36,0,36
"18696","5410國眾","110/07/27","元大-大益",0,18,-18
"18697","5410國眾","110/07/27","港商麥格理",26,0,26
"18698","5410國眾","110/07/27","凱基-台北",0,16,-16
"18699","5410國眾","110/07/27","元富-大昌",21,0,21
"18700","5410國眾","110/07/27","凱基-站前",0,15,-15
"18701","5410國眾","110/07/27","元富-四維",20,0,20
"18702","5410國眾","110/07/27","元大-南勢角",0,13,-13
"18703","5410國眾","110/07/27","新光-台中",20,0,20
"18704","5410國眾","110/07/27","日盛-忠孝",0,11,-11
"18705","5410國眾","110/07/27","統一-金門",15,0,15
"18706","5410國眾","110/07/27","玉山-板橋",0,11,-11
"18707","5410國眾","110/07/27","玉山-高雄",15,0,15
"18708","5410國眾","110/07/27","元大-崇德",0,11,-11
"18709","5410國眾","110/07/27","凱基-竹北",15,0,15
"18710","5410國眾","110/07/27","元大-大天母",0,11,-11
"18711","5410國眾","110/07/27","元大-新莊",14,1,13
"18712","5410國眾","110/07/27","元富-松德",0,10,-10
"18713","5410國眾","110/07/27","華南永昌-中正",14,4,10
"18714","5410國眾","110/07/27","豐農",0,10,-10
"18715","5410國眾","110/07/27","元大-屏南",10,0,10
"18716","5410國眾","110/07/27","新光-新竹",0,10,-10
"18717","5410國眾","110/07/27","元大-中和",10,0,10
"18718","5410國眾","110/07/27","凱基-虎尾",0,10,-10
"18719","5410國眾","110/07/27","台新證券",10,1,9
"18720","5410國眾","110/07/27","元大-善化",0,10,-10
"18721","2841台開","110/07/27","日盛證券",620,0,620
"18722","2841台開","110/07/27","玉山-新竹",0,312,-312
"18723","2841台開","110/07/27","永豐金-豐原",65,0,65
"18724","2841台開","110/07/27","港商野村",0,216,-216
"18725","2841台開","110/07/27","元大-南投",50,0,50
"18726","2841台開","110/07/27","永興-水湳",0,90,-90
"18727","2841台開","110/07/27","台灣摩根士丹利",40,0,40
"18728","2841台開","110/07/27","凱基-興隆",0,64,-64
"18729","2841台開","110/07/27","玉山-高雄",29,0,29
"18730","2841台開","110/07/27","美林",0,30,-30
"18731","2841台開","110/07/27","第一金-台中",20,0,20
"18732","2841台開","110/07/27","國泰-松江",5,35,-30
"18733","2841台開","110/07/27","凱基-市政",20,0,20
"18734","2841台開","110/07/27","台新-左楠",0,25,-25
"18735","2841台開","110/07/27","群益金鼎-大甲",18,1,17
"18736","2841台開","110/07/27","大昌-樹林",0,20,-20
"18737","2841台開","110/07/27","台中銀",16,1,15
"18738","2841台開","110/07/27","富邦-仁愛",0,20,-20
"18739","2841台開","110/07/27","國泰-板橋",12,0,12
"18740","2841台開","110/07/27","致和-南京",0,16,-16
"18741","2841台開","110/07/27","群益金鼎-基隆",10,0,10
"18742","2841台開","110/07/27","凱基-台北",2,16,-14
"18743","2841台開","110/07/27","華南永昌-新莊",10,0,10
"18744","2841台開","110/07/27","日盛-台南",0,10,-10
"18745","2841台開","110/07/27","元大-福營",10,0,10
"18746","2841台開","110/07/27","國票-台東",0,10,-10
"18747","2841台開","110/07/27","元大-歸仁",10,0,10
"18748","2841台開","110/07/27","台新-台中",5,15,-10
"18749","2841台開","110/07/27","中國信託-文心",5,0,5
"18750","2841台開","110/07/27","凱基-台中",0,10,-10
"18751","6207雷科","110/07/27","摩根大通",249,119,130
"18752","6207雷科","110/07/27","永豐金-台南",2,82,-80
"18753","6207雷科","110/07/27","群益金鼎-丹鳳",70,0,70
"18754","6207雷科","110/07/27","永豐金-內湖",39,109,-70
"18755","6207雷科","110/07/27","群益金鼎-東門",42,0,42
"18756","6207雷科","110/07/27","新加坡商瑞銀",22,76,-54
"18757","6207雷科","110/07/27","永豐金-敦南",38,4,34
"18758","6207雷科","110/07/27","新光-高雄",4,57,-53
"18759","6207雷科","110/07/27","凱基-復興",30,0,30
"18760","6207雷科","110/07/27","瑞士信貸",0,40,-40
"18761","6207雷科","110/07/27","元大-東門",30,0,30
"18762","6207雷科","110/07/27","凱基-高雄",4,43,-39
"18763","6207雷科","110/07/27","大昌-桃園",33,8,25
"18764","6207雷科","110/07/27","華南永昌-高雄",4,40,-36
"18765","6207雷科","110/07/27","富邦-虎尾",24,0,24
"18766","6207雷科","110/07/27","新光",11,44,-33
"18767","6207雷科","110/07/27","凱基-羅東",24,2,22
"18768","6207雷科","110/07/27","日盛-板橋中山",0,29,-29
"18769","6207雷科","110/07/27","群益金鼎-延平",21,0,21
"18770","6207雷科","110/07/27","元大-六合",3,30,-27
"18771","6207雷科","110/07/27","群益金鼎-屏東",20,0,20
"18772","6207雷科","110/07/27","中國信託-新竹",7,33,-26
"18773","6207雷科","110/07/27","永豐金-埔里",20,0,20
"18774","6207雷科","110/07/27","元富-城中",0,23,-23
"18775","6207雷科","110/07/27","康和-延平",21,3,18
"18776","6207雷科","110/07/27","元大-大雅",2,20,-18
"18777","6207雷科","110/07/27","群益金鼎-中壢",20,2,18
"18778","6207雷科","110/07/27","永豐金-新莊",2,20,-18
"18779","6207雷科","110/07/27","宏遠證券",31,15,16
"18780","6207雷科","110/07/27","富邦-台中",5,21,-16
"18781","3679新至陞","110/07/27","凱基-市政",25,0,25
"18782","3679新至陞","110/07/27","瑞士信貸",0,13,-13
"18783","3679新至陞","110/07/27","兆豐-高雄",10,0,10
"18784","3679新至陞","110/07/27","元大-天母",0,9,-9
"18785","3679新至陞","110/07/27","光和-溪湖",8,0,8
"18786","3679新至陞","110/07/27","元大-彰化民生",0,6,-6
"18787","3679新至陞","110/07/27","臺銀-新竹",7,0,7
"18788","3679新至陞","110/07/27","康和-澎湖",2,7,-5
"18789","3679新至陞","110/07/27","新加坡商瑞銀",7,0,7
"18790","3679新至陞","110/07/27","聯邦-大業",0,5,-5
"18791","3679新至陞","110/07/27","永豐金-板橋",6,0,6
"18792","3679新至陞","110/07/27","元大-成功",0,5,-5
"18793","3679新至陞","110/07/27","宏遠-光隆",5,0,5
"18794","3679新至陞","110/07/27","康和-板橋",0,4,-4
"18795","3679新至陞","110/07/27","統一",5,0,5
"18796","3679新至陞","110/07/27","凱基-新豐",0,4,-4
"18797","3679新至陞","110/07/27","統一-新竹",5,0,5
"18798","3679新至陞","110/07/27","統一-高雄",0,3,-3
"18799","3679新至陞","110/07/27","元富-松德",5,0,5
"18800","3679新至陞","110/07/27","統一-新台中",0,3,-3
"18801","3679新至陞","110/07/27","元大-淡水",5,0,5
"18802","3679新至陞","110/07/27","元富-安南",0,3,-3
"18803","3679新至陞","110/07/27","日盛證券",4,0,4
"18804","3679新至陞","110/07/27","國票-北高雄",0,3,-3
"18805","3679新至陞","110/07/27","國泰-板橋",4,0,4
"18806","3679新至陞","110/07/27","玉山-新莊",0,3,-3
"18807","3679新至陞","110/07/27","(牛牛牛)亞-網路",3,0,3
"18808","3679新至陞","110/07/27","凱基-屏東",0,3,-3
"18809","3679新至陞","110/07/27","國票-九鼎",3,0,3
"18810","3679新至陞","110/07/27","台灣摩根士丹利",0,2,-2
"18811","2727王品","110/07/27","台灣摩根士丹利",103,12,91
"18812","2727王品","110/07/27","元大-彰化民生",11,420,-409
"18813","2727王品","110/07/27","華南永昌-麻豆",33,0,33
"18814","2727王品","110/07/27","美商高盛",0,247,-247
"18815","2727王品","110/07/27","元大-龍潭",31,1,30
"18816","2727王品","110/07/27","華南永昌",7,193,-186
"18817","2727王品","110/07/27","國泰-敦南",38,11,27
"18818","2727王品","110/07/27","花旗環球",0,86,-86
"18819","2727王品","110/07/27","群益金鼎-基隆",27,1,26
"18820","2727王品","110/07/27","凱基-台北",81,139,-58
"18821","2727王品","110/07/27","富邦-台中",26,0,26
"18822","2727王品","110/07/27","元大證券",23,64,-41
"18823","2727王品","110/07/27","元富",31,6,25
"18824","2727王品","110/07/27","瑞士信貸",0,37,-37
"18825","2727王品","110/07/27","元大-桃園",25,0,25
"18826","2727王品","110/07/27","富邦-建國",8,35,-27
"18827","2727王品","110/07/27","凱基-大直",21,1,20
"18828","2727王品","110/07/27","凱基-埔墘",6,29,-23
"18829","2727王品","110/07/27","日盛-士林",16,0,16
"18830","2727王品","110/07/27","美林",5,26,-21
"18831","2727王品","110/07/27","國票-敦北法人",17,1,16
"18832","2727王品","110/07/27","港商野村",12,30,-18
"18833","2727王品","110/07/27","群益金鼎-高雄",16,0,16
"18834","2727王品","110/07/27","華南永昌-林口",3,21,-18
"18835","2727王品","110/07/27","永豐金-忠孝",18,2,16
"18836","2727王品","110/07/27","彰銀-台中",4,20,-16
"18837","2727王品","110/07/27","臺銀-高雄",16,1,15
"18838","2727王品","110/07/27","統一",3,17,-14
"18839","2727王品","110/07/27","台新-台中",18,3,15
"18840","2727王品","110/07/27","富邦-新竹華信",2,15,-13
"18841","1570力肯","110/07/27","國票-北高雄",7,0,7
"18842","1570力肯","110/07/27","元大-高雄",0,16,-16
"18843","1570力肯","110/07/27","富邦-陽明",5,0,5
"18844","1570力肯","110/07/27","國票-新莊",0,5,-5
"18845","1570力肯","110/07/27","元大-民雄",3,0,3
"18846","1570力肯","110/07/27","凱基-台北",0,5,-5
"18847","1570力肯","110/07/27","凱基-大里",3,0,3
"18848","1570力肯","110/07/27","美林",0,2,-2
"18849","1570力肯","110/07/27","凱基-長庚",3,0,3
"18850","1570力肯","110/07/27","富邦-南屯",0,2,-2
"18851","1570力肯","110/07/27","元大-新莊",2,0,2
"18852","1570力肯","110/07/27","元大-南崁",0,2,-2
"18853","1570力肯","110/07/27","大昌-樹林",2,0,2
"18854","1570力肯","110/07/27","元大-板橋",0,2,-2
"18855","1570力肯","110/07/27","台新-台中",2,0,2
"18856","1570力肯","110/07/27","新光",0,1,-1
"18857","1570力肯","110/07/27","新光-新竹",2,0,2
"18858","1570力肯","110/07/27","國泰-板橋",0,1,-1
"18859","1570力肯","110/07/27","富邦-左營",2,0,2
"18860","1570力肯","110/07/27","凱基-鳳山",0,1,-1
"18861","1570力肯","110/07/27","群益金鼎-土城",1,0,1
"18862","1570力肯","110/07/27","(牛牛牛)亞-鑫豐",2,2,0
"18863","1570力肯","110/07/27","凱基-竹東",1,0,1
"18864","1570力肯","110/07/27","元大-新盛",1,1,0
"18865","1570力肯","110/07/27","日盛-員林",1,0,1
"18866","1570力肯","110/07/27","",NA,NA,NA
"18867","1570力肯","110/07/27","玉山-板橋",1,0,1
"18868","1570力肯","110/07/27","",NA,NA,NA
"18869","1570力肯","110/07/27","元富-同大",1,0,1
"18870","1570力肯","110/07/27","",NA,NA,NA
"18871","6180橘子","110/07/27","新加坡商瑞銀",166,24,142
"18872","6180橘子","110/07/27","花旗環球",31,87,-56
"18873","6180橘子","110/07/27","彰銀-台中",50,1,49
"18874","6180橘子","110/07/27","凱基-台北",53,108,-55
"18875","6180橘子","110/07/27","日盛-文化",48,8,40
"18876","6180橘子","110/07/27","新光",39,81,-42
"18877","6180橘子","110/07/27","美林",39,0,39
"18878","6180橘子","110/07/27","富邦-台北",1,25,-24
"18879","6180橘子","110/07/27","元大-草屯",54,17,37
"18880","6180橘子","110/07/27","第一金-員林",0,22,-22
"18881","6180橘子","110/07/27","美商高盛",35,1,34
"18882","6180橘子","110/07/27","富邦-新竹華信",7,28,-21
"18883","6180橘子","110/07/27","元大-上新莊",32,0,32
"18884","6180橘子","110/07/27","凱基-中山",5,24,-19
"18885","6180橘子","110/07/27","台灣摩根士丹利",30,0,30
"18886","6180橘子","110/07/27","國泰-敦南",22,37,-15
"18887","6180橘子","110/07/27","摩根大通",49,21,28
"18888","6180橘子","110/07/27","合庫-自強",2,16,-14
"18889","6180橘子","110/07/27","兆豐-大同",30,4,26
"18890","6180橘子","110/07/27","大昌-安康",1,14,-13
"18891","6180橘子","110/07/27","元大-羅東",21,0,21
"18892","6180橘子","110/07/27","高橋",0,11,-11
"18893","6180橘子","110/07/27","日盛-頭份",16,0,16
"18894","6180橘子","110/07/27","土銀-新竹",0,10,-10
"18895","6180橘子","110/07/27","瑞士信貸",24,8,16
"18896","6180橘子","110/07/27","兆豐-麻豆",0,10,-10
"18897","6180橘子","110/07/27","群益金鼎-士林",15,0,15
"18898","6180橘子","110/07/27","康和-永和",0,10,-10
"18899","6180橘子","110/07/27","永豐金-南京",15,1,14
"18900","6180橘子","110/07/27","永豐金-竹科",2,12,-10
"18901","2390云辰","110/07/27","凱基-基隆",207,3,204
"18902","2390云辰","110/07/27","凱基-台北",248,732,-484
"18903","2390云辰","110/07/27","摩根大通",730,560,170
"18904","2390云辰","110/07/27","美林",17,218,-201
"18905","2390云辰","110/07/27","華南永昌-中正",182,43,139
"18906","2390云辰","110/07/27","港商野村",85,277,-192
"18907","2390云辰","110/07/27","兆豐-北高雄",124,1,123
"18908","2390云辰","110/07/27","玉山-新莊",4,87,-83
"18909","2390云辰","110/07/27","元大-信義",108,5,103
"18910","2390云辰","110/07/27","新光",96,163,-67
"18911","2390云辰","110/07/27","富邦-陽明",94,22,72
"18912","2390云辰","110/07/27","新光-新竹",7,74,-67
"18913","2390云辰","110/07/27","日盛證券",140,71,69
"18914","2390云辰","110/07/27","富邦-左營",46,107,-61
"18915","2390云辰","110/07/27","第一金-豐原",56,0,56
"18916","2390云辰","110/07/27","大昌-新店",9,64,-55
"18917","2390云辰","110/07/27","統一-新台中",67,22,45
"18918","2390云辰","110/07/27","日盛-和美",28,81,-53
"18919","2390云辰","110/07/27","元大-復北",47,2,45
"18920","2390云辰","110/07/27","元大-台南",3,54,-51
"18921","2390云辰","110/07/27","富邦-建國",54,10,44
"18922","2390云辰","110/07/27","元富-世貿",10,60,-50
"18923","2390云辰","110/07/27","兆豐-桃鶯",46,5,41
"18924","2390云辰","110/07/27","華南永昌-鳳山",41,90,-49
"18925","2390云辰","110/07/27","富邦-中壢",45,4,41
"18926","2390云辰","110/07/27","聯邦商銀",6,52,-46
"18927","2390云辰","110/07/27","富邦-新竹華信",46,11,35
"18928","2390云辰","110/07/27","合庫-高雄",7,50,-43
"18929","2390云辰","110/07/27","第一金-華江",30,2,28
"18930","2390云辰","110/07/27","瑞士信貸",0,42,-42
"18931","2363矽統","110/07/26","凱基-台北",1994,468,1526
"18932","2363矽統","110/07/26","富邦-南屯",5,375,-370
"18933","2363矽統","110/07/26","新加坡商瑞銀",1537,208,1329
"18934","2363矽統","110/07/26","聯邦-興中",0,203,-203
"18935","2363矽統","110/07/26","摩根大通",2033,997,1036
"18936","2363矽統","110/07/26","台新證券",427,622,-195
"18937","2363矽統","110/07/26","瑞士信貸",930,0,930
"18938","2363矽統","110/07/26","元大-鳳中",10,203,-193
"18939","2363矽統","110/07/26","美林",985,76,909
"18940","2363矽統","110/07/26","國泰-板橋",69,209,-140
"18941","2363矽統","110/07/26","港商野村",1072,282,790
"18942","2363矽統","110/07/26","北城證券",6,132,-126
"18943","2363矽統","110/07/26","美商高盛",711,7,704
"18944","2363矽統","110/07/26","華南永昌-朴子",30,152,-122
"18945","2363矽統","110/07/26","新光",570,278,292
"18946","2363矽統","110/07/26","台新-台中",27,145,-118
"18947","2363矽統","110/07/26","台新-台南",244,39,205
"18948","2363矽統","110/07/26","群益金鼎-萬華",13,128,-115
"18949","2363矽統","110/07/26","元大證券",243,52,191
"18950","2363矽統","110/07/26","日盛-樹林",7,116,-109
"18951","2363矽統","110/07/26","永豐金證券",189,27,162
"18952","2363矽統","110/07/26","群益金鼎-屏東",200,303,-103
"18953","2363矽統","110/07/26","元大-楊梅",177,16,161
"18954","2363矽統","110/07/26","元大-潮州",6,102,-96
"18955","2363矽統","110/07/26","群益金鼎",158,21,137
"18956","2363矽統","110/07/26","新光-桃園",22,117,-95
"18957","2363矽統","110/07/26","元富-城東",107,8,99
"18958","2363矽統","110/07/26","凱基-和平",45,140,-95
"18959","2363矽統","110/07/26","日盛-雙和",109,14,95
"18960","2363矽統","110/07/26","合庫-台南",5,95,-90
"18961","8112至上","110/07/26","摩根大通",1728,41,1687
"18962","8112至上","110/07/26","玉山-左營",3,600,-597
"18963","8112至上","110/07/26","台灣摩根士丹利",408,10,398
"18964","8112至上","110/07/26","凱基-三重",1,527,-526
"18965","8112至上","110/07/26","凱基-台北",693,311,382
"18966","8112至上","110/07/26","中國信託-忠孝",0,103,-103
"18967","8112至上","110/07/26","港商法國興業",376,1,375
"18968","8112至上","110/07/26","凱基-站前",7,105,-98
"18969","8112至上","110/07/26","美商高盛",172,26,146
"18970","8112至上","110/07/26","國票-中港",0,96,-96
"18971","8112至上","110/07/26","新加坡商瑞銀",201,69,132
"18972","8112至上","110/07/26","兆豐-公益",3,84,-81
"18973","8112至上","110/07/26","美林",192,62,130
"18974","8112至上","110/07/26","玉山證券",2,65,-63
"18975","8112至上","110/07/26","港商野村",142,58,84
"18976","8112至上","110/07/26","統一-台中",1,62,-61
"18977","8112至上","110/07/26","凱基-永和",75,0,75
"18978","8112至上","110/07/26","富邦-陽明",3,60,-57
"18979","8112至上","110/07/26","凱基-竹科",65,2,63
"18980","8112至上","110/07/26","新光-新竹",86,141,-55
"18981","8112至上","110/07/26","華南永昌-敦南",63,1,62
"18982","8112至上","110/07/26","富邦-台北",2,57,-55
"18983","8112至上","110/07/26","兆豐-天母",50,0,50
"18984","8112至上","110/07/26","玉山-板橋",2,51,-49
"18985","8112至上","110/07/26","新光-桃園",57,11,46
"18986","8112至上","110/07/26","台新-新營",6,47,-41
"18987","8112至上","110/07/26","光和",35,1,34
"18988","8112至上","110/07/26","元大-虎尾",4,42,-38
"18989","8112至上","110/07/26","華南永昌-新莊",31,3,28
"18990","8112至上","110/07/26","日盛-新竹",1,38,-37
"18991","1570力肯","110/07/26","元大-民雄",10,0,10
"18992","1570力肯","110/07/26","元大-高雄",0,33,-33
"18993","1570力肯","110/07/26","新光-台中",10,1,9
"18994","1570力肯","110/07/26","日盛-宜蘭",0,8,-8
"18995","1570力肯","110/07/26","富邦-陽明",9,0,9
"18996","1570力肯","110/07/26","美林",0,5,-5
"18997","1570力肯","110/07/26","大慶-蘆洲",8,0,8
"18998","1570力肯","110/07/26","凱基-永康",0,5,-5
"18999","1570力肯","110/07/26","福勝",8,0,8
"19000","1570力肯","110/07/26","台新證券",0,4,-4
"19001","1570力肯","110/07/26","凱基-桃園",7,0,7
"19002","1570力肯","110/07/26","元大-汐止",0,4,-4
"19003","1570力肯","110/07/26","中國信託-永康",3,0,3
"19004","1570力肯","110/07/26","元大-桃興",0,3,-3
"19005","1570力肯","110/07/26","兆豐-台中港",3,0,3
"19006","1570力肯","110/07/26","元富-吉利",0,2,-2
"19007","1570力肯","110/07/26","國票-北高雄",3,0,3
"19008","1570力肯","110/07/26","國泰-板橋",0,2,-2
"19009","1570力肯","110/07/26","富邦-員林",3,0,3
"19010","1570力肯","110/07/26","元大-台中",0,2,-2
"19011","1570力肯","110/07/26","瑞士信貸",2,0,2
"19012","1570力肯","110/07/26","元大-西螺",0,2,-2
"19013","1570力肯","110/07/26","大昌-樹林",2,0,2
"19014","1570力肯","110/07/26","元大-苑裡",0,2,-2
"19015","1570力肯","110/07/26","兆豐-忠孝",2,0,2
"19016","1570力肯","110/07/26","合庫-三重",0,1,-1
"19017","1570力肯","110/07/26","新光",2,0,2
"19018","1570力肯","110/07/26","臺銀-臺南",0,1,-1
"19019","1570力肯","110/07/26","凱基-台北",2,0,2
"19020","1570力肯","110/07/26","元富-永和",0,1,-1
"19021","2929淘帝","110/07/26","合庫-高雄",47,0,47
"19022","2929淘帝","110/07/26","港商野村",11,42,-31
"19023","2929淘帝","110/07/26","元大-民生",28,0,28
"19024","2929淘帝","110/07/26","凱基-林口",0,30,-30
"19025","2929淘帝","110/07/26","臺銀-鳳山",10,0,10
"19026","2929淘帝","110/07/26","美林",1,28,-27
"19027","2929淘帝","110/07/26","華南永昌-鶯歌",10,0,10
"19028","2929淘帝","110/07/26","富邦-竹北",0,20,-20
"19029","2929淘帝","110/07/26","元大-永和",10,0,10
"19030","2929淘帝","110/07/26","凱基-台北",0,12,-12
"19031","2929淘帝","110/07/26","永豐金證券",8,0,8
"19032","2929淘帝","110/07/26","中國信託-永康",0,10,-10
"19033","2929淘帝","110/07/26","元大-太平",8,1,7
"19034","2929淘帝","110/07/26","摩根大通",0,10,-10
"19035","2929淘帝","110/07/26","德信-和平",6,0,6
"19036","2929淘帝","110/07/26","群益金鼎-高雄",0,10,-10
"19037","2929淘帝","110/07/26","兆豐-南門",6,0,6
"19038","2929淘帝","110/07/26","富邦-宜蘭",0,10,-10
"19039","2929淘帝","110/07/26","元大-新竹經國",6,0,6
"19040","2929淘帝","110/07/26","新加坡商瑞銀",4,13,-9
"19041","2929淘帝","110/07/26","合庫-台南",5,0,5
"19042","2929淘帝","110/07/26","元富-敦南",0,7,-7
"19043","2929淘帝","110/07/26","第一金-新興",5,0,5
"19044","2929淘帝","110/07/26","元大-基隆",0,6,-6
"19045","2929淘帝","110/07/26","玉山-新竹",5,0,5
"19046","2929淘帝","110/07/26","新光-台中",1,6,-5
"19047","2929淘帝","110/07/26","元大-金門",5,0,5
"19048","2929淘帝","110/07/26","華南永昌",0,5,-5
"19049","2929淘帝","110/07/26","台新-台中",4,0,4
"19050","2929淘帝","110/07/26","永豐金-中和",0,5,-5
"19051","5410國眾","110/07/26","摩根大通",71,0,71
"19052","5410國眾","110/07/26","日盛-忠孝",0,142,-142
"19053","5410國眾","110/07/26","凱基-台北",67,4,63
"19054","5410國眾","110/07/26","元富-嘉義",0,55,-55
"19055","5410國眾","110/07/26","兆豐-城中",47,0,47
"19056","5410國眾","110/07/26","國泰-敦南",2,30,-28
"19057","5410國眾","110/07/26","永豐金-內湖",45,0,45
"19058","5410國眾","110/07/26","群益金鼎-板橋",0,15,-15
"19059","5410國眾","110/07/26","元大-新莊",26,0,26
"19060","5410國眾","110/07/26","華南永昌-三重",0,11,-11
"19061","5410國眾","110/07/26","兆豐-麻豆",10,0,10
"19062","5410國眾","110/07/26","永全-南崁",0,10,-10
"19063","5410國眾","110/07/26","新光-台中",10,0,10
"19064","5410國眾","110/07/26","台新-建北",1,11,-10
"19065","5410國眾","110/07/26","元大-屏南",10,0,10
"19066","5410國眾","110/07/26","臺銀-臺南",0,8,-8
"19067","5410國眾","110/07/26","港商野村",9,0,9
"19068","5410國眾","110/07/26","群益金鼎-東大",0,7,-7
"19069","5410國眾","110/07/26","新光",13,4,9
"19070","5410國眾","110/07/26","永豐金-中正",0,7,-7
"19071","5410國眾","110/07/26","華南永昌-小港",7,0,7
"19072","5410國眾","110/07/26","永豐金-桃園",0,7,-7
"19073","5410國眾","110/07/26","玉山-左營",6,0,6
"19074","5410國眾","110/07/26","第一金-高雄",0,6,-6
"19075","5410國眾","110/07/26","土銀-台南",5,0,5
"19076","5410國眾","110/07/26","台中銀-豐原",0,6,-6
"19077","5410國眾","110/07/26","新加坡商瑞銀",5,0,5
"19078","5410國眾","110/07/26","亞東-高雄",0,5,-5
"19079","5410國眾","110/07/26","元富-三重",8,3,5
"19080","5410國眾","110/07/26","國票-北高雄",0,5,-5
"19081","2841台開","110/07/26","台新-台中",282,5,277
"19082","2841台開","110/07/26","港商野村",0,128,-128
"19083","2841台開","110/07/26","凱基-台北",41,0,41
"19084","2841台開","110/07/26","富邦-仁愛",0,70,-70
"19085","2841台開","110/07/26","台灣摩根士丹利",40,0,40
"19086","2841台開","110/07/26","元大-彰化",0,60,-60
"19087","2841台開","110/07/26","元富-緯城",40,0,40
"19088","2841台開","110/07/26","永興-水湳",0,30,-30
"19089","2841台開","110/07/26","玉山-高雄",38,0,38
"19090","2841台開","110/07/26","富邦-新竹華信",0,23,-23
"19091","2841台開","110/07/26","日盛-樹林",21,0,21
"19092","2841台開","110/07/26","宏遠-光隆",0,20,-20
"19093","2841台開","110/07/26","元大-松江",20,0,20
"19094","2841台開","110/07/26","玉山證券",0,20,-20
"19095","2841台開","110/07/26","元大-歸仁",20,0,20
"19096","2841台開","110/07/26","富邦-板橋",0,20,-20
"19097","2841台開","110/07/26","國泰-桃園",20,3,17
"19098","2841台開","110/07/26","元大-台中中港",0,19,-19
"19099","2841台開","110/07/26","新光-台中",15,0,15
"19100","2841台開","110/07/26","臺銀-臺南",0,18,-18
"19101","2841台開","110/07/26","群益金鼎-東門",11,0,11
"19102","2841台開","110/07/26","永豐金-敦南",3,19,-16
"19103","2841台開","110/07/26","華南永昌-內壢",11,0,11
"19104","2841台開","110/07/26","統一-桃園",0,13,-13
"19105","2841台開","110/07/26","元富-烏日",10,0,10
"19106","2841台開","110/07/26","國泰-台中",0,11,-11
"19107","2841台開","110/07/26","國泰-忠孝",10,2,8
"19108","2841台開","110/07/26","元大-福營",0,11,-11
"19109","2841台開","110/07/26","元大-潮州",6,0,6
"19110","2841台開","110/07/26","凱基-站前",0,10,-10
"19111","6207雷科","110/07/26","元大-向上",70,0,70
"19112","6207雷科","110/07/26","摩根大通",45,241,-196
"19113","6207雷科","110/07/26","國票-中和",67,5,62
"19114","6207雷科","110/07/26","華南永昌-台中",16,180,-164
"19115","6207雷科","110/07/26","永豐金-台南",63,2,61
"19116","6207雷科","110/07/26","瑞士信貸",4,69,-65
"19117","6207雷科","110/07/26","國泰-板橋",32,0,32
"19118","6207雷科","110/07/26","國票-天祥",11,76,-65
"19119","6207雷科","110/07/26","華南永昌-朴子",24,0,24
"19120","6207雷科","110/07/26","新加坡商瑞銀",15,78,-63
"19121","6207雷科","110/07/26","台新證券",35,12,23
"19122","6207雷科","110/07/26","凱基-台北",86,134,-48
"19123","6207雷科","110/07/26","永豐金-板盛",24,1,23
"19124","6207雷科","110/07/26","富邦-台中",58,100,-42
"19125","6207雷科","110/07/26","康和-台中",24,2,22
"19126","6207雷科","110/07/26","兆豐-大安",0,41,-41
"19127","6207雷科","110/07/26","台新-台南",22,2,20
"19128","6207雷科","110/07/26","群益金鼎-館前",0,40,-40
"19129","6207雷科","110/07/26","元大-大統",22,2,20
"19130","6207雷科","110/07/26","富邦-羅東",2,39,-37
"19131","6207雷科","110/07/26","元富-桃園",19,0,19
"19132","6207雷科","110/07/26","國票-台東",0,30,-30
"19133","6207雷科","110/07/26","高橋",17,0,17
"19134","6207雷科","110/07/26","凱基-士林",1,30,-29
"19135","6207雷科","110/07/26","元富-同大",30,13,17
"19136","6207雷科","110/07/26","元大-南京",3,31,-28
"19137","6207雷科","110/07/26","元大-內湖",17,0,17
"19138","6207雷科","110/07/26","宏遠-桃園",0,24,-24
"19139","6207雷科","110/07/26","永豐金-內湖",19,2,17
"19140","6207雷科","110/07/26","國票-和平",0,23,-23
"19141","3679新至陞","110/07/26","元富-板橋",16,0,16
"19142","3679新至陞","110/07/26","台新-台中",0,19,-19
"19143","3679新至陞","110/07/26","華南永昌-淡水",10,0,10
"19144","3679新至陞","110/07/26","元大-成功",0,10,-10
"19145","3679新至陞","110/07/26","光和-溪湖",8,0,8
"19146","3679新至陞","110/07/26","日進",0,9,-9
"19147","3679新至陞","110/07/26","宏遠-光隆",6,0,6
"19148","3679新至陞","110/07/26","臺銀-臺中",0,5,-5
"19149","3679新至陞","110/07/26","玉山-嘉義",5,0,5
"19150","3679新至陞","110/07/26","港商法國興業",0,4,-4
"19151","3679新至陞","110/07/26","元富-安南",3,0,3
"19152","3679新至陞","110/07/26","統一-新台中",0,3,-3
"19153","3679新至陞","110/07/26","摩根大通",4,1,3
"19154","3679新至陞","110/07/26","大慶-苗栗",1,3,-2
"19155","3679新至陞","110/07/26","凱基-台北",5,2,3
"19156","3679新至陞","110/07/26","元富-松德",0,2,-2
"19157","3679新至陞","110/07/26","凱基-站前",2,0,2
"19158","3679新至陞","110/07/26","富邦-仁愛",0,2,-2
"19159","3679新至陞","110/07/26","華南永昌",2,0,2
"19160","3679新至陞","110/07/26","元大-文心興安",0,2,-2
"19161","3679新至陞","110/07/26","元大-上新莊",2,0,2
"19162","3679新至陞","110/07/26","永豐金證券",0,2,-2
"19163","3679新至陞","110/07/26","美林",4,3,1
"19164","3679新至陞","110/07/26","臺銀-高雄",0,1,-1
"19165","3679新至陞","110/07/26","台灣摩根士丹利",2,1,1
"19166","3679新至陞","110/07/26","台灣企銀-屏東",0,1,-1
"19167","3679新至陞","110/07/26","美商高盛",1,0,1
"19168","3679新至陞","110/07/26","大慶-富順",0,1,-1
"19169","3679新至陞","110/07/26","富邦-台北",1,0,1
"19170","3679新至陞","110/07/26","統一-彰化",0,1,-1
"19171","2727王品","110/07/26","兆豐-南京",300,0,300
"19172","2727王品","110/07/26","元富-安南",0,62,-62
"19173","2727王品","110/07/26","凱基-台北",74,29,45
"19174","2727王品","110/07/26","瑞士信貸",0,44,-44
"19175","2727王品","110/07/26","富邦-建國",25,2,23
"19176","2727王品","110/07/26","新加坡商瑞銀",0,44,-44
"19177","2727王品","110/07/26","台灣摩根士丹利",22,0,22
"19178","2727王品","110/07/26","統一",11,54,-43
"19179","2727王品","110/07/26","永豐金-屏東",14,1,13
"19180","2727王品","110/07/26","美林",4,39,-35
"19181","2727王品","110/07/26","富邦-桃園",12,1,11
"19182","2727王品","110/07/26","第一金",0,30,-30
"19183","2727王品","110/07/26","日盛-鳳山",11,1,10
"19184","2727王品","110/07/26","康和-台中",0,30,-30
"19185","2727王品","110/07/26","元富-城中",10,0,10
"19186","2727王品","110/07/26","國泰證券",1,31,-30
"19187","2727王品","110/07/26","元大-龍潭",11,1,10
"19188","2727王品","110/07/26","元大證券",37,67,-30
"19189","2727王品","110/07/26","新光-台中",15,6,9
"19190","2727王品","110/07/26","康和",1,29,-28
"19191","2727王品","110/07/26","富邦-台中",10,1,9
"19192","2727王品","110/07/26","永豐金證券",0,27,-27
"19193","2727王品","110/07/26","元大-基隆孝二",10,1,9
"19194","2727王品","110/07/26","安泰",1,26,-25
"19195","2727王品","110/07/26","臺銀-臺中",10,2,8
"19196","2727王品","110/07/26","永豐金-古亭",2,20,-18
"19197","2727王品","110/07/26","元大-花蓮",8,0,8
"19198","2727王品","110/07/26","國票-天祥",0,16,-16
"19199","2727王品","110/07/26","元大-斗信",9,1,8
"19200","2727王品","110/07/26","摩根大通",17,33,-16
"19201","1570力肯","110/07/26","元大-民雄",10,0,10
"19202","1570力肯","110/07/26","元大-高雄",0,33,-33
"19203","1570力肯","110/07/26","新光-台中",10,1,9
"19204","1570力肯","110/07/26","日盛-宜蘭",0,8,-8
"19205","1570力肯","110/07/26","富邦-陽明",9,0,9
"19206","1570力肯","110/07/26","美林",0,5,-5
"19207","1570力肯","110/07/26","大慶-蘆洲",8,0,8
"19208","1570力肯","110/07/26","凱基-永康",0,5,-5
"19209","1570力肯","110/07/26","福勝",8,0,8
"19210","1570力肯","110/07/26","台新證券",0,4,-4
"19211","1570力肯","110/07/26","凱基-桃園",7,0,7
"19212","1570力肯","110/07/26","元大-汐止",0,4,-4
"19213","1570力肯","110/07/26","中國信託-永康",3,0,3
"19214","1570力肯","110/07/26","元大-桃興",0,3,-3
"19215","1570力肯","110/07/26","兆豐-台中港",3,0,3
"19216","1570力肯","110/07/26","元富-吉利",0,2,-2
"19217","1570力肯","110/07/26","國票-北高雄",3,0,3
"19218","1570力肯","110/07/26","國泰-板橋",0,2,-2
"19219","1570力肯","110/07/26","富邦-員林",3,0,3
"19220","1570力肯","110/07/26","元大-台中",0,2,-2
"19221","1570力肯","110/07/26","瑞士信貸",2,0,2
"19222","1570力肯","110/07/26","元大-西螺",0,2,-2
"19223","1570力肯","110/07/26","大昌-樹林",2,0,2
"19224","1570力肯","110/07/26","元大-苑裡",0,2,-2
"19225","1570力肯","110/07/26","兆豐-忠孝",2,0,2
"19226","1570力肯","110/07/26","合庫-三重",0,1,-1
"19227","1570力肯","110/07/26","新光",2,0,2
"19228","1570力肯","110/07/26","臺銀-臺南",0,1,-1
"19229","1570力肯","110/07/26","凱基-台北",2,0,2
"19230","1570力肯","110/07/26","元富-永和",0,1,-1
"19231","6180橘子","110/07/26","凱基-台北",121,1,120
"19232","6180橘子","110/07/26","元大-竹山",0,35,-35
"19233","6180橘子","110/07/26","新加坡商瑞銀",71,2,69
"19234","6180橘子","110/07/26","元大-和平",0,30,-30
"19235","6180橘子","110/07/26","摩根大通",70,4,66
"19236","6180橘子","110/07/26","元大-草屯",3,27,-24
"19237","6180橘子","110/07/26","美林",33,0,33
"19238","6180橘子","110/07/26","華南永昌-高雄",0,21,-21
"19239","6180橘子","110/07/26","台灣摩根士丹利",20,4,16
"19240","6180橘子","110/07/26","兆豐-埔墘",0,18,-18
"19241","6180橘子","110/07/26","合庫-高雄",11,0,11
"19242","6180橘子","110/07/26","元富-林園",0,17,-17
"19243","6180橘子","110/07/26","港商野村",10,0,10
"19244","6180橘子","110/07/26","元富-成功",0,16,-16
"19245","6180橘子","110/07/26","富邦-宜蘭",10,0,10
"19246","6180橘子","110/07/26","群益金鼎-台南",0,13,-13
"19247","6180橘子","110/07/26","統一-彰化",10,1,9
"19248","6180橘子","110/07/26","元大-開元",0,13,-13
"19249","6180橘子","110/07/26","兆豐-北高雄",9,1,8
"19250","6180橘子","110/07/26","富邦-台中",0,12,-12
"19251","6180橘子","110/07/26","元大-新店中正",10,2,8
"19252","6180橘子","110/07/26","(牛牛牛)亞-鑫豐",1,12,-11
"19253","6180橘子","110/07/26","國泰-敦南",10,3,7
"19254","6180橘子","110/07/26","台新-台南",0,11,-11
"19255","6180橘子","110/07/26","合庫-自強",5,0,5
"19256","6180橘子","110/07/26","聯邦-興中",0,11,-11
"19257","6180橘子","110/07/26","大慶-蘆洲",5,0,5
"19258","6180橘子","110/07/26","日盛-中和",0,10,-10
"19259","6180橘子","110/07/26","統一-中壢",5,0,5
"19260","6180橘子","110/07/26","康和-台北",0,10,-10
"19261","2390云辰","110/07/26","元大-大同",311,3,308
"19262","2390云辰","110/07/26","摩根大通",139,570,-431
"19263","2390云辰","110/07/26","華南永昌-鳳山",276,4,272
"19264","2390云辰","110/07/26","美林",103,243,-140
"19265","2390云辰","110/07/26","永豐金-竹北",201,6,195
"19266","2390云辰","110/07/26","元大-彰化民生",0,117,-117
"19267","2390云辰","110/07/26","富邦-左營",107,17,90
"19268","2390云辰","110/07/26","元富-中港",0,102,-102
"19269","2390云辰","110/07/26","元富-高雄",82,5,77
"19270","2390云辰","110/07/26","凱基-台北",161,249,-88
"19271","2390云辰","110/07/26","元大-太平",75,10,65
"19272","2390云辰","110/07/26","國票-新莊",15,78,-63
"19273","2390云辰","110/07/26","元大-大益",63,13,50
"19274","2390云辰","110/07/26","第一金-豐原",1,59,-58
"19275","2390云辰","110/07/26","元富-新竹",41,1,40
"19276","2390云辰","110/07/26","統一-竹南",5,48,-43
"19277","2390云辰","110/07/26","日盛-永康",42,4,38
"19278","2390云辰","110/07/26","第一金-台南",28,62,-34
"19279","2390云辰","110/07/26","群益金鼎-中壢",50,12,38
"19280","2390云辰","110/07/26","台灣摩根士丹利",38,70,-32
"19281","2390云辰","110/07/26","元大-鑫永和",54,18,36
"19282","2390云辰","110/07/26","群益金鼎-士林",20,52,-32
"19283","2390云辰","110/07/26","元富-同大",34,1,33
"19284","2390云辰","110/07/26","群益金鼎-延平",2,31,-29
"19285","2390云辰","110/07/26","致和-崇德",52,21,31
"19286","2390云辰","110/07/26","凱基-豐中",12,40,-28
"19287","2390云辰","110/07/26","永豐金-松山",32,2,30
"19288","2390云辰","110/07/26","富邦-中壢",19,47,-28
"19289","2390云辰","110/07/26","凱基-三重",36,8,28
"19290","2390云辰","110/07/26","統一-基隆",2,27,-25
"19291","2363矽統","110/07/20","第一金-忠孝",400,115,285
"19292","2363矽統","110/07/20","國票-長城",3,452,-449
"19293","2363矽統","110/07/20","第一金-高雄",188,0,188
"19294","2363矽統","110/07/20","美林",158,531,-373
"19295","2363矽統","110/07/20","凱基-高美館",199,14,185
"19296","2363矽統","110/07/20","台新-左楠",13,310,-297
"19297","2363矽統","110/07/20","凱基-台北",434,326,108
"19298","2363矽統","110/07/20","玉山-台大",4,228,-224
"19299","2363矽統","110/07/20","元富-松德",105,0,105
"19300","2363矽統","110/07/20","群益金鼎-大甲",11,227,-216
"19301","2363矽統","110/07/20","元大-竹科",109,7,102
"19302","2363矽統","110/07/20","群益金鼎-中港",2,111,-109
"19303","2363矽統","110/07/20","元大-成功",102,2,100
"19304","2363矽統","110/07/20","元大-大天母",0,109,-109
"19305","2363矽統","110/07/20","富邦-仁愛",116,17,99
"19306","2363矽統","110/07/20","國泰-敦南",114,218,-104
"19307","2363矽統","110/07/20","元大-上新莊",102,16,86
"19308","2363矽統","110/07/20","港商野村",250,350,-100
"19309","2363矽統","110/07/20","台新證券",286,208,78
"19310","2363矽統","110/07/20","康和-澎湖",0,90,-90
"19311","2363矽統","110/07/20","元大-新營",81,9,72
"19312","2363矽統","110/07/20","凱基-中壢",15,99,-84
"19313","2363矽統","110/07/20","華南永昌-鳳山",76,5,71
"19314","2363矽統","110/07/20","元大-學甲",0,81,-81
"19315","2363矽統","110/07/20","富邦-員林",65,2,63
"19316","2363矽統","110/07/20","凱基-三重",22,91,-69
"19317","2363矽統","110/07/20","元富-成功",67,6,61
"19318","2363矽統","110/07/20","永豐金-嘉義",24,92,-68
"19319","2363矽統","110/07/20","新光-新竹",62,1,61
"19320","2363矽統","110/07/20","大慶-蘆洲",23,89,-66
"19321","8112至上","110/07/20","摩根大通",1226,293,933
"19322","8112至上","110/07/20","凱基-三重",27,502,-475
"19323","8112至上","110/07/20","新加坡商瑞銀",358,83,275
"19324","8112至上","110/07/20","宏遠證券",0,418,-418
"19325","8112至上","110/07/20","台灣摩根士丹利",159,9,150
"19326","8112至上","110/07/20","台新-台中",11,291,-280
"19327","8112至上","110/07/20","統一-新竹",115,5,110
"19328","8112至上","110/07/20","美林",44,194,-150
"19329","8112至上","110/07/20","新光",233,126,107
"19330","8112至上","110/07/20","凱基-新莊",0,100,-100
"19331","8112至上","110/07/20","凱基-台北",367,260,107
"19332","8112至上","110/07/20","富邦-永和",14,104,-90
"19333","8112至上","110/07/20","兆豐-西螺",104,10,94
"19334","8112至上","110/07/20","國票-敦北法人",4,88,-84
"19335","8112至上","110/07/20","永豐金-中正",87,6,81
"19336","8112至上","110/07/20","凱基-市政",3,80,-77
"19337","8112至上","110/07/20","富邦-新店",102,24,78
"19338","8112至上","110/07/20","台新證券",68,142,-74
"19339","8112至上","110/07/20","元大-大同",83,5,78
"19340","8112至上","110/07/20","永豐金-中壢",11,80,-69
"19341","8112至上","110/07/20","富邦-園區",64,2,62
"19342","8112至上","110/07/20","永豐金-台南",22,91,-69
"19343","8112至上","110/07/20","新光-台南",73,14,59
"19344","8112至上","110/07/20","元大-大雅",22,87,-65
"19345","8112至上","110/07/20","統一-台中",60,2,58
"19346","8112至上","110/07/20","光和",10,67,-57
"19347","8112至上","110/07/20","元大-北成功",58,4,54
"19348","8112至上","110/07/20","元大-竹科",27,74,-47
"19349","8112至上","110/07/20","元富-林園",53,0,53
"19350","8112至上","110/07/20","兆豐-公益",1,47,-46
"19351","1570力肯","110/07/20","國票-北高雄",36,0,36
"19352","1570力肯","110/07/20","國泰-敦南",0,19,-19
"19353","1570力肯","110/07/20","群益金鼎-高雄",16,0,16
"19354","1570力肯","110/07/20","中國信託-永康",0,12,-12
"19355","1570力肯","110/07/20","臺銀-鳳山",10,0,10
"19356","1570力肯","110/07/20","第一金-路竹",0,10,-10
"19357","1570力肯","110/07/20","群益金鼎-新竹",6,0,6
"19358","1570力肯","110/07/20","福勝",0,10,-10
"19359","1570力肯","110/07/20","大昌-樹林",5,0,5
"19360","1570力肯","110/07/20","群益金鼎-板橋",0,10,-10
"19361","1570力肯","110/07/20","華南永昌-楠梓",5,0,5
"19362","1570力肯","110/07/20","日盛-鳳山",0,8,-8
"19363","1570力肯","110/07/20","元大-基隆孝二",5,0,5
"19364","1570力肯","110/07/20","永豐金-新竹",6,14,-8
"19365","1570力肯","110/07/20","元大-新竹經國",4,0,4
"19366","1570力肯","110/07/20","第一金-彰化",0,7,-7
"19367","1570力肯","110/07/20","土銀-高雄",2,0,2
"19368","1570力肯","110/07/20","元富-吉利",0,7,-7
"19369","1570力肯","110/07/20","台灣企銀-太平",2,0,2
"19370","1570力肯","110/07/20","台中銀-員林",0,7,-7
"19371","1570力肯","110/07/20","兆豐-忠孝",2,0,2
"19372","1570力肯","110/07/20","玉山證券",1,8,-7
"19373","1570力肯","110/07/20","玉山-城中",2,0,2
"19374","1570力肯","110/07/20","統一-三重",0,5,-5
"19375","1570力肯","110/07/20","國泰-板橋",2,0,2
"19376","1570力肯","110/07/20","光和-溪湖",0,3,-3
"19377","1570力肯","110/07/20","凱基-台北",2,0,2
"19378","1570力肯","110/07/20","康和-澎湖",0,3,-3
"19379","1570力肯","110/07/20","華南永昌-高雄",2,0,2
"19380","1570力肯","110/07/20","摩根大通",0,2,-2
"19381","2929淘帝","110/07/20","玉山-新竹",59,0,59
"19382","2929淘帝","110/07/20","臺銀",0,45,-45
"19383","2929淘帝","110/07/20","兆豐-新莊",50,0,50
"19384","2929淘帝","110/07/20","光和-嘉義",0,29,-29
"19385","2929淘帝","110/07/20","元大-大甲",30,0,30
"19386","2929淘帝","110/07/20","新加坡商瑞銀",27,55,-28
"19387","2929淘帝","110/07/20","元大-民生",29,0,29
"19388","2929淘帝","110/07/20","華南永昌-潮州",0,20,-20
"19389","2929淘帝","110/07/20","元大-員林",20,0,20
"19390","2929淘帝","110/07/20","玉山-高雄",0,14,-14
"19391","2929淘帝","110/07/20","元富-台南",18,0,18
"19392","2929淘帝","110/07/20","富邦-南屯",2,13,-11
"19393","2929淘帝","110/07/20","港商野村",63,50,13
"19394","2929淘帝","110/07/20","高橋-龍潭",0,10,-10
"19395","2929淘帝","110/07/20","高橋",10,0,10
"19396","2929淘帝","110/07/20","台新-建北",0,10,-10
"19397","2929淘帝","110/07/20","元富-林園",10,0,10
"19398","2929淘帝","110/07/20","群益金鼎-台中",0,10,-10
"19399","2929淘帝","110/07/20","玉山-台南",10,0,10
"19400","2929淘帝","110/07/20","華南永昌-苗栗",0,10,-10
"19401","2929淘帝","110/07/20","群益金鼎-士林",10,0,10
"19402","2929淘帝","110/07/20","群益金鼎-西松",0,9,-9
"19403","2929淘帝","110/07/20","凱基-台北",16,6,10
"19404","2929淘帝","110/07/20","台新-三民",0,8,-8
"19405","2929淘帝","110/07/20","合庫證券",9,0,9
"19406","2929淘帝","110/07/20","群益金鼎",0,8,-8
"19407","2929淘帝","110/07/20","永豐金證券",9,2,7
"19408","2929淘帝","110/07/20","富邦-永和",0,7,-7
"19409","2929淘帝","110/07/20","凱基-基隆",6,0,6
"19410","2929淘帝","110/07/20","國泰-台中",6,12,-6
"19411","5410國眾","110/07/20","日盛-內湖",27,0,27
"19412","5410國眾","110/07/20","永豐金-內湖",0,23,-23
"19413","5410國眾","110/07/20","富邦-新營",20,0,20
"19414","5410國眾","110/07/20","兆豐-台中港",0,20,-20
"19415","5410國眾","110/07/20","大昌",17,0,17
"19416","5410國眾","110/07/20","元富-嘉義",0,15,-15
"19417","5410國眾","110/07/20","永豐金-台南",17,0,17
"19418","5410國眾","110/07/20","元富-吉利",0,11,-11
"19419","5410國眾","110/07/20","凱基-站前",15,0,15
"19420","5410國眾","110/07/20","凱基-長庚",0,10,-10
"19421","5410國眾","110/07/20","凱基-竹北",11,0,11
"19422","5410國眾","110/07/20","元大-八德",0,10,-10
"19423","5410國眾","110/07/20","元富-民權",9,0,9
"19424","5410國眾","110/07/20","元大-天母",0,10,-10
"19425","5410國眾","110/07/20","群益金鼎-嘉義",6,0,6
"19426","5410國眾","110/07/20","國泰-桃園",0,9,-9
"19427","5410國眾","110/07/20","元大-土城學府",6,0,6
"19428","5410國眾","110/07/20","新光",5,12,-7
"19429","5410國眾","110/07/20","第一金-豐原",5,0,5
"19430","5410國眾","110/07/20","玉山-桃園",0,7,-7
"19431","5410國眾","110/07/20","華南永昌-林口",5,0,5
"19432","5410國眾","110/07/20","玉山-雙和",0,6,-6
"19433","5410國眾","110/07/20","元大-博愛",5,0,5
"19434","5410國眾","110/07/20","臺銀-臺南",0,5,-5
"19435","5410國眾","110/07/20","元大-竹南",5,0,5
"19436","5410國眾","110/07/20","彰銀-七賢",0,5,-5
"19437","5410國眾","110/07/20","元大-新店中正",5,0,5
"19438","5410國眾","110/07/20","宏遠證券",0,5,-5
"19439","5410國眾","110/07/20","元富-烏日",4,0,4
"19440","5410國眾","110/07/20","摩根大通",0,5,-5
"19441","2841台開","110/07/20","中國信託-忠孝",145,0,145
"19442","2841台開","110/07/20","凱基-松山",0,100,-100
"19443","2841台開","110/07/20","第一金-台中",68,0,68
"19444","2841台開","110/07/20","第一金-自由",0,33,-33
"19445","2841台開","110/07/20","美商高盛",37,0,37
"19446","2841台開","110/07/20","港商野村",0,29,-29
"19447","2841台開","110/07/20","台中銀",32,0,32
"19448","2841台開","110/07/20","國泰-敦南",11,31,-20
"19449","2841台開","110/07/20","台新-台中",20,0,20
"19450","2841台開","110/07/20","華南永昌-台中",0,20,-20
"19451","2841台開","110/07/20","凱基-東港",10,0,10
"19452","2841台開","110/07/20","元大-發財",0,15,-15
"19453","2841台開","110/07/20","大昌-安康",10,3,7
"19454","2841台開","110/07/20","元大-福營",9,23,-14
"19455","2841台開","110/07/20","豐農",7,0,7
"19456","2841台開","110/07/20","永豐金-敦南",5,18,-13
"19457","2841台開","110/07/20","元大-歸仁",7,0,7
"19458","2841台開","110/07/20","統一-城中",0,11,-11
"19459","2841台開","110/07/20","日盛-木柵",5,0,5
"19460","2841台開","110/07/20","日盛-台南",0,10,-10
"19461","2841台開","110/07/20","台新-台南",4,0,4
"19462","2841台開","110/07/20","兆豐-寶成",0,10,-10
"19463","2841台開","110/07/20","日盛證券",3,0,3
"19464","2841台開","110/07/20","國票-中港",0,10,-10
"19465","2841台開","110/07/20","台新證券",8,5,3
"19466","2841台開","110/07/20","群益金鼎",0,10,-10
"19467","2841台開","110/07/20","元大-沙鹿",3,0,3
"19468","2841台開","110/07/20","玉山證券",1,10,-9
"19469","2841台開","110/07/20","國泰-台中",2,0,2
"19470","2841台開","110/07/20","大昌-新店",0,6,-6
"19471","6207雷科","110/07/20","元大-西門",100,4,96
"19472","6207雷科","110/07/20","永豐金-內湖",0,109,-109
"19473","6207雷科","110/07/20","凱基-復興",50,0,50
"19474","6207雷科","110/07/20","國泰證券",0,90,-90
"19475","6207雷科","110/07/20","凱基-台北",47,1,46
"19476","6207雷科","110/07/20","元大-頭份",0,55,-55
"19477","6207雷科","110/07/20","玉山-城中",43,1,42
"19478","6207雷科","110/07/20","永豐金-虎尾",0,50,-50
"19479","6207雷科","110/07/20","華南永昌-長虹",44,5,39
"19480","6207雷科","110/07/20","元富-世貿",0,33,-33
"19481","6207雷科","110/07/20","凱基-板橋",38,1,37
"19482","6207雷科","110/07/20","元大-南崁",0,22,-22
"19483","6207雷科","110/07/20","元富-信義",39,3,36
"19484","6207雷科","110/07/20","永豐金-鳳山",0,21,-21
"19485","6207雷科","110/07/20","元富-彰化",35,0,35
"19486","6207雷科","110/07/20","永豐金-三重",6,27,-21
"19487","6207雷科","110/07/20","凱基-高美館",34,0,34
"19488","6207雷科","110/07/20","第一金-澎湖",0,20,-20
"19489","6207雷科","110/07/20","富邦-中壢",26,2,24
"19490","6207雷科","110/07/20","群益金鼎-東大",0,20,-20
"19491","6207雷科","110/07/20","大昌-桃園",23,0,23
"19492","6207雷科","110/07/20","兆豐-民生",0,19,-19
"19493","6207雷科","110/07/20","元大-四維",39,17,22
"19494","6207雷科","110/07/20","元大-北成功",1,20,-19
"19495","6207雷科","110/07/20","台灣摩根士丹利",18,0,18
"19496","6207雷科","110/07/20","元大-虎尾",1,18,-17
"19497","6207雷科","110/07/20","國票-中和",16,0,16
"19498","6207雷科","110/07/20","元大-文心興安",0,15,-15
"19499","6207雷科","110/07/20","永豐金-大園",16,0,16
"19500","6207雷科","110/07/20","瑞士信貸",0,14,-14
"19501","3679新至陞","110/07/20","國票-敦北法人",18,0,18
"19502","3679新至陞","110/07/20","華南永昌-台中",0,32,-32
"19503","3679新至陞","110/07/20","台中銀-員林",17,3,14
"19504","3679新至陞","110/07/20","凱基-台北",12,32,-20
"19505","3679新至陞","110/07/20","群益金鼎-高盛",13,0,13
"19506","3679新至陞","110/07/20","摩根大通",2,14,-12
"19507","3679新至陞","110/07/20","康和-澎湖",8,0,8
"19508","3679新至陞","110/07/20","國泰-桃園",0,11,-11
"19509","3679新至陞","110/07/20","台新證券",6,0,6
"19510","3679新至陞","110/07/20","群益金鼎-台南",0,10,-10
"19511","3679新至陞","110/07/20","宏遠-光隆",4,0,4
"19512","3679新至陞","110/07/20","群益金鼎-大安",0,10,-10
"19513","3679新至陞","110/07/20","玉山-大里",4,0,4
"19514","3679新至陞","110/07/20","永豐金證券",4,14,-10
"19515","3679新至陞","110/07/20","台中銀-豐原",3,0,3
"19516","3679新至陞","110/07/20","兆豐-大同",1,6,-5
"19517","3679新至陞","110/07/20","玉山-新莊",3,0,3
"19518","3679新至陞","110/07/20","群益金鼎-館前",0,4,-4
"19519","3679新至陞","110/07/20","凱基-中山",3,0,3
"19520","3679新至陞","110/07/20","富邦-南屯",0,4,-4
"19521","3679新至陞","110/07/20","富邦-台北",3,0,3
"19522","3679新至陞","110/07/20","瑞士信貸",3,6,-3
"19523","3679新至陞","110/07/20","元大-板橋",3,0,3
"19524","3679新至陞","110/07/20","國泰-板橋",0,3,-3
"19525","3679新至陞","110/07/20","日盛-八德",2,0,2
"19526","3679新至陞","110/07/20","富邦-中壢",1,4,-3
"19527","3679新至陞","110/07/20","日盛-復興",2,0,2
"19528","3679新至陞","110/07/20","台灣企銀",0,2,-2
"19529","3679新至陞","110/07/20","康和-板橋",2,0,2
"19530","3679新至陞","110/07/20","日盛-大墩",0,2,-2
"19531","2727王品","110/07/20","兆豐-南京",200,0,200
"19532","2727王品","110/07/20","凱基-市政",1,75,-74
"19533","2727王品","110/07/20","富邦證券",88,0,88
"19534","2727王品","110/07/20","美商高盛",6,38,-32
"19535","2727王品","110/07/20","台新證券",142,55,87
"19536","2727王品","110/07/20","富邦-陽明",7,38,-31
"19537","2727王品","110/07/20","瑞士信貸",50,0,50
"19538","2727王品","110/07/20","永豐金-中正",3,34,-31
"19539","2727王品","110/07/20","港商野村",106,57,49
"19540","2727王品","110/07/20","永豐金-潮州",0,31,-31
"19541","2727王品","110/07/20","凱基-台北",67,27,40
"19542","2727王品","110/07/20","兆豐-大安",0,30,-30
"19543","2727王品","110/07/20","永豐金-大園",29,2,27
"19544","2727王品","110/07/20","摩根大通",50,73,-23
"19545","2727王品","110/07/20","康和-高雄",20,0,20
"19546","2727王品","110/07/20","日盛證券",4,24,-20
"19547","2727王品","110/07/20","第一金-高雄",20,3,17
"19548","2727王品","110/07/20","凱基-大里",0,20,-20
"19549","2727王品","110/07/20","富邦-板橋",21,4,17
"19550","2727王品","110/07/20","群益金鼎-大甲",0,18,-18
"19551","2727王品","110/07/20","永豐金-桃盛",15,0,15
"19552","2727王品","110/07/20","統一",18,29,-11
"19553","2727王品","110/07/20","凱基",13,0,13
"19554","2727王品","110/07/20","國泰-台中",12,23,-11
"19555","2727王品","110/07/20","新加坡商瑞銀",23,11,12
"19556","2727王品","110/07/20","元大-彰化",0,11,-11
"19557","2727王品","110/07/20","亞東",10,0,10
"19558","2727王品","110/07/20","國泰-館前",4,14,-10
"19559","2727王品","110/07/20","康和-台中",13,4,9
"19560","2727王品","110/07/20","元大-學甲",0,10,-10
"19561","1570力肯","110/07/20","國票-北高雄",36,0,36
"19562","1570力肯","110/07/20","國泰-敦南",0,19,-19
"19563","1570力肯","110/07/20","群益金鼎-高雄",16,0,16
"19564","1570力肯","110/07/20","中國信託-永康",0,12,-12
"19565","1570力肯","110/07/20","臺銀-鳳山",10,0,10
"19566","1570力肯","110/07/20","第一金-路竹",0,10,-10
"19567","1570力肯","110/07/20","群益金鼎-新竹",6,0,6
"19568","1570力肯","110/07/20","福勝",0,10,-10
"19569","1570力肯","110/07/20","大昌-樹林",5,0,5
"19570","1570力肯","110/07/20","群益金鼎-板橋",0,10,-10
"19571","1570力肯","110/07/20","華南永昌-楠梓",5,0,5
"19572","1570力肯","110/07/20","日盛-鳳山",0,8,-8
"19573","1570力肯","110/07/20","元大-基隆孝二",5,0,5
"19574","1570力肯","110/07/20","永豐金-新竹",6,14,-8
"19575","1570力肯","110/07/20","元大-新竹經國",4,0,4
"19576","1570力肯","110/07/20","第一金-彰化",0,7,-7
"19577","1570力肯","110/07/20","土銀-高雄",2,0,2
"19578","1570力肯","110/07/20","元富-吉利",0,7,-7
"19579","1570力肯","110/07/20","台灣企銀-太平",2,0,2
"19580","1570力肯","110/07/20","台中銀-員林",0,7,-7
"19581","1570力肯","110/07/20","兆豐-忠孝",2,0,2
"19582","1570力肯","110/07/20","玉山證券",1,8,-7
"19583","1570力肯","110/07/20","玉山-城中",2,0,2
"19584","1570力肯","110/07/20","統一-三重",0,5,-5
"19585","1570力肯","110/07/20","國泰-板橋",2,0,2
"19586","1570力肯","110/07/20","光和-溪湖",0,3,-3
"19587","1570力肯","110/07/20","凱基-台北",2,0,2
"19588","1570力肯","110/07/20","康和-澎湖",0,3,-3
"19589","1570力肯","110/07/20","華南永昌-高雄",2,0,2
"19590","1570力肯","110/07/20","摩根大通",0,2,-2
"19591","6180橘子","110/07/20","摩根大通",89,31,58
"19592","6180橘子","110/07/20","群益金鼎-中山",0,80,-80
"19593","6180橘子","110/07/20","美商高盛",27,0,27
"19594","6180橘子","110/07/20","台中銀-台北",0,30,-30
"19595","6180橘子","110/07/20","新加坡商瑞銀",28,1,27
"19596","6180橘子","110/07/20","日盛-新莊",1,22,-21
"19597","6180橘子","110/07/20","新光",41,16,25
"19598","6180橘子","110/07/20","元富-緯城",2,20,-18
"19599","6180橘子","110/07/20","日盛-文化",21,0,21
"19600","6180橘子","110/07/20","日盛-新竹",2,15,-13
"19601","6180橘子","110/07/20","元富-潮州",20,0,20
"19602","6180橘子","110/07/20","元大-汐止",0,12,-12
"19603","6180橘子","110/07/20","凱基-台北",31,11,20
"19604","6180橘子","110/07/20","元大-豐原站前",0,12,-12
"19605","6180橘子","110/07/20","元大-草屯",18,0,18
"19606","6180橘子","110/07/20","德信-中正",0,10,-10
"19607","6180橘子","110/07/20","花旗環球",13,0,13
"19608","6180橘子","110/07/20","新光-台南",0,10,-10
"19609","6180橘子","110/07/20","元大-桃園",12,0,12
"19610","6180橘子","110/07/20","玉山-雙和",0,10,-10
"19611","6180橘子","110/07/20","群益金鼎",10,0,10
"19612","6180橘子","110/07/20","元大-四維",0,10,-10
"19613","6180橘子","110/07/20","元大-高雄",10,0,10
"19614","6180橘子","110/07/20","元大-永春",2,12,-10
"19615","6180橘子","110/07/20","群益金鼎-嘉義",9,0,9
"19616","6180橘子","110/07/20","凱基-高美館",0,8,-8
"19617","6180橘子","110/07/20","富邦-嘉義",9,0,9
"19618","6180橘子","110/07/20","華南永昌",2,10,-8
"19619","6180橘子","110/07/20","元富-草屯",10,2,8
"19620","6180橘子","110/07/20","富邦-台北",0,8,-8
"19621","2390云辰","110/07/20","元大證券",6043,11,6032
"19622","2390云辰","110/07/20","華南永昌-鳳山",2,312,-310
"19623","2390云辰","110/07/20","兆豐-復興",998,0,998
"19624","2390云辰","110/07/20","台灣摩根士丹利",0,247,-247
"19625","2390云辰","110/07/20","富邦-嘉義",775,7,768
"19626","2390云辰","110/07/20","元大-復北",4,239,-235
"19627","2390云辰","110/07/20","統一-台中",350,6,344
"19628","2390云辰","110/07/20","富邦-建國",25,236,-211
"19629","2390云辰","110/07/20","兆豐-城中",240,0,240
"19630","2390云辰","110/07/20","元富-中港",0,202,-202
"19631","2390云辰","110/07/20","群益金鼎-館前",204,2,202
"19632","2390云辰","110/07/20","國泰-敦南",20,194,-174
"19633","2390云辰","110/07/20","凱基-大直",187,0,187
"19634","2390云辰","110/07/20","元大-土城學府",10,156,-146
"19635","2390云辰","110/07/20","永豐金證券",160,10,150
"19636","2390云辰","110/07/20","中國信託-松江",0,130,-130
"19637","2390云辰","110/07/20","日盛-高雄",104,2,102
"19638","2390云辰","110/07/20","凱基-基隆",0,130,-130
"19639","2390云辰","110/07/20","凱基-中山",100,3,97
"19640","2390云辰","110/07/20","永豐金-中正",1,117,-116
"19641","2390云辰","110/07/20","元大-基隆",85,7,78
"19642","2390云辰","110/07/20","富邦-陽明",1,94,-93
"19643","2390云辰","110/07/20","群益金鼎-東大",64,2,62
"19644","2390云辰","110/07/20","元大-潮州",20,112,-92
"19645","2390云辰","110/07/20","元大-前金",60,1,59
"19646","2390云辰","110/07/20","宏遠證券",0,89,-89
"19647","2390云辰","110/07/20","國票-北高雄",63,14,49
"19648","2390云辰","110/07/20","兆豐-台中",0,75,-75
"19649","2390云辰","110/07/20","群益金鼎-三重",40,6,34
"19650","2390云辰","110/07/20","新光",8,82,-74
"19651","2363矽統","110/07/19","第一金-忠孝",210,0,210
"19652","2363矽統","110/07/19","富邦-仁愛",32,575,-543
"19653","2363矽統","110/07/19","中國信託-文心",191,9,182
"19654","2363矽統","110/07/19","新加坡商瑞銀",53,486,-433
"19655","2363矽統","110/07/19","華南永昌-鳳山",116,1,115
"19656","2363矽統","110/07/19","摩根大通",42,320,-278
"19657","2363矽統","110/07/19","元大-新竹",113,12,101
"19658","2363矽統","110/07/19","元大-竹科",3,201,-198
"19659","2363矽統","110/07/19","凱基-中山",89,1,88
"19660","2363矽統","110/07/19","元大-成功",7,183,-176
"19661","2363矽統","110/07/19","永豐金-嘉義",82,7,75
"19662","2363矽統","110/07/19","凱基-大里",0,150,-150
"19663","2363矽統","110/07/19","凱基-台南",72,4,68
"19664","2363矽統","110/07/19","瑞士信貸",80,215,-135
"19665","2363矽統","110/07/19","元富-城東",84,17,67
"19666","2363矽統","110/07/19","日盛-新莊",4,135,-131
"19667","2363矽統","110/07/19","群益金鼎-東湖",61,0,61
"19668","2363矽統","110/07/19","宏遠-桃園",20,150,-130
"19669","2363矽統","110/07/19","兆豐-中壢",55,0,55
"19670","2363矽統","110/07/19","凱基-三重",7,107,-100
"19671","2363矽統","110/07/19","康和-內湖",55,1,54
"19672","2363矽統","110/07/19","凱基-台北",384,476,-92
"19673","2363矽統","110/07/19","群益金鼎-桃園",55,2,53
"19674","2363矽統","110/07/19","合庫-台中",3,84,-81
"19675","2363矽統","110/07/19","群益金鼎-大興",50,0,50
"19676","2363矽統","110/07/19","致和-金華",1,80,-79
"19677","2363矽統","110/07/19","台新-台中",81,32,49
"19678","2363矽統","110/07/19","凱基-員林",5,77,-72
"19679","2363矽統","110/07/19","北城證券",58,10,48
"19680","2363矽統","110/07/19","華南永昌-合泰",2,70,-68
"19681","8112至上","110/07/19","摩根大通",1413,144,1269
"19682","8112至上","110/07/19","凱基-三重",3,600,-597
"19683","8112至上","110/07/19","凱基-台北",1053,266,787
"19684","8112至上","110/07/19","元大-府城",0,165,-165
"19685","8112至上","110/07/19","新加坡商瑞銀",523,2,521
"19686","8112至上","110/07/19","台灣企銀-台中",0,150,-150
"19687","8112至上","110/07/19","台灣摩根士丹利",487,8,479
"19688","8112至上","110/07/19","(牛牛牛)亞-鑫豐",26,119,-93
"19689","8112至上","110/07/19","美林",529,93,436
"19690","8112至上","110/07/19","永豐金-台南",15,95,-80
"19691","8112至上","110/07/19","港商野村",358,36,322
"19692","8112至上","110/07/19","亞東-板橋",2,81,-79
"19693","8112至上","110/07/19","美商高盛",276,3,273
"19694","8112至上","110/07/19","陽信",0,70,-70
"19695","8112至上","110/07/19","兆豐-公益",180,7,173
"19696","8112至上","110/07/19","元富-佳里",0,69,-69
"19697","8112至上","110/07/19","國泰-板橋",116,15,101
"19698","8112至上","110/07/19","臺銀-鳳山",7,72,-65
"19699","8112至上","110/07/19","凱基-新莊",100,1,99
"19700","8112至上","110/07/19","兆豐-竹北",4,65,-61
"19701","8112至上","110/07/19","凱基-市政",89,0,89
"19702","8112至上","110/07/19","國泰-新莊",2,62,-60
"19703","8112至上","110/07/19","玉山證券",73,7,66
"19704","8112至上","110/07/19","元富-大裕",2,60,-58
"19705","8112至上","110/07/19","花旗環球",64,0,64
"19706","8112至上","110/07/19","臺灣企銀-桃園",0,55,-55
"19707","8112至上","110/07/19","合庫-台中",55,3,52
"19708","8112至上","110/07/19","康和-台南",4,59,-55
"19709","8112至上","110/07/19","永豐金-中壢",50,1,49
"19710","8112至上","110/07/19","第一金-華江",3,55,-52
"19711","1570力肯","110/07/19","國票-北高雄",34,0,34
"19712","1570力肯","110/07/19","合庫-三重",0,8,-8
"19713","1570力肯","110/07/19","新光",30,3,27
"19714","1570力肯","110/07/19","元大-高雄",0,8,-8
"19715","1570力肯","110/07/19","凱基-台北",24,1,23
"19716","1570力肯","110/07/19","合庫-台中",0,7,-7
"19717","1570力肯","110/07/19","台灣摩根士丹利",7,0,7
"19718","1570力肯","110/07/19","臺銀-臺中",0,6,-6
"19719","1570力肯","110/07/19","元大-林森",5,0,5
"19720","1570力肯","110/07/19","摩根大通",6,11,-5
"19721","1570力肯","110/07/19","元大-士林",4,0,4
"19722","1570力肯","110/07/19","元富-緯城",0,4,-4
"19723","1570力肯","110/07/19","玉山證券",8,5,3
"19724","1570力肯","110/07/19","玉山-台大",0,4,-4
"19725","1570力肯","110/07/19","統一-城中",2,0,2
"19726","1570力肯","110/07/19","群益金鼎-三重",0,4,-4
"19727","1570力肯","110/07/19","元大-基隆孝二",2,0,2
"19728","1570力肯","110/07/19","凱基-鳳山",1,5,-4
"19729","1570力肯","110/07/19","土銀-建國",1,0,1
"19730","1570力肯","110/07/19","元大-板橋",0,4,-4
"19731","1570力肯","110/07/19","日盛-復興",1,0,1
"19732","1570力肯","110/07/19","日盛-和美",0,3,-3
"19733","1570力肯","110/07/19","瑞士信貸",1,0,1
"19734","1570力肯","110/07/19","元富-新店",2,5,-3
"19735","1570力肯","110/07/19","元富-四維",1,0,1
"19736","1570力肯","110/07/19","元大-新莊",0,3,-3
"19737","1570力肯","110/07/19","群益金鼎-北高雄",1,0,1
"19738","1570力肯","110/07/19","永豐金-敦南",0,3,-3
"19739","1570力肯","110/07/19","凱基-高美館",1,0,1
"19740","1570力肯","110/07/19","永豐金-台中",0,3,-3
"19741","2929淘帝","110/07/19","元大-民生",28,0,28
"19742","2929淘帝","110/07/19","元大-六合",0,40,-40
"19743","2929淘帝","110/07/19","宏遠-光隆",25,0,25
"19744","2929淘帝","110/07/19","新光-新竹",0,35,-35
"19745","2929淘帝","110/07/19","華南永昌-苗栗",20,0,20
"19746","2929淘帝","110/07/19","新加坡商瑞銀",1,30,-29
"19747","2929淘帝","110/07/19","元大-員林",20,0,20
"19748","2929淘帝","110/07/19","永豐金-永康",0,27,-27
"19749","2929淘帝","110/07/19","合庫-高雄",18,0,18
"19750","2929淘帝","110/07/19","凱基-復興",0,24,-24
"19751","2929淘帝","110/07/19","臺銀-鳳山",18,0,18
"19752","2929淘帝","110/07/19","日盛-豐原",0,22,-22
"19753","2929淘帝","110/07/19","日盛-雙和",17,0,17
"19754","2929淘帝","110/07/19","富邦-南屯",1,22,-21
"19755","2929淘帝","110/07/19","華南永昌-林口",15,0,15
"19756","2929淘帝","110/07/19","新光",1,21,-20
"19757","2929淘帝","110/07/19","元大-屏南",15,0,15
"19758","2929淘帝","110/07/19","華南永昌",0,20,-20
"19759","2929淘帝","110/07/19","台新-中壢",12,0,12
"19760","2929淘帝","110/07/19","富邦-竹東",2,22,-20
"19761","2929淘帝","110/07/19","新光-台中",11,0,11
"19762","2929淘帝","110/07/19","凱基-士林",0,16,-16
"19763","2929淘帝","110/07/19","凱基-台北",20,9,11
"19764","2929淘帝","110/07/19","福勝",0,15,-15
"19765","2929淘帝","110/07/19","富邦-台北",11,0,11
"19766","2929淘帝","110/07/19","港商野村",25,37,-12
"19767","2929淘帝","110/07/19","合庫-自強",10,0,10
"19768","2929淘帝","110/07/19","群益金鼎-建成",0,11,-11
"19769","2929淘帝","110/07/19","凱基-豐中",10,0,10
"19770","2929淘帝","110/07/19","華南永昌-朴子",0,11,-11
"19771","5410國眾","110/07/19","香港上海匯豐",28,0,28
"19772","5410國眾","110/07/19","群益金鼎-內湖",0,80,-80
"19773","5410國眾","110/07/19","大昌",26,0,26
"19774","5410國眾","110/07/19","永豐金-屏東",0,14,-14
"19775","5410國眾","110/07/19","兆豐-公益",20,0,20
"19776","5410國眾","110/07/19","永豐金-南京",0,10,-10
"19777","5410國眾","110/07/19","合庫-嘉義",10,0,10
"19778","5410國眾","110/07/19","元大-內湖",0,9,-9
"19779","5410國眾","110/07/19","台新-左楠",20,10,10
"19780","5410國眾","110/07/19","富邦-永和",0,8,-8
"19781","5410國眾","110/07/19","摩根大通",15,6,9
"19782","5410國眾","110/07/19","日盛-景美",0,6,-6
"19783","5410國眾","110/07/19","台灣企銀-民雄",8,0,8
"19784","5410國眾","110/07/19","光和",1,7,-6
"19785","5410國眾","110/07/19","元大-竹科",8,0,8
"19786","5410國眾","110/07/19","元大-士林",0,6,-6
"19787","5410國眾","110/07/19","凱基-台北",9,3,6
"19788","5410國眾","110/07/19","新光-台中",0,5,-5
"19789","5410國眾","110/07/19","元大-博愛",6,0,6
"19790","5410國眾","110/07/19","元大-景美",0,5,-5
"19791","5410國眾","110/07/19","台新-三民",5,0,5
"19792","5410國眾","110/07/19","大慶-蘆洲",0,4,-4
"19793","5410國眾","110/07/19","群益金鼎-中壢",5,0,5
"19794","5410國眾","110/07/19","中國信託-新竹",0,4,-4
"19795","5410國眾","110/07/19","群益金鼎-嘉義",5,0,5
"19796","5410國眾","110/07/19","新光",6,10,-4
"19797","5410國眾","110/07/19","日盛證券",4,0,4
"19798","5410國眾","110/07/19","元大-基隆孝二",0,4,-4
"19799","5410國眾","110/07/19","群益金鼎-新店",4,0,4
"19800","5410國眾","110/07/19","土銀-台中",0,3,-3
"19801","2841台開","110/07/19","元富-城東",150,0,150
"19802","2841台開","110/07/19","日進",0,80,-80
"19803","2841台開","110/07/19","中國信託-忠孝",80,0,80
"19804","2841台開","110/07/19","港商野村",0,77,-77
"19805","2841台開","110/07/19","凱基-台北",52,0,52
"19806","2841台開","110/07/19","摩根大通",0,41,-41
"19807","2841台開","110/07/19","美商高盛",48,0,48
"19808","2841台開","110/07/19","元大-三重",1,38,-37
"19809","2841台開","110/07/19","台中銀",43,0,43
"19810","2841台開","110/07/19","元大-福營",0,30,-30
"19811","2841台開","110/07/19","永豐金-豐原",32,0,32
"19812","2841台開","110/07/19","新光",4,28,-24
"19813","2841台開","110/07/19","豐農",20,0,20
"19814","2841台開","110/07/19","元大-竹科",0,22,-22
"19815","2841台開","110/07/19","台新-台中",30,10,20
"19816","2841台開","110/07/19","永豐金-敦南",33,55,-22
"19817","2841台開","110/07/19","華南永昌-新莊",20,0,20
"19818","2841台開","110/07/19","日盛-二林",0,15,-15
"19819","2841台開","110/07/19","第一金-台中",12,0,12
"19820","2841台開","110/07/19","元富-虎尾",0,15,-15
"19821","2841台開","110/07/19","國泰-台中",12,0,12
"19822","2841台開","110/07/19","華南永昌-世貿",0,15,-15
"19823","2841台開","110/07/19","日茂",10,0,10
"19824","2841台開","110/07/19","統一-三多",0,12,-12
"19825","2841台開","110/07/19","凱基-埔墘",10,0,10
"19826","2841台開","110/07/19","台中銀-豐原",0,10,-10
"19827","2841台開","110/07/19","永豐金-內湖",8,0,8
"19828","2841台開","110/07/19","元大-頭份",0,10,-10
"19829","2841台開","110/07/19","合庫-台中",7,0,7
"19830","2841台開","110/07/19","合庫-台南",0,8,-8
"19831","6207雷科","110/07/19","元富-信義",92,0,92
"19832","6207雷科","110/07/19","新加坡商瑞銀",5,104,-99
"19833","6207雷科","110/07/19","國泰證券",90,0,90
"19834","6207雷科","110/07/19","富邦-彰化",2,97,-95
"19835","6207雷科","110/07/19","元富-城中",80,4,76
"19836","6207雷科","110/07/19","永豐金-內湖",6,85,-79
"19837","6207雷科","110/07/19","元大-福營",71,5,66
"19838","6207雷科","110/07/19","摩根大通",102,164,-62
"19839","6207雷科","110/07/19","凱基-復興",60,0,60
"19840","6207雷科","110/07/19","瑞士信貸",0,51,-51
"19841","6207雷科","110/07/19","凱基-台北",91,46,45
"19842","6207雷科","110/07/19","凱基-板橋",10,55,-45
"19843","6207雷科","110/07/19","玉山-城中",42,0,42
"19844","6207雷科","110/07/19","華南永昌-大安",0,40,-40
"19845","6207雷科","110/07/19","華南永昌-長虹",40,0,40
"19846","6207雷科","110/07/19","群益金鼎-東大",1,40,-39
"19847","6207雷科","110/07/19","永豐金-羅東",38,0,38
"19848","6207雷科","110/07/19","台新-高雄",15,47,-32
"19849","6207雷科","110/07/19","日盛-忠孝",36,2,34
"19850","6207雷科","110/07/19","玉山-嘉義",1,32,-31
"19851","6207雷科","110/07/19","凱基-羅東",37,3,34
"19852","6207雷科","110/07/19","凱基-中港",0,30,-30
"19853","6207雷科","110/07/19","第一金-新竹",30,0,30
"19854","6207雷科","110/07/19","元大-六合",7,36,-29
"19855","6207雷科","110/07/19","玉山-數位",27,1,26
"19856","6207雷科","110/07/19","元富-花蓮",0,28,-28
"19857","6207雷科","110/07/19","凱基-長庚",22,0,22
"19858","6207雷科","110/07/19","群益金鼎-瑞豐",6,34,-28
"19859","6207雷科","110/07/19","台灣企銀-北高雄",20,0,20
"19860","6207雷科","110/07/19","新百王",0,26,-26
"19861","3679新至陞","110/07/19","元大-成功",7,0,7
"19862","3679新至陞","110/07/19","群益金鼎-大安",0,15,-15
"19863","3679新至陞","110/07/19","美商高盛",6,0,6
"19864","3679新至陞","110/07/19","凱基-民權",0,10,-10
"19865","3679新至陞","110/07/19","台新-高雄",5,0,5
"19866","3679新至陞","110/07/19","元大-西門",0,10,-10
"19867","3679新至陞","110/07/19","凱基-松山",5,0,5
"19868","3679新至陞","110/07/19","瑞士信貸",0,6,-6
"19869","3679新至陞","110/07/19","日盛-員林",4,0,4
"19870","3679新至陞","110/07/19","兆豐-高雄",0,6,-6
"19871","3679新至陞","110/07/19","台中銀-員林",4,0,4
"19872","3679新至陞","110/07/19","群益金鼎",0,5,-5
"19873","3679新至陞","110/07/19","(牛牛牛)亞-網路",3,0,3
"19874","3679新至陞","110/07/19","元大-永春",0,4,-4
"19875","3679新至陞","110/07/19","大昌-新店",3,0,3
"19876","3679新至陞","110/07/19","凱基-台北",2,5,-3
"19877","3679新至陞","110/07/19","凱基-埔墘",3,0,3
"19878","3679新至陞","110/07/19","港商法國興業",0,2,-2
"19879","3679新至陞","110/07/19","元大-板橋",3,0,3
"19880","3679新至陞","110/07/19","摩根大通",2,4,-2
"19881","3679新至陞","110/07/19","臺銀-金山",2,0,2
"19882","3679新至陞","110/07/19","元大-金門",0,2,-2
"19883","3679新至陞","110/07/19","日盛-樹林",2,0,2
"19884","3679新至陞","110/07/19","元大-土城",0,2,-2
"19885","3679新至陞","110/07/19","致和-東門",2,0,2
"19886","3679新至陞","110/07/19","日盛-鳳山",0,1,-1
"19887","3679新至陞","110/07/19","國票-敦北法人",2,0,2
"19888","3679新至陞","110/07/19","美林",1,2,-1
"19889","3679新至陞","110/07/19","台新證券",2,0,2
"19890","3679新至陞","110/07/19","第一金",0,1,-1
"19891","2727王品","110/07/19","台新證券",374,33,341
"19892","2727王品","110/07/19","台灣摩根士丹利",25,188,-163
"19893","2727王品","110/07/19","瑞士信貸",217,1,216
"19894","2727王品","110/07/19","港商野村",74,198,-124
"19895","2727王品","110/07/19","兆豐-南京",200,0,200
"19896","2727王品","110/07/19","統一",6,80,-74
"19897","2727王品","110/07/19","第一金",70,1,69
"19898","2727王品","110/07/19","合庫-台中",8,79,-71
"19899","2727王品","110/07/19","元大-小港",59,1,58
"19900","2727王品","110/07/19","凱基-台北",178,231,-53
"19901","2727王品","110/07/19","玉山-桃園",42,6,36
"19902","2727王品","110/07/19","富邦-中壢",3,52,-49
"19903","2727王品","110/07/19","永豐金-大園",31,0,31
"19904","2727王品","110/07/19","凱基-永華",0,43,-43
"19905","2727王品","110/07/19","兆豐-大安",30,0,30
"19906","2727王品","110/07/19","土銀-台中",0,36,-36
"19907","2727王品","110/07/19","美商高盛",38,15,23
"19908","2727王品","110/07/19","美林",8,41,-33
"19909","2727王品","110/07/19","康和-澎湖",23,1,22
"19910","2727王品","110/07/19","中國信託-忠孝",1,33,-32
"19911","2727王品","110/07/19","第一金-高雄",21,0,21
"19912","2727王品","110/07/19","新光",31,61,-30
"19913","2727王品","110/07/19","國票-內壢",21,0,21
"19914","2727王品","110/07/19","第一金-豐原",0,26,-26
"19915","2727王品","110/07/19","元大-桃興",19,3,16
"19916","2727王品","110/07/19","富邦-彰化",0,26,-26
"19917","2727王品","110/07/19","凱基-三重",16,1,15
"19918","2727王品","110/07/19","摩根大通",78,97,-19
"19919","2727王品","110/07/19","永豐金-南投",16,1,15
"19920","2727王品","110/07/19","國泰證券",2,21,-19
"19921","1570力肯","110/07/19","國票-北高雄",34,0,34
"19922","1570力肯","110/07/19","合庫-三重",0,8,-8
"19923","1570力肯","110/07/19","新光",30,3,27
"19924","1570力肯","110/07/19","元大-高雄",0,8,-8
"19925","1570力肯","110/07/19","凱基-台北",24,1,23
"19926","1570力肯","110/07/19","合庫-台中",0,7,-7
"19927","1570力肯","110/07/19","台灣摩根士丹利",7,0,7
"19928","1570力肯","110/07/19","臺銀-臺中",0,6,-6
"19929","1570力肯","110/07/19","元大-林森",5,0,5
"19930","1570力肯","110/07/19","摩根大通",6,11,-5
"19931","1570力肯","110/07/19","元大-士林",4,0,4
"19932","1570力肯","110/07/19","元富-緯城",0,4,-4
"19933","1570力肯","110/07/19","玉山證券",8,5,3
"19934","1570力肯","110/07/19","玉山-台大",0,4,-4
"19935","1570力肯","110/07/19","統一-城中",2,0,2
"19936","1570力肯","110/07/19","群益金鼎-三重",0,4,-4
"19937","1570力肯","110/07/19","元大-基隆孝二",2,0,2
"19938","1570力肯","110/07/19","凱基-鳳山",1,5,-4
"19939","1570力肯","110/07/19","土銀-建國",1,0,1
"19940","1570力肯","110/07/19","元大-板橋",0,4,-4
"19941","1570力肯","110/07/19","日盛-復興",1,0,1
"19942","1570力肯","110/07/19","日盛-和美",0,3,-3
"19943","1570力肯","110/07/19","瑞士信貸",1,0,1
"19944","1570力肯","110/07/19","元富-新店",2,5,-3
"19945","1570力肯","110/07/19","元富-四維",1,0,1
"19946","1570力肯","110/07/19","元大-新莊",0,3,-3
"19947","1570力肯","110/07/19","群益金鼎-北高雄",1,0,1
"19948","1570力肯","110/07/19","永豐金-敦南",0,3,-3
"19949","1570力肯","110/07/19","凱基-高美館",1,0,1
"19950","1570力肯","110/07/19","永豐金-台中",0,3,-3
"19951","6180橘子","110/07/19","兆豐證券",55,0,55
"19952","6180橘子","110/07/19","石橋證券",0,80,-80
"19953","6180橘子","110/07/19","凱基-台北",89,35,54
"19954","6180橘子","110/07/19","永豐金-大園",2,50,-48
"19955","6180橘子","110/07/19","合庫-自強",36,0,36
"19956","6180橘子","110/07/19","群益金鼎-屏東",0,40,-40
"19957","6180橘子","110/07/19","新光",50,25,25
"19958","6180橘子","110/07/19","國泰-敦南",0,19,-19
"19959","6180橘子","110/07/19","日盛-龍潭",20,0,20
"19960","6180橘子","110/07/19","日盛-新竹",2,20,-18
"19961","6180橘子","110/07/19","元大-斗信",16,1,15
"19962","6180橘子","110/07/19","摩根大通",17,35,-18
"19963","6180橘子","110/07/19","康和-台中",12,0,12
"19964","6180橘子","110/07/19","富邦-陽明",0,17,-17
"19965","6180橘子","110/07/19","國泰-台中",14,2,12
"19966","6180橘子","110/07/19","美商高盛",11,27,-16
"19967","6180橘子","110/07/19","富邦-嘉義",12,0,12
"19968","6180橘子","110/07/19","統一-宜蘭",0,14,-14
"19969","6180橘子","110/07/19","元大-草屯",12,0,12
"19970","6180橘子","110/07/19","凱基-興隆",0,12,-12
"19971","6180橘子","110/07/19","元富-桃園",11,0,11
"19972","6180橘子","110/07/19","台中銀-豐原",1,11,-10
"19973","6180橘子","110/07/19","兆豐-城中",10,0,10
"19974","6180橘子","110/07/19","永豐金-豐原",0,10,-10
"19975","6180橘子","110/07/19","元大-旗山",10,0,10
"19976","6180橘子","110/07/19","永豐金-竹科",0,10,-10
"19977","6180橘子","110/07/19","元大-大安",10,0,10
"19978","6180橘子","110/07/19","臺銀-鳳山",1,10,-9
"19979","6180橘子","110/07/19","大昌-新店",9,0,9
"19980","6180橘子","110/07/19","群益金鼎-台南",0,9,-9
"19981","2390云辰","110/07/19","摩根大通",1135,266,869
"19982","2390云辰","110/07/19","元富-成功",15,119,-104
"19983","2390云辰","110/07/19","台灣摩根士丹利",232,40,192
"19984","2390云辰","110/07/19","元富-中港",5,101,-96
"19985","2390云辰","110/07/19","凱基-台北",669,504,165
"19986","2390云辰","110/07/19","元富-嘉義",5,85,-80
"19987","2390云辰","110/07/19","美林",290,159,131
"19988","2390云辰","110/07/19","美商高盛",11,62,-51
"19989","2390云辰","110/07/19","統一",111,8,103
"19990","2390云辰","110/07/19","群益金鼎-西松",4,54,-50
"19991","2390云辰","110/07/19","元富-埔里",102,0,102
"19992","2390云辰","110/07/19","聯邦商銀",0,48,-48
"19993","2390云辰","110/07/19","華南永昌-台中",126,26,100
"19994","2390云辰","110/07/19","元大-萬華",15,57,-42
"19995","2390云辰","110/07/19","永豐金-豐原",100,32,68
"19996","2390云辰","110/07/19","群益金鼎-高雄",2,42,-40
"19997","2390云辰","110/07/19","台新-台南",87,25,62
"19998","2390云辰","110/07/19","國泰-敦南",117,154,-37
"19999","2390云辰","110/07/19","台新-左楠",67,11,56
"20000","2390云辰","110/07/19","中國信託-文心",5,40,-35
"20001","2390云辰","110/07/19","國泰-忠孝",52,0,52
"20002","2390云辰","110/07/19","凱基-城中",16,51,-35
"20003","2390云辰","110/07/19","台新證券",105,54,51
"20004","2390云辰","110/07/19","瑞士信貸",0,31,-31
"20005","2390云辰","110/07/19","華南永昌-頭份",53,3,50
"20006","2390云辰","110/07/19","中國信託-永康",1,32,-31
"20007","2390云辰","110/07/19","新光-台南",44,0,44
"20008","2390云辰","110/07/19","統一-彰化",2,32,-30
"20009","2390云辰","110/07/19","合庫-西台中",50,8,42
"20010","2390云辰","110/07/19","元大-館前",7,37,-30
"20011","2363矽統","110/07/16","國票-長城",461,21,440
"20012","2363矽統","110/07/16","新加坡商瑞銀",155,482,-327
"20013","2363矽統","110/07/16","凱基-豐中",201,3,198
"20014","2363矽統","110/07/16","港商野村",253,546,-293
"20015","2363矽統","110/07/16","凱基-土城",132,9,123
"20016","2363矽統","110/07/16","摩根大通",116,401,-285
"20017","2363矽統","110/07/16","台新證券",199,78,121
"20018","2363矽統","110/07/16","瑞士信貸",291,533,-242
"20019","2363矽統","110/07/16","日盛-中和",74,0,74
"20020","2363矽統","110/07/16","日盛-竹北",19,248,-229
"20021","2363矽統","110/07/16","日盛-員林",66,3,63
"20022","2363矽統","110/07/16","臺銀-金山",4,211,-207
"20023","2363矽統","110/07/16","國票-中和",60,3,57
"20024","2363矽統","110/07/16","元大-大統",13,138,-125
"20025","2363矽統","110/07/16","新光",240,184,56
"20026","2363矽統","110/07/16","永豐金證券",11,125,-114
"20027","2363矽統","110/07/16","富邦-竹東",65,9,56
"20028","2363矽統","110/07/16","兆豐-民生",2,101,-99
"20029","2363矽統","110/07/16","華南永昌-鳳山",56,1,55
"20030","2363矽統","110/07/16","群益金鼎-松山",2,100,-98
"20031","2363矽統","110/07/16","凱基-台北",520,466,54
"20032","2363矽統","110/07/16","元大-花蓮",8,99,-91
"20033","2363矽統","110/07/16","元富-城東",63,12,51
"20034","2363矽統","110/07/16","華南永昌-虎尾",68,154,-86
"20035","2363矽統","110/07/16","群益金鼎-桃園",56,5,51
"20036","2363矽統","110/07/16","富邦-新竹華信",7,89,-82
"20037","2363矽統","110/07/16","北城證券",60,10,50
"20038","2363矽統","110/07/16","元大-佳里",3,81,-78
"20039","2363矽統","110/07/16","國票-九鼎",57,7,50
"20040","2363矽統","110/07/16","玉山-南京東路",0,73,-73
"20041","8112至上","110/07/16","宏遠證券",551,6,545
"20042","8112至上","110/07/16","玉山-桃園",42,318,-276
"20043","8112至上","110/07/16","台灣摩根士丹利",317,11,306
"20044","8112至上","110/07/16","美林",64,305,-241
"20045","8112至上","110/07/16","新加坡商瑞銀",378,73,305
"20046","8112至上","110/07/16","宏遠-館前",16,212,-196
"20047","8112至上","110/07/16","凱基-台北",758,553,205
"20048","8112至上","110/07/16","玉山-嘉義",19,95,-76
"20049","8112至上","110/07/16","富邦證券",127,0,127
"20050","8112至上","110/07/16","群益金鼎-三民",7,82,-75
"20051","8112至上","110/07/16","台新證券",129,30,99
"20052","8112至上","110/07/16","日盛-二林",1,73,-72
"20053","8112至上","110/07/16","花旗環球",97,0,97
"20054","8112至上","110/07/16","玉山-台大",8,76,-68
"20055","8112至上","110/07/16","永豐金-台南",97,8,89
"20056","8112至上","110/07/16","元富-台南",1,68,-67
"20057","8112至上","110/07/16","元大-大天母",93,15,78
"20058","8112至上","110/07/16","玉山-板橋",4,71,-67
"20059","8112至上","110/07/16","亞東-板橋",72,2,70
"20060","8112至上","110/07/16","臺灣企銀-埔墘",0,60,-60
"20061","8112至上","110/07/16","永豐金-中正",64,9,55
"20062","8112至上","110/07/16","華南永昌-鶯歌",11,64,-53
"20063","8112至上","110/07/16","大昌-樹林",53,2,51
"20064","8112至上","110/07/16","元大-士林",7,59,-52
"20065","8112至上","110/07/16","凱基-永和",56,5,51
"20066","8112至上","110/07/16","元富-新店",8,57,-49
"20067","8112至上","110/07/16","兆豐-竹北",53,3,50
"20068","8112至上","110/07/16","富邦-陽明",9,58,-49
"20069","8112至上","110/07/16","日盛-豐原",48,0,48
"20070","8112至上","110/07/16","元大-發財",0,49,-49
"20071","1570力肯","110/07/16","新光",71,6,65
"20072","1570力肯","110/07/16","元大-高雄",0,23,-23
"20073","1570力肯","110/07/16","國票-北高雄",21,0,21
"20074","1570力肯","110/07/16","合庫-台南",0,20,-20
"20075","1570力肯","110/07/16","凱基-台北",17,1,16
"20076","1570力肯","110/07/16","元富-新店",0,15,-15
"20077","1570力肯","110/07/16","群益金鼎-高雄",15,0,15
"20078","1570力肯","110/07/16","元大-東港",0,10,-10
"20079","1570力肯","110/07/16","富邦-建國",10,0,10
"20080","1570力肯","110/07/16","中國信託",0,7,-7
"20081","1570力肯","110/07/16","元大-士林",5,0,5
"20082","1570力肯","110/07/16","台新證券",0,6,-6
"20083","1570力肯","110/07/16","瑞士信貸",3,0,3
"20084","1570力肯","110/07/16","日盛-信義",0,5,-5
"20085","1570力肯","110/07/16","臺銀-高雄",2,0,2
"20086","1570力肯","110/07/16","宏遠-館前",0,5,-5
"20087","1570力肯","110/07/16","華南永昌",2,0,2
"20088","1570力肯","110/07/16","國泰-館前",0,5,-5
"20089","1570力肯","110/07/16","元富-同大",1,0,1
"20090","1570力肯","110/07/16","富邦-園區",0,5,-5
"20091","1570力肯","110/07/16","兆豐-麻豆",1,0,1
"20092","1570力肯","110/07/16","永豐金-中正",0,5,-5
"20093","1570力肯","110/07/16","國泰-板橋",1,0,1
"20094","1570力肯","110/07/16","(牛牛牛)亞-鑫豐",0,4,-4
"20095","1570力肯","110/07/16","群益金鼎-東湖",1,0,1
"20096","1570力肯","110/07/16","台中銀-員林",0,3,-3
"20097","1570力肯","110/07/16","元大-東泰",1,0,1
"20098","1570力肯","110/07/16","玉山-新莊",0,3,-3
"20099","1570力肯","110/07/16","元大-南勢角",1,0,1
"20100","1570力肯","110/07/16","凱基-長庚",0,3,-3
"20101","2929淘帝","110/07/16","元大-民生",28,0,28
"20102","2929淘帝","110/07/16","玉山-新竹",0,30,-30
"20103","2929淘帝","110/07/16","元大-員林",20,0,20
"20104","2929淘帝","110/07/16","合庫證券",0,20,-20
"20105","2929淘帝","110/07/16","兆豐-桃鶯",12,0,12
"20106","2929淘帝","110/07/16","元大-六合",0,20,-20
"20107","2929淘帝","110/07/16","元大-大統",10,0,10
"20108","2929淘帝","110/07/16","摩根大通",0,12,-12
"20109","2929淘帝","110/07/16","新加坡商瑞銀",9,0,9
"20110","2929淘帝","110/07/16","永興",0,6,-6
"20111","2929淘帝","110/07/16","凱基-基隆",6,0,6
"20112","2929淘帝","110/07/16","凱基-長庚",0,5,-5
"20113","2929淘帝","110/07/16","合庫-高雄",5,0,5
"20114","2929淘帝","110/07/16","群益金鼎-潭子",0,4,-4
"20115","2929淘帝","110/07/16","台新-台中",6,1,5
"20116","2929淘帝","110/07/16","華南永昌-小港",2,6,-4
"20117","2929淘帝","110/07/16","元大-承德",5,0,5
"20118","2929淘帝","110/07/16","華南永昌-虎尾",0,4,-4
"20119","2929淘帝","110/07/16","元大-沙鹿",5,0,5
"20120","2929淘帝","110/07/16","日盛-和美",0,3,-3
"20121","2929淘帝","110/07/16","大慶-苗栗",5,1,4
"20122","2929淘帝","110/07/16","彰銀",0,3,-3
"20123","2929淘帝","110/07/16","台新-新營",4,0,4
"20124","2929淘帝","110/07/16","港商野村",7,10,-3
"20125","2929淘帝","110/07/16","凱基-台北",6,2,4
"20126","2929淘帝","110/07/16","群益金鼎-中山",1,4,-3
"20127","2929淘帝","110/07/16","兆豐-台中港",3,0,3
"20128","2929淘帝","110/07/16","凱基-嘉義",0,3,-3
"20129","2929淘帝","110/07/16","國票-北高雄",3,0,3
"20130","2929淘帝","110/07/16","元大-斗信",0,3,-3
"20131","5410國眾","110/07/16","盈溢-籬子內",49,0,49
"20132","5410國眾","110/07/16","元大-博愛",0,41,-41
"20133","5410國眾","110/07/16","香港上海匯豐",31,0,31
"20134","5410國眾","110/07/16","元富-嘉義",0,20,-20
"20135","5410國眾","110/07/16","元大-東泰",30,0,30
"20136","5410國眾","110/07/16","國泰-桃園",0,18,-18
"20137","5410國眾","110/07/16","兆豐-台中港",20,0,20
"20138","5410國眾","110/07/16","元富",0,17,-17
"20139","5410國眾","110/07/16","臺銀-臺南",11,0,11
"20140","5410國眾","110/07/16","元大-新竹",0,14,-14
"20141","5410國眾","110/07/16","富邦-新竹華信",11,0,11
"20142","5410國眾","110/07/16","安泰-大發",0,11,-11
"20143","5410國眾","110/07/16","臺銀",10,0,10
"20144","5410國眾","110/07/16","大昌-樹林",0,10,-10
"20145","5410國眾","110/07/16","凱基-台北",8,1,7
"20146","5410國眾","110/07/16","群益金鼎-內湖",0,10,-10
"20147","5410國眾","110/07/16","日盛-士林",5,0,5
"20148","5410國眾","110/07/16","元大-樹林",0,10,-10
"20149","5410國眾","110/07/16","新光-桃園",5,0,5
"20150","5410國眾","110/07/16","元大-內湖",0,9,-9
"20151","5410國眾","110/07/16","國泰-台南",5,0,5
"20152","5410國眾","110/07/16","群益金鼎-永和",0,5,-5
"20153","5410國眾","110/07/16","群益金鼎-嘉義",5,0,5
"20154","5410國眾","110/07/16","凱基-屏東",0,5,-5
"20155","5410國眾","110/07/16","元大-屏南",5,0,5
"20156","5410國眾","110/07/16","統一-員林",0,4,-4
"20157","5410國眾","110/07/16","日盛-員林",3,0,3
"20158","5410國眾","110/07/16","國泰-松江",0,4,-4
"20159","5410國眾","110/07/16","瑞士信貸",3,0,3
"20160","5410國眾","110/07/16","凱基-台南",0,4,-4
"20161","2841台開","110/07/16","日盛證券",250,0,250
"20162","2841台開","110/07/16","元大-歸仁",0,590,-590
"20163","2841台開","110/07/16","凱基-文心",204,0,204
"20164","2841台開","110/07/16","摩根大通",0,245,-245
"20165","2841台開","110/07/16","國泰-館前",114,0,114
"20166","2841台開","110/07/16","日盛-信義",0,145,-145
"20167","2841台開","110/07/16","永豐金-豐原",75,0,75
"20168","2841台開","110/07/16","港商野村",0,103,-103
"20169","2841台開","110/07/16","台新-台中",76,10,66
"20170","2841台開","110/07/16","玉山-嘉義",5,54,-49
"20171","2841台開","110/07/16","中國信託-文心",51,5,46
"20172","2841台開","110/07/16","台新證券",22,63,-41
"20173","2841台開","110/07/16","華南永昌-新莊",41,10,31
"20174","2841台開","110/07/16","美商高盛",0,39,-39
"20175","2841台開","110/07/16","富邦-嘉義",30,0,30
"20176","2841台開","110/07/16","亞東-板橋",0,30,-30
"20177","2841台開","110/07/16","新光",26,0,26
"20178","2841台開","110/07/16","永豐金-北高雄",0,30,-30
"20179","2841台開","110/07/16","富邦-板橋",25,0,25
"20180","2841台開","110/07/16","日盛-忠孝",0,20,-20
"20181","2841台開","110/07/16","新光-台中",22,0,22
"20182","2841台開","110/07/16","元富-草屯",0,15,-15
"20183","2841台開","110/07/16","元大-承德",22,0,22
"20184","2841台開","110/07/16","永豐金-板新",0,12,-12
"20185","2841台開","110/07/16","日盛-三重",20,0,20
"20186","2841台開","110/07/16","第一金-華江",0,10,-10
"20187","2841台開","110/07/16","日盛-新莊",20,0,20
"20188","2841台開","110/07/16","兆豐-南京",0,10,-10
"20189","2841台開","110/07/16","凱基-台南",20,0,20
"20190","2841台開","110/07/16","國票-中港",0,10,-10
"20191","6207雷科","110/07/16","統一-平鎮",215,4,211
"20192","6207雷科","110/07/16","凱基-台北",344,628,-284
"20193","6207雷科","110/07/16","凱基-復興",166,6,160
"20194","6207雷科","110/07/16","新加坡商瑞銀",104,370,-266
"20195","6207雷科","110/07/16","永豐金-南京",141,3,138
"20196","6207雷科","110/07/16","摩根大通",193,430,-237
"20197","6207雷科","110/07/16","永豐金-內湖",117,1,116
"20198","6207雷科","110/07/16","富邦證券",0,150,-150
"20199","6207雷科","110/07/16","日盛證券",104,2,102
"20200","6207雷科","110/07/16","華南永昌-中正",26,169,-143
"20201","6207雷科","110/07/16","群益金鼎-古亭",74,2,72
"20202","6207雷科","110/07/16","凱基-敦北",1,142,-141
"20203","6207雷科","110/07/16","群益金鼎-東門",76,12,64
"20204","6207雷科","110/07/16","凱基-板橋",0,120,-120
"20205","6207雷科","110/07/16","日盛-板橋",78,25,53
"20206","6207雷科","110/07/16","元富-大昌",30,136,-106
"20207","6207雷科","110/07/16","元大-斗六",57,6,51
"20208","6207雷科","110/07/16","元大-北成功",26,97,-71
"20209","6207雷科","110/07/16","元大-頭份",53,3,50
"20210","6207雷科","110/07/16","新光-桃園",29,93,-64
"20211","6207雷科","110/07/16","群益金鼎-東大",56,11,45
"20212","6207雷科","110/07/16","新百王",27,90,-63
"20213","6207雷科","110/07/16","永豐金-虎尾",50,8,42
"20214","6207雷科","110/07/16","玉山-左營",16,72,-56
"20215","6207雷科","110/07/16","元大-西門",39,1,38
"20216","6207雷科","110/07/16","群益金鼎-中壢",3,54,-51
"20217","6207雷科","110/07/16","凱基-竹科",38,1,37
"20218","6207雷科","110/07/16","元富-中原",21,67,-46
"20219","6207雷科","110/07/16","元富-世貿",50,15,35
"20220","6207雷科","110/07/16","大昌-桃園",26,70,-44
"20221","3679新至陞","110/07/16","元大-成功",17,1,16
"20222","3679新至陞","110/07/16","國票-桃園",0,11,-11
"20223","3679新至陞","110/07/16","玉山-台大",5,0,5
"20224","3679新至陞","110/07/16","富邦-台北",0,10,-10
"20225","3679新至陞","110/07/16","日盛-員林",4,0,4
"20226","3679新至陞","110/07/16","富邦-苗栗",0,10,-10
"20227","3679新至陞","110/07/16","凱基-台北",6,2,4
"20228","3679新至陞","110/07/16","元大-永春",0,6,-6
"20229","3679新至陞","110/07/16","台灣摩根士丹利",3,0,3
"20230","3679新至陞","110/07/16","美林",0,5,-5
"20231","3679新至陞","110/07/16","凱基-中山",3,0,3
"20232","3679新至陞","110/07/16","瑞士信貸",3,7,-4
"20233","3679新至陞","110/07/16","元大-承德",3,0,3
"20234","3679新至陞","110/07/16","宏遠-館前",0,3,-3
"20235","3679新至陞","110/07/16","元大-汐止",4,1,3
"20236","3679新至陞","110/07/16","元大-東港",0,3,-3
"20237","3679新至陞","110/07/16","日盛-大墩",2,0,2
"20238","3679新至陞","110/07/16","元大證券",0,2,-2
"20239","3679新至陞","110/07/16","玉山-城中",2,0,2
"20240","3679新至陞","110/07/16","永豐金-板新",0,2,-2
"20241","3679新至陞","110/07/16","華南永昌-內壢",2,0,2
"20242","3679新至陞","110/07/16","臺銀-民權",0,1,-1
"20243","3679新至陞","110/07/16","元大-台南",2,0,2
"20244","3679新至陞","110/07/16","日盛-台中",0,1,-1
"20245","3679新至陞","110/07/16","元大-大同",2,0,2
"20246","3679新至陞","110/07/16","日盛-鳳山",0,1,-1
"20247","3679新至陞","110/07/16","臺銀-高雄",1,0,1
"20248","3679新至陞","110/07/16","元富-古亭",0,1,-1
"20249","3679新至陞","110/07/16","日盛-樹林",1,0,1
"20250","3679新至陞","110/07/16","元富-新興",0,1,-1
"20251","2727王品","110/07/16","富邦證券",570,0,570
"20252","2727王品","110/07/16","台新證券",27,77,-50
"20253","2727王品","110/07/16","兆豐-南京",200,0,200
"20254","2727王品","110/07/16","台灣摩根士丹利",4,47,-43
"20255","2727王品","110/07/16","瑞士信貸",133,2,131
"20256","2727王品","110/07/16","永豐金-大園",0,33,-33
"20257","2727王品","110/07/16","美林",121,26,95
"20258","2727王品","110/07/16","元大-北屯",0,32,-32
"20259","2727王品","110/07/16","統一",103,43,60
"20260","2727王品","110/07/16","富邦-南屯",1,30,-29
"20261","2727王品","110/07/16","中國信託-忠孝",36,2,34
"20262","2727王品","110/07/16","元大-基隆孝二",0,29,-29
"20263","2727王品","110/07/16","元大證券",68,45,23
"20264","2727王品","110/07/16","日盛-忠孝",4,30,-26
"20265","2727王品","110/07/16","合庫-彰化",22,1,21
"20266","2727王品","110/07/16","新光-新竹",1,21,-20
"20267","2727王品","110/07/16","港商野村",126,105,21
"20268","2727王品","110/07/16","凱基-台北",94,113,-19
"20269","2727王品","110/07/16","元富-板橋",22,1,21
"20270","2727王品","110/07/16","富邦-虎尾",1,19,-18
"20271","2727王品","110/07/16","新加坡商瑞銀",36,18,18
"20272","2727王品","110/07/16","元大-南京",0,17,-17
"20273","2727王品","110/07/16","國泰證券",20,5,15
"20274","2727王品","110/07/16","日盛-鳳山",2,18,-16
"20275","2727王品","110/07/16","日盛-桃園",13,1,12
"20276","2727王品","110/07/16","新光",34,50,-16
"20277","2727王品","110/07/16","凱基-市政",12,1,11
"20278","2727王品","110/07/16","富邦-台北",2,18,-16
"20279","2727王品","110/07/16","元大-嘉義",14,3,11
"20280","2727王品","110/07/16","國票-內壢",1,15,-14
"20281","1570力肯","110/07/16","新光",71,6,65
"20282","1570力肯","110/07/16","元大-高雄",0,23,-23
"20283","1570力肯","110/07/16","國票-北高雄",21,0,21
"20284","1570力肯","110/07/16","合庫-台南",0,20,-20
"20285","1570力肯","110/07/16","凱基-台北",17,1,16
"20286","1570力肯","110/07/16","元富-新店",0,15,-15
"20287","1570力肯","110/07/16","群益金鼎-高雄",15,0,15
"20288","1570力肯","110/07/16","元大-東港",0,10,-10
"20289","1570力肯","110/07/16","富邦-建國",10,0,10
"20290","1570力肯","110/07/16","中國信託",0,7,-7
"20291","1570力肯","110/07/16","元大-士林",5,0,5
"20292","1570力肯","110/07/16","台新證券",0,6,-6
"20293","1570力肯","110/07/16","瑞士信貸",3,0,3
"20294","1570力肯","110/07/16","日盛-信義",0,5,-5
"20295","1570力肯","110/07/16","臺銀-高雄",2,0,2
"20296","1570力肯","110/07/16","宏遠-館前",0,5,-5
"20297","1570力肯","110/07/16","華南永昌",2,0,2
"20298","1570力肯","110/07/16","國泰-館前",0,5,-5
"20299","1570力肯","110/07/16","元富-同大",1,0,1
"20300","1570力肯","110/07/16","富邦-園區",0,5,-5
"20301","1570力肯","110/07/16","兆豐-麻豆",1,0,1
"20302","1570力肯","110/07/16","永豐金-中正",0,5,-5
"20303","1570力肯","110/07/16","國泰-板橋",1,0,1
"20304","1570力肯","110/07/16","(牛牛牛)亞-鑫豐",0,4,-4
"20305","1570力肯","110/07/16","群益金鼎-東湖",1,0,1
"20306","1570力肯","110/07/16","台中銀-員林",0,3,-3
"20307","1570力肯","110/07/16","元大-東泰",1,0,1
"20308","1570力肯","110/07/16","玉山-新莊",0,3,-3
"20309","1570力肯","110/07/16","元大-南勢角",1,0,1
"20310","1570力肯","110/07/16","凱基-長庚",0,3,-3
"20311","6180橘子","110/07/16","日盛-文化",71,5,66
"20312","6180橘子","110/07/16","凱基-台北",110,238,-128
"20313","6180橘子","110/07/16","新加坡商瑞銀",75,19,56
"20314","6180橘子","110/07/16","摩根大通",77,161,-84
"20315","6180橘子","110/07/16","瑞士信貸",51,0,51
"20316","6180橘子","110/07/16","元富-高雄",0,62,-62
"20317","6180橘子","110/07/16","台灣企銀-屏東",50,0,50
"20318","6180橘子","110/07/16","美商高盛",0,40,-40
"20319","6180橘子","110/07/16","元大-桃園",52,2,50
"20320","6180橘子","110/07/16","合庫-自強",0,37,-37
"20321","6180橘子","110/07/16","康和-台北",51,10,41
"20322","6180橘子","110/07/16","美林",15,48,-33
"20323","6180橘子","110/07/16","群益金鼎-屏東",61,20,41
"20324","6180橘子","110/07/16","元富-四維",0,32,-32
"20325","6180橘子","110/07/16","元大-彰化",33,2,31
"20326","6180橘子","110/07/16","新光",63,92,-29
"20327","6180橘子","110/07/16","台中銀-台北",30,0,30
"20328","6180橘子","110/07/16","新光-台南",6,28,-22
"20329","6180橘子","110/07/16","福勝",29,3,26
"20330","6180橘子","110/07/16","港商野村",28,49,-21
"20331","6180橘子","110/07/16","兆豐證券",21,0,21
"20332","6180橘子","110/07/16","統一",2,23,-21
"20333","6180橘子","110/07/16","華南永昌-頭份",20,0,20
"20334","6180橘子","110/07/16","元大-豐原站前",3,21,-18
"20335","6180橘子","110/07/16","富邦-台北",25,5,20
"20336","6180橘子","110/07/16","豐農",3,20,-17
"20337","6180橘子","110/07/16","富邦-員林",23,4,19
"20338","6180橘子","110/07/16","安泰-大發",0,17,-17
"20339","6180橘子","110/07/16","台新-新莊",20,2,18
"20340","6180橘子","110/07/16","群益金鼎",2,19,-17
"20341","2390云辰","110/07/16","兆豐-天母",642,7,635
"20342","2390云辰","110/07/16","凱基",0,5007,-5007
"20343","2390云辰","110/07/16","華南永昌-鳳山",339,35,304
"20344","2390云辰","110/07/16","凱基-台北",1224,2306,-1082
"20345","2390云辰","110/07/16","第一金-大稻埕",269,13,256
"20346","2390云辰","110/07/16","元大證券",206,1177,-971
"20347","2390云辰","110/07/16","國泰-敦南",665,427,238
"20348","2390云辰","110/07/16","摩根大通",1073,1967,-894
"20349","2390云辰","110/07/16","富邦-建國",272,50,222
"20350","2390云辰","110/07/16","台灣摩根士丹利",232,671,-439
"20351","2390云辰","110/07/16","元大-信義",180,15,165
"20352","2390云辰","110/07/16","美林",187,496,-309
"20353","2390云辰","110/07/16","瑞士信貸",155,0,155
"20354","2390云辰","110/07/16","港商野村",680,950,-270
"20355","2390云辰","110/07/16","台新證券",461,317,144
"20356","2390云辰","110/07/16","永豐金-中正",18,170,-152
"20357","2390云辰","110/07/16","兆豐-公益",148,11,137
"20358","2390云辰","110/07/16","元富-板橋",30,169,-139
"20359","2390云辰","110/07/16","元大-土城學府",197,61,136
"20360","2390云辰","110/07/16","新加坡商瑞銀",61,175,-114
"20361","2390云辰","110/07/16","元大-天母",232,122,110
"20362","2390云辰","110/07/16","聯邦商銀",54,167,-113
"20363","2390云辰","110/07/16","凱基-基隆",109,2,107
"20364","2390云辰","110/07/16","群益金鼎-大甲",13,111,-98
"20365","2390云辰","110/07/16","元富-成功",110,5,105
"20366","2390云辰","110/07/16","統一-屏東",4,92,-88
"20367","2390云辰","110/07/16","統一-新營",118,14,104
"20368","2390云辰","110/07/16","凱基-大直",3,80,-77
"20369","2390云辰","110/07/16","國泰-板橋",268,170,98
"20370","2390云辰","110/07/16","元大-桃興",46,117,-71
"20371","2363矽統","110/07/15","康和-台中",626,61,565
"20372","2363矽統","110/07/15","新加坡商瑞銀",202,838,-636
"20373","2363矽統","110/07/15","摩根大通",1271,932,339
"20374","2363矽統","110/07/15","美林",185,720,-535
"20375","2363矽統","110/07/15","瑞士信貸",530,230,300
"20376","2363矽統","110/07/15","富邦-仁愛",60,583,-523
"20377","2363矽統","110/07/15","宏遠-桃園",281,0,281
"20378","2363矽統","110/07/15","元大-板橋",35,368,-333
"20379","2363矽統","110/07/15","大展",252,19,233
"20380","2363矽統","110/07/15","花旗環球",0,308,-308
"20381","2363矽統","110/07/15","凱基-台北",683,498,185
"20382","2363矽統","110/07/15","元富-成功",2,113,-111
"20383","2363矽統","110/07/15","永豐金證券",166,11,155
"20384","2363矽統","110/07/15","富邦-新營",23,132,-109
"20385","2363矽統","110/07/15","群益金鼎",157,5,152
"20386","2363矽統","110/07/15","臺銀-金山",197,304,-107
"20387","2363矽統","110/07/15","新光",333,229,104
"20388","2363矽統","110/07/15","日盛-二林",13,116,-103
"20389","2363矽統","110/07/15","永豐金-台南",130,26,104
"20390","2363矽統","110/07/15","台新-左楠",40,126,-86
"20391","2363矽統","110/07/15","國票-南京",100,0,100
"20392","2363矽統","110/07/15","康和-南崁",15,100,-85
"20393","2363矽統","110/07/15","群益金鼎-松山",150,50,100
"20394","2363矽統","110/07/15","永豐金-員林",9,91,-82
"20395","2363矽統","110/07/15","中國信託-松江",103,5,98
"20396","2363矽統","110/07/15","光和-嘉義",5,78,-73
"20397","2363矽統","110/07/15","國票-新莊",187,92,95
"20398","2363矽統","110/07/15","日盛-板橋中山",3,73,-70
"20399","2363矽統","110/07/15","北城證券",216,126,90
"20400","2363矽統","110/07/15","元大證券",10,75,-65
"20401","8112至上","110/07/15","凱基-台北",535,32,503
"20402","8112至上","110/07/15","群益金鼎-台南",0,116,-116
"20403","8112至上","110/07/15","摩根大通",362,16,346
"20404","8112至上","110/07/15","華南永昌-高雄",2,112,-110
"20405","8112至上","110/07/15","台灣摩根士丹利",254,0,254
"20406","8112至上","110/07/15","永豐金-台南",27,128,-101
"20407","8112至上","110/07/15","花旗環球",159,0,159
"20408","8112至上","110/07/15","元大-東蘆",2,73,-71
"20409","8112至上","110/07/15","新加坡商瑞銀",95,2,93
"20410","8112至上","110/07/15","美林",3,66,-63
"20411","8112至上","110/07/15","玉山-嘉義",84,0,84
"20412","8112至上","110/07/15","元大-館前",0,62,-62
"20413","8112至上","110/07/15","新光",82,6,76
"20414","8112至上","110/07/15","元富-信義",0,50,-50
"20415","8112至上","110/07/15","瑞士信貸",80,7,73
"20416","8112至上","110/07/15","台新證券",35,82,-47
"20417","8112至上","110/07/15","美商高盛",64,0,64
"20418","8112至上","110/07/15","大慶-蘆洲",7,53,-46
"20419","8112至上","110/07/15","兆豐-小港",56,0,56
"20420","8112至上","110/07/15","國票-天祥",0,45,-45
"20421","8112至上","110/07/15","永豐金-內湖",60,11,49
"20422","8112至上","110/07/15","凱基-中山",1,45,-44
"20423","8112至上","110/07/15","永豐金-南投",46,1,45
"20424","8112至上","110/07/15","元大-士林",0,43,-43
"20425","8112至上","110/07/15","凱基-三重",40,0,40
"20426","8112至上","110/07/15","玉山-城中",4,44,-40
"20427","8112至上","110/07/15","台灣企銀",29,0,29
"20428","8112至上","110/07/15","凱基-彰化",0,39,-39
"20429","8112至上","110/07/15","元大-府城",42,14,28
"20430","8112至上","110/07/15","元富-花蓮",2,40,-38
"20431","1570力肯","110/07/15","群益金鼎-高雄",40,0,40
"20432","1570力肯","110/07/15","元大-高雄",0,12,-12
"20433","1570力肯","110/07/15","新光",40,8,32
"20434","1570力肯","110/07/15","永豐金-中正",0,10,-10
"20435","1570力肯","110/07/15","凱基-台北",20,2,18
"20436","1570力肯","110/07/15","國泰-松江",0,9,-9
"20437","1570力肯","110/07/15","凱基-天母",6,0,6
"20438","1570力肯","110/07/15","台新證券",0,8,-8
"20439","1570力肯","110/07/15","元富-新店",5,0,5
"20440","1570力肯","110/07/15","玉山證券",0,7,-7
"20441","1570力肯","110/07/15","凱基-中港",5,0,5
"20442","1570力肯","110/07/15","元大-府城",0,7,-7
"20443","1570力肯","110/07/15","富邦-園區",5,0,5
"20444","1570力肯","110/07/15","元大-板橋",0,6,-6
"20445","1570力肯","110/07/15","瑞士信貸",4,0,4
"20446","1570力肯","110/07/15","日盛-信義",0,5,-5
"20447","1570力肯","110/07/15","第一金-路竹",3,0,3
"20448","1570力肯","110/07/15","國票-和平",0,5,-5
"20449","1570力肯","110/07/15","摩根大通",3,0,3
"20450","1570力肯","110/07/15","元大-民雄",0,5,-5
"20451","1570力肯","110/07/15","凱基-桃園",3,0,3
"20452","1570力肯","110/07/15","統一-台中",0,4,-4
"20453","1570力肯","110/07/15","永豐金-苓雅",3,0,3
"20454","1570力肯","110/07/15","玉山-雙和",0,4,-4
"20455","1570力肯","110/07/15","統一-員林",2,0,2
"20456","1570力肯","110/07/15","凱基-敦北",0,4,-4
"20457","1570力肯","110/07/15","元大-永春",2,0,2
"20458","1570力肯","110/07/15","富邦-新店",0,4,-4
"20459","1570力肯","110/07/15","元大-土城永寧",2,0,2
"20460","1570力肯","110/07/15","日盛-板橋",0,3,-3
"20461","2929淘帝","110/07/15","港商野村",58,4,54
"20462","2929淘帝","110/07/15","日盛-園區",0,25,-25
"20463","2929淘帝","110/07/15","元大-民生",29,0,29
"20464","2929淘帝","110/07/15","兆豐-南京",0,20,-20
"20465","2929淘帝","110/07/15","新加坡商瑞銀",22,1,21
"20466","2929淘帝","110/07/15","玉山-高雄",0,18,-18
"20467","2929淘帝","110/07/15","凱基-台北",20,2,18
"20468","2929淘帝","110/07/15","富邦-南屯",1,15,-14
"20469","2929淘帝","110/07/15","大慶-中壢",15,1,14
"20470","2929淘帝","110/07/15","富邦-員林",0,13,-13
"20471","2929淘帝","110/07/15","日盛-和美",10,0,10
"20472","2929淘帝","110/07/15","凱基-站前",0,10,-10
"20473","2929淘帝","110/07/15","元大-員林",10,0,10
"20474","2929淘帝","110/07/15","元大-台中",0,10,-10
"20475","2929淘帝","110/07/15","凱基-基隆",6,0,6
"20476","2929淘帝","110/07/15","美林",10,19,-9
"20477","2929淘帝","110/07/15","臺銀-鳳山",5,0,5
"20478","2929淘帝","110/07/15","元大-新盛",0,8,-8
"20479","2929淘帝","110/07/15","第一金-路竹",5,0,5
"20480","2929淘帝","110/07/15","台新-台南",0,7,-7
"20481","2929淘帝","110/07/15","元富-大裕",5,0,5
"20482","2929淘帝","110/07/15","元大-大天母",0,7,-7
"20483","2929淘帝","110/07/15","玉山-大里",5,0,5
"20484","2929淘帝","110/07/15","華南永昌-虎尾",0,6,-6
"20485","2929淘帝","110/07/15","元大-博愛",5,0,5
"20486","2929淘帝","110/07/15","永豐金證券",0,6,-6
"20487","2929淘帝","110/07/15","永豐金-新莊",5,0,5
"20488","2929淘帝","110/07/15","兆豐-竹北",0,5,-5
"20489","2929淘帝","110/07/15","元大-南崁",4,0,4
"20490","2929淘帝","110/07/15","元大-文心興安",0,5,-5
"20491","5410國眾","110/07/15","香港上海匯豐",18,0,18
"20492","5410國眾","110/07/15","元大-南屯",0,18,-18
"20493","5410國眾","110/07/15","摩根大通",15,0,15
"20494","5410國眾","110/07/15","亞東-新竹",0,15,-15
"20495","5410國眾","110/07/15","日盛-士林",10,0,10
"20496","5410國眾","110/07/15","兆豐-台中港",0,15,-15
"20497","5410國眾","110/07/15","群益金鼎-嘉義",10,0,10
"20498","5410國眾","110/07/15","日盛-板橋",0,12,-12
"20499","5410國眾","110/07/15","元大-高雄",10,0,10
"20500","5410國眾","110/07/15","台中銀-豐原",0,9,-9
"20501","5410國眾","110/07/15","元大-東港",10,0,10
"20502","5410國眾","110/07/15","臺銀-臺南",3,10,-7
"20503","5410國眾","110/07/15","臺銀",10,5,5
"20504","5410國眾","110/07/15","瑞士信貸",0,5,-5
"20505","5410國眾","110/07/15","台新-新營",5,0,5
"20506","5410國眾","110/07/15","統一-員林",0,5,-5
"20507","5410國眾","110/07/15","富邦-台北",5,0,5
"20508","5410國眾","110/07/15","大昌-樹林",0,5,-5
"20509","5410國眾","110/07/15","日盛-屏東",4,0,4
"20510","5410國眾","110/07/15","兆豐-來福",0,5,-5
"20511","5410國眾","110/07/15","高橋",5,1,4
"20512","5410國眾","110/07/15","豐農",0,5,-5
"20513","5410國眾","110/07/15","中國信託-新竹",4,1,3
"20514","5410國眾","110/07/15","元大-大里",0,5,-5
"20515","5410國眾","110/07/15","富邦-建國",3,0,3
"20516","5410國眾","110/07/15","港商野村",0,3,-3
"20517","5410國眾","110/07/15","永豐金-桃園",3,0,3
"20518","5410國眾","110/07/15","中農",0,3,-3
"20519","5410國眾","110/07/15","大展",2,0,2
"20520","5410國眾","110/07/15","國泰-忠孝",0,3,-3
"20521","2841台開","110/07/15","日盛證券",310,0,310
"20522","2841台開","110/07/15","港商野村",0,97,-97
"20523","2841台開","110/07/15","元富-城東",100,0,100
"20524","2841台開","110/07/15","元大-員林",0,77,-77
"20525","2841台開","110/07/15","凱基-文心",30,0,30
"20526","2841台開","110/07/15","新光",3,73,-70
"20527","2841台開","110/07/15","日盛-雙和",24,0,24
"20528","2841台開","110/07/15","永豐金-北高雄",0,30,-30
"20529","2841台開","110/07/15","第一金-台中",20,0,20
"20530","2841台開","110/07/15","華南永昌",0,25,-25
"20531","2841台開","110/07/15","豐農",20,0,20
"20532","2841台開","110/07/15","日盛-台南",0,20,-20
"20533","2841台開","110/07/15","華南永昌-新莊",19,0,19
"20534","2841台開","110/07/15","致和-佳里",0,20,-20
"20535","2841台開","110/07/15","玉山-大里",12,0,12
"20536","2841台開","110/07/15","國票-中港",0,20,-20
"20537","2841台開","110/07/15","元富-安南",10,0,10
"20538","2841台開","110/07/15","元大-歸仁",0,20,-20
"20539","2841台開","110/07/15","凱基-市政",10,0,10
"20540","2841台開","110/07/15","統一-三多",0,19,-19
"20541","2841台開","110/07/15","凱基-竹科",10,0,10
"20542","2841台開","110/07/15","凱基-城中",0,18,-18
"20543","2841台開","110/07/15","國泰-板橋",10,1,9
"20544","2841台開","110/07/15","國票-中和",0,15,-15
"20545","2841台開","110/07/15","凱基-台北",9,0,9
"20546","2841台開","110/07/15","元大-彰化",0,15,-15
"20547","2841台開","110/07/15","合庫證券",6,0,6
"20548","2841台開","110/07/15","元大-復北",0,15,-15
"20549","2841台開","110/07/15","台中銀",6,0,6
"20550","2841台開","110/07/15","土銀-花蓮",0,14,-14
"20551","6207雷科","110/07/15","凱基-板橋",210,45,165
"20552","6207雷科","110/07/15","群益金鼎-台北",20,80,-60
"20553","6207雷科","110/07/15","富邦證券",150,0,150
"20554","6207雷科","110/07/15","元大-大天母",1,56,-55
"20555","6207雷科","110/07/15","凱基-復興",140,0,140
"20556","6207雷科","110/07/15","大慶-中壢",2,50,-48
"20557","6207雷科","110/07/15","華南永昌-中正",140,0,140
"20558","6207雷科","110/07/15","元富-林園",0,47,-47
"20559","6207雷科","110/07/15","永豐金-內湖",92,10,82
"20560","6207雷科","110/07/15","元大-東門",0,40,-40
"20561","6207雷科","110/07/15","富邦-彰化",81,11,70
"20562","6207雷科","110/07/15","第一金-安和",0,37,-37
"20563","6207雷科","110/07/15","(牛牛牛)亞-網路",67,0,67
"20564","6207雷科","110/07/15","凱基-台北",61,97,-36
"20565","6207雷科","110/07/15","台新證券",60,8,52
"20566","6207雷科","110/07/15","國票-南科",0,32,-32
"20567","6207雷科","110/07/15","華南永昌",50,3,47
"20568","6207雷科","110/07/15","元大-四維",0,32,-32
"20569","6207雷科","110/07/15","新加坡商瑞銀",68,26,42
"20570","6207雷科","110/07/15","元大-板橋",0,30,-30
"20571","6207雷科","110/07/15","日盛-景美",40,0,40
"20572","6207雷科","110/07/15","元大-南崁",1,30,-29
"20573","6207雷科","110/07/15","元富-大昌",40,0,40
"20574","6207雷科","110/07/15","凱基-岡山",0,27,-27
"20575","6207雷科","110/07/15","統一-高雄",38,5,33
"20576","6207雷科","110/07/15","統一-新竹",0,26,-26
"20577","6207雷科","110/07/15","日盛證券",32,0,32
"20578","6207雷科","110/07/15","群益金鼎-三民",1,27,-26
"20579","6207雷科","110/07/15","華南永昌-頭份",31,0,31
"20580","6207雷科","110/07/15","國票-台中",0,25,-25
"20581","3679新至陞","110/07/15","群益金鼎-大安",25,0,25
"20582","3679新至陞","110/07/15","元大-成功",0,10,-10
"20583","3679新至陞","110/07/15","元大-彰化",13,0,13
"20584","3679新至陞","110/07/15","群益金鼎-東大",0,8,-8
"20585","3679新至陞","110/07/15","國票-桃園",10,0,10
"20586","3679新至陞","110/07/15","凱基-台北",4,12,-8
"20587","3679新至陞","110/07/15","群益金鼎-台南",10,0,10
"20588","3679新至陞","110/07/15","第一金-華江",0,5,-5
"20589","3679新至陞","110/07/15","華南永昌-台中",10,0,10
"20590","3679新至陞","110/07/15","兆豐-來福",0,5,-5
"20591","3679新至陞","110/07/15","港商野村",9,0,9
"20592","3679新至陞","110/07/15","元大-北三重",0,5,-5
"20593","3679新至陞","110/07/15","元大-永春",6,0,6
"20594","3679新至陞","110/07/15","瑞士信貸",0,4,-4
"20595","3679新至陞","110/07/15","(牛牛牛)亞-網路",5,0,5
"20596","3679新至陞","110/07/15","新加坡商瑞銀",0,4,-4
"20597","3679新至陞","110/07/15","凱基-高雄",5,0,5
"20598","3679新至陞","110/07/15","元大-汐止",0,4,-4
"20599","3679新至陞","110/07/15","美商高盛",6,2,4
"20600","3679新至陞","110/07/15","台中銀-員林",0,3,-3
"20601","3679新至陞","110/07/15","台新證券",3,1,2
"20602","3679新至陞","110/07/15","兆豐-忠孝",0,3,-3
"20603","3679新至陞","110/07/15","群益金鼎-大興",2,0,2
"20604","3679新至陞","110/07/15","玉山-新莊",0,3,-3
"20605","3679新至陞","110/07/15","元大-六合",2,0,2
"20606","3679新至陞","110/07/15","永豐金-屏東",0,3,-3
"20607","3679新至陞","110/07/15","彰銀",1,0,1
"20608","3679新至陞","110/07/15","永豐金-敦南",0,3,-3
"20609","3679新至陞","110/07/15","美林",2,1,1
"20610","3679新至陞","110/07/15","永豐金-萬盛",0,3,-3
"20611","2727王品","110/07/15","兆豐-南京",101,0,101
"20612","2727王品","110/07/15","富邦-左營",0,102,-102
"20613","2727王品","110/07/15","港商野村",166,73,93
"20614","2727王品","110/07/15","日盛-忠孝",2,32,-30
"20615","2727王品","110/07/15","瑞士信貸",97,8,89
"20616","2727王品","110/07/15","群益金鼎-古亭",2,24,-22
"20617","2727王品","110/07/15","玉山證券",56,12,44
"20618","2727王品","110/07/15","日盛-八德",0,21,-21
"20619","2727王品","110/07/15","第一金-高雄",43,1,42
"20620","2727王品","110/07/15","元大-新盛",2,23,-21
"20621","2727王品","110/07/15","台新證券",74,45,29
"20622","2727王品","110/07/15","摩根大通",53,72,-19
"20623","2727王品","110/07/15","康和-澎湖",27,0,27
"20624","2727王品","110/07/15","富邦-彰化",8,26,-18
"20625","2727王品","110/07/15","富邦-陽明",31,4,27
"20626","2727王品","110/07/15","富邦-台中",7,24,-17
"20627","2727王品","110/07/15","國票-北高雄",27,1,26
"20628","2727王品","110/07/15","新加坡商瑞銀",13,29,-16
"20629","2727王品","110/07/15","國泰-板橋",38,12,26
"20630","2727王品","110/07/15","國泰-敦南",35,50,-15
"20631","2727王品","110/07/15","凱基-興隆",23,0,23
"20632","2727王品","110/07/15","元大-龍潭",0,14,-14
"20633","2727王品","110/07/15","凱基-板橋",29,7,22
"20634","2727王品","110/07/15","中國信託-文心",8,21,-13
"20635","2727王品","110/07/15","合庫-彰化",21,0,21
"20636","2727王品","110/07/15","永豐金-竹科",2,15,-13
"20637","2727王品","110/07/15","土銀-南港",20,0,20
"20638","2727王品","110/07/15","臺銀-臺南",2,14,-12
"20639","2727王品","110/07/15","美林",37,18,19
"20640","2727王品","110/07/15","凱基-台北",56,68,-12
"20641","1570力肯","110/07/15","群益金鼎-高雄",40,0,40
"20642","1570力肯","110/07/15","元大-高雄",0,12,-12
"20643","1570力肯","110/07/15","新光",40,8,32
"20644","1570力肯","110/07/15","永豐金-中正",0,10,-10
"20645","1570力肯","110/07/15","凱基-台北",20,2,18
"20646","1570力肯","110/07/15","國泰-松江",0,9,-9
"20647","1570力肯","110/07/15","凱基-天母",6,0,6
"20648","1570力肯","110/07/15","台新證券",0,8,-8
"20649","1570力肯","110/07/15","元富-新店",5,0,5
"20650","1570力肯","110/07/15","玉山證券",0,7,-7
"20651","1570力肯","110/07/15","凱基-中港",5,0,5
"20652","1570力肯","110/07/15","元大-府城",0,7,-7
"20653","1570力肯","110/07/15","富邦-園區",5,0,5
"20654","1570力肯","110/07/15","元大-板橋",0,6,-6
"20655","1570力肯","110/07/15","瑞士信貸",4,0,4
"20656","1570力肯","110/07/15","日盛-信義",0,5,-5
"20657","1570力肯","110/07/15","第一金-路竹",3,0,3
"20658","1570力肯","110/07/15","國票-和平",0,5,-5
"20659","1570力肯","110/07/15","摩根大通",3,0,3
"20660","1570力肯","110/07/15","元大-民雄",0,5,-5
"20661","1570力肯","110/07/15","凱基-桃園",3,0,3
"20662","1570力肯","110/07/15","統一-台中",0,4,-4
"20663","1570力肯","110/07/15","永豐金-苓雅",3,0,3
"20664","1570力肯","110/07/15","玉山-雙和",0,4,-4
"20665","1570力肯","110/07/15","統一-員林",2,0,2
"20666","1570力肯","110/07/15","凱基-敦北",0,4,-4
"20667","1570力肯","110/07/15","元大-永春",2,0,2
"20668","1570力肯","110/07/15","富邦-新店",0,4,-4
"20669","1570力肯","110/07/15","元大-土城永寧",2,0,2
"20670","1570力肯","110/07/15","日盛-板橋",0,3,-3
"20671","6180橘子","110/07/15","兆豐證券",130,0,130
"20672","6180橘子","110/07/15","港商野村",21,137,-116
"20673","6180橘子","110/07/15","摩根大通",111,0,111
"20674","6180橘子","110/07/15","高橋",0,40,-40
"20675","6180橘子","110/07/15","石橋證券",80,0,80
"20676","6180橘子","110/07/15","臺銀",1,40,-39
"20677","6180橘子","110/07/15","凱基-台北",78,26,52
"20678","6180橘子","110/07/15","玉山-桃園",0,35,-35
"20679","6180橘子","110/07/15","新加坡商瑞銀",38,1,37
"20680","6180橘子","110/07/15","玉山-台南",2,33,-31
"20681","6180橘子","110/07/15","富邦-員林",32,0,32
"20682","6180橘子","110/07/15","統一-南京",0,30,-30
"20683","6180橘子","110/07/15","日盛-文化",23,0,23
"20684","6180橘子","110/07/15","康和-台南",0,25,-25
"20685","6180橘子","110/07/15","元富-新店",20,0,20
"20686","6180橘子","110/07/15","大昌-樹林",0,22,-22
"20687","6180橘子","110/07/15","美林",15,0,15
"20688","6180橘子","110/07/15","康和-新竹",0,20,-20
"20689","6180橘子","110/07/15","新光-新竹",17,2,15
"20690","6180橘子","110/07/15","群益金鼎-台中",0,20,-20
"20691","6180橘子","110/07/15","富邦-嘉義",12,0,12
"20692","6180橘子","110/07/15","元大-彰化民生",0,18,-18
"20693","6180橘子","110/07/15","花旗環球",11,0,11
"20694","6180橘子","110/07/15","元大-草屯",0,16,-16
"20695","6180橘子","110/07/15","第一金-新興",11,0,11
"20696","6180橘子","110/07/15","元富-潮州",0,13,-13
"20697","6180橘子","110/07/15","第一金-桃園",10,0,10
"20698","6180橘子","110/07/15","宏遠-台南",0,11,-11
"20699","6180橘子","110/07/15","永興",10,0,10
"20700","6180橘子","110/07/15","大慶-泰山",0,10,-10
"20701","2390云辰","110/07/15","凱基",5007,0,5007
"20702","2390云辰","110/07/15","凱基-台北",382,616,-234
"20703","2390云辰","110/07/15","元大證券",1006,25,981
"20704","2390云辰","110/07/15","富邦-陽明",69,265,-196
"20705","2390云辰","110/07/15","元大-天母",456,20,436
"20706","2390云辰","110/07/15","永豐金-桃園",63,255,-192
"20707","2390云辰","110/07/15","港商野村",975,675,300
"20708","2390云辰","110/07/15","富邦-仁愛",17,187,-170
"20709","2390云辰","110/07/15","摩根大通",1318,1040,278
"20710","2390云辰","110/07/15","日盛-和美",2,165,-163
"20711","2390云辰","110/07/15","國票-博愛",184,7,177
"20712","2390云辰","110/07/15","國泰-敦南",142,290,-148
"20713","2390云辰","110/07/15","群益金鼎-大甲",113,13,100
"20714","2390云辰","110/07/15","台灣摩根士丹利",51,197,-146
"20715","2390云辰","110/07/15","凱基-大直",89,2,87
"20716","2390云辰","110/07/15","國票-嘉義",4,148,-144
"20717","2390云辰","110/07/15","玉山-台中",77,8,69
"20718","2390云辰","110/07/15","台中銀",8,139,-131
"20719","2390云辰","110/07/15","聯邦商銀",70,4,66
"20720","2390云辰","110/07/15","元大-彰化民生",7,138,-131
"20721","2390云辰","110/07/15","元大-大里",88,25,63
"20722","2390云辰","110/07/15","元富-成功",2,111,-109
"20723","2390云辰","110/07/15","富邦-嘉義",542,480,62
"20724","2390云辰","110/07/15","元大-東泰",3,106,-103
"20725","2390云辰","110/07/15","新加坡商瑞銀",158,97,61
"20726","2390云辰","110/07/15","合庫-三重",1,102,-101
"20727","2390云辰","110/07/15","華南永昌-台中",86,35,51
"20728","2390云辰","110/07/15","元富-大裕",4,87,-83
"20729","2390云辰","110/07/15","群益金鼎",51,6,45
"20730","2390云辰","110/07/15","凱基-和平",17,96,-79
"20731","2363矽統","110/07/14","台灣摩根士丹利",463,0,463
"20732","2363矽統","110/07/14","新加坡商瑞銀",568,1321,-753
"20733","2363矽統","110/07/14","台新證券",750,342,408
"20734","2363矽統","110/07/14","瑞士信貸",149,864,-715
"20735","2363矽統","110/07/14","玉山-台中",363,51,312
"20736","2363矽統","110/07/14","台新-屏東",115,380,-265
"20737","2363矽統","110/07/14","元大-斗六",223,25,198
"20738","2363矽統","110/07/14","永豐金證券",16,265,-249
"20739","2363矽統","110/07/14","華南永昌-朴子",208,38,170
"20740","2363矽統","110/07/14","美林",462,701,-239
"20741","2363矽統","110/07/14","元富-西松",169,12,157
"20742","2363矽統","110/07/14","宏遠-桃園",269,500,-231
"20743","2363矽統","110/07/14","永豐金-大園",146,6,140
"20744","2363矽統","110/07/14","凱基-竹北",36,254,-218
"20745","2363矽統","110/07/14","土銀-和平",134,0,134
"20746","2363矽統","110/07/14","港商法國興業",0,214,-214
"20747","2363矽統","110/07/14","富邦-新營",130,13,117
"20748","2363矽統","110/07/14","港商野村",835,1044,-209
"20749","2363矽統","110/07/14","元富-成功",118,11,107
"20750","2363矽統","110/07/14","北城證券",212,411,-199
"20751","2363矽統","110/07/14","元富-烏日",121,18,103
"20752","2363矽統","110/07/14","(牛牛牛)亞-鑫豐",51,241,-190
"20753","2363矽統","110/07/14","日盛-二林",120,18,102
"20754","2363矽統","110/07/14","國票-博愛",24,213,-189
"20755","2363矽統","110/07/14","兆豐-忠孝",98,2,96
"20756","2363矽統","110/07/14","大慶-蘆洲",134,316,-182
"20757","2363矽統","110/07/14","大慶-楊梅",92,3,89
"20758","2363矽統","110/07/14","彰銀-台中",15,193,-178
"20759","2363矽統","110/07/14","元富-三重",120,33,87
"20760","2363矽統","110/07/14","日盛-和美",18,185,-167
"20761","8112至上","110/07/14","新加坡商瑞銀",223,17,206
"20762","8112至上","110/07/14","瑞士信貸",8,170,-162
"20763","8112至上","110/07/14","摩根大通",285,129,156
"20764","8112至上","110/07/14","美林",55,202,-147
"20765","8112至上","110/07/14","花旗環球",124,0,124
"20766","8112至上","110/07/14","凱基-台北",325,436,-111
"20767","8112至上","110/07/14","兆豐-公益",117,4,113
"20768","8112至上","110/07/14","台中銀-台北",0,98,-98
"20769","8112至上","110/07/14","香港上海匯豐",111,0,111
"20770","8112至上","110/07/14","玉山-台大",17,107,-90
"20771","8112至上","110/07/14","永豐金-內湖",117,21,96
"20772","8112至上","110/07/14","康和-內湖",1,90,-89
"20773","8112至上","110/07/14","台灣摩根士丹利",108,16,92
"20774","8112至上","110/07/14","港商野村",21,84,-63
"20775","8112至上","110/07/14","元大-東蘆",77,0,77
"20776","8112至上","110/07/14","兆豐-北高雄",1,60,-59
"20777","8112至上","110/07/14","新光",108,48,60
"20778","8112至上","110/07/14","群益金鼎-海山",1,52,-51
"20779","8112至上","110/07/14","大慶-蘆洲",59,0,59
"20780","8112至上","110/07/14","群益金鼎-大安",0,50,-50
"20781","8112至上","110/07/14","華南永昌-台中",56,3,53
"20782","8112至上","110/07/14","富邦-仁愛",2,49,-47
"20783","8112至上","110/07/14","土銀-嘉義",52,2,50
"20784","8112至上","110/07/14","元大-金華",0,42,-42
"20785","8112至上","110/07/14","美商高盛",40,0,40
"20786","8112至上","110/07/14","元大-內湖",4,43,-39
"20787","8112至上","110/07/14","臺銀",63,29,34
"20788","8112至上","110/07/14","第一金-華江",2,37,-35
"20789","8112至上","110/07/14","元富-嘉義",31,0,31
"20790","8112至上","110/07/14","永豐金-苓雅",2,34,-32
"20791","1570力肯","110/07/14","國票-北高雄",68,0,68
"20792","1570力肯","110/07/14","摩根大通",0,21,-21
"20793","1570力肯","110/07/14","日盛-八德",30,1,29
"20794","1570力肯","110/07/14","新光",1,19,-18
"20795","1570力肯","110/07/14","玉山-高雄",7,0,7
"20796","1570力肯","110/07/14","(牛牛牛)亞-鑫豐",0,17,-17
"20797","1570力肯","110/07/14","臺銀-臺南",5,0,5
"20798","1570力肯","110/07/14","日盛-士林",0,10,-10
"20799","1570力肯","110/07/14","凱基-三峽",5,0,5
"20800","1570力肯","110/07/14","統一-員林",0,10,-10
"20801","1570力肯","110/07/14","元大-和平",5,0,5
"20802","1570力肯","110/07/14","國票-新莊",0,10,-10
"20803","1570力肯","110/07/14","合庫-三重",4,0,4
"20804","1570力肯","110/07/14","凱基-高美館",0,10,-10
"20805","1570力肯","110/07/14","瑞士信貸",4,0,4
"20806","1570力肯","110/07/14","元大-屏東民生",0,5,-5
"20807","1570力肯","110/07/14","統一-三多",4,0,4
"20808","1570力肯","110/07/14","元大-古亭",0,5,-5
"20809","1570力肯","110/07/14","華南永昌-古亭",4,0,4
"20810","1570力肯","110/07/14","日盛-木柵",0,4,-4
"20811","1570力肯","110/07/14","元大-高雄",3,0,3
"20812","1570力肯","110/07/14","大昌",0,4,-4
"20813","1570力肯","110/07/14","兆豐-忠孝",2,0,2
"20814","1570力肯","110/07/14","群益金鼎-東大",0,4,-4
"20815","1570力肯","110/07/14","富邦-陽明",2,0,2
"20816","1570力肯","110/07/14","凱基-台北",0,4,-4
"20817","1570力肯","110/07/14","元大-松山",2,0,2
"20818","1570力肯","110/07/14","元大-板橋",0,4,-4
"20819","1570力肯","110/07/14","元大-忠孝",2,0,2
"20820","1570力肯","110/07/14","第一金-中山",0,3,-3
"20821","2929淘帝","110/07/14","華南永昌-林口",60,0,60
"20822","2929淘帝","110/07/14","群益金鼎",25,540,-515
"20823","2929淘帝","110/07/14","美林",87,31,56
"20824","2929淘帝","110/07/14","國泰-台南",1,30,-29
"20825","2929淘帝","110/07/14","元富-台南",40,0,40
"20826","2929淘帝","110/07/14","宏遠-桃園",0,20,-20
"20827","2929淘帝","110/07/14","元大-民生",39,0,39
"20828","2929淘帝","110/07/14","摩根大通",11,31,-20
"20829","2929淘帝","110/07/14","臺銀-鳳山",34,0,34
"20830","2929淘帝","110/07/14","台新-建北",5,20,-15
"20831","2929淘帝","110/07/14","合庫-高雄",34,1,33
"20832","2929淘帝","110/07/14","新光",1,16,-15
"20833","2929淘帝","110/07/14","華南永昌-鶯歌",28,0,28
"20834","2929淘帝","110/07/14","玉山-板橋",0,15,-15
"20835","2929淘帝","110/07/14","永興",25,0,25
"20836","2929淘帝","110/07/14","凱基-羅東",0,15,-15
"20837","2929淘帝","110/07/14","元大-新盛",25,1,24
"20838","2929淘帝","110/07/14","元大-頭份",0,15,-15
"20839","2929淘帝","110/07/14","日盛-南京",23,0,23
"20840","2929淘帝","110/07/14","第一金-台南",0,13,-13
"20841","2929淘帝","110/07/14","日茂",20,0,20
"20842","2929淘帝","110/07/14","富邦-基隆",0,12,-12
"20843","2929淘帝","110/07/14","台新-台中",20,0,20
"20844","2929淘帝","110/07/14","日茂-南投",1,12,-11
"20845","2929淘帝","110/07/14","華南永昌",20,0,20
"20846","2929淘帝","110/07/14","元大-豐原站前",0,11,-11
"20847","2929淘帝","110/07/14","福勝",15,0,15
"20848","2929淘帝","110/07/14","玉山-士林",0,10,-10
"20849","2929淘帝","110/07/14","富邦-南屯",15,0,15
"20850","2929淘帝","110/07/14","富邦-台北",0,10,-10
"20851","5410國眾","110/07/14","兆豐-城中",35,0,35
"20852","5410國眾","110/07/14","瑞士信貸",0,29,-29
"20853","5410國眾","110/07/14","新光",21,1,20
"20854","5410國眾","110/07/14","國泰-板橋",1,30,-29
"20855","5410國眾","110/07/14","國泰-敦南",21,1,20
"20856","5410國眾","110/07/14","日盛-高雄",0,20,-20
"20857","5410國眾","110/07/14","國泰-台中",20,1,19
"20858","5410國眾","110/07/14","台新-左楠",1,20,-19
"20859","5410國眾","110/07/14","元大-崇德",19,0,19
"20860","5410國眾","110/07/14","元富-大昌",1,18,-17
"20861","5410國眾","110/07/14","土銀-士林",18,0,18
"20862","5410國眾","110/07/14","富邦-建國",0,15,-15
"20863","5410國眾","110/07/14","元大-新盛",20,2,18
"20864","5410國眾","110/07/14","元富-嘉義",0,12,-12
"20865","5410國眾","110/07/14","兆豐-高雄",15,0,15
"20866","5410國眾","110/07/14","永全-南崁",0,12,-12
"20867","5410國眾","110/07/14","宏遠-中和",10,0,10
"20868","5410國眾","110/07/14","元大-員林",0,11,-11
"20869","5410國眾","110/07/14","新光-桃園",10,0,10
"20870","5410國眾","110/07/14","高橋",0,10,-10
"20871","5410國眾","110/07/14","國泰-台南",10,0,10
"20872","5410國眾","110/07/14","永興",0,10,-10
"20873","5410國眾","110/07/14","元大-復北",10,0,10
"20874","5410國眾","110/07/14","華南永昌-三重",0,10,-10
"20875","5410國眾","110/07/14","元大-竹科",8,0,8
"20876","5410國眾","110/07/14","元大-苑裡",0,7,-7
"20877","5410國眾","110/07/14","台新-新營",6,0,6
"20878","5410國眾","110/07/14","港商野村",0,6,-6
"20879","5410國眾","110/07/14","日盛-士林",5,0,5
"20880","5410國眾","110/07/14","摩根大通",5,11,-6
"20881","2841台開","110/07/14","凱基-文心",73,0,73
"20882","2841台開","110/07/14","國泰-敦南",0,50,-50
"20883","2841台開","110/07/14","元富-潮州",30,0,30
"20884","2841台開","110/07/14","凱基-中壢",0,40,-40
"20885","2841台開","110/07/14","第一金-台中",20,0,20
"20886","2841台開","110/07/14","統一-新竹",0,24,-24
"20887","2841台開","110/07/14","華南永昌-新莊",20,0,20
"20888","2841台開","110/07/14","元富-草屯",0,20,-20
"20889","2841台開","110/07/14","永豐金-豐原",20,0,20
"20890","2841台開","110/07/14","台新-台南",0,20,-20
"20891","2841台開","110/07/14","國泰-館前",15,0,15
"20892","2841台開","110/07/14","永豐金-敦南",45,63,-18
"20893","2841台開","110/07/14","群益金鼎-基隆",12,0,12
"20894","2841台開","110/07/14","國票-北高雄",0,13,-13
"20895","2841台開","110/07/14","日盛-信義",10,0,10
"20896","2841台開","110/07/14","凱基-松山",0,10,-10
"20897","2841台開","110/07/14","台新-台中",10,0,10
"20898","2841台開","110/07/14","元大證券",0,10,-10
"20899","2841台開","110/07/14","新光",10,1,9
"20900","2841台開","110/07/14","元大-中壢",0,10,-10
"20901","2841台開","110/07/14","凱基-新店",8,0,8
"20902","2841台開","110/07/14","富邦-陽明",1,10,-9
"20903","2841台開","110/07/14","元大-斗信",7,0,7
"20904","2841台開","110/07/14","富邦-建國",0,9,-9
"20905","2841台開","110/07/14","元大-三重",6,0,6
"20906","2841台開","110/07/14","富邦-台南",0,8,-8
"20907","2841台開","110/07/14","永豐金-中和",6,0,6
"20908","2841台開","110/07/14","康和-澎湖",0,7,-7
"20909","2841台開","110/07/14","元富-成功",5,0,5
"20910","2841台開","110/07/14","日盛-斗六",0,6,-6
"20911","6207雷科","110/07/14","群益金鼎-台北",60,0,60
"20912","6207雷科","110/07/14","新加坡商瑞銀",10,56,-46
"20913","6207雷科","110/07/14","台新-高雄",43,3,40
"20914","6207雷科","110/07/14","國票-中和",0,41,-41
"20915","6207雷科","110/07/14","元大-高雄",19,0,19
"20916","6207雷科","110/07/14","元大-復北",0,33,-33
"20917","6207雷科","110/07/14","福勝",15,0,15
"20918","6207雷科","110/07/14","光和-和美",0,20,-20
"20919","6207雷科","110/07/14","群益金鼎-中山",15,0,15
"20920","6207雷科","110/07/14","群益金鼎-丹鳳",0,20,-20
"20921","6207雷科","110/07/14","元大-林園",15,0,15
"20922","6207雷科","110/07/14","第一金-路竹",0,10,-10
"20923","6207雷科","110/07/14","新光",12,0,12
"20924","6207雷科","110/07/14","元大-歸仁",0,10,-10
"20925","6207雷科","110/07/14","元大-大天母",10,0,10
"20926","6207雷科","110/07/14","宏遠-館前",0,9,-9
"20927","6207雷科","110/07/14","永豐金-忠孝",9,0,9
"20928","6207雷科","110/07/14","凱基-台北",12,20,-8
"20929","6207雷科","110/07/14","永豐金-新店",7,0,7
"20930","6207雷科","110/07/14","美林",0,7,-7
"20931","6207雷科","110/07/14","玉山-嘉義",6,0,6
"20932","6207雷科","110/07/14","摩根大通",16,23,-7
"20933","6207雷科","110/07/14","元大-屏東",6,0,6
"20934","6207雷科","110/07/14","凱基-高雄",1,7,-6
"20935","6207雷科","110/07/14","凱基-大安",5,0,5
"20936","6207雷科","110/07/14","台中銀-豐原",0,5,-5
"20937","6207雷科","110/07/14","富邦-台南",5,0,5
"20938","6207雷科","110/07/14","元大-新竹經國",0,5,-5
"20939","6207雷科","110/07/14","元大-成功",5,0,5
"20940","6207雷科","110/07/14","光和-田中",0,4,-4
"20941","3679新至陞","110/07/14","凱基-台北",31,6,25
"20942","3679新至陞","110/07/14","群益金鼎-東大",0,15,-15
"20943","3679新至陞","110/07/14","華南永昌-新莊",10,0,10
"20944","3679新至陞","110/07/14","瑞士信貸",0,12,-12
"20945","3679新至陞","110/07/14","新加坡商瑞銀",11,3,8
"20946","3679新至陞","110/07/14","群益金鼎-永和",0,10,-10
"20947","3679新至陞","110/07/14","美商高盛",6,0,6
"20948","3679新至陞","110/07/14","元大-成功",5,15,-10
"20949","3679新至陞","110/07/14","第一金-中壢",6,0,6
"20950","3679新至陞","110/07/14","統一-板橋",1,10,-9
"20951","3679新至陞","110/07/14","(牛牛牛)亞-網路",4,0,4
"20952","3679新至陞","110/07/14","玉山-左營",0,5,-5
"20953","3679新至陞","110/07/14","元大-六合",3,0,3
"20954","3679新至陞","110/07/14","群益金鼎-三民",0,4,-4
"20955","3679新至陞","110/07/14","合庫-自強",2,0,2
"20956","3679新至陞","110/07/14","富邦-宜蘭",0,4,-4
"20957","3679新至陞","110/07/14","高橋-內壢",2,0,2
"20958","3679新至陞","110/07/14","永豐金-苓雅",0,3,-3
"20959","3679新至陞","110/07/14","台中銀-員林",2,0,2
"20960","3679新至陞","110/07/14","摩根大通",5,7,-2
"20961","3679新至陞","110/07/14","凱基-高美館",2,0,2
"20962","3679新至陞","110/07/14","元大-板橋三民",0,2,-2
"20963","3679新至陞","110/07/14","元大-福營",2,0,2
"20964","3679新至陞","110/07/14","宏遠-中和",0,1,-1
"20965","3679新至陞","110/07/14","永豐金-松山",2,0,2
"20966","3679新至陞","110/07/14","元富-佳里",0,1,-1
"20967","3679新至陞","110/07/14","永豐金-萬盛",2,0,2
"20968","3679新至陞","110/07/14","(牛牛牛)亞-鑫豐",0,1,-1
"20969","3679新至陞","110/07/14","元富-松德",1,0,1
"20970","3679新至陞","110/07/14","中國信託-中壢",0,1,-1
"20971","2727王品","110/07/14","富邦-左營",102,1,101
"20972","2727王品","110/07/14","統一-城中",100,234,-134
"20973","2727王品","110/07/14","國泰-板橋",105,11,94
"20974","2727王品","110/07/14","富邦-台北",1,125,-124
"20975","2727王品","110/07/14","港商野村",149,72,77
"20976","2727王品","110/07/14","台灣摩根士丹利",1,48,-47
"20977","2727王品","110/07/14","合庫-台中",66,2,64
"20978","2727王品","110/07/14","國票-新莊",0,40,-40
"20979","2727王品","110/07/14","臺銀-金山",63,8,55
"20980","2727王品","110/07/14","永豐金-忠孝",2,39,-37
"20981","2727王品","110/07/14","摩根大通",83,39,44
"20982","2727王品","110/07/14","富邦-彰化",1,34,-33
"20983","2727王品","110/07/14","凱基-台北",84,42,42
"20984","2727王品","110/07/14","康和-高雄",0,30,-30
"20985","2727王品","110/07/14","土銀-台中",35,1,34
"20986","2727王品","110/07/14","安泰",0,26,-26
"20987","2727王品","110/07/14","華南永昌-麻豆",32,1,31
"20988","2727王品","110/07/14","富邦-新竹華信",0,21,-21
"20989","2727王品","110/07/14","元大證券",85,55,30
"20990","2727王品","110/07/14","元大-南崁",1,22,-21
"20991","2727王品","110/07/14","新加坡商瑞銀",40,15,25
"20992","2727王品","110/07/14","彰銀-台中",0,18,-18
"20993","2727王品","110/07/14","日盛-八德",19,0,19
"20994","2727王品","110/07/14","元富-同大",2,20,-18
"20995","2727王品","110/07/14","統一",35,17,18
"20996","2727王品","110/07/14","玉山-嘉義",1,17,-16
"20997","2727王品","110/07/14","元富-大昌",18,1,17
"20998","2727王品","110/07/14","國泰-館前",4,20,-16
"20999","2727王品","110/07/14","玉山-板橋",15,1,14
"21000","2727王品","110/07/14","第一金-嘉義",1,13,-12
"21001","1570力肯","110/07/14","國票-北高雄",68,0,68
"21002","1570力肯","110/07/14","摩根大通",0,21,-21
"21003","1570力肯","110/07/14","日盛-八德",30,1,29
"21004","1570力肯","110/07/14","新光",1,19,-18
"21005","1570力肯","110/07/14","玉山-高雄",7,0,7
"21006","1570力肯","110/07/14","(牛牛牛)亞-鑫豐",0,17,-17
"21007","1570力肯","110/07/14","臺銀-臺南",5,0,5
"21008","1570力肯","110/07/14","日盛-士林",0,10,-10
"21009","1570力肯","110/07/14","凱基-三峽",5,0,5
"21010","1570力肯","110/07/14","統一-員林",0,10,-10
"21011","1570力肯","110/07/14","元大-和平",5,0,5
"21012","1570力肯","110/07/14","國票-新莊",0,10,-10
"21013","1570力肯","110/07/14","合庫-三重",4,0,4
"21014","1570力肯","110/07/14","凱基-高美館",0,10,-10
"21015","1570力肯","110/07/14","瑞士信貸",4,0,4
"21016","1570力肯","110/07/14","元大-屏東民生",0,5,-5
"21017","1570力肯","110/07/14","統一-三多",4,0,4
"21018","1570力肯","110/07/14","元大-古亭",0,5,-5
"21019","1570力肯","110/07/14","華南永昌-古亭",4,0,4
"21020","1570力肯","110/07/14","日盛-木柵",0,4,-4
"21021","1570力肯","110/07/14","元大-高雄",3,0,3
"21022","1570力肯","110/07/14","大昌",0,4,-4
"21023","1570力肯","110/07/14","兆豐-忠孝",2,0,2
"21024","1570力肯","110/07/14","群益金鼎-東大",0,4,-4
"21025","1570力肯","110/07/14","富邦-陽明",2,0,2
"21026","1570力肯","110/07/14","凱基-台北",0,4,-4
"21027","1570力肯","110/07/14","元大-松山",2,0,2
"21028","1570力肯","110/07/14","元大-板橋",0,4,-4
"21029","1570力肯","110/07/14","元大-忠孝",2,0,2
"21030","1570力肯","110/07/14","第一金-中山",0,3,-3
"21031","6180橘子","110/07/14","新加坡商瑞銀",84,28,56
"21032","6180橘子","110/07/14","凱基-台北",4,37,-33
"21033","6180橘子","110/07/14","日盛-信義",29,1,28
"21034","6180橘子","110/07/14","玉山-台南",1,22,-21
"21035","6180橘子","110/07/14","豐農",28,4,24
"21036","6180橘子","110/07/14","日盛-新竹",1,21,-20
"21037","6180橘子","110/07/14","新光-新竹",24,1,23
"21038","6180橘子","110/07/14","元富-潮州",0,19,-19
"21039","6180橘子","110/07/14","華南永昌-高雄",20,0,20
"21040","6180橘子","110/07/14","元大-信義",0,17,-17
"21041","6180橘子","110/07/14","元大-羅東",20,0,20
"21042","6180橘子","110/07/14","台灣企銀-台中",1,16,-15
"21043","6180橘子","110/07/14","元大-台中中港",20,0,20
"21044","6180橘子","110/07/14","元大-北港",0,15,-15
"21045","6180橘子","110/07/14","富邦-嘉義",24,5,19
"21046","6180橘子","110/07/14","富邦-高雄",0,14,-14
"21047","6180橘子","110/07/14","富邦-仁愛",15,0,15
"21048","6180橘子","110/07/14","兆豐-埔墘",0,13,-13
"21049","6180橘子","110/07/14","國票-九鼎",13,0,13
"21050","6180橘子","110/07/14","第一金-中山",0,10,-10
"21051","6180橘子","110/07/14","日盛-木柵",12,0,12
"21052","6180橘子","110/07/14","元大-彰化民生",0,10,-10
"21053","6180橘子","110/07/14","元大-成功",10,0,10
"21054","6180橘子","110/07/14","福勝",1,10,-9
"21055","6180橘子","110/07/14","港商野村",10,2,8
"21056","6180橘子","110/07/14","群益金鼎-丹鳳",1,10,-9
"21057","6180橘子","110/07/14","玉山-左營",8,0,8
"21058","6180橘子","110/07/14","群益金鼎-板橋",0,8,-8
"21059","6180橘子","110/07/14","富邦-陽明",16,8,8
"21060","6180橘子","110/07/14","合庫-鳳山",0,7,-7
"21061","2390云辰","110/07/14","摩根大通",995,198,797
"21062","2390云辰","110/07/14","新加坡商瑞銀",28,399,-371
"21063","2390云辰","110/07/14","美林",383,22,361
"21064","2390云辰","110/07/14","凱基-新豐",3,198,-195
"21065","2390云辰","110/07/14","台灣摩根士丹利",684,358,326
"21066","2390云辰","110/07/14","元大-士林",1,152,-151
"21067","2390云辰","110/07/14","凱基-台北",656,402,254
"21068","2390云辰","110/07/14","元大-竹山",80,181,-101
"21069","2390云辰","110/07/14","日盛-和美",110,5,105
"21070","2390云辰","110/07/14","群益金鼎-開元",19,95,-76
"21071","2390云辰","110/07/14","元大-天母",72,0,72
"21072","2390云辰","110/07/14","新光",77,150,-73
"21073","2390云辰","110/07/14","永豐金-松山",57,0,57
"21074","2390云辰","110/07/14","元富-高雄",0,71,-71
"21075","2390云辰","110/07/14","統一-屏東",53,0,53
"21076","2390云辰","110/07/14","元大-土城學府",130,201,-71
"21077","2390云辰","110/07/14","港商野村",486,450,36
"21078","2390云辰","110/07/14","元大-善化",12,76,-64
"21079","2390云辰","110/07/14","致和-崇德",30,0,30
"21080","2390云辰","110/07/14","華南永昌-岡山",23,81,-58
"21081","2390云辰","110/07/14","富邦-台北",40,14,26
"21082","2390云辰","110/07/14","群益金鼎-大興",82,125,-43
"21083","2390云辰","110/07/14","台新-高雄",38,13,25
"21084","2390云辰","110/07/14","大慶-中壢",0,41,-41
"21085","2390云辰","110/07/14","富邦-板橋",32,7,25
"21086","2390云辰","110/07/14","玉山-板橋",6,47,-41
"21087","2390云辰","110/07/14","陽信-石牌",24,0,24
"21088","2390云辰","110/07/14","富邦-台東",2,42,-40
"21089","2390云辰","110/07/14","凱基-屏東",32,8,24
"21090","2390云辰","110/07/14","元大-新營",3,42,-39
"21091","2363矽統","110/07/14","台灣摩根士丹利",463,0,463
"21092","2363矽統","110/07/14","新加坡商瑞銀",568,1321,-753
"21093","2363矽統","110/07/14","台新證券",750,342,408
"21094","2363矽統","110/07/14","瑞士信貸",149,864,-715
"21095","2363矽統","110/07/14","玉山-台中",363,51,312
"21096","2363矽統","110/07/14","台新-屏東",115,380,-265
"21097","2363矽統","110/07/14","元大-斗六",223,25,198
"21098","2363矽統","110/07/14","永豐金證券",16,265,-249
"21099","2363矽統","110/07/14","華南永昌-朴子",208,38,170
"21100","2363矽統","110/07/14","美林",462,701,-239
"21101","2363矽統","110/07/14","元富-西松",169,12,157
"21102","2363矽統","110/07/14","宏遠-桃園",269,500,-231
"21103","2363矽統","110/07/14","永豐金-大園",146,6,140
"21104","2363矽統","110/07/14","凱基-竹北",36,254,-218
"21105","2363矽統","110/07/14","土銀-和平",134,0,134
"21106","2363矽統","110/07/14","港商法國興業",0,214,-214
"21107","2363矽統","110/07/14","富邦-新營",130,13,117
"21108","2363矽統","110/07/14","港商野村",835,1044,-209
"21109","2363矽統","110/07/14","元富-成功",118,11,107
"21110","2363矽統","110/07/14","北城證券",212,411,-199
"21111","2363矽統","110/07/14","元富-烏日",121,18,103
"21112","2363矽統","110/07/14","(牛牛牛)亞-鑫豐",51,241,-190
"21113","2363矽統","110/07/14","日盛-二林",120,18,102
"21114","2363矽統","110/07/14","國票-博愛",24,213,-189
"21115","2363矽統","110/07/14","兆豐-忠孝",98,2,96
"21116","2363矽統","110/07/14","大慶-蘆洲",134,316,-182
"21117","2363矽統","110/07/14","大慶-楊梅",92,3,89
"21118","2363矽統","110/07/14","彰銀-台中",15,193,-178
"21119","2363矽統","110/07/14","元富-三重",120,33,87
"21120","2363矽統","110/07/14","日盛-和美",18,185,-167
"21121","8112至上","110/07/14","新加坡商瑞銀",223,17,206
"21122","8112至上","110/07/14","瑞士信貸",8,170,-162
"21123","8112至上","110/07/14","摩根大通",285,129,156
"21124","8112至上","110/07/14","美林",55,202,-147
"21125","8112至上","110/07/14","花旗環球",124,0,124
"21126","8112至上","110/07/14","凱基-台北",325,436,-111
"21127","8112至上","110/07/14","兆豐-公益",117,4,113
"21128","8112至上","110/07/14","台中銀-台北",0,98,-98
"21129","8112至上","110/07/14","香港上海匯豐",111,0,111
"21130","8112至上","110/07/14","玉山-台大",17,107,-90
"21131","8112至上","110/07/14","永豐金-內湖",117,21,96
"21132","8112至上","110/07/14","康和-內湖",1,90,-89
"21133","8112至上","110/07/14","台灣摩根士丹利",108,16,92
"21134","8112至上","110/07/14","港商野村",21,84,-63
"21135","8112至上","110/07/14","元大-東蘆",77,0,77
"21136","8112至上","110/07/14","兆豐-北高雄",1,60,-59
"21137","8112至上","110/07/14","新光",108,48,60
"21138","8112至上","110/07/14","群益金鼎-海山",1,52,-51
"21139","8112至上","110/07/14","大慶-蘆洲",59,0,59
"21140","8112至上","110/07/14","群益金鼎-大安",0,50,-50
"21141","8112至上","110/07/14","華南永昌-台中",56,3,53
"21142","8112至上","110/07/14","富邦-仁愛",2,49,-47
"21143","8112至上","110/07/14","土銀-嘉義",52,2,50
"21144","8112至上","110/07/14","元大-金華",0,42,-42
"21145","8112至上","110/07/14","美商高盛",40,0,40
"21146","8112至上","110/07/14","元大-內湖",4,43,-39
"21147","8112至上","110/07/14","臺銀",63,29,34
"21148","8112至上","110/07/14","第一金-華江",2,37,-35
"21149","8112至上","110/07/14","元富-嘉義",31,0,31
"21150","8112至上","110/07/14","永豐金-苓雅",2,34,-32
"21151","1570力肯","110/07/14","國票-北高雄",68,0,68
"21152","1570力肯","110/07/14","摩根大通",0,21,-21
"21153","1570力肯","110/07/14","日盛-八德",30,1,29
"21154","1570力肯","110/07/14","新光",1,19,-18
"21155","1570力肯","110/07/14","玉山-高雄",7,0,7
"21156","1570力肯","110/07/14","(牛牛牛)亞-鑫豐",0,17,-17
"21157","1570力肯","110/07/14","臺銀-臺南",5,0,5
"21158","1570力肯","110/07/14","日盛-士林",0,10,-10
"21159","1570力肯","110/07/14","凱基-三峽",5,0,5
"21160","1570力肯","110/07/14","統一-員林",0,10,-10
"21161","1570力肯","110/07/14","元大-和平",5,0,5
"21162","1570力肯","110/07/14","國票-新莊",0,10,-10
"21163","1570力肯","110/07/14","合庫-三重",4,0,4
"21164","1570力肯","110/07/14","凱基-高美館",0,10,-10
"21165","1570力肯","110/07/14","瑞士信貸",4,0,4
"21166","1570力肯","110/07/14","元大-屏東民生",0,5,-5
"21167","1570力肯","110/07/14","統一-三多",4,0,4
"21168","1570力肯","110/07/14","元大-古亭",0,5,-5
"21169","1570力肯","110/07/14","華南永昌-古亭",4,0,4
"21170","1570力肯","110/07/14","日盛-木柵",0,4,-4
"21171","1570力肯","110/07/14","元大-高雄",3,0,3
"21172","1570力肯","110/07/14","大昌",0,4,-4
"21173","1570力肯","110/07/14","兆豐-忠孝",2,0,2
"21174","1570力肯","110/07/14","群益金鼎-東大",0,4,-4
"21175","1570力肯","110/07/14","富邦-陽明",2,0,2
"21176","1570力肯","110/07/14","凱基-台北",0,4,-4
"21177","1570力肯","110/07/14","元大-松山",2,0,2
"21178","1570力肯","110/07/14","元大-板橋",0,4,-4
"21179","1570力肯","110/07/14","元大-忠孝",2,0,2
"21180","1570力肯","110/07/14","第一金-中山",0,3,-3
"21181","2929淘帝","110/07/14","華南永昌-林口",60,0,60
"21182","2929淘帝","110/07/14","群益金鼎",25,540,-515
"21183","2929淘帝","110/07/14","美林",87,31,56
"21184","2929淘帝","110/07/14","國泰-台南",1,30,-29
"21185","2929淘帝","110/07/14","元富-台南",40,0,40
"21186","2929淘帝","110/07/14","宏遠-桃園",0,20,-20
"21187","2929淘帝","110/07/14","元大-民生",39,0,39
"21188","2929淘帝","110/07/14","摩根大通",11,31,-20
"21189","2929淘帝","110/07/14","臺銀-鳳山",34,0,34
"21190","2929淘帝","110/07/14","台新-建北",5,20,-15
"21191","2929淘帝","110/07/14","合庫-高雄",34,1,33
"21192","2929淘帝","110/07/14","新光",1,16,-15
"21193","2929淘帝","110/07/14","華南永昌-鶯歌",28,0,28
"21194","2929淘帝","110/07/14","玉山-板橋",0,15,-15
"21195","2929淘帝","110/07/14","永興",25,0,25
"21196","2929淘帝","110/07/14","凱基-羅東",0,15,-15
"21197","2929淘帝","110/07/14","元大-新盛",25,1,24
"21198","2929淘帝","110/07/14","元大-頭份",0,15,-15
"21199","2929淘帝","110/07/14","日盛-南京",23,0,23
"21200","2929淘帝","110/07/14","第一金-台南",0,13,-13
"21201","2929淘帝","110/07/14","日茂",20,0,20
"21202","2929淘帝","110/07/14","富邦-基隆",0,12,-12
"21203","2929淘帝","110/07/14","台新-台中",20,0,20
"21204","2929淘帝","110/07/14","日茂-南投",1,12,-11
"21205","2929淘帝","110/07/14","華南永昌",20,0,20
"21206","2929淘帝","110/07/14","元大-豐原站前",0,11,-11
"21207","2929淘帝","110/07/14","福勝",15,0,15
"21208","2929淘帝","110/07/14","玉山-士林",0,10,-10
"21209","2929淘帝","110/07/14","富邦-南屯",15,0,15
"21210","2929淘帝","110/07/14","富邦-台北",0,10,-10
"21211","5410國眾","110/07/14","兆豐-城中",35,0,35
"21212","5410國眾","110/07/14","瑞士信貸",0,29,-29
"21213","5410國眾","110/07/14","新光",21,1,20
"21214","5410國眾","110/07/14","國泰-板橋",1,30,-29
"21215","5410國眾","110/07/14","國泰-敦南",21,1,20
"21216","5410國眾","110/07/14","日盛-高雄",0,20,-20
"21217","5410國眾","110/07/14","國泰-台中",20,1,19
"21218","5410國眾","110/07/14","台新-左楠",1,20,-19
"21219","5410國眾","110/07/14","元大-崇德",19,0,19
"21220","5410國眾","110/07/14","元富-大昌",1,18,-17
"21221","5410國眾","110/07/14","土銀-士林",18,0,18
"21222","5410國眾","110/07/14","富邦-建國",0,15,-15
"21223","5410國眾","110/07/14","元大-新盛",20,2,18
"21224","5410國眾","110/07/14","元富-嘉義",0,12,-12
"21225","5410國眾","110/07/14","兆豐-高雄",15,0,15
"21226","5410國眾","110/07/14","永全-南崁",0,12,-12
"21227","5410國眾","110/07/14","宏遠-中和",10,0,10
"21228","5410國眾","110/07/14","元大-員林",0,11,-11
"21229","5410國眾","110/07/14","新光-桃園",10,0,10
"21230","5410國眾","110/07/14","高橋",0,10,-10
"21231","5410國眾","110/07/14","國泰-台南",10,0,10
"21232","5410國眾","110/07/14","永興",0,10,-10
"21233","5410國眾","110/07/14","元大-復北",10,0,10
"21234","5410國眾","110/07/14","華南永昌-三重",0,10,-10
"21235","5410國眾","110/07/14","元大-竹科",8,0,8
"21236","5410國眾","110/07/14","元大-苑裡",0,7,-7
"21237","5410國眾","110/07/14","台新-新營",6,0,6
"21238","5410國眾","110/07/14","港商野村",0,6,-6
"21239","5410國眾","110/07/14","日盛-士林",5,0,5
"21240","5410國眾","110/07/14","摩根大通",5,11,-6
"21241","2841台開","110/07/14","凱基-文心",73,0,73
"21242","2841台開","110/07/14","國泰-敦南",0,50,-50
"21243","2841台開","110/07/14","元富-潮州",30,0,30
"21244","2841台開","110/07/14","凱基-中壢",0,40,-40
"21245","2841台開","110/07/14","第一金-台中",20,0,20
"21246","2841台開","110/07/14","統一-新竹",0,24,-24
"21247","2841台開","110/07/14","華南永昌-新莊",20,0,20
"21248","2841台開","110/07/14","元富-草屯",0,20,-20
"21249","2841台開","110/07/14","永豐金-豐原",20,0,20
"21250","2841台開","110/07/14","台新-台南",0,20,-20
"21251","2841台開","110/07/14","國泰-館前",15,0,15
"21252","2841台開","110/07/14","永豐金-敦南",45,63,-18
"21253","2841台開","110/07/14","群益金鼎-基隆",12,0,12
"21254","2841台開","110/07/14","國票-北高雄",0,13,-13
"21255","2841台開","110/07/14","日盛-信義",10,0,10
"21256","2841台開","110/07/14","凱基-松山",0,10,-10
"21257","2841台開","110/07/14","台新-台中",10,0,10
"21258","2841台開","110/07/14","元大證券",0,10,-10
"21259","2841台開","110/07/14","新光",10,1,9
"21260","2841台開","110/07/14","元大-中壢",0,10,-10
"21261","2841台開","110/07/14","凱基-新店",8,0,8
"21262","2841台開","110/07/14","富邦-陽明",1,10,-9
"21263","2841台開","110/07/14","元大-斗信",7,0,7
"21264","2841台開","110/07/14","富邦-建國",0,9,-9
"21265","2841台開","110/07/14","元大-三重",6,0,6
"21266","2841台開","110/07/14","富邦-台南",0,8,-8
"21267","2841台開","110/07/14","永豐金-中和",6,0,6
"21268","2841台開","110/07/14","康和-澎湖",0,7,-7
"21269","2841台開","110/07/14","元富-成功",5,0,5
"21270","2841台開","110/07/14","日盛-斗六",0,6,-6
"21271","6207雷科","110/07/14","群益金鼎-台北",60,0,60
"21272","6207雷科","110/07/14","新加坡商瑞銀",10,56,-46
"21273","6207雷科","110/07/14","台新-高雄",43,3,40
"21274","6207雷科","110/07/14","國票-中和",0,41,-41
"21275","6207雷科","110/07/14","元大-高雄",19,0,19
"21276","6207雷科","110/07/14","元大-復北",0,33,-33
"21277","6207雷科","110/07/14","福勝",15,0,15
"21278","6207雷科","110/07/14","光和-和美",0,20,-20
"21279","6207雷科","110/07/14","群益金鼎-中山",15,0,15
"21280","6207雷科","110/07/14","群益金鼎-丹鳳",0,20,-20
"21281","6207雷科","110/07/14","元大-林園",15,0,15
"21282","6207雷科","110/07/14","第一金-路竹",0,10,-10
"21283","6207雷科","110/07/14","新光",12,0,12
"21284","6207雷科","110/07/14","元大-歸仁",0,10,-10
"21285","6207雷科","110/07/14","元大-大天母",10,0,10
"21286","6207雷科","110/07/14","宏遠-館前",0,9,-9
"21287","6207雷科","110/07/14","永豐金-忠孝",9,0,9
"21288","6207雷科","110/07/14","凱基-台北",12,20,-8
"21289","6207雷科","110/07/14","永豐金-新店",7,0,7
"21290","6207雷科","110/07/14","美林",0,7,-7
"21291","6207雷科","110/07/14","玉山-嘉義",6,0,6
"21292","6207雷科","110/07/14","摩根大通",16,23,-7
"21293","6207雷科","110/07/14","元大-屏東",6,0,6
"21294","6207雷科","110/07/14","凱基-高雄",1,7,-6
"21295","6207雷科","110/07/14","凱基-大安",5,0,5
"21296","6207雷科","110/07/14","台中銀-豐原",0,5,-5
"21297","6207雷科","110/07/14","富邦-台南",5,0,5
"21298","6207雷科","110/07/14","元大-新竹經國",0,5,-5
"21299","6207雷科","110/07/14","元大-成功",5,0,5
"21300","6207雷科","110/07/14","光和-田中",0,4,-4
"21301","3679新至陞","110/07/14","凱基-台北",31,6,25
"21302","3679新至陞","110/07/14","群益金鼎-東大",0,15,-15
"21303","3679新至陞","110/07/14","華南永昌-新莊",10,0,10
"21304","3679新至陞","110/07/14","瑞士信貸",0,12,-12
"21305","3679新至陞","110/07/14","新加坡商瑞銀",11,3,8
"21306","3679新至陞","110/07/14","群益金鼎-永和",0,10,-10
"21307","3679新至陞","110/07/14","美商高盛",6,0,6
"21308","3679新至陞","110/07/14","元大-成功",5,15,-10
"21309","3679新至陞","110/07/14","第一金-中壢",6,0,6
"21310","3679新至陞","110/07/14","統一-板橋",1,10,-9
"21311","3679新至陞","110/07/14","(牛牛牛)亞-網路",4,0,4
"21312","3679新至陞","110/07/14","玉山-左營",0,5,-5
"21313","3679新至陞","110/07/14","元大-六合",3,0,3
"21314","3679新至陞","110/07/14","群益金鼎-三民",0,4,-4
"21315","3679新至陞","110/07/14","合庫-自強",2,0,2
"21316","3679新至陞","110/07/14","富邦-宜蘭",0,4,-4
"21317","3679新至陞","110/07/14","高橋-內壢",2,0,2
"21318","3679新至陞","110/07/14","永豐金-苓雅",0,3,-3
"21319","3679新至陞","110/07/14","台中銀-員林",2,0,2
"21320","3679新至陞","110/07/14","摩根大通",5,7,-2
"21321","3679新至陞","110/07/14","凱基-高美館",2,0,2
"21322","3679新至陞","110/07/14","元大-板橋三民",0,2,-2
"21323","3679新至陞","110/07/14","元大-福營",2,0,2
"21324","3679新至陞","110/07/14","宏遠-中和",0,1,-1
"21325","3679新至陞","110/07/14","永豐金-松山",2,0,2
"21326","3679新至陞","110/07/14","元富-佳里",0,1,-1
"21327","3679新至陞","110/07/14","永豐金-萬盛",2,0,2
"21328","3679新至陞","110/07/14","(牛牛牛)亞-鑫豐",0,1,-1
"21329","3679新至陞","110/07/14","元富-松德",1,0,1
"21330","3679新至陞","110/07/14","中國信託-中壢",0,1,-1
"21331","2727王品","110/07/14","富邦-左營",102,1,101
"21332","2727王品","110/07/14","統一-城中",100,234,-134
"21333","2727王品","110/07/14","國泰-板橋",105,11,94
"21334","2727王品","110/07/14","富邦-台北",1,125,-124
"21335","2727王品","110/07/14","港商野村",149,72,77
"21336","2727王品","110/07/14","台灣摩根士丹利",1,48,-47
"21337","2727王品","110/07/14","合庫-台中",66,2,64
"21338","2727王品","110/07/14","國票-新莊",0,40,-40
"21339","2727王品","110/07/14","臺銀-金山",63,8,55
"21340","2727王品","110/07/14","永豐金-忠孝",2,39,-37
"21341","2727王品","110/07/14","摩根大通",83,39,44
"21342","2727王品","110/07/14","富邦-彰化",1,34,-33
"21343","2727王品","110/07/14","凱基-台北",84,42,42
"21344","2727王品","110/07/14","康和-高雄",0,30,-30
"21345","2727王品","110/07/14","土銀-台中",35,1,34
"21346","2727王品","110/07/14","安泰",0,26,-26
"21347","2727王品","110/07/14","華南永昌-麻豆",32,1,31
"21348","2727王品","110/07/14","富邦-新竹華信",0,21,-21
"21349","2727王品","110/07/14","元大證券",85,55,30
"21350","2727王品","110/07/14","元大-南崁",1,22,-21
"21351","2727王品","110/07/14","新加坡商瑞銀",40,15,25
"21352","2727王品","110/07/14","彰銀-台中",0,18,-18
"21353","2727王品","110/07/14","日盛-八德",19,0,19
"21354","2727王品","110/07/14","元富-同大",2,20,-18
"21355","2727王品","110/07/14","統一",35,17,18
"21356","2727王品","110/07/14","玉山-嘉義",1,17,-16
"21357","2727王品","110/07/14","元富-大昌",18,1,17
"21358","2727王品","110/07/14","國泰-館前",4,20,-16
"21359","2727王品","110/07/14","玉山-板橋",15,1,14
"21360","2727王品","110/07/14","第一金-嘉義",1,13,-12
"21361","1570力肯","110/07/14","國票-北高雄",68,0,68
"21362","1570力肯","110/07/14","摩根大通",0,21,-21
"21363","1570力肯","110/07/14","日盛-八德",30,1,29
"21364","1570力肯","110/07/14","新光",1,19,-18
"21365","1570力肯","110/07/14","玉山-高雄",7,0,7
"21366","1570力肯","110/07/14","(牛牛牛)亞-鑫豐",0,17,-17
"21367","1570力肯","110/07/14","臺銀-臺南",5,0,5
"21368","1570力肯","110/07/14","日盛-士林",0,10,-10
"21369","1570力肯","110/07/14","凱基-三峽",5,0,5
"21370","1570力肯","110/07/14","統一-員林",0,10,-10
"21371","1570力肯","110/07/14","元大-和平",5,0,5
"21372","1570力肯","110/07/14","國票-新莊",0,10,-10
"21373","1570力肯","110/07/14","合庫-三重",4,0,4
"21374","1570力肯","110/07/14","凱基-高美館",0,10,-10
"21375","1570力肯","110/07/14","瑞士信貸",4,0,4
"21376","1570力肯","110/07/14","元大-屏東民生",0,5,-5
"21377","1570力肯","110/07/14","統一-三多",4,0,4
"21378","1570力肯","110/07/14","元大-古亭",0,5,-5
"21379","1570力肯","110/07/14","華南永昌-古亭",4,0,4
"21380","1570力肯","110/07/14","日盛-木柵",0,4,-4
"21381","1570力肯","110/07/14","元大-高雄",3,0,3
"21382","1570力肯","110/07/14","大昌",0,4,-4
"21383","1570力肯","110/07/14","兆豐-忠孝",2,0,2
"21384","1570力肯","110/07/14","群益金鼎-東大",0,4,-4
"21385","1570力肯","110/07/14","富邦-陽明",2,0,2
"21386","1570力肯","110/07/14","凱基-台北",0,4,-4
"21387","1570力肯","110/07/14","元大-松山",2,0,2
"21388","1570力肯","110/07/14","元大-板橋",0,4,-4
"21389","1570力肯","110/07/14","元大-忠孝",2,0,2
"21390","1570力肯","110/07/14","第一金-中山",0,3,-3
"21391","6180橘子","110/07/14","新加坡商瑞銀",84,28,56
"21392","6180橘子","110/07/14","凱基-台北",4,37,-33
"21393","6180橘子","110/07/14","日盛-信義",29,1,28
"21394","6180橘子","110/07/14","玉山-台南",1,22,-21
"21395","6180橘子","110/07/14","豐農",28,4,24
"21396","6180橘子","110/07/14","日盛-新竹",1,21,-20
"21397","6180橘子","110/07/14","新光-新竹",24,1,23
"21398","6180橘子","110/07/14","元富-潮州",0,19,-19
"21399","6180橘子","110/07/14","華南永昌-高雄",20,0,20
"21400","6180橘子","110/07/14","元大-信義",0,17,-17
"21401","6180橘子","110/07/14","元大-羅東",20,0,20
"21402","6180橘子","110/07/14","台灣企銀-台中",1,16,-15
"21403","6180橘子","110/07/14","元大-台中中港",20,0,20
"21404","6180橘子","110/07/14","元大-北港",0,15,-15
"21405","6180橘子","110/07/14","富邦-嘉義",24,5,19
"21406","6180橘子","110/07/14","富邦-高雄",0,14,-14
"21407","6180橘子","110/07/14","富邦-仁愛",15,0,15
"21408","6180橘子","110/07/14","兆豐-埔墘",0,13,-13
"21409","6180橘子","110/07/14","國票-九鼎",13,0,13
"21410","6180橘子","110/07/14","第一金-中山",0,10,-10
"21411","6180橘子","110/07/14","日盛-木柵",12,0,12
"21412","6180橘子","110/07/14","元大-彰化民生",0,10,-10
"21413","6180橘子","110/07/14","元大-成功",10,0,10
"21414","6180橘子","110/07/14","福勝",1,10,-9
"21415","6180橘子","110/07/14","港商野村",10,2,8
"21416","6180橘子","110/07/14","群益金鼎-丹鳳",1,10,-9
"21417","6180橘子","110/07/14","玉山-左營",8,0,8
"21418","6180橘子","110/07/14","群益金鼎-板橋",0,8,-8
"21419","6180橘子","110/07/14","富邦-陽明",16,8,8
"21420","6180橘子","110/07/14","合庫-鳳山",0,7,-7
"21421","2390云辰","110/07/14","摩根大通",995,198,797
"21422","2390云辰","110/07/14","新加坡商瑞銀",28,399,-371
"21423","2390云辰","110/07/14","美林",383,22,361
"21424","2390云辰","110/07/14","凱基-新豐",3,198,-195
"21425","2390云辰","110/07/14","台灣摩根士丹利",684,358,326
"21426","2390云辰","110/07/14","元大-士林",1,152,-151
"21427","2390云辰","110/07/14","凱基-台北",656,402,254
"21428","2390云辰","110/07/14","元大-竹山",80,181,-101
"21429","2390云辰","110/07/14","日盛-和美",110,5,105
"21430","2390云辰","110/07/14","群益金鼎-開元",19,95,-76
"21431","2390云辰","110/07/14","元大-天母",72,0,72
"21432","2390云辰","110/07/14","新光",77,150,-73
"21433","2390云辰","110/07/14","永豐金-松山",57,0,57
"21434","2390云辰","110/07/14","元富-高雄",0,71,-71
"21435","2390云辰","110/07/14","統一-屏東",53,0,53
"21436","2390云辰","110/07/14","元大-土城學府",130,201,-71
"21437","2390云辰","110/07/14","港商野村",486,450,36
"21438","2390云辰","110/07/14","元大-善化",12,76,-64
"21439","2390云辰","110/07/14","致和-崇德",30,0,30
"21440","2390云辰","110/07/14","華南永昌-岡山",23,81,-58
"21441","2390云辰","110/07/14","富邦-台北",40,14,26
"21442","2390云辰","110/07/14","群益金鼎-大興",82,125,-43
"21443","2390云辰","110/07/14","台新-高雄",38,13,25
"21444","2390云辰","110/07/14","大慶-中壢",0,41,-41
"21445","2390云辰","110/07/14","富邦-板橋",32,7,25
"21446","2390云辰","110/07/14","玉山-板橋",6,47,-41
"21447","2390云辰","110/07/14","陽信-石牌",24,0,24
"21448","2390云辰","110/07/14","富邦-台東",2,42,-40
"21449","2390云辰","110/07/14","凱基-屏東",32,8,24
"21450","2390云辰","110/07/14","元大-新營",3,42,-39
"21451","2363矽統","110/07/14","台灣摩根士丹利",463,0,463
"21452","2363矽統","110/07/14","新加坡商瑞銀",568,1321,-753
"21453","2363矽統","110/07/14","台新證券",750,342,408
"21454","2363矽統","110/07/14","瑞士信貸",149,864,-715
"21455","2363矽統","110/07/14","玉山-台中",363,51,312
"21456","2363矽統","110/07/14","台新-屏東",115,380,-265
"21457","2363矽統","110/07/14","元大-斗六",223,25,198
"21458","2363矽統","110/07/14","永豐金證券",16,265,-249
"21459","2363矽統","110/07/14","華南永昌-朴子",208,38,170
"21460","2363矽統","110/07/14","美林",462,701,-239
"21461","2363矽統","110/07/14","元富-西松",169,12,157
"21462","2363矽統","110/07/14","宏遠-桃園",269,500,-231
"21463","2363矽統","110/07/14","永豐金-大園",146,6,140
"21464","2363矽統","110/07/14","凱基-竹北",36,254,-218
"21465","2363矽統","110/07/14","土銀-和平",134,0,134
"21466","2363矽統","110/07/14","港商法國興業",0,214,-214
"21467","2363矽統","110/07/14","富邦-新營",130,13,117
"21468","2363矽統","110/07/14","港商野村",835,1044,-209
"21469","2363矽統","110/07/14","元富-成功",118,11,107
"21470","2363矽統","110/07/14","北城證券",212,411,-199
"21471","2363矽統","110/07/14","元富-烏日",121,18,103
"21472","2363矽統","110/07/14","(牛牛牛)亞-鑫豐",51,241,-190
"21473","2363矽統","110/07/14","日盛-二林",120,18,102
"21474","2363矽統","110/07/14","國票-博愛",24,213,-189
"21475","2363矽統","110/07/14","兆豐-忠孝",98,2,96
"21476","2363矽統","110/07/14","大慶-蘆洲",134,316,-182
"21477","2363矽統","110/07/14","大慶-楊梅",92,3,89
"21478","2363矽統","110/07/14","彰銀-台中",15,193,-178
"21479","2363矽統","110/07/14","元富-三重",120,33,87
"21480","2363矽統","110/07/14","日盛-和美",18,185,-167
"21481","8112至上","110/07/14","新加坡商瑞銀",223,17,206
"21482","8112至上","110/07/14","瑞士信貸",8,170,-162
"21483","8112至上","110/07/14","摩根大通",285,129,156
"21484","8112至上","110/07/14","美林",55,202,-147
"21485","8112至上","110/07/14","花旗環球",124,0,124
"21486","8112至上","110/07/14","凱基-台北",325,436,-111
"21487","8112至上","110/07/14","兆豐-公益",117,4,113
"21488","8112至上","110/07/14","台中銀-台北",0,98,-98
"21489","8112至上","110/07/14","香港上海匯豐",111,0,111
"21490","8112至上","110/07/14","玉山-台大",17,107,-90
"21491","8112至上","110/07/14","永豐金-內湖",117,21,96
"21492","8112至上","110/07/14","康和-內湖",1,90,-89
"21493","8112至上","110/07/14","台灣摩根士丹利",108,16,92
"21494","8112至上","110/07/14","港商野村",21,84,-63
"21495","8112至上","110/07/14","元大-東蘆",77,0,77
"21496","8112至上","110/07/14","兆豐-北高雄",1,60,-59
"21497","8112至上","110/07/14","新光",108,48,60
"21498","8112至上","110/07/14","群益金鼎-海山",1,52,-51
"21499","8112至上","110/07/14","大慶-蘆洲",59,0,59
"21500","8112至上","110/07/14","群益金鼎-大安",0,50,-50
"21501","8112至上","110/07/14","華南永昌-台中",56,3,53
"21502","8112至上","110/07/14","富邦-仁愛",2,49,-47
"21503","8112至上","110/07/14","土銀-嘉義",52,2,50
"21504","8112至上","110/07/14","元大-金華",0,42,-42
"21505","8112至上","110/07/14","美商高盛",40,0,40
"21506","8112至上","110/07/14","元大-內湖",4,43,-39
"21507","8112至上","110/07/14","臺銀",63,29,34
"21508","8112至上","110/07/14","第一金-華江",2,37,-35
"21509","8112至上","110/07/14","元富-嘉義",31,0,31
"21510","8112至上","110/07/14","永豐金-苓雅",2,34,-32
"21511","1570力肯","110/07/14","國票-北高雄",68,0,68
"21512","1570力肯","110/07/14","摩根大通",0,21,-21
"21513","1570力肯","110/07/14","日盛-八德",30,1,29
"21514","1570力肯","110/07/14","新光",1,19,-18
"21515","1570力肯","110/07/14","玉山-高雄",7,0,7
"21516","1570力肯","110/07/14","(牛牛牛)亞-鑫豐",0,17,-17
"21517","1570力肯","110/07/14","臺銀-臺南",5,0,5
"21518","1570力肯","110/07/14","日盛-士林",0,10,-10
"21519","1570力肯","110/07/14","凱基-三峽",5,0,5
"21520","1570力肯","110/07/14","統一-員林",0,10,-10
"21521","1570力肯","110/07/14","元大-和平",5,0,5
"21522","1570力肯","110/07/14","國票-新莊",0,10,-10
"21523","1570力肯","110/07/14","合庫-三重",4,0,4
"21524","1570力肯","110/07/14","凱基-高美館",0,10,-10
"21525","1570力肯","110/07/14","瑞士信貸",4,0,4
"21526","1570力肯","110/07/14","元大-屏東民生",0,5,-5
"21527","1570力肯","110/07/14","統一-三多",4,0,4
"21528","1570力肯","110/07/14","元大-古亭",0,5,-5
"21529","1570力肯","110/07/14","華南永昌-古亭",4,0,4
"21530","1570力肯","110/07/14","日盛-木柵",0,4,-4
"21531","1570力肯","110/07/14","元大-高雄",3,0,3
"21532","1570力肯","110/07/14","大昌",0,4,-4
"21533","1570力肯","110/07/14","兆豐-忠孝",2,0,2
"21534","1570力肯","110/07/14","群益金鼎-東大",0,4,-4
"21535","1570力肯","110/07/14","富邦-陽明",2,0,2
"21536","1570力肯","110/07/14","凱基-台北",0,4,-4
"21537","1570力肯","110/07/14","元大-松山",2,0,2
"21538","1570力肯","110/07/14","元大-板橋",0,4,-4
"21539","1570力肯","110/07/14","元大-忠孝",2,0,2
"21540","1570力肯","110/07/14","第一金-中山",0,3,-3
"21541","2929淘帝","110/07/14","華南永昌-林口",60,0,60
"21542","2929淘帝","110/07/14","群益金鼎",25,540,-515
"21543","2929淘帝","110/07/14","美林",87,31,56
"21544","2929淘帝","110/07/14","國泰-台南",1,30,-29
"21545","2929淘帝","110/07/14","元富-台南",40,0,40
"21546","2929淘帝","110/07/14","宏遠-桃園",0,20,-20
"21547","2929淘帝","110/07/14","元大-民生",39,0,39
"21548","2929淘帝","110/07/14","摩根大通",11,31,-20
"21549","2929淘帝","110/07/14","臺銀-鳳山",34,0,34
"21550","2929淘帝","110/07/14","台新-建北",5,20,-15
"21551","2929淘帝","110/07/14","合庫-高雄",34,1,33
"21552","2929淘帝","110/07/14","新光",1,16,-15
"21553","2929淘帝","110/07/14","華南永昌-鶯歌",28,0,28
"21554","2929淘帝","110/07/14","玉山-板橋",0,15,-15
"21555","2929淘帝","110/07/14","永興",25,0,25
"21556","2929淘帝","110/07/14","凱基-羅東",0,15,-15
"21557","2929淘帝","110/07/14","元大-新盛",25,1,24
"21558","2929淘帝","110/07/14","元大-頭份",0,15,-15
"21559","2929淘帝","110/07/14","日盛-南京",23,0,23
"21560","2929淘帝","110/07/14","第一金-台南",0,13,-13
"21561","2929淘帝","110/07/14","日茂",20,0,20
"21562","2929淘帝","110/07/14","富邦-基隆",0,12,-12
"21563","2929淘帝","110/07/14","台新-台中",20,0,20
"21564","2929淘帝","110/07/14","日茂-南投",1,12,-11
"21565","2929淘帝","110/07/14","華南永昌",20,0,20
"21566","2929淘帝","110/07/14","元大-豐原站前",0,11,-11
"21567","2929淘帝","110/07/14","福勝",15,0,15
"21568","2929淘帝","110/07/14","玉山-士林",0,10,-10
"21569","2929淘帝","110/07/14","富邦-南屯",15,0,15
"21570","2929淘帝","110/07/14","富邦-台北",0,10,-10
"21571","5410國眾","110/07/14","兆豐-城中",35,0,35
"21572","5410國眾","110/07/14","瑞士信貸",0,29,-29
"21573","5410國眾","110/07/14","新光",21,1,20
"21574","5410國眾","110/07/14","國泰-板橋",1,30,-29
"21575","5410國眾","110/07/14","國泰-敦南",21,1,20
"21576","5410國眾","110/07/14","日盛-高雄",0,20,-20
"21577","5410國眾","110/07/14","國泰-台中",20,1,19
"21578","5410國眾","110/07/14","台新-左楠",1,20,-19
"21579","5410國眾","110/07/14","元大-崇德",19,0,19
"21580","5410國眾","110/07/14","元富-大昌",1,18,-17
"21581","5410國眾","110/07/14","土銀-士林",18,0,18
"21582","5410國眾","110/07/14","富邦-建國",0,15,-15
"21583","5410國眾","110/07/14","元大-新盛",20,2,18
"21584","5410國眾","110/07/14","元富-嘉義",0,12,-12
"21585","5410國眾","110/07/14","兆豐-高雄",15,0,15
"21586","5410國眾","110/07/14","永全-南崁",0,12,-12
"21587","5410國眾","110/07/14","宏遠-中和",10,0,10
"21588","5410國眾","110/07/14","元大-員林",0,11,-11
"21589","5410國眾","110/07/14","新光-桃園",10,0,10
"21590","5410國眾","110/07/14","高橋",0,10,-10
"21591","5410國眾","110/07/14","國泰-台南",10,0,10
"21592","5410國眾","110/07/14","永興",0,10,-10
"21593","5410國眾","110/07/14","元大-復北",10,0,10
"21594","5410國眾","110/07/14","華南永昌-三重",0,10,-10
"21595","5410國眾","110/07/14","元大-竹科",8,0,8
"21596","5410國眾","110/07/14","元大-苑裡",0,7,-7
"21597","5410國眾","110/07/14","台新-新營",6,0,6
"21598","5410國眾","110/07/14","港商野村",0,6,-6
"21599","5410國眾","110/07/14","日盛-士林",5,0,5
"21600","5410國眾","110/07/14","摩根大通",5,11,-6
"21601","2841台開","110/07/14","凱基-文心",73,0,73
"21602","2841台開","110/07/14","國泰-敦南",0,50,-50
"21603","2841台開","110/07/14","元富-潮州",30,0,30
"21604","2841台開","110/07/14","凱基-中壢",0,40,-40
"21605","2841台開","110/07/14","第一金-台中",20,0,20
"21606","2841台開","110/07/14","統一-新竹",0,24,-24
"21607","2841台開","110/07/14","華南永昌-新莊",20,0,20
"21608","2841台開","110/07/14","元富-草屯",0,20,-20
"21609","2841台開","110/07/14","永豐金-豐原",20,0,20
"21610","2841台開","110/07/14","台新-台南",0,20,-20
"21611","2841台開","110/07/14","國泰-館前",15,0,15
"21612","2841台開","110/07/14","永豐金-敦南",45,63,-18
"21613","2841台開","110/07/14","群益金鼎-基隆",12,0,12
"21614","2841台開","110/07/14","國票-北高雄",0,13,-13
"21615","2841台開","110/07/14","日盛-信義",10,0,10
"21616","2841台開","110/07/14","凱基-松山",0,10,-10
"21617","2841台開","110/07/14","台新-台中",10,0,10
"21618","2841台開","110/07/14","元大證券",0,10,-10
"21619","2841台開","110/07/14","新光",10,1,9
"21620","2841台開","110/07/14","元大-中壢",0,10,-10
"21621","2841台開","110/07/14","凱基-新店",8,0,8
"21622","2841台開","110/07/14","富邦-陽明",1,10,-9
"21623","2841台開","110/07/14","元大-斗信",7,0,7
"21624","2841台開","110/07/14","富邦-建國",0,9,-9
"21625","2841台開","110/07/14","元大-三重",6,0,6
"21626","2841台開","110/07/14","富邦-台南",0,8,-8
"21627","2841台開","110/07/14","永豐金-中和",6,0,6
"21628","2841台開","110/07/14","康和-澎湖",0,7,-7
"21629","2841台開","110/07/14","元富-成功",5,0,5
"21630","2841台開","110/07/14","日盛-斗六",0,6,-6
"21631","6207雷科","110/07/14","群益金鼎-台北",60,0,60
"21632","6207雷科","110/07/14","新加坡商瑞銀",10,56,-46
"21633","6207雷科","110/07/14","台新-高雄",43,3,40
"21634","6207雷科","110/07/14","國票-中和",0,41,-41
"21635","6207雷科","110/07/14","元大-高雄",19,0,19
"21636","6207雷科","110/07/14","元大-復北",0,33,-33
"21637","6207雷科","110/07/14","福勝",15,0,15
"21638","6207雷科","110/07/14","光和-和美",0,20,-20
"21639","6207雷科","110/07/14","群益金鼎-中山",15,0,15
"21640","6207雷科","110/07/14","群益金鼎-丹鳳",0,20,-20
"21641","6207雷科","110/07/14","元大-林園",15,0,15
"21642","6207雷科","110/07/14","第一金-路竹",0,10,-10
"21643","6207雷科","110/07/14","新光",12,0,12
"21644","6207雷科","110/07/14","元大-歸仁",0,10,-10
"21645","6207雷科","110/07/14","元大-大天母",10,0,10
"21646","6207雷科","110/07/14","宏遠-館前",0,9,-9
"21647","6207雷科","110/07/14","永豐金-忠孝",9,0,9
"21648","6207雷科","110/07/14","凱基-台北",12,20,-8
"21649","6207雷科","110/07/14","永豐金-新店",7,0,7
"21650","6207雷科","110/07/14","美林",0,7,-7
"21651","6207雷科","110/07/14","玉山-嘉義",6,0,6
"21652","6207雷科","110/07/14","摩根大通",16,23,-7
"21653","6207雷科","110/07/14","元大-屏東",6,0,6
"21654","6207雷科","110/07/14","凱基-高雄",1,7,-6
"21655","6207雷科","110/07/14","凱基-大安",5,0,5
"21656","6207雷科","110/07/14","台中銀-豐原",0,5,-5
"21657","6207雷科","110/07/14","富邦-台南",5,0,5
"21658","6207雷科","110/07/14","元大-新竹經國",0,5,-5
"21659","6207雷科","110/07/14","元大-成功",5,0,5
"21660","6207雷科","110/07/14","光和-田中",0,4,-4
"21661","3679新至陞","110/07/14","凱基-台北",31,6,25
"21662","3679新至陞","110/07/14","群益金鼎-東大",0,15,-15
"21663","3679新至陞","110/07/14","華南永昌-新莊",10,0,10
"21664","3679新至陞","110/07/14","瑞士信貸",0,12,-12
"21665","3679新至陞","110/07/14","新加坡商瑞銀",11,3,8
"21666","3679新至陞","110/07/14","群益金鼎-永和",0,10,-10
"21667","3679新至陞","110/07/14","美商高盛",6,0,6
"21668","3679新至陞","110/07/14","元大-成功",5,15,-10
"21669","3679新至陞","110/07/14","第一金-中壢",6,0,6
"21670","3679新至陞","110/07/14","統一-板橋",1,10,-9
"21671","3679新至陞","110/07/14","(牛牛牛)亞-網路",4,0,4
"21672","3679新至陞","110/07/14","玉山-左營",0,5,-5
"21673","3679新至陞","110/07/14","元大-六合",3,0,3
"21674","3679新至陞","110/07/14","群益金鼎-三民",0,4,-4
"21675","3679新至陞","110/07/14","合庫-自強",2,0,2
"21676","3679新至陞","110/07/14","富邦-宜蘭",0,4,-4
"21677","3679新至陞","110/07/14","高橋-內壢",2,0,2
"21678","3679新至陞","110/07/14","永豐金-苓雅",0,3,-3
"21679","3679新至陞","110/07/14","台中銀-員林",2,0,2
"21680","3679新至陞","110/07/14","摩根大通",5,7,-2
"21681","3679新至陞","110/07/14","凱基-高美館",2,0,2
"21682","3679新至陞","110/07/14","元大-板橋三民",0,2,-2
"21683","3679新至陞","110/07/14","元大-福營",2,0,2
"21684","3679新至陞","110/07/14","宏遠-中和",0,1,-1
"21685","3679新至陞","110/07/14","永豐金-松山",2,0,2
"21686","3679新至陞","110/07/14","元富-佳里",0,1,-1
"21687","3679新至陞","110/07/14","永豐金-萬盛",2,0,2
"21688","3679新至陞","110/07/14","(牛牛牛)亞-鑫豐",0,1,-1
"21689","3679新至陞","110/07/14","元富-松德",1,0,1
"21690","3679新至陞","110/07/14","中國信託-中壢",0,1,-1
"21691","2727王品","110/07/14","富邦-左營",102,1,101
"21692","2727王品","110/07/14","統一-城中",100,234,-134
"21693","2727王品","110/07/14","國泰-板橋",105,11,94
"21694","2727王品","110/07/14","富邦-台北",1,125,-124
"21695","2727王品","110/07/14","港商野村",149,72,77
"21696","2727王品","110/07/14","台灣摩根士丹利",1,48,-47
"21697","2727王品","110/07/14","合庫-台中",66,2,64
"21698","2727王品","110/07/14","國票-新莊",0,40,-40
"21699","2727王品","110/07/14","臺銀-金山",63,8,55
"21700","2727王品","110/07/14","永豐金-忠孝",2,39,-37
"21701","2727王品","110/07/14","摩根大通",83,39,44
"21702","2727王品","110/07/14","富邦-彰化",1,34,-33
"21703","2727王品","110/07/14","凱基-台北",84,42,42
"21704","2727王品","110/07/14","康和-高雄",0,30,-30
"21705","2727王品","110/07/14","土銀-台中",35,1,34
"21706","2727王品","110/07/14","安泰",0,26,-26
"21707","2727王品","110/07/14","華南永昌-麻豆",32,1,31
"21708","2727王品","110/07/14","富邦-新竹華信",0,21,-21
"21709","2727王品","110/07/14","元大證券",85,55,30
"21710","2727王品","110/07/14","元大-南崁",1,22,-21
"21711","2727王品","110/07/14","新加坡商瑞銀",40,15,25
"21712","2727王品","110/07/14","彰銀-台中",0,18,-18
"21713","2727王品","110/07/14","日盛-八德",19,0,19
"21714","2727王品","110/07/14","元富-同大",2,20,-18
"21715","2727王品","110/07/14","統一",35,17,18
"21716","2727王品","110/07/14","玉山-嘉義",1,17,-16
"21717","2727王品","110/07/14","元富-大昌",18,1,17
"21718","2727王品","110/07/14","國泰-館前",4,20,-16
"21719","2727王品","110/07/14","玉山-板橋",15,1,14
"21720","2727王品","110/07/14","第一金-嘉義",1,13,-12
"21721","1570力肯","110/07/14","國票-北高雄",68,0,68
"21722","1570力肯","110/07/14","摩根大通",0,21,-21
"21723","1570力肯","110/07/14","日盛-八德",30,1,29
"21724","1570力肯","110/07/14","新光",1,19,-18
"21725","1570力肯","110/07/14","玉山-高雄",7,0,7
"21726","1570力肯","110/07/14","(牛牛牛)亞-鑫豐",0,17,-17
"21727","1570力肯","110/07/14","臺銀-臺南",5,0,5
"21728","1570力肯","110/07/14","日盛-士林",0,10,-10
"21729","1570力肯","110/07/14","凱基-三峽",5,0,5
"21730","1570力肯","110/07/14","統一-員林",0,10,-10
"21731","1570力肯","110/07/14","元大-和平",5,0,5
"21732","1570力肯","110/07/14","國票-新莊",0,10,-10
"21733","1570力肯","110/07/14","合庫-三重",4,0,4
"21734","1570力肯","110/07/14","凱基-高美館",0,10,-10
"21735","1570力肯","110/07/14","瑞士信貸",4,0,4
"21736","1570力肯","110/07/14","元大-屏東民生",0,5,-5
"21737","1570力肯","110/07/14","統一-三多",4,0,4
"21738","1570力肯","110/07/14","元大-古亭",0,5,-5
"21739","1570力肯","110/07/14","華南永昌-古亭",4,0,4
"21740","1570力肯","110/07/14","日盛-木柵",0,4,-4
"21741","1570力肯","110/07/14","元大-高雄",3,0,3
"21742","1570力肯","110/07/14","大昌",0,4,-4
"21743","1570力肯","110/07/14","兆豐-忠孝",2,0,2
"21744","1570力肯","110/07/14","群益金鼎-東大",0,4,-4
"21745","1570力肯","110/07/14","富邦-陽明",2,0,2
"21746","1570力肯","110/07/14","凱基-台北",0,4,-4
"21747","1570力肯","110/07/14","元大-松山",2,0,2
"21748","1570力肯","110/07/14","元大-板橋",0,4,-4
"21749","1570力肯","110/07/14","元大-忠孝",2,0,2
"21750","1570力肯","110/07/14","第一金-中山",0,3,-3
"21751","6180橘子","110/07/14","新加坡商瑞銀",84,28,56
"21752","6180橘子","110/07/14","凱基-台北",4,37,-33
"21753","6180橘子","110/07/14","日盛-信義",29,1,28
"21754","6180橘子","110/07/14","玉山-台南",1,22,-21
"21755","6180橘子","110/07/14","豐農",28,4,24
"21756","6180橘子","110/07/14","日盛-新竹",1,21,-20
"21757","6180橘子","110/07/14","新光-新竹",24,1,23
"21758","6180橘子","110/07/14","元富-潮州",0,19,-19
"21759","6180橘子","110/07/14","華南永昌-高雄",20,0,20
"21760","6180橘子","110/07/14","元大-信義",0,17,-17
"21761","6180橘子","110/07/14","元大-羅東",20,0,20
"21762","6180橘子","110/07/14","台灣企銀-台中",1,16,-15
"21763","6180橘子","110/07/14","元大-台中中港",20,0,20
"21764","6180橘子","110/07/14","元大-北港",0,15,-15
"21765","6180橘子","110/07/14","富邦-嘉義",24,5,19
"21766","6180橘子","110/07/14","富邦-高雄",0,14,-14
"21767","6180橘子","110/07/14","富邦-仁愛",15,0,15
"21768","6180橘子","110/07/14","兆豐-埔墘",0,13,-13
"21769","6180橘子","110/07/14","國票-九鼎",13,0,13
"21770","6180橘子","110/07/14","第一金-中山",0,10,-10
"21771","6180橘子","110/07/14","日盛-木柵",12,0,12
"21772","6180橘子","110/07/14","元大-彰化民生",0,10,-10
"21773","6180橘子","110/07/14","元大-成功",10,0,10
"21774","6180橘子","110/07/14","福勝",1,10,-9
"21775","6180橘子","110/07/14","港商野村",10,2,8
"21776","6180橘子","110/07/14","群益金鼎-丹鳳",1,10,-9
"21777","6180橘子","110/07/14","玉山-左營",8,0,8
"21778","6180橘子","110/07/14","群益金鼎-板橋",0,8,-8
"21779","6180橘子","110/07/14","富邦-陽明",16,8,8
"21780","6180橘子","110/07/14","合庫-鳳山",0,7,-7
"21781","2390云辰","110/07/14","摩根大通",995,198,797
"21782","2390云辰","110/07/14","新加坡商瑞銀",28,399,-371
"21783","2390云辰","110/07/14","美林",383,22,361
"21784","2390云辰","110/07/14","凱基-新豐",3,198,-195
"21785","2390云辰","110/07/14","台灣摩根士丹利",684,358,326
"21786","2390云辰","110/07/14","元大-士林",1,152,-151
"21787","2390云辰","110/07/14","凱基-台北",656,402,254
"21788","2390云辰","110/07/14","元大-竹山",80,181,-101
"21789","2390云辰","110/07/14","日盛-和美",110,5,105
"21790","2390云辰","110/07/14","群益金鼎-開元",19,95,-76
"21791","2390云辰","110/07/14","元大-天母",72,0,72
"21792","2390云辰","110/07/14","新光",77,150,-73
"21793","2390云辰","110/07/14","永豐金-松山",57,0,57
"21794","2390云辰","110/07/14","元富-高雄",0,71,-71
"21795","2390云辰","110/07/14","統一-屏東",53,0,53
"21796","2390云辰","110/07/14","元大-土城學府",130,201,-71
"21797","2390云辰","110/07/14","港商野村",486,450,36
"21798","2390云辰","110/07/14","元大-善化",12,76,-64
"21799","2390云辰","110/07/14","致和-崇德",30,0,30
"21800","2390云辰","110/07/14","華南永昌-岡山",23,81,-58
"21801","2390云辰","110/07/14","富邦-台北",40,14,26
"21802","2390云辰","110/07/14","群益金鼎-大興",82,125,-43
"21803","2390云辰","110/07/14","台新-高雄",38,13,25
"21804","2390云辰","110/07/14","大慶-中壢",0,41,-41
"21805","2390云辰","110/07/14","富邦-板橋",32,7,25
"21806","2390云辰","110/07/14","玉山-板橋",6,47,-41
"21807","2390云辰","110/07/14","陽信-石牌",24,0,24
"21808","2390云辰","110/07/14","富邦-台東",2,42,-40
"21809","2390云辰","110/07/14","凱基-屏東",32,8,24
"21810","2390云辰","110/07/14","元大-新營",3,42,-39
"21811","2363矽統","110/07/14","台灣摩根士丹利",463,0,463
"21812","2363矽統","110/07/14","新加坡商瑞銀",568,1321,-753
"21813","2363矽統","110/07/14","台新證券",750,342,408
"21814","2363矽統","110/07/14","瑞士信貸",149,864,-715
"21815","2363矽統","110/07/14","玉山-台中",363,51,312
"21816","2363矽統","110/07/14","台新-屏東",115,380,-265
"21817","2363矽統","110/07/14","元大-斗六",223,25,198
"21818","2363矽統","110/07/14","永豐金證券",16,265,-249
"21819","2363矽統","110/07/14","華南永昌-朴子",208,38,170
"21820","2363矽統","110/07/14","美林",462,701,-239
"21821","2363矽統","110/07/14","元富-西松",169,12,157
"21822","2363矽統","110/07/14","宏遠-桃園",269,500,-231
"21823","2363矽統","110/07/14","永豐金-大園",146,6,140
"21824","2363矽統","110/07/14","凱基-竹北",36,254,-218
"21825","2363矽統","110/07/14","土銀-和平",134,0,134
"21826","2363矽統","110/07/14","港商法國興業",0,214,-214
"21827","2363矽統","110/07/14","富邦-新營",130,13,117
"21828","2363矽統","110/07/14","港商野村",835,1044,-209
"21829","2363矽統","110/07/14","元富-成功",118,11,107
"21830","2363矽統","110/07/14","北城證券",212,411,-199
"21831","2363矽統","110/07/14","元富-烏日",121,18,103
"21832","2363矽統","110/07/14","(牛牛牛)亞-鑫豐",51,241,-190
"21833","2363矽統","110/07/14","日盛-二林",120,18,102
"21834","2363矽統","110/07/14","國票-博愛",24,213,-189
"21835","2363矽統","110/07/14","兆豐-忠孝",98,2,96
"21836","2363矽統","110/07/14","大慶-蘆洲",134,316,-182
"21837","2363矽統","110/07/14","大慶-楊梅",92,3,89
"21838","2363矽統","110/07/14","彰銀-台中",15,193,-178
"21839","2363矽統","110/07/14","元富-三重",120,33,87
"21840","2363矽統","110/07/14","日盛-和美",18,185,-167
"21841","8112至上","110/07/14","新加坡商瑞銀",223,17,206
"21842","8112至上","110/07/14","瑞士信貸",8,170,-162
"21843","8112至上","110/07/14","摩根大通",285,129,156
"21844","8112至上","110/07/14","美林",55,202,-147
"21845","8112至上","110/07/14","花旗環球",124,0,124
"21846","8112至上","110/07/14","凱基-台北",325,436,-111
"21847","8112至上","110/07/14","兆豐-公益",117,4,113
"21848","8112至上","110/07/14","台中銀-台北",0,98,-98
"21849","8112至上","110/07/14","香港上海匯豐",111,0,111
"21850","8112至上","110/07/14","玉山-台大",17,107,-90
"21851","8112至上","110/07/14","永豐金-內湖",117,21,96
"21852","8112至上","110/07/14","康和-內湖",1,90,-89
"21853","8112至上","110/07/14","台灣摩根士丹利",108,16,92
"21854","8112至上","110/07/14","港商野村",21,84,-63
"21855","8112至上","110/07/14","元大-東蘆",77,0,77
"21856","8112至上","110/07/14","兆豐-北高雄",1,60,-59
"21857","8112至上","110/07/14","新光",108,48,60
"21858","8112至上","110/07/14","群益金鼎-海山",1,52,-51
"21859","8112至上","110/07/14","大慶-蘆洲",59,0,59
"21860","8112至上","110/07/14","群益金鼎-大安",0,50,-50
"21861","8112至上","110/07/14","華南永昌-台中",56,3,53
"21862","8112至上","110/07/14","富邦-仁愛",2,49,-47
"21863","8112至上","110/07/14","土銀-嘉義",52,2,50
"21864","8112至上","110/07/14","元大-金華",0,42,-42
"21865","8112至上","110/07/14","美商高盛",40,0,40
"21866","8112至上","110/07/14","元大-內湖",4,43,-39
"21867","8112至上","110/07/14","臺銀",63,29,34
"21868","8112至上","110/07/14","第一金-華江",2,37,-35
"21869","8112至上","110/07/14","元富-嘉義",31,0,31
"21870","8112至上","110/07/14","永豐金-苓雅",2,34,-32
"21871","1570力肯","110/07/14","國票-北高雄",68,0,68
"21872","1570力肯","110/07/14","摩根大通",0,21,-21
"21873","1570力肯","110/07/14","日盛-八德",30,1,29
"21874","1570力肯","110/07/14","新光",1,19,-18
"21875","1570力肯","110/07/14","玉山-高雄",7,0,7
"21876","1570力肯","110/07/14","(牛牛牛)亞-鑫豐",0,17,-17
"21877","1570力肯","110/07/14","臺銀-臺南",5,0,5
"21878","1570力肯","110/07/14","日盛-士林",0,10,-10
"21879","1570力肯","110/07/14","凱基-三峽",5,0,5
"21880","1570力肯","110/07/14","統一-員林",0,10,-10
"21881","1570力肯","110/07/14","元大-和平",5,0,5
"21882","1570力肯","110/07/14","國票-新莊",0,10,-10
"21883","1570力肯","110/07/14","合庫-三重",4,0,4
"21884","1570力肯","110/07/14","凱基-高美館",0,10,-10
"21885","1570力肯","110/07/14","瑞士信貸",4,0,4
"21886","1570力肯","110/07/14","元大-屏東民生",0,5,-5
"21887","1570力肯","110/07/14","統一-三多",4,0,4
"21888","1570力肯","110/07/14","元大-古亭",0,5,-5
"21889","1570力肯","110/07/14","華南永昌-古亭",4,0,4
"21890","1570力肯","110/07/14","日盛-木柵",0,4,-4
"21891","1570力肯","110/07/14","元大-高雄",3,0,3
"21892","1570力肯","110/07/14","大昌",0,4,-4
"21893","1570力肯","110/07/14","兆豐-忠孝",2,0,2
"21894","1570力肯","110/07/14","群益金鼎-東大",0,4,-4
"21895","1570力肯","110/07/14","富邦-陽明",2,0,2
"21896","1570力肯","110/07/14","凱基-台北",0,4,-4
"21897","1570力肯","110/07/14","元大-松山",2,0,2
"21898","1570力肯","110/07/14","元大-板橋",0,4,-4
"21899","1570力肯","110/07/14","元大-忠孝",2,0,2
"21900","1570力肯","110/07/14","第一金-中山",0,3,-3
"21901","2929淘帝","110/07/14","華南永昌-林口",60,0,60
"21902","2929淘帝","110/07/14","群益金鼎",25,540,-515
"21903","2929淘帝","110/07/14","美林",87,31,56
"21904","2929淘帝","110/07/14","國泰-台南",1,30,-29
"21905","2929淘帝","110/07/14","元富-台南",40,0,40
"21906","2929淘帝","110/07/14","宏遠-桃園",0,20,-20
"21907","2929淘帝","110/07/14","元大-民生",39,0,39
"21908","2929淘帝","110/07/14","摩根大通",11,31,-20
"21909","2929淘帝","110/07/14","臺銀-鳳山",34,0,34
"21910","2929淘帝","110/07/14","台新-建北",5,20,-15
"21911","2929淘帝","110/07/14","合庫-高雄",34,1,33
"21912","2929淘帝","110/07/14","新光",1,16,-15
"21913","2929淘帝","110/07/14","華南永昌-鶯歌",28,0,28
"21914","2929淘帝","110/07/14","玉山-板橋",0,15,-15
"21915","2929淘帝","110/07/14","永興",25,0,25
"21916","2929淘帝","110/07/14","凱基-羅東",0,15,-15
"21917","2929淘帝","110/07/14","元大-新盛",25,1,24
"21918","2929淘帝","110/07/14","元大-頭份",0,15,-15
"21919","2929淘帝","110/07/14","日盛-南京",23,0,23
"21920","2929淘帝","110/07/14","第一金-台南",0,13,-13
"21921","2929淘帝","110/07/14","日茂",20,0,20
"21922","2929淘帝","110/07/14","富邦-基隆",0,12,-12
"21923","2929淘帝","110/07/14","台新-台中",20,0,20
"21924","2929淘帝","110/07/14","日茂-南投",1,12,-11
"21925","2929淘帝","110/07/14","華南永昌",20,0,20
"21926","2929淘帝","110/07/14","元大-豐原站前",0,11,-11
"21927","2929淘帝","110/07/14","福勝",15,0,15
"21928","2929淘帝","110/07/14","玉山-士林",0,10,-10
"21929","2929淘帝","110/07/14","富邦-南屯",15,0,15
"21930","2929淘帝","110/07/14","富邦-台北",0,10,-10
"21931","5410國眾","110/07/14","兆豐-城中",35,0,35
"21932","5410國眾","110/07/14","瑞士信貸",0,29,-29
"21933","5410國眾","110/07/14","新光",21,1,20
"21934","5410國眾","110/07/14","國泰-板橋",1,30,-29
"21935","5410國眾","110/07/14","國泰-敦南",21,1,20
"21936","5410國眾","110/07/14","日盛-高雄",0,20,-20
"21937","5410國眾","110/07/14","國泰-台中",20,1,19
"21938","5410國眾","110/07/14","台新-左楠",1,20,-19
"21939","5410國眾","110/07/14","元大-崇德",19,0,19
"21940","5410國眾","110/07/14","元富-大昌",1,18,-17
"21941","5410國眾","110/07/14","土銀-士林",18,0,18
"21942","5410國眾","110/07/14","富邦-建國",0,15,-15
"21943","5410國眾","110/07/14","元大-新盛",20,2,18
"21944","5410國眾","110/07/14","元富-嘉義",0,12,-12
"21945","5410國眾","110/07/14","兆豐-高雄",15,0,15
"21946","5410國眾","110/07/14","永全-南崁",0,12,-12
"21947","5410國眾","110/07/14","宏遠-中和",10,0,10
"21948","5410國眾","110/07/14","元大-員林",0,11,-11
"21949","5410國眾","110/07/14","新光-桃園",10,0,10
"21950","5410國眾","110/07/14","高橋",0,10,-10
"21951","5410國眾","110/07/14","國泰-台南",10,0,10
"21952","5410國眾","110/07/14","永興",0,10,-10
"21953","5410國眾","110/07/14","元大-復北",10,0,10
"21954","5410國眾","110/07/14","華南永昌-三重",0,10,-10
"21955","5410國眾","110/07/14","元大-竹科",8,0,8
"21956","5410國眾","110/07/14","元大-苑裡",0,7,-7
"21957","5410國眾","110/07/14","台新-新營",6,0,6
"21958","5410國眾","110/07/14","港商野村",0,6,-6
"21959","5410國眾","110/07/14","日盛-士林",5,0,5
"21960","5410國眾","110/07/14","摩根大通",5,11,-6
"21961","2841台開","110/07/14","凱基-文心",73,0,73
"21962","2841台開","110/07/14","國泰-敦南",0,50,-50
"21963","2841台開","110/07/14","元富-潮州",30,0,30
"21964","2841台開","110/07/14","凱基-中壢",0,40,-40
"21965","2841台開","110/07/14","第一金-台中",20,0,20
"21966","2841台開","110/07/14","統一-新竹",0,24,-24
"21967","2841台開","110/07/14","華南永昌-新莊",20,0,20
"21968","2841台開","110/07/14","元富-草屯",0,20,-20
"21969","2841台開","110/07/14","永豐金-豐原",20,0,20
"21970","2841台開","110/07/14","台新-台南",0,20,-20
"21971","2841台開","110/07/14","國泰-館前",15,0,15
"21972","2841台開","110/07/14","永豐金-敦南",45,63,-18
"21973","2841台開","110/07/14","群益金鼎-基隆",12,0,12
"21974","2841台開","110/07/14","國票-北高雄",0,13,-13
"21975","2841台開","110/07/14","日盛-信義",10,0,10
"21976","2841台開","110/07/14","凱基-松山",0,10,-10
"21977","2841台開","110/07/14","台新-台中",10,0,10
"21978","2841台開","110/07/14","元大證券",0,10,-10
"21979","2841台開","110/07/14","新光",10,1,9
"21980","2841台開","110/07/14","元大-中壢",0,10,-10
"21981","2841台開","110/07/14","凱基-新店",8,0,8
"21982","2841台開","110/07/14","富邦-陽明",1,10,-9
"21983","2841台開","110/07/14","元大-斗信",7,0,7
"21984","2841台開","110/07/14","富邦-建國",0,9,-9
"21985","2841台開","110/07/14","元大-三重",6,0,6
"21986","2841台開","110/07/14","富邦-台南",0,8,-8
"21987","2841台開","110/07/14","永豐金-中和",6,0,6
"21988","2841台開","110/07/14","康和-澎湖",0,7,-7
"21989","2841台開","110/07/14","元富-成功",5,0,5
"21990","2841台開","110/07/14","日盛-斗六",0,6,-6
"21991","6207雷科","110/07/14","群益金鼎-台北",60,0,60
"21992","6207雷科","110/07/14","新加坡商瑞銀",10,56,-46
"21993","6207雷科","110/07/14","台新-高雄",43,3,40
"21994","6207雷科","110/07/14","國票-中和",0,41,-41
"21995","6207雷科","110/07/14","元大-高雄",19,0,19
"21996","6207雷科","110/07/14","元大-復北",0,33,-33
"21997","6207雷科","110/07/14","福勝",15,0,15
"21998","6207雷科","110/07/14","光和-和美",0,20,-20
"21999","6207雷科","110/07/14","群益金鼎-中山",15,0,15
"22000","6207雷科","110/07/14","群益金鼎-丹鳳",0,20,-20
"22001","6207雷科","110/07/14","元大-林園",15,0,15
"22002","6207雷科","110/07/14","第一金-路竹",0,10,-10
"22003","6207雷科","110/07/14","新光",12,0,12
"22004","6207雷科","110/07/14","元大-歸仁",0,10,-10
"22005","6207雷科","110/07/14","元大-大天母",10,0,10
"22006","6207雷科","110/07/14","宏遠-館前",0,9,-9
"22007","6207雷科","110/07/14","永豐金-忠孝",9,0,9
"22008","6207雷科","110/07/14","凱基-台北",12,20,-8
"22009","6207雷科","110/07/14","永豐金-新店",7,0,7
"22010","6207雷科","110/07/14","美林",0,7,-7
"22011","6207雷科","110/07/14","玉山-嘉義",6,0,6
"22012","6207雷科","110/07/14","摩根大通",16,23,-7
"22013","6207雷科","110/07/14","元大-屏東",6,0,6
"22014","6207雷科","110/07/14","凱基-高雄",1,7,-6
"22015","6207雷科","110/07/14","凱基-大安",5,0,5
"22016","6207雷科","110/07/14","台中銀-豐原",0,5,-5
"22017","6207雷科","110/07/14","富邦-台南",5,0,5
"22018","6207雷科","110/07/14","元大-新竹經國",0,5,-5
"22019","6207雷科","110/07/14","元大-成功",5,0,5
"22020","6207雷科","110/07/14","光和-田中",0,4,-4
"22021","3679新至陞","110/07/14","凱基-台北",31,6,25
"22022","3679新至陞","110/07/14","群益金鼎-東大",0,15,-15
"22023","3679新至陞","110/07/14","華南永昌-新莊",10,0,10
"22024","3679新至陞","110/07/14","瑞士信貸",0,12,-12
"22025","3679新至陞","110/07/14","新加坡商瑞銀",11,3,8
"22026","3679新至陞","110/07/14","群益金鼎-永和",0,10,-10
"22027","3679新至陞","110/07/14","美商高盛",6,0,6
"22028","3679新至陞","110/07/14","元大-成功",5,15,-10
"22029","3679新至陞","110/07/14","第一金-中壢",6,0,6
"22030","3679新至陞","110/07/14","統一-板橋",1,10,-9
"22031","3679新至陞","110/07/14","(牛牛牛)亞-網路",4,0,4
"22032","3679新至陞","110/07/14","玉山-左營",0,5,-5
"22033","3679新至陞","110/07/14","元大-六合",3,0,3
"22034","3679新至陞","110/07/14","群益金鼎-三民",0,4,-4
"22035","3679新至陞","110/07/14","合庫-自強",2,0,2
"22036","3679新至陞","110/07/14","富邦-宜蘭",0,4,-4
"22037","3679新至陞","110/07/14","高橋-內壢",2,0,2
"22038","3679新至陞","110/07/14","永豐金-苓雅",0,3,-3
"22039","3679新至陞","110/07/14","台中銀-員林",2,0,2
"22040","3679新至陞","110/07/14","摩根大通",5,7,-2
"22041","3679新至陞","110/07/14","凱基-高美館",2,0,2
"22042","3679新至陞","110/07/14","元大-板橋三民",0,2,-2
"22043","3679新至陞","110/07/14","元大-福營",2,0,2
"22044","3679新至陞","110/07/14","宏遠-中和",0,1,-1
"22045","3679新至陞","110/07/14","永豐金-松山",2,0,2
"22046","3679新至陞","110/07/14","元富-佳里",0,1,-1
"22047","3679新至陞","110/07/14","永豐金-萬盛",2,0,2
"22048","3679新至陞","110/07/14","(牛牛牛)亞-鑫豐",0,1,-1
"22049","3679新至陞","110/07/14","元富-松德",1,0,1
"22050","3679新至陞","110/07/14","中國信託-中壢",0,1,-1
"22051","2727王品","110/07/14","富邦-左營",102,1,101
"22052","2727王品","110/07/14","統一-城中",100,234,-134
"22053","2727王品","110/07/14","國泰-板橋",105,11,94
"22054","2727王品","110/07/14","富邦-台北",1,125,-124
"22055","2727王品","110/07/14","港商野村",149,72,77
"22056","2727王品","110/07/14","台灣摩根士丹利",1,48,-47
"22057","2727王品","110/07/14","合庫-台中",66,2,64
"22058","2727王品","110/07/14","國票-新莊",0,40,-40
"22059","2727王品","110/07/14","臺銀-金山",63,8,55
"22060","2727王品","110/07/14","永豐金-忠孝",2,39,-37
"22061","2727王品","110/07/14","摩根大通",83,39,44
"22062","2727王品","110/07/14","富邦-彰化",1,34,-33
"22063","2727王品","110/07/14","凱基-台北",84,42,42
"22064","2727王品","110/07/14","康和-高雄",0,30,-30
"22065","2727王品","110/07/14","土銀-台中",35,1,34
"22066","2727王品","110/07/14","安泰",0,26,-26
"22067","2727王品","110/07/14","華南永昌-麻豆",32,1,31
"22068","2727王品","110/07/14","富邦-新竹華信",0,21,-21
"22069","2727王品","110/07/14","元大證券",85,55,30
"22070","2727王品","110/07/14","元大-南崁",1,22,-21
"22071","2727王品","110/07/14","新加坡商瑞銀",40,15,25
"22072","2727王品","110/07/14","彰銀-台中",0,18,-18
"22073","2727王品","110/07/14","日盛-八德",19,0,19
"22074","2727王品","110/07/14","元富-同大",2,20,-18
"22075","2727王品","110/07/14","統一",35,17,18
"22076","2727王品","110/07/14","玉山-嘉義",1,17,-16
"22077","2727王品","110/07/14","元富-大昌",18,1,17
"22078","2727王品","110/07/14","國泰-館前",4,20,-16
"22079","2727王品","110/07/14","玉山-板橋",15,1,14
"22080","2727王品","110/07/14","第一金-嘉義",1,13,-12
"22081","1570力肯","110/07/14","國票-北高雄",68,0,68
"22082","1570力肯","110/07/14","摩根大通",0,21,-21
"22083","1570力肯","110/07/14","日盛-八德",30,1,29
"22084","1570力肯","110/07/14","新光",1,19,-18
"22085","1570力肯","110/07/14","玉山-高雄",7,0,7
"22086","1570力肯","110/07/14","(牛牛牛)亞-鑫豐",0,17,-17
"22087","1570力肯","110/07/14","臺銀-臺南",5,0,5
"22088","1570力肯","110/07/14","日盛-士林",0,10,-10
"22089","1570力肯","110/07/14","凱基-三峽",5,0,5
"22090","1570力肯","110/07/14","統一-員林",0,10,-10
"22091","1570力肯","110/07/14","元大-和平",5,0,5
"22092","1570力肯","110/07/14","國票-新莊",0,10,-10
"22093","1570力肯","110/07/14","合庫-三重",4,0,4
"22094","1570力肯","110/07/14","凱基-高美館",0,10,-10
"22095","1570力肯","110/07/14","瑞士信貸",4,0,4
"22096","1570力肯","110/07/14","元大-屏東民生",0,5,-5
"22097","1570力肯","110/07/14","統一-三多",4,0,4
"22098","1570力肯","110/07/14","元大-古亭",0,5,-5
"22099","1570力肯","110/07/14","華南永昌-古亭",4,0,4
"22100","1570力肯","110/07/14","日盛-木柵",0,4,-4
"22101","1570力肯","110/07/14","元大-高雄",3,0,3
"22102","1570力肯","110/07/14","大昌",0,4,-4
"22103","1570力肯","110/07/14","兆豐-忠孝",2,0,2
"22104","1570力肯","110/07/14","群益金鼎-東大",0,4,-4
"22105","1570力肯","110/07/14","富邦-陽明",2,0,2
"22106","1570力肯","110/07/14","凱基-台北",0,4,-4
"22107","1570力肯","110/07/14","元大-松山",2,0,2
"22108","1570力肯","110/07/14","元大-板橋",0,4,-4
"22109","1570力肯","110/07/14","元大-忠孝",2,0,2
"22110","1570力肯","110/07/14","第一金-中山",0,3,-3
"22111","6180橘子","110/07/14","新加坡商瑞銀",84,28,56
"22112","6180橘子","110/07/14","凱基-台北",4,37,-33
"22113","6180橘子","110/07/14","日盛-信義",29,1,28
"22114","6180橘子","110/07/14","玉山-台南",1,22,-21
"22115","6180橘子","110/07/14","豐農",28,4,24
"22116","6180橘子","110/07/14","日盛-新竹",1,21,-20
"22117","6180橘子","110/07/14","新光-新竹",24,1,23
"22118","6180橘子","110/07/14","元富-潮州",0,19,-19
"22119","6180橘子","110/07/14","華南永昌-高雄",20,0,20
"22120","6180橘子","110/07/14","元大-信義",0,17,-17
"22121","6180橘子","110/07/14","元大-羅東",20,0,20
"22122","6180橘子","110/07/14","台灣企銀-台中",1,16,-15
"22123","6180橘子","110/07/14","元大-台中中港",20,0,20
"22124","6180橘子","110/07/14","元大-北港",0,15,-15
"22125","6180橘子","110/07/14","富邦-嘉義",24,5,19
"22126","6180橘子","110/07/14","富邦-高雄",0,14,-14
"22127","6180橘子","110/07/14","富邦-仁愛",15,0,15
"22128","6180橘子","110/07/14","兆豐-埔墘",0,13,-13
"22129","6180橘子","110/07/14","國票-九鼎",13,0,13
"22130","6180橘子","110/07/14","第一金-中山",0,10,-10
"22131","6180橘子","110/07/14","日盛-木柵",12,0,12
"22132","6180橘子","110/07/14","元大-彰化民生",0,10,-10
"22133","6180橘子","110/07/14","元大-成功",10,0,10
"22134","6180橘子","110/07/14","福勝",1,10,-9
"22135","6180橘子","110/07/14","港商野村",10,2,8
"22136","6180橘子","110/07/14","群益金鼎-丹鳳",1,10,-9
"22137","6180橘子","110/07/14","玉山-左營",8,0,8
"22138","6180橘子","110/07/14","群益金鼎-板橋",0,8,-8
"22139","6180橘子","110/07/14","富邦-陽明",16,8,8
"22140","6180橘子","110/07/14","合庫-鳳山",0,7,-7
"22141","2390云辰","110/07/14","摩根大通",995,198,797
"22142","2390云辰","110/07/14","新加坡商瑞銀",28,399,-371
"22143","2390云辰","110/07/14","美林",383,22,361
"22144","2390云辰","110/07/14","凱基-新豐",3,198,-195
"22145","2390云辰","110/07/14","台灣摩根士丹利",684,358,326
"22146","2390云辰","110/07/14","元大-士林",1,152,-151
"22147","2390云辰","110/07/14","凱基-台北",656,402,254
"22148","2390云辰","110/07/14","元大-竹山",80,181,-101
"22149","2390云辰","110/07/14","日盛-和美",110,5,105
"22150","2390云辰","110/07/14","群益金鼎-開元",19,95,-76
"22151","2390云辰","110/07/14","元大-天母",72,0,72
"22152","2390云辰","110/07/14","新光",77,150,-73
"22153","2390云辰","110/07/14","永豐金-松山",57,0,57
"22154","2390云辰","110/07/14","元富-高雄",0,71,-71
"22155","2390云辰","110/07/14","統一-屏東",53,0,53
"22156","2390云辰","110/07/14","元大-土城學府",130,201,-71
"22157","2390云辰","110/07/14","港商野村",486,450,36
"22158","2390云辰","110/07/14","元大-善化",12,76,-64
"22159","2390云辰","110/07/14","致和-崇德",30,0,30
"22160","2390云辰","110/07/14","華南永昌-岡山",23,81,-58
"22161","2390云辰","110/07/14","富邦-台北",40,14,26
"22162","2390云辰","110/07/14","群益金鼎-大興",82,125,-43
"22163","2390云辰","110/07/14","台新-高雄",38,13,25
"22164","2390云辰","110/07/14","大慶-中壢",0,41,-41
"22165","2390云辰","110/07/14","富邦-板橋",32,7,25
"22166","2390云辰","110/07/14","玉山-板橋",6,47,-41
"22167","2390云辰","110/07/14","陽信-石牌",24,0,24
"22168","2390云辰","110/07/14","富邦-台東",2,42,-40
"22169","2390云辰","110/07/14","凱基-屏東",32,8,24
"22170","2390云辰","110/07/14","元大-新營",3,42,-39
"22171","2363矽統","110/07/14","台灣摩根士丹利",463,0,463
"22172","2363矽統","110/07/14","新加坡商瑞銀",568,1321,-753
"22173","2363矽統","110/07/14","台新證券",750,342,408
"22174","2363矽統","110/07/14","瑞士信貸",149,864,-715
"22175","2363矽統","110/07/14","玉山-台中",363,51,312
"22176","2363矽統","110/07/14","台新-屏東",115,380,-265
"22177","2363矽統","110/07/14","元大-斗六",223,25,198
"22178","2363矽統","110/07/14","永豐金證券",16,265,-249
"22179","2363矽統","110/07/14","華南永昌-朴子",208,38,170
"22180","2363矽統","110/07/14","美林",462,701,-239
"22181","2363矽統","110/07/14","元富-西松",169,12,157
"22182","2363矽統","110/07/14","宏遠-桃園",269,500,-231
"22183","2363矽統","110/07/14","永豐金-大園",146,6,140
"22184","2363矽統","110/07/14","凱基-竹北",36,254,-218
"22185","2363矽統","110/07/14","土銀-和平",134,0,134
"22186","2363矽統","110/07/14","港商法國興業",0,214,-214
"22187","2363矽統","110/07/14","富邦-新營",130,13,117
"22188","2363矽統","110/07/14","港商野村",835,1044,-209
"22189","2363矽統","110/07/14","元富-成功",118,11,107
"22190","2363矽統","110/07/14","北城證券",212,411,-199
"22191","2363矽統","110/07/14","元富-烏日",121,18,103
"22192","2363矽統","110/07/14","(牛牛牛)亞-鑫豐",51,241,-190
"22193","2363矽統","110/07/14","日盛-二林",120,18,102
"22194","2363矽統","110/07/14","國票-博愛",24,213,-189
"22195","2363矽統","110/07/14","兆豐-忠孝",98,2,96
"22196","2363矽統","110/07/14","大慶-蘆洲",134,316,-182
"22197","2363矽統","110/07/14","大慶-楊梅",92,3,89
"22198","2363矽統","110/07/14","彰銀-台中",15,193,-178
"22199","2363矽統","110/07/14","元富-三重",120,33,87
"22200","2363矽統","110/07/14","日盛-和美",18,185,-167
"22201","8112至上","110/07/14","新加坡商瑞銀",223,17,206
"22202","8112至上","110/07/14","瑞士信貸",8,170,-162
"22203","8112至上","110/07/14","摩根大通",285,129,156
"22204","8112至上","110/07/14","美林",55,202,-147
"22205","8112至上","110/07/14","花旗環球",124,0,124
"22206","8112至上","110/07/14","凱基-台北",325,436,-111
"22207","8112至上","110/07/14","兆豐-公益",117,4,113
"22208","8112至上","110/07/14","台中銀-台北",0,98,-98
"22209","8112至上","110/07/14","香港上海匯豐",111,0,111
"22210","8112至上","110/07/14","玉山-台大",17,107,-90
"22211","8112至上","110/07/14","永豐金-內湖",117,21,96
"22212","8112至上","110/07/14","康和-內湖",1,90,-89
"22213","8112至上","110/07/14","台灣摩根士丹利",108,16,92
"22214","8112至上","110/07/14","港商野村",21,84,-63
"22215","8112至上","110/07/14","元大-東蘆",77,0,77
"22216","8112至上","110/07/14","兆豐-北高雄",1,60,-59
"22217","8112至上","110/07/14","新光",108,48,60
"22218","8112至上","110/07/14","群益金鼎-海山",1,52,-51
"22219","8112至上","110/07/14","大慶-蘆洲",59,0,59
"22220","8112至上","110/07/14","群益金鼎-大安",0,50,-50
"22221","8112至上","110/07/14","華南永昌-台中",56,3,53
"22222","8112至上","110/07/14","富邦-仁愛",2,49,-47
"22223","8112至上","110/07/14","土銀-嘉義",52,2,50
"22224","8112至上","110/07/14","元大-金華",0,42,-42
"22225","8112至上","110/07/14","美商高盛",40,0,40
"22226","8112至上","110/07/14","元大-內湖",4,43,-39
"22227","8112至上","110/07/14","臺銀",63,29,34
"22228","8112至上","110/07/14","第一金-華江",2,37,-35
"22229","8112至上","110/07/14","元富-嘉義",31,0,31
"22230","8112至上","110/07/14","永豐金-苓雅",2,34,-32
"22231","1570力肯","110/07/14","國票-北高雄",68,0,68
"22232","1570力肯","110/07/14","摩根大通",0,21,-21
"22233","1570力肯","110/07/14","日盛-八德",30,1,29
"22234","1570力肯","110/07/14","新光",1,19,-18
"22235","1570力肯","110/07/14","玉山-高雄",7,0,7
"22236","1570力肯","110/07/14","(牛牛牛)亞-鑫豐",0,17,-17
"22237","1570力肯","110/07/14","臺銀-臺南",5,0,5
"22238","1570力肯","110/07/14","日盛-士林",0,10,-10
"22239","1570力肯","110/07/14","凱基-三峽",5,0,5
"22240","1570力肯","110/07/14","統一-員林",0,10,-10
"22241","1570力肯","110/07/14","元大-和平",5,0,5
"22242","1570力肯","110/07/14","國票-新莊",0,10,-10
"22243","1570力肯","110/07/14","合庫-三重",4,0,4
"22244","1570力肯","110/07/14","凱基-高美館",0,10,-10
"22245","1570力肯","110/07/14","瑞士信貸",4,0,4
"22246","1570力肯","110/07/14","元大-屏東民生",0,5,-5
"22247","1570力肯","110/07/14","統一-三多",4,0,4
"22248","1570力肯","110/07/14","元大-古亭",0,5,-5
"22249","1570力肯","110/07/14","華南永昌-古亭",4,0,4
"22250","1570力肯","110/07/14","日盛-木柵",0,4,-4
"22251","1570力肯","110/07/14","元大-高雄",3,0,3
"22252","1570力肯","110/07/14","大昌",0,4,-4
"22253","1570力肯","110/07/14","兆豐-忠孝",2,0,2
"22254","1570力肯","110/07/14","群益金鼎-東大",0,4,-4
"22255","1570力肯","110/07/14","富邦-陽明",2,0,2
"22256","1570力肯","110/07/14","凱基-台北",0,4,-4
"22257","1570力肯","110/07/14","元大-松山",2,0,2
"22258","1570力肯","110/07/14","元大-板橋",0,4,-4
"22259","1570力肯","110/07/14","元大-忠孝",2,0,2
"22260","1570力肯","110/07/14","第一金-中山",0,3,-3
"22261","2929淘帝","110/07/14","華南永昌-林口",60,0,60
"22262","2929淘帝","110/07/14","群益金鼎",25,540,-515
"22263","2929淘帝","110/07/14","美林",87,31,56
"22264","2929淘帝","110/07/14","國泰-台南",1,30,-29
"22265","2929淘帝","110/07/14","元富-台南",40,0,40
"22266","2929淘帝","110/07/14","宏遠-桃園",0,20,-20
"22267","2929淘帝","110/07/14","元大-民生",39,0,39
"22268","2929淘帝","110/07/14","摩根大通",11,31,-20
"22269","2929淘帝","110/07/14","臺銀-鳳山",34,0,34
"22270","2929淘帝","110/07/14","台新-建北",5,20,-15
"22271","2929淘帝","110/07/14","合庫-高雄",34,1,33
"22272","2929淘帝","110/07/14","新光",1,16,-15
"22273","2929淘帝","110/07/14","華南永昌-鶯歌",28,0,28
"22274","2929淘帝","110/07/14","玉山-板橋",0,15,-15
"22275","2929淘帝","110/07/14","永興",25,0,25
"22276","2929淘帝","110/07/14","凱基-羅東",0,15,-15
"22277","2929淘帝","110/07/14","元大-新盛",25,1,24
"22278","2929淘帝","110/07/14","元大-頭份",0,15,-15
"22279","2929淘帝","110/07/14","日盛-南京",23,0,23
"22280","2929淘帝","110/07/14","第一金-台南",0,13,-13
"22281","2929淘帝","110/07/14","日茂",20,0,20
"22282","2929淘帝","110/07/14","富邦-基隆",0,12,-12
"22283","2929淘帝","110/07/14","台新-台中",20,0,20
"22284","2929淘帝","110/07/14","日茂-南投",1,12,-11
"22285","2929淘帝","110/07/14","華南永昌",20,0,20
"22286","2929淘帝","110/07/14","元大-豐原站前",0,11,-11
"22287","2929淘帝","110/07/14","福勝",15,0,15
"22288","2929淘帝","110/07/14","玉山-士林",0,10,-10
"22289","2929淘帝","110/07/14","富邦-南屯",15,0,15
"22290","2929淘帝","110/07/14","富邦-台北",0,10,-10
"22291","5410國眾","110/07/14","兆豐-城中",35,0,35
"22292","5410國眾","110/07/14","瑞士信貸",0,29,-29
"22293","5410國眾","110/07/14","新光",21,1,20
"22294","5410國眾","110/07/14","國泰-板橋",1,30,-29
"22295","5410國眾","110/07/14","國泰-敦南",21,1,20
"22296","5410國眾","110/07/14","日盛-高雄",0,20,-20
"22297","5410國眾","110/07/14","國泰-台中",20,1,19
"22298","5410國眾","110/07/14","台新-左楠",1,20,-19
"22299","5410國眾","110/07/14","元大-崇德",19,0,19
"22300","5410國眾","110/07/14","元富-大昌",1,18,-17
"22301","5410國眾","110/07/14","土銀-士林",18,0,18
"22302","5410國眾","110/07/14","富邦-建國",0,15,-15
"22303","5410國眾","110/07/14","元大-新盛",20,2,18
"22304","5410國眾","110/07/14","元富-嘉義",0,12,-12
"22305","5410國眾","110/07/14","兆豐-高雄",15,0,15
"22306","5410國眾","110/07/14","永全-南崁",0,12,-12
"22307","5410國眾","110/07/14","宏遠-中和",10,0,10
"22308","5410國眾","110/07/14","元大-員林",0,11,-11
"22309","5410國眾","110/07/14","新光-桃園",10,0,10
"22310","5410國眾","110/07/14","高橋",0,10,-10
"22311","5410國眾","110/07/14","國泰-台南",10,0,10
"22312","5410國眾","110/07/14","永興",0,10,-10
"22313","5410國眾","110/07/14","元大-復北",10,0,10
"22314","5410國眾","110/07/14","華南永昌-三重",0,10,-10
"22315","5410國眾","110/07/14","元大-竹科",8,0,8
"22316","5410國眾","110/07/14","元大-苑裡",0,7,-7
"22317","5410國眾","110/07/14","台新-新營",6,0,6
"22318","5410國眾","110/07/14","港商野村",0,6,-6
"22319","5410國眾","110/07/14","日盛-士林",5,0,5
"22320","5410國眾","110/07/14","摩根大通",5,11,-6
"22321","2841台開","110/07/14","凱基-文心",73,0,73
"22322","2841台開","110/07/14","國泰-敦南",0,50,-50
"22323","2841台開","110/07/14","元富-潮州",30,0,30
"22324","2841台開","110/07/14","凱基-中壢",0,40,-40
"22325","2841台開","110/07/14","第一金-台中",20,0,20
"22326","2841台開","110/07/14","統一-新竹",0,24,-24
"22327","2841台開","110/07/14","華南永昌-新莊",20,0,20
"22328","2841台開","110/07/14","元富-草屯",0,20,-20
"22329","2841台開","110/07/14","永豐金-豐原",20,0,20
"22330","2841台開","110/07/14","台新-台南",0,20,-20
"22331","2841台開","110/07/14","國泰-館前",15,0,15
"22332","2841台開","110/07/14","永豐金-敦南",45,63,-18
"22333","2841台開","110/07/14","群益金鼎-基隆",12,0,12
"22334","2841台開","110/07/14","國票-北高雄",0,13,-13
"22335","2841台開","110/07/14","日盛-信義",10,0,10
"22336","2841台開","110/07/14","凱基-松山",0,10,-10
"22337","2841台開","110/07/14","台新-台中",10,0,10
"22338","2841台開","110/07/14","元大證券",0,10,-10
"22339","2841台開","110/07/14","新光",10,1,9
"22340","2841台開","110/07/14","元大-中壢",0,10,-10
"22341","2841台開","110/07/14","凱基-新店",8,0,8
"22342","2841台開","110/07/14","富邦-陽明",1,10,-9
"22343","2841台開","110/07/14","元大-斗信",7,0,7
"22344","2841台開","110/07/14","富邦-建國",0,9,-9
"22345","2841台開","110/07/14","元大-三重",6,0,6
"22346","2841台開","110/07/14","富邦-台南",0,8,-8
"22347","2841台開","110/07/14","永豐金-中和",6,0,6
"22348","2841台開","110/07/14","康和-澎湖",0,7,-7
"22349","2841台開","110/07/14","元富-成功",5,0,5
"22350","2841台開","110/07/14","日盛-斗六",0,6,-6
"22351","6207雷科","110/07/14","群益金鼎-台北",60,0,60
"22352","6207雷科","110/07/14","新加坡商瑞銀",10,56,-46
"22353","6207雷科","110/07/14","台新-高雄",43,3,40
"22354","6207雷科","110/07/14","國票-中和",0,41,-41
"22355","6207雷科","110/07/14","元大-高雄",19,0,19
"22356","6207雷科","110/07/14","元大-復北",0,33,-33
"22357","6207雷科","110/07/14","福勝",15,0,15
"22358","6207雷科","110/07/14","光和-和美",0,20,-20
"22359","6207雷科","110/07/14","群益金鼎-中山",15,0,15
"22360","6207雷科","110/07/14","群益金鼎-丹鳳",0,20,-20
"22361","6207雷科","110/07/14","元大-林園",15,0,15
"22362","6207雷科","110/07/14","第一金-路竹",0,10,-10
"22363","6207雷科","110/07/14","新光",12,0,12
"22364","6207雷科","110/07/14","元大-歸仁",0,10,-10
"22365","6207雷科","110/07/14","元大-大天母",10,0,10
"22366","6207雷科","110/07/14","宏遠-館前",0,9,-9
"22367","6207雷科","110/07/14","永豐金-忠孝",9,0,9
"22368","6207雷科","110/07/14","凱基-台北",12,20,-8
"22369","6207雷科","110/07/14","永豐金-新店",7,0,7
"22370","6207雷科","110/07/14","美林",0,7,-7
"22371","6207雷科","110/07/14","玉山-嘉義",6,0,6
"22372","6207雷科","110/07/14","摩根大通",16,23,-7
"22373","6207雷科","110/07/14","元大-屏東",6,0,6
"22374","6207雷科","110/07/14","凱基-高雄",1,7,-6
"22375","6207雷科","110/07/14","凱基-大安",5,0,5
"22376","6207雷科","110/07/14","台中銀-豐原",0,5,-5
"22377","6207雷科","110/07/14","富邦-台南",5,0,5
"22378","6207雷科","110/07/14","元大-新竹經國",0,5,-5
"22379","6207雷科","110/07/14","元大-成功",5,0,5
"22380","6207雷科","110/07/14","光和-田中",0,4,-4
"22381","3679新至陞","110/07/14","凱基-台北",31,6,25
"22382","3679新至陞","110/07/14","群益金鼎-東大",0,15,-15
"22383","3679新至陞","110/07/14","華南永昌-新莊",10,0,10
"22384","3679新至陞","110/07/14","瑞士信貸",0,12,-12
"22385","3679新至陞","110/07/14","新加坡商瑞銀",11,3,8
"22386","3679新至陞","110/07/14","群益金鼎-永和",0,10,-10
"22387","3679新至陞","110/07/14","美商高盛",6,0,6
"22388","3679新至陞","110/07/14","元大-成功",5,15,-10
"22389","3679新至陞","110/07/14","第一金-中壢",6,0,6
"22390","3679新至陞","110/07/14","統一-板橋",1,10,-9
"22391","3679新至陞","110/07/14","(牛牛牛)亞-網路",4,0,4
"22392","3679新至陞","110/07/14","玉山-左營",0,5,-5
"22393","3679新至陞","110/07/14","元大-六合",3,0,3
"22394","3679新至陞","110/07/14","群益金鼎-三民",0,4,-4
"22395","3679新至陞","110/07/14","合庫-自強",2,0,2
"22396","3679新至陞","110/07/14","富邦-宜蘭",0,4,-4
"22397","3679新至陞","110/07/14","高橋-內壢",2,0,2
"22398","3679新至陞","110/07/14","永豐金-苓雅",0,3,-3
"22399","3679新至陞","110/07/14","台中銀-員林",2,0,2
"22400","3679新至陞","110/07/14","摩根大通",5,7,-2
"22401","3679新至陞","110/07/14","凱基-高美館",2,0,2
"22402","3679新至陞","110/07/14","元大-板橋三民",0,2,-2
"22403","3679新至陞","110/07/14","元大-福營",2,0,2
"22404","3679新至陞","110/07/14","宏遠-中和",0,1,-1
"22405","3679新至陞","110/07/14","永豐金-松山",2,0,2
"22406","3679新至陞","110/07/14","元富-佳里",0,1,-1
"22407","3679新至陞","110/07/14","永豐金-萬盛",2,0,2
"22408","3679新至陞","110/07/14","(牛牛牛)亞-鑫豐",0,1,-1
"22409","3679新至陞","110/07/14","元富-松德",1,0,1
"22410","3679新至陞","110/07/14","中國信託-中壢",0,1,-1
"22411","2727王品","110/07/14","富邦-左營",102,1,101
"22412","2727王品","110/07/14","統一-城中",100,234,-134
"22413","2727王品","110/07/14","國泰-板橋",105,11,94
"22414","2727王品","110/07/14","富邦-台北",1,125,-124
"22415","2727王品","110/07/14","港商野村",149,72,77
"22416","2727王品","110/07/14","台灣摩根士丹利",1,48,-47
"22417","2727王品","110/07/14","合庫-台中",66,2,64
"22418","2727王品","110/07/14","國票-新莊",0,40,-40
"22419","2727王品","110/07/14","臺銀-金山",63,8,55
"22420","2727王品","110/07/14","永豐金-忠孝",2,39,-37
"22421","2727王品","110/07/14","摩根大通",83,39,44
"22422","2727王品","110/07/14","富邦-彰化",1,34,-33
"22423","2727王品","110/07/14","凱基-台北",84,42,42
"22424","2727王品","110/07/14","康和-高雄",0,30,-30
"22425","2727王品","110/07/14","土銀-台中",35,1,34
"22426","2727王品","110/07/14","安泰",0,26,-26
"22427","2727王品","110/07/14","華南永昌-麻豆",32,1,31
"22428","2727王品","110/07/14","富邦-新竹華信",0,21,-21
"22429","2727王品","110/07/14","元大證券",85,55,30
"22430","2727王品","110/07/14","元大-南崁",1,22,-21
"22431","2727王品","110/07/14","新加坡商瑞銀",40,15,25
"22432","2727王品","110/07/14","彰銀-台中",0,18,-18
"22433","2727王品","110/07/14","日盛-八德",19,0,19
"22434","2727王品","110/07/14","元富-同大",2,20,-18
"22435","2727王品","110/07/14","統一",35,17,18
"22436","2727王品","110/07/14","玉山-嘉義",1,17,-16
"22437","2727王品","110/07/14","元富-大昌",18,1,17
"22438","2727王品","110/07/14","國泰-館前",4,20,-16
"22439","2727王品","110/07/14","玉山-板橋",15,1,14
"22440","2727王品","110/07/14","第一金-嘉義",1,13,-12
"22441","1570力肯","110/07/14","國票-北高雄",68,0,68
"22442","1570力肯","110/07/14","摩根大通",0,21,-21
"22443","1570力肯","110/07/14","日盛-八德",30,1,29
"22444","1570力肯","110/07/14","新光",1,19,-18
"22445","1570力肯","110/07/14","玉山-高雄",7,0,7
"22446","1570力肯","110/07/14","(牛牛牛)亞-鑫豐",0,17,-17
"22447","1570力肯","110/07/14","臺銀-臺南",5,0,5
"22448","1570力肯","110/07/14","日盛-士林",0,10,-10
"22449","1570力肯","110/07/14","凱基-三峽",5,0,5
"22450","1570力肯","110/07/14","統一-員林",0,10,-10
"22451","1570力肯","110/07/14","元大-和平",5,0,5
"22452","1570力肯","110/07/14","國票-新莊",0,10,-10
"22453","1570力肯","110/07/14","合庫-三重",4,0,4
"22454","1570力肯","110/07/14","凱基-高美館",0,10,-10
"22455","1570力肯","110/07/14","瑞士信貸",4,0,4
"22456","1570力肯","110/07/14","元大-屏東民生",0,5,-5
"22457","1570力肯","110/07/14","統一-三多",4,0,4
"22458","1570力肯","110/07/14","元大-古亭",0,5,-5
"22459","1570力肯","110/07/14","華南永昌-古亭",4,0,4
"22460","1570力肯","110/07/14","日盛-木柵",0,4,-4
"22461","1570力肯","110/07/14","元大-高雄",3,0,3
"22462","1570力肯","110/07/14","大昌",0,4,-4
"22463","1570力肯","110/07/14","兆豐-忠孝",2,0,2
"22464","1570力肯","110/07/14","群益金鼎-東大",0,4,-4
"22465","1570力肯","110/07/14","富邦-陽明",2,0,2
"22466","1570力肯","110/07/14","凱基-台北",0,4,-4
"22467","1570力肯","110/07/14","元大-松山",2,0,2
"22468","1570力肯","110/07/14","元大-板橋",0,4,-4
"22469","1570力肯","110/07/14","元大-忠孝",2,0,2
"22470","1570力肯","110/07/14","第一金-中山",0,3,-3
"22471","6180橘子","110/07/14","新加坡商瑞銀",84,28,56
"22472","6180橘子","110/07/14","凱基-台北",4,37,-33
"22473","6180橘子","110/07/14","日盛-信義",29,1,28
"22474","6180橘子","110/07/14","玉山-台南",1,22,-21
"22475","6180橘子","110/07/14","豐農",28,4,24
"22476","6180橘子","110/07/14","日盛-新竹",1,21,-20
"22477","6180橘子","110/07/14","新光-新竹",24,1,23
"22478","6180橘子","110/07/14","元富-潮州",0,19,-19
"22479","6180橘子","110/07/14","華南永昌-高雄",20,0,20
"22480","6180橘子","110/07/14","元大-信義",0,17,-17
"22481","6180橘子","110/07/14","元大-羅東",20,0,20
"22482","6180橘子","110/07/14","台灣企銀-台中",1,16,-15
"22483","6180橘子","110/07/14","元大-台中中港",20,0,20
"22484","6180橘子","110/07/14","元大-北港",0,15,-15
"22485","6180橘子","110/07/14","富邦-嘉義",24,5,19
"22486","6180橘子","110/07/14","富邦-高雄",0,14,-14
"22487","6180橘子","110/07/14","富邦-仁愛",15,0,15
"22488","6180橘子","110/07/14","兆豐-埔墘",0,13,-13
"22489","6180橘子","110/07/14","國票-九鼎",13,0,13
"22490","6180橘子","110/07/14","第一金-中山",0,10,-10
"22491","6180橘子","110/07/14","日盛-木柵",12,0,12
"22492","6180橘子","110/07/14","元大-彰化民生",0,10,-10
"22493","6180橘子","110/07/14","元大-成功",10,0,10
"22494","6180橘子","110/07/14","福勝",1,10,-9
"22495","6180橘子","110/07/14","港商野村",10,2,8
"22496","6180橘子","110/07/14","群益金鼎-丹鳳",1,10,-9
"22497","6180橘子","110/07/14","玉山-左營",8,0,8
"22498","6180橘子","110/07/14","群益金鼎-板橋",0,8,-8
"22499","6180橘子","110/07/14","富邦-陽明",16,8,8
"22500","6180橘子","110/07/14","合庫-鳳山",0,7,-7
"22501","2390云辰","110/07/14","摩根大通",995,198,797
"22502","2390云辰","110/07/14","新加坡商瑞銀",28,399,-371
"22503","2390云辰","110/07/14","美林",383,22,361
"22504","2390云辰","110/07/14","凱基-新豐",3,198,-195
"22505","2390云辰","110/07/14","台灣摩根士丹利",684,358,326
"22506","2390云辰","110/07/14","元大-士林",1,152,-151
"22507","2390云辰","110/07/14","凱基-台北",656,402,254
"22508","2390云辰","110/07/14","元大-竹山",80,181,-101
"22509","2390云辰","110/07/14","日盛-和美",110,5,105
"22510","2390云辰","110/07/14","群益金鼎-開元",19,95,-76
"22511","2390云辰","110/07/14","元大-天母",72,0,72
"22512","2390云辰","110/07/14","新光",77,150,-73
"22513","2390云辰","110/07/14","永豐金-松山",57,0,57
"22514","2390云辰","110/07/14","元富-高雄",0,71,-71
"22515","2390云辰","110/07/14","統一-屏東",53,0,53
"22516","2390云辰","110/07/14","元大-土城學府",130,201,-71
"22517","2390云辰","110/07/14","港商野村",486,450,36
"22518","2390云辰","110/07/14","元大-善化",12,76,-64
"22519","2390云辰","110/07/14","致和-崇德",30,0,30
"22520","2390云辰","110/07/14","華南永昌-岡山",23,81,-58
"22521","2390云辰","110/07/14","富邦-台北",40,14,26
"22522","2390云辰","110/07/14","群益金鼎-大興",82,125,-43
"22523","2390云辰","110/07/14","台新-高雄",38,13,25
"22524","2390云辰","110/07/14","大慶-中壢",0,41,-41
"22525","2390云辰","110/07/14","富邦-板橋",32,7,25
"22526","2390云辰","110/07/14","玉山-板橋",6,47,-41
"22527","2390云辰","110/07/14","陽信-石牌",24,0,24
"22528","2390云辰","110/07/14","富邦-台東",2,42,-40
"22529","2390云辰","110/07/14","凱基-屏東",32,8,24
"22530","2390云辰","110/07/14","元大-新營",3,42,-39
"22531","2363矽統","110/07/14","台灣摩根士丹利",463,0,463
"22532","2363矽統","110/07/14","新加坡商瑞銀",568,1321,-753
"22533","2363矽統","110/07/14","台新證券",750,342,408
"22534","2363矽統","110/07/14","瑞士信貸",149,864,-715
"22535","2363矽統","110/07/14","玉山-台中",363,51,312
"22536","2363矽統","110/07/14","台新-屏東",115,380,-265
"22537","2363矽統","110/07/14","元大-斗六",223,25,198
"22538","2363矽統","110/07/14","永豐金證券",16,265,-249
"22539","2363矽統","110/07/14","華南永昌-朴子",208,38,170
"22540","2363矽統","110/07/14","美林",462,701,-239
"22541","2363矽統","110/07/14","元富-西松",169,12,157
"22542","2363矽統","110/07/14","宏遠-桃園",269,500,-231
"22543","2363矽統","110/07/14","永豐金-大園",146,6,140
"22544","2363矽統","110/07/14","凱基-竹北",36,254,-218
"22545","2363矽統","110/07/14","土銀-和平",134,0,134
"22546","2363矽統","110/07/14","港商法國興業",0,214,-214
"22547","2363矽統","110/07/14","富邦-新營",130,13,117
"22548","2363矽統","110/07/14","港商野村",835,1044,-209
"22549","2363矽統","110/07/14","元富-成功",118,11,107
"22550","2363矽統","110/07/14","北城證券",212,411,-199
"22551","2363矽統","110/07/14","元富-烏日",121,18,103
"22552","2363矽統","110/07/14","(牛牛牛)亞-鑫豐",51,241,-190
"22553","2363矽統","110/07/14","日盛-二林",120,18,102
"22554","2363矽統","110/07/14","國票-博愛",24,213,-189
"22555","2363矽統","110/07/14","兆豐-忠孝",98,2,96
"22556","2363矽統","110/07/14","大慶-蘆洲",134,316,-182
"22557","2363矽統","110/07/14","大慶-楊梅",92,3,89
"22558","2363矽統","110/07/14","彰銀-台中",15,193,-178
"22559","2363矽統","110/07/14","元富-三重",120,33,87
"22560","2363矽統","110/07/14","日盛-和美",18,185,-167
"22561","8112至上","110/07/14","新加坡商瑞銀",223,17,206
"22562","8112至上","110/07/14","瑞士信貸",8,170,-162
"22563","8112至上","110/07/14","摩根大通",285,129,156
"22564","8112至上","110/07/14","美林",55,202,-147
"22565","8112至上","110/07/14","花旗環球",124,0,124
"22566","8112至上","110/07/14","凱基-台北",325,436,-111
"22567","8112至上","110/07/14","兆豐-公益",117,4,113
"22568","8112至上","110/07/14","台中銀-台北",0,98,-98
"22569","8112至上","110/07/14","香港上海匯豐",111,0,111
"22570","8112至上","110/07/14","玉山-台大",17,107,-90
"22571","8112至上","110/07/14","永豐金-內湖",117,21,96
"22572","8112至上","110/07/14","康和-內湖",1,90,-89
"22573","8112至上","110/07/14","台灣摩根士丹利",108,16,92
"22574","8112至上","110/07/14","港商野村",21,84,-63
"22575","8112至上","110/07/14","元大-東蘆",77,0,77
"22576","8112至上","110/07/14","兆豐-北高雄",1,60,-59
"22577","8112至上","110/07/14","新光",108,48,60
"22578","8112至上","110/07/14","群益金鼎-海山",1,52,-51
"22579","8112至上","110/07/14","大慶-蘆洲",59,0,59
"22580","8112至上","110/07/14","群益金鼎-大安",0,50,-50
"22581","8112至上","110/07/14","華南永昌-台中",56,3,53
"22582","8112至上","110/07/14","富邦-仁愛",2,49,-47
"22583","8112至上","110/07/14","土銀-嘉義",52,2,50
"22584","8112至上","110/07/14","元大-金華",0,42,-42
"22585","8112至上","110/07/14","美商高盛",40,0,40
"22586","8112至上","110/07/14","元大-內湖",4,43,-39
"22587","8112至上","110/07/14","臺銀",63,29,34
"22588","8112至上","110/07/14","第一金-華江",2,37,-35
"22589","8112至上","110/07/14","元富-嘉義",31,0,31
"22590","8112至上","110/07/14","永豐金-苓雅",2,34,-32
"22591","1570力肯","110/07/14","國票-北高雄",68,0,68
"22592","1570力肯","110/07/14","摩根大通",0,21,-21
"22593","1570力肯","110/07/14","日盛-八德",30,1,29
"22594","1570力肯","110/07/14","新光",1,19,-18
"22595","1570力肯","110/07/14","玉山-高雄",7,0,7
"22596","1570力肯","110/07/14","(牛牛牛)亞-鑫豐",0,17,-17
"22597","1570力肯","110/07/14","臺銀-臺南",5,0,5
"22598","1570力肯","110/07/14","日盛-士林",0,10,-10
"22599","1570力肯","110/07/14","凱基-三峽",5,0,5
"22600","1570力肯","110/07/14","統一-員林",0,10,-10
"22601","1570力肯","110/07/14","元大-和平",5,0,5
"22602","1570力肯","110/07/14","國票-新莊",0,10,-10
"22603","1570力肯","110/07/14","合庫-三重",4,0,4
"22604","1570力肯","110/07/14","凱基-高美館",0,10,-10
"22605","1570力肯","110/07/14","瑞士信貸",4,0,4
"22606","1570力肯","110/07/14","元大-屏東民生",0,5,-5
"22607","1570力肯","110/07/14","統一-三多",4,0,4
"22608","1570力肯","110/07/14","元大-古亭",0,5,-5
"22609","1570力肯","110/07/14","華南永昌-古亭",4,0,4
"22610","1570力肯","110/07/14","日盛-木柵",0,4,-4
"22611","1570力肯","110/07/14","元大-高雄",3,0,3
"22612","1570力肯","110/07/14","大昌",0,4,-4
"22613","1570力肯","110/07/14","兆豐-忠孝",2,0,2
"22614","1570力肯","110/07/14","群益金鼎-東大",0,4,-4
"22615","1570力肯","110/07/14","富邦-陽明",2,0,2
"22616","1570力肯","110/07/14","凱基-台北",0,4,-4
"22617","1570力肯","110/07/14","元大-松山",2,0,2
"22618","1570力肯","110/07/14","元大-板橋",0,4,-4
"22619","1570力肯","110/07/14","元大-忠孝",2,0,2
"22620","1570力肯","110/07/14","第一金-中山",0,3,-3
"22621","2929淘帝","110/07/14","華南永昌-林口",60,0,60
"22622","2929淘帝","110/07/14","群益金鼎",25,540,-515
"22623","2929淘帝","110/07/14","美林",87,31,56
"22624","2929淘帝","110/07/14","國泰-台南",1,30,-29
"22625","2929淘帝","110/07/14","元富-台南",40,0,40
"22626","2929淘帝","110/07/14","宏遠-桃園",0,20,-20
"22627","2929淘帝","110/07/14","元大-民生",39,0,39
"22628","2929淘帝","110/07/14","摩根大通",11,31,-20
"22629","2929淘帝","110/07/14","臺銀-鳳山",34,0,34
"22630","2929淘帝","110/07/14","台新-建北",5,20,-15
"22631","2929淘帝","110/07/14","合庫-高雄",34,1,33
"22632","2929淘帝","110/07/14","新光",1,16,-15
"22633","2929淘帝","110/07/14","華南永昌-鶯歌",28,0,28
"22634","2929淘帝","110/07/14","玉山-板橋",0,15,-15
"22635","2929淘帝","110/07/14","永興",25,0,25
"22636","2929淘帝","110/07/14","凱基-羅東",0,15,-15
"22637","2929淘帝","110/07/14","元大-新盛",25,1,24
"22638","2929淘帝","110/07/14","元大-頭份",0,15,-15
"22639","2929淘帝","110/07/14","日盛-南京",23,0,23
"22640","2929淘帝","110/07/14","第一金-台南",0,13,-13
"22641","2929淘帝","110/07/14","日茂",20,0,20
"22642","2929淘帝","110/07/14","富邦-基隆",0,12,-12
"22643","2929淘帝","110/07/14","台新-台中",20,0,20
"22644","2929淘帝","110/07/14","日茂-南投",1,12,-11
"22645","2929淘帝","110/07/14","華南永昌",20,0,20
"22646","2929淘帝","110/07/14","元大-豐原站前",0,11,-11
"22647","2929淘帝","110/07/14","福勝",15,0,15
"22648","2929淘帝","110/07/14","玉山-士林",0,10,-10
"22649","2929淘帝","110/07/14","富邦-南屯",15,0,15
"22650","2929淘帝","110/07/14","富邦-台北",0,10,-10
"22651","5410國眾","110/07/14","兆豐-城中",35,0,35
"22652","5410國眾","110/07/14","瑞士信貸",0,29,-29
"22653","5410國眾","110/07/14","新光",21,1,20
"22654","5410國眾","110/07/14","國泰-板橋",1,30,-29
"22655","5410國眾","110/07/14","國泰-敦南",21,1,20
"22656","5410國眾","110/07/14","日盛-高雄",0,20,-20
"22657","5410國眾","110/07/14","國泰-台中",20,1,19
"22658","5410國眾","110/07/14","台新-左楠",1,20,-19
"22659","5410國眾","110/07/14","元大-崇德",19,0,19
"22660","5410國眾","110/07/14","元富-大昌",1,18,-17
"22661","5410國眾","110/07/14","土銀-士林",18,0,18
"22662","5410國眾","110/07/14","富邦-建國",0,15,-15
"22663","5410國眾","110/07/14","元大-新盛",20,2,18
"22664","5410國眾","110/07/14","元富-嘉義",0,12,-12
"22665","5410國眾","110/07/14","兆豐-高雄",15,0,15
"22666","5410國眾","110/07/14","永全-南崁",0,12,-12
"22667","5410國眾","110/07/14","宏遠-中和",10,0,10
"22668","5410國眾","110/07/14","元大-員林",0,11,-11
"22669","5410國眾","110/07/14","新光-桃園",10,0,10
"22670","5410國眾","110/07/14","高橋",0,10,-10
"22671","5410國眾","110/07/14","國泰-台南",10,0,10
"22672","5410國眾","110/07/14","永興",0,10,-10
"22673","5410國眾","110/07/14","元大-復北",10,0,10
"22674","5410國眾","110/07/14","華南永昌-三重",0,10,-10
"22675","5410國眾","110/07/14","元大-竹科",8,0,8
"22676","5410國眾","110/07/14","元大-苑裡",0,7,-7
"22677","5410國眾","110/07/14","台新-新營",6,0,6
"22678","5410國眾","110/07/14","港商野村",0,6,-6
"22679","5410國眾","110/07/14","日盛-士林",5,0,5
"22680","5410國眾","110/07/14","摩根大通",5,11,-6
"22681","2841台開","110/07/14","凱基-文心",73,0,73
"22682","2841台開","110/07/14","國泰-敦南",0,50,-50
"22683","2841台開","110/07/14","元富-潮州",30,0,30
"22684","2841台開","110/07/14","凱基-中壢",0,40,-40
"22685","2841台開","110/07/14","第一金-台中",20,0,20
"22686","2841台開","110/07/14","統一-新竹",0,24,-24
"22687","2841台開","110/07/14","華南永昌-新莊",20,0,20
"22688","2841台開","110/07/14","元富-草屯",0,20,-20
"22689","2841台開","110/07/14","永豐金-豐原",20,0,20
"22690","2841台開","110/07/14","台新-台南",0,20,-20
"22691","2841台開","110/07/14","國泰-館前",15,0,15
"22692","2841台開","110/07/14","永豐金-敦南",45,63,-18
"22693","2841台開","110/07/14","群益金鼎-基隆",12,0,12
"22694","2841台開","110/07/14","國票-北高雄",0,13,-13
"22695","2841台開","110/07/14","日盛-信義",10,0,10
"22696","2841台開","110/07/14","凱基-松山",0,10,-10
"22697","2841台開","110/07/14","台新-台中",10,0,10
"22698","2841台開","110/07/14","元大證券",0,10,-10
"22699","2841台開","110/07/14","新光",10,1,9
"22700","2841台開","110/07/14","元大-中壢",0,10,-10
"22701","2841台開","110/07/14","凱基-新店",8,0,8
"22702","2841台開","110/07/14","富邦-陽明",1,10,-9
"22703","2841台開","110/07/14","元大-斗信",7,0,7
"22704","2841台開","110/07/14","富邦-建國",0,9,-9
"22705","2841台開","110/07/14","元大-三重",6,0,6
"22706","2841台開","110/07/14","富邦-台南",0,8,-8
"22707","2841台開","110/07/14","永豐金-中和",6,0,6
"22708","2841台開","110/07/14","康和-澎湖",0,7,-7
"22709","2841台開","110/07/14","元富-成功",5,0,5
"22710","2841台開","110/07/14","日盛-斗六",0,6,-6
"22711","6207雷科","110/07/14","群益金鼎-台北",60,0,60
"22712","6207雷科","110/07/14","新加坡商瑞銀",10,56,-46
"22713","6207雷科","110/07/14","台新-高雄",43,3,40
"22714","6207雷科","110/07/14","國票-中和",0,41,-41
"22715","6207雷科","110/07/14","元大-高雄",19,0,19
"22716","6207雷科","110/07/14","元大-復北",0,33,-33
"22717","6207雷科","110/07/14","福勝",15,0,15
"22718","6207雷科","110/07/14","光和-和美",0,20,-20
"22719","6207雷科","110/07/14","群益金鼎-中山",15,0,15
"22720","6207雷科","110/07/14","群益金鼎-丹鳳",0,20,-20
"22721","6207雷科","110/07/14","元大-林園",15,0,15
"22722","6207雷科","110/07/14","第一金-路竹",0,10,-10
"22723","6207雷科","110/07/14","新光",12,0,12
"22724","6207雷科","110/07/14","元大-歸仁",0,10,-10
"22725","6207雷科","110/07/14","元大-大天母",10,0,10
"22726","6207雷科","110/07/14","宏遠-館前",0,9,-9
"22727","6207雷科","110/07/14","永豐金-忠孝",9,0,9
"22728","6207雷科","110/07/14","凱基-台北",12,20,-8
"22729","6207雷科","110/07/14","永豐金-新店",7,0,7
"22730","6207雷科","110/07/14","美林",0,7,-7
"22731","6207雷科","110/07/14","玉山-嘉義",6,0,6
"22732","6207雷科","110/07/14","摩根大通",16,23,-7
"22733","6207雷科","110/07/14","元大-屏東",6,0,6
"22734","6207雷科","110/07/14","凱基-高雄",1,7,-6
"22735","6207雷科","110/07/14","凱基-大安",5,0,5
"22736","6207雷科","110/07/14","台中銀-豐原",0,5,-5
"22737","6207雷科","110/07/14","富邦-台南",5,0,5
"22738","6207雷科","110/07/14","元大-新竹經國",0,5,-5
"22739","6207雷科","110/07/14","元大-成功",5,0,5
"22740","6207雷科","110/07/14","光和-田中",0,4,-4
"22741","3679新至陞","110/07/14","凱基-台北",31,6,25
"22742","3679新至陞","110/07/14","群益金鼎-東大",0,15,-15
"22743","3679新至陞","110/07/14","華南永昌-新莊",10,0,10
"22744","3679新至陞","110/07/14","瑞士信貸",0,12,-12
"22745","3679新至陞","110/07/14","新加坡商瑞銀",11,3,8
"22746","3679新至陞","110/07/14","群益金鼎-永和",0,10,-10
"22747","3679新至陞","110/07/14","美商高盛",6,0,6
"22748","3679新至陞","110/07/14","元大-成功",5,15,-10
"22749","3679新至陞","110/07/14","第一金-中壢",6,0,6
"22750","3679新至陞","110/07/14","統一-板橋",1,10,-9
"22751","3679新至陞","110/07/14","(牛牛牛)亞-網路",4,0,4
"22752","3679新至陞","110/07/14","玉山-左營",0,5,-5
"22753","3679新至陞","110/07/14","元大-六合",3,0,3
"22754","3679新至陞","110/07/14","群益金鼎-三民",0,4,-4
"22755","3679新至陞","110/07/14","合庫-自強",2,0,2
"22756","3679新至陞","110/07/14","富邦-宜蘭",0,4,-4
"22757","3679新至陞","110/07/14","高橋-內壢",2,0,2
"22758","3679新至陞","110/07/14","永豐金-苓雅",0,3,-3
"22759","3679新至陞","110/07/14","台中銀-員林",2,0,2
"22760","3679新至陞","110/07/14","摩根大通",5,7,-2
"22761","3679新至陞","110/07/14","凱基-高美館",2,0,2
"22762","3679新至陞","110/07/14","元大-板橋三民",0,2,-2
"22763","3679新至陞","110/07/14","元大-福營",2,0,2
"22764","3679新至陞","110/07/14","宏遠-中和",0,1,-1
"22765","3679新至陞","110/07/14","永豐金-松山",2,0,2
"22766","3679新至陞","110/07/14","元富-佳里",0,1,-1
"22767","3679新至陞","110/07/14","永豐金-萬盛",2,0,2
"22768","3679新至陞","110/07/14","(牛牛牛)亞-鑫豐",0,1,-1
"22769","3679新至陞","110/07/14","元富-松德",1,0,1
"22770","3679新至陞","110/07/14","中國信託-中壢",0,1,-1
"22771","2727王品","110/07/14","富邦-左營",102,1,101
"22772","2727王品","110/07/14","統一-城中",100,234,-134
"22773","2727王品","110/07/14","國泰-板橋",105,11,94
"22774","2727王品","110/07/14","富邦-台北",1,125,-124
"22775","2727王品","110/07/14","港商野村",149,72,77
"22776","2727王品","110/07/14","台灣摩根士丹利",1,48,-47
"22777","2727王品","110/07/14","合庫-台中",66,2,64
"22778","2727王品","110/07/14","國票-新莊",0,40,-40
"22779","2727王品","110/07/14","臺銀-金山",63,8,55
"22780","2727王品","110/07/14","永豐金-忠孝",2,39,-37
"22781","2727王品","110/07/14","摩根大通",83,39,44
"22782","2727王品","110/07/14","富邦-彰化",1,34,-33
"22783","2727王品","110/07/14","凱基-台北",84,42,42
"22784","2727王品","110/07/14","康和-高雄",0,30,-30
"22785","2727王品","110/07/14","土銀-台中",35,1,34
"22786","2727王品","110/07/14","安泰",0,26,-26
"22787","2727王品","110/07/14","華南永昌-麻豆",32,1,31
"22788","2727王品","110/07/14","富邦-新竹華信",0,21,-21
"22789","2727王品","110/07/14","元大證券",85,55,30
"22790","2727王品","110/07/14","元大-南崁",1,22,-21
"22791","2727王品","110/07/14","新加坡商瑞銀",40,15,25
"22792","2727王品","110/07/14","彰銀-台中",0,18,-18
"22793","2727王品","110/07/14","日盛-八德",19,0,19
"22794","2727王品","110/07/14","元富-同大",2,20,-18
"22795","2727王品","110/07/14","統一",35,17,18
"22796","2727王品","110/07/14","玉山-嘉義",1,17,-16
"22797","2727王品","110/07/14","元富-大昌",18,1,17
"22798","2727王品","110/07/14","國泰-館前",4,20,-16
"22799","2727王品","110/07/14","玉山-板橋",15,1,14
"22800","2727王品","110/07/14","第一金-嘉義",1,13,-12
"22801","1570力肯","110/07/14","國票-北高雄",68,0,68
"22802","1570力肯","110/07/14","摩根大通",0,21,-21
"22803","1570力肯","110/07/14","日盛-八德",30,1,29
"22804","1570力肯","110/07/14","新光",1,19,-18
"22805","1570力肯","110/07/14","玉山-高雄",7,0,7
"22806","1570力肯","110/07/14","(牛牛牛)亞-鑫豐",0,17,-17
"22807","1570力肯","110/07/14","臺銀-臺南",5,0,5
"22808","1570力肯","110/07/14","日盛-士林",0,10,-10
"22809","1570力肯","110/07/14","凱基-三峽",5,0,5
"22810","1570力肯","110/07/14","統一-員林",0,10,-10
"22811","1570力肯","110/07/14","元大-和平",5,0,5
"22812","1570力肯","110/07/14","國票-新莊",0,10,-10
"22813","1570力肯","110/07/14","合庫-三重",4,0,4
"22814","1570力肯","110/07/14","凱基-高美館",0,10,-10
"22815","1570力肯","110/07/14","瑞士信貸",4,0,4
"22816","1570力肯","110/07/14","元大-屏東民生",0,5,-5
"22817","1570力肯","110/07/14","統一-三多",4,0,4
"22818","1570力肯","110/07/14","元大-古亭",0,5,-5
"22819","1570力肯","110/07/14","華南永昌-古亭",4,0,4
"22820","1570力肯","110/07/14","日盛-木柵",0,4,-4
"22821","1570力肯","110/07/14","元大-高雄",3,0,3
"22822","1570力肯","110/07/14","大昌",0,4,-4
"22823","1570力肯","110/07/14","兆豐-忠孝",2,0,2
"22824","1570力肯","110/07/14","群益金鼎-東大",0,4,-4
"22825","1570力肯","110/07/14","富邦-陽明",2,0,2
"22826","1570力肯","110/07/14","凱基-台北",0,4,-4
"22827","1570力肯","110/07/14","元大-松山",2,0,2
"22828","1570力肯","110/07/14","元大-板橋",0,4,-4
"22829","1570力肯","110/07/14","元大-忠孝",2,0,2
"22830","1570力肯","110/07/14","第一金-中山",0,3,-3
"22831","6180橘子","110/07/14","新加坡商瑞銀",84,28,56
"22832","6180橘子","110/07/14","凱基-台北",4,37,-33
"22833","6180橘子","110/07/14","日盛-信義",29,1,28
"22834","6180橘子","110/07/14","玉山-台南",1,22,-21
"22835","6180橘子","110/07/14","豐農",28,4,24
"22836","6180橘子","110/07/14","日盛-新竹",1,21,-20
"22837","6180橘子","110/07/14","新光-新竹",24,1,23
"22838","6180橘子","110/07/14","元富-潮州",0,19,-19
"22839","6180橘子","110/07/14","華南永昌-高雄",20,0,20
"22840","6180橘子","110/07/14","元大-信義",0,17,-17
"22841","6180橘子","110/07/14","元大-羅東",20,0,20
"22842","6180橘子","110/07/14","台灣企銀-台中",1,16,-15
"22843","6180橘子","110/07/14","元大-台中中港",20,0,20
"22844","6180橘子","110/07/14","元大-北港",0,15,-15
"22845","6180橘子","110/07/14","富邦-嘉義",24,5,19
"22846","6180橘子","110/07/14","富邦-高雄",0,14,-14
"22847","6180橘子","110/07/14","富邦-仁愛",15,0,15
"22848","6180橘子","110/07/14","兆豐-埔墘",0,13,-13
"22849","6180橘子","110/07/14","國票-九鼎",13,0,13
"22850","6180橘子","110/07/14","第一金-中山",0,10,-10
"22851","6180橘子","110/07/14","日盛-木柵",12,0,12
"22852","6180橘子","110/07/14","元大-彰化民生",0,10,-10
"22853","6180橘子","110/07/14","元大-成功",10,0,10
"22854","6180橘子","110/07/14","福勝",1,10,-9
"22855","6180橘子","110/07/14","港商野村",10,2,8
"22856","6180橘子","110/07/14","群益金鼎-丹鳳",1,10,-9
"22857","6180橘子","110/07/14","玉山-左營",8,0,8
"22858","6180橘子","110/07/14","群益金鼎-板橋",0,8,-8
"22859","6180橘子","110/07/14","富邦-陽明",16,8,8
"22860","6180橘子","110/07/14","合庫-鳳山",0,7,-7
"22861","2390云辰","110/07/14","摩根大通",995,198,797
"22862","2390云辰","110/07/14","新加坡商瑞銀",28,399,-371
"22863","2390云辰","110/07/14","美林",383,22,361
"22864","2390云辰","110/07/14","凱基-新豐",3,198,-195
"22865","2390云辰","110/07/14","台灣摩根士丹利",684,358,326
"22866","2390云辰","110/07/14","元大-士林",1,152,-151
"22867","2390云辰","110/07/14","凱基-台北",656,402,254
"22868","2390云辰","110/07/14","元大-竹山",80,181,-101
"22869","2390云辰","110/07/14","日盛-和美",110,5,105
"22870","2390云辰","110/07/14","群益金鼎-開元",19,95,-76
"22871","2390云辰","110/07/14","元大-天母",72,0,72
"22872","2390云辰","110/07/14","新光",77,150,-73
"22873","2390云辰","110/07/14","永豐金-松山",57,0,57
"22874","2390云辰","110/07/14","元富-高雄",0,71,-71
"22875","2390云辰","110/07/14","統一-屏東",53,0,53
"22876","2390云辰","110/07/14","元大-土城學府",130,201,-71
"22877","2390云辰","110/07/14","港商野村",486,450,36
"22878","2390云辰","110/07/14","元大-善化",12,76,-64
"22879","2390云辰","110/07/14","致和-崇德",30,0,30
"22880","2390云辰","110/07/14","華南永昌-岡山",23,81,-58
"22881","2390云辰","110/07/14","富邦-台北",40,14,26
"22882","2390云辰","110/07/14","群益金鼎-大興",82,125,-43
"22883","2390云辰","110/07/14","台新-高雄",38,13,25
"22884","2390云辰","110/07/14","大慶-中壢",0,41,-41
"22885","2390云辰","110/07/14","富邦-板橋",32,7,25
"22886","2390云辰","110/07/14","玉山-板橋",6,47,-41
"22887","2390云辰","110/07/14","陽信-石牌",24,0,24
"22888","2390云辰","110/07/14","富邦-台東",2,42,-40
"22889","2390云辰","110/07/14","凱基-屏東",32,8,24
"22890","2390云辰","110/07/14","元大-新營",3,42,-39
"22891","2363矽統","110/07/13","凱基-南崁",2133,63,2070
"22892","2363矽統","110/07/13","凱基-幸福",36,4048,-4012
"22893","2363矽統","110/07/13","國泰-敦南",2195,1617,578
"22894","2363矽統","110/07/13","統一",192,3325,-3133
"22895","2363矽統","110/07/13","中農",670,139,531
"22896","2363矽統","110/07/13","新加坡商瑞銀",1000,2747,-1747
"22897","2363矽統","110/07/13","康和-台中",638,154,484
"22898","2363矽統","110/07/13","凱基-台北",5359,6609,-1250
"22899","2363矽統","110/07/13","群益金鼎-三民",577,137,440
"22900","2363矽統","110/07/13","摩根大通",1930,2858,-928
"22901","2363矽統","110/07/13","台新-屏東",510,88,422
"22902","2363矽統","110/07/13","港商野村",960,1679,-719
"22903","2363矽統","110/07/13","德信-中正",455,67,388
"22904","2363矽統","110/07/13","兆豐-復興",25,705,-680
"22905","2363矽統","110/07/13","日盛-竹北",365,70,295
"22906","2363矽統","110/07/13","統一-仁愛",114,755,-641
"22907","2363矽統","110/07/13","元大-佳里",452,189,263
"22908","2363矽統","110/07/13","統一-敦南",29,638,-609
"22909","2363矽統","110/07/13","國票-博愛",296,38,258
"22910","2363矽統","110/07/13","統一-土城",100,704,-604
"22911","2363矽統","110/07/13","元大-萬華",340,95,245
"22912","2363矽統","110/07/13","統一-城中",116,676,-560
"22913","2363矽統","110/07/13","新光",1259,1031,228
"22914","2363矽統","110/07/13","永豐金證券",306,859,-553
"22915","2363矽統","110/07/13","元富-成功",323,96,227
"22916","2363矽統","110/07/13","元富",54,567,-513
"22917","2363矽統","110/07/13","豐農",228,23,205
"22918","2363矽統","110/07/13","瑞士信貸",202,666,-464
"22919","2363矽統","110/07/13","台灣企銀-岡山",186,4,182
"22920","2363矽統","110/07/13","永豐金-嘉義",67,468,-401
"22921","8112至上","110/07/13","摩根大通",688,296,392
"22922","8112至上","110/07/13","國票-中和",0,401,-401
"22923","8112至上","110/07/13","港商野村",344,145,199
"22924","8112至上","110/07/13","永豐金-板盛",0,205,-205
"22925","8112至上","110/07/13","兆豐-公益",195,5,190
"22926","8112至上","110/07/13","凱基-五股",43,155,-112
"22927","8112至上","110/07/13","台灣摩根士丹利",183,0,183
"22928","8112至上","110/07/13","凱基-市政",0,100,-100
"22929","8112至上","110/07/13","群益金鼎-敦南",153,2,151
"22930","8112至上","110/07/13","元大-大里德芳",1,92,-91
"22931","8112至上","110/07/13","臺銀-金山",146,26,120
"22932","8112至上","110/07/13","玉山-桃園",26,110,-84
"22933","8112至上","110/07/13","臺銀",133,19,114
"22934","8112至上","110/07/13","兆豐-天母",0,81,-81
"22935","8112至上","110/07/13","合庫-台中",115,6,109
"22936","8112至上","110/07/13","凱基-城中",3,84,-81
"22937","8112至上","110/07/13","亞東-板橋",134,26,108
"22938","8112至上","110/07/13","日盛-新莊",9,85,-76
"22939","8112至上","110/07/13","凱基-台北",414,326,88
"22940","8112至上","110/07/13","日盛-台中",2,64,-62
"22941","8112至上","110/07/13","新加坡商瑞銀",181,100,81
"22942","8112至上","110/07/13","日盛-中壢",3,64,-61
"22943","8112至上","110/07/13","國泰-敦南",108,31,77
"22944","8112至上","110/07/13","元大-台中",2,59,-57
"22945","8112至上","110/07/13","第一金-華江",77,4,73
"22946","8112至上","110/07/13","元大-雙和",7,64,-57
"22947","8112至上","110/07/13","永豐金-內湖",73,1,72
"22948","8112至上","110/07/13","元大-高雄",8,62,-54
"22949","8112至上","110/07/13","元大-永和",68,1,67
"22950","8112至上","110/07/13","元大-館前",2,55,-53
"22951","1570力肯","110/07/13","新光",115,11,104
"22952","1570力肯","110/07/13","元大-北三重",0,162,-162
"22953","1570力肯","110/07/13","群益金鼎-高雄",54,0,54
"22954","1570力肯","110/07/13","元大-大灣",0,25,-25
"22955","1570力肯","110/07/13","國票-新莊",22,0,22
"22956","1570力肯","110/07/13","永豐金-苓雅",0,22,-22
"22957","1570力肯","110/07/13","日盛-桃園",12,0,12
"22958","1570力肯","110/07/13","永豐金-永康",0,19,-19
"22959","1570力肯","110/07/13","元大-高雄",12,0,12
"22960","1570力肯","110/07/13","富邦-員林",0,15,-15
"22961","1570力肯","110/07/13","合庫-自強",11,0,11
"22962","1570力肯","110/07/13","凱基-台南",0,11,-11
"22963","1570力肯","110/07/13","摩根大通",26,15,11
"22964","1570力肯","110/07/13","日盛-竹北",0,10,-10
"22965","1570力肯","110/07/13","永豐金-中盛",11,0,11
"22966","1570力肯","110/07/13","國票-九鼎",0,10,-10
"22967","1570力肯","110/07/13","兆豐-台中港",10,0,10
"22968","1570力肯","110/07/13","凱基-桃園",0,10,-10
"22969","1570力肯","110/07/13","國泰-松江",9,0,9
"22970","1570力肯","110/07/13","凱基-新豐",0,10,-10
"22971","1570力肯","110/07/13","元大-新盛",9,0,9
"22972","1570力肯","110/07/13","元大-學甲",0,10,-10
"22973","1570力肯","110/07/13","元富-緯城",6,0,6
"22974","1570力肯","110/07/13","群益金鼎-東湖",1,10,-9
"22975","1570力肯","110/07/13","統一-三重",5,0,5
"22976","1570力肯","110/07/13","大昌",0,6,-6
"22977","1570力肯","110/07/13","元大-前金",5,0,5
"22978","1570力肯","110/07/13","元大-土城學府",0,6,-6
"22979","1570力肯","110/07/13","永豐金證券",5,0,5
"22980","1570力肯","110/07/13","統一",0,5,-5
"22981","2929淘帝","110/07/13","玉山-新竹",130,0,130
"22982","2929淘帝","110/07/13","美商高盛",0,177,-177
"22983","2929淘帝","110/07/13","臺銀-民權",60,0,60
"22984","2929淘帝","110/07/13","凱基-台北",6,80,-74
"22985","2929淘帝","110/07/13","新百王",31,0,31
"22986","2929淘帝","110/07/13","元富-大裕",0,49,-49
"22987","2929淘帝","110/07/13","日盛-園區",30,0,30
"22988","2929淘帝","110/07/13","國泰-館前",3,51,-48
"22989","2929淘帝","110/07/13","元大-南投",31,1,30
"22990","2929淘帝","110/07/13","凱基-中壢",0,41,-41
"22991","2929淘帝","110/07/13","兆豐-忠孝",28,0,28
"22992","2929淘帝","110/07/13","港商野村",21,55,-34
"22993","2929淘帝","110/07/13","元大-民生",28,0,28
"22994","2929淘帝","110/07/13","華南永昌-南京",2,34,-32
"22995","2929淘帝","110/07/13","合庫-高雄",27,0,27
"22996","2929淘帝","110/07/13","群益金鼎-土城",0,30,-30
"22997","2929淘帝","110/07/13","凱基-豐中",27,0,27
"22998","2929淘帝","110/07/13","富邦-南屯",0,22,-22
"22999","2929淘帝","110/07/13","新光",21,4,17
"23000","2929淘帝","110/07/13","第一金-豐原",0,20,-20
"23001","2929淘帝","110/07/13","元大-天母",17,0,17
"23002","2929淘帝","110/07/13","元大-屏南",6,26,-20
"23003","2929淘帝","110/07/13","永興",14,0,14
"23004","2929淘帝","110/07/13","永豐金-敦南",1,21,-20
"23005","2929淘帝","110/07/13","富邦-台北",12,0,12
"23006","2929淘帝","110/07/13","凱基-三重",2,21,-19
"23007","2929淘帝","110/07/13","元大-永和",12,0,12
"23008","2929淘帝","110/07/13","富邦-仁愛",7,25,-18
"23009","2929淘帝","110/07/13","國票-天祥",11,0,11
"23010","2929淘帝","110/07/13","元大-北投",0,16,-16
"23011","5410國眾","110/07/13","兆豐-城中",274,0,274
"23012","5410國眾","110/07/13","元富-嘉義",0,103,-103
"23013","5410國眾","110/07/13","新光",50,4,46
"23014","5410國眾","110/07/13","凱基-台北",0,50,-50
"23015","5410國眾","110/07/13","國泰-台中",26,0,26
"23016","5410國眾","110/07/13","瑞士信貸",0,31,-31
"23017","5410國眾","110/07/13","新加坡商瑞銀",22,0,22
"23018","5410國眾","110/07/13","台新-新莊",0,27,-27
"23019","5410國眾","110/07/13","光和-嘉義",20,0,20
"23020","5410國眾","110/07/13","元大-汐止",0,20,-20
"23021","5410國眾","110/07/13","凱基-竹北",17,0,17
"23022","5410國眾","110/07/13","亞東-新竹",0,17,-17
"23023","5410國眾","110/07/13","新光-桃園",15,0,15
"23024","5410國眾","110/07/13","元大-南勢角",0,13,-13
"23025","5410國眾","110/07/13","凱基-台東",14,0,14
"23026","5410國眾","110/07/13","台新-台南",0,12,-12
"23027","5410國眾","110/07/13","富邦-竹北",11,0,11
"23028","5410國眾","110/07/13","中國信託",0,11,-11
"23029","5410國眾","110/07/13","元富-同大",10,0,10
"23030","5410國眾","110/07/13","華南永昌",0,11,-11
"23031","5410國眾","110/07/13","國泰-敦南",24,15,9
"23032","5410國眾","110/07/13","臺銀-臺南",0,10,-10
"23033","5410國眾","110/07/13","日盛-內湖",7,0,7
"23034","5410國眾","110/07/13","台灣企銀-民雄",0,10,-10
"23035","5410國眾","110/07/13","台新-左楠",7,0,7
"23036","5410國眾","110/07/13","高橋",0,10,-10
"23037","5410國眾","110/07/13","元大-新盛",18,12,6
"23038","5410國眾","110/07/13","康和-嘉義",0,10,-10
"23039","5410國眾","110/07/13","統一",5,0,5
"23040","5410國眾","110/07/13","凱基-基隆",0,10,-10
"23041","2841台開","110/07/13","中國信託-高雄",251,50,201
"23042","2841台開","110/07/13","兆豐-公益",0,177,-177
"23043","2841台開","110/07/13","日盛證券",210,13,197
"23044","2841台開","110/07/13","日進",0,152,-152
"23045","2841台開","110/07/13","第一金-台中",55,0,55
"23046","2841台開","110/07/13","港商野村",0,109,-109
"23047","2841台開","110/07/13","國泰-板橋",46,0,46
"23048","2841台開","110/07/13","日盛-信義",0,103,-103
"23049","2841台開","110/07/13","國泰-館前",48,3,45
"23050","2841台開","110/07/13","國泰-敦南",11,75,-64
"23051","2841台開","110/07/13","華南永昌-新莊",45,0,45
"23052","2841台開","110/07/13","永興",0,50,-50
"23053","2841台開","110/07/13","日盛-園區",42,0,42
"23054","2841台開","110/07/13","永豐金-敦南",61,104,-43
"23055","2841台開","110/07/13","台新證券",32,0,32
"23056","2841台開","110/07/13","富邦-台南",0,42,-42
"23057","2841台開","110/07/13","台新-高雄",32,2,30
"23058","2841台開","110/07/13","國票-安和",0,30,-30
"23059","2841台開","110/07/13","豐農",23,0,23
"23060","2841台開","110/07/13","元大-桃園",0,25,-25
"23061","2841台開","110/07/13","合庫-嘉義",20,0,20
"23062","2841台開","110/07/13","新光",8,32,-24
"23063","2841台開","110/07/13","華南永昌-高雄",20,0,20
"23064","2841台開","110/07/13","元大-仁愛",0,24,-24
"23065","2841台開","110/07/13","元大-樹林",16,0,16
"23066","2841台開","110/07/13","日盛-中和",0,20,-20
"23067","2841台開","110/07/13","第一金-華江",15,2,13
"23068","2841台開","110/07/13","元富",0,20,-20
"23069","2841台開","110/07/13","美商高盛",12,0,12
"23070","2841台開","110/07/13","富邦-宜蘭",0,20,-20
"23071","6207雷科","110/07/13","元大-高雄",121,0,121
"23072","6207雷科","110/07/13","華南永昌-朴子",1,60,-59
"23073","6207雷科","110/07/13","第一金-新興",20,0,20
"23074","6207雷科","110/07/13","元大-南海",0,36,-36
"23075","6207雷科","110/07/13","元富-三重",20,0,20
"23076","6207雷科","110/07/13","凱基-土城",0,35,-35
"23077","6207雷科","110/07/13","元大-林園",15,0,15
"23078","6207雷科","110/07/13","台灣企銀",0,20,-20
"23079","6207雷科","110/07/13","元大-金華",16,1,15
"23080","6207雷科","110/07/13","群益金鼎-丹鳳",0,20,-20
"23081","6207雷科","110/07/13","日盛證券",10,0,10
"23082","6207雷科","110/07/13","元大-博愛",0,17,-17
"23083","6207雷科","110/07/13","統一-台中",10,0,10
"23084","6207雷科","110/07/13","元大-北港",0,13,-13
"23085","6207雷科","110/07/13","群益金鼎-土城",10,0,10
"23086","6207雷科","110/07/13","新加坡商瑞銀",0,12,-12
"23087","6207雷科","110/07/13","群益金鼎-桃園",10,0,10
"23088","6207雷科","110/07/13","凱基-台北",4,16,-12
"23089","6207雷科","110/07/13","永豐金-新莊",10,0,10
"23090","6207雷科","110/07/13","日茂-埔里",0,11,-11
"23091","6207雷科","110/07/13","永豐金-新店",10,0,10
"23092","6207雷科","110/07/13","元大-莒光",0,11,-11
"23093","6207雷科","110/07/13","元大證券",9,0,9
"23094","6207雷科","110/07/13","統一-新竹",0,10,-10
"23095","6207雷科","110/07/13","日盛-木柵",9,1,8
"23096","6207雷科","110/07/13","元大-西螺",0,10,-10
"23097","6207雷科","110/07/13","兆豐-來福",8,0,8
"23098","6207雷科","110/07/13","康和-台中",0,8,-8
"23099","6207雷科","110/07/13","新光",7,0,7
"23100","6207雷科","110/07/13","兆豐-高雄",0,6,-6
"23101","3679新至陞","110/07/13","永豐金證券",50,0,50
"23102","3679新至陞","110/07/13","摩根大通",2,25,-23
"23103","3679新至陞","110/07/13","國泰-桃園",22,0,22
"23104","3679新至陞","110/07/13","元大-成功",0,22,-22
"23105","3679新至陞","110/07/13","台中銀-員林",11,0,11
"23106","3679新至陞","110/07/13","富邦-板橋",1,19,-18
"23107","3679新至陞","110/07/13","元大-文心興安",8,0,8
"23108","3679新至陞","110/07/13","日盛-新莊",0,10,-10
"23109","3679新至陞","110/07/13","美商高盛",6,0,6
"23110","3679新至陞","110/07/13","台新-台中",0,10,-10
"23111","3679新至陞","110/07/13","台新-高雄",6,0,6
"23112","3679新至陞","110/07/13","永豐金-新竹",0,8,-8
"23113","3679新至陞","110/07/13","凱基-台北",18,12,6
"23114","3679新至陞","110/07/13","瑞士信貸",12,19,-7
"23115","3679新至陞","110/07/13","日盛-復興",5,0,5
"23116","3679新至陞","110/07/13","統一-南京",0,7,-7
"23117","3679新至陞","110/07/13","(牛牛牛)亞-鑫豐",4,0,4
"23118","3679新至陞","110/07/13","凱基-新莊",0,7,-7
"23119","3679新至陞","110/07/13","元富-大昌",3,0,3
"23120","3679新至陞","110/07/13","新加坡商瑞銀",0,6,-6
"23121","3679新至陞","110/07/13","富邦-台北",3,0,3
"23122","3679新至陞","110/07/13","合庫-自強",0,5,-5
"23123","3679新至陞","110/07/13","日盛-樹林",2,0,2
"23124","3679新至陞","110/07/13","富邦-桃園",0,5,-5
"23125","3679新至陞","110/07/13","宏遠-光隆",2,0,2
"23126","3679新至陞","110/07/13","永豐金-潮州",0,4,-4
"23127","3679新至陞","110/07/13","美林",3,1,2
"23128","3679新至陞","110/07/13","臺銀-臺南",0,3,-3
"23129","3679新至陞","110/07/13","第一金-中壢",2,0,2
"23130","3679新至陞","110/07/13","元大-六合",0,3,-3
"23131","2727王品","110/07/13","富邦-台北",43,3,40
"23132","2727王品","110/07/13","台灣摩根士丹利",15,97,-82
"23133","2727王品","110/07/13","元大-基隆孝二",40,0,40
"23134","2727王品","110/07/13","玉山-台南",5,57,-52
"23135","2727王品","110/07/13","國票-新莊",40,1,39
"23136","2727王品","110/07/13","新加坡商瑞銀",0,48,-48
"23137","2727王品","110/07/13","第一金-豐原",66,42,24
"23138","2727王品","110/07/13","凱基-台北",41,77,-36
"23139","2727王品","110/07/13","永豐金-大園",34,10,24
"23140","2727王品","110/07/13","永豐金-永康",0,22,-22
"23141","2727王品","110/07/13","元大-北屯",22,0,22
"23142","2727王品","110/07/13","統一-台中",2,22,-20
"23143","2727王品","110/07/13","元大-東蘆",26,7,19
"23144","2727王品","110/07/13","國泰-台中",21,39,-18
"23145","2727王品","110/07/13","永豐金-萬盛",13,1,12
"23146","2727王品","110/07/13","合庫-彰化",3,20,-17
"23147","2727王品","110/07/13","日盛-嘉義",11,0,11
"23148","2727王品","110/07/13","港商野村",13,30,-17
"23149","2727王品","110/07/13","日盛-八德",11,0,11
"23150","2727王品","110/07/13","元大-楊梅",1,16,-15
"23151","2727王品","110/07/13","統一-竹南",11,0,11
"23152","2727王品","110/07/13","凱基-高美館",2,15,-13
"23153","2727王品","110/07/13","日盛-士林",12,2,10
"23154","2727王品","110/07/13","美商高盛",2,14,-12
"23155","2727王品","110/07/13","統一-敦南",10,0,10
"23156","2727王品","110/07/13","統一-平鎮",1,13,-12
"23157","2727王品","110/07/13","中國信託",15,5,10
"23158","2727王品","110/07/13","兆豐-台中港",4,16,-12
"23159","2727王品","110/07/13","兆豐-竹北",13,3,10
"23160","2727王品","110/07/13","凱基-八德",1,13,-12
"23161","1570力肯","110/07/13","新光",115,11,104
"23162","1570力肯","110/07/13","元大-北三重",0,162,-162
"23163","1570力肯","110/07/13","群益金鼎-高雄",54,0,54
"23164","1570力肯","110/07/13","元大-大灣",0,25,-25
"23165","1570力肯","110/07/13","國票-新莊",22,0,22
"23166","1570力肯","110/07/13","永豐金-苓雅",0,22,-22
"23167","1570力肯","110/07/13","日盛-桃園",12,0,12
"23168","1570力肯","110/07/13","永豐金-永康",0,19,-19
"23169","1570力肯","110/07/13","元大-高雄",12,0,12
"23170","1570力肯","110/07/13","富邦-員林",0,15,-15
"23171","1570力肯","110/07/13","合庫-自強",11,0,11
"23172","1570力肯","110/07/13","凱基-台南",0,11,-11
"23173","1570力肯","110/07/13","摩根大通",26,15,11
"23174","1570力肯","110/07/13","日盛-竹北",0,10,-10
"23175","1570力肯","110/07/13","永豐金-中盛",11,0,11
"23176","1570力肯","110/07/13","國票-九鼎",0,10,-10
"23177","1570力肯","110/07/13","兆豐-台中港",10,0,10
"23178","1570力肯","110/07/13","凱基-桃園",0,10,-10
"23179","1570力肯","110/07/13","國泰-松江",9,0,9
"23180","1570力肯","110/07/13","凱基-新豐",0,10,-10
"23181","1570力肯","110/07/13","元大-新盛",9,0,9
"23182","1570力肯","110/07/13","元大-學甲",0,10,-10
"23183","1570力肯","110/07/13","元富-緯城",6,0,6
"23184","1570力肯","110/07/13","群益金鼎-東湖",1,10,-9
"23185","1570力肯","110/07/13","統一-三重",5,0,5
"23186","1570力肯","110/07/13","大昌",0,6,-6
"23187","1570力肯","110/07/13","元大-前金",5,0,5
"23188","1570力肯","110/07/13","元大-土城學府",0,6,-6
"23189","1570力肯","110/07/13","永豐金證券",5,0,5
"23190","1570力肯","110/07/13","統一",0,5,-5
"23191","6180橘子","110/07/13","摩根大通",119,0,119
"23192","6180橘子","110/07/13","元大-崇德",2,61,-59
"23193","6180橘子","110/07/13","美商高盛",96,0,96
"23194","6180橘子","110/07/13","康和-台中",0,51,-51
"23195","6180橘子","110/07/13","新加坡商瑞銀",86,7,79
"23196","6180橘子","110/07/13","康和-台北",0,50,-50
"23197","6180橘子","110/07/13","元大-和平",40,0,40
"23198","6180橘子","110/07/13","元富-潮州",0,40,-40
"23199","6180橘子","110/07/13","凱基-台北",83,47,36
"23200","6180橘子","110/07/13","日盛-永康",0,26,-26
"23201","6180橘子","110/07/13","美林",39,5,34
"23202","6180橘子","110/07/13","永豐金-中正",0,24,-24
"23203","6180橘子","110/07/13","富邦-新竹華信",31,2,29
"23204","6180橘子","110/07/13","國泰-板橋",2,25,-23
"23205","6180橘子","110/07/13","統一-南京",21,0,21
"23206","6180橘子","110/07/13","日盛-大墩",0,20,-20
"23207","6180橘子","110/07/13","富邦-陽明",24,3,21
"23208","6180橘子","110/07/13","元大-草屯",13,32,-19
"23209","6180橘子","110/07/13","大昌-樹林",21,1,20
"23210","6180橘子","110/07/13","元富-林園",1,18,-17
"23211","6180橘子","110/07/13","花旗環球",19,0,19
"23212","6180橘子","110/07/13","新光-新竹",1,18,-17
"23213","6180橘子","110/07/13","華南永昌-台南",19,0,19
"23214","6180橘子","110/07/13","元大-土城永寧",0,17,-17
"23215","6180橘子","110/07/13","福勝",14,0,14
"23216","6180橘子","110/07/13","國泰-新莊",3,19,-16
"23217","6180橘子","110/07/13","富邦-嘉義",12,1,11
"23218","6180橘子","110/07/13","中國信託-永康",6,21,-15
"23219","6180橘子","110/07/13","元大-板橋三民",11,0,11
"23220","6180橘子","110/07/13","凱基-東港",1,15,-14
"23221","2390云辰","110/07/13","新加坡商瑞銀",562,75,487
"23222","2390云辰","110/07/13","大展-台南",0,532,-532
"23223","2390云辰","110/07/13","台灣摩根士丹利",330,155,175
"23224","2390云辰","110/07/13","凱基-台北",668,854,-186
"23225","2390云辰","110/07/13","兆豐-公益",126,25,101
"23226","2390云辰","110/07/13","凱基-三重",12,172,-160
"23227","2390云辰","110/07/13","元富-中港",100,2,98
"23228","2390云辰","110/07/13","兆豐-忠孝",4,161,-157
"23229","2390云辰","110/07/13","統一-新台中",106,9,97
"23230","2390云辰","110/07/13","元大-士林",19,170,-151
"23231","2390云辰","110/07/13","中國信託-松江",81,11,70
"23232","2390云辰","110/07/13","臺銀-新竹",14,117,-103
"23233","2390云辰","110/07/13","日盛-板橋",72,3,69
"23234","2390云辰","110/07/13","國票-台中",4,102,-98
"23235","2390云辰","110/07/13","日盛-和美",57,0,57
"23236","2390云辰","110/07/13","新光",147,232,-85
"23237","2390云辰","110/07/13","永豐金-桃園",88,36,52
"23238","2390云辰","110/07/13","致和-崇德",2,70,-68
"23239","2390云辰","110/07/13","玉山-士林",54,4,50
"23240","2390云辰","110/07/13","群益金鼎-屏東",2,70,-68
"23241","2390云辰","110/07/13","富邦-仁愛",56,6,50
"23242","2390云辰","110/07/13","元大-大里",35,98,-63
"23243","2390云辰","110/07/13","第一金-豐原",50,1,49
"23244","2390云辰","110/07/13","元大-萬華",35,94,-59
"23245","2390云辰","110/07/13","摩根大通",502,453,49
"23246","2390云辰","110/07/13","元富-吉利",2,60,-58
"23247","2390云辰","110/07/13","凱基-松山",61,13,48
"23248","2390云辰","110/07/13","兆豐-新竹",3,53,-50
"23249","2390云辰","110/07/13","大昌",64,22,42
"23250","2390云辰","110/07/13","富邦-嘉義",65,108,-43
"23251","2363矽統","110/07/13","凱基-南崁",2133,63,2070
"23252","2363矽統","110/07/13","凱基-幸福",36,4048,-4012
"23253","2363矽統","110/07/13","國泰-敦南",2195,1617,578
"23254","2363矽統","110/07/13","統一",192,3325,-3133
"23255","2363矽統","110/07/13","中農",670,139,531
"23256","2363矽統","110/07/13","新加坡商瑞銀",1000,2747,-1747
"23257","2363矽統","110/07/13","康和-台中",638,154,484
"23258","2363矽統","110/07/13","凱基-台北",5359,6609,-1250
"23259","2363矽統","110/07/13","群益金鼎-三民",577,137,440
"23260","2363矽統","110/07/13","摩根大通",1930,2858,-928
"23261","2363矽統","110/07/13","台新-屏東",510,88,422
"23262","2363矽統","110/07/13","港商野村",960,1679,-719
"23263","2363矽統","110/07/13","德信-中正",455,67,388
"23264","2363矽統","110/07/13","兆豐-復興",25,705,-680
"23265","2363矽統","110/07/13","日盛-竹北",365,70,295
"23266","2363矽統","110/07/13","統一-仁愛",114,755,-641
"23267","2363矽統","110/07/13","元大-佳里",452,189,263
"23268","2363矽統","110/07/13","統一-敦南",29,638,-609
"23269","2363矽統","110/07/13","國票-博愛",296,38,258
"23270","2363矽統","110/07/13","統一-土城",100,704,-604
"23271","2363矽統","110/07/13","元大-萬華",340,95,245
"23272","2363矽統","110/07/13","統一-城中",116,676,-560
"23273","2363矽統","110/07/13","新光",1259,1031,228
"23274","2363矽統","110/07/13","永豐金證券",306,859,-553
"23275","2363矽統","110/07/13","元富-成功",323,96,227
"23276","2363矽統","110/07/13","元富",54,567,-513
"23277","2363矽統","110/07/13","豐農",228,23,205
"23278","2363矽統","110/07/13","瑞士信貸",202,666,-464
"23279","2363矽統","110/07/13","台灣企銀-岡山",186,4,182
"23280","2363矽統","110/07/13","永豐金-嘉義",67,468,-401
"23281","8112至上","110/07/13","摩根大通",688,296,392
"23282","8112至上","110/07/13","國票-中和",0,401,-401
"23283","8112至上","110/07/13","港商野村",344,145,199
"23284","8112至上","110/07/13","永豐金-板盛",0,205,-205
"23285","8112至上","110/07/13","兆豐-公益",195,5,190
"23286","8112至上","110/07/13","凱基-五股",43,155,-112
"23287","8112至上","110/07/13","台灣摩根士丹利",183,0,183
"23288","8112至上","110/07/13","凱基-市政",0,100,-100
"23289","8112至上","110/07/13","群益金鼎-敦南",153,2,151
"23290","8112至上","110/07/13","元大-大里德芳",1,92,-91
"23291","8112至上","110/07/13","臺銀-金山",146,26,120
"23292","8112至上","110/07/13","玉山-桃園",26,110,-84
"23293","8112至上","110/07/13","臺銀",133,19,114
"23294","8112至上","110/07/13","兆豐-天母",0,81,-81
"23295","8112至上","110/07/13","合庫-台中",115,6,109
"23296","8112至上","110/07/13","凱基-城中",3,84,-81
"23297","8112至上","110/07/13","亞東-板橋",134,26,108
"23298","8112至上","110/07/13","日盛-新莊",9,85,-76
"23299","8112至上","110/07/13","凱基-台北",414,326,88
"23300","8112至上","110/07/13","日盛-台中",2,64,-62
"23301","8112至上","110/07/13","新加坡商瑞銀",181,100,81
"23302","8112至上","110/07/13","日盛-中壢",3,64,-61
"23303","8112至上","110/07/13","國泰-敦南",108,31,77
"23304","8112至上","110/07/13","元大-台中",2,59,-57
"23305","8112至上","110/07/13","第一金-華江",77,4,73
"23306","8112至上","110/07/13","元大-雙和",7,64,-57
"23307","8112至上","110/07/13","永豐金-內湖",73,1,72
"23308","8112至上","110/07/13","元大-高雄",8,62,-54
"23309","8112至上","110/07/13","元大-永和",68,1,67
"23310","8112至上","110/07/13","元大-館前",2,55,-53
"23311","1570力肯","110/07/13","新光",115,11,104
"23312","1570力肯","110/07/13","元大-北三重",0,162,-162
"23313","1570力肯","110/07/13","群益金鼎-高雄",54,0,54
"23314","1570力肯","110/07/13","元大-大灣",0,25,-25
"23315","1570力肯","110/07/13","國票-新莊",22,0,22
"23316","1570力肯","110/07/13","永豐金-苓雅",0,22,-22
"23317","1570力肯","110/07/13","日盛-桃園",12,0,12
"23318","1570力肯","110/07/13","永豐金-永康",0,19,-19
"23319","1570力肯","110/07/13","元大-高雄",12,0,12
"23320","1570力肯","110/07/13","富邦-員林",0,15,-15
"23321","1570力肯","110/07/13","合庫-自強",11,0,11
"23322","1570力肯","110/07/13","凱基-台南",0,11,-11
"23323","1570力肯","110/07/13","摩根大通",26,15,11
"23324","1570力肯","110/07/13","日盛-竹北",0,10,-10
"23325","1570力肯","110/07/13","永豐金-中盛",11,0,11
"23326","1570力肯","110/07/13","國票-九鼎",0,10,-10
"23327","1570力肯","110/07/13","兆豐-台中港",10,0,10
"23328","1570力肯","110/07/13","凱基-桃園",0,10,-10
"23329","1570力肯","110/07/13","國泰-松江",9,0,9
"23330","1570力肯","110/07/13","凱基-新豐",0,10,-10
"23331","1570力肯","110/07/13","元大-新盛",9,0,9
"23332","1570力肯","110/07/13","元大-學甲",0,10,-10
"23333","1570力肯","110/07/13","元富-緯城",6,0,6
"23334","1570力肯","110/07/13","群益金鼎-東湖",1,10,-9
"23335","1570力肯","110/07/13","統一-三重",5,0,5
"23336","1570力肯","110/07/13","大昌",0,6,-6
"23337","1570力肯","110/07/13","元大-前金",5,0,5
"23338","1570力肯","110/07/13","元大-土城學府",0,6,-6
"23339","1570力肯","110/07/13","永豐金證券",5,0,5
"23340","1570力肯","110/07/13","統一",0,5,-5
"23341","2929淘帝","110/07/13","玉山-新竹",130,0,130
"23342","2929淘帝","110/07/13","美商高盛",0,177,-177
"23343","2929淘帝","110/07/13","臺銀-民權",60,0,60
"23344","2929淘帝","110/07/13","凱基-台北",6,80,-74
"23345","2929淘帝","110/07/13","新百王",31,0,31
"23346","2929淘帝","110/07/13","元富-大裕",0,49,-49
"23347","2929淘帝","110/07/13","日盛-園區",30,0,30
"23348","2929淘帝","110/07/13","國泰-館前",3,51,-48
"23349","2929淘帝","110/07/13","元大-南投",31,1,30
"23350","2929淘帝","110/07/13","凱基-中壢",0,41,-41
"23351","2929淘帝","110/07/13","兆豐-忠孝",28,0,28
"23352","2929淘帝","110/07/13","港商野村",21,55,-34
"23353","2929淘帝","110/07/13","元大-民生",28,0,28
"23354","2929淘帝","110/07/13","華南永昌-南京",2,34,-32
"23355","2929淘帝","110/07/13","合庫-高雄",27,0,27
"23356","2929淘帝","110/07/13","群益金鼎-土城",0,30,-30
"23357","2929淘帝","110/07/13","凱基-豐中",27,0,27
"23358","2929淘帝","110/07/13","富邦-南屯",0,22,-22
"23359","2929淘帝","110/07/13","新光",21,4,17
"23360","2929淘帝","110/07/13","第一金-豐原",0,20,-20
"23361","2929淘帝","110/07/13","元大-天母",17,0,17
"23362","2929淘帝","110/07/13","元大-屏南",6,26,-20
"23363","2929淘帝","110/07/13","永興",14,0,14
"23364","2929淘帝","110/07/13","永豐金-敦南",1,21,-20
"23365","2929淘帝","110/07/13","富邦-台北",12,0,12
"23366","2929淘帝","110/07/13","凱基-三重",2,21,-19
"23367","2929淘帝","110/07/13","元大-永和",12,0,12
"23368","2929淘帝","110/07/13","富邦-仁愛",7,25,-18
"23369","2929淘帝","110/07/13","國票-天祥",11,0,11
"23370","2929淘帝","110/07/13","元大-北投",0,16,-16
"23371","5410國眾","110/07/13","兆豐-城中",274,0,274
"23372","5410國眾","110/07/13","元富-嘉義",0,103,-103
"23373","5410國眾","110/07/13","新光",50,4,46
"23374","5410國眾","110/07/13","凱基-台北",0,50,-50
"23375","5410國眾","110/07/13","國泰-台中",26,0,26
"23376","5410國眾","110/07/13","瑞士信貸",0,31,-31
"23377","5410國眾","110/07/13","新加坡商瑞銀",22,0,22
"23378","5410國眾","110/07/13","台新-新莊",0,27,-27
"23379","5410國眾","110/07/13","光和-嘉義",20,0,20
"23380","5410國眾","110/07/13","元大-汐止",0,20,-20
"23381","5410國眾","110/07/13","凱基-竹北",17,0,17
"23382","5410國眾","110/07/13","亞東-新竹",0,17,-17
"23383","5410國眾","110/07/13","新光-桃園",15,0,15
"23384","5410國眾","110/07/13","元大-南勢角",0,13,-13
"23385","5410國眾","110/07/13","凱基-台東",14,0,14
"23386","5410國眾","110/07/13","台新-台南",0,12,-12
"23387","5410國眾","110/07/13","富邦-竹北",11,0,11
"23388","5410國眾","110/07/13","中國信託",0,11,-11
"23389","5410國眾","110/07/13","元富-同大",10,0,10
"23390","5410國眾","110/07/13","華南永昌",0,11,-11
"23391","5410國眾","110/07/13","國泰-敦南",24,15,9
"23392","5410國眾","110/07/13","臺銀-臺南",0,10,-10
"23393","5410國眾","110/07/13","日盛-內湖",7,0,7
"23394","5410國眾","110/07/13","台灣企銀-民雄",0,10,-10
"23395","5410國眾","110/07/13","台新-左楠",7,0,7
"23396","5410國眾","110/07/13","高橋",0,10,-10
"23397","5410國眾","110/07/13","元大-新盛",18,12,6
"23398","5410國眾","110/07/13","康和-嘉義",0,10,-10
"23399","5410國眾","110/07/13","統一",5,0,5
"23400","5410國眾","110/07/13","凱基-基隆",0,10,-10
"23401","2841台開","110/07/13","中國信託-高雄",251,50,201
"23402","2841台開","110/07/13","兆豐-公益",0,177,-177
"23403","2841台開","110/07/13","日盛證券",210,13,197
"23404","2841台開","110/07/13","日進",0,152,-152
"23405","2841台開","110/07/13","第一金-台中",55,0,55
"23406","2841台開","110/07/13","港商野村",0,109,-109
"23407","2841台開","110/07/13","國泰-板橋",46,0,46
"23408","2841台開","110/07/13","日盛-信義",0,103,-103
"23409","2841台開","110/07/13","國泰-館前",48,3,45
"23410","2841台開","110/07/13","國泰-敦南",11,75,-64
"23411","2841台開","110/07/13","華南永昌-新莊",45,0,45
"23412","2841台開","110/07/13","永興",0,50,-50
"23413","2841台開","110/07/13","日盛-園區",42,0,42
"23414","2841台開","110/07/13","永豐金-敦南",61,104,-43
"23415","2841台開","110/07/13","台新證券",32,0,32
"23416","2841台開","110/07/13","富邦-台南",0,42,-42
"23417","2841台開","110/07/13","台新-高雄",32,2,30
"23418","2841台開","110/07/13","國票-安和",0,30,-30
"23419","2841台開","110/07/13","豐農",23,0,23
"23420","2841台開","110/07/13","元大-桃園",0,25,-25
"23421","2841台開","110/07/13","合庫-嘉義",20,0,20
"23422","2841台開","110/07/13","新光",8,32,-24
"23423","2841台開","110/07/13","華南永昌-高雄",20,0,20
"23424","2841台開","110/07/13","元大-仁愛",0,24,-24
"23425","2841台開","110/07/13","元大-樹林",16,0,16
"23426","2841台開","110/07/13","日盛-中和",0,20,-20
"23427","2841台開","110/07/13","第一金-華江",15,2,13
"23428","2841台開","110/07/13","元富",0,20,-20
"23429","2841台開","110/07/13","美商高盛",12,0,12
"23430","2841台開","110/07/13","富邦-宜蘭",0,20,-20
"23431","6207雷科","110/07/13","元大-高雄",121,0,121
"23432","6207雷科","110/07/13","華南永昌-朴子",1,60,-59
"23433","6207雷科","110/07/13","第一金-新興",20,0,20
"23434","6207雷科","110/07/13","元大-南海",0,36,-36
"23435","6207雷科","110/07/13","元富-三重",20,0,20
"23436","6207雷科","110/07/13","凱基-土城",0,35,-35
"23437","6207雷科","110/07/13","元大-林園",15,0,15
"23438","6207雷科","110/07/13","台灣企銀",0,20,-20
"23439","6207雷科","110/07/13","元大-金華",16,1,15
"23440","6207雷科","110/07/13","群益金鼎-丹鳳",0,20,-20
"23441","6207雷科","110/07/13","日盛證券",10,0,10
"23442","6207雷科","110/07/13","元大-博愛",0,17,-17
"23443","6207雷科","110/07/13","統一-台中",10,0,10
"23444","6207雷科","110/07/13","元大-北港",0,13,-13
"23445","6207雷科","110/07/13","群益金鼎-土城",10,0,10
"23446","6207雷科","110/07/13","新加坡商瑞銀",0,12,-12
"23447","6207雷科","110/07/13","群益金鼎-桃園",10,0,10
"23448","6207雷科","110/07/13","凱基-台北",4,16,-12
"23449","6207雷科","110/07/13","永豐金-新莊",10,0,10
"23450","6207雷科","110/07/13","日茂-埔里",0,11,-11
"23451","6207雷科","110/07/13","永豐金-新店",10,0,10
"23452","6207雷科","110/07/13","元大-莒光",0,11,-11
"23453","6207雷科","110/07/13","元大證券",9,0,9
"23454","6207雷科","110/07/13","統一-新竹",0,10,-10
"23455","6207雷科","110/07/13","日盛-木柵",9,1,8
"23456","6207雷科","110/07/13","元大-西螺",0,10,-10
"23457","6207雷科","110/07/13","兆豐-來福",8,0,8
"23458","6207雷科","110/07/13","康和-台中",0,8,-8
"23459","6207雷科","110/07/13","新光",7,0,7
"23460","6207雷科","110/07/13","兆豐-高雄",0,6,-6
"23461","3679新至陞","110/07/13","永豐金證券",50,0,50
"23462","3679新至陞","110/07/13","摩根大通",2,25,-23
"23463","3679新至陞","110/07/13","國泰-桃園",22,0,22
"23464","3679新至陞","110/07/13","元大-成功",0,22,-22
"23465","3679新至陞","110/07/13","台中銀-員林",11,0,11
"23466","3679新至陞","110/07/13","富邦-板橋",1,19,-18
"23467","3679新至陞","110/07/13","元大-文心興安",8,0,8
"23468","3679新至陞","110/07/13","日盛-新莊",0,10,-10
"23469","3679新至陞","110/07/13","美商高盛",6,0,6
"23470","3679新至陞","110/07/13","台新-台中",0,10,-10
"23471","3679新至陞","110/07/13","台新-高雄",6,0,6
"23472","3679新至陞","110/07/13","永豐金-新竹",0,8,-8
"23473","3679新至陞","110/07/13","凱基-台北",18,12,6
"23474","3679新至陞","110/07/13","瑞士信貸",12,19,-7
"23475","3679新至陞","110/07/13","日盛-復興",5,0,5
"23476","3679新至陞","110/07/13","統一-南京",0,7,-7
"23477","3679新至陞","110/07/13","(牛牛牛)亞-鑫豐",4,0,4
"23478","3679新至陞","110/07/13","凱基-新莊",0,7,-7
"23479","3679新至陞","110/07/13","元富-大昌",3,0,3
"23480","3679新至陞","110/07/13","新加坡商瑞銀",0,6,-6
"23481","3679新至陞","110/07/13","富邦-台北",3,0,3
"23482","3679新至陞","110/07/13","合庫-自強",0,5,-5
"23483","3679新至陞","110/07/13","日盛-樹林",2,0,2
"23484","3679新至陞","110/07/13","富邦-桃園",0,5,-5
"23485","3679新至陞","110/07/13","宏遠-光隆",2,0,2
"23486","3679新至陞","110/07/13","永豐金-潮州",0,4,-4
"23487","3679新至陞","110/07/13","美林",3,1,2
"23488","3679新至陞","110/07/13","臺銀-臺南",0,3,-3
"23489","3679新至陞","110/07/13","第一金-中壢",2,0,2
"23490","3679新至陞","110/07/13","元大-六合",0,3,-3
"23491","2727王品","110/07/13","富邦-台北",43,3,40
"23492","2727王品","110/07/13","台灣摩根士丹利",15,97,-82
"23493","2727王品","110/07/13","元大-基隆孝二",40,0,40
"23494","2727王品","110/07/13","玉山-台南",5,57,-52
"23495","2727王品","110/07/13","國票-新莊",40,1,39
"23496","2727王品","110/07/13","新加坡商瑞銀",0,48,-48
"23497","2727王品","110/07/13","第一金-豐原",66,42,24
"23498","2727王品","110/07/13","凱基-台北",41,77,-36
"23499","2727王品","110/07/13","永豐金-大園",34,10,24
"23500","2727王品","110/07/13","永豐金-永康",0,22,-22
"23501","2727王品","110/07/13","元大-北屯",22,0,22
"23502","2727王品","110/07/13","統一-台中",2,22,-20
"23503","2727王品","110/07/13","元大-東蘆",26,7,19
"23504","2727王品","110/07/13","國泰-台中",21,39,-18
"23505","2727王品","110/07/13","永豐金-萬盛",13,1,12
"23506","2727王品","110/07/13","合庫-彰化",3,20,-17
"23507","2727王品","110/07/13","日盛-嘉義",11,0,11
"23508","2727王品","110/07/13","港商野村",13,30,-17
"23509","2727王品","110/07/13","日盛-八德",11,0,11
"23510","2727王品","110/07/13","元大-楊梅",1,16,-15
"23511","2727王品","110/07/13","統一-竹南",11,0,11
"23512","2727王品","110/07/13","凱基-高美館",2,15,-13
"23513","2727王品","110/07/13","日盛-士林",12,2,10
"23514","2727王品","110/07/13","美商高盛",2,14,-12
"23515","2727王品","110/07/13","統一-敦南",10,0,10
"23516","2727王品","110/07/13","統一-平鎮",1,13,-12
"23517","2727王品","110/07/13","中國信託",15,5,10
"23518","2727王品","110/07/13","兆豐-台中港",4,16,-12
"23519","2727王品","110/07/13","兆豐-竹北",13,3,10
"23520","2727王品","110/07/13","凱基-八德",1,13,-12
"23521","1570力肯","110/07/13","新光",115,11,104
"23522","1570力肯","110/07/13","元大-北三重",0,162,-162
"23523","1570力肯","110/07/13","群益金鼎-高雄",54,0,54
"23524","1570力肯","110/07/13","元大-大灣",0,25,-25
"23525","1570力肯","110/07/13","國票-新莊",22,0,22
"23526","1570力肯","110/07/13","永豐金-苓雅",0,22,-22
"23527","1570力肯","110/07/13","日盛-桃園",12,0,12
"23528","1570力肯","110/07/13","永豐金-永康",0,19,-19
"23529","1570力肯","110/07/13","元大-高雄",12,0,12
"23530","1570力肯","110/07/13","富邦-員林",0,15,-15
"23531","1570力肯","110/07/13","合庫-自強",11,0,11
"23532","1570力肯","110/07/13","凱基-台南",0,11,-11
"23533","1570力肯","110/07/13","摩根大通",26,15,11
"23534","1570力肯","110/07/13","日盛-竹北",0,10,-10
"23535","1570力肯","110/07/13","永豐金-中盛",11,0,11
"23536","1570力肯","110/07/13","國票-九鼎",0,10,-10
"23537","1570力肯","110/07/13","兆豐-台中港",10,0,10
"23538","1570力肯","110/07/13","凱基-桃園",0,10,-10
"23539","1570力肯","110/07/13","國泰-松江",9,0,9
"23540","1570力肯","110/07/13","凱基-新豐",0,10,-10
"23541","1570力肯","110/07/13","元大-新盛",9,0,9
"23542","1570力肯","110/07/13","元大-學甲",0,10,-10
"23543","1570力肯","110/07/13","元富-緯城",6,0,6
"23544","1570力肯","110/07/13","群益金鼎-東湖",1,10,-9
"23545","1570力肯","110/07/13","統一-三重",5,0,5
"23546","1570力肯","110/07/13","大昌",0,6,-6
"23547","1570力肯","110/07/13","元大-前金",5,0,5
"23548","1570力肯","110/07/13","元大-土城學府",0,6,-6
"23549","1570力肯","110/07/13","永豐金證券",5,0,5
"23550","1570力肯","110/07/13","統一",0,5,-5
"23551","6180橘子","110/07/13","摩根大通",119,0,119
"23552","6180橘子","110/07/13","元大-崇德",2,61,-59
"23553","6180橘子","110/07/13","美商高盛",96,0,96
"23554","6180橘子","110/07/13","康和-台中",0,51,-51
"23555","6180橘子","110/07/13","新加坡商瑞銀",86,7,79
"23556","6180橘子","110/07/13","康和-台北",0,50,-50
"23557","6180橘子","110/07/13","元大-和平",40,0,40
"23558","6180橘子","110/07/13","元富-潮州",0,40,-40
"23559","6180橘子","110/07/13","凱基-台北",83,47,36
"23560","6180橘子","110/07/13","日盛-永康",0,26,-26
"23561","6180橘子","110/07/13","美林",39,5,34
"23562","6180橘子","110/07/13","永豐金-中正",0,24,-24
"23563","6180橘子","110/07/13","富邦-新竹華信",31,2,29
"23564","6180橘子","110/07/13","國泰-板橋",2,25,-23
"23565","6180橘子","110/07/13","統一-南京",21,0,21
"23566","6180橘子","110/07/13","日盛-大墩",0,20,-20
"23567","6180橘子","110/07/13","富邦-陽明",24,3,21
"23568","6180橘子","110/07/13","元大-草屯",13,32,-19
"23569","6180橘子","110/07/13","大昌-樹林",21,1,20
"23570","6180橘子","110/07/13","元富-林園",1,18,-17
"23571","6180橘子","110/07/13","花旗環球",19,0,19
"23572","6180橘子","110/07/13","新光-新竹",1,18,-17
"23573","6180橘子","110/07/13","華南永昌-台南",19,0,19
"23574","6180橘子","110/07/13","元大-土城永寧",0,17,-17
"23575","6180橘子","110/07/13","福勝",14,0,14
"23576","6180橘子","110/07/13","國泰-新莊",3,19,-16
"23577","6180橘子","110/07/13","富邦-嘉義",12,1,11
"23578","6180橘子","110/07/13","中國信託-永康",6,21,-15
"23579","6180橘子","110/07/13","元大-板橋三民",11,0,11
"23580","6180橘子","110/07/13","凱基-東港",1,15,-14
"23581","2390云辰","110/07/13","新加坡商瑞銀",562,75,487
"23582","2390云辰","110/07/13","大展-台南",0,532,-532
"23583","2390云辰","110/07/13","台灣摩根士丹利",330,155,175
"23584","2390云辰","110/07/13","凱基-台北",668,854,-186
"23585","2390云辰","110/07/13","兆豐-公益",126,25,101
"23586","2390云辰","110/07/13","凱基-三重",12,172,-160
"23587","2390云辰","110/07/13","元富-中港",100,2,98
"23588","2390云辰","110/07/13","兆豐-忠孝",4,161,-157
"23589","2390云辰","110/07/13","統一-新台中",106,9,97
"23590","2390云辰","110/07/13","元大-士林",19,170,-151
"23591","2390云辰","110/07/13","中國信託-松江",81,11,70
"23592","2390云辰","110/07/13","臺銀-新竹",14,117,-103
"23593","2390云辰","110/07/13","日盛-板橋",72,3,69
"23594","2390云辰","110/07/13","國票-台中",4,102,-98
"23595","2390云辰","110/07/13","日盛-和美",57,0,57
"23596","2390云辰","110/07/13","新光",147,232,-85
"23597","2390云辰","110/07/13","永豐金-桃園",88,36,52
"23598","2390云辰","110/07/13","致和-崇德",2,70,-68
"23599","2390云辰","110/07/13","玉山-士林",54,4,50
"23600","2390云辰","110/07/13","群益金鼎-屏東",2,70,-68
"23601","2390云辰","110/07/13","富邦-仁愛",56,6,50
"23602","2390云辰","110/07/13","元大-大里",35,98,-63
"23603","2390云辰","110/07/13","第一金-豐原",50,1,49
"23604","2390云辰","110/07/13","元大-萬華",35,94,-59
"23605","2390云辰","110/07/13","摩根大通",502,453,49
"23606","2390云辰","110/07/13","元富-吉利",2,60,-58
"23607","2390云辰","110/07/13","凱基-松山",61,13,48
"23608","2390云辰","110/07/13","兆豐-新竹",3,53,-50
"23609","2390云辰","110/07/13","大昌",64,22,42
"23610","2390云辰","110/07/13","富邦-嘉義",65,108,-43
"23611","2363矽統","110/07/13","凱基-南崁",2133,63,2070
"23612","2363矽統","110/07/13","凱基-幸福",36,4048,-4012
"23613","2363矽統","110/07/13","國泰-敦南",2195,1617,578
"23614","2363矽統","110/07/13","統一",192,3325,-3133
"23615","2363矽統","110/07/13","中農",670,139,531
"23616","2363矽統","110/07/13","新加坡商瑞銀",1000,2747,-1747
"23617","2363矽統","110/07/13","康和-台中",638,154,484
"23618","2363矽統","110/07/13","凱基-台北",5359,6609,-1250
"23619","2363矽統","110/07/13","群益金鼎-三民",577,137,440
"23620","2363矽統","110/07/13","摩根大通",1930,2858,-928
"23621","2363矽統","110/07/13","台新-屏東",510,88,422
"23622","2363矽統","110/07/13","港商野村",960,1679,-719
"23623","2363矽統","110/07/13","德信-中正",455,67,388
"23624","2363矽統","110/07/13","兆豐-復興",25,705,-680
"23625","2363矽統","110/07/13","日盛-竹北",365,70,295
"23626","2363矽統","110/07/13","統一-仁愛",114,755,-641
"23627","2363矽統","110/07/13","元大-佳里",452,189,263
"23628","2363矽統","110/07/13","統一-敦南",29,638,-609
"23629","2363矽統","110/07/13","國票-博愛",296,38,258
"23630","2363矽統","110/07/13","統一-土城",100,704,-604
"23631","2363矽統","110/07/13","元大-萬華",340,95,245
"23632","2363矽統","110/07/13","統一-城中",116,676,-560
"23633","2363矽統","110/07/13","新光",1259,1031,228
"23634","2363矽統","110/07/13","永豐金證券",306,859,-553
"23635","2363矽統","110/07/13","元富-成功",323,96,227
"23636","2363矽統","110/07/13","元富",54,567,-513
"23637","2363矽統","110/07/13","豐農",228,23,205
"23638","2363矽統","110/07/13","瑞士信貸",202,666,-464
"23639","2363矽統","110/07/13","台灣企銀-岡山",186,4,182
"23640","2363矽統","110/07/13","永豐金-嘉義",67,468,-401
"23641","2363矽統","110/07/13","凱基-南崁",2133,63,2070
"23642","2363矽統","110/07/13","凱基-幸福",36,4048,-4012
"23643","2363矽統","110/07/13","國泰-敦南",2195,1617,578
"23644","2363矽統","110/07/13","統一",192,3325,-3133
"23645","2363矽統","110/07/13","中農",670,139,531
"23646","2363矽統","110/07/13","新加坡商瑞銀",1000,2747,-1747
"23647","2363矽統","110/07/13","康和-台中",638,154,484
"23648","2363矽統","110/07/13","凱基-台北",5359,6609,-1250
"23649","2363矽統","110/07/13","群益金鼎-三民",577,137,440
"23650","2363矽統","110/07/13","摩根大通",1930,2858,-928
"23651","2363矽統","110/07/13","台新-屏東",510,88,422
"23652","2363矽統","110/07/13","港商野村",960,1679,-719
"23653","2363矽統","110/07/13","德信-中正",455,67,388
"23654","2363矽統","110/07/13","兆豐-復興",25,705,-680
"23655","2363矽統","110/07/13","日盛-竹北",365,70,295
"23656","2363矽統","110/07/13","統一-仁愛",114,755,-641
"23657","2363矽統","110/07/13","元大-佳里",452,189,263
"23658","2363矽統","110/07/13","統一-敦南",29,638,-609
"23659","2363矽統","110/07/13","國票-博愛",296,38,258
"23660","2363矽統","110/07/13","統一-土城",100,704,-604
"23661","2363矽統","110/07/13","元大-萬華",340,95,245
"23662","2363矽統","110/07/13","統一-城中",116,676,-560
"23663","2363矽統","110/07/13","新光",1259,1031,228
"23664","2363矽統","110/07/13","永豐金證券",306,859,-553
"23665","2363矽統","110/07/13","元富-成功",323,96,227
"23666","2363矽統","110/07/13","元富",54,567,-513
"23667","2363矽統","110/07/13","豐農",228,23,205
"23668","2363矽統","110/07/13","瑞士信貸",202,666,-464
"23669","2363矽統","110/07/13","台灣企銀-岡山",186,4,182
"23670","2363矽統","110/07/13","永豐金-嘉義",67,468,-401
"23671","2363矽統","110/07/13","凱基-南崁",2133,63,2070
"23672","2363矽統","110/07/13","凱基-幸福",36,4048,-4012
"23673","2363矽統","110/07/13","國泰-敦南",2195,1617,578
"23674","2363矽統","110/07/13","統一",192,3325,-3133
"23675","2363矽統","110/07/13","中農",670,139,531
"23676","2363矽統","110/07/13","新加坡商瑞銀",1000,2747,-1747
"23677","2363矽統","110/07/13","康和-台中",638,154,484
"23678","2363矽統","110/07/13","凱基-台北",5359,6609,-1250
"23679","2363矽統","110/07/13","群益金鼎-三民",577,137,440
"23680","2363矽統","110/07/13","摩根大通",1930,2858,-928
"23681","2363矽統","110/07/13","台新-屏東",510,88,422
"23682","2363矽統","110/07/13","港商野村",960,1679,-719
"23683","2363矽統","110/07/13","德信-中正",455,67,388
"23684","2363矽統","110/07/13","兆豐-復興",25,705,-680
"23685","2363矽統","110/07/13","日盛-竹北",365,70,295
"23686","2363矽統","110/07/13","統一-仁愛",114,755,-641
"23687","2363矽統","110/07/13","元大-佳里",452,189,263
"23688","2363矽統","110/07/13","統一-敦南",29,638,-609
"23689","2363矽統","110/07/13","國票-博愛",296,38,258
"23690","2363矽統","110/07/13","統一-土城",100,704,-604
"23691","2363矽統","110/07/13","元大-萬華",340,95,245
"23692","2363矽統","110/07/13","統一-城中",116,676,-560
"23693","2363矽統","110/07/13","新光",1259,1031,228
"23694","2363矽統","110/07/13","永豐金證券",306,859,-553
"23695","2363矽統","110/07/13","元富-成功",323,96,227
"23696","2363矽統","110/07/13","元富",54,567,-513
"23697","2363矽統","110/07/13","豐農",228,23,205
"23698","2363矽統","110/07/13","瑞士信貸",202,666,-464
"23699","2363矽統","110/07/13","台灣企銀-岡山",186,4,182
"23700","2363矽統","110/07/13","永豐金-嘉義",67,468,-401
"23701","1570力肯","110/07/13","新光",115,11,104
"23702","1570力肯","110/07/13","元大-北三重",0,162,-162
"23703","1570力肯","110/07/13","群益金鼎-高雄",54,0,54
"23704","1570力肯","110/07/13","元大-大灣",0,25,-25
"23705","1570力肯","110/07/13","國票-新莊",22,0,22
"23706","1570力肯","110/07/13","永豐金-苓雅",0,22,-22
"23707","1570力肯","110/07/13","日盛-桃園",12,0,12
"23708","1570力肯","110/07/13","永豐金-永康",0,19,-19
"23709","1570力肯","110/07/13","元大-高雄",12,0,12
"23710","1570力肯","110/07/13","富邦-員林",0,15,-15
"23711","1570力肯","110/07/13","合庫-自強",11,0,11
"23712","1570力肯","110/07/13","凱基-台南",0,11,-11
"23713","1570力肯","110/07/13","摩根大通",26,15,11
"23714","1570力肯","110/07/13","日盛-竹北",0,10,-10
"23715","1570力肯","110/07/13","永豐金-中盛",11,0,11
"23716","1570力肯","110/07/13","國票-九鼎",0,10,-10
"23717","1570力肯","110/07/13","兆豐-台中港",10,0,10
"23718","1570力肯","110/07/13","凱基-桃園",0,10,-10
"23719","1570力肯","110/07/13","國泰-松江",9,0,9
"23720","1570力肯","110/07/13","凱基-新豐",0,10,-10
"23721","1570力肯","110/07/13","元大-新盛",9,0,9
"23722","1570力肯","110/07/13","元大-學甲",0,10,-10
"23723","1570力肯","110/07/13","元富-緯城",6,0,6
"23724","1570力肯","110/07/13","群益金鼎-東湖",1,10,-9
"23725","1570力肯","110/07/13","統一-三重",5,0,5
"23726","1570力肯","110/07/13","大昌",0,6,-6
"23727","1570力肯","110/07/13","元大-前金",5,0,5
"23728","1570力肯","110/07/13","元大-土城學府",0,6,-6
"23729","1570力肯","110/07/13","永豐金證券",5,0,5
"23730","1570力肯","110/07/13","統一",0,5,-5
"23731","1570力肯","110/07/13","新光",115,11,104
"23732","1570力肯","110/07/13","元大-北三重",0,162,-162
"23733","1570力肯","110/07/13","群益金鼎-高雄",54,0,54
"23734","1570力肯","110/07/13","元大-大灣",0,25,-25
"23735","1570力肯","110/07/13","國票-新莊",22,0,22
"23736","1570力肯","110/07/13","永豐金-苓雅",0,22,-22
"23737","1570力肯","110/07/13","日盛-桃園",12,0,12
"23738","1570力肯","110/07/13","永豐金-永康",0,19,-19
"23739","1570力肯","110/07/13","元大-高雄",12,0,12
"23740","1570力肯","110/07/13","富邦-員林",0,15,-15
"23741","1570力肯","110/07/13","合庫-自強",11,0,11
"23742","1570力肯","110/07/13","凱基-台南",0,11,-11
"23743","1570力肯","110/07/13","摩根大通",26,15,11
"23744","1570力肯","110/07/13","日盛-竹北",0,10,-10
"23745","1570力肯","110/07/13","永豐金-中盛",11,0,11
"23746","1570力肯","110/07/13","國票-九鼎",0,10,-10
"23747","1570力肯","110/07/13","兆豐-台中港",10,0,10
"23748","1570力肯","110/07/13","凱基-桃園",0,10,-10
"23749","1570力肯","110/07/13","國泰-松江",9,0,9
"23750","1570力肯","110/07/13","凱基-新豐",0,10,-10
"23751","1570力肯","110/07/13","元大-新盛",9,0,9
"23752","1570力肯","110/07/13","元大-學甲",0,10,-10
"23753","1570力肯","110/07/13","元富-緯城",6,0,6
"23754","1570力肯","110/07/13","群益金鼎-東湖",1,10,-9
"23755","1570力肯","110/07/13","統一-三重",5,0,5
"23756","1570力肯","110/07/13","大昌",0,6,-6
"23757","1570力肯","110/07/13","元大-前金",5,0,5
"23758","1570力肯","110/07/13","元大-土城學府",0,6,-6
"23759","1570力肯","110/07/13","永豐金證券",5,0,5
"23760","1570力肯","110/07/13","統一",0,5,-5
"23761","6180橘子","110/07/13","摩根大通",119,0,119
"23762","6180橘子","110/07/13","元大-崇德",2,61,-59
"23763","6180橘子","110/07/13","美商高盛",96,0,96
"23764","6180橘子","110/07/13","康和-台中",0,51,-51
"23765","6180橘子","110/07/13","新加坡商瑞銀",86,7,79
"23766","6180橘子","110/07/13","康和-台北",0,50,-50
"23767","6180橘子","110/07/13","元大-和平",40,0,40
"23768","6180橘子","110/07/13","元富-潮州",0,40,-40
"23769","6180橘子","110/07/13","凱基-台北",83,47,36
"23770","6180橘子","110/07/13","日盛-永康",0,26,-26
"23771","6180橘子","110/07/13","美林",39,5,34
"23772","6180橘子","110/07/13","永豐金-中正",0,24,-24
"23773","6180橘子","110/07/13","富邦-新竹華信",31,2,29
"23774","6180橘子","110/07/13","國泰-板橋",2,25,-23
"23775","6180橘子","110/07/13","統一-南京",21,0,21
"23776","6180橘子","110/07/13","日盛-大墩",0,20,-20
"23777","6180橘子","110/07/13","富邦-陽明",24,3,21
"23778","6180橘子","110/07/13","元大-草屯",13,32,-19
"23779","6180橘子","110/07/13","大昌-樹林",21,1,20
"23780","6180橘子","110/07/13","元富-林園",1,18,-17
"23781","6180橘子","110/07/13","花旗環球",19,0,19
"23782","6180橘子","110/07/13","新光-新竹",1,18,-17
"23783","6180橘子","110/07/13","華南永昌-台南",19,0,19
"23784","6180橘子","110/07/13","元大-土城永寧",0,17,-17
"23785","6180橘子","110/07/13","福勝",14,0,14
"23786","6180橘子","110/07/13","國泰-新莊",3,19,-16
"23787","6180橘子","110/07/13","富邦-嘉義",12,1,11
"23788","6180橘子","110/07/13","中國信託-永康",6,21,-15
"23789","6180橘子","110/07/13","元大-板橋三民",11,0,11
"23790","6180橘子","110/07/13","凱基-東港",1,15,-14
"23791","1570力肯","110/07/13","新光",115,11,104
"23792","1570力肯","110/07/13","元大-北三重",0,162,-162
"23793","1570力肯","110/07/13","群益金鼎-高雄",54,0,54
"23794","1570力肯","110/07/13","元大-大灣",0,25,-25
"23795","1570力肯","110/07/13","國票-新莊",22,0,22
"23796","1570力肯","110/07/13","永豐金-苓雅",0,22,-22
"23797","1570力肯","110/07/13","日盛-桃園",12,0,12
"23798","1570力肯","110/07/13","永豐金-永康",0,19,-19
"23799","1570力肯","110/07/13","元大-高雄",12,0,12
"23800","1570力肯","110/07/13","富邦-員林",0,15,-15
"23801","1570力肯","110/07/13","合庫-自強",11,0,11
"23802","1570力肯","110/07/13","凱基-台南",0,11,-11
"23803","1570力肯","110/07/13","摩根大通",26,15,11
"23804","1570力肯","110/07/13","日盛-竹北",0,10,-10
"23805","1570力肯","110/07/13","永豐金-中盛",11,0,11
"23806","1570力肯","110/07/13","國票-九鼎",0,10,-10
"23807","1570力肯","110/07/13","兆豐-台中港",10,0,10
"23808","1570力肯","110/07/13","凱基-桃園",0,10,-10
"23809","1570力肯","110/07/13","國泰-松江",9,0,9
"23810","1570力肯","110/07/13","凱基-新豐",0,10,-10
"23811","1570力肯","110/07/13","元大-新盛",9,0,9
"23812","1570力肯","110/07/13","元大-學甲",0,10,-10
"23813","1570力肯","110/07/13","元富-緯城",6,0,6
"23814","1570力肯","110/07/13","群益金鼎-東湖",1,10,-9
"23815","1570力肯","110/07/13","統一-三重",5,0,5
"23816","1570力肯","110/07/13","大昌",0,6,-6
"23817","1570力肯","110/07/13","元大-前金",5,0,5
"23818","1570力肯","110/07/13","元大-土城學府",0,6,-6
"23819","1570力肯","110/07/13","永豐金證券",5,0,5
"23820","1570力肯","110/07/13","統一",0,5,-5
"23821","6180橘子","110/07/13","摩根大通",119,0,119
"23822","6180橘子","110/07/13","元大-崇德",2,61,-59
"23823","6180橘子","110/07/13","美商高盛",96,0,96
"23824","6180橘子","110/07/13","康和-台中",0,51,-51
"23825","6180橘子","110/07/13","新加坡商瑞銀",86,7,79
"23826","6180橘子","110/07/13","康和-台北",0,50,-50
"23827","6180橘子","110/07/13","元大-和平",40,0,40
"23828","6180橘子","110/07/13","元富-潮州",0,40,-40
"23829","6180橘子","110/07/13","凱基-台北",83,47,36
"23830","6180橘子","110/07/13","日盛-永康",0,26,-26
"23831","6180橘子","110/07/13","美林",39,5,34
"23832","6180橘子","110/07/13","永豐金-中正",0,24,-24
"23833","6180橘子","110/07/13","富邦-新竹華信",31,2,29
"23834","6180橘子","110/07/13","國泰-板橋",2,25,-23
"23835","6180橘子","110/07/13","統一-南京",21,0,21
"23836","6180橘子","110/07/13","日盛-大墩",0,20,-20
"23837","6180橘子","110/07/13","富邦-陽明",24,3,21
"23838","6180橘子","110/07/13","元大-草屯",13,32,-19
"23839","6180橘子","110/07/13","大昌-樹林",21,1,20
"23840","6180橘子","110/07/13","元富-林園",1,18,-17
"23841","6180橘子","110/07/13","花旗環球",19,0,19
"23842","6180橘子","110/07/13","新光-新竹",1,18,-17
"23843","6180橘子","110/07/13","華南永昌-台南",19,0,19
"23844","6180橘子","110/07/13","元大-土城永寧",0,17,-17
"23845","6180橘子","110/07/13","福勝",14,0,14
"23846","6180橘子","110/07/13","國泰-新莊",3,19,-16
"23847","6180橘子","110/07/13","富邦-嘉義",12,1,11
"23848","6180橘子","110/07/13","中國信託-永康",6,21,-15
"23849","6180橘子","110/07/13","元大-板橋三民",11,0,11
"23850","6180橘子","110/07/13","凱基-東港",1,15,-14
"23851","2390云辰","110/07/13","新加坡商瑞銀",562,75,487
"23852","2390云辰","110/07/13","大展-台南",0,532,-532
"23853","2390云辰","110/07/13","台灣摩根士丹利",330,155,175
"23854","2390云辰","110/07/13","凱基-台北",668,854,-186
"23855","2390云辰","110/07/13","兆豐-公益",126,25,101
"23856","2390云辰","110/07/13","凱基-三重",12,172,-160
"23857","2390云辰","110/07/13","元富-中港",100,2,98
"23858","2390云辰","110/07/13","兆豐-忠孝",4,161,-157
"23859","2390云辰","110/07/13","統一-新台中",106,9,97
"23860","2390云辰","110/07/13","元大-士林",19,170,-151
"23861","2390云辰","110/07/13","中國信託-松江",81,11,70
"23862","2390云辰","110/07/13","臺銀-新竹",14,117,-103
"23863","2390云辰","110/07/13","日盛-板橋",72,3,69
"23864","2390云辰","110/07/13","國票-台中",4,102,-98
"23865","2390云辰","110/07/13","日盛-和美",57,0,57
"23866","2390云辰","110/07/13","新光",147,232,-85
"23867","2390云辰","110/07/13","永豐金-桃園",88,36,52
"23868","2390云辰","110/07/13","致和-崇德",2,70,-68
"23869","2390云辰","110/07/13","玉山-士林",54,4,50
"23870","2390云辰","110/07/13","群益金鼎-屏東",2,70,-68
"23871","2390云辰","110/07/13","富邦-仁愛",56,6,50
"23872","2390云辰","110/07/13","元大-大里",35,98,-63
"23873","2390云辰","110/07/13","第一金-豐原",50,1,49
"23874","2390云辰","110/07/13","元大-萬華",35,94,-59
"23875","2390云辰","110/07/13","摩根大通",502,453,49
"23876","2390云辰","110/07/13","元富-吉利",2,60,-58
"23877","2390云辰","110/07/13","凱基-松山",61,13,48
"23878","2390云辰","110/07/13","兆豐-新竹",3,53,-50
"23879","2390云辰","110/07/13","大昌",64,22,42
"23880","2390云辰","110/07/13","富邦-嘉義",65,108,-43
"23881","2363矽統","110/07/13","凱基-南崁",2133,63,2070
"23882","2363矽統","110/07/13","凱基-幸福",36,4048,-4012
"23883","2363矽統","110/07/13","國泰-敦南",2195,1617,578
"23884","2363矽統","110/07/13","統一",192,3325,-3133
"23885","2363矽統","110/07/13","中農",670,139,531
"23886","2363矽統","110/07/13","新加坡商瑞銀",1000,2747,-1747
"23887","2363矽統","110/07/13","康和-台中",638,154,484
"23888","2363矽統","110/07/13","凱基-台北",5359,6609,-1250
"23889","2363矽統","110/07/13","群益金鼎-三民",577,137,440
"23890","2363矽統","110/07/13","摩根大通",1930,2858,-928
"23891","2363矽統","110/07/13","台新-屏東",510,88,422
"23892","2363矽統","110/07/13","港商野村",960,1679,-719
"23893","2363矽統","110/07/13","德信-中正",455,67,388
"23894","2363矽統","110/07/13","兆豐-復興",25,705,-680
"23895","2363矽統","110/07/13","日盛-竹北",365,70,295
"23896","2363矽統","110/07/13","統一-仁愛",114,755,-641
"23897","2363矽統","110/07/13","元大-佳里",452,189,263
"23898","2363矽統","110/07/13","統一-敦南",29,638,-609
"23899","2363矽統","110/07/13","國票-博愛",296,38,258
"23900","2363矽統","110/07/13","統一-土城",100,704,-604
"23901","2363矽統","110/07/13","元大-萬華",340,95,245
"23902","2363矽統","110/07/13","統一-城中",116,676,-560
"23903","2363矽統","110/07/13","新光",1259,1031,228
"23904","2363矽統","110/07/13","永豐金證券",306,859,-553
"23905","2363矽統","110/07/13","元富-成功",323,96,227
"23906","2363矽統","110/07/13","元富",54,567,-513
"23907","2363矽統","110/07/13","豐農",228,23,205
"23908","2363矽統","110/07/13","瑞士信貸",202,666,-464
"23909","2363矽統","110/07/13","台灣企銀-岡山",186,4,182
"23910","2363矽統","110/07/13","永豐金-嘉義",67,468,-401
"23911","8112至上","110/07/13","摩根大通",688,296,392
"23912","8112至上","110/07/13","國票-中和",0,401,-401
"23913","8112至上","110/07/13","港商野村",344,145,199
"23914","8112至上","110/07/13","永豐金-板盛",0,205,-205
"23915","8112至上","110/07/13","兆豐-公益",195,5,190
"23916","8112至上","110/07/13","凱基-五股",43,155,-112
"23917","8112至上","110/07/13","台灣摩根士丹利",183,0,183
"23918","8112至上","110/07/13","凱基-市政",0,100,-100
"23919","8112至上","110/07/13","群益金鼎-敦南",153,2,151
"23920","8112至上","110/07/13","元大-大里德芳",1,92,-91
"23921","8112至上","110/07/13","臺銀-金山",146,26,120
"23922","8112至上","110/07/13","玉山-桃園",26,110,-84
"23923","8112至上","110/07/13","臺銀",133,19,114
"23924","8112至上","110/07/13","兆豐-天母",0,81,-81
"23925","8112至上","110/07/13","合庫-台中",115,6,109
"23926","8112至上","110/07/13","凱基-城中",3,84,-81
"23927","8112至上","110/07/13","亞東-板橋",134,26,108
"23928","8112至上","110/07/13","日盛-新莊",9,85,-76
"23929","8112至上","110/07/13","凱基-台北",414,326,88
"23930","8112至上","110/07/13","日盛-台中",2,64,-62
"23931","8112至上","110/07/13","新加坡商瑞銀",181,100,81
"23932","8112至上","110/07/13","日盛-中壢",3,64,-61
"23933","8112至上","110/07/13","國泰-敦南",108,31,77
"23934","8112至上","110/07/13","元大-台中",2,59,-57
"23935","8112至上","110/07/13","第一金-華江",77,4,73
"23936","8112至上","110/07/13","元大-雙和",7,64,-57
"23937","8112至上","110/07/13","永豐金-內湖",73,1,72
"23938","8112至上","110/07/13","元大-高雄",8,62,-54
"23939","8112至上","110/07/13","元大-永和",68,1,67
"23940","8112至上","110/07/13","元大-館前",2,55,-53
"23941","2929淘帝","110/07/13","玉山-新竹",130,0,130
"23942","2929淘帝","110/07/13","美商高盛",0,177,-177
"23943","2929淘帝","110/07/13","臺銀-民權",60,0,60
"23944","2929淘帝","110/07/13","凱基-台北",6,80,-74
"23945","2929淘帝","110/07/13","新百王",31,0,31
"23946","2929淘帝","110/07/13","元富-大裕",0,49,-49
"23947","2929淘帝","110/07/13","日盛-園區",30,0,30
"23948","2929淘帝","110/07/13","國泰-館前",3,51,-48
"23949","2929淘帝","110/07/13","元大-南投",31,1,30
"23950","2929淘帝","110/07/13","凱基-中壢",0,41,-41
"23951","2929淘帝","110/07/13","兆豐-忠孝",28,0,28
"23952","2929淘帝","110/07/13","港商野村",21,55,-34
"23953","2929淘帝","110/07/13","元大-民生",28,0,28
"23954","2929淘帝","110/07/13","華南永昌-南京",2,34,-32
"23955","2929淘帝","110/07/13","合庫-高雄",27,0,27
"23956","2929淘帝","110/07/13","群益金鼎-土城",0,30,-30
"23957","2929淘帝","110/07/13","凱基-豐中",27,0,27
"23958","2929淘帝","110/07/13","富邦-南屯",0,22,-22
"23959","2929淘帝","110/07/13","新光",21,4,17
"23960","2929淘帝","110/07/13","第一金-豐原",0,20,-20
"23961","2929淘帝","110/07/13","元大-天母",17,0,17
"23962","2929淘帝","110/07/13","元大-屏南",6,26,-20
"23963","2929淘帝","110/07/13","永興",14,0,14
"23964","2929淘帝","110/07/13","永豐金-敦南",1,21,-20
"23965","2929淘帝","110/07/13","富邦-台北",12,0,12
"23966","2929淘帝","110/07/13","凱基-三重",2,21,-19
"23967","2929淘帝","110/07/13","元大-永和",12,0,12
"23968","2929淘帝","110/07/13","富邦-仁愛",7,25,-18
"23969","2929淘帝","110/07/13","國票-天祥",11,0,11
"23970","2929淘帝","110/07/13","元大-北投",0,16,-16
"23971","2841台開","110/07/13","中國信託-高雄",251,50,201
"23972","2841台開","110/07/13","兆豐-公益",0,177,-177
"23973","2841台開","110/07/13","日盛證券",210,13,197
"23974","2841台開","110/07/13","日進",0,152,-152
"23975","2841台開","110/07/13","第一金-台中",55,0,55
"23976","2841台開","110/07/13","港商野村",0,109,-109
"23977","2841台開","110/07/13","國泰-板橋",46,0,46
"23978","2841台開","110/07/13","日盛-信義",0,103,-103
"23979","2841台開","110/07/13","國泰-館前",48,3,45
"23980","2841台開","110/07/13","國泰-敦南",11,75,-64
"23981","2841台開","110/07/13","華南永昌-新莊",45,0,45
"23982","2841台開","110/07/13","永興",0,50,-50
"23983","2841台開","110/07/13","日盛-園區",42,0,42
"23984","2841台開","110/07/13","永豐金-敦南",61,104,-43
"23985","2841台開","110/07/13","台新證券",32,0,32
"23986","2841台開","110/07/13","富邦-台南",0,42,-42
"23987","2841台開","110/07/13","台新-高雄",32,2,30
"23988","2841台開","110/07/13","國票-安和",0,30,-30
"23989","2841台開","110/07/13","豐農",23,0,23
"23990","2841台開","110/07/13","元大-桃園",0,25,-25
"23991","2841台開","110/07/13","合庫-嘉義",20,0,20
"23992","2841台開","110/07/13","新光",8,32,-24
"23993","2841台開","110/07/13","華南永昌-高雄",20,0,20
"23994","2841台開","110/07/13","元大-仁愛",0,24,-24
"23995","2841台開","110/07/13","元大-樹林",16,0,16
"23996","2841台開","110/07/13","日盛-中和",0,20,-20
"23997","2841台開","110/07/13","第一金-華江",15,2,13
"23998","2841台開","110/07/13","元富",0,20,-20
"23999","2841台開","110/07/13","美商高盛",12,0,12
"24000","2841台開","110/07/13","富邦-宜蘭",0,20,-20
"24001","6207雷科","110/07/13","元大-高雄",121,0,121
"24002","6207雷科","110/07/13","華南永昌-朴子",1,60,-59
"24003","6207雷科","110/07/13","第一金-新興",20,0,20
"24004","6207雷科","110/07/13","元大-南海",0,36,-36
"24005","6207雷科","110/07/13","元富-三重",20,0,20
"24006","6207雷科","110/07/13","凱基-土城",0,35,-35
"24007","6207雷科","110/07/13","元大-林園",15,0,15
"24008","6207雷科","110/07/13","台灣企銀",0,20,-20
"24009","6207雷科","110/07/13","元大-金華",16,1,15
"24010","6207雷科","110/07/13","群益金鼎-丹鳳",0,20,-20
"24011","6207雷科","110/07/13","日盛證券",10,0,10
"24012","6207雷科","110/07/13","元大-博愛",0,17,-17
"24013","6207雷科","110/07/13","統一-台中",10,0,10
"24014","6207雷科","110/07/13","元大-北港",0,13,-13
"24015","6207雷科","110/07/13","群益金鼎-土城",10,0,10
"24016","6207雷科","110/07/13","新加坡商瑞銀",0,12,-12
"24017","6207雷科","110/07/13","群益金鼎-桃園",10,0,10
"24018","6207雷科","110/07/13","凱基-台北",4,16,-12
"24019","6207雷科","110/07/13","永豐金-新莊",10,0,10
"24020","6207雷科","110/07/13","日茂-埔里",0,11,-11
"24021","6207雷科","110/07/13","永豐金-新店",10,0,10
"24022","6207雷科","110/07/13","元大-莒光",0,11,-11
"24023","6207雷科","110/07/13","元大證券",9,0,9
"24024","6207雷科","110/07/13","統一-新竹",0,10,-10
"24025","6207雷科","110/07/13","日盛-木柵",9,1,8
"24026","6207雷科","110/07/13","元大-西螺",0,10,-10
"24027","6207雷科","110/07/13","兆豐-來福",8,0,8
"24028","6207雷科","110/07/13","康和-台中",0,8,-8
"24029","6207雷科","110/07/13","新光",7,0,7
"24030","6207雷科","110/07/13","兆豐-高雄",0,6,-6
"24031","3679新至陞","110/07/13","永豐金證券",50,0,50
"24032","3679新至陞","110/07/13","摩根大通",2,25,-23
"24033","3679新至陞","110/07/13","國泰-桃園",22,0,22
"24034","3679新至陞","110/07/13","元大-成功",0,22,-22
"24035","3679新至陞","110/07/13","台中銀-員林",11,0,11
"24036","3679新至陞","110/07/13","富邦-板橋",1,19,-18
"24037","3679新至陞","110/07/13","元大-文心興安",8,0,8
"24038","3679新至陞","110/07/13","日盛-新莊",0,10,-10
"24039","3679新至陞","110/07/13","美商高盛",6,0,6
"24040","3679新至陞","110/07/13","台新-台中",0,10,-10
"24041","3679新至陞","110/07/13","台新-高雄",6,0,6
"24042","3679新至陞","110/07/13","永豐金-新竹",0,8,-8
"24043","3679新至陞","110/07/13","凱基-台北",18,12,6
"24044","3679新至陞","110/07/13","瑞士信貸",12,19,-7
"24045","3679新至陞","110/07/13","日盛-復興",5,0,5
"24046","3679新至陞","110/07/13","統一-南京",0,7,-7
"24047","3679新至陞","110/07/13","(牛牛牛)亞-鑫豐",4,0,4
"24048","3679新至陞","110/07/13","凱基-新莊",0,7,-7
"24049","3679新至陞","110/07/13","元富-大昌",3,0,3
"24050","3679新至陞","110/07/13","新加坡商瑞銀",0,6,-6
"24051","3679新至陞","110/07/13","富邦-台北",3,0,3
"24052","3679新至陞","110/07/13","合庫-自強",0,5,-5
"24053","3679新至陞","110/07/13","日盛-樹林",2,0,2
"24054","3679新至陞","110/07/13","富邦-桃園",0,5,-5
"24055","3679新至陞","110/07/13","宏遠-光隆",2,0,2
"24056","3679新至陞","110/07/13","永豐金-潮州",0,4,-4
"24057","3679新至陞","110/07/13","美林",3,1,2
"24058","3679新至陞","110/07/13","臺銀-臺南",0,3,-3
"24059","3679新至陞","110/07/13","第一金-中壢",2,0,2
"24060","3679新至陞","110/07/13","元大-六合",0,3,-3
"24061","2727王品","110/07/13","富邦-台北",43,3,40
"24062","2727王品","110/07/13","台灣摩根士丹利",15,97,-82
"24063","2727王品","110/07/13","元大-基隆孝二",40,0,40
"24064","2727王品","110/07/13","玉山-台南",5,57,-52
"24065","2727王品","110/07/13","國票-新莊",40,1,39
"24066","2727王品","110/07/13","新加坡商瑞銀",0,48,-48
"24067","2727王品","110/07/13","第一金-豐原",66,42,24
"24068","2727王品","110/07/13","凱基-台北",41,77,-36
"24069","2727王品","110/07/13","永豐金-大園",34,10,24
"24070","2727王品","110/07/13","永豐金-永康",0,22,-22
"24071","2727王品","110/07/13","元大-北屯",22,0,22
"24072","2727王品","110/07/13","統一-台中",2,22,-20
"24073","2727王品","110/07/13","元大-東蘆",26,7,19
"24074","2727王品","110/07/13","國泰-台中",21,39,-18
"24075","2727王品","110/07/13","永豐金-萬盛",13,1,12
"24076","2727王品","110/07/13","合庫-彰化",3,20,-17
"24077","2727王品","110/07/13","日盛-嘉義",11,0,11
"24078","2727王品","110/07/13","港商野村",13,30,-17
"24079","2727王品","110/07/13","日盛-八德",11,0,11
"24080","2727王品","110/07/13","元大-楊梅",1,16,-15
"24081","2727王品","110/07/13","統一-竹南",11,0,11
"24082","2727王品","110/07/13","凱基-高美館",2,15,-13
"24083","2727王品","110/07/13","日盛-士林",12,2,10
"24084","2727王品","110/07/13","美商高盛",2,14,-12
"24085","2727王品","110/07/13","統一-敦南",10,0,10
"24086","2727王品","110/07/13","統一-平鎮",1,13,-12
"24087","2727王品","110/07/13","中國信託",15,5,10
"24088","2727王品","110/07/13","兆豐-台中港",4,16,-12
"24089","2727王品","110/07/13","兆豐-竹北",13,3,10
"24090","2727王品","110/07/13","凱基-八德",1,13,-12
"24091","1570力肯","110/07/13","新光",115,11,104
"24092","1570力肯","110/07/13","元大-北三重",0,162,-162
"24093","1570力肯","110/07/13","群益金鼎-高雄",54,0,54
"24094","1570力肯","110/07/13","元大-大灣",0,25,-25
"24095","1570力肯","110/07/13","國票-新莊",22,0,22
"24096","1570力肯","110/07/13","永豐金-苓雅",0,22,-22
"24097","1570力肯","110/07/13","日盛-桃園",12,0,12
"24098","1570力肯","110/07/13","永豐金-永康",0,19,-19
"24099","1570力肯","110/07/13","元大-高雄",12,0,12
"24100","1570力肯","110/07/13","富邦-員林",0,15,-15
"24101","1570力肯","110/07/13","合庫-自強",11,0,11
"24102","1570力肯","110/07/13","凱基-台南",0,11,-11
"24103","1570力肯","110/07/13","摩根大通",26,15,11
"24104","1570力肯","110/07/13","日盛-竹北",0,10,-10
"24105","1570力肯","110/07/13","永豐金-中盛",11,0,11
"24106","1570力肯","110/07/13","國票-九鼎",0,10,-10
"24107","1570力肯","110/07/13","兆豐-台中港",10,0,10
"24108","1570力肯","110/07/13","凱基-桃園",0,10,-10
"24109","1570力肯","110/07/13","國泰-松江",9,0,9
"24110","1570力肯","110/07/13","凱基-新豐",0,10,-10
"24111","1570力肯","110/07/13","元大-新盛",9,0,9
"24112","1570力肯","110/07/13","元大-學甲",0,10,-10
"24113","1570力肯","110/07/13","元富-緯城",6,0,6
"24114","1570力肯","110/07/13","群益金鼎-東湖",1,10,-9
"24115","1570力肯","110/07/13","統一-三重",5,0,5
"24116","1570力肯","110/07/13","大昌",0,6,-6
"24117","1570力肯","110/07/13","元大-前金",5,0,5
"24118","1570力肯","110/07/13","元大-土城學府",0,6,-6
"24119","1570力肯","110/07/13","永豐金證券",5,0,5
"24120","1570力肯","110/07/13","統一",0,5,-5
"24121","6180橘子","110/07/13","摩根大通",119,0,119
"24122","6180橘子","110/07/13","元大-崇德",2,61,-59
"24123","6180橘子","110/07/13","美商高盛",96,0,96
"24124","6180橘子","110/07/13","康和-台中",0,51,-51
"24125","6180橘子","110/07/13","新加坡商瑞銀",86,7,79
"24126","6180橘子","110/07/13","康和-台北",0,50,-50
"24127","6180橘子","110/07/13","元大-和平",40,0,40
"24128","6180橘子","110/07/13","元富-潮州",0,40,-40
"24129","6180橘子","110/07/13","凱基-台北",83,47,36
"24130","6180橘子","110/07/13","日盛-永康",0,26,-26
"24131","6180橘子","110/07/13","美林",39,5,34
"24132","6180橘子","110/07/13","永豐金-中正",0,24,-24
"24133","6180橘子","110/07/13","富邦-新竹華信",31,2,29
"24134","6180橘子","110/07/13","國泰-板橋",2,25,-23
"24135","6180橘子","110/07/13","統一-南京",21,0,21
"24136","6180橘子","110/07/13","日盛-大墩",0,20,-20
"24137","6180橘子","110/07/13","富邦-陽明",24,3,21
"24138","6180橘子","110/07/13","元大-草屯",13,32,-19
"24139","6180橘子","110/07/13","大昌-樹林",21,1,20
"24140","6180橘子","110/07/13","元富-林園",1,18,-17
"24141","6180橘子","110/07/13","花旗環球",19,0,19
"24142","6180橘子","110/07/13","新光-新竹",1,18,-17
"24143","6180橘子","110/07/13","華南永昌-台南",19,0,19
"24144","6180橘子","110/07/13","元大-土城永寧",0,17,-17
"24145","6180橘子","110/07/13","福勝",14,0,14
"24146","6180橘子","110/07/13","國泰-新莊",3,19,-16
"24147","6180橘子","110/07/13","富邦-嘉義",12,1,11
"24148","6180橘子","110/07/13","中國信託-永康",6,21,-15
"24149","6180橘子","110/07/13","元大-板橋三民",11,0,11
"24150","6180橘子","110/07/13","凱基-東港",1,15,-14
"24151","2390云辰","110/07/13","新加坡商瑞銀",562,75,487
"24152","2390云辰","110/07/13","大展-台南",0,532,-532
"24153","2390云辰","110/07/13","台灣摩根士丹利",330,155,175
"24154","2390云辰","110/07/13","凱基-台北",668,854,-186
"24155","2390云辰","110/07/13","兆豐-公益",126,25,101
"24156","2390云辰","110/07/13","凱基-三重",12,172,-160
"24157","2390云辰","110/07/13","元富-中港",100,2,98
"24158","2390云辰","110/07/13","兆豐-忠孝",4,161,-157
"24159","2390云辰","110/07/13","統一-新台中",106,9,97
"24160","2390云辰","110/07/13","元大-士林",19,170,-151
"24161","2390云辰","110/07/13","中國信託-松江",81,11,70
"24162","2390云辰","110/07/13","臺銀-新竹",14,117,-103
"24163","2390云辰","110/07/13","日盛-板橋",72,3,69
"24164","2390云辰","110/07/13","國票-台中",4,102,-98
"24165","2390云辰","110/07/13","日盛-和美",57,0,57
"24166","2390云辰","110/07/13","新光",147,232,-85
"24167","2390云辰","110/07/13","永豐金-桃園",88,36,52
"24168","2390云辰","110/07/13","致和-崇德",2,70,-68
"24169","2390云辰","110/07/13","玉山-士林",54,4,50
"24170","2390云辰","110/07/13","群益金鼎-屏東",2,70,-68
"24171","2390云辰","110/07/13","富邦-仁愛",56,6,50
"24172","2390云辰","110/07/13","元大-大里",35,98,-63
"24173","2390云辰","110/07/13","第一金-豐原",50,1,49
"24174","2390云辰","110/07/13","元大-萬華",35,94,-59
"24175","2390云辰","110/07/13","摩根大通",502,453,49
"24176","2390云辰","110/07/13","元富-吉利",2,60,-58
"24177","2390云辰","110/07/13","凱基-松山",61,13,48
"24178","2390云辰","110/07/13","兆豐-新竹",3,53,-50
"24179","2390云辰","110/07/13","大昌",64,22,42
"24180","2390云辰","110/07/13","富邦-嘉義",65,108,-43
"24181","2363矽統","110/07/13","凱基-南崁",2133,63,2070
"24182","2363矽統","110/07/13","凱基-幸福",36,4048,-4012
"24183","2363矽統","110/07/13","國泰-敦南",2195,1617,578
"24184","2363矽統","110/07/13","統一",192,3325,-3133
"24185","2363矽統","110/07/13","中農",670,139,531
"24186","2363矽統","110/07/13","新加坡商瑞銀",1000,2747,-1747
"24187","2363矽統","110/07/13","康和-台中",638,154,484
"24188","2363矽統","110/07/13","凱基-台北",5359,6609,-1250
"24189","2363矽統","110/07/13","群益金鼎-三民",577,137,440
"24190","2363矽統","110/07/13","摩根大通",1930,2858,-928
"24191","2363矽統","110/07/13","台新-屏東",510,88,422
"24192","2363矽統","110/07/13","港商野村",960,1679,-719
"24193","2363矽統","110/07/13","德信-中正",455,67,388
"24194","2363矽統","110/07/13","兆豐-復興",25,705,-680
"24195","2363矽統","110/07/13","日盛-竹北",365,70,295
"24196","2363矽統","110/07/13","統一-仁愛",114,755,-641
"24197","2363矽統","110/07/13","元大-佳里",452,189,263
"24198","2363矽統","110/07/13","統一-敦南",29,638,-609
"24199","2363矽統","110/07/13","國票-博愛",296,38,258
"24200","2363矽統","110/07/13","統一-土城",100,704,-604
"24201","2363矽統","110/07/13","元大-萬華",340,95,245
"24202","2363矽統","110/07/13","統一-城中",116,676,-560
"24203","2363矽統","110/07/13","新光",1259,1031,228
"24204","2363矽統","110/07/13","永豐金證券",306,859,-553
"24205","2363矽統","110/07/13","元富-成功",323,96,227
"24206","2363矽統","110/07/13","元富",54,567,-513
"24207","2363矽統","110/07/13","豐農",228,23,205
"24208","2363矽統","110/07/13","瑞士信貸",202,666,-464
"24209","2363矽統","110/07/13","台灣企銀-岡山",186,4,182
"24210","2363矽統","110/07/13","永豐金-嘉義",67,468,-401
"24211","8112至上","110/07/13","摩根大通",688,296,392
"24212","8112至上","110/07/13","國票-中和",0,401,-401
"24213","8112至上","110/07/13","港商野村",344,145,199
"24214","8112至上","110/07/13","永豐金-板盛",0,205,-205
"24215","8112至上","110/07/13","兆豐-公益",195,5,190
"24216","8112至上","110/07/13","凱基-五股",43,155,-112
"24217","8112至上","110/07/13","台灣摩根士丹利",183,0,183
"24218","8112至上","110/07/13","凱基-市政",0,100,-100
"24219","8112至上","110/07/13","群益金鼎-敦南",153,2,151
"24220","8112至上","110/07/13","元大-大里德芳",1,92,-91
"24221","8112至上","110/07/13","臺銀-金山",146,26,120
"24222","8112至上","110/07/13","玉山-桃園",26,110,-84
"24223","8112至上","110/07/13","臺銀",133,19,114
"24224","8112至上","110/07/13","兆豐-天母",0,81,-81
"24225","8112至上","110/07/13","合庫-台中",115,6,109
"24226","8112至上","110/07/13","凱基-城中",3,84,-81
"24227","8112至上","110/07/13","亞東-板橋",134,26,108
"24228","8112至上","110/07/13","日盛-新莊",9,85,-76
"24229","8112至上","110/07/13","凱基-台北",414,326,88
"24230","8112至上","110/07/13","日盛-台中",2,64,-62
"24231","8112至上","110/07/13","新加坡商瑞銀",181,100,81
"24232","8112至上","110/07/13","日盛-中壢",3,64,-61
"24233","8112至上","110/07/13","國泰-敦南",108,31,77
"24234","8112至上","110/07/13","元大-台中",2,59,-57
"24235","8112至上","110/07/13","第一金-華江",77,4,73
"24236","8112至上","110/07/13","元大-雙和",7,64,-57
"24237","8112至上","110/07/13","永豐金-內湖",73,1,72
"24238","8112至上","110/07/13","元大-高雄",8,62,-54
"24239","8112至上","110/07/13","元大-永和",68,1,67
"24240","8112至上","110/07/13","元大-館前",2,55,-53
"24241","2929淘帝","110/07/13","玉山-新竹",130,0,130
"24242","2929淘帝","110/07/13","美商高盛",0,177,-177
"24243","2929淘帝","110/07/13","臺銀-民權",60,0,60
"24244","2929淘帝","110/07/13","凱基-台北",6,80,-74
"24245","2929淘帝","110/07/13","新百王",31,0,31
"24246","2929淘帝","110/07/13","元富-大裕",0,49,-49
"24247","2929淘帝","110/07/13","日盛-園區",30,0,30
"24248","2929淘帝","110/07/13","國泰-館前",3,51,-48
"24249","2929淘帝","110/07/13","元大-南投",31,1,30
"24250","2929淘帝","110/07/13","凱基-中壢",0,41,-41
"24251","2929淘帝","110/07/13","兆豐-忠孝",28,0,28
"24252","2929淘帝","110/07/13","港商野村",21,55,-34
"24253","2929淘帝","110/07/13","元大-民生",28,0,28
"24254","2929淘帝","110/07/13","華南永昌-南京",2,34,-32
"24255","2929淘帝","110/07/13","合庫-高雄",27,0,27
"24256","2929淘帝","110/07/13","群益金鼎-土城",0,30,-30
"24257","2929淘帝","110/07/13","凱基-豐中",27,0,27
"24258","2929淘帝","110/07/13","富邦-南屯",0,22,-22
"24259","2929淘帝","110/07/13","新光",21,4,17
"24260","2929淘帝","110/07/13","第一金-豐原",0,20,-20
"24261","2929淘帝","110/07/13","元大-天母",17,0,17
"24262","2929淘帝","110/07/13","元大-屏南",6,26,-20
"24263","2929淘帝","110/07/13","永興",14,0,14
"24264","2929淘帝","110/07/13","永豐金-敦南",1,21,-20
"24265","2929淘帝","110/07/13","富邦-台北",12,0,12
"24266","2929淘帝","110/07/13","凱基-三重",2,21,-19
"24267","2929淘帝","110/07/13","元大-永和",12,0,12
"24268","2929淘帝","110/07/13","富邦-仁愛",7,25,-18
"24269","2929淘帝","110/07/13","國票-天祥",11,0,11
"24270","2929淘帝","110/07/13","元大-北投",0,16,-16
"24271","5410國眾","110/07/13","兆豐-城中",274,0,274
"24272","5410國眾","110/07/13","元富-嘉義",0,103,-103
"24273","5410國眾","110/07/13","新光",50,4,46
"24274","5410國眾","110/07/13","凱基-台北",0,50,-50
"24275","5410國眾","110/07/13","國泰-台中",26,0,26
"24276","5410國眾","110/07/13","瑞士信貸",0,31,-31
"24277","5410國眾","110/07/13","新加坡商瑞銀",22,0,22
"24278","5410國眾","110/07/13","台新-新莊",0,27,-27
"24279","5410國眾","110/07/13","光和-嘉義",20,0,20
"24280","5410國眾","110/07/13","元大-汐止",0,20,-20
"24281","5410國眾","110/07/13","凱基-竹北",17,0,17
"24282","5410國眾","110/07/13","亞東-新竹",0,17,-17
"24283","5410國眾","110/07/13","新光-桃園",15,0,15
"24284","5410國眾","110/07/13","元大-南勢角",0,13,-13
"24285","5410國眾","110/07/13","凱基-台東",14,0,14
"24286","5410國眾","110/07/13","台新-台南",0,12,-12
"24287","5410國眾","110/07/13","富邦-竹北",11,0,11
"24288","5410國眾","110/07/13","中國信託",0,11,-11
"24289","5410國眾","110/07/13","元富-同大",10,0,10
"24290","5410國眾","110/07/13","華南永昌",0,11,-11
"24291","5410國眾","110/07/13","國泰-敦南",24,15,9
"24292","5410國眾","110/07/13","臺銀-臺南",0,10,-10
"24293","5410國眾","110/07/13","日盛-內湖",7,0,7
"24294","5410國眾","110/07/13","台灣企銀-民雄",0,10,-10
"24295","5410國眾","110/07/13","台新-左楠",7,0,7
"24296","5410國眾","110/07/13","高橋",0,10,-10
"24297","5410國眾","110/07/13","元大-新盛",18,12,6
"24298","5410國眾","110/07/13","康和-嘉義",0,10,-10
"24299","5410國眾","110/07/13","統一",5,0,5
"24300","5410國眾","110/07/13","凱基-基隆",0,10,-10
"24301","2841台開","110/07/13","中國信託-高雄",251,50,201
"24302","2841台開","110/07/13","兆豐-公益",0,177,-177
"24303","2841台開","110/07/13","日盛證券",210,13,197
"24304","2841台開","110/07/13","日進",0,152,-152
"24305","2841台開","110/07/13","第一金-台中",55,0,55
"24306","2841台開","110/07/13","港商野村",0,109,-109
"24307","2841台開","110/07/13","國泰-板橋",46,0,46
"24308","2841台開","110/07/13","日盛-信義",0,103,-103
"24309","2841台開","110/07/13","國泰-館前",48,3,45
"24310","2841台開","110/07/13","國泰-敦南",11,75,-64
"24311","2841台開","110/07/13","華南永昌-新莊",45,0,45
"24312","2841台開","110/07/13","永興",0,50,-50
"24313","2841台開","110/07/13","日盛-園區",42,0,42
"24314","2841台開","110/07/13","永豐金-敦南",61,104,-43
"24315","2841台開","110/07/13","台新證券",32,0,32
"24316","2841台開","110/07/13","富邦-台南",0,42,-42
"24317","2841台開","110/07/13","台新-高雄",32,2,30
"24318","2841台開","110/07/13","國票-安和",0,30,-30
"24319","2841台開","110/07/13","豐農",23,0,23
"24320","2841台開","110/07/13","元大-桃園",0,25,-25
"24321","2841台開","110/07/13","合庫-嘉義",20,0,20
"24322","2841台開","110/07/13","新光",8,32,-24
"24323","2841台開","110/07/13","華南永昌-高雄",20,0,20
"24324","2841台開","110/07/13","元大-仁愛",0,24,-24
"24325","2841台開","110/07/13","元大-樹林",16,0,16
"24326","2841台開","110/07/13","日盛-中和",0,20,-20
"24327","2841台開","110/07/13","第一金-華江",15,2,13
"24328","2841台開","110/07/13","元富",0,20,-20
"24329","2841台開","110/07/13","美商高盛",12,0,12
"24330","2841台開","110/07/13","富邦-宜蘭",0,20,-20
"24331","6207雷科","110/07/13","元大-高雄",121,0,121
"24332","6207雷科","110/07/13","華南永昌-朴子",1,60,-59
"24333","6207雷科","110/07/13","第一金-新興",20,0,20
"24334","6207雷科","110/07/13","元大-南海",0,36,-36
"24335","6207雷科","110/07/13","元富-三重",20,0,20
"24336","6207雷科","110/07/13","凱基-土城",0,35,-35
"24337","6207雷科","110/07/13","元大-林園",15,0,15
"24338","6207雷科","110/07/13","台灣企銀",0,20,-20
"24339","6207雷科","110/07/13","元大-金華",16,1,15
"24340","6207雷科","110/07/13","群益金鼎-丹鳳",0,20,-20
"24341","6207雷科","110/07/13","日盛證券",10,0,10
"24342","6207雷科","110/07/13","元大-博愛",0,17,-17
"24343","6207雷科","110/07/13","統一-台中",10,0,10
"24344","6207雷科","110/07/13","元大-北港",0,13,-13
"24345","6207雷科","110/07/13","群益金鼎-土城",10,0,10
"24346","6207雷科","110/07/13","新加坡商瑞銀",0,12,-12
"24347","6207雷科","110/07/13","群益金鼎-桃園",10,0,10
"24348","6207雷科","110/07/13","凱基-台北",4,16,-12
"24349","6207雷科","110/07/13","永豐金-新莊",10,0,10
"24350","6207雷科","110/07/13","日茂-埔里",0,11,-11
"24351","6207雷科","110/07/13","永豐金-新店",10,0,10
"24352","6207雷科","110/07/13","元大-莒光",0,11,-11
"24353","6207雷科","110/07/13","元大證券",9,0,9
"24354","6207雷科","110/07/13","統一-新竹",0,10,-10
"24355","6207雷科","110/07/13","日盛-木柵",9,1,8
"24356","6207雷科","110/07/13","元大-西螺",0,10,-10
"24357","6207雷科","110/07/13","兆豐-來福",8,0,8
"24358","6207雷科","110/07/13","康和-台中",0,8,-8
"24359","6207雷科","110/07/13","新光",7,0,7
"24360","6207雷科","110/07/13","兆豐-高雄",0,6,-6
"24361","3679新至陞","110/07/13","永豐金證券",50,0,50
"24362","3679新至陞","110/07/13","摩根大通",2,25,-23
"24363","3679新至陞","110/07/13","國泰-桃園",22,0,22
"24364","3679新至陞","110/07/13","元大-成功",0,22,-22
"24365","3679新至陞","110/07/13","台中銀-員林",11,0,11
"24366","3679新至陞","110/07/13","富邦-板橋",1,19,-18
"24367","3679新至陞","110/07/13","元大-文心興安",8,0,8
"24368","3679新至陞","110/07/13","日盛-新莊",0,10,-10
"24369","3679新至陞","110/07/13","美商高盛",6,0,6
"24370","3679新至陞","110/07/13","台新-台中",0,10,-10
"24371","3679新至陞","110/07/13","台新-高雄",6,0,6
"24372","3679新至陞","110/07/13","永豐金-新竹",0,8,-8
"24373","3679新至陞","110/07/13","凱基-台北",18,12,6
"24374","3679新至陞","110/07/13","瑞士信貸",12,19,-7
"24375","3679新至陞","110/07/13","日盛-復興",5,0,5
"24376","3679新至陞","110/07/13","統一-南京",0,7,-7
"24377","3679新至陞","110/07/13","(牛牛牛)亞-鑫豐",4,0,4
"24378","3679新至陞","110/07/13","凱基-新莊",0,7,-7
"24379","3679新至陞","110/07/13","元富-大昌",3,0,3
"24380","3679新至陞","110/07/13","新加坡商瑞銀",0,6,-6
"24381","3679新至陞","110/07/13","富邦-台北",3,0,3
"24382","3679新至陞","110/07/13","合庫-自強",0,5,-5
"24383","3679新至陞","110/07/13","日盛-樹林",2,0,2
"24384","3679新至陞","110/07/13","富邦-桃園",0,5,-5
"24385","3679新至陞","110/07/13","宏遠-光隆",2,0,2
"24386","3679新至陞","110/07/13","永豐金-潮州",0,4,-4
"24387","3679新至陞","110/07/13","美林",3,1,2
"24388","3679新至陞","110/07/13","臺銀-臺南",0,3,-3
"24389","3679新至陞","110/07/13","第一金-中壢",2,0,2
"24390","3679新至陞","110/07/13","元大-六合",0,3,-3
"24391","2727王品","110/07/13","富邦-台北",43,3,40
"24392","2727王品","110/07/13","台灣摩根士丹利",15,97,-82
"24393","2727王品","110/07/13","元大-基隆孝二",40,0,40
"24394","2727王品","110/07/13","玉山-台南",5,57,-52
"24395","2727王品","110/07/13","國票-新莊",40,1,39
"24396","2727王品","110/07/13","新加坡商瑞銀",0,48,-48
"24397","2727王品","110/07/13","第一金-豐原",66,42,24
"24398","2727王品","110/07/13","凱基-台北",41,77,-36
"24399","2727王品","110/07/13","永豐金-大園",34,10,24
"24400","2727王品","110/07/13","永豐金-永康",0,22,-22
"24401","2727王品","110/07/13","元大-北屯",22,0,22
"24402","2727王品","110/07/13","統一-台中",2,22,-20
"24403","2727王品","110/07/13","元大-東蘆",26,7,19
"24404","2727王品","110/07/13","國泰-台中",21,39,-18
"24405","2727王品","110/07/13","永豐金-萬盛",13,1,12
"24406","2727王品","110/07/13","合庫-彰化",3,20,-17
"24407","2727王品","110/07/13","日盛-嘉義",11,0,11
"24408","2727王品","110/07/13","港商野村",13,30,-17
"24409","2727王品","110/07/13","日盛-八德",11,0,11
"24410","2727王品","110/07/13","元大-楊梅",1,16,-15
"24411","2727王品","110/07/13","統一-竹南",11,0,11
"24412","2727王品","110/07/13","凱基-高美館",2,15,-13
"24413","2727王品","110/07/13","日盛-士林",12,2,10
"24414","2727王品","110/07/13","美商高盛",2,14,-12
"24415","2727王品","110/07/13","統一-敦南",10,0,10
"24416","2727王品","110/07/13","統一-平鎮",1,13,-12
"24417","2727王品","110/07/13","中國信託",15,5,10
"24418","2727王品","110/07/13","兆豐-台中港",4,16,-12
"24419","2727王品","110/07/13","兆豐-竹北",13,3,10
"24420","2727王品","110/07/13","凱基-八德",1,13,-12
"24421","1570力肯","110/07/13","新光",115,11,104
"24422","1570力肯","110/07/13","元大-北三重",0,162,-162
"24423","1570力肯","110/07/13","群益金鼎-高雄",54,0,54
"24424","1570力肯","110/07/13","元大-大灣",0,25,-25
"24425","1570力肯","110/07/13","國票-新莊",22,0,22
"24426","1570力肯","110/07/13","永豐金-苓雅",0,22,-22
"24427","1570力肯","110/07/13","日盛-桃園",12,0,12
"24428","1570力肯","110/07/13","永豐金-永康",0,19,-19
"24429","1570力肯","110/07/13","元大-高雄",12,0,12
"24430","1570力肯","110/07/13","富邦-員林",0,15,-15
"24431","1570力肯","110/07/13","合庫-自強",11,0,11
"24432","1570力肯","110/07/13","凱基-台南",0,11,-11
"24433","1570力肯","110/07/13","摩根大通",26,15,11
"24434","1570力肯","110/07/13","日盛-竹北",0,10,-10
"24435","1570力肯","110/07/13","永豐金-中盛",11,0,11
"24436","1570力肯","110/07/13","國票-九鼎",0,10,-10
"24437","1570力肯","110/07/13","兆豐-台中港",10,0,10
"24438","1570力肯","110/07/13","凱基-桃園",0,10,-10
"24439","1570力肯","110/07/13","國泰-松江",9,0,9
"24440","1570力肯","110/07/13","凱基-新豐",0,10,-10
"24441","1570力肯","110/07/13","元大-新盛",9,0,9
"24442","1570力肯","110/07/13","元大-學甲",0,10,-10
"24443","1570力肯","110/07/13","元富-緯城",6,0,6
"24444","1570力肯","110/07/13","群益金鼎-東湖",1,10,-9
"24445","1570力肯","110/07/13","統一-三重",5,0,5
"24446","1570力肯","110/07/13","大昌",0,6,-6
"24447","1570力肯","110/07/13","元大-前金",5,0,5
"24448","1570力肯","110/07/13","元大-土城學府",0,6,-6
"24449","1570力肯","110/07/13","永豐金證券",5,0,5
"24450","1570力肯","110/07/13","統一",0,5,-5
"24451","6180橘子","110/07/13","摩根大通",119,0,119
"24452","6180橘子","110/07/13","元大-崇德",2,61,-59
"24453","6180橘子","110/07/13","美商高盛",96,0,96
"24454","6180橘子","110/07/13","康和-台中",0,51,-51
"24455","6180橘子","110/07/13","新加坡商瑞銀",86,7,79
"24456","6180橘子","110/07/13","康和-台北",0,50,-50
"24457","6180橘子","110/07/13","元大-和平",40,0,40
"24458","6180橘子","110/07/13","元富-潮州",0,40,-40
"24459","6180橘子","110/07/13","凱基-台北",83,47,36
"24460","6180橘子","110/07/13","日盛-永康",0,26,-26
"24461","6180橘子","110/07/13","美林",39,5,34
"24462","6180橘子","110/07/13","永豐金-中正",0,24,-24
"24463","6180橘子","110/07/13","富邦-新竹華信",31,2,29
"24464","6180橘子","110/07/13","國泰-板橋",2,25,-23
"24465","6180橘子","110/07/13","統一-南京",21,0,21
"24466","6180橘子","110/07/13","日盛-大墩",0,20,-20
"24467","6180橘子","110/07/13","富邦-陽明",24,3,21
"24468","6180橘子","110/07/13","元大-草屯",13,32,-19
"24469","6180橘子","110/07/13","大昌-樹林",21,1,20
"24470","6180橘子","110/07/13","元富-林園",1,18,-17
"24471","6180橘子","110/07/13","花旗環球",19,0,19
"24472","6180橘子","110/07/13","新光-新竹",1,18,-17
"24473","6180橘子","110/07/13","華南永昌-台南",19,0,19
"24474","6180橘子","110/07/13","元大-土城永寧",0,17,-17
"24475","6180橘子","110/07/13","福勝",14,0,14
"24476","6180橘子","110/07/13","國泰-新莊",3,19,-16
"24477","6180橘子","110/07/13","富邦-嘉義",12,1,11
"24478","6180橘子","110/07/13","中國信託-永康",6,21,-15
"24479","6180橘子","110/07/13","元大-板橋三民",11,0,11
"24480","6180橘子","110/07/13","凱基-東港",1,15,-14
"24481","2390云辰","110/07/13","新加坡商瑞銀",562,75,487
"24482","2390云辰","110/07/13","大展-台南",0,532,-532
"24483","2390云辰","110/07/13","台灣摩根士丹利",330,155,175
"24484","2390云辰","110/07/13","凱基-台北",668,854,-186
"24485","2390云辰","110/07/13","兆豐-公益",126,25,101
"24486","2390云辰","110/07/13","凱基-三重",12,172,-160
"24487","2390云辰","110/07/13","元富-中港",100,2,98
"24488","2390云辰","110/07/13","兆豐-忠孝",4,161,-157
"24489","2390云辰","110/07/13","統一-新台中",106,9,97
"24490","2390云辰","110/07/13","元大-士林",19,170,-151
"24491","2390云辰","110/07/13","中國信託-松江",81,11,70
"24492","2390云辰","110/07/13","臺銀-新竹",14,117,-103
"24493","2390云辰","110/07/13","日盛-板橋",72,3,69
"24494","2390云辰","110/07/13","國票-台中",4,102,-98
"24495","2390云辰","110/07/13","日盛-和美",57,0,57
"24496","2390云辰","110/07/13","新光",147,232,-85
"24497","2390云辰","110/07/13","永豐金-桃園",88,36,52
"24498","2390云辰","110/07/13","致和-崇德",2,70,-68
"24499","2390云辰","110/07/13","玉山-士林",54,4,50
"24500","2390云辰","110/07/13","群益金鼎-屏東",2,70,-68
"24501","2390云辰","110/07/13","富邦-仁愛",56,6,50
"24502","2390云辰","110/07/13","元大-大里",35,98,-63
"24503","2390云辰","110/07/13","第一金-豐原",50,1,49
"24504","2390云辰","110/07/13","元大-萬華",35,94,-59
"24505","2390云辰","110/07/13","摩根大通",502,453,49
"24506","2390云辰","110/07/13","元富-吉利",2,60,-58
"24507","2390云辰","110/07/13","凱基-松山",61,13,48
"24508","2390云辰","110/07/13","兆豐-新竹",3,53,-50
"24509","2390云辰","110/07/13","大昌",64,22,42
"24510","2390云辰","110/07/13","富邦-嘉義",65,108,-43
"24511","2363矽統","110/07/13","凱基-南崁",2133,63,2070
"24512","2363矽統","110/07/13","凱基-幸福",36,4048,-4012
"24513","2363矽統","110/07/13","國泰-敦南",2195,1617,578
"24514","2363矽統","110/07/13","統一",192,3325,-3133
"24515","2363矽統","110/07/13","中農",670,139,531
"24516","2363矽統","110/07/13","新加坡商瑞銀",1000,2747,-1747
"24517","2363矽統","110/07/13","康和-台中",638,154,484
"24518","2363矽統","110/07/13","凱基-台北",5359,6609,-1250
"24519","2363矽統","110/07/13","群益金鼎-三民",577,137,440
"24520","2363矽統","110/07/13","摩根大通",1930,2858,-928
"24521","2363矽統","110/07/13","台新-屏東",510,88,422
"24522","2363矽統","110/07/13","港商野村",960,1679,-719
"24523","2363矽統","110/07/13","德信-中正",455,67,388
"24524","2363矽統","110/07/13","兆豐-復興",25,705,-680
"24525","2363矽統","110/07/13","日盛-竹北",365,70,295
"24526","2363矽統","110/07/13","統一-仁愛",114,755,-641
"24527","2363矽統","110/07/13","元大-佳里",452,189,263
"24528","2363矽統","110/07/13","統一-敦南",29,638,-609
"24529","2363矽統","110/07/13","國票-博愛",296,38,258
"24530","2363矽統","110/07/13","統一-土城",100,704,-604
"24531","2363矽統","110/07/13","元大-萬華",340,95,245
"24532","2363矽統","110/07/13","統一-城中",116,676,-560
"24533","2363矽統","110/07/13","新光",1259,1031,228
"24534","2363矽統","110/07/13","永豐金證券",306,859,-553
"24535","2363矽統","110/07/13","元富-成功",323,96,227
"24536","2363矽統","110/07/13","元富",54,567,-513
"24537","2363矽統","110/07/13","豐農",228,23,205
"24538","2363矽統","110/07/13","瑞士信貸",202,666,-464
"24539","2363矽統","110/07/13","台灣企銀-岡山",186,4,182
"24540","2363矽統","110/07/13","永豐金-嘉義",67,468,-401
"24541","8112至上","110/07/13","摩根大通",688,296,392
"24542","8112至上","110/07/13","國票-中和",0,401,-401
"24543","8112至上","110/07/13","港商野村",344,145,199
"24544","8112至上","110/07/13","永豐金-板盛",0,205,-205
"24545","8112至上","110/07/13","兆豐-公益",195,5,190
"24546","8112至上","110/07/13","凱基-五股",43,155,-112
"24547","8112至上","110/07/13","台灣摩根士丹利",183,0,183
"24548","8112至上","110/07/13","凱基-市政",0,100,-100
"24549","8112至上","110/07/13","群益金鼎-敦南",153,2,151
"24550","8112至上","110/07/13","元大-大里德芳",1,92,-91
"24551","8112至上","110/07/13","臺銀-金山",146,26,120
"24552","8112至上","110/07/13","玉山-桃園",26,110,-84
"24553","8112至上","110/07/13","臺銀",133,19,114
"24554","8112至上","110/07/13","兆豐-天母",0,81,-81
"24555","8112至上","110/07/13","合庫-台中",115,6,109
"24556","8112至上","110/07/13","凱基-城中",3,84,-81
"24557","8112至上","110/07/13","亞東-板橋",134,26,108
"24558","8112至上","110/07/13","日盛-新莊",9,85,-76
"24559","8112至上","110/07/13","凱基-台北",414,326,88
"24560","8112至上","110/07/13","日盛-台中",2,64,-62
"24561","8112至上","110/07/13","新加坡商瑞銀",181,100,81
"24562","8112至上","110/07/13","日盛-中壢",3,64,-61
"24563","8112至上","110/07/13","國泰-敦南",108,31,77
"24564","8112至上","110/07/13","元大-台中",2,59,-57
"24565","8112至上","110/07/13","第一金-華江",77,4,73
"24566","8112至上","110/07/13","元大-雙和",7,64,-57
"24567","8112至上","110/07/13","永豐金-內湖",73,1,72
"24568","8112至上","110/07/13","元大-高雄",8,62,-54
"24569","8112至上","110/07/13","元大-永和",68,1,67
"24570","8112至上","110/07/13","元大-館前",2,55,-53
"24571","2929淘帝","110/07/13","玉山-新竹",130,0,130
"24572","2929淘帝","110/07/13","美商高盛",0,177,-177
"24573","2929淘帝","110/07/13","臺銀-民權",60,0,60
"24574","2929淘帝","110/07/13","凱基-台北",6,80,-74
"24575","2929淘帝","110/07/13","新百王",31,0,31
"24576","2929淘帝","110/07/13","元富-大裕",0,49,-49
"24577","2929淘帝","110/07/13","日盛-園區",30,0,30
"24578","2929淘帝","110/07/13","國泰-館前",3,51,-48
"24579","2929淘帝","110/07/13","元大-南投",31,1,30
"24580","2929淘帝","110/07/13","凱基-中壢",0,41,-41
"24581","2929淘帝","110/07/13","兆豐-忠孝",28,0,28
"24582","2929淘帝","110/07/13","港商野村",21,55,-34
"24583","2929淘帝","110/07/13","元大-民生",28,0,28
"24584","2929淘帝","110/07/13","華南永昌-南京",2,34,-32
"24585","2929淘帝","110/07/13","合庫-高雄",27,0,27
"24586","2929淘帝","110/07/13","群益金鼎-土城",0,30,-30
"24587","2929淘帝","110/07/13","凱基-豐中",27,0,27
"24588","2929淘帝","110/07/13","富邦-南屯",0,22,-22
"24589","2929淘帝","110/07/13","新光",21,4,17
"24590","2929淘帝","110/07/13","第一金-豐原",0,20,-20
"24591","2929淘帝","110/07/13","元大-天母",17,0,17
"24592","2929淘帝","110/07/13","元大-屏南",6,26,-20
"24593","2929淘帝","110/07/13","永興",14,0,14
"24594","2929淘帝","110/07/13","永豐金-敦南",1,21,-20
"24595","2929淘帝","110/07/13","富邦-台北",12,0,12
"24596","2929淘帝","110/07/13","凱基-三重",2,21,-19
"24597","2929淘帝","110/07/13","元大-永和",12,0,12
"24598","2929淘帝","110/07/13","富邦-仁愛",7,25,-18
"24599","2929淘帝","110/07/13","國票-天祥",11,0,11
"24600","2929淘帝","110/07/13","元大-北投",0,16,-16
"24601","5410國眾","110/07/13","兆豐-城中",274,0,274
"24602","5410國眾","110/07/13","元富-嘉義",0,103,-103
"24603","5410國眾","110/07/13","新光",50,4,46
"24604","5410國眾","110/07/13","凱基-台北",0,50,-50
"24605","5410國眾","110/07/13","國泰-台中",26,0,26
"24606","5410國眾","110/07/13","瑞士信貸",0,31,-31
"24607","5410國眾","110/07/13","新加坡商瑞銀",22,0,22
"24608","5410國眾","110/07/13","台新-新莊",0,27,-27
"24609","5410國眾","110/07/13","光和-嘉義",20,0,20
"24610","5410國眾","110/07/13","元大-汐止",0,20,-20
"24611","5410國眾","110/07/13","凱基-竹北",17,0,17
"24612","5410國眾","110/07/13","亞東-新竹",0,17,-17
"24613","5410國眾","110/07/13","新光-桃園",15,0,15
"24614","5410國眾","110/07/13","元大-南勢角",0,13,-13
"24615","5410國眾","110/07/13","凱基-台東",14,0,14
"24616","5410國眾","110/07/13","台新-台南",0,12,-12
"24617","5410國眾","110/07/13","富邦-竹北",11,0,11
"24618","5410國眾","110/07/13","中國信託",0,11,-11
"24619","5410國眾","110/07/13","元富-同大",10,0,10
"24620","5410國眾","110/07/13","華南永昌",0,11,-11
"24621","5410國眾","110/07/13","國泰-敦南",24,15,9
"24622","5410國眾","110/07/13","臺銀-臺南",0,10,-10
"24623","5410國眾","110/07/13","日盛-內湖",7,0,7
"24624","5410國眾","110/07/13","台灣企銀-民雄",0,10,-10
"24625","5410國眾","110/07/13","台新-左楠",7,0,7
"24626","5410國眾","110/07/13","高橋",0,10,-10
"24627","5410國眾","110/07/13","元大-新盛",18,12,6
"24628","5410國眾","110/07/13","康和-嘉義",0,10,-10
"24629","5410國眾","110/07/13","統一",5,0,5
"24630","5410國眾","110/07/13","凱基-基隆",0,10,-10
"24631","2841台開","110/07/13","中國信託-高雄",251,50,201
"24632","2841台開","110/07/13","兆豐-公益",0,177,-177
"24633","2841台開","110/07/13","日盛證券",210,13,197
"24634","2841台開","110/07/13","日進",0,152,-152
"24635","2841台開","110/07/13","第一金-台中",55,0,55
"24636","2841台開","110/07/13","港商野村",0,109,-109
"24637","2841台開","110/07/13","國泰-板橋",46,0,46
"24638","2841台開","110/07/13","日盛-信義",0,103,-103
"24639","2841台開","110/07/13","國泰-館前",48,3,45
"24640","2841台開","110/07/13","國泰-敦南",11,75,-64
"24641","2841台開","110/07/13","華南永昌-新莊",45,0,45
"24642","2841台開","110/07/13","永興",0,50,-50
"24643","2841台開","110/07/13","日盛-園區",42,0,42
"24644","2841台開","110/07/13","永豐金-敦南",61,104,-43
"24645","2841台開","110/07/13","台新證券",32,0,32
"24646","2841台開","110/07/13","富邦-台南",0,42,-42
"24647","2841台開","110/07/13","台新-高雄",32,2,30
"24648","2841台開","110/07/13","國票-安和",0,30,-30
"24649","2841台開","110/07/13","豐農",23,0,23
"24650","2841台開","110/07/13","元大-桃園",0,25,-25
"24651","2841台開","110/07/13","合庫-嘉義",20,0,20
"24652","2841台開","110/07/13","新光",8,32,-24
"24653","2841台開","110/07/13","華南永昌-高雄",20,0,20
"24654","2841台開","110/07/13","元大-仁愛",0,24,-24
"24655","2841台開","110/07/13","元大-樹林",16,0,16
"24656","2841台開","110/07/13","日盛-中和",0,20,-20
"24657","2841台開","110/07/13","第一金-華江",15,2,13
"24658","2841台開","110/07/13","元富",0,20,-20
"24659","2841台開","110/07/13","美商高盛",12,0,12
"24660","2841台開","110/07/13","富邦-宜蘭",0,20,-20
"24661","6207雷科","110/07/13","元大-高雄",121,0,121
"24662","6207雷科","110/07/13","華南永昌-朴子",1,60,-59
"24663","6207雷科","110/07/13","第一金-新興",20,0,20
"24664","6207雷科","110/07/13","元大-南海",0,36,-36
"24665","6207雷科","110/07/13","元富-三重",20,0,20
"24666","6207雷科","110/07/13","凱基-土城",0,35,-35
"24667","6207雷科","110/07/13","元大-林園",15,0,15
"24668","6207雷科","110/07/13","台灣企銀",0,20,-20
"24669","6207雷科","110/07/13","元大-金華",16,1,15
"24670","6207雷科","110/07/13","群益金鼎-丹鳳",0,20,-20
"24671","6207雷科","110/07/13","日盛證券",10,0,10
"24672","6207雷科","110/07/13","元大-博愛",0,17,-17
"24673","6207雷科","110/07/13","統一-台中",10,0,10
"24674","6207雷科","110/07/13","元大-北港",0,13,-13
"24675","6207雷科","110/07/13","群益金鼎-土城",10,0,10
"24676","6207雷科","110/07/13","新加坡商瑞銀",0,12,-12
"24677","6207雷科","110/07/13","群益金鼎-桃園",10,0,10
"24678","6207雷科","110/07/13","凱基-台北",4,16,-12
"24679","6207雷科","110/07/13","永豐金-新莊",10,0,10
"24680","6207雷科","110/07/13","日茂-埔里",0,11,-11
"24681","6207雷科","110/07/13","永豐金-新店",10,0,10
"24682","6207雷科","110/07/13","元大-莒光",0,11,-11
"24683","6207雷科","110/07/13","元大證券",9,0,9
"24684","6207雷科","110/07/13","統一-新竹",0,10,-10
"24685","6207雷科","110/07/13","日盛-木柵",9,1,8
"24686","6207雷科","110/07/13","元大-西螺",0,10,-10
"24687","6207雷科","110/07/13","兆豐-來福",8,0,8
"24688","6207雷科","110/07/13","康和-台中",0,8,-8
"24689","6207雷科","110/07/13","新光",7,0,7
"24690","6207雷科","110/07/13","兆豐-高雄",0,6,-6
"24691","3679新至陞","110/07/13","永豐金證券",50,0,50
"24692","3679新至陞","110/07/13","摩根大通",2,25,-23
"24693","3679新至陞","110/07/13","國泰-桃園",22,0,22
"24694","3679新至陞","110/07/13","元大-成功",0,22,-22
"24695","3679新至陞","110/07/13","台中銀-員林",11,0,11
"24696","3679新至陞","110/07/13","富邦-板橋",1,19,-18
"24697","3679新至陞","110/07/13","元大-文心興安",8,0,8
"24698","3679新至陞","110/07/13","日盛-新莊",0,10,-10
"24699","3679新至陞","110/07/13","美商高盛",6,0,6
"24700","3679新至陞","110/07/13","台新-台中",0,10,-10
"24701","3679新至陞","110/07/13","台新-高雄",6,0,6
"24702","3679新至陞","110/07/13","永豐金-新竹",0,8,-8
"24703","3679新至陞","110/07/13","凱基-台北",18,12,6
"24704","3679新至陞","110/07/13","瑞士信貸",12,19,-7
"24705","3679新至陞","110/07/13","日盛-復興",5,0,5
"24706","3679新至陞","110/07/13","統一-南京",0,7,-7
"24707","3679新至陞","110/07/13","(牛牛牛)亞-鑫豐",4,0,4
"24708","3679新至陞","110/07/13","凱基-新莊",0,7,-7
"24709","3679新至陞","110/07/13","元富-大昌",3,0,3
"24710","3679新至陞","110/07/13","新加坡商瑞銀",0,6,-6
"24711","3679新至陞","110/07/13","富邦-台北",3,0,3
"24712","3679新至陞","110/07/13","合庫-自強",0,5,-5
"24713","3679新至陞","110/07/13","日盛-樹林",2,0,2
"24714","3679新至陞","110/07/13","富邦-桃園",0,5,-5
"24715","3679新至陞","110/07/13","宏遠-光隆",2,0,2
"24716","3679新至陞","110/07/13","永豐金-潮州",0,4,-4
"24717","3679新至陞","110/07/13","美林",3,1,2
"24718","3679新至陞","110/07/13","臺銀-臺南",0,3,-3
"24719","3679新至陞","110/07/13","第一金-中壢",2,0,2
"24720","3679新至陞","110/07/13","元大-六合",0,3,-3
"24721","2727王品","110/07/13","富邦-台北",43,3,40
"24722","2727王品","110/07/13","台灣摩根士丹利",15,97,-82
"24723","2727王品","110/07/13","元大-基隆孝二",40,0,40
"24724","2727王品","110/07/13","玉山-台南",5,57,-52
"24725","2727王品","110/07/13","國票-新莊",40,1,39
"24726","2727王品","110/07/13","新加坡商瑞銀",0,48,-48
"24727","2727王品","110/07/13","第一金-豐原",66,42,24
"24728","2727王品","110/07/13","凱基-台北",41,77,-36
"24729","2727王品","110/07/13","永豐金-大園",34,10,24
"24730","2727王品","110/07/13","永豐金-永康",0,22,-22
"24731","2727王品","110/07/13","元大-北屯",22,0,22
"24732","2727王品","110/07/13","統一-台中",2,22,-20
"24733","2727王品","110/07/13","元大-東蘆",26,7,19
"24734","2727王品","110/07/13","國泰-台中",21,39,-18
"24735","2727王品","110/07/13","永豐金-萬盛",13,1,12
"24736","2727王品","110/07/13","合庫-彰化",3,20,-17
"24737","2727王品","110/07/13","日盛-嘉義",11,0,11
"24738","2727王品","110/07/13","港商野村",13,30,-17
"24739","2727王品","110/07/13","日盛-八德",11,0,11
"24740","2727王品","110/07/13","元大-楊梅",1,16,-15
"24741","2727王品","110/07/13","統一-竹南",11,0,11
"24742","2727王品","110/07/13","凱基-高美館",2,15,-13
"24743","2727王品","110/07/13","日盛-士林",12,2,10
"24744","2727王品","110/07/13","美商高盛",2,14,-12
"24745","2727王品","110/07/13","統一-敦南",10,0,10
"24746","2727王品","110/07/13","統一-平鎮",1,13,-12
"24747","2727王品","110/07/13","中國信託",15,5,10
"24748","2727王品","110/07/13","兆豐-台中港",4,16,-12
"24749","2727王品","110/07/13","兆豐-竹北",13,3,10
"24750","2727王品","110/07/13","凱基-八德",1,13,-12
"24751","1570力肯","110/07/13","新光",115,11,104
"24752","1570力肯","110/07/13","元大-北三重",0,162,-162
"24753","1570力肯","110/07/13","群益金鼎-高雄",54,0,54
"24754","1570力肯","110/07/13","元大-大灣",0,25,-25
"24755","1570力肯","110/07/13","國票-新莊",22,0,22
"24756","1570力肯","110/07/13","永豐金-苓雅",0,22,-22
"24757","1570力肯","110/07/13","日盛-桃園",12,0,12
"24758","1570力肯","110/07/13","永豐金-永康",0,19,-19
"24759","1570力肯","110/07/13","元大-高雄",12,0,12
"24760","1570力肯","110/07/13","富邦-員林",0,15,-15
"24761","1570力肯","110/07/13","合庫-自強",11,0,11
"24762","1570力肯","110/07/13","凱基-台南",0,11,-11
"24763","1570力肯","110/07/13","摩根大通",26,15,11
"24764","1570力肯","110/07/13","日盛-竹北",0,10,-10
"24765","1570力肯","110/07/13","永豐金-中盛",11,0,11
"24766","1570力肯","110/07/13","國票-九鼎",0,10,-10
"24767","1570力肯","110/07/13","兆豐-台中港",10,0,10
"24768","1570力肯","110/07/13","凱基-桃園",0,10,-10
"24769","1570力肯","110/07/13","國泰-松江",9,0,9
"24770","1570力肯","110/07/13","凱基-新豐",0,10,-10
"24771","1570力肯","110/07/13","元大-新盛",9,0,9
"24772","1570力肯","110/07/13","元大-學甲",0,10,-10
"24773","1570力肯","110/07/13","元富-緯城",6,0,6
"24774","1570力肯","110/07/13","群益金鼎-東湖",1,10,-9
"24775","1570力肯","110/07/13","統一-三重",5,0,5
"24776","1570力肯","110/07/13","大昌",0,6,-6
"24777","1570力肯","110/07/13","元大-前金",5,0,5
"24778","1570力肯","110/07/13","元大-土城學府",0,6,-6
"24779","1570力肯","110/07/13","永豐金證券",5,0,5
"24780","1570力肯","110/07/13","統一",0,5,-5
"24781","6180橘子","110/07/13","摩根大通",119,0,119
"24782","6180橘子","110/07/13","元大-崇德",2,61,-59
"24783","6180橘子","110/07/13","美商高盛",96,0,96
"24784","6180橘子","110/07/13","康和-台中",0,51,-51
"24785","6180橘子","110/07/13","新加坡商瑞銀",86,7,79
"24786","6180橘子","110/07/13","康和-台北",0,50,-50
"24787","6180橘子","110/07/13","元大-和平",40,0,40
"24788","6180橘子","110/07/13","元富-潮州",0,40,-40
"24789","6180橘子","110/07/13","凱基-台北",83,47,36
"24790","6180橘子","110/07/13","日盛-永康",0,26,-26
"24791","6180橘子","110/07/13","美林",39,5,34
"24792","6180橘子","110/07/13","永豐金-中正",0,24,-24
"24793","6180橘子","110/07/13","富邦-新竹華信",31,2,29
"24794","6180橘子","110/07/13","國泰-板橋",2,25,-23
"24795","6180橘子","110/07/13","統一-南京",21,0,21
"24796","6180橘子","110/07/13","日盛-大墩",0,20,-20
"24797","6180橘子","110/07/13","富邦-陽明",24,3,21
"24798","6180橘子","110/07/13","元大-草屯",13,32,-19
"24799","6180橘子","110/07/13","大昌-樹林",21,1,20
"24800","6180橘子","110/07/13","元富-林園",1,18,-17
"24801","6180橘子","110/07/13","花旗環球",19,0,19
"24802","6180橘子","110/07/13","新光-新竹",1,18,-17
"24803","6180橘子","110/07/13","華南永昌-台南",19,0,19
"24804","6180橘子","110/07/13","元大-土城永寧",0,17,-17
"24805","6180橘子","110/07/13","福勝",14,0,14
"24806","6180橘子","110/07/13","國泰-新莊",3,19,-16
"24807","6180橘子","110/07/13","富邦-嘉義",12,1,11
"24808","6180橘子","110/07/13","中國信託-永康",6,21,-15
"24809","6180橘子","110/07/13","元大-板橋三民",11,0,11
"24810","6180橘子","110/07/13","凱基-東港",1,15,-14
"24811","2390云辰","110/07/13","新加坡商瑞銀",562,75,487
"24812","2390云辰","110/07/13","大展-台南",0,532,-532
"24813","2390云辰","110/07/13","台灣摩根士丹利",330,155,175
"24814","2390云辰","110/07/13","凱基-台北",668,854,-186
"24815","2390云辰","110/07/13","兆豐-公益",126,25,101
"24816","2390云辰","110/07/13","凱基-三重",12,172,-160
"24817","2390云辰","110/07/13","元富-中港",100,2,98
"24818","2390云辰","110/07/13","兆豐-忠孝",4,161,-157
"24819","2390云辰","110/07/13","統一-新台中",106,9,97
"24820","2390云辰","110/07/13","元大-士林",19,170,-151
"24821","2390云辰","110/07/13","中國信託-松江",81,11,70
"24822","2390云辰","110/07/13","臺銀-新竹",14,117,-103
"24823","2390云辰","110/07/13","日盛-板橋",72,3,69
"24824","2390云辰","110/07/13","國票-台中",4,102,-98
"24825","2390云辰","110/07/13","日盛-和美",57,0,57
"24826","2390云辰","110/07/13","新光",147,232,-85
"24827","2390云辰","110/07/13","永豐金-桃園",88,36,52
"24828","2390云辰","110/07/13","致和-崇德",2,70,-68
"24829","2390云辰","110/07/13","玉山-士林",54,4,50
"24830","2390云辰","110/07/13","群益金鼎-屏東",2,70,-68
"24831","2390云辰","110/07/13","富邦-仁愛",56,6,50
"24832","2390云辰","110/07/13","元大-大里",35,98,-63
"24833","2390云辰","110/07/13","第一金-豐原",50,1,49
"24834","2390云辰","110/07/13","元大-萬華",35,94,-59
"24835","2390云辰","110/07/13","摩根大通",502,453,49
"24836","2390云辰","110/07/13","元富-吉利",2,60,-58
"24837","2390云辰","110/07/13","凱基-松山",61,13,48
"24838","2390云辰","110/07/13","兆豐-新竹",3,53,-50
"24839","2390云辰","110/07/13","大昌",64,22,42
"24840","2390云辰","110/07/13","富邦-嘉義",65,108,-43
"24841","2363矽統","110/07/13","凱基-南崁",2133,63,2070
"24842","2363矽統","110/07/13","凱基-幸福",36,4048,-4012
"24843","2363矽統","110/07/13","國泰-敦南",2195,1617,578
"24844","2363矽統","110/07/13","統一",192,3325,-3133
"24845","2363矽統","110/07/13","中農",670,139,531
"24846","2363矽統","110/07/13","新加坡商瑞銀",1000,2747,-1747
"24847","2363矽統","110/07/13","康和-台中",638,154,484
"24848","2363矽統","110/07/13","凱基-台北",5359,6609,-1250
"24849","2363矽統","110/07/13","群益金鼎-三民",577,137,440
"24850","2363矽統","110/07/13","摩根大通",1930,2858,-928
"24851","2363矽統","110/07/13","台新-屏東",510,88,422
"24852","2363矽統","110/07/13","港商野村",960,1679,-719
"24853","2363矽統","110/07/13","德信-中正",455,67,388
"24854","2363矽統","110/07/13","兆豐-復興",25,705,-680
"24855","2363矽統","110/07/13","日盛-竹北",365,70,295
"24856","2363矽統","110/07/13","統一-仁愛",114,755,-641
"24857","2363矽統","110/07/13","元大-佳里",452,189,263
"24858","2363矽統","110/07/13","統一-敦南",29,638,-609
"24859","2363矽統","110/07/13","國票-博愛",296,38,258
"24860","2363矽統","110/07/13","統一-土城",100,704,-604
"24861","2363矽統","110/07/13","元大-萬華",340,95,245
"24862","2363矽統","110/07/13","統一-城中",116,676,-560
"24863","2363矽統","110/07/13","新光",1259,1031,228
"24864","2363矽統","110/07/13","永豐金證券",306,859,-553
"24865","2363矽統","110/07/13","元富-成功",323,96,227
"24866","2363矽統","110/07/13","元富",54,567,-513
"24867","2363矽統","110/07/13","豐農",228,23,205
"24868","2363矽統","110/07/13","瑞士信貸",202,666,-464
"24869","2363矽統","110/07/13","台灣企銀-岡山",186,4,182
"24870","2363矽統","110/07/13","永豐金-嘉義",67,468,-401
"24871","8112至上","110/07/13","摩根大通",688,296,392
"24872","8112至上","110/07/13","國票-中和",0,401,-401
"24873","8112至上","110/07/13","港商野村",344,145,199
"24874","8112至上","110/07/13","永豐金-板盛",0,205,-205
"24875","8112至上","110/07/13","兆豐-公益",195,5,190
"24876","8112至上","110/07/13","凱基-五股",43,155,-112
"24877","8112至上","110/07/13","台灣摩根士丹利",183,0,183
"24878","8112至上","110/07/13","凱基-市政",0,100,-100
"24879","8112至上","110/07/13","群益金鼎-敦南",153,2,151
"24880","8112至上","110/07/13","元大-大里德芳",1,92,-91
"24881","8112至上","110/07/13","臺銀-金山",146,26,120
"24882","8112至上","110/07/13","玉山-桃園",26,110,-84
"24883","8112至上","110/07/13","臺銀",133,19,114
"24884","8112至上","110/07/13","兆豐-天母",0,81,-81
"24885","8112至上","110/07/13","合庫-台中",115,6,109
"24886","8112至上","110/07/13","凱基-城中",3,84,-81
"24887","8112至上","110/07/13","亞東-板橋",134,26,108
"24888","8112至上","110/07/13","日盛-新莊",9,85,-76
"24889","8112至上","110/07/13","凱基-台北",414,326,88
"24890","8112至上","110/07/13","日盛-台中",2,64,-62
"24891","8112至上","110/07/13","新加坡商瑞銀",181,100,81
"24892","8112至上","110/07/13","日盛-中壢",3,64,-61
"24893","8112至上","110/07/13","國泰-敦南",108,31,77
"24894","8112至上","110/07/13","元大-台中",2,59,-57
"24895","8112至上","110/07/13","第一金-華江",77,4,73
"24896","8112至上","110/07/13","元大-雙和",7,64,-57
"24897","8112至上","110/07/13","永豐金-內湖",73,1,72
"24898","8112至上","110/07/13","元大-高雄",8,62,-54
"24899","8112至上","110/07/13","元大-永和",68,1,67
"24900","8112至上","110/07/13","元大-館前",2,55,-53
"24901","4903聯光通","110/07/13","台灣企銀-太平",56,0,56
"24902","4903聯光通","110/07/13","土銀",0,32,-32
"24903","4903聯光通","110/07/13","元富-新興",23,0,23
"24904","4903聯光通","110/07/13","元大-樹林",0,19,-19
"24905","4903聯光通","110/07/13","日盛-樹林",22,0,22
"24906","4903聯光通","110/07/13","凱基-士林",0,17,-17
"24907","4903聯光通","110/07/13","兆豐-天母",20,0,20
"24908","4903聯光通","110/07/13","國票-博愛",0,14,-14
"24909","4903聯光通","110/07/13","華南永昌-桃園",20,0,20
"24910","4903聯光通","110/07/13","元富",0,10,-10
"24911","4903聯光通","110/07/13","富邦-新店",10,0,10
"24912","4903聯光通","110/07/13","新光",0,10,-10
"24913","4903聯光通","110/07/13","新光-台中",5,0,5
"24914","4903聯光通","110/07/13","玉山-南京東路",0,10,-10
"24915","4903聯光通","110/07/13","華南永昌-台中",5,0,5
"24916","4903聯光通","110/07/13","富邦-陽明",0,10,-10
"24917","4903聯光通","110/07/13","元大-崇德",5,0,5
"24918","4903聯光通","110/07/13","元大-大甲",0,8,-8
"24919","4903聯光通","110/07/13","元大-草屯",5,0,5
"24920","4903聯光通","110/07/13","富邦-台中",0,7,-7
"24921","4903聯光通","110/07/13","元富-草屯",4,0,4
"24922","4903聯光通","110/07/13","凱基-中壢",0,6,-6
"24923","4903聯光通","110/07/13","元大-清水",4,0,4
"24924","4903聯光通","110/07/13","臺銀-民權",0,5,-5
"24925","4903聯光通","110/07/13","元大-東泰",4,0,4
"24926","4903聯光通","110/07/13","日盛-板橋",0,5,-5
"24927","4903聯光通","110/07/13","元大-佳里",2,0,2
"24928","4903聯光通","110/07/13","中國信託-忠孝",0,5,-5
"24929","4903聯光通","110/07/13","永豐金-板橋",2,0,2
"24930","4903聯光通","110/07/13","永豐金-鳳山",0,5,-5
"24931","2929淘帝","110/07/13","玉山-新竹",130,0,130
"24932","2929淘帝","110/07/13","美商高盛",0,177,-177
"24933","2929淘帝","110/07/13","臺銀-民權",60,0,60
"24934","2929淘帝","110/07/13","凱基-台北",6,80,-74
"24935","2929淘帝","110/07/13","新百王",31,0,31
"24936","2929淘帝","110/07/13","元富-大裕",0,49,-49
"24937","2929淘帝","110/07/13","日盛-園區",30,0,30
"24938","2929淘帝","110/07/13","國泰-館前",3,51,-48
"24939","2929淘帝","110/07/13","元大-南投",31,1,30
"24940","2929淘帝","110/07/13","凱基-中壢",0,41,-41
"24941","2929淘帝","110/07/13","兆豐-忠孝",28,0,28
"24942","2929淘帝","110/07/13","港商野村",21,55,-34
"24943","2929淘帝","110/07/13","元大-民生",28,0,28
"24944","2929淘帝","110/07/13","華南永昌-南京",2,34,-32
"24945","2929淘帝","110/07/13","合庫-高雄",27,0,27
"24946","2929淘帝","110/07/13","群益金鼎-土城",0,30,-30
"24947","2929淘帝","110/07/13","凱基-豐中",27,0,27
"24948","2929淘帝","110/07/13","富邦-南屯",0,22,-22
"24949","2929淘帝","110/07/13","新光",21,4,17
"24950","2929淘帝","110/07/13","第一金-豐原",0,20,-20
"24951","2929淘帝","110/07/13","元大-天母",17,0,17
"24952","2929淘帝","110/07/13","元大-屏南",6,26,-20
"24953","2929淘帝","110/07/13","永興",14,0,14
"24954","2929淘帝","110/07/13","永豐金-敦南",1,21,-20
"24955","2929淘帝","110/07/13","富邦-台北",12,0,12
"24956","2929淘帝","110/07/13","凱基-三重",2,21,-19
"24957","2929淘帝","110/07/13","元大-永和",12,0,12
"24958","2929淘帝","110/07/13","富邦-仁愛",7,25,-18
"24959","2929淘帝","110/07/13","國票-天祥",11,0,11
"24960","2929淘帝","110/07/13","元大-北投",0,16,-16
"24961","5410國眾","110/07/13","兆豐-城中",274,0,274
"24962","5410國眾","110/07/13","元富-嘉義",0,103,-103
"24963","5410國眾","110/07/13","新光",50,4,46
"24964","5410國眾","110/07/13","凱基-台北",0,50,-50
"24965","5410國眾","110/07/13","國泰-台中",26,0,26
"24966","5410國眾","110/07/13","瑞士信貸",0,31,-31
"24967","5410國眾","110/07/13","新加坡商瑞銀",22,0,22
"24968","5410國眾","110/07/13","台新-新莊",0,27,-27
"24969","5410國眾","110/07/13","光和-嘉義",20,0,20
"24970","5410國眾","110/07/13","元大-汐止",0,20,-20
"24971","5410國眾","110/07/13","凱基-竹北",17,0,17
"24972","5410國眾","110/07/13","亞東-新竹",0,17,-17
"24973","5410國眾","110/07/13","新光-桃園",15,0,15
"24974","5410國眾","110/07/13","元大-南勢角",0,13,-13
"24975","5410國眾","110/07/13","凱基-台東",14,0,14
"24976","5410國眾","110/07/13","台新-台南",0,12,-12
"24977","5410國眾","110/07/13","富邦-竹北",11,0,11
"24978","5410國眾","110/07/13","中國信託",0,11,-11
"24979","5410國眾","110/07/13","元富-同大",10,0,10
"24980","5410國眾","110/07/13","華南永昌",0,11,-11
"24981","5410國眾","110/07/13","國泰-敦南",24,15,9
"24982","5410國眾","110/07/13","臺銀-臺南",0,10,-10
"24983","5410國眾","110/07/13","日盛-內湖",7,0,7
"24984","5410國眾","110/07/13","台灣企銀-民雄",0,10,-10
"24985","5410國眾","110/07/13","台新-左楠",7,0,7
"24986","5410國眾","110/07/13","高橋",0,10,-10
"24987","5410國眾","110/07/13","元大-新盛",18,12,6
"24988","5410國眾","110/07/13","康和-嘉義",0,10,-10
"24989","5410國眾","110/07/13","統一",5,0,5
"24990","5410國眾","110/07/13","凱基-基隆",0,10,-10
"24991","2841台開","110/07/13","中國信託-高雄",251,50,201
"24992","2841台開","110/07/13","兆豐-公益",0,177,-177
"24993","2841台開","110/07/13","日盛證券",210,13,197
"24994","2841台開","110/07/13","日進",0,152,-152
"24995","2841台開","110/07/13","第一金-台中",55,0,55
"24996","2841台開","110/07/13","港商野村",0,109,-109
"24997","2841台開","110/07/13","國泰-板橋",46,0,46
"24998","2841台開","110/07/13","日盛-信義",0,103,-103
"24999","2841台開","110/07/13","國泰-館前",48,3,45
"25000","2841台開","110/07/13","國泰-敦南",11,75,-64
"25001","2841台開","110/07/13","華南永昌-新莊",45,0,45
"25002","2841台開","110/07/13","永興",0,50,-50
"25003","2841台開","110/07/13","日盛-園區",42,0,42
"25004","2841台開","110/07/13","永豐金-敦南",61,104,-43
"25005","2841台開","110/07/13","台新證券",32,0,32
"25006","2841台開","110/07/13","富邦-台南",0,42,-42
"25007","2841台開","110/07/13","台新-高雄",32,2,30
"25008","2841台開","110/07/13","國票-安和",0,30,-30
"25009","2841台開","110/07/13","豐農",23,0,23
"25010","2841台開","110/07/13","元大-桃園",0,25,-25
"25011","2841台開","110/07/13","合庫-嘉義",20,0,20
"25012","2841台開","110/07/13","新光",8,32,-24
"25013","2841台開","110/07/13","華南永昌-高雄",20,0,20
"25014","2841台開","110/07/13","元大-仁愛",0,24,-24
"25015","2841台開","110/07/13","元大-樹林",16,0,16
"25016","2841台開","110/07/13","日盛-中和",0,20,-20
"25017","2841台開","110/07/13","第一金-華江",15,2,13
"25018","2841台開","110/07/13","元富",0,20,-20
"25019","2841台開","110/07/13","美商高盛",12,0,12
"25020","2841台開","110/07/13","富邦-宜蘭",0,20,-20
"25021","6207雷科","110/07/13","元大-高雄",121,0,121
"25022","6207雷科","110/07/13","華南永昌-朴子",1,60,-59
"25023","6207雷科","110/07/13","第一金-新興",20,0,20
"25024","6207雷科","110/07/13","元大-南海",0,36,-36
"25025","6207雷科","110/07/13","元富-三重",20,0,20
"25026","6207雷科","110/07/13","凱基-土城",0,35,-35
"25027","6207雷科","110/07/13","元大-林園",15,0,15
"25028","6207雷科","110/07/13","台灣企銀",0,20,-20
"25029","6207雷科","110/07/13","元大-金華",16,1,15
"25030","6207雷科","110/07/13","群益金鼎-丹鳳",0,20,-20
"25031","6207雷科","110/07/13","日盛證券",10,0,10
"25032","6207雷科","110/07/13","元大-博愛",0,17,-17
"25033","6207雷科","110/07/13","統一-台中",10,0,10
"25034","6207雷科","110/07/13","元大-北港",0,13,-13
"25035","6207雷科","110/07/13","群益金鼎-土城",10,0,10
"25036","6207雷科","110/07/13","新加坡商瑞銀",0,12,-12
"25037","6207雷科","110/07/13","群益金鼎-桃園",10,0,10
"25038","6207雷科","110/07/13","凱基-台北",4,16,-12
"25039","6207雷科","110/07/13","永豐金-新莊",10,0,10
"25040","6207雷科","110/07/13","日茂-埔里",0,11,-11
"25041","6207雷科","110/07/13","永豐金-新店",10,0,10
"25042","6207雷科","110/07/13","元大-莒光",0,11,-11
"25043","6207雷科","110/07/13","元大證券",9,0,9
"25044","6207雷科","110/07/13","統一-新竹",0,10,-10
"25045","6207雷科","110/07/13","日盛-木柵",9,1,8
"25046","6207雷科","110/07/13","元大-西螺",0,10,-10
"25047","6207雷科","110/07/13","兆豐-來福",8,0,8
"25048","6207雷科","110/07/13","康和-台中",0,8,-8
"25049","6207雷科","110/07/13","新光",7,0,7
"25050","6207雷科","110/07/13","兆豐-高雄",0,6,-6
"25051","3679新至陞","110/07/13","永豐金證券",50,0,50
"25052","3679新至陞","110/07/13","摩根大通",2,25,-23
"25053","3679新至陞","110/07/13","國泰-桃園",22,0,22
"25054","3679新至陞","110/07/13","元大-成功",0,22,-22
"25055","3679新至陞","110/07/13","台中銀-員林",11,0,11
"25056","3679新至陞","110/07/13","富邦-板橋",1,19,-18
"25057","3679新至陞","110/07/13","元大-文心興安",8,0,8
"25058","3679新至陞","110/07/13","日盛-新莊",0,10,-10
"25059","3679新至陞","110/07/13","美商高盛",6,0,6
"25060","3679新至陞","110/07/13","台新-台中",0,10,-10
"25061","3679新至陞","110/07/13","台新-高雄",6,0,6
"25062","3679新至陞","110/07/13","永豐金-新竹",0,8,-8
"25063","3679新至陞","110/07/13","凱基-台北",18,12,6
"25064","3679新至陞","110/07/13","瑞士信貸",12,19,-7
"25065","3679新至陞","110/07/13","日盛-復興",5,0,5
"25066","3679新至陞","110/07/13","統一-南京",0,7,-7
"25067","3679新至陞","110/07/13","(牛牛牛)亞-鑫豐",4,0,4
"25068","3679新至陞","110/07/13","凱基-新莊",0,7,-7
"25069","3679新至陞","110/07/13","元富-大昌",3,0,3
"25070","3679新至陞","110/07/13","新加坡商瑞銀",0,6,-6
"25071","3679新至陞","110/07/13","富邦-台北",3,0,3
"25072","3679新至陞","110/07/13","合庫-自強",0,5,-5
"25073","3679新至陞","110/07/13","日盛-樹林",2,0,2
"25074","3679新至陞","110/07/13","富邦-桃園",0,5,-5
"25075","3679新至陞","110/07/13","宏遠-光隆",2,0,2
"25076","3679新至陞","110/07/13","永豐金-潮州",0,4,-4
"25077","3679新至陞","110/07/13","美林",3,1,2
"25078","3679新至陞","110/07/13","臺銀-臺南",0,3,-3
"25079","3679新至陞","110/07/13","第一金-中壢",2,0,2
"25080","3679新至陞","110/07/13","元大-六合",0,3,-3
"25081","2727王品","110/07/13","富邦-台北",43,3,40
"25082","2727王品","110/07/13","台灣摩根士丹利",15,97,-82
"25083","2727王品","110/07/13","元大-基隆孝二",40,0,40
"25084","2727王品","110/07/13","玉山-台南",5,57,-52
"25085","2727王品","110/07/13","國票-新莊",40,1,39
"25086","2727王品","110/07/13","新加坡商瑞銀",0,48,-48
"25087","2727王品","110/07/13","第一金-豐原",66,42,24
"25088","2727王品","110/07/13","凱基-台北",41,77,-36
"25089","2727王品","110/07/13","永豐金-大園",34,10,24
"25090","2727王品","110/07/13","永豐金-永康",0,22,-22
"25091","2727王品","110/07/13","元大-北屯",22,0,22
"25092","2727王品","110/07/13","統一-台中",2,22,-20
"25093","2727王品","110/07/13","元大-東蘆",26,7,19
"25094","2727王品","110/07/13","國泰-台中",21,39,-18
"25095","2727王品","110/07/13","永豐金-萬盛",13,1,12
"25096","2727王品","110/07/13","合庫-彰化",3,20,-17
"25097","2727王品","110/07/13","日盛-嘉義",11,0,11
"25098","2727王品","110/07/13","港商野村",13,30,-17
"25099","2727王品","110/07/13","日盛-八德",11,0,11
"25100","2727王品","110/07/13","元大-楊梅",1,16,-15
"25101","2727王品","110/07/13","統一-竹南",11,0,11
"25102","2727王品","110/07/13","凱基-高美館",2,15,-13
"25103","2727王品","110/07/13","日盛-士林",12,2,10
"25104","2727王品","110/07/13","美商高盛",2,14,-12
"25105","2727王品","110/07/13","統一-敦南",10,0,10
"25106","2727王品","110/07/13","統一-平鎮",1,13,-12
"25107","2727王品","110/07/13","中國信託",15,5,10
"25108","2727王品","110/07/13","兆豐-台中港",4,16,-12
"25109","2727王品","110/07/13","兆豐-竹北",13,3,10
"25110","2727王品","110/07/13","凱基-八德",1,13,-12
"25111","1570力肯","110/07/13","新光",115,11,104
"25112","1570力肯","110/07/13","元大-北三重",0,162,-162
"25113","1570力肯","110/07/13","群益金鼎-高雄",54,0,54
"25114","1570力肯","110/07/13","元大-大灣",0,25,-25
"25115","1570力肯","110/07/13","國票-新莊",22,0,22
"25116","1570力肯","110/07/13","永豐金-苓雅",0,22,-22
"25117","1570力肯","110/07/13","日盛-桃園",12,0,12
"25118","1570力肯","110/07/13","永豐金-永康",0,19,-19
"25119","1570力肯","110/07/13","元大-高雄",12,0,12
"25120","1570力肯","110/07/13","富邦-員林",0,15,-15
"25121","1570力肯","110/07/13","合庫-自強",11,0,11
"25122","1570力肯","110/07/13","凱基-台南",0,11,-11
"25123","1570力肯","110/07/13","摩根大通",26,15,11
"25124","1570力肯","110/07/13","日盛-竹北",0,10,-10
"25125","1570力肯","110/07/13","永豐金-中盛",11,0,11
"25126","1570力肯","110/07/13","國票-九鼎",0,10,-10
"25127","1570力肯","110/07/13","兆豐-台中港",10,0,10
"25128","1570力肯","110/07/13","凱基-桃園",0,10,-10
"25129","1570力肯","110/07/13","國泰-松江",9,0,9
"25130","1570力肯","110/07/13","凱基-新豐",0,10,-10
"25131","1570力肯","110/07/13","元大-新盛",9,0,9
"25132","1570力肯","110/07/13","元大-學甲",0,10,-10
"25133","1570力肯","110/07/13","元富-緯城",6,0,6
"25134","1570力肯","110/07/13","群益金鼎-東湖",1,10,-9
"25135","1570力肯","110/07/13","統一-三重",5,0,5
"25136","1570力肯","110/07/13","大昌",0,6,-6
"25137","1570力肯","110/07/13","元大-前金",5,0,5
"25138","1570力肯","110/07/13","元大-土城學府",0,6,-6
"25139","1570力肯","110/07/13","永豐金證券",5,0,5
"25140","1570力肯","110/07/13","統一",0,5,-5
"25141","6180橘子","110/07/13","摩根大通",119,0,119
"25142","6180橘子","110/07/13","元大-崇德",2,61,-59
"25143","6180橘子","110/07/13","美商高盛",96,0,96
"25144","6180橘子","110/07/13","康和-台中",0,51,-51
"25145","6180橘子","110/07/13","新加坡商瑞銀",86,7,79
"25146","6180橘子","110/07/13","康和-台北",0,50,-50
"25147","6180橘子","110/07/13","元大-和平",40,0,40
"25148","6180橘子","110/07/13","元富-潮州",0,40,-40
"25149","6180橘子","110/07/13","凱基-台北",83,47,36
"25150","6180橘子","110/07/13","日盛-永康",0,26,-26
"25151","6180橘子","110/07/13","美林",39,5,34
"25152","6180橘子","110/07/13","永豐金-中正",0,24,-24
"25153","6180橘子","110/07/13","富邦-新竹華信",31,2,29
"25154","6180橘子","110/07/13","國泰-板橋",2,25,-23
"25155","6180橘子","110/07/13","統一-南京",21,0,21
"25156","6180橘子","110/07/13","日盛-大墩",0,20,-20
"25157","6180橘子","110/07/13","富邦-陽明",24,3,21
"25158","6180橘子","110/07/13","元大-草屯",13,32,-19
"25159","6180橘子","110/07/13","大昌-樹林",21,1,20
"25160","6180橘子","110/07/13","元富-林園",1,18,-17
"25161","6180橘子","110/07/13","花旗環球",19,0,19
"25162","6180橘子","110/07/13","新光-新竹",1,18,-17
"25163","6180橘子","110/07/13","華南永昌-台南",19,0,19
"25164","6180橘子","110/07/13","元大-土城永寧",0,17,-17
"25165","6180橘子","110/07/13","福勝",14,0,14
"25166","6180橘子","110/07/13","國泰-新莊",3,19,-16
"25167","6180橘子","110/07/13","富邦-嘉義",12,1,11
"25168","6180橘子","110/07/13","中國信託-永康",6,21,-15
"25169","6180橘子","110/07/13","元大-板橋三民",11,0,11
"25170","6180橘子","110/07/13","凱基-東港",1,15,-14
"25171","2390云辰","110/07/13","新加坡商瑞銀",562,75,487
"25172","2390云辰","110/07/13","大展-台南",0,532,-532
"25173","2390云辰","110/07/13","台灣摩根士丹利",330,155,175
"25174","2390云辰","110/07/13","凱基-台北",668,854,-186
"25175","2390云辰","110/07/13","兆豐-公益",126,25,101
"25176","2390云辰","110/07/13","凱基-三重",12,172,-160
"25177","2390云辰","110/07/13","元富-中港",100,2,98
"25178","2390云辰","110/07/13","兆豐-忠孝",4,161,-157
"25179","2390云辰","110/07/13","統一-新台中",106,9,97
"25180","2390云辰","110/07/13","元大-士林",19,170,-151
"25181","2390云辰","110/07/13","中國信託-松江",81,11,70
"25182","2390云辰","110/07/13","臺銀-新竹",14,117,-103
"25183","2390云辰","110/07/13","日盛-板橋",72,3,69
"25184","2390云辰","110/07/13","國票-台中",4,102,-98
"25185","2390云辰","110/07/13","日盛-和美",57,0,57
"25186","2390云辰","110/07/13","新光",147,232,-85
"25187","2390云辰","110/07/13","永豐金-桃園",88,36,52
"25188","2390云辰","110/07/13","致和-崇德",2,70,-68
"25189","2390云辰","110/07/13","玉山-士林",54,4,50
"25190","2390云辰","110/07/13","群益金鼎-屏東",2,70,-68
"25191","2390云辰","110/07/13","富邦-仁愛",56,6,50
"25192","2390云辰","110/07/13","元大-大里",35,98,-63
"25193","2390云辰","110/07/13","第一金-豐原",50,1,49
"25194","2390云辰","110/07/13","元大-萬華",35,94,-59
"25195","2390云辰","110/07/13","摩根大通",502,453,49
"25196","2390云辰","110/07/13","元富-吉利",2,60,-58
"25197","2390云辰","110/07/13","凱基-松山",61,13,48
"25198","2390云辰","110/07/13","兆豐-新竹",3,53,-50
"25199","2390云辰","110/07/13","大昌",64,22,42
"25200","2390云辰","110/07/13","富邦-嘉義",65,108,-43
"25201","2363矽統","110/07/13","凱基-南崁",2133,63,2070
"25202","2363矽統","110/07/13","凱基-幸福",36,4048,-4012
"25203","2363矽統","110/07/13","國泰-敦南",2195,1617,578
"25204","2363矽統","110/07/13","統一",192,3325,-3133
"25205","2363矽統","110/07/13","中農",670,139,531
"25206","2363矽統","110/07/13","新加坡商瑞銀",1000,2747,-1747
"25207","2363矽統","110/07/13","康和-台中",638,154,484
"25208","2363矽統","110/07/13","凱基-台北",5359,6609,-1250
"25209","2363矽統","110/07/13","群益金鼎-三民",577,137,440
"25210","2363矽統","110/07/13","摩根大通",1930,2858,-928
"25211","2363矽統","110/07/13","台新-屏東",510,88,422
"25212","2363矽統","110/07/13","港商野村",960,1679,-719
"25213","2363矽統","110/07/13","德信-中正",455,67,388
"25214","2363矽統","110/07/13","兆豐-復興",25,705,-680
"25215","2363矽統","110/07/13","日盛-竹北",365,70,295
"25216","2363矽統","110/07/13","統一-仁愛",114,755,-641
"25217","2363矽統","110/07/13","元大-佳里",452,189,263
"25218","2363矽統","110/07/13","統一-敦南",29,638,-609
"25219","2363矽統","110/07/13","國票-博愛",296,38,258
"25220","2363矽統","110/07/13","統一-土城",100,704,-604
"25221","2363矽統","110/07/13","元大-萬華",340,95,245
"25222","2363矽統","110/07/13","統一-城中",116,676,-560
"25223","2363矽統","110/07/13","新光",1259,1031,228
"25224","2363矽統","110/07/13","永豐金證券",306,859,-553
"25225","2363矽統","110/07/13","元富-成功",323,96,227
"25226","2363矽統","110/07/13","元富",54,567,-513
"25227","2363矽統","110/07/13","豐農",228,23,205
"25228","2363矽統","110/07/13","瑞士信貸",202,666,-464
"25229","2363矽統","110/07/13","台灣企銀-岡山",186,4,182
"25230","2363矽統","110/07/13","永豐金-嘉義",67,468,-401
"25231","8112至上","110/07/13","摩根大通",688,296,392
"25232","8112至上","110/07/13","國票-中和",0,401,-401
"25233","8112至上","110/07/13","港商野村",344,145,199
"25234","8112至上","110/07/13","永豐金-板盛",0,205,-205
"25235","8112至上","110/07/13","兆豐-公益",195,5,190
"25236","8112至上","110/07/13","凱基-五股",43,155,-112
"25237","8112至上","110/07/13","台灣摩根士丹利",183,0,183
"25238","8112至上","110/07/13","凱基-市政",0,100,-100
"25239","8112至上","110/07/13","群益金鼎-敦南",153,2,151
"25240","8112至上","110/07/13","元大-大里德芳",1,92,-91
"25241","8112至上","110/07/13","臺銀-金山",146,26,120
"25242","8112至上","110/07/13","玉山-桃園",26,110,-84
"25243","8112至上","110/07/13","臺銀",133,19,114
"25244","8112至上","110/07/13","兆豐-天母",0,81,-81
"25245","8112至上","110/07/13","合庫-台中",115,6,109
"25246","8112至上","110/07/13","凱基-城中",3,84,-81
"25247","8112至上","110/07/13","亞東-板橋",134,26,108
"25248","8112至上","110/07/13","日盛-新莊",9,85,-76
"25249","8112至上","110/07/13","凱基-台北",414,326,88
"25250","8112至上","110/07/13","日盛-台中",2,64,-62
"25251","8112至上","110/07/13","新加坡商瑞銀",181,100,81
"25252","8112至上","110/07/13","日盛-中壢",3,64,-61
"25253","8112至上","110/07/13","國泰-敦南",108,31,77
"25254","8112至上","110/07/13","元大-台中",2,59,-57
"25255","8112至上","110/07/13","第一金-華江",77,4,73
"25256","8112至上","110/07/13","元大-雙和",7,64,-57
"25257","8112至上","110/07/13","永豐金-內湖",73,1,72
"25258","8112至上","110/07/13","元大-高雄",8,62,-54
"25259","8112至上","110/07/13","元大-永和",68,1,67
"25260","8112至上","110/07/13","元大-館前",2,55,-53
"25261","4903聯光通","110/07/13","台灣企銀-太平",56,0,56
"25262","4903聯光通","110/07/13","土銀",0,32,-32
"25263","4903聯光通","110/07/13","元富-新興",23,0,23
"25264","4903聯光通","110/07/13","元大-樹林",0,19,-19
"25265","4903聯光通","110/07/13","日盛-樹林",22,0,22
"25266","4903聯光通","110/07/13","凱基-士林",0,17,-17
"25267","4903聯光通","110/07/13","兆豐-天母",20,0,20
"25268","4903聯光通","110/07/13","國票-博愛",0,14,-14
"25269","4903聯光通","110/07/13","華南永昌-桃園",20,0,20
"25270","4903聯光通","110/07/13","元富",0,10,-10
"25271","4903聯光通","110/07/13","富邦-新店",10,0,10
"25272","4903聯光通","110/07/13","新光",0,10,-10
"25273","4903聯光通","110/07/13","新光-台中",5,0,5
"25274","4903聯光通","110/07/13","玉山-南京東路",0,10,-10
"25275","4903聯光通","110/07/13","華南永昌-台中",5,0,5
"25276","4903聯光通","110/07/13","富邦-陽明",0,10,-10
"25277","4903聯光通","110/07/13","元大-崇德",5,0,5
"25278","4903聯光通","110/07/13","元大-大甲",0,8,-8
"25279","4903聯光通","110/07/13","元大-草屯",5,0,5
"25280","4903聯光通","110/07/13","富邦-台中",0,7,-7
"25281","4903聯光通","110/07/13","元富-草屯",4,0,4
"25282","4903聯光通","110/07/13","凱基-中壢",0,6,-6
"25283","4903聯光通","110/07/13","元大-清水",4,0,4
"25284","4903聯光通","110/07/13","臺銀-民權",0,5,-5
"25285","4903聯光通","110/07/13","元大-東泰",4,0,4
"25286","4903聯光通","110/07/13","日盛-板橋",0,5,-5
"25287","4903聯光通","110/07/13","元大-佳里",2,0,2
"25288","4903聯光通","110/07/13","中國信託-忠孝",0,5,-5
"25289","4903聯光通","110/07/13","永豐金-板橋",2,0,2
"25290","4903聯光通","110/07/13","永豐金-鳳山",0,5,-5
"25291","2929淘帝","110/07/13","玉山-新竹",130,0,130
"25292","2929淘帝","110/07/13","美商高盛",0,177,-177
"25293","2929淘帝","110/07/13","臺銀-民權",60,0,60
"25294","2929淘帝","110/07/13","凱基-台北",6,80,-74
"25295","2929淘帝","110/07/13","新百王",31,0,31
"25296","2929淘帝","110/07/13","元富-大裕",0,49,-49
"25297","2929淘帝","110/07/13","日盛-園區",30,0,30
"25298","2929淘帝","110/07/13","國泰-館前",3,51,-48
"25299","2929淘帝","110/07/13","元大-南投",31,1,30
"25300","2929淘帝","110/07/13","凱基-中壢",0,41,-41
"25301","2929淘帝","110/07/13","兆豐-忠孝",28,0,28
"25302","2929淘帝","110/07/13","港商野村",21,55,-34
"25303","2929淘帝","110/07/13","元大-民生",28,0,28
"25304","2929淘帝","110/07/13","華南永昌-南京",2,34,-32
"25305","2929淘帝","110/07/13","合庫-高雄",27,0,27
"25306","2929淘帝","110/07/13","群益金鼎-土城",0,30,-30
"25307","2929淘帝","110/07/13","凱基-豐中",27,0,27
"25308","2929淘帝","110/07/13","富邦-南屯",0,22,-22
"25309","2929淘帝","110/07/13","新光",21,4,17
"25310","2929淘帝","110/07/13","第一金-豐原",0,20,-20
"25311","2929淘帝","110/07/13","元大-天母",17,0,17
"25312","2929淘帝","110/07/13","元大-屏南",6,26,-20
"25313","2929淘帝","110/07/13","永興",14,0,14
"25314","2929淘帝","110/07/13","永豐金-敦南",1,21,-20
"25315","2929淘帝","110/07/13","富邦-台北",12,0,12
"25316","2929淘帝","110/07/13","凱基-三重",2,21,-19
"25317","2929淘帝","110/07/13","元大-永和",12,0,12
"25318","2929淘帝","110/07/13","富邦-仁愛",7,25,-18
"25319","2929淘帝","110/07/13","國票-天祥",11,0,11
"25320","2929淘帝","110/07/13","元大-北投",0,16,-16
"25321","5410國眾","110/07/13","兆豐-城中",274,0,274
"25322","5410國眾","110/07/13","元富-嘉義",0,103,-103
"25323","5410國眾","110/07/13","新光",50,4,46
"25324","5410國眾","110/07/13","凱基-台北",0,50,-50
"25325","5410國眾","110/07/13","國泰-台中",26,0,26
"25326","5410國眾","110/07/13","瑞士信貸",0,31,-31
"25327","5410國眾","110/07/13","新加坡商瑞銀",22,0,22
"25328","5410國眾","110/07/13","台新-新莊",0,27,-27
"25329","5410國眾","110/07/13","光和-嘉義",20,0,20
"25330","5410國眾","110/07/13","元大-汐止",0,20,-20
"25331","5410國眾","110/07/13","凱基-竹北",17,0,17
"25332","5410國眾","110/07/13","亞東-新竹",0,17,-17
"25333","5410國眾","110/07/13","新光-桃園",15,0,15
"25334","5410國眾","110/07/13","元大-南勢角",0,13,-13
"25335","5410國眾","110/07/13","凱基-台東",14,0,14
"25336","5410國眾","110/07/13","台新-台南",0,12,-12
"25337","5410國眾","110/07/13","富邦-竹北",11,0,11
"25338","5410國眾","110/07/13","中國信託",0,11,-11
"25339","5410國眾","110/07/13","元富-同大",10,0,10
"25340","5410國眾","110/07/13","華南永昌",0,11,-11
"25341","5410國眾","110/07/13","國泰-敦南",24,15,9
"25342","5410國眾","110/07/13","臺銀-臺南",0,10,-10
"25343","5410國眾","110/07/13","日盛-內湖",7,0,7
"25344","5410國眾","110/07/13","台灣企銀-民雄",0,10,-10
"25345","5410國眾","110/07/13","台新-左楠",7,0,7
"25346","5410國眾","110/07/13","高橋",0,10,-10
"25347","5410國眾","110/07/13","元大-新盛",18,12,6
"25348","5410國眾","110/07/13","康和-嘉義",0,10,-10
"25349","5410國眾","110/07/13","統一",5,0,5
"25350","5410國眾","110/07/13","凱基-基隆",0,10,-10
"25351","2841台開","110/07/13","中國信託-高雄",251,50,201
"25352","2841台開","110/07/13","兆豐-公益",0,177,-177
"25353","2841台開","110/07/13","日盛證券",210,13,197
"25354","2841台開","110/07/13","日進",0,152,-152
"25355","2841台開","110/07/13","第一金-台中",55,0,55
"25356","2841台開","110/07/13","港商野村",0,109,-109
"25357","2841台開","110/07/13","國泰-板橋",46,0,46
"25358","2841台開","110/07/13","日盛-信義",0,103,-103
"25359","2841台開","110/07/13","國泰-館前",48,3,45
"25360","2841台開","110/07/13","國泰-敦南",11,75,-64
"25361","2841台開","110/07/13","華南永昌-新莊",45,0,45
"25362","2841台開","110/07/13","永興",0,50,-50
"25363","2841台開","110/07/13","日盛-園區",42,0,42
"25364","2841台開","110/07/13","永豐金-敦南",61,104,-43
"25365","2841台開","110/07/13","台新證券",32,0,32
"25366","2841台開","110/07/13","富邦-台南",0,42,-42
"25367","2841台開","110/07/13","台新-高雄",32,2,30
"25368","2841台開","110/07/13","國票-安和",0,30,-30
"25369","2841台開","110/07/13","豐農",23,0,23
"25370","2841台開","110/07/13","元大-桃園",0,25,-25
"25371","2841台開","110/07/13","合庫-嘉義",20,0,20
"25372","2841台開","110/07/13","新光",8,32,-24
"25373","2841台開","110/07/13","華南永昌-高雄",20,0,20
"25374","2841台開","110/07/13","元大-仁愛",0,24,-24
"25375","2841台開","110/07/13","元大-樹林",16,0,16
"25376","2841台開","110/07/13","日盛-中和",0,20,-20
"25377","2841台開","110/07/13","第一金-華江",15,2,13
"25378","2841台開","110/07/13","元富",0,20,-20
"25379","2841台開","110/07/13","美商高盛",12,0,12
"25380","2841台開","110/07/13","富邦-宜蘭",0,20,-20
"25381","6207雷科","110/07/13","元大-高雄",121,0,121
"25382","6207雷科","110/07/13","華南永昌-朴子",1,60,-59
"25383","6207雷科","110/07/13","第一金-新興",20,0,20
"25384","6207雷科","110/07/13","元大-南海",0,36,-36
"25385","6207雷科","110/07/13","元富-三重",20,0,20
"25386","6207雷科","110/07/13","凱基-土城",0,35,-35
"25387","6207雷科","110/07/13","元大-林園",15,0,15
"25388","6207雷科","110/07/13","台灣企銀",0,20,-20
"25389","6207雷科","110/07/13","元大-金華",16,1,15
"25390","6207雷科","110/07/13","群益金鼎-丹鳳",0,20,-20
"25391","6207雷科","110/07/13","日盛證券",10,0,10
"25392","6207雷科","110/07/13","元大-博愛",0,17,-17
"25393","6207雷科","110/07/13","統一-台中",10,0,10
"25394","6207雷科","110/07/13","元大-北港",0,13,-13
"25395","6207雷科","110/07/13","群益金鼎-土城",10,0,10
"25396","6207雷科","110/07/13","新加坡商瑞銀",0,12,-12
"25397","6207雷科","110/07/13","群益金鼎-桃園",10,0,10
"25398","6207雷科","110/07/13","凱基-台北",4,16,-12
"25399","6207雷科","110/07/13","永豐金-新莊",10,0,10
"25400","6207雷科","110/07/13","日茂-埔里",0,11,-11
"25401","6207雷科","110/07/13","永豐金-新店",10,0,10
"25402","6207雷科","110/07/13","元大-莒光",0,11,-11
"25403","6207雷科","110/07/13","元大證券",9,0,9
"25404","6207雷科","110/07/13","統一-新竹",0,10,-10
"25405","6207雷科","110/07/13","日盛-木柵",9,1,8
"25406","6207雷科","110/07/13","元大-西螺",0,10,-10
"25407","6207雷科","110/07/13","兆豐-來福",8,0,8
"25408","6207雷科","110/07/13","康和-台中",0,8,-8
"25409","6207雷科","110/07/13","新光",7,0,7
"25410","6207雷科","110/07/13","兆豐-高雄",0,6,-6
"25411","3679新至陞","110/07/13","永豐金證券",50,0,50
"25412","3679新至陞","110/07/13","摩根大通",2,25,-23
"25413","3679新至陞","110/07/13","國泰-桃園",22,0,22
"25414","3679新至陞","110/07/13","元大-成功",0,22,-22
"25415","3679新至陞","110/07/13","台中銀-員林",11,0,11
"25416","3679新至陞","110/07/13","富邦-板橋",1,19,-18
"25417","3679新至陞","110/07/13","元大-文心興安",8,0,8
"25418","3679新至陞","110/07/13","日盛-新莊",0,10,-10
"25419","3679新至陞","110/07/13","美商高盛",6,0,6
"25420","3679新至陞","110/07/13","台新-台中",0,10,-10
"25421","3679新至陞","110/07/13","台新-高雄",6,0,6
"25422","3679新至陞","110/07/13","永豐金-新竹",0,8,-8
"25423","3679新至陞","110/07/13","凱基-台北",18,12,6
"25424","3679新至陞","110/07/13","瑞士信貸",12,19,-7
"25425","3679新至陞","110/07/13","日盛-復興",5,0,5
"25426","3679新至陞","110/07/13","統一-南京",0,7,-7
"25427","3679新至陞","110/07/13","(牛牛牛)亞-鑫豐",4,0,4
"25428","3679新至陞","110/07/13","凱基-新莊",0,7,-7
"25429","3679新至陞","110/07/13","元富-大昌",3,0,3
"25430","3679新至陞","110/07/13","新加坡商瑞銀",0,6,-6
"25431","3679新至陞","110/07/13","富邦-台北",3,0,3
"25432","3679新至陞","110/07/13","合庫-自強",0,5,-5
"25433","3679新至陞","110/07/13","日盛-樹林",2,0,2
"25434","3679新至陞","110/07/13","富邦-桃園",0,5,-5
"25435","3679新至陞","110/07/13","宏遠-光隆",2,0,2
"25436","3679新至陞","110/07/13","永豐金-潮州",0,4,-4
"25437","3679新至陞","110/07/13","美林",3,1,2
"25438","3679新至陞","110/07/13","臺銀-臺南",0,3,-3
"25439","3679新至陞","110/07/13","第一金-中壢",2,0,2
"25440","3679新至陞","110/07/13","元大-六合",0,3,-3
"25441","2727王品","110/07/13","富邦-台北",43,3,40
"25442","2727王品","110/07/13","台灣摩根士丹利",15,97,-82
"25443","2727王品","110/07/13","元大-基隆孝二",40,0,40
"25444","2727王品","110/07/13","玉山-台南",5,57,-52
"25445","2727王品","110/07/13","國票-新莊",40,1,39
"25446","2727王品","110/07/13","新加坡商瑞銀",0,48,-48
"25447","2727王品","110/07/13","第一金-豐原",66,42,24
"25448","2727王品","110/07/13","凱基-台北",41,77,-36
"25449","2727王品","110/07/13","永豐金-大園",34,10,24
"25450","2727王品","110/07/13","永豐金-永康",0,22,-22
"25451","2727王品","110/07/13","元大-北屯",22,0,22
"25452","2727王品","110/07/13","統一-台中",2,22,-20
"25453","2727王品","110/07/13","元大-東蘆",26,7,19
"25454","2727王品","110/07/13","國泰-台中",21,39,-18
"25455","2727王品","110/07/13","永豐金-萬盛",13,1,12
"25456","2727王品","110/07/13","合庫-彰化",3,20,-17
"25457","2727王品","110/07/13","日盛-嘉義",11,0,11
"25458","2727王品","110/07/13","港商野村",13,30,-17
"25459","2727王品","110/07/13","日盛-八德",11,0,11
"25460","2727王品","110/07/13","元大-楊梅",1,16,-15
"25461","2727王品","110/07/13","統一-竹南",11,0,11
"25462","2727王品","110/07/13","凱基-高美館",2,15,-13
"25463","2727王品","110/07/13","日盛-士林",12,2,10
"25464","2727王品","110/07/13","美商高盛",2,14,-12
"25465","2727王品","110/07/13","統一-敦南",10,0,10
"25466","2727王品","110/07/13","統一-平鎮",1,13,-12
"25467","2727王品","110/07/13","中國信託",15,5,10
"25468","2727王品","110/07/13","兆豐-台中港",4,16,-12
"25469","2727王品","110/07/13","兆豐-竹北",13,3,10
"25470","2727王品","110/07/13","凱基-八德",1,13,-12
"25471","1570力肯","110/07/13","新光",115,11,104
"25472","1570力肯","110/07/13","元大-北三重",0,162,-162
"25473","1570力肯","110/07/13","群益金鼎-高雄",54,0,54
"25474","1570力肯","110/07/13","元大-大灣",0,25,-25
"25475","1570力肯","110/07/13","國票-新莊",22,0,22
"25476","1570力肯","110/07/13","永豐金-苓雅",0,22,-22
"25477","1570力肯","110/07/13","日盛-桃園",12,0,12
"25478","1570力肯","110/07/13","永豐金-永康",0,19,-19
"25479","1570力肯","110/07/13","元大-高雄",12,0,12
"25480","1570力肯","110/07/13","富邦-員林",0,15,-15
"25481","1570力肯","110/07/13","合庫-自強",11,0,11
"25482","1570力肯","110/07/13","凱基-台南",0,11,-11
"25483","1570力肯","110/07/13","摩根大通",26,15,11
"25484","1570力肯","110/07/13","日盛-竹北",0,10,-10
"25485","1570力肯","110/07/13","永豐金-中盛",11,0,11
"25486","1570力肯","110/07/13","國票-九鼎",0,10,-10
"25487","1570力肯","110/07/13","兆豐-台中港",10,0,10
"25488","1570力肯","110/07/13","凱基-桃園",0,10,-10
"25489","1570力肯","110/07/13","國泰-松江",9,0,9
"25490","1570力肯","110/07/13","凱基-新豐",0,10,-10
"25491","1570力肯","110/07/13","元大-新盛",9,0,9
"25492","1570力肯","110/07/13","元大-學甲",0,10,-10
"25493","1570力肯","110/07/13","元富-緯城",6,0,6
"25494","1570力肯","110/07/13","群益金鼎-東湖",1,10,-9
"25495","1570力肯","110/07/13","統一-三重",5,0,5
"25496","1570力肯","110/07/13","大昌",0,6,-6
"25497","1570力肯","110/07/13","元大-前金",5,0,5
"25498","1570力肯","110/07/13","元大-土城學府",0,6,-6
"25499","1570力肯","110/07/13","永豐金證券",5,0,5
"25500","1570力肯","110/07/13","統一",0,5,-5
"25501","6180橘子","110/07/13","摩根大通",119,0,119
"25502","6180橘子","110/07/13","元大-崇德",2,61,-59
"25503","6180橘子","110/07/13","美商高盛",96,0,96
"25504","6180橘子","110/07/13","康和-台中",0,51,-51
"25505","6180橘子","110/07/13","新加坡商瑞銀",86,7,79
"25506","6180橘子","110/07/13","康和-台北",0,50,-50
"25507","6180橘子","110/07/13","元大-和平",40,0,40
"25508","6180橘子","110/07/13","元富-潮州",0,40,-40
"25509","6180橘子","110/07/13","凱基-台北",83,47,36
"25510","6180橘子","110/07/13","日盛-永康",0,26,-26
"25511","6180橘子","110/07/13","美林",39,5,34
"25512","6180橘子","110/07/13","永豐金-中正",0,24,-24
"25513","6180橘子","110/07/13","富邦-新竹華信",31,2,29
"25514","6180橘子","110/07/13","國泰-板橋",2,25,-23
"25515","6180橘子","110/07/13","統一-南京",21,0,21
"25516","6180橘子","110/07/13","日盛-大墩",0,20,-20
"25517","6180橘子","110/07/13","富邦-陽明",24,3,21
"25518","6180橘子","110/07/13","元大-草屯",13,32,-19
"25519","6180橘子","110/07/13","大昌-樹林",21,1,20
"25520","6180橘子","110/07/13","元富-林園",1,18,-17
"25521","6180橘子","110/07/13","花旗環球",19,0,19
"25522","6180橘子","110/07/13","新光-新竹",1,18,-17
"25523","6180橘子","110/07/13","華南永昌-台南",19,0,19
"25524","6180橘子","110/07/13","元大-土城永寧",0,17,-17
"25525","6180橘子","110/07/13","福勝",14,0,14
"25526","6180橘子","110/07/13","國泰-新莊",3,19,-16
"25527","6180橘子","110/07/13","富邦-嘉義",12,1,11
"25528","6180橘子","110/07/13","中國信託-永康",6,21,-15
"25529","6180橘子","110/07/13","元大-板橋三民",11,0,11
"25530","6180橘子","110/07/13","凱基-東港",1,15,-14
"25531","2390云辰","110/07/13","新加坡商瑞銀",562,75,487
"25532","2390云辰","110/07/13","大展-台南",0,532,-532
"25533","2390云辰","110/07/13","台灣摩根士丹利",330,155,175
"25534","2390云辰","110/07/13","凱基-台北",668,854,-186
"25535","2390云辰","110/07/13","兆豐-公益",126,25,101
"25536","2390云辰","110/07/13","凱基-三重",12,172,-160
"25537","2390云辰","110/07/13","元富-中港",100,2,98
"25538","2390云辰","110/07/13","兆豐-忠孝",4,161,-157
"25539","2390云辰","110/07/13","統一-新台中",106,9,97
"25540","2390云辰","110/07/13","元大-士林",19,170,-151
"25541","2390云辰","110/07/13","中國信託-松江",81,11,70
"25542","2390云辰","110/07/13","臺銀-新竹",14,117,-103
"25543","2390云辰","110/07/13","日盛-板橋",72,3,69
"25544","2390云辰","110/07/13","國票-台中",4,102,-98
"25545","2390云辰","110/07/13","日盛-和美",57,0,57
"25546","2390云辰","110/07/13","新光",147,232,-85
"25547","2390云辰","110/07/13","永豐金-桃園",88,36,52
"25548","2390云辰","110/07/13","致和-崇德",2,70,-68
"25549","2390云辰","110/07/13","玉山-士林",54,4,50
"25550","2390云辰","110/07/13","群益金鼎-屏東",2,70,-68
"25551","2390云辰","110/07/13","富邦-仁愛",56,6,50
"25552","2390云辰","110/07/13","元大-大里",35,98,-63
"25553","2390云辰","110/07/13","第一金-豐原",50,1,49
"25554","2390云辰","110/07/13","元大-萬華",35,94,-59
"25555","2390云辰","110/07/13","摩根大通",502,453,49
"25556","2390云辰","110/07/13","元富-吉利",2,60,-58
"25557","2390云辰","110/07/13","凱基-松山",61,13,48
"25558","2390云辰","110/07/13","兆豐-新竹",3,53,-50
"25559","2390云辰","110/07/13","大昌",64,22,42
"25560","2390云辰","110/07/13","富邦-嘉義",65,108,-43
"25561","2363矽統","110/07/13","凱基-南崁",2133,63,2070
"25562","2363矽統","110/07/13","凱基-幸福",36,4048,-4012
"25563","2363矽統","110/07/13","國泰-敦南",2195,1617,578
"25564","2363矽統","110/07/13","統一",192,3325,-3133
"25565","2363矽統","110/07/13","中農",670,139,531
"25566","2363矽統","110/07/13","新加坡商瑞銀",1000,2747,-1747
"25567","2363矽統","110/07/13","康和-台中",638,154,484
"25568","2363矽統","110/07/13","凱基-台北",5359,6609,-1250
"25569","2363矽統","110/07/13","群益金鼎-三民",577,137,440
"25570","2363矽統","110/07/13","摩根大通",1930,2858,-928
"25571","2363矽統","110/07/13","台新-屏東",510,88,422
"25572","2363矽統","110/07/13","港商野村",960,1679,-719
"25573","2363矽統","110/07/13","德信-中正",455,67,388
"25574","2363矽統","110/07/13","兆豐-復興",25,705,-680
"25575","2363矽統","110/07/13","日盛-竹北",365,70,295
"25576","2363矽統","110/07/13","統一-仁愛",114,755,-641
"25577","2363矽統","110/07/13","元大-佳里",452,189,263
"25578","2363矽統","110/07/13","統一-敦南",29,638,-609
"25579","2363矽統","110/07/13","國票-博愛",296,38,258
"25580","2363矽統","110/07/13","統一-土城",100,704,-604
"25581","2363矽統","110/07/13","元大-萬華",340,95,245
"25582","2363矽統","110/07/13","統一-城中",116,676,-560
"25583","2363矽統","110/07/13","新光",1259,1031,228
"25584","2363矽統","110/07/13","永豐金證券",306,859,-553
"25585","2363矽統","110/07/13","元富-成功",323,96,227
"25586","2363矽統","110/07/13","元富",54,567,-513
"25587","2363矽統","110/07/13","豐農",228,23,205
"25588","2363矽統","110/07/13","瑞士信貸",202,666,-464
"25589","2363矽統","110/07/13","台灣企銀-岡山",186,4,182
"25590","2363矽統","110/07/13","永豐金-嘉義",67,468,-401
"25591","8112至上","110/07/13","摩根大通",688,296,392
"25592","8112至上","110/07/13","國票-中和",0,401,-401
"25593","8112至上","110/07/13","港商野村",344,145,199
"25594","8112至上","110/07/13","永豐金-板盛",0,205,-205
"25595","8112至上","110/07/13","兆豐-公益",195,5,190
"25596","8112至上","110/07/13","凱基-五股",43,155,-112
"25597","8112至上","110/07/13","台灣摩根士丹利",183,0,183
"25598","8112至上","110/07/13","凱基-市政",0,100,-100
"25599","8112至上","110/07/13","群益金鼎-敦南",153,2,151
"25600","8112至上","110/07/13","元大-大里德芳",1,92,-91
"25601","8112至上","110/07/13","臺銀-金山",146,26,120
"25602","8112至上","110/07/13","玉山-桃園",26,110,-84
"25603","8112至上","110/07/13","臺銀",133,19,114
"25604","8112至上","110/07/13","兆豐-天母",0,81,-81
"25605","8112至上","110/07/13","合庫-台中",115,6,109
"25606","8112至上","110/07/13","凱基-城中",3,84,-81
"25607","8112至上","110/07/13","亞東-板橋",134,26,108
"25608","8112至上","110/07/13","日盛-新莊",9,85,-76
"25609","8112至上","110/07/13","凱基-台北",414,326,88
"25610","8112至上","110/07/13","日盛-台中",2,64,-62
"25611","8112至上","110/07/13","新加坡商瑞銀",181,100,81
"25612","8112至上","110/07/13","日盛-中壢",3,64,-61
"25613","8112至上","110/07/13","國泰-敦南",108,31,77
"25614","8112至上","110/07/13","元大-台中",2,59,-57
"25615","8112至上","110/07/13","第一金-華江",77,4,73
"25616","8112至上","110/07/13","元大-雙和",7,64,-57
"25617","8112至上","110/07/13","永豐金-內湖",73,1,72
"25618","8112至上","110/07/13","元大-高雄",8,62,-54
"25619","8112至上","110/07/13","元大-永和",68,1,67
"25620","8112至上","110/07/13","元大-館前",2,55,-53
"25621","4903聯光通","110/07/13","台灣企銀-太平",56,0,56
"25622","4903聯光通","110/07/13","土銀",0,32,-32
"25623","4903聯光通","110/07/13","元富-新興",23,0,23
"25624","4903聯光通","110/07/13","元大-樹林",0,19,-19
"25625","4903聯光通","110/07/13","日盛-樹林",22,0,22
"25626","4903聯光通","110/07/13","凱基-士林",0,17,-17
"25627","4903聯光通","110/07/13","兆豐-天母",20,0,20
"25628","4903聯光通","110/07/13","國票-博愛",0,14,-14
"25629","4903聯光通","110/07/13","華南永昌-桃園",20,0,20
"25630","4903聯光通","110/07/13","元富",0,10,-10
"25631","4903聯光通","110/07/13","富邦-新店",10,0,10
"25632","4903聯光通","110/07/13","新光",0,10,-10
"25633","4903聯光通","110/07/13","新光-台中",5,0,5
"25634","4903聯光通","110/07/13","玉山-南京東路",0,10,-10
"25635","4903聯光通","110/07/13","華南永昌-台中",5,0,5
"25636","4903聯光通","110/07/13","富邦-陽明",0,10,-10
"25637","4903聯光通","110/07/13","元大-崇德",5,0,5
"25638","4903聯光通","110/07/13","元大-大甲",0,8,-8
"25639","4903聯光通","110/07/13","元大-草屯",5,0,5
"25640","4903聯光通","110/07/13","富邦-台中",0,7,-7
"25641","4903聯光通","110/07/13","元富-草屯",4,0,4
"25642","4903聯光通","110/07/13","凱基-中壢",0,6,-6
"25643","4903聯光通","110/07/13","元大-清水",4,0,4
"25644","4903聯光通","110/07/13","臺銀-民權",0,5,-5
"25645","4903聯光通","110/07/13","元大-東泰",4,0,4
"25646","4903聯光通","110/07/13","日盛-板橋",0,5,-5
"25647","4903聯光通","110/07/13","元大-佳里",2,0,2
"25648","4903聯光通","110/07/13","中國信託-忠孝",0,5,-5
"25649","4903聯光通","110/07/13","永豐金-板橋",2,0,2
"25650","4903聯光通","110/07/13","永豐金-鳳山",0,5,-5
"25651","2929淘帝","110/07/13","玉山-新竹",130,0,130
"25652","2929淘帝","110/07/13","美商高盛",0,177,-177
"25653","2929淘帝","110/07/13","臺銀-民權",60,0,60
"25654","2929淘帝","110/07/13","凱基-台北",6,80,-74
"25655","2929淘帝","110/07/13","新百王",31,0,31
"25656","2929淘帝","110/07/13","元富-大裕",0,49,-49
"25657","2929淘帝","110/07/13","日盛-園區",30,0,30
"25658","2929淘帝","110/07/13","國泰-館前",3,51,-48
"25659","2929淘帝","110/07/13","元大-南投",31,1,30
"25660","2929淘帝","110/07/13","凱基-中壢",0,41,-41
"25661","2929淘帝","110/07/13","兆豐-忠孝",28,0,28
"25662","2929淘帝","110/07/13","港商野村",21,55,-34
"25663","2929淘帝","110/07/13","元大-民生",28,0,28
"25664","2929淘帝","110/07/13","華南永昌-南京",2,34,-32
"25665","2929淘帝","110/07/13","合庫-高雄",27,0,27
"25666","2929淘帝","110/07/13","群益金鼎-土城",0,30,-30
"25667","2929淘帝","110/07/13","凱基-豐中",27,0,27
"25668","2929淘帝","110/07/13","富邦-南屯",0,22,-22
"25669","2929淘帝","110/07/13","新光",21,4,17
"25670","2929淘帝","110/07/13","第一金-豐原",0,20,-20
"25671","2929淘帝","110/07/13","元大-天母",17,0,17
"25672","2929淘帝","110/07/13","元大-屏南",6,26,-20
"25673","2929淘帝","110/07/13","永興",14,0,14
"25674","2929淘帝","110/07/13","永豐金-敦南",1,21,-20
"25675","2929淘帝","110/07/13","富邦-台北",12,0,12
"25676","2929淘帝","110/07/13","凱基-三重",2,21,-19
"25677","2929淘帝","110/07/13","元大-永和",12,0,12
"25678","2929淘帝","110/07/13","富邦-仁愛",7,25,-18
"25679","2929淘帝","110/07/13","國票-天祥",11,0,11
"25680","2929淘帝","110/07/13","元大-北投",0,16,-16
"25681","5410國眾","110/07/13","兆豐-城中",274,0,274
"25682","5410國眾","110/07/13","元富-嘉義",0,103,-103
"25683","5410國眾","110/07/13","新光",50,4,46
"25684","5410國眾","110/07/13","凱基-台北",0,50,-50
"25685","5410國眾","110/07/13","國泰-台中",26,0,26
"25686","5410國眾","110/07/13","瑞士信貸",0,31,-31
"25687","5410國眾","110/07/13","新加坡商瑞銀",22,0,22
"25688","5410國眾","110/07/13","台新-新莊",0,27,-27
"25689","5410國眾","110/07/13","光和-嘉義",20,0,20
"25690","5410國眾","110/07/13","元大-汐止",0,20,-20
"25691","5410國眾","110/07/13","凱基-竹北",17,0,17
"25692","5410國眾","110/07/13","亞東-新竹",0,17,-17
"25693","5410國眾","110/07/13","新光-桃園",15,0,15
"25694","5410國眾","110/07/13","元大-南勢角",0,13,-13
"25695","5410國眾","110/07/13","凱基-台東",14,0,14
"25696","5410國眾","110/07/13","台新-台南",0,12,-12
"25697","5410國眾","110/07/13","富邦-竹北",11,0,11
"25698","5410國眾","110/07/13","中國信託",0,11,-11
"25699","5410國眾","110/07/13","元富-同大",10,0,10
"25700","5410國眾","110/07/13","華南永昌",0,11,-11
"25701","5410國眾","110/07/13","國泰-敦南",24,15,9
"25702","5410國眾","110/07/13","臺銀-臺南",0,10,-10
"25703","5410國眾","110/07/13","日盛-內湖",7,0,7
"25704","5410國眾","110/07/13","台灣企銀-民雄",0,10,-10
"25705","5410國眾","110/07/13","台新-左楠",7,0,7
"25706","5410國眾","110/07/13","高橋",0,10,-10
"25707","5410國眾","110/07/13","元大-新盛",18,12,6
"25708","5410國眾","110/07/13","康和-嘉義",0,10,-10
"25709","5410國眾","110/07/13","統一",5,0,5
"25710","5410國眾","110/07/13","凱基-基隆",0,10,-10
"25711","2841台開","110/07/13","中國信託-高雄",251,50,201
"25712","2841台開","110/07/13","兆豐-公益",0,177,-177
"25713","2841台開","110/07/13","日盛證券",210,13,197
"25714","2841台開","110/07/13","日進",0,152,-152
"25715","2841台開","110/07/13","第一金-台中",55,0,55
"25716","2841台開","110/07/13","港商野村",0,109,-109
"25717","2841台開","110/07/13","國泰-板橋",46,0,46
"25718","2841台開","110/07/13","日盛-信義",0,103,-103
"25719","2841台開","110/07/13","國泰-館前",48,3,45
"25720","2841台開","110/07/13","國泰-敦南",11,75,-64
"25721","2841台開","110/07/13","華南永昌-新莊",45,0,45
"25722","2841台開","110/07/13","永興",0,50,-50
"25723","2841台開","110/07/13","日盛-園區",42,0,42
"25724","2841台開","110/07/13","永豐金-敦南",61,104,-43
"25725","2841台開","110/07/13","台新證券",32,0,32
"25726","2841台開","110/07/13","富邦-台南",0,42,-42
"25727","2841台開","110/07/13","台新-高雄",32,2,30
"25728","2841台開","110/07/13","國票-安和",0,30,-30
"25729","2841台開","110/07/13","豐農",23,0,23
"25730","2841台開","110/07/13","元大-桃園",0,25,-25
"25731","2841台開","110/07/13","合庫-嘉義",20,0,20
"25732","2841台開","110/07/13","新光",8,32,-24
"25733","2841台開","110/07/13","華南永昌-高雄",20,0,20
"25734","2841台開","110/07/13","元大-仁愛",0,24,-24
"25735","2841台開","110/07/13","元大-樹林",16,0,16
"25736","2841台開","110/07/13","日盛-中和",0,20,-20
"25737","2841台開","110/07/13","第一金-華江",15,2,13
"25738","2841台開","110/07/13","元富",0,20,-20
"25739","2841台開","110/07/13","美商高盛",12,0,12
"25740","2841台開","110/07/13","富邦-宜蘭",0,20,-20
"25741","6207雷科","110/07/13","元大-高雄",121,0,121
"25742","6207雷科","110/07/13","華南永昌-朴子",1,60,-59
"25743","6207雷科","110/07/13","第一金-新興",20,0,20
"25744","6207雷科","110/07/13","元大-南海",0,36,-36
"25745","6207雷科","110/07/13","元富-三重",20,0,20
"25746","6207雷科","110/07/13","凱基-土城",0,35,-35
"25747","6207雷科","110/07/13","元大-林園",15,0,15
"25748","6207雷科","110/07/13","台灣企銀",0,20,-20
"25749","6207雷科","110/07/13","元大-金華",16,1,15
"25750","6207雷科","110/07/13","群益金鼎-丹鳳",0,20,-20
"25751","6207雷科","110/07/13","日盛證券",10,0,10
"25752","6207雷科","110/07/13","元大-博愛",0,17,-17
"25753","6207雷科","110/07/13","統一-台中",10,0,10
"25754","6207雷科","110/07/13","元大-北港",0,13,-13
"25755","6207雷科","110/07/13","群益金鼎-土城",10,0,10
"25756","6207雷科","110/07/13","新加坡商瑞銀",0,12,-12
"25757","6207雷科","110/07/13","群益金鼎-桃園",10,0,10
"25758","6207雷科","110/07/13","凱基-台北",4,16,-12
"25759","6207雷科","110/07/13","永豐金-新莊",10,0,10
"25760","6207雷科","110/07/13","日茂-埔里",0,11,-11
"25761","6207雷科","110/07/13","永豐金-新店",10,0,10
"25762","6207雷科","110/07/13","元大-莒光",0,11,-11
"25763","6207雷科","110/07/13","元大證券",9,0,9
"25764","6207雷科","110/07/13","統一-新竹",0,10,-10
"25765","6207雷科","110/07/13","日盛-木柵",9,1,8
"25766","6207雷科","110/07/13","元大-西螺",0,10,-10
"25767","6207雷科","110/07/13","兆豐-來福",8,0,8
"25768","6207雷科","110/07/13","康和-台中",0,8,-8
"25769","6207雷科","110/07/13","新光",7,0,7
"25770","6207雷科","110/07/13","兆豐-高雄",0,6,-6
"25771","3679新至陞","110/07/13","永豐金證券",50,0,50
"25772","3679新至陞","110/07/13","摩根大通",2,25,-23
"25773","3679新至陞","110/07/13","國泰-桃園",22,0,22
"25774","3679新至陞","110/07/13","元大-成功",0,22,-22
"25775","3679新至陞","110/07/13","台中銀-員林",11,0,11
"25776","3679新至陞","110/07/13","富邦-板橋",1,19,-18
"25777","3679新至陞","110/07/13","元大-文心興安",8,0,8
"25778","3679新至陞","110/07/13","日盛-新莊",0,10,-10
"25779","3679新至陞","110/07/13","美商高盛",6,0,6
"25780","3679新至陞","110/07/13","台新-台中",0,10,-10
"25781","3679新至陞","110/07/13","台新-高雄",6,0,6
"25782","3679新至陞","110/07/13","永豐金-新竹",0,8,-8
"25783","3679新至陞","110/07/13","凱基-台北",18,12,6
"25784","3679新至陞","110/07/13","瑞士信貸",12,19,-7
"25785","3679新至陞","110/07/13","日盛-復興",5,0,5
"25786","3679新至陞","110/07/13","統一-南京",0,7,-7
"25787","3679新至陞","110/07/13","(牛牛牛)亞-鑫豐",4,0,4
"25788","3679新至陞","110/07/13","凱基-新莊",0,7,-7
"25789","3679新至陞","110/07/13","元富-大昌",3,0,3
"25790","3679新至陞","110/07/13","新加坡商瑞銀",0,6,-6
"25791","3679新至陞","110/07/13","富邦-台北",3,0,3
"25792","3679新至陞","110/07/13","合庫-自強",0,5,-5
"25793","3679新至陞","110/07/13","日盛-樹林",2,0,2
"25794","3679新至陞","110/07/13","富邦-桃園",0,5,-5
"25795","3679新至陞","110/07/13","宏遠-光隆",2,0,2
"25796","3679新至陞","110/07/13","永豐金-潮州",0,4,-4
"25797","3679新至陞","110/07/13","美林",3,1,2
"25798","3679新至陞","110/07/13","臺銀-臺南",0,3,-3
"25799","3679新至陞","110/07/13","第一金-中壢",2,0,2
"25800","3679新至陞","110/07/13","元大-六合",0,3,-3
"25801","2727王品","110/07/13","富邦-台北",43,3,40
"25802","2727王品","110/07/13","台灣摩根士丹利",15,97,-82
"25803","2727王品","110/07/13","元大-基隆孝二",40,0,40
"25804","2727王品","110/07/13","玉山-台南",5,57,-52
"25805","2727王品","110/07/13","國票-新莊",40,1,39
"25806","2727王品","110/07/13","新加坡商瑞銀",0,48,-48
"25807","2727王品","110/07/13","第一金-豐原",66,42,24
"25808","2727王品","110/07/13","凱基-台北",41,77,-36
"25809","2727王品","110/07/13","永豐金-大園",34,10,24
"25810","2727王品","110/07/13","永豐金-永康",0,22,-22
"25811","2727王品","110/07/13","元大-北屯",22,0,22
"25812","2727王品","110/07/13","統一-台中",2,22,-20
"25813","2727王品","110/07/13","元大-東蘆",26,7,19
"25814","2727王品","110/07/13","國泰-台中",21,39,-18
"25815","2727王品","110/07/13","永豐金-萬盛",13,1,12
"25816","2727王品","110/07/13","合庫-彰化",3,20,-17
"25817","2727王品","110/07/13","日盛-嘉義",11,0,11
"25818","2727王品","110/07/13","港商野村",13,30,-17
"25819","2727王品","110/07/13","日盛-八德",11,0,11
"25820","2727王品","110/07/13","元大-楊梅",1,16,-15
"25821","2727王品","110/07/13","統一-竹南",11,0,11
"25822","2727王品","110/07/13","凱基-高美館",2,15,-13
"25823","2727王品","110/07/13","日盛-士林",12,2,10
"25824","2727王品","110/07/13","美商高盛",2,14,-12
"25825","2727王品","110/07/13","統一-敦南",10,0,10
"25826","2727王品","110/07/13","統一-平鎮",1,13,-12
"25827","2727王品","110/07/13","中國信託",15,5,10
"25828","2727王品","110/07/13","兆豐-台中港",4,16,-12
"25829","2727王品","110/07/13","兆豐-竹北",13,3,10
"25830","2727王品","110/07/13","凱基-八德",1,13,-12
"25831","1570力肯","110/07/13","新光",115,11,104
"25832","1570力肯","110/07/13","元大-北三重",0,162,-162
"25833","1570力肯","110/07/13","群益金鼎-高雄",54,0,54
"25834","1570力肯","110/07/13","元大-大灣",0,25,-25
"25835","1570力肯","110/07/13","國票-新莊",22,0,22
"25836","1570力肯","110/07/13","永豐金-苓雅",0,22,-22
"25837","1570力肯","110/07/13","日盛-桃園",12,0,12
"25838","1570力肯","110/07/13","永豐金-永康",0,19,-19
"25839","1570力肯","110/07/13","元大-高雄",12,0,12
"25840","1570力肯","110/07/13","富邦-員林",0,15,-15
"25841","1570力肯","110/07/13","合庫-自強",11,0,11
"25842","1570力肯","110/07/13","凱基-台南",0,11,-11
"25843","1570力肯","110/07/13","摩根大通",26,15,11
"25844","1570力肯","110/07/13","日盛-竹北",0,10,-10
"25845","1570力肯","110/07/13","永豐金-中盛",11,0,11
"25846","1570力肯","110/07/13","國票-九鼎",0,10,-10
"25847","1570力肯","110/07/13","兆豐-台中港",10,0,10
"25848","1570力肯","110/07/13","凱基-桃園",0,10,-10
"25849","1570力肯","110/07/13","國泰-松江",9,0,9
"25850","1570力肯","110/07/13","凱基-新豐",0,10,-10
"25851","1570力肯","110/07/13","元大-新盛",9,0,9
"25852","1570力肯","110/07/13","元大-學甲",0,10,-10
"25853","1570力肯","110/07/13","元富-緯城",6,0,6
"25854","1570力肯","110/07/13","群益金鼎-東湖",1,10,-9
"25855","1570力肯","110/07/13","統一-三重",5,0,5
"25856","1570力肯","110/07/13","大昌",0,6,-6
"25857","1570力肯","110/07/13","元大-前金",5,0,5
"25858","1570力肯","110/07/13","元大-土城學府",0,6,-6
"25859","1570力肯","110/07/13","永豐金證券",5,0,5
"25860","1570力肯","110/07/13","統一",0,5,-5
"25861","6180橘子","110/07/13","摩根大通",119,0,119
"25862","6180橘子","110/07/13","元大-崇德",2,61,-59
"25863","6180橘子","110/07/13","美商高盛",96,0,96
"25864","6180橘子","110/07/13","康和-台中",0,51,-51
"25865","6180橘子","110/07/13","新加坡商瑞銀",86,7,79
"25866","6180橘子","110/07/13","康和-台北",0,50,-50
"25867","6180橘子","110/07/13","元大-和平",40,0,40
"25868","6180橘子","110/07/13","元富-潮州",0,40,-40
"25869","6180橘子","110/07/13","凱基-台北",83,47,36
"25870","6180橘子","110/07/13","日盛-永康",0,26,-26
"25871","6180橘子","110/07/13","美林",39,5,34
"25872","6180橘子","110/07/13","永豐金-中正",0,24,-24
"25873","6180橘子","110/07/13","富邦-新竹華信",31,2,29
"25874","6180橘子","110/07/13","國泰-板橋",2,25,-23
"25875","6180橘子","110/07/13","統一-南京",21,0,21
"25876","6180橘子","110/07/13","日盛-大墩",0,20,-20
"25877","6180橘子","110/07/13","富邦-陽明",24,3,21
"25878","6180橘子","110/07/13","元大-草屯",13,32,-19
"25879","6180橘子","110/07/13","大昌-樹林",21,1,20
"25880","6180橘子","110/07/13","元富-林園",1,18,-17
"25881","6180橘子","110/07/13","花旗環球",19,0,19
"25882","6180橘子","110/07/13","新光-新竹",1,18,-17
"25883","6180橘子","110/07/13","華南永昌-台南",19,0,19
"25884","6180橘子","110/07/13","元大-土城永寧",0,17,-17
"25885","6180橘子","110/07/13","福勝",14,0,14
"25886","6180橘子","110/07/13","國泰-新莊",3,19,-16
"25887","6180橘子","110/07/13","富邦-嘉義",12,1,11
"25888","6180橘子","110/07/13","中國信託-永康",6,21,-15
"25889","6180橘子","110/07/13","元大-板橋三民",11,0,11
"25890","6180橘子","110/07/13","凱基-東港",1,15,-14
"25891","2390云辰","110/07/13","新加坡商瑞銀",562,75,487
"25892","2390云辰","110/07/13","大展-台南",0,532,-532
"25893","2390云辰","110/07/13","台灣摩根士丹利",330,155,175
"25894","2390云辰","110/07/13","凱基-台北",668,854,-186
"25895","2390云辰","110/07/13","兆豐-公益",126,25,101
"25896","2390云辰","110/07/13","凱基-三重",12,172,-160
"25897","2390云辰","110/07/13","元富-中港",100,2,98
"25898","2390云辰","110/07/13","兆豐-忠孝",4,161,-157
"25899","2390云辰","110/07/13","統一-新台中",106,9,97
"25900","2390云辰","110/07/13","元大-士林",19,170,-151
"25901","2390云辰","110/07/13","中國信託-松江",81,11,70
"25902","2390云辰","110/07/13","臺銀-新竹",14,117,-103
"25903","2390云辰","110/07/13","日盛-板橋",72,3,69
"25904","2390云辰","110/07/13","國票-台中",4,102,-98
"25905","2390云辰","110/07/13","日盛-和美",57,0,57
"25906","2390云辰","110/07/13","新光",147,232,-85
"25907","2390云辰","110/07/13","永豐金-桃園",88,36,52
"25908","2390云辰","110/07/13","致和-崇德",2,70,-68
"25909","2390云辰","110/07/13","玉山-士林",54,4,50
"25910","2390云辰","110/07/13","群益金鼎-屏東",2,70,-68
"25911","2390云辰","110/07/13","富邦-仁愛",56,6,50
"25912","2390云辰","110/07/13","元大-大里",35,98,-63
"25913","2390云辰","110/07/13","第一金-豐原",50,1,49
"25914","2390云辰","110/07/13","元大-萬華",35,94,-59
"25915","2390云辰","110/07/13","摩根大通",502,453,49
"25916","2390云辰","110/07/13","元富-吉利",2,60,-58
"25917","2390云辰","110/07/13","凱基-松山",61,13,48
"25918","2390云辰","110/07/13","兆豐-新竹",3,53,-50
"25919","2390云辰","110/07/13","大昌",64,22,42
"25920","2390云辰","110/07/13","富邦-嘉義",65,108,-43
"25921","2363矽統","110/07/13","凱基-南崁",2133,63,2070
"25922","2363矽統","110/07/13","凱基-幸福",36,4048,-4012
"25923","2363矽統","110/07/13","國泰-敦南",2195,1617,578
"25924","2363矽統","110/07/13","統一",192,3325,-3133
"25925","2363矽統","110/07/13","中農",670,139,531
"25926","2363矽統","110/07/13","新加坡商瑞銀",1000,2747,-1747
"25927","2363矽統","110/07/13","康和-台中",638,154,484
"25928","2363矽統","110/07/13","凱基-台北",5359,6609,-1250
"25929","2363矽統","110/07/13","群益金鼎-三民",577,137,440
"25930","2363矽統","110/07/13","摩根大通",1930,2858,-928
"25931","2363矽統","110/07/13","台新-屏東",510,88,422
"25932","2363矽統","110/07/13","港商野村",960,1679,-719
"25933","2363矽統","110/07/13","德信-中正",455,67,388
"25934","2363矽統","110/07/13","兆豐-復興",25,705,-680
"25935","2363矽統","110/07/13","日盛-竹北",365,70,295
"25936","2363矽統","110/07/13","統一-仁愛",114,755,-641
"25937","2363矽統","110/07/13","元大-佳里",452,189,263
"25938","2363矽統","110/07/13","統一-敦南",29,638,-609
"25939","2363矽統","110/07/13","國票-博愛",296,38,258
"25940","2363矽統","110/07/13","統一-土城",100,704,-604
"25941","2363矽統","110/07/13","元大-萬華",340,95,245
"25942","2363矽統","110/07/13","統一-城中",116,676,-560
"25943","2363矽統","110/07/13","新光",1259,1031,228
"25944","2363矽統","110/07/13","永豐金證券",306,859,-553
"25945","2363矽統","110/07/13","元富-成功",323,96,227
"25946","2363矽統","110/07/13","元富",54,567,-513
"25947","2363矽統","110/07/13","豐農",228,23,205
"25948","2363矽統","110/07/13","瑞士信貸",202,666,-464
"25949","2363矽統","110/07/13","台灣企銀-岡山",186,4,182
"25950","2363矽統","110/07/13","永豐金-嘉義",67,468,-401
"25951","8112至上","110/07/13","摩根大通",688,296,392
"25952","8112至上","110/07/13","國票-中和",0,401,-401
"25953","8112至上","110/07/13","港商野村",344,145,199
"25954","8112至上","110/07/13","永豐金-板盛",0,205,-205
"25955","8112至上","110/07/13","兆豐-公益",195,5,190
"25956","8112至上","110/07/13","凱基-五股",43,155,-112
"25957","8112至上","110/07/13","台灣摩根士丹利",183,0,183
"25958","8112至上","110/07/13","凱基-市政",0,100,-100
"25959","8112至上","110/07/13","群益金鼎-敦南",153,2,151
"25960","8112至上","110/07/13","元大-大里德芳",1,92,-91
"25961","8112至上","110/07/13","臺銀-金山",146,26,120
"25962","8112至上","110/07/13","玉山-桃園",26,110,-84
"25963","8112至上","110/07/13","臺銀",133,19,114
"25964","8112至上","110/07/13","兆豐-天母",0,81,-81
"25965","8112至上","110/07/13","合庫-台中",115,6,109
"25966","8112至上","110/07/13","凱基-城中",3,84,-81
"25967","8112至上","110/07/13","亞東-板橋",134,26,108
"25968","8112至上","110/07/13","日盛-新莊",9,85,-76
"25969","8112至上","110/07/13","凱基-台北",414,326,88
"25970","8112至上","110/07/13","日盛-台中",2,64,-62
"25971","8112至上","110/07/13","新加坡商瑞銀",181,100,81
"25972","8112至上","110/07/13","日盛-中壢",3,64,-61
"25973","8112至上","110/07/13","國泰-敦南",108,31,77
"25974","8112至上","110/07/13","元大-台中",2,59,-57
"25975","8112至上","110/07/13","第一金-華江",77,4,73
"25976","8112至上","110/07/13","元大-雙和",7,64,-57
"25977","8112至上","110/07/13","永豐金-內湖",73,1,72
"25978","8112至上","110/07/13","元大-高雄",8,62,-54
"25979","8112至上","110/07/13","元大-永和",68,1,67
"25980","8112至上","110/07/13","元大-館前",2,55,-53
"25981","4903聯光通","110/07/13","台灣企銀-太平",56,0,56
"25982","4903聯光通","110/07/13","土銀",0,32,-32
"25983","4903聯光通","110/07/13","元富-新興",23,0,23
"25984","4903聯光通","110/07/13","元大-樹林",0,19,-19
"25985","4903聯光通","110/07/13","日盛-樹林",22,0,22
"25986","4903聯光通","110/07/13","凱基-士林",0,17,-17
"25987","4903聯光通","110/07/13","兆豐-天母",20,0,20
"25988","4903聯光通","110/07/13","國票-博愛",0,14,-14
"25989","4903聯光通","110/07/13","華南永昌-桃園",20,0,20
"25990","4903聯光通","110/07/13","元富",0,10,-10
"25991","4903聯光通","110/07/13","富邦-新店",10,0,10
"25992","4903聯光通","110/07/13","新光",0,10,-10
"25993","4903聯光通","110/07/13","新光-台中",5,0,5
"25994","4903聯光通","110/07/13","玉山-南京東路",0,10,-10
"25995","4903聯光通","110/07/13","華南永昌-台中",5,0,5
"25996","4903聯光通","110/07/13","富邦-陽明",0,10,-10
"25997","4903聯光通","110/07/13","元大-崇德",5,0,5
"25998","4903聯光通","110/07/13","元大-大甲",0,8,-8
"25999","4903聯光通","110/07/13","元大-草屯",5,0,5
"26000","4903聯光通","110/07/13","富邦-台中",0,7,-7
"26001","4903聯光通","110/07/13","元富-草屯",4,0,4
"26002","4903聯光通","110/07/13","凱基-中壢",0,6,-6
"26003","4903聯光通","110/07/13","元大-清水",4,0,4
"26004","4903聯光通","110/07/13","臺銀-民權",0,5,-5
"26005","4903聯光通","110/07/13","元大-東泰",4,0,4
"26006","4903聯光通","110/07/13","日盛-板橋",0,5,-5
"26007","4903聯光通","110/07/13","元大-佳里",2,0,2
"26008","4903聯光通","110/07/13","中國信託-忠孝",0,5,-5
"26009","4903聯光通","110/07/13","永豐金-板橋",2,0,2
"26010","4903聯光通","110/07/13","永豐金-鳳山",0,5,-5
"26011","2929淘帝","110/07/13","玉山-新竹",130,0,130
"26012","2929淘帝","110/07/13","美商高盛",0,177,-177
"26013","2929淘帝","110/07/13","臺銀-民權",60,0,60
"26014","2929淘帝","110/07/13","凱基-台北",6,80,-74
"26015","2929淘帝","110/07/13","新百王",31,0,31
"26016","2929淘帝","110/07/13","元富-大裕",0,49,-49
"26017","2929淘帝","110/07/13","日盛-園區",30,0,30
"26018","2929淘帝","110/07/13","國泰-館前",3,51,-48
"26019","2929淘帝","110/07/13","元大-南投",31,1,30
"26020","2929淘帝","110/07/13","凱基-中壢",0,41,-41
"26021","2929淘帝","110/07/13","兆豐-忠孝",28,0,28
"26022","2929淘帝","110/07/13","港商野村",21,55,-34
"26023","2929淘帝","110/07/13","元大-民生",28,0,28
"26024","2929淘帝","110/07/13","華南永昌-南京",2,34,-32
"26025","2929淘帝","110/07/13","合庫-高雄",27,0,27
"26026","2929淘帝","110/07/13","群益金鼎-土城",0,30,-30
"26027","2929淘帝","110/07/13","凱基-豐中",27,0,27
"26028","2929淘帝","110/07/13","富邦-南屯",0,22,-22
"26029","2929淘帝","110/07/13","新光",21,4,17
"26030","2929淘帝","110/07/13","第一金-豐原",0,20,-20
"26031","2929淘帝","110/07/13","元大-天母",17,0,17
"26032","2929淘帝","110/07/13","元大-屏南",6,26,-20
"26033","2929淘帝","110/07/13","永興",14,0,14
"26034","2929淘帝","110/07/13","永豐金-敦南",1,21,-20
"26035","2929淘帝","110/07/13","富邦-台北",12,0,12
"26036","2929淘帝","110/07/13","凱基-三重",2,21,-19
"26037","2929淘帝","110/07/13","元大-永和",12,0,12
"26038","2929淘帝","110/07/13","富邦-仁愛",7,25,-18
"26039","2929淘帝","110/07/13","國票-天祥",11,0,11
"26040","2929淘帝","110/07/13","元大-北投",0,16,-16
"26041","5410國眾","110/07/13","兆豐-城中",274,0,274
"26042","5410國眾","110/07/13","元富-嘉義",0,103,-103
"26043","5410國眾","110/07/13","新光",50,4,46
"26044","5410國眾","110/07/13","凱基-台北",0,50,-50
"26045","5410國眾","110/07/13","國泰-台中",26,0,26
"26046","5410國眾","110/07/13","瑞士信貸",0,31,-31
"26047","5410國眾","110/07/13","新加坡商瑞銀",22,0,22
"26048","5410國眾","110/07/13","台新-新莊",0,27,-27
"26049","5410國眾","110/07/13","光和-嘉義",20,0,20
"26050","5410國眾","110/07/13","元大-汐止",0,20,-20
"26051","5410國眾","110/07/13","凱基-竹北",17,0,17
"26052","5410國眾","110/07/13","亞東-新竹",0,17,-17
"26053","5410國眾","110/07/13","新光-桃園",15,0,15
"26054","5410國眾","110/07/13","元大-南勢角",0,13,-13
"26055","5410國眾","110/07/13","凱基-台東",14,0,14
"26056","5410國眾","110/07/13","台新-台南",0,12,-12
"26057","5410國眾","110/07/13","富邦-竹北",11,0,11
"26058","5410國眾","110/07/13","中國信託",0,11,-11
"26059","5410國眾","110/07/13","元富-同大",10,0,10
"26060","5410國眾","110/07/13","華南永昌",0,11,-11
"26061","5410國眾","110/07/13","國泰-敦南",24,15,9
"26062","5410國眾","110/07/13","臺銀-臺南",0,10,-10
"26063","5410國眾","110/07/13","日盛-內湖",7,0,7
"26064","5410國眾","110/07/13","台灣企銀-民雄",0,10,-10
"26065","5410國眾","110/07/13","台新-左楠",7,0,7
"26066","5410國眾","110/07/13","高橋",0,10,-10
"26067","5410國眾","110/07/13","元大-新盛",18,12,6
"26068","5410國眾","110/07/13","康和-嘉義",0,10,-10
"26069","5410國眾","110/07/13","統一",5,0,5
"26070","5410國眾","110/07/13","凱基-基隆",0,10,-10
"26071","2841台開","110/07/13","中國信託-高雄",251,50,201
"26072","2841台開","110/07/13","兆豐-公益",0,177,-177
"26073","2841台開","110/07/13","日盛證券",210,13,197
"26074","2841台開","110/07/13","日進",0,152,-152
"26075","2841台開","110/07/13","第一金-台中",55,0,55
"26076","2841台開","110/07/13","港商野村",0,109,-109
"26077","2841台開","110/07/13","國泰-板橋",46,0,46
"26078","2841台開","110/07/13","日盛-信義",0,103,-103
"26079","2841台開","110/07/13","國泰-館前",48,3,45
"26080","2841台開","110/07/13","國泰-敦南",11,75,-64
"26081","2841台開","110/07/13","華南永昌-新莊",45,0,45
"26082","2841台開","110/07/13","永興",0,50,-50
"26083","2841台開","110/07/13","日盛-園區",42,0,42
"26084","2841台開","110/07/13","永豐金-敦南",61,104,-43
"26085","2841台開","110/07/13","台新證券",32,0,32
"26086","2841台開","110/07/13","富邦-台南",0,42,-42
"26087","2841台開","110/07/13","台新-高雄",32,2,30
"26088","2841台開","110/07/13","國票-安和",0,30,-30
"26089","2841台開","110/07/13","豐農",23,0,23
"26090","2841台開","110/07/13","元大-桃園",0,25,-25
"26091","2841台開","110/07/13","合庫-嘉義",20,0,20
"26092","2841台開","110/07/13","新光",8,32,-24
"26093","2841台開","110/07/13","華南永昌-高雄",20,0,20
"26094","2841台開","110/07/13","元大-仁愛",0,24,-24
"26095","2841台開","110/07/13","元大-樹林",16,0,16
"26096","2841台開","110/07/13","日盛-中和",0,20,-20
"26097","2841台開","110/07/13","第一金-華江",15,2,13
"26098","2841台開","110/07/13","元富",0,20,-20
"26099","2841台開","110/07/13","美商高盛",12,0,12
"26100","2841台開","110/07/13","富邦-宜蘭",0,20,-20
"26101","6207雷科","110/07/13","元大-高雄",121,0,121
"26102","6207雷科","110/07/13","華南永昌-朴子",1,60,-59
"26103","6207雷科","110/07/13","第一金-新興",20,0,20
"26104","6207雷科","110/07/13","元大-南海",0,36,-36
"26105","6207雷科","110/07/13","元富-三重",20,0,20
"26106","6207雷科","110/07/13","凱基-土城",0,35,-35
"26107","6207雷科","110/07/13","元大-林園",15,0,15
"26108","6207雷科","110/07/13","台灣企銀",0,20,-20
"26109","6207雷科","110/07/13","元大-金華",16,1,15
"26110","6207雷科","110/07/13","群益金鼎-丹鳳",0,20,-20
"26111","6207雷科","110/07/13","日盛證券",10,0,10
"26112","6207雷科","110/07/13","元大-博愛",0,17,-17
"26113","6207雷科","110/07/13","統一-台中",10,0,10
"26114","6207雷科","110/07/13","元大-北港",0,13,-13
"26115","6207雷科","110/07/13","群益金鼎-土城",10,0,10
"26116","6207雷科","110/07/13","新加坡商瑞銀",0,12,-12
"26117","6207雷科","110/07/13","群益金鼎-桃園",10,0,10
"26118","6207雷科","110/07/13","凱基-台北",4,16,-12
"26119","6207雷科","110/07/13","永豐金-新莊",10,0,10
"26120","6207雷科","110/07/13","日茂-埔里",0,11,-11
"26121","6207雷科","110/07/13","永豐金-新店",10,0,10
"26122","6207雷科","110/07/13","元大-莒光",0,11,-11
"26123","6207雷科","110/07/13","元大證券",9,0,9
"26124","6207雷科","110/07/13","統一-新竹",0,10,-10
"26125","6207雷科","110/07/13","日盛-木柵",9,1,8
"26126","6207雷科","110/07/13","元大-西螺",0,10,-10
"26127","6207雷科","110/07/13","兆豐-來福",8,0,8
"26128","6207雷科","110/07/13","康和-台中",0,8,-8
"26129","6207雷科","110/07/13","新光",7,0,7
"26130","6207雷科","110/07/13","兆豐-高雄",0,6,-6
"26131","3679新至陞","110/07/13","永豐金證券",50,0,50
"26132","3679新至陞","110/07/13","摩根大通",2,25,-23
"26133","3679新至陞","110/07/13","國泰-桃園",22,0,22
"26134","3679新至陞","110/07/13","元大-成功",0,22,-22
"26135","3679新至陞","110/07/13","台中銀-員林",11,0,11
"26136","3679新至陞","110/07/13","富邦-板橋",1,19,-18
"26137","3679新至陞","110/07/13","元大-文心興安",8,0,8
"26138","3679新至陞","110/07/13","日盛-新莊",0,10,-10
"26139","3679新至陞","110/07/13","美商高盛",6,0,6
"26140","3679新至陞","110/07/13","台新-台中",0,10,-10
"26141","3679新至陞","110/07/13","台新-高雄",6,0,6
"26142","3679新至陞","110/07/13","永豐金-新竹",0,8,-8
"26143","3679新至陞","110/07/13","凱基-台北",18,12,6
"26144","3679新至陞","110/07/13","瑞士信貸",12,19,-7
"26145","3679新至陞","110/07/13","日盛-復興",5,0,5
"26146","3679新至陞","110/07/13","統一-南京",0,7,-7
"26147","3679新至陞","110/07/13","(牛牛牛)亞-鑫豐",4,0,4
"26148","3679新至陞","110/07/13","凱基-新莊",0,7,-7
"26149","3679新至陞","110/07/13","元富-大昌",3,0,3
"26150","3679新至陞","110/07/13","新加坡商瑞銀",0,6,-6
"26151","3679新至陞","110/07/13","富邦-台北",3,0,3
"26152","3679新至陞","110/07/13","合庫-自強",0,5,-5
"26153","3679新至陞","110/07/13","日盛-樹林",2,0,2
"26154","3679新至陞","110/07/13","富邦-桃園",0,5,-5
"26155","3679新至陞","110/07/13","宏遠-光隆",2,0,2
"26156","3679新至陞","110/07/13","永豐金-潮州",0,4,-4
"26157","3679新至陞","110/07/13","美林",3,1,2
"26158","3679新至陞","110/07/13","臺銀-臺南",0,3,-3
"26159","3679新至陞","110/07/13","第一金-中壢",2,0,2
"26160","3679新至陞","110/07/13","元大-六合",0,3,-3
"26161","2727王品","110/07/13","富邦-台北",43,3,40
"26162","2727王品","110/07/13","台灣摩根士丹利",15,97,-82
"26163","2727王品","110/07/13","元大-基隆孝二",40,0,40
"26164","2727王品","110/07/13","玉山-台南",5,57,-52
"26165","2727王品","110/07/13","國票-新莊",40,1,39
"26166","2727王品","110/07/13","新加坡商瑞銀",0,48,-48
"26167","2727王品","110/07/13","第一金-豐原",66,42,24
"26168","2727王品","110/07/13","凱基-台北",41,77,-36
"26169","2727王品","110/07/13","永豐金-大園",34,10,24
"26170","2727王品","110/07/13","永豐金-永康",0,22,-22
"26171","2727王品","110/07/13","元大-北屯",22,0,22
"26172","2727王品","110/07/13","統一-台中",2,22,-20
"26173","2727王品","110/07/13","元大-東蘆",26,7,19
"26174","2727王品","110/07/13","國泰-台中",21,39,-18
"26175","2727王品","110/07/13","永豐金-萬盛",13,1,12
"26176","2727王品","110/07/13","合庫-彰化",3,20,-17
"26177","2727王品","110/07/13","日盛-嘉義",11,0,11
"26178","2727王品","110/07/13","港商野村",13,30,-17
"26179","2727王品","110/07/13","日盛-八德",11,0,11
"26180","2727王品","110/07/13","元大-楊梅",1,16,-15
"26181","2727王品","110/07/13","統一-竹南",11,0,11
"26182","2727王品","110/07/13","凱基-高美館",2,15,-13
"26183","2727王品","110/07/13","日盛-士林",12,2,10
"26184","2727王品","110/07/13","美商高盛",2,14,-12
"26185","2727王品","110/07/13","統一-敦南",10,0,10
"26186","2727王品","110/07/13","統一-平鎮",1,13,-12
"26187","2727王品","110/07/13","中國信託",15,5,10
"26188","2727王品","110/07/13","兆豐-台中港",4,16,-12
"26189","2727王品","110/07/13","兆豐-竹北",13,3,10
"26190","2727王品","110/07/13","凱基-八德",1,13,-12
"26191","1570力肯","110/07/13","新光",115,11,104
"26192","1570力肯","110/07/13","元大-北三重",0,162,-162
"26193","1570力肯","110/07/13","群益金鼎-高雄",54,0,54
"26194","1570力肯","110/07/13","元大-大灣",0,25,-25
"26195","1570力肯","110/07/13","國票-新莊",22,0,22
"26196","1570力肯","110/07/13","永豐金-苓雅",0,22,-22
"26197","1570力肯","110/07/13","日盛-桃園",12,0,12
"26198","1570力肯","110/07/13","永豐金-永康",0,19,-19
"26199","1570力肯","110/07/13","元大-高雄",12,0,12
"26200","1570力肯","110/07/13","富邦-員林",0,15,-15
"26201","1570力肯","110/07/13","合庫-自強",11,0,11
"26202","1570力肯","110/07/13","凱基-台南",0,11,-11
"26203","1570力肯","110/07/13","摩根大通",26,15,11
"26204","1570力肯","110/07/13","日盛-竹北",0,10,-10
"26205","1570力肯","110/07/13","永豐金-中盛",11,0,11
"26206","1570力肯","110/07/13","國票-九鼎",0,10,-10
"26207","1570力肯","110/07/13","兆豐-台中港",10,0,10
"26208","1570力肯","110/07/13","凱基-桃園",0,10,-10
"26209","1570力肯","110/07/13","國泰-松江",9,0,9
"26210","1570力肯","110/07/13","凱基-新豐",0,10,-10
"26211","1570力肯","110/07/13","元大-新盛",9,0,9
"26212","1570力肯","110/07/13","元大-學甲",0,10,-10
"26213","1570力肯","110/07/13","元富-緯城",6,0,6
"26214","1570力肯","110/07/13","群益金鼎-東湖",1,10,-9
"26215","1570力肯","110/07/13","統一-三重",5,0,5
"26216","1570力肯","110/07/13","大昌",0,6,-6
"26217","1570力肯","110/07/13","元大-前金",5,0,5
"26218","1570力肯","110/07/13","元大-土城學府",0,6,-6
"26219","1570力肯","110/07/13","永豐金證券",5,0,5
"26220","1570力肯","110/07/13","統一",0,5,-5
"26221","6180橘子","110/07/13","摩根大通",119,0,119
"26222","6180橘子","110/07/13","元大-崇德",2,61,-59
"26223","6180橘子","110/07/13","美商高盛",96,0,96
"26224","6180橘子","110/07/13","康和-台中",0,51,-51
"26225","6180橘子","110/07/13","新加坡商瑞銀",86,7,79
"26226","6180橘子","110/07/13","康和-台北",0,50,-50
"26227","6180橘子","110/07/13","元大-和平",40,0,40
"26228","6180橘子","110/07/13","元富-潮州",0,40,-40
"26229","6180橘子","110/07/13","凱基-台北",83,47,36
"26230","6180橘子","110/07/13","日盛-永康",0,26,-26
"26231","6180橘子","110/07/13","美林",39,5,34
"26232","6180橘子","110/07/13","永豐金-中正",0,24,-24
"26233","6180橘子","110/07/13","富邦-新竹華信",31,2,29
"26234","6180橘子","110/07/13","國泰-板橋",2,25,-23
"26235","6180橘子","110/07/13","統一-南京",21,0,21
"26236","6180橘子","110/07/13","日盛-大墩",0,20,-20
"26237","6180橘子","110/07/13","富邦-陽明",24,3,21
"26238","6180橘子","110/07/13","元大-草屯",13,32,-19
"26239","6180橘子","110/07/13","大昌-樹林",21,1,20
"26240","6180橘子","110/07/13","元富-林園",1,18,-17
"26241","6180橘子","110/07/13","花旗環球",19,0,19
"26242","6180橘子","110/07/13","新光-新竹",1,18,-17
"26243","6180橘子","110/07/13","華南永昌-台南",19,0,19
"26244","6180橘子","110/07/13","元大-土城永寧",0,17,-17
"26245","6180橘子","110/07/13","福勝",14,0,14
"26246","6180橘子","110/07/13","國泰-新莊",3,19,-16
"26247","6180橘子","110/07/13","富邦-嘉義",12,1,11
"26248","6180橘子","110/07/13","中國信託-永康",6,21,-15
"26249","6180橘子","110/07/13","元大-板橋三民",11,0,11
"26250","6180橘子","110/07/13","凱基-東港",1,15,-14
"26251","2390云辰","110/07/13","新加坡商瑞銀",562,75,487
"26252","2390云辰","110/07/13","大展-台南",0,532,-532
"26253","2390云辰","110/07/13","台灣摩根士丹利",330,155,175
"26254","2390云辰","110/07/13","凱基-台北",668,854,-186
"26255","2390云辰","110/07/13","兆豐-公益",126,25,101
"26256","2390云辰","110/07/13","凱基-三重",12,172,-160
"26257","2390云辰","110/07/13","元富-中港",100,2,98
"26258","2390云辰","110/07/13","兆豐-忠孝",4,161,-157
"26259","2390云辰","110/07/13","統一-新台中",106,9,97
"26260","2390云辰","110/07/13","元大-士林",19,170,-151
"26261","2390云辰","110/07/13","中國信託-松江",81,11,70
"26262","2390云辰","110/07/13","臺銀-新竹",14,117,-103
"26263","2390云辰","110/07/13","日盛-板橋",72,3,69
"26264","2390云辰","110/07/13","國票-台中",4,102,-98
"26265","2390云辰","110/07/13","日盛-和美",57,0,57
"26266","2390云辰","110/07/13","新光",147,232,-85
"26267","2390云辰","110/07/13","永豐金-桃園",88,36,52
"26268","2390云辰","110/07/13","致和-崇德",2,70,-68
"26269","2390云辰","110/07/13","玉山-士林",54,4,50
"26270","2390云辰","110/07/13","群益金鼎-屏東",2,70,-68
"26271","2390云辰","110/07/13","富邦-仁愛",56,6,50
"26272","2390云辰","110/07/13","元大-大里",35,98,-63
"26273","2390云辰","110/07/13","第一金-豐原",50,1,49
"26274","2390云辰","110/07/13","元大-萬華",35,94,-59
"26275","2390云辰","110/07/13","摩根大通",502,453,49
"26276","2390云辰","110/07/13","元富-吉利",2,60,-58
"26277","2390云辰","110/07/13","凱基-松山",61,13,48
"26278","2390云辰","110/07/13","兆豐-新竹",3,53,-50
"26279","2390云辰","110/07/13","大昌",64,22,42
"26280","2390云辰","110/07/13","富邦-嘉義",65,108,-43
"26281","2363矽統","110/07/13","凱基-南崁",2133,63,2070
"26282","2363矽統","110/07/13","凱基-幸福",36,4048,-4012
"26283","2363矽統","110/07/13","國泰-敦南",2195,1617,578
"26284","2363矽統","110/07/13","統一",192,3325,-3133
"26285","2363矽統","110/07/13","中農",670,139,531
"26286","2363矽統","110/07/13","新加坡商瑞銀",1000,2747,-1747
"26287","2363矽統","110/07/13","康和-台中",638,154,484
"26288","2363矽統","110/07/13","凱基-台北",5359,6609,-1250
"26289","2363矽統","110/07/13","群益金鼎-三民",577,137,440
"26290","2363矽統","110/07/13","摩根大通",1930,2858,-928
"26291","2363矽統","110/07/13","台新-屏東",510,88,422
"26292","2363矽統","110/07/13","港商野村",960,1679,-719
"26293","2363矽統","110/07/13","德信-中正",455,67,388
"26294","2363矽統","110/07/13","兆豐-復興",25,705,-680
"26295","2363矽統","110/07/13","日盛-竹北",365,70,295
"26296","2363矽統","110/07/13","統一-仁愛",114,755,-641
"26297","2363矽統","110/07/13","元大-佳里",452,189,263
"26298","2363矽統","110/07/13","統一-敦南",29,638,-609
"26299","2363矽統","110/07/13","國票-博愛",296,38,258
"26300","2363矽統","110/07/13","統一-土城",100,704,-604
"26301","2363矽統","110/07/13","元大-萬華",340,95,245
"26302","2363矽統","110/07/13","統一-城中",116,676,-560
"26303","2363矽統","110/07/13","新光",1259,1031,228
"26304","2363矽統","110/07/13","永豐金證券",306,859,-553
"26305","2363矽統","110/07/13","元富-成功",323,96,227
"26306","2363矽統","110/07/13","元富",54,567,-513
"26307","2363矽統","110/07/13","豐農",228,23,205
"26308","2363矽統","110/07/13","瑞士信貸",202,666,-464
"26309","2363矽統","110/07/13","台灣企銀-岡山",186,4,182
"26310","2363矽統","110/07/13","永豐金-嘉義",67,468,-401
"26311","8112至上","110/07/13","摩根大通",688,296,392
"26312","8112至上","110/07/13","國票-中和",0,401,-401
"26313","8112至上","110/07/13","港商野村",344,145,199
"26314","8112至上","110/07/13","永豐金-板盛",0,205,-205
"26315","8112至上","110/07/13","兆豐-公益",195,5,190
"26316","8112至上","110/07/13","凱基-五股",43,155,-112
"26317","8112至上","110/07/13","台灣摩根士丹利",183,0,183
"26318","8112至上","110/07/13","凱基-市政",0,100,-100
"26319","8112至上","110/07/13","群益金鼎-敦南",153,2,151
"26320","8112至上","110/07/13","元大-大里德芳",1,92,-91
"26321","8112至上","110/07/13","臺銀-金山",146,26,120
"26322","8112至上","110/07/13","玉山-桃園",26,110,-84
"26323","8112至上","110/07/13","臺銀",133,19,114
"26324","8112至上","110/07/13","兆豐-天母",0,81,-81
"26325","8112至上","110/07/13","合庫-台中",115,6,109
"26326","8112至上","110/07/13","凱基-城中",3,84,-81
"26327","8112至上","110/07/13","亞東-板橋",134,26,108
"26328","8112至上","110/07/13","日盛-新莊",9,85,-76
"26329","8112至上","110/07/13","凱基-台北",414,326,88
"26330","8112至上","110/07/13","日盛-台中",2,64,-62
"26331","8112至上","110/07/13","新加坡商瑞銀",181,100,81
"26332","8112至上","110/07/13","日盛-中壢",3,64,-61
"26333","8112至上","110/07/13","國泰-敦南",108,31,77
"26334","8112至上","110/07/13","元大-台中",2,59,-57
"26335","8112至上","110/07/13","第一金-華江",77,4,73
"26336","8112至上","110/07/13","元大-雙和",7,64,-57
"26337","8112至上","110/07/13","永豐金-內湖",73,1,72
"26338","8112至上","110/07/13","元大-高雄",8,62,-54
"26339","8112至上","110/07/13","元大-永和",68,1,67
"26340","8112至上","110/07/13","元大-館前",2,55,-53
"26341","4903聯光通","110/07/13","台灣企銀-太平",56,0,56
"26342","4903聯光通","110/07/13","土銀",0,32,-32
"26343","4903聯光通","110/07/13","元富-新興",23,0,23
"26344","4903聯光通","110/07/13","元大-樹林",0,19,-19
"26345","4903聯光通","110/07/13","日盛-樹林",22,0,22
"26346","4903聯光通","110/07/13","凱基-士林",0,17,-17
"26347","4903聯光通","110/07/13","兆豐-天母",20,0,20
"26348","4903聯光通","110/07/13","國票-博愛",0,14,-14
"26349","4903聯光通","110/07/13","華南永昌-桃園",20,0,20
"26350","4903聯光通","110/07/13","元富",0,10,-10
"26351","4903聯光通","110/07/13","富邦-新店",10,0,10
"26352","4903聯光通","110/07/13","新光",0,10,-10
"26353","4903聯光通","110/07/13","新光-台中",5,0,5
"26354","4903聯光通","110/07/13","玉山-南京東路",0,10,-10
"26355","4903聯光通","110/07/13","華南永昌-台中",5,0,5
"26356","4903聯光通","110/07/13","富邦-陽明",0,10,-10
"26357","4903聯光通","110/07/13","元大-崇德",5,0,5
"26358","4903聯光通","110/07/13","元大-大甲",0,8,-8
"26359","4903聯光通","110/07/13","元大-草屯",5,0,5
"26360","4903聯光通","110/07/13","富邦-台中",0,7,-7
"26361","4903聯光通","110/07/13","元富-草屯",4,0,4
"26362","4903聯光通","110/07/13","凱基-中壢",0,6,-6
"26363","4903聯光通","110/07/13","元大-清水",4,0,4
"26364","4903聯光通","110/07/13","臺銀-民權",0,5,-5
"26365","4903聯光通","110/07/13","元大-東泰",4,0,4
"26366","4903聯光通","110/07/13","日盛-板橋",0,5,-5
"26367","4903聯光通","110/07/13","元大-佳里",2,0,2
"26368","4903聯光通","110/07/13","中國信託-忠孝",0,5,-5
"26369","4903聯光通","110/07/13","永豐金-板橋",2,0,2
"26370","4903聯光通","110/07/13","永豐金-鳳山",0,5,-5
"26371","2929淘帝","110/07/13","玉山-新竹",130,0,130
"26372","2929淘帝","110/07/13","美商高盛",0,177,-177
"26373","2929淘帝","110/07/13","臺銀-民權",60,0,60
"26374","2929淘帝","110/07/13","凱基-台北",6,80,-74
"26375","2929淘帝","110/07/13","新百王",31,0,31
"26376","2929淘帝","110/07/13","元富-大裕",0,49,-49
"26377","2929淘帝","110/07/13","日盛-園區",30,0,30
"26378","2929淘帝","110/07/13","國泰-館前",3,51,-48
"26379","2929淘帝","110/07/13","元大-南投",31,1,30
"26380","2929淘帝","110/07/13","凱基-中壢",0,41,-41
"26381","2929淘帝","110/07/13","兆豐-忠孝",28,0,28
"26382","2929淘帝","110/07/13","港商野村",21,55,-34
"26383","2929淘帝","110/07/13","元大-民生",28,0,28
"26384","2929淘帝","110/07/13","華南永昌-南京",2,34,-32
"26385","2929淘帝","110/07/13","合庫-高雄",27,0,27
"26386","2929淘帝","110/07/13","群益金鼎-土城",0,30,-30
"26387","2929淘帝","110/07/13","凱基-豐中",27,0,27
"26388","2929淘帝","110/07/13","富邦-南屯",0,22,-22
"26389","2929淘帝","110/07/13","新光",21,4,17
"26390","2929淘帝","110/07/13","第一金-豐原",0,20,-20
"26391","2929淘帝","110/07/13","元大-天母",17,0,17
"26392","2929淘帝","110/07/13","元大-屏南",6,26,-20
"26393","2929淘帝","110/07/13","永興",14,0,14
"26394","2929淘帝","110/07/13","永豐金-敦南",1,21,-20
"26395","2929淘帝","110/07/13","富邦-台北",12,0,12
"26396","2929淘帝","110/07/13","凱基-三重",2,21,-19
"26397","2929淘帝","110/07/13","元大-永和",12,0,12
"26398","2929淘帝","110/07/13","富邦-仁愛",7,25,-18
"26399","2929淘帝","110/07/13","國票-天祥",11,0,11
"26400","2929淘帝","110/07/13","元大-北投",0,16,-16
"26401","5410國眾","110/07/13","兆豐-城中",274,0,274
"26402","5410國眾","110/07/13","元富-嘉義",0,103,-103
"26403","5410國眾","110/07/13","新光",50,4,46
"26404","5410國眾","110/07/13","凱基-台北",0,50,-50
"26405","5410國眾","110/07/13","國泰-台中",26,0,26
"26406","5410國眾","110/07/13","瑞士信貸",0,31,-31
"26407","5410國眾","110/07/13","新加坡商瑞銀",22,0,22
"26408","5410國眾","110/07/13","台新-新莊",0,27,-27
"26409","5410國眾","110/07/13","光和-嘉義",20,0,20
"26410","5410國眾","110/07/13","元大-汐止",0,20,-20
"26411","5410國眾","110/07/13","凱基-竹北",17,0,17
"26412","5410國眾","110/07/13","亞東-新竹",0,17,-17
"26413","5410國眾","110/07/13","新光-桃園",15,0,15
"26414","5410國眾","110/07/13","元大-南勢角",0,13,-13
"26415","5410國眾","110/07/13","凱基-台東",14,0,14
"26416","5410國眾","110/07/13","台新-台南",0,12,-12
"26417","5410國眾","110/07/13","富邦-竹北",11,0,11
"26418","5410國眾","110/07/13","中國信託",0,11,-11
"26419","5410國眾","110/07/13","元富-同大",10,0,10
"26420","5410國眾","110/07/13","華南永昌",0,11,-11
"26421","5410國眾","110/07/13","國泰-敦南",24,15,9
"26422","5410國眾","110/07/13","臺銀-臺南",0,10,-10
"26423","5410國眾","110/07/13","日盛-內湖",7,0,7
"26424","5410國眾","110/07/13","台灣企銀-民雄",0,10,-10
"26425","5410國眾","110/07/13","台新-左楠",7,0,7
"26426","5410國眾","110/07/13","高橋",0,10,-10
"26427","5410國眾","110/07/13","元大-新盛",18,12,6
"26428","5410國眾","110/07/13","康和-嘉義",0,10,-10
"26429","5410國眾","110/07/13","統一",5,0,5
"26430","5410國眾","110/07/13","凱基-基隆",0,10,-10
"26431","2841台開","110/07/13","中國信託-高雄",251,50,201
"26432","2841台開","110/07/13","兆豐-公益",0,177,-177
"26433","2841台開","110/07/13","日盛證券",210,13,197
"26434","2841台開","110/07/13","日進",0,152,-152
"26435","2841台開","110/07/13","第一金-台中",55,0,55
"26436","2841台開","110/07/13","港商野村",0,109,-109
"26437","2841台開","110/07/13","國泰-板橋",46,0,46
"26438","2841台開","110/07/13","日盛-信義",0,103,-103
"26439","2841台開","110/07/13","國泰-館前",48,3,45
"26440","2841台開","110/07/13","國泰-敦南",11,75,-64
"26441","2841台開","110/07/13","華南永昌-新莊",45,0,45
"26442","2841台開","110/07/13","永興",0,50,-50
"26443","2841台開","110/07/13","日盛-園區",42,0,42
"26444","2841台開","110/07/13","永豐金-敦南",61,104,-43
"26445","2841台開","110/07/13","台新證券",32,0,32
"26446","2841台開","110/07/13","富邦-台南",0,42,-42
"26447","2841台開","110/07/13","台新-高雄",32,2,30
"26448","2841台開","110/07/13","國票-安和",0,30,-30
"26449","2841台開","110/07/13","豐農",23,0,23
"26450","2841台開","110/07/13","元大-桃園",0,25,-25
"26451","2841台開","110/07/13","合庫-嘉義",20,0,20
"26452","2841台開","110/07/13","新光",8,32,-24
"26453","2841台開","110/07/13","華南永昌-高雄",20,0,20
"26454","2841台開","110/07/13","元大-仁愛",0,24,-24
"26455","2841台開","110/07/13","元大-樹林",16,0,16
"26456","2841台開","110/07/13","日盛-中和",0,20,-20
"26457","2841台開","110/07/13","第一金-華江",15,2,13
"26458","2841台開","110/07/13","元富",0,20,-20
"26459","2841台開","110/07/13","美商高盛",12,0,12
"26460","2841台開","110/07/13","富邦-宜蘭",0,20,-20
"26461","6207雷科","110/07/13","元大-高雄",121,0,121
"26462","6207雷科","110/07/13","華南永昌-朴子",1,60,-59
"26463","6207雷科","110/07/13","第一金-新興",20,0,20
"26464","6207雷科","110/07/13","元大-南海",0,36,-36
"26465","6207雷科","110/07/13","元富-三重",20,0,20
"26466","6207雷科","110/07/13","凱基-土城",0,35,-35
"26467","6207雷科","110/07/13","元大-林園",15,0,15
"26468","6207雷科","110/07/13","台灣企銀",0,20,-20
"26469","6207雷科","110/07/13","元大-金華",16,1,15
"26470","6207雷科","110/07/13","群益金鼎-丹鳳",0,20,-20
"26471","6207雷科","110/07/13","日盛證券",10,0,10
"26472","6207雷科","110/07/13","元大-博愛",0,17,-17
"26473","6207雷科","110/07/13","統一-台中",10,0,10
"26474","6207雷科","110/07/13","元大-北港",0,13,-13
"26475","6207雷科","110/07/13","群益金鼎-土城",10,0,10
"26476","6207雷科","110/07/13","新加坡商瑞銀",0,12,-12
"26477","6207雷科","110/07/13","群益金鼎-桃園",10,0,10
"26478","6207雷科","110/07/13","凱基-台北",4,16,-12
"26479","6207雷科","110/07/13","永豐金-新莊",10,0,10
"26480","6207雷科","110/07/13","日茂-埔里",0,11,-11
"26481","6207雷科","110/07/13","永豐金-新店",10,0,10
"26482","6207雷科","110/07/13","元大-莒光",0,11,-11
"26483","6207雷科","110/07/13","元大證券",9,0,9
"26484","6207雷科","110/07/13","統一-新竹",0,10,-10
"26485","6207雷科","110/07/13","日盛-木柵",9,1,8
"26486","6207雷科","110/07/13","元大-西螺",0,10,-10
"26487","6207雷科","110/07/13","兆豐-來福",8,0,8
"26488","6207雷科","110/07/13","康和-台中",0,8,-8
"26489","6207雷科","110/07/13","新光",7,0,7
"26490","6207雷科","110/07/13","兆豐-高雄",0,6,-6
"26491","3679新至陞","110/07/13","永豐金證券",50,0,50
"26492","3679新至陞","110/07/13","摩根大通",2,25,-23
"26493","3679新至陞","110/07/13","國泰-桃園",22,0,22
"26494","3679新至陞","110/07/13","元大-成功",0,22,-22
"26495","3679新至陞","110/07/13","台中銀-員林",11,0,11
"26496","3679新至陞","110/07/13","富邦-板橋",1,19,-18
"26497","3679新至陞","110/07/13","元大-文心興安",8,0,8
"26498","3679新至陞","110/07/13","日盛-新莊",0,10,-10
"26499","3679新至陞","110/07/13","美商高盛",6,0,6
"26500","3679新至陞","110/07/13","台新-台中",0,10,-10
"26501","3679新至陞","110/07/13","台新-高雄",6,0,6
"26502","3679新至陞","110/07/13","永豐金-新竹",0,8,-8
"26503","3679新至陞","110/07/13","凱基-台北",18,12,6
"26504","3679新至陞","110/07/13","瑞士信貸",12,19,-7
"26505","3679新至陞","110/07/13","日盛-復興",5,0,5
"26506","3679新至陞","110/07/13","統一-南京",0,7,-7
"26507","3679新至陞","110/07/13","(牛牛牛)亞-鑫豐",4,0,4
"26508","3679新至陞","110/07/13","凱基-新莊",0,7,-7
"26509","3679新至陞","110/07/13","元富-大昌",3,0,3
"26510","3679新至陞","110/07/13","新加坡商瑞銀",0,6,-6
"26511","3679新至陞","110/07/13","富邦-台北",3,0,3
"26512","3679新至陞","110/07/13","合庫-自強",0,5,-5
"26513","3679新至陞","110/07/13","日盛-樹林",2,0,2
"26514","3679新至陞","110/07/13","富邦-桃園",0,5,-5
"26515","3679新至陞","110/07/13","宏遠-光隆",2,0,2
"26516","3679新至陞","110/07/13","永豐金-潮州",0,4,-4
"26517","3679新至陞","110/07/13","美林",3,1,2
"26518","3679新至陞","110/07/13","臺銀-臺南",0,3,-3
"26519","3679新至陞","110/07/13","第一金-中壢",2,0,2
"26520","3679新至陞","110/07/13","元大-六合",0,3,-3
"26521","2727王品","110/07/13","富邦-台北",43,3,40
"26522","2727王品","110/07/13","台灣摩根士丹利",15,97,-82
"26523","2727王品","110/07/13","元大-基隆孝二",40,0,40
"26524","2727王品","110/07/13","玉山-台南",5,57,-52
"26525","2727王品","110/07/13","國票-新莊",40,1,39
"26526","2727王品","110/07/13","新加坡商瑞銀",0,48,-48
"26527","2727王品","110/07/13","第一金-豐原",66,42,24
"26528","2727王品","110/07/13","凱基-台北",41,77,-36
"26529","2727王品","110/07/13","永豐金-大園",34,10,24
"26530","2727王品","110/07/13","永豐金-永康",0,22,-22
"26531","2727王品","110/07/13","元大-北屯",22,0,22
"26532","2727王品","110/07/13","統一-台中",2,22,-20
"26533","2727王品","110/07/13","元大-東蘆",26,7,19
"26534","2727王品","110/07/13","國泰-台中",21,39,-18
"26535","2727王品","110/07/13","永豐金-萬盛",13,1,12
"26536","2727王品","110/07/13","合庫-彰化",3,20,-17
"26537","2727王品","110/07/13","日盛-嘉義",11,0,11
"26538","2727王品","110/07/13","港商野村",13,30,-17
"26539","2727王品","110/07/13","日盛-八德",11,0,11
"26540","2727王品","110/07/13","元大-楊梅",1,16,-15
"26541","2727王品","110/07/13","統一-竹南",11,0,11
"26542","2727王品","110/07/13","凱基-高美館",2,15,-13
"26543","2727王品","110/07/13","日盛-士林",12,2,10
"26544","2727王品","110/07/13","美商高盛",2,14,-12
"26545","2727王品","110/07/13","統一-敦南",10,0,10
"26546","2727王品","110/07/13","統一-平鎮",1,13,-12
"26547","2727王品","110/07/13","中國信託",15,5,10
"26548","2727王品","110/07/13","兆豐-台中港",4,16,-12
"26549","2727王品","110/07/13","兆豐-竹北",13,3,10
"26550","2727王品","110/07/13","凱基-八德",1,13,-12
"26551","1570力肯","110/07/13","新光",115,11,104
"26552","1570力肯","110/07/13","元大-北三重",0,162,-162
"26553","1570力肯","110/07/13","群益金鼎-高雄",54,0,54
"26554","1570力肯","110/07/13","元大-大灣",0,25,-25
"26555","1570力肯","110/07/13","國票-新莊",22,0,22
"26556","1570力肯","110/07/13","永豐金-苓雅",0,22,-22
"26557","1570力肯","110/07/13","日盛-桃園",12,0,12
"26558","1570力肯","110/07/13","永豐金-永康",0,19,-19
"26559","1570力肯","110/07/13","元大-高雄",12,0,12
"26560","1570力肯","110/07/13","富邦-員林",0,15,-15
"26561","1570力肯","110/07/13","合庫-自強",11,0,11
"26562","1570力肯","110/07/13","凱基-台南",0,11,-11
"26563","1570力肯","110/07/13","摩根大通",26,15,11
"26564","1570力肯","110/07/13","日盛-竹北",0,10,-10
"26565","1570力肯","110/07/13","永豐金-中盛",11,0,11
"26566","1570力肯","110/07/13","國票-九鼎",0,10,-10
"26567","1570力肯","110/07/13","兆豐-台中港",10,0,10
"26568","1570力肯","110/07/13","凱基-桃園",0,10,-10
"26569","1570力肯","110/07/13","國泰-松江",9,0,9
"26570","1570力肯","110/07/13","凱基-新豐",0,10,-10
"26571","1570力肯","110/07/13","元大-新盛",9,0,9
"26572","1570力肯","110/07/13","元大-學甲",0,10,-10
"26573","1570力肯","110/07/13","元富-緯城",6,0,6
"26574","1570力肯","110/07/13","群益金鼎-東湖",1,10,-9
"26575","1570力肯","110/07/13","統一-三重",5,0,5
"26576","1570力肯","110/07/13","大昌",0,6,-6
"26577","1570力肯","110/07/13","元大-前金",5,0,5
"26578","1570力肯","110/07/13","元大-土城學府",0,6,-6
"26579","1570力肯","110/07/13","永豐金證券",5,0,5
"26580","1570力肯","110/07/13","統一",0,5,-5
"26581","6180橘子","110/07/13","摩根大通",119,0,119
"26582","6180橘子","110/07/13","元大-崇德",2,61,-59
"26583","6180橘子","110/07/13","美商高盛",96,0,96
"26584","6180橘子","110/07/13","康和-台中",0,51,-51
"26585","6180橘子","110/07/13","新加坡商瑞銀",86,7,79
"26586","6180橘子","110/07/13","康和-台北",0,50,-50
"26587","6180橘子","110/07/13","元大-和平",40,0,40
"26588","6180橘子","110/07/13","元富-潮州",0,40,-40
"26589","6180橘子","110/07/13","凱基-台北",83,47,36
"26590","6180橘子","110/07/13","日盛-永康",0,26,-26
"26591","6180橘子","110/07/13","美林",39,5,34
"26592","6180橘子","110/07/13","永豐金-中正",0,24,-24
"26593","6180橘子","110/07/13","富邦-新竹華信",31,2,29
"26594","6180橘子","110/07/13","國泰-板橋",2,25,-23
"26595","6180橘子","110/07/13","統一-南京",21,0,21
"26596","6180橘子","110/07/13","日盛-大墩",0,20,-20
"26597","6180橘子","110/07/13","富邦-陽明",24,3,21
"26598","6180橘子","110/07/13","元大-草屯",13,32,-19
"26599","6180橘子","110/07/13","大昌-樹林",21,1,20
"26600","6180橘子","110/07/13","元富-林園",1,18,-17
"26601","6180橘子","110/07/13","花旗環球",19,0,19
"26602","6180橘子","110/07/13","新光-新竹",1,18,-17
"26603","6180橘子","110/07/13","華南永昌-台南",19,0,19
"26604","6180橘子","110/07/13","元大-土城永寧",0,17,-17
"26605","6180橘子","110/07/13","福勝",14,0,14
"26606","6180橘子","110/07/13","國泰-新莊",3,19,-16
"26607","6180橘子","110/07/13","富邦-嘉義",12,1,11
"26608","6180橘子","110/07/13","中國信託-永康",6,21,-15
"26609","6180橘子","110/07/13","元大-板橋三民",11,0,11
"26610","6180橘子","110/07/13","凱基-東港",1,15,-14
"26611","2390云辰","110/07/13","新加坡商瑞銀",562,75,487
"26612","2390云辰","110/07/13","大展-台南",0,532,-532
"26613","2390云辰","110/07/13","台灣摩根士丹利",330,155,175
"26614","2390云辰","110/07/13","凱基-台北",668,854,-186
"26615","2390云辰","110/07/13","兆豐-公益",126,25,101
"26616","2390云辰","110/07/13","凱基-三重",12,172,-160
"26617","2390云辰","110/07/13","元富-中港",100,2,98
"26618","2390云辰","110/07/13","兆豐-忠孝",4,161,-157
"26619","2390云辰","110/07/13","統一-新台中",106,9,97
"26620","2390云辰","110/07/13","元大-士林",19,170,-151
"26621","2390云辰","110/07/13","中國信託-松江",81,11,70
"26622","2390云辰","110/07/13","臺銀-新竹",14,117,-103
"26623","2390云辰","110/07/13","日盛-板橋",72,3,69
"26624","2390云辰","110/07/13","國票-台中",4,102,-98
"26625","2390云辰","110/07/13","日盛-和美",57,0,57
"26626","2390云辰","110/07/13","新光",147,232,-85
"26627","2390云辰","110/07/13","永豐金-桃園",88,36,52
"26628","2390云辰","110/07/13","致和-崇德",2,70,-68
"26629","2390云辰","110/07/13","玉山-士林",54,4,50
"26630","2390云辰","110/07/13","群益金鼎-屏東",2,70,-68
"26631","2390云辰","110/07/13","富邦-仁愛",56,6,50
"26632","2390云辰","110/07/13","元大-大里",35,98,-63
"26633","2390云辰","110/07/13","第一金-豐原",50,1,49
"26634","2390云辰","110/07/13","元大-萬華",35,94,-59
"26635","2390云辰","110/07/13","摩根大通",502,453,49
"26636","2390云辰","110/07/13","元富-吉利",2,60,-58
"26637","2390云辰","110/07/13","凱基-松山",61,13,48
"26638","2390云辰","110/07/13","兆豐-新竹",3,53,-50
"26639","2390云辰","110/07/13","大昌",64,22,42
"26640","2390云辰","110/07/13","富邦-嘉義",65,108,-43
"26641","2363矽統","110/07/12","凱基-幸福",4046,31,4015
"26642","2363矽統","110/07/12","台新證券",478,2105,-1627
"26643","2363矽統","110/07/12","統一",3504,120,3384
"26644","2363矽統","110/07/12","第一金-忠孝",4,1068,-1064
"26645","2363矽統","110/07/12","摩根大通",3006,2149,857
"26646","2363矽統","110/07/12","台新-台中",381,1003,-622
"26647","2363矽統","110/07/12","永豐金證券",1428,610,818
"26648","2363矽統","110/07/12","新光",1295,1822,-527
"26649","2363矽統","110/07/12","兆豐-復興",1936,1233,703
"26650","2363矽統","110/07/12","大昌-樹林",54,537,-483
"26651","2363矽統","110/07/12","台灣摩根士丹利",701,0,701
"26652","2363矽統","110/07/12","華南永昌-台中",90,549,-459
"26653","2363矽統","110/07/12","永豐金-南投",803,145,658
"26654","2363矽統","110/07/12","玉山-高雄",167,612,-445
"26655","2363矽統","110/07/12","統一-仁愛",1214,586,628
"26656","2363矽統","110/07/12","元富-同大",201,540,-339
"26657","2363矽統","110/07/12","統一-土城",688,75,613
"26658","2363矽統","110/07/12","華南永昌-東勢",31,367,-336
"26659","2363矽統","110/07/12","統一-城中",711,131,580
"26660","2363矽統","110/07/12","土銀-花蓮",9,333,-324
"26661","2363矽統","110/07/12","統一-敦南",632,54,578
"26662","2363矽統","110/07/12","凱基-豐中",120,434,-314
"26663","2363矽統","110/07/12","新加坡商瑞銀",1232,731,501
"26664","2363矽統","110/07/12","永豐金-竹科",54,323,-269
"26665","2363矽統","110/07/12","元富",2640,2142,498
"26666","2363矽統","110/07/12","元大-斗六",53,300,-247
"26667","2363矽統","110/07/12","凱基-永和",460,31,429
"26668","2363矽統","110/07/12","華南永昌-朴子",47,278,-231
"26669","2363矽統","110/07/12","第一金",380,22,358
"26670","2363矽統","110/07/12","永豐金-彰化",22,228,-206
"26671","8112至上","110/07/12","摩根大通",1167,290,877
"26672","8112至上","110/07/12","群益金鼎-新莊",1,156,-155
"26673","8112至上","110/07/12","凱基-台北",983,546,437
"26674","8112至上","110/07/12","國票-中港",0,131,-131
"26675","8112至上","110/07/12","新加坡商瑞銀",429,12,417
"26676","8112至上","110/07/12","元大證券",10,136,-126
"26677","8112至上","110/07/12","元大-屏南",360,2,358
"26678","8112至上","110/07/12","元大-中壢",11,135,-124
"26679","8112至上","110/07/12","美林",323,15,308
"26680","8112至上","110/07/12","合庫-基隆",0,122,-122
"26681","8112至上","110/07/12","台灣摩根士丹利",299,0,299
"26682","8112至上","110/07/12","群益金鼎-高盛",4,103,-99
"26683","8112至上","110/07/12","港商野村",267,28,239
"26684","8112至上","110/07/12","新光",110,202,-92
"26685","8112至上","110/07/12","大慶",165,3,162
"26686","8112至上","110/07/12","元大-府城",2,94,-92
"26687","8112至上","110/07/12","永豐金-台南",170,29,141
"26688","8112至上","110/07/12","富邦-板橋",5,92,-87
"26689","8112至上","110/07/12","華南永昌-長虹",128,2,126
"26690","8112至上","110/07/12","元大-土城",8,89,-81
"26691","8112至上","110/07/12","富邦-仁愛",157,51,106
"26692","8112至上","110/07/12","日盛-頭份",40,117,-77
"26693","8112至上","110/07/12","瑞士信貸",104,0,104
"26694","8112至上","110/07/12","玉山-嘉義",3,80,-77
"26695","8112至上","110/07/12","凱基-站前",100,11,89
"26696","8112至上","110/07/12","永豐金-松山",4,79,-75
"26697","8112至上","110/07/12","富邦-北港",90,3,87
"26698","8112至上","110/07/12","元大-敦南",3,75,-72
"26699","8112至上","110/07/12","元大-北港",101,20,81
"26700","8112至上","110/07/12","元富-大裕",6,77,-71
"26701","4903聯光通","110/07/12","台灣企銀-太平",19,0,19
"26702","4903聯光通","110/07/12","玉山-南京東路",0,16,-16
"26703","4903聯光通","110/07/12","統一-土城",17,0,17
"26704","4903聯光通","110/07/12","新光",0,14,-14
"26705","4903聯光通","110/07/12","國票-博愛",14,0,14
"26706","4903聯光通","110/07/12","兆豐-彰化",0,10,-10
"26707","4903聯光通","110/07/12","新光-台中",15,2,13
"26708","4903聯光通","110/07/12","國票",0,10,-10
"26709","4903聯光通","110/07/12","元大-彰化",11,0,11
"26710","4903聯光通","110/07/12","富邦-敦南",0,10,-10
"26711","4903聯光通","110/07/12","華南永昌-林口",10,0,10
"26712","4903聯光通","110/07/12","元大-前金",0,9,-9
"26713","4903聯光通","110/07/12","永豐金-南投",9,0,9
"26714","4903聯光通","110/07/12","日盛-頭份",0,8,-8
"26715","4903聯光通","110/07/12","元大-清水",8,0,8
"26716","4903聯光通","110/07/12","元大-太平",0,8,-8
"26717","4903聯光通","110/07/12","元大-博愛",8,0,8
"26718","4903聯光通","110/07/12","兆豐-埔墘",0,7,-7
"26719","4903聯光通","110/07/12","玉山-新莊",5,0,5
"26720","4903聯光通","110/07/12","臺銀-民權",0,5,-5
"26721","4903聯光通","110/07/12","凱基-士林",10,5,5
"26722","4903聯光通","110/07/12","富邦-板橋",0,5,-5
"26723","4903聯光通","110/07/12","元大-斗六",4,0,4
"26724","4903聯光通","110/07/12","元大-土城永寧",0,5,-5
"26725","4903聯光通","110/07/12","永豐金-羅東",4,0,4
"26726","4903聯光通","110/07/12","台新證券",0,4,-4
"26727","4903聯光通","110/07/12","日盛-樹林",3,0,3
"26728","4903聯光通","110/07/12","凱基-中壢",0,4,-4
"26729","4903聯光通","110/07/12","華南永昌-鶯歌",2,0,2
"26730","4903聯光通","110/07/12","元大-羅東",0,4,-4
"26731","2929淘帝","110/07/12","新光-台中",95,36,59
"26732","2929淘帝","110/07/12","華南永昌-林口",7,208,-201
"26733","2929淘帝","110/07/12","富邦-板橋",62,5,57
"26734","2929淘帝","110/07/12","富邦-台北",6,200,-194
"26735","2929淘帝","110/07/12","合庫-高雄",56,6,50
"26736","2929淘帝","110/07/12","元富-大裕",11,200,-189
"26737","2929淘帝","110/07/12","永興",41,0,41
"26738","2929淘帝","110/07/12","台中銀-台北",0,160,-160
"26739","2929淘帝","110/07/12","兆豐-忠孝",58,18,40
"26740","2929淘帝","110/07/12","日盛-園區",1,111,-110
"26741","2929淘帝","110/07/12","新光-高雄",39,3,36
"26742","2929淘帝","110/07/12","日盛-八德",0,88,-88
"26743","2929淘帝","110/07/12","凱基-豐中",36,0,36
"26744","2929淘帝","110/07/12","玉山-新竹",32,110,-78
"26745","2929淘帝","110/07/12","元大-民生",35,0,35
"26746","2929淘帝","110/07/12","元大-前金",0,72,-72
"26747","2929淘帝","110/07/12","臺銀-臺南",32,1,31
"26748","2929淘帝","110/07/12","元大-館前",12,83,-71
"26749","2929淘帝","110/07/12","台新證券",44,13,31
"26750","2929淘帝","110/07/12","華南永昌",1,57,-56
"26751","2929淘帝","110/07/12","新百王",30,0,30
"26752","2929淘帝","110/07/12","元大-南崁",4,59,-55
"26753","2929淘帝","110/07/12","群益金鼎-大興",30,0,30
"26754","2929淘帝","110/07/12","元大-嘉義",0,51,-51
"26755","2929淘帝","110/07/12","凱基-台北",32,5,27
"26756","2929淘帝","110/07/12","日茂",1,50,-49
"26757","2929淘帝","110/07/12","元富-城東",26,0,26
"26758","2929淘帝","110/07/12","新光",35,83,-48
"26759","2929淘帝","110/07/12","國泰-松江",26,0,26
"26760","2929淘帝","110/07/12","日盛-新竹",1,48,-47
"26761","5410國眾","110/07/12","群益金鼎-中壢",68,0,68
"26762","5410國眾","110/07/12","摩根大通",6,67,-61
"26763","5410國眾","110/07/12","凱基-市政",40,0,40
"26764","5410國眾","110/07/12","元富-嘉義",0,60,-60
"26765","5410國眾","110/07/12","凱基-竹北",38,0,38
"26766","5410國眾","110/07/12","凱基-台北",0,51,-51
"26767","5410國眾","110/07/12","華南永昌-三重",30,0,30
"26768","5410國眾","110/07/12","元富-大裕",0,33,-33
"26769","5410國眾","110/07/12","永興",20,0,20
"26770","5410國眾","110/07/12","日盛-木柵",0,15,-15
"26771","5410國眾","110/07/12","統一-新台中",20,0,20
"26772","5410國眾","110/07/12","群益金鼎-民權",0,15,-15
"26773","5410國眾","110/07/12","兆豐-三重",20,0,20
"26774","5410國眾","110/07/12","元富-緯城",0,14,-14
"26775","5410國眾","110/07/12","富邦-台中",20,0,20
"26776","5410國眾","110/07/12","元大-大同",0,12,-12
"26777","5410國眾","110/07/12","臺銀",15,0,15
"26778","5410國眾","110/07/12","元大-莒光",0,10,-10
"26779","5410國眾","110/07/12","新光-桃園",20,6,14
"26780","5410國眾","110/07/12","元大-博愛",0,10,-10
"26781","5410國眾","110/07/12","元大-員林",12,0,12
"26782","5410國眾","110/07/12","日盛-永康",0,8,-8
"26783","5410國眾","110/07/12","日盛-員林",10,0,10
"26784","5410國眾","110/07/12","元大-四維",5,13,-8
"26785","5410國眾","110/07/12","元大-新盛",10,0,10
"26786","5410國眾","110/07/12","新加坡商瑞銀",0,7,-7
"26787","5410國眾","110/07/12","永豐金-台南",10,0,10
"26788","5410國眾","110/07/12","致和-金華",0,7,-7
"26789","5410國眾","110/07/12","元富-新莊",8,0,8
"26790","5410國眾","110/07/12","新光-新竹",0,7,-7
"26791","2841台開","110/07/12","永豐金-敦南",139,26,113
"26792","2841台開","110/07/12","華南永昌-朴子",0,528,-528
"26793","2841台開","110/07/12","日盛-雙和",68,0,68
"26794","2841台開","110/07/12","元大-苑裡",2,50,-48
"26795","2841台開","110/07/12","台新證券",62,4,58
"26796","2841台開","110/07/12","群益金鼎-東湖",0,40,-40
"26797","2841台開","110/07/12","凱基-文心",50,0,50
"26798","2841台開","110/07/12","第一金-員林",0,30,-30
"26799","2841台開","110/07/12","第一金-台中",45,0,45
"26800","2841台開","110/07/12","德信-中正",0,20,-20
"26801","2841台開","110/07/12","富邦-嘉義",40,0,40
"26802","2841台開","110/07/12","兆豐-嘉義",0,20,-20
"26803","2841台開","110/07/12","日盛-木柵",30,0,30
"26804","2841台開","110/07/12","彰銀-七賢",0,15,-15
"26805","2841台開","110/07/12","中國信託-文心",31,3,28
"26806","2841台開","110/07/12","元大-承德",0,14,-14
"26807","2841台開","110/07/12","元大-福營",30,7,23
"26808","2841台開","110/07/12","元富",0,12,-12
"26809","2841台開","110/07/12","台中銀",20,0,20
"26810","2841台開","110/07/12","富邦-陽明",0,11,-11
"26811","2841台開","110/07/12","國泰-板橋",20,0,20
"26812","2841台開","110/07/12","元大證券",0,11,-11
"26813","2841台開","110/07/12","元大-前金",20,0,20
"26814","2841台開","110/07/12","元大-大甲",0,10,-10
"26815","2841台開","110/07/12","中國信託-高雄",16,1,15
"26816","2841台開","110/07/12","日盛-新竹",0,8,-8
"26817","2841台開","110/07/12","陽信-石牌",15,0,15
"26818","2841台開","110/07/12","元富-城東",0,8,-8
"26819","2841台開","110/07/12","永豐金-南投",15,0,15
"26820","2841台開","110/07/12","玉山-台南",2,10,-8
"26821","6207雷科","110/07/12","元大-高雄",34,0,34
"26822","6207雷科","110/07/12","永豐金-三重",1,32,-31
"26823","6207雷科","110/07/12","華南永昌-林口",16,1,15
"26824","6207雷科","110/07/12","永全-八德",0,30,-30
"26825","6207雷科","110/07/12","摩根大通",19,6,13
"26826","6207雷科","110/07/12","國泰-台中",0,14,-14
"26827","6207雷科","110/07/12","元富-埔里",10,0,10
"26828","6207雷科","110/07/12","第一金-澎湖",0,10,-10
"26829","6207雷科","110/07/12","凱基-台南",10,0,10
"26830","6207雷科","110/07/12","元富-林園",0,10,-10
"26831","6207雷科","110/07/12","新加坡商瑞銀",9,0,9
"26832","6207雷科","110/07/12","元大-東門",0,10,-10
"26833","6207雷科","110/07/12","瑞士信貸",8,0,8
"26834","6207雷科","110/07/12","兆豐-嘉義",0,4,-4
"26835","6207雷科","110/07/12","中國信託-高雄",9,1,8
"26836","6207雷科","110/07/12","新光",0,4,-4
"26837","6207雷科","110/07/12","凱基-高雄",6,0,6
"26838","6207雷科","110/07/12","新光-台中",0,4,-4
"26839","6207雷科","110/07/12","元大-六合",6,0,6
"26840","6207雷科","110/07/12","群益金鼎-開元",0,4,-4
"26841","6207雷科","110/07/12","永豐金-信義",6,0,6
"26842","6207雷科","110/07/12","凱基-桃園",0,4,-4
"26843","6207雷科","110/07/12","群益金鼎-土城",5,0,5
"26844","6207雷科","110/07/12","凱基-民權",0,4,-4
"26845","6207雷科","110/07/12","群益金鼎-竹南",5,0,5
"26846","6207雷科","110/07/12","玉山-新莊",0,3,-3
"26847","6207雷科","110/07/12","元大-大灣",5,1,4
"26848","6207雷科","110/07/12","國泰-松江",0,3,-3
"26849","6207雷科","110/07/12","永興",3,0,3
"26850","6207雷科","110/07/12","富邦-羅東",0,3,-3
"26851","3679新至陞","110/07/12","富邦-新竹華信",40,2,38
"26852","3679新至陞","110/07/12","瑞士信貸",0,45,-45
"26853","3679新至陞","110/07/12","台中銀-員林",28,2,26
"26854","3679新至陞","110/07/12","永豐金-天母",0,39,-39
"26855","3679新至陞","110/07/12","聯邦-大業",24,0,24
"26856","3679新至陞","110/07/12","摩根大通",7,35,-28
"26857","3679新至陞","110/07/12","永豐金證券",20,0,20
"26858","3679新至陞","110/07/12","凱基-台北",8,36,-28
"26859","3679新至陞","110/07/12","港商法國興業",14,0,14
"26860","3679新至陞","110/07/12","華南永昌-小港",1,23,-22
"26861","3679新至陞","110/07/12","日盛-樹林",13,1,12
"26862","3679新至陞","110/07/12","台新-台中",0,15,-15
"26863","3679新至陞","110/07/12","國泰-桃園",9,0,9
"26864","3679新至陞","110/07/12","統一-台中",0,12,-12
"26865","3679新至陞","110/07/12","宏遠-館前",8,0,8
"26866","3679新至陞","110/07/12","元大-成功",1,12,-11
"26867","3679新至陞","110/07/12","凱基",10,2,8
"26868","3679新至陞","110/07/12","康和-澎湖",0,8,-8
"26869","3679新至陞","110/07/12","(牛牛牛)亞-網路",7,0,7
"26870","3679新至陞","110/07/12","新加坡商瑞銀",0,7,-7
"26871","3679新至陞","110/07/12","兆豐-員林",7,0,7
"26872","3679新至陞","110/07/12","兆豐-來福",0,7,-7
"26873","3679新至陞","110/07/12","大慶-蘆洲",5,0,5
"26874","3679新至陞","110/07/12","元大-佳里",0,6,-6
"26875","3679新至陞","110/07/12","土銀-花蓮",4,0,4
"26876","3679新至陞","110/07/12","美商高盛",0,5,-5
"26877","3679新至陞","110/07/12","台新-高雄",5,1,4
"26878","3679新至陞","110/07/12","國票-新莊",0,5,-5
"26879","3679新至陞","110/07/12","元大-天母",4,0,4
"26880","3679新至陞","110/07/12","台新-屏東",0,5,-5
"26881","2727王品","110/07/12","凱基-台北",354,198,156
"26882","2727王品","110/07/12","台灣摩根士丹利",5,386,-381
"26883","2727王品","110/07/12","統一-城中",159,22,137
"26884","2727王品","110/07/12","元大-嘉義",4,60,-56
"26885","2727王品","110/07/12","日盛-忠孝",60,0,60
"26886","2727王品","110/07/12","元大-大同",2,44,-42
"26887","2727王品","110/07/12","永豐金-忠孝",45,5,40
"26888","2727王品","110/07/12","國泰-台中",32,73,-41
"26889","2727王品","110/07/12","合庫-新竹",31,0,31
"26890","2727王品","110/07/12","元大證券",127,163,-36
"26891","2727王品","110/07/12","富邦-台中",31,3,28
"26892","2727王品","110/07/12","凱基",1,33,-32
"26893","2727王品","110/07/12","元大-桃園",35,10,25
"26894","2727王品","110/07/12","永全-南崁",1,31,-30
"26895","2727王品","110/07/12","新加坡商瑞銀",28,4,24
"26896","2727王品","110/07/12","凱基-和平",2,32,-30
"26897","2727王品","110/07/12","群益金鼎-古亭",25,2,23
"26898","2727王品","110/07/12","永豐金-大園",8,38,-30
"26899","2727王品","110/07/12","元大-龍潭",29,7,22
"26900","2727王品","110/07/12","瑞士信貸",0,28,-28
"26901","2727王品","110/07/12","永豐金-永康",25,3,22
"26902","2727王品","110/07/12","元富",17,44,-27
"26903","2727王品","110/07/12","富邦-竹北",24,3,21
"26904","2727王品","110/07/12","元大-北屯",5,32,-27
"26905","2727王品","110/07/12","群益金鼎-松山",20,0,20
"26906","2727王品","110/07/12","華南永昌",3,28,-25
"26907","2727王品","110/07/12","元大-八德",20,0,20
"26908","2727王品","110/07/12","統一-竹南",1,23,-22
"26909","2727王品","110/07/12","元大-南京",25,6,19
"26910","2727王品","110/07/12","永豐金證券",4,26,-22
"26911","1570力肯","110/07/12","國票-北高雄",40,0,40
"26912","1570力肯","110/07/12","日盛-竹北",0,40,-40
"26913","1570力肯","110/07/12","摩根大通",16,0,16
"26914","1570力肯","110/07/12","第一金-華江",1,38,-37
"26915","1570力肯","110/07/12","新光",31,19,12
"26916","1570力肯","110/07/12","元大-永春",0,26,-26
"26917","1570力肯","110/07/12","元大-台中中港",12,0,12
"26918","1570力肯","110/07/12","元大-古亭",1,20,-19
"26919","1570力肯","110/07/12","日盛-高雄",10,0,10
"26920","1570力肯","110/07/12","國泰-松江",0,16,-16
"26921","1570力肯","110/07/12","第一金-路竹",10,0,10
"26922","1570力肯","110/07/12","台新-台南",0,15,-15
"26923","1570力肯","110/07/12","台新-新莊",10,0,10
"26924","1570力肯","110/07/12","康和-石牌",0,15,-15
"26925","1570力肯","110/07/12","元大-新盛",9,0,9
"26926","1570力肯","110/07/12","國泰-板橋",0,11,-11
"26927","1570力肯","110/07/12","凱基-台北",8,0,8
"26928","1570力肯","110/07/12","元大-高雄",0,11,-11
"26929","1570力肯","110/07/12","彰銀-七賢",6,0,6
"26930","1570力肯","110/07/12","兆豐-桃園",0,10,-10
"26931","1570力肯","110/07/12","元富-緯城",6,0,6
"26932","1570力肯","110/07/12","元大-大益",0,10,-10
"26933","1570力肯","110/07/12","華南永昌-古亭",6,0,6
"26934","1570力肯","110/07/12","中國信託-文心",0,5,-5
"26935","1570力肯","110/07/12","富邦-陽明",6,0,6
"26936","1570力肯","110/07/12","光和",0,5,-5
"26937","1570力肯","110/07/12","臺銀-臺南",5,0,5
"26938","1570力肯","110/07/12","陽信-石牌",0,5,-5
"26939","1570力肯","110/07/12","宏遠-館前",5,0,5
"26940","1570力肯","110/07/12","國泰-高雄",0,5,-5
"26941","6180橘子","110/07/12","康和-台中",32,2,30
"26942","6180橘子","110/07/12","新百王",1,40,-39
"26943","6180橘子","110/07/12","美林",32,3,29
"26944","6180橘子","110/07/12","富邦-陽明",4,42,-38
"26945","6180橘子","110/07/12","元大-羅東",21,0,21
"26946","6180橘子","110/07/12","新光",3,32,-29
"26947","6180橘子","110/07/12","兆豐-埔墘",16,0,16
"26948","6180橘子","110/07/12","日盛-文化",4,20,-16
"26949","6180橘子","110/07/12","元大-雙和",12,0,12
"26950","6180橘子","110/07/12","華南永昌-鶯歌",0,15,-15
"26951","6180橘子","110/07/12","美商高盛",18,7,11
"26952","6180橘子","110/07/12","中國信託-忠孝",7,20,-13
"26953","6180橘子","110/07/12","台新證券",14,3,11
"26954","6180橘子","110/07/12","凱基-台北",5,17,-12
"26955","6180橘子","110/07/12","元大-中壢",12,1,11
"26956","6180橘子","110/07/12","凱基-高雄",0,11,-11
"26957","6180橘子","110/07/12","統一-南京",10,0,10
"26958","6180橘子","110/07/12","凱基-大安",0,10,-10
"26959","6180橘子","110/07/12","致和-崇德",10,0,10
"26960","6180橘子","110/07/12","元大-北屯",0,10,-10
"26961","6180橘子","110/07/12","玉山-板橋",10,0,10
"26962","6180橘子","110/07/12","元大-南京",0,9,-9
"26963","6180橘子","110/07/12","富邦-仁愛",10,0,10
"26964","6180橘子","110/07/12","元大-台南",1,10,-9
"26965","6180橘子","110/07/12","摩根大通",10,1,9
"26966","6180橘子","110/07/12","康和-澎湖",0,8,-8
"26967","6180橘子","110/07/12","元富-林園",8,0,8
"26968","6180橘子","110/07/12","第一金-台中",0,7,-7
"26969","6180橘子","110/07/12","大慶-富順",7,0,7
"26970","6180橘子","110/07/12","台新-台南",1,8,-7
"26971","2390云辰","110/07/12","統一-新台中",170,0,170
"26972","2390云辰","110/07/12","元大-天母",2,450,-448
"26973","2390云辰","110/07/12","華南永昌-麻豆",137,2,135
"26974","2390云辰","110/07/12","國泰-忠孝",1,143,-142
"26975","2390云辰","110/07/12","元富-成功",103,14,89
"26976","2390云辰","110/07/12","摩根大通",377,512,-135
"26977","2390云辰","110/07/12","元大-土城學府",146,69,77
"26978","2390云辰","110/07/12","台灣摩根士丹利",0,91,-91
"26979","2390云辰","110/07/12","永豐金-永康",76,4,72
"26980","2390云辰","110/07/12","美林",84,146,-62
"26981","2390云辰","110/07/12","台中銀",73,2,71
"26982","2390云辰","110/07/12","華南永昌-嘉義",2,61,-59
"26983","2390云辰","110/07/12","大昌",63,3,60
"26984","2390云辰","110/07/12","永豐金-羅東",0,49,-49
"26985","2390云辰","110/07/12","合庫-三重",50,0,50
"26986","2390云辰","110/07/12","玉山-台中",6,53,-47
"26987","2390云辰","110/07/12","元富-高雄",93,50,43
"26988","2390云辰","110/07/12","玉山-新莊",2,48,-46
"26989","2390云辰","110/07/12","元大-館前",40,4,36
"26990","2390云辰","110/07/12","元大-大里",7,52,-45
"26991","2390云辰","110/07/12","港商野村",143,109,34
"26992","2390云辰","110/07/12","元大-內湖",3,48,-45
"26993","2390云辰","110/07/12","元大-雙和",34,0,34
"26994","2390云辰","110/07/12","永豐金-市政",1,42,-41
"26995","2390云辰","110/07/12","群益金鼎-民權",33,2,31
"26996","2390云辰","110/07/12","元大-學甲",1,41,-40
"26997","2390云辰","110/07/12","日盛-八德",40,10,30
"26998","2390云辰","110/07/12","兆豐-高雄",2,41,-39
"26999","2390云辰","110/07/12","國票-嘉義",30,0,30
"27000","2390云辰","110/07/12","新加坡商瑞銀",21,59,-38
"27001","4903聯光通","110/07/12","台灣企銀-太平",19,0,19
"27002","4903聯光通","110/07/12","玉山-南京東路",0,16,-16
"27003","4903聯光通","110/07/12","統一-土城",17,0,17
"27004","4903聯光通","110/07/12","新光",0,14,-14
"27005","4903聯光通","110/07/12","國票-博愛",14,0,14
"27006","4903聯光通","110/07/12","兆豐-彰化",0,10,-10
"27007","4903聯光通","110/07/12","新光-台中",15,2,13
"27008","4903聯光通","110/07/12","國票",0,10,-10
"27009","4903聯光通","110/07/12","元大-彰化",11,0,11
"27010","4903聯光通","110/07/12","富邦-敦南",0,10,-10
"27011","4903聯光通","110/07/12","華南永昌-林口",10,0,10
"27012","4903聯光通","110/07/12","元大-前金",0,9,-9
"27013","4903聯光通","110/07/12","永豐金-南投",9,0,9
"27014","4903聯光通","110/07/12","日盛-頭份",0,8,-8
"27015","4903聯光通","110/07/12","元大-清水",8,0,8
"27016","4903聯光通","110/07/12","元大-太平",0,8,-8
"27017","4903聯光通","110/07/12","元大-博愛",8,0,8
"27018","4903聯光通","110/07/12","兆豐-埔墘",0,7,-7
"27019","4903聯光通","110/07/12","玉山-新莊",5,0,5
"27020","4903聯光通","110/07/12","臺銀-民權",0,5,-5
"27021","4903聯光通","110/07/12","凱基-士林",10,5,5
"27022","4903聯光通","110/07/12","富邦-板橋",0,5,-5
"27023","4903聯光通","110/07/12","元大-斗六",4,0,4
"27024","4903聯光通","110/07/12","元大-土城永寧",0,5,-5
"27025","4903聯光通","110/07/12","永豐金-羅東",4,0,4
"27026","4903聯光通","110/07/12","台新證券",0,4,-4
"27027","4903聯光通","110/07/12","日盛-樹林",3,0,3
"27028","4903聯光通","110/07/12","凱基-中壢",0,4,-4
"27029","4903聯光通","110/07/12","華南永昌-鶯歌",2,0,2
"27030","4903聯光通","110/07/12","元大-羅東",0,4,-4
"27031","2929淘帝","110/07/12","新光-台中",95,36,59
"27032","2929淘帝","110/07/12","華南永昌-林口",7,208,-201
"27033","2929淘帝","110/07/12","富邦-板橋",62,5,57
"27034","2929淘帝","110/07/12","富邦-台北",6,200,-194
"27035","2929淘帝","110/07/12","合庫-高雄",56,6,50
"27036","2929淘帝","110/07/12","元富-大裕",11,200,-189
"27037","2929淘帝","110/07/12","永興",41,0,41
"27038","2929淘帝","110/07/12","台中銀-台北",0,160,-160
"27039","2929淘帝","110/07/12","兆豐-忠孝",58,18,40
"27040","2929淘帝","110/07/12","日盛-園區",1,111,-110
"27041","2929淘帝","110/07/12","新光-高雄",39,3,36
"27042","2929淘帝","110/07/12","日盛-八德",0,88,-88
"27043","2929淘帝","110/07/12","凱基-豐中",36,0,36
"27044","2929淘帝","110/07/12","玉山-新竹",32,110,-78
"27045","2929淘帝","110/07/12","元大-民生",35,0,35
"27046","2929淘帝","110/07/12","元大-前金",0,72,-72
"27047","2929淘帝","110/07/12","臺銀-臺南",32,1,31
"27048","2929淘帝","110/07/12","元大-館前",12,83,-71
"27049","2929淘帝","110/07/12","台新證券",44,13,31
"27050","2929淘帝","110/07/12","華南永昌",1,57,-56
"27051","2929淘帝","110/07/12","新百王",30,0,30
"27052","2929淘帝","110/07/12","元大-南崁",4,59,-55
"27053","2929淘帝","110/07/12","群益金鼎-大興",30,0,30
"27054","2929淘帝","110/07/12","元大-嘉義",0,51,-51
"27055","2929淘帝","110/07/12","凱基-台北",32,5,27
"27056","2929淘帝","110/07/12","日茂",1,50,-49
"27057","2929淘帝","110/07/12","元富-城東",26,0,26
"27058","2929淘帝","110/07/12","新光",35,83,-48
"27059","2929淘帝","110/07/12","國泰-松江",26,0,26
"27060","2929淘帝","110/07/12","日盛-新竹",1,48,-47
"27061","5410國眾","110/07/12","群益金鼎-中壢",68,0,68
"27062","5410國眾","110/07/12","摩根大通",6,67,-61
"27063","5410國眾","110/07/12","凱基-市政",40,0,40
"27064","5410國眾","110/07/12","元富-嘉義",0,60,-60
"27065","5410國眾","110/07/12","凱基-竹北",38,0,38
"27066","5410國眾","110/07/12","凱基-台北",0,51,-51
"27067","5410國眾","110/07/12","華南永昌-三重",30,0,30
"27068","5410國眾","110/07/12","元富-大裕",0,33,-33
"27069","5410國眾","110/07/12","永興",20,0,20
"27070","5410國眾","110/07/12","日盛-木柵",0,15,-15
"27071","5410國眾","110/07/12","統一-新台中",20,0,20
"27072","5410國眾","110/07/12","群益金鼎-民權",0,15,-15
"27073","5410國眾","110/07/12","兆豐-三重",20,0,20
"27074","5410國眾","110/07/12","元富-緯城",0,14,-14
"27075","5410國眾","110/07/12","富邦-台中",20,0,20
"27076","5410國眾","110/07/12","元大-大同",0,12,-12
"27077","5410國眾","110/07/12","臺銀",15,0,15
"27078","5410國眾","110/07/12","元大-莒光",0,10,-10
"27079","5410國眾","110/07/12","新光-桃園",20,6,14
"27080","5410國眾","110/07/12","元大-博愛",0,10,-10
"27081","5410國眾","110/07/12","元大-員林",12,0,12
"27082","5410國眾","110/07/12","日盛-永康",0,8,-8
"27083","5410國眾","110/07/12","日盛-員林",10,0,10
"27084","5410國眾","110/07/12","元大-四維",5,13,-8
"27085","5410國眾","110/07/12","元大-新盛",10,0,10
"27086","5410國眾","110/07/12","新加坡商瑞銀",0,7,-7
"27087","5410國眾","110/07/12","永豐金-台南",10,0,10
"27088","5410國眾","110/07/12","致和-金華",0,7,-7
"27089","5410國眾","110/07/12","元富-新莊",8,0,8
"27090","5410國眾","110/07/12","新光-新竹",0,7,-7
"27091","2841台開","110/07/12","永豐金-敦南",139,26,113
"27092","2841台開","110/07/12","華南永昌-朴子",0,528,-528
"27093","2841台開","110/07/12","日盛-雙和",68,0,68
"27094","2841台開","110/07/12","元大-苑裡",2,50,-48
"27095","2841台開","110/07/12","台新證券",62,4,58
"27096","2841台開","110/07/12","群益金鼎-東湖",0,40,-40
"27097","2841台開","110/07/12","凱基-文心",50,0,50
"27098","2841台開","110/07/12","第一金-員林",0,30,-30
"27099","2841台開","110/07/12","第一金-台中",45,0,45
"27100","2841台開","110/07/12","德信-中正",0,20,-20
"27101","2841台開","110/07/12","富邦-嘉義",40,0,40
"27102","2841台開","110/07/12","兆豐-嘉義",0,20,-20
"27103","2841台開","110/07/12","日盛-木柵",30,0,30
"27104","2841台開","110/07/12","彰銀-七賢",0,15,-15
"27105","2841台開","110/07/12","中國信託-文心",31,3,28
"27106","2841台開","110/07/12","元大-承德",0,14,-14
"27107","2841台開","110/07/12","元大-福營",30,7,23
"27108","2841台開","110/07/12","元富",0,12,-12
"27109","2841台開","110/07/12","台中銀",20,0,20
"27110","2841台開","110/07/12","富邦-陽明",0,11,-11
"27111","2841台開","110/07/12","國泰-板橋",20,0,20
"27112","2841台開","110/07/12","元大證券",0,11,-11
"27113","2841台開","110/07/12","元大-前金",20,0,20
"27114","2841台開","110/07/12","元大-大甲",0,10,-10
"27115","2841台開","110/07/12","中國信託-高雄",16,1,15
"27116","2841台開","110/07/12","日盛-新竹",0,8,-8
"27117","2841台開","110/07/12","陽信-石牌",15,0,15
"27118","2841台開","110/07/12","元富-城東",0,8,-8
"27119","2841台開","110/07/12","永豐金-南投",15,0,15
"27120","2841台開","110/07/12","玉山-台南",2,10,-8
"27121","6207雷科","110/07/12","元大-高雄",34,0,34
"27122","6207雷科","110/07/12","永豐金-三重",1,32,-31
"27123","6207雷科","110/07/12","華南永昌-林口",16,1,15
"27124","6207雷科","110/07/12","永全-八德",0,30,-30
"27125","6207雷科","110/07/12","摩根大通",19,6,13
"27126","6207雷科","110/07/12","國泰-台中",0,14,-14
"27127","6207雷科","110/07/12","元富-埔里",10,0,10
"27128","6207雷科","110/07/12","第一金-澎湖",0,10,-10
"27129","6207雷科","110/07/12","凱基-台南",10,0,10
"27130","6207雷科","110/07/12","元富-林園",0,10,-10
"27131","6207雷科","110/07/12","新加坡商瑞銀",9,0,9
"27132","6207雷科","110/07/12","元大-東門",0,10,-10
"27133","6207雷科","110/07/12","瑞士信貸",8,0,8
"27134","6207雷科","110/07/12","兆豐-嘉義",0,4,-4
"27135","6207雷科","110/07/12","中國信託-高雄",9,1,8
"27136","6207雷科","110/07/12","新光",0,4,-4
"27137","6207雷科","110/07/12","凱基-高雄",6,0,6
"27138","6207雷科","110/07/12","新光-台中",0,4,-4
"27139","6207雷科","110/07/12","元大-六合",6,0,6
"27140","6207雷科","110/07/12","群益金鼎-開元",0,4,-4
"27141","6207雷科","110/07/12","永豐金-信義",6,0,6
"27142","6207雷科","110/07/12","凱基-桃園",0,4,-4
"27143","6207雷科","110/07/12","群益金鼎-土城",5,0,5
"27144","6207雷科","110/07/12","凱基-民權",0,4,-4
"27145","6207雷科","110/07/12","群益金鼎-竹南",5,0,5
"27146","6207雷科","110/07/12","玉山-新莊",0,3,-3
"27147","6207雷科","110/07/12","元大-大灣",5,1,4
"27148","6207雷科","110/07/12","國泰-松江",0,3,-3
"27149","6207雷科","110/07/12","永興",3,0,3
"27150","6207雷科","110/07/12","富邦-羅東",0,3,-3
"27151","3679新至陞","110/07/12","富邦-新竹華信",40,2,38
"27152","3679新至陞","110/07/12","瑞士信貸",0,45,-45
"27153","3679新至陞","110/07/12","台中銀-員林",28,2,26
"27154","3679新至陞","110/07/12","永豐金-天母",0,39,-39
"27155","3679新至陞","110/07/12","聯邦-大業",24,0,24
"27156","3679新至陞","110/07/12","摩根大通",7,35,-28
"27157","3679新至陞","110/07/12","永豐金證券",20,0,20
"27158","3679新至陞","110/07/12","凱基-台北",8,36,-28
"27159","3679新至陞","110/07/12","港商法國興業",14,0,14
"27160","3679新至陞","110/07/12","華南永昌-小港",1,23,-22
"27161","3679新至陞","110/07/12","日盛-樹林",13,1,12
"27162","3679新至陞","110/07/12","台新-台中",0,15,-15
"27163","3679新至陞","110/07/12","國泰-桃園",9,0,9
"27164","3679新至陞","110/07/12","統一-台中",0,12,-12
"27165","3679新至陞","110/07/12","宏遠-館前",8,0,8
"27166","3679新至陞","110/07/12","元大-成功",1,12,-11
"27167","3679新至陞","110/07/12","凱基",10,2,8
"27168","3679新至陞","110/07/12","康和-澎湖",0,8,-8
"27169","3679新至陞","110/07/12","(牛牛牛)亞-網路",7,0,7
"27170","3679新至陞","110/07/12","新加坡商瑞銀",0,7,-7
"27171","3679新至陞","110/07/12","兆豐-員林",7,0,7
"27172","3679新至陞","110/07/12","兆豐-來福",0,7,-7
"27173","3679新至陞","110/07/12","大慶-蘆洲",5,0,5
"27174","3679新至陞","110/07/12","元大-佳里",0,6,-6
"27175","3679新至陞","110/07/12","土銀-花蓮",4,0,4
"27176","3679新至陞","110/07/12","美商高盛",0,5,-5
"27177","3679新至陞","110/07/12","台新-高雄",5,1,4
"27178","3679新至陞","110/07/12","國票-新莊",0,5,-5
"27179","3679新至陞","110/07/12","元大-天母",4,0,4
"27180","3679新至陞","110/07/12","台新-屏東",0,5,-5
"27181","2727王品","110/07/12","凱基-台北",354,198,156
"27182","2727王品","110/07/12","台灣摩根士丹利",5,386,-381
"27183","2727王品","110/07/12","統一-城中",159,22,137
"27184","2727王品","110/07/12","元大-嘉義",4,60,-56
"27185","2727王品","110/07/12","日盛-忠孝",60,0,60
"27186","2727王品","110/07/12","元大-大同",2,44,-42
"27187","2727王品","110/07/12","永豐金-忠孝",45,5,40
"27188","2727王品","110/07/12","國泰-台中",32,73,-41
"27189","2727王品","110/07/12","合庫-新竹",31,0,31
"27190","2727王品","110/07/12","元大證券",127,163,-36
"27191","2727王品","110/07/12","富邦-台中",31,3,28
"27192","2727王品","110/07/12","凱基",1,33,-32
"27193","2727王品","110/07/12","元大-桃園",35,10,25
"27194","2727王品","110/07/12","永全-南崁",1,31,-30
"27195","2727王品","110/07/12","新加坡商瑞銀",28,4,24
"27196","2727王品","110/07/12","凱基-和平",2,32,-30
"27197","2727王品","110/07/12","群益金鼎-古亭",25,2,23
"27198","2727王品","110/07/12","永豐金-大園",8,38,-30
"27199","2727王品","110/07/12","元大-龍潭",29,7,22
"27200","2727王品","110/07/12","瑞士信貸",0,28,-28
"27201","2727王品","110/07/12","永豐金-永康",25,3,22
"27202","2727王品","110/07/12","元富",17,44,-27
"27203","2727王品","110/07/12","富邦-竹北",24,3,21
"27204","2727王品","110/07/12","元大-北屯",5,32,-27
"27205","2727王品","110/07/12","群益金鼎-松山",20,0,20
"27206","2727王品","110/07/12","華南永昌",3,28,-25
"27207","2727王品","110/07/12","元大-八德",20,0,20
"27208","2727王品","110/07/12","統一-竹南",1,23,-22
"27209","2727王品","110/07/12","元大-南京",25,6,19
"27210","2727王品","110/07/12","永豐金證券",4,26,-22
"27211","1570力肯","110/07/12","國票-北高雄",40,0,40
"27212","1570力肯","110/07/12","日盛-竹北",0,40,-40
"27213","1570力肯","110/07/12","摩根大通",16,0,16
"27214","1570力肯","110/07/12","第一金-華江",1,38,-37
"27215","1570力肯","110/07/12","新光",31,19,12
"27216","1570力肯","110/07/12","元大-永春",0,26,-26
"27217","1570力肯","110/07/12","元大-台中中港",12,0,12
"27218","1570力肯","110/07/12","元大-古亭",1,20,-19
"27219","1570力肯","110/07/12","日盛-高雄",10,0,10
"27220","1570力肯","110/07/12","國泰-松江",0,16,-16
"27221","1570力肯","110/07/12","第一金-路竹",10,0,10
"27222","1570力肯","110/07/12","台新-台南",0,15,-15
"27223","1570力肯","110/07/12","台新-新莊",10,0,10
"27224","1570力肯","110/07/12","康和-石牌",0,15,-15
"27225","1570力肯","110/07/12","元大-新盛",9,0,9
"27226","1570力肯","110/07/12","國泰-板橋",0,11,-11
"27227","1570力肯","110/07/12","凱基-台北",8,0,8
"27228","1570力肯","110/07/12","元大-高雄",0,11,-11
"27229","1570力肯","110/07/12","彰銀-七賢",6,0,6
"27230","1570力肯","110/07/12","兆豐-桃園",0,10,-10
"27231","1570力肯","110/07/12","元富-緯城",6,0,6
"27232","1570力肯","110/07/12","元大-大益",0,10,-10
"27233","1570力肯","110/07/12","華南永昌-古亭",6,0,6
"27234","1570力肯","110/07/12","中國信託-文心",0,5,-5
"27235","1570力肯","110/07/12","富邦-陽明",6,0,6
"27236","1570力肯","110/07/12","光和",0,5,-5
"27237","1570力肯","110/07/12","臺銀-臺南",5,0,5
"27238","1570力肯","110/07/12","陽信-石牌",0,5,-5
"27239","1570力肯","110/07/12","宏遠-館前",5,0,5
"27240","1570力肯","110/07/12","國泰-高雄",0,5,-5
"27241","6180橘子","110/07/12","康和-台中",32,2,30
"27242","6180橘子","110/07/12","新百王",1,40,-39
"27243","6180橘子","110/07/12","美林",32,3,29
"27244","6180橘子","110/07/12","富邦-陽明",4,42,-38
"27245","6180橘子","110/07/12","元大-羅東",21,0,21
"27246","6180橘子","110/07/12","新光",3,32,-29
"27247","6180橘子","110/07/12","兆豐-埔墘",16,0,16
"27248","6180橘子","110/07/12","日盛-文化",4,20,-16
"27249","6180橘子","110/07/12","元大-雙和",12,0,12
"27250","6180橘子","110/07/12","華南永昌-鶯歌",0,15,-15
"27251","6180橘子","110/07/12","美商高盛",18,7,11
"27252","6180橘子","110/07/12","中國信託-忠孝",7,20,-13
"27253","6180橘子","110/07/12","台新證券",14,3,11
"27254","6180橘子","110/07/12","凱基-台北",5,17,-12
"27255","6180橘子","110/07/12","元大-中壢",12,1,11
"27256","6180橘子","110/07/12","凱基-高雄",0,11,-11
"27257","6180橘子","110/07/12","統一-南京",10,0,10
"27258","6180橘子","110/07/12","凱基-大安",0,10,-10
"27259","6180橘子","110/07/12","致和-崇德",10,0,10
"27260","6180橘子","110/07/12","元大-北屯",0,10,-10
"27261","6180橘子","110/07/12","玉山-板橋",10,0,10
"27262","6180橘子","110/07/12","元大-南京",0,9,-9
"27263","6180橘子","110/07/12","富邦-仁愛",10,0,10
"27264","6180橘子","110/07/12","元大-台南",1,10,-9
"27265","6180橘子","110/07/12","摩根大通",10,1,9
"27266","6180橘子","110/07/12","康和-澎湖",0,8,-8
"27267","6180橘子","110/07/12","元富-林園",8,0,8
"27268","6180橘子","110/07/12","第一金-台中",0,7,-7
"27269","6180橘子","110/07/12","大慶-富順",7,0,7
"27270","6180橘子","110/07/12","台新-台南",1,8,-7
"27271","2390云辰","110/07/12","統一-新台中",170,0,170
"27272","2390云辰","110/07/12","元大-天母",2,450,-448
"27273","2390云辰","110/07/12","華南永昌-麻豆",137,2,135
"27274","2390云辰","110/07/12","國泰-忠孝",1,143,-142
"27275","2390云辰","110/07/12","元富-成功",103,14,89
"27276","2390云辰","110/07/12","摩根大通",377,512,-135
"27277","2390云辰","110/07/12","元大-土城學府",146,69,77
"27278","2390云辰","110/07/12","台灣摩根士丹利",0,91,-91
"27279","2390云辰","110/07/12","永豐金-永康",76,4,72
"27280","2390云辰","110/07/12","美林",84,146,-62
"27281","2390云辰","110/07/12","台中銀",73,2,71
"27282","2390云辰","110/07/12","華南永昌-嘉義",2,61,-59
"27283","2390云辰","110/07/12","大昌",63,3,60
"27284","2390云辰","110/07/12","永豐金-羅東",0,49,-49
"27285","2390云辰","110/07/12","合庫-三重",50,0,50
"27286","2390云辰","110/07/12","玉山-台中",6,53,-47
"27287","2390云辰","110/07/12","元富-高雄",93,50,43
"27288","2390云辰","110/07/12","玉山-新莊",2,48,-46
"27289","2390云辰","110/07/12","元大-館前",40,4,36
"27290","2390云辰","110/07/12","元大-大里",7,52,-45
"27291","2390云辰","110/07/12","港商野村",143,109,34
"27292","2390云辰","110/07/12","元大-內湖",3,48,-45
"27293","2390云辰","110/07/12","元大-雙和",34,0,34
"27294","2390云辰","110/07/12","永豐金-市政",1,42,-41
"27295","2390云辰","110/07/12","群益金鼎-民權",33,2,31
"27296","2390云辰","110/07/12","元大-學甲",1,41,-40
"27297","2390云辰","110/07/12","日盛-八德",40,10,30
"27298","2390云辰","110/07/12","兆豐-高雄",2,41,-39
"27299","2390云辰","110/07/12","國票-嘉義",30,0,30
"27300","2390云辰","110/07/12","新加坡商瑞銀",21,59,-38
"27301","4903聯光通","110/07/09","元大-敦南",10,0,10
"27302","4903聯光通","110/07/09","第一金-台中",0,12,-12
"27303","4903聯光通","110/07/09","凱基-士林",5,0,5
"27304","4903聯光通","110/07/09","日盛-忠孝",0,3,-3
"27305","4903聯光通","110/07/09","元大-苗栗",5,0,5
"27306","4903聯光通","110/07/09","群益金鼎-崇德",0,3,-3
"27307","4903聯光通","110/07/09","元大-屏南",3,0,3
"27308","4903聯光通","110/07/09","國票-內壢",0,2,-2
"27309","4903聯光通","110/07/09","中國信託-永康",1,0,1
"27310","4903聯光通","110/07/09","康和-南崁",0,2,-2
"27311","4903聯光通","110/07/09","玉山證券",1,0,1
"27312","4903聯光通","110/07/09","新光-台中",0,2,-2
"27313","4903聯光通","110/07/09","元大-太平",4,3,1
"27314","4903聯光通","110/07/09","玉山-城中",0,2,-2
"27315","4903聯光通","110/07/09","永豐金-嘉義",1,0,1
"27316","4903聯光通","110/07/09","中國信託-文心",0,1,-1
"27317","4903聯光通","110/07/09","大昌",0,0,0
"27318","4903聯光通","110/07/09","大昌",0,0,0
"27319","4903聯光通","110/07/09","中農",0,0,0
"27320","4903聯光通","110/07/09","中農",0,0,0
"27321","4903聯光通","110/07/09","",NA,NA,NA
"27322","4903聯光通","110/07/09","",NA,NA,NA
"27323","4903聯光通","110/07/09","",NA,NA,NA
"27324","4903聯光通","110/07/09","",NA,NA,NA
"27325","4903聯光通","110/07/09","",NA,NA,NA
"27326","4903聯光通","110/07/09","",NA,NA,NA
"27327","4903聯光通","110/07/09","",NA,NA,NA
"27328","4903聯光通","110/07/09","",NA,NA,NA
"27329","4903聯光通","110/07/09","",NA,NA,NA
"27330","4903聯光通","110/07/09","",NA,NA,NA
"27331","2929淘帝","110/07/09","台中銀-台北",110,0,110
"27332","2929淘帝","110/07/09","新光",2,82,-80
"27333","2929淘帝","110/07/09","華南永昌-頭份",72,0,72
"27334","2929淘帝","110/07/09","摩根大通",2,63,-61
"27335","2929淘帝","110/07/09","合庫-高雄",71,0,71
"27336","2929淘帝","110/07/09","第一金-路竹",0,50,-50
"27337","2929淘帝","110/07/09","高橋-龍潭",37,0,37
"27338","2929淘帝","110/07/09","港商麥格理",0,42,-42
"27339","2929淘帝","110/07/09","新光-台中",60,26,34
"27340","2929淘帝","110/07/09","陽信-石牌",0,40,-40
"27341","2929淘帝","110/07/09","元富-大裕",22,1,21
"27342","2929淘帝","110/07/09","台新-左楠",1,39,-38
"27343","2929淘帝","110/07/09","合庫-鳳山",20,0,20
"27344","2929淘帝","110/07/09","凱基-桃園",3,29,-26
"27345","2929淘帝","110/07/09","元大-員林",22,2,20
"27346","2929淘帝","110/07/09","兆豐-內湖",0,25,-25
"27347","2929淘帝","110/07/09","台新-建北",15,0,15
"27348","2929淘帝","110/07/09","元大-北港",0,20,-20
"27349","2929淘帝","110/07/09","兆豐-桃園",13,0,13
"27350","2929淘帝","110/07/09","富邦-北港",0,19,-19
"27351","2929淘帝","110/07/09","兆豐-忠孝",10,0,10
"27352","2929淘帝","110/07/09","富邦-花蓮",0,17,-17
"27353","2929淘帝","110/07/09","國票-敦北法人",10,0,10
"27354","2929淘帝","110/07/09","國泰-台中",2,17,-15
"27355","2929淘帝","110/07/09","永豐金-博愛",10,0,10
"27356","2929淘帝","110/07/09","群益金鼎-彰化",0,15,-15
"27357","2929淘帝","110/07/09","群益金鼎-潭子",8,0,8
"27358","2929淘帝","110/07/09","元大-博愛",0,14,-14
"27359","2929淘帝","110/07/09","富邦-南屯",8,0,8
"27360","2929淘帝","110/07/09","日盛-板橋",0,13,-13
"27361","5410國眾","110/07/09","元大-新盛",14,0,14
"27362","5410國眾","110/07/09","(牛牛牛)亞-鑫豐",1,41,-40
"27363","5410國眾","110/07/09","台灣企銀-民雄",10,0,10
"27364","5410國眾","110/07/09","元富-嘉義",0,25,-25
"27365","5410國眾","110/07/09","元富-虎尾",9,0,9
"27366","5410國眾","110/07/09","凱基-高美館",0,10,-10
"27367","5410國眾","110/07/09","摩根大通",10,1,9
"27368","5410國眾","110/07/09","凱基-城中",0,10,-10
"27369","5410國眾","110/07/09","兆豐-北高雄",7,0,7
"27370","5410國眾","110/07/09","元大-頭份",0,10,-10
"27371","5410國眾","110/07/09","凱基-台北",8,1,7
"27372","5410國眾","110/07/09","群益金鼎-丹鳳",0,7,-7
"27373","5410國眾","110/07/09","華南永昌-公誠",7,0,7
"27374","5410國眾","110/07/09","凱基-復興",0,7,-7
"27375","5410國眾","110/07/09","香港上海匯豐",6,0,6
"27376","5410國眾","110/07/09","元大-員林",0,7,-7
"27377","5410國眾","110/07/09","凱基-中壢",6,0,6
"27378","5410國眾","110/07/09","富邦-竹東",0,6,-6
"27379","5410國眾","110/07/09","華南永昌-南京",6,0,6
"27380","5410國眾","110/07/09","亞東-高雄",0,5,-5
"27381","5410國眾","110/07/09","統一-三重",5,0,5
"27382","5410國眾","110/07/09","大慶-中壢",1,6,-5
"27383","5410國眾","110/07/09","富邦-宜蘭",5,0,5
"27384","5410國眾","110/07/09","群益金鼎-中港",0,5,-5
"27385","5410國眾","110/07/09","元大-崇德",5,0,5
"27386","5410國眾","110/07/09","元大-八德",0,5,-5
"27387","5410國眾","110/07/09","元大-博愛",5,0,5
"27388","5410國眾","110/07/09","富邦-基隆",0,4,-4
"27389","5410國眾","110/07/09","元大-龍潭",5,0,5
"27390","5410國眾","110/07/09","臺銀-新竹",0,3,-3
"27391","2841台開","110/07/09","日盛-雙和",102,0,102
"27392","2841台開","110/07/09","港商野村",0,129,-129
"27393","2841台開","110/07/09","元大-館前",70,0,70
"27394","2841台開","110/07/09","兆豐-永和",0,100,-100
"27395","2841台開","110/07/09","凱基-文心",50,0,50
"27396","2841台開","110/07/09","台新證券",7,28,-21
"27397","2841台開","110/07/09","富邦-嘉義",40,0,40
"27398","2841台開","110/07/09","國票-北高雄",0,20,-20
"27399","2841台開","110/07/09","美商高盛",15,0,15
"27400","2841台開","110/07/09","永豐金-敦南",29,46,-17
"27401","2841台開","110/07/09","台中銀",15,0,15
"27402","2841台開","110/07/09","合庫-基隆",0,12,-12
"27403","2841台開","110/07/09","新光",11,0,11
"27404","2841台開","110/07/09","中國信託-松江",0,12,-12
"27405","2841台開","110/07/09","華南永昌-長虹",10,0,10
"27406","2841台開","110/07/09","兆豐-城中",0,12,-12
"27407","2841台開","110/07/09","永豐金-南投",10,0,10
"27408","2841台開","110/07/09","台中銀-豐原",0,10,-10
"27409","2841台開","110/07/09","合庫-桃園",7,0,7
"27410","2841台開","110/07/09","兆豐-景美",0,10,-10
"27411","2841台開","110/07/09","群益金鼎-古亭",7,0,7
"27412","2841台開","110/07/09","群益金鼎-基隆",0,10,-10
"27413","2841台開","110/07/09","國泰-敦南",6,0,6
"27414","2841台開","110/07/09","元大-北三重",0,10,-10
"27415","2841台開","110/07/09","凱基-桃園",8,2,6
"27416","2841台開","110/07/09","(牛牛牛)亞-網路",0,9,-9
"27417","2841台開","110/07/09","日盛證券",5,0,5
"27418","2841台開","110/07/09","台新-高雄",1,10,-9
"27419","2841台開","110/07/09","元富-文心",5,0,5
"27420","2841台開","110/07/09","凱基-台北",0,7,-7
"27421","6207雷科","110/07/09","群益金鼎-新竹",47,0,47
"27422","6207雷科","110/07/09","新光",7,24,-17
"27423","6207雷科","110/07/09","永豐金-三重",31,0,31
"27424","6207雷科","110/07/09","日盛-和美",0,15,-15
"27425","6207雷科","110/07/09","新加坡商瑞銀",33,5,28
"27426","6207雷科","110/07/09","國泰-台南",0,15,-15
"27427","6207雷科","110/07/09","元大-高雄",26,0,26
"27428","6207雷科","110/07/09","華南永昌-古亭",0,14,-14
"27429","6207雷科","110/07/09","統一-員林",22,0,22
"27430","6207雷科","110/07/09","土銀-白河",0,11,-11
"27431","6207雷科","110/07/09","台新-高雄",22,0,22
"27432","6207雷科","110/07/09","日盛-台南",0,10,-10
"27433","6207雷科","110/07/09","摩根大通",34,17,17
"27434","6207雷科","110/07/09","元富-林園",0,10,-10
"27435","6207雷科","110/07/09","元大-博愛",17,1,16
"27436","6207雷科","110/07/09","富邦-園區",0,10,-10
"27437","6207雷科","110/07/09","日茂-埔里",12,0,12
"27438","6207雷科","110/07/09","元大-上新莊",0,10,-10
"27439","6207雷科","110/07/09","國泰-台中",17,6,11
"27440","6207雷科","110/07/09","永豐金-南京",0,10,-10
"27441","6207雷科","110/07/09","富邦-三重",10,0,10
"27442","6207雷科","110/07/09","兆豐-小港",0,6,-6
"27443","6207雷科","110/07/09","元大-沙鹿",10,0,10
"27444","6207雷科","110/07/09","富邦-羅東",1,7,-6
"27445","6207雷科","110/07/09","元大-八德",10,0,10
"27446","6207雷科","110/07/09","元大-土城永寧",0,6,-6
"27447","6207雷科","110/07/09","第一金-路竹",11,2,9
"27448","6207雷科","110/07/09","永豐金-板盛",0,6,-6
"27449","6207雷科","110/07/09","統一-南京",5,0,5
"27450","6207雷科","110/07/09","日盛-板橋",0,5,-5
"27451","3679新至陞","110/07/09","元大-大天母",10,0,10
"27452","3679新至陞","110/07/09","第一金-光復",0,11,-11
"27453","3679新至陞","110/07/09","日盛-樹林",9,0,9
"27454","3679新至陞","110/07/09","瑞士信貸",0,8,-8
"27455","3679新至陞","110/07/09","凱基-台北",11,2,9
"27456","3679新至陞","110/07/09","大慶-苗栗",0,5,-5
"27457","3679新至陞","110/07/09","華南永昌-小港",8,0,8
"27458","3679新至陞","110/07/09","元大-永春",0,5,-5
"27459","3679新至陞","110/07/09","兆豐-來福",7,0,7
"27460","3679新至陞","110/07/09","日盛-和美",0,4,-4
"27461","3679新至陞","110/07/09","香港上海匯豐",5,0,5
"27462","3679新至陞","110/07/09","元大-雙和",0,3,-3
"27463","3679新至陞","110/07/09","台中銀-員林",3,0,3
"27464","3679新至陞","110/07/09","永豐金-屏東",0,3,-3
"27465","3679新至陞","110/07/09","新光",3,0,3
"27466","3679新至陞","110/07/09","彰銀",0,2,-2
"27467","3679新至陞","110/07/09","土銀-花蓮",2,0,2
"27468","3679新至陞","110/07/09","宏遠-館前",0,2,-2
"27469","3679新至陞","110/07/09","第一金-澎湖",2,0,2
"27470","3679新至陞","110/07/09","港商野村",0,2,-2
"27471","3679新至陞","110/07/09","摩根大通",2,0,2
"27472","3679新至陞","110/07/09","大昌-新店",0,2,-2
"27473","3679新至陞","110/07/09","國泰-敦南",2,0,2
"27474","3679新至陞","110/07/09","元大-新莊",0,2,-2
"27475","3679新至陞","110/07/09","元大-淡水",4,2,2
"27476","3679新至陞","110/07/09","元大-板橋",0,2,-2
"27477","3679新至陞","110/07/09","日盛-士林",1,0,1
"27478","3679新至陞","110/07/09","台灣摩根士丹利",0,1,-1
"27479","3679新至陞","110/07/09","日盛-信義",1,0,1
"27480","3679新至陞","110/07/09","第一金-高雄",0,1,-1
"27481","2727王品","110/07/09","台灣匯立證券",90,0,90
"27482","2727王品","110/07/09","台灣摩根士丹利",0,267,-267
"27483","2727王品","110/07/09","國泰-敦南",166,84,82
"27484","2727王品","110/07/09","富邦-台北",35,299,-264
"27485","2727王品","110/07/09","富邦-仁愛",56,12,44
"27486","2727王品","110/07/09","凱基-台北",174,296,-122
"27487","2727王品","110/07/09","台新證券",109,66,43
"27488","2727王品","110/07/09","第一金",2,102,-100
"27489","2727王品","110/07/09","新光",117,87,30
"27490","2727王品","110/07/09","群益金鼎-大安",0,80,-80
"27491","2727王品","110/07/09","臺銀-臺中",35,6,29
"27492","2727王品","110/07/09","兆豐-大安",7,60,-53
"27493","2727王品","110/07/09","元大-桃園",32,3,29
"27494","2727王品","110/07/09","永豐金-南投",0,50,-50
"27495","2727王品","110/07/09","元富-宜蘭",34,6,28
"27496","2727王品","110/07/09","新加坡商瑞銀",6,46,-40
"27497","2727王品","110/07/09","玉山-台中",34,8,26
"27498","2727王品","110/07/09","合庫-彰化",11,50,-39
"27499","2727王品","110/07/09","群益金鼎-宜蘭",30,4,26
"27500","2727王品","110/07/09","永豐金-萬盛",13,52,-39
"27501","2727王品","110/07/09","富邦-台中",42,16,26
"27502","2727王品","110/07/09","瑞士信貸",0,34,-34
"27503","2727王品","110/07/09","第一金-豐原",25,1,24
"27504","2727王品","110/07/09","元大-和平",4,35,-31
"27505","2727王品","110/07/09","臺銀",30,8,22
"27506","2727王品","110/07/09","美林",14,44,-30
"27507","2727王品","110/07/09","兆豐-來福",23,1,22
"27508","2727王品","110/07/09","元大-員林",9,38,-29
"27509","2727王品","110/07/09","玉山-士林",22,2,20
"27510","2727王品","110/07/09","元富-西松",4,31,-27
"27511","1570力肯","110/07/09","凱基-台北",30,1,29
"27512","1570力肯","110/07/09","群益金鼎-彰化",0,20,-20
"27513","1570力肯","110/07/09","新光-台南",20,0,20
"27514","1570力肯","110/07/09","元大-土城學府",0,20,-20
"27515","1570力肯","110/07/09","元大-高雄",20,0,20
"27516","1570力肯","110/07/09","元大-大統",0,16,-16
"27517","1570力肯","110/07/09","國票-中正",12,0,12
"27518","1570力肯","110/07/09","元大-新營",0,11,-11
"27519","1570力肯","110/07/09","日盛-高雄",6,0,6
"27520","1570力肯","110/07/09","元大-和平",0,10,-10
"27521","1570力肯","110/07/09","元富-緯城",6,0,6
"27522","1570力肯","110/07/09","元大-草屯",0,10,-10
"27523","1570力肯","110/07/09","群益金鼎-台南",6,0,6
"27524","1570力肯","110/07/09","元大-鹿港",0,9,-9
"27525","1570力肯","110/07/09","華南永昌-岡山",6,0,6
"27526","1570力肯","110/07/09","合庫-基隆",0,7,-7
"27527","1570力肯","110/07/09","統一-中壢",5,0,5
"27528","1570力肯","110/07/09","摩根大通",2,8,-6
"27529","1570力肯","110/07/09","凱基-三峽",5,0,5
"27530","1570力肯","110/07/09","台灣企銀-豐原",0,4,-4
"27531","1570力肯","110/07/09","大昌-樹林",4,0,4
"27532","1570力肯","110/07/09","日盛-桃園",0,4,-4
"27533","1570力肯","110/07/09","新光",3,0,3
"27534","1570力肯","110/07/09","國泰-高雄",0,3,-3
"27535","1570力肯","110/07/09","富邦-新竹華信",3,0,3
"27536","1570力肯","110/07/09","永豐金-敦南",0,3,-3
"27537","1570力肯","110/07/09","合庫-台中",2,0,2
"27538","1570力肯","110/07/09","土銀-彰化",0,2,-2
"27539","1570力肯","110/07/09","臺銀-臺中",2,0,2
"27540","1570力肯","110/07/09","臺銀-鳳山",0,2,-2
"27541","6180橘子","110/07/09","摩根大通",63,1,62
"27542","6180橘子","110/07/09","元大-南京",1,32,-31
"27543","6180橘子","110/07/09","富邦-陽明",73,33,40
"27544","6180橘子","110/07/09","群益金鼎-台北",0,25,-25
"27545","6180橘子","110/07/09","新加坡商瑞銀",31,0,31
"27546","6180橘子","110/07/09","兆豐-復興",0,21,-21
"27547","6180橘子","110/07/09","美商高盛",25,0,25
"27548","6180橘子","110/07/09","永豐金-嘉義",0,21,-21
"27549","6180橘子","110/07/09","凱基-台北",26,10,16
"27550","6180橘子","110/07/09","凱基-中壢",8,24,-16
"27551","6180橘子","110/07/09","華南永昌-楠梓",13,0,13
"27552","6180橘子","110/07/09","致和-崇德",0,15,-15
"27553","6180橘子","110/07/09","華南永昌-朴子",11,0,11
"27554","6180橘子","110/07/09","群益金鼎-屏東",0,15,-15
"27555","6180橘子","110/07/09","元大-北港",11,0,11
"27556","6180橘子","110/07/09","群益金鼎-中山",0,15,-15
"27557","6180橘子","110/07/09","元大-成功",10,1,9
"27558","6180橘子","110/07/09","瑞士信貸",1,15,-14
"27559","6180橘子","110/07/09","新光",26,18,8
"27560","6180橘子","110/07/09","日盛-二林",0,10,-10
"27561","6180橘子","110/07/09","統一-三重",6,0,6
"27562","6180橘子","110/07/09","凱基-東門",0,10,-10
"27563","6180橘子","110/07/09","群益金鼎-嘉義",6,0,6
"27564","6180橘子","110/07/09","華南永昌-三重",0,10,-10
"27565","6180橘子","110/07/09","元大-員林中山",6,0,6
"27566","6180橘子","110/07/09","元大-彰化民生",1,11,-10
"27567","6180橘子","110/07/09","合庫-鳳山",5,0,5
"27568","6180橘子","110/07/09","永豐金-新店",1,11,-10
"27569","6180橘子","110/07/09","富邦-建國",6,1,5
"27570","6180橘子","110/07/09","群益金鼎-丹鳳",0,8,-8
"27571","2390云辰","110/07/09","摩根大通",279,56,223
"27572","2390云辰","110/07/09","元大-天母",0,127,-127
"27573","2390云辰","110/07/09","日盛-鳳山",110,2,108
"27574","2390云辰","110/07/09","中國信託-文心",5,109,-104
"27575","2390云辰","110/07/09","宏遠證券",100,0,100
"27576","2390云辰","110/07/09","永豐金-復興",0,55,-55
"27577","2390云辰","110/07/09","元大-大里",63,6,57
"27578","2390云辰","110/07/09","凱基-台北",239,286,-47
"27579","2390云辰","110/07/09","凱基-八德",59,10,49
"27580","2390云辰","110/07/09","德信",2,32,-30
"27581","2390云辰","110/07/09","合庫-新竹",40,0,40
"27582","2390云辰","110/07/09","兆豐-桃鶯",2,32,-30
"27583","2390云辰","110/07/09","國票",40,1,39
"27584","2390云辰","110/07/09","致和-南京",0,30,-30
"27585","2390云辰","110/07/09","新加坡商瑞銀",49,13,36
"27586","2390云辰","110/07/09","富邦-虎尾",1,31,-30
"27587","2390云辰","110/07/09","統一-新台中",36,2,34
"27588","2390云辰","110/07/09","元大-善化",2,31,-29
"27589","2390云辰","110/07/09","國票-嘉義",31,0,31
"27590","2390云辰","110/07/09","富邦-板橋",0,27,-27
"27591","2390云辰","110/07/09","華南永昌",35,7,28
"27592","2390云辰","110/07/09","富邦-永和",3,28,-25
"27593","2390云辰","110/07/09","玉山-台中",49,22,27
"27594","2390云辰","110/07/09","第一金-自由",20,44,-24
"27595","2390云辰","110/07/09","華南永昌-敦南",25,0,25
"27596","2390云辰","110/07/09","凱基-內湖",0,24,-24
"27597","2390云辰","110/07/09","新光-高雄",27,4,23
"27598","2390云辰","110/07/09","元大-汐止",1,24,-23
"27599","2390云辰","110/07/09","台灣摩根士丹利",85,63,22
"27600","2390云辰","110/07/09","新光-台中",12,33,-21
"27601","4903聯光通","110/07/09","元大-敦南",10,0,10
"27602","4903聯光通","110/07/09","第一金-台中",0,12,-12
"27603","4903聯光通","110/07/09","凱基-士林",5,0,5
"27604","4903聯光通","110/07/09","日盛-忠孝",0,3,-3
"27605","4903聯光通","110/07/09","元大-苗栗",5,0,5
"27606","4903聯光通","110/07/09","群益金鼎-崇德",0,3,-3
"27607","4903聯光通","110/07/09","元大-屏南",3,0,3
"27608","4903聯光通","110/07/09","國票-內壢",0,2,-2
"27609","4903聯光通","110/07/09","中國信託-永康",1,0,1
"27610","4903聯光通","110/07/09","康和-南崁",0,2,-2
"27611","4903聯光通","110/07/09","玉山證券",1,0,1
"27612","4903聯光通","110/07/09","新光-台中",0,2,-2
"27613","4903聯光通","110/07/09","元大-太平",4,3,1
"27614","4903聯光通","110/07/09","玉山-城中",0,2,-2
"27615","4903聯光通","110/07/09","永豐金-嘉義",1,0,1
"27616","4903聯光通","110/07/09","中國信託-文心",0,1,-1
"27617","4903聯光通","110/07/09","大昌",0,0,0
"27618","4903聯光通","110/07/09","大昌",0,0,0
"27619","4903聯光通","110/07/09","中農",0,0,0
"27620","4903聯光通","110/07/09","中農",0,0,0
"27621","4903聯光通","110/07/09","",NA,NA,NA
"27622","4903聯光通","110/07/09","",NA,NA,NA
"27623","4903聯光通","110/07/09","",NA,NA,NA
"27624","4903聯光通","110/07/09","",NA,NA,NA
"27625","4903聯光通","110/07/09","",NA,NA,NA
"27626","4903聯光通","110/07/09","",NA,NA,NA
"27627","4903聯光通","110/07/09","",NA,NA,NA
"27628","4903聯光通","110/07/09","",NA,NA,NA
"27629","4903聯光通","110/07/09","",NA,NA,NA
"27630","4903聯光通","110/07/09","",NA,NA,NA
"27631","2929淘帝","110/07/09","台中銀-台北",110,0,110
"27632","2929淘帝","110/07/09","新光",2,82,-80
"27633","2929淘帝","110/07/09","華南永昌-頭份",72,0,72
"27634","2929淘帝","110/07/09","摩根大通",2,63,-61
"27635","2929淘帝","110/07/09","合庫-高雄",71,0,71
"27636","2929淘帝","110/07/09","第一金-路竹",0,50,-50
"27637","2929淘帝","110/07/09","高橋-龍潭",37,0,37
"27638","2929淘帝","110/07/09","港商麥格理",0,42,-42
"27639","2929淘帝","110/07/09","新光-台中",60,26,34
"27640","2929淘帝","110/07/09","陽信-石牌",0,40,-40
"27641","2929淘帝","110/07/09","元富-大裕",22,1,21
"27642","2929淘帝","110/07/09","台新-左楠",1,39,-38
"27643","2929淘帝","110/07/09","合庫-鳳山",20,0,20
"27644","2929淘帝","110/07/09","凱基-桃園",3,29,-26
"27645","2929淘帝","110/07/09","元大-員林",22,2,20
"27646","2929淘帝","110/07/09","兆豐-內湖",0,25,-25
"27647","2929淘帝","110/07/09","台新-建北",15,0,15
"27648","2929淘帝","110/07/09","元大-北港",0,20,-20
"27649","2929淘帝","110/07/09","兆豐-桃園",13,0,13
"27650","2929淘帝","110/07/09","富邦-北港",0,19,-19
"27651","2929淘帝","110/07/09","兆豐-忠孝",10,0,10
"27652","2929淘帝","110/07/09","富邦-花蓮",0,17,-17
"27653","2929淘帝","110/07/09","國票-敦北法人",10,0,10
"27654","2929淘帝","110/07/09","國泰-台中",2,17,-15
"27655","2929淘帝","110/07/09","永豐金-博愛",10,0,10
"27656","2929淘帝","110/07/09","群益金鼎-彰化",0,15,-15
"27657","2929淘帝","110/07/09","群益金鼎-潭子",8,0,8
"27658","2929淘帝","110/07/09","元大-博愛",0,14,-14
"27659","2929淘帝","110/07/09","富邦-南屯",8,0,8
"27660","2929淘帝","110/07/09","日盛-板橋",0,13,-13
"27661","5410國眾","110/07/09","元大-新盛",14,0,14
"27662","5410國眾","110/07/09","(牛牛牛)亞-鑫豐",1,41,-40
"27663","5410國眾","110/07/09","台灣企銀-民雄",10,0,10
"27664","5410國眾","110/07/09","元富-嘉義",0,25,-25
"27665","5410國眾","110/07/09","元富-虎尾",9,0,9
"27666","5410國眾","110/07/09","凱基-高美館",0,10,-10
"27667","5410國眾","110/07/09","摩根大通",10,1,9
"27668","5410國眾","110/07/09","凱基-城中",0,10,-10
"27669","5410國眾","110/07/09","兆豐-北高雄",7,0,7
"27670","5410國眾","110/07/09","元大-頭份",0,10,-10
"27671","5410國眾","110/07/09","凱基-台北",8,1,7
"27672","5410國眾","110/07/09","群益金鼎-丹鳳",0,7,-7
"27673","5410國眾","110/07/09","華南永昌-公誠",7,0,7
"27674","5410國眾","110/07/09","凱基-復興",0,7,-7
"27675","5410國眾","110/07/09","香港上海匯豐",6,0,6
"27676","5410國眾","110/07/09","元大-員林",0,7,-7
"27677","5410國眾","110/07/09","凱基-中壢",6,0,6
"27678","5410國眾","110/07/09","富邦-竹東",0,6,-6
"27679","5410國眾","110/07/09","華南永昌-南京",6,0,6
"27680","5410國眾","110/07/09","亞東-高雄",0,5,-5
"27681","5410國眾","110/07/09","統一-三重",5,0,5
"27682","5410國眾","110/07/09","大慶-中壢",1,6,-5
"27683","5410國眾","110/07/09","富邦-宜蘭",5,0,5
"27684","5410國眾","110/07/09","群益金鼎-中港",0,5,-5
"27685","5410國眾","110/07/09","元大-崇德",5,0,5
"27686","5410國眾","110/07/09","元大-八德",0,5,-5
"27687","5410國眾","110/07/09","元大-博愛",5,0,5
"27688","5410國眾","110/07/09","富邦-基隆",0,4,-4
"27689","5410國眾","110/07/09","元大-龍潭",5,0,5
"27690","5410國眾","110/07/09","臺銀-新竹",0,3,-3
"27691","2841台開","110/07/09","日盛-雙和",102,0,102
"27692","2841台開","110/07/09","港商野村",0,129,-129
"27693","2841台開","110/07/09","元大-館前",70,0,70
"27694","2841台開","110/07/09","兆豐-永和",0,100,-100
"27695","2841台開","110/07/09","凱基-文心",50,0,50
"27696","2841台開","110/07/09","台新證券",7,28,-21
"27697","2841台開","110/07/09","富邦-嘉義",40,0,40
"27698","2841台開","110/07/09","國票-北高雄",0,20,-20
"27699","2841台開","110/07/09","美商高盛",15,0,15
"27700","2841台開","110/07/09","永豐金-敦南",29,46,-17
"27701","2841台開","110/07/09","台中銀",15,0,15
"27702","2841台開","110/07/09","合庫-基隆",0,12,-12
"27703","2841台開","110/07/09","新光",11,0,11
"27704","2841台開","110/07/09","中國信託-松江",0,12,-12
"27705","2841台開","110/07/09","華南永昌-長虹",10,0,10
"27706","2841台開","110/07/09","兆豐-城中",0,12,-12
"27707","2841台開","110/07/09","永豐金-南投",10,0,10
"27708","2841台開","110/07/09","台中銀-豐原",0,10,-10
"27709","2841台開","110/07/09","合庫-桃園",7,0,7
"27710","2841台開","110/07/09","兆豐-景美",0,10,-10
"27711","2841台開","110/07/09","群益金鼎-古亭",7,0,7
"27712","2841台開","110/07/09","群益金鼎-基隆",0,10,-10
"27713","2841台開","110/07/09","國泰-敦南",6,0,6
"27714","2841台開","110/07/09","元大-北三重",0,10,-10
"27715","2841台開","110/07/09","凱基-桃園",8,2,6
"27716","2841台開","110/07/09","(牛牛牛)亞-網路",0,9,-9
"27717","2841台開","110/07/09","日盛證券",5,0,5
"27718","2841台開","110/07/09","台新-高雄",1,10,-9
"27719","2841台開","110/07/09","元富-文心",5,0,5
"27720","2841台開","110/07/09","凱基-台北",0,7,-7
"27721","6207雷科","110/07/09","群益金鼎-新竹",47,0,47
"27722","6207雷科","110/07/09","新光",7,24,-17
"27723","6207雷科","110/07/09","永豐金-三重",31,0,31
"27724","6207雷科","110/07/09","日盛-和美",0,15,-15
"27725","6207雷科","110/07/09","新加坡商瑞銀",33,5,28
"27726","6207雷科","110/07/09","國泰-台南",0,15,-15
"27727","6207雷科","110/07/09","元大-高雄",26,0,26
"27728","6207雷科","110/07/09","華南永昌-古亭",0,14,-14
"27729","6207雷科","110/07/09","統一-員林",22,0,22
"27730","6207雷科","110/07/09","土銀-白河",0,11,-11
"27731","6207雷科","110/07/09","台新-高雄",22,0,22
"27732","6207雷科","110/07/09","日盛-台南",0,10,-10
"27733","6207雷科","110/07/09","摩根大通",34,17,17
"27734","6207雷科","110/07/09","元富-林園",0,10,-10
"27735","6207雷科","110/07/09","元大-博愛",17,1,16
"27736","6207雷科","110/07/09","富邦-園區",0,10,-10
"27737","6207雷科","110/07/09","日茂-埔里",12,0,12
"27738","6207雷科","110/07/09","元大-上新莊",0,10,-10
"27739","6207雷科","110/07/09","國泰-台中",17,6,11
"27740","6207雷科","110/07/09","永豐金-南京",0,10,-10
"27741","6207雷科","110/07/09","富邦-三重",10,0,10
"27742","6207雷科","110/07/09","兆豐-小港",0,6,-6
"27743","6207雷科","110/07/09","元大-沙鹿",10,0,10
"27744","6207雷科","110/07/09","富邦-羅東",1,7,-6
"27745","6207雷科","110/07/09","元大-八德",10,0,10
"27746","6207雷科","110/07/09","元大-土城永寧",0,6,-6
"27747","6207雷科","110/07/09","第一金-路竹",11,2,9
"27748","6207雷科","110/07/09","永豐金-板盛",0,6,-6
"27749","6207雷科","110/07/09","統一-南京",5,0,5
"27750","6207雷科","110/07/09","日盛-板橋",0,5,-5
"27751","3679新至陞","110/07/09","元大-大天母",10,0,10
"27752","3679新至陞","110/07/09","第一金-光復",0,11,-11
"27753","3679新至陞","110/07/09","日盛-樹林",9,0,9
"27754","3679新至陞","110/07/09","瑞士信貸",0,8,-8
"27755","3679新至陞","110/07/09","凱基-台北",11,2,9
"27756","3679新至陞","110/07/09","大慶-苗栗",0,5,-5
"27757","3679新至陞","110/07/09","華南永昌-小港",8,0,8
"27758","3679新至陞","110/07/09","元大-永春",0,5,-5
"27759","3679新至陞","110/07/09","兆豐-來福",7,0,7
"27760","3679新至陞","110/07/09","日盛-和美",0,4,-4
"27761","3679新至陞","110/07/09","香港上海匯豐",5,0,5
"27762","3679新至陞","110/07/09","元大-雙和",0,3,-3
"27763","3679新至陞","110/07/09","台中銀-員林",3,0,3
"27764","3679新至陞","110/07/09","永豐金-屏東",0,3,-3
"27765","3679新至陞","110/07/09","新光",3,0,3
"27766","3679新至陞","110/07/09","彰銀",0,2,-2
"27767","3679新至陞","110/07/09","土銀-花蓮",2,0,2
"27768","3679新至陞","110/07/09","宏遠-館前",0,2,-2
"27769","3679新至陞","110/07/09","第一金-澎湖",2,0,2
"27770","3679新至陞","110/07/09","港商野村",0,2,-2
"27771","3679新至陞","110/07/09","摩根大通",2,0,2
"27772","3679新至陞","110/07/09","大昌-新店",0,2,-2
"27773","3679新至陞","110/07/09","國泰-敦南",2,0,2
"27774","3679新至陞","110/07/09","元大-新莊",0,2,-2
"27775","3679新至陞","110/07/09","元大-淡水",4,2,2
"27776","3679新至陞","110/07/09","元大-板橋",0,2,-2
"27777","3679新至陞","110/07/09","日盛-士林",1,0,1
"27778","3679新至陞","110/07/09","台灣摩根士丹利",0,1,-1
"27779","3679新至陞","110/07/09","日盛-信義",1,0,1
"27780","3679新至陞","110/07/09","第一金-高雄",0,1,-1
"27781","2727王品","110/07/09","台灣匯立證券",90,0,90
"27782","2727王品","110/07/09","台灣摩根士丹利",0,267,-267
"27783","2727王品","110/07/09","國泰-敦南",166,84,82
"27784","2727王品","110/07/09","富邦-台北",35,299,-264
"27785","2727王品","110/07/09","富邦-仁愛",56,12,44
"27786","2727王品","110/07/09","凱基-台北",174,296,-122
"27787","2727王品","110/07/09","台新證券",109,66,43
"27788","2727王品","110/07/09","第一金",2,102,-100
"27789","2727王品","110/07/09","新光",117,87,30
"27790","2727王品","110/07/09","群益金鼎-大安",0,80,-80
"27791","2727王品","110/07/09","臺銀-臺中",35,6,29
"27792","2727王品","110/07/09","兆豐-大安",7,60,-53
"27793","2727王品","110/07/09","元大-桃園",32,3,29
"27794","2727王品","110/07/09","永豐金-南投",0,50,-50
"27795","2727王品","110/07/09","元富-宜蘭",34,6,28
"27796","2727王品","110/07/09","新加坡商瑞銀",6,46,-40
"27797","2727王品","110/07/09","玉山-台中",34,8,26
"27798","2727王品","110/07/09","合庫-彰化",11,50,-39
"27799","2727王品","110/07/09","群益金鼎-宜蘭",30,4,26
"27800","2727王品","110/07/09","永豐金-萬盛",13,52,-39
"27801","2727王品","110/07/09","富邦-台中",42,16,26
"27802","2727王品","110/07/09","瑞士信貸",0,34,-34
"27803","2727王品","110/07/09","第一金-豐原",25,1,24
"27804","2727王品","110/07/09","元大-和平",4,35,-31
"27805","2727王品","110/07/09","臺銀",30,8,22
"27806","2727王品","110/07/09","美林",14,44,-30
"27807","2727王品","110/07/09","兆豐-來福",23,1,22
"27808","2727王品","110/07/09","元大-員林",9,38,-29
"27809","2727王品","110/07/09","玉山-士林",22,2,20
"27810","2727王品","110/07/09","元富-西松",4,31,-27
"27811","1570力肯","110/07/09","凱基-台北",30,1,29
"27812","1570力肯","110/07/09","群益金鼎-彰化",0,20,-20
"27813","1570力肯","110/07/09","新光-台南",20,0,20
"27814","1570力肯","110/07/09","元大-土城學府",0,20,-20
"27815","1570力肯","110/07/09","元大-高雄",20,0,20
"27816","1570力肯","110/07/09","元大-大統",0,16,-16
"27817","1570力肯","110/07/09","國票-中正",12,0,12
"27818","1570力肯","110/07/09","元大-新營",0,11,-11
"27819","1570力肯","110/07/09","日盛-高雄",6,0,6
"27820","1570力肯","110/07/09","元大-和平",0,10,-10
"27821","1570力肯","110/07/09","元富-緯城",6,0,6
"27822","1570力肯","110/07/09","元大-草屯",0,10,-10
"27823","1570力肯","110/07/09","群益金鼎-台南",6,0,6
"27824","1570力肯","110/07/09","元大-鹿港",0,9,-9
"27825","1570力肯","110/07/09","華南永昌-岡山",6,0,6
"27826","1570力肯","110/07/09","合庫-基隆",0,7,-7
"27827","1570力肯","110/07/09","統一-中壢",5,0,5
"27828","1570力肯","110/07/09","摩根大通",2,8,-6
"27829","1570力肯","110/07/09","凱基-三峽",5,0,5
"27830","1570力肯","110/07/09","台灣企銀-豐原",0,4,-4
"27831","1570力肯","110/07/09","大昌-樹林",4,0,4
"27832","1570力肯","110/07/09","日盛-桃園",0,4,-4
"27833","1570力肯","110/07/09","新光",3,0,3
"27834","1570力肯","110/07/09","國泰-高雄",0,3,-3
"27835","1570力肯","110/07/09","富邦-新竹華信",3,0,3
"27836","1570力肯","110/07/09","永豐金-敦南",0,3,-3
"27837","1570力肯","110/07/09","合庫-台中",2,0,2
"27838","1570力肯","110/07/09","土銀-彰化",0,2,-2
"27839","1570力肯","110/07/09","臺銀-臺中",2,0,2
"27840","1570力肯","110/07/09","臺銀-鳳山",0,2,-2
"27841","6180橘子","110/07/09","摩根大通",63,1,62
"27842","6180橘子","110/07/09","元大-南京",1,32,-31
"27843","6180橘子","110/07/09","富邦-陽明",73,33,40
"27844","6180橘子","110/07/09","群益金鼎-台北",0,25,-25
"27845","6180橘子","110/07/09","新加坡商瑞銀",31,0,31
"27846","6180橘子","110/07/09","兆豐-復興",0,21,-21
"27847","6180橘子","110/07/09","美商高盛",25,0,25
"27848","6180橘子","110/07/09","永豐金-嘉義",0,21,-21
"27849","6180橘子","110/07/09","凱基-台北",26,10,16
"27850","6180橘子","110/07/09","凱基-中壢",8,24,-16
"27851","6180橘子","110/07/09","華南永昌-楠梓",13,0,13
"27852","6180橘子","110/07/09","致和-崇德",0,15,-15
"27853","6180橘子","110/07/09","華南永昌-朴子",11,0,11
"27854","6180橘子","110/07/09","群益金鼎-屏東",0,15,-15
"27855","6180橘子","110/07/09","元大-北港",11,0,11
"27856","6180橘子","110/07/09","群益金鼎-中山",0,15,-15
"27857","6180橘子","110/07/09","元大-成功",10,1,9
"27858","6180橘子","110/07/09","瑞士信貸",1,15,-14
"27859","6180橘子","110/07/09","新光",26,18,8
"27860","6180橘子","110/07/09","日盛-二林",0,10,-10
"27861","6180橘子","110/07/09","統一-三重",6,0,6
"27862","6180橘子","110/07/09","凱基-東門",0,10,-10
"27863","6180橘子","110/07/09","群益金鼎-嘉義",6,0,6
"27864","6180橘子","110/07/09","華南永昌-三重",0,10,-10
"27865","6180橘子","110/07/09","元大-員林中山",6,0,6
"27866","6180橘子","110/07/09","元大-彰化民生",1,11,-10
"27867","6180橘子","110/07/09","合庫-鳳山",5,0,5
"27868","6180橘子","110/07/09","永豐金-新店",1,11,-10
"27869","6180橘子","110/07/09","富邦-建國",6,1,5
"27870","6180橘子","110/07/09","群益金鼎-丹鳳",0,8,-8
"27871","2390云辰","110/07/09","摩根大通",279,56,223
"27872","2390云辰","110/07/09","元大-天母",0,127,-127
"27873","2390云辰","110/07/09","日盛-鳳山",110,2,108
"27874","2390云辰","110/07/09","中國信託-文心",5,109,-104
"27875","2390云辰","110/07/09","宏遠證券",100,0,100
"27876","2390云辰","110/07/09","永豐金-復興",0,55,-55
"27877","2390云辰","110/07/09","元大-大里",63,6,57
"27878","2390云辰","110/07/09","凱基-台北",239,286,-47
"27879","2390云辰","110/07/09","凱基-八德",59,10,49
"27880","2390云辰","110/07/09","德信",2,32,-30
"27881","2390云辰","110/07/09","合庫-新竹",40,0,40
"27882","2390云辰","110/07/09","兆豐-桃鶯",2,32,-30
"27883","2390云辰","110/07/09","國票",40,1,39
"27884","2390云辰","110/07/09","致和-南京",0,30,-30
"27885","2390云辰","110/07/09","新加坡商瑞銀",49,13,36
"27886","2390云辰","110/07/09","富邦-虎尾",1,31,-30
"27887","2390云辰","110/07/09","統一-新台中",36,2,34
"27888","2390云辰","110/07/09","元大-善化",2,31,-29
"27889","2390云辰","110/07/09","國票-嘉義",31,0,31
"27890","2390云辰","110/07/09","富邦-板橋",0,27,-27
"27891","2390云辰","110/07/09","華南永昌",35,7,28
"27892","2390云辰","110/07/09","富邦-永和",3,28,-25
"27893","2390云辰","110/07/09","玉山-台中",49,22,27
"27894","2390云辰","110/07/09","第一金-自由",20,44,-24
"27895","2390云辰","110/07/09","華南永昌-敦南",25,0,25
"27896","2390云辰","110/07/09","凱基-內湖",0,24,-24
"27897","2390云辰","110/07/09","新光-高雄",27,4,23
"27898","2390云辰","110/07/09","元大-汐止",1,24,-23
"27899","2390云辰","110/07/09","台灣摩根士丹利",85,63,22
"27900","2390云辰","110/07/09","新光-台中",12,33,-21
"27901","4903聯光通","110/07/09","元大-敦南",10,0,10
"27902","4903聯光通","110/07/09","第一金-台中",0,12,-12
"27903","4903聯光通","110/07/09","凱基-士林",5,0,5
"27904","4903聯光通","110/07/09","日盛-忠孝",0,3,-3
"27905","4903聯光通","110/07/09","元大-苗栗",5,0,5
"27906","4903聯光通","110/07/09","群益金鼎-崇德",0,3,-3
"27907","4903聯光通","110/07/09","元大-屏南",3,0,3
"27908","4903聯光通","110/07/09","國票-內壢",0,2,-2
"27909","4903聯光通","110/07/09","中國信託-永康",1,0,1
"27910","4903聯光通","110/07/09","康和-南崁",0,2,-2
"27911","4903聯光通","110/07/09","玉山證券",1,0,1
"27912","4903聯光通","110/07/09","新光-台中",0,2,-2
"27913","4903聯光通","110/07/09","元大-太平",4,3,1
"27914","4903聯光通","110/07/09","玉山-城中",0,2,-2
"27915","4903聯光通","110/07/09","永豐金-嘉義",1,0,1
"27916","4903聯光通","110/07/09","中國信託-文心",0,1,-1
"27917","4903聯光通","110/07/09","大昌",0,0,0
"27918","4903聯光通","110/07/09","大昌",0,0,0
"27919","4903聯光通","110/07/09","中農",0,0,0
"27920","4903聯光通","110/07/09","中農",0,0,0
"27921","4903聯光通","110/07/09","",NA,NA,NA
"27922","4903聯光通","110/07/09","",NA,NA,NA
"27923","4903聯光通","110/07/09","",NA,NA,NA
"27924","4903聯光通","110/07/09","",NA,NA,NA
"27925","4903聯光通","110/07/09","",NA,NA,NA
"27926","4903聯光通","110/07/09","",NA,NA,NA
"27927","4903聯光通","110/07/09","",NA,NA,NA
"27928","4903聯光通","110/07/09","",NA,NA,NA
"27929","4903聯光通","110/07/09","",NA,NA,NA
"27930","4903聯光通","110/07/09","",NA,NA,NA
"27931","2929淘帝","110/07/09","台中銀-台北",110,0,110
"27932","2929淘帝","110/07/09","新光",2,82,-80
"27933","2929淘帝","110/07/09","華南永昌-頭份",72,0,72
"27934","2929淘帝","110/07/09","摩根大通",2,63,-61
"27935","2929淘帝","110/07/09","合庫-高雄",71,0,71
"27936","2929淘帝","110/07/09","第一金-路竹",0,50,-50
"27937","2929淘帝","110/07/09","高橋-龍潭",37,0,37
"27938","2929淘帝","110/07/09","港商麥格理",0,42,-42
"27939","2929淘帝","110/07/09","新光-台中",60,26,34
"27940","2929淘帝","110/07/09","陽信-石牌",0,40,-40
"27941","2929淘帝","110/07/09","元富-大裕",22,1,21
"27942","2929淘帝","110/07/09","台新-左楠",1,39,-38
"27943","2929淘帝","110/07/09","合庫-鳳山",20,0,20
"27944","2929淘帝","110/07/09","凱基-桃園",3,29,-26
"27945","2929淘帝","110/07/09","元大-員林",22,2,20
"27946","2929淘帝","110/07/09","兆豐-內湖",0,25,-25
"27947","2929淘帝","110/07/09","台新-建北",15,0,15
"27948","2929淘帝","110/07/09","元大-北港",0,20,-20
"27949","2929淘帝","110/07/09","兆豐-桃園",13,0,13
"27950","2929淘帝","110/07/09","富邦-北港",0,19,-19
"27951","2929淘帝","110/07/09","兆豐-忠孝",10,0,10
"27952","2929淘帝","110/07/09","富邦-花蓮",0,17,-17
"27953","2929淘帝","110/07/09","國票-敦北法人",10,0,10
"27954","2929淘帝","110/07/09","國泰-台中",2,17,-15
"27955","2929淘帝","110/07/09","永豐金-博愛",10,0,10
"27956","2929淘帝","110/07/09","群益金鼎-彰化",0,15,-15
"27957","2929淘帝","110/07/09","群益金鼎-潭子",8,0,8
"27958","2929淘帝","110/07/09","元大-博愛",0,14,-14
"27959","2929淘帝","110/07/09","富邦-南屯",8,0,8
"27960","2929淘帝","110/07/09","日盛-板橋",0,13,-13
"27961","5410國眾","110/07/09","元大-新盛",14,0,14
"27962","5410國眾","110/07/09","(牛牛牛)亞-鑫豐",1,41,-40
"27963","5410國眾","110/07/09","台灣企銀-民雄",10,0,10
"27964","5410國眾","110/07/09","元富-嘉義",0,25,-25
"27965","5410國眾","110/07/09","元富-虎尾",9,0,9
"27966","5410國眾","110/07/09","凱基-高美館",0,10,-10
"27967","5410國眾","110/07/09","摩根大通",10,1,9
"27968","5410國眾","110/07/09","凱基-城中",0,10,-10
"27969","5410國眾","110/07/09","兆豐-北高雄",7,0,7
"27970","5410國眾","110/07/09","元大-頭份",0,10,-10
"27971","5410國眾","110/07/09","凱基-台北",8,1,7
"27972","5410國眾","110/07/09","群益金鼎-丹鳳",0,7,-7
"27973","5410國眾","110/07/09","華南永昌-公誠",7,0,7
"27974","5410國眾","110/07/09","凱基-復興",0,7,-7
"27975","5410國眾","110/07/09","香港上海匯豐",6,0,6
"27976","5410國眾","110/07/09","元大-員林",0,7,-7
"27977","5410國眾","110/07/09","凱基-中壢",6,0,6
"27978","5410國眾","110/07/09","富邦-竹東",0,6,-6
"27979","5410國眾","110/07/09","華南永昌-南京",6,0,6
"27980","5410國眾","110/07/09","亞東-高雄",0,5,-5
"27981","5410國眾","110/07/09","統一-三重",5,0,5
"27982","5410國眾","110/07/09","大慶-中壢",1,6,-5
"27983","5410國眾","110/07/09","富邦-宜蘭",5,0,5
"27984","5410國眾","110/07/09","群益金鼎-中港",0,5,-5
"27985","5410國眾","110/07/09","元大-崇德",5,0,5
"27986","5410國眾","110/07/09","元大-八德",0,5,-5
"27987","5410國眾","110/07/09","元大-博愛",5,0,5
"27988","5410國眾","110/07/09","富邦-基隆",0,4,-4
"27989","5410國眾","110/07/09","元大-龍潭",5,0,5
"27990","5410國眾","110/07/09","臺銀-新竹",0,3,-3
"27991","2841台開","110/07/09","日盛-雙和",102,0,102
"27992","2841台開","110/07/09","港商野村",0,129,-129
"27993","2841台開","110/07/09","元大-館前",70,0,70
"27994","2841台開","110/07/09","兆豐-永和",0,100,-100
"27995","2841台開","110/07/09","凱基-文心",50,0,50
"27996","2841台開","110/07/09","台新證券",7,28,-21
"27997","2841台開","110/07/09","富邦-嘉義",40,0,40
"27998","2841台開","110/07/09","國票-北高雄",0,20,-20
"27999","2841台開","110/07/09","美商高盛",15,0,15
"28000","2841台開","110/07/09","永豐金-敦南",29,46,-17
"28001","2841台開","110/07/09","台中銀",15,0,15
"28002","2841台開","110/07/09","合庫-基隆",0,12,-12
"28003","2841台開","110/07/09","新光",11,0,11
"28004","2841台開","110/07/09","中國信託-松江",0,12,-12
"28005","2841台開","110/07/09","華南永昌-長虹",10,0,10
"28006","2841台開","110/07/09","兆豐-城中",0,12,-12
"28007","2841台開","110/07/09","永豐金-南投",10,0,10
"28008","2841台開","110/07/09","台中銀-豐原",0,10,-10
"28009","2841台開","110/07/09","合庫-桃園",7,0,7
"28010","2841台開","110/07/09","兆豐-景美",0,10,-10
"28011","2841台開","110/07/09","群益金鼎-古亭",7,0,7
"28012","2841台開","110/07/09","群益金鼎-基隆",0,10,-10
"28013","2841台開","110/07/09","國泰-敦南",6,0,6
"28014","2841台開","110/07/09","元大-北三重",0,10,-10
"28015","2841台開","110/07/09","凱基-桃園",8,2,6
"28016","2841台開","110/07/09","(牛牛牛)亞-網路",0,9,-9
"28017","2841台開","110/07/09","日盛證券",5,0,5
"28018","2841台開","110/07/09","台新-高雄",1,10,-9
"28019","2841台開","110/07/09","元富-文心",5,0,5
"28020","2841台開","110/07/09","凱基-台北",0,7,-7
"28021","6207雷科","110/07/09","群益金鼎-新竹",47,0,47
"28022","6207雷科","110/07/09","新光",7,24,-17
"28023","6207雷科","110/07/09","永豐金-三重",31,0,31
"28024","6207雷科","110/07/09","日盛-和美",0,15,-15
"28025","6207雷科","110/07/09","新加坡商瑞銀",33,5,28
"28026","6207雷科","110/07/09","國泰-台南",0,15,-15
"28027","6207雷科","110/07/09","元大-高雄",26,0,26
"28028","6207雷科","110/07/09","華南永昌-古亭",0,14,-14
"28029","6207雷科","110/07/09","統一-員林",22,0,22
"28030","6207雷科","110/07/09","土銀-白河",0,11,-11
"28031","6207雷科","110/07/09","台新-高雄",22,0,22
"28032","6207雷科","110/07/09","日盛-台南",0,10,-10
"28033","6207雷科","110/07/09","摩根大通",34,17,17
"28034","6207雷科","110/07/09","元富-林園",0,10,-10
"28035","6207雷科","110/07/09","元大-博愛",17,1,16
"28036","6207雷科","110/07/09","富邦-園區",0,10,-10
"28037","6207雷科","110/07/09","日茂-埔里",12,0,12
"28038","6207雷科","110/07/09","元大-上新莊",0,10,-10
"28039","6207雷科","110/07/09","國泰-台中",17,6,11
"28040","6207雷科","110/07/09","永豐金-南京",0,10,-10
"28041","6207雷科","110/07/09","富邦-三重",10,0,10
"28042","6207雷科","110/07/09","兆豐-小港",0,6,-6
"28043","6207雷科","110/07/09","元大-沙鹿",10,0,10
"28044","6207雷科","110/07/09","富邦-羅東",1,7,-6
"28045","6207雷科","110/07/09","元大-八德",10,0,10
"28046","6207雷科","110/07/09","元大-土城永寧",0,6,-6
"28047","6207雷科","110/07/09","第一金-路竹",11,2,9
"28048","6207雷科","110/07/09","永豐金-板盛",0,6,-6
"28049","6207雷科","110/07/09","統一-南京",5,0,5
"28050","6207雷科","110/07/09","日盛-板橋",0,5,-5
"28051","3679新至陞","110/07/09","元大-大天母",10,0,10
"28052","3679新至陞","110/07/09","第一金-光復",0,11,-11
"28053","3679新至陞","110/07/09","日盛-樹林",9,0,9
"28054","3679新至陞","110/07/09","瑞士信貸",0,8,-8
"28055","3679新至陞","110/07/09","凱基-台北",11,2,9
"28056","3679新至陞","110/07/09","大慶-苗栗",0,5,-5
"28057","3679新至陞","110/07/09","華南永昌-小港",8,0,8
"28058","3679新至陞","110/07/09","元大-永春",0,5,-5
"28059","3679新至陞","110/07/09","兆豐-來福",7,0,7
"28060","3679新至陞","110/07/09","日盛-和美",0,4,-4
"28061","3679新至陞","110/07/09","香港上海匯豐",5,0,5
"28062","3679新至陞","110/07/09","元大-雙和",0,3,-3
"28063","3679新至陞","110/07/09","台中銀-員林",3,0,3
"28064","3679新至陞","110/07/09","永豐金-屏東",0,3,-3
"28065","3679新至陞","110/07/09","新光",3,0,3
"28066","3679新至陞","110/07/09","彰銀",0,2,-2
"28067","3679新至陞","110/07/09","土銀-花蓮",2,0,2
"28068","3679新至陞","110/07/09","宏遠-館前",0,2,-2
"28069","3679新至陞","110/07/09","第一金-澎湖",2,0,2
"28070","3679新至陞","110/07/09","港商野村",0,2,-2
"28071","3679新至陞","110/07/09","摩根大通",2,0,2
"28072","3679新至陞","110/07/09","大昌-新店",0,2,-2
"28073","3679新至陞","110/07/09","國泰-敦南",2,0,2
"28074","3679新至陞","110/07/09","元大-新莊",0,2,-2
"28075","3679新至陞","110/07/09","元大-淡水",4,2,2
"28076","3679新至陞","110/07/09","元大-板橋",0,2,-2
"28077","3679新至陞","110/07/09","日盛-士林",1,0,1
"28078","3679新至陞","110/07/09","台灣摩根士丹利",0,1,-1
"28079","3679新至陞","110/07/09","日盛-信義",1,0,1
"28080","3679新至陞","110/07/09","第一金-高雄",0,1,-1
"28081","2727王品","110/07/09","台灣匯立證券",90,0,90
"28082","2727王品","110/07/09","台灣摩根士丹利",0,267,-267
"28083","2727王品","110/07/09","國泰-敦南",166,84,82
"28084","2727王品","110/07/09","富邦-台北",35,299,-264
"28085","2727王品","110/07/09","富邦-仁愛",56,12,44
"28086","2727王品","110/07/09","凱基-台北",174,296,-122
"28087","2727王品","110/07/09","台新證券",109,66,43
"28088","2727王品","110/07/09","第一金",2,102,-100
"28089","2727王品","110/07/09","新光",117,87,30
"28090","2727王品","110/07/09","群益金鼎-大安",0,80,-80
"28091","2727王品","110/07/09","臺銀-臺中",35,6,29
"28092","2727王品","110/07/09","兆豐-大安",7,60,-53
"28093","2727王品","110/07/09","元大-桃園",32,3,29
"28094","2727王品","110/07/09","永豐金-南投",0,50,-50
"28095","2727王品","110/07/09","元富-宜蘭",34,6,28
"28096","2727王品","110/07/09","新加坡商瑞銀",6,46,-40
"28097","2727王品","110/07/09","玉山-台中",34,8,26
"28098","2727王品","110/07/09","合庫-彰化",11,50,-39
"28099","2727王品","110/07/09","群益金鼎-宜蘭",30,4,26
"28100","2727王品","110/07/09","永豐金-萬盛",13,52,-39
"28101","2727王品","110/07/09","富邦-台中",42,16,26
"28102","2727王品","110/07/09","瑞士信貸",0,34,-34
"28103","2727王品","110/07/09","第一金-豐原",25,1,24
"28104","2727王品","110/07/09","元大-和平",4,35,-31
"28105","2727王品","110/07/09","臺銀",30,8,22
"28106","2727王品","110/07/09","美林",14,44,-30
"28107","2727王品","110/07/09","兆豐-來福",23,1,22
"28108","2727王品","110/07/09","元大-員林",9,38,-29
"28109","2727王品","110/07/09","玉山-士林",22,2,20
"28110","2727王品","110/07/09","元富-西松",4,31,-27
"28111","1570力肯","110/07/09","凱基-台北",30,1,29
"28112","1570力肯","110/07/09","群益金鼎-彰化",0,20,-20
"28113","1570力肯","110/07/09","新光-台南",20,0,20
"28114","1570力肯","110/07/09","元大-土城學府",0,20,-20
"28115","1570力肯","110/07/09","元大-高雄",20,0,20
"28116","1570力肯","110/07/09","元大-大統",0,16,-16
"28117","1570力肯","110/07/09","國票-中正",12,0,12
"28118","1570力肯","110/07/09","元大-新營",0,11,-11
"28119","1570力肯","110/07/09","日盛-高雄",6,0,6
"28120","1570力肯","110/07/09","元大-和平",0,10,-10
"28121","1570力肯","110/07/09","元富-緯城",6,0,6
"28122","1570力肯","110/07/09","元大-草屯",0,10,-10
"28123","1570力肯","110/07/09","群益金鼎-台南",6,0,6
"28124","1570力肯","110/07/09","元大-鹿港",0,9,-9
"28125","1570力肯","110/07/09","華南永昌-岡山",6,0,6
"28126","1570力肯","110/07/09","合庫-基隆",0,7,-7
"28127","1570力肯","110/07/09","統一-中壢",5,0,5
"28128","1570力肯","110/07/09","摩根大通",2,8,-6
"28129","1570力肯","110/07/09","凱基-三峽",5,0,5
"28130","1570力肯","110/07/09","台灣企銀-豐原",0,4,-4
"28131","1570力肯","110/07/09","大昌-樹林",4,0,4
"28132","1570力肯","110/07/09","日盛-桃園",0,4,-4
"28133","1570力肯","110/07/09","新光",3,0,3
"28134","1570力肯","110/07/09","國泰-高雄",0,3,-3
"28135","1570力肯","110/07/09","富邦-新竹華信",3,0,3
"28136","1570力肯","110/07/09","永豐金-敦南",0,3,-3
"28137","1570力肯","110/07/09","合庫-台中",2,0,2
"28138","1570力肯","110/07/09","土銀-彰化",0,2,-2
"28139","1570力肯","110/07/09","臺銀-臺中",2,0,2
"28140","1570力肯","110/07/09","臺銀-鳳山",0,2,-2
"28141","6180橘子","110/07/09","摩根大通",63,1,62
"28142","6180橘子","110/07/09","元大-南京",1,32,-31
"28143","6180橘子","110/07/09","富邦-陽明",73,33,40
"28144","6180橘子","110/07/09","群益金鼎-台北",0,25,-25
"28145","6180橘子","110/07/09","新加坡商瑞銀",31,0,31
"28146","6180橘子","110/07/09","兆豐-復興",0,21,-21
"28147","6180橘子","110/07/09","美商高盛",25,0,25
"28148","6180橘子","110/07/09","永豐金-嘉義",0,21,-21
"28149","6180橘子","110/07/09","凱基-台北",26,10,16
"28150","6180橘子","110/07/09","凱基-中壢",8,24,-16
"28151","6180橘子","110/07/09","華南永昌-楠梓",13,0,13
"28152","6180橘子","110/07/09","致和-崇德",0,15,-15
"28153","6180橘子","110/07/09","華南永昌-朴子",11,0,11
"28154","6180橘子","110/07/09","群益金鼎-屏東",0,15,-15
"28155","6180橘子","110/07/09","元大-北港",11,0,11
"28156","6180橘子","110/07/09","群益金鼎-中山",0,15,-15
"28157","6180橘子","110/07/09","元大-成功",10,1,9
"28158","6180橘子","110/07/09","瑞士信貸",1,15,-14
"28159","6180橘子","110/07/09","新光",26,18,8
"28160","6180橘子","110/07/09","日盛-二林",0,10,-10
"28161","6180橘子","110/07/09","統一-三重",6,0,6
"28162","6180橘子","110/07/09","凱基-東門",0,10,-10
"28163","6180橘子","110/07/09","群益金鼎-嘉義",6,0,6
"28164","6180橘子","110/07/09","華南永昌-三重",0,10,-10
"28165","6180橘子","110/07/09","元大-員林中山",6,0,6
"28166","6180橘子","110/07/09","元大-彰化民生",1,11,-10
"28167","6180橘子","110/07/09","合庫-鳳山",5,0,5
"28168","6180橘子","110/07/09","永豐金-新店",1,11,-10
"28169","6180橘子","110/07/09","富邦-建國",6,1,5
"28170","6180橘子","110/07/09","群益金鼎-丹鳳",0,8,-8
"28171","2390云辰","110/07/09","摩根大通",279,56,223
"28172","2390云辰","110/07/09","元大-天母",0,127,-127
"28173","2390云辰","110/07/09","日盛-鳳山",110,2,108
"28174","2390云辰","110/07/09","中國信託-文心",5,109,-104
"28175","2390云辰","110/07/09","宏遠證券",100,0,100
"28176","2390云辰","110/07/09","永豐金-復興",0,55,-55
"28177","2390云辰","110/07/09","元大-大里",63,6,57
"28178","2390云辰","110/07/09","凱基-台北",239,286,-47
"28179","2390云辰","110/07/09","凱基-八德",59,10,49
"28180","2390云辰","110/07/09","德信",2,32,-30
"28181","2390云辰","110/07/09","合庫-新竹",40,0,40
"28182","2390云辰","110/07/09","兆豐-桃鶯",2,32,-30
"28183","2390云辰","110/07/09","國票",40,1,39
"28184","2390云辰","110/07/09","致和-南京",0,30,-30
"28185","2390云辰","110/07/09","新加坡商瑞銀",49,13,36
"28186","2390云辰","110/07/09","富邦-虎尾",1,31,-30
"28187","2390云辰","110/07/09","統一-新台中",36,2,34
"28188","2390云辰","110/07/09","元大-善化",2,31,-29
"28189","2390云辰","110/07/09","國票-嘉義",31,0,31
"28190","2390云辰","110/07/09","富邦-板橋",0,27,-27
"28191","2390云辰","110/07/09","華南永昌",35,7,28
"28192","2390云辰","110/07/09","富邦-永和",3,28,-25
"28193","2390云辰","110/07/09","玉山-台中",49,22,27
"28194","2390云辰","110/07/09","第一金-自由",20,44,-24
"28195","2390云辰","110/07/09","華南永昌-敦南",25,0,25
"28196","2390云辰","110/07/09","凱基-內湖",0,24,-24
"28197","2390云辰","110/07/09","新光-高雄",27,4,23
"28198","2390云辰","110/07/09","元大-汐止",1,24,-23
"28199","2390云辰","110/07/09","台灣摩根士丹利",85,63,22
"28200","2390云辰","110/07/09","新光-台中",12,33,-21
"28201","4903聯光通","110/07/09","元大-敦南",10,0,10
"28202","4903聯光通","110/07/09","第一金-台中",0,12,-12
"28203","4903聯光通","110/07/09","凱基-士林",5,0,5
"28204","4903聯光通","110/07/09","日盛-忠孝",0,3,-3
"28205","4903聯光通","110/07/09","元大-苗栗",5,0,5
"28206","4903聯光通","110/07/09","群益金鼎-崇德",0,3,-3
"28207","4903聯光通","110/07/09","元大-屏南",3,0,3
"28208","4903聯光通","110/07/09","國票-內壢",0,2,-2
"28209","4903聯光通","110/07/09","中國信託-永康",1,0,1
"28210","4903聯光通","110/07/09","康和-南崁",0,2,-2
"28211","4903聯光通","110/07/09","玉山證券",1,0,1
"28212","4903聯光通","110/07/09","新光-台中",0,2,-2
"28213","4903聯光通","110/07/09","元大-太平",4,3,1
"28214","4903聯光通","110/07/09","玉山-城中",0,2,-2
"28215","4903聯光通","110/07/09","永豐金-嘉義",1,0,1
"28216","4903聯光通","110/07/09","中國信託-文心",0,1,-1
"28217","4903聯光通","110/07/09","大昌",0,0,0
"28218","4903聯光通","110/07/09","大昌",0,0,0
"28219","4903聯光通","110/07/09","中農",0,0,0
"28220","4903聯光通","110/07/09","中農",0,0,0
"28221","4903聯光通","110/07/09","",NA,NA,NA
"28222","4903聯光通","110/07/09","",NA,NA,NA
"28223","4903聯光通","110/07/09","",NA,NA,NA
"28224","4903聯光通","110/07/09","",NA,NA,NA
"28225","4903聯光通","110/07/09","",NA,NA,NA
"28226","4903聯光通","110/07/09","",NA,NA,NA
"28227","4903聯光通","110/07/09","",NA,NA,NA
"28228","4903聯光通","110/07/09","",NA,NA,NA
"28229","4903聯光通","110/07/09","",NA,NA,NA
"28230","4903聯光通","110/07/09","",NA,NA,NA
"28231","2929淘帝","110/07/09","台中銀-台北",110,0,110
"28232","2929淘帝","110/07/09","新光",2,82,-80
"28233","2929淘帝","110/07/09","華南永昌-頭份",72,0,72
"28234","2929淘帝","110/07/09","摩根大通",2,63,-61
"28235","2929淘帝","110/07/09","合庫-高雄",71,0,71
"28236","2929淘帝","110/07/09","第一金-路竹",0,50,-50
"28237","2929淘帝","110/07/09","高橋-龍潭",37,0,37
"28238","2929淘帝","110/07/09","港商麥格理",0,42,-42
"28239","2929淘帝","110/07/09","新光-台中",60,26,34
"28240","2929淘帝","110/07/09","陽信-石牌",0,40,-40
"28241","2929淘帝","110/07/09","元富-大裕",22,1,21
"28242","2929淘帝","110/07/09","台新-左楠",1,39,-38
"28243","2929淘帝","110/07/09","合庫-鳳山",20,0,20
"28244","2929淘帝","110/07/09","凱基-桃園",3,29,-26
"28245","2929淘帝","110/07/09","元大-員林",22,2,20
"28246","2929淘帝","110/07/09","兆豐-內湖",0,25,-25
"28247","2929淘帝","110/07/09","台新-建北",15,0,15
"28248","2929淘帝","110/07/09","元大-北港",0,20,-20
"28249","2929淘帝","110/07/09","兆豐-桃園",13,0,13
"28250","2929淘帝","110/07/09","富邦-北港",0,19,-19
"28251","2929淘帝","110/07/09","兆豐-忠孝",10,0,10
"28252","2929淘帝","110/07/09","富邦-花蓮",0,17,-17
"28253","2929淘帝","110/07/09","國票-敦北法人",10,0,10
"28254","2929淘帝","110/07/09","國泰-台中",2,17,-15
"28255","2929淘帝","110/07/09","永豐金-博愛",10,0,10
"28256","2929淘帝","110/07/09","群益金鼎-彰化",0,15,-15
"28257","2929淘帝","110/07/09","群益金鼎-潭子",8,0,8
"28258","2929淘帝","110/07/09","元大-博愛",0,14,-14
"28259","2929淘帝","110/07/09","富邦-南屯",8,0,8
"28260","2929淘帝","110/07/09","日盛-板橋",0,13,-13
"28261","5410國眾","110/07/09","元大-新盛",14,0,14
"28262","5410國眾","110/07/09","(牛牛牛)亞-鑫豐",1,41,-40
"28263","5410國眾","110/07/09","台灣企銀-民雄",10,0,10
"28264","5410國眾","110/07/09","元富-嘉義",0,25,-25
"28265","5410國眾","110/07/09","元富-虎尾",9,0,9
"28266","5410國眾","110/07/09","凱基-高美館",0,10,-10
"28267","5410國眾","110/07/09","摩根大通",10,1,9
"28268","5410國眾","110/07/09","凱基-城中",0,10,-10
"28269","5410國眾","110/07/09","兆豐-北高雄",7,0,7
"28270","5410國眾","110/07/09","元大-頭份",0,10,-10
"28271","5410國眾","110/07/09","凱基-台北",8,1,7
"28272","5410國眾","110/07/09","群益金鼎-丹鳳",0,7,-7
"28273","5410國眾","110/07/09","華南永昌-公誠",7,0,7
"28274","5410國眾","110/07/09","凱基-復興",0,7,-7
"28275","5410國眾","110/07/09","香港上海匯豐",6,0,6
"28276","5410國眾","110/07/09","元大-員林",0,7,-7
"28277","5410國眾","110/07/09","凱基-中壢",6,0,6
"28278","5410國眾","110/07/09","富邦-竹東",0,6,-6
"28279","5410國眾","110/07/09","華南永昌-南京",6,0,6
"28280","5410國眾","110/07/09","亞東-高雄",0,5,-5
"28281","5410國眾","110/07/09","統一-三重",5,0,5
"28282","5410國眾","110/07/09","大慶-中壢",1,6,-5
"28283","5410國眾","110/07/09","富邦-宜蘭",5,0,5
"28284","5410國眾","110/07/09","群益金鼎-中港",0,5,-5
"28285","5410國眾","110/07/09","元大-崇德",5,0,5
"28286","5410國眾","110/07/09","元大-八德",0,5,-5
"28287","5410國眾","110/07/09","元大-博愛",5,0,5
"28288","5410國眾","110/07/09","富邦-基隆",0,4,-4
"28289","5410國眾","110/07/09","元大-龍潭",5,0,5
"28290","5410國眾","110/07/09","臺銀-新竹",0,3,-3
"28291","2841台開","110/07/09","日盛-雙和",102,0,102
"28292","2841台開","110/07/09","港商野村",0,129,-129
"28293","2841台開","110/07/09","元大-館前",70,0,70
"28294","2841台開","110/07/09","兆豐-永和",0,100,-100
"28295","2841台開","110/07/09","凱基-文心",50,0,50
"28296","2841台開","110/07/09","台新證券",7,28,-21
"28297","2841台開","110/07/09","富邦-嘉義",40,0,40
"28298","2841台開","110/07/09","國票-北高雄",0,20,-20
"28299","2841台開","110/07/09","美商高盛",15,0,15
"28300","2841台開","110/07/09","永豐金-敦南",29,46,-17
"28301","2841台開","110/07/09","台中銀",15,0,15
"28302","2841台開","110/07/09","合庫-基隆",0,12,-12
"28303","2841台開","110/07/09","新光",11,0,11
"28304","2841台開","110/07/09","中國信託-松江",0,12,-12
"28305","2841台開","110/07/09","華南永昌-長虹",10,0,10
"28306","2841台開","110/07/09","兆豐-城中",0,12,-12
"28307","2841台開","110/07/09","永豐金-南投",10,0,10
"28308","2841台開","110/07/09","台中銀-豐原",0,10,-10
"28309","2841台開","110/07/09","合庫-桃園",7,0,7
"28310","2841台開","110/07/09","兆豐-景美",0,10,-10
"28311","2841台開","110/07/09","群益金鼎-古亭",7,0,7
"28312","2841台開","110/07/09","群益金鼎-基隆",0,10,-10
"28313","2841台開","110/07/09","國泰-敦南",6,0,6
"28314","2841台開","110/07/09","元大-北三重",0,10,-10
"28315","2841台開","110/07/09","凱基-桃園",8,2,6
"28316","2841台開","110/07/09","(牛牛牛)亞-網路",0,9,-9
"28317","2841台開","110/07/09","日盛證券",5,0,5
"28318","2841台開","110/07/09","台新-高雄",1,10,-9
"28319","2841台開","110/07/09","元富-文心",5,0,5
"28320","2841台開","110/07/09","凱基-台北",0,7,-7
"28321","6207雷科","110/07/09","群益金鼎-新竹",47,0,47
"28322","6207雷科","110/07/09","新光",7,24,-17
"28323","6207雷科","110/07/09","永豐金-三重",31,0,31
"28324","6207雷科","110/07/09","日盛-和美",0,15,-15
"28325","6207雷科","110/07/09","新加坡商瑞銀",33,5,28
"28326","6207雷科","110/07/09","國泰-台南",0,15,-15
"28327","6207雷科","110/07/09","元大-高雄",26,0,26
"28328","6207雷科","110/07/09","華南永昌-古亭",0,14,-14
"28329","6207雷科","110/07/09","統一-員林",22,0,22
"28330","6207雷科","110/07/09","土銀-白河",0,11,-11
"28331","6207雷科","110/07/09","台新-高雄",22,0,22
"28332","6207雷科","110/07/09","日盛-台南",0,10,-10
"28333","6207雷科","110/07/09","摩根大通",34,17,17
"28334","6207雷科","110/07/09","元富-林園",0,10,-10
"28335","6207雷科","110/07/09","元大-博愛",17,1,16
"28336","6207雷科","110/07/09","富邦-園區",0,10,-10
"28337","6207雷科","110/07/09","日茂-埔里",12,0,12
"28338","6207雷科","110/07/09","元大-上新莊",0,10,-10
"28339","6207雷科","110/07/09","國泰-台中",17,6,11
"28340","6207雷科","110/07/09","永豐金-南京",0,10,-10
"28341","6207雷科","110/07/09","富邦-三重",10,0,10
"28342","6207雷科","110/07/09","兆豐-小港",0,6,-6
"28343","6207雷科","110/07/09","元大-沙鹿",10,0,10
"28344","6207雷科","110/07/09","富邦-羅東",1,7,-6
"28345","6207雷科","110/07/09","元大-八德",10,0,10
"28346","6207雷科","110/07/09","元大-土城永寧",0,6,-6
"28347","6207雷科","110/07/09","第一金-路竹",11,2,9
"28348","6207雷科","110/07/09","永豐金-板盛",0,6,-6
"28349","6207雷科","110/07/09","統一-南京",5,0,5
"28350","6207雷科","110/07/09","日盛-板橋",0,5,-5
"28351","3679新至陞","110/07/09","元大-大天母",10,0,10
"28352","3679新至陞","110/07/09","第一金-光復",0,11,-11
"28353","3679新至陞","110/07/09","日盛-樹林",9,0,9
"28354","3679新至陞","110/07/09","瑞士信貸",0,8,-8
"28355","3679新至陞","110/07/09","凱基-台北",11,2,9
"28356","3679新至陞","110/07/09","大慶-苗栗",0,5,-5
"28357","3679新至陞","110/07/09","華南永昌-小港",8,0,8
"28358","3679新至陞","110/07/09","元大-永春",0,5,-5
"28359","3679新至陞","110/07/09","兆豐-來福",7,0,7
"28360","3679新至陞","110/07/09","日盛-和美",0,4,-4
"28361","3679新至陞","110/07/09","香港上海匯豐",5,0,5
"28362","3679新至陞","110/07/09","元大-雙和",0,3,-3
"28363","3679新至陞","110/07/09","台中銀-員林",3,0,3
"28364","3679新至陞","110/07/09","永豐金-屏東",0,3,-3
"28365","3679新至陞","110/07/09","新光",3,0,3
"28366","3679新至陞","110/07/09","彰銀",0,2,-2
"28367","3679新至陞","110/07/09","土銀-花蓮",2,0,2
"28368","3679新至陞","110/07/09","宏遠-館前",0,2,-2
"28369","3679新至陞","110/07/09","第一金-澎湖",2,0,2
"28370","3679新至陞","110/07/09","港商野村",0,2,-2
"28371","3679新至陞","110/07/09","摩根大通",2,0,2
"28372","3679新至陞","110/07/09","大昌-新店",0,2,-2
"28373","3679新至陞","110/07/09","國泰-敦南",2,0,2
"28374","3679新至陞","110/07/09","元大-新莊",0,2,-2
"28375","3679新至陞","110/07/09","元大-淡水",4,2,2
"28376","3679新至陞","110/07/09","元大-板橋",0,2,-2
"28377","3679新至陞","110/07/09","日盛-士林",1,0,1
"28378","3679新至陞","110/07/09","台灣摩根士丹利",0,1,-1
"28379","3679新至陞","110/07/09","日盛-信義",1,0,1
"28380","3679新至陞","110/07/09","第一金-高雄",0,1,-1
"28381","2727王品","110/07/09","台灣匯立證券",90,0,90
"28382","2727王品","110/07/09","台灣摩根士丹利",0,267,-267
"28383","2727王品","110/07/09","國泰-敦南",166,84,82
"28384","2727王品","110/07/09","富邦-台北",35,299,-264
"28385","2727王品","110/07/09","富邦-仁愛",56,12,44
"28386","2727王品","110/07/09","凱基-台北",174,296,-122
"28387","2727王品","110/07/09","台新證券",109,66,43
"28388","2727王品","110/07/09","第一金",2,102,-100
"28389","2727王品","110/07/09","新光",117,87,30
"28390","2727王品","110/07/09","群益金鼎-大安",0,80,-80
"28391","2727王品","110/07/09","臺銀-臺中",35,6,29
"28392","2727王品","110/07/09","兆豐-大安",7,60,-53
"28393","2727王品","110/07/09","元大-桃園",32,3,29
"28394","2727王品","110/07/09","永豐金-南投",0,50,-50
"28395","2727王品","110/07/09","元富-宜蘭",34,6,28
"28396","2727王品","110/07/09","新加坡商瑞銀",6,46,-40
"28397","2727王品","110/07/09","玉山-台中",34,8,26
"28398","2727王品","110/07/09","合庫-彰化",11,50,-39
"28399","2727王品","110/07/09","群益金鼎-宜蘭",30,4,26
"28400","2727王品","110/07/09","永豐金-萬盛",13,52,-39
"28401","2727王品","110/07/09","富邦-台中",42,16,26
"28402","2727王品","110/07/09","瑞士信貸",0,34,-34
"28403","2727王品","110/07/09","第一金-豐原",25,1,24
"28404","2727王品","110/07/09","元大-和平",4,35,-31
"28405","2727王品","110/07/09","臺銀",30,8,22
"28406","2727王品","110/07/09","美林",14,44,-30
"28407","2727王品","110/07/09","兆豐-來福",23,1,22
"28408","2727王品","110/07/09","元大-員林",9,38,-29
"28409","2727王品","110/07/09","玉山-士林",22,2,20
"28410","2727王品","110/07/09","元富-西松",4,31,-27
"28411","1570力肯","110/07/09","凱基-台北",30,1,29
"28412","1570力肯","110/07/09","群益金鼎-彰化",0,20,-20
"28413","1570力肯","110/07/09","新光-台南",20,0,20
"28414","1570力肯","110/07/09","元大-土城學府",0,20,-20
"28415","1570力肯","110/07/09","元大-高雄",20,0,20
"28416","1570力肯","110/07/09","元大-大統",0,16,-16
"28417","1570力肯","110/07/09","國票-中正",12,0,12
"28418","1570力肯","110/07/09","元大-新營",0,11,-11
"28419","1570力肯","110/07/09","日盛-高雄",6,0,6
"28420","1570力肯","110/07/09","元大-和平",0,10,-10
"28421","1570力肯","110/07/09","元富-緯城",6,0,6
"28422","1570力肯","110/07/09","元大-草屯",0,10,-10
"28423","1570力肯","110/07/09","群益金鼎-台南",6,0,6
"28424","1570力肯","110/07/09","元大-鹿港",0,9,-9
"28425","1570力肯","110/07/09","華南永昌-岡山",6,0,6
"28426","1570力肯","110/07/09","合庫-基隆",0,7,-7
"28427","1570力肯","110/07/09","統一-中壢",5,0,5
"28428","1570力肯","110/07/09","摩根大通",2,8,-6
"28429","1570力肯","110/07/09","凱基-三峽",5,0,5
"28430","1570力肯","110/07/09","台灣企銀-豐原",0,4,-4
"28431","1570力肯","110/07/09","大昌-樹林",4,0,4
"28432","1570力肯","110/07/09","日盛-桃園",0,4,-4
"28433","1570力肯","110/07/09","新光",3,0,3
"28434","1570力肯","110/07/09","國泰-高雄",0,3,-3
"28435","1570力肯","110/07/09","富邦-新竹華信",3,0,3
"28436","1570力肯","110/07/09","永豐金-敦南",0,3,-3
"28437","1570力肯","110/07/09","合庫-台中",2,0,2
"28438","1570力肯","110/07/09","土銀-彰化",0,2,-2
"28439","1570力肯","110/07/09","臺銀-臺中",2,0,2
"28440","1570力肯","110/07/09","臺銀-鳳山",0,2,-2
"28441","6180橘子","110/07/09","摩根大通",63,1,62
"28442","6180橘子","110/07/09","元大-南京",1,32,-31
"28443","6180橘子","110/07/09","富邦-陽明",73,33,40
"28444","6180橘子","110/07/09","群益金鼎-台北",0,25,-25
"28445","6180橘子","110/07/09","新加坡商瑞銀",31,0,31
"28446","6180橘子","110/07/09","兆豐-復興",0,21,-21
"28447","6180橘子","110/07/09","美商高盛",25,0,25
"28448","6180橘子","110/07/09","永豐金-嘉義",0,21,-21
"28449","6180橘子","110/07/09","凱基-台北",26,10,16
"28450","6180橘子","110/07/09","凱基-中壢",8,24,-16
"28451","6180橘子","110/07/09","華南永昌-楠梓",13,0,13
"28452","6180橘子","110/07/09","致和-崇德",0,15,-15
"28453","6180橘子","110/07/09","華南永昌-朴子",11,0,11
"28454","6180橘子","110/07/09","群益金鼎-屏東",0,15,-15
"28455","6180橘子","110/07/09","元大-北港",11,0,11
"28456","6180橘子","110/07/09","群益金鼎-中山",0,15,-15
"28457","6180橘子","110/07/09","元大-成功",10,1,9
"28458","6180橘子","110/07/09","瑞士信貸",1,15,-14
"28459","6180橘子","110/07/09","新光",26,18,8
"28460","6180橘子","110/07/09","日盛-二林",0,10,-10
"28461","6180橘子","110/07/09","統一-三重",6,0,6
"28462","6180橘子","110/07/09","凱基-東門",0,10,-10
"28463","6180橘子","110/07/09","群益金鼎-嘉義",6,0,6
"28464","6180橘子","110/07/09","華南永昌-三重",0,10,-10
"28465","6180橘子","110/07/09","元大-員林中山",6,0,6
"28466","6180橘子","110/07/09","元大-彰化民生",1,11,-10
"28467","6180橘子","110/07/09","合庫-鳳山",5,0,5
"28468","6180橘子","110/07/09","永豐金-新店",1,11,-10
"28469","6180橘子","110/07/09","富邦-建國",6,1,5
"28470","6180橘子","110/07/09","群益金鼎-丹鳳",0,8,-8
"28471","2390云辰","110/07/09","摩根大通",279,56,223
"28472","2390云辰","110/07/09","元大-天母",0,127,-127
"28473","2390云辰","110/07/09","日盛-鳳山",110,2,108
"28474","2390云辰","110/07/09","中國信託-文心",5,109,-104
"28475","2390云辰","110/07/09","宏遠證券",100,0,100
"28476","2390云辰","110/07/09","永豐金-復興",0,55,-55
"28477","2390云辰","110/07/09","元大-大里",63,6,57
"28478","2390云辰","110/07/09","凱基-台北",239,286,-47
"28479","2390云辰","110/07/09","凱基-八德",59,10,49
"28480","2390云辰","110/07/09","德信",2,32,-30
"28481","2390云辰","110/07/09","合庫-新竹",40,0,40
"28482","2390云辰","110/07/09","兆豐-桃鶯",2,32,-30
"28483","2390云辰","110/07/09","國票",40,1,39
"28484","2390云辰","110/07/09","致和-南京",0,30,-30
"28485","2390云辰","110/07/09","新加坡商瑞銀",49,13,36
"28486","2390云辰","110/07/09","富邦-虎尾",1,31,-30
"28487","2390云辰","110/07/09","統一-新台中",36,2,34
"28488","2390云辰","110/07/09","元大-善化",2,31,-29
"28489","2390云辰","110/07/09","國票-嘉義",31,0,31
"28490","2390云辰","110/07/09","富邦-板橋",0,27,-27
"28491","2390云辰","110/07/09","華南永昌",35,7,28
"28492","2390云辰","110/07/09","富邦-永和",3,28,-25
"28493","2390云辰","110/07/09","玉山-台中",49,22,27
"28494","2390云辰","110/07/09","第一金-自由",20,44,-24
"28495","2390云辰","110/07/09","華南永昌-敦南",25,0,25
"28496","2390云辰","110/07/09","凱基-內湖",0,24,-24
"28497","2390云辰","110/07/09","新光-高雄",27,4,23
"28498","2390云辰","110/07/09","元大-汐止",1,24,-23
"28499","2390云辰","110/07/09","台灣摩根士丹利",85,63,22
"28500","2390云辰","110/07/09","新光-台中",12,33,-21
"28501","4903聯光通","110/07/09","元大-敦南",10,0,10
"28502","4903聯光通","110/07/09","第一金-台中",0,12,-12
"28503","4903聯光通","110/07/09","凱基-士林",5,0,5
"28504","4903聯光通","110/07/09","日盛-忠孝",0,3,-3
"28505","4903聯光通","110/07/09","元大-苗栗",5,0,5
"28506","4903聯光通","110/07/09","群益金鼎-崇德",0,3,-3
"28507","4903聯光通","110/07/09","元大-屏南",3,0,3
"28508","4903聯光通","110/07/09","國票-內壢",0,2,-2
"28509","4903聯光通","110/07/09","中國信託-永康",1,0,1
"28510","4903聯光通","110/07/09","康和-南崁",0,2,-2
"28511","4903聯光通","110/07/09","玉山證券",1,0,1
"28512","4903聯光通","110/07/09","新光-台中",0,2,-2
"28513","4903聯光通","110/07/09","元大-太平",4,3,1
"28514","4903聯光通","110/07/09","玉山-城中",0,2,-2
"28515","4903聯光通","110/07/09","永豐金-嘉義",1,0,1
"28516","4903聯光通","110/07/09","中國信託-文心",0,1,-1
"28517","4903聯光通","110/07/09","大昌",0,0,0
"28518","4903聯光通","110/07/09","大昌",0,0,0
"28519","4903聯光通","110/07/09","中農",0,0,0
"28520","4903聯光通","110/07/09","中農",0,0,0
"28521","4903聯光通","110/07/09","",NA,NA,NA
"28522","4903聯光通","110/07/09","",NA,NA,NA
"28523","4903聯光通","110/07/09","",NA,NA,NA
"28524","4903聯光通","110/07/09","",NA,NA,NA
"28525","4903聯光通","110/07/09","",NA,NA,NA
"28526","4903聯光通","110/07/09","",NA,NA,NA
"28527","4903聯光通","110/07/09","",NA,NA,NA
"28528","4903聯光通","110/07/09","",NA,NA,NA
"28529","4903聯光通","110/07/09","",NA,NA,NA
"28530","4903聯光通","110/07/09","",NA,NA,NA
"28531","2929淘帝","110/07/09","台中銀-台北",110,0,110
"28532","2929淘帝","110/07/09","新光",2,82,-80
"28533","2929淘帝","110/07/09","華南永昌-頭份",72,0,72
"28534","2929淘帝","110/07/09","摩根大通",2,63,-61
"28535","2929淘帝","110/07/09","合庫-高雄",71,0,71
"28536","2929淘帝","110/07/09","第一金-路竹",0,50,-50
"28537","2929淘帝","110/07/09","高橋-龍潭",37,0,37
"28538","2929淘帝","110/07/09","港商麥格理",0,42,-42
"28539","2929淘帝","110/07/09","新光-台中",60,26,34
"28540","2929淘帝","110/07/09","陽信-石牌",0,40,-40
"28541","2929淘帝","110/07/09","元富-大裕",22,1,21
"28542","2929淘帝","110/07/09","台新-左楠",1,39,-38
"28543","2929淘帝","110/07/09","合庫-鳳山",20,0,20
"28544","2929淘帝","110/07/09","凱基-桃園",3,29,-26
"28545","2929淘帝","110/07/09","元大-員林",22,2,20
"28546","2929淘帝","110/07/09","兆豐-內湖",0,25,-25
"28547","2929淘帝","110/07/09","台新-建北",15,0,15
"28548","2929淘帝","110/07/09","元大-北港",0,20,-20
"28549","2929淘帝","110/07/09","兆豐-桃園",13,0,13
"28550","2929淘帝","110/07/09","富邦-北港",0,19,-19
"28551","2929淘帝","110/07/09","兆豐-忠孝",10,0,10
"28552","2929淘帝","110/07/09","富邦-花蓮",0,17,-17
"28553","2929淘帝","110/07/09","國票-敦北法人",10,0,10
"28554","2929淘帝","110/07/09","國泰-台中",2,17,-15
"28555","2929淘帝","110/07/09","永豐金-博愛",10,0,10
"28556","2929淘帝","110/07/09","群益金鼎-彰化",0,15,-15
"28557","2929淘帝","110/07/09","群益金鼎-潭子",8,0,8
"28558","2929淘帝","110/07/09","元大-博愛",0,14,-14
"28559","2929淘帝","110/07/09","富邦-南屯",8,0,8
"28560","2929淘帝","110/07/09","日盛-板橋",0,13,-13
"28561","5410國眾","110/07/09","元大-新盛",14,0,14
"28562","5410國眾","110/07/09","(牛牛牛)亞-鑫豐",1,41,-40
"28563","5410國眾","110/07/09","台灣企銀-民雄",10,0,10
"28564","5410國眾","110/07/09","元富-嘉義",0,25,-25
"28565","5410國眾","110/07/09","元富-虎尾",9,0,9
"28566","5410國眾","110/07/09","凱基-高美館",0,10,-10
"28567","5410國眾","110/07/09","摩根大通",10,1,9
"28568","5410國眾","110/07/09","凱基-城中",0,10,-10
"28569","5410國眾","110/07/09","兆豐-北高雄",7,0,7
"28570","5410國眾","110/07/09","元大-頭份",0,10,-10
"28571","5410國眾","110/07/09","凱基-台北",8,1,7
"28572","5410國眾","110/07/09","群益金鼎-丹鳳",0,7,-7
"28573","5410國眾","110/07/09","華南永昌-公誠",7,0,7
"28574","5410國眾","110/07/09","凱基-復興",0,7,-7
"28575","5410國眾","110/07/09","香港上海匯豐",6,0,6
"28576","5410國眾","110/07/09","元大-員林",0,7,-7
"28577","5410國眾","110/07/09","凱基-中壢",6,0,6
"28578","5410國眾","110/07/09","富邦-竹東",0,6,-6
"28579","5410國眾","110/07/09","華南永昌-南京",6,0,6
"28580","5410國眾","110/07/09","亞東-高雄",0,5,-5
"28581","5410國眾","110/07/09","統一-三重",5,0,5
"28582","5410國眾","110/07/09","大慶-中壢",1,6,-5
"28583","5410國眾","110/07/09","富邦-宜蘭",5,0,5
"28584","5410國眾","110/07/09","群益金鼎-中港",0,5,-5
"28585","5410國眾","110/07/09","元大-崇德",5,0,5
"28586","5410國眾","110/07/09","元大-八德",0,5,-5
"28587","5410國眾","110/07/09","元大-博愛",5,0,5
"28588","5410國眾","110/07/09","富邦-基隆",0,4,-4
"28589","5410國眾","110/07/09","元大-龍潭",5,0,5
"28590","5410國眾","110/07/09","臺銀-新竹",0,3,-3
"28591","2841台開","110/07/09","日盛-雙和",102,0,102
"28592","2841台開","110/07/09","港商野村",0,129,-129
"28593","2841台開","110/07/09","元大-館前",70,0,70
"28594","2841台開","110/07/09","兆豐-永和",0,100,-100
"28595","2841台開","110/07/09","凱基-文心",50,0,50
"28596","2841台開","110/07/09","台新證券",7,28,-21
"28597","2841台開","110/07/09","富邦-嘉義",40,0,40
"28598","2841台開","110/07/09","國票-北高雄",0,20,-20
"28599","2841台開","110/07/09","美商高盛",15,0,15
"28600","2841台開","110/07/09","永豐金-敦南",29,46,-17
"28601","2841台開","110/07/09","台中銀",15,0,15
"28602","2841台開","110/07/09","合庫-基隆",0,12,-12
"28603","2841台開","110/07/09","新光",11,0,11
"28604","2841台開","110/07/09","中國信託-松江",0,12,-12
"28605","2841台開","110/07/09","華南永昌-長虹",10,0,10
"28606","2841台開","110/07/09","兆豐-城中",0,12,-12
"28607","2841台開","110/07/09","永豐金-南投",10,0,10
"28608","2841台開","110/07/09","台中銀-豐原",0,10,-10
"28609","2841台開","110/07/09","合庫-桃園",7,0,7
"28610","2841台開","110/07/09","兆豐-景美",0,10,-10
"28611","2841台開","110/07/09","群益金鼎-古亭",7,0,7
"28612","2841台開","110/07/09","群益金鼎-基隆",0,10,-10
"28613","2841台開","110/07/09","國泰-敦南",6,0,6
"28614","2841台開","110/07/09","元大-北三重",0,10,-10
"28615","2841台開","110/07/09","凱基-桃園",8,2,6
"28616","2841台開","110/07/09","(牛牛牛)亞-網路",0,9,-9
"28617","2841台開","110/07/09","日盛證券",5,0,5
"28618","2841台開","110/07/09","台新-高雄",1,10,-9
"28619","2841台開","110/07/09","元富-文心",5,0,5
"28620","2841台開","110/07/09","凱基-台北",0,7,-7
"28621","6207雷科","110/07/09","群益金鼎-新竹",47,0,47
"28622","6207雷科","110/07/09","新光",7,24,-17
"28623","6207雷科","110/07/09","永豐金-三重",31,0,31
"28624","6207雷科","110/07/09","日盛-和美",0,15,-15
"28625","6207雷科","110/07/09","新加坡商瑞銀",33,5,28
"28626","6207雷科","110/07/09","國泰-台南",0,15,-15
"28627","6207雷科","110/07/09","元大-高雄",26,0,26
"28628","6207雷科","110/07/09","華南永昌-古亭",0,14,-14
"28629","6207雷科","110/07/09","統一-員林",22,0,22
"28630","6207雷科","110/07/09","土銀-白河",0,11,-11
"28631","6207雷科","110/07/09","台新-高雄",22,0,22
"28632","6207雷科","110/07/09","日盛-台南",0,10,-10
"28633","6207雷科","110/07/09","摩根大通",34,17,17
"28634","6207雷科","110/07/09","元富-林園",0,10,-10
"28635","6207雷科","110/07/09","元大-博愛",17,1,16
"28636","6207雷科","110/07/09","富邦-園區",0,10,-10
"28637","6207雷科","110/07/09","日茂-埔里",12,0,12
"28638","6207雷科","110/07/09","元大-上新莊",0,10,-10
"28639","6207雷科","110/07/09","國泰-台中",17,6,11
"28640","6207雷科","110/07/09","永豐金-南京",0,10,-10
"28641","6207雷科","110/07/09","富邦-三重",10,0,10
"28642","6207雷科","110/07/09","兆豐-小港",0,6,-6
"28643","6207雷科","110/07/09","元大-沙鹿",10,0,10
"28644","6207雷科","110/07/09","富邦-羅東",1,7,-6
"28645","6207雷科","110/07/09","元大-八德",10,0,10
"28646","6207雷科","110/07/09","元大-土城永寧",0,6,-6
"28647","6207雷科","110/07/09","第一金-路竹",11,2,9
"28648","6207雷科","110/07/09","永豐金-板盛",0,6,-6
"28649","6207雷科","110/07/09","統一-南京",5,0,5
"28650","6207雷科","110/07/09","日盛-板橋",0,5,-5
"28651","3679新至陞","110/07/09","元大-大天母",10,0,10
"28652","3679新至陞","110/07/09","第一金-光復",0,11,-11
"28653","3679新至陞","110/07/09","日盛-樹林",9,0,9
"28654","3679新至陞","110/07/09","瑞士信貸",0,8,-8
"28655","3679新至陞","110/07/09","凱基-台北",11,2,9
"28656","3679新至陞","110/07/09","大慶-苗栗",0,5,-5
"28657","3679新至陞","110/07/09","華南永昌-小港",8,0,8
"28658","3679新至陞","110/07/09","元大-永春",0,5,-5
"28659","3679新至陞","110/07/09","兆豐-來福",7,0,7
"28660","3679新至陞","110/07/09","日盛-和美",0,4,-4
"28661","3679新至陞","110/07/09","香港上海匯豐",5,0,5
"28662","3679新至陞","110/07/09","元大-雙和",0,3,-3
"28663","3679新至陞","110/07/09","台中銀-員林",3,0,3
"28664","3679新至陞","110/07/09","永豐金-屏東",0,3,-3
"28665","3679新至陞","110/07/09","新光",3,0,3
"28666","3679新至陞","110/07/09","彰銀",0,2,-2
"28667","3679新至陞","110/07/09","土銀-花蓮",2,0,2
"28668","3679新至陞","110/07/09","宏遠-館前",0,2,-2
"28669","3679新至陞","110/07/09","第一金-澎湖",2,0,2
"28670","3679新至陞","110/07/09","港商野村",0,2,-2
"28671","3679新至陞","110/07/09","摩根大通",2,0,2
"28672","3679新至陞","110/07/09","大昌-新店",0,2,-2
"28673","3679新至陞","110/07/09","國泰-敦南",2,0,2
"28674","3679新至陞","110/07/09","元大-新莊",0,2,-2
"28675","3679新至陞","110/07/09","元大-淡水",4,2,2
"28676","3679新至陞","110/07/09","元大-板橋",0,2,-2
"28677","3679新至陞","110/07/09","日盛-士林",1,0,1
"28678","3679新至陞","110/07/09","台灣摩根士丹利",0,1,-1
"28679","3679新至陞","110/07/09","日盛-信義",1,0,1
"28680","3679新至陞","110/07/09","第一金-高雄",0,1,-1
"28681","2727王品","110/07/09","台灣匯立證券",90,0,90
"28682","2727王品","110/07/09","台灣摩根士丹利",0,267,-267
"28683","2727王品","110/07/09","國泰-敦南",166,84,82
"28684","2727王品","110/07/09","富邦-台北",35,299,-264
"28685","2727王品","110/07/09","富邦-仁愛",56,12,44
"28686","2727王品","110/07/09","凱基-台北",174,296,-122
"28687","2727王品","110/07/09","台新證券",109,66,43
"28688","2727王品","110/07/09","第一金",2,102,-100
"28689","2727王品","110/07/09","新光",117,87,30
"28690","2727王品","110/07/09","群益金鼎-大安",0,80,-80
"28691","2727王品","110/07/09","臺銀-臺中",35,6,29
"28692","2727王品","110/07/09","兆豐-大安",7,60,-53
"28693","2727王品","110/07/09","元大-桃園",32,3,29
"28694","2727王品","110/07/09","永豐金-南投",0,50,-50
"28695","2727王品","110/07/09","元富-宜蘭",34,6,28
"28696","2727王品","110/07/09","新加坡商瑞銀",6,46,-40
"28697","2727王品","110/07/09","玉山-台中",34,8,26
"28698","2727王品","110/07/09","合庫-彰化",11,50,-39
"28699","2727王品","110/07/09","群益金鼎-宜蘭",30,4,26
"28700","2727王品","110/07/09","永豐金-萬盛",13,52,-39
"28701","2727王品","110/07/09","富邦-台中",42,16,26
"28702","2727王品","110/07/09","瑞士信貸",0,34,-34
"28703","2727王品","110/07/09","第一金-豐原",25,1,24
"28704","2727王品","110/07/09","元大-和平",4,35,-31
"28705","2727王品","110/07/09","臺銀",30,8,22
"28706","2727王品","110/07/09","美林",14,44,-30
"28707","2727王品","110/07/09","兆豐-來福",23,1,22
"28708","2727王品","110/07/09","元大-員林",9,38,-29
"28709","2727王品","110/07/09","玉山-士林",22,2,20
"28710","2727王品","110/07/09","元富-西松",4,31,-27
"28711","1570力肯","110/07/09","凱基-台北",30,1,29
"28712","1570力肯","110/07/09","群益金鼎-彰化",0,20,-20
"28713","1570力肯","110/07/09","新光-台南",20,0,20
"28714","1570力肯","110/07/09","元大-土城學府",0,20,-20
"28715","1570力肯","110/07/09","元大-高雄",20,0,20
"28716","1570力肯","110/07/09","元大-大統",0,16,-16
"28717","1570力肯","110/07/09","國票-中正",12,0,12
"28718","1570力肯","110/07/09","元大-新營",0,11,-11
"28719","1570力肯","110/07/09","日盛-高雄",6,0,6
"28720","1570力肯","110/07/09","元大-和平",0,10,-10
"28721","1570力肯","110/07/09","元富-緯城",6,0,6
"28722","1570力肯","110/07/09","元大-草屯",0,10,-10
"28723","1570力肯","110/07/09","群益金鼎-台南",6,0,6
"28724","1570力肯","110/07/09","元大-鹿港",0,9,-9
"28725","1570力肯","110/07/09","華南永昌-岡山",6,0,6
"28726","1570力肯","110/07/09","合庫-基隆",0,7,-7
"28727","1570力肯","110/07/09","統一-中壢",5,0,5
"28728","1570力肯","110/07/09","摩根大通",2,8,-6
"28729","1570力肯","110/07/09","凱基-三峽",5,0,5
"28730","1570力肯","110/07/09","台灣企銀-豐原",0,4,-4
"28731","1570力肯","110/07/09","大昌-樹林",4,0,4
"28732","1570力肯","110/07/09","日盛-桃園",0,4,-4
"28733","1570力肯","110/07/09","新光",3,0,3
"28734","1570力肯","110/07/09","國泰-高雄",0,3,-3
"28735","1570力肯","110/07/09","富邦-新竹華信",3,0,3
"28736","1570力肯","110/07/09","永豐金-敦南",0,3,-3
"28737","1570力肯","110/07/09","合庫-台中",2,0,2
"28738","1570力肯","110/07/09","土銀-彰化",0,2,-2
"28739","1570力肯","110/07/09","臺銀-臺中",2,0,2
"28740","1570力肯","110/07/09","臺銀-鳳山",0,2,-2
"28741","6180橘子","110/07/09","摩根大通",63,1,62
"28742","6180橘子","110/07/09","元大-南京",1,32,-31
"28743","6180橘子","110/07/09","富邦-陽明",73,33,40
"28744","6180橘子","110/07/09","群益金鼎-台北",0,25,-25
"28745","6180橘子","110/07/09","新加坡商瑞銀",31,0,31
"28746","6180橘子","110/07/09","兆豐-復興",0,21,-21
"28747","6180橘子","110/07/09","美商高盛",25,0,25
"28748","6180橘子","110/07/09","永豐金-嘉義",0,21,-21
"28749","6180橘子","110/07/09","凱基-台北",26,10,16
"28750","6180橘子","110/07/09","凱基-中壢",8,24,-16
"28751","6180橘子","110/07/09","華南永昌-楠梓",13,0,13
"28752","6180橘子","110/07/09","致和-崇德",0,15,-15
"28753","6180橘子","110/07/09","華南永昌-朴子",11,0,11
"28754","6180橘子","110/07/09","群益金鼎-屏東",0,15,-15
"28755","6180橘子","110/07/09","元大-北港",11,0,11
"28756","6180橘子","110/07/09","群益金鼎-中山",0,15,-15
"28757","6180橘子","110/07/09","元大-成功",10,1,9
"28758","6180橘子","110/07/09","瑞士信貸",1,15,-14
"28759","6180橘子","110/07/09","新光",26,18,8
"28760","6180橘子","110/07/09","日盛-二林",0,10,-10
"28761","6180橘子","110/07/09","統一-三重",6,0,6
"28762","6180橘子","110/07/09","凱基-東門",0,10,-10
"28763","6180橘子","110/07/09","群益金鼎-嘉義",6,0,6
"28764","6180橘子","110/07/09","華南永昌-三重",0,10,-10
"28765","6180橘子","110/07/09","元大-員林中山",6,0,6
"28766","6180橘子","110/07/09","元大-彰化民生",1,11,-10
"28767","6180橘子","110/07/09","合庫-鳳山",5,0,5
"28768","6180橘子","110/07/09","永豐金-新店",1,11,-10
"28769","6180橘子","110/07/09","富邦-建國",6,1,5
"28770","6180橘子","110/07/09","群益金鼎-丹鳳",0,8,-8
"28771","2390云辰","110/07/09","摩根大通",279,56,223
"28772","2390云辰","110/07/09","元大-天母",0,127,-127
"28773","2390云辰","110/07/09","日盛-鳳山",110,2,108
"28774","2390云辰","110/07/09","中國信託-文心",5,109,-104
"28775","2390云辰","110/07/09","宏遠證券",100,0,100
"28776","2390云辰","110/07/09","永豐金-復興",0,55,-55
"28777","2390云辰","110/07/09","元大-大里",63,6,57
"28778","2390云辰","110/07/09","凱基-台北",239,286,-47
"28779","2390云辰","110/07/09","凱基-八德",59,10,49
"28780","2390云辰","110/07/09","德信",2,32,-30
"28781","2390云辰","110/07/09","合庫-新竹",40,0,40
"28782","2390云辰","110/07/09","兆豐-桃鶯",2,32,-30
"28783","2390云辰","110/07/09","國票",40,1,39
"28784","2390云辰","110/07/09","致和-南京",0,30,-30
"28785","2390云辰","110/07/09","新加坡商瑞銀",49,13,36
"28786","2390云辰","110/07/09","富邦-虎尾",1,31,-30
"28787","2390云辰","110/07/09","統一-新台中",36,2,34
"28788","2390云辰","110/07/09","元大-善化",2,31,-29
"28789","2390云辰","110/07/09","國票-嘉義",31,0,31
"28790","2390云辰","110/07/09","富邦-板橋",0,27,-27
"28791","2390云辰","110/07/09","華南永昌",35,7,28
"28792","2390云辰","110/07/09","富邦-永和",3,28,-25
"28793","2390云辰","110/07/09","玉山-台中",49,22,27
"28794","2390云辰","110/07/09","第一金-自由",20,44,-24
"28795","2390云辰","110/07/09","華南永昌-敦南",25,0,25
"28796","2390云辰","110/07/09","凱基-內湖",0,24,-24
"28797","2390云辰","110/07/09","新光-高雄",27,4,23
"28798","2390云辰","110/07/09","元大-汐止",1,24,-23
"28799","2390云辰","110/07/09","台灣摩根士丹利",85,63,22
"28800","2390云辰","110/07/09","新光-台中",12,33,-21
"28801","4903聯光通","110/07/09","元大-敦南",10,0,10
"28802","4903聯光通","110/07/09","第一金-台中",0,12,-12
"28803","4903聯光通","110/07/09","凱基-士林",5,0,5
"28804","4903聯光通","110/07/09","日盛-忠孝",0,3,-3
"28805","4903聯光通","110/07/09","元大-苗栗",5,0,5
"28806","4903聯光通","110/07/09","群益金鼎-崇德",0,3,-3
"28807","4903聯光通","110/07/09","元大-屏南",3,0,3
"28808","4903聯光通","110/07/09","國票-內壢",0,2,-2
"28809","4903聯光通","110/07/09","中國信託-永康",1,0,1
"28810","4903聯光通","110/07/09","康和-南崁",0,2,-2
"28811","4903聯光通","110/07/09","玉山證券",1,0,1
"28812","4903聯光通","110/07/09","新光-台中",0,2,-2
"28813","4903聯光通","110/07/09","元大-太平",4,3,1
"28814","4903聯光通","110/07/09","玉山-城中",0,2,-2
"28815","4903聯光通","110/07/09","永豐金-嘉義",1,0,1
"28816","4903聯光通","110/07/09","中國信託-文心",0,1,-1
"28817","4903聯光通","110/07/09","大昌",0,0,0
"28818","4903聯光通","110/07/09","大昌",0,0,0
"28819","4903聯光通","110/07/09","中農",0,0,0
"28820","4903聯光通","110/07/09","中農",0,0,0
"28821","4903聯光通","110/07/09","",NA,NA,NA
"28822","4903聯光通","110/07/09","",NA,NA,NA
"28823","4903聯光通","110/07/09","",NA,NA,NA
"28824","4903聯光通","110/07/09","",NA,NA,NA
"28825","4903聯光通","110/07/09","",NA,NA,NA
"28826","4903聯光通","110/07/09","",NA,NA,NA
"28827","4903聯光通","110/07/09","",NA,NA,NA
"28828","4903聯光通","110/07/09","",NA,NA,NA
"28829","4903聯光通","110/07/09","",NA,NA,NA
"28830","4903聯光通","110/07/09","",NA,NA,NA
"28831","2929淘帝","110/07/09","台中銀-台北",110,0,110
"28832","2929淘帝","110/07/09","新光",2,82,-80
"28833","2929淘帝","110/07/09","華南永昌-頭份",72,0,72
"28834","2929淘帝","110/07/09","摩根大通",2,63,-61
"28835","2929淘帝","110/07/09","合庫-高雄",71,0,71
"28836","2929淘帝","110/07/09","第一金-路竹",0,50,-50
"28837","2929淘帝","110/07/09","高橋-龍潭",37,0,37
"28838","2929淘帝","110/07/09","港商麥格理",0,42,-42
"28839","2929淘帝","110/07/09","新光-台中",60,26,34
"28840","2929淘帝","110/07/09","陽信-石牌",0,40,-40
"28841","2929淘帝","110/07/09","元富-大裕",22,1,21
"28842","2929淘帝","110/07/09","台新-左楠",1,39,-38
"28843","2929淘帝","110/07/09","合庫-鳳山",20,0,20
"28844","2929淘帝","110/07/09","凱基-桃園",3,29,-26
"28845","2929淘帝","110/07/09","元大-員林",22,2,20
"28846","2929淘帝","110/07/09","兆豐-內湖",0,25,-25
"28847","2929淘帝","110/07/09","台新-建北",15,0,15
"28848","2929淘帝","110/07/09","元大-北港",0,20,-20
"28849","2929淘帝","110/07/09","兆豐-桃園",13,0,13
"28850","2929淘帝","110/07/09","富邦-北港",0,19,-19
"28851","2929淘帝","110/07/09","兆豐-忠孝",10,0,10
"28852","2929淘帝","110/07/09","富邦-花蓮",0,17,-17
"28853","2929淘帝","110/07/09","國票-敦北法人",10,0,10
"28854","2929淘帝","110/07/09","國泰-台中",2,17,-15
"28855","2929淘帝","110/07/09","永豐金-博愛",10,0,10
"28856","2929淘帝","110/07/09","群益金鼎-彰化",0,15,-15
"28857","2929淘帝","110/07/09","群益金鼎-潭子",8,0,8
"28858","2929淘帝","110/07/09","元大-博愛",0,14,-14
"28859","2929淘帝","110/07/09","富邦-南屯",8,0,8
"28860","2929淘帝","110/07/09","日盛-板橋",0,13,-13
"28861","5410國眾","110/07/09","元大-新盛",14,0,14
"28862","5410國眾","110/07/09","(牛牛牛)亞-鑫豐",1,41,-40
"28863","5410國眾","110/07/09","台灣企銀-民雄",10,0,10
"28864","5410國眾","110/07/09","元富-嘉義",0,25,-25
"28865","5410國眾","110/07/09","元富-虎尾",9,0,9
"28866","5410國眾","110/07/09","凱基-高美館",0,10,-10
"28867","5410國眾","110/07/09","摩根大通",10,1,9
"28868","5410國眾","110/07/09","凱基-城中",0,10,-10
"28869","5410國眾","110/07/09","兆豐-北高雄",7,0,7
"28870","5410國眾","110/07/09","元大-頭份",0,10,-10
"28871","5410國眾","110/07/09","凱基-台北",8,1,7
"28872","5410國眾","110/07/09","群益金鼎-丹鳳",0,7,-7
"28873","5410國眾","110/07/09","華南永昌-公誠",7,0,7
"28874","5410國眾","110/07/09","凱基-復興",0,7,-7
"28875","5410國眾","110/07/09","香港上海匯豐",6,0,6
"28876","5410國眾","110/07/09","元大-員林",0,7,-7
"28877","5410國眾","110/07/09","凱基-中壢",6,0,6
"28878","5410國眾","110/07/09","富邦-竹東",0,6,-6
"28879","5410國眾","110/07/09","華南永昌-南京",6,0,6
"28880","5410國眾","110/07/09","亞東-高雄",0,5,-5
"28881","5410國眾","110/07/09","統一-三重",5,0,5
"28882","5410國眾","110/07/09","大慶-中壢",1,6,-5
"28883","5410國眾","110/07/09","富邦-宜蘭",5,0,5
"28884","5410國眾","110/07/09","群益金鼎-中港",0,5,-5
"28885","5410國眾","110/07/09","元大-崇德",5,0,5
"28886","5410國眾","110/07/09","元大-八德",0,5,-5
"28887","5410國眾","110/07/09","元大-博愛",5,0,5
"28888","5410國眾","110/07/09","富邦-基隆",0,4,-4
"28889","5410國眾","110/07/09","元大-龍潭",5,0,5
"28890","5410國眾","110/07/09","臺銀-新竹",0,3,-3
"28891","2841台開","110/07/09","日盛-雙和",102,0,102
"28892","2841台開","110/07/09","港商野村",0,129,-129
"28893","2841台開","110/07/09","元大-館前",70,0,70
"28894","2841台開","110/07/09","兆豐-永和",0,100,-100
"28895","2841台開","110/07/09","凱基-文心",50,0,50
"28896","2841台開","110/07/09","台新證券",7,28,-21
"28897","2841台開","110/07/09","富邦-嘉義",40,0,40
"28898","2841台開","110/07/09","國票-北高雄",0,20,-20
"28899","2841台開","110/07/09","美商高盛",15,0,15
"28900","2841台開","110/07/09","永豐金-敦南",29,46,-17
"28901","2841台開","110/07/09","台中銀",15,0,15
"28902","2841台開","110/07/09","合庫-基隆",0,12,-12
"28903","2841台開","110/07/09","新光",11,0,11
"28904","2841台開","110/07/09","中國信託-松江",0,12,-12
"28905","2841台開","110/07/09","華南永昌-長虹",10,0,10
"28906","2841台開","110/07/09","兆豐-城中",0,12,-12
"28907","2841台開","110/07/09","永豐金-南投",10,0,10
"28908","2841台開","110/07/09","台中銀-豐原",0,10,-10
"28909","2841台開","110/07/09","合庫-桃園",7,0,7
"28910","2841台開","110/07/09","兆豐-景美",0,10,-10
"28911","2841台開","110/07/09","群益金鼎-古亭",7,0,7
"28912","2841台開","110/07/09","群益金鼎-基隆",0,10,-10
"28913","2841台開","110/07/09","國泰-敦南",6,0,6
"28914","2841台開","110/07/09","元大-北三重",0,10,-10
"28915","2841台開","110/07/09","凱基-桃園",8,2,6
"28916","2841台開","110/07/09","(牛牛牛)亞-網路",0,9,-9
"28917","2841台開","110/07/09","日盛證券",5,0,5
"28918","2841台開","110/07/09","台新-高雄",1,10,-9
"28919","2841台開","110/07/09","元富-文心",5,0,5
"28920","2841台開","110/07/09","凱基-台北",0,7,-7
"28921","6207雷科","110/07/09","群益金鼎-新竹",47,0,47
"28922","6207雷科","110/07/09","新光",7,24,-17
"28923","6207雷科","110/07/09","永豐金-三重",31,0,31
"28924","6207雷科","110/07/09","日盛-和美",0,15,-15
"28925","6207雷科","110/07/09","新加坡商瑞銀",33,5,28
"28926","6207雷科","110/07/09","國泰-台南",0,15,-15
"28927","6207雷科","110/07/09","元大-高雄",26,0,26
"28928","6207雷科","110/07/09","華南永昌-古亭",0,14,-14
"28929","6207雷科","110/07/09","統一-員林",22,0,22
"28930","6207雷科","110/07/09","土銀-白河",0,11,-11
"28931","6207雷科","110/07/09","台新-高雄",22,0,22
"28932","6207雷科","110/07/09","日盛-台南",0,10,-10
"28933","6207雷科","110/07/09","摩根大通",34,17,17
"28934","6207雷科","110/07/09","元富-林園",0,10,-10
"28935","6207雷科","110/07/09","元大-博愛",17,1,16
"28936","6207雷科","110/07/09","富邦-園區",0,10,-10
"28937","6207雷科","110/07/09","日茂-埔里",12,0,12
"28938","6207雷科","110/07/09","元大-上新莊",0,10,-10
"28939","6207雷科","110/07/09","國泰-台中",17,6,11
"28940","6207雷科","110/07/09","永豐金-南京",0,10,-10
"28941","6207雷科","110/07/09","富邦-三重",10,0,10
"28942","6207雷科","110/07/09","兆豐-小港",0,6,-6
"28943","6207雷科","110/07/09","元大-沙鹿",10,0,10
"28944","6207雷科","110/07/09","富邦-羅東",1,7,-6
"28945","6207雷科","110/07/09","元大-八德",10,0,10
"28946","6207雷科","110/07/09","元大-土城永寧",0,6,-6
"28947","6207雷科","110/07/09","第一金-路竹",11,2,9
"28948","6207雷科","110/07/09","永豐金-板盛",0,6,-6
"28949","6207雷科","110/07/09","統一-南京",5,0,5
"28950","6207雷科","110/07/09","日盛-板橋",0,5,-5
"28951","3679新至陞","110/07/09","元大-大天母",10,0,10
"28952","3679新至陞","110/07/09","第一金-光復",0,11,-11
"28953","3679新至陞","110/07/09","日盛-樹林",9,0,9
"28954","3679新至陞","110/07/09","瑞士信貸",0,8,-8
"28955","3679新至陞","110/07/09","凱基-台北",11,2,9
"28956","3679新至陞","110/07/09","大慶-苗栗",0,5,-5
"28957","3679新至陞","110/07/09","華南永昌-小港",8,0,8
"28958","3679新至陞","110/07/09","元大-永春",0,5,-5
"28959","3679新至陞","110/07/09","兆豐-來福",7,0,7
"28960","3679新至陞","110/07/09","日盛-和美",0,4,-4
"28961","3679新至陞","110/07/09","香港上海匯豐",5,0,5
"28962","3679新至陞","110/07/09","元大-雙和",0,3,-3
"28963","3679新至陞","110/07/09","台中銀-員林",3,0,3
"28964","3679新至陞","110/07/09","永豐金-屏東",0,3,-3
"28965","3679新至陞","110/07/09","新光",3,0,3
"28966","3679新至陞","110/07/09","彰銀",0,2,-2
"28967","3679新至陞","110/07/09","土銀-花蓮",2,0,2
"28968","3679新至陞","110/07/09","宏遠-館前",0,2,-2
"28969","3679新至陞","110/07/09","第一金-澎湖",2,0,2
"28970","3679新至陞","110/07/09","港商野村",0,2,-2
"28971","3679新至陞","110/07/09","摩根大通",2,0,2
"28972","3679新至陞","110/07/09","大昌-新店",0,2,-2
"28973","3679新至陞","110/07/09","國泰-敦南",2,0,2
"28974","3679新至陞","110/07/09","元大-新莊",0,2,-2
"28975","3679新至陞","110/07/09","元大-淡水",4,2,2
"28976","3679新至陞","110/07/09","元大-板橋",0,2,-2
"28977","3679新至陞","110/07/09","日盛-士林",1,0,1
"28978","3679新至陞","110/07/09","台灣摩根士丹利",0,1,-1
"28979","3679新至陞","110/07/09","日盛-信義",1,0,1
"28980","3679新至陞","110/07/09","第一金-高雄",0,1,-1
"28981","2727王品","110/07/09","台灣匯立證券",90,0,90
"28982","2727王品","110/07/09","台灣摩根士丹利",0,267,-267
"28983","2727王品","110/07/09","國泰-敦南",166,84,82
"28984","2727王品","110/07/09","富邦-台北",35,299,-264
"28985","2727王品","110/07/09","富邦-仁愛",56,12,44
"28986","2727王品","110/07/09","凱基-台北",174,296,-122
"28987","2727王品","110/07/09","台新證券",109,66,43
"28988","2727王品","110/07/09","第一金",2,102,-100
"28989","2727王品","110/07/09","新光",117,87,30
"28990","2727王品","110/07/09","群益金鼎-大安",0,80,-80
"28991","2727王品","110/07/09","臺銀-臺中",35,6,29
"28992","2727王品","110/07/09","兆豐-大安",7,60,-53
"28993","2727王品","110/07/09","元大-桃園",32,3,29
"28994","2727王品","110/07/09","永豐金-南投",0,50,-50
"28995","2727王品","110/07/09","元富-宜蘭",34,6,28
"28996","2727王品","110/07/09","新加坡商瑞銀",6,46,-40
"28997","2727王品","110/07/09","玉山-台中",34,8,26
"28998","2727王品","110/07/09","合庫-彰化",11,50,-39
"28999","2727王品","110/07/09","群益金鼎-宜蘭",30,4,26
"29000","2727王品","110/07/09","永豐金-萬盛",13,52,-39
"29001","2727王品","110/07/09","富邦-台中",42,16,26
"29002","2727王品","110/07/09","瑞士信貸",0,34,-34
"29003","2727王品","110/07/09","第一金-豐原",25,1,24
"29004","2727王品","110/07/09","元大-和平",4,35,-31
"29005","2727王品","110/07/09","臺銀",30,8,22
"29006","2727王品","110/07/09","美林",14,44,-30
"29007","2727王品","110/07/09","兆豐-來福",23,1,22
"29008","2727王品","110/07/09","元大-員林",9,38,-29
"29009","2727王品","110/07/09","玉山-士林",22,2,20
"29010","2727王品","110/07/09","元富-西松",4,31,-27
"29011","1570力肯","110/07/09","凱基-台北",30,1,29
"29012","1570力肯","110/07/09","群益金鼎-彰化",0,20,-20
"29013","1570力肯","110/07/09","新光-台南",20,0,20
"29014","1570力肯","110/07/09","元大-土城學府",0,20,-20
"29015","1570力肯","110/07/09","元大-高雄",20,0,20
"29016","1570力肯","110/07/09","元大-大統",0,16,-16
"29017","1570力肯","110/07/09","國票-中正",12,0,12
"29018","1570力肯","110/07/09","元大-新營",0,11,-11
"29019","1570力肯","110/07/09","日盛-高雄",6,0,6
"29020","1570力肯","110/07/09","元大-和平",0,10,-10
"29021","1570力肯","110/07/09","元富-緯城",6,0,6
"29022","1570力肯","110/07/09","元大-草屯",0,10,-10
"29023","1570力肯","110/07/09","群益金鼎-台南",6,0,6
"29024","1570力肯","110/07/09","元大-鹿港",0,9,-9
"29025","1570力肯","110/07/09","華南永昌-岡山",6,0,6
"29026","1570力肯","110/07/09","合庫-基隆",0,7,-7
"29027","1570力肯","110/07/09","統一-中壢",5,0,5
"29028","1570力肯","110/07/09","摩根大通",2,8,-6
"29029","1570力肯","110/07/09","凱基-三峽",5,0,5
"29030","1570力肯","110/07/09","台灣企銀-豐原",0,4,-4
"29031","1570力肯","110/07/09","大昌-樹林",4,0,4
"29032","1570力肯","110/07/09","日盛-桃園",0,4,-4
"29033","1570力肯","110/07/09","新光",3,0,3
"29034","1570力肯","110/07/09","國泰-高雄",0,3,-3
"29035","1570力肯","110/07/09","富邦-新竹華信",3,0,3
"29036","1570力肯","110/07/09","永豐金-敦南",0,3,-3
"29037","1570力肯","110/07/09","合庫-台中",2,0,2
"29038","1570力肯","110/07/09","土銀-彰化",0,2,-2
"29039","1570力肯","110/07/09","臺銀-臺中",2,0,2
"29040","1570力肯","110/07/09","臺銀-鳳山",0,2,-2
"29041","6180橘子","110/07/09","摩根大通",63,1,62
"29042","6180橘子","110/07/09","元大-南京",1,32,-31
"29043","6180橘子","110/07/09","富邦-陽明",73,33,40
"29044","6180橘子","110/07/09","群益金鼎-台北",0,25,-25
"29045","6180橘子","110/07/09","新加坡商瑞銀",31,0,31
"29046","6180橘子","110/07/09","兆豐-復興",0,21,-21
"29047","6180橘子","110/07/09","美商高盛",25,0,25
"29048","6180橘子","110/07/09","永豐金-嘉義",0,21,-21
"29049","6180橘子","110/07/09","凱基-台北",26,10,16
"29050","6180橘子","110/07/09","凱基-中壢",8,24,-16
"29051","6180橘子","110/07/09","華南永昌-楠梓",13,0,13
"29052","6180橘子","110/07/09","致和-崇德",0,15,-15
"29053","6180橘子","110/07/09","華南永昌-朴子",11,0,11
"29054","6180橘子","110/07/09","群益金鼎-屏東",0,15,-15
"29055","6180橘子","110/07/09","元大-北港",11,0,11
"29056","6180橘子","110/07/09","群益金鼎-中山",0,15,-15
"29057","6180橘子","110/07/09","元大-成功",10,1,9
"29058","6180橘子","110/07/09","瑞士信貸",1,15,-14
"29059","6180橘子","110/07/09","新光",26,18,8
"29060","6180橘子","110/07/09","日盛-二林",0,10,-10
"29061","6180橘子","110/07/09","統一-三重",6,0,6
"29062","6180橘子","110/07/09","凱基-東門",0,10,-10
"29063","6180橘子","110/07/09","群益金鼎-嘉義",6,0,6
"29064","6180橘子","110/07/09","華南永昌-三重",0,10,-10
"29065","6180橘子","110/07/09","元大-員林中山",6,0,6
"29066","6180橘子","110/07/09","元大-彰化民生",1,11,-10
"29067","6180橘子","110/07/09","合庫-鳳山",5,0,5
"29068","6180橘子","110/07/09","永豐金-新店",1,11,-10
"29069","6180橘子","110/07/09","富邦-建國",6,1,5
"29070","6180橘子","110/07/09","群益金鼎-丹鳳",0,8,-8
"29071","2390云辰","110/07/09","摩根大通",279,56,223
"29072","2390云辰","110/07/09","元大-天母",0,127,-127
"29073","2390云辰","110/07/09","日盛-鳳山",110,2,108
"29074","2390云辰","110/07/09","中國信託-文心",5,109,-104
"29075","2390云辰","110/07/09","宏遠證券",100,0,100
"29076","2390云辰","110/07/09","永豐金-復興",0,55,-55
"29077","2390云辰","110/07/09","元大-大里",63,6,57
"29078","2390云辰","110/07/09","凱基-台北",239,286,-47
"29079","2390云辰","110/07/09","凱基-八德",59,10,49
"29080","2390云辰","110/07/09","德信",2,32,-30
"29081","2390云辰","110/07/09","合庫-新竹",40,0,40
"29082","2390云辰","110/07/09","兆豐-桃鶯",2,32,-30
"29083","2390云辰","110/07/09","國票",40,1,39
"29084","2390云辰","110/07/09","致和-南京",0,30,-30
"29085","2390云辰","110/07/09","新加坡商瑞銀",49,13,36
"29086","2390云辰","110/07/09","富邦-虎尾",1,31,-30
"29087","2390云辰","110/07/09","統一-新台中",36,2,34
"29088","2390云辰","110/07/09","元大-善化",2,31,-29
"29089","2390云辰","110/07/09","國票-嘉義",31,0,31
"29090","2390云辰","110/07/09","富邦-板橋",0,27,-27
"29091","2390云辰","110/07/09","華南永昌",35,7,28
"29092","2390云辰","110/07/09","富邦-永和",3,28,-25
"29093","2390云辰","110/07/09","玉山-台中",49,22,27
"29094","2390云辰","110/07/09","第一金-自由",20,44,-24
"29095","2390云辰","110/07/09","華南永昌-敦南",25,0,25
"29096","2390云辰","110/07/09","凱基-內湖",0,24,-24
"29097","2390云辰","110/07/09","新光-高雄",27,4,23
"29098","2390云辰","110/07/09","元大-汐止",1,24,-23
"29099","2390云辰","110/07/09","台灣摩根士丹利",85,63,22
"29100","2390云辰","110/07/09","新光-台中",12,33,-21
"29101","4903聯光通","110/07/09","元大-敦南",10,0,10
"29102","4903聯光通","110/07/09","第一金-台中",0,12,-12
"29103","4903聯光通","110/07/09","凱基-士林",5,0,5
"29104","4903聯光通","110/07/09","日盛-忠孝",0,3,-3
"29105","4903聯光通","110/07/09","元大-苗栗",5,0,5
"29106","4903聯光通","110/07/09","群益金鼎-崇德",0,3,-3
"29107","4903聯光通","110/07/09","元大-屏南",3,0,3
"29108","4903聯光通","110/07/09","國票-內壢",0,2,-2
"29109","4903聯光通","110/07/09","中國信託-永康",1,0,1
"29110","4903聯光通","110/07/09","康和-南崁",0,2,-2
"29111","4903聯光通","110/07/09","玉山證券",1,0,1
"29112","4903聯光通","110/07/09","新光-台中",0,2,-2
"29113","4903聯光通","110/07/09","元大-太平",4,3,1
"29114","4903聯光通","110/07/09","玉山-城中",0,2,-2
"29115","4903聯光通","110/07/09","永豐金-嘉義",1,0,1
"29116","4903聯光通","110/07/09","中國信託-文心",0,1,-1
"29117","4903聯光通","110/07/09","大昌",0,0,0
"29118","4903聯光通","110/07/09","大昌",0,0,0
"29119","4903聯光通","110/07/09","中農",0,0,0
"29120","4903聯光通","110/07/09","中農",0,0,0
"29121","4903聯光通","110/07/09","",NA,NA,NA
"29122","4903聯光通","110/07/09","",NA,NA,NA
"29123","4903聯光通","110/07/09","",NA,NA,NA
"29124","4903聯光通","110/07/09","",NA,NA,NA
"29125","4903聯光通","110/07/09","",NA,NA,NA
"29126","4903聯光通","110/07/09","",NA,NA,NA
"29127","4903聯光通","110/07/09","",NA,NA,NA
"29128","4903聯光通","110/07/09","",NA,NA,NA
"29129","4903聯光通","110/07/09","",NA,NA,NA
"29130","4903聯光通","110/07/09","",NA,NA,NA
"29131","2929淘帝","110/07/09","台中銀-台北",110,0,110
"29132","2929淘帝","110/07/09","新光",2,82,-80
"29133","2929淘帝","110/07/09","華南永昌-頭份",72,0,72
"29134","2929淘帝","110/07/09","摩根大通",2,63,-61
"29135","2929淘帝","110/07/09","合庫-高雄",71,0,71
"29136","2929淘帝","110/07/09","第一金-路竹",0,50,-50
"29137","2929淘帝","110/07/09","高橋-龍潭",37,0,37
"29138","2929淘帝","110/07/09","港商麥格理",0,42,-42
"29139","2929淘帝","110/07/09","新光-台中",60,26,34
"29140","2929淘帝","110/07/09","陽信-石牌",0,40,-40
"29141","2929淘帝","110/07/09","元富-大裕",22,1,21
"29142","2929淘帝","110/07/09","台新-左楠",1,39,-38
"29143","2929淘帝","110/07/09","合庫-鳳山",20,0,20
"29144","2929淘帝","110/07/09","凱基-桃園",3,29,-26
"29145","2929淘帝","110/07/09","元大-員林",22,2,20
"29146","2929淘帝","110/07/09","兆豐-內湖",0,25,-25
"29147","2929淘帝","110/07/09","台新-建北",15,0,15
"29148","2929淘帝","110/07/09","元大-北港",0,20,-20
"29149","2929淘帝","110/07/09","兆豐-桃園",13,0,13
"29150","2929淘帝","110/07/09","富邦-北港",0,19,-19
"29151","2929淘帝","110/07/09","兆豐-忠孝",10,0,10
"29152","2929淘帝","110/07/09","富邦-花蓮",0,17,-17
"29153","2929淘帝","110/07/09","國票-敦北法人",10,0,10
"29154","2929淘帝","110/07/09","國泰-台中",2,17,-15
"29155","2929淘帝","110/07/09","永豐金-博愛",10,0,10
"29156","2929淘帝","110/07/09","群益金鼎-彰化",0,15,-15
"29157","2929淘帝","110/07/09","群益金鼎-潭子",8,0,8
"29158","2929淘帝","110/07/09","元大-博愛",0,14,-14
"29159","2929淘帝","110/07/09","富邦-南屯",8,0,8
"29160","2929淘帝","110/07/09","日盛-板橋",0,13,-13
"29161","5410國眾","110/07/09","元大-新盛",14,0,14
"29162","5410國眾","110/07/09","(牛牛牛)亞-鑫豐",1,41,-40
"29163","5410國眾","110/07/09","台灣企銀-民雄",10,0,10
"29164","5410國眾","110/07/09","元富-嘉義",0,25,-25
"29165","5410國眾","110/07/09","元富-虎尾",9,0,9
"29166","5410國眾","110/07/09","凱基-高美館",0,10,-10
"29167","5410國眾","110/07/09","摩根大通",10,1,9
"29168","5410國眾","110/07/09","凱基-城中",0,10,-10
"29169","5410國眾","110/07/09","兆豐-北高雄",7,0,7
"29170","5410國眾","110/07/09","元大-頭份",0,10,-10
"29171","5410國眾","110/07/09","凱基-台北",8,1,7
"29172","5410國眾","110/07/09","群益金鼎-丹鳳",0,7,-7
"29173","5410國眾","110/07/09","華南永昌-公誠",7,0,7
"29174","5410國眾","110/07/09","凱基-復興",0,7,-7
"29175","5410國眾","110/07/09","香港上海匯豐",6,0,6
"29176","5410國眾","110/07/09","元大-員林",0,7,-7
"29177","5410國眾","110/07/09","凱基-中壢",6,0,6
"29178","5410國眾","110/07/09","富邦-竹東",0,6,-6
"29179","5410國眾","110/07/09","華南永昌-南京",6,0,6
"29180","5410國眾","110/07/09","亞東-高雄",0,5,-5
"29181","5410國眾","110/07/09","統一-三重",5,0,5
"29182","5410國眾","110/07/09","大慶-中壢",1,6,-5
"29183","5410國眾","110/07/09","富邦-宜蘭",5,0,5
"29184","5410國眾","110/07/09","群益金鼎-中港",0,5,-5
"29185","5410國眾","110/07/09","元大-崇德",5,0,5
"29186","5410國眾","110/07/09","元大-八德",0,5,-5
"29187","5410國眾","110/07/09","元大-博愛",5,0,5
"29188","5410國眾","110/07/09","富邦-基隆",0,4,-4
"29189","5410國眾","110/07/09","元大-龍潭",5,0,5
"29190","5410國眾","110/07/09","臺銀-新竹",0,3,-3
"29191","2841台開","110/07/09","日盛-雙和",102,0,102
"29192","2841台開","110/07/09","港商野村",0,129,-129
"29193","2841台開","110/07/09","元大-館前",70,0,70
"29194","2841台開","110/07/09","兆豐-永和",0,100,-100
"29195","2841台開","110/07/09","凱基-文心",50,0,50
"29196","2841台開","110/07/09","台新證券",7,28,-21
"29197","2841台開","110/07/09","富邦-嘉義",40,0,40
"29198","2841台開","110/07/09","國票-北高雄",0,20,-20
"29199","2841台開","110/07/09","美商高盛",15,0,15
"29200","2841台開","110/07/09","永豐金-敦南",29,46,-17
"29201","2841台開","110/07/09","台中銀",15,0,15
"29202","2841台開","110/07/09","合庫-基隆",0,12,-12
"29203","2841台開","110/07/09","新光",11,0,11
"29204","2841台開","110/07/09","中國信託-松江",0,12,-12
"29205","2841台開","110/07/09","華南永昌-長虹",10,0,10
"29206","2841台開","110/07/09","兆豐-城中",0,12,-12
"29207","2841台開","110/07/09","永豐金-南投",10,0,10
"29208","2841台開","110/07/09","台中銀-豐原",0,10,-10
"29209","2841台開","110/07/09","合庫-桃園",7,0,7
"29210","2841台開","110/07/09","兆豐-景美",0,10,-10
"29211","2841台開","110/07/09","群益金鼎-古亭",7,0,7
"29212","2841台開","110/07/09","群益金鼎-基隆",0,10,-10
"29213","2841台開","110/07/09","國泰-敦南",6,0,6
"29214","2841台開","110/07/09","元大-北三重",0,10,-10
"29215","2841台開","110/07/09","凱基-桃園",8,2,6
"29216","2841台開","110/07/09","(牛牛牛)亞-網路",0,9,-9
"29217","2841台開","110/07/09","日盛證券",5,0,5
"29218","2841台開","110/07/09","台新-高雄",1,10,-9
"29219","2841台開","110/07/09","元富-文心",5,0,5
"29220","2841台開","110/07/09","凱基-台北",0,7,-7
"29221","6207雷科","110/07/09","群益金鼎-新竹",47,0,47
"29222","6207雷科","110/07/09","新光",7,24,-17
"29223","6207雷科","110/07/09","永豐金-三重",31,0,31
"29224","6207雷科","110/07/09","日盛-和美",0,15,-15
"29225","6207雷科","110/07/09","新加坡商瑞銀",33,5,28
"29226","6207雷科","110/07/09","國泰-台南",0,15,-15
"29227","6207雷科","110/07/09","元大-高雄",26,0,26
"29228","6207雷科","110/07/09","華南永昌-古亭",0,14,-14
"29229","6207雷科","110/07/09","統一-員林",22,0,22
"29230","6207雷科","110/07/09","土銀-白河",0,11,-11
"29231","6207雷科","110/07/09","台新-高雄",22,0,22
"29232","6207雷科","110/07/09","日盛-台南",0,10,-10
"29233","6207雷科","110/07/09","摩根大通",34,17,17
"29234","6207雷科","110/07/09","元富-林園",0,10,-10
"29235","6207雷科","110/07/09","元大-博愛",17,1,16
"29236","6207雷科","110/07/09","富邦-園區",0,10,-10
"29237","6207雷科","110/07/09","日茂-埔里",12,0,12
"29238","6207雷科","110/07/09","元大-上新莊",0,10,-10
"29239","6207雷科","110/07/09","國泰-台中",17,6,11
"29240","6207雷科","110/07/09","永豐金-南京",0,10,-10
"29241","6207雷科","110/07/09","富邦-三重",10,0,10
"29242","6207雷科","110/07/09","兆豐-小港",0,6,-6
"29243","6207雷科","110/07/09","元大-沙鹿",10,0,10
"29244","6207雷科","110/07/09","富邦-羅東",1,7,-6
"29245","6207雷科","110/07/09","元大-八德",10,0,10
"29246","6207雷科","110/07/09","元大-土城永寧",0,6,-6
"29247","6207雷科","110/07/09","第一金-路竹",11,2,9
"29248","6207雷科","110/07/09","永豐金-板盛",0,6,-6
"29249","6207雷科","110/07/09","統一-南京",5,0,5
"29250","6207雷科","110/07/09","日盛-板橋",0,5,-5
"29251","3679新至陞","110/07/09","元大-大天母",10,0,10
"29252","3679新至陞","110/07/09","第一金-光復",0,11,-11
"29253","3679新至陞","110/07/09","日盛-樹林",9,0,9
"29254","3679新至陞","110/07/09","瑞士信貸",0,8,-8
"29255","3679新至陞","110/07/09","凱基-台北",11,2,9
"29256","3679新至陞","110/07/09","大慶-苗栗",0,5,-5
"29257","3679新至陞","110/07/09","華南永昌-小港",8,0,8
"29258","3679新至陞","110/07/09","元大-永春",0,5,-5
"29259","3679新至陞","110/07/09","兆豐-來福",7,0,7
"29260","3679新至陞","110/07/09","日盛-和美",0,4,-4
"29261","3679新至陞","110/07/09","香港上海匯豐",5,0,5
"29262","3679新至陞","110/07/09","元大-雙和",0,3,-3
"29263","3679新至陞","110/07/09","台中銀-員林",3,0,3
"29264","3679新至陞","110/07/09","永豐金-屏東",0,3,-3
"29265","3679新至陞","110/07/09","新光",3,0,3
"29266","3679新至陞","110/07/09","彰銀",0,2,-2
"29267","3679新至陞","110/07/09","土銀-花蓮",2,0,2
"29268","3679新至陞","110/07/09","宏遠-館前",0,2,-2
"29269","3679新至陞","110/07/09","第一金-澎湖",2,0,2
"29270","3679新至陞","110/07/09","港商野村",0,2,-2
"29271","3679新至陞","110/07/09","摩根大通",2,0,2
"29272","3679新至陞","110/07/09","大昌-新店",0,2,-2
"29273","3679新至陞","110/07/09","國泰-敦南",2,0,2
"29274","3679新至陞","110/07/09","元大-新莊",0,2,-2
"29275","3679新至陞","110/07/09","元大-淡水",4,2,2
"29276","3679新至陞","110/07/09","元大-板橋",0,2,-2
"29277","3679新至陞","110/07/09","日盛-士林",1,0,1
"29278","3679新至陞","110/07/09","台灣摩根士丹利",0,1,-1
"29279","3679新至陞","110/07/09","日盛-信義",1,0,1
"29280","3679新至陞","110/07/09","第一金-高雄",0,1,-1
"29281","2727王品","110/07/09","台灣匯立證券",90,0,90
"29282","2727王品","110/07/09","台灣摩根士丹利",0,267,-267
"29283","2727王品","110/07/09","國泰-敦南",166,84,82
"29284","2727王品","110/07/09","富邦-台北",35,299,-264
"29285","2727王品","110/07/09","富邦-仁愛",56,12,44
"29286","2727王品","110/07/09","凱基-台北",174,296,-122
"29287","2727王品","110/07/09","台新證券",109,66,43
"29288","2727王品","110/07/09","第一金",2,102,-100
"29289","2727王品","110/07/09","新光",117,87,30
"29290","2727王品","110/07/09","群益金鼎-大安",0,80,-80
"29291","2727王品","110/07/09","臺銀-臺中",35,6,29
"29292","2727王品","110/07/09","兆豐-大安",7,60,-53
"29293","2727王品","110/07/09","元大-桃園",32,3,29
"29294","2727王品","110/07/09","永豐金-南投",0,50,-50
"29295","2727王品","110/07/09","元富-宜蘭",34,6,28
"29296","2727王品","110/07/09","新加坡商瑞銀",6,46,-40
"29297","2727王品","110/07/09","玉山-台中",34,8,26
"29298","2727王品","110/07/09","合庫-彰化",11,50,-39
"29299","2727王品","110/07/09","群益金鼎-宜蘭",30,4,26
"29300","2727王品","110/07/09","永豐金-萬盛",13,52,-39
"29301","2727王品","110/07/09","富邦-台中",42,16,26
"29302","2727王品","110/07/09","瑞士信貸",0,34,-34
"29303","2727王品","110/07/09","第一金-豐原",25,1,24
"29304","2727王品","110/07/09","元大-和平",4,35,-31
"29305","2727王品","110/07/09","臺銀",30,8,22
"29306","2727王品","110/07/09","美林",14,44,-30
"29307","2727王品","110/07/09","兆豐-來福",23,1,22
"29308","2727王品","110/07/09","元大-員林",9,38,-29
"29309","2727王品","110/07/09","玉山-士林",22,2,20
"29310","2727王品","110/07/09","元富-西松",4,31,-27
"29311","1570力肯","110/07/09","凱基-台北",30,1,29
"29312","1570力肯","110/07/09","群益金鼎-彰化",0,20,-20
"29313","1570力肯","110/07/09","新光-台南",20,0,20
"29314","1570力肯","110/07/09","元大-土城學府",0,20,-20
"29315","1570力肯","110/07/09","元大-高雄",20,0,20
"29316","1570力肯","110/07/09","元大-大統",0,16,-16
"29317","1570力肯","110/07/09","國票-中正",12,0,12
"29318","1570力肯","110/07/09","元大-新營",0,11,-11
"29319","1570力肯","110/07/09","日盛-高雄",6,0,6
"29320","1570力肯","110/07/09","元大-和平",0,10,-10
"29321","1570力肯","110/07/09","元富-緯城",6,0,6
"29322","1570力肯","110/07/09","元大-草屯",0,10,-10
"29323","1570力肯","110/07/09","群益金鼎-台南",6,0,6
"29324","1570力肯","110/07/09","元大-鹿港",0,9,-9
"29325","1570力肯","110/07/09","華南永昌-岡山",6,0,6
"29326","1570力肯","110/07/09","合庫-基隆",0,7,-7
"29327","1570力肯","110/07/09","統一-中壢",5,0,5
"29328","1570力肯","110/07/09","摩根大通",2,8,-6
"29329","1570力肯","110/07/09","凱基-三峽",5,0,5
"29330","1570力肯","110/07/09","台灣企銀-豐原",0,4,-4
"29331","1570力肯","110/07/09","大昌-樹林",4,0,4
"29332","1570力肯","110/07/09","日盛-桃園",0,4,-4
"29333","1570力肯","110/07/09","新光",3,0,3
"29334","1570力肯","110/07/09","國泰-高雄",0,3,-3
"29335","1570力肯","110/07/09","富邦-新竹華信",3,0,3
"29336","1570力肯","110/07/09","永豐金-敦南",0,3,-3
"29337","1570力肯","110/07/09","合庫-台中",2,0,2
"29338","1570力肯","110/07/09","土銀-彰化",0,2,-2
"29339","1570力肯","110/07/09","臺銀-臺中",2,0,2
"29340","1570力肯","110/07/09","臺銀-鳳山",0,2,-2
"29341","6180橘子","110/07/09","摩根大通",63,1,62
"29342","6180橘子","110/07/09","元大-南京",1,32,-31
"29343","6180橘子","110/07/09","富邦-陽明",73,33,40
"29344","6180橘子","110/07/09","群益金鼎-台北",0,25,-25
"29345","6180橘子","110/07/09","新加坡商瑞銀",31,0,31
"29346","6180橘子","110/07/09","兆豐-復興",0,21,-21
"29347","6180橘子","110/07/09","美商高盛",25,0,25
"29348","6180橘子","110/07/09","永豐金-嘉義",0,21,-21
"29349","6180橘子","110/07/09","凱基-台北",26,10,16
"29350","6180橘子","110/07/09","凱基-中壢",8,24,-16
"29351","6180橘子","110/07/09","華南永昌-楠梓",13,0,13
"29352","6180橘子","110/07/09","致和-崇德",0,15,-15
"29353","6180橘子","110/07/09","華南永昌-朴子",11,0,11
"29354","6180橘子","110/07/09","群益金鼎-屏東",0,15,-15
"29355","6180橘子","110/07/09","元大-北港",11,0,11
"29356","6180橘子","110/07/09","群益金鼎-中山",0,15,-15
"29357","6180橘子","110/07/09","元大-成功",10,1,9
"29358","6180橘子","110/07/09","瑞士信貸",1,15,-14
"29359","6180橘子","110/07/09","新光",26,18,8
"29360","6180橘子","110/07/09","日盛-二林",0,10,-10
"29361","6180橘子","110/07/09","統一-三重",6,0,6
"29362","6180橘子","110/07/09","凱基-東門",0,10,-10
"29363","6180橘子","110/07/09","群益金鼎-嘉義",6,0,6
"29364","6180橘子","110/07/09","華南永昌-三重",0,10,-10
"29365","6180橘子","110/07/09","元大-員林中山",6,0,6
"29366","6180橘子","110/07/09","元大-彰化民生",1,11,-10
"29367","6180橘子","110/07/09","合庫-鳳山",5,0,5
"29368","6180橘子","110/07/09","永豐金-新店",1,11,-10
"29369","6180橘子","110/07/09","富邦-建國",6,1,5
"29370","6180橘子","110/07/09","群益金鼎-丹鳳",0,8,-8
"29371","2390云辰","110/07/09","摩根大通",279,56,223
"29372","2390云辰","110/07/09","元大-天母",0,127,-127
"29373","2390云辰","110/07/09","日盛-鳳山",110,2,108
"29374","2390云辰","110/07/09","中國信託-文心",5,109,-104
"29375","2390云辰","110/07/09","宏遠證券",100,0,100
"29376","2390云辰","110/07/09","永豐金-復興",0,55,-55
"29377","2390云辰","110/07/09","元大-大里",63,6,57
"29378","2390云辰","110/07/09","凱基-台北",239,286,-47
"29379","2390云辰","110/07/09","凱基-八德",59,10,49
"29380","2390云辰","110/07/09","德信",2,32,-30
"29381","2390云辰","110/07/09","合庫-新竹",40,0,40
"29382","2390云辰","110/07/09","兆豐-桃鶯",2,32,-30
"29383","2390云辰","110/07/09","國票",40,1,39
"29384","2390云辰","110/07/09","致和-南京",0,30,-30
"29385","2390云辰","110/07/09","新加坡商瑞銀",49,13,36
"29386","2390云辰","110/07/09","富邦-虎尾",1,31,-30
"29387","2390云辰","110/07/09","統一-新台中",36,2,34
"29388","2390云辰","110/07/09","元大-善化",2,31,-29
"29389","2390云辰","110/07/09","國票-嘉義",31,0,31
"29390","2390云辰","110/07/09","富邦-板橋",0,27,-27
"29391","2390云辰","110/07/09","華南永昌",35,7,28
"29392","2390云辰","110/07/09","富邦-永和",3,28,-25
"29393","2390云辰","110/07/09","玉山-台中",49,22,27
"29394","2390云辰","110/07/09","第一金-自由",20,44,-24
"29395","2390云辰","110/07/09","華南永昌-敦南",25,0,25
"29396","2390云辰","110/07/09","凱基-內湖",0,24,-24
"29397","2390云辰","110/07/09","新光-高雄",27,4,23
"29398","2390云辰","110/07/09","元大-汐止",1,24,-23
"29399","2390云辰","110/07/09","台灣摩根士丹利",85,63,22
"29400","2390云辰","110/07/09","新光-台中",12,33,-21
"29401","4903聯光通","110/07/09","元大-敦南",10,0,10
"29402","4903聯光通","110/07/09","第一金-台中",0,12,-12
"29403","4903聯光通","110/07/09","凱基-士林",5,0,5
"29404","4903聯光通","110/07/09","日盛-忠孝",0,3,-3
"29405","4903聯光通","110/07/09","元大-苗栗",5,0,5
"29406","4903聯光通","110/07/09","群益金鼎-崇德",0,3,-3
"29407","4903聯光通","110/07/09","元大-屏南",3,0,3
"29408","4903聯光通","110/07/09","國票-內壢",0,2,-2
"29409","4903聯光通","110/07/09","中國信託-永康",1,0,1
"29410","4903聯光通","110/07/09","康和-南崁",0,2,-2
"29411","4903聯光通","110/07/09","玉山證券",1,0,1
"29412","4903聯光通","110/07/09","新光-台中",0,2,-2
"29413","4903聯光通","110/07/09","元大-太平",4,3,1
"29414","4903聯光通","110/07/09","玉山-城中",0,2,-2
"29415","4903聯光通","110/07/09","永豐金-嘉義",1,0,1
"29416","4903聯光通","110/07/09","中國信託-文心",0,1,-1
"29417","4903聯光通","110/07/09","大昌",0,0,0
"29418","4903聯光通","110/07/09","大昌",0,0,0
"29419","4903聯光通","110/07/09","中農",0,0,0
"29420","4903聯光通","110/07/09","中農",0,0,0
"29421","4903聯光通","110/07/09","",NA,NA,NA
"29422","4903聯光通","110/07/09","",NA,NA,NA
"29423","4903聯光通","110/07/09","",NA,NA,NA
"29424","4903聯光通","110/07/09","",NA,NA,NA
"29425","4903聯光通","110/07/09","",NA,NA,NA
"29426","4903聯光通","110/07/09","",NA,NA,NA
"29427","4903聯光通","110/07/09","",NA,NA,NA
"29428","4903聯光通","110/07/09","",NA,NA,NA
"29429","4903聯光通","110/07/09","",NA,NA,NA
"29430","4903聯光通","110/07/09","",NA,NA,NA
"29431","2929淘帝","110/07/09","台中銀-台北",110,0,110
"29432","2929淘帝","110/07/09","新光",2,82,-80
"29433","2929淘帝","110/07/09","華南永昌-頭份",72,0,72
"29434","2929淘帝","110/07/09","摩根大通",2,63,-61
"29435","2929淘帝","110/07/09","合庫-高雄",71,0,71
"29436","2929淘帝","110/07/09","第一金-路竹",0,50,-50
"29437","2929淘帝","110/07/09","高橋-龍潭",37,0,37
"29438","2929淘帝","110/07/09","港商麥格理",0,42,-42
"29439","2929淘帝","110/07/09","新光-台中",60,26,34
"29440","2929淘帝","110/07/09","陽信-石牌",0,40,-40
"29441","2929淘帝","110/07/09","元富-大裕",22,1,21
"29442","2929淘帝","110/07/09","台新-左楠",1,39,-38
"29443","2929淘帝","110/07/09","合庫-鳳山",20,0,20
"29444","2929淘帝","110/07/09","凱基-桃園",3,29,-26
"29445","2929淘帝","110/07/09","元大-員林",22,2,20
"29446","2929淘帝","110/07/09","兆豐-內湖",0,25,-25
"29447","2929淘帝","110/07/09","台新-建北",15,0,15
"29448","2929淘帝","110/07/09","元大-北港",0,20,-20
"29449","2929淘帝","110/07/09","兆豐-桃園",13,0,13
"29450","2929淘帝","110/07/09","富邦-北港",0,19,-19
"29451","2929淘帝","110/07/09","兆豐-忠孝",10,0,10
"29452","2929淘帝","110/07/09","富邦-花蓮",0,17,-17
"29453","2929淘帝","110/07/09","國票-敦北法人",10,0,10
"29454","2929淘帝","110/07/09","國泰-台中",2,17,-15
"29455","2929淘帝","110/07/09","永豐金-博愛",10,0,10
"29456","2929淘帝","110/07/09","群益金鼎-彰化",0,15,-15
"29457","2929淘帝","110/07/09","群益金鼎-潭子",8,0,8
"29458","2929淘帝","110/07/09","元大-博愛",0,14,-14
"29459","2929淘帝","110/07/09","富邦-南屯",8,0,8
"29460","2929淘帝","110/07/09","日盛-板橋",0,13,-13
"29461","5410國眾","110/07/09","元大-新盛",14,0,14
"29462","5410國眾","110/07/09","(牛牛牛)亞-鑫豐",1,41,-40
"29463","5410國眾","110/07/09","台灣企銀-民雄",10,0,10
"29464","5410國眾","110/07/09","元富-嘉義",0,25,-25
"29465","5410國眾","110/07/09","元富-虎尾",9,0,9
"29466","5410國眾","110/07/09","凱基-高美館",0,10,-10
"29467","5410國眾","110/07/09","摩根大通",10,1,9
"29468","5410國眾","110/07/09","凱基-城中",0,10,-10
"29469","5410國眾","110/07/09","兆豐-北高雄",7,0,7
"29470","5410國眾","110/07/09","元大-頭份",0,10,-10
"29471","5410國眾","110/07/09","凱基-台北",8,1,7
"29472","5410國眾","110/07/09","群益金鼎-丹鳳",0,7,-7
"29473","5410國眾","110/07/09","華南永昌-公誠",7,0,7
"29474","5410國眾","110/07/09","凱基-復興",0,7,-7
"29475","5410國眾","110/07/09","香港上海匯豐",6,0,6
"29476","5410國眾","110/07/09","元大-員林",0,7,-7
"29477","5410國眾","110/07/09","凱基-中壢",6,0,6
"29478","5410國眾","110/07/09","富邦-竹東",0,6,-6
"29479","5410國眾","110/07/09","華南永昌-南京",6,0,6
"29480","5410國眾","110/07/09","亞東-高雄",0,5,-5
"29481","5410國眾","110/07/09","統一-三重",5,0,5
"29482","5410國眾","110/07/09","大慶-中壢",1,6,-5
"29483","5410國眾","110/07/09","富邦-宜蘭",5,0,5
"29484","5410國眾","110/07/09","群益金鼎-中港",0,5,-5
"29485","5410國眾","110/07/09","元大-崇德",5,0,5
"29486","5410國眾","110/07/09","元大-八德",0,5,-5
"29487","5410國眾","110/07/09","元大-博愛",5,0,5
"29488","5410國眾","110/07/09","富邦-基隆",0,4,-4
"29489","5410國眾","110/07/09","元大-龍潭",5,0,5
"29490","5410國眾","110/07/09","臺銀-新竹",0,3,-3
"29491","2841台開","110/07/09","日盛-雙和",102,0,102
"29492","2841台開","110/07/09","港商野村",0,129,-129
"29493","2841台開","110/07/09","元大-館前",70,0,70
"29494","2841台開","110/07/09","兆豐-永和",0,100,-100
"29495","2841台開","110/07/09","凱基-文心",50,0,50
"29496","2841台開","110/07/09","台新證券",7,28,-21
"29497","2841台開","110/07/09","富邦-嘉義",40,0,40
"29498","2841台開","110/07/09","國票-北高雄",0,20,-20
"29499","2841台開","110/07/09","美商高盛",15,0,15
"29500","2841台開","110/07/09","永豐金-敦南",29,46,-17
"29501","2841台開","110/07/09","台中銀",15,0,15
"29502","2841台開","110/07/09","合庫-基隆",0,12,-12
"29503","2841台開","110/07/09","新光",11,0,11
"29504","2841台開","110/07/09","中國信託-松江",0,12,-12
"29505","2841台開","110/07/09","華南永昌-長虹",10,0,10
"29506","2841台開","110/07/09","兆豐-城中",0,12,-12
"29507","2841台開","110/07/09","永豐金-南投",10,0,10
"29508","2841台開","110/07/09","台中銀-豐原",0,10,-10
"29509","2841台開","110/07/09","合庫-桃園",7,0,7
"29510","2841台開","110/07/09","兆豐-景美",0,10,-10
"29511","2841台開","110/07/09","群益金鼎-古亭",7,0,7
"29512","2841台開","110/07/09","群益金鼎-基隆",0,10,-10
"29513","2841台開","110/07/09","國泰-敦南",6,0,6
"29514","2841台開","110/07/09","元大-北三重",0,10,-10
"29515","2841台開","110/07/09","凱基-桃園",8,2,6
"29516","2841台開","110/07/09","(牛牛牛)亞-網路",0,9,-9
"29517","2841台開","110/07/09","日盛證券",5,0,5
"29518","2841台開","110/07/09","台新-高雄",1,10,-9
"29519","2841台開","110/07/09","元富-文心",5,0,5
"29520","2841台開","110/07/09","凱基-台北",0,7,-7
"29521","6207雷科","110/07/09","群益金鼎-新竹",47,0,47
"29522","6207雷科","110/07/09","新光",7,24,-17
"29523","6207雷科","110/07/09","永豐金-三重",31,0,31
"29524","6207雷科","110/07/09","日盛-和美",0,15,-15
"29525","6207雷科","110/07/09","新加坡商瑞銀",33,5,28
"29526","6207雷科","110/07/09","國泰-台南",0,15,-15
"29527","6207雷科","110/07/09","元大-高雄",26,0,26
"29528","6207雷科","110/07/09","華南永昌-古亭",0,14,-14
"29529","6207雷科","110/07/09","統一-員林",22,0,22
"29530","6207雷科","110/07/09","土銀-白河",0,11,-11
"29531","6207雷科","110/07/09","台新-高雄",22,0,22
"29532","6207雷科","110/07/09","日盛-台南",0,10,-10
"29533","6207雷科","110/07/09","摩根大通",34,17,17
"29534","6207雷科","110/07/09","元富-林園",0,10,-10
"29535","6207雷科","110/07/09","元大-博愛",17,1,16
"29536","6207雷科","110/07/09","富邦-園區",0,10,-10
"29537","6207雷科","110/07/09","日茂-埔里",12,0,12
"29538","6207雷科","110/07/09","元大-上新莊",0,10,-10
"29539","6207雷科","110/07/09","國泰-台中",17,6,11
"29540","6207雷科","110/07/09","永豐金-南京",0,10,-10
"29541","6207雷科","110/07/09","富邦-三重",10,0,10
"29542","6207雷科","110/07/09","兆豐-小港",0,6,-6
"29543","6207雷科","110/07/09","元大-沙鹿",10,0,10
"29544","6207雷科","110/07/09","富邦-羅東",1,7,-6
"29545","6207雷科","110/07/09","元大-八德",10,0,10
"29546","6207雷科","110/07/09","元大-土城永寧",0,6,-6
"29547","6207雷科","110/07/09","第一金-路竹",11,2,9
"29548","6207雷科","110/07/09","永豐金-板盛",0,6,-6
"29549","6207雷科","110/07/09","統一-南京",5,0,5
"29550","6207雷科","110/07/09","日盛-板橋",0,5,-5
"29551","3679新至陞","110/07/09","元大-大天母",10,0,10
"29552","3679新至陞","110/07/09","第一金-光復",0,11,-11
"29553","3679新至陞","110/07/09","日盛-樹林",9,0,9
"29554","3679新至陞","110/07/09","瑞士信貸",0,8,-8
"29555","3679新至陞","110/07/09","凱基-台北",11,2,9
"29556","3679新至陞","110/07/09","大慶-苗栗",0,5,-5
"29557","3679新至陞","110/07/09","華南永昌-小港",8,0,8
"29558","3679新至陞","110/07/09","元大-永春",0,5,-5
"29559","3679新至陞","110/07/09","兆豐-來福",7,0,7
"29560","3679新至陞","110/07/09","日盛-和美",0,4,-4
"29561","3679新至陞","110/07/09","香港上海匯豐",5,0,5
"29562","3679新至陞","110/07/09","元大-雙和",0,3,-3
"29563","3679新至陞","110/07/09","台中銀-員林",3,0,3
"29564","3679新至陞","110/07/09","永豐金-屏東",0,3,-3
"29565","3679新至陞","110/07/09","新光",3,0,3
"29566","3679新至陞","110/07/09","彰銀",0,2,-2
"29567","3679新至陞","110/07/09","土銀-花蓮",2,0,2
"29568","3679新至陞","110/07/09","宏遠-館前",0,2,-2
"29569","3679新至陞","110/07/09","第一金-澎湖",2,0,2
"29570","3679新至陞","110/07/09","港商野村",0,2,-2
"29571","3679新至陞","110/07/09","摩根大通",2,0,2
"29572","3679新至陞","110/07/09","大昌-新店",0,2,-2
"29573","3679新至陞","110/07/09","國泰-敦南",2,0,2
"29574","3679新至陞","110/07/09","元大-新莊",0,2,-2
"29575","3679新至陞","110/07/09","元大-淡水",4,2,2
"29576","3679新至陞","110/07/09","元大-板橋",0,2,-2
"29577","3679新至陞","110/07/09","日盛-士林",1,0,1
"29578","3679新至陞","110/07/09","台灣摩根士丹利",0,1,-1
"29579","3679新至陞","110/07/09","日盛-信義",1,0,1
"29580","3679新至陞","110/07/09","第一金-高雄",0,1,-1
"29581","2727王品","110/07/09","台灣匯立證券",90,0,90
"29582","2727王品","110/07/09","台灣摩根士丹利",0,267,-267
"29583","2727王品","110/07/09","國泰-敦南",166,84,82
"29584","2727王品","110/07/09","富邦-台北",35,299,-264
"29585","2727王品","110/07/09","富邦-仁愛",56,12,44
"29586","2727王品","110/07/09","凱基-台北",174,296,-122
"29587","2727王品","110/07/09","台新證券",109,66,43
"29588","2727王品","110/07/09","第一金",2,102,-100
"29589","2727王品","110/07/09","新光",117,87,30
"29590","2727王品","110/07/09","群益金鼎-大安",0,80,-80
"29591","2727王品","110/07/09","臺銀-臺中",35,6,29
"29592","2727王品","110/07/09","兆豐-大安",7,60,-53
"29593","2727王品","110/07/09","元大-桃園",32,3,29
"29594","2727王品","110/07/09","永豐金-南投",0,50,-50
"29595","2727王品","110/07/09","元富-宜蘭",34,6,28
"29596","2727王品","110/07/09","新加坡商瑞銀",6,46,-40
"29597","2727王品","110/07/09","玉山-台中",34,8,26
"29598","2727王品","110/07/09","合庫-彰化",11,50,-39
"29599","2727王品","110/07/09","群益金鼎-宜蘭",30,4,26
"29600","2727王品","110/07/09","永豐金-萬盛",13,52,-39
"29601","2727王品","110/07/09","富邦-台中",42,16,26
"29602","2727王品","110/07/09","瑞士信貸",0,34,-34
"29603","2727王品","110/07/09","第一金-豐原",25,1,24
"29604","2727王品","110/07/09","元大-和平",4,35,-31
"29605","2727王品","110/07/09","臺銀",30,8,22
"29606","2727王品","110/07/09","美林",14,44,-30
"29607","2727王品","110/07/09","兆豐-來福",23,1,22
"29608","2727王品","110/07/09","元大-員林",9,38,-29
"29609","2727王品","110/07/09","玉山-士林",22,2,20
"29610","2727王品","110/07/09","元富-西松",4,31,-27
"29611","1570力肯","110/07/09","凱基-台北",30,1,29
"29612","1570力肯","110/07/09","群益金鼎-彰化",0,20,-20
"29613","1570力肯","110/07/09","新光-台南",20,0,20
"29614","1570力肯","110/07/09","元大-土城學府",0,20,-20
"29615","1570力肯","110/07/09","元大-高雄",20,0,20
"29616","1570力肯","110/07/09","元大-大統",0,16,-16
"29617","1570力肯","110/07/09","國票-中正",12,0,12
"29618","1570力肯","110/07/09","元大-新營",0,11,-11
"29619","1570力肯","110/07/09","日盛-高雄",6,0,6
"29620","1570力肯","110/07/09","元大-和平",0,10,-10
"29621","1570力肯","110/07/09","元富-緯城",6,0,6
"29622","1570力肯","110/07/09","元大-草屯",0,10,-10
"29623","1570力肯","110/07/09","群益金鼎-台南",6,0,6
"29624","1570力肯","110/07/09","元大-鹿港",0,9,-9
"29625","1570力肯","110/07/09","華南永昌-岡山",6,0,6
"29626","1570力肯","110/07/09","合庫-基隆",0,7,-7
"29627","1570力肯","110/07/09","統一-中壢",5,0,5
"29628","1570力肯","110/07/09","摩根大通",2,8,-6
"29629","1570力肯","110/07/09","凱基-三峽",5,0,5
"29630","1570力肯","110/07/09","台灣企銀-豐原",0,4,-4
"29631","1570力肯","110/07/09","大昌-樹林",4,0,4
"29632","1570力肯","110/07/09","日盛-桃園",0,4,-4
"29633","1570力肯","110/07/09","新光",3,0,3
"29634","1570力肯","110/07/09","國泰-高雄",0,3,-3
"29635","1570力肯","110/07/09","富邦-新竹華信",3,0,3
"29636","1570力肯","110/07/09","永豐金-敦南",0,3,-3
"29637","1570力肯","110/07/09","合庫-台中",2,0,2
"29638","1570力肯","110/07/09","土銀-彰化",0,2,-2
"29639","1570力肯","110/07/09","臺銀-臺中",2,0,2
"29640","1570力肯","110/07/09","臺銀-鳳山",0,2,-2
"29641","6180橘子","110/07/09","摩根大通",63,1,62
"29642","6180橘子","110/07/09","元大-南京",1,32,-31
"29643","6180橘子","110/07/09","富邦-陽明",73,33,40
"29644","6180橘子","110/07/09","群益金鼎-台北",0,25,-25
"29645","6180橘子","110/07/09","新加坡商瑞銀",31,0,31
"29646","6180橘子","110/07/09","兆豐-復興",0,21,-21
"29647","6180橘子","110/07/09","美商高盛",25,0,25
"29648","6180橘子","110/07/09","永豐金-嘉義",0,21,-21
"29649","6180橘子","110/07/09","凱基-台北",26,10,16
"29650","6180橘子","110/07/09","凱基-中壢",8,24,-16
"29651","6180橘子","110/07/09","華南永昌-楠梓",13,0,13
"29652","6180橘子","110/07/09","致和-崇德",0,15,-15
"29653","6180橘子","110/07/09","華南永昌-朴子",11,0,11
"29654","6180橘子","110/07/09","群益金鼎-屏東",0,15,-15
"29655","6180橘子","110/07/09","元大-北港",11,0,11
"29656","6180橘子","110/07/09","群益金鼎-中山",0,15,-15
"29657","6180橘子","110/07/09","元大-成功",10,1,9
"29658","6180橘子","110/07/09","瑞士信貸",1,15,-14
"29659","6180橘子","110/07/09","新光",26,18,8
"29660","6180橘子","110/07/09","日盛-二林",0,10,-10
"29661","6180橘子","110/07/09","統一-三重",6,0,6
"29662","6180橘子","110/07/09","凱基-東門",0,10,-10
"29663","6180橘子","110/07/09","群益金鼎-嘉義",6,0,6
"29664","6180橘子","110/07/09","華南永昌-三重",0,10,-10
"29665","6180橘子","110/07/09","元大-員林中山",6,0,6
"29666","6180橘子","110/07/09","元大-彰化民生",1,11,-10
"29667","6180橘子","110/07/09","合庫-鳳山",5,0,5
"29668","6180橘子","110/07/09","永豐金-新店",1,11,-10
"29669","6180橘子","110/07/09","富邦-建國",6,1,5
"29670","6180橘子","110/07/09","群益金鼎-丹鳳",0,8,-8
"29671","2390云辰","110/07/09","摩根大通",279,56,223
"29672","2390云辰","110/07/09","元大-天母",0,127,-127
"29673","2390云辰","110/07/09","日盛-鳳山",110,2,108
"29674","2390云辰","110/07/09","中國信託-文心",5,109,-104
"29675","2390云辰","110/07/09","宏遠證券",100,0,100
"29676","2390云辰","110/07/09","永豐金-復興",0,55,-55
"29677","2390云辰","110/07/09","元大-大里",63,6,57
"29678","2390云辰","110/07/09","凱基-台北",239,286,-47
"29679","2390云辰","110/07/09","凱基-八德",59,10,49
"29680","2390云辰","110/07/09","德信",2,32,-30
"29681","2390云辰","110/07/09","合庫-新竹",40,0,40
"29682","2390云辰","110/07/09","兆豐-桃鶯",2,32,-30
"29683","2390云辰","110/07/09","國票",40,1,39
"29684","2390云辰","110/07/09","致和-南京",0,30,-30
"29685","2390云辰","110/07/09","新加坡商瑞銀",49,13,36
"29686","2390云辰","110/07/09","富邦-虎尾",1,31,-30
"29687","2390云辰","110/07/09","統一-新台中",36,2,34
"29688","2390云辰","110/07/09","元大-善化",2,31,-29
"29689","2390云辰","110/07/09","國票-嘉義",31,0,31
"29690","2390云辰","110/07/09","富邦-板橋",0,27,-27
"29691","2390云辰","110/07/09","華南永昌",35,7,28
"29692","2390云辰","110/07/09","富邦-永和",3,28,-25
"29693","2390云辰","110/07/09","玉山-台中",49,22,27
"29694","2390云辰","110/07/09","第一金-自由",20,44,-24
"29695","2390云辰","110/07/09","華南永昌-敦南",25,0,25
"29696","2390云辰","110/07/09","凱基-內湖",0,24,-24
"29697","2390云辰","110/07/09","新光-高雄",27,4,23
"29698","2390云辰","110/07/09","元大-汐止",1,24,-23
"29699","2390云辰","110/07/09","台灣摩根士丹利",85,63,22
"29700","2390云辰","110/07/09","新光-台中",12,33,-21
"29701","4903聯光通","110/07/09","元大-敦南",10,0,10
"29702","4903聯光通","110/07/09","第一金-台中",0,12,-12
"29703","4903聯光通","110/07/09","凱基-士林",5,0,5
"29704","4903聯光通","110/07/09","日盛-忠孝",0,3,-3
"29705","4903聯光通","110/07/09","元大-苗栗",5,0,5
"29706","4903聯光通","110/07/09","群益金鼎-崇德",0,3,-3
"29707","4903聯光通","110/07/09","元大-屏南",3,0,3
"29708","4903聯光通","110/07/09","國票-內壢",0,2,-2
"29709","4903聯光通","110/07/09","中國信託-永康",1,0,1
"29710","4903聯光通","110/07/09","康和-南崁",0,2,-2
"29711","4903聯光通","110/07/09","玉山證券",1,0,1
"29712","4903聯光通","110/07/09","新光-台中",0,2,-2
"29713","4903聯光通","110/07/09","元大-太平",4,3,1
"29714","4903聯光通","110/07/09","玉山-城中",0,2,-2
"29715","4903聯光通","110/07/09","永豐金-嘉義",1,0,1
"29716","4903聯光通","110/07/09","中國信託-文心",0,1,-1
"29717","4903聯光通","110/07/09","大昌",0,0,0
"29718","4903聯光通","110/07/09","大昌",0,0,0
"29719","4903聯光通","110/07/09","中農",0,0,0
"29720","4903聯光通","110/07/09","中農",0,0,0
"29721","2929淘帝","110/07/09","台中銀-台北",110,0,110
"29722","2929淘帝","110/07/09","新光",2,82,-80
"29723","2929淘帝","110/07/09","華南永昌-頭份",72,0,72
"29724","2929淘帝","110/07/09","摩根大通",2,63,-61
"29725","2929淘帝","110/07/09","合庫-高雄",71,0,71
"29726","2929淘帝","110/07/09","第一金-路竹",0,50,-50
"29727","2929淘帝","110/07/09","高橋-龍潭",37,0,37
"29728","2929淘帝","110/07/09","港商麥格理",0,42,-42
"29729","2929淘帝","110/07/09","新光-台中",60,26,34
"29730","2929淘帝","110/07/09","陽信-石牌",0,40,-40
"29731","2929淘帝","110/07/09","元富-大裕",22,1,21
"29732","2929淘帝","110/07/09","台新-左楠",1,39,-38
"29733","2929淘帝","110/07/09","合庫-鳳山",20,0,20
"29734","2929淘帝","110/07/09","凱基-桃園",3,29,-26
"29735","2929淘帝","110/07/09","元大-員林",22,2,20
"29736","2929淘帝","110/07/09","兆豐-內湖",0,25,-25
"29737","2929淘帝","110/07/09","台新-建北",15,0,15
"29738","2929淘帝","110/07/09","元大-北港",0,20,-20
"29739","2929淘帝","110/07/09","兆豐-桃園",13,0,13
"29740","2929淘帝","110/07/09","富邦-北港",0,19,-19
"29741","2929淘帝","110/07/09","兆豐-忠孝",10,0,10
"29742","2929淘帝","110/07/09","富邦-花蓮",0,17,-17
"29743","2929淘帝","110/07/09","國票-敦北法人",10,0,10
"29744","2929淘帝","110/07/09","國泰-台中",2,17,-15
"29745","2929淘帝","110/07/09","永豐金-博愛",10,0,10
"29746","2929淘帝","110/07/09","群益金鼎-彰化",0,15,-15
"29747","2929淘帝","110/07/09","群益金鼎-潭子",8,0,8
"29748","2929淘帝","110/07/09","元大-博愛",0,14,-14
"29749","2929淘帝","110/07/09","富邦-南屯",8,0,8
"29750","2929淘帝","110/07/09","日盛-板橋",0,13,-13
"29751","5410國眾","110/07/09","元大-新盛",14,0,14
"29752","5410國眾","110/07/09","(牛牛牛)亞-鑫豐",1,41,-40
"29753","5410國眾","110/07/09","台灣企銀-民雄",10,0,10
"29754","5410國眾","110/07/09","元富-嘉義",0,25,-25
"29755","5410國眾","110/07/09","元富-虎尾",9,0,9
"29756","5410國眾","110/07/09","凱基-高美館",0,10,-10
"29757","5410國眾","110/07/09","摩根大通",10,1,9
"29758","5410國眾","110/07/09","凱基-城中",0,10,-10
"29759","5410國眾","110/07/09","兆豐-北高雄",7,0,7
"29760","5410國眾","110/07/09","元大-頭份",0,10,-10
"29761","5410國眾","110/07/09","凱基-台北",8,1,7
"29762","5410國眾","110/07/09","群益金鼎-丹鳳",0,7,-7
"29763","5410國眾","110/07/09","華南永昌-公誠",7,0,7
"29764","5410國眾","110/07/09","凱基-復興",0,7,-7
"29765","5410國眾","110/07/09","香港上海匯豐",6,0,6
"29766","5410國眾","110/07/09","元大-員林",0,7,-7
"29767","5410國眾","110/07/09","凱基-中壢",6,0,6
"29768","5410國眾","110/07/09","富邦-竹東",0,6,-6
"29769","5410國眾","110/07/09","華南永昌-南京",6,0,6
"29770","5410國眾","110/07/09","亞東-高雄",0,5,-5
"29771","5410國眾","110/07/09","統一-三重",5,0,5
"29772","5410國眾","110/07/09","大慶-中壢",1,6,-5
"29773","5410國眾","110/07/09","富邦-宜蘭",5,0,5
"29774","5410國眾","110/07/09","群益金鼎-中港",0,5,-5
"29775","5410國眾","110/07/09","元大-崇德",5,0,5
"29776","5410國眾","110/07/09","元大-八德",0,5,-5
"29777","5410國眾","110/07/09","元大-博愛",5,0,5
"29778","5410國眾","110/07/09","富邦-基隆",0,4,-4
"29779","5410國眾","110/07/09","元大-龍潭",5,0,5
"29780","5410國眾","110/07/09","臺銀-新竹",0,3,-3
"29781","2841台開","110/07/09","日盛-雙和",102,0,102
"29782","2841台開","110/07/09","港商野村",0,129,-129
"29783","2841台開","110/07/09","元大-館前",70,0,70
"29784","2841台開","110/07/09","兆豐-永和",0,100,-100
"29785","2841台開","110/07/09","凱基-文心",50,0,50
"29786","2841台開","110/07/09","台新證券",7,28,-21
"29787","2841台開","110/07/09","富邦-嘉義",40,0,40
"29788","2841台開","110/07/09","國票-北高雄",0,20,-20
"29789","2841台開","110/07/09","美商高盛",15,0,15
"29790","2841台開","110/07/09","永豐金-敦南",29,46,-17
"29791","2841台開","110/07/09","台中銀",15,0,15
"29792","2841台開","110/07/09","合庫-基隆",0,12,-12
"29793","2841台開","110/07/09","新光",11,0,11
"29794","2841台開","110/07/09","中國信託-松江",0,12,-12
"29795","2841台開","110/07/09","華南永昌-長虹",10,0,10
"29796","2841台開","110/07/09","兆豐-城中",0,12,-12
"29797","2841台開","110/07/09","永豐金-南投",10,0,10
"29798","2841台開","110/07/09","台中銀-豐原",0,10,-10
"29799","2841台開","110/07/09","合庫-桃園",7,0,7
"29800","2841台開","110/07/09","兆豐-景美",0,10,-10
"29801","2841台開","110/07/09","群益金鼎-古亭",7,0,7
"29802","2841台開","110/07/09","群益金鼎-基隆",0,10,-10
"29803","2841台開","110/07/09","國泰-敦南",6,0,6
"29804","2841台開","110/07/09","元大-北三重",0,10,-10
"29805","2841台開","110/07/09","凱基-桃園",8,2,6
"29806","2841台開","110/07/09","(牛牛牛)亞-網路",0,9,-9
"29807","2841台開","110/07/09","日盛證券",5,0,5
"29808","2841台開","110/07/09","台新-高雄",1,10,-9
"29809","2841台開","110/07/09","元富-文心",5,0,5
"29810","2841台開","110/07/09","凱基-台北",0,7,-7
"29811","6207雷科","110/07/09","群益金鼎-新竹",47,0,47
"29812","6207雷科","110/07/09","新光",7,24,-17
"29813","6207雷科","110/07/09","永豐金-三重",31,0,31
"29814","6207雷科","110/07/09","日盛-和美",0,15,-15
"29815","6207雷科","110/07/09","新加坡商瑞銀",33,5,28
"29816","6207雷科","110/07/09","國泰-台南",0,15,-15
"29817","6207雷科","110/07/09","元大-高雄",26,0,26
"29818","6207雷科","110/07/09","華南永昌-古亭",0,14,-14
"29819","6207雷科","110/07/09","統一-員林",22,0,22
"29820","6207雷科","110/07/09","土銀-白河",0,11,-11
"29821","6207雷科","110/07/09","台新-高雄",22,0,22
"29822","6207雷科","110/07/09","日盛-台南",0,10,-10
"29823","6207雷科","110/07/09","摩根大通",34,17,17
"29824","6207雷科","110/07/09","元富-林園",0,10,-10
"29825","6207雷科","110/07/09","元大-博愛",17,1,16
"29826","6207雷科","110/07/09","富邦-園區",0,10,-10
"29827","6207雷科","110/07/09","日茂-埔里",12,0,12
"29828","6207雷科","110/07/09","元大-上新莊",0,10,-10
"29829","6207雷科","110/07/09","國泰-台中",17,6,11
"29830","6207雷科","110/07/09","永豐金-南京",0,10,-10
"29831","6207雷科","110/07/09","富邦-三重",10,0,10
"29832","6207雷科","110/07/09","兆豐-小港",0,6,-6
"29833","6207雷科","110/07/09","元大-沙鹿",10,0,10
"29834","6207雷科","110/07/09","富邦-羅東",1,7,-6
"29835","6207雷科","110/07/09","元大-八德",10,0,10
"29836","6207雷科","110/07/09","元大-土城永寧",0,6,-6
"29837","6207雷科","110/07/09","第一金-路竹",11,2,9
"29838","6207雷科","110/07/09","永豐金-板盛",0,6,-6
"29839","6207雷科","110/07/09","統一-南京",5,0,5
"29840","6207雷科","110/07/09","日盛-板橋",0,5,-5
"29841","3679新至陞","110/07/09","元大-大天母",10,0,10
"29842","3679新至陞","110/07/09","第一金-光復",0,11,-11
"29843","3679新至陞","110/07/09","日盛-樹林",9,0,9
"29844","3679新至陞","110/07/09","瑞士信貸",0,8,-8
"29845","3679新至陞","110/07/09","凱基-台北",11,2,9
"29846","3679新至陞","110/07/09","大慶-苗栗",0,5,-5
"29847","3679新至陞","110/07/09","華南永昌-小港",8,0,8
"29848","3679新至陞","110/07/09","元大-永春",0,5,-5
"29849","3679新至陞","110/07/09","兆豐-來福",7,0,7
"29850","3679新至陞","110/07/09","日盛-和美",0,4,-4
"29851","3679新至陞","110/07/09","香港上海匯豐",5,0,5
"29852","3679新至陞","110/07/09","元大-雙和",0,3,-3
"29853","3679新至陞","110/07/09","台中銀-員林",3,0,3
"29854","3679新至陞","110/07/09","永豐金-屏東",0,3,-3
"29855","3679新至陞","110/07/09","新光",3,0,3
"29856","3679新至陞","110/07/09","彰銀",0,2,-2
"29857","3679新至陞","110/07/09","土銀-花蓮",2,0,2
"29858","3679新至陞","110/07/09","宏遠-館前",0,2,-2
"29859","3679新至陞","110/07/09","第一金-澎湖",2,0,2
"29860","3679新至陞","110/07/09","港商野村",0,2,-2
"29861","3679新至陞","110/07/09","摩根大通",2,0,2
"29862","3679新至陞","110/07/09","大昌-新店",0,2,-2
"29863","3679新至陞","110/07/09","國泰-敦南",2,0,2
"29864","3679新至陞","110/07/09","元大-新莊",0,2,-2
"29865","3679新至陞","110/07/09","元大-淡水",4,2,2
"29866","3679新至陞","110/07/09","元大-板橋",0,2,-2
"29867","3679新至陞","110/07/09","日盛-士林",1,0,1
"29868","3679新至陞","110/07/09","台灣摩根士丹利",0,1,-1
"29869","3679新至陞","110/07/09","日盛-信義",1,0,1
"29870","3679新至陞","110/07/09","第一金-高雄",0,1,-1
"29871","2727王品","110/07/09","台灣匯立證券",90,0,90
"29872","2727王品","110/07/09","台灣摩根士丹利",0,267,-267
"29873","2727王品","110/07/09","國泰-敦南",166,84,82
"29874","2727王品","110/07/09","富邦-台北",35,299,-264
"29875","2727王品","110/07/09","富邦-仁愛",56,12,44
"29876","2727王品","110/07/09","凱基-台北",174,296,-122
"29877","2727王品","110/07/09","台新證券",109,66,43
"29878","2727王品","110/07/09","第一金",2,102,-100
"29879","2727王品","110/07/09","新光",117,87,30
"29880","2727王品","110/07/09","群益金鼎-大安",0,80,-80
"29881","2727王品","110/07/09","臺銀-臺中",35,6,29
"29882","2727王品","110/07/09","兆豐-大安",7,60,-53
"29883","2727王品","110/07/09","元大-桃園",32,3,29
"29884","2727王品","110/07/09","永豐金-南投",0,50,-50
"29885","2727王品","110/07/09","元富-宜蘭",34,6,28
"29886","2727王品","110/07/09","新加坡商瑞銀",6,46,-40
"29887","2727王品","110/07/09","玉山-台中",34,8,26
"29888","2727王品","110/07/09","合庫-彰化",11,50,-39
"29889","2727王品","110/07/09","群益金鼎-宜蘭",30,4,26
"29890","2727王品","110/07/09","永豐金-萬盛",13,52,-39
"29891","2727王品","110/07/09","富邦-台中",42,16,26
"29892","2727王品","110/07/09","瑞士信貸",0,34,-34
"29893","2727王品","110/07/09","第一金-豐原",25,1,24
"29894","2727王品","110/07/09","元大-和平",4,35,-31
"29895","2727王品","110/07/09","臺銀",30,8,22
"29896","2727王品","110/07/09","美林",14,44,-30
"29897","2727王品","110/07/09","兆豐-來福",23,1,22
"29898","2727王品","110/07/09","元大-員林",9,38,-29
"29899","2727王品","110/07/09","玉山-士林",22,2,20
"29900","2727王品","110/07/09","元富-西松",4,31,-27
"29901","1570力肯","110/07/09","凱基-台北",30,1,29
"29902","1570力肯","110/07/09","群益金鼎-彰化",0,20,-20
"29903","1570力肯","110/07/09","新光-台南",20,0,20
"29904","1570力肯","110/07/09","元大-土城學府",0,20,-20
"29905","1570力肯","110/07/09","元大-高雄",20,0,20
"29906","1570力肯","110/07/09","元大-大統",0,16,-16
"29907","1570力肯","110/07/09","國票-中正",12,0,12
"29908","1570力肯","110/07/09","元大-新營",0,11,-11
"29909","1570力肯","110/07/09","日盛-高雄",6,0,6
"29910","1570力肯","110/07/09","元大-和平",0,10,-10
"29911","1570力肯","110/07/09","元富-緯城",6,0,6
"29912","1570力肯","110/07/09","元大-草屯",0,10,-10
"29913","1570力肯","110/07/09","群益金鼎-台南",6,0,6
"29914","1570力肯","110/07/09","元大-鹿港",0,9,-9
"29915","1570力肯","110/07/09","華南永昌-岡山",6,0,6
"29916","1570力肯","110/07/09","合庫-基隆",0,7,-7
"29917","1570力肯","110/07/09","統一-中壢",5,0,5
"29918","1570力肯","110/07/09","摩根大通",2,8,-6
"29919","1570力肯","110/07/09","凱基-三峽",5,0,5
"29920","1570力肯","110/07/09","台灣企銀-豐原",0,4,-4
"29921","1570力肯","110/07/09","大昌-樹林",4,0,4
"29922","1570力肯","110/07/09","日盛-桃園",0,4,-4
"29923","1570力肯","110/07/09","新光",3,0,3
"29924","1570力肯","110/07/09","國泰-高雄",0,3,-3
"29925","1570力肯","110/07/09","富邦-新竹華信",3,0,3
"29926","1570力肯","110/07/09","永豐金-敦南",0,3,-3
"29927","1570力肯","110/07/09","合庫-台中",2,0,2
"29928","1570力肯","110/07/09","土銀-彰化",0,2,-2
"29929","1570力肯","110/07/09","臺銀-臺中",2,0,2
"29930","1570力肯","110/07/09","臺銀-鳳山",0,2,-2
"29931","6180橘子","110/07/09","摩根大通",63,1,62
"29932","6180橘子","110/07/09","元大-南京",1,32,-31
"29933","6180橘子","110/07/09","富邦-陽明",73,33,40
"29934","6180橘子","110/07/09","群益金鼎-台北",0,25,-25
"29935","6180橘子","110/07/09","新加坡商瑞銀",31,0,31
"29936","6180橘子","110/07/09","兆豐-復興",0,21,-21
"29937","6180橘子","110/07/09","美商高盛",25,0,25
"29938","6180橘子","110/07/09","永豐金-嘉義",0,21,-21
"29939","6180橘子","110/07/09","凱基-台北",26,10,16
"29940","6180橘子","110/07/09","凱基-中壢",8,24,-16
"29941","6180橘子","110/07/09","華南永昌-楠梓",13,0,13
"29942","6180橘子","110/07/09","致和-崇德",0,15,-15
"29943","6180橘子","110/07/09","華南永昌-朴子",11,0,11
"29944","6180橘子","110/07/09","群益金鼎-屏東",0,15,-15
"29945","6180橘子","110/07/09","元大-北港",11,0,11
"29946","6180橘子","110/07/09","群益金鼎-中山",0,15,-15
"29947","6180橘子","110/07/09","元大-成功",10,1,9
"29948","6180橘子","110/07/09","瑞士信貸",1,15,-14
"29949","6180橘子","110/07/09","新光",26,18,8
"29950","6180橘子","110/07/09","日盛-二林",0,10,-10
"29951","6180橘子","110/07/09","統一-三重",6,0,6
"29952","6180橘子","110/07/09","凱基-東門",0,10,-10
"29953","6180橘子","110/07/09","群益金鼎-嘉義",6,0,6
"29954","6180橘子","110/07/09","華南永昌-三重",0,10,-10
"29955","6180橘子","110/07/09","元大-員林中山",6,0,6
"29956","6180橘子","110/07/09","元大-彰化民生",1,11,-10
"29957","6180橘子","110/07/09","合庫-鳳山",5,0,5
"29958","6180橘子","110/07/09","永豐金-新店",1,11,-10
"29959","6180橘子","110/07/09","富邦-建國",6,1,5
"29960","6180橘子","110/07/09","群益金鼎-丹鳳",0,8,-8
"29961","2390云辰","110/07/09","摩根大通",279,56,223
"29962","2390云辰","110/07/09","元大-天母",0,127,-127
"29963","2390云辰","110/07/09","日盛-鳳山",110,2,108
"29964","2390云辰","110/07/09","中國信託-文心",5,109,-104
"29965","2390云辰","110/07/09","宏遠證券",100,0,100
"29966","2390云辰","110/07/09","永豐金-復興",0,55,-55
"29967","2390云辰","110/07/09","元大-大里",63,6,57
"29968","2390云辰","110/07/09","凱基-台北",239,286,-47
"29969","2390云辰","110/07/09","凱基-八德",59,10,49
"29970","2390云辰","110/07/09","德信",2,32,-30
"29971","2390云辰","110/07/09","合庫-新竹",40,0,40
"29972","2390云辰","110/07/09","兆豐-桃鶯",2,32,-30
"29973","2390云辰","110/07/09","國票",40,1,39
"29974","2390云辰","110/07/09","致和-南京",0,30,-30
"29975","2390云辰","110/07/09","新加坡商瑞銀",49,13,36
"29976","2390云辰","110/07/09","富邦-虎尾",1,31,-30
"29977","2390云辰","110/07/09","統一-新台中",36,2,34
"29978","2390云辰","110/07/09","元大-善化",2,31,-29
"29979","2390云辰","110/07/09","國票-嘉義",31,0,31
"29980","2390云辰","110/07/09","富邦-板橋",0,27,-27
"29981","2390云辰","110/07/09","華南永昌",35,7,28
"29982","2390云辰","110/07/09","富邦-永和",3,28,-25
"29983","2390云辰","110/07/09","玉山-台中",49,22,27
"29984","2390云辰","110/07/09","第一金-自由",20,44,-24
"29985","2390云辰","110/07/09","華南永昌-敦南",25,0,25
"29986","2390云辰","110/07/09","凱基-內湖",0,24,-24
"29987","2390云辰","110/07/09","新光-高雄",27,4,23
"29988","2390云辰","110/07/09","元大-汐止",1,24,-23
"29989","2390云辰","110/07/09","台灣摩根士丹利",85,63,22
"29990","2390云辰","110/07/09","新光-台中",12,33,-21
"29991","4903聯光通","110/07/08","元富-新興",18,0,18
"29992","4903聯光通","110/07/08","中國信託-中壢",0,14,-14
"29993","4903聯光通","110/07/08","元大-苗栗",9,0,9
"29994","4903聯光通","110/07/08","彰銀",0,7,-7
"29995","4903聯光通","110/07/08","兆豐-鹿港",3,0,3
"29996","4903聯光通","110/07/08","中國信託-松江",0,5,-5
"29997","4903聯光通","110/07/08","群益金鼎-萬華",2,0,2
"29998","4903聯光通","110/07/08","光和",0,2,-2
"29999","4903聯光通","110/07/08","元大-屏南",1,0,1
"30000","4903聯光通","110/07/08","元大-鶯歌",0,2,-2
"30001","4903聯光通","110/07/08","華南永昌-新莊",0,0,0
"30002","4903聯光通","110/07/08","群益金鼎-館前",0,1,-1
"30003","4903聯光通","110/07/08","元大-羅東",0,0,0
"30004","4903聯光通","110/07/08","華南永昌",0,1,-1
"30005","4903聯光通","110/07/08","元大-太平",2,3,-1
"30006","4903聯光通","110/07/08","華南永昌-新莊",0,0,0
"30007","4903聯光通","110/07/08","元大-羅東",0,0,0
"30008","2929淘帝","110/07/08","日盛-園區",90,6,84
"30009","2929淘帝","110/07/08","元大-太平",1,111,-110
"30010","2929淘帝","110/07/08","華南永昌-頭份",54,0,54
"30011","2929淘帝","110/07/08","港商野村",31,106,-75
"30012","2929淘帝","110/07/08","美商高盛",50,0,50
"30013","2929淘帝","110/07/08","凱基-板橋",62,111,-49
"30014","2929淘帝","110/07/08","台中銀-台北",50,0,50
"30015","2929淘帝","110/07/08","新光-台中",30,78,-48
"30016","2929淘帝","110/07/08","臺銀-臺南",30,0,30
"30017","2929淘帝","110/07/08","元富-永和",1,41,-40
"30018","2929淘帝","110/07/08","永豐金-大園",42,12,30
"30019","2929淘帝","110/07/08","永豐金-鳳山",0,28,-28
"30020","2929淘帝","110/07/08","元富-三重",30,1,29
"30021","2929淘帝","110/07/08","元大-南崁",0,26,-26
"30022","2929淘帝","110/07/08","兆豐-桃鶯",29,0,29
"30023","2929淘帝","110/07/08","元大-花蓮",2,27,-25
"30024","2929淘帝","110/07/08","元大-承德",20,3,17
"30025","2929淘帝","110/07/08","元大-府城",0,24,-24
"30026","2929淘帝","110/07/08","新光-新竹",13,0,13
"30027","2929淘帝","110/07/08","新光",21,43,-22
"30028","2929淘帝","110/07/08","富邦-內湖",13,0,13
"30029","2929淘帝","110/07/08","臺銀-民權",0,20,-20
"30030","2929淘帝","110/07/08","國泰-板橋",13,1,12
"30031","2929淘帝","110/07/08","摩根大通",66,84,-18
"30032","2929淘帝","110/07/08","第一金-大稻埕",10,0,10
"30033","2929淘帝","110/07/08","凱基-台北",0,17,-17
"30034","2929淘帝","110/07/08","統一-汐止",10,0,10
"30035","2929淘帝","110/07/08","元大-博愛",6,23,-17
"30036","2929淘帝","110/07/08","元富-大裕",10,0,10
"30037","2929淘帝","110/07/08","永豐金-桃盛",0,16,-16
"30038","5410國眾","110/07/08","元大-新盛",15,0,15
"30039","5410國眾","110/07/08","元大-旗山",0,50,-50
"30040","5410國眾","110/07/08","元大-屏南",10,0,10
"30041","5410國眾","110/07/08","元大-頭份",0,14,-14
"30042","5410國眾","110/07/08","元大-成功",10,0,10
"30043","5410國眾","110/07/08","國泰-高雄",0,8,-8
"30044","5410國眾","110/07/08","元大-東泰",7,0,7
"30045","5410國眾","110/07/08","元大-小港",0,7,-7
"30046","5410國眾","110/07/08","富邦-陽明",6,0,6
"30047","5410國眾","110/07/08","統一-嘉義",0,5,-5
"30048","5410國眾","110/07/08","臺銀-金山",5,0,5
"30049","5410國眾","110/07/08","兆豐-台中港",0,5,-5
"30050","5410國眾","110/07/08","日盛-員林",5,0,5
"30051","5410國眾","110/07/08","凱基-屏東",0,5,-5
"30052","5410國眾","110/07/08","摩根大通",5,0,5
"30053","5410國眾","110/07/08","元大-八德",0,5,-5
"30054","5410國眾","110/07/08","富邦-桃園",5,0,5
"30055","5410國眾","110/07/08","元富-嘉義",0,4,-4
"30056","5410國眾","110/07/08","元富-大昌",4,0,4
"30057","5410國眾","110/07/08","玉山-雙和",0,4,-4
"30058","5410國眾","110/07/08","台新-台中",4,0,4
"30059","5410國眾","110/07/08","凱基-高美館",1,5,-4
"30060","5410國眾","110/07/08","華南永昌-小港",5,1,4
"30061","5410國眾","110/07/08","統一-員林",0,3,-3
"30062","5410國眾","110/07/08","元大-新竹",5,1,4
"30063","5410國眾","110/07/08","臺銀-鳳山",0,2,-2
"30064","5410國眾","110/07/08","元大-土城學府",4,0,4
"30065","5410國眾","110/07/08","亞東",0,2,-2
"30066","5410國眾","110/07/08","元大-新莊",4,0,4
"30067","5410國眾","110/07/08","新光",0,2,-2
"30068","2841台開","110/07/08","元大-樹林",653,0,653
"30069","2841台開","110/07/08","港商野村",0,868,-868
"30070","2841台開","110/07/08","台新證券",115,0,115
"30071","2841台開","110/07/08","群益金鼎-忠孝",0,100,-100
"30072","2841台開","110/07/08","永豐金-豐原",105,0,105
"30073","2841台開","110/07/08","宏遠-高雄",0,56,-56
"30074","2841台開","110/07/08","元富-新興",100,0,100
"30075","2841台開","110/07/08","新光",3,38,-35
"30076","2841台開","110/07/08","凱基-文心",50,0,50
"30077","2841台開","110/07/08","花旗環球",0,29,-29
"30078","2841台開","110/07/08","元大-八德",40,0,40
"30079","2841台開","110/07/08","富邦-仁愛",2,30,-28
"30080","2841台開","110/07/08","日盛-雙和",30,0,30
"30081","2841台開","110/07/08","元富-潮州",0,24,-24
"30082","2841台開","110/07/08","統一-竹南",30,0,30
"30083","2841台開","110/07/08","元大-沙鹿",0,20,-20
"30084","2841台開","110/07/08","凱基-台南",30,0,30
"30085","2841台開","110/07/08","元大-汐止",0,20,-20
"30086","2841台開","110/07/08","元大-福營",30,0,30
"30087","2841台開","110/07/08","合庫-嘉義",2,20,-18
"30088","2841台開","110/07/08","合庫-台中",22,0,22
"30089","2841台開","110/07/08","國泰-敦南",3,21,-18
"30090","2841台開","110/07/08","大昌-安康",28,10,18
"30091","2841台開","110/07/08","日盛-竹北",0,15,-15
"30092","2841台開","110/07/08","元大-斗信",15,0,15
"30093","2841台開","110/07/08","元大-三重",0,15,-15
"30094","2841台開","110/07/08","富邦-台北",13,0,13
"30095","2841台開","110/07/08","永豐金-敦南",45,60,-15
"30096","2841台開","110/07/08","合庫-桃園",10,0,10
"30097","2841台開","110/07/08","(牛牛牛)亞-網路",0,12,-12
"30098","6207雷科","110/07/08","台新-高雄",54,2,52
"30099","6207雷科","110/07/08","群益金鼎-丹鳳",0,60,-60
"30100","6207雷科","110/07/08","新光-台中",18,0,18
"30101","6207雷科","110/07/08","元大-頭份",1,56,-55
"30102","6207雷科","110/07/08","日盛-嘉義",16,0,16
"30103","6207雷科","110/07/08","國票-中和",0,30,-30
"30104","6207雷科","110/07/08","合庫-鳳山",15,0,15
"30105","6207雷科","110/07/08","凱基-台北",1,29,-28
"30106","6207雷科","110/07/08","臺銀-臺中",12,0,12
"30107","6207雷科","110/07/08","兆豐-板橋",0,25,-25
"30108","6207雷科","110/07/08","群益金鼎-土城",12,0,12
"30109","6207雷科","110/07/08","凱基-城中",4,25,-21
"30110","6207雷科","110/07/08","新光",25,14,11
"30111","6207雷科","110/07/08","日進",0,20,-20
"30112","6207雷科","110/07/08","凱基-中壢",11,0,11
"30113","6207雷科","110/07/08","台新證券",3,20,-17
"30114","6207雷科","110/07/08","台灣企銀",10,0,10
"30115","6207雷科","110/07/08","群益金鼎-中山",0,16,-16
"30116","6207雷科","110/07/08","第一金-新興",11,1,10
"30117","6207雷科","110/07/08","元大-東門",0,16,-16
"30118","6207雷科","110/07/08","元富-吉利",10,0,10
"30119","6207雷科","110/07/08","群益金鼎-大甲",0,13,-13
"30120","6207雷科","110/07/08","光和-和美",10,0,10
"30121","6207雷科","110/07/08","日盛-板橋",0,10,-10
"30122","6207雷科","110/07/08","永豐金-南京",10,0,10
"30123","6207雷科","110/07/08","日盛-中壢",0,10,-10
"30124","6207雷科","110/07/08","土銀",8,0,8
"30125","6207雷科","110/07/08","摩根大通",125,135,-10
"30126","6207雷科","110/07/08","中國信託-高雄",8,0,8
"30127","6207雷科","110/07/08","凱基-五股",0,10,-10
"30128","3679新至陞","110/07/08","華南永昌-台中",17,0,17
"30129","3679新至陞","110/07/08","大慶-蘆洲",0,10,-10
"30130","3679新至陞","110/07/08","國泰-桃園",6,0,6
"30131","3679新至陞","110/07/08","華南永昌-小港",0,7,-7
"30132","3679新至陞","110/07/08","元大-永春",6,0,6
"30133","3679新至陞","110/07/08","國泰-館前",0,3,-3
"30134","3679新至陞","110/07/08","香港上海匯豐",4,0,4
"30135","3679新至陞","110/07/08","元大-板橋",0,3,-3
"30136","3679新至陞","110/07/08","中國信託-新竹",3,0,3
"30137","3679新至陞","110/07/08","港商法國興業",0,2,-2
"30138","3679新至陞","110/07/08","國票-敦北法人",3,0,3
"30139","3679新至陞","110/07/08","第一金-忠孝",0,2,-2
"30140","3679新至陞","110/07/08","群益金鼎-台南",2,0,2
"30141","3679新至陞","110/07/08","元富-古亭",0,2,-2
"30142","3679新至陞","110/07/08","凱基",2,0,2
"30143","3679新至陞","110/07/08","摩根大通",1,3,-2
"30144","3679新至陞","110/07/08","凱基-台北",6,4,2
"30145","3679新至陞","110/07/08","富邦-板橋",0,2,-2
"30146","3679新至陞","110/07/08","日盛-信義",1,0,1
"30147","3679新至陞","110/07/08","元大-文心興安",0,2,-2
"30148","3679新至陞","110/07/08","日盛-新莊",1,0,1
"30149","3679新至陞","110/07/08","臺銀-高雄",0,1,-1
"30150","3679新至陞","110/07/08","大慶",1,0,1
"30151","3679新至陞","110/07/08","日盛-高雄",0,1,-1
"30152","3679新至陞","110/07/08","兆豐-三重",1,0,1
"30153","3679新至陞","110/07/08","日盛-文化",0,1,-1
"30154","3679新至陞","110/07/08","致和-東門",1,0,1
"30155","3679新至陞","110/07/08","美商高盛",0,1,-1
"30156","3679新至陞","110/07/08","台新證券",1,0,1
"30157","3679新至陞","110/07/08","瑞士信貸",0,1,-1
"30158","2727王品","110/07/08","群益金鼎-大安",80,0,80
"30159","2727王品","110/07/08","台灣摩根士丹利",1,300,-299
"30160","2727王品","110/07/08","富邦-台北",237,165,72
"30161","2727王品","110/07/08","元大證券",173,439,-266
"30162","2727王品","110/07/08","永豐金-萬盛",55,5,50
"30163","2727王品","110/07/08","統一",33,200,-167
"30164","2727王品","110/07/08","永豐金-南投",53,10,43
"30165","2727王品","110/07/08","凱基-台北",476,615,-139
"30166","2727王品","110/07/08","國泰-敦南",190,148,42
"30167","2727王品","110/07/08","永豐金-松山",8,138,-130
"30168","2727王品","110/07/08","台新-高雄",71,36,35
"30169","2727王品","110/07/08","新加坡商瑞銀",38,138,-100
"30170","2727王品","110/07/08","富邦-建國",62,27,35
"30171","2727王品","110/07/08","富邦-嘉義",84,182,-98
"30172","2727王品","110/07/08","永豐金證券",50,15,35
"30173","2727王品","110/07/08","元富-台南",4,99,-95
"30174","2727王品","110/07/08","港商野村",185,152,33
"30175","2727王品","110/07/08","凱基-永華",4,92,-88
"30176","2727王品","110/07/08","元大-嘉義",35,3,32
"30177","2727王品","110/07/08","凱基-大直",2,73,-71
"30178","2727王品","110/07/08","台新-三民",35,4,31
"30179","2727王品","110/07/08","美林",105,164,-59
"30180","2727王品","110/07/08","凱基-桃園",35,4,31
"30181","2727王品","110/07/08","第一金-台南",11,63,-52
"30182","2727王品","110/07/08","元大-和平",41,10,31
"30183","2727王品","110/07/08","摩根大通",216,259,-43
"30184","2727王品","110/07/08","兆豐-大安",33,5,28
"30185","2727王品","110/07/08","元大-員林",9,50,-41
"30186","2727王品","110/07/08","元大-新盛",33,6,27
"30187","2727王品","110/07/08","兆豐-虎尾",1,41,-40
"30188","1570力肯","110/07/08","群益金鼎-三重",20,0,20
"30189","1570力肯","110/07/08","中國信託-永康",0,26,-26
"30190","1570力肯","110/07/08","凱基-中壢",20,0,20
"30191","1570力肯","110/07/08","統一-敦南",0,12,-12
"30192","1570力肯","110/07/08","群益金鼎-台南",14,0,14
"30193","1570力肯","110/07/08","國票-博愛",0,10,-10
"30194","1570力肯","110/07/08","元富-緯城",10,0,10
"30195","1570力肯","110/07/08","元大-西門",0,10,-10
"30196","1570力肯","110/07/08","瑞士信貸",7,0,7
"30197","1570力肯","110/07/08","新光",0,9,-9
"30198","1570力肯","110/07/08","摩根大通",6,0,6
"30199","1570力肯","110/07/08","永豐金-大園",0,9,-9
"30200","1570力肯","110/07/08","土銀-白河",5,0,5
"30201","1570力肯","110/07/08","日盛-大墩",0,6,-6
"30202","1570力肯","110/07/08","台灣摩根士丹利",4,0,4
"30203","1570力肯","110/07/08","台新證券",0,6,-6
"30204","1570力肯","110/07/08","元大-新莊",3,0,3
"30205","1570力肯","110/07/08","永全",0,5,-5
"30206","1570力肯","110/07/08","永豐金-苓雅",3,0,3
"30207","1570力肯","110/07/08","元大-天母",0,5,-5
"30208","1570力肯","110/07/08","合庫-三重",2,0,2
"30209","1570力肯","110/07/08","元富-吉利",0,3,-3
"30210","1570力肯","110/07/08","(牛牛牛)亞-鑫豐",2,0,2
"30211","1570力肯","110/07/08","國泰-高雄",0,3,-3
"30212","1570力肯","110/07/08","玉山-大里",2,0,2
"30213","1570力肯","110/07/08","群益金鼎-北高雄",0,3,-3
"30214","1570力肯","110/07/08","國泰-敦南",2,0,2
"30215","1570力肯","110/07/08","群益金鼎-東門",0,2,-2
"30216","1570力肯","110/07/08","華南永昌-岡山",2,0,2
"30217","1570力肯","110/07/08","日盛-高雄",5,6,-1
"30218","6180橘子","110/07/08","新光",30,4,26
"30219","6180橘子","110/07/08","元大-土城學府",0,89,-89
"30220","6180橘子","110/07/08","康和-台南",22,0,22
"30221","6180橘子","110/07/08","凱基-東勢",1,66,-65
"30222","6180橘子","110/07/08","國泰-板橋",22,0,22
"30223","6180橘子","110/07/08","光和",0,64,-64
"30224","6180橘子","110/07/08","日盛-文化",21,0,21
"30225","6180橘子","110/07/08","中國信託-忠孝",0,50,-50
"30226","6180橘子","110/07/08","中國信託-文心",20,2,18
"30227","6180橘子","110/07/08","元富-大裕",0,25,-25
"30228","6180橘子","110/07/08","凱基-台北",39,24,15
"30229","6180橘子","110/07/08","統一-基隆",1,25,-24
"30230","6180橘子","110/07/08","元富-新店",14,0,14
"30231","6180橘子","110/07/08","美商高盛",1,21,-20
"30232","6180橘子","110/07/08","元大-土城永寧",11,0,11
"30233","6180橘子","110/07/08","元大證券",1,19,-18
"30234","6180橘子","110/07/08","永豐金-南京",11,0,11
"30235","6180橘子","110/07/08","元大-太平",2,20,-18
"30236","6180橘子","110/07/08","宏遠-館前",10,0,10
"30237","6180橘子","110/07/08","合庫證券",2,18,-16
"30238","6180橘子","110/07/08","國泰-新莊",10,0,10
"30239","6180橘子","110/07/08","台灣摩根士丹利",1,12,-11
"30240","6180橘子","110/07/08","群益金鼎",10,0,10
"30241","6180橘子","110/07/08","瑞士信貸",0,11,-11
"30242","6180橘子","110/07/08","凱基-高雄",10,0,10
"30243","6180橘子","110/07/08","元富-嘉義",0,11,-11
"30244","6180橘子","110/07/08","凱基-大安",10,0,10
"30245","6180橘子","110/07/08","新光-高雄",0,11,-11
"30246","6180橘子","110/07/08","富邦-仁愛",10,0,10
"30247","6180橘子","110/07/08","大慶-苗栗",0,10,-10
"30248","2390云辰","110/07/08","統一-新台中",126,1,125
"30249","2390云辰","110/07/08","摩根大通",62,661,-599
"30250","2390云辰","110/07/08","元大-員林",111,0,111
"30251","2390云辰","110/07/08","新加坡商瑞銀",0,173,-173
"30252","2390云辰","110/07/08","合庫-高雄",105,0,105
"30253","2390云辰","110/07/08","元大-天母",7,150,-143
"30254","2390云辰","110/07/08","凱基-台北",255,177,78
"30255","2390云辰","110/07/08","台灣摩根士丹利",0,134,-134
"30256","2390云辰","110/07/08","新光",71,17,54
"30257","2390云辰","110/07/08","玉山-台中",17,120,-103
"30258","2390云辰","110/07/08","國票-嘉義",53,0,53
"30259","2390云辰","110/07/08","美商高盛",0,78,-78
"30260","2390云辰","110/07/08","富邦-仁愛",53,4,49
"30261","2390云辰","110/07/08","美林",11,82,-71
"30262","2390云辰","110/07/08","兆豐-城中",48,0,48
"30263","2390云辰","110/07/08","群益金鼎-大興",35,106,-71
"30264","2390云辰","110/07/08","元大-新營",47,0,47
"30265","2390云辰","110/07/08","光和",11,71,-60
"30266","2390云辰","110/07/08","國泰-敦南",89,55,34
"30267","2390云辰","110/07/08","國泰-台中",28,70,-42
"30268","2390云辰","110/07/08","兆豐-台中",40,7,33
"30269","2390云辰","110/07/08","玉山-新莊",6,46,-40
"30270","2390云辰","110/07/08","永豐金-中正",36,6,30
"30271","2390云辰","110/07/08","富邦-台北",21,57,-36
"30272","2390云辰","110/07/08","中國信託-三重",29,0,29
"30273","2390云辰","110/07/08","土銀-台中",0,30,-30
"30274","2390云辰","110/07/08","富邦-陽明",33,5,28
"30275","2390云辰","110/07/08","兆豐-埔墘",1,31,-30
"30276","2390云辰","110/07/08","元富-桃園",27,0,27
"30277","2390云辰","110/07/08","玉山-南京東路",3,33,-30
"30278","4903聯光通","110/07/07","元大-太平",47,4,43
"30279","4903聯光通","110/07/07","日盛-板橋",0,15,-15
"30280","4903聯光通","110/07/07","華南永昌-桃園",10,0,10
"30281","4903聯光通","110/07/07","元大-八德",0,9,-9
"30282","4903聯光通","110/07/07","元大-南投",9,0,9
"30283","4903聯光通","110/07/07","宏遠證券",0,7,-7
"30284","4903聯光通","110/07/07","新光-台中",3,0,3
"30285","4903聯光通","110/07/07","大慶",0,7,-7
"30286","4903聯光通","110/07/07","國泰-敦南",1,0,1
"30287","4903聯光通","110/07/07","群益金鼎-館前",0,6,-6
"30288","4903聯光通","110/07/07","國票-中正",0,0,0
"30289","4903聯光通","110/07/07","元大-羅東",0,5,-5
"30290","4903聯光通","110/07/07","康和-內湖",0,0,0
"30291","4903聯光通","110/07/07","新光",8,12,-4
"30292","4903聯光通","110/07/07","凱基-站前",0,0,0
"30293","4903聯光通","110/07/07","國泰-高雄",0,3,-3
"30294","4903聯光通","110/07/07","華南永昌",1,1,0
"30295","4903聯光通","110/07/07","第一金-台中",0,3,-3
"30296","4903聯光通","110/07/07","華南永昌-新莊",0,0,0
"30297","4903聯光通","110/07/07","中農",0,1,-1
"30298","4903聯光通","110/07/07","臺灣企銀-桃園",0,1,-1
"30299","4903聯光通","110/07/07","台新-新營",0,1,-1
"30300","4903聯光通","110/07/07","元大-鶯歌",2,3,-1
"30301","4903聯光通","110/07/07","元大-永和",0,1,-1
"30302","4903聯光通","110/07/07","元大-苑裡",0,1,-1
"30303","2929淘帝","110/07/07","統一",163,0,163
"30304","2929淘帝","110/07/07","新光-台中",57,142,-85
"30305","2929淘帝","110/07/07","港商野村",323,181,142
"30306","2929淘帝","110/07/07","兆豐-忠孝",0,76,-76
"30307","2929淘帝","110/07/07","日盛-中壢",132,10,122
"30308","2929淘帝","110/07/07","台新-建北",0,53,-53
"30309","2929淘帝","110/07/07","新加坡商瑞銀",140,19,121
"30310","2929淘帝","110/07/07","臺銀-鳳山",0,44,-44
"30311","2929淘帝","110/07/07","日盛-嘉義",101,0,101
"30312","2929淘帝","110/07/07","元大-新盛",0,42,-42
"30313","2929淘帝","110/07/07","摩根大通",101,16,85
"30314","2929淘帝","110/07/07","富邦-建國",6,47,-41
"30315","2929淘帝","110/07/07","元大-太平",55,2,53
"30316","2929淘帝","110/07/07","日盛-園區",0,40,-40
"30317","2929淘帝","110/07/07","元富-松德",50,1,49
"30318","2929淘帝","110/07/07","新光-高雄",1,38,-37
"30319","2929淘帝","110/07/07","凱基-板橋",53,5,48
"30320","2929淘帝","110/07/07","永豐金-三重",1,34,-33
"30321","2929淘帝","110/07/07","美林",80,34,46
"30322","2929淘帝","110/07/07","元大-彰化",0,31,-31
"30323","2929淘帝","110/07/07","元富-台南",41,0,41
"30324","2929淘帝","110/07/07","第一金-大稻埕",0,30,-30
"30325","2929淘帝","110/07/07","兆豐-竹北",39,0,39
"30326","2929淘帝","110/07/07","國泰-敦南",3,33,-30
"30327","2929淘帝","110/07/07","元大-西門",36,0,36
"30328","2929淘帝","110/07/07","富邦-員林",0,30,-30
"30329","2929淘帝","110/07/07","華南永昌",39,4,35
"30330","2929淘帝","110/07/07","元大-蘆洲",1,30,-29
"30331","2929淘帝","110/07/07","日盛-板橋中山",30,0,30
"30332","2929淘帝","110/07/07","台新-台南",4,32,-28
"30333","5410國眾","110/07/07","兆豐-城中",66,0,66
"30334","5410國眾","110/07/07","富邦-仁愛",0,115,-115
"30335","5410國眾","110/07/07","摩根大通",21,0,21
"30336","5410國眾","110/07/07","亞東-板橋",0,38,-38
"30337","5410國眾","110/07/07","元大-北投",21,0,21
"30338","5410國眾","110/07/07","凱基-台北",2,24,-22
"30339","5410國眾","110/07/07","亞東-新竹",15,0,15
"30340","5410國眾","110/07/07","彰銀-七賢",0,10,-10
"30341","5410國眾","110/07/07","元大-福營",12,0,12
"30342","5410國眾","110/07/07","凱基-基隆",0,10,-10
"30343","5410國眾","110/07/07","新光-高雄",11,0,11
"30344","5410國眾","110/07/07","凱基-屏東",0,10,-10
"30345","5410國眾","110/07/07","華南永昌-小港",10,0,10
"30346","5410國眾","110/07/07","凱基-鳳山",0,10,-10
"30347","5410國眾","110/07/07","元大-大灣",10,0,10
"30348","5410國眾","110/07/07","永豐金-忠孝",0,10,-10
"30349","5410國眾","110/07/07","元大-莒光",10,0,10
"30350","5410國眾","110/07/07","日盛-板橋中山",0,9,-9
"30351","5410國眾","110/07/07","台中銀-豐原",9,0,9
"30352","5410國眾","110/07/07","統一-高雄",0,5,-5
"30353","5410國眾","110/07/07","元大-南屯",9,0,9
"30354","5410國眾","110/07/07","元大-斗六",0,5,-5
"30355","5410國眾","110/07/07","日盛-新莊",7,0,7
"30356","5410國眾","110/07/07","元大-大益",0,5,-5
"30357","5410國眾","110/07/07","元富-大昌",6,0,6
"30358","5410國眾","110/07/07","元大-南投",0,5,-5
"30359","5410國眾","110/07/07","新光-新竹",6,0,6
"30360","5410國眾","110/07/07","永豐金-員林",0,5,-5
"30361","5410國眾","110/07/07","臺銀-金山",5,0,5
"30362","5410國眾","110/07/07","華南永昌-楠梓",0,4,-4
"30363","2841台開","110/07/07","永豐金-豐原",268,0,268
"30364","2841台開","110/07/07","凱基-市政",0,200,-200
"30365","2841台開","110/07/07","永豐金-南投",200,0,200
"30366","2841台開","110/07/07","永豐金-彰化",0,100,-100
"30367","2841台開","110/07/07","新光",139,9,130
"30368","2841台開","110/07/07","元大-開元",1,93,-92
"30369","2841台開","110/07/07","中國信託-高雄",50,1,49
"30370","2841台開","110/07/07","港商野村",0,80,-80
"30371","2841台開","110/07/07","元大-歸仁",40,0,40
"30372","2841台開","110/07/07","凱基-台南",25,85,-60
"30373","2841台開","110/07/07","台中銀",35,0,35
"30374","2841台開","110/07/07","美商高盛",1,58,-57
"30375","2841台開","110/07/07","台新-新營",30,0,30
"30376","2841台開","110/07/07","統一-三重",0,55,-55
"30377","2841台開","110/07/07","富邦-台南",30,0,30
"30378","2841台開","110/07/07","台新證券",12,50,-38
"30379","2841台開","110/07/07","國泰-板橋",30,1,29
"30380","2841台開","110/07/07","陽信-石牌",0,31,-31
"30381","2841台開","110/07/07","凱基-文心",28,0,28
"30382","2841台開","110/07/07","元大-福營",0,31,-31
"30383","2841台開","110/07/07","凱基-站前",27,0,27
"30384","2841台開","110/07/07","第一金-澎湖",0,30,-30
"30385","2841台開","110/07/07","大昌-安康",38,16,22
"30386","2841台開","110/07/07","元大-新莊",0,30,-30
"30387","2841台開","110/07/07","合庫-台中",20,0,20
"30388","2841台開","110/07/07","國泰-館前",0,28,-28
"30389","2841台開","110/07/07","日盛-台南",20,0,20
"30390","2841台開","110/07/07","元大-竹科",0,25,-25
"30391","2841台開","110/07/07","台中銀-員林",20,0,20
"30392","2841台開","110/07/07","富邦-仁愛",1,22,-21
"30393","6207雷科","110/07/07","元大-大天母",21,0,21
"30394","6207雷科","110/07/07","元大-高雄",0,105,-105
"30395","6207雷科","110/07/07","元大-頭份",18,0,18
"30396","6207雷科","110/07/07","永豐金-中正",0,35,-35
"30397","6207雷科","110/07/07","第一金-新興",16,0,16
"30398","6207雷科","110/07/07","摩根大通",8,39,-31
"30399","6207雷科","110/07/07","富邦-虎尾",12,0,12
"30400","6207雷科","110/07/07","元大-林園",0,30,-30
"30401","6207雷科","110/07/07","兆豐-板橋",10,0,10
"30402","6207雷科","110/07/07","凱基-台北",0,19,-19
"30403","6207雷科","110/07/07","玉山-台大",10,0,10
"30404","6207雷科","110/07/07","國票-中和",13,25,-12
"30405","6207雷科","110/07/07","元大-四維",10,0,10
"30406","6207雷科","110/07/07","新加坡商瑞銀",0,9,-9
"30407","6207雷科","110/07/07","元大-鹿港",10,0,10
"30408","6207雷科","110/07/07","玉山-高雄",0,8,-8
"30409","6207雷科","110/07/07","元大-信義",10,0,10
"30410","6207雷科","110/07/07","玉山-台南",0,8,-8
"30411","6207雷科","110/07/07","台新-三民",8,0,8
"30412","6207雷科","110/07/07","宏遠-高雄",0,5,-5
"30413","6207雷科","110/07/07","元大-上新莊",8,0,8
"30414","6207雷科","110/07/07","元大-南海",0,5,-5
"30415","6207雷科","110/07/07","大昌-桃園",7,0,7
"30416","6207雷科","110/07/07","元大-莒光",0,4,-4
"30417","6207雷科","110/07/07","新光-台中",10,4,6
"30418","6207雷科","110/07/07","港商野村",0,3,-3
"30419","6207雷科","110/07/07","日盛-頭份",5,0,5
"30420","6207雷科","110/07/07","大慶-台南",0,3,-3
"30421","6207雷科","110/07/07","日茂-埔里",5,0,5
"30422","6207雷科","110/07/07","凱基-站前",0,3,-3
"30423","3679新至陞","110/07/07","永豐金證券",18,0,18
"30424","3679新至陞","110/07/07","美林",0,13,-13
"30425","3679新至陞","110/07/07","元大-文心興安",6,0,6
"30426","3679新至陞","110/07/07","兆豐-大安",0,10,-10
"30427","3679新至陞","110/07/07","中農",5,0,5
"30428","3679新至陞","110/07/07","國泰-桃園",0,4,-4
"30429","3679新至陞","110/07/07","台新證券",4,0,4
"30430","3679新至陞","110/07/07","永豐金-虎尾",0,4,-4
"30431","3679新至陞","110/07/07","華南永昌-小港",4,0,4
"30432","3679新至陞","110/07/07","台灣摩根士丹利",0,3,-3
"30433","3679新至陞","110/07/07","元大-天母",4,0,4
"30434","3679新至陞","110/07/07","瑞士信貸",0,3,-3
"30435","3679新至陞","110/07/07","台中銀-員林",4,1,3
"30436","3679新至陞","110/07/07","統一-新竹",0,3,-3
"30437","3679新至陞","110/07/07","摩根大通",4,1,3
"30438","3679新至陞","110/07/07","統一-三重",0,3,-3
"30439","3679新至陞","110/07/07","凱基-台北",7,4,3
"30440","3679新至陞","110/07/07","凱基-竹北",0,3,-3
"30441","3679新至陞","110/07/07","華南永昌-高雄",3,0,3
"30442","3679新至陞","110/07/07","元富-世貿",0,2,-2
"30443","3679新至陞","110/07/07","永豐金-潮州",2,0,2
"30444","3679新至陞","110/07/07","兆豐-鹿港",0,2,-2
"30445","3679新至陞","110/07/07","合庫-新竹",1,0,1
"30446","3679新至陞","110/07/07","玉山-台大",0,2,-2
"30447","3679新至陞","110/07/07","土銀-高雄",1,0,1
"30448","3679新至陞","110/07/07","國泰-館前",0,2,-2
"30449","3679新至陞","110/07/07","元富-新興",1,0,1
"30450","3679新至陞","110/07/07","群益金鼎-新莊",0,2,-2
"30451","3679新至陞","110/07/07","富邦-中壢",1,0,1
"30452","3679新至陞","110/07/07","元大-桃園",0,2,-2
"30453","2727王品","110/07/07","第一金",62,0,62
"30454","2727王品","110/07/07","台灣摩根士丹利",1,177,-176
"30455","2727王品","110/07/07","凱基-埔墘",40,0,40
"30456","2727王品","110/07/07","凱基-台北",49,151,-102
"30457","2727王品","110/07/07","中國信託-忠孝",40,1,39
"30458","2727王品","110/07/07","摩根大通",19,107,-88
"30459","2727王品","110/07/07","玉山-板橋",40,6,34
"30460","2727王品","110/07/07","美商高盛",2,86,-84
"30461","2727王品","110/07/07","亞東-新竹",31,1,30
"30462","2727王品","110/07/07","元大-北屯",1,52,-51
"30463","2727王品","110/07/07","群益金鼎-宜蘭",25,1,24
"30464","2727王品","110/07/07","國泰證券",1,47,-46
"30465","2727王品","110/07/07","富邦-竹北",23,0,23
"30466","2727王品","110/07/07","統一",3,33,-30
"30467","2727王品","110/07/07","元大-旗山",23,0,23
"30468","2727王品","110/07/07","第一金-台中",1,30,-29
"30469","2727王品","110/07/07","元富-宜蘭",21,0,21
"30470","2727王品","110/07/07","華南永昌-中正",4,29,-25
"30471","2727王品","110/07/07","國票-長城",20,0,20
"30472","2727王品","110/07/07","美林",0,23,-23
"30473","2727王品","110/07/07","台新證券",47,28,19
"30474","2727王品","110/07/07","群益金鼎-館前",0,20,-20
"30475","2727王品","110/07/07","富邦-新竹華信",18,1,17
"30476","2727王品","110/07/07","國票-內壢",0,16,-16
"30477","2727王品","110/07/07","永豐金-中正",18,1,17
"30478","2727王品","110/07/07","兆豐-新莊",0,15,-15
"30479","2727王品","110/07/07","華南永昌-麻豆",17,1,16
"30480","2727王品","110/07/07","港商野村",15,28,-13
"30481","2727王品","110/07/07","永豐金-潮州",15,0,15
"30482","2727王品","110/07/07","元大-善化",1,13,-12
"30483","1570力肯","110/07/07","台新證券",88,0,88
"30484","1570力肯","110/07/07","新光",0,54,-54
"30485","1570力肯","110/07/07","摩根大通",49,15,34
"30486","1570力肯","110/07/07","元大-高雄",0,40,-40
"30487","1570力肯","110/07/07","合庫-桃園",20,0,20
"30488","1570力肯","110/07/07","國票-北高雄",38,50,-12
"30489","1570力肯","110/07/07","元大-土城學府",20,0,20
"30490","1570力肯","110/07/07","群益金鼎-嘉義",0,10,-10
"30491","1570力肯","110/07/07","永豐金-板盛",18,0,18
"30492","1570力肯","110/07/07","元大-草屯",0,10,-10
"30493","1570力肯","110/07/07","永豐金-永康",18,0,18
"30494","1570力肯","110/07/07","日盛-高雄",0,9,-9
"30495","1570力肯","110/07/07","統一-員林",14,0,14
"30496","1570力肯","110/07/07","第一金-路竹",0,9,-9
"30497","1570力肯","110/07/07","元大-竹山",6,0,6
"30498","1570力肯","110/07/07","元大-古亭",0,9,-9
"30499","1570力肯","110/07/07","統一-敦南",5,0,5
"30500","1570力肯","110/07/07","國票-中正",0,8,-8
"30501","1570力肯","110/07/07","元大-永和",5,0,5
"30502","1570力肯","110/07/07","群益金鼎-鳳山",0,6,-6
"30503","1570力肯","110/07/07","元富-大裕",4,0,4
"30504","1570力肯","110/07/07","元大-土城永寧",0,6,-6
"30505","1570力肯","110/07/07","華南永昌-斗六",4,0,4
"30506","1570力肯","110/07/07","中國信託",0,5,-5
"30507","1570力肯","110/07/07","永豐金-松山",6,3,3
"30508","1570力肯","110/07/07","日盛-板橋",0,4,-4
"30509","1570力肯","110/07/07","永豐金-南投",4,1,3
"30510","1570力肯","110/07/07","日盛-木柵",0,4,-4
"30511","1570力肯","110/07/07","土銀-彰化",2,0,2
"30512","1570力肯","110/07/07","玉山-桃園",0,4,-4
"30513","6180橘子","110/07/07","臺銀-金山",27,0,27
"30514","6180橘子","110/07/07","凱基-台北",6,36,-30
"30515","6180橘子","110/07/07","元富-潮州",20,0,20
"30516","6180橘子","110/07/07","元大-天母",1,26,-25
"30517","6180橘子","110/07/07","凱基-中山",20,0,20
"30518","6180橘子","110/07/07","富邦-陽明",0,22,-22
"30519","6180橘子","110/07/07","元大-太平",23,4,19
"30520","6180橘子","110/07/07","日盛-頭份",0,20,-20
"30521","6180橘子","110/07/07","摩根大通",17,0,17
"30522","6180橘子","110/07/07","富邦-仁愛",0,20,-20
"30523","6180橘子","110/07/07","元大-草屯",20,3,17
"30524","6180橘子","110/07/07","永豐金-新莊",0,20,-20
"30525","6180橘子","110/07/07","華南永昌-楠梓",15,1,14
"30526","6180橘子","110/07/07","台灣摩根士丹利",0,18,-18
"30527","6180橘子","110/07/07","中國信託-永康",12,0,12
"30528","6180橘子","110/07/07","華南永昌-長虹",1,16,-15
"30529","6180橘子","110/07/07","日盛-文化",10,0,10
"30530","6180橘子","110/07/07","新光-新竹",0,12,-12
"30531","6180橘子","110/07/07","國泰-館前",10,0,10
"30532","6180橘子","110/07/07","凱基-中壢",0,12,-12
"30533","6180橘子","110/07/07","華南永昌-鶯歌",10,0,10
"30534","6180橘子","110/07/07","第一金-忠孝",0,11,-11
"30535","6180橘子","110/07/07","元大-豐原站前",10,0,10
"30536","6180橘子","110/07/07","元大-沙鹿",0,11,-11
"30537","6180橘子","110/07/07","元大-北屯",10,0,10
"30538","6180橘子","110/07/07","永豐金-羅東",0,11,-11
"30539","6180橘子","110/07/07","兆豐-台中",10,1,9
"30540","6180橘子","110/07/07","兆豐-埔墘",0,10,-10
"30541","6180橘子","110/07/07","群益金鼎-開元",9,0,9
"30542","6180橘子","110/07/07","華南永昌-台中",0,10,-10
"30543","2390云辰","110/07/07","元大-向上",144,0,144
"30544","2390云辰","110/07/07","摩根大通",18,674,-656
"30545","2390云辰","110/07/07","元富-中港",102,0,102
"30546","2390云辰","110/07/07","凱基-台北",141,625,-484
"30547","2390云辰","110/07/07","群益金鼎-民權",104,4,100
"30548","2390云辰","110/07/07","美林",32,261,-229
"30549","2390云辰","110/07/07","兆豐-忠孝",81,0,81
"30550","2390云辰","110/07/07","新加坡商瑞銀",50,149,-99
"30551","2390云辰","110/07/07","合庫-新竹",60,0,60
"30552","2390云辰","110/07/07","台灣摩根士丹利",7,87,-80
"30553","2390云辰","110/07/07","元大-土城學府",59,1,58
"30554","2390云辰","110/07/07","元大-金華",2,68,-66
"30555","2390云辰","110/07/07","玉山-大里",58,3,55
"30556","2390云辰","110/07/07","國票-新莊",13,65,-52
"30557","2390云辰","110/07/07","元大-東蘆",54,1,53
"30558","2390云辰","110/07/07","凱基-三重",12,56,-44
"30559","2390云辰","110/07/07","元富-三重",51,0,51
"30560","2390云辰","110/07/07","新光-台中",23,65,-42
"30561","2390云辰","110/07/07","元富-埔里",50,0,50
"30562","2390云辰","110/07/07","第一金-中壢",5,45,-40
"30563","2390云辰","110/07/07","中國信託-三重",52,3,49
"30564","2390云辰","110/07/07","華南永昌-斗六",0,40,-40
"30565","2390云辰","110/07/07","元大-彰化民生",64,15,49
"30566","2390云辰","110/07/07","富邦-新竹華信",25,61,-36
"30567","2390云辰","110/07/07","元大-潮州",50,5,45
"30568","2390云辰","110/07/07","玉山-新莊",2,32,-30
"30569","2390云辰","110/07/07","元富-高雄",57,14,43
"30570","2390云辰","110/07/07","凱基-新豐",17,47,-30
"30571","2390云辰","110/07/07","凱基-和平",40,0,40
"30572","2390云辰","110/07/07","統一-汐止",1,29,-28
"30573","4903聯光通","110/07/06","元大-苗栗",10,0,10
"30574","4903聯光通","110/07/06","宏遠證券",0,13,-13
"30575","4903聯光通","110/07/06","彰銀",5,0,5
"30576","4903聯光通","110/07/06","富邦-新營",0,4,-4
"30577","4903聯光通","110/07/06","元大-松山",5,0,5
"30578","4903聯光通","110/07/06","元富-草屯",0,3,-3
"30579","4903聯光通","110/07/06","新光",3,0,3
"30580","4903聯光通","110/07/06","元大-羅東",0,3,-3
"30581","4903聯光通","110/07/06","群益金鼎-館前",1,0,1
"30582","4903聯光通","110/07/06","元大-北三重",0,2,-2
"30583","4903聯光通","110/07/06","華南永昌-鶯歌",1,0,1
"30584","4903聯光通","110/07/06","國泰-敦南",0,1,-1
"30585","4903聯光通","110/07/06","永豐金-市政",1,0,1
"30586","4903聯光通","110/07/06","元富-板橋",0,0,0
"30587","4903聯光通","110/07/06","元富-板橋",0,0,0
"30588","4903聯光通","110/07/06","華南永昌",0,0,0
"30589","4903聯光通","110/07/06","華南永昌",0,0,0
"30590","4903聯光通","110/07/06","元大-太平",2,2,0
"30591","4903聯光通","110/07/06","元大-太平",2,2,0
"30592","2929淘帝","110/07/06","新光",204,85,119
"30593","2929淘帝","110/07/06","港商野村",62,282,-220
"30594","2929淘帝","110/07/06","日盛-中壢",94,0,94
"30595","2929淘帝","110/07/06","摩根大通",64,264,-200
"30596","2929淘帝","110/07/06","元富-城東",84,0,84
"30597","2929淘帝","110/07/06","統一",0,163,-163
"30598","2929淘帝","110/07/06","日盛-雙和",55,0,55
"30599","2929淘帝","110/07/06","香港上海匯豐",0,141,-141
"30600","2929淘帝","110/07/06","第一金-路竹",71,17,54
"30601","2929淘帝","110/07/06","新加坡商瑞銀",54,179,-125
"30602","2929淘帝","110/07/06","元大-花蓮",44,2,42
"30603","2929淘帝","110/07/06","合庫-高雄",3,122,-119
"30604","2929淘帝","110/07/06","永豐金-大園",73,33,40
"30605","2929淘帝","110/07/06","美林",34,118,-84
"30606","2929淘帝","110/07/06","元大-太平",44,6,38
"30607","2929淘帝","110/07/06","元大-員林",2,82,-80
"30608","2929淘帝","110/07/06","國泰-板橋",40,5,35
"30609","2929淘帝","110/07/06","元富-松德",26,75,-49
"30610","2929淘帝","110/07/06","兆豐-內湖",33,1,32
"30611","2929淘帝","110/07/06","臺銀-臺南",9,52,-43
"30612","2929淘帝","110/07/06","元大-博愛",43,11,32
"30613","2929淘帝","110/07/06","元大-北投",5,48,-43
"30614","2929淘帝","110/07/06","日盛-竹北",40,10,30
"30615","2929淘帝","110/07/06","臺銀-民權",1,41,-40
"30616","2929淘帝","110/07/06","元大-善化",52,22,30
"30617","2929淘帝","110/07/06","兆豐-忠孝",1,41,-40
"30618","2929淘帝","110/07/06","富邦-北港",29,0,29
"30619","2929淘帝","110/07/06","元大-西門",1,36,-35
"30620","2929淘帝","110/07/06","凱基-湖口",27,0,27
"30621","2929淘帝","110/07/06","玉山-嘉義",3,35,-32
"30622","5410國眾","110/07/06","兆豐-城中",28,0,28
"30623","5410國眾","110/07/06","凱基-高美館",1,18,-17
"30624","5410國眾","110/07/06","元大-小港",20,0,20
"30625","5410國眾","110/07/06","國泰-館前",0,15,-15
"30626","5410國眾","110/07/06","元大-新盛",18,0,18
"30627","5410國眾","110/07/06","國泰-板橋",2,17,-15
"30628","5410國眾","110/07/06","香港上海匯豐",15,0,15
"30629","5410國眾","110/07/06","新光",0,13,-13
"30630","5410國眾","110/07/06","華南永昌-小港",15,0,15
"30631","5410國眾","110/07/06","元富-緯城",0,10,-10
"30632","5410國眾","110/07/06","元富-大昌",13,0,13
"30633","5410國眾","110/07/06","中農",0,10,-10
"30634","5410國眾","110/07/06","臺銀-臺南",10,0,10
"30635","5410國眾","110/07/06","凱基-屏東",0,10,-10
"30636","5410國眾","110/07/06","元富-延平",8,0,8
"30637","5410國眾","110/07/06","新光-桃園",0,6,-6
"30638","5410國眾","110/07/06","元大-八德",17,9,8
"30639","5410國眾","110/07/06","高橋-龍潭",0,5,-5
"30640","5410國眾","110/07/06","摩根大通",7,0,7
"30641","5410國眾","110/07/06","元富-世貿",0,5,-5
"30642","5410國眾","110/07/06","凱基-桃園",7,0,7
"30643","5410國眾","110/07/06","群益金鼎-瑞豐",0,5,-5
"30644","5410國眾","110/07/06","永豐金-屏東",7,0,7
"30645","5410國眾","110/07/06","富邦-台中",0,5,-5
"30646","5410國眾","110/07/06","台新-左楠",5,0,5
"30647","5410國眾","110/07/06","永豐金-板橋",0,5,-5
"30648","5410國眾","110/07/06","富邦-竹東",5,0,5
"30649","5410國眾","110/07/06","富邦-台南",0,4,-4
"30650","5410國眾","110/07/06","元大-新莊",5,0,5
"30651","5410國眾","110/07/06","凱基-站前",0,3,-3
"30652","2841台開","110/07/06","群益金鼎-忠孝",100,0,100
"30653","2841台開","110/07/06","港商野村",0,295,-295
"30654","2841台開","110/07/06","台新證券",58,0,58
"30655","2841台開","110/07/06","元大-善化",0,50,-50
"30656","2841台開","110/07/06","台新-台中",58,0,58
"30657","2841台開","110/07/06","元大-四維",0,50,-50
"30658","2841台開","110/07/06","永豐金-敦南",50,0,50
"30659","2841台開","110/07/06","台新-新營",0,30,-30
"30660","2841台開","110/07/06","元大-台中",45,0,45
"30661","2841台開","110/07/06","群益金鼎-桃園",0,21,-21
"30662","2841台開","110/07/06","凱基-文心",43,0,43
"30663","2841台開","110/07/06","台中銀-員林",0,20,-20
"30664","2841台開","110/07/06","永豐金-潮州",30,0,30
"30665","2841台開","110/07/06","群益金鼎-延平",0,15,-15
"30666","2841台開","110/07/06","第一金-自由",25,0,25
"30667","2841台開","110/07/06","元大-三重",0,13,-13
"30668","2841台開","110/07/06","美商高盛",17,0,17
"30669","2841台開","110/07/06","元富-古亭",0,10,-10
"30670","2841台開","110/07/06","大昌-安康",39,22,17
"30671","2841台開","110/07/06","群益金鼎-北高雄",0,10,-10
"30672","2841台開","110/07/06","台中銀",15,0,15
"30673","2841台開","110/07/06","華南永昌-南京",0,10,-10
"30674","2841台開","110/07/06","玉山-嘉義",15,0,15
"30675","2841台開","110/07/06","富邦-花蓮",0,10,-10
"30676","2841台開","110/07/06","新光",11,0,11
"30677","2841台開","110/07/06","富邦-高雄",0,10,-10
"30678","2841台開","110/07/06","兆豐-永和",10,0,10
"30679","2841台開","110/07/06","元大-竹山",0,10,-10
"30680","2841台開","110/07/06","康和-內湖",10,0,10
"30681","2841台開","110/07/06","元大-屏東",0,10,-10
"30682","6207雷科","110/07/06","新光",45,4,41
"30683","6207雷科","110/07/06","凱基-高美館",1,104,-103
"30684","6207雷科","110/07/06","統一-基隆",30,0,30
"30685","6207雷科","110/07/06","摩根大通",11,45,-34
"30686","6207雷科","110/07/06","康和-南崁",13,0,13
"30687","6207雷科","110/07/06","群益金鼎-新竹",0,22,-22
"30688","6207雷科","110/07/06","宏遠-台南",10,0,10
"30689","6207雷科","110/07/06","港商野村",2,23,-21
"30690","6207雷科","110/07/06","國票-和平",10,0,10
"30691","6207雷科","110/07/06","凱基-台北",0,14,-14
"30692","6207雷科","110/07/06","永豐金-天母",10,0,10
"30693","6207雷科","110/07/06","台新-三民",0,12,-12
"30694","6207雷科","110/07/06","台新證券",10,1,9
"30695","6207雷科","110/07/06","群益金鼎-開元",1,11,-10
"30696","6207雷科","110/07/06","群益金鼎-士林",8,0,8
"30697","6207雷科","110/07/06","富邦-南屯",0,8,-8
"30698","6207雷科","110/07/06","群益金鼎-瑞豐",7,0,7
"30699","6207雷科","110/07/06","元大-善化",0,8,-8
"30700","6207雷科","110/07/06","元大-四維",7,0,7
"30701","6207雷科","110/07/06","日盛-頭份",0,5,-5
"30702","6207雷科","110/07/06","國票-中和",6,0,6
"30703","6207雷科","110/07/06","第一金-高雄",0,5,-5
"30704","6207雷科","110/07/06","台新-中壢",6,0,6
"30705","6207雷科","110/07/06","凱基-八德",0,5,-5
"30706","6207雷科","110/07/06","凱基-高雄",6,0,6
"30707","6207雷科","110/07/06","凱基-頭份",0,5,-5
"30708","6207雷科","110/07/06","富邦-彰化",6,0,6
"30709","6207雷科","110/07/06","合庫-新竹",0,4,-4
"30710","6207雷科","110/07/06","凱基-大安",5,0,5
"30711","6207雷科","110/07/06","新光-高雄",0,4,-4
"30712","3679新至陞","110/07/06","凱基",11,0,11
"30713","3679新至陞","110/07/06","摩根大通",0,22,-22
"30714","3679新至陞","110/07/06","台中銀-員林",11,1,10
"30715","3679新至陞","110/07/06","凱基-台北",6,21,-15
"30716","3679新至陞","110/07/06","安泰-大發",10,0,10
"30717","3679新至陞","110/07/06","瑞士信貸",0,13,-13
"30718","3679新至陞","110/07/06","香港上海匯豐",8,0,8
"30719","3679新至陞","110/07/06","富邦-苗栗",0,10,-10
"30720","3679新至陞","110/07/06","永豐金證券",8,2,6
"30721","3679新至陞","110/07/06","元大-永春",0,6,-6
"30722","3679新至陞","110/07/06","第一金-高雄",5,0,5
"30723","3679新至陞","110/07/06","凱基-興隆",0,5,-5
"30724","3679新至陞","110/07/06","群益金鼎-高盛",3,0,3
"30725","3679新至陞","110/07/06","國泰-桃園",0,3,-3
"30726","3679新至陞","110/07/06","元大-嘉義",3,0,3
"30727","3679新至陞","110/07/06","元大-萬華",2,5,-3
"30728","3679新至陞","110/07/06","臺銀-高雄",2,0,2
"30729","3679新至陞","110/07/06","美林",0,2,-2
"30730","3679新至陞","110/07/06","日盛-復興",2,0,2
"30731","3679新至陞","110/07/06","第一金-華江",0,2,-2
"30732","3679新至陞","110/07/06","日盛-樹林",4,2,2
"30733","3679新至陞","110/07/06","新光-台中",0,2,-2
"30734","3679新至陞","110/07/06","宏遠-館前",2,0,2
"30735","3679新至陞","110/07/06","華南永昌-民權",0,2,-2
"30736","3679新至陞","110/07/06","台新證券",2,0,2
"30737","3679新至陞","110/07/06","元大-板橋",0,2,-2
"30738","3679新至陞","110/07/06","康和-板橋",2,0,2
"30739","3679新至陞","110/07/06","日盛-板橋中山",0,1,-1
"30740","3679新至陞","110/07/06","群益金鼎-台南",2,0,2
"30741","3679新至陞","110/07/06","宏遠證券",0,1,-1
"30742","2727王品","110/07/06","元大證券",1033,729,304
"30743","2727王品","110/07/06","台灣摩根士丹利",35,184,-149
"30744","2727王品","110/07/06","富邦-台北",332,46,286
"30745","2727王品","110/07/06","元大-北屯",11,79,-68
"30746","2727王品","110/07/06","統一",252,43,209
"30747","2727王品","110/07/06","元富-敦南",4,70,-66
"30748","2727王品","110/07/06","永豐金-松山",147,14,133
"30749","2727王品","110/07/06","元大-基隆孝二",11,75,-64
"30750","2727王品","110/07/06","富邦-嘉義",301,198,103
"30751","2727王品","110/07/06","臺銀-臺南",9,69,-60
"30752","2727王品","110/07/06","新加坡商瑞銀",128,34,94
"30753","2727王品","110/07/06","中國信託-忠孝",5,48,-43
"30754","2727王品","110/07/06","元富-台南",97,6,91
"30755","2727王品","110/07/06","永豐金-市政",5,46,-41
"30756","2727王品","110/07/06","台新證券",169,105,64
"30757","2727王品","110/07/06","彰銀-台中",19,56,-37
"30758","2727王品","110/07/06","美林",115,58,57
"30759","2727王品","110/07/06","玉山證券",30,67,-37
"30760","2727王品","110/07/06","華南永昌",75,23,52
"30761","2727王品","110/07/06","凱基-埔墘",4,41,-37
"30762","2727王品","110/07/06","凱基-台北",445,398,47
"30763","2727王品","110/07/06","永豐金-大園",3,40,-37
"30764","2727王品","110/07/06","凱基-大直",48,7,41
"30765","2727王品","110/07/06","元富",2,37,-35
"30766","2727王品","110/07/06","凱基-林口",45,4,41
"30767","2727王品","110/07/06","富邦-仁愛",32,64,-32
"30768","2727王品","110/07/06","德信",40,1,39
"30769","2727王品","110/07/06","玉山-板橋",52,82,-30
"30770","2727王品","110/07/06","第一金",42,5,37
"30771","2727王品","110/07/06","中國信託-文心",10,39,-29
"30772","1570力肯","110/07/06","香港上海匯豐",47,0,47
"30773","1570力肯","110/07/06","新光",2,107,-105
"30774","1570力肯","110/07/06","元大-高雄",55,16,39
"30775","1570力肯","110/07/06","摩根大通",11,58,-47
"30776","1570力肯","110/07/06","元富-緯城",37,0,37
"30777","1570力肯","110/07/06","高橋",4,50,-46
"30778","1570力肯","110/07/06","台新-台南",16,0,16
"30779","1570力肯","110/07/06","合庫-桃園",0,20,-20
"30780","1570力肯","110/07/06","元大-新竹經國",14,0,14
"30781","1570力肯","110/07/06","永豐金-板盛",0,18,-18
"30782","1570力肯","110/07/06","富邦-左營",12,0,12
"30783","1570力肯","110/07/06","華南永昌-公誠",0,9,-9
"30784","1570力肯","110/07/06","國票-中正",12,2,10
"30785","1570力肯","110/07/06","凱基-台北",1,9,-8
"30786","1570力肯","110/07/06","國票-博愛",10,0,10
"30787","1570力肯","110/07/06","臺銀-臺中",0,6,-6
"30788","1570力肯","110/07/06","統一-敦南",12,5,7
"30789","1570力肯","110/07/06","台新-三民",0,5,-5
"30790","1570力肯","110/07/06","群益金鼎-三重",7,0,7
"30791","1570力肯","110/07/06","華南永昌-麻豆",0,5,-5
"30792","1570力肯","110/07/06","臺銀-臺南",6,0,6
"30793","1570力肯","110/07/06","合庫-台南",0,4,-4
"30794","1570力肯","110/07/06","大慶-蘆洲",6,0,6
"30795","1570力肯","110/07/06","統一-員林",0,4,-4
"30796","1570力肯","110/07/06","元富-新店",6,0,6
"30797","1570力肯","110/07/06","康和-澎湖",0,4,-4
"30798","1570力肯","110/07/06","玉山-雙和",7,1,6
"30799","1570力肯","110/07/06","華南永昌-斗六",0,4,-4
"30800","1570力肯","110/07/06","永豐金-敦南",9,3,6
"30801","1570力肯","110/07/06","元大-和平",0,4,-4
"30802","6180橘子","110/07/06","凱基-台北",72,12,60
"30803","6180橘子","110/07/06","臺銀-金山",5,105,-100
"30804","6180橘子","110/07/06","美林",29,0,29
"30805","6180橘子","110/07/06","元大-台中",0,100,-100
"30806","6180橘子","110/07/06","合庫-自強",21,0,21
"30807","6180橘子","110/07/06","康和-台南",3,50,-47
"30808","6180橘子","110/07/06","凱基-三峽",17,0,17
"30809","6180橘子","110/07/06","元大-中和",0,35,-35
"30810","6180橘子","110/07/06","富邦-虎尾",15,1,14
"30811","6180橘子","110/07/06","中國信託-忠孝",0,16,-16
"30812","6180橘子","110/07/06","元富-潮州",13,0,13
"30813","6180橘子","110/07/06","玉山-高雄",0,12,-12
"30814","6180橘子","110/07/06","中國信託-永康",13,0,13
"30815","6180橘子","110/07/06","港商野村",0,11,-11
"30816","6180橘子","110/07/06","元大-草屯",18,5,13
"30817","6180橘子","110/07/06","群益金鼎-松山",0,11,-11
"30818","6180橘子","110/07/06","臺銀",11,0,11
"30819","6180橘子","110/07/06","永豐金-豐原",0,11,-11
"30820","6180橘子","110/07/06","新光",15,4,11
"30821","6180橘子","110/07/06","元富-嘉義",5,15,-10
"30822","6180橘子","110/07/06","元大-竹東",11,0,11
"30823","6180橘子","110/07/06","玉山-士林",0,10,-10
"30824","6180橘子","110/07/06","宏遠-台中",10,0,10
"30825","6180橘子","110/07/06","凱基-北門",0,10,-10
"30826","6180橘子","110/07/06","第一金-台南",10,0,10
"30827","6180橘子","110/07/06","第一金-忠孝",0,9,-9
"30828","6180橘子","110/07/06","國泰-敦南",10,0,10
"30829","6180橘子","110/07/06","統一-基隆",0,9,-9
"30830","6180橘子","110/07/06","富邦-嘉義",10,0,10
"30831","6180橘子","110/07/06","安泰-大發",1,10,-9
"30832","2390云辰","110/07/06","元大-天母",975,276,699
"30833","2390云辰","110/07/06","台灣摩根士丹利",3,265,-262
"30834","2390云辰","110/07/06","摩根大通",688,312,376
"30835","2390云辰","110/07/06","群益金鼎-海山",3,166,-163
"30836","2390云辰","110/07/06","國泰-忠孝",164,3,161
"30837","2390云辰","110/07/06","國泰-敦南",188,339,-151
"30838","2390云辰","110/07/06","富邦-北港",140,7,133
"30839","2390云辰","110/07/06","元大-土城學府",12,119,-107
"30840","2390云辰","110/07/06","聯邦商銀",151,22,129
"30841","2390云辰","110/07/06","永豐金-高雄",4,103,-99
"30842","2390云辰","110/07/06","中國信託-文心",143,17,126
"30843","2390云辰","110/07/06","土銀-士林",0,94,-94
"30844","2390云辰","110/07/06","永豐金-中正",133,7,126
"30845","2390云辰","110/07/06","元大-佳里",11,91,-80
"30846","2390云辰","110/07/06","群益金鼎-大興",178,76,102
"30847","2390云辰","110/07/06","玉山-台中",10,86,-76
"30848","2390云辰","110/07/06","元富-中港",103,3,100
"30849","2390云辰","110/07/06","新光",251,324,-73
"30850","2390云辰","110/07/06","統一-新台中",104,12,92
"30851","2390云辰","110/07/06","富邦-敦南",29,101,-72
"30852","2390云辰","110/07/06","新加坡商瑞銀",211,120,91
"30853","2390云辰","110/07/06","兆豐-台中",0,58,-58
"30854","2390云辰","110/07/06","兆豐-忠孝",100,11,89
"30855","2390云辰","110/07/06","日盛證券",16,73,-57
"30856","2390云辰","110/07/06","凱基-林口",87,9,78
"30857","2390云辰","110/07/06","元大-東泰",5,61,-56
"30858","2390云辰","110/07/06","元富-西松",72,4,68
"30859","2390云辰","110/07/06","台新證券",136,190,-54
"30860","2390云辰","110/07/06","台新-左楠",66,9,57
"30861","2390云辰","110/07/06","元大-六合",10,63,-53
